	coreid	status	nwords_original	nwords_result	nwords_recovered	nwords_omitted	nwords_created	prop_recovered	common_words	original_only	result_only
0	wfo-0001025636	success	208	131	110	98	21	0.529	0-5,0.1,0.1-0.3,0.6-2.8,1,1-2,1-2.2,1-3.5,1-4,1-5,1-5.5,1.1-6.1,1.4-3.5,1.7-5.2,1.7-9.2,1.8,10-45,2-4,2.5-6,2.6-8.3,3-5,6.5-10,9.5-29.5,abaxially,absent,adaxially,anther,base,blade,blue,broadly,brownish,cell,chartaceous,clavate,cm,condition,contracted,corolla,diameter,digestion,distal,drying,elliptic,end,enzyme,filament,flower,fresh,fruit,glabrous,globose,green,greenish,half,herb,highly,honeycomb-shaped,interjected,lanceolate,lateral,leaflet,lobe,long,longer,membranous,minute,mm,moderately,mottled,near,obovate,odd-pinnate,often,orbicular,orne,ovate,ovoid,pedicel,peduncle,perfect,petiole,plant,pubescent,purple,removed,ripe,rotate,rotate-pentagonal,scale-like,seed,sessile,singly,size,slightly,sometimes,stem,stigma,straight,style,subglabrous,terminal,testal,tube,tuber,typically,wall,whitish,wide,x	0-2,1-10,1-3,2,3-6,5-merou,acumen,acuminate,acute,ag,along,alyx,apart,apex,apparently,articulated,axe,berry,capitat,ciliate,clearly,connivent,covering,cuneate,decurrent,dorsally,eaf,edge,eed,especially,exceeding,except,flat,folded,geminat,generally,glabrou,greatly,green-white,hair,hair-like,hal,high,homostylous,larger,lengthening,like,living,lower,make,margin,midrib,minutely,mucilaginous,multicellular,nflorescence,oblique,obtuse,orolla,pair,petiolulate,petiolule,plurifoliate,pore,poricidal,proximal,puberulent,reduced,rosette-forming,rounded,ruit,semierec,seudostipule,short,slit,spaced,specimen,stamen,ste,stolo,subequal,tall,tamen,tem,thick,throughout,tip,tri-,truncate,unequal,unforked,unit,unwinged,uppermost,vary,wet,yellow,ympodial	abaxial,adaxial,arrangement,calyx,capitate,colour,form,growth,height,inflorescence,leaf,length,ovary,position,presence,pseudostipule,shape,staman,stolon,texture,type
1	wfo-0001025637	success	193	115	96	97	19	0.497	0-0.3,0.2-0.5,0.2-0.9,0.3-0.5,0.8-2.6,1-12,1-2,1-2.5,1.2-3.5,1.5-5,1.6-2.5,14-38,2-7,2.5-8,2.8-4.2,3-10,3-5,3-9,5-7,abaxially,adaxially,anther,axillary,blade,blue,brownish,bud,cell,clavate,cm,condition,connivent,coriaceous,corolla,dark,deep,diameter,digestion,dot,drying,elliptic,enzyme,filament,flower,fresh,fruit,glabrescent,glabrous,globose,green,greenish,hair,herb,homostylous,honeycomb-shaped,interjected,lanceolate,lateral,leaf,leaflet,light,lilac,lobe,long,medium,mm,mottled,odd-pinnate,ovoid,pedicel,peduncle,pentagonal,petiole,plant,purple,removed,ripe,rotate,seed,short,size,stigma,straight,stripe,style,subtending,terminal,testal,tiny,tube,tuber,wall,white,whitish,wide,x	0-27,1-5,2-20,2-3,3-4,4-6,5-merou,acumen,acuminate,acute,adaxiall,ag,along,alyx,apart,apex,apparently,arranged,articulated,attenuate,axe,base,bead,berry,capitat,covering,cuneate,decreasing,decurrent,distal,dorsally,eaf,edge,eed,erec,exceeding,flat,folded,forked,geminat,generally,glabrou,green-white,hair-like,hal,half,high,lengthening,like,linear,living,lower,make,moniliform,mucilaginous,multiple,necklace,nflorescence,onto,orolla,ovate,pair,perfect,petiolulate,petiolule,plurifoliate,pore,poricidal,rachi,rounded,ruit,secondary,seudostipule,slit,sometimes,spaced,specimen,stamen,stolon,subequal,symmetric,tall,tamen,tem,thick,throughout,tip,toward,tri-,typically,unit,unwinged,usually,vary,wet,yellow,ympodial	5-merous,arrangement,calyx,capitate,colour,form,growth,height,inflorescence,length,ovary,position,presence,present,pseudostipule,shape,staman,stem,texture
2	wfo-0001025639	success	154	109	84	70	25	0.545	1-2,1-3,1-4,10-21,2-3.5,2.8-3.2,20-35,3-6,3.5-7,4-10,4.5-8.5,5-10,5-8,6-12,6-8,8-9,apical,apically,base,branched,broadly,calyx,cell,cm,connate,corolla,cyme,dark,dehiscent,diameter,dichasial,dichasially,distal,ebracteate,elliptic,elliptical,filament,flower,globose,green,green-white,half,herbaceous,honeycomb,interjected,introrse,lateral,leaf,leaflet,lobe,long,maturing,medium,mm,monochasial,obovate,odd-pinnate,often,ovate,ovoid,pattern,pedicel,peduncle,perfect,petiole,plant,poricidally,present,puberulent,pubescent,rotate,seed,short,size,slit,stigma,straight,style,terminal,testal,violet,white,wide,yellow	2-3,3-4,3-5,3-6-foliat,5-1.,8-12,abaxially,acumen,acuminate,acute,adaxially,apex,articulate,belo,covering,cuneate,digestion,diminishing,dorsally,eaf,edge,eed,emoval,enzyme,exceeding,flat,folded,forked,frequently,generally,globo,gradually,hair-like,lon,long-attenuate,lower,lunat,make,mucilaginous,nflorescence,nther,oblique,orolla,pair,perennial,petiolule,plan,produced,proximal,rare,reveal,ruit,seudostipule,sometimes,stamen,tal,tem,thick,throughou,throughout,top,toward,truncate,tuber-bearing,typically,unit,vary,wall,ympodial,¼	abaxial,adaxial,anther,arrangement,blade,colour,form,fruit,growth,height,inflorescence,length,lunate,na,ovary,position,presence,pseudostipule,shape,staman,stem,texture,tube,tuber,type
3	wfo-0001025642	success	149	97	75	74	22	0.503	0.3-0.4,1,1-2,1-2.5,1-2.7,1-3.2,1.5-2.5,10-20,3-5,3.5-6,4-7.5,4.5-8,5-6,5.5-7,7-11.5,9-12,abaxially,absent,adaxially,apical,apically,branched,calyx,cm,connate,corolla,cyme,dehiscent,diameter,dichasial,dichasially,distal,ebracteate,elliptic,elliptic-lanceolate,flower,globose,green,green-white,half,herbaceous,interjected,introrse,lanceolate,lateral,leaf,leaflet,long,maturing,mm,monochasial,odd-pinnate,often,ovoid,pedicel,peduncle,perennial,perfect,petiole,plant,poricidally,present,puberulent,seed,short,size,slit,stellate,stigma,straight,style,terminal,throughout,wide,yellow	1-3,1-4,2-10,2-3,3,3-6-foliat,8-13,absen,acumen,acuminate,acute,apex,apiculate,articulate,attenuate,base,cell,covering,digestion,diminishing,dorsally,eaf,edge,eed,emoval,enzyme,exceeding,filament,flat,folded,forked,generally,globo,gradually,hair-like,honeycomb,lanceolat,living,lobe,lon,lower,lunate,make,mucilaginous,nflorescence,nther,oblique,obtuse,orolla,pair,pattern,plan,proximal,reveal,ruit,sessile,seudostipule,specimen,stamen,tal,tem,testal,thick,throughou,toward,tuber-bearing,typically,unit,vary,wall,whit,without,ympodial,¼	anther,arrangement,blade,colour,form,fruit,growth,height,history,inflorescence,length,life,na,ovary,position,presence,shape,stem,texture,tuber,type,white
4	wfo-0001025644	success	204	120	101	103	19	0.495	0.8-1.5,1-2,1.3-2.1,10,10-11,12-28,2,2-3,2.4-4,2.5-11,2.5-6,25-50,3-10,3-5,3.3-8.2,4-19,4-6,4.5-9.5,6-7,6.5-13,abaxially,absent,adaxially,almost,anther,axillary,blade,blue,broadly,brownish,bud,cell,chartaceous,ciliate,clavate,cm,condition,connivent,corolla,denticulate,diameter,drying,elliptic,filament,finely,flower,fresh,fruit,glabrous,globose,green,greenish,hair,herb,homostylous,honeycomb-shaped,interjected,invested,lanceolate,lateral,leaflet,like,long,margin,membranous,mm,mottled,multicellular,non-glandular,odd-pinnate,ovate,ovoid,pedicel,peduncle,pentagonal,petiole,plant,pubescent,purple,rounded,seed,short,size,stem,stigma,straight,style,subtending,terminal,testal,tinged,trichome,tube,tuber,uniseriate,usually,white,whitish,wing,winged,x	.3,0-5,1-10,13-21,2-4,3-4,5-merou,acumen,acuminate,acute,ag,along,always,alyx,apart,apex,apparently,articulated,attenuate,axe,base,berry,c.,capitat,cordate,covering,cuneate,digestion,distal,dorsally,eaf,edge,eed,end,enzyme,erec,especially,exceeding,except,flat,folded,forked,geminat,generally,glabrou,greatly,green-white,hair-like,half,lengthening,living,lobe,lower,make,middl,midrib,minutely,mucilaginous,nflorescence,oblique,often,one,orbicular,orolla,pair,perfect,petiolule,placed,plurifoliate,pore,poricidal,proximal,puberulent,rarely,reduced,removed,ruit,sessile,seudostipule,shallowly,slit,spaced,specimen,stamen,ste,stolo,subequal,tall,tamen,tem,thick,throughout,tip,tri-,truncate,typically,unit,vary,wall,well-developed,wet,yellow,ympodial	5-merous,arrangement,calyx,capitate,colour,form,growth,height,inflorescence,leaf,length,ovary,position,presence,present,pseudostipule,shape,staman,texture
5	wfo-0001025645	success	150	96	72	78	24	0.48	0.3-0.8,0.8,1-2,1-3.5,10-11,10-16,15-25,2-4.5,2.5,3-5.5,4-12,4-6,4-7,5,5-5.5,abaxially,adaxially,apical,apically,branched,calyx,cm,connate,corolla,cyme,dehiscent,diameter,dichasial,dichasially,distal,ebracteate,elliptic-lanceolate,flower,glabrous,globose,green,green-white,half,herbaceous,interjected,introrse,lanceolate,lateral,leaf,leaflet,long,maturing,mm,monochasial,odd-pinnate,often,ovoid,pedicel,peduncle,perennial,perfect,petiole,plant,poricidally,puberulent,seed,short,size,slit,stellate,stigma,straight,style,terminal,throughout,wide,yellow	0.5-1,1-4,12-17,2-3,3-6-foliat,4-5,8-10,absen,acumen,acuminate,acute,apex,articulate,base,cell,covering,cuneate,decurrent,digestion,diminishing,dorsally,eaf,edge,eed,elliptic,emoval,enzyme,exceeding,filament,flat,folded,forked,generally,globo,gradually,hair-like,honeycomb,larger,living,lobe,lon,lower,lunat,make,mucilaginous,mucronate,nflorescence,nther,oblique,oblong,orolla,pair,pattern,plan,proximal,rachi,reveal,ruit,second,sessile,seudostipule,specimen,stamen,tal,tem,testal,thick,throughou,toward,tuber-bearing,typically,unit,vary,wall,whit,without,ympodial,¼	absent,anther,arrangement,blade,colour,form,fruit,growth,height,history,inflorescence,length,life,na,ovary,position,presence,present,shape,stem,texture,tuber,type,white
6	wfo-0001025646	success	136	94	71	65	23	0.522	0.25-0.4,0.5-2.1,0.6-2.3,0.6-3,0.7-3.5,1.1-1.4,1.1-4.5,1.2-7.0,2-3,2-4,2.3-9.0,3.2-6,3.5-7,4-15.5,4-5,7-8,abaxially,adaxially,apical,apically,calyx,cm,connate,corolla,cyme,dehiscent,diameter,dichasial,distal,elliptic,flower,forked,fruit,generally,globose,half,herbaceous,interjected,introrse,lateral,leaf,leaflet,long,maturing,mm,monochasial,obovate,odd-pinnate,often,ovary,ovate,pedicel,peduncle,pentagonal,perennial,perfect,petiole,plant,poricidally,probably,puberulent,short,size,slit,stigma,straight,strigose,style,terminal,wide,yellow	0-.,1-4,1-7,1.2,1.5-3,2.5-3,3,3-6-foliat,4-10,abruptly,acumen,acuminate,acute,apex,apiculate,articulate,attenuate,ature,base,branched,caudate,cuneate,decurrent,dichasially,diminishing,dorsally,eaf,ebracteate,edge,eed,exceeding,filament,flat,folded,globo,gradually,like,lobe,lon,lower,lunat,nflorescence,nther,oblique,orolla,pair,petiolule,plan,proximal,seen,sessile,seudostipule,slightly,sometimes,stamen,tal,tem,toward,tuber-bearing,typically,unit,vary,whit,ympodial,¼	0-4,anther,arrangement,blade,colour,form,growth,height,history,inflorescence,length,life,na,position,presence,present,seed,shape,stem,texture,tuber,type,white
7	wfo-0001025647	success	194	120	101	93	19	0.521	0.06-0.24,0.4-1.5,0.6-3,0.8-3,1-2,1-5,1.2-3,1.3-2.9,1.4-5,1.5-5,1.5-5.5,2,2-3,2-4,2-5,2.5-3,3-6,4-10,5-6,6.2-11,absent,anther,axillary,base,blade,blue,broadly,brownish,bud,cell,chartaceous,clavate,cm,condition,connivent,corolla,densely,diameter,digestion,distal,drying,elliptic,enzyme,filament,flower,frequently,fresh,fruit,glabrous,globose,green,greenish,hair,half,herb,honeycomb-shaped,interjected,lanceolate,lateral,leaflet,light,like,linear,lobe,long,membranous,mm,moderately,multicellular,narrowly,near,odd-pinnate,often,ovoid,pedicel,peduncle,perfect,petiole,plant,pubescent,removed,ripe,rotate,scale-like,seed,size,sometimes,stem,stigma,straight,style,subtending,terminal,testal,tube,tuber,unbranched,unwinged,wall,whitish,x	0-4,1,1-10,1-3,4-6,5-merou,abaxially,acumen,acute,adaxially,ag,along,alyx,apart,apex,apparently,articulated,attenuate,axe,berry,borne,capitat,ciliate,covering,decurrent,dorsally,eaf,edge,eed,end,erec,especially,exceeding,except,flat,folded,forming,geminat,glabrou,greatly,green-white,hair-like,hal,high,homostylous,lengthening,living,lower,make,margin,midrib,minutely,mucilaginous,nflorescence,oblique,obtuse,orbicular,orolla,ovate,pair,petiolulate,plurifoliate,pore,poricidal,proximal,puberulent,reduced,rosette,ruit,sessile,seudostipule,short,singly,slit,spaced,specimen,stamen,ste,stolo,subequal,tall,tamen,tem,thick,throughout,tip,tri-,typically,unit,vary,wet,yellow,ympodial	arrangement,calyx,capitate,colour,form,growth,height,inflorescence,leaf,length,ovary,position,presence,present,pseudostipule,shape,staman,texture,type
8	wfo-0001025652	success	156	97	73	83	24	0.468	.3,0.5-1,1,1-1.5,1.5-2,10-20,2-3,2-6,20-50,3-3.5,3-5,4,4-6,4-7,anther,anthesi,base,bilobed,blade,calyx,cm,corolla,densely,elliptic,filament,fleshy,flower,fruit,furcate,glabrous,green,growth,lateral,leaf,lobe,lobed,minutely,mm,nearly,occasionally,opposite,ovary,ovoid-reniform,pale,paler,papillose,pedicel,petiole,pinkish-grey,pitted,planar,plant,poricidal,red-papillose,shape,shiny,shrub,simple,size,small,stem,stigma,straight,strongly,style,tan,tip,tree,tube,vein,white,winged,x	.5,15-17,15-19,2-5,3-5-flowered,9-11,abruptly,acuminate,acute,apex,appearing,bark,broad,campanulate,closed,closely,completely,connate,decurrent,dia,differing,difoliate,dry,eaf,edicel,eed,emerge,envelope,free,geminat,glabrate,greyi,greyish,growing,irregular,like,live,lon,long,lower,main,major,margin,matte,middle,minor,minute,narrowing,new,nflorescence,older,one,onto,overlappin,ovoid,pair,papillae,papillo,parallel,pore,portion,rather,ry,scar,shaped,soon,spaced,specimen,surface,tall,tapering,tear,tear-drop,thick,thicker,tightly,ud,unit,wider,widest,wing,ympodial,young	abaxial,adaxial,arrangement,cell,colour,diameter,form,height,inflorescence,interjected,leaflet,length,na,peduncle,position,presence,pseudostipule,seed,staman,terminal,testal,texture,tuber,type
9	wfo-0001025653	success	218	84	51	167	33	0.234	.0,.3,.5,.6,.7,.8,.9,1.3,20,acuminate,anther,blade,brown,calyx,chartaceous,cm,corolla,cylindrical,densely,diameter,extra-axillary,filament,filiform,flower,fruit,glabrous,glandular,globolunate,hair,lateral,leaf,least,lobe,long,minute,mm,pedicel,peduncle,petiole,pubescent,reddish,short,shrub,simple,stellate,stem,stigma,style,truncate,tube,unbranched	.1,.2,0.1,0.13,0.15,0.2–0.4,0.3–0.5,0.3–0.8,0.6–1.6,0.7–1.1,0.8,1.0–1.6,1.1–1.3,1.3–1.8,1.6,1.9–3.3,1–1.5,2.3–3.2,2.5–4.0,2.6,4–6,5-merou,6–8,6–9,7–12,8–11,90°,abaxially,absent,adaxiall,adaxially,adnate,aequilateral,ag,alyx,among,anthesi,apart,apex,apical,apparently,appearing,around,articulate,attenuate,axe,ba,bark,base,broad,bud,channeled,clinate,congested,craspedodromous,deltoid,developed,directed,distinct,dry,eaf,edge,eed,either,emerging,entire,erect,extending,ferruginous,fertile,free,globose,heterostylous,increasing,intact,internode,interpetalar,intersepalar,know,known,lanceolate,layer,less,lobed,lon,longer,low,lower,margin,mature,midpoint,midrib,midvein,much,nflorescence,noticeably,oblique,obtuse,occasionally,opaque,opposed,orolla,ovate,persistent,plurifoliat,pore,porrect,porrect-stellate,portion,potentially,prickl,prickle,primary,raised,ray,reduced,remaining,restricted,rhizomatous,rigid,rounded,row,ruit,scarcely,secondary,see,seen,sessile,short-stipitate,shorter,shot-stipitate,side,sinuate,sloughing,sparsely,splitting,spread,stamen,stellae,stellate-pubescent,stipe,stipitate,straight,subcordate,surface,suture,tamen,tem,time,tip,tissue,transparent,truncat,two,ud,unarme,unarmed,vary,vein,well,wide,yellow-ferruginous,ympodia,young,±equal,±erect,×	0.6-1.6,1.0-1.6,1.3-1.8,2.3-3.2,2.5-4.0,5-merous,abaxial,adaxial,arrangement,cell,colour,form,growth,height,inflorescence,interjected,leaflet,length,na,ovary,plant,position,presence,pseudostipule,seed,shape,size,staman,terminal,testal,texture,tuber,type
10	wfo-0001025654	success	140	77	49	91	28	0.35	0,1,1-2,15-22,2,25-30,4,5-6,5-merous,6,7-8,abaxial,absent,adaxial,anther,blade,calyx,chartaceous,cm,diameter,dull,filament,flower,fruit,glabrous,globose,inflorescence,juvenile,lanceolate,leaf,lobe,mature,mm,mostly,pedicel,pedicellate,peduncle,petiole,position,purple,shrub,simple,size,stellate,stem,stigma,style,sub-axillary,x	2-2.5,2-foliate,3/4,4-5,5,?,abaxially,abortive,abundant,accrescen,acumen,acuminate,alyx,ape,apex,apica,apparently,armed,articulated,axe,ba,base,branched,broadly,cuneate,eaf,eed,elliptic,erect,flattened,frequently,fruiting,geminat,glandular,hair,homostylou,hooked,larger,later,less,long,lower,mainly,margin,midvein,minute,minutely,narrowed,nflorescence,oblique,often,older,orolla,pale,phase,pore,prickle,pubescent,rachi,repand,retrorse,ruit,scarcely,scattered,sessile,several,shallowly,shortly,single,slender,slightly,smaller,solitary,sparsely,straw-coloured,sub-acuminate,surface,tal,tamen,tem,tip,toward,triangular,unarme,unit,unknow,unknown,vary,yellow,ympodial,young	arrangement,cell,colour,corolla,form,growth,height,homostylous,interjected,lateral,leaflet,length,na,ovary,plant,presence,pseudostipule,red,seed,shape,staman,terminal,testal,texture,tube,tuber,type,unarmed
11	wfo-0001025655	success	226	115	90	136	25	0.398	-8-17,0.3-0.4,1-1.2,1-1.5,1-2,1.3-1.5,1.5-2,11,2-2.5,2.5-3,2.5-5-,3-5,4,4-5,5-6-merous,6-7,6-8,abaxial,anther,apex,asymmetric,attenuate,base,beige,blade,calyx,cinereous,clavate,cm,curved,cyme,deeply,diameter,epicarp,ferruginous,ferruginous-pubescent,ferruginous-tomentose,filament,flower,fruit,glabrous,globose,helicoid,hirsute-glandular,leaf,leathery,length,lilac,linear-lanceolate,lobe,long,minutely,mm,monoclinous,mucilaginous,multiangulate-stellate,parted,pedicel,peduncle,persistently,petiole,plant,reddish,rugose,sessile,shrub,slightly,solitary,staminate,stellate,stem,stigma,straight,style,sub-capitate,sub-sessile,subcoriaceous,subreniform,subsagittate,subterete,tomentose,tomentose-velutinous,trichome,tube,unarmed,unbranched,violet,viscid-velutinous,wide,yellowish	-3-5-lobed,0.6-0.8,1-3,1.4-2,2,2-3,2-3.5,2-5-celled,3-,3-7,3-8-flowered,4-6,5-7,8-10,accrescent,acuminate,along,alyx,anthesi,armed,articulate,ba,bark,basal,branch,branched,brow,brown,canaliculate,central,compressed,cordate,cordate-lanceolate,dark,densely,di-,discolorous,distal,dry,eaf,eed,elongate,enlarged,entire,equal,erect,exceeding,free,fruiting,functional,fused,geminat,glabrescent,gland,glandular,glandular-stellate,glandular-tipped,gynoeci,held,indument,lanate,long-exserted,long-stalked,longer,lower,many-celled,maturit,midrib,mix,multiangulate,multiseriate,nflorescence,numerous,oblong-urceolate,older,one,orolla,papillo,part,peduncl,perennia,persistent,petiol,porrect-stellate,prickle,primary,prolonged,prominent,rachi,ranch,ray,recurved,reduced,reflexed,rounded,ruit,secondary,sepal,short,similar,slender,small,somewhat,sparsely,splitting,stalk,stalked,stamen,stellae,stellate-glandular,strongly,sub-globose,sub-quadrangular,surface,surrounded,tall,tamen,terete,time,triangular-lanceolate,trifoliate,uniseriate,unit,upright,vary,vein,velutinous,villous,weakly,within,without,woolly,ympodial,young,¼,½	adaxial,arrangement,colour,corolla,form,growth,height,inflorescence,interjected,lateral,leaflet,na,ovary,papillose,position,presence,pseudostipule,seed,shape,size,staman,terminal,texture,tuber,type
12	wfo-0001025656	success	209	112	85	124	27	0.407	-10,-14,0.2-,0.2-0.4,0.8-1,1-1.5,1-2,1-4,1.5-2,12-15,2.5-5,3-12,3-3.5,3-7,4-4.5,4-5,5-,6-11,8-10,8-9,anther,berry,blue,brown,calyx,cell,channelled,chartaceous,clavate-truncate,cm,coriaceous,corolla,corymbose,curved,cyme,diameter,filament,flattened,flower,globose,green,grey,growth,heterostylous,hirsute,inflorescence,internodal,lanate,lobe,lobed,long-styled,minutely,mm,ochraceous,ovary,pedicel,peduncle,petiole,plant,poricidal,prickle,purple,reniform,reticulate,rugose,rusty,short-styled,shrub,simple,slightly,stellate,stem,stigma,straight,style,subcoriaceous,subreniform,tapering,tomentose,tomentose-lanate,tomentose-velutinous,tube,viscid,x,yellow	0.2-0.3,0.5-0.6,1.8-2,1/3,10-,10-15,2-2.5,3,30-40,4-6,6,abaxially,acuminate,acute,adaxially,adult,almost,along,anthesi,apart,apex,apical,apically,armed,bark,basal,base,branched,congested,cuneate,densely,denser,discolorous,distal,eaf,eed,elliptic,elliptic-ovate,elongate,entire,erect,evenly,exserted,flexuous,foliaceous,free,fruiting,glabrous,gland,glandular,gre,inflorescenc,juvenile,lengthening,like,linear-lanceolate,lobed-angulate,long,long-stalked,longer,loosely,looser,lower,margin,mature,midpoint,midrib,minute,mixed,multangulate,multicellular,near,new,nflorescence,older,ovate,papillat,partially,perfect,pericarp,plurifoliat,pore,porrect,portion,prickly,pubescence,pubescent,raised,reflexed,relatively,rounded,ruit,scandent,scar,sessile,several,short-stalked,single,spaced,sparse,sparsely,stalk,staminate,subglobose,subscandent,subtuncate,surface,tall,testa,time,tip,trichome,turbinate,ud,unit,upper,vein,venation,white,whitish,without,wood,ympodial,young	abaxial,adaxial,arrangement,blade,colour,form,fruit,height,interjected,lateral,leaf,leaflet,length,na,papillate,position,presence,pseudostipule,seed,shape,size,staman,terminal,testal,texture,tuber,type
13	wfo-0001025657	success	239	101	74	165	27	0.31	0.1-0.4,0.2-0.4,1-1.1,1-1.3,1-1.6,1-3,1.2-1.5,1.3-2,1.5-1.8,2-10,2.2-5.5,2.5-9.3,2.7-4.3,3-4,3-6,4-4.4,5-14,5-16,6-12,7-27,7-9.5,8.3-12,anther,berry,blade,bluish,branched,brown,calyx,chartaceous,cm,corolla,cylindrical,dark,deltoid,diameter,dried,filament,fleshy,flower,fruit,granular,green,lateral,leaf,length,lobe,mm,oblong,pedicel,peduncle,perfect,petiole,pseudo-terminal,reticulate-punctate,ripe,shrub,simple,soft,stellate,stem,stigma,style,suborbicular,tan,tomentose,tomentose-pubescent,tree,tube,velutinous-pubescent,white,x,yellow,yellowish	-2,/3,0.5-2.5,1.7-1.9,12x,2-3.5,2/3,25-60,3-4.8,3.2-6,4-4.5,4-7,6-8,6.5-10,7-9,8-10.5,abaxially,accrescent,acute,adaxially,ag,also,anthesi,apart,apex,apparently,appearing,ark,around,articulated,ascending,axe,axillary,ba,base,blunt-tipped,branch,broadly,bud,capitat,central,closely,conical,cordate,dendritic-multangulat,dendritic-multangulate,dense,densely,directed,distally,due,eaf,earl,edge,eed,elliptic,entire,especially,evident,exerted,expanded,exserted,farinose,few-rayed,free,fruiting,glabrous,glandula,glandular,hair,half,inserted,lanate-pubescent,lanceolate,lengthening,light,lobed,long,long-stalked,longitudinal,lower,m.,magnification,main,margin,midrib,minutely,mixed,multangulate,narrowly,nearly,nflorescence,obtuse,occasional,often,older,open,orbicular,orolla,ovat,ovate,ovate-lanceolate,overlapping,pale,part,parted,partly,persistent,persistently,plurifoliate,pore,poricidal,porrect-stellate,present,pubescence,pubescent,rachi,ray,reportedly,ruit,scented,semi-ovate,sessile,short,short-,short-stalked,side,slightly,slit,somewhat,spaced,splitting,stamen,stellate-pubescent,stipitate-glandular,stipitate-multangulate,strongly,subcampanulate,subcoriaceous,surface,suture,tall,tamen,terete,thick-stalked,thickened,thin-stalked,time,tip,tomentum,transparent,two-third,ud,unarme,unarmed,unit,upper,usually,vary,vein,way,weakly,wide,ympodial,young	abaxial,adaxial,arrangement,capitate,cell,colour,form,growth,height,inflorescence,interjected,leaflet,na,ovary,plant,position,presence,pseudostipule,seed,shape,size,staman,terminal,testal,texture,tuber,type
14	wfo-0001025666	success	217	104	78	139	26	0.359	0-0.7,0.3,0.5-1,0.5-1.5,1,1-1.5,1-1.7,1.5-1.8,1.5-2.5,1.5-3.5,2-3,2.8-4.5,21-30,3-3.5,3.5-4,4-5,5-6,5.5-9.5,6-20,6-7.5,anther,base,blade,brown,calyx,chartaceous,cm,cylindrical,densely,diameter,extra-axillary,filament,flattened,flower,fruit,glabrous,gland-tipped,globose,green,hair,inflorescence,lateral,leaf,length,lobe,lobed,mm,narrowly,ovate,pale,pedicel,peduncle,perennial,petiole,pinkish,plant,prostrate,pseudo-racemose,pseudo-umbellate,purple,shallowly,short,shrub,simple,slightly,sparsely,stellate-pubescent,stigma,stoloniferous,style,tapered,tube,white,whitish,x,yellow,yellowish,yellowish-green	%,.8,0-5,0.05-0.25,0.2-0.3,0.2-0.35,0.2-0.8,0.25-0.35,0.25-0.4,0.5-2,1-1.4,1-2,1-locular,1.6-2.3,10-30,14-29,2-4,2-8,20-60,25-65,3-5,3-7,4-6,5-merou,7-8,8-12,9-10,9-20,abaxially,absen,absent,acicular,across,acute,adaxially,alyx,andromonoecious,apart,apex,armed,articulated,attenuate,axe,ba,capitat,center,confined,connivent,cross-section,cuneate,d.,difoliate,directed,distal,distall,eaf,eed,eglandular,elliptica,elliptical,entire,exocarp,finely,finger,fruiting,functional,geminate,half,heterostylous,incomplete,index,interpetalar,juicy,lamina,less,lobing,long,longer,loosely,lower,margin,mature,mesocarp,midpoint,midrib,midvein,minute,moderately,moist,nflorescence,oblique,obtuse,orolla,part,per,placenta,pore,porrect,presen,present,prickle,probably,rachi,ray,reticulate,ridged,ruit,septum,sessile,side,spaced,sparse,stage,stellae,stellate,straight,strongly,surface,tal,tamen,tem,terete,thick,throughout,time,tissu,tissue,transparent,triangular,unarme,unarmed,unbranched,unit,uvenile,vary,vein,weakly,wide,ympodial	5-merous,abaxial,adaxial,arrangement,capitate,colour,corolla,form,growth,height,interjected,leaflet,na,ovary,position,presence,pseudostipule,seed,shape,size,staman,stem,terminal,texture,tuber,type
15	wfo-0001025669	invalid_json	216	128	100	116	28	0.463	'',.5,0-7,0.1-0.3,0.8-2.4,1,1-2,1-2.2,1-4,1.3-4.2,1.4-2.5,1.6-4.4,13-35,2-3,2-4,2.2-6,2.2-6.5,2.4-7,3-5,3-7,9-24.5,``,absent,anther,base,blade,blue,broadly,brownish,cell,chartaceous,clavate,cm,condition,connivent,corolla,diameter,drying,elliptic,filament,flower,fresh,fruit,glabrous,globose,green,greenish,hair,herb,homostylous,honeycomb-shaped,interjected,lanceolate,lateral,leaflet,like,lobe,long,membranous,minute,mm,moderately,monochasium,mottled,obovate,odd-pinnate,orbicular,ovate,ovoid,pedicel,peduncle,petiole,plant,pubescent,purple,rarely,ripe,rotate,scale-like,seed,size,slightly,sometimes,stem,stigma,straight,streaked,style,subglabrous,terminal,testal,tinged,tube,tuber,typically,unwinged,white,whitish,wide,x	0-1,0-5,1-10,1-3,2,4-6,5-merou,abaxially,absen,acumen,acuminate,acute,adaxially,ag,along,alyx,apart,apex,apparently,articulation,axe,berry,capitat,ciliate,clearly,contracted,covering,cuneate,decurrent,digestion,discussion,distal,distinct,dorsally,eaf,edge,eed,end,enzyme,erec,especially,exceeding,except,extra,flat,flowered,folded,forming,geminat,glabrou,greatly,green-white,hair-like,half,highly,larger,lengthening,living,lower,make,margin,midrib,minutely,mucilaginous,multicellular,near,nflorescence,oblique,obtuse,often,one,orolla,pair,perfect,petiolulate,petiolule,placed,plurifoliate,pore,poricidal,proximal,puberulent,reduced,removed,rosette,rounded,ruit,see,sessile,seudostipule,short,single,slit,spaced,species,specimen,stamen,ste,stolo,subequal,tall,tamen,tem,thick,throughout,tip,tri-,truncate,unbranched,unequal,unit,vary,wall,wet,yellow,ympodial	'extra,5-merous,[,],abaxial,adaxial,arrangement,calyx,capitate,characteristic,colour,form,growth,height,inflorescence,leaf,length,ovary,position,presence,present,pseudostipule,shape,staman,texture,value,{,}
16	wfo-0001025685	success	222	108	79	143	29	0.356	-30,0.4-6,0.45-0.9,0.5-1,1-4,1.5-2,12-13,2-5,2-6,2-7,3-3.5,4-4.5,6.5-9,7-18,anther,berry,brown,calyx,clavate,cm,coriaceous,corolla,curved,dark,diameter,filament,finely,flattened,flower,glandular,glandular-viscid,globose,green,growth,heterostylous,internodal,like,lobe,lobed,long-styled,minutely,mm,orangish,ornamented,ovary,pedicel,peduncle,petiole,plant,pubescent,quadrate,red,reniform,reticulate,ripe,scabrous,shrub,simple,size,small,sparsely,stellate,stem,stigma,straight,style,subcompressed,subtruncate,tapering,tomentose-floccose,tomentose-scabrous,tomentose-velutinous,tree,trichome,tube,velutinous-floccose,white,x,yellowish	-15,-22,/3,/4,0.2-0.3,0.3-0.5,0.3-1,1-1.5,1-multicellular,1.4,1.5-2.5,1.8-2.5,10-15,2,2-2.2,2-3,2-4,3,3-10,3-4,3.5-10,4-5,50,7-8,8-10,<,abaxially,acuminate,acute,adaxially,adult,angulate,anthesi,apart,apex,apiculate,armed,articulated,ascendin,bark,basal,basally,base,branched,caly,channelled,chartaceous,concav,cordate,cordiforme,cuneate,deciduous,deltate,dense,discolorous,distal,eaf,eed,elongating,entire,erect,exserted,flowering,foliaceous,free,fruiting,glabrescen,glabrous,heavily,impressed,juvenile,lanceolate,larger,long,lower,margin,midpoint,minute,mixed,multangulate,multicellular,new,nflorescence,oblique,oblong-lanceolate,obverse,older,ovate,ovate-cordiforme,ovate-elliptic,papillo,partially,per,perfect,pericarp,persistent,plurifoliat,pore,poricidal,porrect,portion,prickle,prickly,puberulent,pubescence,raised,ray,recurved,reduced,reflexed,rest,ruit,scandent,scar,sessile,shallowly,short-styled,slightly,slit,spaced,sparse,stalked,staminate,subcordate,subglobose,subscabrous,testa,thick,time,tip,tomentose-ferruginous,triangular-lanceolate,truncate,turbinate,ud,uneven,unit,vein,venation,way,without,woody,ympodial	abaxial,adaxial,arrangement,blade,cell,colour,denser,form,fruit,height,inflorescence,interjected,lateral,leaf,leaflet,length,na,papillose,position,presence,pseudostipule,seed,shape,staman,terminal,testal,texture,tuber,type
17	wfo-0001025688	success	218	119	69	149	50	0.317	0.2,0.5,1-celled,abaxially,abruptly,adaxially,also,anther,blade,brown,calyx,cm,cylindrical,densely,diameter,erect,extra-axillary,filament,flower,fruit,glabrous,gland,gland-tipped,globose,glutinous,hair,hyaline,larger,leaf,lobe,long,minute,mm,otherwise,pedicel,peduncle,petiole,pilose,prickle,puberulent,pubescence,rarely,rather,ripe,scattered,shrub,similar,simple,size,sparsely,stellate,stem,stigma,stipitate,style,suborbicular,surface,tapering,thin-textured,truncate,tube,unbranched,vein,white,x,yellow,yellow-green,yellowish-green,±	0.1,0.1–2,0.5–2,0.5–3,0.5–3.5,0.6–0.8,0.6–2,0.6–2.4,0.6–4,0.8,0–10,1,1.3–1.7,1.5–2,1.5–3,1.5–4,1/2,14155,15–25,1–1.5,1–1.6,1–1.8,1–2,1–3-celled,1–6-celled,1–8,2-foliate,25,2–3,2–3.5,2–4-celled,2–4–celled,3.2–3.6,3–10,3–4,4,4-lobed,40–75,4–15,4–5-rayed,4–6,4–9,5,59,5°,5–18,6–7,6–8,8–10,8–15,=,accrescent,acicular,acute,adaxiall,angle,anthesi,apex,armed,ascending,average,axe,base,branch,coiling,conpsicuously,constricted,contiguou,curved,darker,deeply,dense,developing,directed,distall,distally,eaf,eed,enlarged,entire,except,fewer,flattened,flowering,free,fresh,fruiting,geminate,grading,green,lacking,lanceolate,less,lobed,lon,lower,major,many,margin,minor,mottling,n,narrowed,narrowly,nearly,nee,nflorescence,none,often,one,orolla,ovate,per,pericarp,pore,rachi,recurved,ruit,scarious,sessile,short,single,slightly,small,sometimes,somewhat,spreading,stellae,straight,sulcate,tal,tamen,tem,thic,thick,thickene,thickened,tip,triangular,truncat,twice,unit,upper,usually,vary,way,wide,wing,ympodial	0-10,0.5-2,0.5-3,0.5-3.5,0.6-2.4,0.6-4,1-1.5,1-2,1-3-celled,1-6-celled,1.5-3,15-25,2-3.5,2-4-celled,3-4,3.2-3.6,4-15,4-6,4-9,5-18,6-7,8-15,abaxial,adaxial,arrangement,cell,colour,corolla,form,growth,height,inflorescence,interjected,lateral,leaflet,length,na,ovary,plant,position,presence,pseudostipule,seed,shape,staman,terminal,testal,texture,tuber,type
18	wfo-0001025694	success	199	118	73	126	45	0.367	1,20,5-merous,abaxial,abaxially,adaxial,adaxially,anther,attenuate,becoming,blade,brown,calyx,chartaceous,cm,connivent,cylindrical,dark,densely,diameter,drying,erect,filament,flower,fruit,fused,glabrous,gland-tipped,glandular,globose,green,hair,hermaphroditic,inflorescence,length,like,lobe,long,midpoint,mixed,mm,moderately,mottled,often,orange,pedicel,peduncle,petiole,plant,porrect-stellate,pubescent,ray,reniform,rugose,rusty,scandent,short,shrub,simple,sparsely,stellate,stellate-pubescent,stem,stigma,still,style,tan,tube,turning,white,whitish,young,×	0.2,0.2–0.3,0.3–0.6,0.5–1,0.5–1.5,0.5–3,1.5–2,1.5–3.5,10–15,10–25,1991,1–2,1–2.5,1–3,2.5,2.5–11,25–50,2–15,2–3,2–3.5,2–4,2–5-branched,3–5,3–6,4–12,4–15,4–5,5–10,6–10,6–20,8–12,absen,absent,accrescent,acute,adaxiall,alyx,androgynoecious,andromonoecious,apart,apex,apical,armed,articulated,asymmetrical,axe,ba,base,berry,beyond,capitat,center,completely,cordate,covering,discolorous,eaf,eed,elliptic,entire,exerted,exserted,flattened,frui,fruiting,functionally,heterostylou,interpetalar,little,lower,male,margin,matur,membranaceous,midrib,midvein,multicellular,multiseriate,narrowly,nearly,nflorescence,obtuse,occasionally,opening,orolla,ovate,per,pinnate,plurifoliat,pore,prickle,rachi,recurved,reflexed,roselike,ruit,secondary,side,slit,spaced,sparse,specifically,spine,stalk,stamen,staminate,surface,swollen,tal,tamen,tem,tip,tissue,triangular,triangular-ovate,unicellular,uniseriate,unit,vary,vein,venation,walker,whelan,wide,yellow,ympodial	0.5-1.5,0.5-3,1-2,1-2.5,1-3,1.5-2,1.5-3.5,10-25,2-15,2-3.5,2-4,2.5-11,3-5,3-6,4-15,6-10,6-20,arrangement,capitate,cell,colour,corolla,form,growth,height,heterostylous,interjected,lateral,leaf,leaflet,mature,na,ovary,position,presence,pseudostipule,seed,shape,size,staman,terminal,testal,texture,tuber,type
19	wfo-0001025697	success	181	113	93	88	20	0.514	-9,0-14,0.15-0.75,0.6-3.5,1-1.7,1-2,1-3,1.5-1.8,1.7-8.6,2-10.5,2-2.6,2-6,25-35,3-10,3-4,3-6,3.3-11,4-7.5,5.5-11.5,6.5-13.5,abaxially,adaxially,anther,axillary,berry,blade,blue,brownish,bud,cell,clavate,cm,condition,connivent,coriaceous,corolla,dark,deep,diameter,digestion,drying,elliptic,enzyme,filament,flower,fresh,fruit,glabrescent,glabrous,globose,green,greenish,hair,herb,homostylous,honeycomb-shaped,interjected,lanceolate,lateral,leaf,leaflet,light,lilac,lobe,long,medium,mm,odd-pinnate,ovate,ovoid,pedicel,peduncle,pentagonal,petiole,plant,purple,removed,ripe,rotate,seed,short,size,stigma,straight,stripe,style,subtending,terminal,testal,tube,wall,whitish,x	0.8-2,10-26,2-4,3-5,5-merou,acumen,acuminate,acute,adaxiall,ag,alyx,apart,apex,apparently,articulated,asymmetric,attenuate,axe,base,basiscopic,capitat,covering,decreasing,decurrent,distal,dorsally,eaf,edge,eed,erec,exceeding,flat,folded,forked,geminat,generally,glabrou,green-white,hair-like,hal,half,high,lengthening,linear,living,lower,make,mucilaginous,nflorescence,orbicular,orolla,pair,perfect,petiolulate,plurifoliate,pore,poricidal,rachi,rounded,ruit,sessile,seudostipule,side,slightly,slit,spaced,specimen,stamen,subequal,subglabrou,tall,tamen,tem,thick,throughout,tip,tissue,toward,tri-,typically,unit,unwinged,usually,vary,wet,wood,yellow,ympodial	5-merous,arrangement,calyx,capitate,colour,form,growth,height,inflorescence,length,ovary,position,presence,pseudostipule,shape,staman,stem,subglabrous,texture,woody
20	wfo-0001025699	success	181	114	85	96	29	0.47	.2,1,1-1.5,1-2.5,1-3,1.5-2,1/3,10,15-20,2,2-2.5,2-6,3-15,3-3.5,3-8,4-5,8-9,absent,adaxially,almost,anther,anthesi,apparently,base,becoming,branching,brown,calyx,campanulate,capitate,cm,completely,corolla,dark,darker,diameter,ellipsoid,filament,flower,glabrous,globose,green,grey-brown,growth,immature,inflorescence,leaf,leaf-opposed,leafy,lobe,lobed,minutely,mm,older,ovary,pale,pedicel,peduncle,perfect,petiole,poricidal,red,reniform,reticulate-pitted,rounded,rounded-sagittate,shoot,short,simple,slightly,small,stem,stigma,straight,style,surface,time,tip,tree,tube,way,white,x,young,½	.5,0.5,1-2,1.5,2cm,3-5.5,499,5-8,5-winged,5.5-14,abaxially,acute,age,apart,apex,appearing,articulating,attenuate,bark,berry,c.,conical,conspicuously,continuing,corrugate,crystal,cup-shaped,deltate,densely,difoliate,dorsal,dry,drying,eaf,eed,elliptic,entire,erect,exerted,face,fide,free,fruiting,glabrou,included,inclusion,inflorescenc,irregularly,lanceolate,leaving,lengthening,less,lower,margin,markedly,midrib,narrowly,new,nflorescence,nodding,one,onto,oxalate,pair,papillat,papillose,peg,penden,per,plurifoliate,pore,portion,primary,reddish,ruit,sand,scar,slit,somewhat,spaced,stearn,strongly,tangled,thickened,triangular,trichome,ud,unit,vein,white-spotted,wide,wing,winged,woody,yellow,ympodial	2-14,abaxial,adaxial,arrangement,blade,cell,colour,form,fruit,height,interjected,lateral,leaflet,length,na,papillate,plant,position,presence,pseudostipule,seed,shape,size,staman,terminal,testal,texture,tuber,type
21	wfo-0001025700	success	189	105	82	107	23	0.434	0-16,0.30-2.0,0.5-2,0.7-2.7,0.8-2.6,1-3,1.1-2.3,1.5-2,10.5-12,15-40,2-12,2-7,2.5-4,3-8,3.5-10.5,3.7-8.6,5-15,5-20,5.3-17.5,5.5-18,5.5-8,9-31,anther,blade,brownish,cell,chartaceous,clavate,cm,condition,connivent,corolla,diameter,dot,drying,elliptic,filament,flower,fresh,fruit,glabrescent,glabrous,globose,green,greenish,herb,homostylous,honeycomb-shaped,interjected,lanceolate,lateral,leaf,leaflet,light,lilac,lobe,long,medium,mm,odd-pinnate,ovate,ovoid,pedicel,peduncle,pentagonal,perfect,petiole,plant,purple,rotate-pentagonal,seed,size,sometimes,stigma,straight,style,terminal,testal,tube,white,whitish,x	0.8-4,1-2,10-40,3-4,4-5,5-merou,abaxially,acuman,acumen,acuminate,acute,adaxially,ag,alyx,apex,apiculate,apparently,articulated,asymmetric,attenuate,axe,axillary,basal,base,basiscopic,berry,bud,capitat,considerably,covering,decrease,decreasing,digestion,distal,dorsally,eaf,edge,eed,enzyme,erec,exceeding,except,flat,folded,forked,geminat,generally,glabrou,green-white,hair,hair-like,hal,half,high,larger,lengthening,linear,living,lower,make,mucilaginous,narrowly,nflorescence,orbicular,orolla,pair,par,petiolulate,plurifoliate,pore,poricidal,proximal,removed,ripe,rounded,ruit,sessile,seudostipule,short,side,slightly,slit,specimen,stamen,subequal,subglabrou,subtending,tall,tamen,tem,thick,throughout,tip,tissue,toward,tri-,typically,unit,unwinged,usually,vary,wall,wet,whose,winged,yellow,ympodial	5-merous,abaxial,adaxial,arrangement,calyx,capitate,colour,form,growth,height,inflorescence,length,na,ovary,position,presence,pseudostipule,shape,staman,stem,texture,tuber,type
22	wfo-0001025702	success	279	106	78	201	28	0.28	.0,0.3–2.2,0.4–2.3,0.5–0.8,0.5–1.3,0.6–1.0,1.2–1.6,1.4–2.8,1.6–1.7,1.6–2.0,1.6–2.3,1.7–2.3,1.7–9.2,2,2.0–3.2,2.3,2.3–7.8,3.2,4.5–5.2,6.6,acuminate,anther,attachment,attenuate,blade,calyx,capitate,chartaceous,cm,corolla,curved,densely,diameter,dry,elliptic,extra-axillary,ferruginous,filament,filiform,flattened-orbicular,flower,fruit,glabrous,globose,homostylous,hooked,incurved,lanceolate,lateral,lobe,mature,mm,moderately,notched,oblong,pedicel,petiole,point,pubescent,red,scandent,shrub,simple,somewhat,sparsely,stellate,stem,stigma,style,sub-coriaceous,tip,toward,tube,white,yellow-ferruginous,yellow-tan,×,–6	.1,.3,.5,.7,/2,0.04,0.3–0.4,0.5–0.6,0.6–0.9,0.7–1.4,1.3–1.8,1.3–2.8,1.4–1.6,1.4–2.2,1.6–1.8,1.6–2.1,1.7,1.9,1/3,1/4–1/3,2.2,2.2–2.9,2.3–6.6,2.5,2.6–7,2–14,3.6–3.9,4,4.3,4–16,5-merou,5.2–7.5,5.4,6.9–10.3,6–10,6–8,abaxially,acute,adaxially,adjacent,adnate,aequilateral,ag,alyx,anthesi,apart,apex,apical,apiculate,apparently,appearing,appresse,around,articulate,axe,ba,bark,base,based,becoming,berry,branch,broad,broad-based,broadly,brochidodromous,brown,bud,channeled,completely,congested,cream,cuneate,deciduous,deflexed,deltate,deltoid,dentate,developed,difoliate,directed,distal,distally,distinct,eaf,edge,eed,either,emerging,endocarp,entire,exocarp,extending,fertile,flexed,forked,free,geminat,glandular,glossy,gradually,gree,hair,hort,increasing,indistinct,intact,internode,interpetalar,intersepalar,joining,juic,laterally,lax,layer,limp,lon,long,longer,lower,m.,margin,midpoint,midrib,midvein,minute,nearly,nflorescence,oblique,obtuse,occasionally,opaque,orolla,ovate,per,perforated,poorly,pore,porrect,portion,potentially,presen,prickle,primary,pseudo-intermarginal,pseudo-peduncle,raised,ray,reddish,reflexed,remaining,retrorse,rounded,row,ruit,scattered,secondary,seen,sessile,shoot,side,sinus,sloughing,smoot,smooth,sometimes,soon,splitting,spread,stamen,stellae,stellate-pubescent,straight,strongly,surface,suture,tamen,tem,thin,time,tissue,transparent,triangular,truncate,two,ud,unarmed,unbranched,upper,vary,vein,wide,yellow,yellow-ferruginou,ympodia,young,±90,±90°,±connivent,±equal,±glabrous	5-merous,abaxial,adaxial,arrangement,colour,form,growth,height,inflorescence,interjected,leaf,leaflet,length,na,ovary,peduncle,plant,position,presence,pseudostipule,seed,shape,size,staman,terminal,texture,tuber,type
23	wfo-0001025704	success	248	119	97	151	22	0.391	0-3.5,0.3-0.8,0.5-1.5,0.7-1,1-3.5,1-6,1.2-3,1.5-3.2,2-4.5,2-7,2.7-4,3-15,3-5,3-6,4-5,4.5-6.5,5-merous,6-12,8-15,abaxial,adaxial,almost,andromonoecious,anther,blade,calyx,cell,chartaceous,cm,connivent,densely,diameter,discolorous,drying,ellipsoid,erect,evenly,filament,flattened-reniform,flower,fruit,glabrescent,glabrous,green,green-yellow,heterostylous,irregular,lateral,leaf,length,lobe,lobed,long,maturity,mauve,mm,often,orange,orange-brown,outline,pale,pedicel,peduncle,petiole,plant,poricidal,recurved,red-green,round,shape,shrub,slender,small,smooth,sometimes,somewhat,sparsely,spherical,stellate-pubescent,stem,stout,straight,strongly,style,tapering,terminal,tip,tree,tube,warty,white,wide,yellow,yellow-green,yellowish,young,×	-10,-2,-3,-5,/6,0,0-100,0-2,0-5,0.1,0.1-0.3,0.1-0.5,0.15-0.8,1,1-4,1.5-2,1.5-4.5,1.8-3.5,1/2-4/5,1/4-3/4,1/5,2,2-10,2-3,2-5,2.5-4.5,3-10,4-12,5-20,6-15,8-12,8-17,abaxially,acute,age,alyx,apar,apart,apex,apically,apiculate,apparently,articulated,auriculate,axe,ba,bark,base,berry,branched,broad-deltate,brow,cordate,covering,curved,deltate,development,distal,distance,eaf,eed,elliptic,elongating,end,equal,extending,flattened,free,fruiting,gray,half,hermaphrodite,infructescence,less,lobing,long-styled,longer,lower,lowermost,margin,mature,midpoint,midvein,moderately,multangulate,near,nflorescence,obtuse,occasionally,older,one,open,orolla,oung,ovate,pair,pendulous,per,pericarp,pit,plurifoliat,porrect,portion,prickl,prickle,prickly,primary,prominent,raised,rarely,ray,red-brown,reflexed,retaining,rounded,ruit,scar,secondary,sessile,short-styled,shorter,side,spaced,spreading,stalk,stalked,staminat,stellate,stellate-pubescen,surface,tamen,terete,tertiary,throughout,time,trichome,truncate,unarmed,unbranched,unit,upper,variously,vary,vein,venation,visible,way,white-gray,widening,woody,ympodial	arrangement,colour,corolla,form,growth,height,inflorescence,interjected,leaflet,na,ovary,position,presence,pseudostipule,seed,size,staman,stigma,testal,texture,tuber,type
24	wfo-0001025714	success	249	94	47	202	47	0.189	-5,anther,attenuate,blade,calyx,cm,cylindrical,diameter,extra-axillary,filament,flattened,flower,free,fruit,glabrous,glandular-pubescent,globose,light,lobe,maturity,minutely,mm,ovary,pedicel,peduncle,petiole,pubescent,rounded,short,shrub,simple,size,stellate,stem,stigma,stipitate-glandular,straight,style,subreniform,tan,thin-textured,tube,unbranched,white,x,yellow,yellowish	%,-rayed,.2,0.1–0.8,0.2–0.8,0.5,0.5–0.6,0.5–1.3,0.5–2,0.8,0–0.4,1,1.2–2.4,1.3–3,1.5–2,1.5–2.5,1.5–3.5,1.6–2.3,1.8–,1/3,100,10–11,13,15,15–25,1–2,1–4,2,2-foliate,2.2–3,2.5,2.5–3.8,2.8,2–3,2–4-celled,2–7,2–8,3.7–5,3–16,3–9,4–18,4–6,5,5.9–7.5,50,5–25,5–6.5,6.2–6.8,6–16,7–18,7–8.5,8–13,9.2–10,9–22,>,abaxially,absent,accrescent,acicular,acute,adaxiall,adaxially,additional,always,anthesi,apart,apex,appearing,armed,around,articulated,ascending,asia,axe,ba,base,berry,branch,broadly,capitat,caudate-tipped,completely,concealing,covering,curved,decidedly,differing,dilated,dimorphic,directed,distall,eaf,eed,enlarged,entire-margined,erect,fertile,few-branched,few-rayed,forward,frui,fruiting,geminat,glabrou,gland,gland-tipped,gland–tipped,hair,half,halfway,herbarium,horizontally,hyaline,immediately,increasingly,lacking,larger,latter,less,lobed,lobing,long,longer,longest,lower,lowermost,mainly,major,male,many-rayed,margin,midrib,minor,minute,mixed,multangulate,narrowly,nearly,nflorescence,numerous,obtuse,often,one,orbicular,orolla,ovate,pair,per,perhaps,pilose,plane,pointing,pore,predominating,prickle,pubescence,rachi,rare,rarely,recurved,reflexed,ruit,scarcely,scattered,sessile,shorter,similar,single,slender,slightly,small,smaller,sometimes,spaced,sparse,specimen,spine,spreading,stellae,stipitate,stouter,subcordate,subglabrous,tal,tamen,tem,terete,time,toward,triangular,truncate,unequal,unit,upper,usually,various,vary,way,wide,ympodial,–1.25,–7–9	0-0.8,0.1-0.8,0.5-0.6,0.5-2,1-2,1.3-3,1.5-2,1.6-2.3,1.8-,15-25,2-3,2.2-3,3-16,3-9,4-18,5-6.5,5.9-7.5,6.2-6.8,7-8.5,9-22,abaxial,adaxial,arrangement,capitate,colour,corolla,form,growth,height,inflorescence,interjected,lateral,leaf,leaflet,length,na,plant,position,presence,pseudostipule,seed,shape,staman,terminal,texture,tuber,type
25	wfo-0001025726	success	158	97	68	90	29	0.43	-10,-16,-5,0.2-0.3,0.5,1,1-1.5,1-2.5,1-3,10-15,2.5,3-10,3-5,5,6-12,6-8,abaxially,adaxially,anther,blade,branched,brown,calyx,chartaceous,cm,compound,diameter,filament,flattened,flower,foveolate,fruit,glabrous,globose,green,imparipinnately,lateral,leaflet,light,lobe,mm,narrowly,oblong,occasionally,pedicel,peduncle,perennial,petiole,puberulent,purple,ranging,rarely,rugose,scandent,shape,simple,size,stellate,stigma,straight,strongly,style,surface,terminal,tube,variable,white,x	0-1,0.2,0.5-1.5,2-,2-3,20-40,3-4,4,4-10,7-9,accrescen,acuminate,acute,adaxiall,adjacent,ag,alyx,anthesi,apex,armed,articulated,axe,ba,base,becoming,broadly,campanulate,clustered,confluent,connivent,dr.,eaf,eed,elliptic,elongating,entire,equal,fertile,fruiting,geminat,hair,internode,lengthening,lobed,long,major,margin,midrib,nflorescence,oblon,often,orolla,ovate,pinnate,pinnatifid,plurifoliate,pore,poricidal,present,prickle,rachi,recurve,recurved,rounded,ruit,side,slender,slit,spreading,stout,subwoody,swollen,tamen,tem,terminally,time,tip,truncat,ud,unbranched,unit,usually,variously,vary,vein,vin,wide,woody,yellow,ympodial	abaxial,adaxial,arrangement,cell,colour,corolla,dry,form,growth,height,inflorescence,interjected,leaf,length,na,ovary,plant,position,presence,pseudostipule,seed,staman,stem,testal,texture,truncate,tuber,type,vine
26	wfo-0001025729	success	177	94	66	111	28	0.373	.5,0.25-0.5,0.7-1.2,1-1.5,1-5,1.1-1.5,1.2-1.8,1.5-2,1.75,2,20,4-5,4-8,9-17,abaxial,adaxially,anther,calyx,cm,corolla,dark,dia,dirty,drying,elliptic,filament,flattened-reniform,glabrous,globose,green,greenish-yellow,greyish-brown,lateral,leaf,lobe,lobed,long,mm,opposite,ovary,pale,pedicel,petiole,pitted,plant,poricidal,ripening,shiny,simple,size,stem,stigma,straight,style,terminal,tip,tree,treelet,trichome,tube,tuft,uniseriate,usually,white,x,yellow	-20,/4,2-3.5,3-6,5-50-flowered,6-8,7-8,abaxially,abrupt,acute,along,anthesi,apar,apex,apical,apiculate,appearing,axil,bark,basal,base,berry,black,blackish,branched,bright,bristly,bud,covered,covering,cyathiform,deflexed,deltoid,densely,denser,diam,differing,difoliate,eaf,edicel,eed,enclosed,expanded,f,fleshy,free,fruiting,furcate,geminat,gently,glabrou,growing,incrassate,lamina,lat,like,live,lon,lower,m.,main,mainly,major,margin,member,middle,minor,minute,minutely,nflorescence,oblique,occasionally,often,older,one,overlapping,overtopping,pair,papillo,papillose,partially,pit,pore,portion,prominent,pubescent,quite,raised,reflexed,rounded,ruit,scar,shaped,short,sparsely,stout,surface,tall,tapering,tear-drop,touching,tub,ud,unit,vein,way,widening,widest,woody,ympodial,young	4-20,adaxial,arrangement,blade,cell,colour,diameter,flower,form,fruit,growth,height,inflorescence,interjected,leaflet,length,na,peduncle,position,presence,pseudostipule,seed,shape,staman,testal,texture,tuber,type
27	wfo-0001025737	success	220	116	66	154	50	0.3	1.5,1.5-2,10,5-merous,anther,base,blade,bright,cm,densely,diameter,extra-axillary,filament,filiform,flattened-reniform,flower,fruit,glabrous,gland-tipped,globose,green,greenish,growth,hair,homostylous,immature,interpetalar,juicy,lateral,light,lighter-colored,linear-attenuate,lobe,loosely,margin,minute,minutely,mm,narrow,near,orange,pale,pedicel,peduncle,petiole,pitted,rarely,seed,shiny,shrub,simple,stellate,stellate-tomentose,stem,stigma,style,thick-chartaceous,tinge,tissue,tomentose,tube,turning,violet,white,x,yellow	-branched,0.2–0.3,0.3–0.7,0.3–2,0.6,0.6–0.9,0.7–1.3,0.8–1.1,0.9–1.1,1.4–1.8,1.5–2,1.5–3,1.5–5,1.5–6.5,1.7–2.2,10–12,1–,1–1.2,1–1.5,2,2.5–3,2.5–4.5,25–50,2–3,3,3.5–5,3.5–8,3–10,44599,47092,4–11,4–6,5,51,5–6,7–8,8–10,8–16,9-10,95,abaxially,absent,accrescen,acute,adaxiall,adaxially,age,alyx,angularly-cordate,apart,apex,apical,apparently,appressed-tomentose,armed,articulated,attenuate,axe,ba,becoming,branch,broad-based,capitat,deeply,difoliate,directed,distall,eaf,eed,entire,except,fertile,finely,free,geminat,glabrou,high,internode,juvenile,lance-ovoid,like,linear-lanceolate,lobed,lon,long,long-stipitate,lower,major,midpoint,midvein,midzone,mixed,nee,nflorescence,northern,numerous,oblong,obtuse,odorle,orolla,ovate,ovate-lanceolate,part,per,perfect,persistently,pore,porrect,prickle,principal,range,ray,reflexed,rounded,ruit,scarcely,sessile,shallowly,short-,short-stipitate,shorter,side,sinus,slender,southern,spaced,sparsely,splitting,ste,stellae,stellate-pubescent,stipe,straigh,straight,surface,tamen,tem,time,tomento,triangular-attenuate,ud,unarmed,usually,vary,vein,vigorous,whitish,wide,ympodia,×,–14,–20,–3,–4	0.3-2,0.6-0.9,0.7-1.3,0.8-1.1,0.9-1.1,1.4-1.8,1.5-3,1.5-5,1.7-2.2,10-12,2.5-3,2.5-4.5,20,25-50,3.5-5,3.5-8,4,5-6,7-8,8-16,abaxial,adaxial,arrangement,calyx,capitate,cell,colour,corolla,form,height,inflorescence,interjected,leaf,leaflet,length,na,odorles,ovary,plant,position,presence,pseudostipule,shape,size,staman,terminal,testal,texture,tuber,type
28	wfo-0001025741	success	231	126	77	154	49	0.333	5-merous,abaxial,abaxially,abundant,adaxial,adaxially,andromonoecious,anther,apex,blade,brown,calyx,chartaceous,cm,column,connivent,curved,cylindrical,dark,densely,diameter,emergent,extraaxillary,fading,filament,flattened,flower,fruit,glabrous,globose,golden-tan,green,hair,inflorescence,interpetalar,juicy,leaf,length,light,lighter,like,lobe,long-stalked,lustrous,maturity,mm,moderately,orange,orange-tan,outline,pedicel,peduncle,petiole,plant,porrect-stellate,pubescent,reniform,rotate-stellate,rugose,shiny,short-cylindrical,simple,somewhat,stalked,stem,stigma,strongly,style,tan,tapered,tissue,tree,tube,violet,white,young,×	.2,.5,0-0.1,0.5–0.8,0.5–3,0–0.1,1.1–2,1.2–1.5,1.7–2,1.8–2.1,10–35,11–14,12–15,15–45,1–2,1–2.5,1–4,2.5–3,2.5–3.5,2.5–8,20–23,29–36,2–3,2–3.2,2–4,2–7.5,30–120,3–10,3–6,4–5,4–6,4–7,5–17,5–6,6.5–9,6–7,8–15+,8–18,abundantly,acuminate,acute,along,alyx,andromonoeciou,anthesi,apart,armed,articulated,axe,ba,bark,base,becoming,berry,broad-based,capitat,congested,covered,cuneate,db,deltate,deltoid,difoliate,directed,distall,dry,eaf,eed,eglandular,either,entire,equal,flowering,free,fresh,frui,fruiting,functionally,geminat,glandular,half,hermaphroditic,heterstylous,included,inflated,knobby,lanceolate,lobed,lon,long,lower,major,margin,membranaceous,midpoint,midvein,multangulate,multiseriate,nearly,nflorescence,oblique,once-branched,one,orolla,ovate,part,pericarp,pore,present,prickle,rachi,ray,remaining,ruit,runk,sessile,shallowly,sharp,short,short-stalked,side,small,spaced,sparse,sparsely,stalk,staminate,stellate,stellate-pubescent,stout,straight,subtending,surface,tamen,thi,thin,time,tuft,unarmed,unbranched,unit,vary,vein,wide,within,yellow,ympodial,–12,–20,–28,–30,–39,–6,–8	-12,0.5-0.8,0.5-3,1.1-2,1.2-1.5,1.7-2,1.8-2.1,11-14,12-15,15-45,2.5-3,2.5-3.5,2.5-8,20,3-10,30,30-120,4-6,4-7,5-17,6.5-9,8,arrangement,capitate,cell,colour,corolla,dbh,form,growth,height,heterostylous,interjected,lateral,leaflet,na,ovary,position,presence,pseudostipule,seed,shape,size,staman,terminal,testal,texture,tuber,type
29	wfo-0001025743	success	157	120	95	62	25	0.605	.5,0-15,0.15-0.3,0.3-0.5,0.3-0.6,0.4-0.5,0.4-0.8,0.9-1.2,0.9-2.6,1.2-4,11-25,12-17,2-3,2-4,2-4.5,2.8-3.5,3.5-5.5,4.5-5.5,5-10,6-10,6-7,8-10,9-18,absent,acicular,adult,apart,apex,articulated,base,blade,broadly,brown,calyx,chartaceous,cm,cordate,cuneate,cylindrical,decimetre,deeply,deltate,dense,diameter,extra-axillary,finger,flower,fruit,glabrous,gland-tipped,globose,green,grey,hair,herbaceous,inflorescence,lateral,length,lobe,lobed,long,longer,margin,mid-point,midvein,mm,obtuse,ovate,pale,pedicel,peduncle,per,petiole,plant,present,prickle,prostrate,resprouter,short,simple,spaced,sprawling,stellate,straight,style,thick,throughout,time,tube,unbranched,vein,white,wide,x,yellow	%,0-6,0.1-0.3,0.5-0.9,1,1-6,1.3-1.8,2.3-5,3-13,3-4,3-6,30-80,4-8,5-20,5-merou,6-20,abaxially,absen,adaxiall,adaxially,alyx,andromonoecious,armed,axe,ba,branche,directed,distall,eaf,eed,fruiting,functional,half,heterostylous,index,lamina,less,lobing,lon,lower,mature,minute,nflorescence,nther,oblique,onl,orolla,part,pore,presen,ruit,side,stage,strongly,tal,tem,unit,unknow,uvenile,vary,yellowish-gree,ympodial	5-merous,abaxial,adaxial,anther,arrangement,branch,colour,corolla,feature,form,growth,height,history,leaf,life,ovary,position,seed,shape,size,stem,texture,type,unknown,yellowish-green
30	wfo-0001025749	success	217	101	76	141	25	0.35	0.2-1.5,0.3-1.5,0.5-0.8,0.5-0.9,0.6-4.5,0.8-0.9,1-10,1-2,1-8.5,1-9,1.5-2,1.5-2.5,2-2.5,2.5-6,3-5,5-merous,abaxial,abaxially,adaxial,adaxially,anther,apparently,berry,blade,calyx,chartaceous,cm,dark,densely,diameter,dull,filament,filiform,flattened-reniform,flower,fruit,glabrous,green-brown,lateral,leaf,length,lobe,lobed,long,maturity,mauve,mm,moderately,orange-brown,orange-red,pale,pedicel,peduncle,petiole,poricidal,recurved,red-brown,shrub,smooth,sometimes,sparsely,spherical,spreading,stellate-pubescent,stem,straight,straw-yellow,style,tapering,tip,tube,white,wide,yellow,yellow-green,yellow-orange	-1,-12,.5,/5,0-10,0-3,0-5,0-6,0-8,0.1,0.1-0.2,0.1-0.3,0.1-0.4,0.2,0.4-0.7,0.5,0.5-1.3,0.5-3,1,1-13,1-3,1-6,1.5,1/4-1/3,1/5-1/2,2-10,2/3,3-20,4-8,5-,5-10,5-20,6-8,acuminat,acute,adnate,almost,alyx,apar,apart,apex,apically,articulated,bark,base,branched,broad-deltate,concolorous,cuneate,curved,difoliate,discolorous,distance,drying,eaf,eed,elongating,equal,erect,extending,flattened,free,fruiting,geminat,gently,glabrescent,gray,herbaceous,indistinct,infructescence,light,lon,long-ovate,longer,lower,magnification,margin,markedly,mature,midpoint,midvein,narrow-deltate,narrow-ovate,nflorescence,oblong,obtuse,occasionally,older,one,open,orange-brow,orbicular,orolla,oung,ovate,pair,pendulous,per,perfec,pericarp,porrect,portion,prickl,prickle,prickly,primary,procumbent,purple,rarely,ray,reduced,rounded,ruit,scar,sessile,shorter,side,spaced,stalk,stalked,stellate,strongly,surface,tamen,terete,tertiary,time,toward,trichome,unit,usually,variously,vary,vein,venation,visible,way,without,yellowish,ympodial,½-2/	arrangement,colour,corolla,form,growth,height,inflorescence,interjected,leaflet,na,ovary,perfect,plant,position,presence,pseudostipule,seed,shape,size,staman,stigma,terminal,texture,tuber,type
31	wfo-0001025754	success	164	89	59	105	30	0.36	.5,0.5-1,0.5-1.5,1,1-3,1-3.5,1.5,1.5-3,1.5-4,10-20,2-7,3-10,4-6,5-12,5-15,absent,anther,beyond,blade,brown,calyx,chartaceous,cm,diameter,dm,drying,equal,exserted,filament,flower,fruit,glabrous,globose,herb,immature,leaf,lobe,maturing,membranaceous,mm,moderately,nearly,oblong,pedicel,peduncle,petiole,pubescent,rotate,semitransparent,solitary,sparsely,stamen,stem,stigma,style,tube,white,x,yellow	-celled,0.1-0.2,1-2,10-35,2-4,2-5-celled,2-foliate,3-5,3-6,4,abaxially,abundant,acuminate,acute,adaxiall,adaxially,along,apex,asymmetrical,axe,barely,base,berry,branch,center,ciliate,connected,cordate,cordiform,decumbent,decurrent,dehiscing,densely,denser,dried,eaf,edge,eed,eglandular,emarginat,entire,erect,explosively,fine,flat,geminat,glandular,hair,held,interpetalar,leaving,like,linear-lanceolate,long,lower,lying,main,margin,material,maturit,mesocarp,mixed,much-branched,nfloresence,notch,often,orolla,palmately,parallel,penden,per,placenta,pressure,probably,pubescen,rachi,radiating,raised,ridge,ruit,running,shallow,short,slightly,small,sometimes,straight,surface,swollen,tal,tamen,tem,tissue,triangular,truncate,unbranched,unit,upright,vary,vein,visible,watery,wid,woody,ympodial	abaxial,adaxial,arrangement,cell,colour,corolla,form,geminate,growth,height,inflorescence,interjected,lateral,leaflet,length,na,ovary,plant,position,presence,pseudostipule,seed,shape,size,staman,terminal,testal,texture,tuber,type
32	wfo-0001025760	success	210	105	80	130	25	0.381	-5,-6,0-0.5,0.3-1,0.4-0.8,0.45-0.9,0.5-2,0.8-1.8,1-,1-1.8,1-4,1.5-2.5,1.5-5,2-2.5,2.1-3.5,2.3-4,2.5-10,3.5-9,5-18,abaxial,adaxial,almost,anther,black,blade,calyx,chartaceous,cm,cream,dark,diameter,dull,filament,flattened-reniform,flower,fruit,glabrous,green,herb,infructescence,lateral,leaf,length,lobe,lobed,long,marking,maturity,membranous,mm,moderately,orange,orange-brown,pale,pedicel,peduncle,per,petiole,poricidal,recurved,red-brown,shape,slender,spherical,stellate-pubescent,stem,stout,straight,style,subentire,tapering,tip,tube,unbranched,weakly,white,wide,yellow,yellow-green,young	-10,-12,-3,.5,/3,0-100,0.1,0.1-0.2,0.15-0.3,0.2-0.35,0.5-1.5,0.7-2.5,1,1-2,1.5,1.5-4.5,1/4,1/4-1/2,1/4-1/3,1/5,2-3,2.5-8,2/3,3,3-6,3.5-17,5-10-merous,8-10,abaxially,acut,acute,alyx,annual,apar,apex,apically,apparently,articulated,bark,base,berry,broad-deltate,brow,concolorous,connivent,cultivar,cuneate,curved,deltate,difoliate,discolorous,distance,drying,eaf,eed,elliptic,elongating,equal,erect,extending,free,fruiting,geminat,geminate,gently,glabrescent,hair,lengt,longer,lower,margin,mature,midpoint,midvein,minute,nflorescence,often,older,one,open,orolla,oung,ovate,pair,pendulous,perennial,perfec,pericarp,porrect,portion,primary,ray,reflexe,rounded,ruit,scar,sessile,shorter,shrub,side,simple,smooth,sometimes,spaced,spreading,stalk,stalked,stellate,stellate-pubescen,surface,tamen,terete,tertiary,thick-stalked,time,trichome,unarme,unarmed,unit,upper,usually,various,variously,vary,vein,venation,visible,way,woody,ympodial	arrangement,brown,colour,corolla,form,growth,height,inflorescence,interjected,leaflet,na,ovary,perfect,plant,position,presence,pseudostipule,seed,size,staman,stigma,terminal,texture,tuber,type
33	wfo-0001025782	success	200	97	73	127	24	0.365	.5,0-5,0.4-0.6,0.55-0.75,0.9-1.3,1-2,1.2-6,1.3-1.6,2-2.5,2-3,3-4,4,4-4.5,4.5-9,5-merous,5.5-6,6-14,abaxial,adaxial,andromonoecious,anther,berry,blade,brown,calyx,chartaceous,climbing,cm,connivent,diameter,dull,evenly,filament,flattened-reniform,flower,fruit,glabrous,green,green-brown,heterostylous,lateral,leaf,length,lobe,lobed,long,maturity,membranous,mm,moderately,orange-brown,pedicel,peduncle,petiole,plant,poricidal,shrub,sparsely,spherical,stellate-pubescent,stem,stout,straight,style,tapering,tip,tube,weakly,white,wide,yellow,yellow-green,young	-2,0-10,0.1-0.15,0.1-0.2,0.1-0.25,0.3-1,0.5-1,1,1-1.7,1-2.5,1-4,1.5-3,1/4-1/2,1/4-1/3,1/6,10-13,2-10,2-5,2-7,2.5-3.5,2/3-3/4,20,3-5,5-20,5-6.5,5-8,6-8,abaxially,acuminat,acuminate,also,alyx,apar,apart,apex,apically,apparently,articulated,bark,base,concolorous,conical,cuneate,curved,deltate,densely,difoliate,discolorous,distal,distance,drying,eaf,eed,elliptic,elongated,elongating,equal,extending,flattened,free,fruiting,geminat,geminate,gently,glabrescent,hair,hermaphrodite,infructescence,lengt,less,long-styled,longer,lower,lowermost,margin,mature,midpoint,midvein,minute,nflorescence,occasionally,older,one,open,orolla,oung,pair,pendulous,per,pericarp,porrect,portion,prickl,prickle,prickly,primary,ray,red-brow,reduced,ruit,scar,sessile,short-styled,shorter,side,simple,smooth,spaced,spreading,staminat,stellate,surface,tamen,terete,tertiary,time,toward,trichome,unbranched,unit,vary,vein,venation,visible,way,woody,ympodial	arrangement,colour,corolla,form,growth,height,inflorescence,interjected,leaflet,na,ovary,position,presence,pseudostipule,red-brown,seed,shape,size,staman,stigma,terminal,texture,tuber,type
34	wfo-0001025783	success	179	101	73	106	28	0.408	.5,0.5-1.5,0.8-3.5,1-1.2,1-1.5,1-3,2-3+,2-5,2-6.5,5,anther,base,berry,branched,brown,c.,calyx,cell,cm,coriaceous,corolla,diameter,ellipsoid,flattened,fleshy,flower,glabrous,globose,greyish,growth,lateral,lax,less,lobe,lobed,long,lower,mm,pale,pedicel,peduncle,pentagonal,perfect,petiole,pubescent,purple,reniform,ripe,sagittate,shiny,shoot,short,shrub,simple,somewhat,sparsely,stellate,stem,stigma,style,surface,terminal,testal,thin,time,tube,type,upper,vine,violet,way,wide,woody	0.5,0.5-1,1.8-2,2,3-4,5-merou,7-10,<,abaxiall,abaxially,acute,adaxiall,adaxially,along,alyx,anthesi,apart,ape,apex,ark,articulated,axil,branching,bud,cluster,completely,confined,conical,dendritic,densely,eaf,eed,elliptic,entire,erect,expanded,exposed,exserted,filiform,flexuous,free,fruiting,glabrou,green,groove,hromosome,ilament,inserted,keeled,known,long/tall,margin,mature,midrib,midvein,minute,minutely,mmm,narrowly,near,new,nflorescence,nodding,number,obscured,obtuse,occasionally,older,orolla,outlin,pair,penden,pericarp,pitted,plurifoliat,point,portion,possibly,primary,revolute,ruit,scar,scarious,see,sleeve,slightly,sometimes,spaced,sparse,strongly,suture,transparent,triangular,trichome,truncate,tuft,twinin,ud,uniseriate,unit,vary,vein,weak,within,yellowish,ympodial	5-merous,abaxial,adaxial,arrangement,blade,colour,filament,form,fruit,height,inflorescence,interjected,leaf,leaflet,length,na,outline,ovary,plant,position,presence,pseudostipule,seed,shape,size,staman,texture,tuber
35	wfo-0001025784	success	241	109	65	176	44	0.27	.5,0.2-0.3,0.5,1-5,1.2,3.5,6,anther,black,blade,calyx,cell,cm,cylindrical,diameter,extra-axillary,filament,flattened,flower,fruit,glabrous,gland,globose,green,greenish,greenish-yellow,hair,hyaline,lanceolate,leaf,lobe,minute,mm,moderately,nearly,pedicel,peduncle,petiole,prickle,pubescence,pubescent,purple,sessile,shrub,similar,simple,smooth,sparsely,spreading-pilose,stellae,stellate,stem,stigma,stipitate,style,subreniform,thin-textured,truncate,tube,unbranched,white,x,yellow,yellow-brown,yellow-green	-3,.2–0.4,0.2,0.2–1.1,0.3–0.5,0.4–2.5,0.5–1.8,0.5–2,0.5–3,0.6–0.8,0.7,0.8–1.1,0.8–1.2,0.9–1.2,0.9–1.4,1,1.2–2.5,1.3–1.8,1.6–2.2,1/3,10,10–15,15075,1709,1–,1–3,1–5,2,2-foliate,2.5–3.3,2/3,2–2.5,2–3,2–4,2–5-celled,2–7,3–4,3–4-rayed,4.5–5.5,5,5–6,6.5–8,6.5–8.5,=,abaxially,accrescent,acicular,acute,adaxiall,adaxially,also,always,anthesi,apart,apex,articulated,asplund,ba,base,becoming,branched,brazil,ciliate,completely,conical,curved,directed,distall,drying,eaf,eed,enclosing,enlarged,especially,et,exceeding,fertile,fide,free,frui,fruiting,geminat,glabrescent,glabrou,gland-tipped,glandular-pubescent,insolated,irregularly,irwin,lobed,long,longitudinal,lower,lowest,major,male,many,margin,midpoint,midrib,minutely,mostly,mottled,much,n,narrowly,nflorescence,numerous,obtuse,offset,one,orolla,ovate,pair,per,pilose,pore,rachi,raised,rarely,ray,recurved,reflexed,reported,ripe,rounded,rudimentary,ruit,second,shallowly,sharp,short,side,slightly,small,sometimes,somewhat,spaced,spiny,sprawling,stamen,ste,stout,straight,subcapitat,subcordate,surface,tal,tamen,tem,thick,thicker,time,tip,toward,triangular,unarmed,unequal,unit,upper,usually,variously,vary,vein,way,wid,wide,widest,without,ympodial,young,–2,–4,–5.5,–8,–9	0.5-3,0.8-1.1,0.8-1.2,0.9-1.2,0.9-1.4,10-15,2-2.5,2-3,2-4,2-5-celled,2-7,2.5-3.3,3-4-rayed,4.5-5.5,9,abaxial,adaxial,arrangement,colour,corolla,form,growth,height,inflorescence,interjected,lateral,leaflet,length,na,ovary,plant,position,presence,pseudostipule,seed,shape,size,staman,subcapitate,terminal,testal,texture,tuber,type
36	wfo-0001025788	success	158	113	86	72	27	0.544	0.5-2,1-4,1-5,1.8-2.7,1.8-3.9,10-24,14-48,15-30,2-10,2-13,2-3,2-5,2.8-9.5,4-5.5,4.5-10.1,4.5-12.5,5-8,6.2-12.5,acute,apical,apically,base,blue,branched,calyx,cell,cm,conical,connate,corolla,cyme,deep,dehiscent,diameter,dichasial,dichasially,distal,ebracteate,elliptical,filament,finely,flower,green,green-white,half,herbaceous,honeycomb,interjected,introrse,lateral,leaf,leaflet,lobe,long,maturing,medium,mm,monochasial,narrowly,obtuse,odd-pinnate,often,ovate,ovoid,pattern,pedicel,peduncle,perfect,petiole,plant,poricidally,pubescent,purple,rotate,seed,short,size,slit,stigma,straight,style,terminal,testal,tip,wide,yellow	-8,0-6,2m,3-,3-6-foliat,4-3.,6-7,8-38,abaxiall,abaxially,acumen,acuminate,adaxially,apex,articulate,attenuate,covering,cuneate,digestion,diminishing,dorsally,eaf,edge,eed,emoval,enzyme,exceeding,flat,folded,forked,generally,globo,gradually,hair-like,living,lon,long-attenuate,lower,lunat,make,mucilaginous,nflorescence,nther,oblique,orolla,pair,perennial,petiolule,plan,proximal,reveal,rounded,ruit,sessile,seudostipule,specimen,stamen,subequal,subsessile,tal,tem,thick,throughou,throughout,toward,tuber-bearing,typically,unit,vary,wall,ympodial,¼	abaxial,adaxial,anther,arrangement,blade,colour,form,fruit,globose,growth,height,inflorescence,length,lunate,na,ovary,position,presence,present,pseudostipule,shape,staman,stem,texture,tube,tuber,type
37	wfo-0001025792	success	203	117	92	111	25	0.453	0.4-0.7,1-2,1-3,10-15,2-11,2-3,2-3.5,2.5-3.5,2.5-4,21-28,3.5-6,4-12,4-6,4.5-7,5,5-10,5-9,7-10,7.5-8,8-10,anther,auriculate,axillary,blade,blue-mauve,blue-purple,brownish,bud,cell,chartaceous,cm,condition,connivent,corolla,dark,densely,diameter,digestion,drying,elliptic,enzyme,filament,flower,fresh,fruit,glabrous,globose,green,greenish,half,herb,homostylous,honeycomb-shaped,interjected,lanceolate,lateral,leaflet,lobe,mauve,membranous,minute,mm,odd-pinnate,ovoid,papillose,pedicel,peduncle,perfect,petiole,plant,proximal,pubescent,purple,removed,ripe,rotate-pentagonal,seed,size,stem,stigma,straight,streak,style,subtending,terminal,testal,tinged,tube,wall,white,whitish,x	1-10,1-4,3-4,3-5,5-6,5-merou,9-12,abaxially,acumen,acuminate,acute,adaxially,ag,along,alyx,apart,apex,apparently,articulated,articulation,axe,base,basiscopic,berry,broadly,capitat,ciliate,covering,decurrent,developing,distal,distinct,distinctly,dorsally,eaf,edge,eed,especially,exceeding,except,flat,folded,forked,geminat,generally,glabrou,greatly,green-white,hair,hair-like,hal,high,indistinct,lengthening,like,living,long,lower,make,margin,midrib,minutely,mottle,mucilaginous,narrow,narrowly,nflorescence,oblique,often,onto,orolla,pair,petiolulate,plurifoliate,pore,poricidal,puberulent,rachi,reduced,rounded,ruit,semi-erec,semi-rosette,sessile,seudostipule,short,shortly,side,slightly,slit,spaced,specimen,stamen,ste,sub-rosette,subequal,tall,tamen,tem,thick,throughout,tip,tri-,unit,usually,vary,wet,wing,yellow,ympodial,young	5-merous,abaxial,adaxial,arrangement,calyx,capitate,colour,form,growth,height,inflorescence,leaf,length,mottled,na,ovary,position,presence,present,pseudostipule,shape,staman,texture,tuber,type
38	wfo-0001025804	success	155	93	61	94	32	0.394	0.5-1,1-1.5,1-3,1.2-1.5,1.4-1.7,1.5-2,16-35,2-2.5,3-4.5,3.5-12,4-10,6-8,abaxially,adaxially,anther,base,bilobed,calyx,clavate,cm,corolla,cream,difoliate,filament,flattened,flower,glabrous,globose,green,incrassate,internodal,lateral,leaf,light,lobe,lobed,margin,minutely,mm,nearly,occasionally,opposite,ovary,paler,pedicel,pitted,plurifoliate,poricidal,reddish-brown,reniform,shrub,size,somewhat,stem,stigma,style,tip,tube,white,whitish-green,x	.25,.5,10-20,11-20,2.5-4,5,7-10,?,acute,age,anthesi,apar,ape,apex,apiculate,attenuate,ba,bark,berry,branched,c.,conical,covered,cucullate,dark,decurrent,deflexed,densely,dia,differing,drying,eaf,edicel,eed,ellipsoid,elliptic,erect,exserted,fleshy,free,fruiting,geminat,glandular,later,lengthening,long,lower,main,major,many,mere,middle,minor,minute,near,nflorescence,obovate,often,older,onto,pair,papillae,papillat,papillate,papillose,planar,pore,portion,projection,red,red-papillose,reddish-brow,regularly,rim,ruit,scar,sessile,slit,spaced,strongly,surface,tall,thick,time,tub,ud,unit,vein,widest,wing,winged,woody,ympodial,young	0.5,abaxial,adaxial,arrangement,blade,cell,colour,diameter,form,fruit,geminate,growth,height,inflorescence,interjected,leaflet,length,na,peduncle,petiole,plant,position,presence,pseudostipule,seed,shape,staman,terminal,testal,texture,tuber,type
39	wfo-0001025813	invalid_json	197	115	86	111	29	0.437	'',0.7-1.7,1-1.5,1-2,1-4,1.2-4.5,1.3-7,1.5-1.8,1.5-6.5,15-30,2-3,3-3.5,3-4,3-5,3-7,5-18.5,5-6,6-7,``,absent,anther,base,berry,blade,blue,broadly,brownish,cell,chartaceous,cm,condition,corolla,dark,densely,diameter,drying,elliptic,filament,flower,fresh,fruit,glabrous,globose,green,greenish,hair,herb,homostylous,honeycomb-shaped,interjected,lanceolate,lateral,leaflet,light,lobe,membranous,minute,mm,monochasium,odd-pinnate,ovoid,pedicel,peduncle,perfect,petiole,pilose,plant,pubescent,rarely,rotate,seed,size,stem,stigma,straight,style,suborbicular,terminal,testal,tube,tuber,typically,violet,white,whitish,x	0-2,1-10,1.5-2,2-4,2-5,3-6,5-merou,abaxially,acumen,acuminate,acute,adaxially,ag,along,alyx,apart,apex,apparently,articulated,axe,borne,ciliate,connivent,contracted,covering,cuneate,decreasing,decurrent,digestion,discussion,distal,distinct,dorsally,eaf,edge,eed,end,enzyme,especially,exceeding,extra,flat,folded,geminat,glabrou,green-white,hair-like,half,highly,larger,lengthening,like,living,long,longer,lower,make,margin,midrib,minutely,mucilaginous,near,nflorescence,obtuse,often,orbicular,orolla,ovate,ovoi,pair,petiolulate,plurifoliate,pore,poricidal,puberulent,rachi,removed,rosette-formin,ruit,see,sessile,seudostipule,short,single-flowered,singly,slit,sometimes,spaced,species,specimen,stamen,ste,stolo,strongly,tamen,tem,thick,thir,throughout,tip,toward,tri-,unforked,unit,unwinged,vary,vein,wall,wet,yellow,ympodial	'extra,5-merous,[,],abaxial,adaxial,arrangement,calyx,characteristic,colour,form,growth,height,inflorescence,leaf,length,na,ovary,position,presence,present,pseudostipule,shape,staman,texture,type,value,{,}
40	wfo-0001025817	success	238	121	91	147	30	0.382	0.8–1.5,0–1.6,1-1.6,1.5–2.5,1.7-2.1,1.8–2.3,1.8–3,10,10–35,1–3,2–2.9,2–3,2–5,2–8,3.2–8,3–,3–13,3–8,4–5.5,4–7,5–20,7–9,8–21,adaxially,anther,asymmetric,bicolorous,black,blade,broadly,brown,calyx,chartaceous,cm,dark,deeper,densely,diameter,distally,dull,eventually,expanded,extra-axillary,filament,filiform,flower,fruit,glabrate,glabrous,globose,green,larger,lateral,leaf,lenticular,like,lobe,minutely,mm,moderate,occasionally,ovate,pale,pedicel,peduncle,petiole,pitted,pubescent,purple,rachi,ripe,shrub,simple,sized,slender,slightly,small,soon,stellate,stem,stigma,strongly,style,tapering,tree,tube,turning,violet,white,yellow,×	0.5–0.7,0.6–0.8,10–16,12–16,1–5,2–6.5,3.5–6,3–6,4–6,5-merou,5–6,6–13,8–14,abaxially,absent,accrescen,acuminate,acute,age,along,although,alyx,amount,apart,apex,apiculate,apparently,armed,articulated,asymmetrically,axe,ba,base,berry,bifurcate,branch,branched,broad-based,campanulate,capitat,central,compresse,conical,deciduous,deltoid,dense,developing,difoliate,directed,distall,eaf,eed,entire,exceeding,except,expansion,fertile,fewer,flowering,forming,free,fruiting,geminat,glabrou,high,impressed,interpetalar,juvenile,lacking,lanceolate,large,laterally,linear-lanceolate,long,low,lower,major,margin,midpoint,midvein,minute,much,near,nerve,nflorescence,numerous,oblong,obtuse,often,one,orolla,overlapping,pedunculate,persistent,persistently,pinnatifi,pore,portion,present,prickle,prickly,principal,pubescence,racemose,rarely,rayed,reaching,recognizable,rounded,row,ruit,sessile,short,single,sinuate–repand,sinus,sometimes,spaced,sparse,spreading,stalked,stellae,stout,surface,tamen,time,tissue,tomentose,trunk,ultimate,unarmed,underside,unequally,unit,usually,variously,vary,vein,velvety,weakly,well,white-stellate,wide,without,woolly,ympodial,young	5-merous,abaxial,adaxial,arrangement,capitate,cell,colour,corolla,form,growth,height,inflorescence,interjected,leaflet,length,na,ovary,plant,position,presence,pseudostipule,seed,shape,size,staman,terminal,testal,texture,tuber,type
41	wfo-0001025825	success	187	120	96	91	24	0.513	0.4-1,0.5-10.4,0.7-2.2,0.9-2,1-2,1-3,1-5.5,1.1-1.4,10-24,10.5-26,2-3.7,2-5,3-10,3-5,3-8.5,3.7-6.5,4-8,4-9,6-10,6.6-14,abaxially,acuminate,acute,adaxially,anther,apex,axillary,back,berry,blade,brownish,bud,cell,clavate,cm,condition,connivent,coriaceous,corolla,dark,diameter,digestion,drying,elliptic,enzyme,filament,flower,fresh,fruit,glabrescent,glabrous,green,greenish,hair,herb,homostylous,honeycomb-shaped,interjected,lanceolate,lateral,leaf,leaflet,light,lilac,lobe,long,medium,mm,odd-pinnate,ovoid,pedicel,peduncle,pentagonal,petiole,plant,poricidal,removed,rotate-pentagonal,seed,shiny,short,size,stigma,straight,streak,style,subtending,terminal,testal,tip,tube,wall,white,whitish,x,yellow	0-0.21,0.4-3,0.5-0.8,0.9-4,14-85,22-86,5-10,5-7,5-merou,acumen,adaxiall,ag,alyx,apart,apparently,articulated,asymmetric,attenuate,axe,base,basiscopic,capitat,covering,cuneate,decreasing,decurrent,distal,dorsally,eaf,edge,eed,erec,exceeding,flat,folded,forked,geminat,generally,glabrou,green-white,hair-like,hal,half,high,increasing,lengthening,living,lower,make,middle,mucilaginous,nflorescence,orbicular,orolla,ovate,pair,perfect,petiolulate,plurifoliate,pore,rachi,rounded,ruit,sessile,seudostipule,side,slightly,slit,smaller,spaced,specimen,stamen,subequal,subglabrou,tall,tamen,tem,thick,throughout,tissue,toward,tri-,unit,unwinged,usually,vary,wet,wide,wing,winged,ympodial	5-merous,abaxial,adaxial,arrangement,calyx,capitate,colour,form,growth,height,inflorescence,length,na,ovary,position,presence,present,pseudostipule,shape,staman,stem,texture,tuber,type
42	wfo-0001025835	success	297	110	86	211	24	0.29	.3,0.5-2.8,0.6-1.3,0.65-0.8,0.7-3,1-1.5,1-3,1-9,1.2-2,1.5-1.8,1.5-2,1.5-3.5,2-6,2.2-2.5,2.5-3,3-6,3.5-4,9-11,adaxial,almost,anther,apparently,becoming,berry,black,blade,bright,brown,calyx,clavate,cm,corolla,curved,diameter,drying,dull,equal,erect,evenly,filament,flattened-reniform,flower,free,fruit,gently,glabrous,globose,green,greenish,lateral,leaf,length,lobe,lobed,maturity,mauve,mm,moderately,orange-brown,pale,pedicel,peduncle,perfect,petiole,red,shiny,shrub,simple,smooth,sparsely,stellate,stellate-pubescent,stem,stigma,straw-yellow,style,tapering,terminal,thin,tube,white,x,yellow,yellowish,young,×	.1,/4,0.05-0.1,0.1,0.1-0.2,0.2-2,0.5,0.5-0.7,0.5-1,0.7-1.8,1,1-2,1-2.5,1-4,1-5,1-7,1-8,1.2-1.8,1.5-3,1/2,1/3,1/3-3/4,1/4-1/2,1/4-1/3,1/4-2/3,2.5-3.5,20,3-5,3-7,30-45°,4,4-5,4-8,5,5-20,5-merou,6,6-8,7-9.5,8,abaxially,accrescent,acuminate,acute,adaxially,ag,always,alyx,apar,apart,apex,apically,apiculate,armed,articulated,axe,bark,base,beyond,branche,branched,broad-based,broad-deltate,cell,chartaceous,concolorous,covering,cupular,dark,deep,deltate,developed,development,difoliate,distance,divided,dorsal,eaf,eed,elongating,exserted,extending,faint,finely,finger-hair,flat,flattened,foliaceous,fruiting,geminat,glabrescent,gre,green-brown,infructescence,irregula,irregular,lamina,lengthening,less,lobing,long,long-deltate,longer,longitudinal,lower,margin,mature,midpoint,midvein,minute,mostly,network,nflorescence,obconical,oblong,obtuse,occasional,often,older,one,open,opening,orange,orange-translucent,orolla,oung,outline,ovate,ovoi,ovoid,pair,papillae,papillo,part,pendulous,per,pericarp,pit,point,pore,poricidal,porrect,portion,prickle,primary,pronounced,rachi,raised,rarely,ray,reduced,reflexed,regular,rest,ribbed,ridged,rounded,ruit,scar,secondarily,secondary,sessile,shallow,short,shorter,shortly,side,significantly,sinus,slender,slightly,slit,small,sometimes,somewhat,spaced,spherical,spreading,stalk,stalked,straight,stump,surface,tamen,terete,tertiary,throughout,time,tip,toward,translucent,trichome,trifoliate,ud,unarmed,unequal,unit,upper,usually,variously,vary,vein,venation,visible,weakly,wide,widest,wing,woody,yellow-orange,ympodial	5-merous,abaxial,arrangement,colour,form,growth,height,inflorescence,interjected,leaflet,na,ovary,papillose,plant,position,presence,pseudostipule,seed,shape,size,staman,texture,tuber,type
43	wfo-0001025838	success	217	112	90	127	22	0.415	0.5-1,0.7-2,1-1.2,1-1.5,1.2-5,1.5-2,1.5-2.5,1.5-3.5,1.5-5,1.8-2,2-2.5,2.5-3,3.5-,4-15,4.5-5.5,6-15,6.5-7,adaxial,anther,berry,black,branched,brown,calyx,capitate,cell,clavate,cm,connivent,corolla,dendritic,dense,densely,diameter,ellipsoidal,filament,flattened,fleshy,flower,fruit,glabrous,globose,greenish,growth,inflorescence,lateral,leaf,like,lobe,lobed,long,loosely,many,membranous,minutely,mm,often,pale,pedicel,peduncle,perfect,petiole,pubescent,purple,reddish,reniform,ripe,seed,shiny,shrub,simple,slightly,sparsely,square,stellate,stem,stigma,style,terminal,testal,thin,time,tinged,tree,trichome,tube,tuft,white,x,yellow	-20,.5,0.5,1.5-1.7,10-15,10-60,2-5,2/3,20-40,5,5-merou,abruptly,acuminate,adaxially,ag,along,alyx,anthesi,apart,apex,apiculate,appearing,archin,ark,articulated,attenuate,axil,basall,base,branch,broad,clustered,cucullate,cup-shaped,dark,decurrent,denser,disintegrating,drying,eaf,eed,elliptic,entire,erect,exserted,extending,free,fruiting,glabrescent,hairy,ilament,inserted,insertion,irregularly,keeled,lamina,lanceolate,lengthening,less,lower,m.,margin,midrib,minute,mostly,narrowing,narrowly,never,new,nflorescence,nodding,occasionally,older,onto,orolla,ovoid,pair,papillat,papillo,per,pericarp,pitted,platform,plurifoliat,point,pointed,pore,poricidal,portion,primary,quadrate,revolute,ruit,scar,shin,short,sinus,sleeve,slender,slit,small,sometimes,spaced,spreading,strongly,surface,tall,tem,thi,tip,turbinate,twinin,ud,uniseriate,unit,upper,vary,vein,wall,way,weight,wing,winged,woody,yellowish,ympodial,¾	5-merous,abaxial,arrangement,blade,colour,form,height,interjected,leaflet,length,na,ovary,plant,position,presence,pseudostipule,shape,size,staman,texture,tuber,type
44	wfo-0001025845	success	180	114	90	90	24	0.5	0.3-0.5,0.4-1.5,0.5-11,1-2,1-4.5,1.5,1.5-13,1.5-2,1.5-2.5,1.5-7,2,2-15,2-3,2.5-4,4-5,4-6,5-6,6-6.5,6-9,abundantly,adaxial,anther,apex,base,blade,branch,brown,calyx,chartaceous,cm,compressed,corolla,cylindrical,dark,diameter,distally,eglandular,ellipsoidal,extra-axillary,filament,flattened,flower,fork,fruit,glabrous,green,greenish,herb,lateral,laterally,leaf,light,lobe,located,longitudinal,membranaceous,minutely,mm,narrowly,obtuse,often,orange,ovoid,pedicel,peduncle,perfect,petiole,puberulent,pubescent,purple,rotate-stellate,rugose-verrucate,sagittate,sand-punctate,shrub,simple,sparsely,stigma,stripe,strongly,style,tapered,terminal,triangular,truncate,tube,unbranched,white,x,yellow	.5,0.5-2.5,1,1-1.8,2-5-lobed,3,3-13,3-4,3-6,3-foliat,7-10,abaxially,acuminate,acute,adaxially,aggregate,along,apart,apiculate,around,articulated,ascending,axe,ba,cell,channe,connivent,cuneate,decurrent,deltate,diamete,directed,distall,divided,eaf,eed,elliptic,entire,especially,free,glabrou,inserted,lobed,long,lower,major,margin,mesocarp,midrib,near,nearly,nflorescence,obovate,orolla,ovate,part,patch,pinnately,pore,rachi,radiu,rarely,rounded,ruit,shorter,side,sinus,small,spaced,stone,subcordate,tal,tamen,tem,thecae,thick,tightly,time,tip,tomento,truncat,unit,unlobed,vary,vein,veiny,wide,yellowish,ympodial,youn	abaxial,arrangement,colour,form,growth,height,inflorescence,interjected,leaflet,length,na,ovary,plant,position,presence,pseudostipule,seed,shape,size,staman,stem,texture,tuber,type
45	wfo-0001025850	success	197	113	88	109	25	0.447	-5,.5,.8,0.5-,0.5-1,0.5-3,0.6-1,1,1-1.5,1-3,1.5,1.5-5,2,2-6.5,6-7,abaxial,anther,base,berry,branched,broadly,brown,calyx,capitate,cell,cm,connivent,corolla,diameter,divaricate,ellipsoid,filament,flattened,fleshy,flower,glabrous,glandular,globose,green,growth,inflorescence,later,lateral,lax,lobe,lobed,loosely,many,membranous,mm,nearly,occasionally,openly,orange,outline,pale,pedicel,peduncle,perfect,petiole,pinnatifid,pubescent,reddish,reniform,ripe,scattered,shiny,shrub,simple,sinuate,slightly,stellate,stem,stigma,style,surface,tan,terminal,testal,thin,time,trichome,tube,uniseriate,vine,white,woody,x	-7,0.5,1-celled,15-20,2-12,3-4,30,4-5,5-7,5-merou,acute,ag,along,alyx,anthesi,apar,apex,apparently,ark,articulated,axi,basal,cupped,cyathiform,deciduous,deflexed,deltate,densely,denser,divided,drying,eaf,eed,elliptic,elongate,em,entire,erect,exserted,extending,free,fruiting,geminat,glabrou,gland,half,halfway,ilament,irregularly,lamina,leaving,lengthening,less,long,lower,margin,midrib,minute,minutely,narrowly,new,nflorescence,nodding,node,often,older,orolla,pair,papillate-puberulent,papillo,peg,per,pitted,planar,plurifoliate,pore,poricidal,portion,primary,puberulen,rhomboid,rounded,ruit,scar,shallowly,sinus,sleeve,slender,slit,small,sometimes,soon,spaced,splitting,spreadin,spreading,strongly,surfac,tiny,tip,truncate,twinin,ud,unit,vary,vein,yellow,ympodial,young	5-merous,adaxial,arrangement,blade,colour,form,fruit,height,interjected,leaf,leaflet,length,na,ovary,plant,position,presence,pseudostipule,seed,shape,size,staman,texture,tuber,type
46	wfo-0001025856	success	185	90	49	136	41	0.265	0.5,1-3,2,3,3-10,anther,berry,blade,branched,brown,calyx,chartaceous,cm,compound,connivent,corolla,diameter,elliptic,filament,flattened-reniform,flower,foveolate,glabrescent,glabrous,globose,green,lateral,leaflet,light,lobe,lobed,mm,oblong,pedicel,peduncle,petiole,pinnately,rugose,spreading,stigma,straight,streak,strongly,style,terminal,tube,uniformly,white,×	.4,/4,0,0.3-1,0.3–0.5,1.5–2,10–,10–15,15–20,1–,1–1.5,1–2,1–5,2.5–4,20,20–30,20–35,2–,2–4,3–4,3–5,4–,4–10,4–6,5–,5–10,5–15,5–7,6–12,abaxially,acuminate,acute,adaxially,ag,always,alyx,anthesi,apex,apiculate,armed,articulated,axe,base,becoming,bud,c.,calcium,campanulate,commonly,corresponding,crystal,cuneate,densely,difoliate,dr.,eaf,eed,ellipsoid,entire,equal,exserted,fifth,four,fruiting,geminat,glabrou,herbaceous,internode,larger,lengthening,long,long-styled,longer,lower,major,margin,narrowly,nearly,nflorescence,oblique,often,one,opposite,orange,orolla,outline,oxalate,pair,papillat,perennial,pericarp,petiolulate,petiolule,plurifoliate,pointed,pore,poricidal,present,prickle,rachi,rarely,recurve,recurved,rounded,ruit,side,slender,slightly,slit,somewhat,soon,stellate,stout,subopposite,subwood,subwoody,surface,tamen,tem,throughout,time,tip,triangular,truncat,tub,unequal,unit,usually,vary,vein,vin,way,wide,widest,yellow,ympodial	1-5,1.5-2,10,10-15,10-30,15-20,2-15,2-4,2.5-4,5-10,5-7,6-12,abaxial,adaxial,arrangement,cell,colour,dry,form,fruit,growth,inflorescence,interjected,leaf,length,na,ovary,position,presence,pseudostipule,seed,shape,size,staman,stem,testal,texture,truncate,tuber,type,vine
47	wfo-0001025872	success	160	91	62	98	29	0.388	0.25-0.5,0.6-1,1-1.3,1-1.5,1-2,1.2-1.6,1.7-3,2-2.5,2-5,2/3,3.5-4,4-4.5,4.5-13,6-8,anther,base,becoming,blade,brownish,calyx,capitate,cm,corolla,crinkled,dark,densely,dia,dry,filament,flattened-reniform,flower,glabrous,globose,green,greenish-tan,later,lateral,leaf,live,lobe,lobed,material,mm,occasionally,opposite,ovary,pedicel,petiole,plant,poricidal,pubescent,shrub,stem,stigma,straight,style,terminal,tip,tube,way,white,x	.1,.5,0.5,0.5-1,1,1.2-1.5,10-25-flowered,6-10,acute,along,anthesi,apart,apex,apically,auriculate,ba,bark,beginning,beneath,berry,branched,bright,broadly,coriaceous,crowded,cup-shaped,decurrent,deeply,deflexed,dense,eaf,edicel,eed,elliptic,exserted,flattened,fleshy,free,fruiting,glandular-resinous,grayish-brow,incrassate,inflorescenc,irregularly,junction,lon,long,lower,main,margin,midrib,minutely,narrowly,nflorescence,often,older,onto,pair,paler,papillae,papillo,papillose,pitted,planar,plurifoliat,pore,portion,prominent,red-papillose,revolute,rounded,rounded-triangular,ruit,scar,several,shaped,simple,somewhat,soon,spaced,specimen,surface,tall,tapering,tear-drop,thick,thickened,time,trichome,tub,ud,uniseriate,unit,vein,visible,woody,ympodial,young	1.5,abaxial,adaxial,arrangement,cell,colour,diameter,form,fruit,growth,height,inflorescence,interjected,leaflet,length,na,peduncle,plurifoliate,position,presence,pseudostipule,seed,shape,size,staman,testal,texture,tuber,type
48	wfo-0001025875	success	205	90	65	140	25	0.317	0.1-1.1,0.3-2,0.5-6,0.8-1.8,1.1-1.6,1.2-1.8,1.5-2.5,2.3-3,2.4-2.8,2.5-4.5,4.5-6.5,5-10,5-14,8-11,anther,blade,calyx,chartaceous,cm,cylindrical,dark,densely,diameter,erect,extra-axillary,filament,flower,fruit,glabrous,globose,green,grey,inflorescence,lateral,leaf,length,lobe,lobed,long,mm,oblate,pale,pedicel,peduncle,perennial,petiole,plant,pseudo-racemose,purple,rhizomatous,rotate,shrub,simple,sparsely,stellate-pubescent,stigma,streak,style,truncate,tube,unbranched,white,x,yellow,yellowish	%,.05,0-0.1,0-0.5,0-1.5,0-5,0.1-0.2,0.2-0.45,0.25-0.4,0.3-0.4,0.4-0.5,0.4-0.7,0.5-1,0.5-1.3,0.7-0.8,0.8-0.9,0.9-1.4,1-10,1-2,1-3,1-7,1.5-6,15-25,2-locular,3-5,3-6,4-10,5-11,5-15,5-9,5-merou,6-13,7-10,7-14,7-8,8-14,9-13,?,abaxially,absen,absent,accrescent,acicular,across,acute,adaxiall,adaxially,adult,alyx,andromonoecious,anvil-shape,apart,apex,articulated,attenuate,axe,ba,basal,base,branchlet,cross-section,cuneate,decimetre,deeply,deltate,directed,distally,dm,eaf,eed,eglandular,entire,exocarp,finger,fruiting,functional,geminat,gland-tipped,hair,half,hastate,heterostylous,juicy,juvenile,lamina,lanceolate,less,linear,longer,lower,margin,mature,mesocarp,mid-point,midpoint,midvein,minute,moist,narrowly,nflorescence,oblique,obtuse,orolla,pair,part,per,placenta,plurifoliate,pore,porrect,possibly,present,prickle,ray,ruit,sessile,shallowly,short,spaced,stalk,stalked,stellae,stellate,straight,surface,tal,tamen,tem,thick,throughout,time,transparent,unarme,unarmed,unit,upper,vary,weakly,wide,ympodial	5-merous,abaxial,adaxial,arrangement,colour,corolla,form,growth,height,interjected,leaflet,na,ovary,position,presence,pseudostipule,seed,shape,size,staman,stem,terminal,texture,tuber,type
49	wfo-0001025888	success	256	104	72	184	32	0.281	.5,.6,1.5,2.1,3.2,3.8,9.5,across,along,anther,apex,attachment,base,blade,calyx,channeled,chartaceous,cm,corolla,deltoid,densely,diameter,dry,extra-axillary,filament,filiform,flattened-orbicular,flower,fruit,glabrous,glandular,globose,hair,hooked,lamina,lateral,leaf,lobe,mature,mm,notched,oblong,orange-red,ovate,pedicel,peduncle,petiole,point,porrect,pubescence,pubescent,red,restricted,scattered,sessile,short-stipitate,shrub,simple,small,stellae,stellate,stigma,straight,style,tree,tube,vein,white,yellow,yellow-ferruginous,yellow-tan,±straight	.05,.3,.4,0.04,0.1,0.2,0.3–0.5,0.4,0.4–0.6,0.4–0.7,0.5–0.7,0.6–1.2,0.7–0.8,0.7–1.5,0.8,0.8–1.0,0.9–1.1,0.9–1.2,0.9–1.3,1.0–1.8,1.2–2.3,1.4–1.8,1.5–1.9,1.5–2.0,1.5–2.1,1.5–4.0,1.7–2.1,1.8–2.3,1.8–3.5,1.9–2.2,1.9–3.4,1/2–2/3,1/3,2.2,2.5–2.6,2.6,2.7–3.0,3,3.0–11.1,3.1–4.2,3/4,4.2–5.5,4–8,4–9,5,5-merou,5.5–11.1,5–7,6–10,7.1–9.1,8.1–17.1,90°,abaxially,acute,adaxially,adnate,alveolate,alyx,anthesi,apart,apiculate,apparently,appearing,appresse,arching,area,articulate,axe,ba,berry,branch,branching,broad,brochidodromous,bud,capitat,central,clinate,congested,cuneate,dehiscen,denser,dentate,development,difoliate,distal,distinct,eaf,eed,either,emerging,endocarp,entire,exocarp,fertile,flexed,free,geminat,glabrescent,gradually,homostylous,increasing,internode,interpetalar,intersepalar,juic,less,little,lon,long,longer,longitudinally,lower,major,many,margin,middle,midpoint,midrib,midvein,minor,minute,moderately,nearly,nflorescence,oblique,opaque,orolla,per,poorly-developed,portion,potentially,pubescen,raised,ray,reflexed,rigid,rounded,row,ruit,shinny,shorter,side,sinuate,sinus,smoot,sometimes,spaced,sparsely,splitting,spread,spreading,stellate-pubescent,stipe,surface,swelling,tamen,tardily,tem,thin,though,time,tip,tissue,truncate,two,typically,ud,unarmed,unbranched,vary,weakly,well,wide,ympodia,young,±90°,±aequilateral,±equal,±erect,±glabrous,±overlapping,±smooth,×	0.3,0.4-0.7,0.6-1.2,0.7-1.5,0.8-1.0,0.9-1.2,1.0-1.8,1.4-1.8,1.5-2.0,1.5-4.0,1.9-2.2,2.5-2.6,3.0-11.1,8.1-17.1,arrangement,capitate,colour,dense,form,growth,height,inflorescence,length,ovary,plant,position,seed,shape,size,staman,stem,texture
50	wfo-0001025892	success	170	84	62	108	22	0.365	.3,0.2-0.4,0.3-0.7,0.3-0.8,2-7,2.5-4,2.5-6,2.8-3,4.5-7.5,5-17,7-15,8-11.5,absent,anther,apex,blade,calyx,chartaceous,cm,curved,cylindrical,densely,diameter,extra-axillary,flower,fruit,glandular,globose,grey,grey-green,herbaceous,inflorescence,lanceolate,leaf-opposed,length,linear,lobe,mm,narrowly,oblate,pale,papillae,pedicel,peduncle,petiole,pseudo-racemose,purple,resprouter,simple,solitary,stellate,stellate-pubescent,stem,sticky-glandular,stigma,style,tube,unbranched,white,x,yellow,yellowish-green	%,0-0.1,0-0.3,0-1,0-10,0.05-0.1,0.1-0.2,0.2-0.5,0.2-0.8,0.3-0.5,0.4-0.6,0.4-0.8,0.7-0.9,0.8-1.1,1-2,1.5-5,10-17,2-locular,4-merou,5-7,6-10,8-10,8-11,8-13,9-18,abaxially,absen,adaxiall,adaxially,alyx,apart,articulated,axe,ba,base,broad-based,connivent,cross-section,cuneate,d.,deltate,dense,directed,distall,distributed,dult,eaf,eed,eglandular,entire,erect,exocarp,finger,fruiting,geminat,glabrous,gland-tipped,hair,half,juicy,lamina,lateral,less,long,longer,lower,margin,mature,mesocarp,mid-point,midpoint,minute,moist,nflorescence,oblique,obtuse,orolla,part,per,perfect,placenta,pore,porrect,present,prickle,ray,ruit,sessil,sessile,short,spaced,stage,stalk,stellae,straight,tal,tamen,thick,throughout,time,triangular,truncat,unarmed,unit,uvenile,vary,wide,ympodial	4-merous,abaxial,adaxial,arrangement,colour,corolla,filament,form,growth,height,leaf,na,ovary,plant,position,seed,shape,size,staman,texture,truncate,type
51	wfo-0001025893	success	157	86	57	100	29	0.363	.5,0.5-1.5,0.8-1,1-1.2,1-1.5,1-2.5,1-4,1.5-2,11-20,2-2.5,2-3,5-6,anther,bi-lobed,blade,brownish-green,calyx,capitate,cm,corolla,dia,filament,flower,fruit,glabrate,glabrous,globose,golden-puberulent,green,greyish,internodal,lateral,leaf,lobe,lobed,minutely,mm,opposite,ovary,ovoid-reniform,pale,pedicel,petiole,pitted,shaped,shrub,sometimes,stem,stigma,straight,style,tear-drop,tube,white,winged,x,yellowish	.25,.4,1.5-1.7,3-5,6-10,accrescent,along,anthesi,apex,attenuate,bank,barely,bark,base,bearing,beginning,beneath,berry,branched,broadly,closely,cup-shaped,decurrent,deflexed,deltoid,densely,difoliate,dry,eaf,early,eed,ellipsoid,elliptic,erect,even,exserted,faintly,free,fruiting,geminate,gravelly,growing,impressed,inflorescenc,lon,long,long-acuminate,longitudinally,lower,main,many,margin,material,middle,narrowly,nearly,nflorescence,obovate,occasionally,older,overlapping,pair,papillo,papillose,planar,plurifoliat,pore,poricidal,portion,puberulent,red-papillose,reflexed,river,rocky,ruit,sandy,scar,slender,slightly,spaced,specimen,stream,striat,surface,tall,tapering,thickened,time,tip,trichome,ud,unicellular,unit,usually,vein,visible,widest,woody,ympodial,young	abaxial,adaxial,alternate,arrangement,cell,colour,diameter,form,growth,height,inflorescence,interjected,leaflet,length,na,peduncle,plant,position,presence,pseudostipule,seed,shape,size,staman,terminal,testal,texture,tuber,type
52	wfo-0001025896	success	146	91	60	86	31	0.411	-3,0.5,0.5-2,1-1.5,1-3,1-6.5,1-8,1.5-2,2-14,2-2.5,2.5-14,2.5-5,4,4-23,4-5,4-6,5-15,6-10,abaxial,angled,blade,brownish,calyx,cell,chartaceous,cm,cylindrical,densely,diameter,flower,forked,fruit,glabrous,globose,lobe,mm,moderately,nearly,orange,ovate,pale,pedicel,peduncle,perfect,petiole,pubescent,purple,red,rotate-stellate,rugose,shrub,simple,smooth,stem,stigma,style,tube,unbranched,white,x	-30,.5-2.5,1-25,1.5-9,10-15,10-25,4-12,5-7,6-13,7-,7743,abaxially,absen,acosta,acuminate,acute,adaxiall,adaxially,aggregate,also,apart,apex,articulated,axe,ba,base,branched,connivent,constricted,cuneate,deltate,dendritically,directed,distall,eaf,eed,eglandular,elliptic-ovate,entire,especially,gland,greenish,hair,inflated,like,long,lower,many-foliat,margin,membranaceous,near,nflorescence,nther,obtuse,occasionally,often,orolla,pore,present,puberulent,pubescen,rachi,radiu,ripe,ruit,short-stalked,solí,spaced,sparsely,stalked,stone,subcordate,surface,tal,tem,time,tip,triangular-ovate,triangular-subulate,truncat,unit,vary,vein,wide,yellow,ympodial	adaxial,anther,arrangement,colour,corolla,filament,form,growth,height,inflorescence,interjected,lateral,leaf,leaflet,length,na,ovary,plant,position,presence,pseudostipule,seed,shape,size,staman,terminal,testal,texture,truncate,tuber,type
53	wfo-0001025902	success	211	106	83	128	23	0.393	/2,0.1-0.5,0.5-2,0.5-2.5,1-1.2,1-1.5,1.5,1.5-2,1.5-3,1/3,11-15,1983,2-6,2.5-4,4-13,5-6,adaxially,anther,base,becoming,black,cabrera,calyx,cell,chartaceous,circular,clavate,cm,corolla,diameter,dull,ellipsoid,fide,filament,flattened-reniform,fleshy,flower,glabrous,globose,green,growth,inflorescence,lateral,leaf,leaf-opposed,length,lobe,lobed,long,lower,mature,mm,occasionally,ovary,pale,pedicel,peduncle,perfect,petiole,pubescent,rotate-stellate,rounded,scattered,simple,sometimes,sparsely,stem,stigma,style,surface,terminal,testal,trichome,tube,vine,violet,way,whitish,woody,x,yellow,yellowish,½	.2,.5,1.2-1.5,3-10,4,4-5,4-6,40,5-merou,8-10,8-15,8-9,>,abaxially,absent,accompanied,acute,ag,aid,along,always,alyx,anthesi,apar,apex,ark,articulated,attenuate,axi,bark,beginning,berr,berry,branch,branched,branching,broadly,c.,climbin,completely,conical,connivent,deciduou,deltate,densely,eaf,eed,either,entire,except,exfoliatin,exserted,free,fruiting,geminat,ilament,lanceolate,leaving,lengthening,less,linear,loosely,low,margin,markedly,midvei,minute,minutely,new,nflorescence,obscured,often,older,one,orolla,pair,papillat,papillose,peg,pendant,per,pericarp,pitted,planar,plurifoliate,pore,poricidal,portion,primary,prominent,revolute,ridged,ruit,scar,scrambling,semi-aquati,semi-circular,shallow,sleeve,slender,slit,small,somewhat,soon,spaced,spreading,strongly,tangled,tapering,tem,thin,time,tip,twining,ud,ultimate,uniseriate,unit,usually,vary,vegetation,vein,water,weak,weight,widely,wing,ympodial	5-merous,abaxial,adaxial,arrangement,blade,colour,form,fruit,height,interjected,leaflet,na,plant,position,presence,pseudostipule,seed,shape,size,staman,texture,tuber,type
54	wfo-0001025906	success	188	111	90	98	21	0.479	0-14,0.1-2,0.15-0.6,0.2-0.6,0.20-0.60,1-2,1.1-2,1.6-12.4,1.8-4.8,16-51,2-4.4,2-6,2.6-5.2,3-10,4-12,4-5,4-7,5-6,5-7,5.2-9,8-16,8.5-12.5,abaxially,adaxially,anther,axillary,blade,blue,brownish,bud,cell,clavate,cm,condition,connivent,coriaceous,corolla,dark,diameter,drying,filament,flower,fresh,fruit,glabrous,globose,green,greenish,hair,herb,homostylous,honeycomb-shaped,interjected,lanceolate,lateral,leaf,leaflet,light,lilac,linear,lobe,long,mm,odd-pinnate,ovoid,pedicel,peduncle,pentagonal,petiole,plant,pubescent,purple,ripe,rotate,seed,shiny,short,size,stigma,straight,stripe,style,sub-glabrous,subtending,terminal,testal,tube,white,whitish,x	1-3,1-6,3-5,4-10,5-merou,acumen,acute,adaxiall,ag,alyx,apart,apex,apparently,articulated,axe,base,berry,capitat,covering,cuneate,decreasing,decurrency,decurrent,delimited,digestion,diminishing,distal,dorsally,eaf,edge,eed,enzyme,erec,exceeding,falcate,first,flat,folded,forked,geminat,generally,glabrou,green-white,hair-like,hal,half,high,lengthening,living,lower,make,mucilaginous,next,nflorescence,obtuse,orolla,pair,perfect,plurifoliate,pore,poricidal,rachi,removed,ruit,second,sessile,seudostipule,slightly,slit,smaller,spaced,sparsely,specimen,stamen,subequal,subglabrou,subglabrous,tall,tamen,tem,thick,third,throughout,tip,toward,tri-,typically,unit,unwinged,usually,vary,wall,well,wet,width,wood,yellow,ympodial	5-merous,arrangement,calyx,capitate,colour,form,growth,height,inflorescence,length,na,ovary,position,presence,pseudostipule,shape,staman,stem,texture,tuber,type
55	wfo-0001025907	success	148	105	74	74	31	0.5	.05,.5,.5-1,1-1.2,1-2.3,1-3,1-5,1.5-2,1.5-2.2,12-45,2,2-3.5,2/3,3-,4-5,5-15,anther,anticlinal,axillary,brown,calyx,cell,cm,conical,densely,diameter,elliptic,filament,flattened,flower,free,fruit,glabrous,green,greenish,growth,highly,irregular,lobe,long,lower,minutely,mm,new,obovate,ovary,ovoid-reniform,papillate,pedicel,petiole,plant,poricidal,portion,projection,pubescent,raised,red-papillate,round,rugose,seed,shrub,simple,sinuous,size,stigma,style,thickening,tip,trichome,tube,uniseriate,white,without,x	-4,0,0-60,0.8-1.8,1,10-15,2-8,3-4,3/2,absent,acuminate,acute,along,anthesi,anthesis5-7,apex,appearing,attenuate,axil,base,beak,bearing,berry,breaking,c,clavat,conspicuously,deciduous,eaf,edicel,eed,epidermal,erec,fruiting,globose,included,iquito,isolated,lamina,lobed,lon,margin,near,nearly,nflorescence,occasionally,open,pair,papillose,per,population,primary,reflexed,remaining,ruit,scar,scattered,single-stemmed,slender,soon,sparsely,surface,tal,tem,time,truncate,tub,ud,unifoliat,unit,variable,vein,white-lenticellate,ympodial	0.05,5-7,abaxial,adaxial,arrangement,blade,clavate,colour,corolla,form,height,inflorescence,interjected,lateral,leaf,leaflet,length,na,peduncle,position,presence,pseudostipule,shape,staman,stem,terminal,testal,texture,tuber,type,unifoliate
56	wfo-0001026203	success	197	116	93	104	23	0.472	0.06-0.86,0.3-11,0.38-11.3,0.4-3,0.5-2.3,0.5-3.2,0.7-2.6,1-13,1-2,1-9,1.1-7.9,1.2-5.5,2-10,2-4.9,2-5,2-8.5,2.2-13.3,3-10,3-11,3.2-22,3.2-23,7-47,abaxially,adaxially,anther,axillary,berry,blade,blue,brownish,bud,cell,clavate,cm,condition,connivent,coriaceous,corolla,dark,deep,diameter,drying,elliptic,filament,flower,fresh,fruit,glabrescent,glabrous,globose,green,greenish,hair,herb,homostylous,honeycomb-shaped,interjected,lanceolate,lateral,leaf,leaflet,light,lilac,lobe,long,medium,mm,odd-pinnate,ovate,ovoid,pedicel,peduncle,pentagonal,petiole,plant,ripe,rotate,seed,short,size,sometimes,stigma,straight,stripe,style,subtending,terminal,testal,tube,tuber,whitish,wide,x	0-39,0-7,0.3-6,1-4,1-5,2-43,3-5,5-merou,acumen,acuminate,acute,ag,along,alyx,apart,apex,apparently,arranged,articulated,asymmetric,attenuate,axe,base,basiscopic,bead,capitat,covering,decreasing,decurrent,digestion,distal,dorsally,eaf,edge,eed,enzyme,erect,exceeding,flat,folded,forked,geminat,generally,glabrescen,glabrou,green-white,hair-like,hal,half,high,lengthening,like,linear,living,lower,make,middle,moniliform,mucilaginous,multiple,necklace,nflorescence,orbicular,orolla,pair,perfect,plurifoliate,pore,poricidal,rachi,removed,rosett,rounded,ruit,sessile,seudostipule,side,slightly,slit,spaced,specimen,stamen,stolon,subequal,subglabrous,tall,tamen,tem,thick,throughout,tip,tissue,toward,tri-,typically,unit,unwinged,usually,vary,wall,wet,white,yellow,ympodial	5-merous,abaxial,adaxial,arrangement,calyx,capitate,colour,form,growth,height,inflorescence,length,na,ovary,position,presence,present,pseudostipule,shape,staman,stem,texture,type
57	wfo-0001026205	success	165	107	79	86	28	0.479	.5,.5-2,0.3-2,1,1-1.5,1-3,1-6,15-20,2-14,30-35,4,5-7.5,5-merous,5.5-6,7-9,adaxially,anther,apparently,attenuate,blade,calyx,chartaceous,cm,cream,deeply,densely,diameter,elliptic,erect,exceeding,extra-axillary,filament,flattened,flower,four,fruit,glabrous,globose,growth,hair,homostylous,lateral,leaf,lobe,long,maturing,midpoint,minute,minutely,mm,often,pedicel,peduncle,petiole,porrect-stellate,pubescent,purple,ray,scarcely,seed,sessile,short,shrub,simple,size,sparsely,stellate,stellate-pubescent,stem,stigma,strongly,style,tip,trichome,tube,violet,white,x,yellow	-14,-2.5,-6,0.5-,0.75-1,1-2,1.5,2-3,3,3/4,8,abaxially,absent,accrescen,acuminate,acute,alyx,apex,apical,armed,around,articulated,axe,ba,base,cuneate,difoliate,distinct,divided,eaf,eed,enlarged,entire,extror,fruiting,geminat,glandular,globo,including,linear-lanceolate,lower,major,margin,minor,new,nflorescence,node,oblique,orolla,perfec,pore,porrect,prickle,proximally,rachi,rare,rarely,ruit,shortly,similar,slender,slightly,small,smaller,solitary,sparse,stellat,stellate-pubescen,straight,summit,surface,tall,tamen,tem,thickened,third,toward,unarme,unarmed,unit,usually,vary,wide,wing,ympodial,zigza	0.5-2.5,abaxial,adaxial,arrangement,cell,colour,corolla,form,height,inflorescence,interjected,leaflet,length,na,ovary,perfect,plant,position,presence,pseudostipule,red,shape,staman,terminal,testal,texture,tuber,type
58	wfo-0001026208	success	214	107	83	131	24	0.388	0.5-1.2,0.6-0.8,0.6-0.9,0.7-2,0.8-1.5,1-2,1-5,1.8-2.3,1.8-2.5,11-25,2-20,2.5-6,3-5,3.5-5,5-17,5-merous,abaxial,adaxial,anther,apparently,berry,blade,bright,brown,calyx,chartaceous,cm,connivent,dark,densely,diameter,dull,elliptic,erect,evenly,filament,flattened-reniform,flower,fruit,glabrous,green,green-brown,lateral,leaf,length,lobe,lobed,long,maturity,mauve,membranous,mm,moderately,orange,orange-brown,ovate,pale,pedicel,peduncle,petiole,poricidal,pubescent,recurved,red,shrub,slender,sometimes,sparsely,spherical,stellate-pubescent,stem,stout,straight,straw-yellow,style,tapering,terminal,tip,tube,white,wide,yellow,young	-1/2,-10,-3,-5,.5,/3,0,0-20,0-4,0-5,0-8,0.1,0.1-0.2,0.1-0.25,0.1-0.3,0.5-0.8,0.8-1.3,1-4,1.5,1.5-2.5,1/3,1/4-1/3,1/4-1/6,2,2-3,2-4,2.5-5,3-30,3-6,3/,4-7,4-9,5,5-,5-22,6-22,6-8,abaxially,acuminate,acut,acute,alyx,apar,apart,apex,apically,articulated,bark,base,becoming,branched,broad-deltate,conical,cuneate,curved,deltate,difoliate,discolorous,distance,drying,eaf,eed,elongated,elongating,equal,extending,flattened,free,fruiting,geminat,geminate,glabrescent,gray-greenish,infructescence,longer,lower,margin,mature,midpoint,midvein,nflorescence,older,one,open,orolla,oung,pair,pendulous,per,perfec,pericarp,porrect,portion,prickle,prickly,primary,ray,red-brow,rounded,ruit,scar,sessile,shorter,side,smooth,somewhat,spaced,spreading,stalk,stalked,stellate,subentire,surface,tamen,terete,tertiary,time,toward,trichome,unarme,unarmed,unit,usually,variously,vary,vein,venation,visible,way,woody,ympodial	arrangement,colour,corolla,form,growth,height,inflorescence,interjected,leaflet,na,ovary,perfect,plant,position,presence,pseudostipule,seed,shape,size,staman,stigma,texture,tuber,type
59	wfo-0001026215	success	150	110	80	70	30	0.533	.05,.5,0.05,0.5-1,1,1-3,1.5,1.5-2,1.5-2.2,13-35,2-3,2-3.5,3/4,4-15,4-5,7-8,along,anther,anticlinal,axillary,base,brown,calyx,cell,clavate,cm,completely,conical,corolla,densely,diameter,elliptic,entire,filament,flattened-round,flower,fruit,glabrous,green,greenish,herb,highly,irregular,length,less,lobe,lobed,long,markedly,mm,nearly,occasionally,often,ovary,ovoid-reniform,papillae,pedicel,petiole,poricidal,projection,purple,red-papillose,rugose,seed,shrub,simple,sinuous,stem,stigma,strongly,style,thickening,tip,tube,way,white,white-pubescent,winged,without,x	-3,0,15-2,18-20,2,2-4,abaxially,abruptly,absent,acuminate,anthesi,ape,apex,axil,beak,berry,bifi,broadly,conspicuously,continually,deltate,eaf,edicel,eed,enlarged,epidermal,erect,exserted,free,fruiting,globose,horizontal,internode,kink,lower,marked,minutely,narrowing,nflorescence,noddin,nodding,onto,pair,papillat,papillate,per,portion,primary,raised,reflexed,rounded,ruit,scar,shortsympodial,single-stemmed,small,ste,surface,tal,tem,time,tub,ud,unifoliat,unit,usually,vein,white-lenticellate,wide,wing	abaxial,adaxial,arrangement,bifid,blade,colour,form,growth,height,inflorescence,interjected,lateral,leaf,leaflet,na,peduncle,plant,position,presence,pseudostipule,shape,size,staman,tall,terminal,testal,texture,tuber,type,unifoliate
60	wfo-0001026220	success	158	113	69	89	44	0.437	/3,0.3-1.5,1.3-1.7,1.5-2.5,10-20,2.5-3.5,4-10,4-12,8-12,annual,anther,armed,back,band,base,bearded,blade,brown,calyx,cm,dark,dia,dry,essentially,foveolate,glabrous,glandular,glaucescent,hair,herb,internodal,lacking,leaf,lobe,long,maturity,minutely,mm,near,often,one,ovate,pentagonal,persistent,petal,petiole,pigment,pinnatifid,pinnatisect,plant,portion,proximal,reddish,reticulately,ridged,second,short,simple,spherical,splitting,stellate,stellate-pubescent,stem,surface,thrice,tube,ventral,year,yellow	.3-2.8,.5,0.2,1,1.0-1.8,5-10,50-90,6-10,7-11-flowere,accrescent,across,acute,along,alyx,anthesi,ape,becoming,berry,campanulate,closely,coarsely,conspicuous,developing,difoliate,divided,dryin,eaf,eed,flattened-ovo,foliaceous,geminat,heteromorphic,interpetalar,invested,lanceolate,large,later,latter,lon,main,many,mostly,much,nearly,nflorescence,obtuse,orolla,pentagonal-stellae,per,persisting,plicate,prickle,prickly,purple,ray,red,reduced,ruit,scattered,shorter,side,similar,slende,somewhat,spaced,stellae,straight,suffused,surrounding,tall,tamen,terminally,tightly,tigma,tissue,tub,twice,tyle,ultimate,unexpande,unit,upon,vary,vein,well-developed,widely,yello,ympodial,young	2.3-2.8,7-11-flowered,abaxial,adaxial,arrangement,cell,colour,corolla,diameter,filament,flattened-ovoid,flower,form,fruit,growth,height,history,inflorescence,interjected,lateral,leaflet,length,life,na,ovary,pedicel,peduncle,pentagonal-stellate,position,presence,pseudostipule,seed,shape,size,slender,staman,stigma,style,terminal,testal,texture,tuber,type,unexpanded
61	wfo-0001026227	success	150	85	54	96	31	0.36	.3,.8,0,0-1.5,0.3-2.2,0.4-1.4,1.5-4,1.6-2,15-20,2-2.5,2.5-3,5-merous,blade,calyx,chartaceous,cm,densely,diameter,elliptical,flower,fruit,globose,green,grey,herbaceous,inflorescence,lateral,leaf-opposed,length,lobe,lobed,long,mm,moderately,ovate,pale,pedicel,peduncle,petiole,pseudo-racemose,resprouter,shallowly,simple,solitary,sparsely,stellate,stellate-pubescent,stigma,style,thick,tube,unbranched,x,yellow	%,0-0.1,0-1,0-3,0.1-0.7,0.25-0.4,0.3-0.4,0.3-0.5,0.3-0.6,0.3-0.9,0.5-1,0.9-1.2,1,1-1.3,1-4,10-15,17-55,2-10,2-3,3-6,3-7.5,5-30,6-8,7-8,abaxially,absen,absent,acicular,across,adaxially,apart,apex,armed,articulated,axe,ba,base,chartaceou,cuneate,d.,deltate,distributed,eaf,eed,eglandular,entire,finger,fruiting,gland-tipped,gree,hair,half,index,lamina,lobing,lon,longer,lower,margin,mature,mid-point,midpoint,midvein,nflorescence,oblique,obtuse,orolla,part,per,porrect,present,prickle,ray,ruit,sessile,short,side,spaced,sprawling,stage,stalk,stellae,straight,tal,tamen,tem,throughout,time,transparent,unit,unknow,uvenile,vary,wide,yellowish,ympodial	abaxial,adaxial,anther,arrangement,colour,corolla,filament,form,growth,height,history,interjected,leaf,leaflet,life,na,ovary,perennial,plant,position,presence,pseudostipule,seed,shape,size,staman,stem,terminal,texture,tuber,type
62	wfo-0001026229	success	299	105	73	226	32	0.244	1,5,abaxial,adaxial,anther,base,beneath,berry,black,blade,branching,brown,calyx,clavate,cm,corolla,cylindrical,dark,densely,diameter,drying,elliptic,flattened,flower,fruit,glabrescent,glabrous,globose,golden,green,growth,hirsute,immature,inflorescence,internodal,lateral,leaf,lobe,lobed,long,mature,membranaceous,mm,moderately,narrowly,oblong,ovate-elliptic,pale,papillose,pedicel,peduncle,petiole,pubescent,purple,reniform,shiny,shrub,simple,size,spreading,stellate,stem,stigma,style,subopposite,surface,terminal,tube,upper,white,wide,yellowish-white,¾	0.1–1.47,0.2–0.8,0.35,0.3–0.9,0.3–1.2,0.4,0.8–1.2,0.8–2,0.9,0.9–4.3,1-celled,1.2–4.8,1.3–1.5,1.3–1.7,1.4,1.7–11.8,1.7–2.3,1.8,1.8–5.5,1.9–2.5,1/3,13,1–1.4,1–2,1–4,2,2.3–3.4,2.8–4,2–3,2–3-celled,2–4-celled,3,35,3–4,3–5,4.5–6.5,4–6,5-merou,5–9,6–15,6–7,6–8,8.6–12,8–10,9–31,abaxially,accrescent,acuminate,acute,adaxiall,adaxially,ag,almost,also,always,alyx,anthesi,apex,ark,articulated,associated,asymmetric,attenuate-caudate,axe,ba,barely,branch,broadly,broken,camptodromous,capitate,celled,central,changing,commentary,commonly,completely,concentrated,connivent,cordate,covered,creating,cuneate,cyme,deltoid,develope,developed,differing,directed,discolorous,di­,dried,eaf,eed,eglandular,ellipsoidal,elongated,entire,even,faces,few-rayed,found,free,frequently,fresh,fully,geminate,gland,glandular,glandular-capitate,hair,head,hispid,hyaline,ilament,impressed,included,insertion,introrsely,involute,irregular,lamina,lanceolate,larger,less,like,long-stalked,longer,longitudinal,lower,mainly,margin,material,maturit,midpoint,midri,midvein,minute,mixed,much,multangulate,multangulate-stellate,multiseriate,narrow-ovate,near,nearly,new,nflorescence,often,old,older,one,open,opening,orientation,orolla,other,oung,ovate,pair,paired,pedunculate,per,perfect,pink,pit,plurifoliate,point,poorly,pore,poricidal,porrect-stellate,portion,primary,purplish,ra,rachi,raised,rarely,ray,remnant,revolute,rounded,ruit,secondary,see,sessile,shin,short-,short-stalked,shorter,slightly,slit,small,smaller,solitary,sometimes,somewhat,sparsely,spread,spreadin,stalk,strongly,subsessile,supported,surfac,three,tree,trichome,trifoliate,tuft,type,ud,unbranched,unequal,unit,usually,vary,vein,venation,vestiture,visible,weakly,whitish-green,yellow,ympodial	0.1-1.47,0.3-1.2,0.35-4.3,1-1.4,1-2,1.2-4.8,1.3-1.7,1.7-11.8,1.7-2.3,1.8-5.5,1.9-2.5,2.3-3.4,2.8-4,5-merous,6-7,6-8,arrangement,colour,filament,form,height,history,length,life,ovary,perennial,plant,position,seed,shape,staman,texture
63	wfo-0001026230	success	144	86	52	92	34	0.361	.25,.5,.8,0.3-1.5,0.5-3,0.9-2,1-1.4,1-1.5,1.1-1.8,12.6-20.8,2-4,3-4,4.6-9.3,anther,area,calyx,clavate,cm,corolla,dia,elliptic,filament,fruit,glabrous,globose,green,grey,lateral,leaf,lobe,lobed,minutely,mm,opposite,ovary,papillose,pedicel,petiole,poricidal,shrub,simple,slightly,small,stem,stigma,strongly,style,tip,tree,tube,white,x	0.75-1,1-4,1.8-2.3,1.9-4.1,2-5,5-10,5-20-flowered,acuminate,acute,anisomorphic,anisophyllou,anthesi,apart,apex,apiculate,appears,back,bark,base,beginning,beneath,berry,broadly,bud,clu,completely,cordate,coroll,deflexed,deltoid,difoliate,distal,eaf,edicel,eed,enclosing,erect,evenly,except,free,fruiting,geminate,immature,inflorescenc,large,lon,long,long-acuminate,long-triangular,lower,main,major,margin,middle,minor,nearly,nflorescence,obtuse,older,orbicular,ovoid,pair,pointed,pore,portion,raised,reflexed,rounded,ruit,rusty-papillose,scar,shaped,sinus,slender,spaced,straight,surface,tall,tapering,tear-drop,thickened,ud,umbonate,unit,unknown,vein,white-lenticellat,widest,winged,woody,ympodial,young	abaxial,adaxial,anisophyllous,arrangement,blade,cell,colour,diameter,flower,form,growth,height,history,inflorescence,interjected,leaflet,length,life,na,peduncle,perennial,plant,position,presence,pseudostipule,seed,shape,size,staman,terminal,testal,texture,tuber,type
64	wfo-0001026233	success	165	100	63	102	37	0.382	-1,-1.9,-3.8,-5.5,-50,.25,.75,0.7-0.8,0.8-1.55,0.8-4,1.2-2.7,2.1,2.3-7,2.4-3.5,2.6,3.5-4.5,5-30,6,annual,anther,antrorse,apex,base,calyx,campanulate,capitate,cm,curved,cylindrical,densely,diameter,ellipsoidal,elliptic,filament,glabrous,globose,herb,leaf,less,lilac,lobe,lobed,mm,moderately,near,ovate,pale,petiole,pubescent,scarcely,seed,simple,sparsely,stigma,style,trans-ovoidal,trichome,tube,tuberculate,unifoliate,uniseriate,x,yellow	-8.1,0.3,0.5,0.7-,0.8-1.3,1,1-,1.1,1.5,1/2,2,2-,2/3,3.2-3.7,3.2-4.7,4-,5-6.2,abundant,accrescent,acute,ag,annular,articulated,ascending,basal,bearing,berry,broadly,coat,conspicuous,cuneate-attenuate,difoliat,dimorphic,eaf,eed,embryo,entire,evident,few-,fruiting,hair,herbaceous,hig,interlobular,investing,lamina,larger,long,longitudinal,longitudinally,lower,margin,membrane,minutely,multicellular,narrowly,non-glandular,obtuse,occasionally,opening,orolla,other,outer,ovule,papery-scarious,partially,pinnatipartite,pinnatisect,pore,poricidal,portion,present,protuberance,pubescen,ree,reticulate,ridged,rounded,ruit,seede,serrate,shorter,slender,slightly,slit,small,smaller,striate,strongly,styl,subglobose,surface,tem,tip,unequal,unit,vary,venatio,verrucose,wider,winged,ympodial	abaxial,adaxial,arrangement,blade,cell,colour,corolla,difoliate,flower,form,fruit,growth,height,history,inflorescence,interjected,lateral,leaflet,length,life,na,ovary,pedicel,peduncle,plant,position,presence,pseudostipule,shape,size,staman,stem,terminal,testal,texture,tuber,type
65	wfo-0001026241	success	220	105	78	142	27	0.355	0.5,0.5–0.7,0.5–0.8,0.7–1.1,1.2–2,1.5–1.7,1.5–2.5,1.5–3.5,1.9–2.1,109,1–,1–1.1,1–1.4,1–1.5,1–2,2.5–3,2–2.1,2–3,3–3.1,4.5–5,5-merous,anther,black,brittle,brown,calyx,capitate,cell,cm,cordate,corolla,dia,dry,et,filament,flower,fruit,galiano,glabrous,glandular-pubescent,globose,herb,inflorescence,internodal,lateral,leaf,leaflet,lobe,lobed,mm,orangish,outline,ovary,ovate,ovoid,papillate,pedicel,peduncle,perennial,perfect,petiole,pinnatifid,pubescent,reniform,seed,shiny,sinuate,stellate,stem,stigma,style,subshrub,terminal,ternate,triangular,tube,white,x	.2,.3,.5,0.1–0.15,0.2–,0.3–,0.3–0.4,0.3–0.6,0.3–1,0.5–1,1-,1-celled,1.2–1.5,1/3–1/2,10-20,2-flowered,3,3-,30–50,4-,5,5-celled,6,abaxially,adaxially,always,anthesi,apex,apical,appearing,appears,articulated,attenuate,ba,basal,base,basiscopically,beak,berry,branching,broader,campanulate,center,conical,connecting,covered,cup,curved,curving,darker,decurrent,deflexe,dehiscing,deltate,densely,denser,depressed-globose,difoliate,discrete,drying,dwarf,eaf,eglandular,elliptic,enclosed,entire,equal,erect,erose,extended,foliat,foliose,free,fruiting,geminate,gland,glandular,intially,irregularly,larger,like,lon,long,longitudinal,main,margin,midvein,mixture,much,near,nflorescence,oblique,one,onto,open,papillat,per,pericarp,pitted,pore,portion,prolonged,pubescen,pulp,rachi,remain,robust,ruit,shallowly,simple,slightly,slit,small,smaller,sometimes,somewhat,spatulate,stamen,stout,strongly,succulent,sulcate,surface,taproot,testa,thick,thickened,tip,tissue,trichome,truncate,tuberculate,ud,uniseriate,unit,usually,vein,way,wide,wing,woody,ympodial	30-50,abaxial,adaxial,arrangement,blade,colour,diameter,form,growth,height,history,interjected,length,life,na,plant,position,presence,present,pseudostipule,shape,size,staman,testal,texture,tuber,type
66	wfo-0001026242	success	210	101	71	139	30	0.338	0-2,0.4-0.5,0.4-2,0.5-1,0.55-0.9,0.7-1.3,1-1.5,1-2.5,1.5-3,1.5-4,2-2.5,2.5-2.8,2.5-4.5,3-6.5,7-17,abaxial,almost,anther,berry,blade,branched,bright,calyx,cm,curved,diameter,dull,elliptic,erect,evenly,filament,filiform,flattened-reniform,flower,fruit,glabrescent,glabrous,glandular,green,hair,lateral,leaf,length,lobe,lobed,long,maturity,minute,mm,orange-brown,pale,pale-brown,pedicel,peduncle,petiole,poricidal,red,red-brown,shrub,spherical,stellate-pubescent,stem,straight,style,tapering,tip,tube,white,wide,yellow,young	-0.9,-1.5,-2,-5,-6,/4,0,0.05-0.2,0.1,0.3-0.5,0.35-,0.4-0.55,0.5,0.5-0.7,0.7,1-3,1.2-2,1/2,1/5-1/3,1/6-1/4,10-,10-20,2-5,30-80,4-10,4-13,4-5-merous,4.5-5.5,5-,5-18,5-7,6.5-8,8-20,abaxially,acut,acute,alyx,ame,apar,apart,apex,apically,apparently,articulated,bark,base,broad-deltate,c.,concolorous,connivent,cuneate,deltate,densely,difoliate,distance,drying,eaf,eed,elongating,equal,extending,eye,flattened,free,fruiting,geminat,glabrou,green-gra,infructescence,irregularly,largely,longer,lower,margin,mature,membranous,midpoint,midvein,moderately,multangulate,naked,narrow-deltate,nflorescence,obtuse,occasionally,older,one,open,orolla,oung,pair,per,perfec,pericarp,porrect,portion,prickl,prickle,prickly,primary,ray,recurved,reflexed,rounded,ruit,scar,sessile,shorte,shorter,side,simple,smooth,sometimes,spaced,sparsely,spreading,stalk,stalked,stellate,subentire,surface,tamen,terete,tertiary,time,trichome,unarme,unarmed,unit,upper,variously,vary,vein,venation,visible,way,weakly,woody,ympodial	0.35-0.55-0.9,adaxial,arrangement,colour,corolla,form,growth,height,history,inflorescence,interjected,leaflet,life,na,ovary,perennial,perfect,plant,position,presence,pseudostipule,seed,shape,size,staman,stigma,terminal,texture,tuber,type
67	wfo-0001026259	success	233	97	84	149	13	0.361	.1,.7,.8,0.3–1.2,0.4–0.6,0.7–0.9,1.0–1.2,1.0–3.3,1.2–8.4,1.4–4.0,1.5,1.5–2.0,12–24,2–17,3.0–3.4,5-merous,6,8–11,abaxial,adaxial,anther,berry,broadly,brown,calyx,cell,cm,concave-reniform,corolla,densely,diameter,ellipsoid,filament,fleshy,flower,fruit,glabrous,globose,green,green-orange,herb,inflorescence,internodal,lateral,leaf,length,lilac,lobe,long,membranous,minutely,mm,nearly,outline,ovary,ovate-lanceolate,papillate,pedicel,peduncle,pentagonal,perfect,petiole,plant,pubescent,purple-coloured,rarely,ripe,shiny,shrub,simple,smooth,somewhat,sparsely,stellate,stem,stigma,style,testal,translucent,tube,turning,white,wide,young	0.1–0.2,0.2–0.4,0.5,0.5–0.6,0404,0–2,1,1-celled,11–22,1m,1–2,1–2-celled,1–3-celled,2-ridged,2/3,2–3-celled,35–45,4–5,5–14,5–7-celled,7–10,?,abaxially,acuminate,acute,adaxially,affected,age,anthesi,apar,apex,appressed,arising,base,becoming,beyond,branch,branched,branching,central,close,coloured,cone,congested,conical-ellipsoid,cream-coloured,cylindrical,decurrent,dehiscing,deltate,difoliate,drop,eaf,eed,elongating,end,entire,especially,et,exerted,free,fruiting,geminat,gradually,growt,halfway,hilum,individual,knapp,larger,leave,lengthening,less,like,live,lobed,lon,longer,lower,lowermost,margin,much,narrower,narrowly,near,nflorescence,node,occasionally,often,once-branched,one,pair,pale,pathogen,per,pericarp,pore,poricidal,portion,positioned,primary,purple,purple-black,rachi,recurving,reduced,reflexed,relatively,remaining,rounded,ruit,scar,short,shorter,similar,slightly,slit,sometimes,spaced,splitting,spreading,star,stone,stout,straight,strongly,sub-laterally,surface,tall,tapering,tem,thick,tightly,tinged,tip,together,toward,trichome,two,ud,uniseriate,unit,vein,winged,woody,yellow,yellow-green,ympodial,–15	arrangement,blade,colour,form,growth,height,position,seed,shape,size,staman,texture,type
68	wfo-0001026262	success	179	122	91	88	31	0.508	0.25-0.5,0.5-1,0.8-1.4,1-2,1.5,1.5-2,10-15,2-2.5,2-5,3,3-10,3-6,4-15,4-6,5-8,7-13,7-9,abaxial,abaxially,absent,adaxial,adaxially,anther,apparently,armed,attenuate,base,blade,brown,calyx,chartaceous,cm,connivent,cylindrical,dark,densely,diameter,discolorous,extra-axillary,filament,flower,fruit,glabrous,globose,green,hair,immature,leaf,light,like,lobe,lobed,long,mature,midpoint,mm,moderately,mottling,nearly,netlike,orange,ovate,pedicel,peduncle,perfect,petiole,pit,porrect-stellate,prickle,pubescent,raised,reniform,ridge,rusty,scandent,separated,shrub,simple,slightly,stellate,stem,stigma,style,tan,tapering,tube,unbranched,unlobed,vine,white,x	0.2-0.6,0.5,0.5-1.5,0.5-1mm,0.75-1.5,1,1-.,1-5,2-3,30,4-10,4-7,4-8,5-merou,absen,accrescent,acute,adaxiall,alyx,apar,apex,apical,asymmetrical,axe,berry,beyond,contiguous,cordate,difoliate,directed,distal,eaf,eed,either,em,end,expanded,exserted,filiform,frui,fruiting,geminate,glabrou,gree,interpetelar,intorsel,lacking,lower,major,midrib,midvein,multicellular,multiseriate,narrowly,nflorescence,obscure,obtuse,occasionally,often,orolla,pair,per,pore,rachi,ray,recurved,roselike,ruit,secondary,side,spaced,sparsely,stalk,stamen,ste,surface,tamen,tissue,triangular,unarmed,unequa,unicellular,unit,vary,vein,wide,yellow,ympodial	1-4,5-merous,arrangement,cell,colour,corolla,form,growth,height,history,inflorescence,interjected,lateral,leaflet,length,life,na,ovary,plant,position,presence,pseudostipule,seed,shape,size,staman,terminal,testal,texture,tuber,type
69	wfo-0001026267	success	162	105	72	90	33	0.444	.25,0.5-1,0.6-1.7,0.7-1.1,1-1.2,1-1.5,1-2.6,1.5-2,2.5-3,3-15,3-6.1,5-7,8.5-15,anther,base,blackish,bright,calyx,cm,corolla,dia,drying,filament,flattened-reniform,glabrous,globose,green,greyish-green,hard,lateral,lavender,leaf,lobe,lobed,maturity,minutely,mm,narrowly,nearly,often,opposite,ovary,ovate,pale,papillose,pedicel,petiole,pitted,poricidal,quickly,remaining,ripening,scattered,shrub,simple,size,small,softening,stem,stigma,straight,style,tan,tinge,tip,tree,trichome,tube,uniseriate,white,x,yellow-green	.5,0.1-1,1-4,1.5-2.3,20-30-flowered,3.2-8.6,4-8,8-10,acuminate,acute,anthesi,apex,attenuate,axil,ba,bark,beginning,beneath,berry,body,broadly,closely,crateriform,cuneate,decurrent,deflexed,densely,depressed,differing,difoliate,distally,distinct,eaf,edicel,eed,except,exerted,free,fruiting,geminat,greenish-white,incrassate,inflorescenc,larger,lon,long,longinflorescence,lower,main,major,margin,middle,minor,occasionally,older,one,overlapping,pair,papillo,pitting,pore,portion,pubescent,raised,reflexed,rough,ruit,scar,scarious,shaped,slender,slightly,soon,spaced,sparsely,surface,tall,tapering,tear-drop,triangular,tuft,ud,unit,vein,widest,wing,winged,woody,ympodial,young	abaxial,adaxial,arrangement,blade,cell,colour,diameter,flower,form,fruit,growth,height,history,inflorescence,interjected,leaflet,length,life,na,peduncle,perennial,plant,position,presence,pseudostipule,seed,shape,staman,terminal,testal,texture,tuber,type
70	wfo-0001026272	success	182	117	88	94	29	0.484	1,1-1.5,1.5-2,12-15,2-2.5,2-3,2-7,3-4,3-5,3.5-4,4-5,5-8,7-10,7-8,abaxial,anther,apiculate,base,beyond,brown,calyx,clavate,cm,coriaceous,corolla,corymbose,cream-colored,cyme,densely,diameter,elliptic,exserted,filament,flattened,flower,form,glabrous,glandular,globose,green,growth,heterostylous,inflorescence,internodal,lanceolate,lobe,lobed,long-styled,mm,obelliptic,ovary,ovoid,pedicel,peduncle,petiole,pitted,poricidal,porrect,pubescence,pubescent,reddish,reniform,reticulately,rugose,rusty,scabrous,scandent,shrub,simple,somewhat,stellate,stem,stigma,style,subcoriaceous,tapering,thick,tip,trichome,tube,unarmed,velutinous,viscid-pubescent,way,white,x,yellowish,¾	0.2-0.3,1-1/5,1-2,1-2-celled,1.2-1.5,1/3,20,20-30,6-8,abaxially,adaxially,age,anthesi,apex,armed,articulated,bark,basal,berry,branched,celled,denser,discolorous,distal,eaf,eed,epidermi,erect,free,fruiting,fused,lengthening,like,long,lower,many,midpoin,midpoint,minute,mixed,multangulate,multicellular,new,nflorescence,numerous,oblong,older,partially,pendant,per,perfect,pericarp,plurifoliat,pore,porrect-stellate,portion,prickle,prickly,quarter,rachi,raise,recurved,reduced,ruit,scar,sessile,short-styled,slightly,slit,spaced,sparse,sparsely,stalked,staminate,sub-sessile,subconical,subglobose,subtruncat,surface,terete,testa,time,triangular-lanceolate,turbinate,ud,unarme,unevenly,unicellular,unit,upper,venation,visible,woody,ympodial	adaxial,arrangement,blade,cell,colour,fruit,height,history,interjected,lateral,leaf,leaflet,length,life,na,plant,position,presence,pseudostipule,seed,shape,size,staman,subtruncate,terminal,testal,texture,tuber,type
71	wfo-0001026279	success	248	120	91	157	29	0.367	-34.3,-5.9,0.2-0.4,0.25-0.4,0.8-2.3,1-1.4,1-10,1-3.5,1.1-1.6,1.1-1.9,1.5-1.8,1.5-3,1.7-2.3,1.9-3,11.5-19.7,14-27,3-4,3.1-4.2,3.4-5.2,3.5-7.8,3.8-5.1,8,9-22,acuminate,anther,apex,black,blade,blunt-tipped,branched,brown,calyx,capitate,cm,corolla,cylindrical,dark,deltoid,diameter,drying,elliptic,elongated,filament,flower,fruit,glabrescent,glabrous,globose,granular,grayish,green,immature,lanceolate,lateral,lavender,leaf,length,lilac,lobe,many,mature,mm,oblong,occasionally,pale,pedicel,peduncle,perfect,petiole,plant,pseudo-terminal,reticulate-punctate,rounded,scabridulous,scabrous,shrub,simple,stellate,stem,stigma,style,suborbicular,time,tomentose-pubescent,tree,tube,white,whitish,x,yellowish,yellowish-tan	-11.4,-2.9,-4,/14-1/8,0.9-1,0.9-1.8,1.9-3.2,1/2,2.4-3.2,2.5-3.2,2.6-4.8,2/3,3.1-3.6,4-7.5,5-200,5-8,8-11,8.5-10.5,abaxially,accrescent,acute,adaxiall,adaxially,ag,anthesi,apart,apparently,appearing,appressed,ark,around,articulated,attenuate,axe,axillary,ba,base,berry,branch,bud,chartaceous,closely,completely,conical,covering,cuneate,dendritic-echinoi,dendritic-echinoid,dense,directed,distally,due,eaf,earl,echinoi,echinoid,edge,eed,entire,enveloping,equal,evident,exerted,expanded,farinose,few-rayed,fleshy,free,fruiting,glabrescen,grayish-green,hair,half,inserted,lengthening,lobed,long,long-stalked,longer,longitudinal,longitudinall,lower,m.,main,margin,midrib,minute,mixed,multangulate,multangulate-pubescent,multiseriate,narrowly,nflorescence,obovate,occasional,often,older,open,orbicular,orolla,ovate-lanceolate,overlapping,partly,plurifoliate,pore,poricidal,porrect-stellate,present,prominent,pubescence,rachi,ruit,scattered,secondary,semi-ovate,sessile,short,short-,short-decurrent,short-stalked,side,slightly,slit,slowly,somewhat,spaced,splitting,stalk,stamen,subcampanulate,subcoriaceous,subsessile,sulcate,surface,suture,tall,tamen,tertiary,thickened,thin,thin-stalked,tip,tomentose,ud,unarme,unarmed,unit,unwinged,upper,usually,vary,vein,way,wide,yellow,ympodial,young	abaxial,adaxial,arrangement,cell,colour,form,growth,height,history,inflorescence,interjected,leaflet,life,longitudinally,na,ovary,perennial,position,presence,pseudostipule,seed,shape,size,staman,terminal,testal,texture,tuber,type
72	wfo-0001026292	success	190	114	82	108	32	0.432	0.25-0.5,0.5-1,0.5-2,0.75-1.25,1-1.5,1-3,1-8,1.5,1.5-2,10-15,12-16,2-4,2.5-3.5,20-25,3-15,3-9,5-10,abaxially,absent,adaxial,adaxially,anther,attenuate,blade,brown,bud,calyx,chartaceous,cm,connivent,curved,cylindrical,dark,diameter,distal,end,extra-axillary,filament,flower,fruit,glabrous,globose,green,immature,leaf,lobe,lobed,many,mature,mm,moderately,nearly,netlike,orange,orange-red,ovate,pedicel,peduncle,petiole,pit,pubescent,raised,reniform,ridge,separated,shrub,simple,small,sparsely,spreading,stem,stigma,style,tan,tapering,tube,unbranched,upward,white,whitish,wide,x	-13,0.5,0.5-1.5,1-2.5,1-5,1.5-2.5,1.5-8,1/3,13-17,2-3,2-6,3-5,3-8,30-40,4-8,5-merou,absen,accrescent,acute,adaxiall,alyx,apar,apex,apical,apparently,armed,asymmetrical,axe,base,berry,beyond,cordate,cut,densely,difoliate,directed,discolorous,distally,eaf,eed,either,expanded,exserted,filiform,flattened,frui,fruiting,geminate,glabrou,gree,hair,introrsel,lanceolate,less,like,lon,long,lower,major,margin,midpoint,midrib,midvein,multicellular,multiseriate,nflorescence,obscure,obtuse,occasionally,often,orolla,pair,per,perfect,pore,porrect-stellate,prickle,rachi,ray,recurved,reflexed,roselike,ruit,scandent,secondary,side,sinus,slightly,spaced,stalk,stamen,stellate,surface,swollen,tamen,tem,thin-skinned,triangular,unarmed,unequa,unicellular,unit,vary,vegetatio,vein,way,yellow,ympodial	5-merous,abaxial,arrangement,cell,colour,corolla,form,growth,height,history,inflorescence,interjected,lateral,leaflet,length,life,na,ovary,perennial,plant,position,presence,pseudostipule,seed,shape,size,staman,terminal,testal,texture,tuber,type
73	wfo-0001026298	success	192	107	79	113	28	0.411	0.2-4,0.25-0.5,0.3-2,0.4-1,0.5-2,0.5-3,0.6-1.5,0.75-1,1-1.5,1.5-2.5,1.5-4,2850,3-4,3-6,3/4,4-13,8-28,anther,area,base,blade,broadened,calyx,cm,corolla,dia,difoliate,elliptic,fide,filament,flower,glabrate,glabrous,globose,golden,green,haught,inflorescence,lateral,leaf,length,lobe,lobed,long-styled,minutely,mm,obovate,opposite,ovary,ovoid-reniform,pale,pedicel,petiole,pitted,plant,poricidal,red,reddish,rhizomatous,shape,short-styled,shrub,simple,size,sometimes,somewhat,stem,stigma,straight,style,surface,tip,treelet,tube,unit,way,white,x,yellowish-tan	.5,0.1-0.3,0.8-2,1.4-6,1.5-9,2-3,5-30-flowered,7-12,acuminate,acute,along,american,anthesi,apex,appearing,appressed,auriculate,ba,bark,bearing,beginning,beneath,berry,bu,caudate,central,closely,conical,corky,costa,deflexed,deltoid,densely,differing,distal,dry,eaf,edicel,eed,ellipsoid,erect,even,exsertion,free,fruiting,geminat,greyish,impressed,inflorescenc,later,locality,lon,long,long-triangular,lower,main,major,margin,material,middle,midrib,minor,minute,nflorescence,oblique,occasionally,often,older,one,orbicular,overlapping,pair,papillo,papillose,peelin,planar,pore,portion,prominent,puberulent,rarely,rather,reflexed,rest,rican,rough,rounded,ruit,scar,scattered,shaped,shorter,single,slender,spaced,tall,tapering,tear-drop,thick,third,time,trichome,two,ud,unicellular,uniseriate,variable,varying,vein,widest,woody,ympodial,young	abaxial,adaxial,arrangement,cell,colour,diameter,form,fruit,geminate,growth,height,history,interjected,leaflet,life,na,peduncle,position,presence,pseudostipule,seed,staman,sympodial,terminal,testal,texture,tuber,type
74	wfo-0001026299	success	239	104	80	159	24	0.335	0.25-0.5,0.4-0.5,0.5-0.7,0.5-1,0.5-2.5,0.7-3.5,0.8-1,1,1-1.4,1.1-1.7,1.2-5,1.8-2,2.2-3.2,6-20,7-12,anther,base,beneath,broadly,brown,calyx,capitate,cell,cm,corolla,dark,densely,diameter,elliptic,filament,flower,fruit,glabrous,glandular,globose,green,hair-like,herb,imparipinnate,inflorescence,interjected,interrupted,lateral,leaf,leaflet,less,lobe,long,long-acuminate,minute,minutely,mm,nearly,obovate,outgrowth,ovary,pale,pedicel,peduncle,pentagonal,perennial,petiole,present,pseudostipule,pubescent,short,simple,size,sparsely,stem,stigma,straight,stripe,style,tall,terminal,tube,variously,woody,yellow	--,-0.8,-1,-10,-2.5,-3.5,-5,.5,0-8,0.1-0.2,0.1-0.25,0.1-0.4,0.1-0.5,0.15-0.2,0.2-0.25,0.2-1,0.3-0.4,0.4-2,0.5,0.5-0.6,0.6-2,0.8-0.9,0.9-1,1-celled,1.2-1.6,1.5-,1.5-2.3,2-4,2-6,2-foliate,2-locular,2.5,2.5-7,25,3-,3.5-10,5,5-15,5-20,abaxially,absent,abundant,acroscopically,acute,adaxially,almost,along,angled,anthesi,apex,apical,appearance,appendage,approximately,articulated,axi,basal,basiscopically,berr,bract,bracteate,change,chota,column,conical,could,crenat,crenate-serrate,decurrent,developed,diamete,distal,eaf,ebracteate,edicel,eed,eglandular,entire,erect,exserted,fruiting,give,gree,hal,half,head,intermixed,internode,investing,irregularly,jequetepeque,lacking,lanceolate,larger,like,lobed,lon,longer,loosely,lower,marañón,margin,maturity,middle,mixture,multicellular,narrowly,nflorescence,node,oblique,occasionally,often,pair,patent,petiolule,population,primary,prostrate,pubescence,purple,rachi,reflexed,regularly,rest,ruit,scarcely,scattered,secondary,sessile,silky,sparse,spreading,staminal,sterile,stout,surface,tem,tertiary,testa,thick,tip,toward,trichome,truncate,ud,unicellular,uniseriate,unit,usually,valley,vein,velvety,wall,way,weak-walled,white,wide,winged,ympodial	1.5-10,3-15,abaxial,adaxial,arrangement,blade,colour,form,growth,height,history,length,life,na,plant,position,presence,seed,shape,staman,testal,texture,tuber,type
75	wfo-0001026305	success	135	97	62	73	35	0.459	0.2-1,0.5-2,0.6-1,0.7-1,1-1.5,2-2.5,2.5-3,3-8.5,4-4.5,5-7,6-9,7-16,abaxial,abaxially,adaxially,anther,area,calyx,cm,corolla,densely,dia,difoliate,elliptic,filament,glabrate,glabrous,globose,green,greenish-white,lateral,leaf,leaf-opposed,lobe,lobed,minute,minutely,mm,occasionally,ovary,ovoid-reniform,pale,papillose,pedicel,petiole,pitted,pore,poricidal,pubescent,shaped,shining,shrub,simple,stem,stigma,style,tan,tear-drop,tip,tube,unifoliate,x	.25,/4,0.25-0.5,1.3-1.5,2-6-flowered,7-9,acute,along,anthesi,apex,apical,attenuate,ba,bark,base,beige-tan,berry,closely,congested,conical,dark,deflexed,deltate,dendritic,drying,eaf,edicel,eed,exserted,free,fruiting,geminat,interlocking,knob-like,lamina,like,lon,long,lower,main,margin,middle,midrib,nflorescence,older,overlappin,pair,planar,portion,projection,reddish-brow,rounded,ruit,scar,scattered,slender,spaced,sparsely,strongly,styl,surface,tall,trichome,tub,ud,unit,vein,visible,way,widest,woody,ympodial,young	0.25,adaxial,arrangement,blade,cell,colour,diameter,flower,form,fruit,geminate,growth,height,history,inflorescence,interjected,leaflet,length,life,na,peduncle,plant,position,presence,pseudostipule,reddish-brown,seed,shape,size,staman,terminal,testal,texture,tuber,type
76	wfo-0001026307	success	193	101	79	114	22	0.409	.6,.8,0.2–0.5,0.2–1.5,0.5–0.7,0.5–5.0,0.8–5,1.0–1.2,1.0–2.4,2.0–3.5,2.6–13,3.0–4.0,3.5–7.0,4–5.7,5-merous,8–12,abaxial,adaxial,anther,black,broadly,calyx,cell,central,clavate,cm,corolla,cylindrical,densely,diameter,eye,filament,flattened-reniform,flower,fruit,glabrous,globose,green,growth,herb,internodal,lateral,length,lobe,long,membranous,minutely,mm,outline,ovary,ovate,paler,pedicel,peduncle,pentagonal,perfect,petiole,pubescent,purple,purple-yellow,ripe,shape,shrub,simple,sparsely,stellate,stem,stigma,style,testal,tinged,tube,turning,vigorous,weak-stemmed,white,wide,yellow,yellow-green	.0–1.2,.3,.5,.5–4.0,0.4,0.5–0.6,0.6,0.8–0.9,0.8–2,1.0–1.5,1.0–2.0,1.0–2.5,1–3-celled,1–6-celled,2.0,2.0–3.0,2/3,35–45,3–8,3–8-celled,5–7,9,abaxially,acute,acute-acuminate,adaxially,age,angled,anthesi,apar,apex,appressed,articulated,base,becoming,berry,beyond,cone,cuneate,decurrent,difoliate,eaf,eed,ellipsoid,end,entire,exerted,facing,free,fruiting,geminat,glandular,gradually,hilum,later,lengthening,like,lobed,longer,lower,margin,middle,narrower,narrowing,new,nflorescence,one,pair,papillat,per,pore,poricidal,portion,positioned,primary,recurved,reflexe,reflexed,restricted,ruit,scar,shallow,shallowly,shorter,side,slightly,slit,spaced,spreading,ste,stone,straight,strongly,sub-laterally,surface,tal,tem,three,tip,toward,translucent,triangular,trichome,two,ud,undulate,unequal,unevenly,uniseriate,unit,upper,variable,vein,ympodial	arrangement,blade,colour,form,height,inflorescence,interjected,leaf,leaflet,na,papillate,plant,position,presence,pseudostipule,seed,size,staman,terminal,texture,tuber,type
77	wfo-0001026317	success	169	97	79	90	18	0.467	/4,0.25-1,0.3-1.2,0.5,0.5-0.6,0.8-1,1-1.2,1-1.5,10-12,2-2.5,2-4,2.5-10,3-3.5,4-5,acuminate,acute,anther,apex,attenuate,bark,base,berry,bright,brown,calyx,capitate,clonal,cm,corolla,dark,dendritic,densely,diameter,elliptic,entire,filament,flattened,flower,glabrous,globose,growth,inflorescence,internodal,less,lobe,lobed,margin,mm,narrowly,orange,ovary,pair,pale,pedicel,peduncle,perfect,petiole,plant,primary,pubescence,pubescent,red,reniform,shiny,shrub,simple,sparsely,stem,stigma,style,terminal,trichome,tube,uniseriate,vein,way,white,x,yellowish	.5,0.5-0.8,0.5-1,0.6-,0.7-0.9,1-5.7,2-,3,3-foliate,3.5-15,50-200,6-8,6x,?,abaxially,absent,adaxially,age,anthesi,apart,apically,approximately,branched,closely,conical,correlated,deltate,dense,distally,drying,eaf,eed,em,erec,erect,essentially,exerted,extremely,found,free,fruiting,geminat,halfwa,lamina,lengthening,like,longer,lower,many,maturity,minutely,new,nflorescence,nodding,occasionally,often,packed,papillat,papillate,per,pericarp,pitted,planar,plane,population,pore,poricidal,portion,pubescen,pulp,rachi,reflexed,ruit,scar,slightly,slit,sticky,straight,surface,swollen,thin,time,tip,toward,triangular,ud,unit,variable,woody,ympodial	2,2-15,arrangement,blade,colour,form,fruit,height,history,leaf,length,life,number,position,seed,shape,size,texture
78	wfo-0001026321	success	213	93	70	143	23	0.329	.5,0-0.2,0.1-0.4,0.5-0.6,1.2-3.5,1.5-3,2-7,2.5-5.5,2.7-3.1,3-10,3-4,3.5-8.5,4-,4.5-6,7-9,8-20,adaxial,anther,blade,broadly,brown,calyx,chartaceous,cm,cylindrical,densely,diameter,extra-axillary,flower,fruit,glandular-puberulent,globose,green,grey-green,herbaceous,inflorescence,lanceolate,leaf,leaf-opposed,length,lobe,long,mm,moderately,orbicular,ovate,pale,pedicel,peduncle,petiole,plant,prostrate,pseudo-racemose,resprouter,rusty,simple,solitary,sprawling,stellate,stellate-pubescent,stigma,style,thick,throughout,tube,unbranched,white,x,yellow,yellowish-green	%,0-0.1,0-0.25,0-0.3,0-2,0-3.5,0.1-0.2,0.1-0.3,0.3-0.6,0.4-0.6,0.4-0.7,0.6-0.9,1-1.2,1-1.5,1-2,1-3,1-4,1-5,1-locular,1.2-1.7,10-17,2-3,2-4,2-5,2-5.5,20-40,30-65,4.5,5-25,5-merou,50-100,6-10,6-11,7-10,8-11,abaxially,absent,accrescent,acicular,across,adaxiall,adaxially,adult,also,alyx,andromonoecious,apart,apex,armed,articulated,ascending,attenuate,axe,ba,base,bisexual,branchlet,capitat,central,connivent,cordate,cross-section,decimetre,deltate,directed,distall,eaf,eed,eglandular,elliptica,entire,exocarp,finger,frui,fruiting,functional,glabrous,gland-tipped,glandular,greenish-white,hair,half,halfway,heterostylous,hig,incomplete,juicy,juvenile,lateral,less,lobed,longer,lower,margin,mature,mesocarp,mid-point,midpoint,midrib,midvein,minute,moist,nflorescence,oblique,obtuse,orolla,pair,part,per,placenta,pore,porrect,present,prickle,rachi,ray,rostrate,ruit,septum,sessile,shallowly,shallowly-lobed,short,side,spaced,sparse,stalk,stellae,straight,surface,tamen,tem,time,transparent,unarme,unarmed,unit,unknow,upper,vary,weakly,wide,ympodial	5-merous,abaxial,arrangement,capitate,colour,corolla,elliptical,filament,form,growth,height,history,life,na,ovary,position,seed,shape,size,staman,stem,texture,type
79	wfo-0001026325	success	216	117	67	149	50	0.31	.2,0.5,2,3,5-merous,anther,blade,blue-violet,calyx,cm,cylindrical,darker,densely,diameter,ellipsoid,elliptic,extra-axillary,filament,finely,flattened-reniform,flower,foveolate,fruit,glabrous,green,herb,hermaphroditic,heteromorphic,inflorescence,lanceolate,lateral,leaf,lenticular,less,light,lobe,maturity,mm,mottling,narrowly,oblong,ovate-elliptic,ovoid,pale,pedicel,peduncle,perennial,petiole,pubescent,rotate-stellate,simple,sometimes,staminate,stellate,stellate-pentagonal,stellate-pubescent,stem,stigma,straight,style,tube,usually,white,yellow,yellow-orange,young,×	0.15–0.4,0.3,0.5–1.5,0.5–5,0.6–1.8,1,1.1–2,1.2–1.8,1.2–2,1.2–2.2,1.2–2.5,1.3–2.5,1.5,1.5–2.3,1.7–3.5,1.8–2.5,10–12,10–20,12–16,1–1.5,1–2,1–2.5,1–5,1–6,2-,2.5–4,2–10,2–4,2–5,2–6,3-foliate,3.3,3.5,4,4–7,4–8,5,5–9,6.5–15,7–10,7–8.5,abaxially,absent,accrescent,acuminate,acute,adaxiall,adaxially,alyx,andromonoecious,apart,apex,appearing,armed,articulated,axe,base,berry,bud,c.,capitat,caudate,central,chartaceous,completely,connivent,covering,cuneate,curved,deltate,directed,directly,discolorous,distal,distall,downward,eaf,eed,emerging,exserted,few-branched,forked,formed,fruiting,functionally,geminat,hair,hermaphorditi,like,linear,lobed,lon,long,long-stuled,lower,lowermost,major,malae,margin,moderately,nflorescence,node,obtuse,often,one,orolla,outline,per,plurifoliate,pointed,pore,prickle,producing,proximal,ray,rind,root,ruit,sessile,shallowly,shoot,short-styled,side,sinuate,somewhat,spaced,sparsely,subentire,subglobose-ovoid,subtruncate,surface,swelling,tall,tamen,tapered,tem,toug,triangular,tuber-like,unarmed,unbranched,unequal,unit,upright,vary,vein,weakly,ympodial,–3	0.5-5,0.6-1.8,1-1.5,1-2,1-2.5,1-5,1.1-2,1.2-1.8,1.2-2,1.2-2.2,1.5-2.3,1.7-3.5,1.8-2.5,10-12,2-10,2.5-4,4-7,7-10,7-8.5,abaxial,adaxial,arrangement,capitate,cell,colour,corolla,form,growth,height,history,interjected,leaflet,length,life,na,ovary,plant,position,presence,present,pseudostipule,seed,shape,size,staman,terminal,testal,texture,tuber,type
80	wfo-0001026335	success	157	102	70	87	32	0.446	.5,0.25-0.5,0.5-1,0.6-1,1,1-1.5,1-2,1.5-2,10-20,2,2-3,2-4,2-7.5,3-18,5-15,5-7,adaxially,anther,blade,branched,calyx,chartaceous,cm,cylindrical,dense,densely,diameter,elliptic,elliptic-ovate,filament,flattened,flower,forked,fruit,glabrescent,glabrous,globose,green,hair,leaf,leaf-opposed,like,lobe,mm,multangulate,oblong,pedicel,peduncle,perfect,petiole,probably,pubescence,pubescent,reticulate,ripe,scattered,sessile,shrub,simple,stellate,stem,stigma,style,tube,unripe,usually,white,whitish,x,yellowish	.5-3.5,0.1-0.3,0.8-1.3,1-3,1-4,1.5-4,10-30,3-5,4-5,5-,7-8,abaxially,accrescent,acuminate,acute,adaxiall,ag,apart,apex,apparently,articulated,axe,ba,base,capitat,connivent,covering,cuneate,curved,deltate,directed,distally,eaf,eed,entire,equal,erect,especially,frui,fruiting,geminate,glandula,glandular,held,lanceolate,large,long,longitudinal,lower,many-foliate,margin,midpoint,moderately,much,nflorescence,often,opening,orolla,paired,pore,rachi,ray,rounded,ruit,slightly,slit,smaller,sometimes,spaced,ste,stellate-pubescent,straight,subtending,surface,tal,tamen,tem,time,tip,toward,unit,uprigh,vary,vein,wide,yellow,ympodial	abaxial,adaxial,arrangement,capitate,cell,colour,corolla,form,growth,height,history,inflorescence,interjected,lateral,leaflet,length,life,na,ovary,plant,position,presence,pseudostipule,seed,shape,size,staman,terminal,testal,texture,tuber,type
81	wfo-0001026342	success	280	142	122	158	20	0.436	.3,0.06,0.08,0.3–0.5,0.3–0.6,0.4–0.6,0.6–2.8,0.7–1.4,0.7–1.6,0.7–1.8,0.8–1.2,0.8–1.5,0.9–1.3,1.1–1.5,1.1–3.7,1.2,1.5–2.1,1.7–2.6,1.8–2.2,1.9–2.9,1/3,2.0,2.0–7.6,2.8–4.9,3.1–13.7,3.2–3.7,4.7,5.2–7.7,7.7–11.2,8–13,9.5–14.2,90°,acuminate,acute,adnate,aequilateral,anther,apex,attachment,attenuate,base,blade,calyx,chartaceous,climate,cm,corolla,densely,diameter,dry,emerging,entire,erect,extra-axillary,flattened-orbicular,flattened-reniform,flexed,flower,fruit,glabrous,glandular,globose,hair,inflorescence,internode,interpetalar,lateral,leaf,length,less,lobe,long,longer,margin,markedly,mature,midpoint,minute,mm,notched,oblique,occasionally,oval,ovate,pedicel,peduncle,petiole,point,porrect,pubescence,pubescent,ray,red,rounded,sessile,short-stipitate,shorter,shrub,simple,slightly,sparsely,stellae,stellate,stem,stigma,stipe,straight,style,tissue,tube,upper,well-developed,white,yellow,yellow-ferruginous,yellow-tan,±90°,±equal,×,–0.9,–19.0,–31.0	.4–3.0,.6,.9,0.07,0.3–0.9,0.6–1.3,0.8,0.8–1.1,1.3–1.8,1.5–2.3,1/2–2/3,2.1,2.1–3.3,2.1–3.7,2.5,2.5–3.8,2.9,3.6–4.6,4602,5-merou,5.1–6.6,5–8,6–12,7–8,8,8.5–9.5,abaxially,absent,adaxial,adaxially,ag,along,alyx,anthesi,apart,apical,apparently,appearing,arching,around,articulate,axe,ba,bark,becoming,bent,berry,borne,branch,broad,brochidodromous,brown,bud,cancellate,capitat,caudate,channeled,clinate,congested,connivent,deciduous,deltoid,dentate,development,difoliate,directed,distal,dorsally,edge,eed,either,endocarp,exocarp,extending,fertile,filament,filiform,free,geminat,glossy,gradually,homostylous,immature,increasing,individually,intact,intersepalar,juic,laxly,layer,lon,lower,many,mckee,midrib,midvein,moderate,moderately,nearly,nflorescence,oblong,observed,one,orolla,ove,per,perforated,pore,porrect-stellate,portion,potentially,raised,reddish,reflexe,remaining,rigid,row,ruit,seen,side,sinus,sloughing,smoot,soon,spaced,speciman,splitting,spread,stamen,stellate-pubescent,surface,suture,tamen,tardily,tem,thin,time,tip,toward,translucent,transparent,trifurcating,truncate,two,typically,ud,unarmed,unbranched,various,vary,vein,weakly,wide,ympodia,young,±densely,±evenly,±glabrous	adhesion,arrangement,capitate,colour,form,growth,height,history,life,number,ovary,perennial,plant,position,presence,seed,shape,size,staman,texture
82	wfo-0001026343	success	221	112	84	137	28	0.38	-3.5,-4,-7,.5,0-4,0.05-0.5,0.1-0.2,0.45-1,1.3-1.7,1.5-2.5,1.8-2.2,1.8-3,1/3,2-3,2-3.2,2-4,2-6,2.2-3.2,3-4,5.5-9,7-9,abaxial,acute,anther,apex,base,berry,blade,broadly,calyx,chartaceous,cm,cream,cuneate,dark,densely,diameter,dull,elliptic,equal,flattened-reniform,fruit,glabrescent,glabrous,green,lateral,leaf,length,lobe,lobed,long,margin,marking,maturity,mauve,midpoint,mm,orange-brown,pale,pedicel,peduncle,petiole,plant,poricidal,purple,ray,rounded,shrub,small,sparsely,spherical,stellate,stellate-pubescent,stem,style,surface,tapering,tip,tree,tube,upper,wide,yellow,young	-1,-1.5,-15,/2,/5,0,0-10,0-2,0-40,0-5,0.05-0.2,0.15,0.2,0.2-0.3,0.2-0.7,0.3,0.5,0.5-1.5,0.8-1.5,1-2,1-3,1-4,1.5-2,1/,1/4-2/3,1/5,10-30,2-5,2-8,2.5-8,3-5,3.5-4.5,5-10,5-merous,6-9,7-12,7-14,7-8,abaxially,acuminat,adaxial,alyx,andromonoecious,apar,apart,apically,apparently,articulated,bark,branched,brow,concolorous,connivent,curved,deltate,distal,distance,drying,eed,elongating,erect,extending,faint,filament,flattened,flower,free,fruiting,green-brown,hermaphrodite,heterostylous,infructescence,less,lobing,lon,long-styled,longer,lower,lowermost,mature,midvein,moderately,multangulate,narrow-deltate,nflorescence,obtuse,older,one,open,orange,orolla,oung,ovate,pair,pendulous,per,pericarp,plurifoliat,porrect,portion,prickl,prickle,prickly,primary,reddish,reduced,reflexed,ruit,scar,secondary,sessile,short-styled,side,smooth,sometimes,spaced,spreading,stalk,stalked,staminat,stout,tamen,terete,tertiary,time,trichome,unarmed,unit,variously,vary,vein,venation,visible,way,weakly,woody,ympodial	adhesion,arrangement,climate,colour,corolla,form,glandular,growth,hair,height,history,inflorescence,life,na,number,ovary,perennial,position,presence,present,pubescence,seed,shape,size,staman,stigma,stipe,texture
83	wfo-0001026351	success	199	121	97	102	24	0.487	0.25-0.5,0.5-1,0.5-1.0,0.5-1.5,0.5-1mm,0.75-1.0,1-1.5,1-2,1-2.5,1-3,10-15,2-3.5,2-5,3-10,3-9,4-7,5-15,8-15,acute,anther,apex,asymmetrical,attenuate,base,blade,branched,brown,bud,calyx,chartaceous,cm,commonly,connivent,cordate,coriaceous,corolla,cylindrical,densely,diameter,entire,extra-axillary,flower,fruit,glabrous,globose,green,hair,immature,leaf,leathery,length,like,lobe,lobed,margin,mature,midpoint,mm,moderately,nearly,obtuse,occasionally,often,orange,orange-red,ovary,ovate,pale,pedicel,peduncle,petiole,plant,porrect-stellate,pubescent,purple,ray,red,reniform,revolute,seed,simple,slightly,spreading,stellate,stem,stigma,style,subcoriaceous,tan,tapering,tube,unbranched,vine,white,wide,x,yellow	0.5,1-.,1-4,10-18,12-16,15-50,2-4,3-6,4-6,4-9,40-80,5-merou,6-10,6-8,abaxial,abaxially,absent,accrescent,adaxial,adaxially,alyx,andromonoecious,apar,apical,apparently,armed,axe,berry,beyond,branch,dark,difoliate,directed,discolorous,distally,distinct,eaf,eed,either,em,exserted,exseted,filament,filiform,flattened,forming,frui,fruiting,functionally,geminate,glabrou,gree,hermaphroditic,heteromorphic,introrsel,long,long-styled,lower,major,male,midrib,midvein,multicellular,multiseriate,narrowly,nflorescence,occasional,orane,orolla,outer,pair,per,pore,prickle,proximally,rachi,recurved,roselike,ruit,scrambling,short-,side,siz,spaced,sparsely,stalk,stamen,ste,stellare,straight,surfac,surface,swellin,tamen,triangular,unarmed,unequal,unicellular,unit,vary,vein,ympodial	1-6,adhesion,arrangement,climate,colour,form,glandular,growth,height,history,inflorescence,life,na,number,perennial,position,presence,present,pubescence,shape,size,staman,stipe,texture
84	wfo-0001026352	success	209	110	81	128	29	0.388	.3,0.5,0.5-0.8,0.5-1,0.5-3,0.6-,0.7-2,1-,1.2-1.7,1.5-4.6,3-15,3.5-9,4-4.5,5-6,<,?,acuminate,acute,anther,apex,base,berry,blue,calyx,capitate-truncate,chartaceous,cm,cordate,corolla,densely,diameter,ellipsoid,entire,evenly,flattened,glabrous,globose,green,growth,immature,inflorescence,lamina,leafy,length,lobe,lobed,long,margin,membranous,mm,narrowly,nearly,ovate,pale,pedicel,peduncle,petiole,pink,pubescent,reniform,shallowly,shiny,shoot,short,simple,stellate,stem,stigma,style,terminal,thin,truncate,tube,unspecified,vein,vine,violet,white,wide,woody,yellowish	.5,0.5-1.5,0.9-1,1-1.5,1-10,1-2-celled,1.5,1.5-2,10+,12-60,2,2-3-celled,5-merou,6-7,7-9,abaxially,adaxiall,ag,almost,alyx,angle,anthesi,antrorsely,apart,apparently,appearance,arising,articulated,articulation,axi,bark,basal,bending,branch,branching,broadly,brown,cell,conical,curved,deciduous,deltate,denser,discolorous,eaf,eed,eventually,expanded,exserted,few-celled,filament,flower,free,fruiting,giving,greenish,half,heigh,herbarium,ilament,impressed,inflorescenc,irregularly,junction,large,largest,leave,leaving,lengthening,like,lower,many,mature,minutely,near,new,nflorescence,older,orolla,outline,pair,papillate,papillo,peg,per,perfect,pericarp,plurifoliat,point,pore,poricidal,portion,primary,principal,rachi,reflexed,rest,revolute,right,ruit,scar,seen,sleeve,slit,small,spaced,sparser,specimen,spreadin,spreading,straw-colored,strongly,surface,tem,third,time,tip,trichome,tub,tuberculate,ud,uniseriate,unit,upper,vary,weak,widest,ympodial	adhesion,arrangement,blade,climate,colour,form,fruit,glandular,hair,height,history,leaf,life,midpoint,na,number,ovary,plant,position,presence,present,pubescence,ray,seed,shape,size,staman,stipe,texture
85	wfo-0001026352	success	214	114	85	129	29	0.397	.3,0.5,0.5-0.8,0.5-1,0.5-1.5,0.5-3,0.6-,0.7-2,1-,1.2-1.7,1.5-4.6,2,3-15,3.5-9,4-4.5,5-6,<,?,acuminate,acute,anther,apex,base,berry,blue,calyx,capitate-truncate,chartaceous,cm,conical,connivent,cordate,corolla,densely,diameter,ellipsoid,entire,evenly,flattened-reniform,form,glabrous,globose,green,growth,immature,inflorescence,lamina,leaf,leafy,length,lobe,lobed,margin,membranous,mm,narrowly,nearly,ovate,pale,pedicel,peduncle,petiole,pink,pubescent,shallowly,shiny,shoot,short,simple,stellate,stem,stigma,style,terminal,truncate,tube,unspecified,vein,vine,violet,white,woody,x,yellow,yellowish	.5,0.9-1,1-1.5,1-10,1-2-celled,1.5,1.5-2,10+,12-60,2-3-celled,5-merou,6-7,7-9,abaxially,adaxially,ag,almost,alyx,angle,anthesi,antrorsely,apart,apparently,appearance,arising,ark,articulated,articulation,axi,basal,bending,branch,branching,broadly,brown,cell,curved,deciduous,deltate,denser,discolorous,eaf,eed,eventually,expanded,exserted,few-celled,filament,flower,free,fruiting,geminat,giving,greenish,half,heigh,herbarium,ilament,impressed,inflorescenc,irregularly,junction,large,largest,leaving,lengthening,like,long,lower,many,mature,minutely,near,new,nflorescence,older,orolla,outline,pair,papillate,papillo,peg,per,perfect,pericarp,plurifoliate,point,pore,poricidal,portion,primary,principal,rachi,reflexed,rest,revolute,right,ruit,scar,seen,sleeve,slit,small,spaced,sparser,speciman,specimen,spreadin,spreading,straw-colored,strongly,surface,tem,thin,third,time,tip,trichome,tub,tuberculate,twining,ud,uniseriate,unit,upper,vary,weak,widest,ympodial	absent,adhesion,arrangement,blade,climate,colour,fruit,glandular,hair,height,history,life,midpoint,na,number,ovary,perennial,plant,position,presence,present,pubescence,ray,seed,shape,size,staman,stipe,texture
86	wfo-0001026357	success	206	128	108	98	20	0.524	0.1-0.3,0.11-0.29,0.2-0.7,0.4-1.6,0.8-1,0.8-1.2,0.9-1.2,1-1.2,1-6,1.1-1.7,1.4-2,1.5-2.2,1.5-2.8,10-17,2-2.8,2-3,2-3.3,2-6,3.9-6.2,4-6,4-7,5,5.8-13.6,7-10,7-15,abaxially,adaxially,along,anther,apex,asymmetrically,bark,base,blunt-tipped,branch,brown,calyx,chartaceous,cm,conical,corolla,cylindrical,dark,decurrent,densely,diameter,ellipsoid,elliptic,entire,ferrugineous-pubescent,flower,foveolate,fruit,globose,granular,green,immature,inserted,lanceolate,leaf,length,lobe,long-attenuate,many,margin,mature,mm,multangulate-pubescent,narrowly,nearly,oblanceolate,oblong,obovoid,ovate,pale,pedicel,peduncle,persistently,petiole,porrect-stellate,rachi,revolute,rough,scabrous,several,shrub,simple,slightly,small,smooth,sparsely,stellate,stellate-pubescent,stellate-tomentose,stelliform,stem,stigma,style,tan,terete,testa,time,tree,tube,white,x,yellow,young	0.6-1.5,1.5-2.5,1.7-2.9,1/2,10-11,2.3-4.2,2.5-3.3,30-68,4-5,6-7.5,absen,accrescent,acute,adaxiall,ag,anthesi,apart,apparently,around,articulated,axillary,ba,berry,blade,branched,capitat,closely,completely,conspicuous,coriaceous,covering,directed,distally,eaf,edge,eed,enveloping,exserted,farinose,filament,fleshy,free,fruiting,glabrous,hair,half,hig,large,lateral,lengthening,line,lobed,long,lower,m.,main,midrib,minute,mostly,multangulat,multangulate,nflorescence,obtuse,older,orolla,ovate-lanceolate,perfect,plurifoliate,pore,poricidal,porrect-stellat,pubescent,ruit,runk,semi-ovate,sessile,short-stalked,side,slit,somewhat,spaced,sparse,stellate-pubescen,suture,tamen,thick-stalked,tip,tomentose-pubescent,touching,ud,unit,vary,vein,way,weakly,whitish,within,ympodial	adhesion,arrangement,branching,bud,capitate,colour,form,growth,height,history,inflorescence,life,ovary,perennial,plant,seed,shape,size,staman,texture
87	wfo-0001026367	success	216	126	78	138	48	0.361	1.2-1.6,abaxially,acuminate,adaxially,anther,apex,asymmetric,attenuate,base,black-brown,blade,blue,broadly,close,cm,colored,cordate,dense,densely,diameter,dried,entire,eventually,flower,fruit,glabrate,globose,green,growth,hair,immature,initially,irregularly,lance,later,lateral,lavender,leaf,lenticular,lighter,lobe,lobed,longer,loosely,margin,mm,ovate,overtopped,pedicel,peduncle,pentagonal,petiole,plump,pubescence,pubescent,ray,rotate,rounded,shallowly,shrub,simple,sinuately,slightly,soon,stellate,stem,stigma,style,tan,terminal,thick-chartaceous,tomentose,tube,turning,usually,weakly,yellow,×	.5,0.2–0.5,0.4–0.6,0.4–0.7,0.5–0.7,0.7–1.5,1.8–2.5,10,10–15,10–18,15-20,15–30,1–2,1–3,2.5–4,2–3,2–3.5,2–4,2–4.5,2–5-branched,3–4,3–6,3–7,5-merou,5–7.5,5–9,6–8,7-9.7,7–11,8–10,abaxial,acicular,acute,adaxial,adaxiall,age,along,alyx,apart,apparently,armed,articulated,ascending,axe,ba,branch,branched,capitat,caudate,center,closely,deeply,deltoid,denser,directed,distally,eaf,eed,erect,farinose,filament,filiform,finely,geminat,glabrous,high,homostylous,internode,interpetalar,interwoven,larger,like,little,lon,long,looser,lower,maturit,midpoint,midvei,midvein,midzone,minutely,mostly,much,narrowly,near,nflorescence,oblong,often,orolla,ovoid,perfect,pitted,plurifoliate,pore,porrect,prickle,principal,ruit,sessile,short,shorter,side,similar,sinus,small,somewhat,some­what,spaced,sparsely,splitting,spreadin,spreading,spreadingly,stalk,stalked,ste,stellae,stellate-pubescent,stellate-tomentose,surface,tamen,tawny,tem,time,tip,tissue,tomento,triangular,ud,unarmed,vary,vein,well-developed,wide,ympodia,–20	0.2-0.5,0.4-0.6,0.5-0.7,0.7-1.5,1-2,1-3,1.8-2.5,10-15,10-18,2-3,2-4,2-4.5,2.5-4,20,3-4,3-7,5-7.5,5-9,6-8,8-10,adhesion,arrangement,calyx,capitate,colour,corolla,form,glandular,height,history,inflorescence,length,life,maturity,na,number,ovary,perennial,plant,position,presence,present,seed,shape,size,staman,stipe,texture
88	wfo-0001026377	success	155	116	85	70	31	0.548	0,1,16,2,2-3,2.5,3,30,5-6,5-7,7,8-13,abaxially,abundant,abundantly,acumen,acute,along,anther,apex,base,bright,broadly,calyx,cell,central,chartaceous,cm,densely,distinctly,extra-axillary,flower,forked,hair,hermaphroditic,lateral,leaf,like,linear,lobe,long,main,mainly,margin,midpoint,minor,mm,narrow,oblique,often,ovate,pale,pedicel,peduncle,petiole,plant,pore,prickle,pubescent,purple,ray,reduced,repand,retrorse,scattered,shallow,short,shrub,side,simple,staminate,stellate,stellate-pubescent,stem,stigma,stipe,style,subcordate,surface,tapered,triangular,tube,unbranched,vein,x	-8,0.5,1/5-1/4,12,3-,3-5,4,5-merous,7-7.5,abaxiall,adaxially,andromonoecious,apica,armed,articulated,axe,ba,belo,blade,branched,broad,brownish,cut,distall,eaf,eed,ending,ermaphroditic,filament,fresh,geminat,hermaphrodite,heterostylous,internode,lon,lower,midrib,nflorescence,orolla,polished,porrect,prickl,prickly,proximal,rachi,rounded,ruit,seen,sharp,single,sinus,smaller,sparsely,stou,straggly,straight,structure,subsagittate,tamen,taminate,tem,tipped,transition,unequal,unknow,unknown,vary,vestigia,way,ympodial	3-6,abaxial,adaxial,adhesion,apical,arrangement,colour,corolla,diameter,form,fruit,growth,height,history,inflorescence,length,life,na,ovary,perennial,position,presence,pubescence,seed,shape,size,staman,stout,texture,vestigial,ye
89	wfo-0001026379	success	219	127	109	110	18	0.498	-4.5,0.2-0.38,0.2-0.4,0.7-1,0.7-2.5,0.8-1.2,0.9-1.2,1-1.7,1-10,1-2,1-3.7,1.3-2.1,1.5-2.3,1.7-4.9,1.8-2.6,1.8-3.2,1.9-3.4,13,2-7,2.6-3.7,3-11,4.1-7,5.3-10.2,8-13,8-15,8-29,8.3-10,9-14,abaxially,acute,adaxially,anther,apart,apex,attenuate,bark,blunt-tipped,branch,branched,brown,calyx,cm,conical,corolla,dark,densely,diameter,dried,echinoid-pubescent,ellipsoid,entire,filament,finely,flower,fruit,globose,granular,gray-brown,grayish,growth,lateral,leaf,length,lobe,main,many,margin,midrib,minutely,mm,multangulate,nearly,oblong,obovate,ovate,pale,pedicel,peduncle,persistently,petiole,plant,porrect-stellate,rachi,reniform,rich,scabrous,shrub,side,simple,size,small,stellate,stellate-tomentose,stelliform,stem,stigma,style,terete,time,tomentose-pubescent,tree,tube,vein,velutinous-pubescent,violet,whitish,x,yellow,young	1.8-5,1/2,2-2.8,2.4-5.1,2.9-4,2/3,3/4,4-5,50-450,6-10.6,accrescent,adaxiall,ag,along,anthesi,apparently,around,articulated,axillary,ba,basal,base,berry,blade,capitat,chartaceous,closely,completely,covering,cylindrical,dendritic-echinoid,directed,distal,distally,eaf,echinoi,echinoid,edge,eed,enveloping,evident,farinose,few-rayed,fleshy,free,fruiting,glabrous,hair,hig,included,inserted,lacking,large,lengthening,line,lobed,long,long-attenuate,lower,m.,mature,minute,mostly,multangulat,multangulate-pubescent,nflorescence,obtuse,often,older,orolla,ovate-lanceolate,partly,perfect,pitted,plurifoliate,pore,poricidal,present,pubescen,rather,recent,ruit,runk,scattered,semi-ovate,sessile,short-stalked,slit,sometimes,somewhat,spaced,sparse,stellate-,stellate-pubescent,suture,tamen,testa,thin,tip,translucent,ud,uneven,unit,upper,usually,vary,vestigial,way,whitish-brown,ympodial	arrangement,branching,bud,capitate,color,form,height,history,inflorescence,life,ovary,perennial,pubescent,seed,shape,spacing,staman,texture
90	wfo-0001026388	success	264	96	64	200	32	0.242	.5,0.2-0.6,1-2,1.4,1.5-2,1.6,1.8,8.5,abaxially,adaxially,anther,attenuate,base,bilobed,brown,calyx,cm,corolla,diameter,distinctly,erect,extra-axillary,flower,free,fruit,glabrous,globose,green,halfway,inserted,inside,leaf,length,life,lighter,lobe,mm,moderately,much,outside,ovate,pedicel,peduncle,petiole,pilose,plant,shape,shrub,simple,size,sparsely,stellate,stem,stigma,style,suborbicular,thin-textured,tip,truncate,tube,white,x,yellow-orange,yellowish	.2,.7,0.15,0.2–1,0.2–2,0.4–1,0.5–1.7,0.5–2,0.5–4,0.8–1.5,0.8–2.5,1.4–1.6,1.5–2.2,1.5–3.5,108,10–20,12,1–2,1–2.5,1–6,2-foliate,2.5–4,20–,25,2–4,2–4-celled,2–9,3,3.2–3.7,45,4–10,4–5-rayed,4–6-celled,5,5–12,5–20,6,65–145,6–11,6–7,8-13,=,?,abundant,acicular,acuminate,acute,adaxiall,always,angle,apar,apex,apiculate,apparent,appearance,armed,ascending,becoming,blade,bleaching,branch,bright,ciliate,closely,color,conduplicate,confined,covering,cylindrical,deeply,dense,developing,dilated,directed,distall,divided,division,dried,eaf,eed,enlarged,entire,especially,exceeding,except,exclusive,exserted,filament,first,flowering,folded,forward,geminat,geminate,giving,gland,glistening,glutinous,golden,grading,greenish,hair,hyaline,lanceolate,larger,lateral,least,less,light,lobed,lon,long,lower,major,margin,midrib,minute,minutely,mostly,n,nearly,nflorescence,oblique,often,one,orolla,otherwise,ovate-apiculate,pair,papillat,par,per,plane,pointing,pore,pressing,prickle,probably,purple-colored,rachi,ranging,rarely,recurved,reflexed,reported,rip,ripe,ruit,scarious,scattered,sessile,shallowly,sideway,similar,single,sinuate,sinus,slightly,small,smaller,sometimes,somewhat,spaced,spreading,stamen,stellae,stipitate,straight,straw,strongly,sunlight,surface,tal,tamen,tem,thickened,triangular,turning,twice,twisted,two,unarmed,unbranched,unicellular,unit,upper,usually,various,variously,vary,vein,viewed,whole,wide,wing,yellow,yellow-green,ympodial,±,–8	0.4-1,0.5-1.7,0.5-2,0.8-1.5,0.8-2.5,1-2.5,1.4-1.6,10-20,2-9,20-45,3.2-3.7,5-12,5-20,6-7,adhesion,arrangement,colour,form,growth,height,history,inflorescence,na,ovary,perennial,position,presence,present,pubescence,seed,staman,texture
91	wfo-0001026397	success	202	110	90	112	20	0.446	0.5-1,1-2,1-2.5,1-3,1.5-3.5,10-14,10-20,13-18,2-10,2-2.5,2-5,2.5,3-3.5,3-4,3-5,3-9,4-16,5-15,5-8,absent,anther,attenuate,base,brown,bud,calyx,chartaceous,cm,connivent,coriaceous,cylindrical,densely,diameter,expanding,extra-axillary,filiform,flower,fruit,functionally,glabrous,glandular,globose,greatly,green,hair,hermaphroditic,immature,leaf,leathery,like,line,lobe,lobed,male,mature,mm,moderately,nearly,occasional,orange,ovate,pedicel,peduncle,petiole,plant,porrect-stellate,present,pubescent,purple,ray,red,reniform,rusty,simple,sparsely,spreading,stellate,stem,stigma,style,tan,tapering,thick,tube,vine,weakly,white,woody,x,yellow	0.5-1.5,1,1-.,1-6,1-9,1.5,1.5-3,12-15,12-16,4-8,5,5-merou,50-100,6-10,8-20,abaxially,absen,accrescent,acute,adaxial,adaxially,alyx,andromonoecious,anthesi,apar,apex,apical,armed,asymmetrical,axe,berry,beyond,blade,cordate,dark,difoliate,directed,discolorous,eaf,eed,either,em,entire,exserted,filament,flattened,frui,fruiting,geminate,glabrou,gree,greem,heteromorphic,introrsel,long,long-styled,lower,major,many,margin,midpoint,midrib,midvein,multicellular,multiseriate,narrowly,netlike,nflorescence,obscure,obtuse,often,older,orolla,pair,per,pit,pore,prickle,rachi,raised,recurved,reflexed,ridge,roselike,ruit,secondary,separated,short-and,side,siz,slightly,small,spaced,stalk,stamen,ste,straight,surface,tamen,triangular,unarmed,unbranched,unequal,unicellular,unit,usually,vary,vein,whitish,wide,ympodial,young	1-4,adhesion,arrangement,colour,corolla,form,growth,height,inflorescence,length,number,ovary,position,presence,pubescence,seed,shape,size,staman,texture
92	wfo-0001026400	success	187	98	75	112	23	0.401	0.2-0.8,0.5-1.2,1.7-2.2,10-18,13-30,2-8,3.4-4.8,30-55,4-7,5-7,6-13,6-15,6.5-20,8-12,9-13,anther,axillary,blue,brownish,bud,clavate,cm,condition,coriaceous,corolla,deep,diameter,drying,elliptic,finely,fresh,fruit,glabrescent,glabrous,globose,green,greenish,hair,herb,lanceolate,leaf,light,lilac,lobe,long,mm,moderately,odd-pinnate,ovate,ovoid,pedicel,peduncle,pentagonal,petiole,plant,puberulent,pubescent,purple,ripe,seed,semi-stellate,short,simple,size,stigma,stripe,style,subtending,terminal,tip,tube,white,whitish,x,yellow	0.4-1,0.5-1,0.7-1.1,1-10,1-2,1.3-2.6,10-28,12-27,2-6,2.4-5.9,3-6,3.5-5.9,5-merou,abaxially,acumen,acuminate,acute,adaxiall,adaxially,ag,alyx,apart,apex,apparently,articulated,asymmetric,attenuate,axe,base,basiscopic,berry,blade,capitat,cell,connivent,covering,dark,decreasing,decurrent,digestion,distal,dorsally,eaf,edge,eed,enzyme,erec,exceeding,filament,flat,flower,folded,forked,geminat,generally,glabrou,gree,green-white,hair-like,hal,half,high,homostylous,honeycomb-shaped,interjected,lateral,leaflet,lengthening,linear,living,lower,make,mucilaginous,nflorescence,orbicular,orolla,pair,perfect,petiolulate,plurifoliate,pore,poricidal,removed,rounded,ruit,sessile,seudostipule,side,slightly,slit,spaced,specimen,stamen,straight,subequal,tall,tamen,tem,testal,thick,throughout,tissue,toward,tri-,typically,unit,unwinged,usually,vary,wall,wet,ympodial	abaxial,adaxial,adhesion,arrangement,calyx,capitate,colour,form,growth,height,history,inflorescence,length,life,na,ovary,perennial,position,pubescence,shape,staman,stem,texture
93	wfo-0001026406	success	219	109	81	138	28	0.37	-1,.2,.5,0.3-0.5,0.4-0.8,0.5-1.5,1-2,1/4,12-19,2-2.7,2.5-8,2.9-3.2,3-10.5,3.2-3.8,5-25,6-12,7-10,7-8,9-15,acute,anther,apex,base,blade,calyx,chartaceous,cm,connivent,cordate,cream,dark,densely,diameter,equal,flattened-reniform,fruit,glabrous,green,herb,lateral,leaf,length,lobe,lobed,long,margin,marking,maturity,mauve,midpoint,midvein,mm,obtuse,orange-brown,ovate,pale,pedicel,peduncle,petiole,plant,poricidal,purple,ray,red-brown,shrub,spherical,stellate,stellate-pubescent,stem,stout,style,tapering,terminal,tip,tube,upper,velvety,white,wide,yellow,young	0,0-3,0-30,0-5,0.3,0.3-0.7,0.4-0.9,0.5,0.5-2.5,0.8,00-200,1,1.3-1.5,1.5-2,1.5-5,1.8-2.4,1/,1/3,1/4-1/2,1/4-1/3,10-30,2-3,2-6,20-60,3-4,30-60,5,5-50,5-6,5-7,5-8,5-merous,6-15,6.5-7,7-9,abaxial,abaxially,adaxial,adaxially,alyx,ame,andromonoecious,apar,apart,apically,apparently,articulated,bark,berry,branched,broad-deltate,c.,conical,curved,deltate,dirty-whitish,discolorous,distal,distance,drying,eaf,eed,elongated,elongating,erect,extending,filament,flattened,flower,foliaceous,free,fruiting,fully,gently,hermaphrodite,heterostylous,infructescence,least,lon,long-styled,longer,lower,lowermost,mature,moderately,nflorescence,oblong,older,one,open,opening,orolla,oung,pair,pendent,pendulous,per,pericarp,plurifoliat,porrect,portion,prickl,prickle,prickly,primary,reflexed,rounded,ruit,scar,sessile,short-styled,side,smooth,sometimes,spaced,sparsely,spreading,stalk,stalked,staminat,straight,surface,tamen,terete,tertiary,time,trichome,unit,variously,vary,vein,venation,visible,way,weakly,woody,yellow-brow,ympodial	adhesion,arrangement,climate,colour,corolla,form,glandular,growth,hair,height,history,inflorescence,life,na,number,ovary,perennial,position,presence,present,pubescence,seed,shape,size,staman,stigma,stipe,texture
94	wfo-0001026407	success	221	127	98	123	29	0.443	-11,-6,.5,/3,0.5,0.5-0.6,0.5-2,0.9-3,1,1.2-1.5,1.5-1.7,1.5-2,1.5-7,2-2.5,2.5-3,3.5,4-5,5,5-10,7-8,acute,anther,apex,base,becoming,berry,black,brown,calyx,capitate,chartaceous,cm,conical,connivent,corolla,deep,dendritic,densely,diameter,ellipsoid,elliptic,entire,erect,evenly,flattened-reniform,fleshy,glabrous,globose,golden,growth,inflorescence,internodal,lateral,lax,lobe,lobed,long,loosely,margin,markedly,membranous,minutely,mm,narrowly,oblique,occasionally,papillate,pedicel,peduncle,petiole,pubescence,pubescent,purple,purplish,reddish,revolute,ripe,shiny,short,shrub,simple,slightly,sparsely,stellate,stem,stiff,stigma,style,terminal,trichome,truncate,tube,vine,violet,way,woody,x,yellow	+,0.5-1,1-1.2,1-10,1.3,20-30,20-40,3.5-5.5,5-7,5-merou,7-10,abaxially,adaxially,ag,aid,along,always,alyx,anthesi,apart,appearing,area,ark,around,articulated,axi,basal,beneath,berr,blunt,branch,branched,broadly,brownish,cell,clear,climbin,congested,deltate,dense,denser,discolorous,eaf,eed,exserted,filament,flower,free,fruiting,geminat,glabrescen,glabrou,golden-pubescent,ilament,interpetalar,irregularly,lamina,leafy,leaving,lengthening,like,lower,many,midvein,mixture,near,new,nflorescence,numerous,obscured,often,older,open,orolla,outline,pair,pale,paler,papillat,pedice,peg,pentagonal,per,perfect,pericarp,persistent,pitted,planar,plurifoliate,pore,poricidal,portion,primary,pubescenc,ruit,scar,sinus,sleeve,slit,small,spaced,sparser,spreading,stout,strongly,surface,tangled,tem,testal,thin,time,tip,transition,twining,ud,undulate,unit,upper,usually,vary,vein,weak,ympodial	adhesion,arrangement,blade,climate,colour,form,fruit,glandular,hair,height,history,leaf,length,life,midpoint,na,number,ovary,perennial,plant,position,presence,ray,seed,shape,size,staman,stipe,texture
95	wfo-0001026422	success	273	104	58	215	46	0.212	0.2,3.5,6.8,7.6,8.4,acuminate,acute,adnate,anther,apex,base,blade,calyx,capitate,chartaceous,cm,corolla,cuneate,densely,diameter,elliptic,entire,extra-axillary,flattened-irregular,flattened-reniform,flower,fruit,glabrous,globose,lanceolate,lateral,length,lobe,margin,mm,moderately,ovate,pedicel,peduncle,petiole,pubescence,pubescent,ray,red-brown,rounded,shrub,simple,sinuate,stellate,stem,stigma,stipe,style,tube,white,yellow,yellow-tan,yellowish-green	.0,.04,.3,.6,.7,.9,/3,0.04,0.06,0.08,0.1–0.5,0.2–0.4,0.3–0.5,0.3–0.7,0.4–1.3,0.4–2.4,0.6–0.9,0.6–1.1,0.6–2.0,0.7–0.8,0.7–1.6,0.8,0.9–1.5,0.9–1.9,0.9–7.5,1.0,1.0–1.9,1.1–1.4,1.2–2.8,1.3–2.2,1.6–1.9,1.6–2.2,1.7–2.4,1.8–2.2,1.8–2.3,1/2–2/3,1/3,1/3–2/3,10,13.2–27.8,1–3,2.0–3.2,2.2–14.0,2.8–4.2,3.5–4.5,3.8–4.8,4.7,4–8,5-merou,5.0,5.8–7.4,5.8–8.3,56,5–7,6–8,7.7–9.2,7.8–26.9,abaxially,absent,adaxially,aequilateral,ag,alveolate,alyx,anthesi,apart,apical,apiculate,apparently,appearing,appresse,around,articulate,attenuate,axe,ba,bark,basal,becoming,bent,berry,borne,branch,branching,broad,brochidodromous,bud,channeled,cream,darker,deciduous,deltoid,dentate,development,difoliate,directed,distal,distally,distinct,dry,eaf,edge,eed,either,emerging,endocarp,erect,especially,evenly,exocarp,extending,fertile,filament,filiform,free,geminat,glandular,glossy,gradually,gray-brown,gree,green,hair,homostylous,immature,increasing,individually,intact,internode,interpetalar,intersepalar,juic,layer,light,lon,long,longer,lower,many,many-flowered,mature,midpoint,midrib,midvein,minute,much,nearly,nflorescence,oblique,oblong,observed,occasionally,orolla,ove,per,perforated,pore,porrect,porrect-stellae,portion,potentially,presumably,raised,reflexed,remaining,rigid,row,ruit,scarcely,sessile,short-stipitate,side,sinus,sloughing,smoot,soon,sparsely,splitting,spreading,stamen,stellae,stellate-pubescent,straight,stripe,surface,suture,tamen,tardily,tem,thin,time,tip,tissue,translucent,transparent,truncate,two,typically,ud,unarmed,unbranched,upper,various,vary,vein,weakly,well-developed,wide,yellow-ferruginous,ympodia,young,±congested,±erect,×,–5	0.06-0.08,0.1-0.5,0.3,0.3-0.7,0.4-1.3,0.4-2.4,0.6,0.6-1.1,0.6-2.0,0.7-0.8,0.7-1.6,0.9-1.5,0.9-1.9,1.3-2.2,1.6-1.9,1.8-2.3,13.2-27.8,2.2-14.0,2.8-4.2,3.5-4.5,4-8,5.8-7.4,7.8-26.9,adhesion,arrangement,colour,dense,form,growth,height,history,inflorescence,leaf,life,number,ovary,perennial,plant,position,presence,present,seed,shape,size,staman,texture
96	wfo-0001026424	success	138	75	37	101	38	0.268	1-1.5,1.5-2,10-15,15,15-30,3-4,acuminate,acute,apex,axil,base,blush-violet,broadly,calyx,cm,corolla,cuneate,elliptic,fork,glabrous,glandular,hair,leaf,lobe,minute,mm,oblique,obovate,pedicel,peduncle,petiole,pinnatisect,rotate-stellate,shrub,simple,stem,x	-25,-3.5,-4,0.75-1.5,1,1-,1-10,1-2,10,12-60,2,3-11,637/1,8-,acuman,acumen,age,angular,anthesi,aspect,ba,becoming,blunt,bluntly,broad,campanulate,cell,clonal,close,common,conspicuous,cut,cyme,dia,distinct,downard,eaf,ellipsoid,erect,exceeding,except,exerted,facetted,facing,floral,flower,forked,general,gree,growing,interacuminal,lacking,lanceolate,lanceolate-elliptic,larger,lasting,lavender,line,lobed,lon,long,lower,midvein,nflorescence,often,part,pedicellate,plurifoliat,point,rachi,raised,rarely,rh,rounded,scorpioid,second,several,shallowly,short,sinus,slightly,soft-wooded,soon,stone,straggly,time,tip,tissue,toward,triangular,tub,ud,unit,unwinged,usually,violet,within,woody,year,ympodial,young	1-4,adhesion,anther,arrangement,blade,climate,colour,diameter,form,fruit,growth,height,history,inflorescence,length,life,margin,midpoint,na,number,ovary,perennial,plant,position,presence,present,pubescence,ray,seed,shape,size,staman,stellate,stigma,stipe,style,texture,tube
97	wfo-0001026440	success	181	124	100	81	24	0.552	0-15,1-5,1.1-1.4,1.1-1.5,1.3-1.7,1.5-2.1,1.9-3.7,14-30,2-2.8,2-4,2.9-4.4,3-5,3-7,3-8,3/4,4-12,5-7,7-14,9,abaxially,acute,adaxially,anther,appressed,bark,basal,base,blunt-tipped,branch,branched,broadly,brown,calyx,chartaceous,closely,cm,conical,corolla,dendritic-echinoid,diameter,echinoid,elliptic,filament,flower,globose,granular,green,greenish-yellow,hair,leaf,length,lobe,many,minutely,mm,mostly,multangulate,multangulate-pubescent,oblong,obovate,obovoid-oblong,obtuse,often,ovate,pale,pedicel,peduncle,persistently,petiole,plurifoliate,porrect-stellate,reniform,ripe,scabrous,semi-ovate,sessile,short-stalked,shrub,simple,size,small,spaced,stellate,stellate-pubescent,stem,stigma,style,terete,time,tomentose,tomentose-pubescent,tomentum,tree,truncate,tube,turning,white,x,yellow,young	1.8-4.5,1/2,1/2-2/3,3.9-6.5,accrescent,adaxiall,ag,along,always,anthesi,apex,apparently,articulated,axillary,ba,berry,blade,bract-like,branche,capitat,dense,developed,dichotomy,directed,distal,distally,eaf,echinoi,eed,entire,first,fleshy,free,fruiting,high,included,inserted,large,lengthening,lobed,long,long-attenuate,lower,m.,margin,minute,multangulat,nearly,nflorescence,obscure,older,openly,orolla,pair,perfect,pitted,pore,poricidal,pubescen,rather,ruit,runk,short-acuminate,slit,sometimes,somewhat,sparse,suture,tamen,testa,thick,thin,tip,translucent,ud,uneven,unit,usually,vary,way,ympodial	arrangement,branching,bud,capitate,colour,form,fruit,growth,height,history,inflorescence,insertion,life,ovary,perennial,plant,pubescence,pubescent,seed,shape,spacing,staman,texture,type
98	wfo-0001026441	success	197	91	71	126	20	0.36	0.3-0.7,0.5-1.5,1-1.5,1-2,1.5-2.5,10,15-20,2-2.5,2-5.5,2-8,4-6,4-8,4-8.5,4.5-6.5,5-10.5,7-20,7-8,9-14,anther,axillary,berry,brownish,bud,chartaceous,cm,condition,conical,corolla,diameter,drying,fresh,fruit,glabrous,green,greenish,herb,lanceolate,lateral,leaf,leaflet,light,lobe,long,mm,mottled,odd-pinnate,ovoid,pale,pedicel,peduncle,petiole,plant,pubescent,purple,ripe,rotate,seed,size,sparsely,stem,stigma,style,subtending,terminal,tube,usually,violet,whitish,wide,x,yellow	.5,0-2,0.4-3,0.8,1-10,1.5-2,10-14,3-5,5,5-merou,6-15,abaxially,absent,acumen,acuminate,adaxially,ag,alyx,apart,apex,apparently,articulated,attenuate,axe,base,blade,capitat,cell,ciliate,connivent,covering,decreasing,digestion,distal,dorsally,eaf,edge,eed,elliptic-lanceolate,end,enzyme,equal,erec,especially,exceeding,filament,flat,flower,folded,forked,fourt,geminat,generally,glabrou,gradually,green-white,hair,hair-like,half,homostylous,honeycomb-shaped,interjected,internal,larger,lengthening,like,living,lower,make,margin,middle,minute,minutely,mucilaginous,narrow,nflorescence,obtuse,one,orbicular,orolla,ovate,pair,perfect,petiolule,placed,plurifoliate,pore,poricidal,puberulent,removed,rounded,ruit,secondary,semierect,seudostipule,short,slightly,slit,spaced,specimen,stamen,star,ste,stolo,straight,subequal,subsessile,symmetrical,tall,tamen,tem,testal,thick,throughout,tip,toward,tri-,tuber,typically,unit,vary,wall,wet,white,wing,ympodial	adhesion,arrangement,calyx,capitate,colour,form,growth,height,history,inflorescence,length,life,na,ovary,perennial,position,pubescence,shape,staman,texture
99	wfo-0001026453	success	211	119	93	118	26	0.441	.5,0.1-2.7,0.45-5.5,0.5,0.5-0.7,0.5-1,0.8-1.1,1-1.5,1-2,1.5-2,1.9-21.3,15,2-2.5,4m,5.5-8,6-8,7-9,acuminate,acute,almost,anther,apex,attenuate,base,berry,bright,brown,calyx,capitate,cm,conical,corolla,diameter,elliptic,entire,flattened,glabrous,globose,growth,inflorescence,lateral,leaf,length,linear,lobe,lobed,long,margin,maturity,midpoint,minutely,mm,narrowly,nearly,oblique,occasionally,opposite,pale,pedicel,peduncle,petiole,poricidal,porrect,pubescence,pubescent,ray,red,reniform,rounded,scattered,sessile,shallowly,shiny,shrub,simple,small,sometimes,stellate,stem,stigma,strongly,style,tan,tapering,thin,tip,tree,trichome,tube,violet,white,x,yellowish	1,1-1.2,10-20,2,30,5-32,6-10,6376,<,abaxially,aberrant,absent,adaxial,adaxially,along,anthesi,apart,armed,articulated,axi,bark,basal,based,beneath,bent,branched,broad,cell,deflexed,deltate-triangular,dense,densely,denser,directed,distall,distally,eaf,easily,eed,enlarged,enmeshing,equal,evenly,exceeding,exserted,filament,filiform,flower,free,fruiting,glabrescent,grayish,hanging,howard,internode,irregularly,lamina,lengthening,less,like,lower,midrib,midvein,new,nflorescence,often,older,one,open,orange,outline,pair,papillo,parallel,per,perfect,pericarp,pitted,plurifoliat,pore,portion,prickle,primary,reddish,rest,ruit,scar,shorter,side,sinuate,slightly,slit,smaller,somewhat,sorter,spaced,sparse,sparsely,sparser,spreading,straight,surfac,surface,tangled,testal,time,triangular,trunk,ud,unarmed,unit,upper,usually,vein,visible,weak,within,ympodial	adhesion,arrangement,blade,climate,colour,form,fruit,glandular,hair,height,history,life,na,number,ovary,perennial,plant,position,presence,present,seed,shape,size,staman,stipe,texture
100	wfo-0001026460	success	131	97	62	69	35	0.473	.1,0.5-1.5,1-1.5,1.5-2,13.5-21,2.5-3,4.5-5,6-7,6-9,7-9,abaxially,acute-acuminate,adaxially,anther,apex,base,becoming,branched,brown,calyx,capitate,cm,completely,corolla,dark,dia,elliptic,floccose,glabrous,globose,green,greenish,inflorescence,internodal,leaf,less,lobe,lobed,minutely,mm,nearly,often,opposite,ovary,ovoid-reniform,pedicel,poricidal,puberulent,reddish,shrub,somewhat,soon,stem,stigma,style,subshrub,tiny,tip,trichome,tube,white,x	.5,1/2,10-15,2-2.5,5,513,8-10,acut,anthesi,axi,berry,closely,conical,deflexed,deltate,distal,do,drying,eaf,edicel,eed,erect,fide,filament,filiform,flower,free,frui,fruiting,inflorescenc,like,long,long-exserted,lower,major,membraneous,middle,nflorescence,older,pair,pale,papillo,papillose,pitted,pore,portion,reddish-brow,reflexed,ruit,santo,scar,shaped,simple,slightly,spaced,surface,tall,tapering,tear-drop,tub,ud,unifoliat,unit,vein,widest,woody,yellow,ympodial,young	acute,adhesion,arrangement,blade,climate,colour,diameter,form,fruit,glandular,growth,hair,height,history,length,life,margin,midpoint,na,number,peduncle,petiole,plant,position,presence,pubescence,ray,seed,shape,size,staman,stellate,stipe,texture,unifoliate
101	wfo-0001026485	success	188	112	83	105	29	0.441	-35,.25,1-10,1-2,1-2.5,1-4,2,2-6,2.3-5,2.5-5,20-30,3-25,3-4,3-6,3-7,3.5-7,4.5-9,5-7,6-9,abaxially,acute,adaxially,andromonoecious,anther,apex,armed,attenuate,base,blade,bright,brown,calyx,cm,compound,connivent,diameter,entire,flattened,flower,fruit,glabrous,globose,greenish-white,inflorescence,leaf,light,lobe,long-attenuate,margin,midvein,mm,oblique,obovoid,opposite,orange,ovate,pair,pedicel,peduncle,perennial,petiole,plant,prickle,puberulent,pubescent,pyriform,rarely,recurved,reflexed,scandent,simple,sparsely,spreading,stellate,stigma,strongly,style,tapering,truncate,tube,unbranched,x,yellow	-1.5,-22,0.25-1,1.5,1.5-5,10-20,10-25,2-3,2-4,20-40,20-50,4-9,45,5-20,5-merou,6-10,7-15,abaxiall,absen,accrescen,aggregate,alyx,apart,appearing,articulated,axe,broadly,chartaceous,congested,cylindrical,developing,difoliate,directed,distall,dr.,eaf,eed,elliptic,elongating,even,fertile,filament,forked,foveolate,fruiting,geminat,glabrou,heterostylous,hollow,imparipinnate,internode,lanceolate,lateral,leaflet,leaving,like,long,lower,lowermost,major,narrowly,nearly,nflorescence,occasionally,one,orolla,per,pore,rachi,recurve,ripe,robust,rugose,ruit,scar,side,slightly,small,sometimes,spaced,speciman,straight,subcoriaceous,subopposite,surface,swollen,tamen,tem,thickened,time,tip,tissue,tone-cell,toward,triangular,trichome,truncat,unit,usually,vary,vein,vin,wide,winged,ympodial	adhesion,arrangement,climate,colour,corolla,form,glandular,growth,hair,height,history,length,life,midpoint,na,number,ovary,position,presence,pubescence,ray,reproduction,seed,shape,size,staman,stem,stipe,texture
102	wfo-0001026489	success	153	93	60	93	33	0.392	0.5-1,0.5-2,0.8-1.2,0.8-1.3,0.8-3.7,1-1.5,1.5-5,2-3,2-4,2-5,2.5-13,2.5-4,2/3,5-6,acute,along,anther,apex,area,axil,base,beneath,branched,brown,calyx,cm,corolla,dark,dia,elliptic,flattened-reniform,glabrous,globose,green,leaf,lobe,lobed,margin,mm,opposite,ovary,pedicel,petiole,poricidal,pubescent,shrub,simple,size,stem,stigma,style,tip,trichome,tube,uniseriate,vein,way,white,widened,x	.3,0.05-0.1,0.25-0.5,0.5,0.5-0.75,0.6-1.4,1.3-3,2-8-flowered,8-13,anthesi,appearing,ba,bark,berry,broadly,closely,cup-shaped,deflexed,deltoid,densely,differing,difoliate,dry,eaf,edicel,eed,erect,exserted,extending,filament,flattened,fleshy,free,fruiting,geminat,gra,incrassate,lamina,later,lateral,lon,long,lower,main,major,middle,minor,minutely,nflorescence,occasionally,often,older,one,overlappin,pair,paler,papillo,papillose,parallel,perpendicular,pitted,planar,pore,portion,prominent,red-papillose,rhachi,ruit,scar,shaped,shiny,slender,somewhat,soon,spaced,specimen,straight,strongly,surface,tall,tapering,tear-drop,terminal,thickened,tub,ud,unit,usually,whitish,widest,woody,ympodial,young	adhesion,arrangement,blade,climate,colour,diameter,form,fruit,glandular,growth,hair,height,history,inflorescence,length,life,midpoint,na,number,peduncle,perennial,plant,position,presence,pubescence,ray,reproduction,seed,shape,staman,stellate,stipe,texture
103	wfo-0001026490	success	272	143	115	157	28	0.423	.5,0.1–0.2,0.1–2.5,0.5–1,0.5–1.5,0.5–8,0.8–1.5,0.8–12,1.5–2,1.5–3.5,10–20,1–1.2,1–2.5,1–3,2.5–3.5,2–2.5,2–4,3,3–4.2,3–4.5,4–5,5–7,7-pinnate,7–15,acuminate,acute,along,anther,apex,axillary,base,blade,brown,calyx,chartaceous,cm,connivent,corolla,darker,densely,diameter,ellipsoidal,elliptic,entire,equal,extra-axillary,filament,flattened,flower,free,fruit,fused,glabrous,green,immature,incurved,inflorescence,irregularly,leaf,length,lenticular,light,lobe,long,main,margin,mature,medium,midvein,mm,moderately,mottled,nearly,oblique,oblong,obtuse,obtusely,orange,ovate,pedicel,peduncle,pentagonal,petiole,pointed,present,pubescence,pubescent,revolute,rounded,seed,shape,shoot,short,simple,size,slightly,sometimes,sparsely,spur,stem,stigma,striping,style,teardrop-shaped,terminal,tip,truncate,tube,vine,violet,white,yellow,½,×,–4.5	0.2–1,0.2–1.5,0.3–3.5,0.4–0.8,0.5–3.5,0.7–3,1.2–8,1.5,1.5–5,1.8–2.2,1.9,1–15,1–8,2,2–6,2–8,3–5,3–5-pinnate,3–8,4.6,4–4.5,5-merous,6,7,=,[,],abaxially,absent,accrescent,adaxially,ag,alyx,anthesi,apart,apical,apicall,apparently,around,articulated,axe,ba,becoming,bract,bracteate,branched,broadly,capitat,cauline,ciliate,climbing,commonly,completely,contiguously,cordate,covered,crisped,cylindrical,decreasing,directed,distal,distally,eaf,eed,eglandular,exceeding,expanded,flat,fruiting,geminat,ground,interjected,lacking,large,lateral,latrorse-introrse,leaflet,lobed,longitudinal,lower,lowermost,lunate,markedly,match,mean,mean=,middle,minute,multicellular,near,nflorescence,node,obliqu,obliquely,oblon,occasionally,one,opening,orolla,ovate-lanceolate,pair,papillose,part,per,perfec,perfect,petiolule,plurifoliate,pore,pseudostipule,pubescen,punctate,pur,rachi,radial,reflexed,reniform,resulting,rooting,ruit,sand,seudostipule,shorter,similar,slender,slit,smaller,smooth,somewhat,spaced,stamen,striation,strongly,surface,tamen,tawny,tem,thickened,toward,trailing,transparent,trichome,trichomessympodial,typically,unbranched,undulate,unit,vary,vegetation,wide,wing,woody,yellowish-tan,youn,–4,–8,–9.5	adhesion,arrangement,capitate,climate,colour,form,glandular,growth,hair,height,herb,history,life,midpoint,na,number,ovary,perennial,plant,position,presence,ray,reproduction,staman,stellate,stipe,texture,young
104	wfo-0001026491	success	165	101	65	100	36	0.394	.5,1-2,1.5-2,1.5-2.5,1.5-3.5,1.7,2-4,2.5-3.5,3,3-pinnate,5-6,5-8,6-8,abaxially,acuminate,acute,adaxially,anther,apex,base,blade,broadly,cm,crinkly,cuneate,deep,diameter,elliptic-lanceolate,entire,globose,green,hair,inflorescence,lanceolate,leaf,light,lobe,margin,mm,oblong-elliptic,often,ovate-elliptic,ovoid,pale,pedicel,peduncle,petiole,present,pubescent,purple,rotate-pentagonal,rotate-substellate,rounded,shortly,shrub,simple,spotted,stigma,straight,strigose,suborbicular-ovate,tube,white,x,yellow	1,10-50,1977,2-3,2-celled,5-merou,7-8,abaxiall,absent,alyx,anderson,apparently,appressed,articulated,averaging,axe,ba,bayonet,bent,berry,bract,branched,branching,capitat,cellular-papillose,cellular-pilose,central,connivent,conspicuously,deciduous,deltoid,densely,directed,distall,eaf,eed,equal,filament,first,flower,geminat,glistening,greatly,growing,highly,homostylous,interjected,lateral,leaflet,less,long,lower,lunulat,mean,middle,minutely,near,nflorescence,obtuse,orolla,ovate,perfect,pilose,plurifoliate,point,pore,poricidal,porrect-incurved,rachi,rarely,readily,reduced,row,ruit,scandent,seudostipule,sharp,similar,slender,small,strigo,strong,strongly,subacute,surface,tal,tamen,tawny,tem,terminal,tightly,tip,tyle,uniseriate,unit,upright,usually,ventral,whitish,ympodial	adhesion,arrangement,calyx,capitate,climate,colour,corolla,distally,form,fruit,glandular,growth,height,history,length,life,midpoint,na,number,ovary,perennial,plant,position,presence,pubescence,ray,reproduction,seed,shape,size,staman,stellate,stem,stipe,style,texture
105	wfo-0001026501	success	195	112	81	114	31	0.415	-1.7,.6,/3,0-1,0.05-0.3,0.27-0.7,0.5-0.6,0.5-0.9,0.5-1,0.6-1.1,0.6-2,0.9-2.2,1-2,1-2.5,1.8-2.2,1/4,2.5-4,2.8-3,3.5-4,6-9,?,acute,anther,apex,base,berry,blade,calyx,chartaceous,cm,cuneate,densely,diameter,dull,elliptic,entire,flattened-reniform,fruit,glabrous,green,leaf,length,lobe,lobed,long,margin,mauve,midpoint,mm,orange-brown,orbicular,ovate,pale,pedicel,peduncle,petiole,poricidal,ray,rounded,scandent,shoot,short,shrub,simple,sparsely,spherical,spreading,stellate,stellate-pubescent,stem,style,surface,tapering,terminal,tip,tube,upper,way,white,wide,yellow	-3,.1,.35,.5,.7,0,0-2,0.1,0.2-1.8,0.5,0.6-1,1,1/2-2/3,1/6-1/2,2-10,3-4,3-5,3-9,4-5,4-7,5-merous,7-9,abaxially,acicular,almost,alyx,apar,apart,apically,apparently,articulated,bark,becoming,borne,branched,brown,brown-green,color,concolorous,curved,deltate,discolorous,drying,eaf,eed,elongated,elongating,equal,erect,eye,filament,filiform,filiform-acuminat,flattened,flower,free,fruiting,glabrou,gray,infructescence,known,light,longer,lower,mature,moderately,naked,nflorescence,often,older,one,open,orolla,oung,pair,pendulous,per,perfec,pericarp,plurifoliat,porrect,portion,prickl,prickle,prickly,primary,reddish,ruit,scar,sessile,shorter,slender,small,smooth,sometimes,somewhat,spaced,stalk,stalked,straight,subsessile,tamen,terete,time,trichome,unarme,unarmed,unit,variously,vary,vein,visible,yellow-green,ympodial	adhesion,arrangement,climate,colour,corolla,form,glandular,growth,hair,height,history,inflorescence,life,na,number,ovary,perennial,perfect,plant,position,presence,pubescence,reproduction,seed,shape,size,staman,stigma,stipe,texture,ye
106	wfo-0001026503	success	269	129	102	167	27	0.379	.3,.5,.9,0.03,0.3–,0.6–0.7,0.6–1.0,0.7,0.7–3.7,0.8–1.1,0.8–1.7,0.8–3.5,1.0–1.6,1.0–3.5,1.1–1.4,1.3–1.6,1.5–2.0,1.9–5.5,1/3,2.2–2.5,2.2–2.8,2.2–6.3,2.6–2.9,3,3.0–4.5,4.0–12.0,8.2,acuminate,acute,adnate,aequilateral,anther,apex,attachment,attenuate,base,blade,calyx,capitate,chartaceous,cm,corolla,diameter,dry,entire,extra-axillary,flattened-orbicular,flattened-reniform,flower,fruit,glabrous,glandular,globose,hair,internode,lacking,lanceolate,lateral,leaf,lobe,long,margin,mature,minute,mm,notched,oblique,oblong,ovate,pedicel,peduncle,petiole,point,present,pubescence,red,red-brown,rotate-stellate,rounded,scarcely,scattered,short,shortly,shrub,simple,sinuate,small,stellate,stem,stigma,straight,style,subacute,tree,tube,upper,white,yellow,yellow-ferruginous,yellow-tan,young,×	.6,0.3–0.6,0.4–1.2,1.0–1.5,1.3,1.3–3.7,1.4–1.7,1.4–2.3,1.5–1.8,1.5–2.5,1.7,1/3–1/2,1/4–1/3,2.3–2.6,22,2–3,4.7,4.8,4.9–5.8,5,5-merou,5.0,6.0,6.9–10.3,7–10,9.0–1.0,90°,abaxially,adaxially,ag,always,alyx,anthesi,apart,apical,apiculate,apparently,appearing,arching,around,articulate,axe,ba,bark,becoming,bent,berry,branch,branching,brochidodromous,brown,bud,central,channeled,deltoid,dentate,depression,developed,development,difoliate,directed,distal,distally,eaf,edge,eed,eglandular,either,emerging,endocarp,exocarp,extending,fertile,filament,filiform,flattened,flexed,free,geminat,glabrou,glossy,gradually,gree,green,homostylous,increasing,intact,interpetalar,intersepalar,irregularly,juic,lackin,layer,lon,lower,lying,major,many,midrib,midvein,minor,moderate,moderately,near,nearly,nflorescence,obviously,ocasionally,occasionally,opaque,orolla,outline,oval,pale,per,perforated,pore,portion,potentially,pubescent,raised,reddish,reflexe,remaining,rigid,row,ruit,shallow,side,sinus,slightly,sloughing,smoot,spaced,sparse,sparsely,splitting,spread,spreading,stamen,stipitate,surface,suture,tamen,tem,thin,though,time,tip,tissue,transparent,truncate,two,ud,unarmed,usually,vary,vein,weakly,well,wide,without,yellowish,ympodia,±equal,±smooth,±straight	adhesion,arrangement,climate,colour,form,growth,height,history,inflorescence,length,life,midpoint,na,number,ovary,perennial,plant,position,presence,ray,reproduction,seed,shape,size,staman,stipe,texture
107	wfo-0001026513	success	138	86	48	90	38	0.348	0.8-2,1-1.5,1-3,2-5,3-5,4-5,6-8,8-16,acute,anther,apex,area,base,calyx,cm,corolla,dia,elliptic,flower,fruit,glabrous,globose,green,lanceolate,leaf,lobe,lobed,long-styled,mm,opposite,ovary,papillose,pedicel,petiole,plant,poricidal,short-styled,shrub,slender,small,stem,stigma,style,tip,treelet,tube,white,x	.1,.25,.3,.75,/3,2-2.2,3-6-flowered,7-9,anthesi,apiculate,ba,bark,berry,broadly,caly,closely,completely,darkish,decurrent,deflexed,delicate,deltoid,differentiated,dry,eaf,edicel,eed,erect,except,exserted,filament,free,fruiting,gre,hirsute,immature,known,lateral,leave,less,live,long,longer,lower,main,mature,middle,minute,minutely,much,nflorescence,obscure,older,overlappin,pair,pale,pore,portion,prominent,raised,reflexed,rest,ruit,scar,shaped,shiny,simple,somewhat,soon,spaced,specimen,straight,styl,surface,tall,tear-drop,trichome,ud,undersurface,unifoliat,uniseriate,unit,vein,venation,way,wide,widest,woody,ympodial,young	0.25,0.3,1,3,adhesion,arrangement,blade,climate,colour,diameter,form,glandular,growth,hair,height,history,inflorescence,length,life,margin,midpoint,na,number,peduncle,perennial,position,presence,pubescence,ray,reproduction,seed,shape,size,staman,stellate,stipe,texture,unifoliate
108	wfo-0001026529	success	219	105	81	138	24	0.37	0.3-1,0.5-4.5,1.1-2.5,1.5-2.5,10-28,11-14,12-22,120-210,3-5,3-9.5,5-15,5-9,6-20,?,abaxially,adaxially,anther,axillary,blue,brownish,bud,chartaceous,clavate,cm,condition,connivent,corolla,creamy,dark,deep,densely,diameter,drying,faintly,fresh,fruit,glabrous,glandular,globose,greatly,green,greenish,herb,lanceolate,length,lilac,long,medium,membranous,mm,moderately,non-glandular,odd-pinnate,ovoid,pedicel,peduncle,pentagonal,petiole,plant,pubescent,pure,rarely,ripe,seed,shape,short,size,slightly,stem,stigma,style,substellate,subtending,terminal,trichome,varying,white,whitish,x,yellow,yellowish	0-25,1,1-10,1-2,1-3,1-4.5,1.5-4,10,2,2-5,2-7.5,20-60,3-12,3-6,4-8,5-17,5-merou,50-70,600-950,acumen,acuminate,acute,ag,along,alyx,apart,apex,apparently,articulated,attenuate,axe,base,berry,blade,broadly,capitat,cell,ciliate,cordate,covering,digestion,distal,dorsally,dot,eaf,edge,eed,elliptic,enzyme,erec,especially,exceeding,except,filament,flat,flower,folded,forked,geminat,generally,glabrou,gland,gree,green-white,hair,hair-like,hal,half,head,homostylous,honeycomb-shaped,interjected,lateral,leaflet,lengthening,light,like,living,lobe,longer,lower,lunate,make,margin,midrib,minutely,mucilaginous,narrowly,nflorescence,oblique,often,orbicular,orolla,ovate,pair,perfect,petiolulate,petiolule,plurifoliate,pore,poricidal,proximal,puberulent,reduced,removed,rounded,ruit,scattered,sessile,seudostipule,slit,spaced,specimen,stamen,ste,straight,subequal,subsessile,tall,tamen,tem,testal,tetralobulate,thick,throughout,tip,tri-,tube,typically,unit,unwinged,usually,vary,wall,wet,wide,wing,ympodial	adhesion,arrangement,calyx,capitate,colour,form,growth,height,hermaphroditic,history,inflorescence,leaf,life,na,ovary,perennial,position,presence,present,pubescence,reproduction,staman,stellate,texture
109	wfo-0001026534	success	150	99	66	84	33	0.44	0.5-1,1-2,1.5-9,10-20,2-2.5,2-3,2-7,2.5-15,3-25,3-4,3-5,3.5-4,4-10,5-6,6-35,7-40,abaxially,acuminate,adaxially,apex,auriculate,base,blade,calyx,chartaceous,cm,connivent,cordate,densely,diameter,eglandular,ellipsoidal,entire,flattened,fruit,glabrous,glandular,hair,lanceolate,lobe,margin,mm,moderately,orange,ovate,ovoid,pale,pedicel,peduncle,petiole,pinkish,puberulent,pubescent,purple,red,simple,stellate,stigma,style,tree,truncate,tube,unbranched,white,x,yellow	-1.5,1-2.5,1-3,1.5-6,10-15,10-50,15-50,2-8,2.5-4,3-,3-10,4-foliat,4.5-5,7-12,absent,acute,aggregate,apart,ape,apiculate,articulated,axe,basal,beyond,branched,bright,cell,connective,cylindrical,darker,deltate,directed,distally,eaf,eed,equal,exserted,fleshy,flower,leaving,lemon-yello,lon,long,longitudinal,lower,m.,narrowly,nflorescence,nther,obtuse,often,orolla,pedicellar,perfect,pore,presen,puberulen,rachi,radiu,remnant,ruit,shorter,slightly,small,spaced,sparsely,stamen,stone,stripe,subcoriaceous,tal,tem,thecae,time,tip,tomento,triangular,truncat,ud,unit,vary,vein,wide,ympodial	adhesion,anther,arrangement,climate,colour,corolla,form,growth,height,hermaphroditic,history,inflorescence,leaf,length,life,midpoint,na,number,ovary,perennial,plant,position,presence,pubescence,ray,reproduction,seed,shape,size,staman,stem,stipe,texture
110	wfo-0001026535	success	248	114	88	160	26	0.355	.5,0.7-1.5,1,1.2-2,1.3,1/2-2/3,1/3,2-3,2-5,2.5,3,3-4.5,3.5-4,7-8,acute,almost,along,anther,anthesi,apex,apparently,base,berry,black,brachyblast,branch,broadly,calyx,chartaceous,clavate,clustered,cm,conical,corolla,cuneate,dark,developed,diameter,distributed,dorsal,drying,elliptic,elongated,entire,evenly,free,fruit,glabrous,leaf,length,liana,lobe,lobed,lower,margin,membranous,mm,number,oblong,obovate,older,orange-brown,ovate,ovoid,partly,pedicel,peduncle,petiole,plant,pubescent,rarely,ray,rounded,shrub,side,stem,stigma,style,terminal,thin,truncate,tube,unevenly,violet,widely,x,yellowish,young	.1,.2,.4,.8,0-0.5,0.1-0.2,0.15,0.2,0.2-0.3,0.2-1.5,0.5-1,1-2,1-3,1-5,1.5-2,1.5-3,3-5,4-15,5-10,5-7,5°,abaxial,abaxially,absent,accrescent,adaxially,age,alternate,alyx,apar,apically,area,around,articulated,bark,becoming,branched,branching,brown,clearly,concolorous,condensed,cup,cupular,curved,deeply,delineate,delineated,deltoid,dendritic,dendritic-pubescent,dense,detaching,developing,dilated,discolorous,divided,domatia,dry,eaf,eed,ellipsoi,equal,except,eye,fertilisation,filament,fine,flat,flexuous,flower,forming,frui,fruiting,green-brown,increasing,inside,known,leave,lengthening,like,linear,lon,long,loop,loose,m.,main,marginal,midvein,minute,minutely,mostly,much,naked,network,nflorescence,nther,obscure,orolla,outside,pair,papillo,pendulous,perfec,pericarp,plurifoliat,pointed,pore,poricidal,portion,primary,prominent,protruding,rachi,raised,reaching,ridged,ruit,scar,secondary,see,short,simple,sinus,slender,slightly,smaller,smooth,soon,spaced,sparsely,spreading,stump,surface,tearing,terete,tertiary,tip,tissue,toward,translucent,trichome,tufted,two,ud,unarmed,uneven,unit,unlignified,vary,vein,venation,visible,weakly,white,wide,wider,ympodial,youngest	adhesion,arrangement,blade,climate,colour,form,glandular,growth,hair,height,inflorescence,midpoint,na,ovary,perfect,position,presence,pubescence,reproduction,seed,shape,size,staman,stellate,stipe,texture
111	wfo-0001026538	success	226	121	90	136	31	0.398	-3.5,-5.8,0.1-0.3,0.6-0.8,0.8-1.2,0.8-2.2,0.9-1.2,1-1.9,1-2.5,1-3,1.2-1.5,1.3-2.8,1.4-2.6,1.7-2.5,12-21.5,2-5,3.2-4.8,3.5-4.6,3.5-5.8,4-8,6-13,abaxially,acuminate,acute,adaxially,anther,apex,base,black,blade,broadly,brown-black,calyx,chartaceous,cm,corolla,decurrent,deltoid,diameter,drying,elliptic,entire,flower,fruit,glabrous,globose,green,hair,inserted,lanceolate,leaf,length,lobe,long-attenuate,margin,mm,mostly,multangulate,obovate,occasionally,ovate,ovate-lanceolate,pedicel,peduncle,petiole,porrect-stellate,pseudo-terminal,pubescence,pubescent,rarely,scabridulous,sessile,short,short-stalked,shrub,simple,small,stellate,stem,stigma,style,subconical,suborbicular,terete,tree,tube,white,x,yellow,yellowish-tan	.5-3,/15-1/9,0-160,0.3-1.5,0.4-,0.8-1.5,1.2-1.4,1.2-2.6,1.4-3,1.5-2.5mm,1.8-4.6,1/2,2-3.5,2.1-3.2,2.1-3.4,3-4,3.7-5.8,5,6.3-8.9,6.7-,8-10,8.1-14.8,[,],accrescent,adaxiall,ag,along,anthesi,apart,apparently,appearing,around,articulated,axe,axillary,ba,bark,berry,blunt-tipped,branch,branched,brown,bud,capitat,closely,completely,constricted,covering,cylindrical,dense,densely,directed,distally,due,eaf,edge,eed,enveloping,exserted,farinose,filament,fleshy,free,frui,fruiting,glabrescen,glabrou,gray,lackin,lateral,lengthening,lobed,long,long-stalked,longer,longitudinal,lower,main,many,measured,midrib,mixed,nearly,nflorescence,obscured,obtuse,older,orolla,overlapping,pale,perfect,plurifoliate,pore,poricidal,porrect-stellat,rachi,rather,reticulate-punctate,ruit,runk,semi-ovate,side,slightly,slit,sometimes,somewhat,soon,spaced,stamen,subcampanulate,surface,suture,tall,tamen,thick,thickened,thin-textured,time,tip,tomentose-pubescent,tomentu,touching,ud,unarme,unarmed,unit,usually,vary,vein,way,weakly,wide,yellowish,ympodial,young	6.7-14.8,adhesion,arrangement,capitate,climate,colour,form,glandular,growth,height,hermaphroditic,history,inflorescence,life,midpoint,na,number,ovary,perennial,plant,position,presence,ray,reproduction,seed,shape,size,staman,stipe,texture,ye
112	wfo-0001026539	success	194	101	67	127	34	0.345	0.2,1-1.5,2,2-4-celled,30,5,5.5,acuminate,acute,anther,apex,basal,base,blade,brown,calyx,cell,chartaceous,clustered,cm,connivent,corolla,creamy,diameter,elongate,entire,equal,flattened-reniform,fruit,glabrous,globose,growth,height,lance-elliptic,lateral,leaf,lobe,long-attenuate,margin,mm,nearly,oblanceolate,occasionally,orange,pedicel,peduncle,perennial,petiole,pilosulose,present,red,rugose,sinuate,staman,stellate,stem,stigma,strongly,style,tapering,terminal,tube,usually,vine,white,yellow,×	-6,.5,0,0.25,0.3-0.5,0.5,0.9,1,1-2-celled,1.5–2,10–15,10–28,15–20,1–2,2.5,2.5–4,20,20–35,2–2.5,2–3,2–4,2–5,3,3–5,4–6,5–,5–10,6–15,abaxially,absent,adaxially,ag,always,alyx,anthesi,apiculate,approximately,armed,articulated,axe,ba,becoming,berry,branched,broadly,bud,campanulate,capitat,cucullate,deltate,densely,dr.,eaf,early,eed,ellipsoid,elongating,exserted,filament,flower,four,glabrou,hair,hooked,ine,interpetalar,larger,lengthening,lobed,long,long-styled,longer,lower,major,midrib,minutely,narrowly,nflorescence,often,one,orolla,pair,pericarp,pitted,pointed,pore,poricidal,prickle,puberulent,pubescent,pustulate,rachi,recurve,recurved,robust,rounded,ruit,sessil,shallow,shoot,short,side,simple,slender,slightly,slit,somewhat,spreading,stout,straight,subwoody,surface,tamen,terminally,time,tip,tissue,triangular,trichome,tub,unequal,vary,vein,wide,winged,woody,young	0.25-0.9,1.5,1.5-2,10,10-15,10-28,2-4,2.5-4,4-6,6-15,adhesion,arrangement,capitate,colour,dry,form,history,inflorescence,length,life,na,number,ovary,plant,position,presence,pubescence,ray,reproduction,seed,shape,size,stipe,texture
113	wfo-0001026604	success	192	109	96	96	13	0.5	.4,.5,0.8-0.9,1-1.2,1.2-1.7,1.5-2,1.5-9,10-30,2-2.3,2-2.5,2.3-3.5,3-3.5,3-5,4-4.5,4.5-7,5-7,acuminate,along,anther,apex,articulated,articulation,bark,base,berry,brown,c.,calyx,capitate,cm,conical,cordate,corolla,dark,diameter,distal,ellipsoid,entire,flattened,fruit,glabrous,globose,growth,inflated,liana,lobed,margin,midrib,minute,minutely,mm,narrowly,new,nodding,oblique,ovary,ovate,ovoid,pair,pale,papillose,pedicel,peduncle,petiole,poricidal,primary,pubescent,purple,quarter,red,reddish,reniform,ripe,shape,shiny,shrub,simple,somewhat,stellate,stem,stigma,stout,style,surface,thin,tip,trichome,truncate,tube,uniseriate,vein,vining,violet,way,woody,x	.75,0,0.1,0.4-0.6,0.8-1,1.1-1.3,3.5-4,5,50-100,<,?,absent,age,aid,always,anthesi,apart,appearing,atop,basal,branching,brow,cell,clearly,climbing,comical,cucullate,cupped,deflexed,densely,differentiated,distinct,drying,due,eaf,eed,elongate,expanding,exserted,filament,flexuous,flower,free,fruiting,later,leaf-opposed,leaving,lengthening,lobe,lower,mere,nflorescence,occasionally,older,outline,overall,papillo,part,particularly,peg,per,perfect,pericarp,pitted,planar,plurifoliat,poin,point,pore,portion,receptacle-like,rim,ruit,scar,series,sinuate,slender,slightly,slit,spaced,strongly,structure,support,swolle,terminal,testal,time,tub,twisting,ud,undulation,unit,upper,widely,ympodial,½	arrangement,bud,colour,form,inflorescence,leaf,length,number,pubescence,seed,size,texture,type
114	wfo-0001026606	success	213	115	71	142	44	0.333	0.4-0.8,0.5-1.6,1.3-1.9,1.4-2.1,12.5-22.5,2-3,3-4.6,3-6,acute,apex,asymmetric,asymmetrically,base,berry,black,blade,broadly,chartaceous,cm,coarsely,cordate,diameter,extra-axillary,flower,fruit,glabrous,globose,golden,hair,lanceolate,lenticular,linear,lobe,margin,midpoint,mm,obtuse,ovate,pedicel,peduncle,pentagonal,petiole,present,pubescence,rarely,ray,rayed,ripe,scabrous,shrub,simple,small,stellate,stellate-pubescent,stelliform,stem,stigma,style,subentire,surface,tan,tapering,toothed,tree,truncate,tube,weakly,white,wider,x,yellow	0.5–0.8,1.7-2.1,10–20,12-17,15–20,15–25,1–1.5,1–3,2.4-3.6,2–2.5,2–4,3–10,3–4,3–5,3–6,4.2-5.2,4–20,4–7,5-merou,5.8-7.2,5–15,6–7,6–8,7.3-9.7,7–12,8–10,abaxial,abaxiall,abaxially,absent,adaxial,adaxially,almost,along,alyx,an¬ther,apart,apiculate,apparently,armed,articulated,axe,ba,band,based,blunt-tipped,branched,broad,capitat,central,closely,compressed,concentrated,cylindrical,densely,developed,difoliate,directed,distally,eaf,eed,entire,eventually,expanded,filament,forming,geminat,glabrate,glabrou,homostylous,initially,internode,interpetalar,larger,lateral,laterally,lighter,lon,long,low,lower,main,midvein,minutely,moderately,much,nearly,nerve,nflorescence,obsolete,occasionally,often,of¬ten,older,open,orolla,perfect,peripherally,persistently,pitted,pore,prickle,prickly,puberulent,pubescen,pubescent,rachi,recurved,reduced,rounded,ruit,scar,scattered,sessile,short,shortly,slightly,sometimes,spaced,sparingly,sparsely,spreading,stellae,stout,tall,tamen,tem,thick,thickened,three,tissue,unarmed,usually,vary,vein,warty,wide,widely,woolly,yello,ympodia,young	0.5-0.8,1-1.5,15-20,15-25,2-2.5,3-10,3-4,3-5,4-20,4-7,6-7,7-12,8-10,adhesion,anther,arrangement,calyx,capitate,climate,colour,corolla,form,glandular,growth,height,history,inflorescence,leaf,length,life,na,number,ovary,perennial,plant,position,presence,reproduction,seed,shape,size,staman,stipe,texture
115	wfo-0001026607	success	204	107	78	126	29	0.382	0.1-0.3,0.8-3.4,0.8-4.5,0.8-5,1-2,10-30,2-2.5,2.4-5.8,2.5-3.8,3-8,4-10,4-6,5.8-19.8,6-10,abaxially,acute,adaxially,anther,apex,axillary,base,blade,brownish,bud,chartaceous,clavate,cm,condition,corolla,decurrent,deep,diameter,drying,elliptic,finely,fresh,fruit,glabrous,globose,green,greenish,hair,herb,lanceolate,leaf,lobe,long,margin,medium,membranous,mm,moderately,obtuse,odd-pinnate,ovate,ovoid,pedicel,peduncle,pentagonal,petiole,plant,puberulent,pubescent,ripe,rounded,seed,sessile,size,stem,stigma,style,subtending,terminal,tube,violet,whitish,x,yellow	0-3,0-4,0.3-1.8,0.5-5.8,1-10,1-3.8,1-5,1-8,1.5-4,2-10,2-3,2.7-19,5,5-merou,absent,acumen,ag,along,alyx,apart,apparently,articulated,attenuate,axe,basiscopic,berry,capitat,cell,ciliate,clearly,coarse,connivent,covering,decreasing,digestion,distal,dorsally,dot,eaf,edge,eed,enzyme,especially,exceeding,filament,flat,flower,folded,forked,forming,geminat,generally,glabrou,greatly,gree,green-white,hair-like,hal,half,high,homostylous,honeycomb,interjected,larger,lateral,leaflet,lengthening,like,living,lower,make,marked,midrib,minute,minutely,much,mucilaginous,nflorescence,often,orbicular,orolla,pair,perfect,petiolulate,plurifoliate,pore,poricidal,present,rachi,rarely,removed,rosette,ruit,scattered,semierec,seudostipule,shaped,short,side,simple,slit,sometimes,spaced,specimen,stamen,ste,straight,tall,tamen,tem,testal,thick,throughout,tip,toward,tri-,typically,unit,unwinged,usually,vary,wall,wet,white,without,ympodial	adhesion,arrangement,calyx,capitate,climate,colour,form,glandular,growth,height,history,inflorescence,length,life,midpoint,na,number,ovary,perennial,position,presence,pubescence,ray,reproduction,shape,staman,stellate,stipe,texture
116	wfo-0001026613	success	159	83	51	108	32	0.321	1-2,11-19.5,2.3-8,2.5-2.8,3-5,4-5,5-6,5-7,6-8,8-18,8.5-10,8.5-9,9.5-13.5,acuminate,anther,apex,base,berry,blade,chartaceous,cm,cordate,corolla,diameter,fruit,glabrous,hair,herb,lanceolate,leaf,lobe,margin,membranous,mm,odd-pinnate,ovate,pedicel,peduncle,petiole,plant,pubescent,purple,rotate-pentagonal,size,stem,stigma,style,terminal,tube,x,yellow	0.5-1,0.6,1-10,1.5-4,2-7.5,3-10,4.5-8.5,5,5-merou,5.5-7,6-12,6.2-9.5,abaxially,absent,acumen,adaxially,ag,along,alyx,apart,apparently,articulated,attenuate,axe,axillary,borne,bud,capitat,ciliate,conical,connivent,decreasing,densely,distal,dorsally,eaf,edge,eed,end,erec,especially,filament,flat,flower,folded,forked,geminat,generally,greatly,green,hal,half,homostylous,immature,interjected,larger,lateral,leaflet,lengthening,like,long,lower,m-1.2,mature,middle,midrib,minute,minutely,mottled,nflorescence,orolla,pair,perfect,petiolule,plurifoliate,pore,poricidal,proximal,puberulent,pubescen,ruit,secondary,semierect,seudostipule,singly,slit,spaced,sparsely,ste,stolo,subequal,subtending,symmetrical,tall,tamen,tem,tip,toward,tri-,tuber,typically,unit,unknow,unknown,unwinged,usually,vary,ympodial	0.6-1.2,adhesion,arrangement,calyx,capitate,climate,colour,dense,form,glandular,growth,height,history,inflorescence,length,life,midpoint,na,number,ovary,perennial,position,presence,pubescence,ray,reproduction,seed,shape,staman,stellate,stipe,texture
117	wfo-0001026614	success	200	86	45	155	41	0.225	.8,0.2,0.4-0.7,1.3-1.8,2.2,4-7,anther,black,brown,calyx,cm,dark,diameter,extra-axillary,flattened-reniform,fleshy,fruit,glabrous,globose,golden,leaf,linear,lobe,mm,mottled,orange,orange-red,ovate,pedicel,peduncle,petiole,pubescence,rotate-pentagonal,shrub,simple,stellate,stellate-pubescent,stem,stigma,style,tube,white,x,yellow,yellowish	0.2–0.3,0.5,0.5–2,1-,1.5–2,11-15,15–30,1–2,1–3,1–5,2.2-5.5,2.5,2.5–3,20–25,2–4,2–4-branched,2–6.5,3-foliate,3.2-5.2,3–10,4.5–11,4.5–5.5,5,5-merou,5.3-8.2,50,6.4-8.4,6–8,7.2-9.8,8–10,9–16,>,abaxially,absent,across,acuminate,acute,adaxiall,adaxially,alyx,apart,apex,apparently,armed,articulated,axe,ba,base,berry,blade,blunt-tipped,broad-based,campanulate,capitat,chartaceous,clavate,closely,commonly,concentrated,cylindrical,densely,denser,developed,directed,distally,dried,eaf,eed,entire,erect,especially,evenly,expanded,filament,flower,foveolate,fruiting,geminate,glabrescent,gland-tipped,globo,hair,homostylous,internode,interpetalar,irregularly,lanceolate-attenuate,lateral,less,lobed,lon,long,lower,margin,midpoint,midvein,minute,minutely,nearly,nflorescence,oblique,obtuse,often,orolla,ovate-lanceolate,ovoid,pair,per,perfect,pore,prickle,pubescent,rachi,rarely,ray,reflexed,repand,ripe,rounded,ruit,scattered,sessile,shallowly,shin,side,similar,slightly,smaller,sometimes,somewhat,soon,spaced,sparsely,spreading,stellae,surface,tall,tamen,tapering,tem,time,tissu,tissue,ud,unarme,unarmed,usually,vary,vein,weakly,well,wide,ympodia,young,–5	0.2-0.3,0.5-3,1-2,1-2.5,1-5,1.5-2,2-4,2-6.5,2.5-3,3-10,4.5-11,4.5-5.5,8-10,9-16,adhesion,arrangement,capitate,colour,corolla,form,growth,height,hermaphroditic,history,inflorescence,length,life,na,ovary,perennial,plant,position,presence,present,reproduction,seed,shape,shiny,size,staman,texture
118	wfo-0001026632	success	108	86	53	55	33	0.491	.5,0,1-2,10-12,7,abaxially,abundantly,acuminate,acute,adaxially,anther,apex,base,blade,broadly,cm,densely,diameter,divided,elliptic,extra-axillary,flower,glandular,hair,halfway,height,lamina,leaf,lobe,long,margin,minute,mm,moderately,ovate,pedicel,peduncle,petiole,prickly,ray,scarcely,short,shrub,simple,stellate,stellate-pubescent,stigma,style,triangular,truncate,tube,unknown,x	1.5,3-4,5-merou,6,acumen,alyx,armed,ba,bu,capitat,cell,central,commonly,condensed,cyme,developed,eaf,eed,equal,erect,exposed,filament,flattened,geminat,interacuminal,lanceolat,lateral,less,little,lon,lower,nflorescence,orolla,porrect-stellate,prickle,prominent,pubescent,reddish-brown,rounded,ruit,sessile,shallow,sinus,straight,structure,tamen,tem,tissue,toward,unarme,unknow,vary,well,ympodial,young	adhesion,arrangement,calyx,capitate,climate,colour,corolla,dense,form,fruit,growth,history,inflorescence,lanceolate,length,life,midpoint,na,number,ovary,plant,position,presence,pubescence,reproduction,seed,shape,size,staman,stem,stipe,texture,ye
119	wfo-0001026642	success	193	102	55	138	47	0.285	0.25,annual,anther,apex,axillary,base,bipinnate,black,blade,blue,brown,calyx,clavate,cm,dark,diameter,flattened,fruit,glabrous,glandular,globose,green-purple,hair,herb,lavender,leaf,length,lilac,lobe,long,mm,multicellular,number,oblong,obtuse,ovate,pale,pedicel,peduncle,pentagonal,perennial,petiole,pinnate,pubescent,shoot,simple,sparsely,stigma,style,subglabrous,tube,uniseriate,violet,x,yellow	.05,.1,.8,0.1,0.1–0.3,0.2,0.4,0.4–2.2,0.5,0.5–,0.5–0.7,0.5–1.7,0.5–2.0,0.5–3.5,0.6,0.6–1.0,0.75–1.0,0.75–2.0,0.7–1.6,0.8–1.2,1.0,1.0–2.0,1.2–1.7,1.2–2.0,1.2–3.5,1.2–6.2,1.6–8.0,1.9–3.0,12–30,1–10,1–3,2.0–4.0,2.5–3.5,2.5–4.0,2.8–3.0,3.0–5.1,3–5,4.0–6.0,4–7,5,5.0–7.0,50–100,6,<,abaxial,abaxially,acute,adaxiall,adaxially,ag,along,anthesi,apart,appressed,articulated,axe,ba,borne,branched,cell,chartaceous,circular,connivent,cylindrical,decreasing,decumbent,densely,denser,divided,eaf,eed,either,elliptic,equal,erect,filament,fleshy,flower,geminat,glabrescen,gland,half,indumentum,lon,longitudinal,lower,m.,moderately,narrow,nflorescence,occasionally,often,opening,orolla,pair,perfect,pinnae,pitted,pore,poricidal,present,primary,probably,rapidly,rounded,ruit,secondary,sessile,shallowly,side,slit,sometimes,spaced,stone,straight,surface,tal,tamen,tem,time,tip,unicellular,unifoliate,unit,usually,vary,vein,white,wide,wing,woody,ympodial,–1.2,–11.0,–2.0,–4.5,–6,–7	0.1-0.3,0.4-2.2,0.5-0.7,0.5-2.0,0.5-3.5,0.75-2.0,0.8-1.2,1-3,1.2-1.7,1.2-2.0,1.2-6.2,1.6-8.0,2.0-4.0,2.8-3.0,3.0-5.1,4.0-6.0,5.0-7.0,50-100,adhesion,arrangement,climate,colour,corolla,form,growth,height,history,inflorescence,life,margin,midpoint,na,ovary,plant,position,presence,pubescence,ray,reproduction,seed,shape,size,staman,stellate,stem,stipe,texture
120	wfo-0001026651	success	222	101	65	157	36	0.293	1,1.8,2.8,3,acuminate,acute,anther,apex,attenuate,base,calyx,capitate,cell,chartaceous,cm,densely,diameter,dull,entire,flattened,flower,fruit,glabrous,glandular,globose,green,hair,herb,lanceolate,lateral,leaf,length,less,lobe,margin,mm,moderate,narrowly-elliptic,oblong-ellipsoid,ovate-reniform,pedicel,peduncle,petiole,plant,pubescence,pubescent,revolute,rounded,seed,shape,shrub,simple,size,slightly,sometimes,stellate,stem,stigma,style,sub-opposite,terminal,translucent,white,yellow,×	-celled,0.2–1.3,0.35–2.6,0.9–3,1–2,2.2–10,2–11.5,2–13,2–3,2–3.3,2–4,2–4.5,2–8,3-plurifoliate,3–5,3–7,4,4–6,4–7.8,5-merou,6–10,6–14,8,abaxially,absent,accrescent,adaxiall,adaxially,along,alyx,anisophyllous,antror,antrorse,antrorsely,apar,appressed,arcuate,ark,articulated,asymmetric,axi,beneath,berry,beyond,branch,broadly,brochidodromous,brown,brownish-green,capitat,ciliate,circular,connivent,cordate,cylindrical,cyme,dark,decumbent,decurrent,differing,directed,discolorous,drying,eaf,eed,elliptic,emarginate,equal,erect,exfoliating,exserted,eye,filament,flexuous,frui,geminate,geniculate,glabrescent,glabrou,growt,head,highly,hilum,hollow,impressed,introrsely,light,like,long,longitudinal,lower,lying,major,markedly,matte,membranaceous,midrib,minor,moderately,mostly,much-branched,multicellular,naked,new,nflorescence,normally,obtuse,older,one,onto,opening,orolla,ovate-deltate,ovate-lanceolate,parallel,pedunculate,per,perfect,pore,poricidal,prominent,reduce,region,ripe,ruit,secondary,shiny,similar,single-celled,slit,small,smaller,spaced,stalk,stamen,straight,subapical,surface,tall,tamen,tem,trichome,turning,unbranched,undulate,uniseriate,unit,upper,usually,vary,vein,venation,visible,wide,woody,ympodial,young	1-2,2-11.5,2-13,2-3.3,2-4.5,2-8,2.2-10,4-6,4-7.8,6-10,6-14,adhesion,arrangement,blade,climate,colour,corolla,form,growth,height,history,inflorescence,life,midpoint,na,number,ovary,position,presence,present,ray,reproduction,staman,stipe,texture,tube
121	wfo-0001026656	success	211	95	70	141	25	0.332	0.3-3,1-1.8,1-2,1-3.8,1.1-8.1,1.5-7,2-6,2.5-17,20-60,4-10,4-13,4-8,5-35,5.5-27,9-11,anther,blue,broadly,brownish,capitate,chartaceous,cm,condition,corolla,densely,diameter,dot,drying,elliptic,fresh,fruit,generally,glabrous,globose,green,greenish,herb,lanceolate,light,lobe,long,membranous,mm,moderately,narrowly,occasionally,odd-pinnate,ovate,ovoid,pedicel,peduncle,pentagonal,petiole,plant,pubescent,purple,rotate-pentagonal,scattered,seed,stem,stigma,style,subglabrous,terminal,tube,violet,white,whitish,wide,yellow	0-4,0.3-4.2,0.4-6.5,0.7-10.5,0.9-13,1,1-10,1-4,1-5,10,2-8,5,5-18,5-merou,abaxially,absent,acumen,acuminate,acute,adaxially,ag,along,alyx,apart,apex,articulated,attenuate,base,bearing,blade,borne,bud,cell,ciliate,clavat,connate,connivent,covering,cuneate,curved,dark,decurrent,digestion,distal,dorsally,eaf,edge,eed,end,enzyme,erec,especially,exceeding,filament,flat,flower,folded,forked,geminat,glaucous,greatly,green-white,greenish-yellow,hair,hair-like,half,homostylous,honeycomb-shaped,interjected,larger,lateral,leaflet,lengthening,like,living,lower,lunate,make,margin,middl,midvein,minutely,mottled,mucilaginous,nflorescence,non-glandular,oblique,often,orolla,pair,petiolulate,petiolule,plurifoliate,pore,poricidal,puberulent,pubescen,rachi,ranging,removed,ruit,scale-like,seudostipule,short,singly,slightly,slit,sometimes,somewhat,spaced,specimen,stamen,star,ste,stolo,straight,subequal,subtending,symmetrical,tall,tamen,tem,tertiary,testal,therefore,thick,throughout,tinged,tip,tri-,truncate,tuber,typically,unit,unwinged,vary,wall,wet,wing,without,ympodial	adhesion,arrangement,calyx,clavate,colour,form,growth,height,history,inflorescence,leaf,length,life,na,ovary,perennial,position,presence,pubescence,reproduction,shape,size,staman,stellate,texture
122	wfo-0001026663	success	251	117	88	163	29	0.351	-2.9,0.2-0.6,0.3-0.8,0.9-1.5,1,1-2.5,1-3.2,1-5,1.1,1.2-2,1.4-2.6,1.6-2.3,10-26,2-12,2.1-2.6,2.5-3.7,2.9-5,2/3,24-45,3.8-5.7,4.7-25.9,8-17,abaxially,acuminate,adaxially,anther,apex,attenuate,base,blade,blunt-tipped,broadly,brown,calyx,cm,conical,corolla,dark,diameter,drying,entire,fleshy,flower,fruit,globose,granular,green,hair,inserted,lanceolate,leaf,length,less,light,lobe,long,margin,mm,obtuse,ovate,pale,pedicel,peduncle,petiole,present,pseudo-terminal,pubescence,ray,rich,scabrous,short,shrub,simple,small,stellate,stem,stigma,style,subglobose,tomentose,tree,tube,upper,violet,white,whitish,x,yellow	-15,-8,-9.7,.5-2.5,/25-1/15,/3,0-160,0.4-2.2,1.1-2.1,1.4-3.1,1.9-2.6,1/2,1/3,1/4-1/2,10.3-13.2,12-14,2.8-5.3,3-5,3.5-5,31,4.5-5.7,5-8,5.5-,5.5-8.8,7.5-9,accrescent,acute,adaxiall,ag,along,angled,anthesi,apart,apparently,appressed,around,articulated,ascending,axe,axillary,bark,becoming,berry,branch,branched,bud,capitat,chartaceous,closely,completely,constricted,covering,cylindrical,densely,directed,distally,distributed,eaf,echinoi,echinoid,echinoid-pubescent,edge,eed,elongated,enveloping,especially,evident,exserted,farinose,filament,flared,free,fruiting,glabrescen,glabrescent,glabrous,granular-tomentose,greenish-brown,grooved,immature,lateral,lengthening,line,lined,lobed,long-stalke,long-stalked,longer,longitudinal,longitudinally,lower,m.,main,many,matur,midrib,midvein,minute,multangulate,multangulate-pubescent,nearly,nflorescence,occasional,occuring,older,opening,openly,orolla,ovate-lanceolat,ovate-lanceolate,perfect,persistent,plurifoliate,pore,poricidal,porrect-stellate,pubescent,rachi,rather,ridged,robust,ruit,runk,sessile,short-stalked,side,slightly,slit,sometimes,somewhat,soon,spaced,sparsely,stalk,stalked,stamen,strongly,subcampanulate,subcoriaceous,subglabrous,suture,tall,tamen,tangled,terete,thick,thin,time,tip,tomentose-pubescent,tomentum,touching,ud,unarme,unarmed,unit,usually,vary,vein,way,wide,ympodial,young	5.5-9,adhesion,arrangement,capitate,climate,colour,form,glandular,growth,height,history,inflorescence,life,midpoint,na,number,ovary,perennial,plant,position,presence,reproduction,seed,shape,size,staman,stipe,texture,unknown
123	wfo-0001026686	success	196	86	64	132	22	0.327	.4,0.6-0.9,1-2,1.5-7,1.7-2.5,10-28,2.4-3.6,3-4,4-6,5-16.5,5-8,6.5-12.7,7-9,8-10,8-27,abaxially,adaxially,anther,axillary,berry,brownish,bud,chartaceous,cm,condition,conical,corolla,densely,diameter,drying,fresh,fruit,glabrous,green,greenish,herb,lanceolate,leaf,light,lobe,long,mm,odd-pinnate,ovoid,pedicel,peduncle,petiole,plant,pubescent,purple-violet,ripe,rotate-stellate,seed,size,sparsely,stigma,style,subtending,terminal,tube,whitish,wide,x,yellow	0.2-0.5,1,1-10,1-2.5,1.2-3.4,1.2-3.6,2-10,2-9,2.5-8,3-5,3.7-8,5,5-merou,8-14,absent,acumen,acuminate,ag,along,alyx,apart,apex,apparently,articulated,axe,base,blade,borne,capitat,cell,ciliate,connivent,covering,decreasing,digestion,distal,dorsally,eaf,edge,eed,elliptic-lanceolate,end,enzyme,equal,erec,especially,exceeding,filament,flat,flower,folded,forked,geminat,generally,glabrou,gradually,green-white,hair,hair-like,half,homostylous,honeycomb-shaped,interjected,larger,lateral,leaflet,lengthening,like,living,lower,make,margin,middle,midrib,minute,minutely,mottled,mucilaginous,nflorescence,obtuse,often,orbicular,orolla,ovate,pair,perfect,petiolule,plurifoliate,pore,poricidal,puberulent,pubescen,purple,removed,round,ruit,secondary,semierect,seudostipule,singly,slightly,slit,spaced,specimen,stamen,star,ste,stolo,straight,stripe,subequal,subsessile,symmetrical,tall,tamen,tem,testal,thick,throughout,tip,toward,tri-,tuber,typically,unit,usually,vary,wall,wet,white,wing,ympodial	adhesion,arrangement,calyx,capitate,colour,form,growth,height,history,inflorescence,length,life,na,ovary,perennial,position,pubescence,reproduction,shape,staman,stem,texture
124	wfo-0001026695	success	128	71	48	80	23	0.375	0.6-8,1-2,1.6,2,2-6,2.5-5.2,2.5-7,3-4,3-8,4,4-5,4-5.5,6-7,6-8,6.5-13,8-16,8-17.5,calyx,cm,compound,connate,corolla,diameter,distal,glabrescent,half,herbaceous,lateral,leaf,leaflet,long,mm,odd-pinnate,ovate,ovate-lanceolate,pedicel,peduncle,perennial,petiole,plant,pubescent,simple,stellate,stigma,style,terminal,wide,yellow	1-1.5,1-4,11-14,2-3,2.5-3,3-6-foliat,6-12,abaxially,absen,acumen,acuminate,acute,adaxially,apex,apical,apically,articulate,base,branched,cordate,cuneate,cyme,decurrent,dehiscent,dichasial,dichasially,dorsally,eaf,ebracteate,edge,eed,exceeding,filament,flat,flower,folded,forked,generally,globo,interjected,introrse,lobe,lon,lower,lunat,maturing,monochasial,nflorescence,nther,oblique,often,one,orolla,pair,perfect,plan,poricidally,proximal,rounded,ruit,sessile,seudostipule,short,short-acuminate,slit,stamen,straight,tal,tem,triangular,tuber-bearing,typically,unit,unknow,unknown,vary,whit,without,ympodial,¼	anther,arrangement,color,form,fruit,globose,growth,height,history,inflorescence,length,life,na,ovary,position,reproduction,seed,shape,size,stem,texture,white,width
125	wfo-0001026696	success	139	71	49	90	22	0.353	0.3-4.5,0.8-7,0.9-7.2,1,1-1.3,1.3-2.1,2-17,3-17,3-3.5,3-6,3-8.5,9,abaxially,adaxially,broadly,calyx,cm,connate,corolla,densely,diameter,distal,globose,green,green-white,half,herbaceous,lanceolate,light,linear,long,mm,odd-pinnate,ovate,ovoid,pedicel,peduncle,perennial,petiole,plant,pubescent,seed,stellate,stigma,style,throughout,white-cream,wide,yellow	1-4,1.5-3,2-3,3-6-foliat,4-16,5-35,acumen,acute,apex,apical,apically,apiculate,articulate,base,branched,cell,covering,cuneate,cyme,decurrent,dehiscent,dichasial,dichasially,digestion,dorsally,eaf,ebracteate,edge,eed,emoval,entire,enzyme,exceeding,filament,flat,flower,folded,forked,generally,globo,hair-like,honeycomb,introrse,lateral,light-yello,living,lobe,lon,lower,lunat,make,margin,maturing,monochasial,mucilaginous,nflorescence,nther,oblong,obtuse,often,orolla,pattern,perfect,plan,poricidally,proximal,reveal,rounded,ruit,seudostipule,short,simple,sinuate,slit,specimen,stamen,straight,tal,tem,testal,thick,throughou,tuber-bearing,typically,unit,vary,wall,without,ympodial,¼	anther,arrangement,color,form,fruit,growth,height,history,inflorescence,leaf,length,life,light-yellow,na,ovary,position,pubescence,reproduction,shape,size,stem,texture
126	wfo-0001026706	success	232	98	74	158	24	0.319	-3.1,0.2-0.3,0.2-0.5,0.8-1.2,0.8-1.5,1-2.2,1-5,1.1-4,1.5-3,12,14-32,2.2-3.3,2.5-3,3-4.6,3.1-3.8,3.6-5.7,4,4.2-12,4.5-5.5,5.3-6.4,6.1-,7-16,9.8-15.4,abaxially,adaxially,anther,blunt-tipped,calyx,cm,coriaceous,corolla,diameter,fleshy,flower,fruit,glabrate,globose,golden,green,inserted,lanceolate,leaf,length,lobe,long,mm,ovate,ovate-elliptic,pedicel,peduncle,petiole,pseudo-terminal,pubescence,shrub,simple,small,softly,stellate,stem,stigma,style,subconical,subglobose,suborbicular,tall,tomentose-pubescent,tree,tube,velutinous,white,whitish,x,yellow,yellowish-tan	-4.4,-5.5,-6.1,.5,/14-1/6,0-240,0.6-2.2,0.8-2.8,0.9-1.9,0.9-2,1/2-2/3,10-15,2.3-3.8,2.7-4,2.9-6,2/3-3/4,5-6.5,6-10,6-8,8-14,accrescent,acute,adaxiall,ag,anthesi,apart,apex,apparently,appearing,around,articulated,attenuate,axe,axillary,ba,bark,base,becoming,berry,blade,branch,branched,brown,bud,capitat,chartaceous,closely,completely,covering,crisped,cuneate,cylindrical,dark,dendritic-echinoid,dendritic-multangulate,densely,directed,distally,eaf,edge,eed,entire,enveloping,exserted,farinose,filament,fourth,free,fruiting,furfuraceou,glabrous,grayish,hair,herbarium,indument,lackin,lacking,lateral,lengthening,lobed,long-stalked,longitudinal,lower,m.,main,many,margin,matted,midrib,minute,mixed,multangulat,multangulate,nearly,nflorescence,oblong,obscured,obtuse,occasionally,often,older,orolla,ovate-lanceolate,pale,perfect,persistent,plurifoliate,pore,poricidal,porrect-stellate,pubescent,rachi,rather,reddish,reticulate-punctate,ruit,runk,semi-ovate,sessile,short-,short-stalked,side,slightly,slit,somewhat,soon,spaced,sparsely,specimen,splitting,stalked,stamen,strongly,subcampanulate,sulcate,surface,suture,tamen,thin-walled,time,tip,tomentu,touching,translucent,transparent,ud,unarme,unarmed,unevenly,unit,upper,vary,vein,wavy,way,wide,ympodial,young	adhesion,arrangement,capitate,colour,form,growth,height,history,inflorescence,life,na,ovary,perennial,plant,position,presence,present,reproduction,seed,shape,size,staman,texture,unknown
127	wfo-0001026707	success	196	107	75	121	32	0.383	-1/3,/3,0.05-0.15,0.3-0.8,0.5-1,0.6-0.7,0.7-1,0.7-1.4,0.7-1.5,1.5-1.8,1.6-2,1/3,1/8-1/4,11-16,2-2.3,2.5-4,3-4,3-4.5,3-7,4,8-15,?,acute,anther,apex,attenuate,base,berry,blade,calyx,chartaceous,clustered,cm,diameter,entire,flattened-reniform,fruit,glabrous,green,lateral,leaf,length,lobe,lobed,long,margin,mauve,midpoint,mm,moderately,narrow-oblong,orange-brown,pedicel,peduncle,petiole,poricidal,ray,rounded,shrub,small,spherical,stellate,stellate-pubescent,stem,style,surface,tapering,terminal,tip,tree,tube,upper,way,white,wide	-3,-5,.5,.8,0,0-20,0.05,0.1-0.2,0.5-3,0.6-0.8,1-1.7,1-3,1-5,1/3-1/2,1/3-3/4,1/4-1/3,2-10,2-6,2.5-3,2.5-6,3-8,5-10,5-25,5-7,5-8,5-merous,abaxially,alyx,apar,apart,apically,apparently,articulated,bark,branche,branched,broad-deltate,broadly,color,concolorous,connivent,curved,cuspidat,decurrent,densely,discolorous,drying,eaf,eed,elongating,equal,erect,eye,filament,flower,foliaceous,free,fruiting,fused,gently,glabrescent,glabrou,gray,inflated,infructescence,juvenil,known,less,longer,lower,mature,naked,narrow-deltate,nflorescence,obtuse,older,one,open,orolla,oung,per,perfec,pericarp,plurifoliat,porrect,porrect-lepidote,portion,prickle,prickly,pubescent,red-brown,reflexed,ruit,scar,sessile,shorter,simple,slender,smooth,sometimes,spaced,sparsely,spreading,stalk,stalked,stout,straight,tamen,terete,time,trichome,unarmed,unit,variously,vary,venation,visible,weakly,yellow-green,ympodial,¼	adhesion,arrangement,branch,climate,colour,corolla,form,glandular,growth,hair,height,history,inflorescence,life,na,number,ovary,perennial,plant,position,presence,pubescence,reproduction,seed,shape,size,staman,stigma,stipe,texture,unknown,ye
128	wfo-0001026711	success	210	111	81	129	30	0.386	-5,0-6,0.1,0.2-0.3,0.3-1,0.5-1.5,0.7-,0.7-1.4,0.75-1,0.8-2.2,0.9-1.1,1.5-2.2,1.7-4,1/3,2-2.2,2-3.5,2.1-2.5,3-4.5,3.5-5.2,4.5-7,7-8,acute,anther,apex,base,berry,blade,calyx,cm,connivent,cuneate,densely,diameter,dull,erect,evenly,flattened-reniform,fruit,glabrous,green,lateral,leaf,length,lobe,lobed,long,margin,maturity,mauve,midpoint,mm,obtuse,orange,orange-brown,pedicel,peduncle,petiole,poricidal,purple,ray,red,rounded,shallowly,shrub,sometimes,spherical,stellate,stellate-pubescent,stem,style,surface,tapering,terminal,thick-chartaceous,tip,tube,upper,weakly,wide,yellow,young	-15,-2,-6,-7,.2,.5,.8,0,0-0.2,0-25,0-4,0.15,0.7-0.9,0.8,0.9-1.5,1-,1-2,1-30,1.5-,1/,1/2-2/3,1/4,1/4-1/3,2-2.5,2-4,2-6,3-4,3-5,3-7,4-8,5-merous,abaxially,acicular,acuminat,alyx,ame,apar,apart,apically,apparently,articulated,bark,branched,brow,c.,cell,concolorous,curved,deltate,difoliate,discolorous,distance,drying,eaf,eed,elliptic,elongating,equal,extending,faint,filament,flower,free,fruiting,geminat,infructescence,less,longer,lower,mature,midvein,moderately,narrow-deltate,nflorescence,occasionally,older,one,open,orolla,oung,outline,pair,pale,pendulous,per,perfec,pericarp,perpendicular,pit,porrect,portion,prickl,prickle,prickly,primary,raised,reduced,reflexed,ruit,scar,sessile,shorter,side,slender,small,smooth,somewhat,spaced,spreading,stalk,stalked,straight,tamen,terete,tertiary,time,trichome,unarmed,uniform,unit,variously,vary,vein,venation,visible,way,woody,yellow-green,ympodial	adhesion,arrangement,climate,colour,corolla,form,glandular,growth,hair,height,history,inflorescence,life,na,number,ovary,perennial,plant,position,presence,present,pubescence,reproduction,seed,shape,size,staman,stigma,stipe,texture
129	wfo-0001026717	success	207	88	66	141	22	0.319	0.3-0.6,0.6-1.5,1-2,1-2.5,1.4-2.2,13-28,14-22,2.5-4.5,2.5-5.5,3-4,3-6,3.3-11,4-6,5-11,5-13.5,5-6,7-11,abaxially,adaxially,anther,brownish,chartaceous,cm,condition,conical,corolla,dark,diameter,drying,elliptic,fresh,fruit,glabrous,green,greenish,herb,lanceolate,leaf,light,lobe,long,membranous,mm,odd-pinnate,ovoid,pedicel,peduncle,pentagonal,petiole,plant,pubescent,purple,ripe,rotate,seed,size,sparsely,stigma,style,terminal,tube,violet,whitish,wide,x,yellow	0.3-2.5,0.3-5,0.8,1-10,1-3,1.3-2.5,1.8-3,15-34,2.2-5,3-5,4-8,4-9,5,5-merou,5.3-9,acumen,acuminate,ag,along,alyx,apart,apex,apparently,articulated,attenuate,axe,axillary,base,berry,blade,borne,bud,capitat,cell,ciliate,connivent,covering,darker,decreasing,decurrent,digestion,distal,dorsally,eaf,edge,eed,end,enzyme,equal,erec,especially,exceeding,filament,flat,flower,folded,forked,geminat,generally,glabrou,gradually,green-white,hair,hair-like,half,homostylous,honeycomb-shaped,interjected,larger,lateral,leaflet,lengthening,like,living,lower,make,margin,medium,middle,midrib,minute,minutely,mottled,mucilaginous,narrow,nflorescence,obtuse,often,one-quarte,orbicular,orolla,ovate,pair,perfect,petiolule,plurifoliate,pore,poricidal,present,puberulent,pubescen,removed,round,ruit,secondary,semierect,sessile,seudostipule,singly,slightly,slit,spaced,specimen,stamen,ste,stolo,straight,stripe,subequal,subglabrous,subsessile,subtending,symmetrical,tall,tamen,tem,testal,thick,throughout,tip,toward,tri-,tuber,typically,unit,usually,vary,wall,wet,wing,ympodial	adhesion,arrangement,calyx,capitate,colour,form,growth,height,history,inflorescence,length,life,na,ovary,perennial,position,pubescence,reproduction,shape,staman,stem,texture
130	wfo-0001026725	success	166	98	66	100	32	0.398	.5,/4,0.2,0.7-1.2,1-1.2,1-1.5,1-4.5,1-5,1.5,1.5-2,1.6-2,2,3.5-4,3.6-7.7,8-18.6,acute,anther,apex,base,beneath,calyx,capitate,cm,corolla,dia,elliptic,flattened-reniform,fruit,glabrous,glandular-papillose,globose,green,greenish-white,large,leaf,less,lobe,lobed,long,margin,minutely,mm,opposite,ovary,ovate,papillose,pedicel,petiole,poricidal,pubescent,reddish-brown,rounded,scarious,shrub,size,stem,stigma,style,tip,trichome,tube,tuft,uniseriate,way,white,x	.3,1.2-1.7,1/2,2.2-4,5-20-flowered,5-5.5,5-6,8-9,accrescent,anthesi,apart,attenuate,axil,bark,becoming,berry,black,bluish,broadly,brownish-papillose,character,crackin,cup-shaped,dark,deflexed,differing,difoliate,dry,drying,eaf,edicel,eed,ellipsoid,evenly,extremely,filament,free,fruiting,geminat,geographically,incrassate,inflorescenc,interpetalar,lateral,lon,lower,main,major,margine,material,middle,minor,nflorescence,occasionally,often,older,one,onto,open,ovoid,pair,pale,paler,papillo,pitted,planar,pore,portion,prominent,proximal,reflexed,ruit,scar,shaped,short,simple,sinus,slender,slightly,spaced,split,straight,stretching,subshrub,surface,tall,tan,tapering,tear-drop,triangular,ud,unit,upper,varying,vein,widest,winged,woody,ympodial,young	adhesion,arrangement,blade,climate,colour,diameter,form,glandular,growth,hair,height,history,inflorescence,length,life,midpoint,na,number,peduncle,perennial,plant,position,presence,pubescence,ray,reproduction,seed,shape,staman,stellate,stipe,texture
131	wfo-0001026733	success	188	122	87	101	35	0.463	-13,-4,-7,0.3-0.5,0.5-2,1-1.5,1-2,1-3,1-7,1.5-14,1.5-2,1.5-2.5,10-20,2-2.5,2-3,2.5-7.5,25-40,3-15,3-3.5,3-7,4,4-23,4-5,5-8,acuminate,adaxially,apex,base,blade,calyx,chartaceous,cm,connivent,cordate,curled,densely,diameter,eglandular-pilose,eglandular-pubescent,ellipsoidal,elliptic-ovate,entire,flattened,forked,fruit,fusiform,glabrous,gland-tipped,glandular-,glandular-puberulent,green,greyish,hair,hirsute,immature,lanceolate,lobe,long,longitudinal,margin,mm,moderately,oblique,ovate,pedicel,peduncle,petiole,pilose,shining,simple,sometimes,stellate,stigma,stripe,style,submarginally,tree,truncate,tube,unbranched,villous,white,white-puberulent,wide,x,yellow,yellowish	-1,-11,-14,-15,-2,-8,.5-3,0.3-2,0.5,0.5-1,0.5-4,1,15-,2-4,2-6,20-50,3-4-foliat,4.5-5,7-10,8-12,abaxially,acute,acute-acuminate,aggregate,apart,ape,articulated,axe,basal,beyond,capitat,cell,ciliat,color,connective,cylindrical,deltate,dense,dia,directed,distally,eaf,eed,eglandular-villous,equal,especially,exceeding,exserted,flower,glabrate,glandula,glandular-tomentose,leaving,linear-triangular,lon,lower,membranaceous,midrib,narrowly,near,nflorescence,nther,orolla,ovoid,ovum,pedicellar,perfect,pore,present,pubescent,pubescent-pilo,pubescent-pilose,rachi,radiu,remnant,ripe,round,ruit,shorter,slightly,small,smooth,spaced,sparsely,stamen,stone,swelling,tal,tem,thecae,time,toward,triangular,ud,unit,unknow,unknown,usually,vary,vein,ympodial	adhesion,anther,arrangement,capitate,climate,colour,corolla,form,glandular,growth,height,hermaphroditic,history,inflorescence,leaf,length,life,midpoint,na,number,ovary,perennial,plant,position,presence,pubescence,ray,reproduction,seed,shape,size,staman,stem,stipe,texture
132	wfo-0001026734	success	266	110	76	190	34	0.286	0.1,0.3,1,3,acuminate,anther,apex,base,blade,broadly,brown,calyx,chartaceous,clavate,cm,connivent,corolla,cuneate,cylindrical,dark,densely,diameter,drying,elliptic,entire,flattened,flower,fruit,glabrous,glandular,globose,green,growth,hair,immature,internodal,lateral,leaf,length,less,lobe,lobed,long,long-attenuate,margin,maturity,membranaceous,midpoint,mm,moderately,obtuse,ovary,pale,pedicel,peduncle,petiole,pubescence,pubescent,purple,ray,reniform,shape,shrub,simple,size,slightly,sparsely,stellate,stem,stigma,style,subopposite,tube,white,wide,yellow	0.2,0.5,0.6,0.7–0.9,0.7–1,0.8–1,1.6–2,1.6–2.5,1.8–2.2,1.8–3,1/4,1–1.2,1–3,2.2–7,2.3–5,2.5–3,2–2.4,2–3,3.2–3.8,3–4,3–4-celled,3–8,4–6,4–7,4–8,4–9,5-merou,5–9,8,abaxial,abaxially,absent,accrescent,acute,adaxial,adaxiall,adaxially,ag,also,always,alyx,anthesi,apical,apice,archin,ark,articulated,associated,asymmetric,axi,barely,becoming,beneat,beneath,berry,branch,branched,bright,caly,camptodromous,capitate,celled,central,closely,commonly,congested,covered,covering,cyme,dense,denser,differing,directed,discolorous,distally,downward,dried,due,eaf,eed,eglandular,emergent,erect,f.,fewer,flat,foliate,forked,found,free,frequently,geminate,glabrescen,glabrescent,gray,held,ilament,initially,introrsely,irregular,j,lamina,lanceolate,large,longer,longitudinal,lower,lying,material,mature,maturit,midri,minute,mostly,much,multiseriate,narrow,near,new,nflorescence,normally,oblong,obovate,observed,often,old,older,one,one-celled,opening,orolla,other,oung,ovate,pair,paired,papillose,perfect,pit,plane,pointing,pore,poricidal,porrect,porrect-stellate,portion,purplish,rachi,raised,rarely,rayed,reaching,rounded,ruit,scandent,secondary,sessile,shiny,short-stalked,shorter,slit,smaller,sometimes,spaced,sparse,spread,spreading,stalk,still,subsessile,surfac,surface,terminal,trichome,tuft,ud,unbranched,unequal,uniseriate,unit,upward,vary,vein,venation,vestiture,visible,whole,yellowish,ympodial,¾	0.7-0.9,0.8-1,1-3,1.6-2,1.6-2.5,1.8-3,2-2.4,2.2-7,2.3-5,2.5-3,3-8,4-9,5-9,adhesion,arrangement,climate,colour,form,height,history,inflorescence,life,na,number,perennial,plant,position,presence,present,reproduction,seed,staman,stipe,texture
133	wfo-0001026739	success	197	97	75	122	22	0.381	0.25-0.94,0.4-5,1-2,1-3,1.2-2.1,16-54,2-9,2.5-13.5,2.6-4.8,3-4,3.2-17.5,4-8,5.6-13.1,6-13,6.6-18,7-9,abaxially,adaxially,anther,axillary,brown,brownish,bud,clavate,cm,condition,coriaceous,corolla,densely,diameter,drying,fresh,fruit,glabrous,globose,green,greenish,hair,herb,lanceolate,leaf,light,lobe,mm,moniliform,oblanceolate,odd-pinnate,ovate,ovoid,pedicel,peduncle,pentagonal,petiole,plant,pubescent,purple,ripe,rotate,seed,short,simple,size,sometimes,stem,stigma,stripe,style,subtending,terminal,tube,tuber,white,whitish,x,yellow	0-0.34,0-38,0.5-1.2,1-10,1.4-3.5,10-60,2-4,2-5.3,2-6,2.7-6.9,3.8-8.5,5-merou,abaxiall,acumen,acuminate,acute,ag,along,alyx,apart,apex,apparently,arranged,articulated,asymmetric,attenuate,axe,base,basiscopic,bead,berry,blade,capitat,cell,connivent,covering,dark,decreasing,digestion,distal,dorsally,eaf,edge,eed,enzyme,erec,exceeding,filament,flat,flower,folded,forked,geminat,generally,glabrou,green-white,hair-like,hal,half,high,homostylous,honeycomb-shaped,interjected,larger,lateral,leaflet,lengthening,like,linear,living,long,lower,make,margin,mucilaginous,multiple,necklace,nflorescence,orbicular,orolla,pair,perfect,petal,plurifoliate,pore,poricidal,removed,rest,rounded,ruit,sessile,seudostipule,side,slit,spaced,specimen,stamen,stolon,straight,sub-glabrous,subequal,tall,tamen,tem,testal,thick,throughout,tip,tissue,toward,tri-,typically,unit,usually,vary,wall,wet,wide,wing,winged,yellowish,ympodial	adhesion,arrangement,calyx,capitate,colour,form,growth,height,history,inflorescence,length,life,na,ovary,perennial,position,pseudostipule,pubescence,reproduction,shape,staman,texture
134	wfo-0001026740	success	171	104	71	100	33	0.415	0-10,0.5-1,1-2,1-3,1-5,10-20,2-3,2-4,2.5-27,2.5-3,2.5-4.5,2.5-6,3-15,3-3.5,3-5,3.5-40,4-5,4.5-10,5-40,5-8,6-10,abaxially,acuminate,acute,adaxially,apex,basal,base,blade,calyx,cm,connivent,cordate,curled,densely,diameter,eglandular,ellipsoidal,elliptic,entire,flattened,fruit,glabrous,glandular-puberulent,greenish,hair,lanceolate,lobe,long,margin,mm,moderately,ovate,pedicel,peduncle,petiole,pilose,puberulent,purple,simple,stellate,stigma,style,subcoriaceous,tree,truncate,tube,violet,whitish,x,yellow	-17,-2,1-10,1-12,1-4,10-30,20-50,3-foliat,8-19,absen,absent,acute-acuminate,aggregate,also,apart,ape,apiculate,articulated,axe,beyond,branched,browni,cell,ciliate,connective,corky,cylindrical,darker,deltate,directed,distally,eaf,eed,equal,especially,exceeding,exserted,fleshy,flower,glabrate,immature,leaving,lon,lower,mature,narrowly,near,nearly,nflorescence,nther,oblong,obtuse,often,orange,orolla,ovoid,pedicellar,perfect,pilo,pore,present,pubescent,rachi,radiu,rarely,remnant,reticulate,ruit,scar,sessile,shorter,slightly,small,sometimes,spaced,sparsely,stamen,stone,stripe,swelling,tal,tems,thecae,time,tomentose,toward,triangular,truncat,ud,unbranched,unit,unlobed,vary,vein,villous,white-puberulent,wide,woody,ympodial,young	adhesion,anther,arrangement,climate,colour,corolla,form,glandular,growth,height,history,inflorescence,leaf,length,life,midpoint,na,number,ovary,perennial,plant,position,presence,pubescence,ray,reproduction,seed,shape,size,staman,stem,stipe,texture
135	wfo-0001026752	success	169	111	85	84	26	0.503	-25,-3,-4,0-,1,1-12,1-2,1-5,1-6,1.5-2,1.5-2.5,10-20,2-2.5,2-3,2.5-20,2.5-5,3-18,3-4,3.5-4,4-45,4-5,abaxially,abruptly,adaxially,also,apex,basal,base,black,branched,calyx,campanulate,chartaceous,cm,cordate,cuneate,darker,densely,diameter,ellipsoidal,elliptic-oblong,elliptic-ovate,entire,finely,flattened,fleshy,forked,fruit,glabrous,globose,green,greenish-brown,immature,lanceolate,lobe,margin,mm,moderately,pedicel,peduncle,petiole,pilose,possibly,pubescent,pubescent-pilose,purplish,rarely,rather,ripe,short-acuminate,simple,stellate,stigma,stripe,style,tree,truncate,tube,unbranched,vein,violet,white,whitish,x,yellow	-50,1-1.5,1-3,1.5-12,15-35,2,2-4,20-30,3,3-5,3-foliat,7-15,8-16,absent,acute,aggregate,apart,ape,apiculate,articulated,axe,beyond,blade,capitat,cell,connective,connivent,coriaceous,cylindrical,deltate,dilated,directed,distally,eaf,eed,equal,exceeding,exserted,flower,hair,laterally,leaving,less,lon,long,lower,narrowly,near,nearly,nflorescence,nther,obtuse,orolla,ovoid,papillose,pedicellar,perfect,pilo,pore,presence,present,rachi,radiu,remnant,ruit,slightly,small,somewhat,spaced,stamen,stone,tal,tem,thecae,time,tomento,triangular,ud,unit,unknow,vary,wide,yello,ympodial	anther,arrangement,capitate,colour,corolla,form,growth,height,hermaphroditic,history,inflorescence,leaf,length,life,na,ovary,perennial,plant,position,pubescence,reproduction,seed,shape,size,stem,texture
136	wfo-0001026754	success	176	93	69	107	24	0.392	-6+,.5,0.5,0.9-1.1,1,1-,1.5-3,1/2,10,2,2-2.5,2-3,2-4,2.5-3.5,2/3,5,5-lobed,5.5-9,anther,apex,base,berry,calyx,clavate,cm,conical,connivent,corolla,deeply,diameter,ellipsoid,elliptic,glabrous,globose,growth,inflorescence,irregularly,lamina,later,lateral,leaf,lobe,lobed,long,loosely,membranous,minutely,mm,narrowly,pedicel,peduncle,petiole,pubescent,simple,sparsely,splitting,stellate-rotate,stem,stigma,style,terminal,tube,vein,vine,way,white,woody,x,yellow	0.5-1,198.,3-4-celled,30+,4-5,5-merou,7-9,9,9-11,abaxially,acute,adaxially,ag,along,alyx,anthesi,apar,apparently,ark,articulated,asymmetric,axi,basal,branched,broadly,brow,cabrera,complete,cucullat,dendritic,densely,denser,distal,divided,eaf,ed,entire,especially,exerted,extending,fide,filament,flower,free,half,halfway,ilament,leaving,lengthening,like,lower,many,margin,mature,midvein,minute,mixture,mostly,new,nflorescence,oblique,older,orolla,outline,pair,papillo,peg,perfect,pinnate,planar,plurifoliat,pore,poricidal,portion,primary,puberulent,ruit,scandent,scar,seen,sleeve,slender,slit,small,sometimes,spaced,spreading,surface,tangled,tem,time,tip,transparent,trichome,truncate,tub,twinin,twining,ud,uniseriate,unit,upper,vary,weak,within,yellowish,ympodial	adhesion,arrangement,colour,form,fruit,height,history,length,life,na,ovary,perennial,plant,position,presence,present,pubescence,reproduction,seed,shape,size,staman,stellate,texture
137	wfo-0001026756	success	147	92	60	87	32	0.408	0-7-1.2,0.5-3,1-1.5,1.5-1.7,1.5-10,1.5-2,1.8-3,3-4,3.5-8.5,5-10,5-5.5,6-16,acute,anther,apex,attenuate,base,bilobed,brown,calyx,cm,corolla,dark,densely,dia,difoliate,elliptic,glabrous,globose,green,hard,leaf,lobe,lobed,long,mm,nearly,opposite,ovary,ovate,ovoid-reniform,pedicel,petiole,pinkish-white,poricidal,pubescence,pubescent,shape,shrub,sparsely,stem,stigma,style,tip,tree,tube,unifoliate,white,wide,woody	.25,.5,0.25-0.5,0.5-1,1-2,1.5-3,5-10-flowered,6-10,abaxial,abaxially,adaxially,along,anthesi,apiculate,ba,bark,berry,broadly,closely,conical,corresponding,deflexed,deltate,dendritic,denser,differing,distal,eaf,edicel,eed,erect,exserted,filament,fleshy,free,fruiting,geminat,glabrescent,grayish-brow,inflorescenc,irregular,lamina,lateral,lax,like,lower,main,major,middle,minor,minutely,nflorescence,occasionally,older,overlappin,pair,pale,papillo,perhaps,pericarp,pitted,planar,pore,portion,present,rest,ruit,scar,shaped,simple,somewhat,soon,spaced,strongly,surface,tall,tear-drop,thick,trichome,tub,ud,uniseriate,unit,vein,widest,ympodial,young	adhesion,arrangement,blade,climate,colour,diameter,form,fruit,glandular,growth,hair,height,history,inflorescence,length,life,margin,midpoint,na,number,peduncle,plant,position,presence,ray,reproduction,seed,size,staman,stellate,stipe,texture
138	wfo-0001026777	success	168	98	66	102	32	0.393	0.5-1,0.5-1.5,1-1.3,1-1.5,1-10,1-2,1-4,1.2-1.8,1.5-3,2-4,2-4.5,3-3.5,5-14,5-7,acuminate,acute,anther,apex,base,beneath,blue,brown,calyx,capitate,cm,corolla,dia,elliptic,fide,flattened-reniform,glabrous,globose,green,growth,leaf,lobe,lobed,margin,minutely,mm,narrowly,nearly,opposite,ovary,papillose,pedicel,petiole,poricidal,pubescent,russet,seed,shiny,shrub,size,sparsely,stem,stigma,style,tip,trichome,tube,tuft,uniseriate,vellozo,white,x	.25,.5,/3,0.25-0.5,0.5-5,0.9-3,1.5-5,2-5,4-8,5-50-flowered,anthesi,apart,apiculate,axil,ba,beginning,berry,body,branching,campanulate,cell,cup,decurrent,deflexed,dense,differing,difoliate,distal,eaf,edicel,eed,end,exserted,filament,filiform,flattened,flexuous,free,fruiting,geminat,glabrate,greyi,hyaline,incrassate,inflorescenc,irregularly,lateral,like,lon,long,lower,main,major,matted,middle,minor,near,new,nflorescence,occasionally,often,older,one,onto,outline,overtopping,pair,papillo,pitted,planar,pore,portion,prominent,quadrate-deltoid,quite,rest,ruit,scar,shaped,sinuate,slightly,smooth,somewhat,soon,spaced,straight,surface,tall,tapering,tear-drop,testa,thread-like,ud,unit,vein,wall,way,widest,woody,yellowish,ympodial,young	0.25,adhesion,arrangement,blade,climate,colour,diameter,form,fruit,glandular,hair,height,history,inflorescence,length,life,midpoint,na,number,peduncle,perennial,plant,position,presence,pubescence,ray,reproduction,shape,staman,stellate,stipe,texture
139	wfo-0001026782	success	206	107	80	126	27	0.388	-10,-4,-5,0.5-1,0.5-2,0–1,1,1-1.5,1.3,1.4–2,1.5,1.8–3,10–15,1–5,2,2-5,3,3-4,3.5–8.5,3–12,4–13,4–6-rayed,6-7,8-10,acute,annual,anther,anthesi,apex,base,blade,blue,bluish,brown,calyx,cm,cordate,dark,darker,diameter,fruit,glabrous,globose,green,greenish,herb,immature,irregularly,length,light,lilac,lobe,margin,maturity,mm,mottling,obtuse,ovate,pedicel,peduncle,petiole,pubescence,purple,ray,reniform,rotate-campanulate,simple,stellate,stem,stigma,style,tapered,thin-textured,tomentose,tube,white,x,yellow,yellowish-brown,–5	0.5,0–10,1.5–2.5,1/3–1/2,15,1–3,2-foliate,2–4,4,4–10-rayed,4–9,5,6,7,abaxially,abundant,abundantly,accrescent,acicular,adaxiall,adaxially,additional,apiculate,armed,articulate,axe,becoming,berr,clavat,clustered,coarse,commonly,curved,dehiscent,deltoid,densely,dilated,divided,eaf,eed,enclosing,exceeding,except,fertile,filament,finely,flower,fruiting,geminat,glabrou,gland-tipped,gradually,hair,internode,interpetalar,larger,like,lon,long,lower,lowermost,main,male,midpoint,midrib,minute,much,much-branched,narrowly,nearly,nflorescence,numerous,often,one,orolla,pair,partially,perfect,pore,porrect-stellate,prickle,pubescent,pustulate,rachi,radiu,rarely,ruit,sessile,shallow,short,shorter,slightly,small,smaller,somewhat,sparsely,spreading,stalk,staminate,ste,stellae,stellate-pubescent,stellate-tomentose,stipitate,straight,strongly,surface,tall,tamen,tem,terminal,thick-stalked,tip,tissue,tooth,triangular,two,unbranched,upper,upward,vary,vein,way,woody,ympodia,–6	4–10,adhesion,arrangement,clavate,colour,corolla,form,growth,height,history,inflorescence,leaf,life,lobed,na,number,ovary,plant,position,presence,present,reproduction,seed,shape,size,staman,texture
140	wfo-0001026788	success	291	131	108	183	23	0.371	.05,.3,0.2–0.3,0.3–0.4,0.3–0.5,0.4–0.6,0.6–1.0,0.6–1.3,0.6–1.9,0.8–1.1,0.9–1.2,0.9–1.3,1.0–1.5,1.2–1.7,1.3–1.6,1.3–2.5,1.5–1.9,1.7–1.9,1/3,2.1–2.9,2.7–5.7,2.8–3.1,3.8,3.8–4.9,4,4–8,6.4,7.8–11.0,8.5,acuminate,acute,adnate,aequilateral,anther,apex,attachment,attenuate,base,blade,calyx,chartaceous,cm,corolla,densely,developed,diameter,dry,entire,erect,extra-axillary,flattened-orbicular,flattened-reniform,flower,fruit,glabrous,glandular,globose,hair,incurved,internode,interpetalar,lanceolate,lateral,leaf,lobe,long,longer,margin,markedly,mature,mm,moderately,notched,oblique,orange,oval,ovate,pedicel,peduncle,petiole,point,pubescent,ray,rounded,scandent,scarcely,shrub,simple,sinuate,slightly,small,sometimes,somewhat,stellate,stem,stigma,style,subcoriaceous,tissue,tree,tube,upper,well,white,yellow,yellow-tan,±glabrous,×	.0,.04,/3,0.4–0.7,0.5–0.7,0.5–0.8,0.8–1.8,0.9–2.0,0–,1.0–2.0,1.1–1.3,1.2–1.6,1.3–1.8,1.4–2.2,1.5–2.2,1.7,1/4–1/3,10.8,1–3,2.0,2.5–11.0,2.9–4.0,2/3,2/3s,2–3,3,3.0,3.4,4.0,4.6–6.0,4–7,5,5-merou,7.0–8.9,8,8.3–10.9,90°,abaxially,absent,adaxially,adjacent,ag,alveolate,alyx,anthesi,apart,apical,apparently,appearing,appressed,around,articulate,axe,ba,bark,basal,based,becoming,berry,branch,branching,broad,broad-based,broadly,brochidodromous,brown,bud,capitat,channeled,clinate,connivent,curved,deciduous,deflexed,deltoid,dentate,development,difoliate,directed,distal,distally,distinct,distinctly,eaf,edge,eed,either,emerging,evenly,exocarp,extending,fertile,filament,filiform,flat,flexed,free,geminat,glossy,gradually,homostylous,hort,increasing,intact,intersepalar,juic,layer,laying,less,lobed,lon,lower,many,midpoint,midrib,midvein,minute,nearly,nflorescence,occasionally,opaque,orolla,per,perforated,pore,porrect,porrect-stellate,portion,potentially,presen,prickle,primary,proximal,raised,reddish,reflexe,remaining,restricted,retrorse,rigid,row,ruit,scattered,sessile,shoot,side,sigmoid,sinus,sloughing,smoot,soon,spaced,sparsely,splitting,spread,stamen,stellae,stellate-pubescent,straight,surface,suture,swelling,tamen,tem,thin,time,transparent,triangular,two,ud,unarmed,unbranched,vary,vein,weakly,wide,yellow-ferruginou,yellow-ferruginous,ympodia,young,±90°,±dense,±equal	0–2.5–11.0,adhesion,arrangement,capitate,colour,form,growth,height,inflorescence,length,number,ovary,plant,position,presence,present,pubescence,seed,shape,size,staman,stipe,texture
141	wfo-0001026790	success	236	123	95	141	28	0.403	-11,-19,-4,-40,0-10,0.2-1.5,0.5-2,0.5-4,0.6-10,0.7-3,1-1.5,1.5-3,1.5-5,1.8-4,1.9-2.6,1/4,1/4-1/2,2-11,2.5-4.5,2.7-3.2,3.5-17,4-9,5-10,6.5-9,7-15,acute,andromonoecious,anther,apex,base,berry,blade,calyx,chartaceous,cm,connivent,cordate,cream,dark,densely,diameter,dull,elliptic,equal,erect,flattened-reniform,flower,fruit,glabrous,glandular,green,hair,lanceolate,lateral,leaf,length,lobe,lobed,long,long-styled,margin,marking,maturity,mauve,midpoint,mm,moderately,orange-brown,ovate,pale,pedicel,peduncle,petiole,plant,poricidal,ray,rounded,short-styled,shrub,smooth,spherical,stellate,stellate-pubescent,stem,style,surface,tapering,terminal,tip,tube,upper,way,wide,yellow,young	-1/2,-1/3,-10,-2,-3,-6,-merous,0,0-150,0-20,0-30,0-5,0.2,0.2-0.4,0.2-0.6,0.2-2,0.7-1.5,0.8,1,1-2,1-3,1.5,1.5-2.5,1.5-4,1/2-3/,1/5-1/3,1/6-1/4,2,2-,2-3,2-30,2-5,2-7,4-,4-11,4-7,5,5-9,6-12,6-8,7-12,7-13,7-20,abaxially,acuminat,adaxially,alyx,ame,apar,apart,apically,apparently,articulated,bark,becoming,branched,broad-deltate,brown-green,c.,concolorous,conical,curved,deltate,discolorous,distance,drying,eaf,eed,elongated,elongating,entire,extending,filament,flattened,free,fruiting,gently,green-brown,heterostylous,inflorescenc,infructescence,longer,lower,mature,midvein,minute,narrow-deltate,near,nflorescence,obtuse,older,one,open,orolla,oung,pair,pendulous,per,pericarp,plurifoliat,porrect,portion,prickle,prickly,primary,red-brow,red-brown,reduced,reflexed,ruit,scar,sessile,side,simple,sometimes,spaced,sparsely,spreading,stalk,stalked,stout,straight,tamen,terete,tertiary,time,toward,trichome,unarme,unarmed,unit,usually,variously,vary,vein,venation,visible,weakly,woody,yellow-green,ympodial	adhesion,arrangement,climate,colour,corolla,form,growth,height,history,inflorescence,life,na,number,ovary,perennial,plurifoliate,position,presence,present,pubescence,reproduction,seed,shape,size,staman,stigma,stipe,texture
142	wfo-0001026818	success	252	112	86	166	26	0.341	-15,-3,-4.5,0-1,0.3-0.8,0.3-2.5,0.5-1,0.5-2.5,0.7-2,1.8-3.5,2-4,2-4.5,2.5-4,2.7-4,3-5,4-10,4-7,5-11,5-15,6.5-9.5,7-30,7-50,8-11,8-15,acute,adaxially,anther,apex,attenuate,base,blade,branched,broadly,calyx,cm,coarsely,cordate,densely,dentate,diameter,elliptic,elliptic-ovate,erect,extra-axillary,fruit,globose,hair,inflorescence,lanceolate,leaf-opposed,length,lenticular,lobe,margin,midpoint,mm,obtuse,orange,orange-red,pedicel,peduncle,perennial,petiole,pubescence,pubescent,ray,reniform-ovate,sessile,shallowly,simple,size,spreading-hirsute,spreadingly,stellae,stellate,stellate-pubescent,stem,stigma,style,tan,thin-textured,truncate,tube,white,x,yellow	-1.5,-2,-2.5,-7,0-1.5,0.1-0.3,0.3-1,0.5-1.5,1,1-4,1.5-,1/3,2,2-15,2-3,2-foliate,2.5-5,4-6,5-12,5-20,5-9,6-10,7-15,abaxially,abrupt,abundant,accrescent,acute-,adaxiall,along,always,apart,apparent,articulated,ascending,average,axe,ba,becoming,broad-based,campanulate,capitat,capitate-glandular,cast,cauline,class,closely,commonly,compresse,connivent,covering,cream,cylindrical,deltoid,density,depressed-deltoid,directed,distal,distall,distinct,eaf,eed,elongate,entire,equaling,especially,essentially,felty-pubescent,female-sterile,filament,flower,foliar,frui,fruiting,geminate,glabrous,grading,inserted,interlobal,large-leaved,larger,largest,lateral,laterally,less,lignescent,like,long,longest,lower,major,maturit,mesocarp,middle,midrib,minutely,mixture,mostly,multiseriate,nearly,nflorescence,numerous,oblique,obtuse-,occasionally,often,one,orolla,oung,outline,ovate,ovate-lanceolate,per,perfect,persistent,pitted,pore,prickle,prickly,principal,prominent,purplish,rachi,radiu,ripe,round-tipped,ruit,scattered,short,shorter,side,similar,sinus,smaller,sometimes,somewhat,spaced,sparse,sparsely,spreading,stalk,stalked,ste,stipitate,surface,tal,tamen,termination,thickened,time,tooth-like,transition,trichome,two,unarmed,unbranched,unit,usually,variable,vary,vein,vivo,weakly,wide,yellowish,ympodial	adhesion,arrangement,capitate,climate,colour,corolla,form,glandular,growth,height,history,leaf,life,na,number,ovary,plant,position,presence,reproduction,seed,shape,staman,stipe,texture,ye
143	wfo-0001026819	success	218	115	84	134	31	0.385	0.5-1.5,1-2,1.5-10,1.5-12,1.5-3.3,1.6-3.5,2-5,2.5-5,3-120,3-18,3-35,3-38,4-10,4-7,5-30,6-11,acuminate,acute,anther,apex,base,blade,blue,broadly,brownish,capitate,chartaceous,cm,condition,corolla,cuneate,densely,diameter,dot,drying,elliptic,fresh,fruit,glabrous,globose,green,greenish,hair,herb,lanceolate,light,lobe,long,margin,membranous,mm,moderately,narrowly,oblique,odd-pinnate,ovate,ovoid,pedicel,peduncle,pentagonal,petiole,plant,pubescent,purple,rotate-pentagonal,scattered,seed,slightly,stem,stigma,stripe,style,subglabrous,symmetrical,terminal,tinged,truncate,tube,usually,violet,white,whitish,wide,yellow	0-27,0.3-4.7,1-10,1-2.3,1-5,1.2-36,1.5-3.0,1.5-3.5,10,10-26,2-6,3-20,4,5-merou,7,abaxially,absent,acumen,adaxially,ag,along,alyx,apart,articulated,ascending,attenuate,bearing,borne,bud,cell,ciliate,clavat,connate,connivent,covering,curved,dark,decurrent,digestion,distal,dorsally,eaf,edge,eed,end,enzyme,erec,especially,exceeding,filament,flat,flower,folded,forked,geminat,generally,glabrou,glaucous,greatly,green-white,greenish-yellow,hair-like,half,homostylous,honeycomb-shaped,interjected,larger,lateral,leaflet,lengthening,like,living,lower,lunate,make,middle,midvein,minutely,mottled,mucilaginous,nflorescence,non-glandular,often,orolla,pair,pedice,petiolule,plurifoliate,pore,poricidal,puberulent,rachi,ranging,removed,ruit,scale-like,seudostipule,short,singly,slit,sometimes,somewhat,spaced,specimen,stamen,star,ste,stolo,straight,subequal,suborbicular,subrosette,subtending,tall,tamen,tem,tertiary,testal,therefore,thick,throughout,tip,tri-,tuber,typically,unit,unwinged,vary,wall,wet,wing,within,without,ympodial	adhesion,arrangement,calyx,clavate,climate,colour,form,glandular,growth,height,history,inflorescence,leaf,length,life,midpoint,na,number,ovary,perennial,position,presence,pubescence,ray,reproduction,shape,size,staman,stellate,stipe,texture
144	wfo-0001026821	success	204	107	74	130	33	0.363	.2,/3,0.4-1.5,0.5-1.2,0.7-1.8,0.8-1,1-2,1-5,1.2-1.5,1.5-2.5,10-15,2-3.5,2.5-18,3-18,4-4.5,5-12,5-20,5-34,acuminate,anther,apex,appressed,base,blade,broadly,brown,cm,cordate,dark,diameter,ellipsoidal,elliptic,flattened,flower,fruit,fused,gglobose,glabrous,green,hair,herb,lanceolate,leaf-opposed,length,light,lobe,long,long-attenuate,margin,mature,membranous,mm,oblique,oblong,obtuse,odd-pinnate,pale,pedicel,peduncle,petiole,pilose,rounded,somewhat,sparsely,stellate,stigma,stripe,style,subglabrous,substellate,tube,white,x,yellow	0-20,0.2-1.5,0.3-1.2,0.3-2.5,0.5-3.5,1-1.5,1-20,1-3,17,1977,2-15,2-6,2-celled,3-11,3-6,3-7,3-branched,3-celled,5-10,5-merou,abaxially,acut,adaxial,adaxially,ag,alyx,anderson,angular,apart,apical,apically,apiculate,articulated,auriculate,axe,ba,basal,bayonet,berry,bract,cell,chartaceous,ciliat,cuneate,deltate,directed,distal,distally,due,eaf,eed,equal,especially,exceeding,filament,forked,frequent,geminat,glabrou,gland-tipped,greatly,homostylous,incurved,interjected,interstaminal,large,lateral,leaflet,longitudinal,lower,lowermost,many,mean,membrane,minute,minutely,moderately,much,narrowly,nflorescence,obliquely,occasional,occasionally,one-celled,opening,orolla,pair,paired,per,perfect,petiolule,plurifoliate,pore,present,pseudostipular,puberulent,pubescen,pubescent,rachi,rarely,reduced,remnant,reniform,ruit,scandent,seudostipule,short,slender,slightly,slit,small,smaller,spaced,stamen,subtended,surface,tamen,tem,terminal,thickening,time,tri-,truncat,unbranched,unit,vary,wall,wide,winged,ympodial	adhesion,arrangement,calyx,climate,colour,corolla,form,glandular,growth,height,history,inflorescence,leaf,life,midpoint,na,number,ovary,perennial,plant,position,presence,pubescence,ray,reproduction,seed,shape,size,staman,stem,stipe,texture,truncate
145	wfo-0001026827	success	143	98	65	78	33	0.455	.5,/3,0.2-0.5,0.4-0.6,0.5-2,0.6-1,1-1.1,1-2.1,1.3-1.6,1.5-2,2-2.2,2-4,3-9,5-6,acute,age,and/or,anther,apex,arachnoid,attenuate,base,calyx,clavate,cm,conical,corolla,dendritic,densely,diameter,glabrous,growth,inflorescence,internodal,lanceolate,leaf,lengthening,lobe,lobed,margin,mm,narrowly,oblanceolate,ovary,pedicel,peduncle,petiole,pore,poricidal,pubescent,revolute,shrub,simple,slit,sparsely,stem,stigma,style,tip,trichome,tube,uniseriate,way,white,x	1-,1-1.5,1-2,2-2.5,7-9,?,abaxially,adaxiall,anthesi,apart,appearing,bark,branch,branched,broadly,crowded,deciduou,deltate,dense,distally,dry,drying,eaf,ellipsoid,erect,especially,exerted,filament,fleshy,flower,free,glabrescent,irregularly,know,known,lamina,less,like,lower,minutely,near,new,nflorescence,nodding,ot,pair,paler,papillat,papillate,perfect,planar,plane,plurifoliat,portion,primary,rachi,reddish,scar,sinus,slender,small,soon,stout,straight,strongly,surfac,surface,terminal,thick,thickened,third,tub,ud,unit,upper,vein,widest,ympodial	1-2.5,adaxially,adhesion,arrangement,blade,climate,colour,form,fruit,glandular,hair,height,hermaphroditic,history,length,life,midpoint,na,number,perennial,plant,position,presence,pubescence,ray,reproduction,seed,shape,size,staman,stellate,stipe,texture
146	wfo-0001026830	success	198	104	80	118	24	0.404	0.3-1.3,0.5-1.0,0.9-1.9,1-11,1-2,1.5-4,10-57,2.5-5,4-10,4-14.5,4-7,4.4-14.5,4.5-17.5,5-11,6-13,anther,axillary,brown,brownish,bud,ciliate,clavate,cm,condition,connivent,coriaceous,corolla,deep,diameter,drying,elliptic,finely,fresh,fruit,glabrescent,glabrous,globose,green,greenish,hair,herb,lanceolate,leaf,light,lobe,long,margin,medium,mm,moderately,moniliform,odd-pinnate,ovate,ovoid,pedicel,peduncle,pentagonal,petiole,plant,puberulent,pubescent,purple,ripe,rotate,seed,short,simple,size,stigma,stripe,style,subtending,terminal,tube,tuber,white,whitish,x,yellow,yellowish	0-10,0.4-1,0.5-1.2,1-10,1.1-2.7,1.4-4,2-4,2-6,2.5-4.4,2.7-8,3.5-8.5,5-merou,7-18,abaxially,acumen,acuminate,acute,adaxiall,adaxially,ag,along,alyx,apart,apex,apparently,arranged,articulated,asymmetric,attenuate,axe,base,basiscopic,bead,berry,blade,capitat,cell,covering,decreasing,digestion,distal,dorsally,eaf,edge,eed,enzyme,erec,exceeding,filament,flat,flower,folded,forked,geminat,generally,glabrou,green-white,hair-like,hal,half,high,homostylous,honeycomb,interjected,lateral,leaflet,lengthening,like,linear,living,lower,make,mucilaginous,multiple,necklace,nflorescence,orbicular,orolla,pair,perfect,petiolulate,plurifoliate,pore,poricidal,removed,rounded,ruit,sessile,seudostipule,shaped,side,slit,spaced,specimen,stamen,stolon,straight,subequal,subglabrou,subglabrous,tall,tamen,tem,testal,thick,throughout,tip,tissue,toward,tri-,typically,unit,unwinged,usually,vary,wall,wet,ympodial	abaxial,adaxial,adhesion,arrangement,calyx,capitate,colour,form,growth,height,history,inflorescence,length,life,na,ovary,perennial,position,pubescence,reproduction,shape,staman,stem,texture
147	wfo-0001026831	success	207	113	83	124	30	0.401	-6.5,-9,0-6,0.1-0.25,0.2-1,0.3-0.65,0.5-1.2,0.6,0.6-2,0.65-1,0.7-2,1-2.2,1-2.5,1.5-2.5,1/3,2-2.5,2.3-2.9,2.5-4.5,3-6,7-8,acute,anther,apex,attenuate,base,berry,blade,bright,calyx,chartaceous,cm,cream,dark,densely,diameter,dull,elliptic,erect,flattened-reniform,fruit,glabrous,green,lateral,leaf,length,lobe,lobed,long,margin,marking,maturity,mauve,membranous,midpoint,mm,moderately,narrow-cuneate,orange,orange-brown,pale,pedicel,peduncle,petiole,poricidal,ray,rounded,scandent,shrub,sparsely,spherical,stellate,stellate-pubescent,stem,style,surface,tapering,tip,tube,upper,white,wide,yellow,young	-0.25,-5,.5,/4,0-10,0-20,0-3,0.1,0.1-0.2,0.15-0.25,0.2-0.4,0.3-0.6,0.7-1.1,1-10,1-2,1-3,1-4,1-6,1.2-2,1/3-1/,1/3-2/3,1/5-1/4,2-3,2-4,3-5,3.5-10,5-merous,7-10,abaxially,alyx,apar,apart,apically,apparently,articulated,bark,branched,broad-deltate,brow,caudat,cell,concolorous,connivent,curved,deltate,difoliate,distance,drying,eaf,eed,elongating,equal,extending,eye,filament,flower,free,fruiting,fully,geminat,glabrescent,gray-brown,herbaceous,infructescence,less,longer,lower,mature,midvein,multangulate,naked,nflorescence,oblong,occasionally,older,one,open,opening,orolla,oung,outline,ovate,pair,pendulous,per,perfec,pericarp,porrect,portion,prickl,prickle,prickly,primary,raised,red-brown,reduced,ruit,scar,sessile,shiny,shorter,side,slender,smooth,sometimes,spaced,spreading,stalk,subsessile,tamen,terete,tertiary,time,trichome,unit,usually,vary,vein,venation,visible,way,white-gray,yellow-green,ympodial	adhesion,arrangement,climate,colour,corolla,form,glandular,growth,hair,height,history,inflorescence,life,na,number,ovary,perennial,plant,position,presence,pubescence,reproduction,seed,shape,size,staman,stigma,stipe,texture,ye
148	wfo-0001026841	success	139	83	47	92	36	0.338	0.25-0.5,0.5-1,0.6-1,0.75-1,0.8-1,0.8-3,1.5,1.5-2,3-6.5,3.5-5,4-8,6-8,9.2-18,acute,anther,apex,base,bi-lobed,calyx,clavate,cm,corolla,dia,elliptic,glabrous,globose,green,inflorescence,leaf,lobe,lobed,margin,mm,opposite,ovary,pedicel,petiole,poricidal,pubescent,shrub,stem,stigma,style,tip,tube,white,x	.25,.5,/4,0.05,0.25-0.3,0.5-0.75,0.5-2,2-2.5,5-8-flowered,7-9,along,anthesi,apart,arch,axi,ba,bark,beneath,berry,broadly,conical,coroll,curly-tipped,decurrent,deflexed,deltoid,eaf,edicel,eed,ellipsoid,exsertion,filament,filiform,free,fruiting,glabrate,greyish-gree,hyaline,immature,joined,known,later,lateral,like,lon,long,lower,main,middle,minutely,nflorescence,older,pair,paler,papillo,papillose,pore,portion,prominent,raised,reddish,reflexed,rest,ruit,scar,series,shaped,shining,simple,slender,slightly,spaced,sparsely,straight,tall,tapering,tear-drop,terminal,thickened,trichome,ud,unevenly,unifoliat,uniseriate,unit,vein,way,widest,winged,woody,ympodial,young	0.25,adhesion,arrangement,blade,climate,colour,diameter,form,fruit,glandular,growth,hair,height,history,length,life,midpoint,na,number,peduncle,perennial,plant,position,presence,pubescence,ray,reproduction,seed,shape,size,staman,stellate,stipe,texture,unifoliate,ye
149	wfo-0001026849	success	180	95	67	113	28	0.372	0-10,0.5-1,1,1-1.5,1-2,1.5-2.5,1.75-2,2,2-3,38/2,637/2,7-8,acute,anther,apex,aster,axil,base,brown,calyx,capitate,cm,colour,conical,corolla,discoidal,entire,expanded,fork,glabrous,glandular,green,grey-brown,growth,hair,inflorescence,lavender,leaf,lobe,long-cuneate,margin,minute,mm,oblong,oblong-lanceolate,ovary,pedicel,peduncle,petiole,reproducing,rh,rotate,rounded,sea,seed,short-lived,shrub,simple,slightly,stem,stigma,style,tube,undulate,vegetatively,violet,x	-50,1-6,100-130,11,30-,40,5,5-10,80-,adherent,adult,amongst,appearing,aspect,australian,berry,cell,composed,conspicuous,curved,cut,cyme,deflexed,developed,dia,distinct,distinctly,eed,ellipsoid,emarginate,enlarge,erect,exceeding,except,exerted,facetted,filament,filled,flesh,floral,flower,flowered,free,fruiting,general,globose,globular,granule,greater,gree,half,interacuminal,large,leave,lengthening,less,linear-lanceolate,little,lon,long,loosely,lower,mature,maturity,mid-vein,minutely,native,nflorescence,occasionally,often,pal,pale,pedicellate,petal,plurifoliat,pore,poricidal,preparation,pruinose,purple,rarely,relatively,reticulate,rhachi,ruit,ruiting,shallow,shed,sinus,slende,slit,soft-wooded,solanum,solitary,sometimes,somewhat,soon,stone,stony,stout,surface,thus,tip,tissue,tub,ud,unarmed,unit,uvenile,way,well,ympodial,young	8,adhesion,arrangement,blade,climate,diameter,form,fruit,height,history,length,life,midpoint,na,number,plant,plurifoliate,position,presence,pubescence,ray,reproduction,shape,size,staman,stellate,stipe,texture
150	wfo-0001026851	success	267	121	84	183	37	0.315	.8,2,4-5,5,acute,andromonoecious,anther,apex,base,berry,bilobed,blade,bright,broadly,c.,calyx,capitate,circular,cm,connivent,cordate,dark,diameter,fading,flattened,flower,fruit,glabrous,gland,globose,glossy,greenish,hair,inside,irregularly,lateral,leaf,less,light,lighter,lobe,lobed,long,long-styled,margin,matte,membranous,minute,minutely,mm,moderately,orange,outside,ovate,pair,pedicel,peduncle,petiole,pilose,plant,pubescence,pubescent,shrub,size,slightly,stellate,stem,stipitate,stipitate-glandular,straw-colored,style,suborbicular,surface,tapering,tip,tube,usually,way,white,wide,winged,yellow,–13,–2	-2,-celled,.4,0.3–1,0.8–1.5,0–1,1,1-7,1.5,1.5–2,1.5–2.8,10-15,15,175–415,1979,1–4.5,1–7,2.2–3.6,2.5–4,2/3,2–10,2–3,2–3.5,300,3–3.6,3–5,4–5-celled,4–6,4–6-celled,5-merous,5–6.5,5–7-celled,6–11,7–12,8–10.5,8–15,=,abaxial,abaxiall,abundant,acicular,adaxial,almost,alyx,apar,appearing,armed,articulated,average,ba,becoming,branched,ciliate,coarse,coarsely,coil,complete,conspicuous,conspicuously,curve,densely,dentate,difoliate,directed,distall,distally,dot,eaf,eed,elongating,endocarp,enlarged,entire,equal,evenly,exceeding,except,eye,fertile,fide,filament,fine,flexuous,free,fruiting,geminat,grading,gradually,green,heavily,heterostylous,hyaline,infructescence,lacking,large,larger,lenticel,little,live,lower,major,making,merely,midrib,minor,mostly,much,n,naked,narrowly,near,nearly,nee,nflorescence,occasionally,often,one,orolla,otherwise,oung,papillo,pattern,per,pericarp,pore,poricidal,portion,preserved,prickle,prickly,recurved,reflexed,rest,ruit,sap,scanden,scant,scar,scarious,scattered,sessile,shiny,short-styled,similar,simple,slender,small,smaller,sometimes,somewhat,spaced,sparsely,specimen,speckled,spongy,sprawling,spreading,stamen,staminat,straight,tall,tamen,tasteles,terete,thick,thickened,tooth,tough,triangular,trichome,twice,unarmed,unbranched,uniform,unit,vary,vein,visible,watery,well,wing,yellowish,ympodial	0.3-1,1.5-2,2-10,2-3,2-3.5,4-6,5-6.5,6-11,7-12,adhesion,arrangement,climate,colour,corolla,form,glandular,growth,height,history,inflorescence,length,life,midpoint,na,number,ovary,perennial,position,presence,ray,reproduction,seed,shape,staman,stigma,stipe,texture
151	wfo-0001026858	success	153	80	57	96	23	0.373	-30,0.8,0.8-1,1-10,1-11.5,1-5,1.3-1.5,1.5-4,2-3,2-4,2.5-3,3-4,4.5-10.5,6-10,6-7,abaxially,adaxially,calyx,cm,connate,corolla,diameter,distal,forked,generally,glabrescent,glabrous,globose,green,green-white,half,herbaceous,interjected,lateral,leaf,leaflet,light,long,mm,odd-pinnate,ovate,ovate-lanceolate,ovoid,pedicel,peduncle,perennial,petiole,plant,seed,shiny,size,stellate,stigma,style,throughout,wide,yellow	-4,0-.,0.5,1-,1-4,2-2.5,3-,3-6-foliat,4-24,5-15,6-18,abruptly,acumen,acute,apex,apical,apically,articulate,base,branched,cell,cordate,covering,cuneate,cyme,dehiscent,dichasial,dichasially,digestion,diminishing,dorsally,eaf,ebracteate,edge,eed,emoval,enzyme,exceeding,filament,flat,flower,folded,globo,hair-like,honeycomb,introrse,living,lobe,lon,lower,lunat,make,maturing,minute,monochasial,mucilaginous,mucronate,nflorescence,nther,oblique,oblong,obtuse,often,orolla,pair,pattern,perfect,plan,poricidally,proximal,reveal,rounded,ruit,seudostipule,short,slightly,slit,specimen,stamen,straight,tal,tem,testal,thick,throughou,toward,triangular,tuber-bearing,typically,unit,vary,wall,white-crea,without,ympodial,¼	0-2,3-15,anther,arrangement,color,form,fruit,growth,height,history,inflorescence,length,life,na,number,ovary,position,pubescence,reproduction,shape,stem,texture,white-cream
152	wfo-0001026870	success	206	102	78	128	24	0.379	%,.5,0-0.1,0.2-0.35,0.25-0.5,0.4-0.8,0.5-1,0.7-1.4,1.4-1.8,15-25,2-3,2-3.5,2-5,2-6,2-7,3-12,4-5,4-9,5-7.5,7-11,7-8,9.5-12,acute,adaxially,anther,apex,black,brownish,calyx,chartaceous,cm,deeply,densely,diameter,dioecious,elliptical,extra-axillary,forked,fruit,glabrous,globose,grey,grey-green,inflorescence,lamina,lanceolate,length,lobe,lobed,long,margin,mm,obtuse,ovate,ovate-reniform,pedicel,peduncle,perennial,petiole,plant,present,purple,ray,ridged,rotate,rotate-stellate,shrub,simple,stellate-pubescent,stem,stigma,style,terete,throughout,tube,unknown,x,yellow	.05,0,0-1,0.05-0.15,0.2-1.2,0.25-0.4,0.3-0.4,0.7-2,1,1-11,1-4,1-5,1.5-2,1.9-3,10-14,11-14,12-28,140-600,18-30,2-foliate,2.5-12,3-10,3-5,300-600,4-7,5-merou,6-70,abaxially,absent,abundant,accrescent,acicular,adaxiall,alyx,apart,armed,articulated,ascending,axe,ba,basal,base,blade,broad-based,broadly,brown,color,cuneate,cylindrical,d.,deltate,diamete,directed,distal,distall,distributed,dult,eaf,eed,eglandular,enclosing,erect,female,filament,finely,finger,flattened,flower,fruiting,functional,geminat,glabrou,gland-tipped,hair,heterostylous,index,interpetalar,lateral,lobing,lon,longer,lower,male,mature,midpoint,midvein,minute,nflorescence,oblique,orolla,part,per,pore,porrect,presen,prickle,probably,pseudo-racemose,reticulate,rhizomatous,ruit,rusty,sessile,short,side,solitary,spaced,stage,stalk,stellae,straight,surface,tal,tamen,thick,time,tissue,triangular,unbranched,unit,unknow,uvenile,vary,vein,white,wide,yellowish,ympodial	adhesion,arrangement,colour,corolla,form,growth,height,history,leaf,life,na,number,ovary,position,presence,pubescence,reproduction,seed,shape,size,staman,stellate,stipe,texture
153	wfo-0001026874	success	222	97	61	161	36	0.275	.3,.5,0-1,0.5,1.5,3-5,6-7,adaxially,anther,asymmetric,attenuate,base,broadly,calyx,cm,connivent,diameter,flower,foveolate,fruit,glabrate,glabrous,glandular-pubescent,globose,growth,lanceolate,leaf,length,lenticular,lobe,mm,near,orange,ovate,pedicel,peduncle,petiole,point,present,pubescence,reddish,ripe,scabrous,shiny,shrub,simple,slender,sparsely,stellate,stellate-pentagonal,stem,stigma,style,surface,tan,thin-textured,tube,white,widest,x,yellow	0,0.2–0.6,1.5–2.5,1.5–4,1.5–5,12–20,15-20,1–,1–3,2,2-foliate,2–2.5,2–3,2–4,2–5,2–6,2–several-branched,4.5,4–7.5,5.5,5.5–7.5,5–15,6–12,6–9,8-12,8–20,9.5–11.5,abaxially,absent,across,acuminate,acute,adaxiall,along,apar,apex,apical,axe,basally,based,berry,beset,blade,broad,capitate,caudate,clavat,colored,compressed,dark,deltoid,dense,densely,depressed,developed,drying,eaf,eed,entire,erect,except,filament,filiform,finely,flowering,fruiting,geminat,generally,glabrou,gland,glandular,green,hair,hermaphroditic,internode,interpetalar,juvenile,lance,lanceolat,lanceoloid,larger,lateral,laterally,lighter,like,lon,long,lower,main,major,margin,midpoint,midrib,midvein,minute,moderately,narrowly,new,nflorescence,obtuse,often,orolla,ovoid,per,perfect,pinnatifid,pore,portion,prickle,prickly,prominently,pubescen,pubescent,rachi,recurved,reduced,repand,rounded,ruit,scattered,sessile,short,side,similar,slightly,small,sometimes,somewhat,spaced,sparse,spreading,stalked,stellae,stellate-tomentose,straight,subulate,swollen,tall,tamen,tem,tip,tipped,tissue,tooth,truncate,ud,unarmed,upon,usually,variable,vary,varying,vein,vestiture,warty,weakly,widely,yello,ympodia,–5,–many	0.2-0.6,1-3,1.5-2.5,1.5-4,12-20,2-2.5,2-3,2-6,4-7.5,5.5-7.5,6-12,6-9,8-20,9.5-11.5,adhesion,arrangement,clavate,colour,corolla,form,height,history,inflorescence,life,na,ovary,perennial,plant,position,presence,reproduction,seed,shape,size,staman,texture
154	wfo-0001026895	success	166	114	82	84	32	0.494	0.5-1.2,0.5-1.5,0.5-2,0.8-1,1-1.5,1-5,1.4-2.1,1.5-2,2-2.3,2-2.5,2-3,2/3,3-12,4.5-5,acute,along,anther,apex,apically,attenuate,base,brown,calyx,capitate,cm,corolla,dark,dendritic,denser,dia,drying,elliptic,flattened,glabrous,globose,green,hard,incrassate,internodal,lamina,leaf,lobe,lobed,margin,mm,mustard,narrowly,often,ovary,pale,pedicel,petiole,pointed,poricidal,pubescent,reddish,reniform,scattered,shape,shrub,shrublet,simple,size,small,sparsely,stem,stigma,style,swollen,swollen-based,tan,tip,toothed,trichome,tube,uniseriate,vein,way,white,woody,x,yellow	.5,0-0.5,0.5-1,2.5-3.2,5-6,5-8-flowered,abaxial,adaxial,anthesi,apical,appearing,ba,bark,berry,borne,broad,broadly,campanulate,closely,conical,contracted,deflexed,deltoid,differing,difoliate,eaf,edicel,eed,ellipsoid,elongate,erect,filament,filiform,free,fruiting,geminat,glabrate,lateral,like,lon,long,long-exserted,lower,main,major,middle,minor,minute,minutely,nflorescence,obovate,older,overlappin,pair,papillo,pericarp,pitted,pore,portion,present,projection,reddish-brow,ruit,scar,shaped,shoot,short,side,somewhat,soon,spaced,surface,tall,tear-drop,thin,tub,tuft,type,ud,unit,usually,widest,ympodial,young	0.5,adhesion,arrangement,blade,climate,colour,diameter,form,fruit,glandular,growth,hair,height,history,inflorescence,length,life,midpoint,na,number,peduncle,plant,position,presence,pubescence,ray,reproduction,seed,staman,stellate,stipe,texture
155	wfo-0001026905	success	204	117	88	116	29	0.431	0-2,0.15,0.3-0.4,0.4-1,0.5-0.7,0.5-1.5,0.6-0.7,0.75-1.1,0.9-1.3,1-2,1-2.5,1-3.7,1.9-2.5,1/2-3/4,1/3,2.5-2.9,2.5-3.5,3-5,3-8,7-8,acute,anther,apex,attenuate,base,berry,blade,calyx,chartaceous,cm,connivent,cream,dark,densely,diameter,dull,equal,erect,flattened-reniform,fruit,glabrous,green,inflorescence,lateral,leaf,length,lobe,lobed,long,margin,marking,maturity,mauve,midpoint,mm,moderately,oblong,orange,orange-brown,ovate,pale,pedicel,peduncle,petiole,poricidal,ray,red,rounded,shallowly,shrub,sometimes,sparsely,spherical,stellate,stellate-pubescent,stem,style,surface,tapering,tip,tube,upper,usually,way,white,wide,yellow,young	-1.5,-10,-2,-2/3,-3,-4,.2,.5,0,0-20,0-25,0.1,0.2-0.3,0.2-0.5,0.4,0.4-0.9,0.7-1.4,1,1-20,1-4,1-6,1/4,1/5-1/3,2-3,2/3-3/,5-6,5-merous,6-8,abaxially,acuminat,alyx,ame,apar,apart,apically,apparently,articulated,bark,branched,brow,c.,cell,curved,deltate,difoliate,discolorous,distance,drying,eaf,eed,elongating,extending,eye,filament,flower,free,fruiting,geminat,gray-green,infructescence,longer,lower,mature,midvein,naked,older,one,open,orolla,oung,outline,pair,pendulous,per,perfec,pericarp,pit,porrect,portion,prickl,prickle,prickly,primary,raised,reduced,ruit,scar,sessile,shorter,side,slender,small,smooth,somewhat,spaced,spreading,stalk,stalked,straight,subentire,tamen,terete,tertiary,time,trichome,unarmed,unit,variously,vary,vein,venation,visible,weakly,woody,yellow-green,ympodial	adhesion,arrangement,climate,colour,corolla,form,glandular,growth,hair,height,history,life,na,number,ovary,perennial,plant,position,presence,present,pubescence,reproduction,seed,shape,size,staman,stigma,stipe,texture
156	wfo-0001026923	success	177	109	81	96	28	0.458	0.25-0.5,0.5,0.5-1,0.6-0.8,0.8-1,1,1-1.5,1-7,10,2,2-2.5,2-6,3-5,4-18,5-10,5-15,5-9,abaxially,absent,acuminate,adaxially,anther,apex,base,black,blade,brown,calyx,chartaceous,cm,cuneate,densely,diameter,elliptic,elliptic-ovate,entire,equal,flattened,flower,fruit,glabrescent,glabrous,globose,green,leaf,leaf-opposed,light,lobe,long,margin,midpoint,mm,moderately,nearly,oblong,orange,pedicel,peduncle,petiole,possibly,pubescence,pubescent,purple,ray,red,ripening,rounded,shrub,simple,small,sparsely,stellate,stem,stigma,strongly,style,tree,tube,white,x,yellow	-5,.1-0.3,.5,0-5,1-3,1-4,1.5-2,1.5-4,2-3,20-50,3-4,4-5-,5-6,accrescent,acute,adaxiall,ag,apart,apparently,articulated,axe,ba,branched,capitat,center,connivent,covering,curved,cylindrical,deltate,denser,directed,distally,eaf,eed,eglandular,erect,filament,forked,frui,fruiting,fused,geminate,gland-tippe,glandular,hair,held,intermediate,lanceolate,large,lateral,like,longitudinal,lower,many-foliate,midvein,much,multangulate,nflorescence,opening,orolla,paired,peltate,perfect,pore,rachi,relatively,rugulose,ruit,scale,sessile,short,slightly,slit,smaller,sometimes,somewhat,spaced,ste,straight,subtending,surface,tal,tamen,tem,time,tip,trichome,unit,uprigh,usually,vary,whitish,wide,yellowish,ympodial	0.1-0.3,adhesion,arrangement,capitate,climate,colour,corolla,dense,form,growth,height,history,inflorescence,length,life,na,number,ovary,plant,position,presence,reproduction,seed,shape,size,staman,texture,ye
157	wfo-0001026924	success	190	107	79	111	28	0.416	0-0.2,0-2.3,0.2-0.4,0.5-0.6,0.5-0.7,0.5-6,0.8-2.6,0.9-1.3,1-1.5,1-4,1.1-4.2,2-4,2.8-8.5,3-6,4.3-6.2,5-7,7-8,8-9,absent,acute,adaxially,anther,apex,base,blade,brown,calyx,chartaceous,cm,cordate,cuneate,densely,diameter,drab,drying,eglandular,entire,extra-axillary,finally,fruit,glabrous,globose,green,grey,grey-green,hair,herbaceous,inflorescence,lanceolate,length,light,lobe,lobed,long,margin,midpoint,mm,obtuse,ovate,pale,pedicel,peduncle,petiole,present,purple,ray,resprouter,shallowly,simple,stellate,stellate-pubescent,stem,stigma,style,truncate,tube,x,yellow,yellowish	%,-4,0-1.5,0-2,0.05-0.1,0.05-0.2,0.1-0.3,0.4-0.5,0.5-0.8,0.5-1.5,0.7-1.1,0.7-1.2,0.8-1.2,1-6,10-13,17-40,2-,2-2.5,2-foliate,3,4-7,5,5-merou,6-8,7-10,abaxially,absen,accrescent,acicular,across,adaxiall,alyx,apart,apparently,appearance,axe,capitat,connivent,curved,cylindrical,d.,directed,distall,distally,distributed,dult,eaf,eed,erect,finger,first,flower,fruiting,geminat,glabrou,gland-tipped,half,lamina,lateral,less,longer,lower,markedly,mature,mid-poin,minute,minutely,narrowly,nflorescence,oblique,orolla,part,per,perfect,pore,porrect,prickle,pseudo-racemose,rachi,raisin-like,rostrate,ruit,rusty,short,slightly,spaced,sparsely,stage,stalk,stellae,straight,surface,tal,tamen,thick,thicker,thicknes,throughout,time,triangular,unarme,unarmed,unbranched,undulate,unit,unknow,uvenile,vary,white,wide,ympodial	adhesion,arrangement,capitate,climate,colour,corolla,form,glandular,growth,height,history,leaf,life,na,number,ovary,perennial,plant,position,presence,pubescence,reproduction,seed,shape,size,staman,stipe,texture
158	wfo-0001026925	success	215	108	80	135	28	0.372	.5,0.5-1.5,0.9-1.8,1-1.4,1-25,1-3.5,1.8-2,1/3,2.4-2.6,2.4-3,3-7,4-14,4-7,6-17,6-8,7-12,acute,andromonoecious,anther,apex,attenuate,base,berry,blade,calyx,chartaceous,cm,connivent,cream,dark,diameter,elliptic,equal,erect,flattened-reniform,fruit,glabrescent,glabrous,green,hair,lateral,leaf,length,lobe,lobed,long,margin,marking,maturity,mauve,membranous,midpoint,mm,moderately,orange-brown,ovate,pale,pedicel,peduncle,petiole,plant,poricidal,ray,shrub,sparsely,spherical,stellate,stellate-pubescent,stem,style,surface,tapering,terminal,tip,tube,upper,white,wide,yellow,young	-2,/6,0,0-10,0-20,0-5,0-7,0.1,0.1-0.2,0.1-0.3,0.2,0.5-4,0.7-1.8,00-200,1-1.3,1-3,1-4,1.5-2,1.5-2.5,1.5-4.5,1.8-2.5,1/3-1/2,1/4-2/3,1/6-1/3,2-4,2-5,2.5-6,2/,3-20,4-10,4-5,5-6,5-8,5-merous,5.5-10,6-10,abaxially,acuminat,alyx,ame,apar,apart,apically,apparently,articulated,bark,branched,broad-deltate,brow,c.,concolorous,curved,deltate,distal,distance,drying,eaf,eed,elongating,extending,filament,flattened,flower,free,fruiting,gently,green-brown,hermaphrodite,heterostylous,infructescence,lobing,long-styled,longer,lower,lowermost,mature,midvein,minute,narrow-deltate,nflorescence,oblong,older,one,open,orolla,oung,pair,pendent,pendulous,per,pericarp,plurifoliat,porrect,portion,prickl,prickle,prickly,primary,rarely,red-brown,reduced,reflexed,rounded,ruit,scar,secondary,sessile,short-styled,side,simple,smooth,sometimes,spaced,spreading,stalk,stalked,staminat,stout,straight,tamen,terete,tertiary,time,translucent,trichome,unarmed,unit,vary,vein,venation,visible,way,woody,yellow-orange,ympodial	adhesion,arrangement,climate,colour,corolla,form,glandular,growth,height,history,inflorescence,life,na,number,ovary,perennial,position,presence,present,pubescence,reproduction,seed,shape,size,staman,stigma,stipe,texture
159	wfo-0001026946	success	205	98	76	129	22	0.371	0.5-2,1-2,1-4,1.5-2,1.6-3.7,10-39,12-23,2-15,2.5-10.5,3-5,3.5-10,5-7,6-24,8-15,abaxially,adaxially,anther,axillary,broadly,brownish,bud,chartaceous,clavate,cm,condition,corolla,creamy,deeply,densely,diameter,drying,elliptic,fresh,fruit,glabrous,globose,green,greenish,herb,lanceolate,lobe,long,membranous,mm,mottled,narrowly,odd-pinnate,ovate,ovoid,pedicel,peduncle,pentagonal,petiole,plant,pubescent,pure,purple,ripe,seed,short,short-pubescent,size,slightly,stellate,stem,stigma,streak,style,subtending,terminal,tube,white,whitish,x,yellow,yellow-white	0-20,0-5,0.9-3.5,0.9-4.3,1,1-10,2,2-5,2.7-9,3-20,3-6,4-7,4.1-9.4,5-merou,8-25,acumen,acuminate,acute,ag,along,alyx,apart,apex,apparently,articulation,attenuate,axe,base,berry,blade,borne,capitat,cell,ciliate,connivent,covering,digestion,distal,dorsally,dot,eaf,edge,eed,end,enzyme,erec,especially,exceeding,except,extremely,filament,flat,flower,folded,forked,geminat,generally,glabrou,greatly,green-white,hair,hair-like,half,homostylous,honeycomb-shaped,interjected,lateral,leaflet,lengthening,like,living,lower,make,margin,midrib,minutely,mucilaginous,nflorescence,oblique,often,orbicular,orolla,pair,perfect,petiolulate,petiolule,plurifoliate,pore,poricidal,proximal,puberulent,pubescen,reduced,removed,rounded,ruit,scattered,sessile,seudostipule,singly,slit,spaced,specimen,stamen,ste,stolo,straight,subequal,tall,tamen,tem,testal,thick,thir,throughout,tip,tri-,truncate,tuber,typically,unit,unwinged,usually,variable,vary,wall,wet,wing,ympodial	adhesion,arrangement,calyx,capitate,colour,form,growth,height,history,inflorescence,leaf,length,life,na,ovary,perennial,position,pubescence,reproduction,shape,staman,texture
160	wfo-0001026962	success	205	99	68	137	31	0.332	.05,0.3-0.7,0.5-0.8,1,1-1.2,1-1.5,1-3,1-6,1.5-17,1.5-2,1.5-5,10-12,2-2.5,2-6,3-3.5,4-5,6-7,acute,anther,apex,base,blade,calyx,chartaceous,cm,corolla,diameter,difoliate,dry,elliptic,entire,flattened-reniform,fruit,glabrous,globose,green,inflorescence,internodal,leaf,lobe,margin,material,mm,narrowly,oblong,occasionally,opposite,pale,pedicel,peduncle,petiole,purplish,shrub,size,small,sometimes,somewhat,stellate,stem,stigma,style,tinged,tree,tube,unifoliate,white,x,yellow	.5,0,0.5,0.5-1,0.5-1.5,0.8-1,1-2,1-4.5,1.5-3,10-20,15-22,2-5,2/3-3/4,3-6,9-12,9-17,abaxially,abrupt,abruptly,accrescent,adaxially,ag,alyx,anthesi,apparently,appearing,arising,articulated,axe,bark,basebud,becoming,beneath,brittle,broadly,bud,capitat,cell,closely,composed,connivent,constricted,cucullat,cylindrical,darker,deflexed,deltate,densely,denser,differing,dimorphic,eaf,eed,elongate,evenly,except,exerted,filament,flower,free,fruiting,geminat,glabrate,glabrou,ilament,incrassate,later,lateral,like,lobed,long,longitudinal,main,major,minor,minutely,nflorescence,obconic,obovoid,often,older,one,opening,orolla,oung,outline,ovate-lanceolate,overlapping,packed,pair,papillose,paten,pendent,perfect,pitted,pore,portion,prominent,pubescen,pubescent,rachi,raised,reflexed,remaining,rest,rounded,rounder,ruit,sagittate,shaped,simple,slender,slightly,slit,soon,straight,surface,tal,tapering,tear-drop,tip,tooth,triangular,trichome,trunk,unarmed,unbranched,uniseriate,unit,vary,vein,way,whit,woody,yellowish,ympodial,young	adhesion,arrangement,capitate,climate,colour,dense,form,geminate,glandular,growth,hair,height,history,length,life,midpoint,na,number,ovary,perennial,plant,position,presence,pubescence,ray,reproduction,seed,shape,staman,stipe,texture
161	wfo-0001026963	success	151	94	64	87	30	0.424	.5,0.2-0.6,0.8-3,1-1.5,1.2-1.5,1.5-4.5,1.5-6,2-2.5,2-4.5,3-5,6-7,acute,anther,apex,apical,base,c.,calyx,capitate,cm,conical,coriaceous,corolla,diameter,elliptic,elongate,flower,glabrous,growth,herb,heterostylous,inflorescence,internodal,lobe,lobed,long-styled,margin,membranous,midpoint,minute,minutely,mm,ovary,ovate,pedicel,peduncle,petiole,pubescent,ray,shallowly,simple,sparsely,stellate,stem,stigma,style,subshrub,tapering,tooth,truncate,tube,way,white,x	-5,.4,0.5,0.5-0.6,1-2,1.1-1.4,3-5-rayed,4,4-5,5-6,<,abaxially,abruptly,absent,acicular,anthesi,armed,articulated,bark,brow,closely,clustered,creeping,cup-shaped,curved,dark,deep,densely,eaf,eed,ellipsoid,elongating,filament,free,included,inflorescenc,know,known,like,long,long-triangular,lower,markedly,mature,new,nflorescence,nodding,node,oblique,older,outline,pair,papillo,per,plurifoliat,pore,poricidal,porrect,portion,prickle,prickly,primary,prominent,reddish,reflexed,rooting,rootstock,ruit,scar,scattered,sessile,short-styled,side,slit,small,sometimes,spaced,surface,tip,trichome,ud,unarmed,unit,vein,woody,yellowish,ympodial	adhesion,arrangement,blade,climate,colour,form,fruit,glandular,hair,height,history,leaf,length,life,na,number,papillose,perennial,plant,position,presence,present,pubescence,reproduction,seed,shape,size,staman,stipe,texture
162	wfo-0001026964	success	128	91	57	71	34	0.445	.2,.5,0,0.5,0.5-1,10,10-30,2-2.5,3-5,7-8,acuminate,acute,anther,apex,attenuate,axillary,base,calyx,cm,conical,corolla,diameter,elliptic,glabrous,green,greenish,herb,lobe,lobed,long,margin,minutely,mm,nearly,obovate,ovary,pedicel,petiole,pinnate,poricidal,pubescent,purple,rugose,shape,simple,size,smooth,somewhat,sparsely,stigma,style,tip,trichome,tube,uniseriate,x,yellow	1-1.2,1-2.5,2-4,3.5-7,4.5-8.5,?,along,anthesi,basal,beak,bearing,berry,capitat,conspicuously,differentiated,distinct,eaf,edicel,equal,erec,exserted,filament,filiform,fleshy,flower,free,fruiting,glabrou,globose,horizontal,immature,known,lateral,leaflet,lenticellate,lightly,line,long-attenuate,lower,nflorescence,noddin,often,one,onto,open,ot,pair,papillate,petiolule,portion,primary,purpli,rachi,reflexed,ruit,scar,side,slender,small,surface,tal,tem,terminal,time,tub,ud,unifoliat,unit,vein,winged,ympodial	adhesion,arrangement,blade,capitate,climate,colour,form,fruit,glandular,growth,hair,height,history,inflorescence,leaf,length,life,midpoint,na,number,peduncle,perennial,plant,position,presence,pubescence,ray,reproduction,seed,staman,stellate,stem,stipe,texture
163	wfo-0001026965	success	157	92	56	101	36	0.357	-2.5,.6,0.5-,0.6-2,0.7-1,0.7-1.5,0.8-1.25,1.1-1.65,1.3-2,1.5-2,1.5-4,1.7-2,1.9-2.4,2.5-4,acute,anther,antrorse,apex,base,calyx,campanulate,capitate,cm,cuneate-attenuate,diameter,ellipsoidal,elliptical,glabrous,glandular,globose,herb,lobe,margin,mm,narrowly,obovate,ovate,pale,petiole,pinnatifid,pinnatipartite,pubescent,seed,simple,stem,stigma,style,subglobose,trans-ovoidal,trichome,tube,uniseriate,violet,white,x,yellow	.3,.5,0.2,0.4,0.5-1.5,0.6-1.1,0.7-1.1,2/3,25,3-,3-4,3.5-6.2,3.5-9,5-15,6.4-12,8-17,abaxially,abundant,accrescent,adaxially,ag,appressed,articulated,basal,berry,broadly,c.,coat,coiled,connectival,covering,cylindrical,difoliat,dorsal,eaf,eed,eglandular,elliptic,embryo,evident,exserted,filament,flexuose,fruiting,herbaceous,hig,latitudinally,long,longer,longitudinal,longitudinally,lower,mixed,multi-seeded,non-glandular,noticeable,opening,opposite,orolla,outer,ovat,pair,papery-scarious,papillae,papillose,partially,pore,poricidal,portion,procumbent,prolongation,prostrate,ree,reticulate,ridged,rounded,ruit,segment,short,similar,slightly,slit,small,smooth,straight,striate,strongly,styl,surface,tem,time,tip,tuberculate,unequal,unifoliate,unit,vary,venation,wider,winged,ympodial	3-15,adhesion,arrangement,blade,climate,colour,corolla,form,fruit,growth,hair,height,history,inflorescence,leaf,length,life,midpoint,na,number,ovary,pedicel,peduncle,perennial,plant,position,presence,pubescence,ray,reproduction,shape,size,staman,stellate,stipe,texture
164	wfo-0001026981	success	252	109	81	171	28	0.321	-0.8,-35,0.05-0.1,0.3-0.5,0.4-0.5,0.5,0.5-30,0.6-1.4,0.6-2,0.8-1.2,1-3.3,1.5-2.0,1.5-8.5,1.8-2.8,3.5-14,4,7.5,<,abaxially,adaxially,anther,apex,asymmetric,base,brown,calyx,capitate,cm,conical,cordate,corolla,densely,diameter,entire,fruit,glabrescent,glandular,globose,herb,imparipinnate,interrupted,irregularly,leaf,lobe,lobed,long,margin,maturity,minutely,mm,multicellular,obovate,orange,orbicular,ovary,ovate,pale,pedicel,peduncle,pentagonal,perennial,petiole,plant,present,pubescence,pubescent,rounded,sparsely,stem,stigma,style,thick,trichome,tube,uni-,uniseriate,variously,velvety,villous,wide,yellow	-0.4,-14,-2,-2.5,-4,-8,.2,.2-0.2,0-5,0.1-0.2,0.1-0.3,0.15-0.2,0.2,0.2-0.4,0.2-2,0.25-0.4,0.3.6,0.4-0.7,0.4-2,0.45-1.3,0.5-0.3,0.7-0.8,0.8-6,0.9-1.4,0.9-1.5,1,1-2,1-2-cellular,1-3,1-3-celled,1-4,1.5-5,1/3,11,196.,2-3,2-3-branched,2-locular,3-foliate,4-8,4-celled,6-10,absen,absent,abundant,academy,accrescent,acute,adpressed,along,amongst,angled,anthesi,apical,appearance,appendage,appressed,articulated,articulation,axi,basiscopically,bay,beak,becoming,bract,bracteole-like,cell,citrus-like,coastal,column,composed,cone,d,dark,deltate,distal,eaf,ebracteate,edicel,eed,erect,exserted,filament,flower,fruiting,giving,gree,green,hair-like,half,halfway,head,included,initially,interjected,internode,jointles,larger,later,lateral,leaflet,less,like,lime,linear,lon,lower,mainly,mixed,much,narrowly,nflorescence,occasionally,outgrowth,pair,patent,per,petiolule,population,primary,procumbent,pronounced,proximal,pseudostipule,rachi,reflexed,rick,robust,ruit,scen,secondary,see,sessile,several,shaggy,shaped,short,shorter,silky,simple,slender,smaller,sometimes,sparser,specimen,spreadin,staminal,sterile,straight,strong,surface,tangled,tem,terminal,tertiary,testa,tightly,transparent,tub,type,unicellular,unit,upto,usually,viny,wall,winged,without,ympodial,‘,’	0.3-0.6,adhesion,arrangement,blade,climate,colour,form,growth,hair,height,history,inflorescence,length,life,midpoint,na,number,position,presence,ray,reproduction,seed,shape,size,staman,stellate,stipe,texture
165	wfo-0001026987	success	214	110	84	130	26	0.393	0-0.1,0-1,0.2-0.4,0.2-0.5,0.4-1,0.5-0.7,0.5-2,0.7-0.8,1-2,1-3,1-4,1.1-6,1.5-2,2-5,2.5-11,3.5-3.8,3.5-5,4-6,5-10,5.5-7,absent,acute,adaxially,anther,apex,base,bent,blade,calyx,chartaceous,cm,connivent,cordate,cuneate,densely,diameter,eglandular,entire,extra-axillary,fruit,glabrous,glandular,globose,hair,hastate,inflorescence,lanceolate,leaf,length,lilac,lobe,lobed,loosely,margin,midpoint,mm,obtuse,often,ovate,pale,pedicel,peduncle,perennial,petiole,present,purple,ray,red,rhizomatous,shallowly,shrub,simple,sparsely,stellate,stellate-pubescent,stigma,style,thin,triangular,tube,twisted,white,x,yellow	%,0-0.2,0-10,0-4,0.05-0.1,0.2-1,0.25-0.4,0.4-0.5,0.4-0.7,0.5-1,0.5-2.5,0.7-1,0.7-1.5,1-11,1.1-2.6,1.4-3,15-35,2-7,2.5-6.5,4-7,4.5-6,5-8,5-merou,6-20,7-10,8-10,8-11.5,8-12,8-13,abaxially,absen,abundant,accrescent,across,adaxiall,adult,alyx,apart,articulated,ascending,axe,ba,basal,berry,branch,branche,broad-based,capitat,curved,cylindrical,decimetre,deflexed,deltate,directed,distall,distributed,dm,eaf,eed,erect,filament,finger,flower,fruiting,gland-tipped,glandular-hairy,green,grey,half,homostylous,interpetalar,juicy,juvenile,lacking,lamina,lateral,less,long,longer,lower,mature,mesocarp,mid-point,minute,narrowly,nflorescence,oblique,orolla,pair,part,per,perfect,pore,porrect,prickle,rachi,ruit,scarcely,sessile,shallowly-lobed,short,slightly,spaced,sparse,stalk,stellae,straight,succulen,summit,surface,tal,tamen,tem,thick,thickened,throughout,time,tissue,toward,unarme,unarmed,unbranched,unit,unknow,upper,upward,vary,wide,yellowish,ympodial	adhesion,arrangement,capitate,climate,colour,corolla,form,growth,height,history,life,na,number,ovary,plant,position,presence,pubescence,reproduction,seed,shape,size,staman,stem,stipe,texture
166	wfo-0001026992	success	243	122	94	149	28	0.387	0.2-0.5,0.25-0.45,0.5-1.2,0.8-3.4,1-4,1.2-1.4,1.2-1.7,1.3-2.6,1.3-4.3,1.4-1.9,1.7-1.9,1.7-2.4,1.7-4.3,12-33,2-10,2.8-4.7,3-4,3.3-5.6,5-15,5.3-12.1,6-10,8-14,abaxial,abaxially,abruptly,acuminate,acute,adaxially,anther,apex,attenuate,base,blade,blunt-tipped,broadly,brown,calyx,cm,corolla,dark,deltoid,diameter,drying,elliptic,entire,flower,fruit,globose,granular-tomentose,hair,inserted,lance-ovate,lanceolate,leaf,length,lobe,margin,mm,moderately,orange-tan,ovate,pedicel,peduncle,petiole,plant,pubescence,pubescent,reniform,ripe,scabridulous-,short,shrub,simple,size,small,sometimes,sparingly,stellate,stem,stigma,style,surface,tan,terminal,tomentose,tree,tube,velutinous,violet,white,whitish,x,yellow,yellowish	-2.5,/7,0.6-1.5,00-170,1.4-1.6,1.5-3.4,1/2,10-12,2-5.6,2.3-3.3,2.6-4.6,2.8-4.6,3.3-5.5,4-8,5-merou,8,8-11,accrescent,adaxiall,ag,along,alyx,angled,anthesi,apart,apparently,appressed,approximately,around,articulated,axe,axillary,ba,bark,berry,branch,branched,capitat,chartaceous,completely,coriaceous,covering,crown,cylindrical,densely,directed,distally,eaf,echinoi,echinoid,edge,eed,enveloping,equal,evident,exserted,farinose,filament,flat-topped,fleshy,forming,free,fruiting,geminate,glabrescen,glabrous,greenish,grooved,high,homostylous,immature,lacking,lateral,lengthening,less,line,lobed,long,long-stalked,longitudinal,longitudinally,lower,m.,main,many,mature,maturity,midrib,minute,mostly,multangulate,nearly,nflorescence,oblong,obtuse,occasional,occasionally,often,older,orolla,ovate-lanceolate,overlapping,perfect,plurifoliate,pore,poricidal,porrect-stellate,rachi,rare,rather,reticulate-punctate,ruit,runk,semi-ovate,sessile,short-,short-stalked,shorter,side,slit,somewhat,spaced,split,spreading,stalked,stamen,stout-stalked,subcampanulate,subglobose,suture,tamen,terete,thin-textured,time,tip,ud,unarme,unarmed,unequal,unit,usually,vary,vein,way,weakly,wide,ympodial,young,½	adhesion,arrangement,capitate,climate,colour,form,glabrescent,glandular,growth,height,history,inflorescence,life,midpoint,na,number,ovary,perennial,position,presence,present,ray,reproduction,seed,shape,staman,stipe,texture
167	wfo-0001026994	success	266	112	84	182	28	0.316	-10,-20,-30,.5,0.05-0.1,0.5-0.6,0.5-0.7,0.5-0.8,0.5-2,1,1-1.4,1-1.5,1-1.6,1.2-1.6,2-,2-2.6,2.2-3.2,2.5-6.5,4,4-15,5-,6-20,7-13,8-12,acuminate,acute,anther,apex,base,bright,broadly,brown,calyx,capitate,cm,corolla,crenate,dark,deeply,densely,diameter,elliptic,fruit,glabrous,glandular,globose,greenish,herb,imparipinnate,inflorescence,interrupted,irregularly,leaf,lobe,lobed,long,margin,minutely,mm,moderately,narrowly,obovate,ovary,pedicel,peduncle,perennial,petiole,present,puberulent,pubescent,purple,rotate-stellate,size,sparsely,stem,stigma,stripe,style,thick,tube,velvety,white,wide,yellow	-0.7,-foliate,.2,0.05-0.2,0.1,0.1-0.2,0.1-0.3,0.15-0.2,0.2-0.4,0.2-0.5,0.25,0.3-0.4,0.4-0.5,0.4-1.2,0.5,0.5-0.9,0.5-1.2,0.5-1.3,0.7-2.5,0.9-1.2,0.9-1.3,1-1.2,1-2,1.2-3.5,1.4-2.1,10-20,12-,2,2-4,2-5-locular,20-50,3,3-branched,4-celled,5,5-7,8,abaxially,absent,abundant,acroscopically,additional,adpressed,along,also,amongst,andscattered,anthesi,apical,apically,appearance,appendage,articulate,articulation,basal,basally,basiscopically,becoming,beneath,bent,berry,bifurcate,bifurcation,bract,bracteate,branched,broader,cell,celled,column,conical,crenat,crowded,darker,decreasing,decumbent,decurrent,developed,distal,eaf,ebracteate,edicel,eed,eglandular,erect,especially,essentially,exserted,fewer,filament,flower,fruiting,giving,grayish,gree,green,habitat,hair-like,hal,half,halfway,head,interjected,internode,investing,lamina,lanceolate,large,larger,largest,lateral,leaflet,leave,less,like,locule,lon,loosely,lower,markedly,medial,midvein,much,narrower,narrowing,nearly,nflorescence,node,oblique,occasionally,often,outgrowth,pair,paler,papillate,petiolule,primary,pseudostipule,rachi,rarely,reflexed,regularly,ripe,robust,rocky,secondary,sessile,set,shaggy,short,silky,simple,sinus,slightly,sometimes,specimen,spreadin,spreading,staminal,sterile,straight,surface,tall,tem,terminal,tertiary,testa,tip,toward,trichome,ud,unicellular,uniseriate,unit,usually,wall,weak-walled,well,winged,woody,ympodial,young	adhesion,arrangement,blade,climate,color,decurred,form,growth,hair,height,history,length,life,midpoint,na,number,plant,position,presence,pubescence,ray,reproduction,seed,shape,staman,stellate,stipe,texture
168	wfo-0001026996	success	188	95	71	117	24	0.378	0.6-1,1-2,1-3,1.2-1.8,1.8-4.4,15-28,2-3,3-10,3-7,3.3-6,3.8-14.1,4-8,4.5-10.5,5-8,6-8,8.7-18.6,acumen,anther,axillary,blue,brownish,bud,clavate,cm,condition,coriaceous,corolla,dark,deep,diameter,drying,elliptic,fresh,fruit,glabrous,globose,green,greenish,herb,lanceolate,leaf,lilac,lobe,medium,mm,moniliform,mottled,odd-pinnate,ovate,ovoid,pedicel,peduncle,pentagonal,petiole,plant,purple,ripe,rotate,seed,size,stigma,stripe,style,subtending,terminal,tube,tuber,white,whitish,x,yellow	0-6,0.9-2.7,1-4,1-5,1.3-7.7,14-33,3-5,4-4.4,5-merou,6.9-10.9,abaxiall,abaxially,acuminate,acute,adaxially,ag,along,alyx,apart,apex,apparently,arranged,articulated,asymmetric,attenuate,axe,base,basiscopic,bead,berry,blade,capitat,cell,connivent,considerably,covering,decreasing,digestion,distal,dorsally,eaf,edge,eed,enzyme,erec,exceeding,filament,flat,flower,folded,forked,geminat,generally,glabrou,green-white,hair-like,half,homostylous,honeycomb-shaped,interjected,larger,lateral,leaflet,lengthening,like,linear,living,long,lower,make,middl,mucilaginous,multiple,necklace,nflorescence,orbicular,orolla,pair,perfect,petiolulate,plurifoliate,pore,poricidal,removed,rounded,ruit,sessile,seudostipule,side,slightly,slit,sometimes,spaced,specimen,stamen,stolon,straight,subglabrou,symmetric,tall,tamen,tem,testal,thick,throughout,tip,tissue,toward,tri-,typically,unit,unwinged,usually,vary,wall,wet,ympodial	adhesion,arrangement,calyx,capitate,colour,form,growth,height,history,inflorescence,length,life,na,ovary,perennial,position,pseudostipule,pubescence,reproduction,shape,staman,stem,subglabrous,texture
169	wfo-0001027009	success	226	108	82	144	26	0.363	0-0.2,0-0.3,0.4-1,0.7-1,0.7-1.3,0.8-1.3,0.8-2.1,1.4-4,10-15,2-3,2.3-3,3-3.5,3-5,3.3-3.6,4-6.5,4-9.5,5-23,6-9,6.5-11,7-12.5,absent,acute,adaxially,anther,apex,base,black,blade,brown,calyx,capitate,chartaceous,cm,connivent,cuneate,deeply,densely,diameter,elliptical,extra-axillary,fruit,glabrous,glandular,globose,green,grey,grey-green,hair,inflorescence,lanceolate,length,lobe,lobed,margin,midpoint,mm,obtuse,ovate,pale,pedicel,peduncle,perennial,petiole,plant,present,purple,ray,rhizomatous,rotate,shallowly,shrub,simple,slightly,stellate-pubescent,stem,stigma,style,throughout,tube,x,yellow,yellowish-green	%,0-0.5,0-1.2,0-1.5,0-15,0-5,0-8,0.1-0.2,0.15-0.3,0.5-2,0.7-0.9,0.8-1.2,1-1.5,1-1.8,1-2,1-2.5,1-3,1-5,1-9,1.3-2.2,1.6-3.5,10-20,2-4,2-6,2-foliate,20-30,23-48,3-10,35-400,40-125,5,5-7,5-merous,6-8,7-11,7-8,abaxially,abundant,accrescent,acicular,adaxiall,alyx,andromonoecious,apart,armed,articulated,ascending,attenuate,axe,ba,basal,bilobe,bisexual,broad-based,broadly,curved,cylindrical,d.,deflexed,deltate,dimorphic,directed,distal,distall,distributed,dult,eaf,eed,eglandular,entire,erect,filament,finger,flower,fruiting,functional,geminate,gland-tipped,half,heterostylous,incised,index,interpetalar,juic,lamina,larger,lateral,lobing,lon,long,longer,lower,male,markedly,mature,mesocarp,midvein,minute,minutely,moist,nflorescence,oblique,orolla,part,per,pore,porrect,presen,prickle,pricklie,probably,pseudo-racemose,rarely,reticulate,ridged,ripe,ruit,short,side,spaced,stage,stalk,stellae,straight,strongly,surface,tal,tamen,terete,thick,time,tip,tissue,unarmed,unbranched,unit,unknow,uvenile,vary,vein,white,wide,yellowish,ympodial	adhesion,arrangement,bilobed,climate,colour,corolla,form,growth,height,history,leaf,life,na,number,ovary,position,presence,pubescence,reproduction,seed,shape,size,staman,stellate,stipe,texture
170	wfo-0001027010	success	198	106	82	116	24	0.414	0-2.5,0.4-5.1,0.5-1.5,1.2-1.7,1.2-1.9,14-46,2.1-4.3,2.2-12.9,3-10,3-6,3-8,4-12,4-8,4.4-29,4.9-31,5-13,5-14,abaxially,acute,adaxially,anther,axillary,brownish,bud,clavate,cm,condition,coriaceous,corolla,deep,diameter,drying,elliptic,fresh,fruit,glabrescent,glabrous,green,greenish,hair,herb,lanceolate,leaf,light,lobe,long,mm,moniliform,narrow,occasionally,odd-pinnate,ovate,ovoid,pedicel,peduncle,pentagonal,petiole,plant,purple,ripe,rotate,scabrous,seed,short,size,sometimes,spot,stigma,stripe,style,subtending,terminal,tube,tuber,usually,white,whitish,wide,wing,winged,x,yellow	0-2,0-3,1-10,1-2,1-4,1-7,1.4-6.9,10-60,2-6,2-9.4,2.1-15.3,3-5,3.5-13.6,5-merou,acumen,acuminate,adaxiall,ag,along,alyx,apart,apex,apparently,arranged,articulated,asymmetric,attenuate,axe,base,basiscopic,bead,blade,capitat,cell,coloration,connivent,covering,decreasing,digestion,distal,dorsally,eaf,edge,eed,enzyme,erec,exceeding,filament,flat,flower,folded,forked,geminat,generally,glabrescen,glabrou,green-white,hair-like,hal,half,high,homostylous,honeycomb-shaped,interjected,larger,lateral,leaflet,lengthening,like,living,lower,make,mucilaginous,multiple,necklace,nflorescence,orbicular,orolla,pair,perfect,petiolulate,plurifoliate,pore,poricidal,present,removed,rounded,ruit,scabrou,sessile,seudostipule,side,slightly,slit,spaced,specimen,stamen,stolon,straight,subequal,tall,tamen,tem,testal,thick,throughout,tip,tissue,toward,tri-,typically,unit,vary,wall,wet,ympodial	adhesion,arrangement,calyx,capitate,colour,form,growth,height,history,inflorescence,length,life,na,ovary,perennial,position,presence,pubescence,reproduction,shape,staman,stellate,stem,texture
171	wfo-0001027019	success	142	94	61	81	33	0.43	/4,1-1.5,1-2,1.5-2,1.5-3,12-30,2-3,2-8,4-5,7-14,abaxially,acute,adaxially,along,anther,apex,attenuate,base,branched,calyx,capitate,cm,corolla,densely,dia,flattened,glabrous,globose,golden,green,inflorescence,leaf,lobe,lobed,midrib,mm,obovate,opposite,ovary,ovoid-reniform,pale,pedicel,petiole,plant,poricidal,pubescent,shrub,small,somewhat,sparsely,stem,stigma,style,tan,tip,tree,trichome,tube,way,white,x	.5,0-0.5,0.5-1,1/2,10,10-40-flowered,2-5,4-8.5,abaxial,abruptly,anthesi,apparent,ba,bark,berry,bright,constriction,cyathiform,deflexed,deltoid,difoliate,distal,eaf,edicel,eed,ellipsoid,elliptic,erect,even,exserted,filament,fleshy,free,fruiting,geminat,glabrate,inflorescenc,largely,later,like,live,lon,long,lower,major,minor,minutely,narrowed,nflorescence,older,onto,overlapping,papillo,papillose,pitted,planar,pore,portion,reddish-brow,rest,ruit,scar,shaped,spaced,straight,strongly,surface,tall,tapering,tear-drop,third,tub,ud,unit,waxy,widest,wing,winged,woody,ympodial,young	adhesion,arrangement,blade,climate,colour,diameter,form,fruit,glandular,growth,hair,height,history,length,life,margin,midpoint,na,number,peduncle,perennial,position,presence,pubescence,ray,reproduction,seed,shape,size,staman,stellate,stipe,texture
172	wfo-0001027030	success	234	100	76	158	24	0.325	0.05-0.1,0.15-0.2,0.2,0.4-0.5,0.4-0.8,0.5,0.5-0.7,0.5-1,0.6-0.7,0.6-0.8,0.7-1,0.8-0.9,1,1-1.3,1-3,1.2-1.6,1.6-2,2-6,2.2-3.2,5-12,abaxial,anther,branched,bright,brown,calyx,capitate,cm,corolla,dark,densely,denser,diameter,elliptic,evenly,fruit,globose,green,herb,imparipinnate,inflorescence,interrupted,lobe,long,minutely,mm,narrowly,obovate,ovary,pale,paler,papillate,pedicel,peduncle,perennial,petiole,pseudostipule,pubescence,pubescent,rotate-stellate,simple,size,soft,sometimes,sparsely,spread,stem,stigma,style,tall,thick,trichome,tube,velvety,wide,yellow	-11,-15,.2,.5,0-4,0.1-0.7,0.1-0.9,0.2-0.3,0.2-1,0.3-,0.3-0.5,0.3-0.7,0.4-1.5,0.5-,0.5-0.8,0.6-1.8,0.8-1,0.9-1.1,1-,1-1.2,1-3.4,1.5-,2-,2-3,2-4,2-4.8,2-7,2-foliate,2-locular,3-4-celled,3-8,3-9,4-celled,8-celled,abaxially,absent,abundant,acuminate,acute,adaxially,adpressed,angled,anthesi,apex,apical,appearance,appendage,articulated,articulation,axi,basal,base,basiscopically,beneath,berry,beyond,bract,cell,column,conical,crenat,crenate,crenation,darker,decurrent,deeper,deeply,diamete,distal,due,eaf,edicel,eed,eglandular,entire,exserted,extremely,filament,flower,fruiting,giving,gland,glandular,grayish,gree,growt,hair-like,hal,half,halfway,interjected,internode,interspersed,investing,irregularly,lamina,lanceolate,larger,lateral,leaflet,less,like,lon,longer,loosely,lower,margin,multicellular,near,nflorescence,node,oblique,occasionally,often,outgrowth,pair,petiolule,present,primary,reflexed,robust,ruit,secondary,sessile,silky,similar,slender,slightly,small,smaller,somewhat,spreadin,spreading,staminal,sterile,straight,stripe,surface,tem,terminal,tertiary,testa,tiny,trailing,truncate,ud,unicellular,uniseriate,unit,usually,vein,wall,weak,white,winged,woody,ympodial,young	1-4,2-9,adaxial,adhesion,arrangement,colour,dioecious,form,growth,hair,height,history,leaf,length,life,na,plant,position,reproduction,seed,shape,staman,texture,width
173	wfo-0001027035	success	199	95	74	125	21	0.372	0.1-0.9,0.3-2.3,0.4-12.8,0.5-7,0.9-3.1,1-3,1-3.4,1.8-5.2,10-80,2.8-10.3,3-10,4-18,4-18.5,4.9-23.5,abaxially,adaxially,anther,axillary,blue,brownish,bud,clavate,cm,completely,condition,corolla,deep,diameter,drying,elliptic,fresh,fruit,glabrescent,glabrous,globose,green,greenish,hair,herb,lanceolate,leaf,light,lilac,lobe,long,medium,mm,odd-pinnate,ovate,ovoid,pedicel,peduncle,pentagonal,petiole,plant,purple,ripe,rotate,seed,shape,short,size,sometimes,stigma,stripe,style,subtending,terminal,tube,white,whitish,wide,x,yellow	0-36,0-7,0.5-3.4,0.5-5,0.8-3,0.8-4.2,1-2,1-8,1.5-5.9,1.7-8,2-38,2-7,3-5,5-merou,acumen,acuminate,acute,adaxiall,ag,along,alyx,apart,apex,apparently,arranged,articulated,asymmetric,attenuate,axe,base,basiscopic,bead,blade,capitat,cell,coloration,connivent,covering,decreasing,digestion,distal,dorsally,eaf,edge,eed,enzyme,erec,exceeding,filament,flat,flower,folded,forked,geminat,generally,glabrescen,glabrou,green-white,hair-like,hal,half,high,homostylous,honeycomb,interjected,larger,lateral,leaflet,lengthening,like,living,lower,make,moniliform,mucilaginous,multiple,necklace,nflorescence,orbicular,orolla,pair,perfect,petiolulate,plurifoliate,pore,poricidal,present,removed,rounded,ruit,second,sessile,seudostipule,shaped,side,slightly,slit,smaller,spaced,specimen,stamen,stolon,straight,subequal,subglabrous,tall,tamen,tem,testal,thick,throughout,tip,tissue,toward,tri-,tuber,typically,unit,unwinged,usually,variable,vary,wall,wet,ympodial	adhesion,arrangement,calyx,capitate,colour,form,growth,height,history,inflorescence,length,life,na,ovary,perennial,position,pubescence,reproduction,staman,stem,texture
174	wfo-0001027050	success	244	122	95	149	27	0.389	-12,-9,0.1-0.3,0.1-3,0.2-0.5,0.2-1,0.3-1.5,0.5-3,1-1.5,1.5-6,10-13.5,2-2.5,2-5,2-8,2.5-3,3-5,4-20,4-8,5-10,5-9,8-26,acuminate,acute,anther,apex,base,blade,broadly,brown,calyx,capitate,chartaceous,cm,coarsely,conical,cordate,cuneate,densely,diameter,eglandular,elliptic,entire,equal,ferruginous,flattened-reniform,fruit,glabrous,glandular-puberulent,green,growth,hair,inflorescence,lanceolate,lateral,leaf,leaf-opposed,length,lobe,lobed,long,margin,midpoint,minutely,mm,moderately,obtuse,ovate,pale,pedicel,peduncle,petiole,plant,present,pubescent,ray,ripe,rounded,shallowly,shiny,shrub,small,sparsely,spherical,stellate,stem,stigma,style,toothed,tree,truncate,tube,white,wide,yellow,yellowish-green	.2,.5,/3,0-0.2,0-3,0.8,0.9-2.1,1,1-2,1.5-2,12-15,15-50+,2-3,2-4,5,5-6,5-7,5-merous,50,6-8,7-30+,abaxial,abaxially,absen,absent,abundant,adaxial,adaxiall,adult,alyx,andromonoeciou,apar,arme,articulated,axe,bark,basal,berry,branch,branched,broad,broad-based,brow,closely,connivent,curved,deeply,difoliate,directed,distal,distall,distally,drying,eaf,eed,erec,erect,except,filament,flattened,flower,free,fruiting,geminat,half,heterostylous,infructescence,inside,interpetalar,juicy,juvenile,larger,least,less,like,long-styled,longer,lower,markedly,mature,mid-way,midrib,midvein,minute,moist,mucilaginous,multiseriate,narrowly,near,nflorescence,numerous,oblique,occasionally,often,older,orolla,oung,ovate-lanceolate,papillat,per,pericarp,pore,poricidal,porrect,portion,prickle,pricklier,prickly,rest,ruit,scar,scattered,secondary,sessile,several,short-stalked,short-styled,shorter,side,slightly,somewhat,spaced,stalk,stalked,stellate-pubescent,straight,surface,tall,tamen,terete,thicker,time,tip,tissue,touching,triangular,trichome,unarmed,unbranched,unit,usually,vary,way,weakly,whitish,woody,ympodial,young,younger	adhesion,alternate,andromonoecious,arrangement,climate,colour,corolla,form,glandular,height,history,life,na,number,ovary,papillate,perennial,position,presence,pubescence,reproduction,seed,shape,size,staman,stipe,texture
175	wfo-0001027050	success	234	119	94	140	25	0.402	0.2-0.6,0.2-1,0.5-1,0.5-3,1-1.5,1.5-2,1.5-6,10-13.5,2-10,2-2.5,2-3,2-5,2-8,2.5-3,3-15,3-5,4-40,4-8,5-10,5-9,8-40+,abaxially,acuminate,acute,adaxially,andromonoecious,anther,apex,base,blade,broadly,brown,calyx,chartaceous,cm,coarsely,cordate,cuneate,densely,diameter,drying,elliptic,entire,extra-axillary,ferruginous,flattened,fruit,glabrous,glandular-puberulent,globose,green,growth,hair,inflorescence,lanceolate,leaf,leaf-opposed,length,lobe,lobed,margin,midpoint,mm,moderately,obtuse,often,ovate,pale,pedicel,peduncle,petiole,plant,present,ray,rounded,shallowly,shrub,simple,small,sparsely,stellate,stellate-pubescent,stem,stigma,style,toothed,tree,truncate,tube,white,whitish,x,yellow,yellowish-green	.2,0-0.2,0-0.5,0-1,0-3,0.1-3,0.3-0.6,0.4-1,0.5-0.8,0.8,1-2,1-5,10-30,11-21,12-15,14-20,15-50+,16-40,2-3-locular,2-4,2-6,2-foliate,23-40+,4-19,5,5-6,5-7,5-merous,6-8,7-30+,8-26,absen,absent,abundant,accrescent,across,adaxiall,adult,anvil-shape,apart,armed,articulated,axe,ba,branche,branched,broad-based,capitat,connivent,contiguous,cross-section,curved,cylindrical,deeply,directed,distall,distally,distributed,eaf,eed,eglandular,erect,except,exocarp,filament,flower,forked,fruiting,functional,geminat,half,held,interpetalar,juicy,juvenile,lateral,less,like,long,longer,lower,markedly,mature,mesocarp,midvein,minute,minutely,moist,mucilaginous,multiseriate,narrowly,nearly,nflorescence,oblique,orolla,ovate-lanceolate,pair,per,pinnatifid,pitted,placenta,pore,porrect,prickle,rachi,ruit,scattered,sessile,shorter,side,slightly,somewhat,spaced,stalk,stalked,stellae,straight,surface,tal,tamen,tem,thick,thicker,throughout,time,tip,tissue,triangular,unarme,unarmed,unbranched,unit,upper,upright,usually,vary,weakly,wide,ympodial,younger	adhesion,arrangement,capitate,climate,colour,corolla,form,glandular,height,history,life,na,number,ovary,perennial,position,presence,pubescence,reproduction,seed,shape,size,staman,stipe,texture
176	wfo-0001027067	success	228	110	85	143	25	0.373	0-0.2,0-1.8,0-7,0.2-0.4,0.3-1,0.35-0.5,0.8-1,1.7-2.8,1.7-3.3,2-3,2.5-3.8,2.5-4,2.9-3.7,3.5-9,4-5.5,5-12.5,6-10,6-7,6-8,7-16,absent,acute,adaxially,anther,apex,base,black,blade,broadly,brown,calyx,chartaceous,cm,cuneate,dark,deeply,densely,diameter,extra-axillary,flattened,fruit,glabrous,globose,green,hair,inflorescence,lanceolate,leaf,length,lobe,lobed,margin,midpoint,mm,obtuse,ovate,pale,pedicel,peduncle,perennial,petiole,plant,present,purple,ray,rhizomatous,rotate,scattered,shrub,simple,slightly,sparsely,stellate,stellate-pubescent,stem,stigma,streak,style,throughout,truncate,tube,twisted,x,yellow,yellowish-green	%,.05,0-0.1,0-0.5,0-12,0-6,0.4-0.5,0.4-0.7,0.5-1,0.5-1.5,0.5-2,0.9-2.5,1-2,1-4,1-7,1.2-1.4,1.4-2.5,1.5-2,11-16,11-20,13-65,15-27,15-60,2-10,2-4.5,2-7,2-foliate,2-locular,2.7-5,20-45,20-50,20-65,3-10,3-4,3-5,3-6,3.5-5.5,4-9,5-6,5-9.5,5-merou,5.5-12.5,7-11,7-8,8-14,abaxial,abaxially,abundant,accrescent,acicular,across,adaxiall,adult,alyx,andromonoecious,apart,armed,articulated,attenuate,axe,ba,bilobe,broad-based,connivent,curved,cylindrical,decimetr,directed,distall,dult,eaf,eed,eglandular,erect,exocarp,filament,finally,finger,firm,flower,fruiting,functional,geminate,gland-tipped,grey,half,heterostylous,hig,index,interpetalar,juic,juvenile,lateral,less,lobing,lon,long,longer,lower,mature,mesocarp,mid-point,midvein,minute,moist,nflorescence,oblique,orolla,papery,part,per,pink,pore,porrect,presen,prickle,pseudo-racemose,rachi,ruit,sessile,short,side,skin,somewhat,spaced,sprawling,stalk,stellae,straight,tamen,thick,time,tissue,transparent,unbranched,unit,vary,vein,weakly,white,wide,yellowish,ympodial	adhesion,arrangement,bilobed,climate,colour,corolla,form,glandular,growth,height,history,life,na,number,ovary,position,presence,pubescence,reproduction,seed,shape,size,staman,stipe,texture
177	wfo-0001027069	success	200	97	75	125	22	0.375	0.15-0.8,0.5-1.5,0.5-5,0.8-3.3,1-2,1-2.5,1-5,1-7.7,1.5-12,1.5-5,10-25,3-19,3.5-6,4-8,4-9,7-10,abaxially,adaxially,anther,axillary,blotch,brown,brownish,bud,chartaceous,cm,condition,corolla,darker,diameter,drying,elliptic,elliptical-conical,fresh,fruit,glabrescent,glabrous,green,greenish,herb,lanceolate,light,lobe,long,membranous,mm,narrowly,odd-pinnate,ovate,ovoid,pedicel,peduncle,petiole,plant,pubescent,purple,seed,short,simple,size,sparsely,stellate,stem,stigma,stripe,style,subtending,terminal,tube,vertical,white,whitish,wide,x,yellow	0-4,0.2-3,0.5-5.5,1-10,1.5-3,1.5-6,2-5,2-6,2.5-12,3-11,5-merou,acumen,acuminate,acute,ag,along,alyx,apart,apex,apparently,articulated,axe,base,berry,blade,borne,broadly,capitat,cell,ciliate,connivent,cordate,covering,cuneate,decreasing,decurrent,digestion,distal,dorsally,eaf,edge,eed,end,enzyme,erect,especially,exceeding,filament,flat,flower,folded,forked,geminat,generally,glabrou,green-white,hair,hair-like,half,homostylous,honeycomb-shaped,interjected,lateral,lax,leaflet,lengthening,like,linear,living,lower,make,margin,middl,midrib,minutely,mucilaginous,nflorescence,obtuse,orolla,pair,perfect,petiolule,plurifoliate,pore,poricidal,puberulent,pubescen,rachi,rare,rarely,removed,ruit,seudostipule,singly,slightly,slit,sometimes,spaced,specimen,stamen,ste,stolo,straight,subequal,tall,talle,tamen,tem,testal,thick,throughout,tip,toward,tri-,truncate,tuber,typically,unequal,unit,unwinged,usually,vary,wall,wet,ympodial	adhesion,arrangement,calyx,capitate,colour,form,growth,height,history,inflorescence,leaf,length,life,na,ovary,perennial,position,pubescence,reproduction,shape,staman,texture
178	wfo-0001027091	success	142	103	62	80	41	0.437	0.8,1-1.6,1.1-1.6,1.8-2.6,1/2-2/3,2.3-2.9,2.5-3.5,3-8,3-9,4-10,5-11,8.5-11.5,9-13,annual,anther,arcuate,base,blade,blue,bristly,broadly,brown,calyx,cm,dark,densely,developing,dm,dry,glabrous,glandular,hair,herb,internodal,invested,lenticular,lobe,long,maturity,mm,obtuse,ovate,pedicel,petiole,pinnatifid,prickly,rounded,simple,sometimes,sparsely,spherical,splitting,stellate-pentagonal,stem,strait,tapering,terete,terminally,tightly,tube,variously,violet	.3,0.7,30-60,6-10,6-10-flowere,accrescent,across,acute-tipped,along,alyx,anthesi,armed,beneath,berry,branched,campanulate,capitate-glandular,cauline,deltoid,dia,difoliate,divided,eaf,eed,enveloped,extended,few-rayed,fully,geminat,gland,green,high,linear-lanceolate,lon,longer,low,main,mostly,narrowly,near,nflorescence,occasionally,oriented,orolla,per,pinnatisect,radially,reticulately,ridge,ruit,scattered,sessile,short,short-stipitate,slende,somewhat,spreadingly,ste,stellae,suffused,surface,tamen,taprooted,tigma,tub,twice,tyle,undulate,unexpande,uniseriate,unit,usually,vary,vein,vestiture,wholly,wrinkled,yello,ympodial,younger	0.3,adhesion,apex,arrangement,climate,colour,corolla,diameter,form,fruit,growth,height,history,inflorescence,leaf,length,life,margin,midpoint,na,number,ovary,peduncle,plant,position,presence,pubescence,ray,reproduction,seed,shape,size,staman,stellate,stigma,stipe,style,texture,unexpanded,ye,yellow
179	wfo-0001027102	success	167	82	58	109	24	0.347	.5,0.2-2,0.5-2,0.5-3,1-1.5,1-2,1-2.5,1.5-2,10-20,15-35,2-3,3,3-12,3-4,4-5,abaxially,adaxially,anther,calyx,cm,connivent,densely,diameter,elliptic,flattened,flower,fruit,glabrous,globose,lanceolate,leaf,leaf-opposed,lobe,mm,moderately,narrowly,oblong,orange,pedicel,peduncle,petiole,pubescent,shrub,simple,size,somewhat,stellate,stem,stigma,style,subcoriaceous,truncate,tube,unbranched,white,x,yellow,yellow-brown	.5-6,0.5,0.5-1,1-3,1-4,1-6,15,2-2.5,3-5,4-7,5-12,<,absen,absent,accrescent,acuman,acuminate,acute,adaxial,adaxiall,ag,aggregate,almost,alyx,apart,apex,appearance,articulated,axe,ba,base,blade,broad,broadly,cell,channe,chartaceous,ciliate,congested,corky,cuneate,curved,cylindrical,deltate,differing,difoliate,dimorphic,directed,distally,eaf,eed,entire,few-,filament,forked,free,fruiting,geminat,giving,hair,ilament,long,long-tapered,longitudinal,m.,major,margin,minor,multiseriate,nflorescence,obtuse,often,one,opening,orolla,ovate,per,perfect,pore,portion,rachi,rarely,ripe,roughened,rugulose,ruit,short,slender,slit,small,spaced,sparsely,stone,straight,surface,tal,tem,time,tip,tomentose,triangular,truncat,unarme,unit,usually,vary,wide,ympodial,young	adhesion,arrangement,colour,corolla,form,growth,height,hermaphroditic,history,inflorescence,length,life,na,ovary,perennial,plant,position,presence,pubescence,reproduction,seed,shape,staman,texture
180	wfo-0001027104	success	141	99	64	77	35	0.454	0.15-0.35,0.5-0.8,1-3,1.2-6,1.5-2.3,1.5-4.2,10-15,2-3,2-6,2.2-5,3-5.5,6-7.5,abaxially,acuminate,acute,adaxially,apex,apical,apically,attenuate,base,calyx,cm,connate,cordate,corolla,dehiscent,diameter,distal,finely,globose,green,green-white,half,herbaceous,introrse,lobe,long,maturing,mm,odd-pinnate,often,ovate,ovoid,pedicel,peduncle,perennial,petiole,plant,poricidally,pubescent,seed,short,slit,stellate,stigma,style,throughout,tone,truncate,white,wide,yellow,yellow-green	1-1.5,1-4,3-6-foliat,4-15,5-15,acumen,articulate,branched,cell,condition,covering,cyme,dichasial,dichasially,digestion,dorsally,eaf,ebracteate,edge,eed,emoval,enzyme,epiphyti,epiphytic-like,exceeding,filament,flat,flower,folded,forked,generally,globo,growing,hair-like,honeycomb,lateral,linear,living,lon,lower,make,monochasial,mos,mucilaginous,mucronate,narrowly,nflorescence,nther,orolla,ovat,pattern,perfect,plan,proximal,rarely,reveal,ruit,seudostipule,simple,specimen,stamen,straight,tall,tem,terrestrial,testal,thick,throughou,tuber-bearing,typically,unit,vary,viole,wall,without,ympodial,¼	adhesion,anther,arrangement,blade,climate,colour,form,fruit,glandular,growth,hair,height,history,inflorescence,leaf,length,life,margin,midpoint,na,number,ovary,position,presence,pubescence,ray,reproduction,shape,size,staman,stem,stipe,texture,tube,violet
181	wfo-0001027114	success	154	101	69	85	32	0.448	-17,-2,-30,.5,0.5-1,1-1.1,1-1.2,1-1.5,1.5-2,1/2,13-21,2-2.5,2-3,3-4,3-7,6-8,6-9,abaxially,acute,anther,apex,appearing,base,bushy,calyx,capitate,cm,corolla,dark,dendritic,densely,dia,elliptic,flattened-reniform,glabrous,globose,green,inflorescence,lamina,leaf,lobe,lobed,long,margin,mm,occasionally,opposite,ovary,pedicel,petiole,poricidal,pubescent,reddish-brown,scattered,shoot-terminal,shrub,simple,size,stem,stigma,style,thickened,tip,trichome,tube,uniseriate,way,white,wide	1-2,1.5-1.7,20-40,5,7-10,7-9,abaxial,adaxially,along,alternating,anthesi,apar,axillary,ba,bark,berry,branched,closely,commonly,conical,deltate,differing,difoliate,drying,due,eaf,edicel,eed,erect,exserted,filament,flowered,free,fruiting,geminate,glabrou,growt,halfway,inflorescenc,investing,lateral,like,lon,lower,main,major,many,minor,minute,minutely,nflorescence,older,opening,pair,papillo,pitted,planar,plurifoliate,pore,portion,projection,rapid,reddish,rest,ruit,scar,several,shoot,slit,soft,spaced,surface,tall,tapering,time,triangular,tub,ud,unevenly,unit,vein,woody,yellowish,ympodial,young	adhesion,arrangement,blade,climate,colour,diameter,form,fruit,glandular,growth,hair,height,history,length,life,midpoint,na,number,peduncle,perennial,plant,position,presence,pubescence,ray,reproduction,seed,shape,staman,stellate,stipe,texture
182	wfo-0001027117	success	235	107	76	159	31	0.323	-1.5,0-5,0.1-0.7,0.6-0.9,0.7-0.9,0.7-1.3,0.7-1.5,0.8-,1-2,1.5-,1.5-2.3,1.5-6.5,1.7-2.5,1/3,2-3,2.3-2.8,4-6.5,4.5-6.5,5-11,5-14,6-10,acute,almost,anther,apex,attenuate,base,black,blade,brown,calyx,chartaceous,cm,cordate,dark,densely,diameter,evenly,flattened-reniform,fruit,green,herb,lateral,leaf,length,lobe,lobed,long,margin,maturity,mauve,midpoint,mm,moderately,oblong,pedicel,peduncle,petiole,ray,rounded,shallowly,smooth,sparsely,spherical,staman,stellate,stellate-pubescent,stem,style,surface,tapering,tube,upper,wide,yellow,young	-11,-12,-2.8,-3/4,.5,/3,0-10,0-15,0-20,0-25,0-40,0.1,0.1-,0.15-0.25,0.15-0.35,0.2,0.2-0.45,0.5,0.5-1.5,1-4,1-6,1.2,1.8-2.5,1/,1/4,1/8-1/2,10-20,2-6,2-8,25-100,3-10,3-15,3-6,4-7,4-8,4.5-8,5-merous,6-9,7-,8,abaxially,accrescent,acicular,alyx,ame,apar,apart,apically,apparently,articulated,bark,berry,beyond,branched,brittle,c.,cell,concolorous,connivent,curved,deltate,discolorous,distance,drying,eaf,eed,elongating,enclosing,erect,extending,fifth,filament,fine,flower,four,free,fruiting,gently,glabrescent,glabrous,gra,herbarium,infructescence,irregularly,less,lon,long-acuminat,longer,lower,mature,membranous,midvein,narrow-deltate,narrow-elliptic,narrow-lanceolate,nflorescence,obovate,older,one,open,orolla,oung,outline,ovate,pair,pale,pendulous,per,perfec,pericarp,perpendicular,pit,plurifoliat,poricidal,porrect,portion,prickl,prickle,prickly,primary,raised,red-brown,reduced,reflexed,ruit,scar,sessile,shiny,shorter,side,small,sometimes,spaced,specimen,spreading,stalk,stalked,straight,tamen,tearing,terete,tertiary,time,tip,tissue,translucent,trichome,unequal,unit,variously,vary,vein,venation,visible,way,weakly,woody,yellow-green,ympodial	0.1-0.45,adhesion,arrangement,climate,colour,corolla,form,glandular,growth,hair,height,history,inflorescence,life,na,number,ovary,perennial,plant,position,presence,pubescence,reproduction,seed,shape,size,stigma,stipe,texture,unknown,ye
183	wfo-0001027123	success	181	101	71	110	30	0.392	-10,0.7-3.5,0.8-1.3,1,1-1.2,1-1.5,1.5-2,2-2.6,2-5.5,2-lobed,2.5-10.4,2.5-4,2.5-6,3-4,4-5,5-6,acute,anther,apex,attenuate,base,brown,calyx,clavate,cm,commonly,conical,constricted,corolla,dark,diameter,elliptic,exerted,flattened,glabrous,glandular,globose,inflorescence,leaf,less,lobe,lobed,margin,mauve-purple,mm,narrowly,ovary,papillate,pedicel,peduncle,petiole,reddish,reniform,revolute,shiny,simple,soon,sparsely,stellate,stem,stigma,strongly,style,subshrub,terminal,tube,violet,way,x,young,¾	-20,.3,.5,0.3-1.6cm,0.5,0.5-0.8,0.9-1.3,2-2.2,2-2.5,2-3,3-15,4-6,5-10,abaxial,adaxial,adaxially,along,anthesi,appearing,axe,axi,bark,branched,bright,broadly,campanulate,cell,completely,coriaceous,cup-shaped,darker,deltate,dendritic,densely,denser,drying,eaf,edge,eed,enlarged,erect,fide,filament,flower,free,fruiting,green,inserted,lamina,lax,lewi,like,lon,long,loose,loosely,lower,midvein,minute,minutely,monopodia,nflorescence,nodding,older,outline,pair,papillae,perfect,perhaps,petal,pitted,planar,plurifoliate,portion,primary,prominent,pubescent,scar,scatted,scattered,shin,shinin,shining,short,sinuate,sleeve,slightly,sometimes,spaced,stoutish,straight,surface,testal,thick,time,tip,trailing,trichome,tub,turned,ud,unit,upper,usually,vein,warty,white,widely,wood,ympodial	0.3-1.6,adhesion,arrangement,blade,climate,colour,form,fruit,growth,hair,height,history,length,life,midpoint,na,number,perennial,plant,position,presence,pubescence,ray,reproduction,seed,shape,size,staman,stipe,texture
184	wfo-0001027125	success	155	126	93	62	33	0.6	.5,/4,0,0.5,1,12,3,4,5,50,6,abaxially,acuminate,acute,adaxially,anther,anthesi,apex,armed,articulated,base,becoming,blue,brown,bud,clavate,clustered,cm,completely,connivent,coriaceous,corolla,deeply,diameter,ellipsoid,elliptic,elongating,entire,filament,flattened,fleshy,flower,foveolate,fruit,glabrous,globose,green,internode,lateral,lengthening,light,lobed,major,margin,midrib,minutely,mm,mostly,narrowly,oblong,papillate,pedicel,peduncle,petiole,pore,poricidal,prickle,rachi,recurved,rugose,side,simple,slender,slit,somewhat,spreading,stellate,stem,stigma,strongly,style,subwoody,surface,terminal,terminally,thick,tip,truncate,vein,vine,way,yellow,×	0.3,0.3-0.6,0.8,1.2-2,10–,10–15,12–17,1–,25–50,3–,3–10,3–5,3–7,4–6,5–10,5–7,6–,6–9,?,absent,ag,alyx,apiculate,axe,ba,bilobe,blade,branched,calyx,campanulate,cucullat,dr.,eaf,eed,equal,exserted,lobe,long,long-styled,lower,middle,nflorescence,orolla,plurifoliat,recurve,robust,rounded,ruit,stout,tamen,thickened,time,triangular,tube,unit,vary,wide,widest,woody,ympodial,youn,–9	0.3-0.8,1-3-7,10-15,10-25-50,12-17,3-10,3-5,3-5-10,4-6,6-9,9,abaxial,age,armament,arrangement,bilobed,colour,dry,form,growth,inflorescence,leaf,length,na,ovary,position,pubescence,seed,shape,size,staman,texture,width
185	wfo-0001027131	success	186	99	72	114	27	0.387	0-0.1,0.4-0.8,0.5-1,0.9-2.5,1-1.2,1-1.5,1-4,1.4-2,1.5-3.3,1.7-3.5,2.6-3,3-4,3-9,4.5-8.5,5.5-6.5,7-8,9.5-11.5,absent,acute,anther,apex,base,black,blade,brown,calyx,chartaceous,cm,cordate,dark,densely,diameter,eglandular,entire,extra-axillary,fruit,gland-tipped,globose,green,hair,inflorescence,juicy,length,lobe,margin,midpoint,mm,moist,obtuse,ovate,pale,pedicel,peduncle,perennial,petiole,plant,present,purple,ray,rhizomatous,rotate,short,shrub,simple,stellate-pubescent,stem,streak,style,tube,x,yellow,yellowish-green	%,.05,.7,0-0.3,0-2,0-3,0-5,0.2-2.2,0.4-1,0.5-0.8,0.7-2.5,1-2,1-3,12-20,17-35,2-5,2.3-2.7,4-10,4-7,4-8,4-locular,5-merou,7-11,7-9,abaxially,absen,across,adaxiall,adaxially,alyx,andromonoecious,anvil-shape,apart,articulated,ascending,attenuate,axe,ba,broad-based,circular,cross-section,cylindrical,d.,directed,distall,distally,distributed,dult,eaf,eed,elliptical,erect,exocarp,finger,flower,fruiting,functional,geminat,grey,half,heterostylous,hig,lamina,lateral,less,long,longer,lower,markedly,mature,mesocarp,mid-point,minute,nflorescence,oblique,onl,orolla,part,per,placenta,plurifoliate,pore,porrect,possibly,prickle,pseudo-racemose,ridged,ruit,rusty,spaced,stage,stalk,stalked,stellae,straight,tamen,terete,thick,thicker,thicknes,throughout,time,unarme,unarmed,unbranched,unit,unknow,uvenile,vary,weakly,white,wide,yellowish,ympodial	adhesion,arrangement,climate,colour,corolla,form,glandular,growth,height,history,leaf,life,na,number,ovary,position,presence,pubescence,reproduction,seed,shape,size,staman,stellate,stigma,stipe,texture
186	wfo-0001027146	success	213	108	87	126	21	0.408	0.3-2.2,0.7-2.4,0.8,1-2,1-2.5,1-9.5,13-36,2-13,2-4.2,3.3-6.1,3.5-22,4-11,4-12.5,4-8,6-10,6-17.5,6.5-52,abaxially,adaxially,anther,axillary,berry,brownish,bud,chartaceous,clavate,cm,coarsely,condition,conical,corolla,deep,diameter,drying,elliptic,finely,fresh,fruit,glabrous,green,greenish,hair,herb,lanceolate,leaf,like,lobe,long,medium,membranous,mm,moniliform,mottled,odd-pinnate,ovate,ovoid,pedicel,peduncle,pentagonal,petiole,plant,puberulent,pubescent,purple,ripe,rotate,seed,simple,size,stem,stigma,style,subglabrous,subtending,terminal,throughout,tinged,tube,tuber,unwinged,violet,white,whitish,wide,wing,x,yellow	0-11,0.5-3.2,0.6-3.3,0.8-3.1,0.8-5.8,1-10,1.9-10,10,2-12.2,2-5,4-38,5-merou,6,acumen,acuminate,ag,along,alyx,apart,apex,apparently,arranged,articulated,asymmetrical,attenuate,axe,base,basiscopic,bead,blade,capitat,cell,ciliate,commonly,connivent,covering,dark,darker,decreasing,digestion,distal,dorsally,eaf,edge,eed,enzyme,erec,especially,exceeding,filament,flat,flower,folded,forked,fourt,fourth,geminat,generally,glabrou,gradually,green-white,hair-like,half,homostylous,honeycomb-shaped,interjected,lateral,leaflet,lengthening,living,lower,make,margin,midrib,minute,minutely,mucilaginous,multiple,necklace,nflorescence,orbicular,orolla,pair,perfect,petiolule,plurifoliate,pore,poricidal,proximal,rarely,ray,removed,ruit,secondary,semierect,sessile,seudostipule,side,slit,sometimes,spaced,specimen,stamen,ste,stolon,straight,subequal,subglabrou,subsessile,symmetrical,tall,tamen,tem,testal,thick,tip,tissue,toward,tri-,typically,unit,usually,vary,wall,wet,ympodial	adhesion,arrangement,calyx,capitate,colour,form,growth,height,history,inflorescence,length,life,na,ovary,perennial,position,pubescence,reproduction,shape,staman,texture
187	wfo-0001027154	success	215	111	72	143	39	0.335	.5,.6,0.4-0.5,1-1.3,1.9,2,2.9,3-7,5,adaxially,anther,apex,attenuate,base,blade,calyx,chartaceous,cm,connivent,densely,diameter,extra-axillary,flattened,flower,fruit,globose,green,highly,immature,leaf,length,linear,lobe,margin,mature,mm,nearly,oblique,outline,ovate,pedicel,peduncle,petiole,plant,pubescent,ray,reniform,rotate-pentagonal,rounded,sessile,shape,shrub,simple,size,sometimes,stellae,stellate-tomentose,stem,stigma,stipe,style,tan,tardily,tomentose,truncate,tube,unknown,variable,white,x,yellow,yellowish	-15,-16,.2,0,0.2,0.3–0.6,1.5–2.5,1.5–3,17–19,1–2,2-6,2.5-5,23,26,2–2.5,2–4,35,3–10,4.5–5,4.5–8,4–8,6–8,6–9-rayed,7.5-11,7–20,8,8-11,abaxially,absent,accrescent,acute,adaxiall,ag,alyx,ample,apart,armed,articulated,axe,ba,basal,berry,branch,branched,broad,broad-based,capitat,clavate,color,curved,cylindrical,deltate,difoliate,directed,distally,eaf,eed,entire,evidently,except,ferruginous,filament,finer,flowering,foveolate,free,fruiting,geminat,glabrescen,glabrous,hair,ilament,interpetalar,irregularly,juvenile,lanceolate,larger,less,lighter,like,lobed,lognitudinal,long,m.,major,midpoint,midrib,minute,minutely,mostly,much,near,nflorescence,normally,often,older,opening,orolla,paler,part,per,perfect,pinnately,pore,prickle,rachi,rarely,reaching,recurved,reflexed,repand,ruit,shiny,side,sinus,slightly,slit,smaller,spaced,sprout,ste,stipitate,stout,straight,sulcate,surface,tal,tem,third,three,tissue,unarme,unarmed,underside,uniform,unit,usually,vary,vein,within,ympodial,young,–4	0.3-0.6,0.6,1,1-2,1.5-3,10,17-19,2-2.5,3-10,4-8,4.5-5,4.5-8,6-8,7-20,adhesion,arrangement,capitate,colour,corolla,form,glabrescent,growth,height,history,inflorescence,life,na,number,ovary,perennial,position,presence,pubescence,reproduction,seed,staman,stellate,texture,ye
188	wfo-0001027157	success	207	92	71	136	21	0.343	0.15-0.3,0.9-2.8,1,1-2,1-3,1-6,1.5-6.5,10-30,2-15,2-2.5,2-3,2.5-3,3-7,3.3-7.8,4-5,6.5-14.5,9-12,anther,axillary,brownish,bud,chartaceous,clavate,cm,condition,conical,corolla,deeply,densely,diameter,drying,fresh,fruit,glabrous,green,greenish,hair,herb,lanceolate,leaf,like,lobe,long,membranous,mm,odd-pinnate,ovoid,pedicel,peduncle,petiole,plant,puberulent,pubescent,ripe,seed,size,sometimes,stellate,stem,stigma,style,subtending,terminal,tinged,tube,violet,white,whitish,wide,x,yellow	0-3,0.7-2,1-10,1-3.8,2,2-5,2.3-4,3-12,3.8-8.3,5-merou,abaxially,absent,acumen,acuminate,acute,adaxially,ag,along,alyx,among,apart,apex,apparently,articulated,attenuate,axe,base,berry,blade,broadly,capitat,cell,ciliate,connivent,cordate,covering,cuneate,decreasing,decurrent,digestion,distal,dorsally,eaf,edge,eed,elliptic,end,enzyme,erec,especially,exceeding,filament,flat,flower,folded,forked,geminat,generally,glabrou,grassland,greatly,green-white,hair-like,half,homostylous,honeycomb-shaped,interjected,lateral,leaflet,lengthening,living,low-growing,lower,make,margin,markedly,middl,midrib,minutely,mucilaginous,narrowly,nflorescence,oblique,obtuse,one,orbicular,orolla,ovate,pair,perfect,petiolulate,petiolule,placed,plurifoliate,pore,poricidal,rarely,removed,rounded,ruit,semi-rosette,sessile,seudostipule,shady,short,situation,slightly,slit,spaced,specimen,stamen,ste,stolo,straight,subsessile,sunny,tall,tamen,tem,testal,thick,throughout,tip,toward,tri-,tuber,typically,unequal,unit,unwinged,usually,vary,wall,wet,woodland,ympodial	adhesion,arrangement,calyx,capitate,colour,form,growth,height,history,inflorescence,length,life,na,ovary,perennial,position,pubescence,reproduction,shape,staman,texture
189	wfo-0001027184	success	219	126	98	121	28	0.447	.5,.7,.8,0.2-0.4,0.4-2,0.4–0.9,0.5-2,0.8,1.5-5,13–18,19,1–2,1–4,2,2–4-celled,3–4-celled,4–12,abaxially,acute,adaxially,along,anther,apex,axi,axillary,base,blade,blue,borne,bract-like,brown,calyx,chartaceous,cm,connivent,densely,diameter,especially,flattened,fleshy,flower,fruit,glabrescent,glabrous,globose,hair,herbaceous,imparipinnate,leaf,leafy,light,lobe,long,margin,membranous,meter,midrib,mm,oblong,obtuse,older,orange,pedicel,peduncle,petiole,pilose,prominently,pubescent,raised,red,reticulate,revolute,ripe,several,shape,shoot,short,simple,size,slightly,small,somewhat,sparsely,stellate,stem,stigma,style,tertiary,truncate,tube,unequal,vein,vine,weak,white,x,yellow,young	.3,0-,0-0.2,0.8–1.6,0–3,1-2,1.5,1.8–3.5,1–2.5,2.8–4.1,3-4-,3-foliolate,3.5–8,3–,4,5,5-7,7,9,absent,accrescent,adaxiall,adventitious,ag,always,alyx,apart,appressed,articulated,axe,ba,basal,branch,broad,broadly,cell,clavat,cluster,cordat,covered,cylindrical,directed,eaf,eed,elliptic,entire,epidermal,extension,fasciculate,filament,foliaceous,free,fruiting,geminat,generally,glabrou,grading,hairlike,half,ilament,introrsely,lanceolate,larger,largest,lateral,leaflet,least,less,like,longitudinal,lower,m.,minutely,mostly,much,narrowly,nearly,nflorescence,node,often,opening,opposite,orolla,ovate,ower,per,petiolule,plurifoliate,pore,portion,prominent,pseudostipule,puberulent,rachi,rarely,root,ruit,scarcely,secondary,slit,soft-woody,spaced,straight,subopposite,sulcate,surface,terminal,tightly,tip,tree,trunk,unarme,unbranched,uniform,unit,usually,vary,visible,wall,ympodial,–9	adhesion,arrangement,clavate,climate,colour,corolla,form,glandular,growth,height,history,inflorescence,length,life,midpoint,na,number,ovary,plant,position,presence,pubescence,ray,reproduction,seed,staman,stipe,texture
190	wfo-0001027186	success	168	96	70	98	26	0.417	0.5-1,1-1.5,1-2.5,1.4-1.6,1.5,1.5-2,1.5-2.5,1.6-5,2-6,2-lobed,3.5-4,4-15,4-9,5-10,6-7,abaxially,acute,adaxially,anther,apex,attenuate,base,berry,calyx,clavate,cm,conical,corolla,diameter,dry,elliptic,entire,fruit,glabrous,globose,green,growth,immature,lobe,lobed,margin,maturity,mm,narrowly,ovary,ovoid,pale,pedicel,peduncle,petiole,poridical,pubescent,reniform,seed,shiny,simple,slightly,sparsely,stem,stigma,style,terminal,tip,tree,tube,variably,white,woody,x,yellow	-6,.4,.5,15,2.5-3,3-4,30-40,9-10,?,abaxial,age,always,anthesi,apart,apparently,axil,bark,branch,branched,broadly,brown,dark,dbh,deflexed,deltate,denditic,dendritic,densely,denser,eaf,ellipsoid,enlarging,exerted,filament,filiform,flower,free,fruiting,glabrescent,golden,incrassat,irregularly,keeled,lamina,lengthening,less,like,longer,loose,lower,m.,midrib,minutely,much,new,nflorescence,occasionally,pair,papillat,papillate,pendent,perfect,pericarp,pitted,planar,plane,plurifoliat,pointed,pore,portion,primary,pubescen,rachi,reddish,rough,ruit,scar,scattered,short,slit,small,soon,spaced,spreading,stalk,straight,strongly,surface,time,treelet,trichome,tub,ud,uniseriate,unit,vein,way,ympodial	2,adhesion,arrangement,blade,colour,form,height,hermaphroditic,history,inflorescence,leaf,length,life,na,perennial,plant,position,presence,present,pubescence,reproduction,shape,size,staman,stellate,texture
191	wfo-0001027187	success	224	118	87	137	31	0.388	.5,0.2,0.3–1,0.6,0.8–2,1.0,1.2,1.5–3.5,1–1.5,1–1.8,1–2,1–3,2.5–4,2.5–6,2–2.5,2–3,2–7,3.5–10,3–10.5,3–7,4,4.5–8,5–11,5–15,6–8,7–12,anther,apex,base,blade,blue,broadly,calyx,cm,cordate,cuneate,darker,deltoid-ovate,densely,diameter,extra-axillary,flattened-reniform,fruit,glabrous,glandular-puberulent,globose,green,hair,herb,irregularly,lanceolate,leaf,lenticular,light,lobe,lobed,margin,maturity,minutely,mm,moderately,mottling,narrowly,obtuse,pedicel,peduncle,perennial,petiole,pubescent,ray,rotate-stellate,rounded,serrate,shallowly,simple,sky,sparsely,stellate,stellate-pubescent,stem,stigma,style,subglobose,tube,yellow,young,×	0,0.05–0.1,0.15–0.4,0.4,0.5,0.5–1,0.5–1.5,1,1-celled,12,13–18,1–3-celled,2,2-,2–5,3-foliate,3.2,3–10,3–6,4–5,5,5-merous,5.4,5.5,5–10,5–6,5–8,6,7,7–15,9,abaxially,accrescent,acute,acute-acuminate,adaxiall,adaxially,alyx,andromonoecious,apart,armed,articulated,axe,berry,branched,bud,capitat,central,chartaceous,completely,connivent,continuum,covering,cylindrical,decumbent,deflexed,deltate,deltate-lanceolate,directed,distal,distall,downward,eaf,eed,equal,erect,exserted,filament,finely,flower,forked,foveolate,fruiting,geminat,grading,hermaphroditic,lateral,like,lon,long,long-stalked,lower,major,morphology,nflorescence,node,offset,often,one,open,orolla,outline,perfect,plurifoliate,pore,prickle,prickle-like,producing,proximal,rarely,rind,root,rooting,ruit,sessile,short-stalked,showing,side,sinus,small,sometimes,spaced,spreading,stalk,staminate,stout,straight,strongly,subequal,subsessile,surface,tall,tamen,tapered,tem,toug,triangular,truncate,unbranched,unequal,unit,usually,vary,vein,weakly,wide,ympodial	adhesion,arrangement,capitate,climate,colour,corolla,dioecious,form,glandular,growth,height,history,inflorescence,length,life,midpoint,na,number,ovary,plant,position,presence,pubescence,reproduction,seed,shape,size,staman,stipe,texture,ye
192	wfo-0001027198	success	191	111	80	111	31	0.419	.5,0.05-1.0,0.5-0.75,0.5-1,0.8-1,1-1.5,1-10,1.5-10,1.5-2,11-20,3/4,5-6,7.5-9,acuminate,acute,anther,apex,attenuate,axil,base,beneath,calyx,clavate,cm,corolla,decurrent,dendritic,densely,dia,elliptic,entire,flower,glabrous,globose,golden,green,inflorescence,leaf,lobe,lobed,long,margin,minute,minutely,mm,obovate,often,opposite,ovary,ovoid-reniform,pale,paler,pedicel,petiole,plant,puberulent,pubescence,pubescent,shaped,shining,short,shrub,simple,size,speciman,stem,stigma,style,styled,surface,tannish-yellow,tear-drop,trichome,tube,type,uniseriate,vein,way,white,x	.4,0.7-1,1-5,10-11,2-5.5,4-9,5-120-flowered,abruptly,always,anthesi,apart,ba,beginning,berry,broadening,bushy,caly,channeled,closely,complex,constriction,corky,corresponding,cyathiform,deltoid,differing,difoliate,dry,eaf,edge,edicel,eed,erect,evenly,exserted,extremely,eye,female,filament,found,free,fruiting,furcate,geminat,glabrate,impressed,inflorescenc,invisible,large,lateral,like,live,lon,lower,main,major,male,many,medium,meet,middle,minor,naked,nearly,nflorescence,older,overlapping,ovoid,papillo,papillose,pendan,pitted,planar,pore,poricidal,portion,rather,reddi,reflexed,rest,rounded,ruit,scar,sessile,set,slender,slightly,small,soon,spaced,specimen,straight,strong,tall,testae,thickened,thin,time,tip,top,tree,two,ud,undersurface,unit,usually,widest,woody,yellowish,ympodial,young	0.5,adhesion,arrangement,blade,climate,colour,diameter,form,fruit,glandular,growth,hair,height,history,length,life,midpoint,na,number,peduncle,perennial,position,presence,ray,reproduction,seed,shape,staman,stellate,stipe,texture
193	wfo-0001027200	success	139	77	52	87	25	0.374	0.05-0.25,0.5-1,0.6-1,1-1.4,1-1.5,1.2-1.5,1.5-2,1.5-5,2.5-3,3-3.5,3.5-6,6-8,8-15,anther,beneath,brown,calyx,capitate,cm,corolla,dark,densely,dia,elliptic,glabrous,globose,green,inflorescence,leaf,lobe,lobed,mm,ovary,ovoid-reniform,pedicel,petiole,puberulent,shaped,shrub,size,small,sparsely,stem,stigma,style,tear-drop,tree,tube,unifoliate,vein,white,x	0.25-0.5,0.5-0.75,0.7-2.5,1.6-6,2-3,9-11,across,acute,anthesi,apex,aspec,ba,bark,base,berry,branch,branche,broadly,conical,converging,decurrent,deeply,deflexed,deltoid,differing,eaf,eed,except,filament,flattened,free,fruiting,geminate,giving,golden,grey-brown,horizontally,impressed,lateral,lightly,like,lon,long,lower,main,major,margin,middle,minor,minute,minutely,near,nearly,node,non-reproductive,occasionally,older,onto,papillo,papillose,pitted,planar,pore,poricidal,portion,prominent,reflexed,rest,ruit,slightly,sparse,spreading,straight,surface,tall,tip,trichome,unicellular,uniseriate,unit,widened,widest,winged,woody,yellowish,ympodial,young	adhesion,arrangement,colour,diameter,form,fruit,growth,height,history,length,life,na,peduncle,perennial,plant,position,presence,present,pubescence,reproduction,seed,shape,staman,stellate,texture
194	wfo-0001027204	success	154	115	82	72	33	0.532	-8,.5-1,.8-2,0.5-4,1-3.5,1-7,1.5-3.5,1.5-6.5,1.5-9,2-2.5,2-4,2-8,3-20,3-5,4-6,5-19,5-30,5-9,6-10,abaxially,acuminate,acute,adaxially,along,angled,apex,base,blade,brown,calyx,chartaceous,cm,connivent,cuneate,decurrent,dense,densely,diameter,eglandular,elliptic,entire,especially,fruit,glabrate,glabrous,glandular,globose,greenish,hair,lanceolate,lobe,margin,mm,moderately,nearly,orange,ovate,pedicel,peduncle,petiole,pink,present,pseudohair,pubescent,pubescent-pilose,purplish,reddish,rugose,shrub,simple,stellate,stellate-campanulate,stigma,style,subcoriaceous,tube,violet,white,x,x1-2,yellow,yellowish	-4.5,-40,1,1-10,1-14,15-35,2-5,4-5-foliat,6-12,8-15,absen,adaxial,aggregate,apart,articulated,axe,branched,cell,channe,cylindrical,denser,directed,distall,distally,eaf,eed,except,expanded,flower,forked,leaving,lon,long,lower,membranaceous,midrib,narrowed,narrowly,near,nflorescence,nther,obtuse,often,orolla,peg,perfect,pore,puberulent,pubescen,rachi,radiu,ripe,ruit,scar,short,spaced,sparsely,stone,subacute,tal,tem,time,tip,triangular,triangular-deltate,truncat,twice,unbranched,unit,vary,wide,ympodial	adhesion,anther,arrangement,climate,colour,corolla,form,growth,height,history,inflorescence,leaf,length,life,midpoint,na,number,ovary,perennial,plant,position,presence,pubescence,ray,reproduction,seed,shape,size,staman,stem,stipe,texture,truncate
195	wfo-0001027213	success	231	133	104	127	29	0.45	-19,-3.3,0-2.5,0.2-0.4,0.2-0.5,0.8-1.8,1-5,1.1-1.7,1.2-1.6,1.2-1.7,1.2-2.5,1.3-2.2,1.7-3.6,1.7-3.9,1.8-3.2,10-24,12.3-16.3,2-5,2.9-3.8,3.5-8,4-9.5,4.2-5.9,5.7-6.2,8-24,abaxially,acuminate,acute,adaxially,anther,apex,attenuate,base,blade,blunt-tipped,broadly,brown,calyx,cell,cm,conical,corolla,cuneate,deltoid,diameter,drying,elliptic,entire,epidermal,eventually,few-rayed,flower,fruit,glabrescent,globose,granular,green,group,hair,immature,inserted,lanceolate,leaf,length,lobe,margin,mm,multangulate,oblanceolate,often,pale,pedicel,peduncle,petiole,porrect-stellate,prominent,pseudo-terminal,pubescence,pubescent,reniform,scabrous,short,short-attenuate,shrub,simple,sometimes,stellate,stem,stigma,style,thick-stalked,tomentose,tomentose-pubescent,tree,tube,vestigial-rayed,violet,white,whitish,whitish-green,x,yellow,yellow-green,yellow-tan,yellowish	-230,-4.5,/10,0-160,0.7-2.3,1-2,1.8-2.8,1/2-2/3,2.4-4.7,2.5-5.1,2.9-4.8,2/3,3.5-5,5-7.5,5-8,5-merou,8.2-10.5,9-13,accrescent,ag,along,alyx,anthesi,apart,apparently,ark,around,articulated,axe,axillary,ba,basal,branch,branched,capitat,completely,covering,cylindrical,dark,decurrent,directed,distally,eaf,early,edge,eed,enveloping,exserted,farinose,filament,free,fruiting,glabrescen,glabrous,grayish-brown,high,homostylous,lackin,lateral,lengthening,lobed,long,long-,long-stalked,longitudinal,lower,m.,main,many,midrib,mixed,moderately,mostly,multangulat,nearly,nflorescence,obovate,obscured,obtuse,older,orbicular,orolla,ovate,ovate-lanceolate,partly,perfect,plurifoliate,pore,poricidal,porrect-stellat,rachi,rather,relatively,reticulate-punctate,ruit,sessile,short-,short-stalked,side,slit,somewhat,spaced,sparsely,stamen,subcampanulate,surface,suture,tamen,terete,thick,thin-stalked,ti,time,tip,tomentu,touching,ud,unarme,unarmed,unit,unwinged,vary,vein,way,wide,ympodial,young	adhesion,arrangement,capitate,climate,colour,form,glandular,growth,height,history,inflorescence,life,midpoint,na,number,ovary,perennial,plant,position,presence,ray,reproduction,seed,shape,size,staman,stipe,texture,ye
196	wfo-0001027214	success	181	98	74	107	24	0.409	-20,-38,0.25,0.5-0.8,0.5-1,0.7-2,0.7-2.5,1-2.8,1.2-3,1.5,1.5-1.8,1.5-6,10-13,15-25,2,2-9,6-12,7-12,abaxially,adaxially,anther,basal,base,calyx,cm,conical,corolla,densely,diameter,elliptic,finely,flattened-round,fruit,glabrous,green,greenish,grown,height,herb,inflorescence,lanceolate,lateral,leaflet,length,less,lobed,long,long-conical,minutely,mm,narrowly,nearly,ovary,pedicel,petiole,pinnate,pointed,poricidal,pubescent,rachi,rugose,seed,sharply,simple,stigma,style,terminal,tip,trichome,tube,uniseriate,white,whitish,x	-9,..,.25,.5,0,0-16,0.3-1.5,0.3-1.7,0.8-1,1-1.5,10-,12-17,3-,3-6,4-5,5-6,6-,8-9,absent,acuminate,acute,along,anthesi,anticlinal,apex,apical,berry,broadly,capitat,cell,climbing,composed,conspicuously,decurrent,deltate,dr.,drying,eaf,edicel,eed,epidermal,erect,exserted,extending,filament,flower,free,fruiting,globose,groove,horizontal,inflorescenc,irregular,lamina,like,lobe,lon,long-acuminate,lower,margin,markedly,midrib,nflorescence,noddin,nodding,oblique,obovate,occasionally,often,once-branched,onto,open,opposite,pair,paired,papilla,papillate,per,perfectly,petiolule,portion,projection,reflexed,rest,rugosity,ruit,scar,scattered,scrambling,sinuous,smaller,somewhat,surface,tem,thickening,time,triangular,truncate,tub,ud,unevenly,unifoliat,unit,vein,white-lenticellate,without,ympodial	.0,0.5,2.0,6-12-17,arrangement,capitate,colour,form,growth,history,leaf,life,na,papillae,perennial,plant,presence,pubescence,reproduction,shape,size,stellate,stem,texture
197	wfo-0001027219	success	143	89	57	86	32	0.399	0.3,0.4-0.6,0.5-0.8,1,1-2,1.5-2,1.5-2.5,2,2-2.5,2-3.5,2-4,3-5,3-6,6-8,acuminate,acute,anther,apex,base,bright,broadly,calyx,capitate,cm,conical,corolla,diameter,elliptic,entire,flower,glabrescent,glabrous,green,growth,hard,leaf-opposed,lobe,lobed,long-conical,long-styled,margin,mm,ovary,pedicel,peduncle,petiole,poricidal,purple,shrub,simple,stem,stigma,style,tip,tube,violet,x	.5,/4,0.5,1-15,1-3,2-3,7-8,absent,age,anthesi,axillary,bark,berr,berry,brown,c.,closely,completely,cup-shaped,deltate,densely,drying,eaf,edge,eed,erect,exerte,exfoliatin,filament,free,fruiting,glabrou,globose,greyish,heterostylous,known,lengthening,less,lower,maturity,minutely,new,nflorescence,overlappin,pair,pale,papillo,papillose-pubescent,pendent,pericarp,planar,plurifoliat,pointed,pore,portion,primary,pubescent,ruit,scar,sharply,shoot,short,short-styled,slightly,slit,sometimes,somewhat,soon,spaced,stout,surface,terminal,thickened,trichome,tuft,ud,uniseriate,unit,vein,way,weight,white,woody,yellowish,ympodial,–1/3	adhesion,arrangement,blade,climate,colour,form,fruit,glandular,hair,height,history,inflorescence,leaf,length,life,midpoint,na,number,perennial,plant,position,presence,pubescence,ray,reproduction,seed,shape,size,staman,stellate,stipe,texture
198	wfo-0001027221	success	261	109	61	200	48	0.234	.5,0.3-0.6,1,1.4-2,3.1-4.8,4,acute,andromonoecious,anther,apex,attenuate,base,berry,blade,blue,bright,calyx,cm,diameter,extra-axillary,flattened-reniform,flower,fruit,glabrous,glandular-pubescent,globose,hair,intensity,lanceolate,leaf,light,lobe,margin,midpoint,mm,orange,outline,ovate,pale,pedicel,peduncle,persistently,petiole,plant,ray,rounded,shrub,simple,size,stellae,stellate,stellate-tomentose,stem,stigma,style,subcordate,tube,variable,violet,x,yellow	-9.5,0,0.4,0.4–0.6,0.5–2,0.8–1,1-4,1.5-2,1.6–2,11-17,11–14,13–16,14–17,1–2,2,2.2-3.2,2.5–2.8,2.5–5,2.9–3.6,2/3,25-30,2–2.5,2–3,2–5,3–6,4.5–11,4–8-rayed,5-8,5-merou,6-8,6.5–7,8.5–18,9,abaxial,abaxiall,abaxially,acicular,actually,acutely,adaxially,along,also,always,alyx,ample,apart,apparent,apparently,appear,armed,aromatic,articulated,ba,becoming,blunt-tipped,branched,broad-based,bud,capitat,caudate,central,chartaceous,clavate,closely,common,contrasting,coroll,curved,cylindrical,darker,deeply,delicate,dense,densely,development,difoliate,directed,discrete,distally,eaf,eed,entire,equal,eventually,evidently,exceeding,expanded,fewer,filament,frequently,fresh,fruiting,geminat,glabrescent,gland,half,herbarium,hermaphrodite,homostylous,interpetalar,juic,lateral,least,like,likely,lobed,long,lower,main,major,material,microscope,midrib,midvein,minor,minutely,mostly,much,nearly,nerve,nflorescence,obtuse,often,older,orolla,ovate-oblong,ovate-triangular,pair,paired,per,perfect,perhaps,peripherally,pitted,plurifoliate,pore,predominately,prickle,probably,rachi,rarely,reflexed,repand,ruit,sessile,short-stalked,side,similar,sinus,slightly,smaller,sometimes,somewhat,soon,source,spaced,sparsely,specimen,splitting,sprout,stalk,stalked,stamen,stellate-pubescent,straight,sulcate,surface,tal,tapered,tem,thick-textured,thickened,time,tip,tissue,tomentose,toward,triangular-caudate,unarmed,unbranched,underside,unequal,unit,unpleasantly,usually,vary,vein,viscid,viscidity,way,weakly,white,wide,ympodial,youn,young,–11.5,–15,–3,–4	0.4-0.6,0.5-2,0.8-1,1-2,11-14,11.5,13-16,15,2-2.5,2.5-2.8,2.5-5,2.9-3.6,3-6,4-8,4-8-rayed,4.5-11,6.5-7,8.5-18,absent,adhesion,arrangement,capitate,climate,colour,corolla,form,glandular,growth,height,history,inflorescence,juicy,length,life,na,number,ovary,perennial,position,presence,present,pubescence,reproduction,seed,shape,staman,stipe,texture
199	wfo-0001027223	success	189	96	71	118	25	0.376	.5,0.19-0.75,0.3-1.2,1-3,1.8-3.5,16-41,3-10,3-11,3-5.2,3.5-4,3.7-9.3,4-6,5-8,5.9-12.2,9-15,9-22,anther,axillary,brownish,bud,clavate,cm,condition,conical,corolla,deep,densely,diameter,dot,drying,elliptic,fresh,fruit,glabrous,green,greenish,hair,herb,hyaline,lanceolate,leaf,light,like,lobe,long,mm,odd-pinnate,ovoid,pedicel,peduncle,pentagonal,petiole,plant,pubescent,purple,ripe,rotate,seed,size,sometimes,stigma,stripe,style,subtending,terminal,tube,white,whitish,wide,x,yellow	1-2,1.3-2,1.5-3.5,2-4,2-7,3-5,3.5-6,3.5-7,5-10,5-21,5-merou,9-35,abaxially,acumen,acuminate,adaxiall,adaxially,ag,alyx,apart,apex,apparently,articulated,asymmetric,attenuate,axe,base,basiscopic,berry,blade,capitat,cell,connivent,covering,decreasing,digestion,distal,dorsally,eaf,edge,eed,end,enzyme,erec,exceeding,filament,flat,flower,folded,forked,geminat,generally,glabrou,green-white,hair-like,hal,half,homostylous,honeycomb-shaped,interjected,larger,lateral,leaflet,lengthening,living,lower,make,middle,mucilaginous,nflorescence,one,orbicular,orolla,ovate,pair,perfect,petiolulate,placed,plurifoliate,pore,poricidal,present,removed,rounded,ruit,sessile,seudostipule,short,shortly,side,slightly,slit,spaced,specimen,stamen,ste,stolo,straight,subequal,tall,tamen,tem,testal,thick,throughout,tip,tissue,toward,tri-,tuber,typically,unit,unwinged,usually,vary,wall,wet,ympodial	abaxial,adaxial,adhesion,arrangement,calyx,capitate,colour,form,growth,height,history,inflorescence,length,life,na,ovary,perennial,position,pseudostipule,pubescence,reproduction,shape,staman,stem,texture
200	wfo-0001027229	success	206	109	80	126	29	0.388	0-0.2,0.1-3,0.2-0.4,0.2-2,0.5-0.9,0.6-1,1-1.5,1-2,1.5-2.5,1.5-3,1.8-2.7,3-6,3.5-5,3.5-6,4-10,4-6,4-7,5-15,5-6,7-11,8.5-12,abaxially,acute,adaxially,anther,apex,base,blade,broadly,calyx,chartaceous,circular,cm,cordate,densely,diameter,eglandular,extra-axillary,fruit,glabrous,gland-tipped,glandular,globose,green,hair,herbaceous,inflorescence,lanceolate,length,lilac,lobe,lobed,margin,midpoint,mm,moderately,obtuse,ovate,pale,pedicel,peduncle,pentagonal,petiole,present,ray,reniform,resprouter,shallowly,short,simple,sparsely,stellate,stellate-pubescent,stigma,style,tan,throughout,tube,x,yellow	%,0-0.1,0-8,0.1-0.3,0.1-0.6,0.1-1,0.1-1.4,0.2-1.7,0.5-0.7,0.5-3,0.6-0.7,1-6,1-7,1-8,1.1-1.2,1.3-1.7,12-17,2-10,2-4,2-5,2-foliate,2-locular,2.5-6,20-65,25-35,30-145,30-300,4-5,40-55,5-9,5-merou,8-12,absen,absent,abundant,accrescent,acicular,across,adaxiall,adult,alyx,apart,armed,articulated,attenuate,axe,ba,branche,capitat,cross-section,cylindrical,decimetre,directed,distall,eaf,eed,elliptica,erect,especially,exceeding,exocarp,filament,finger,flattened,flower,fruiting,geminat,homostylous,index,interpetalar,juicy,lamina,lateral,lobing,lon,long,longer,lower,mature,mesocarp,mid-point,midvein,minute,minutely,moist,nflorescence,oblique,orolla,part,per,perfect,placenta,pore,porrect,presen,prickle,prostrate,pseudo-racemose,rachi,reticulate,ruit,side,spaced,sprawling,stage,stalk,stalked,stellae,straight,surface,tal,tamen,tem,thick,time,tissue,toward,transparent,triangular,unbranched,unit,uvenile,vary,vein,wide,ympodial	adhesion,arrangement,capitate,climate,colour,corolla,elliptical,form,growth,height,history,leaf,life,na,number,ovary,perennial,plant,position,presence,pubescence,reproduction,seed,shape,size,staman,stem,stipe,texture
201	wfo-0001027232	success	195	108	80	115	28	0.41	0.3-0.4,0.3-0.45,0.3-0.5,0.6-0.9,0.7-1.5,1.5-2.5,1.5-3,1.8-3.9,2-3.4,2.1-2.8,2.5-3,3-5,3.5-10,4-5.5,4-8,4.5-6.5,5-11.5,5-8,absent,acute,adaxially,anther,apex,base,black,blade,bluntly,broadly,brown,calyx,chartaceous,cm,cordate,deeply,diameter,discoid,extra-axillary,flattened,fruit,glabrous,gland-tipped,globose,green,hair,inflorescence,irregularly,lancolate,length,lilac,lobe,lobed,margin,midpoint,mm,obtuse,orbicular,outline,ovate,pale,pedicel,peduncle,perennial,petiole,present,purple,ray,rhizomatous,short,shrub,simple,sparsely,stellate,stellate-pubescent,stigma,style,throughout,triangular,tube,x,yellow	%,0-0.1,0-7,0.15-0.3,0.25-0.4,0.4-0.8,0.45-0.6,0.5-0.8,0.7-1.3,0.8-3.2,0.9-7.5,1-10,1-locular,1.1-1.5,10-30,14-18,14-30,15-100,2-25,25-35,3-9,350-800,4-10,4-6,5-merous,6-8,7-9,abaxially,absen,accrescent,acicular,across,adaxiall,adult,apart,apparen,armed,articulated,axe,ba,branche,capitat,confined,cylindrical,decimetre,deltate,directed,distall,distributed,eaf,eed,eglandular,erect,exocarp,filament,finger,flower,forked,fruiting,half,incomplete,index,juicy,lamina,lateral,less,lobing,long,longer,lower,mature,mesocarp,mid-point,midrib,midvein,minute,minutely,moderately,nflorescence,oblique,orolla,part,per,perfect,placenta,pore,porrect,prickle,reticulate,rostrate,ruit,septum,sessile,side,spaced,sparse,stalk,stellae,straight,succulent,surface,tal,tamen,tem,thick,time,transparent,unarme,unbranched,unit,unknow,vary,vein,wide,ympodial	adhesion,arrangement,capitate,climate,colour,corolla,form,glandular,growth,height,history,leaf,life,na,number,ovary,plant,position,presence,pubescence,reproduction,seed,shape,size,staman,stem,stipe,texture
202	wfo-0001027234	success	206	116	86	120	30	0.417	-0.15,-3,-3.5,0.05-0.1,0.1,0.2-1.3,0.3-0.4,0.3-1,0.5-2,0.5-3,0.6-0.8,0.7-1.3,0.7-1.5,0.8-0.9,0.9-1.6,1-2,1.5-2.2,1.5-4,1.8-3,2-4,2/3-4/5,3-5,8-16,acute,almost,anther,apex,attenuate,base,berry,black,blade,brown,calyx,cm,cordate,dark,diameter,entire,equal,erect,flattened-reniform,fruit,glabrescent,glabrous,herb,lateral,leaf,length,lobe,lobed,long,margin,maturity,mauve,membranous,midpoint,mm,near,orbicular,ovate,pedicel,peduncle,petiole,poricidal,purple,ray,red,rounded,scandent,shrub,simple,smooth,sometimes,spherical,spreading,stellate,stem,style,surface,tapering,tip,trichome,tube,way,wide	-1.5,-2,-6,.5,0-20,0-4,0.1-2,0.15,0.5-0.7,1,1-4,1.2-2,1.5-3.5,1/3,1/4-1/3,12-18,3-10,3-6.5,4-5-merous,8-15,abaxially,absent,acuminat,alyx,apar,apart,apically,apparently,articulated,bark,beyond,blac,branched,broad-deltate,cell,concolorous,curved,deltate,difoliate,dot,drying,eaf,eed,elongating,eye,filament,filiform,flower,free,fruiting,geminat,glabrou,glan,gland,globular,gray,green,herbaceous,infructescence,longer,lower,mature,moderately,multangulate,naked,narrowly,nflorescence,oblong,obtuse,older,one,open,orolla,oung,outline,pair,pale,pendulous,per,perfec,pericarp,perpendicular,pit,porrect,portion,prickle,prickly,primary,protruding,raised,reduced,reflexed,ruit,scar,scattered,sessile,shorter,slightly,spaced,sparsely,stalk,stalked,stellate-pubescent,straight,tamen,terete,tertiary,time,unarme,unarmed,unit,vary,vein,venation,visible,white,winged,yellow,yellowish,ympodial	adhesion,arrangement,climate,colour,corolla,form,glandular,growth,hair,height,history,inflorescence,life,na,number,ovary,perfect,plant,position,presence,present,pubescence,reproduction,seed,shape,size,staman,stigma,stipe,texture
203	wfo-0001027235	success	189	97	69	120	28	0.365	.5,0.5,1,1.2,1.5,10,11,12,14,18,2,2.5,3,35,4,6,8,9,?,anther,apex,base,black,blade,calyx,chartaceous,chocolate-brown,cm,deeply,diameter,difoliate,extra-axillary,flower,fruit,glabrous,globose,green,hair,herb,leaf,length,linear-lanceolate,lobe,lobed,margin,midpoint,mm,nearly,obtuse,pedicel,peduncle,petiole,pinnatifid,pinnatisect,pubescent,ray,reniform,rotate-stellate,rounded,sparsely,stellate,stem,stigma,style,tube,turning,white,yellow,×	13,30,40,5,5-merous,abaxial,abaxially,absent,abundant,accrescent,acicular,acute,adaxial,adaxially,alternating,alyx,apart,armed,articulated,asymmetrical,axe,ba,berry,brown,burr-like,c.,completely,cordate,covering,creating,curved,cylindrical,densely,dimorphic,directed,distally,dry,drying,eaf,eed,enantiostylou,filament,four,fruiting,geminate,glabrou,gland-tipped,interpetalar,introrsely,invested,irregularly,larger,left-handed,like,lon,long,longitudinal,lower,lowermost,maturity,midrib,midvein,moderately,multicellular,multiseriate,narrowly,nflorescence,occasional,occasionally,often,one,opening,opposite,orolla,pair,per,pinnate,pore,prickle,prickly,rachi,raised,ridge,right,ruit,secondary,shallowly,side,simple,slightly,slit,spaced,stalk,ste,straight,strongly,surface,tamen,tan,tapering,tearing,tem,tightly,tissue,triangular,unbranched,undulate,unequa,unicellular,uniseriate,unit,upper,upward,usually,vary,vein,venation,wid,ympodial,zygomorphic	adhesion,arrangement,climate,colour,corolla,form,glandular,growth,height,history,inflorescence,life,na,number,ovary,perennial,plant,position,presence,present,pubescence,reproduction,seed,shape,size,staman,stipe,texture
204	wfo-0001027236	success	199	137	111	88	26	0.558	-4.5,-5,1,1-1.5,1-2.5,1-3,1.5-2,10,10-20,2-2.5,2-3,2-5,2-6,2.5-,3-3.5,3-4,4-5,5-,5-6,5-9,7-14,8-10,acute,anther,anthesi,apex,asymmetric,basal,base,becoming,berry,blue,branched,brown,calyx,chartaceous,clavate-truncate,cm,cordate,corolla,densely,diameter,flattened,flower,fruit,glabrous,glandular,glandular-hirsute,globose,green,growth,heterostylous,internodal,lanceolate,length,like,lobe,lobed,lobed-angulate,long-styled,lower,margin,midpoint,minutely,mm,older,ovary,ovate-cordate,pedicel,peduncle,petiole,plant,prickle,pubescence,pubescent,ray,reniform,ripe,rounded,rusty,short-styled,shrub,simple,stellate,stellate-pilose,stem,stigma,style,subcoriaceous,subglobose,suborbicular,subsagittate,surface,tapering,terete,tiny,trichome,tube,unarmed,upper,velutinous,villous,villous-glandular,violet,viscid,woody,woolly,x,yellow-orange,young,¼	-82,/6,0.2-0.3,0.6-0.7,1-2,1.2-1.5,2-,3-8,30-50,5-8,abaxially,adaxially,armed,articulated,bark,brow,caly,closely,compressed,dark,discolorous,distal,eaf,eed,eglandular,erect,exserted,filament,foveolate,free,fruiting,fused,glabrescent,gland-tipped,lateral,lengthening,light,long,middle,minute,mixed,multangulate,nearly,new,nflorescence,obverse,ochraceous,ovate-turbinate,papillo,partially,per,perfect,pericarp,plurifoliat,pore,poricidal,porrect,portion,prickly,raise,recurved,reflexe,reticulate,ruit,runcinate,scandent,scar,sessile,slightly,slit,smooth,somewhat,space,sparsely,stalked,staminate,stellate-glandular,striped,tall,testa,tip,ud,unevenly,unit,viscid-tomentose,yellow,ympodial,½	adhesion,arrangement,blade,climate,colour,form,hair,height,history,inflorescence,leaf,life,na,number,papillose,perennial,position,presence,present,reproduction,seed,shape,size,staman,stipe,texture
205	wfo-0001027237	success	122	80	45	77	35	0.369	0.5-1,1-1.2,1.5-2,1.5-2.5,2-3,3-3.5,3-4,6-11,6-8,8,anther,base,brown,calyx,clavate,cm,corolla,dark,flattened,glabrous,globose,green,greenish-white,inflorescence,internodal,leaf,lobe,lobed,margin,mm,ovary,paler,pedicel,reniform,shaped,shrub,small,stem,stigma,style,tear-drop,tree,tube,white,x	.5,/4,30-100-flowered,5,anthesi,apart,apiculae,apiculate,appearing,ba,bark,berry,blac,black,branc,branched,broadly,completely,cucullate,cup-shaped,deflexed,deltoid,dia,difoliate,drying,edicel,eed,ellipsoid,erect,exsertion,filament,free,fruiting,geminate,greyi,later,long,lower,many,minutely,nflorescence,occasionally,older,papillate,papillo,papillose,part,pitted,plurifoliat,pore,poricidal,portion,reflexed,regularly,regulary,ruit,scar,shining,slender,spaced,straight,surface,tall,tapering,terminal,time,tip,ud,unit,upper,usually,way,widely,woody,x.,ympodial,young	0.5,adhesion,apex,arrangement,blade,climate,colour,diameter,form,fruit,glandular,growth,hair,height,history,length,life,midpoint,na,number,peduncle,petiole,plant,position,presence,pubescence,ray,reproduction,seed,shape,size,staman,stellate,stipe,texture
206	wfo-0001027238	success	204	102	74	130	28	0.363	.3,0-1,0-1.5,0.3-0.5,0.3-0.8,0.3-1,0.3-5,0.5-1,0.5-16,1-1.5,1.5-3,1.5-4,2-4,3-4,3-5,3-6,4-10,5-15,acuminate,acute,anther,apex,base,black,blade,brown,calyx,chartaceous,cm,cuneate,densely,diameter,elliptic,elliptic-ovate,entire,equal,extra-axillary,fruit,glabrescent,glabrous,globose,lavender,leaf,light,lobe,margin,membranaceous,mm,oblong,outline,pale,pedicel,peduncle,petiole,pubescent,purple,ray,reniform,rounded,shiny,shrub,simple,small,sparsely,stellate,stellate-pubescent,stem,stigma,style,tree,tube,white,x,yellow	-25,-5,.5,0-0.7,0.5-2,1-2,1.5-7,10,15-30,2-3,4-,4-16,4-5,4-8,5-7,5-merou,6-15,6-8,abaxially,accrescent,adaxiall,adaxially,ag,alyx,apparently,articulated,axe,ba,berry,branch,capitat,connivent,contiguous,covering,cylindrical,dark,deltate,differentiated,directed,discolorous,distally,eaf,eed,filament,flattened,fleshy,flower,foliaceous,fork,free,frui,fruiting,geminate,gland,gland-tipped,green,greenish,growt,hair,homostylous,interpetalar,introrsely,juic,large,lighter,like,long,longitudinal,lower,major,midpoint,minor,minutely,mixed,multangulate,narrowly,near,nearly,new,nflorescence,oblique,obtuse,often,one,opening,orolla,paired,part,perfect,pericarp,pitted,plurifoliate,pore,porrect-stellate,rachi,ripe,ruit,scandent,sessile,short-stalked,side,similar,slit,sometimes,somewhat,sparse,sprawling,ste,straight,strongly,subtending,surface,tamen,tem,time,tip,tissue,toward,triangular,unarme,unbranched,unequal,unit,vary,vein,whitish,wide,without,yellowish,ympodial	adhesion,arrangement,capitate,colour,corolla,form,growth,height,history,inflorescence,length,life,na,number,ovary,perennial,plant,position,presence,present,pubescence,reproduction,seed,shape,size,staman,stipe,texture
207	wfo-0001027242	success	238	108	82	156	26	0.345	0-0.7,0.15-0.25,0.25-0.5,0.3-0.5,0.3-1.1,0.6-3,0.7-1.2,1-1.5,1-2.5,1.5,1.5-2,1.5-3,1.9-5,2.5-3,2.8-3.7,3-4.5,4-5.5,4.5-11,5.5-7,6-21,7-8,absent,acute,anther,apex,base,blade,calyx,chartaceous,cm,connivent,cuneate,densely,diameter,entire,extra-axillary,flattened,fruit,glabrous,gland-tipped,globose,hair,inflorescence,leaf,length,light,lobe,lobed,loosely,margin,midpoint,mm,narrowly,orange,ovate,pale,pedicel,peduncle,perennial,petiole,pink,plant,present,purple,ray,red,rhizomatous,shallowly,short,shrub,simple,sparsely,stellate,stellate-pubescent,stigma,style,subcoriaceous,tube,white,whitish,x,yellow	%,.05,.2,0-1.5,0-15,0-20,0-5,0.2-0.7,0.2-1,0.5-1,0.6-0.9,1-1.2,1-2,1-locular,10-22,12-16,15-25,2,2-2.9,2-3,3-12,3-6,3-7,3.5-4.5,4-30,4-7,4.5-10.5,5-merou,6-14,6-7,6-8,8-15,9-11,abaxially,absen,accrescent,acicular,across,adaxially,adult,alyx,andromonoecious,apart,apparen,articulated,axe,ba,bract-like,branch,branche,capitat,confined,contiguous,cylindrical,deltate,directed,distall,dm,eaf,eed,erect,exocarp,filament,finger,flower,forked,fruiting,geminate,green,half,heterostylous,incomplete,index,interpetalar,juicy,juvenile,lamina,lateral,less,lobing,long,longer,lower,mature,mesocarp,mid-point,midrib,midvein,minute,minutely,mixed,moderately,much,nearly,nflorescence,oblique,obtuse,occasionally,often,one,orolla,pair,part,per,perfect,placenta,plurifoliate,pore,porrect,prickle,pseudo-racemose,pseudo-umbellate,rachi,reticulate,rooting,rostrate,rounde,ruit,septum,sessile,side,slightly,smaller,smooth,spaced,sparse,sprawling,stellae,straight,strongly,succulent,surface,tall,tamen,tapered,tem,thick,throughout,time,tip,tissu,tissue,toward,triangular,unarme,unarmed,unbranched,unit,upper,usually,vary,vein,weakly,wide,yellowish,ympodial	adhesion,arrangement,capitate,climate,colour,corolla,form,glandular,growth,height,history,life,na,number,ovary,position,presence,pubescence,reproduction,seed,shape,size,staman,stem,stipe,texture
208	wfo-0001027244	success	294	116	89	205	27	0.303	-12,-2,-3.2,.5,0.05,0.2-1,0.3-0.6,0.45-0.6,0.5-0.8,0.7-1.5,0.9-1.3,1,1.1-1.3,1.2-1.6,1.5-2.4,1.5-6.5,1.7-3.0,2-,2.1-8,3.5-13,4-12,7-12,acute,anther,apex,base,broadly,brown,calyx,capitate,cm,cordate,corolla,crenate,dark,densely,dentate,diameter,elliptic,fruit,glabrous,glandular,globose,green,greenish,herb,imparipinnate,inflorescence,interrupted,irregularly,length,like,lobe,lobed,long,margin,mixture,mm,obovate,orbicular,ovary,pedicel,peduncle,perennial,petiole,present,pubescent,purple,rotate-stellate,rounded,simple,size,slender,sparsely,stem,stigma,stripe,style,thick,trichome,truncate,tube,uniseriate,velvety,vivid,white,wide,woody,yellow	-1.2,0-,0.02-,0.04-,0.05-1,0.07-0.15,0.1-,0.1-0.3,0.1-0.5,0.1-0.6,0.15-0.2,0.2,0.2-,0.25-0.4,0.3,0.3-0.4,0.3-0.5,0.3-0.8,0.4-,0.4-0.6,0.4-1,0.5,0.5-1,0.6-0.9,0.6-09,0.7-1,0.7-2,0.7-3,0.8-1.2,0.9-1.7,1-2-celled,1-2.5,1-3.5,1-celled,1.5-2,1.5-2.1,1/2,2-4,2-4-celled,2-9,2-foliate,2-locular,3-5,3/4,4-celled,5-,5-10,5-9-celled,8-16,8-celled,abaxially,absent,abundance,abundant,acroscopically,acuminate,adaxially,adpressed,alfway,along,also,always,amongst,angled,anthesi,apical,apparently,appearance,appendage,arequipa,around,articulated,articulatio,articulation,axi,basal,berr,berry,bifurcate,bract,bracteate,branched,c.,cage,cell,column,common,conical,curved,deciduous,decumbent,decurrent,deeper,deltate,dense,density,developed,diamete,distal,eaf,edicel,eed,eglandular,either,elliptical,erect,exserted,extremely,filament,flower,flushed,forming,fruiting,general,giving,glabrescent,gland,gree,hair-like,half,halfway,head,hyaline,interjected,internode,investing,lamina,lanceolate,larger,largest,lateral,leaflet,leave,lobing,lon,longer,lower,middle,midvein,minute,mixed,multicellular,narrowly,near,node,oblique,occasionally,often,onto,outgrowth,pair,papillate-pubescent,patent,petiolule,population,primary,pseudostipule,rachi,reflexed,rest,ripe,ruit,scattered,secondary,sessile,shaggy,short,shorter,silky,sinus,small,sometimes,somewhat,sparse,sparser,spreading,staminal,sterile,stout,straight,strongly,surface,tall,tem,terminal,tertiary,testa,tiny,tip,tipped,toward,two,ud,undulate,unicellular,unit,united,upper,usually,variable,variety,vein,wall,winged,ympodial	adhesion,arrangement,blade,climate,colour,form,growth,hair,height,history,leaf,life,midpoint,na,number,plant,position,presence,pubescence,ray,reproduction,seed,shape,staman,stellate,stipe,texture
209	wfo-0001027248	success	158	96	73	85	23	0.462	.5,0.5-1,0.5-2.5,0.7-1.2,1-1.5,1-2,1-3,1-5,3-4,3-7,3.5-4,5-5.5,6-13,6.5-8,abaxially,adaxially,along,anther,arachnoid,area,base,beige,broadened,brown,calyx,cm,corolla,dark,densely,denser,dia,difoliate,dirty,elliptic,felty,fruit,geminate,glabrous,globose,green,leaf,lobe,lobed,long,merely,mm,nearly,occasionally,opposite,ovary,ovoid-reniform,patch,pedicel,petiole,poricidal,pubescence,pubescent,scattered,shrub,size,small,stem,stigma,style,tip,top,tree,trichome,tube,unifoliate,vein,white,wide	0,2-2.5,2-4.5,3-7-flowered,4-8,7-9,abaxial,acute,anthesi,ape,apex,appearing,arachnoid-pubescen,arachnoid-pubescent,bark,beneath,berry,broadly,brownish,brownish-gra,closely,conical,deflexed,deltate,differing,eaf,edicel,eed,ellipsoid,erect,exserted,filament,fleshy,free,fruiting,glabrescent,grayish-green,impressed,lamina,later,lateral,lightly,lower,main,major,margin,minor,minutely,nflorescence,node,older,overlappin,pair,pale,papillo,papillose,per,pitted,planar,pore,portion,present,ruit,scar,shaped,shoot,simple,somewhat,soon,spaced,sparsely,specimen,strongly,surface,tall,tear-drop,thick,tub,ud,unit,wid,winged,woody,ympodial,young	adhesion,arrangement,colour,diameter,form,growth,height,history,inflorescence,length,life,na,peduncle,perennial,plant,position,presence,reproduction,seed,shape,staman,stellate,texture
210	wfo-0001027258	success	178	109	77	101	32	0.433	/4,0.25-0.5,0.6-2,0.9-1.3,1-2.3,1.5-1.6,2-2.5,3-4,3-6,3.5-4,4-5,4.5-5,6-8,7-13,abaxially,acuminate,acute,adaxially,age,anther,apex,attenuate,axil,base,calyx,capitate,cm,corolla,densely,dia,elliptic,flattened-reniform,fruit,glabrous,globose,green,internodal,lateral,leaf,length,lengthening,lobe,lobed,main,margin,mm,occasionally,onto,opposite,ovary,ovate,pedicel,petiole,pore,poricidal,pubescent,shrub,simple,size,slightly,slit,sparsely,stem,stigma,style,tip,treelet,trichome,tube,tuft,uniseriate,vein,way,white,winged,x,yellowish-tan	.25,.5,0.5-1,1-1.5,1-4,1.2-2,2.5-8,5-10-flowered,7-9,abruptly,along,anthesi,apar,apical,apiculae,ba,bark,beneath,berry,broadly,crystal,darker,decurrent,deflexed,deltate,dense,deposit,differing,difoliate,dissecting,drying,eaf,edicel,eed,ellipsoid,enlarge,entire,evenly,exserted,extending,fide,filament,fragrant,free,fruiting,geminat,glabrou,greenish-yellow,incrassate,lamina,large,lenticel,long,lower,major,microscope,middle,minor,minute,minutely,nee,nflorescence,often,older,pair,pale,papillo,papillose,pitted,planar,portion,projection,prominent,red-papillose,reddish,ruit,sand,scar,scattered,slender,small,spaced,speck,straight,strongly,surface,sweetly,swollen,tall,tiny,tub,ud,unit,urceolate,visible,widening,widest,woody,yellowish,ympodial,young	0.25,adhesion,arrangement,blade,climate,colour,diameter,form,glandular,growth,hair,height,history,inflorescence,life,midpoint,na,number,peduncle,perennial,plant,position,presence,pubescence,ray,reproduction,seed,shape,staman,stellate,stipe,texture
211	wfo-0001027260	success	176	109	76	100	33	0.432	0.25-1,0.5-3,0.5-6.5,0.8-2,1-3,1-6,1-7,1.5-13,1.5-2,10-25,2-10,2-18,2-2.5,2.5-3.5,3-11,3-4.5,3-6,3.5-25,4-32,6-20,acuminate,acute-,age,apex,basal,base,blade,chartaceous,clavate,cm,cordate,darker,densely,diameter,ellipsoidal,elliptic,elliptic-ovate,entire,fading,flattened,fruit,glabrate,glabrous,globose,greenish,hair,lavender,lobe,longitudinal,margin,mm,ovate,pedicel,peduncle,petiole,pilose,pink,puberulent,pubescent,purple,shrub,simple,small,stellate,stigma,stripe,style,subcoriaceous,tree,truncate,tube,white,x,yellow,yellow-green,yellowish	-17,-2,-60,-7,0.5-1,0.75-1,1-,1-2,1-4,15-30,2-,2.5-14,3-,3-10,4-25,4-5-foliat,4-6,4.5-14,5-,5-25,5-40,5-merous,abaxially,absent,acute,adaxially,aggregate,also,alyx,apart,ape,articulated,axe,berry,beyond,branched,cell,connective,connivent,cylindrical,diamete,directed,distally,eaf,eed,eglandular,equal,exceeding,exserted,flower,lanceolate,leaving,lon,long,lower,membranaceous,moderately,narrowly,nearly,nflorescence,nther,obtuse,often,orolla,pedicellar,perfec,perfect,pilo,pore,presen,puberulent-pubescen,puberulent-pubescent,pubescent-pilose,rachi,radiu,remnant,ruit,shorter,slightly,spaced,sparsely,stamen,stone,strongly,tal,tapered,tem,thecae,time,tomento,triangular,ud,unbranched,unit,usually,vary,vein,wide,yellow-orang,ympodial	adhesion,anther,arrangement,calyx,climate,colour,corolla,form,glandular,growth,height,history,inflorescence,leaf,length,life,midpoint,na,number,ovary,plant,position,presence,pubescence,ray,reproduction,seed,shape,size,staman,stem,stipe,texture
212	wfo-0001027265	success	159	100	58	101	42	0.365	0.2-0.4,0.5-1,1.2-1.3,1.2-2,2,2-3,3-lobed,abaxially,acute,adaxially,anther,apex,base,blade,calyx,chartaceous,ciliate,cm,diameter,entire,extra-axillary,flattened-reniform,fruit,glabrous,globose,hair,herb,hermaphroditic,leaf-opposed,light,lobe,long-attenuate,margin,mm,nearly,oblong,orange,ovate-lanceolate,pedicel,peduncle,petiole,pubescent,purple,rarely,red,rotate-stellate,seed,simple,slightly,sometimes,sparsely,stigma,style,subcoriaceous,tube,white,x,yellow	-2.5,.2,.3,.5,0.1–2,0.5,0.5–0.6,1-1.3,1-2.5,1-3,1.2–1.4,1.5-2.5,1.5–1.8,1.5–2,1.5–4,2-,2-4,2/3,20-30,2–2.5,2–3,3-,30–50,4-5,4.5–8,4–6,4–7-branched,5-merou,58409,accrescent,adaxiall,alyx,apart,apparently,articulated,axe,ba,berry,broad,capitat,connivent,covering,croat,cylindrical,dehiscent,eaf,eed,erect,filament,flower,foliate,frui,fruiting,geminat,granule,juic,larger,lon,long,longitudinall,low,lower,mesocarp,minutely,near,nflorescence,node,numerous,obtuse,orolla,paired,partially,pitted,pore,present,prominent,puberulent,rachi,recurved,ripe,rooting,ruit,scarcely,sclerotic,somewhat,spaced,surface,tall,tamen,tem,time,tip,triangular,unit,usually,vary,weak,white-puberulent,wide,winged,ympodial	0.1-2,0.5-0.6,1.2-1.4,1.5-1.8,1.5-4,2-2.5,30-50,4-6,4.5-8,adhesion,arrangement,capitate,climate,colour,corolla,form,glandular,growth,height,history,inflorescence,leaf,length,life,midpoint,na,number,ovary,perennial,plant,position,presence,pubescence,ray,reproduction,shape,size,staman,stellate,stem,stipe,texture
213	wfo-0001027265	success	156	107	65	91	42	0.417	.3,.5,0.2-0.4,0.5,0.5-1,1.2-1.3,1.2-2,2,2-3,3-lobed,abaxially,acute,adaxially,anther,apex,base,blade,calyx,chartaceous,ciliate,cm,diameter,entire,extra-axillary,flattened-reniform,fruit,glabrous,globose,hair,herb,hermaphroditic,leaf-opposed,light,lobe,long,long-attenuate,margin,mm,near,nearly,oblong,orange,ovate-lanceolate,pedicel,peduncle,petiole,pubescent,purple,rarely,red,rotate-stellate,seed,simple,slightly,sometimes,sparsely,stigma,style,subcoriaceous,tube,weak,white,winged,x,yellow	-2.5,.2,0.1–2,0.5–0.6,1-1.3,1-2.5,1-3,1.2–1.4,1.5-2.5,1.5–1.8,1.5–2,1.5–4,2-,2-4,2/3,20-30,2–2.5,2–3,3-,30–50,4-5,4.5–8,4–6,4–7-branched,5-merou,58409,accrescent,adaxiall,alyx,apart,apparently,articulated,axe,ba,broad,capitat,connivent,covering,croat,cylindrical,dehiscent,eaf,eed,erect,filament,flower,foliate,frui,fruiting,geminat,granule,juic,larger,lon,longitudinall,low,lower,mesocarp,minutely,nflorescence,node,numerous,obtuse,orolla,paired,partially,pitted,pore,prominent,puberulent,rachi,recurved,ripe,rooting,ruit,scarcely,sclerotic,somewhat,spaced,surface,tall,tamen,tem,time,tip,triangular,unit,vary,white-puberulent,wide,ympodial	0.1-2,0.5-0.6,1.2-1.4,1.5-1.8,1.5-4,2-2.5,30-50,4-6,4.5-8,adhesion,arrangement,capitate,climate,colour,corolla,form,glandular,growth,height,history,inflorescence,leaf,length,life,midpoint,na,number,ovary,perennial,plant,position,presence,pubescence,ray,reproduction,shape,size,staman,stellate,stem,stipe,texture
214	wfo-0001027276	success	219	103	76	143	27	0.347	-22,.5,1,1.5,10,6,7,80,acute,alternate,anther,apex,base,beneath,bifid,black-green,broadly,brown,calyx,clonal,cm,cone,conspicuously,corolla,dark,dense,diameter,drying,entire,even,fruit,glabrous,globular,green,growth,indumentum,inflorescence,lanceolate,least,length,lighter,linear,lobe,lobed,loose,margin,minutely,mm,oblong-lanceolate,ovary,pedicel,petiole,plant,prickle,purple,rarely,reticulate,rotate,scabrous,short,slightly,somewhat,staman,stellate,stem,stigma,straight,style,subshrub,tapered,tapering,throughout,trichome,wavy,widened,×	0,0.5,0.5–1,1.2–1.5,1.5–2,1–1.5,1–2,2,2–5,2–6,4–5,4–9,5,5-merous,5–10,5–12mm,5–7,9–12,absent,acuman,acumen,ale,along,alyx,anthesi,apparently,armed,around,aspect,ba,becoming,berry,beyond,boht,borne,branche,c.,caly,central,covered,cyme,densely,detaching,different,dioeciou,drop,eaf,eduncle,eed,ending,erect,eventually,except,expanding,exserted,extending,falling,female,filament,filiform,fine,flower,following,functionally,fused,gra,gray-green,growt,hermaphrodite,inaperturate,including,ingle,largest,lon,long,lower,mostly,mout,near,new,newer,next,older,open,opening,orphologically,petal,plurifoliat,pollen,poricidal,porrect-stellate,prickly,producing,proportion,ra,red-tinged,remaining,resprout,retained,rickle,ruit,ruiting,scarcely-rooted,scattered,seaso,shed,shor,side,slender,small,solitary,sparsely,splitting,stalked,stamen,staminate,stellate-funnelform,stellate-pubescent,stigmatic,stolon,successively,surface,surrounding,suture,taminate,tem,tending,time,tip,toward,type,unarme,underground,unequal,unit,verall,vestigial,wide,without,woody,yellow-green,ympodial,–	-,1.2-1.5,1.5-2,2-5,4-5,4-9,5-10,5-12,5-7,abaxial,adaxial,adhesion,arrangement,colour,dioecious,form,height,history,leaf,life,peduncle,reproduction,seed,shape,size,texture,tube
215	wfo-0001027284	success	172	110	78	94	32	0.453	.3,0.1–0.5,0.7–0.9,0.7–1,1.2–1.5,1.5–2,1.5–2.5,1.5–8,1.8–2,1–3,2.5–3,2.5–3.5,2–2.2,3.5–14,3–4,4,4–12,4–6,9–18,abaxially,acuminate,adaxially,anther,apex,axillary,base,blade,brownish,calyx,cm,cordate,diameter,elliptic,entire,extra-axillary,fine,flattened-reniform,flower,fruit,glabrous,globose,green,inflorescence,lobe,margin,midvein,mm,nearly,oblique,orangish,ovate,ovoid,pale,pedicel,peduncle,petiole,pubescence,pubescent,rarely,rounded,scandent,shortly,shrub,simple,size,sometimes,soon,sparsely,stellate,stem-terminal,stigma,style,tan,truncate,tube,vine,white,x	0.1–2,0.2–,1.5–5.5,1–1.5,1–2,2–16,5-merous,5–7,5–8,accrescent,acute,alyx,anthesi,axe,berry,branch,branched,c.,capitat,ciliat,climbing,conspicuous,contiguousl,cylindrical,deflected,deltoid,densely,distally,eaf,eed,enlarged,filament,flattened,fleshy,fruiting,glabrescen,glabrou,gradually,herbaceous,immature,leafy,long,lower,m.,maturity,minutely,near,nflorescence,nternode,one,orolla,pair,pendulou,perfec,pink,pinnate,planar,plurifoliate,pointed,prominent,rachi,reduced,reticulate-rugulose,ruit,sand-punctat,sand-punctate,scar,secondary,seen,side,slightly,somewhat,spaced,spreading,surface,tamen,tem,thickened,thickly,time,tip,toward,tree,unbranched,understory,unifoliat,unit,vary,vein,venation,weakly,wide,woody,ympodial	0.2–1.5,adhesion,arrangement,capitate,climate,colour,corolla,form,glabrescent,glandular,growth,hair,height,history,leaf,length,life,midpoint,na,number,ovary,plant,position,presence,ray,reproduction,seed,shape,staman,stem,stipe,texture
216	wfo-0001027289	success	194	107	80	114	27	0.412	0-0.7,0.25-0.7,0.3-1,0.5-0.7,0.5-1.4,0.8-2.6,1.1-1.5,1.4-1.8,1.5-3.5,10.5-12.5,2.5-2.8,3.5-5,3.5-7.5,4-11,4-7,5.5-7.5,6-8,7-10,abaxially,absent,acute,adaxially,anther,apex,base,black,blade,broadly,brown,calyx,chartaceous,cm,connivent,cordate,densely,diameter,eglandular,entire,fruit,glabrous,gland-tipped,globose,green,grey,hair,inflorescence,lanceolate,leaf-opposed,length,lobe,lobed,long,margin,midpoint,mm,obtuse,ovate,pedicel,peduncle,perennial,petiole,pink,plant,present,purple,ray,rhizomatous,shallowly,short,shrub,simple,stellate,stellate-pubescent,style,tube,white,x,yellow,yellowish,yellowish-green	%,.05,0-1,0-3,0.05-0.1,0.3-0.9,0.4-0.8,1,1-2,1-5,1.2-2.5,1.3-1.5,1.5-2,1.5-2.3,10-16,12-17,16-35,2-foliate,2.4-3,30-160,4-locular,5-merou,6-9,7-13,7-8,absen,accrescent,acicular,across,adaxiall,alyx,andromonoecious,apart,articulated,ascending,axe,ba,bark,circular,cork,cross-section,cylindrical,deltate,directed,distall,distally,distributed,dm,eaf,eed,elliptica,erect,exocarp,finger,flower,fruiting,functional,furrowed,geminate,glabrou,half,heterostylous,juicy,lamina,lateral,less,longer,lower,markedly,mature,mesocarp,mid-point,minute,moist,nflorescence,oblique,orolla,part,per,placenta,pore,porrect,prickle,probably,pseudo-racemose,ruit,rusty,solitary,spaced,stage,stalk,stalked,stellae,straight,strongly,tal,tamen,tem,thick,thicker,thicknes,throughout,time,transparent,unarme,unarmed,unbranched,unit,unknow,uvenile,vary,weakly,wide,ympodial	adhesion,arrangement,climate,colour,corolla,form,glandular,growth,height,history,leaf,life,na,number,ovary,position,presence,pubescence,reproduction,seed,shape,size,staman,stem,stigma,stipe,texture
217	wfo-0001027290	success	165	102	72	93	30	0.436	.8,0-1,0-2.5,0.3-0.5,0.8-1.2,0.9-1.2,1.1-4.4,1.4-1.6,1.5-1.8,1.5-2,2.8-5.5,3.5-5,4-6,5-9.5,7-8,abaxially,absent,adaxially,anther,apex,base,blade,broadly,calyx,chartaceous,cm,cordate,densely,diameter,entire,erect,extra-axillary,flower,fruit,glabrous,gland-tipped,globose,green,hair,inflorescence,length,lobe,lobed,margin,mid-point,midpoint,mm,moist,obtuse,ovate,pedicel,peduncle,perennial,petiole,present,purple,ray,rhizomatous,shallowly,short,shrub,simple,sparsely,stellate-pubescent,style,thick,tube,unknown,x,yellow,yellowish,yellowish-green	%,0-0.7,0-3,0.05-0.25,0.1-0.9,0.2-0.4,0.7-0.9,0.7-1.2,1-1.7,1-2,1-5,1.6-1.8,11-15,180-420,2-11,2-6,20-45,3-35,3-5,3-6,5-20,5-merou,50-70,6-8,8-10,8-9,acicular,across,adaxiall,alyx,apart,armed,articulated,ascending,attenuate,axe,ba,cylindrical,d.,directed,distall,distributed,eaf,eed,eglandular,finger,fruiting,functional,grey-green,half,juic,lamina,lateral,lon,long,longer,lower,mature,mesocarp,midvein,minute,nflorescence,oblique,onl,orolla,part,per,pore,porrect,presen,prickle,pseudo-racemose,ruit,rusty,spaced,stage,stalk,stellae,straight,tal,tamen,tem,throughout,time,unbranched,unit,unknow,uvenile,vary,vein,white,wide,ympodial	adhesion,arrangement,climate,colour,corolla,form,glandular,growth,height,history,juicy,leaf,life,na,number,ovary,plant,position,presence,pubescence,reproduction,seed,shape,size,staman,stellate,stem,stigma,stipe,texture
218	wfo-0001027299	success	237	130	80	157	50	0.338	2.7,5.2,abaxially,acuminate,anther,apex,asymmetric,base,becoming,blade,calyx,cm,composed,cordate,densely,diameter,distally,elongating,entire,erect,expanded,flower,fruit,glabrous,globose,hirsute,inflorescence,initially,intense,interwoven,lanceolate,lateral,leaf,length,lenticular,linear,lobe,long,margin,mm,obtuse,ovate,overtopped,pedicel,peduncle,pentagonal,petiole,plump,pubescence,pubescent,purplish,ray,reniform,repand,rotate,short-stalked,shrub,simple,slightly,somewhat,soon,stalked,stellae,stellate,stellate-pubescent,stellate-tomentose,stem,stigma,style,sun,tan,terminal,thick-textured,truncate,tube,undulate,violet,weakly,yellow,young	.5,0.2–3,0.3–0.8,0.5–1.5,0.8–1,0.8–1.2,0–10,1.2–1.5,1.3–1.7,1.5,1.5–3,1.5–4,11–17,15,15–19,1–2,1–3.5,1–4,2.5–4,2.5–5,25-30,2–13,2–2.7,3–3.5,4.5–13,4–10,5,5-merou,5–10,5–12,6,6–10,6–8,6–9,7–11,7–9,8–13,8–20,9–25,abaxial,accrescent,acicular,adaxially,along,alyx,apart,apiculate,apparently,appearing,articulated,ascending,axe,barely,branch,branched,bristle,bristle-like,broadly,c.,campanulate,cauline,common,conduplicate,contiguous,coriaceous,deciduou,delicate,deltate,deltoid,dense,densest,developed,directed,distall,eaf,eed,equalling,erry,exceeding,falcate,filament,filiform,fruiting,geminat,glabrou,hair,intergrading,internode,intervening,like,long-stalked,lower,maturit,midpoint,midvein,midzone,minutely,mixed,narrowly,nearly,nflorescence,often,one,orange,orolla,ovoid,perfect,pitted,plurifoliate,pore,prickle,prickly,principal,racemose,rachise,rarely,reaching,ripe,secondary,short,shorter,side,similar,slender,smaller,sometimes,some­what,spaced,sparse,spreading,spreadingly,stalk,stipitate-stellate,straight,styl,surface,tall,tamen,tapering,tardily,tem,tippe,ud,ultimate,unarme,unarmed,usually,vary,varying,vein,well,wooll,woolly,ympodia,×,–7,–9	0-10,0.2-3,0.3-0.8,0.5-1.5,1-2,1.2-1.5,1.3-1.7,1.5-3,1.5-4,11-17,2-2.7,2.5-4,2.5-5,3-3.5,4.5-13,5-10,5-12,6-8,7-11,7-9,8-13,8-20,9,9-25,adhesion,arrangement,colour,corolla,form,growth,height,history,life,maturity,na,number,ovary,perennial,plant,position,presence,present,reproduction,seed,shape,size,staman,stipe,texture,x
219	wfo-0001027302	success	188	134	103	85	31	0.548	.5,0.4-5,0.5-1,0.6-1,0.8-1,1-1.3,1-1.5,1-3,1.2-2.5,1.5-2,10,2,2-3,2-6,2.2,2.7-7.5,3.5-5,3/4,7,7/8,abaxial,abaxially,acuminate,acute,age,along,anther,apex,appearing,base,becoming,blade,branching,bright,calyx,capitate,clavate,cm,conical,cordate,corolla,crispate,dendritic,densely,diameter,elliptic,especially,flattened,free,glabrous,globose,growth,later,lateral,leaf,length,lenticular,lobe,lobed,long,main,margin,mm,monochasial,narrowly,occasionally,otherwise,ovary,ovate,overtopping,pericarp,petiole,plant,plurifoliate,pore,poridical,puberulent,pubescent,red,reddish-brown,shoot,shrub,simple,slit-like,small,somewhat,stem,stigma,style,surface,terminal,thin,tiny,tip,tree,trichome,truncate,tube,undulate,vein,violet,way,x	0.5,1,1-2,1.2-1.6,10-20,5-7,6-12,adaxial,adaxially,anthesi,apical,ba,bark,basal,berry,broader,brownish-yellow,cultivation,decurrent,deflexed,deltoid,denser,dichasia,discussion,eaf,edicel,eed,entire,ew,exserted,filament,fine,flat-topped,flower,fruiting,growing,inserted,juvenile,larger,lax,less,like,lon,long-triangular,lower,m.,minutely,nflorescence,nodding,older,pair,pale,papillo,pedicle,per,pitted,planar,portion,prominent,pyramidal,reflexed,ruit,scar,scattered,scrambling,secondary,see,shade,shin,sleeve,sparsely,stamen,strongly,tall,tapering,time,tub,ud,unit,usually,wide,winged,woody,ympodial,young	adhesion,arrangement,climate,colour,dichasial,form,fruit,glandular,hair,height,history,inflorescence,life,midpoint,na,number,pedicel,peduncle,perennial,position,presence,pubescence,ray,reproduction,seed,shape,size,staman,stellate,stipe,texture
220	wfo-0001027310	success	215	116	87	128	29	0.405	-2.2,-20,/3,0.05-0.15,0.7-2,0.9-0.17,1-1.2,1-1.7,1-6,1.1-1.5,1/10-1/6,11-16,2-3.1,2-4,2.2-2.5,2.8-3,20-60,4-9,4.5-5.5,5-7,9-13,abaxially,acute,andromonoecious,anther,apex,base,berry,blade,calyx,chartaceous,cm,connivent,cuneate,densely,diameter,entire,equal,evenly,flattened-reniform,fruit,glaucous,green,hair,lanceolate,lateral,leaf,length,lobe,lobed,long,margin,maturity,mauve,midpoint,mm,moderately,orange-brown,pedicel,peduncle,petiole,plant,poricidal,purple,ray,rounded,shrub,simple,sometimes,sparse,spherical,stellate,stellate-pubescent,stem,stout,style,tapering,terminal,tip,toward,tree,truncate,tube,way,wide,yellow,young	.8,0,0-20,0-5,0.05,0.1,0.1-0.2,0.15-0.3,0.6-1,1.5-2.2,1.5-5,1/3-1/2,1/3-3/4,2-10,2-5,2/3,22-30,3-15,4-10,4.5-7,5-10,5-20,5-merous,6-8,7-10,8-10,abaxial,acut,adaxial,alyx,apar,apart,apically,apparently,articulated,bark,branched,branching,broadly,curved,dark,deltate,discolorous,distal,drying,eaf,eed,elongating,erect,faint,filament,flattened,flower,foliaceous,free,fruiting,fused,gently,glabrescent,glabrou,glabrous,gray,green-brown,hermaphrodite,heterostylous,inflated,infructescence,less,long-styled,longer,lower,lowermost,mature,minutely,nflorescence,older,one,open,orolla,oung,pair,pale,pendulous,per,pericarp,pitted,plurifoliat,porrect,porrect-lepidote,portion,prickle,prickly,primary,pubescent,red,reddi,reflexed,ruit,scar,secondary,sessile,shallowly,short-styled,shorter,smooth,spaced,sparsely,spreading,stalk,stalked,staminat,straight,strongly,surface,tamen,terete,tertiary,time,trichome,unarme,unarmed,unit,vary,vein,venation,visible,woody,ympodial	adhesion,arrangement,climate,colour,corolla,form,glandular,growth,height,history,inflorescence,life,na,number,ovary,perennial,plurifoliate,position,presence,present,pubescence,reproduction,seed,shape,size,staman,stigma,stipe,texture
221	wfo-0001027313	success	173	116	69	104	47	0.399	.7,0.15,1.5,4,abaxially,acute,adaxially,anther,apex,apparently,atenuate,attenuate,base,blade,cm,cordate,densely,diameter,dull,entire,flower,fruit,globose,green,hair,high,irregularly,lanceolate,lateral,leaf,lobe,long,loosely,margin,maturing,mm,obtuse,ovate,pedicel,peduncle,persistently,petiole,purplish,ray,shrub,simple,sinuate,slender,small,sparse,stellate,stellate-pubescent,stellate-tomentose,stem,stigma,style,thick-chartaceous,tomentose,tree,tube,undulate,usually,violet,weak,whitish,whitish-tomentose,yellow,yellowish,×	.5,0.1–0.3,0.5–0.6,0.8–1,1.2–1.3,1.2–1.4,1.5–2,1–1.3,1–2,1–4,2–3-branched,2–4.5,2–8.5,3–3.5,3–4,3–5.5,3–9,4.5–5,5,5-merou,5.5–16,5.5–7,50,5–6,6–11,6–8,adaxiall,along,alyx,apar,apical,articulated,axe,branch,branched,broadbased,capitat,dbh,difoliate,directed,distall,eaf,eed,filament,filiform,finely,geminat,glabrous,half,homostylous,immature,internode,interpetalar,like,little,lon,lower,midpoint,midvein,minute,minutely,much,narrowly,nearly,nflorescence,orolla,ovoid,perfect,pitted,pore,porrect,prickle,principal,rarely,ruit,scar,sessile-stellate,short-stalked,short-stipitate,shorter,side,similar,sinus,sometimes,splitting,stalk,stellae,stellate-tomento,surface,tamen,tem,time,tissue,triangular,ud,unarme,unarmed,vary,vein,vigorous,wide,ympodia,–12,–3	0.1-0.3,0.5-0.6,1-1.3,1-2,1-4,1.2-1.3,1.2-1.4,12,2,2-8.5,3-4,3-5.5,3-9,4.5-5,5.5-16,5.5-7,6-11,6-8,adhesion,arrangement,calyx,capitate,colour,corolla,form,growth,height,history,inflorescence,length,life,na,number,ovary,perennial,plant,position,presence,present,pubescence,reproduction,seed,shape,size,staman,stipe,texture
222	wfo-0001027315	success	217	103	75	142	28	0.346	.5,.9,0.15-0.2,0.2-0.5,0.3-0.6,0.3-1,0.4-0.7,0.5,0.6-0.8,1.3-3,10-20,2,2-2.5,2-5,2-7.5,3,acute,anther,apex,base,berry,blue-green,brown,calyx,capitate,cm,conical,corolla,densely,diameter,dioecious,elliptic,entire,flattened,glabrous,globose,growth,inflorescence,internodal,length,lobe,margin,midpoint,minute,mm,ovary,paler,pedicel,peduncle,pentagonal,petiole,plant,poricidal,pubescent,purple,ray,reddish,reniform,ripe,shiny,shrub,simple,somewhat,stellate,stem,stigma,style,thin,tip,trichome,tube,vestigial,white,x,young	.15,.5x,0.2,0.25-0.4,0.3-0.5,0.6-0.6,0.6-0.7,0365,1-1.3,1-1.5,1-2,1.5-1.7,1.5-2,1.5-3,2/3,3-3.5,3-5,3-7,5-7,8,<,?,abaxially,adaxially,age,almost,along,anthesi,arching,armed,articulated,bark,broad-based,consisting,correlated,dark,deltate,dense,difoliate,discolorous,drying,eaf,echinoid,eed,ekman,ellipsoid,especially,exerted,female,fide,filament,filiform,flower,free,fruiting,fused,geminat,glabrescen,globular,greyish-white,half,hangin,highly,immature,impressed,lamina,lengthening,lepidote,like,lobed,long,lower,male,marginal,markedly,midrib,minutely,mixture,new,nflorescence,oblique,obscuring,occasionally,often,older,overlappin,packed,pair,pale,papillo,per,pericarp,pistillate,pitted,plan,planar,pore,porrect,portion,present,prickle,pricklines,primary,prominent,rest,rhachi,rounded,ruit,scar,scattered,sessile,shoot,short,short-stalked,shorter,similar,slit,smaller,solitary,sparse,sparsely,stalked,staminate,stellate-lepidote,straight,strongly,surface,throughout,tightly,ud,unarmed,unisexual,unit,vein,venation,visible,way,without,woody,yellowish,ympodial,½	1,adhesion,arrangement,blade,climate,colour,form,fruit,glandular,hair,height,history,leaf,life,na,number,perennial,position,presence,pubescence,reproduction,seed,shape,size,staman,stipe,texture,ye
223	wfo-0001027317	success	144	80	56	88	24	0.389	0.1-0.2,0.4-1.5,0.5-1,0.8-3.5,1,1-1.5,1-2,1.4-1.6,2-9,3-3.5,4.5-5,?,adaxially,along,anther,base,bilobed,calyx,cm,corolla,densely,dia,elliptic,erect,fruit,glabrous,globose,golden,green,leaf,like,lobed,long,minute,mm,nearly,offset,opposite,ovary,pedicel,petiole,poricidal,pubescent,shrub,simple,size,slightly,stem,stigma,style,tip,trichome,uniseriate,vein,white,x	.25,.5,0.3-1,0.5-3,1-5,1.5-2,2-3-flowered,7-9,abaxial,acuminate,acute,anthesi,apex,apical,apically,arch,ba,bark,beneath,berry,broadly,closely,conical,cucullate,deciduous,deflexed,deltoid,differing,difoliate,drying,eaf,edicel,eed,ellipsoid,elongated,expanded,filament,filiform,free,fruiting,geminat,greyish-whit,immature,inflorescenc,joined,known,lateral,lobe,lon,long-exserted,lower,main,major,margin,mature,minor,minutely,nflorescence,older,overlappin,pair,pale,papillo,papillose,pointed,pore,portion,projection,prominent,reflexed,rest,ruit,scar,series,shaped,soon,spaced,sparsely,strongly,surface,tall,tear-drop,tub,tube,ud,woody,ympodia,young	0.25-1,arrangement,colour,diameter,diphyllous,form,growth,height,history,inflorescence,length,life,na,peduncle,perennial,plant,position,presence,pubescence,reproduction,seed,shape,stellate,texture
224	wfo-0001027323	success	175	74	48	127	26	0.274	1-1.5,1.2-1.5,14-21,2-3,2-6,2.5-3,20-45,3-5,5-7,anther,area,broadened,calyx,cm,corolla,dia,elliptic,fleshy,fruit,glabrous,globose,leaf,lobe,lobed,minutely,mm,opposite,ovary,ovoid-reniform,papillose,pedicel,persistent,petiole,pinkish-grey,plant,poricidal,red-papillose,reddish-grey,size,stem,stigma,style,tan,tip,treelet,tube,white,x	.75,/3,0.5-1,1-2,10-15,5-20-flowered,6-11,7-9,acute,adaxial,along,anthesi,apex,apparent,appearing,arising,asymmetric,attenuate,ba,bark,base,berry,bud,campanulate,character,closed,closely,cork,decurrent,deflexed,densely,differing,difoliate,dried,dry,eaf,edicel,eed,elongate,entire,erect,erose,exserted,filament,five-pointed,flopping,flower,free,fruiting,furcate,geminat,glabrate,grey,growing,held,higher,hood,hooded,immature,interpetalar,lateral,like,live,lon,long,long-triangular-deltoid,lower,main,major,margin,matte,mature,measured,middle,minor,nflorescence,occasionally,older,one,onto,overlapping,ovoid,pair,papillae,papillo,partially,pitted,planar,pore,portion,prominent,proximal,rather,rest,ridge,ruit,scar,secondary,seen,shaped,sinus,slightly,small,smoot,soon,spaced,specimen,straight,surface,tall,tear-drop,thickened,thin,tiny,trunk,two,ud,unit,upper,vein,visible,way,widest,winged,woody,ympodial,young	0.75,3,5,7,adhesion,arrangement,colour,diameter,form,growth,height,history,inflorescence,length,life,na,peduncle,position,presence,pubescence,reproduction,seed,shape,staman,stellate,texture
225	wfo-0001027340	success	189	91	67	122	24	0.354	0.5-0.9,1-2,10-16,16-22,2-3,2-4,3.5-5,3.5-9,4-7.5,5-11,5-6,6-8.5,7-18,7-8,8-9.5,abaxially,adaxially,anther,axillary,brownish,bud,chartaceous,cm,condition,corolla,diameter,drying,elliptic,fresh,fruit,glabrous,globose,green,greenish,herb,lanceolate,lilac-purple,lobe,long,membranous,minutely,mm,odd-pinnate,ovate,ovoid,pedicel,peduncle,petiole,plant,puberulent,pubescent,purple,ripe,rotate,seed,size,sparsely,stem,stigma,style,subtending,terminal,tinged,tube,whitish,x,yellow	1-10,1-3,1.5-2.7,2-3.5,2.5-4.5,2.7-4.5,3-4,4-6,5-merou,8-14,abruptly,absent,acumen,acuminate,ag,along,alyx,apart,apex,apparently,articulated,articulation,auriculate,axe,base,berry,blade,capitat,cell,ciliate,connivent,cordate,covering,dark,decreasing,developing,digestion,distal,distinct,dorsally,eaf,edge,eed,enzyme,especially,exceeding,filament,flat,flower,folded,forked,geminat,generally,glabrou,green-white,hair,hair-like,hal,half,high,homostylous,honeycomb-shaped,indistinct,interjected,lateral,leaflet,lengthening,like,living,lower,make,margin,midrib,minute,mucilaginous,narrow,narrowed,nflorescence,orolla,pair,papillose,perfect,petiolulate,plurifoliate,pointed,pore,poricidal,purpl,removed,rounded,ruit,semi-erec,semi-rosette,sessile,seudostipule,short,shortly,slightly,slit,spaced,specimen,splotched,stamen,ste,straight,tall,tamen,tem,testal,thick,throughout,tip,tri-,truncate,unit,usually,vary,wall,wet,wing,ympodial,young	adhesion,arrangement,calyx,capitate,colour,form,growth,height,history,inflorescence,leaf,length,life,na,ovary,perennial,position,presence,pubescence,reproduction,shape,staman,stellate,texture
226	wfo-0001027354	success	166	106	76	90	30	0.458	0.5-2,0.7-1.3,1-1.2,1-7,1.5-1.8,1.5-2,1.7-5,2.5-3.5,3-4,3.4-4,3/4,4-10,5-7,6.5-13,abaxially,acute,anther,apex,appearing,base,bi-lobed,blade,branch,calyx,cm,corolla,dendritic,densely,diameter,elliptic,flattened,fork,free,fruit,glabrate,glabrous,globose,golden,growth,later,lateral,leaf,length,lenticular,lobe,lobed,mm,narrowly,occasionally,ovary,pedicel,pericarp,petiole,plurifoliate,poricidal,pubescent,purplish-black,reddish-brown,shrub,small,sparsely,stem,stigma,style,terminal,thin,tiny,tip,tree,tree-like,trichome,tube,violet,way,white,x	.5,0,0.5,1,1-1.5,10,10-20,8-12,abaxial,absent,adaxial,age,along,anthesi,apical,ba,bark,basal,becoming,belo,berry,branching,conical,covered,dark,deltoid,denser,dichasia,drying,eaf,edicel,eed,entire,erect,ew,exserted,filament,flower,fruiting,inserted,less,like,long,loose,loosely,lower,m.,minutely,monochasial,mostly,near,nflorescence,nodding,older,pair,papillo,per,pitted,planar,pore,portion,pubescen,pyramidal,raised,ruit,scar,secondary,side,simple,sleeve,slightly,slit-like,somewhat,stamen,strongly,surface,tall,tapering,thecalyx,time,tub,type,ud,unit,vein,wide,winged,woody,ympodial,young	0.5-1,adhesion,arrangement,climate,colour,form,glandular,hair,height,history,inflorescence,life,margin,midpoint,na,number,peduncle,plant,position,presence,pubescence,ray,reproduction,seed,shape,size,staman,stellate,stipe,texture
227	wfo-0001027359	success	224	114	84	140	30	0.375	-0.25,-2,/3,0-9,0.1-0.2,0.3-1.2,0.5-2,0.6-1,1-1.2,1-2,1.2-1.5,1.5-2.5,1.8-3.2,2-4,2.5-3.5,2.5-5.5,4-,5-6.5,6-8,abaxially,acute,anther,apex,base,berry,blade,bright,calyx,chartaceous,cm,cuneate,densely,diameter,dull,entire,erect,flattened-reniform,fruit,glabrescent,glabrous,lateral,leaf,length,lobe,lobed,long,margin,maturity,membranous,midpoint,mm,moderately,obtuse,occasional,orange-brown,ovate,pedicel,peduncle,petiole,poricidal,purple,ray,red,scandent,shallowly,shrub,sometimes,sparsely,spherical,spreading,stellate,stellate-pubescent,stem,style,tapering,terminal,tip,trichome,tube,undulate,way,white,wide,yellow	-20,-3,-4,-7,-9,.1,.2,.5,/4,0,0-2,0-3,0-5,0.1,0.1-1.5,0.3-0.5,0.5,0.5-1,0.6-0.8,1-3,1-4,1-5,1.2-2,1.5-2,1/5-1/4,2-10,2-3,3-10,4-5,5-,5-merous,7-8,acut,alyx,apar,apart,apically,apparently,articulated,ba,bark,branched,brow,cell,concolorous,coroll,cream,curved,dark,deltate,difoliate,distinctive,drying,eaf,eed,elongate,elongating,equal,eye,filament,filiform,flattened,flower,free,fruiting,geminat,gray,green,herbaceous,infructescence,less,like,longer,lower,marking,mature,minutely,naked,narrow-deltate,narrow-ovate,near,nflorescence,often,older,one,open,orolla,oung,outline,ovoid,pair,pale,per,perfec,pericarp,pit,porrect,portion,prickle,prickly,primary,rachi,raised,rarely,reflexed,reticulate,ruit,scar,sessile,shorter,simple,slender,slightly,small,smooth,spaced,stalk,stalked,stump,surface,tamen,terete,tertiary,time,tinge,ud,unarme,unarmed,unit,usually,variously,vary,vein,venation,visible,weakly,woody,yellow-brown,ympodial,young	adhesion,arrangement,climate,colour,corolla,form,glandular,growth,hair,height,history,inflorescence,life,na,number,ovary,perennial,plant,position,presence,pubescence,reproduction,seed,shape,size,staman,stigma,stipe,texture,ye
228	wfo-0001027365	success	233	114	72	161	42	0.309	.5,2,2.8,3,acuminate,acute,andromonoecious,anther,apex,apparently,base,blade,blue,brown,calyx,capitate,chartaceous,cm,cuneate,densely,diameter,elliptic,entire,equal,extraaxillary,flattened,fruit,glabrous,glandular,globose,green,hair,inflorescence,juicy,lanceolate,leaf,length,light,lobe,margin,midpoint,mm,moderately,nearly,oblique,orange,outline,pedicel,peduncle,petiole,plant,pubescent,ray,reniform,repand,rotate-stellate,shallowly,simple,slightly,sparsely,stellate,stem,stigma,strongly,style,subcoriaceous,tapered,tree,tube,violet,yellow,×	.1,.1–0.3,.2,0,0.1–0.3,0.2–0.5,0–0.03,0–0.1,1,1.1–1.4,1.5–1.8,10–15,11–14,14–15,15–30,1–1.9,1–4,2.2–2.3,2.3–4.2,2.5–4.5,2.6–3,2–,2–5,3–10,3–3.5,3–3.9,4.5–5,4–4.5,4–5,5-merous,5–5.5,5–8,6–7.5,7–1,7–15,8–15,8–9,abaxial,abaxially,absent,adaxial,adaxially,ag,along,alyx,andromonoeciou,anthesi,apart,articulated,axe,ba,bark,becoming,berry,bilobe,branched,broad-based,broadly,central,column,congested,connivent,curved,cylindrical,dark,db,difoliate,directed,discolorous,distally,dried,eaf,eed,eglandular,either,emergent,filament,flower,flowering,free,fresh,frui,fruiting,functionally,geminat,golden-tan,half,hermaphroditic,heterstylous,included,inflated,interpetalar,knobby,lighter,like,lobed,long,longitudinal,lower,major,maturity,membranaceous,midvein,moderate,mostly,mpodial,multangulate,multangulate-stellate,multiseriate,multiseriate-stalked,nflorescence,obtuse,often,one,opening,orolla,part,pericarp,pore,porrect-stellate,portion,prickle,pronounced,rachi,reduced-stellate,reflexed,rugose,ruit,runk,sessile,sharp,shiny,short-stalked,side,slit,somewhat,spaced,stalk,stalked,staminate,stellate-pubescent,stout,straight,subtending,surface,tamen,tan,thi,time,tissue,truncate,unarmed,unbranched,unit,vary,vein,wide,within,young,–2,–20	0.1-0.3,0.2-0.5,1-1.9,1.1-1.4,10-15,14-15,15-30,2-5,2.5-4.5,2.6-3,20,3-10,4-5,4.5-5,7-10+,7-15,adhesion,arrangement,bilobed,climate,colour,corolla,form,growth,height,history,life,na,number,ovary,perennial,position,presence,present,pubescence,reproduction,seed,shape,size,staman,stipe,texture
229	wfo-0001027366	success	136	95	59	77	36	0.434	/4,0.7-1,1-1.5,1-2,1-3,11-21,2-2.5,4-4.5,4-5,5-7,6-19,abaxially,acute,adaxially,anther,apex,base,bright,broadly,brown,calyx,capitate,cm,corolla,dark,dia,drying,elliptic,glabrous,globose,golden,green,greenish-white,internodal,leaf,lobe,lobed,long,margin,mm,opposite,orbicular,ovary,ovoid-reniform,pedicel,petiole,poridical,rounded,shining,shrub,sometimes,somewhat,stem,stigma,style,tip,tube,way,wide	.5,/2,0.25-0.5,0.5-1,1.5-2,3-10-flowered,3-9,603,anthesi,ape,axe,ba,bark,berry,closely,conical,conspicuously,deflexed,deltate,eaf,edicel,eed,erect,et,except,exserted,fide,filament,free,fruiting,lamina,lateral,less,lon,long-triangular,lower,main,middle,minutely,nflorescence,older,overlappin,ovoid,packed,pair,pale,papillo,papillose,parallel,pitted,planar,pointed,pore,portion,ramo,reddish,ruit,scar,secondary,shaped,simple,straight,surface,tall,tear-drop,trichome,tub,ud,unifoliat,unit,vein,venation,widest,woody,yellowish-gre,ympodial,young	0.5,adhesion,arrangement,blade,climate,colour,diameter,form,fruit,glandular,growth,hair,height,history,inflorescence,length,life,midpoint,na,number,peduncle,perennial,plant,position,presence,pubescence,ray,reproduction,seed,shape,size,staman,stellate,stipe,texture,unifoliate
230	wfo-0001027368	success	145	108	73	72	35	0.503	-20,-5,.5,0.3-2.5,0.5-3.5,0.5-5,0.8-2,1-2,1-6,1.5-2,1.5-2.5,2,2-2.5,2-3,2-9,3-12.5,4-6,5-15,5-6,abaxially,acuminate,acute,adaxially,apex,base,blade,calyx,chartaceous,cm,connivent,cuneate,decurrent,densely,diameter,ellipsiodal,elliptic,elliptic-ovate,entire,glabrous,globose,hair,lanceolate,lenticular,lobe,margin,mm,moderately,narrowly,oblong,occasionally,ovoid-fusiform,pedicel,peduncle,petiole,puberulent,pubescent,purple,ray,shrub,simple,small,sparsely,stellate,stigma,style,subcoriaceous,subhastate,truncate,tube,unknown,white,x,yellow	-10,-15,-2,1-15-flower,2-4,3,4-many-foliat,5-10,8-13,abruptly,absen,adaxiall,aggregate,also,apart,articulated,axe,ba,branched,cell,color,contiguous,cylindrical,darker,deltate,dendritically,denser,directed,distally,eaf,eed,except,forked,gland,lighter,long,long-stalked,lower,midvein,narrowed,nearly,nflorescence,nther,obtuse,often,orolla,otherwise,pore,pubescen,rachi,radiu,ruit,sometimes,spaced,stalked,star,stone,subcapitat,tal,tem,terminal,three,time,tip,triangular,unbranched,unit,usually,vary,vein,wide,ympodial	adhesion,anther,arrangement,climate,colour,corolla,form,fruit,glandular,growth,height,history,inflorescence,leaf,length,life,midpoint,na,number,ovary,perennial,plant,position,presence,present,pubescence,reproduction,seed,shape,size,staman,stem,stipe,subcapitate,texture
231	wfo-0001027369	success	191	90	60	131	30	0.314	.5,.7,0-1,0.6-0.8,1-2.5,1.2-2.5,1.2-3,1.5-2,2-5,3-4,abaxially,almost,anther,apex,base,berry,blade,calyx,cm,cordate,densely,diameter,fruit,glabrous,glaucous,hair,lateral,leaf,length,lobe,lobed,long,margin,mauve,membranous,midpoint,mm,orbicular,pedicel,peduncle,petiole,poricidal,ray,reniform,rounded,shrub,simple,sparsely,spherical,spreading,stellate,stellate-pubescent,stem,style,surface,tapering,terminal,tip,tube,wide	-1,-10,-11,-2,.1,.4,/4,0,0-15,0-3,0-5,0-6,0.05-0.15,0.1,0.1-0.2,0.1-0.3,0.2-0.5,0.25-0.4,0.3-1.5,0.5,0.5-0.8,0.5-1.5,1-,1-2,1-3,1-4,1/3,2-3,2-4,3,3-10,4-5,4-8,5,5-merous,7-15,acut,alyx,ame,apar,apart,apically,apparently,articulated,bark,branched,broad-deltate,c.,color,concolorous,curved,deltate,difoliate,distance,drying,eaf,eed,elongating,equal,erect,extending,eye,filament,filiform,flower,free,fruiting,geminat,glabrou,gra,green,herbaceous,infructescence,know,known,lanceolate,less,lon,lower,mature,midvein,moderately,multangulate,naked,narrowly,nflorescence,older,one,open,orolla,oung,pale,pendulous,per,perfec,pericarp,perpendicular,porrect,portion,prickl,prickle,prickly,reflexed,ruit,scandent,scar,sessile,side,slender,slightly,smooth,spaced,stalk,stalked,straight,strongly,tamen,terete,time,trichome,unarmed,unequal,unit,vary,venation,visible,way,wider,winged,yellow,ympodial	adhesion,arrangement,climate,colour,corolla,form,glandular,growth,height,history,inflorescence,life,na,number,ovary,perennial,plant,position,presence,present,pubescence,reproduction,seed,shape,size,staman,stigma,stipe,texture,unknown
232	wfo-0001027378	success	149	106	76	73	30	0.51	.2,0.5–1,1.2–1.5,1.2–1.8,1.5–1.8,1.5–8,15–35,1–1.5,1–3,2.5–7,2–11,2–2.2,2–2.5,3–4.5,3–5,4–6,5–13,5–7,abaxially,acuminate,adaxially,anther,apex,base,blade,blue,broadly,calyx,chartaceous,cm,cordate,deeply,diameter,extra-axillary,fleshy,fruit,glabrous,hair,herbaceous,leaf,light,lobe,long,margin,minutely,mm,moderately,ovate,ovoid,pedicel,peduncle,pentagonal,petiole,primary,pubescent,revolute,rotate-stellate,simple,slender,small,somewhat,spaced,sparsely,stem,stigma,style,terrestrial,tooth,trichome,tube,unknown,vein,vine,white,widely,x	0.7–1,0.8–2.5,2.3–5,3–6,4–9,5-8,5-merous,5–10,6–10,6–7,acute,adaxial,alyx,apar,apicall,axe,berry,c.,capitat,ciliate,clavate,climbin,color,cylindrical,deltoid,densely,eaf,eed,filament,flattened,flower,fruiting,glabrou,hair-tipped,half,lanceolate,like,lon,longer,lower,m.,markedly,membranous,narrowly,nflorescence,nternode,obscure,often,orolla,palmate,papillose,perfec,plurifoliat,pointed,rachi,rounded,ruit,sand-punctat,sand-punctate,scattered,short,side,slightly,tamen,tem,tip,unbranched,unit,unknow,vary,venation,wide,ympodial	0.2,adhesion,arrangement,capitate,climate,climbing,colour,corolla,form,glandular,growth,history,inflorescence,length,life,midpoint,na,number,ovary,position,presence,pubescence,ray,seed,shape,size,staman,stellate,stipe,texture
233	wfo-0001027378	success	141	101	69	72	32	0.489	.2,1-1.5,1-3,1.2-1.5,1.5-1.8,1.5-8,15-35,2-11,2-2.2,2-4,2.5-7,3-4.5,3-5,4-6,5-13,abaxially,acuminate,adaxially,anther,apex,basally,base,blade,blue,broadly,calyx,chartaceous,climbing,cm,cordate,deeply,diameter,extra-axillary,fleshy,flower,fruit,glabrous,hair,herb,leaf,light,lobe,margin,minutely,mm,oblong,ovate,pedicel,peduncle,petiole,pubescent,revolute,rotate-pentagonal,simple,small,somewhat,spaced,sparsely,stigma,style,terrestrial,tooth,trailing,tube,unknown,white,widely,x,yellow	0.7-1,0.8-2.5,2.3-5,3-6,4-9,5-8,5-merou,6-10,6-7,acute,ag,alyx,apart,apicall,apparently,articulated,axe,ba,capitat,ciliate,clavate,connivent,cylindrical,deltoid,densely,directed,distally,eaf,eed,equal,filament,fruiting,geminat,hair-tipped,lanceolate,large,long,longer,longitudinal,lower,moderately,multicellular,narrowly,nflorescence,node,obscure,often,opening,orolla,perfect,plurifoliate,pore,pubescen,rachi,rooting,rounded,scattered,short,slender,slightly,slit,tamen,tem,tip,unbranched,unit,unknow,vary,vein,weakly,wide,ympodial	adhesion,arrangement,capitate,climate,colour,corolla,form,glandular,growth,height,history,inflorescence,length,life,midpoint,na,number,ovary,plant,position,presence,pubescence,ray,reproduction,seed,shape,size,staman,stellate,stem,stipe,texture
234	wfo-0001027380	success	134	96	63	71	33	0.47	.5,0,1-1.5,11-17,2-3,2-3.5,2.5-3,3-4,30-35,4-6.5,5,5-8,?,abaxially,acuminate,adaxially,anther,apex,base,blade,broadly,calyx,chartaceous,cm,conical,deeply,diameter,entire,extra-axillary,flattened,flower,fruit,glabrous,globose,hair,leaf,len,lobe,long,margin,minute,mm,oblique,orange-red,ovate-lanceolate,pedicel,peduncle,petiole,pubescent,red,rounded,shrub,simple,small,sparsely,stellate,stem,stigma,style,tree,visible,white,x	1136.,5-merous,9-10,accrescen,adaxiall,almost,alyx,apparently,armed,articulated,axe,ba,bark,berry,brown,capitat,developed,distally,drying,eaf,eed,erect,filament,forked,fruiting,geminate,greenish-brown,hartley,homostylous,hooked,lon,loose,lower,minutely,mpodial,nflorescence,occasionally,open,orolla,oung,pair,paler,perfec,perfect,prickle,primary,rachi,reticulate,rip,ruit,scarcely,scattered,scramblin,shallow,slender,slightly,smooth,somewhat,sparse,structure,tall,tamen,testa,thickening,triangular,truncate,unarmed,unbranched,unknown,vary,vein	adhesion,arrangement,capitate,climate,colour,corolla,form,glandular,growth,height,history,inflorescence,length,life,midpoint,na,number,ovary,plant,position,presence,pubescence,ray,reproduction,ripe,seed,shape,size,staman,stipe,texture,tube,ye
235	wfo-0001027381	success	262	74	55	207	19	0.21	.8,0-1,0.5-0.6,0.5-1,0.6-0.7,1-2.5,1.5-4,2-6,3-7.5,3.5-4,4-5,5-11,anther,calyx,capitate,chartaceous,clavate,cm,diameter,distributed,elliptic,erect,evenly,free,fruit,glabrous,globose,leaf,length,lobed,long,maturity,mauve,mm,oblong,orange,ovate,pedicel,peduncle,petiole,plant,present,shiny,shrub,size,smooth,stellate,stellate-pubescent,stem,stigma,style,tapering,thin,white,x	.3,.4,/5,0-1.5,0.1,0.2,0.3-0.5,0.4-0.6,0.5,0.5-0.7,0°,1-1.5,1-2,1/3-1/2,1/4-1/3,2,2-2.5,2-3,2-4,3-4,3-5,4-8,5-8,5-merou,7-8,8-10,abaxially,absent,accrescent,acute,adaxially,age,almost,along,alyx,angle,apex,apically,apparently,area,articulated,attachment,bark,base,berry,blackish,blade,branch,branched,brown,clearly,concolorous,cordate,covering,cream,curved,dark,delineated,deltoid,densely,density,difoliate,dilated,distance,divided,drying,dull,eaf,eed,ellipsoi,elongated,elongating,epidermi,equal,even,exserted,extending,eye,faint,fertile,filament,filiform,flat,flattened,flower,fruiting,geminat,gland,green,grey,greyi,higher,inconspicuous,indumentum,infructescence,irregula,known,lamina,lanceolate,lateral,lengthening,less,light,like,lobe,long-deltoid,longer,longitudinal,lower,main,margin,marking,mature,midpoint,midvein,minute,mostly,naked,never,nflorescence,obconical,oblique,obscuring,obtuse,often,orange-green,orolla,pair,pale,papillose,part,pendulous,per,perfect,pericarp,point,pore,poricidal,porrect,portion,prickle,primary,prominently,protruding,puffy,rachi,raised,rarely,ray,reduced,region,rest,right,rounded,ruit,scar,sessile,shallow,side,simple,sinus,slender,slightly,slit,small,smoot,sometimes,sparse,sparsely,spreading,stalk,straight,striate,stump,surface,surrounded,tamen,terminal,tertiary,time,tip,tissue,translucent,trichome,truncate,tube,ud,unarme,unarmed,unit,usually,variable,variously,vary,vein,venation,visibl,visible,wide,widening,without,woody,yellow,yellow-green,yellowish,ympodial,young	adhesion,arrangement,colour,corolla,form,growth,height,history,inflorescence,life,ovary,perennial,presence,pubescence,reproduction,shape,staman,texture,unknown
236	wfo-0001027384	success	155	98	63	92	35	0.406	0.4-1.1,0.5-1,0.9-1,1-1.3,1-3,1-4,1.5-2,2.5-6.5,3-3.5,3-4,3/4,5-5.5,7-14,7.5-8,acute,anther,apex,base,brown,calyx,capitate,clavate,cm,corolla,cuneate,dia,flattened-reniform,glabrous,globose,green,hard,herbarium,leaf,lobe,lobed,margin,minutely,mm,mustard,narrowly,obovate,opposite,ovary,papillose,pedicel,petiole,poricidal,pseudo-terminal,rounded,shrub,small,specimen,stem,stigma,style,surface,tip,tree,tube,way,white,x,yellow	.25,.5,.75,/3,1-1.5,4-7,5-15-flowered,abov,anothe,anthesi,apart,ba,bark,beginning,beneath,berry,breaking,broadly,bud,closely,deep,difoliate,distal,drying,eaf,edicel,eed,ellipsoid,equal,erect,filament,free,fruiting,geminate,incrassate,inflorescenc,later,lateral,long,long-exserted,lower,main,member,middle,nflorescence,occasionally,older,overlapping,pair,pale,paler,papillo,peeling,pitted,planar,pore,portion,prominent,rarely,reddish-purple,ruit,scar,section,shaped,shining,simple,siz,slender,spaced,straight,subcoriaceous-fleshy,sulcate,tall,tapering,tear-drop,thick,transverse,triangular,trichome,tub,tuft,ud,uniseriate,unit,vein,widely,widest,without,woody,yellowish,ympodial,young	0.75,adhesion,arrangement,blade,climate,colour,diameter,form,fruit,glandular,growth,hair,height,history,inflorescence,length,life,midpoint,na,number,peduncle,perennial,plant,position,presence,pubescence,ray,reproduction,seed,shape,size,staman,stellate,stipe,texture
237	wfo-0001027389	success	154	87	53	101	34	0.344	.25,.5,0.25-0.5,0.5-1.5,0.6-1,1-1.5,11-14,2-2.5,3-3.5,3-4.5,5-7,acuminate,acute,anther,apex,base,broadening,brown,calyx,cm,corolla,dark,dia,elliptic,glabrous,globose,green,hispidulous,inflorescence,leaf,lobe,lobed,margin,minutely,mm,opposite,ovary,ovate,ovoid-reniform,pedicel,petiole,shaped,shrub,slight,sparsely,stem,stigma,style,tear-drop,truncate,tube,white,x	.1,0.25-0.3,0.5-0.75,1,1-2,1.8-1.9,4-5-flowered,7-8,along,anthesi,apart,ba,bark,beneath,berry,broadly,bud,conical,decurrent,deflexed,deltoid,dry,eaf,edicel,eed,ellipsoid,erect,evenly,except,expanded,exserted,filament,filiform,foetid,foliage,free,fruiting,geminate,lateral,like,lon,long,lower,main,making,material,middle,nearly,nflorescence,node,non-reproductive,obovoi,occasionally,often,older,one,pair,paler,papillo,papillose,pitted,pore,poricidal,portion,prominent,prominently,proximal,puberulent,raise,raised,reddish-golden,reflexed,rest,ruit,scar,shin,side,simple,slender,slightly,soon,spaced,straight,surface,tall,tapering,thread-like,tip,top,trichome,ud,unifoliat,uniseriate,unit,vein,widest,winged,woody,yellowish,ympodial,young	adhesion,arrangement,blade,climate,colour,diameter,form,fruit,glandular,growth,hair,height,history,length,life,midpoint,na,number,peduncle,perennial,plant,position,presence,pubescence,ray,reproduction,seed,shape,size,staman,stellate,stipe,texture,unifoliate
238	wfo-0001027395	success	153	112	80	73	32	0.523	.5,0.25-0.5,0.6-1.1,0.75-1,1-1.5,1-2,1-5,1.1-1.5,1.5-1.9,1.5-2.5,1.6-2.9,12.5-17.3,2-3,2.2-7,3.5-4,5-6.5,8,acute,anther,apex,attenuate,base,beneath,berry,black,calyx,capitate,cm,conical,corolla,decurrent,densely,dia,drying,fruit,glabrous,globose,green,immature,imperceptibly,large,leaf,lobe,lobed,long,major,margin,minor,minutely,mm,narrowly,nearly,obovate,occasionally,opposite,ovary,papillose,pedicel,petiole,pore,poricidal,primary,pubescent,rusty-papillate,secondary,shaped,shrub,size,stem,stigma,style,tapering,tear-drop,tip,trichome,tube,uniseriate,vein,white,x	.25,10-20-flowered,11-15,4-6,anthesi,apically,apiculate,bark,becoming,beginning,caly,closely,constricted,cucullate,deflexed,deltoid,depressed,differing,difoliate,eaf,edicel,eed,enlarging,erect,exfoliating,exserted,filament,fleshy,free,fruiting,geminat,inflorescenc,known,lateral,lon,lower,main,midrib,nflorescence,older,once-furcate,overlapping,ovoid,pair,papillo,partially,piece,planar,pointed,portion,raised,restricted,robust,ruit,scar,shining,shiny,simple,small,somewhat,spaced,straight,tall,thick,thickened,transverse,ud,unit,within,without,woody,ympodial,young	adhesion,arrangement,blade,climate,colour,diameter,form,glandular,growth,hair,height,history,inflorescence,length,life,midpoint,na,number,peduncle,perennial,plant,position,presence,pubescence,ray,reproduction,seed,shape,staman,stellate,stipe,texture
239	wfo-0001027396	success	244	130	102	142	28	0.418	-5,0-3,0-4,0.4-0.7,0.5-1,0.7-2.5,0.8-1.3,1.5-3.5,1/3,10-30,10-35,12-25,2-3,2-3.5,2.5-4,2.8-4.5,3.5-6,4,4-7,5.5-7.5,6-20,6.5-7.5,7-10,8-20,abaxially,acute,almost,andromonoecious,anther,apex,attenuate,base,berry,black,blade,brown,calyx,chartaceous,cm,connivent,cream,cuneate,dark,densely,diameter,elliptic,elongate,equal,flattened-reniform,flower,fruit,glabrous,glandular,green,hair,herb,lateral,leaf,length,lobe,lobed,long,long-styled,margin,marking,maturity,mauve,midpoint,mm,moderately,obtuse,often,orange,pale,pedicel,peduncle,petiole,plant,poricidal,pubescent,purple,ray,rotate,short-styled,shrub,simple,sometimes,somewhat,sparsely,spherical,stellate-pubescent,stem,style,tapering,tearing,tip,tube,upper,white,wide,yellow,young	-2,-6,/3,0-100,0-30,0-5,0.1-0.5,0.1-1,0.5-1.5,0.5-2,0.5-2.5,0.8,1,1-4,1.2-2,1.5-3,1.8-3,1/2-2/3,1/4-1/3,1/6,10-15,10-25,15-40,2-7,20-100,3-,3-9,4-5,4-6,5-10,5-20,5-30,5-50,5-8,5-merous,7-15,abaxial,adaxial,alyx,ame,apar,apart,apically,apparently,articulated,ba,bark,broad,broad-deltate,bulbous,c.,concolorous,curved,decurrent,deltate,difoliate,discolorous,distal,distance,drying,eaf,eed,elongating,erect,extending,extensive,fewer,filament,flattened,free,fruiting,fully,geminat,glabrescent,gray-brow,hermaphrodite,heterostylous,infructescence,less,lignified,lobing,lon,long-acuminat,longer,lower,lowermost,mature,midvein,near,nflorescence,older,one,open,opening,orolla,oung,pair,pendulous,per,pericarp,perpendicular,porrect,portion,prickl,prickle,prickly,primary,red-brown,reflexed,ruit,scar,secondary,sessile,side,smooth,spaced,spreading,stalk,stalked,staminat,stout,straight,surface,tamen,terete,tertiary,time,trichome,unarmed,unbranched,unit,usually,variously,vary,vein,venation,visible,way,woody,yellow-green,yellowish,ympodial	adhesion,arrangement,climate,colour,corolla,form,growth,height,history,inflorescence,life,na,number,ovary,perennial,position,presence,present,pubescence,reproduction,seed,shape,size,staman,stellate,stigma,stipe,texture
240	wfo-0001027416	success	137	85	46	91	39	0.336	.5,0.2-0.4,1.3-2.0,1.5-2.0,2.6-3.0,4-7,4-8,5-10,5.5-8.5,8-10,annual,anther,apically,base,blade,blue,broadly,brown,calyx,capitate,cm,dark,dm,dry,glabrous,hair,herb,incurved,internodal,lenticular,lobe,mm,ovary,ovate,pedicel,pentagonal-stellate,prickly,slightly,spherical,stem,strigulose,tube,violet,viscid-villous,weakly,yellow	0.3-0.5,0.5-1.0,1.0,1/2-2/3,3-7,4.0-5.5,5-9-flowere,accrescent,across,acute,along,alyx,anthesi,appearance,beneath,berry,borne,branching,campanulate,capitate-glandular,cauline,deltoid,developing,dia,difoliate,divided,eaf,eed,enveloped,erect,externally,few-rayed,fine,foveolate,geminat,gland,green,heteromorphic,invested,lanceolate,linear,lon,long,main,maturity,minutely,much-dissected,narrowly,nflorescence,often,orolla,otherwise,pinnatifid,prickle,quantity,reticulately,ruit,scattered,sessile,short,short-stipitate,simple,slende,slender,smooth,somewhat,splitting,spreading,stellae,straight,strait,tall,tamen,taprooted,terete,thrice,tightly,tigma,tub,twice,tyle,ultimate,uniseriate,unit,usually,varying,vein,villous,wholly,wrinkled,ympodial	adhesion,apex,arrangement,climate,colour,corolla,diameter,form,fruit,glandular,growth,height,history,inflorescence,leaf,length,life,margin,midpoint,na,number,peduncle,petiole,plant,position,presence,pubescence,ray,reproduction,seed,shape,size,staman,stellate,stigma,stipe,style,texture,ye
241	wfo-0001027432	success	215	124	99	116	25	0.46	0.1,0.3-0.4,0.5-1,1-1.5,1-3,1.4-2,1.5-,1.5-2,10-22,2-2.5,2-3-lobed,3,3-10,3-4,3-7,3.5-4.5,4.5-,5-10,6-10,6-7,7-,8-10,8-16,abaxially,acute,angulate,anther,apex,attenuate,base,blade,brownish,c.,calyx,chartaceous,clavate,cm,coriaceous,corolla,densely,diameter,entire,flower,fruit,glabrous,glandular,glandular-pubescent,globose,green,greenish,growth,heterostylous,hirsute,irregularly,leaf,light,lobe,lobed,margin,maturing,midpoint,mm,ovary,ovate,ovate-elliptic,pedicel,peduncle,perfect,petiole,plant,poricidal,rarely,ray,reniform,reticulate,scabrous,shrub,simple,somewhat,stellate,stem,stigma,style,sub-coriaceous,subglobose,tan,tapering,terminal,tip,tomentose,trichome,tube,velutinous,way,white,woody,x,yellow,young	-1.5,.5,0.2-0.3,0.3-1.0,0.3-3.5,0.5-0.1,0.8-1.0,1-multicellular,1/3,1/4,20-30,3-5,3-6,30,4-5,acicular,adaxially,apart,apical,armed,articulate,bark,basal,berry,branched,branching,brow,campanulate,confined,conical,cream,curved,cuspidate,distal,eaf,eed,eglandular,epidermi,erect,especially,exserte,ferruginous,fewer,filament,flattened,free,fruiting,glabrescent,juvenile,laterally,leave,lengthening,like,linear-lanceolate,long,long-styled,lower,many,many-celled,minute,much,mucilaginous,multangulate,multiangulate,near,new,nflorescence,ochraceous,older,one,partially,per,pericarp,plurifoliat,pore,porrect,porrect-stellate,portion,prickle,prickly,prominent,puberulent,pubescent,raise,recurved,ruit,sessile,short-styled,similar,slightly,spaced,sparsely,staminate,stellate-pubescen,stellate-pubescent,stellate-tomentose,stipitate,straight,subsessile,surface,terete,testa,thick,time,tomentose-floccose,tomentose-scabrous,ud,unarmed,unevenly,unicellular,unit,upper,villose,visible,yellowish,ympodial	adhesion,arrangement,climate,colour,form,hair,height,history,inflorescence,length,life,na,number,perennial,position,presence,pubescence,reproduction,seed,shape,size,staman,stipe,texture,ye
242	wfo-0001027437	success	193	99	72	121	27	0.373	0,0.2-0.4,1-1.5,1-2,1-4,2-2.5,2-3,2-4.5,2.5,2.8-6,4-4.5,4-5,5-12,5-6,6-8,7-17,acuminate,acute,anther,apex,attenuate,base,beige,brown,calyx,chartaceous,clavate,cm,cordate,corolla,diameter,elliptic,entire,erect,fruit,glandular,glandular-viscous,globose,growth,hirsute,internodal,lateral,lenticulate,linear-lanceolate,lobe,margin,midpoint,mm,oblanceolate,ovary,pedicel,peduncle,petiole,pubescence,pubescent,ray,scabrous,shrub,sparsely,stellate,stellate-rotate,stem,stigma,style,subreniform,subspherical,tomentose,tube,velutinous,white,woody,x	0.4-0.5,1,1-3,1.2-1.5,2-2.5mm,2-several,30,4,abaxially,adaxially,anthesi,antrorse,armed,articulated,bark,basal,beneath,berry,branched,compressed,corymbose,curved,cyme,dark,decurrent,densely,diamete,discolorous,distal,eaf,eed,egalndular,elongate,erec,exceeding,filament,flower,free,fruiting,glabrous,green,heterostylous,impressed,inserted,laterally,leaving,lengthening,like,lobed,long,long-styled,lower,middle,minute,mixed,mixture,near,nerve,new,nflorescence,oblong,older,one,ovate,partially,perfect,pericarp,plurifoliat,pore,poricidal,porrect,portion,prickle,prickly,prominent,puberulent,raise,recurved,reddish,reduced,reflexed,reticulate,rugose,ruit,rusty,scar,scarce,sessile,short-styled,simple,slightly,slit,spaced,sparse,stalked,staminate,stipitate,straight,strongly,subcampanulate,surface,tall,terete,testa,thick,three,time,tinge,tip,triangular-lanceolate,trichome,ud,unarmed,unevenly,unicellular,unit,upper,venation,within,yellow,ympodial	adhesion,arrangement,blade,climate,colour,form,hair,height,history,inflorescence,leaf,length,life,na,number,plant,plurifoliate,position,presence,present,reproduction,seed,shape,size,staman,stipe,texture
243	wfo-0001027447	success	197	94	69	128	25	0.35	0-0.4,0.15-0.25,0.2-1,0.25-0.5,0.4-0.6,0.6-1,1-2.5,1.3-1.7,1.5-3,2.3-5,3-4.5,3.5-4.5,3.8-4.3,4-8,7-14,7-8,absent,acuminate,acute,anther,apex,base,blade,calyx,chartaceous,cm,cuneate,densely,diameter,elliptical,entire,extra-axillary,fruit,glabrous,globose,hair,inflorescence,leaf,length,lobe,lobed,margin,midpoint,mm,obtuse,ovate,pale,pedicel,peduncle,perennial,petiole,plant,present,pubescence,ray,red,rhizomatous,shallowly,shrub,simple,sparsely,stellate,stellate-pubescent,style,succulent,tube,white,x,yellow	%,.25,0-0.5,0-1,0-10,0-2.5,0-4,0.2-0.6,0.25-0.3,0.5-1.7,0.6-0.8,1-1.4,1-10,1-2,1-locular,1.2-1.7,10-20,13-18,17-28,2.1-3.2,2.5-4,25-30,3-6,4-6,4-9,5-13,5-8,5-merou,6-10,7-10,7-14.5,8-13,abaxially,absen,acicular,across,adaxiall,adaxially,adult,alyx,andromonoecious,apart,articulated,axe,ba,branch,branche,brown,confined,cross-section,cylindrical,decimetre,directed,distall,distally,dm,eaf,eed,eglandular,elliptica,erect,exocarp,finger,flower,fruiting,functional,gland-tipped,green,half,heterostylous,incomplete,index,juicy,juvenile,lamina,lateral,less,lobing,long,longer,lower,markedly,mature,mesocarp,midrib,midvein,minute,moderately,nflorescence,oblique,orolla,pair,part,per,placenta,pore,porrect,prickle,pseudo-racemose,rostrate,ruit,septum,sessile,short,side,spaced,stellae,straight,surface,tal,tamen,tem,thick,thicker,throughout,time,transparent,unarme,unarmed,unbranched,unit,unknow,upper,vary,vein,weakly,wide,ympodial	adhesion,arrangement,climate,colour,corolla,form,glandular,growth,height,history,life,na,number,ovary,position,presence,reproduction,seed,shape,size,staman,stem,stigma,stipe,texture
244	wfo-0001027449	success	160	101	66	94	35	0.412	/3,0.5-1,0.8-1.5,0.9-1.1,1.4-1.5,2-4,3,3-3.5,3-7,5-6,8-15,acute,anther,apex,area,base,beneath,brown,calyx,cm,corolla,dark,densely,dia,dry,elliptic,fruit,glabrous,globose,green,inflorescence,leaf,lobe,lobed,long,material,minutely,mm,narrowly,oblique,often,opposite,ovary,ovoid-reniform,papillose,pedicel,petiole,poricidal,pubescent,red-papillose,shrub,size,small,sparsely,stem,stigma,style,tip,tree,trichome,tube,tuft,uniseriate,way,white,x	.4,.5,.75,0.5-1.5,1.2-1.5,1.5-2.5,10-15-flowered,2-3,4-6,acuminate,anthesi,appearing,arising,around,axil,bark,becoming,beginning,berry,bud,closely,cup,deciduous,deflexed,dense,density,differing,difoliate,eaf,edicel,eed,ellipsoid,erect,exserted,extreme,filament,forming,free,frui,fruiting,geminat,glabrate,inflorescenc,lamina,later,lateral,like,lon,long-acuminate,long-triangular,lower,main,major,minor,nflorescence,obconic,older,one,orangish,overlapping,packed,pair,pale,persistent,pitted,pointed,pore,portion,prominent,raised,reddish-brow,reflexed,rest,ruit,scar,shaped,simple,slender,soon,sparse,straight,styl,surface,tall,tapering,tear-drop,trunk,ud,unit,varying,vein,woody,ympodial,young	0.5,1,2,adhesion,arrangement,blade,climate,colour,diameter,form,glandular,growth,hair,height,history,length,life,margin,midpoint,na,number,peduncle,perennial,plant,position,presence,pubescence,ray,reproduction,seed,shape,staman,stellate,stipe,texture
245	wfo-0001027452	success	152	85	58	94	27	0.382	.5,0.5-1,0.5-1.5,0.5-2,0.5-2.5,1-3,1-4.5,1.5,1.5-3,10-20,2-6,2-foliate,3-9,4,4-6,5-12,abaxially,absent,adaxially,anther,brown,calyx,chartaceous,cm,densely,diameter,dm,drying,elliptic,elliptic-ovoid,flower,fruit,glabrous,globose,herb,immature,lobe,maturing,membranaceous,mm,moderately,nearly,oblong,pedicel,peduncle,petiole,pubescent,rotate,seed,semitransparent,sparsely,stigma,style,tube,usually,white,x,yellow	1,1-2,1-5,2-4,3-6,5-20,abundant,acute,adaxiall,along,apex,axe,base,berry,beyond,blade,branched,cell,celled,center,ciliate,connected,cordate,decurrent,dehiscing,denser,eaf,eed,emarginat,entire,equal,explosively,exserted,filament,flat,frui,geminat,growt,hair,held,interpetalar,large,linear-lanceolate,long,lower,lying,margin,maturit,mesocarp,new,nfloresence,notched,obtuse,often,one-,orolla,outer,parallel,per,perpendicular,placenta,pressure,pubescen,rachi,raised,ridge,rounded,ruit,running,short,significantly,single,slightly,smaller,smoother,sometimes,stamen,straight,swollen,tal,tamen,tem,tissue,triangular,two-celled,unbranched,unit,vary,vein,wall,watery,wid,woody,ympodial	adhesion,arrangement,colour,corolla,form,geminate,growth,height,history,inflorescence,leaf,length,life,na,ovary,perennial,plant,position,presence,pubescence,reproduction,shape,size,staman,stellate,stem,texture
246	wfo-0001027471	success	165	118	90	75	28	0.545	.5,/4,0.1-0.2,0.2-0.5,0.4-1,0.5-0.6,0.5-1.5,0.9-1,1-1.2,1-1.5,1.4-3,2-2.5,2-3,2-lobed,3-4,3-7,4-5,acute,adaxially,age,along,anther,apex,base,berry,bifid,branched,brittle,calyx,cm,conical,corolla,dendritic,densely,diameter,elliptic,entire,flattened,glabrous,globose,growth,herb,inflorescence,internodal,lamina,leaf,leaf-opposed,lengthening,lobe,lobed,margin,maturity,midvein,mixture,mm,ovary,ovate,pedicel,peduncle,perfect,petal,petiole,pore,poridical,pubescent,red-orange,reniform,scattered,shape,shrub,simple,size,slit,small,somewhat,sparsely,stem,stigma,style,subshrub,tan,thin,tip,trichome,tube,vein,way,white,x,yellowish	0.2-0.4,0.5,0.5-0.7,0.7-0.9,1-1.6,1.5-2,6-7,abaxially,anthesi,appressed,ascending,bark,c.,closely,deltate,desnsely,differing,difoliate,distant,drying,eaf,eed,erec,erect,especially,filament,flower,free,fruiting,furcate-dendritic,geminate,included,less,like,long-triangular,lower,major,minor,minutely,new,nflorescence,nodding,node,occasionally,open-conical,orbicular,overlapping,pair,pale,papillat,pericarp,pitted,planar,plane,portion,primary,pubscent,rachi,reflexed,ruit,scar,similar,slender,slightly,spaced,straight,surface,thickened,trifoliat,ud,uniseriate,unit,usually,woody,ympodial	adhesion,arrangement,blade,climate,colour,form,fruit,glandular,hair,height,history,length,life,midpoint,na,number,plant,position,presence,present,pubescence,ray,reproduction,seed,staman,stellate,stipe,texture
247	wfo-0001027473	success	138	104	71	67	33	0.514	.25,/2,0.5-1,0.8-1,1-1.5,1-2,1.3-2,1.5-2,2-2.5,2.5-3,3.5-5,4.5-13,8.5-37,?,abaxially,acute,adaxially,anther,apex,base,brown,calyx,clavate,cm,corolla,decurrent,dendritic,densely,di-,dia,flattened-reniform,glabrous,globose,green,incrassate,later,leaf,like,lobe,lobed,long,margin,mm,near,obovate,occasionally,ovary,pedicel,petiole,pointed,pubescent,pubesent,rootstock,rusty,sessile,shape,shrub,somewhat,sparsely,stem,stigma,style,subshrub,trichome,trifoliate,tube,way,white,wide,woody,young	0.25-0.5,1.8-2,1/3,5,6-9,absen,along,anthesi,ape,apparently,bark,berry,conical,deccurent,deep,deflexed,denser,differing,drying,eaf,eed,empty,erect,filament,free,fruiting,geminat,giving,lateral,less,long-triangular,lower,main,major,middle,minor,minute,minutely,older,overall,pair,pale,papillo,pitted,planar,pore,poricidal,portion,ruit,sac,shaped,sterile,strongly,surface,tall,tear-drop,thick,tip,unit,usually,vein,widest,wing,winged,yellowish,yellowish-brow,ympodial	absent,adhesion,arrangement,blade,climate,colour,diameter,form,fruit,glandular,growth,hair,height,history,inflorescence,length,life,midpoint,na,number,peduncle,plant,position,presence,pubescence,ray,reproduction,seed,size,staman,stellate,stipe,texture
248	wfo-0001027483	success	164	69	51	113	18	0.311	0.2-1.9,0.6,1-2.5,1.2-2.5,1.5-10,1.5-2.6,1.5-3,2-4,2-4.5,3-15,3-6,3.5-20,4.5-8,calyx,cm,coarsely,connate,corolla,diameter,distal,elliptical,finely,globose,green,green-white,half,herbaceous,lateral,leaf,leaflet,light,long,medium,mm,odd-pinnate,ovate,ovoid,pedicel,peduncle,perennial,petiole,plant,pubescent,rotate,seed,size,terminal,violet,violet-purple,wide,yellow	0-1.,1,1-2,1-4,1-5,2,2-3,3-6-foliat,5-10,5-6,abaxially,acumen,acute,adaxially,apex,apical,apically,articulate,basal,base,branched,cell,covering,cuneate,cyme,decurrent,dehiscent,dichasial,dichasially,digestion,diminishing,dorsally,dot,eaf,ebracteate,edge,eed,emoval,enzyme,erec,exceeding,filament,flat,flower,folded,forked,generally,globo,gradually,hair-like,honeycomb,interjected,interpetiolar,introrse,lighter,living,lobe,lon,lower,lunat,make,maturing,minute,monochasial,mucilaginous,nflorescence,nther,obtuse,often,orolla,pair,pattern,perfect,petiolule,plan,poricidally,proximal,purple,rachi,ray,reveal,rosette,rounded,ruit,sessile,seudostipule,short,slit,smooth,sometimes,specimen,stamen,stigma,straight,style,subsessile,tall,tem,testal,thick,throughout,tissu,toward,tuber-bearing,typically,uniform,unit,vary,varying,wall,white,ympodial,¼	anther,arrangement,color,form,fruit,growth,height,history,inflorescence,length,life,na,ovary,position,reproduction,shape,stem,texture
249	wfo-0001027503	success	197	86	69	128	17	0.35	.5,0.4-0.7,0.5,0.5-0.6,0.5-0.7,0.8-1,1-1.2,1-3,1.2-2.5,2-3,2.5-5.5,4,anther,base,beige,berry,calyx,clavate,cm,conical,coriaceous,corolla,densely,diameter,dioecious,echinoid,elliptic,fruit,glabrous,globose,greenish,growth,inflorescence,internodal,leaf,lobe,lobed,long,mm,narrowly,nearly,ovary,pale,pedicel,peduncle,petiole,plant,poricidal,pubescence,pubescent,ripe,shiny,shrub,simple,small,stellate,stem,stigma,style,tan,thick,thin,tip,tree,trichome,tube,white,x,yellowish	0.15-0.2,0.2,0.6-0.7,0.9-1.2,1,1.1-1.5,10,2.5-3,20-40,549,8-11,<,abaxially,acute,adaxially,age,almost,along,anthesi,apex,armed,articulated,bark,beneath,berr,bluntly,branched,broad-based,broadly,common,consisting,deflexed,deltate,dense,distally,due,eaf,eed,ellipsoid,elongate,enclosing,entire,erect,expanding,female,fide,filament,flower,foliose,free,fruiting,glabrescen,greatly,grey,included,juvenile,known,lamina,lanceolate,large,lengthening,lepidote,less,like,likely,lower,male,margin,midrib,minutely,mixture,new,nflorescence,occasionally,often,older,overlappin,packed,pair,papillo,partially,peguero,pericarp,pistillate,planar,plurifoliat,pore,porrect,portion,prickle,prickly,primary,prominent,ray,rest,rhachi,rounded,rudimentary,ruit,scar,seen,shoot,short,similar,slit,solitary,somewhat,sparsely,staminate,stout,straight,surface,tightly,time,tiny,truncate,tubular,ud,unarme,unarmed,underside,unisexual,unit,vein,visible,without,ympodial,½	arrangement,colour,form,height,history,length,life,na,perennial,position,presence,present,reproduction,seed,shape,size,texture
250	wfo-0001027506	success	215	125	96	119	29	0.447	-0.35,-7,-7.5,.2,/6,0-10,0.1-0.3,0.2-0.3,0.5-1.5,0.5-6,0.7-1.3,1.2-1.5,1.8,1/3,2-3.2,2.2-3.5,2.5-5,3-5,3-6,3.5-5,6.5-10,8-10,abaxially,acuminate,acute,andromonoecious,anther,apex,base,becoming,berry,blade,calyx,chartaceous,cm,connivent,cordate,cream,cuneate,dark,densely,diameter,dry,entire,equal,flattened-reniform,fruit,glabrous,green,hard,lateral,leaf,length,lobe,lobed,long,margin,marking,maturity,mauve,midpoint,mm,occasionally,orange-brown,ovate,pale,pedicel,peduncle,petiole,plant,poricidal,purple,ray,shrub,simple,small,smooth,sometimes,spherical,stellate,stellate-pubescent,stem,style,subentire,tapering,terminal,tip,tree,truncate,tube,upper,way,wide,woody,yellow,young	-1,-20,-3,.5,/2,0,0-2,0-6,0-60,0.1-,0.2,0.25,0.8-1.5,1-2,1-3,1-4,1.5-2.2,1/6-1/4,10-40,2.5-8,3-10,5-10,5-7,5-merous,6-13,7-8,7-9,9-13,acuminat,alyx,ame,apar,apart,apically,apparently,articulated,bark,branched,brow,brown,c.,cell,concolorous,curved,distal,drying,eaf,eed,elongating,erect,filament,fine,flattened,flower,free,fruiting,glabrescent,hermaphrodite,heterostylous,infructescence,lengt,long-styled,longer,lower,lowermost,mature,moderately,multangulate,narrow-deltate,nflorescence,older,one,open,orange,orolla,oung,outline,pair,pendulous,per,pericarp,pit,plurifoliat,porrect,portion,prickl,prickle,prickly,primary,raised,reddish,reduced,reflexed,ruit,scar,sessile,short-styled,spaced,spreading,stalk,stalked,staminat,stout,surface,tamen,terete,tertiary,time,trichome,twice,unarmed,unit,variously,vary,vein,venation,visible,yellow-green,ympodial	adhesion,arrangement,climate,colour,corolla,form,glandular,growth,hair,height,history,inflorescence,life,na,number,ovary,perennial,position,presence,present,pubescence,reproduction,seed,shape,size,staman,stigma,stipe,texture
251	wfo-0001027510	success	195	113	85	110	28	0.436	.5,.7,0-0.4,0-0.5,0.4-0.9,0.5-0.6,0.5-1.1,0.7-1.5,0.9-3.4,1.5-2,1.5-2.5,10-15,2-2.2,2.5-3,2.6-6,3-5,4-5.5,4-6,4-9,5-10,6-13,6-7.5,abaxially,absent,acute,adaxially,anther,apex,base,blade,broadly,calyx,capitate,chartaceous,cm,connivent,cordate,densely,diameter,distributed,eglandular,entire,extra-axillary,fruit,glabrous,gland-tipped,globose,green,hair,inflorescence,interpetalar,juicy,lanceolate,leaf,length,lobe,margin,midpoint,mm,obtuse,ovate,pale,pedicel,peduncle,perennial,petiole,pubescent,purple,ray,red,rhizomatous,rotate-stellate,short,shrub,simple,stellate,stellate-pubescent,stigma,style,succulent,throughout,tissue,tube,x,yellow	%,0-0.9,0-2,0-5,0.1-0.3,0.2-0.4,0.7-1.6,0.8-1.8,1-2,1-3,1-locular,1.5-3,1.5-4,1.6-2,10-12,10-13,17-35,2-3,2-5,2-foliate,2.6-5.5,3-6,4-5,4-8,5-merou,6,6-8,9-12,absen,abundant,accrescent,across,adult,alyx,apart,apparen,articulated,axe,ba,contiguous,cylindrical,deltate,directed,distall,eaf,eed,elliptic,erect,exceeding,filament,finger,flower,forke,fruiting,geminat,grey,homostylous,incomplete,juvenile,lamina,lateral,leafy,lobed,long,lower,mature,mesocarp,minute,minutely,nearly,nflorescence,oblique,orolla,pair,part,per,perfect,placenta,pore,porrect,prickle,pseudo-umbellate,rachi,reticulate,ruit,septum,sessile,shallowly,soliary,spaced,stalk,stellae,surface,tal,tamen,tem,thick,time,tissu,transparent,unarme,unarmed,unbranched,unit,upper,usually,vary,wide,without,ympodial	adhesion,arrangement,climate,colour,corolla,forked,form,glandular,growth,height,history,life,na,number,ovary,plant,position,presence,present,pubescence,reproduction,seed,shape,size,staman,stem,stipe,texture
252	wfo-0001027536	success	200	105	74	126	31	0.37	0.4-2.0,1-2,1.5-2,2-10,2-2.5,2-3,2-5,3-3.5,3-4,3-5,4,4-10,4-12,4-5,5-6,8-10,abaxially,acute,adaxially,anther,apex,base,blade,brown,calyx,cm,connivent,decurrent,densely,depressed-globose,diameter,eglandular,elliptic,entire,ferruginous,flower,fruit,glandular,globose,hair,inflorescence,leaf,leathery,lenticular,linear-lanceolate,lobe,margin,midpoint,mm,multiseriate-stalked,oblanceolate,pedicel,peduncle,perennial,petiole,sessile,shrub,simple,slightly,stellate,stem,stigma,style,subcoriaceous,subreniform,terete,tomentose,trichome,tube,velutinous,villose,white,x,yellow	-15,-3,1-1.5,2-,2-4,20,3-forked,30-50,4-8,5-10,5-7,8-,accrescent,adaxiall,alyx,apart,ape,apical,apiculate,armed,articulated,asymmetric,axe,ba,basal,berry,bicolored,bisexua,branch,branched,chartaceous,clavate-truncat,compressed,curved,dark,distal,dry,eaf,eed,enlarged,epicarp,equal,erect,exceeding,ferruginous-tomentose,filament,fine,fleshy,free,fruiting,glabrous,gland-tipped,glandular-stellate,gynoecia,held,impressed,introrse,laterally,like,long,longer,lower,many-foliat,maturit,mixed,mostly,multiseriate,nflorescence,one,opening,ornamentation,orolla,part,per,perfect,persistent,persistently,pore,prickle,primary,prominent,pubescent,rachi,recurved,reddish,reduced,reflexed,reticulated,ruit,short,similar,single,slender,small,somewhat,spaced,sparsely,splitting,stalk,stamen,staminate,straight,subcampanulate,subulate,surface,surrounded,tal,tamen,tem,thick,time,tip,unarme,unarmed,unbranched,unisexual,unit,upper,upright,usually,vary,vein,wide,yellowish,ympodial,zygomorphic	1,2,adhesion,arrangement,bisexual,clavate-truncate,climate,colour,corolla,form,growth,height,history,length,life,na,number,ovary,plant,position,presence,present,pubescence,ray,reproduction,seed,shape,size,staman,stipe,texture
253	wfo-0001027538	success	137	87	56	81	31	0.409	.5,.9,0-0.1,0.3-0.4,0.4-0.5,0.4-0.85,0.5,0.5-1,0.9-1,0.9-1.8,1.5-3.5,4-5,8,absent,acute,adaxially,anther,apex,base,blade,calyx,chartaceous,cm,cordate,densely,diameter,entire,extra-axillary,fruit,glabrous,grey-green,hair,inflorescence,lateral,length,lobe,long,margin,midpoint,mm,obtuse,ovate,pedicel,peduncle,petiole,present,prostrate,ray,simple,stellate,stellate-pubescent,time,tube,unknown,x,yellow	%,0-1.5,0-2,0.05-0.15,0.1-0.2,0.3-0.45,0.5-1.5,0.6-1,0.9-1.2,1,1-4,1.9-2.4,2-4,20-25,5-merou,7-12,8-13,?,abaxially,absen,acicular,across,adaxiall,alyx,apart,armed,articulated,attenuate,axe,ba,brown,directed,distall,distributed,eaf,eed,eglandular,finger,flower,fruiting,gland-tipped,globo,half,lamina,less,lon,lower,mature,mid-point,midvein,minute,nflorescence,oblique,orolla,part,per,pore,porrect,prickle,ruit,rusty,sessile,short,shru,spaced,stage,stalk,stellae,straight,tamen,tem,thick,throughout,unarmed,unbranched,unit,unknow,uvenile,wide,yellowish,ympodial	adhesion,arrangement,climate,colour,corolla,form,glandular,globose,growth,height,history,leaf,life,na,number,ovary,plant,position,presence,pubescence,reproduction,seed,shape,shrub,size,staman,stem,stigma,stipe,style,texture
254	wfo-0001027548	success	216	105	74	142	31	0.343	-11.5,0.3-1.2,0.5-2,1,1-1.5,1-2.5,1-3.5,1.2,1.5-2.5,3-7,4-8,4.5,6-9,acuminate,acute,almost,anther,apex,attenuate,base,berry,black,brown,calyx,capitate,cm,connivent,corolla,dark,densely,diameter,dull,ellipsoid,elliptic,entire,flattened-reniform,glabrous,glandular,globose,green,growth,immature,inflorescence,leaf,lilac,lobe,lobed,loosely,margin,matte,membranous,mm,narrowly,papillate,pedicel,peduncle,perfect,petiole,pubescent,ripe,simple,size,stellate,stem,stigma,style,terminal,tinged,tube,vine,white,woody,x,yellow	.3,0.2,0.5,1-10,1.5,1.5-2,10-12,10-50,4-6,5-merou,7-10,8-9,abaxiall,adaxially,ag,along,also,although,alyx,anthesi,apart,apical,apparently,appearing,area,ark,articulated,articulation,axi,basal,beneath,bent,branch,branched,branching,bu,c.,cell,conical,darker,deflexe,deltate,dendritic,denser,depressed-elliptic,drying,eaf,early,eed,elongate,em,exserted,extending,filament,flexuous,flower,free,fruiting,geminat,glabrescen,half,herbarium,ilament,irregularly,lamina,leaving,lengthening,less,like,lon,long,long-styled,loose,lower,many,minute,minutely,mixed,near,new,nflorescence,occasionally,older,orolla,outline,pair,pale,papillae,papillo,per,pericarp,pitted,planar,plurifoliate,point,pore,poricidal,portion,primary,prominent,puberulent,rachi,rectangular,reddish,revolute,ruit,scar,scattered,slender,slit,small,sometimes,somewhat,spaced,sparse,sparsely,specimen,spreading,strongly,surface,swollen,tapering,testal,thickened,thin,time,tiny,tip,transparent,trichome,twinin,type,ud,uniseriate,unit,upper,usually,vary,vein,warty,way,ympodial	0.3-1,8,adhesion,arrangement,blade,climate,colour,form,fruit,hair,height,history,length,life,midpoint,na,number,ovary,perennial,plant,position,presence,present,pubescence,ray,reproduction,seed,shape,staman,stipe,texture
255	wfo-0001027581	success	200	101	57	143	44	0.285	acute,anther,apex,base,broadly,brown,calyx,clavate,cm,connivent,corolla,dark,densely,diameter,ellipsoidal,elliptic,entire,evenly,flattened-reniform,globose,golden,green,growth,inflorescence,leaf,length,lobe,lobed,long,loosely,margin,mm,moderately,pedicel,peduncle,petiole,plane,pubescent,purple,ray,reddish,shiny,shrub,simple,size,small,stellate,stem,stigma,style,terminal,thin,tree,tube,unevenly,wide,yellow	0.2–0.3,0.3,0.3–1,0.5–1,0.5–1.5,1,1.2–1.5,1.3–1.5,1.5,1.5–2,1.5–3,10,100+,10–16,12,12–30,15–20,1–1.5,1–3-rayed,2.5–3,200,3.5–4.5,3–3.5,4.5–16,4–8,5-merou,6–7,7–10,7–9,8,8–10,9–11,9–9.5,>,abaxial,abaxially,adaxial,ag,along,alyx,anthesi,apar,ark,articulated,axe,beneath,berry,branched,branching,brow,bulbous,c.,clearly,closely,cup-shaped,deltate,dichasia,discolorous,distally,drying,eaf,echinoid,eed,erec,exserted,filament,flower,free,fruiting,glabrescent,glabrous,gradually,greyish,ilament,lamina,largest,lengthening,less,like,longest,lower,many,midvei,minute,minutely,mixed,multangulate,multiseriate,narrowing,near,new,nflorescence,nodding,older,orolla,pair,papillo,part,per,perfect,pericarp,pitted,plurifoliate,pore,poricidal,porrect-stellate,portion,primary,reflexed,rhachi,ripe,ruit,scar,scarcely,sessile,short-stalked,slit,smaller,spaced,sparsely,spreading,stalk,stout,surface,tall,tem,time,tip,trichome,ud,undersurface,unit,upper,vary,varying,vein,visible,way,weak,whit,woody,yellowish,ympodial	0.3-1,0.5-1,0.5-1.5,1-1.5,1-3,1.3-1.5,1.5-2,1.5-3,12-30,15-20,2.5-3,3-3.5,4-8,4.5-16,7-10,7-9,9-9.5,adhesion,arrangement,blade,colour,form,fruit,glandular,hair,height,hermaphroditic,history,life,na,number,ovary,perennial,plant,position,presence,present,pubescence,reproduction,seed,shape,staman,stipe,texture
256	wfo-0001027584	success	144	100	67	77	33	0.465	-2,0.5-1,0.5-1.5,0.9-1,0.9-2.5,1-1.2,1.5-2,1.6-1.9,11.5-45,2-10,3-.,4-6,4-7,4.5-20,abruptly,acuminate,anther,apex,attenuate,base,calyx,cm,conical,corolla,darker,densely,diameter,ellipsoid,elliptic,flattened,four,fruit,glabrous,green,herb,lobe,lobed,long,margin,minutely,mm,nearly,ovary,ovate,pale,papillate,pedicel,peduncle,petiole,reddish,reniform,scattered,smooth,sparsely,stem,stigma,stripe,style,suffruticose,surface,tan,tip,trichome,tube,uniseriate,white,x	-16,..,.5,1.2-1.4,1.5-8,10-15,100,2,2.5-3,3,7-10,8-9,absent,anthesi,apical,bark,becoming,beginning,beneath,branch,branched,brittle,broadly,brow,c.,capitat,cell,cucullate,deflexe,deltate,dry,eaf,edicel,eed,erec,filament,flower,fruiting,irregular,lamina,lower,markedly,narrowly,nflorescence,open,outer,outline,pair,per,pericarp,planar,plurifoliat,pointed,present,primary,regularly,ruit,scar,shrub,single,single-stemmed,sinuate,small,sparse,striate,testal,thickening,thin,time,triangular,tuft,ud,unit,vein,wall,without,ympdoial	adhesion,arrangement,blade,capitate,climate,colour,form,glandular,growth,hair,height,history,inflorescence,leaf,length,life,midpoint,na,number,plant,plurifoliate,position,presence,pubescence,ray,reproduction,seed,shape,size,staman,stellate,stipe,texture
257	wfo-0001027585	success	217	111	85	132	26	0.392	0-1,0-2,0.15-0.25,0.25-0.35,0.6-0.9,1-3,1-4,10-25,12-23,2-5,2.3-2.8,3-3.5,3-4,3-7,4.5-20,5-8,7-10,7-9,absent,acuminate,acute,adaxially,anther,apex,base,blade,calyx,chartaceous,cm,connivent,cuneate,cylindrical,densely,diameter,elliptic,entire,erect,extra-axillary,flattened,fruit,glabrous,globose,green,hair,inflorescence,lanceolate,leaf,length,lilac,lobe,lobed,long,loosely,margin,midpoint,mm,oblate,ovate,pale,pedicel,peduncle,perennial,petiole,plant,present,pubescent,ray,rhizomatous,ripe,rounded,shallowly,shrub,simple,sparsely,sprawling,stellate,stellate-pubescent,stigma,style,throughout,tube,unripe,vine,x,yellow	%,.05,0,0-0.5,0-15,0-4,0.2-0.3,0.2-0.4,0.5-1,0.7-4.5,0.9-1.8,1,1.9-2.5,11-15,13-18,15-20,15-30,2-3,2-6,2-foliate,2-locular,22-25,29-40,3.8-4.2,4-8,5-17,5-7,5-merou,6-7,6-8,7-14.5,8-10,8-14,abaxially,absen,accrescent,acicular,across,adaxiall,adult,alyx,andromonoecious,anvil-shape,apart,articulated,axe,ba,branch,branche,broad-based,brown,capitat,confined,cross-section,curved,decimetre,deltate,directed,distall,distributed,dm,eaf,eed,eglandular,exocarp,finger,flower,fruiting,functional,geminat,gland-tipped,half,heterostylous,interpetalar,juicy,juvenile,lamina,lateral,less,longer,lower,mature,mesocarp,mid-point,midrib,midvein,minute,moist,narrowly,nflorescence,oblique,orolla,pair,part,per,placenta,pore,porrect,prickle,purple,rachi,ruit,scarcely,sessile,short,side,spaced,sparse,stalked,stellae,straight,surface,tal,tamen,tem,thick,time,tissue,transparent,triangular,unarme,unarmed,unbranched,unit,upper,vary,vein,weakly,white,wide,yellowish,ympodial	adhesion,arrangement,capitate,climate,colour,corolla,form,glandular,growth,height,history,life,na,number,ovary,position,presence,pubescence,reproduction,seed,shape,size,staman,stem,stipe,texture
258	wfo-0001027594	success	168	94	62	106	32	0.369	.5,0.3-1.2,0.7-1,0.7-1.2,1-2,1.5-2,10-15,2.5,2.5-4,3-4,4-5,acute,anther,apex,attenuate,base,berry,bright,calyx,capitate,cm,corolla,dia,flattened-reniform,fleshy,glabrous,glandular,globose,green,hard,immature,lavendar,leaf,lobe,lobed,margin,minutely,mm,oblanceolate,occasionally,often,opposite,orange,ovary,pale,papillose,pedicel,petiole,poricidal,puberulent,ripe,seed,shrub,stem,stigma,style,tinged,tip,tube,white,x,yellow-tan	.1,.2,0.6-1.4,0.9-2.5,1,2-2.2,2-3,2-5,3/4,4.7-6.8,5-20-flowered,across,age,anthesi,ba,bark,becoming,bi-lobed,body,branch,brown,closely,constriction,curved,dark,decurrent,deltoid,difoliate,distal,eaf,edicel,eed,elliptic,erect,especially,extending,filament,free,fruiting,geminat,geminate,incrassate,interpetalar,junction,lateral,lenticellat,less,locule,lon,long,lower,main,major,maroon,middle,minor,minute,nflorescence,non-reproductive,oblong,obovate,obovoid,older,one,ovate,overlappin,pair,paler,papillo,pitted,pore,portion,prominent,raised,reflexed,reproductive,rounded,ruit,scar,shaped,shoot,simple,sinus,slender,slightly,small,spaced,straggly,straight,surface,tall,tapering,tear-drop,thin,trichome,two,ud,uniseriate,unit,vein,way,widest,winged,woody,ympodial,young	adhesion,arrangement,blade,climate,colour,diameter,form,fruit,growth,hair,height,history,inflorescence,length,life,midpoint,na,number,peduncle,perennial,plant,position,presence,pubescence,ray,reproduction,shape,size,staman,stellate,stipe,texture
259	wfo-0001027600	success	185	117	92	93	25	0.497	0.5-1.5,1,1-14,1-4,1-5,1.5-2,10-,15-25,2-18,2-3,2-3.5,2-4,2-4.5,2-6,2.5-21,2.5-6,20-30,3-15,3-5,3-5-lobed,3-6,abaxially,acuminate,adaxially,along,apex,apical,basal,base,calyx,campanulate,cm,collection,concave,cordate,cuneate,densely,diameter,ellipsoidal,entire,except,fading,flattened,fruit,glabrescent,glabrous,gland,glandular-puberulent,greenish-white,leaf,lobe,lobed,main,margin,mature,midrib,minutely,mm,moderately,oblong,older,orange,papillose,pedicel,peduncle,petiole,pilose,pinnately,puberulence,puberulent,pubescent,purple,purplish,rarely,rounded,simple,sparsely,stigma,style,subcoriaceous,surface,tree,truncate,tube,two,unlobed,vein,white,x,yellow,yellow-green,young	-10,-3,0.5-1,1-2,1.5-2.5,1/2-3/4,10-20,2-11,2-5,4-6,4-foliat,5-13,8-17,abruptly,absen,absent,acute,adaxial,adpressed,aggregate,apart,ape,apiculate,articulated,axe,beyond,blade,brow,cell,channe,connective,coriaceous,cream,deltate,dilated,directed,distally,divided,eaf,eed,elliptic,especially,exceeding,exserted,fleshy,flower,forked,laterally,leaving,lon,long,lower,narrowed,nflorescence,nther,obconical,obtuse,occasionally,orolla,ovate,ovoid,pedicellar,perfect,pilo,pore,puberulen,rachi,radiu,remnant,ruit,shorter,sinus,slightly,small,somewhat,spaced,stamen,stone,strongly,tal,tem,thecae,time,tip,tomento,triangular,ud,unbranched,unit,vary,wide,yellowish,ympodial	anther,arrangement,colour,corolla,form,growth,height,hermaphroditic,history,inflorescence,length,life,na,ovary,perennial,plant,position,pubescence,reproduction,seed,shape,size,stem,texture,tomentose
260	wfo-0001027601	success	204	109	82	122	27	0.402	0-0.1,0-3,0.1-0.5,0.2-0.4,0.25-0.4,0.3-0.5,0.4-2,0.5-1.5,0.5-2,1-1.4,1.5-2,1.6-5,2-15,2.5-3,2.5-6,2.6-4,7-18,8-9,absent,acuminate,acute,adaxially,andromonoecious,angularly,anther,apex,base,blade,buff,calyx,chartaceous,cm,connivent,cuneate,densely,diameter,ellipsoidal,elliptical,entire,erect,extra-axillary,fruit,glabrous,globose,hair,inflorescence,lanceolate,lateral,leaf-opposed,length,lilac,lobe,lobed,long,margin,midpoint,mm,ovate,pale,pedicel,peduncle,perennial,petiole,plant,present,ray,red,reniform,rhizomatous,shallowly,shrub,simple,sparsely,stellate,stellate-pubescent,stigma,style,throughout,time,tube,x,yellow	%,.05,0-10,0-7,0.2-0.8,0.4-0.5,0.5-0.8,0.5-1,1-1.3,1-2,1-locular,10-16,13-25,2-6,2.3-4.3,3-5,3-6,3-7,3-foliate,4-10,5-merou,6-8,7-20,7-8,abaxially,absen,accrescent,acicular,across,adaxiall,adult,alyx,apart,apparen,around,articulated,axe,ba,branche,brown,capitat,confined,congested,contiguous,cylindrical,decimetre,deltate,directed,distall,eaf,eed,eglandular,exocarp,filament,finger,flattened,flower,fruiting,functional,geminate,gland-tipped,green,half,heterostylous,incomplete,index,juicy,lamina,less,lobing,longer,lower,mature,mesocarp,midrib,midvein,minute,narrow,nearly,nflorescence,oblique,obtuse,orolla,outer,part,per,placenta,pore,porrect,prickle,pseudo-racemose,rachi,reticulate,ruit,septum,sessile,short,side,spaced,stalk,stellae,straight,strongly,succulent,surface,tal,tamen,tem,thick,toward,unarme,unarmed,unbranched,unit,vary,vein,weakly,white,wide,wing,yellowish,ympodial	adhesion,arrangement,capitate,climate,colour,corolla,form,glandular,growth,height,history,leaf,life,na,number,ovary,position,presence,pubescence,reproduction,seed,shape,size,staman,stem,stipe,texture
261	wfo-0001027606	success	192	106	79	113	27	0.411	0-0.2,0.2-4,0.3-0.8,0.3-1.2,0.4-0.5,0.5-0.75,0.5-1,0.7-0.9,1-1.5,1-2,1-2.5,10-19,2-4,2-7,2.5-4,3-4.1,4-6.5,6-8,abaxially,absent,acute,adaxially,anther,apex,base,blade,broadly,calyx,chartaceous,cm,cuneate,deeply,depression,diameter,entire,extra-axillary,flattened,flower,fruit,glabrous,gland-tipped,globose,hair,inflorescence,lanceolate,leaf,length,lilac,lobe,lobed,long,margin,mid-point,midpoint,mm,obtuse,ovate,pale,pedicel,peduncle,perennial,petiole,pinkish,present,pubescence,red,reniform,rhizomatous,short,shrub,simple,stellate,stigma,style,throughout,tube,vein,x,yellow	%,-10,0-1.5,0-4,0.2-0.3,0.2-2.5,1,1-5,1-7,1-locular,1.5-2.9,12-25,2,2-,2-3,2-5,2-5.5,3-10,3-4,3-foliate,4-11,5-merou,5.5-7,6-9,7-10,7-22,9-13,absen,accrescent,acicular,adaxiall,adult,alyx,apart,apparen,apparently,articulated,axe,ba,branch,branche,branched,brown,cylindrical,directed,distall,distally,dm,eaf,eed,erect,exocarp,filament,finger,fruiting,geminat,green,grey,half,incomplete,index,juicy,juvenile,lamina,less,lobing,longer,lower,markedly,mature,mesocarp,midvein,minute,narrowly,nflorescence,oblique,occasionally,orolla,pair,part,per,perfect,placenta,pore,prickle,pseudo-racemose,rachi,rostrate,ruit,scarcely,septum,side,spaced,straight,succulent,surface,tal,tamen,tem,thick,thicker,time,triangular,truncat,unarme,unarmed,unbranched,unit,upper,usually,vary,wide,ympodial	adhesion,arrangement,climate,colour,corolla,form,glandular,growth,height,history,life,na,number,ovary,plant,position,presence,ray,reproduction,seed,shape,size,staman,stem,stipe,texture,truncate
262	wfo-0001027607	success	167	108	74	93	34	0.443	.1,.5,0.25-0.5,0.5,0.5-1,0.8-1,1,1-4,1.5-3,2-2.5,2-3,2-4,2.5-3,3-3.5,3/4,5-10,8-9,acuminate,acute,anther,apex,area,base,brown,calyx,cm,corolla,curling,dark,decurrent,dia,dry,elliptic,glabrous,globose,golden,green,leaf,less,lobe,lobed,long,material,minute,mm,narrowly,occasionally,opposite,ovary,ovoid-reniform,papillose,pedicel,petiole,plant,poricidal,present,prominent,shrub,stem,stigma,style,tan,tip,treelet,trichome,tube,unifoliate,uniseriate,vein,way,white,widened,x,yellowish	.25,1.2-1.5,4-10-flowered,5-7,age,anthesi,apar,arching,aspect,ba,bark,basal,becoming,berry,branch,branche,corky,deflexed,deltoid,densely,eaf,edicel,eed,ellipsoid,elongate,erect,evenly,except,exserted,f,filament,filiform,flattened,free,fruiting,geminate,gently,giving,glabrate,lamina,lateral,lenticellat,like,lon,lower,m.,main,middle,midrib,minutely,narrow,nflorescence,non-reproductive,obovoid,older,pagoda-like,pair,pitted,pore,portion,pubescent,raised,rarely,reddish-brown,reflexed,ruit,scar,shaped,short,simple,slender,slight,slightly,small,soon,spaced,straight,strongly,styl,surface,tall,tapering,tear-drop,tub,ud,unit,widening,widest,winged,woody,ympodial,young,zig-zag	adhesion,arrangement,blade,climate,colour,diameter,form,fruit,glandular,growth,hair,height,history,inflorescence,length,life,margin,midpoint,na,number,peduncle,perennial,position,presence,pubescence,ray,reproduction,seed,shape,size,staman,stellate,stipe,texture
263	wfo-0001027613	success	238	118	93	145	25	0.391	.5,0.1-0.6,0.2-1.6,0.4-1,0.5-0.6,0.5-0.7,1.5-2,1.5-3,2-2.2,2-2.5,2-3,2-5.6,2.3-2.6,3-4,3-5,4-5,4-8,4.5-9.5,5-18,6-12.5,7-12,9-10.5,abaxially,acute,andromonoecious,anther,apex,base,blade,broadly,brown,calyx,campanulate,chartaceous,circular,cm,connivent,cordate,corolla,dark,diameter,extra-axillary,fruit,glabrous,gland-tipped,glandular,globose,green,hair,herbaceous,inflorescence,inserted,length,lilac,lobe,lobed,margin,midpoint,mm,moderately,nearly,obtuse,ovate,pale,pedicel,peduncle,petiole,plant,present,prostrate,purple,ray,reniform,resprouter,rotate,shallowly,short,simple,somewhat,sparsely,sprawling,stellate,stellate-pubescent,stigma,streak,style,tan,throughout,tube,weakly,x,yellow,yellowish-green	%,0-0.1,0.1-0.7,0.3-0.4,0.3-1,0.4-0.5,0.4-1.2,0.4-1.5,0.7-1.5,0.8-1.7,1-1.5,1-1.7,1-10,1-2,1-7,1.2-1.4,1.2-2,1.3-1.8,10-17,12-15,15-100,15-28,2-5,2-7,2-8,2-foliate,2-locular,20-50,3-6,30-100,36-70,4-7,5,5-6,5-8,5-merou,7-8,80-180,9-17,absen,absent,abundant,accrescent,acicular,across,adaxially,adult,alyx,and/or,anvil-shape,apart,armed,articulated,attenuate,axe,ba,bitter,branche,capitat,clear,contiguous,cross-section,curved,cylindrical,decimetre,deltate,densely,directed,distall,distally,distributed,eaf,eed,eglandular,exocarp,filament,finger,flattened,flower,fruiting,functional,geminat,half,heterostylous,index,interpetalar,juicy,lamina,lateral,less,lobing,lon,lonf,long,longer,lower,markedly,mature,mesocarp,mid-point,midvein,minute,minutely,moist,nflorescence,oblique,orolla,part,per,placenta,pore,porrect,presen,prickle,pubescent,rachi,reticulate,ruit,sessile,side,spaced,stage,stalk,stalked,stellae,straight,surface,tal,tamen,tem,thick,thicker,time,tissu,tissue,transparent,triangular,unbranched,unit,uvenile,vary,vein,watery,wide,ympodial	adhesion,arrangement,capitate,climate,colour,form,growth,height,history,leaf,life,na,number,ovary,position,presence,pubescence,reproduction,seed,shape,size,staman,stem,stipe,texture
264	wfo-0001027618	success	202	115	80	122	35	0.396	0.5-1,1-23,1-3,1-5,1-9,1.4-4,2-11,2-11.5,2-27,2-5,2-8.5,2.5-6,3-30,3-5,4,4-8,5-30,5-7.5,8-16,8-35,abaxially,adaxially,apex,base,blade,branched,campanulate,capitate,chartaceous,cm,compound,cordate,cuneate,densely,diameter,ellipsoidal,elliptic-ovate,entire,fruit,fusiform,glabrous,globose,greenish,leaf,length,lobe,long,margin,membranaceous,minutely,mm,oblong,orange,papillose,pedicel,peduncle,per,petiole,pinnately,puberulent,puberulent-pubescent,pubescent-pilose,purple,reticulate,shrub,simple,stigma,style,sympodial,tomentose,tree,truncate,tube,unbranched,unit,urceolate,white,wide,x,yellow	-10,-pubescent,0-10,0.5,0.5-6,1,1-,1-1.5,1-13,1-14,1.5-13,1.5-3,1.5-7,1.5-8.5,11-16,11-22,11-pinnate,12-27,15-30,15-35,2-12,2-9,3-18,3-7,3-7-pinnate,3.5-6,5-18,5-20,5-merous,5.5-12,6-25,6-40,7-25,acuminat,acut,acute,aggregate,also,alyx,apart,ape,articulated,ascending,axe,basal,beyond,bud,cell,connective,cylindrical,darker,deltate,dia,diamete,dilated,directed,distally,eaf,eed,elliptic,exceeding,exserted,fleshy,flower,lateral,laterally,leaflet,leaving,less,lon,longitudinal,lower,mesocarp,moderately,near,nflorescence,nther,obovate,obtu,obtuse,often,orolla,ovate,pedicellar,perfec,perfect,petiolule,pilo,pilose,pore,presen,puberulent-pilo,pubescent,rachi,radiu,ranch,ratio,remnant,ripe,rown,ruit,runk,shallowly,shorter,slightly,small,sometimes,somewhat,spaced,sparsely,spreading,stamen,stone,stripe,tal,terminal,thecae,triangular,uni,vary,width,without	acuminate,adhesion,anther,arrangement,calyx,climate,colour,corolla,form,glandular,growth,hair,height,history,inflorescence,life,midpoint,na,number,ovary,perennial,plant,position,presence,pubescence,ray,reproduction,seed,shape,size,staman,stellate,stem,stipe,texture
265	wfo-0001027622	success	203	114	89	114	25	0.438	.5,0-14,0.3-10,1-2,1.5-3.5,12-23,2-25,2-6,2.5-3.5,3-4,3-4.5,3.5-11,6-17,6-7,8-16,abaxially,adaxially,along,anther,axillary,blue,blue-purple,broadly,brownish,bud,chartaceous,ciliate,clavate,cm,condition,connivent,corolla,diameter,drying,elliptical,especially,fresh,fruit,glabrescent,glabrous,globose,green,greenish,hair,herb,lanceolate,light,like,lobe,long,margin,membranous,middle,midrib,minutely,mm,mottled,narrowly,odd-pinnate,ovate,ovoid,pale,pedicel,peduncle,pentagonal,petal,petiole,plant,puberulent,pubescent,purple,seed,size,slightly,star,stellate,stem,stigma,striped,style,subglabrous,subtending,terminal,tip,tube,tuber,whitish,x,yellow	0-16,1,1-10,1.5-4.2,1.6-4.5,1/,2-3,3-16,4-5,4-9.5,5-11,5-merou,8-20,acumen,acuminate,acute,ag,alyx,apart,apex,apparently,articulated,axe,base,berry,blade,borne,capitat,cell,covering,decumben,different,digestion,distal,dorsally,eaf,edge,eed,elliptic,end,enzyme,erect,exceeding,except,filament,flat,flower,folded,forked,geminat,generally,glabrou,greatly,green-white,hair-like,half,homostylous,honeycomb-shaped,interjected,lateral,leaflet,lengthening,living,lower,make,mucilaginous,nflorescence,oblique,often,orolla,ovate-lanceolate,pair,perfect,petiolule,plurifoliate,population,pore,poricidal,proximal,reduced,removed,rounded,ruit,seudostipule,shortly,singly,slit,sometimes,spaced,specimen,stamen,ste,stolo,straight,subequal,tall,tamen,tem,testal,thick,throughout,tri-,truncate,typically,unit,unwinged,usually,vary,varying,wall,wet,wide,wing,ympodial	adhesion,arrangement,calyx,capitate,colour,form,growth,height,history,inflorescence,leaf,length,life,na,ovary,perennial,position,presence,present,pseudostipule,pubescence,reproduction,shape,staman,texture
266	wfo-0001027624	success	189	99	76	113	23	0.402	0.1-0.9,0.3-1,0.5-1.5,1-3,1.1-8.4,1.2-2.6,1.3-2.9,2.4-4.8,3-10,3-11,3-4,4-15.2,4-7,4-8,5-9,6-18.5,9-41,abaxially,acumen,adaxially,anther,axillary,brownish,bud,clavate,cm,condition,corolla,deep,densely,diameter,drying,entirely,fresh,fruit,glabrous,globose,green,greenish,hair,herb,lanceolate,leaf,light,like,lobe,long,mm,moniliform,mottled,odd-pinnate,ovoid,pedicel,peduncle,pentagonal,petiole,plant,pubescent,purple,rotate,seed,short,size,sometimes,stigma,style,subtending,terminal,tube,tuber,usually,white,whitish,wide,x,yellow	0-3,0-7,0.4-3,0.8-5.6,1-2,1-5,1.5-6.6,2-20,2-5,2-7,2.9-12,3-5,5-merou,acuman,acuminate,acute,ag,along,alyx,apart,apex,apparently,arranged,articulated,axe,base,bead,berry,blade,capitat,cell,connivent,considerably,covering,cuneate,decreasing,decumben,decurrent,digestion,distal,dorsally,eaf,edge,eed,elliptic,enzyme,erect,exceeding,filament,flat,flower,folded,forked,geminat,glabrou,green-white,hair-like,half,homostylous,honeycomb-shaped,interjected,larger,lateral,leaflet,leave,lengthening,living,lower,make,middl,mucilaginous,multiple,necklace,nflorescence,onto,orbicular,orolla,ovate,pair,perfect,plurifoliate,pore,poricidal,present,rachi,removed,ruit,sessile,seudostipule,slightly,slit,spaced,specimen,stamen,stolon,straight,tall,tamen,tem,testal,thick,throughout,tip,toward,tri-,typically,unit,unwinged,vary,wall,wet,widely,ympodial	adhesion,arrangement,calyx,capitate,colour,form,growth,height,history,inflorescence,length,life,na,ovary,perennial,position,pseudostipule,pubescence,reproduction,shape,staman,stem,texture
267	wfo-0001027626	success	152	94	67	85	27	0.441	.3,.5,0.2–0.6,0.5–1,0.7–1,1,1.3–4.5,1.5–2,13–14,2–49,2–5,3–4,3–55,4.4–11,4–6,5–6,8,9–18,abaxially,adaxially,along,anther,arrangement,calyx,center,chartaceous,cm,cordate,coriaceous,densely,diameter,distichous,elliptical,extra-axillary,fleshy,flower,fruit,glabrous,greenish-white,leaf-opposed,liana,lobe,midvein,minutely,mm,moderately,nearly,ovate,pedicel,peduncle,petal,petiole,possibly,pubescent,rachi,scandent,shrub,somewhat,spindle-shaped,stellate,stigma,style,terminal,tube,unknown,white,x	0.1–0.2,0.5-1,0.7–2.8,1.5–8,14–116,2–3,3–4.5,3–5,5-merous,accrescen,acuminate,acute,alyx,apar,apex,axe,base,berry,blade,broadly,c.,capitat,ciliat,clavate,climbing,color,distant,distinct,eaf,eed,entire,filament,frequently,fruiting,glabrou,immature,lamina,lanceolate,line,long,lower,m.,margin,maturity,membranous,mor,nflorescence,nternode,oblique,orolla,pair,perfec,pinnate,plurifoliat,pointed,reflexed,rounded,ruit,sand-punctat,sand-punctate,scar,secondary,seen,shortly,side,simple,slender,spaced,sparsely,ste,tamen,tem,time,tip,trichome,truncate,two,unbranched,unit,vary,vein,venation,wide,wiry-woody,ympodial	adhesion,capitate,colour,corolla,form,growth,height,history,inflorescence,leaf,length,life,na,ovary,perfect,plant,position,presence,present,pubescence,reproduction,seed,shape,size,staman,stem,texture
268	wfo-0001027627	success	245	119	74	171	45	0.302	.1,abaxially,acuminate,adaxially,anther,apex,base,blade,broadly,brown,calyx,chartaceous,cm,cordate,corolla,densely,diameter,entire,extra-axillary,flattened-reniform,free,fruit,glabrescent,globose,green,hair,lateral,lavender,leaf,lighter,linear,linear-lanceolate,lobe,loosely,margin,midpoint,mm,narrowly,obtuse,ovary,ovate,pedicel,peduncle,petiole,present,pubescence,pubescent,purple,ray,rounded,shallowly,shrub,simple,sinuate,slender,sometimes,sparsely,stellate,stellate-pubescent,stellate-tomentose,stem,stigma,stipe,style,tapering,tardily,thick,tomentose,tube,usually,velvety,violet,yellow,×	.5,0.05–0.25,0.1–1,0.3,0.4,0.6–1,0–,1.5,1.5–2,1.5–2.5,1.8–2.5,11–14,12–25,13–17,1–1.5,1–5,2,2.5–4,2–15,2–4,2–5,2–6,3.5,3–3.5,3–6,4–,4–12,5-angled,5-merou,5–7,6–,6–15,7–10,7–15,9,9–13,9–15,abundant,accrescent,across,along,alyx,ampliate,apart,apparently,articulated,ascending,axe,ba,band,based,becoming,berry,bifurcate,borne,branch,branched,briefly,broad,bud,c.,capitat,caudate,central,contiguous,dense,difoliate,distal,distally,eaf,eed,erect,evident,except,exposed,extensively,fertile,filament,filiform,flower,flowering,geminat,glabrous,grayish,growt,half,high,homostylous,internode,interpetalar,interwoven,juvenile,larger,like,line,long,longer,lower,major,middle,midvein,minor,minute,minutely,mostly,much,narrow,near,nearly,nflorescence,numerous,oblong,occasionally,often,ovoid,paired,par,pitted,portion,prickle,principal,prominently,recurved,reduced,ruit,scattered,short,shorter,side,single,sinus,small,smaller,somewhat,spaced,sparse,splitting,spreading,stalk,stalked,stellae,stellate-tomento,stellate-velvety,stemmed,stout,subeaqually,surface,tamen,tawny,thickened,time,tip,tissue,tree,triangular,trunk,ud,unarmed,unequally,vein,visible,weakly,wide,yello,ympodia,young,zone,×1.5–1.7,–2.5,–30,–5	0-2-15,0.3-0.4,0.6-1,1-1.5,1-5,1.5-1.7,1.5-2.5,1.8-2.5,12-25,13-17,2-4,2-6,2.5-4,3-6,4-,4-12,5,7-10,7-15,9-13,adhesion,arrangement,capitate,climate,colour,form,glandular,growth,height,history,inflorescence,length,life,na,number,perennial,plant,position,presence,reproduction,seed,shape,size,staman,texture
269	wfo-0001027630	success	149	80	58	91	22	0.389	.1,.5,0.05-0.1,0.5-1,0.5-1.2,0.5-2,1-5,1.4-1.7,1.5-2,3/4,4-6,5.5-11.2,8-9,anther,base,calyx,climbing,cm,corolla,dia,extreme,fruit,glabrous,globose,golden,hirsute,internodal,lanceolate,leaf,linear,lobe,lobed,long,minutely,mm,occasionally,opposite,ovary,paler,papillose,pedicel,petiole,puberulent,pubescent,shaped,shrub,sparsely,stem,stigma,style,tear-drop,tip,trichome,tube,uniseriate,way,white,x	.2,1-1.5,2-3,2-6-flowered,6-10,acute,also,anthesi,apart,apex,arising,bark,beginning,berry,blunt,branchlet,broadly,ciliate,de,decurrent,deflexed,deltoid,densely,distinguishable,eaf,edicel,eed,elongat,erose,except,filament,free,fruiting,glabrate,globo,green,immature,indistinct,inflorescenc,irregularly,knob-like,known,lateral,lon,long-acuminate,lower,main,margin,middle,midrib,near,nflorescence,novo,older,pair,partially,pore,poricidal,portion,prominent,proximal,raised,reflexed,rest,rounded,ruit,scar,seen,simple,slender,spaced,straight,strongly,swollen,tall,tapering,terminal,thickened,ti,ud,ultimate,unifoliat,unit,vein,wide,widest,wing,winged,yellowish,ympodial,young	adhesion,arrangement,colour,diameter,form,growth,height,inflorescence,length,na,peduncle,plant,position,presence,pubescence,seed,shape,size,staman,stellate,texture,unifoliate
270	wfo-0001027646	success	166	88	58	108	30	0.349	0-0.1,0.15-0.25,0.2-1.1,0.4-0.5,0.4-0.6,0.6-0.7,1-3,2-4,3.5-4,5-10,6-8,absent,acuminate,acute,adaxially,anther,apex,base,blade,calyx,chartaceous,cm,cuneate,densely,diameter,eglandular,entire,extra-axillary,flattened,fruit,glabrous,globose,hair,inflorescence,length,lobe,margin,midpoint,mm,obtuse,ovate,pale,pedicel,peduncle,perennial,petiole,present,ray,red,reniform,shrub,simple,sparsely,stellate,stellate-pubescent,style,x,yellow	%,.4,0-0.2,0-1,0-10,0-2,0.1-0.25,0.5-0.6,0.7-1.2,0.7-1.5,0.7-2,1,1-2,1-6,1-locular,10-18,15-20,2-6,2-foliate,2.1-3.2,4-11,5-merou,6-13,6-7,abaxially,absen,acicular,across,adaxiall,adult,alyx,apart,articulated,axe,ba,branche,brown,confined,cylindrical,directed,distall,dm,eaf,eed,erect,finger,flower,fruiting,functional,geminat,gland-tipped,green,grey,half,incomplete,juicy,lamina,lateral,less,long,longer,lower,mature,mesocarp,midrib,midvein,minute,moderately,multiradiate,nflorescence,oblique,onl,orolla,part,per,pore,porrect,prickle,probably,pseudo-umbellate,rhizomatous,ruit,septum,short,solitary,spaced,stage,stalk,stellae,straight,succulen,tal,tamen,tem,thick,throughout,time,transparent,unarme,unarmed,unbranched,unit,unknow,uvenile,vary,wide,yellowish,ympodial	adhesion,arrangement,climate,colour,corolla,form,glandular,growth,height,history,leaf,life,na,number,ovary,plant,position,presence,pubescence,reproduction,seed,shape,size,staman,stem,stigma,stipe,succulent,texture,tube
271	wfo-0001027661	success	222	109	87	135	22	0.392	+,0.5,0.5-2,0.6-1.1,0.6-1.5,1-1.5,1-7,1.2-6,1.5,1.5-2,2.5-7,4.5-6,5-9,6-12,8-10,<,anther,base,branch,bright,calyx,capitate,cm,column,connivent,cordate,corolla,deeply,dendritic,diameter,ellipsoid,elliptic,flattened,fused,glabrous,globose,growth,herbaceous,lateral,leaf,lobe,lobed,long,margin,membraneous,minutely,mm,ovate,pale,papillate,pedicel,peduncle,perfect,petiole,pinnatifid,pubescence,purple,red,reniform,ripe,shape,shiny,short,simple,single,size,stellate,stem,stigma,style,tan,terminal,ternately,thin,tightly,tip,trichome,tube,uniseriate,vine,violet,way,white,wide,woody,yellow,¾	-10,0.5-,1-,1-5,1.3,2,2.5-3,30,4-15,4-8-celled,40,5-merou,6-8,6-9,>,abaxially,acuminate,acute,adaxiall,ag,along,alyx,anthesi,apart,apex,ark,articulate,axi,basal,berry,branched,broadly,cell,commonly,conical,creeping,densely,denser,density,eaf,eed,entire,even,extremely,filament,flower,free,fruiting,gre,green,grey,ground,hue,ilament,irregularly,lamina,leaf-opposed,leaving,lengthening,like,long-exserted,lower,many,markedly,minute,mixture,moderately,narrowing,near,new,nflorescence,occasionally,often,older,open,orolla,outline,pair,papillat,papillo,peg,pentagonal,per,pericarp,pitted,plurifoliat,pointed,pore,poricidal,portion,primary,prominent,pubescen,pubescent,purplish,rachi,rarely,reflexed,ruit,scar,sinus,sleeve,slender,slit,small,spaced,sparsely,spot,spreadin,spreading,strongly,surface,swollen,tangled,tem,testa,time,trailing,triangular,truncate,turbinate,two,type,ud,underground,unieriate,unit,upper,usually,variable,vary,vein,yellowish,ympodial,zig-za	0.5-7,1,adhesion,arrangement,colour,form,fruit,height,history,inflorescence,length,life,na,ovary,plant,position,presence,present,reproduction,seed,staman,texture
272	wfo-0001027714	success	251	136	109	142	27	0.434	+,/3,0.5,1-,1-1.5,1-1.6,1-2,1.5-2,1.5-5,14-16,2-,2-2.5,2-8,2.5-,2.5-4,3-3.5,4-10,4-5,4.5-5,5,5-6,7-20,<,acuminate,acute,almost,anther,apex,basal,base,berry,bright,brown,calyx,capitate,cm,confined,connivent,cordate,corolla,cucullate,deep,densely,diameter,ellipsoid,elliptic,elongate,entire,flattened,fleshy,fruit,glabrous,globose,growth,inflorescence,juicy,lamina,lateral,leaf,lobe,lobed,long,loosely,margin,mm,obovate,occasionally,often,otherwise,ovary,pair,pale,papillate,pedicel,peduncle,petiole,pubescence,pubescent,purple,red,reddish,reniform,ripe,seed,shiny,simple,slightly,small,somewhat,sparsely,stellate-rotate,stem,stigma,style,terminal,thick,thin,tip,trichome,truncate,tube,uniformly,vein,vine,violet,way,woody,x,yellow	.5,0,0.4,0.5-0.7,0.6-0.7,0.9-1.5,1,1.5-2.5,1.5-3,2373.,5-10,5-merou,6-7,80,abaxial,abaxially,adaxial,adaxially,age,aid,along,alyx,angle,anthesi,apar,apice,appearance,ark,around,articulated,axi,branched,canop,cell,channelled,climbin,conical,connected,corky,creating,cupped,deflexed,dendritic,denser,drying,eaf,eed,enlarged,especially,exserted,fide,filament,flower,free,fruiting,furcate,giving,glabrate,glabrou,groove,hairy,hanging,ilament,immature,individual,inflated,irregularly,large,leaving,lengthening,like,lon,longer,lower,many,marginal,mature,mere,minute,minutely,mpodial,nee,new,nflorescence,nodding,older,orolla,outline,papillo,peg,per,perfect,pericarp,petal,petiolule,pinnatifid,pitted,plat,plurifoliat,pore,poricidal,portion,primary,prominent,reaching,rectangular,rim,ruit,scar,showy,similar,sleeve,slender,slit,spaced,spreading,strongly,surface,tangled,tem,testa,testal,thecae,thickened,third,time,tiny,tooth,twining,ud,uniseriate,unit,upper,usually,visible,wall,weak,weight,widest,wing,yellowish,younger	adhesion,arrangement,blade,climate,colour,form,glandular,hair,height,history,length,life,midpoint,na,number,plant,position,presence,ray,reproduction,shape,size,staman,stellate,stipe,texture,ye
273	wfo-0001027719	success	172	106	78	94	28	0.453	0-0.15,0-7,0.15-0.4,0.3-0.5,0.3-0.7,0.6-2.8,0.9-1.1,1.6-1.9,10-24,2-2.3,3-5,3-7.5,4-5,4-6,4.5-12.5,5-6,5-8,8-13,absent,acute,adaxially,andromonoecious,anther,apex,base,blade,broadly,calyx,chartaceous,cm,cuneate,densely,diameter,entire,extra-axillary,flower,fruit,gland-tipped,globose,green,hair,herbaceous,inflorescence,length,lilac,lobe,lobed,long,margin,mid-point,midpoint,mm,moist,oblique,obtuse,ovate,pale,part,pedicel,peduncle,petiole,plant,present,ray,resprouter,shallowly,short,simple,sparsely,stellate,stellate-pubescent,stem,strongly,style,thick,tube,x,yellow	%,.25,0-0.2,0-1,0-20,0.25-0.4,0.25-0.6,0.4-1.7,0.6-0.8,0.8-1,1-1.5,1-2,1-3,1.1-2,13-20,13-25,3-7,30-70,4-7,5-merou,6-10,6-8,7-11,abaxially,acicular,across,adaxiall,alyx,apart,armed,articulated,attenuate,axe,ba,brown,d.,difoliate,directed,distall,distributed,dult,eaf,eed,eglandular,erect,exocarp,finger,fruiting,functional,geminat,greenish-white,half,heterostylous,hig,juic,lamina,lateral,less,longer,lower,mature,mesocarp,midvein,minute,nflorescence,orolla,per,pore,porrect,presen,prickle,pseudo-racemose,ruit,sessile,solitary,spaced,sprawling,stage,stalk,stellae,straight,tamen,throughout,time,unarme,unbranched,unit,unknow,uvenile,vary,vein,white,wide,ympodial	adhesion,arrangement,climate,colour,corolla,form,glandular,growth,height,history,juicy,leaf,life,na,number,ovary,perennial,position,presence,pubescence,reproduction,seed,shape,size,staman,stigma,stipe,texture
274	wfo-0001027720	success	184	80	57	127	23	0.31	0.25-0.35,0.3-5,0.4-0.7,0.5-0.8,0.8-1,1-2,1-3.5,1.5-2,13-35,2-3,2-4,2-7,4-5.5,4-7,4.3-15,7-8,anther,calyx,chartaceous,cm,connivent,diameter,elliptic,extra-axillary,fruit,glabrous,globose,hair,inflorescence,lanceolate,leaf,length,lilac,lobe,loosely,mm,ovate,pale,pedicel,peduncle,perennial,petiole,present,pubescent,red,rhizomatous,shrub,simple,sparsely,stellate,stellate-pubescent,stigma,style,subreniform,tube,x,yellow	%,.25-0.3,0,0-15,0.15-0.25,0.4-0.8,0.5-1,0.6-1.2,1-1.5,1-locular,13-23,15-25,2-branched,2-foliate,2.8-3.1,23-35,3-13,4-,4.3-7.5,5-merous,6,7-10,7-9,8-11,8-16,9-15,abaxially,absen,absent,acute,adaxiall,adaxially,adult,alyx,apex,apparently,articulated,axe,ba,base,berry,blade,brown,capitat,confined,cuneate,cylindrical,deltate,densely,directed,distall,distally,eaf,eed,eglandular,entire,erect,filament,finger,flattened,flower,fruiting,geminat,gland-tipped,green,half,hig,homostylous,incomplete,intepetalar,juicy,juvenile,lamina,lateral,less,long,lower,margin,markedly,mature,mesocarp,mid-point,midpoint,midrib,minute,narrowly,nflorescence,notched,oblique,orolla,part,per,perfec,perfect,pore,porrect,prickle,rachi,ray,ruit,scarce,septum,sessile,short,slightly,stellae,straight,succulen,surface,tamen,tem,thick,thicker,time,tissue,toward,triangular,unarme,unarmed,unit,upper,vary,white,wide,without,yellowi,ympodial	adhesion,arrangement,capitate,colour,corolla,form,growth,height,history,life,na,ovary,plant,position,presence,pubescence,reproduction,seed,shape,size,staman,stem,texture
275	wfo-0001027720	success	272	152	103	169	49	0.379	.04,.2,.3,.9,1/3,10.0,2.0,abaxially,acuminate,acute,adaxially,adnate,anther,apex,attachment,attenuate,base,becoming,bilobed,blade,broad,calyx,capitate,cm,conical,corolla,cream,curved,densely,developed,diameter,dry,elliptic,entire,erect,especially,extra-axillary,flattened-irregular,flattened-orbicular,flattened-reniform,flower,fruit,glabrous,glandular,globose,growth,hair,internode,interpetalar,juvenile,lateral,lavender,leaf,lobe,long,margin,mature,midpoint,minute,mm,moderately,notched,orange,ovate,pedicel,peduncle,petiole,point,poorly,porrect,portion,proximal,pubescent,ray,red,sessile,short,shrub,simple,slightly,small,stellae,stellate,stem,stigma,straight,style,subacute,subcoriaceous,tissue,toward,tree,tube,upper,violet,wavy,way,white,yellow,yellow-ferruginous,yellow-tan,young,×	.0,.5,0,0.1–0.6,0.2–0.4,0.3–0.4,0.7–0.9,0.7–1.1,0.7–1.2,0.8–1.3,0.8–1.9,0.8–2.0,0.9,1.4–1.9,1.5–1.7,1.5–2.0,1.5–2.5,1.5–3.3,1.5–9.0,1.7–1.8,1.7–2.0,1.7–2.5,1.8–2.0,1.9–2.2,1/2,1/3–1/2,10.8–18.2,12–16,13.0,19.7–30.0,2.5,2.5–2.8,2.5–2.9,2–3,3.2,3.6,3.7–5.7,3.9,4.0–12.6,4.0–18.0,4–5-merou,5.1–18.6,6.5–9.5,6–8,8.0,8.0–11.9,8.2–10.5,8.5–9.4,9.5–16.0,aequilateral,alyx,anthesi,apical,apiculate,apparently,appearing,armed,articulated,axe,ba,berry,branch,broad-based,brochidodromous,bud,cancellate,channel,channeled,colore,concave,congested,connivent,crisped,deciduous,dehiscence,dentate,difoliate,distally,dorsally,eaf,eed,either,emerging,endocarp,exocarp,fertile,filament,filiform,free,geminat,glossy,gradually,heavily,homostylous,hooked,inclined,increasing,intersepalar,juic,lamina,large,least,like,line,lon,longer,lower,m.,major,midrib,midvein,minor,narrowly,nearly,nflorescence,oblique,oblong,occasionally,often,orolla,part,per,perforate,pore,porrect-stellate,potentially,presumably,prickle,raised,reflexed,rigid,rip,row,ruit,scattered,shorter,side,sinus,soon,sparsely,splitting,spread,stamen,stellate-pubescen,stellate-pubescent,surface,suture,tall,tamen,tem,thin,time,tip,translucent,triangular,truncate,twice-branched,two,ud,unarmed,vary,vein,weakly,wide,yellow-ferruginou,ympodia,youngest,±equal,–4	0.1-0.6,0.2-0.4,0.3-0.4,0.7-1.1,1.4-1.9,1.5-2.5,1.5-3.3,1.5-9.0,1.7-2.5,1.8-2.0,1/3-1/2,19.7-30.0,2-4,2.5-2.8,3.7-5.7,4.0-12.6,4.0-18.0,5.1-18.6,6-8,6.5-9.5,8.0-11.9,9.5-16.0,adhesion,arrangement,climate,colored,colour,form,height,history,inflorescence,length,life,na,number,ovary,perennial,plant,position,presence,present,pubescence,reproduction,seed,shape,size,staman,stipe,texture
276	wfo-0001027735	success	166	89	60	106	29	0.361	.7,.75,0-0.1,0.25-0.5,0.3-0.6,0.5-3,1.3-3.5,1.7-3.5,2-2.5,2-3.5,2.5-3,3.5-5,4-5,4-8,5-5.8,7-10.5,8-11,acuminate,acute,anther,apex,base,blade,calyx,chartaceous,cm,diameter,extra-axillary,fruit,inflorescence,lateral,length,lobe,lobed,long,margin,mm,obtuse,ovate,pale,pedicel,peduncle,perennial,petiole,present,ray,rotate-stellate,shallowly,shrub,simple,sparsely,stalk,stellate,stellate-pubescent,style,time,tube,white,x,yellow	%,0-1,0-4,0-5,0.15-0.2,0.4-0.8,0.5-0.8,1,1-2,1.3-1.6,1.9-2.2,10-14,11-17,12-15,2-8,20-35,25-50,3-8,30-50,4-6,5,5-merou,9-12,abaxially,absent,abundant,acicular,across,adaxially,adult,alyx,apart,armed,articulated,attenuate,axe,ba,branche,brown,directed,distall,distributed,dm,eaf,eed,eglandular,erect,finger,flower,fruiting,geminat,glabrou,gland-tipped,globo,green,hair,half,index,lamina,less,lobing,longer,lower,mature,mid-point,midpoint,midvein,minute,moderately,nflorescence,oblique,orolla,part,per,pinkish,pore,porrect,presen,prickle,pseudo-racemose,purpl,rhizomatous,ruit,sessile,short,side,spaced,sparse,stage,stellae,straight,tal,tamen,tem,thick,throughout,transparent,unarme,unbranched,unctional,unit,unknow,uvenile,vein,wide,ympodial	adhesion,arrangement,colour,corolla,form,globose,growth,height,history,leaf,life,na,number,ovary,plant,position,presence,pubescence,purple,reproduction,seed,shape,size,staman,stem,stigma,stipe,texture,unknown
277	wfo-0001027742	success	239	124	95	144	29	0.397	-13,-20,-9,0-0.2,0.1-0.5,0.4-0.8,0.5-5,0.6-0.8,1-1.2,1-2,2-2.5,2-3,2-6,2.5-5,3-6,3-9,3.5-10,3.5-9.5,4-6,4-lobed,5-12,7-10,7-9,abaxially,absent,acute,adaxially,annual,anther,apex,base,black,blade,broadly,brown,calyx,chartaceous,cm,cordate,densely,depressed,diameter,drying,entire,erect,extra-axillary,finally,fruit,glabrous,globose,grey-green,hair,inflorescence,ivory-green,lanceolate,length,lilac,lobe,lobed,long,margin,midpoint,mm,moderately,obtuse,ovate,ovate-lancelate,pale,pedicel,peduncle,perennial,petiole,present,prostrate,purple,ray,rhizomatous,shallowly,shrub,simple,somewhat,square,stellate-pentagonal,stellate-pubescent,stem,stigma,style,throughout,truncate,tube,white,x,yellow,yellowish,yellowish-green	%,-8,0-0.8,0-1.1,0-12,0-3.5,0-9,0.05-0.1,0.1-0.4,0.6-0.9,0.7-0.9,0.8-1.8,1-,1-1.1,1-1.5,1-1.8,1-3,1-4,1-5,1-8,1.7-2,10-18,10-20,2-,2-2.3,2-5,2-5.5,2-foliate,200-660,25-55,3-4,3-5,4-locular,5-merou,60-300,7-8,9-14,abundant,accrescent,acicular,adaxiall,alyx,anthesi,anvil-shape,apart,armed,articulated,attenuate,axe,ba,bent,broad,capitat,cone,connivent,cross-section,curved,cylindrical,decimetr,directed,distall,distally,distributed,dult,eaf,eed,eglandular,enclosing,especially,exceeding,exocarp,filament,finger,flower,fruiting,geminat,gland-tipped,homostylous,index,interpetalar,juicy,lamina,lateral,lobing,lon,longer,loosely,lower,markedly,mature,mesocarp,mid-point,midvein,minute,minutely,moist,nflorescence,oblique,one,orolla,outside,part,per,perfect,placenta,pore,porrect,presen,prickle,pseudo-racemose,rachi,reticulate,rostrate,rounded,ruit,rusty,short,side,slightly,spaced,stage,stalk,stalked,stellae,straight,strongly,surface,tal,tamen,thick,thicker,thicknes,time,tip,tissue,toward,unbranched,unit,unknow,uvenile,vary,vein,wide,ympodial	1-5.5,adhesion,arrangement,capitate,climate,colour,corolla,form,glandular,growth,height,history,leaf,life,na,number,ovary,plant,position,presence,pubescence,reproduction,seed,shape,size,staman,stellate,stipe,texture
278	wfo-0001027757	success	186	115	67	119	48	0.36	0.5,5–,7–8,acute,anther,anthesi,apex,axillary,base,blade,blue,brown,calyx,campanulate,clavate,cm,colour,dark,decurrent,diameter,erect,flattened,fruit,glabrous,globose,hair,irregularly,leaf,lilac,lobe,lobed,long,margin,mm,moderately,multicellular,oblong,obtuse,occasionally,ovate,pale,pedicel,peduncle,perennial,petiole,pubescent,regularly,rotate,shrub,simple,sparsely,stigma,style,tube,unicellular,uniseriate,unknown,violet,white,x,yellow,–19,–2.7,–3.2,–5.5,–6,–9	0.2,0.2–0.3,0.3–2.0,0.6,0.6–1.0,0.7,0–1.4,1.0–1.1,1.0–2.5,1.2–4.0,1.5–1.6,1.5–2.5,1.6–2.4,1.9–2.7,12,1–1.5,1–11,1–2,1–3,2,2.5,2.5–4,2.5–5.5,2.5–7,2–,2–10,3–12,3–5,4–9,5,60–100,6–9,8–16,abaxially,absen,accrescent,adaxiall,adaxially,ag,along,apart,apical,arising,articulated,axe,ba,basal,borne,branching,cell,chartaceous,concave,connivent,convex,cylindrical,deeply,densely,directed,distally,eaf,eed,elliptic,entire,equal,erose,filament,fleshy,flower,geminat,glabrescen,glabrou,lanceolate,leafy,lon,longitudinal,lower,m.,narrowly,nflorescence,often,opening,opposed,orolla,pair,perfect,pitted,plurifoliate,pore,poricidal,primary,probably,rootstock,ruit,secondary,serrate,shoot,side,slit,smaller,sometimes,spaced,stone,straight,surface,tall,tamen,tem,thic,thickened,time,tip,toward,unbranched,unit,vary,wide,woody,ympodial,–4.0	0-1.4,0.2-0.3,0.3-2.0,1-1.5,1-3,1.0-1.1,1.0-2.5,1.2-4.0,1.5-1.6,1.5-2.5,2-10,2.5-4,2.5-5.5,2.5-7,4-9,6-9,60-100,8-16,adhesion,arrangement,climate,corolla,form,glandular,growth,height,history,inflorescence,length,life,midpoint,na,number,ovary,plant,position,presence,pubescence,ray,reproduction,seed,shape,size,staman,stellate,stem,stipe,texture
279	wfo-0001027765	success	167	83	61	106	22	0.365	-30,-44,0.8,1,1-10,1-11.5,1-5,1.5-6,10-13,2-2.5,2-3,2-4,2.5-4.2,20-30,3-12,5-6,5-8,abaxially,calyx,cm,connate,corolla,diameter,distal,forked,glandular,globose,green,green-white,hair,half,herbaceous,interjected,lateral,leaf,leaflet,light,long,mm,odd-pinnate,ovate,ovate-lanceolate,ovoid,pedicel,peduncle,perennial,petiole,pilose,plant,seed,simple,size,stellate,stigma,style,terminal,tone,violet,white,wide,yellow	-4,0-.,1-,1-2,1-4,2.5-4,3-,3-20,3-6-foliat,5,5-15,7-20,abaxial,abruptly,acumen,acuminate,acute,apex,apical,apically,apiculate,articulate,base,branched,cell,cordate,covering,cuneate,cyme,dehiscent,dichasial,dichasially,digestion,diminishing,dorsally,eaf,ebracteate,edge,eed,elliptic,elliptic-lanceolate,emoval,enzyme,exceeding,filament,flat,flower,folded,generally,globo,hair-like,honeycomb,introrse,living,lobe,lon,lower,lunat,make,maturing,monochasial,mucilaginous,nflorescence,nther,oblique,obtuse,often,orolla,ovate-elliptic,pair,pattern,perfect,petiolate,petiolule,plan,poricidally,proximal,reveal,rounded,ruit,sessile,seudostipule,short,side,slightly,slit,specimen,stamen,straight,tal,tem,testal,thick,throughou,throughout,tip,toward,truncate,tuber-bearing,typically,unit,vary,wall,without,ympodial,¼	0-2,3-15,anther,arrangement,color,form,fruit,growth,height,history,inflorescence,length,life,na,number,ovary,position,pubescence,reproduction,shape,stem,texture
280	wfo-0001027767	success	184	103	80	104	23	0.435	0.3-0.5,1,1-1.5,1-2,1.0-2,1.5-1.8,1.5-2,10-12,10-20,2-3,3,3.5-5,4-5,4-many-celled,5-6,5-7,5-8,7-8,anther,apex,attenuate,bicolorous,branch,brown,calyx,clavate,cm,dark,dark-green,deeply,diameter,ferruginous,fruit,glabrous,globose,hirsute-glandular,lanuginose,leaf,long,minutely,mm,oblanceolate,oblong-lanceolate,oval-elliptic,parted,pedicel,peduncle,pendent,petiole,plant,porrect-stellate,prickle,recurved,reniform,sessile,shiny,short,shrub,solitary,stellate,stigma,style,sub-conic,sub-globose,sub-sessile,sub-truncate,subcoriaceous,subreniform,terete,terminal,thick,tomentose,trichome,tube,unarmed,villous,white,wide,winged,yellowish	15-25,2-2.5,2.6-3,3-6-branched,30-many-flowered,5-merous,8-9,abaxial,accrescent,across,acute,along,alyx,anthesi,armed,articulate,attenuat,base,beige,blade,campanulate,central,coriaceous,curved,cyme,distal,eaf,eed,enlarged,entire,epicarp,equal,erect-branched,exceeding,filament,floral,flower,free,fruiting,geminat,glandular,glandular-stalke,glandular-stalked,glandular-stellate,gynoeci,helicoid,indument,irregularly,lobe,lobed,long-exserted,longer,lower,many-celled,midrib,multiangulate,nflorescence,numerous,orolla,papillo,part,peduncl,perennia,perfect,persistent,persistently,plurifoliate,primary,prominent,pubescent,rachi,ranch,ray,reduced,reflexed,rugose,ruit,secondary,similar,small,somewhat,sparse,sparsely,stalked,stamen,staminate,stem,straight,surfac,surrounded,tall,tamen,uniseriate,unit,vary,vein,viscid-glandular,viscid-villous,withi,within,without,yellow,ympodial,young	adhesion,arrangement,colour,corolla,form,growth,height,history,inflorescence,length,life,ovary,papillose,perennial,position,pubescence,reproduction,seed,shape,size,staman,texture,type
281	wfo-0001027768	success	214	104	77	137	27	0.36	.5,0-0.1,0.1-0.3,0.1-0.4,0.15-0.25,0.15-0.3,0.3-1.5,0.5-3.4,0.6-0.9,1-2.5,1.2-1.4,1.5-2,2-2.5,2.9-3.7,3-15,3-4.5,4-5,6-6.5,8-10,absent,anther,apex,attenuate,base,black,blade,brown,calyx,chartaceous,cm,cuneate,dark,densely,diameter,elliptical,entire,flattened,fruit,glabrous,globose,green,hair,inflorescence,lanceolate,leaf,leaf-opposed,length,light,lobe,margin,midpoint,mm,obtuse,pale,pear-shaped,pedicel,peduncle,perennial,petiole,present,purple,ray,rhizomatous,shrub,simple,sparsely,stellate,stellate-pubescent,stigma,streak,style,subcoriaceous,tube,turning,violet,x,yellow	%,0,0-0.2,0-0.3,0-2,0.2-0.3,0.25-1,0.3-0.6,0.3-0.7,0.5-1.5,0.6-1.5,1,1-2,1.2-1.8,1.2-3.4,1.7-2.6,10-15,11-14,15-50,18-35,2-7,2-locular,3,4-,5-7,5-merou,6-12,6-15,7-10,8-12,8-16,abaxiallly,abaxially,accrescent,acicular,across,adaxiall,adaxially,adult,alyx,apart,articulated,axe,ba,branchlet,capitat,confined,connivent,contiguous,curved,cylindrical,deltate,difoliate,directed,distall,distributed,dm,eaf,eed,eglandular,erect,exocarp,filament,finger,flower,fruiting,geminat,gland-tipped,greenish-white,grey,grey-green,half,hig,juicy,juvenile,lamina,lateral,less,long,longer,loosely,lower,mature,mesocarp,mid-point,midrib,midvein,minute,minutely,moist,narrowly,nearly,nflorescence,oblique,orolla,part,per,perfect,placenta,pore,porrect,prickle,pseudo-racemose,pubescent,rachi,reddish,reticulate,ruit,semi-circula,sessile,short,smooth,solitary,somewhat,spaced,spongy,sprawling,stellae,straight,surface,tamen,tem,thick,throughout,time,toward,triangular,unarme,unarmed,unbranched,unit,vary,white,wide,winged,yellowish,ympodial	adhesion,arrangement,capitate,climate,colour,corolla,form,glandular,growth,height,history,life,na,number,ovary,plant,position,presence,pubescence,reproduction,seed,shape,size,staman,stem,stipe,texture
282	wfo-0001027770	success	242	104	81	161	23	0.335	0.1-0.3,0.2-2,0.3,0.6-1.2,0.8-2.5,1-2,1-3,1.5,12,2,2-3,2-4,2.5-3,3,3-5,3-6,4,4-8,6,6-10,7-15,abaxially,adaxially,anther,base,berry,calyx,clavate,cm,dark,densely,diameter,elliptic,equal,flattened,fruit,glabrous,globose,herbaceous,lateral,leaf,length,like,lobe,lobed,long,maturity,mm,mostly,narrowly,orange,orange-brown,ovoid,pale,pedicel,peduncle,perfect,petiole,plant,present,pubescent,reniform,simple,smooth,spherical,spreading,stellate,stellate-pubescent,stem,stigma,style,tapering,terminal,thin,tube,violet,white,wide,woody,yellow,young	0-45°,0.1-0.15,0.15,0.3-2,0.5,0.5-1,0.5-2,0.8-1.5,1-2.5,1-5,1.5-2,1/2-1/6,10-14,12-14,16,2-6,2/3,20,3-4,4-6,4-7,5-30,5-merous,50,7,9,acute,ag,almost,alyx,anthesi,apart,apex,apically,apparently,armed,articulated,bark,blade,branching,brown,c.,concolorous,cuneate,cuspidate,deltate,dense,difoliate,dilated,distance,drying,eaf,eed,elongating,entire,erect,extending,eye,filament,filiform,flat,flower,free,fruiting,geminat,gray,green,horizontal,infructescence,irregular,lanceolate,lengthening,less,lon,longer,lower,margin,markedly,mature,midpoint,midvein,naked,nflorescence,oblique,obscured,obtuse,often,older,orolla,oung,ovate,pair,papillate,papillo,pendulous,per,pericarp,pore,poricidal,porrect,portion,prickle,prickly,primary,prominent,pubescenc,raised,rare,rarely,ray,red,reduced,reduced-multangulat,reflexed,rounded,ruit,scar,sessile,shallowly,short-styled,side,slightly,small,sometimes,somewhat,spaced,sparse,sparsely,stalk,staminat,stolon,straight,stump,subsessile,surface,tall,tamen,terete,tertiary,throughout,time,tip,toward,trichome,unarme,unarmed,underground,uniform,unit,usually,variously,vary,vein,venation,visibl,visible,way,white-green,yellow-green,ympodial,½	20-50,adhesion,arrangement,colour,corolla,form,growth,height,history,inflorescence,life,na,ovary,papillose,position,presence,pubescence,reproduction,seed,shape,size,staman,texture
283	wfo-0001027807	success	116	83	45	71	38	0.388	0-0.2,0.1-1,0.2-0.3,0.2-0.9,0.3-0.4,0.9-1,0.9-2.5,2-5,3.5-9,acuminate,acute,apex,attenuate,base,brown,cm,diameter,dry,elliptic,flattened,glabrous,globose,green,growth,internodal,lanceolate,leaf,leaf-opposed,margin,material,mm,narrowly,occasionally,pedicel,peduncle,petiole,reddish,reniform,revolute,shrub,simple,small,stem,tree,x	.5,1-1.5,15-30,2-6,abaxially,adaxially,almost,barely,bark,berry,brittle,bud,closely,decurrent,deflexe,deflexed,difoliate,drying,eaf,eed,ellipti,flower,fruiting,geminat,gray,grayish,know,known,maturity,midrib,minutely,new,nflorescence,older,ot,overlapping,pair,pale,paler,papillae,papillate,parallel,pitted,plane,primary,prominent,rachi,reddi,reproductive,ruit,scar,seemingly,shoot,slender,slightly,somewhat,spaced,sparsely,surface,thickened,ud,unifoliate,unit,usually,vein,visible,white,winged,yellowish,ympodial,young	adhesion,anther,arrangement,blade,calyx,climate,colour,corolla,form,fruit,glandular,hair,height,history,inflorescence,length,life,lobe,midpoint,na,number,ovary,plant,position,presence,pubescence,ray,reproduction,seed,shape,size,staman,stellate,stigma,stipe,style,texture,tube
284	wfo-0001027808	success	178	95	68	110	27	0.382	.5,.7,0.2-0.3,0.2-0.35,0.5-0.6,0.5-1,0.5-3,0.6-1.2,1-2,1.6-3,1.9-2.4,12-18,2.5-3.5,5-7.5,5.5-6.5,7-8,8-12,absent,acuminate,acute,adaxially,andromonoecious,anther,apex,base,blade,broadly,calyx,chartaceous,cm,cuneate,densely,diameter,extra-axillary,fruit,globose,hair,inflorescence,lateral,lavender,length,lobe,lobed,long,margin,mm,ovate,pale,pedicel,peduncle,perennial,petiole,plant,present,ray,shallowly,simple,sparsely,stellate,stellate-pubescent,stigma,style,throughout,time,tube,vine,x,yellow	%,.2,0-0.1,0-7,0.05-0.2,0.25-0.35,0.3-0.6,0.4-0.8,0.4-1,0.6-1.4,1,1-1.3,1.1-1.3,1.4-1.8,15-30,2-4,2-foliate,2.5-4,20-30,23-28,3-11,40-120,5-7,5-merou,6-8,7-10,70-90,9-14,abaxially,acicular,across,adaxiall,alyx,apart,armed,articulated,axe,ba,broad-based,brown,capitat,curved,d.,deltate,directed,distall,distributed,eaf,eed,eglandular,finger,flower,fruiting,functional,geminat,gland-tipped,green,half,heterostylous,index,lamina,less,lobing,longer,lower,mature,mid-point,midpoint,midvein,minute,nflorescence,oblique,orang,orolla,part,per,pore,porrect,presen,prickle,pseudo-racemose,purple,rostrate,ruit,sessile,short,side,spaced,sprawling,stage,stalk,stellae,straight,tal,tamen,tem,thick,unarme,unarmed,unbranched,unit,unknow,uvenile,vary,vein,weakly,white,wide,yellowish,ympodial	adhesion,arrangement,capitate,colour,corolla,form,glandular,growth,height,history,leaf,life,na,number,orange,ovary,position,presence,pubescence,reproduction,seed,shape,size,staman,stem,stipe,texture
285	wfo-0001027816	success	187	115	87	100	28	0.465	.5,0.2,0.5-1,0.5-2,0.6-0.8,0.7-1,1,1-1.5,1-3,1.5-2,1.8-6,2-4,2/3,3-3.5,3.5-4,4-5,<,acuminate,acute,along,anther,apex,attenuate,base,becoming,berry,bluish,brown,calyx,capitate,cm,connivent,corolla,dark,densely,diameter,ellipsoid,entire,flattened,fleshy,glabrous,gland-tipped,glandular,globose,growth,inflorescence,lanceolate,lateral,leaf,less,linear,lobe,lobed,loosely,margin,minutely,mm,orange,pedicel,peduncle,petiole,plant,pubescent,purple,reddish,reniform,ripe,shiny,shrub,simple,slightly,sometimes,sparsely,stellate,stem,stigma,style,terminal,thin,tip,trichome,tube,uniformly,uniseriate,way,x,½	..,0.5,1-1,1-4,1.2-2,12-14,2-2.5,5-30,5-merou,6-9,ag,almost,alyx,anthesi,apar,ark,articulated,axi,branched,cell,confined,conical,cupped,dense,drying,eaf,eed,em,erect,exserted,filament,filiform,flower,free,fruiting,half,ilament,irregularly,leaving,lengthening,like,lower,m.,markedly,minute,new,nflorescence,nodding,occasionally,often,older,orolla,pair,papillo,patent,peg,per,perfect,perhaps,pericarp,pitted,plurifoliat,pore,poricidal,portion,primary,prominen,pubescen,rectangular,red,rounded,ruit,scar,several,sleeve,slit,small,somewhat,spaced,sparse,spreadin,spreading,square,surface,testal,time,triangular,twinin,ud,ultimate,unit,upper,usually,variable,vary,vein,viscous,woody,yellowish,ympodial	adhesion,arrangement,blade,climate,colour,form,fruit,hair,height,history,length,life,midpoint,na,number,ovary,perennial,position,presence,pubescence,ray,reproduction,seed,shape,size,staman,stipe,texture
286	wfo-0001027819	success	199	110	85	114	25	0.427	0.5-1,1-2,10-20,10-50,12-21,16-25,2-15,20-35,22-35,3-40,3-5,4,4-10,4-15,4-25,4-5,5-6,8-10,9-12,abaxially,acute,adaxially,apex,apical,base,cm,concave,cordate,cuneate,cylindrical,deeply,densely,diameter,ellipsoidal,entire,especially,fading,finely,forked,fruit,glabrous,globose,green,leaf,length,lobed,long,margin,mm,moderately,narrowly,oblong,pedicel,peduncle,per,petiole,probably,protuberance,puberulent,purple,purplish,rachi,rugose,simple,sparsely,stellate,stigma,style,subcoriaceous,sympodial,tree,triangular,truncate,tube,two,umbrella-shaped,unbranched,unit,unknown,unlobed,whitish,wide,x,yellow,young	-100,1,1-,1-5,1.5-2,15-22,2,2-,2-3,20-25,20-40,25-35,3-5-lobed,5,5-merous,aggregate,also,alyx,apart,ape,apiculat,articulated,axe,ba,basal,beyond,blade,branched,cell,ciliate,color,connective,denser,dia,diamete,dilated,directed,distally,divided,eaf,eed,eglandular,eglandular-pilose,elliptic,elliptic-ovate,equal,exceeding,except,exserted,fleshy,flower,hair,halfway,leaving,lobe,lon,lower,main,mesocarp,midrib,narrow,near,nflorescence,nther,oblique,obtu,obtuse,occasionally,often,orolla,ovate,pedicellar,perfec,perfect,pilose,pinnately,pore,present,prominent,puberulen,puberulence,radiu,ranch,rarely,ratio,remnant,ripe,rounded,rown,ruit,runk,shallowly,short-acuminat,shorter,sinus,slightly,small,sometimes,spaced,stamen,stone,strongly,swelling,tal,thecae,toward,ud,uni,usually,vary,vein,villous,width,without	anther,arrangement,branch,calyx,colour,corolla,crown,form,growth,height,hermaphroditic,history,inflorescence,life,ovary,perennial,plant,position,pubescence,reproduction,seed,shape,short-acuminate,size,texture
287	wfo-0001027829	success	197	101	74	123	27	0.376	0.1-0.8,0.5,0.6-0.7,0.6-0.9,0.7,1-,1-1.5,1.5,1.5-2,1.7-2,12,3-7,4-6,5,5-18,5.5-6,6-6.5,acuminate,acute,anther,apex,base,black,calyx,clavate,cm,corolla,dense,diameter,elliptic,elongate,entire,evenly,flattened,glabrous,globose,growth,inflorescence,lateral,length,lobe,margin,midpoint,mm,narrowly,oblique,ovary,pale,pedicel,peduncle,petiole,pubescence,pubescent,ray,reniform,shiny,shrub,simple,small,somewhat,sparsely,stellate,stem,stigma,style,tan,tapering,thin,tree,truncate,tube,white,x,yellowish	.1,.5,0.7-0.8,1,1-3,1.5-2.5,1/3,10-20,2,20-31,30,5-8,8-10,abaxially,adaxially,along,anthesi,apar,armed,articulated,axi,bark,beneath,bent,berry,bright,brown,cell,commonly,conical,densely,denser,directed,distally,drying,eaf,eed,enmeshing,equal,erect,exceeding,exserted,filament,filiform,flower,free,fruiting,glabrescen,gland-tipped,hang,larger,like,lobed,long,lower,midrib,midvein,minute,minutely,mixed,mixture,multicellular,nearly,new,nflorescence,nodding,often,older,one,open,orange,pair,papillat,per,perfect,pericarp,pitted,plurifoliat,pointed,pore,porect,poricidal,porrect,portion,prickle,primary,prominent,rectangular,reddish,reflexed,regular,ripe,ruit,scar,scattered,sessile,sharply,short,short-stalked,shorter,side,sinuate,spaced,straight,strongly,surface,tangled,testal,time,tip,triangular,trichome,twice,ud,un,unarmed,unit,upper,usually,vein,weak,within,ympodial	0.1,adhesion,arrangement,blade,climate,colour,form,fruit,glandular,hair,height,history,leaf,life,na,number,plant,position,presence,reproduction,seed,shape,size,staman,stipe,texture,ye
288	wfo-0001027834	success	236	122	91	145	31	0.386	-6.1,0.2-0.3,0.2-0.4,0.2-0.6,0.9-1.8,1-1.6,1-10,1.1-1.6,1.1-1.8,1.4-2,1.8-4.9,10-25,2-3.8,2-8,2.2-4.3,2.3-3.4,3-15,4-5.2,4.8-6.9,5-20,6.9-18.1,abaxially,acuminate,acute,anther,apex,attenuate,base,blade,blunt-tipped,brown,calyx,cm,connivent,corolla,deltoid,diameter,discolorous,drying,ellipsoid,entire,finely,fleshy,flower,fruit,globose,granular-tomentose,hair,leaf,lenticular,light,lobe,margin,mm,obovate,obtuse,orbicular,ovate,ovate-elliptic,pedicel,peduncle,petiole,pseudo-terminal,pubescence,rarely,ray,ripe,rounded,scabridulous,semi-spherical,short,shrub,simple,small,soft,sometimes,stellate,stem,stigma,style,subcoriaceous,tree,tube,velutinous-tomentose,white,whitish,x,yellow,yellowish,yellowish-tan,yellowish-tomentose	.5-3,0-110,0.4-1.1,0.5-2,1-1.9,1-2.5,1.6-2.7,1/2,2.4-6.2,2.7-7.3,2.9-4.2,25,3-4.3,4-6,5-merous,5.1-8,9-11.9,9-13,abaxial,absent,accrescent,adaxial,adaxially,ag,alyx,angled,anthesi,apar,apical,around,articulated,axillary,ba,bark,becoming,berry,branch,branched,branching,bud,capitat,closely,completely,concentrated,coriaceous,covering,crown,cylindrical,dendritic-echinoi,dendritic-echinoid,densely,dichasia,directed,distally,eaf,echinoi,echinoid,edge,eed,enclosing,enveloping,equal,erec,exserted,farinose,filament,flat-topped,forming,fruiting,glabrescent,glabrous,gray,grooved,high,included,inserted,lengthening,less,lobed,long,long-stalked,longitudinal,longitudinally,lower,many,mostly,multangulat,multangulate,near,nflorescence,numerous,obscured,older,orolla,ovate-lanceolate,pair,perfec,persistent,plurifoliate,pore,poricidal,porrect-stellate,primary,pubescent,rachi,reticulate-punctate,ruit,runk,scar,semi-ovate,sessile,short-stalked,slit,somewhat,spaced,sparsely,spreading,stalked,stamen,stellate-pubescent,subcampanulate,surface,suture,tamen,though,time,tip,tomentose,tomentu,tomentum,toward,trichome,turbinoid,ud,unarme,unit,usually,vary,vein,villous,way,whitish-tomentose,wide,ympodial,young	adhesion,arrangement,capitate,climate,colour,form,glandular,growth,height,history,inflorescence,length,life,midpoint,na,number,ovary,perennial,plant,position,presence,present,reproduction,seed,shape,size,staman,stipe,texture,tomantose,unknown
289	wfo-0001027843	success	154	72	45	109	27	0.292	0.5-0.75,0.5-1,0.8-3.5,1-1.2,1-1.3,1-1.5,1.2-1.5,2-2.5,3-6,5-6,6-13,6-9,anther,calyx,clavate,cm,corolla,densely,dia,glabrous,globose,green,leaf,lobe,lobed,mm,opposite,ovary,ovate,pedicel,petiole,poricidal,pubescent,shape,shrub,size,sparsely,stem,stigma,style,tip,trichome,tube,white,x	.5,.75,/3,1.2-2.5,2-4,3-15-flowered,acute,along,anthesi,apart,apex,apiculate,ba,bark,base,bearing,becoming,beginning,beneath,berry,broadly,conical,coroll,curly,deflexed,deltoid,denser,differing,difoliate,distally,eaf,edicel,eed,ellipsoid,erose,exsertion,filament,flower,free,fruiting,geminat,glabrate,hairy,impressed,irregularly,known,lamina,larger,later,lateral,like,lon,long,long-acuminate,lower,main,major,margin,middle,minor,minutely,near,nearly,nflorescence,occasionally,older,one,orbicular,pair,papillo,papillose,pleated,pore,portion,prominent,proximal,reddish-gre,reflexed,rounded,ruit,scar,shaped,simple,sinus,slender,slightly,somewhat,spaced,sparser,stiff,straight,strongly,surface,tall,tapering,tear-drop,time,tipped,two,ud,uniseriate,unit,vein,way,widest,winged,woody,ympodial,young	0.5,1,adhesion,arrangement,colour,diameter,form,fruit,growth,height,history,inflorescence,length,life,na,peduncle,perennial,plant,position,presence,present,pubescence,reproduction,seed,staman,stellate,texture
290	wfo-0001027847	success	219	112	88	131	24	0.402	-2.5,-4,-6,0-2,0.1-0.4,0.4-1,0.8-0.9,0.8-1.2,1-2.5,1.5-2,1.5-2.5,1.9-2.3,1/4,2-2.8,2-5,2.2-3,2.5-3.5,3-6,5.5-8,6-8,abaxially,acute,anther,apex,base,berry,blade,calyx,chartaceous,cm,connivent,cordate,densely,diameter,dull,elliptic,equal,erect,evenly,flattened-reniform,fruit,green,lateral,leaf,length,lobe,lobed,long,margin,maturity,mauve,midpoint,mm,moderately,orange,orange-brown,ovate,pedicel,peduncle,petiole,poricidal,purple,ray,red,rounded,scandent,seed,shrub,simple,size,smooth,sometimes,sparsely,spherical,stellate,stellate-pubescent,stem,style,surface,tapering,terminal,tip,tube,upper,white,wide,yellow,young	-0.8,-2,-3,-5,.35,.7,/2,/3,0,0-7,0.15-0.2,0.2,0.5,0.5-1,0.8,1,1-2,1.5-5,1/2,1/6-1/3,2-3,2-4,2/,3-15,3-5,3.5-6,4-5-merous,5-25,5-6,6-11,7-10,almost,alyx,ame,apar,apart,apically,apparently,articulated,bark,branched,broadly,brow,c.,curved,deltate,dimorphic,discolorous,distance,drying,eaf,edge,eed,elongating,extending,faint,filament,filiform,filiform-acuminat,finely,flattened,flower,free,fruiting,geminate,glabrescent,glabrous,gray,increasing,infructescence,lon,longer,lower,mature,middle,midvein,minor,narrow-deltate,nflorescence,older,one,open,orbicular,orolla,oung,pair,pendulous,per,perfec,pericarp,perpendicular,pit,pitted,plurifoliat,porrect,portion,prickl,prickle,prickly,primary,red-brown,reddish,retrorse,ruit,scar,sessile,side,slender,spaced,spreading,stalk,stalked,straight,strongly,tamen,terete,tertiary,time,toward,trichome,unarmed,unit,usually,variously,vary,vein,venation,visible,way,weakly,ympodial	adhesion,arrangement,climate,colour,corolla,form,glandular,growth,hair,height,inflorescence,na,number,ovary,plant,position,presence,pubescence,shape,staman,stigma,stipe,texture,ye
291	wfo-0001027850	success	221	129	103	118	26	0.466	-22,-4,-5,-6,0.2-0.5,0.6-1,1-1.5,1-2,1-3,1-4,1.5-2,2-2.5,2-4,2-5,2.5-3,3-4,3.5-13,4-5,4-6,6-7,7-18,8-10,acuminate,acute,adaxially,adult,anther,apex,base,berry,blue,branched,brown,calyx,charataceous,clavate,cm,coriaceous,corolla,dark,diameter,elliptic,entire,flattened,flower,glabrous,glandular,globose,green,growth,hirsute,inflorescence,internodal,juvenile,laxly,length,linear,lobe,lobed-angulate,long-styled,loosely,margin,mature,midpoint,minutely,mm,oblong,obovate,ovary,ovate-lanceolate,pedicel,peduncle,petiole,plant,porrect,pubescence,purple,reniform,rounded,rusty,rusty-pubescent,sagittate,scabrous,sessile,short-styled,shrub,simple,stellate,stellate-apiculate,stem,stigma,style,subglobose,subreniform,subsessile,subtruncate,tapered,tomentose,trichome,tube,woody,x,yellowish	-10,0.3-0.35,0.5-1,1,1-multicellular,2-3,2-6,3-6,3-7,50,6-10,<,>,abaxially,almost,angled,anthesi,apart,armed,articulated,bark,basal,brow,caly,cell,channelled,curved,discolorous,distal,dry,eaf,eed,eglandular,enclosed,erect,expanding,filament,flowering,foliaceous,free,fruiting,glabrescent,heterostylous,impressed,leaving,lengthening,like,lobed,long,longer,lower,material,minute,mixed,mixture,multicellular,new,nflorescence,obliqu,oblong-lanceolate,obverse,occasionally,older,one,ornamented,papillo,partially,per,perfect,pericarp,persistent,plurifoliat,pore,poricidal,portion,prickle,prickly,prominent,pubescent,raised,reddish,reduced,reflexed,rest,reticulate,rugose,ruit,scandent,scar,single,slightly,slit,spaced,sparse,sparsely,stalked,staminate,straight,strongly,surface,tall,testa,time,tip,triangular-lanceolate,turbinate,ud,unevenly,unit,upper,vein,velutinous,venation,whitish,wood,yellow,ympodial,¼	adhesion,arrangement,blade,climate,colour,form,fruit,hair,height,history,leaf,life,na,number,papillose,position,presence,present,ray,reproduction,seed,shape,size,staman,stipe,texture
292	wfo-0001027864	success	222	117	89	133	28	0.401	0-0.1,0.1-0.4,0.25-0.5,0.4-0.7,0.4-1.4,0.6-0.7,0.7-0.9,0.7-1.4,1-2,1-3.5,1.2-1.5,1.4-4,1.5-8,2-3,2.5-3,3-10,3-4.2,3-5.5,3.5-5,5-9,6-12,6-7,abaxially,absent,acute,adaxially,anther,apex,base,blade,calyx,chartaceous,cm,connivent,cuneate,densely,diameter,ellipsoidal,entire,extra-axillary,fruit,glabrous,globose,green,grey,grey-green,hair,herbaceous,inflorescence,interpetalar,lanceolate,length,lilac,linear,lobe,lobed,loosely,margin,midpoint,mm,moderately,oblong,obtuse,pale,pedicel,peduncle,petiole,present,purple,ray,reniform,resprouter,scattered,shallowly,simple,slightly,stellate,stellate-pubescent,stem,stigma,style,tapered,tissue,tube,white,x,yellow,yellowish,yellowish-green	%,0-0.2,0-100,0-2,0-3,0.05-0.4,0.3-1,0.5-0.7,0.5-0.8,0.5-1,0.7-1,0.9-1.1,1-1.1,1-1.3,1-1.5,1-3,1-4,13-20,2-foliate,2-locular,3-4,3-5,3-6,3.8-14,4,4-,5-merou,6-8,6-9,7-10,7-20,8-12,8-13,8-14,absen,abundant,accrescent,acicular,alyx,anvil-shape,apart,articulated,attenuate,axe,ba,broad-based,brown,capitat,cross-section,curved,cylindrical,decimetr,deflexed,deltate,directed,distall,distributed,dult,eaf,eed,eglandular,erect,exocarp,filament,finely,finger,flattened,flower,fruiting,geminate,gland-tipped,half,homostylous,index,juicy,lamina,lateral,less,lobing,lon,long,longer,lower,mature,mesocarp,mid-point,minute,moist,nearly,nflorescence,oblique,orolla,part,per,perfect,placenta,pore,porrect,prickle,pseudo-racemose,rachi,reticulate,ridged,rostrate,ruit,rusty-brown,sessile,short,side,smooth,spaced,sprawling,stage,stalk,stalked,stellae,straight,surface,tal,tamen,terete,thick,throughout,time,tip,tissu,unarmed,unbranched,unit,uvenile,vary,wide,ympodial	adhesion,arrangement,capitate,climate,colour,corolla,form,glandular,growth,height,history,leaf,life,na,number,ovary,perennial,plant,position,presence,pubescence,reproduction,seed,shape,size,staman,stipe,texture
293	wfo-0001027872	success	190	105	69	121	36	0.363	1,1-8,1.0-1.3,10,15,2,2-3,2.2-3.5,35,5-7,5-8,6-20,8-11,acuminate,acute,apex,base,ca,calyx,cm,commonly,connate,cordate,cuneate,deep,densely,diameter,distal,elliptic,externally,forked,generally,glabrescent,glandular,glandular-pubescent,globose,green,green-white,half,herbaceous,homogeneously,lanceolate,lobe,long,mm,moderately,narrowly,obliquely,odd-pinnate,ovate,ovoid,pedicel,peduncle,perennial,plant,pubescent,purple,rhizomatous,rotate,rounded,seed,shape,size,stigma,style,uniformly,usually,wide,yellow	0.5,1-1.2,1-4,1.5-4,12-35,2.8,20,3-6-foliat,4-6,5-10,5-lobed,abaxially,acumen,adaxially,angular,apical,apically,apiculate,articulate,b,ba,basal,becoming,branched,caudate,cell,celled,clasping,covering,cyme,decreasing,dehiscent,dichasial,dichasially,digestion,eaf,ebracteate,eed,emoval,enzyme,erect,exceeding,filament,flower,four-celled,gland,globo,gray-green,hair-like,honeycomb,interjected,introrse,lateral,leaflet,light,living,lon,longer,lower,make,maturing,middle,monochasial,mottled,mucilaginous,nearly,nflorescence,nther,oblong,often,orolla,pair,pattern,pentagonal,perfect,petiolate,petiolulate,petiolule,poricidally,puberulent,purpl,rarely,reduced,reveal,rhizome,rotate-,ruit,semi-lunate,sessile,seudostipule,short,single,slightly,slit,sometimes,somewhat,specimen,stamen,ste,straight,subequal,symmetrically,tem,terete,terminal,testal,thick,tinged,tip,trailing,type,typically,unbranched,unit,vary,viole,wall,wid,wider,yellowish-green,ympodial	adhesion,anther,arrangement,blade,climate,colour,corolla,form,fruit,growth,hair,height,history,inflorescence,leaf,length,life,margin,midpoint,na,number,ovary,petiole,position,presence,pubescence,ray,reproduction,rotate-pentagonal,staman,stellate,stem,stipe,texture,tube,violet
294	wfo-0001027880	success	185	115	86	99	29	0.465	.25,0.3-3,0.5-1.5,0.5-5,0.6-1,0.6-1.5,0.8-1.5,1-15,1-2,1-2.5,1-3,1.5-2,1.5-3,10-15,2-3,4-10,4-6,abaxially,acuminate,acute,adaxially,anther,apex,apiculate,base,blade,calyx,clavate,cm,cordate,coriaceous,densely,diameter,distichous,entire,epiphytic,extra-axillary,flattened,flower,fruit,glabrous,globose,greenish,hair,inflorescence,leaf,leaf-opposed,lobe,margin,midvein,mm,nearly,oblique,oblong,oblong-ovate,often,ovate,ovoid,pedicel,peduncle,petiole,pink,pubescent,purple,red-brown,revolute,ripe,rounded,rugulose,shrub,size,slightly,sometimes,somewhat,stellate,stigma,style,surface,tan,truncate,tube,undulate,vine,white,x,yellow	-3,-3.5,1-14,2-80,2/,3-4,5-11,5-8,5-merou,8,absen,accrescen,ag,aggregate,along,alyx,apart,apparently,articulated,axe,ba,branch,branching,cell,chartaceous,ciliat,conical,connivent,contiguously,curled,cylindrical,deltate,dense,diminishing,directed,discolorous,distally,distinct,distinctly,eaf,eed,equal,filament,fruiting,geminat,green,growing,increasing,internode,line,long,longer,longitudinal,lower,minutely,multicellular,nflorescence,node,occasionally,opening,orolla,pair,pale,papillose,perfect,plurifoliate,point,pore,pubescen,rachi,reddish,rooting,ruit,scar,secondary,simple,slender,slit,spaced,sparsely,ste,stone,tamen,tem,thickened,time,tip,trailing,tree,trunk,typically,unbranched,uniseriate,unit,usually,vary,vein,wide,ympodial	adhesion,arrangement,climate,colour,corolla,form,glandular,growth,height,history,length,life,midpoint,na,number,ovary,plant,position,presence,pubescence,ray,reproduction,seed,shape,staman,stem,stipe,texture,ye
295	wfo-0001027880	success	170	115	82	88	33	0.482	.25,0.3–3,0.5,0.5–1.5,0.5–5,0.6–1,0.6–1.5,0.8–1.5,1.5–2,1.5–3,10–15,1–15,1–2,1–2.5,2–3,4–10,4–6,abaxially,absent,acuminate,acute,adaxially,anther,apex,apiculate,arrangement,base,blade,bluish-purple,calyx,chartaceous,cm,cordate,coriaceous,densely,diameter,distichous,entire,extra-axillary,flattened,flower,fruit,glabrous,globose,greenish,hair,leaf,leaf-opposed,lobe,margin,mm,nearly,oblique,oblong-ovate,often,ovate,ovoid,pedicel,peduncle,petiole,pink,pubescent,red,reddish-brown,revolute,rounded,rugulose,shrubby,slightly,sometimes,somewhat,stellate,stigma,style,surface,tan,truncate,tube,undulate,vine,white,x	0.2-0.5,1–14,1–3,2-80,2/3,3–4,5-merous,5–11,5–8,8,accrescen,along,alyx,apar,axe,berry,c.,capitat,ciliat,clavate,climbing,conical,contiguously,curled,cylindrical,deltate,dense,discolored,distinct,distinctly,eaf,eed,filament,fruiting,green,lanceolate,line,long,longer,lower,m.,membranous,midvein,minutely,mottled,nflorescence,nternode,occasionally,orolla,pair,pale,papillose,perfec,pinnate,plurifoliat,rachi,reddish,rip,ruit,sand-punctat,sand-punctate,scar,secondary,simple,slender,spaced,sparsely,ste,tamen,tem,thickened,time,tip,tree,trichome,trunk,typically,unbranched,uniseriate,unit,vary,vegetatio,vein,venation,wide,woody,ympodial,–3.5	adhesion,capitate,climate,colour,corolla,form,glandular,growth,height,history,inflorescence,length,life,midpoint,na,number,ovary,perfect,plant,position,presence,pubescence,ray,reproduction,ripe,seed,shape,size,staman,stem,stipe,texture,true
296	wfo-0001027881	success	215	107	64	151	43	0.298	-3,acute,anther,apex,attenuate,base,berry,blackish,blade,bulge,calyx,chartaceous,cm,connivent,cordate,cordiform,densely,diameter,dorsally,drying,entire,extra-axillary,flattened,flower,fruit,glabrous,glandular,globose,greenish,hair,herb,immature,lateral,leaf,light-brown,lobe,margin,maturity,membranaceous,mm,moderately,ovate-elliptic,pedicel,peduncle,petiole,pubescence,pubescent,reniform,rotate,seed,simple,size,small,sparsely,staman,stem,stigma,style,subopposite,surface,translucent,tube,white,yellow	.3–0.5,0.5–2.2,0.8–1.5,1-celled,1.3–2,1.8–2.9,10–25,1–2,1–2-celled,1–2.5,1–2.6,1–3,1–3-celled,1–4,2.5–3.6,20–40,2–4,2–6,2–7,4–6,4–9.5,5,5-merous,6–10,7–14,7–9,8,abaxially,absent,abundant,accrescent,acuminate,adaxiall,adaxially,almost,alyx,appressed,articulated,asymmetric,axe,ba,barely,camptodromous,capitat,case,central,ciliate,closely,commonly,connected,contiguous,curved,cylindrical,decurrent,dehiscing,denser,difoliate,directed,eaf,ed,eglandular,emarginate,emerging,equal,erect,exceeding,exclusively,explosively,eye,few-,fewer,filament,forming,frequent,geminate,giving,groove,half,held,hollow,impression,interpetalar,introrsely,larger,less,like,long,longer,longitudinal,lower,mainly,many-branched,maturit,mesocarp,mixed,much,multicelled,multicellular,naked,near,netlike,nflorescence,normally,one,opening,orolla,other,pair,parallel,part,per,perfec,placenta,pore,pressure,primary,projection,prominent,rachi,raised,ruit,secondary,sessile,short,side,similar,slightly,slit,smaller,solitary,sometimes,stalk,stamen,subapically,tal,tamen,tem,tissue,triangular,two,unbranched,unit,vary,vein,venation,visible,watery,winged,woody,ympodial,×	0.3-0.5,0.5-2.2,0.8-1.5,1-2,1-2.5,1-4,2-6,2-7,2.5-3.6,20-40,4-6,6-10,7-14,7-9,adhesion,arrangement,capitate,climate,colour,corolla,form,growth,height,history,inflorescence,length,life,midpoint,na,number,ovary,perennial,plant,position,presence,present,ray,reproduction,rugulose,shape,stellate,stipe,texture
297	wfo-0001027882	success	184	112	77	107	35	0.418	0.5-1,1-1.5,1-5,1.5-2,1.5-2.2,1.5-6,2-3,2-lobed,2.1-2.6,3.5-4,3.5-5,4-5,6-9,abaxially,acuminate,adaxially,anther,apex,appearing,attenuate,base,berry,branch,calyx,clavate,cm,conical,corolla,densely,diameter,elliptic,entire,flattened,fork,glabrous,globose,green,growth,hairy,inflorescence,leaf-opposed,less,lobe,lobed,margin,maturity,minutely,mm,ovary,ovoid,pale,papillate,pedicel,peduncle,petiole,pitted,poricidal,reniform,shiny,shrub,simple,small,sometimes,sparse,stem,sticky,stigma,style,surface,tip,tree,trichome,tube,uniseriate,white,x,yellow	.25,.5,0.1,06a,1,1.5-,1.6-2.2,10-25,10-40,2-6,2.5-3,3-4,3.2-6,7-,9-13,absent,age,along,anthesi,apart,apparently,axil,bark,branched,branching,broadly,brown,c.,caly,completely,cucullate,dark,deltate,dense,difoliate,dry,drying,eaf,eed,erect,et,exerted,fide,filament,flower,free,fruiting,fusiform,geminat,glabrou,hollow,hooked,irregularly,junction,kallunki,lamina,lengthening,lower,markedly,midrib,new,nflorescence,nodding,occasionally,pair,papillat,paulo,penden,perfect,planar,plane,pointed,population,pore,portion,primary,pulp,rachi,rarely,red-papillat,reddish,ruit,scar,shattering,slender,slit,spaced,sparsely,specimen,stout,straight,strongly,structurally,sweet-scented,swollen,são,thickened,time,tuft,ud,unit,usually,vein,way,woody,yellowish,ympodial	1.5-4,2,7-25,adhesion,arrangement,blade,climate,colour,form,fruit,glandular,hair,height,history,leaf,length,life,midpoint,na,number,perennial,plant,position,presence,pubescence,ray,reproduction,rugulose,seed,shape,size,staman,stellate,stipe,texture
298	wfo-0001027889	success	151	104	68	83	36	0.45	0.5-1,0.5-11,0.7-2,1-10,1-3.5,1.5,10-12,2-20,2-3,3-4,3-9,abaxially,acute-acuminate,adaxially,apex,basal,base,blade,calyx,chartaceous,cm,darker,densely,diameter,eglandular-puberulent,eglandular-pubescent,elliptic,entire,finely,fruit,glabrous,glandular-,green,greenish,immature,length,light,lobe,longitudinal,margin,mm,moderately,ovate,ovoid,pedicel,peduncle,petiole,probably,puberulent,puberulent-pubescent,ripe,shrub,simple,sparsely,stellate,stigma,stripe,style,subcordate,tomentose,tree,truncate,tube,unknown,violet,white,x,yellowish	-2.5,-pubescent,.5,.5-2,0,1,1-3,1.5-2,10-20,10-30,3-8,4-foliat,5-10,acuminate,acute,aggregate,apart,ape,apiculate,articulated,axe,beyond,capitat,cell,color,connective,connivent,cylindrical,deltate,dilated,directed,distally,eaf,eed,equal,exceeding,exserted,extending,flower,introrse,laterally,leaving,lon,long,lower,narrow,nflorescence,nther,oblong,orolla,pedicellar,perfect,pore,presen,present,puberulen,puberulent-pubescen,rachi,radiu,remnant,ruit,slightly,small,somewhat,spaced,stamen,stone,subcoriaceous,swelling,tal,tem,thecae,time,tip,tomento,triangular,ud,unbranched,unit,vary,wide,yello,ympodial	1-2.5,adhesion,anther,arrangement,capitate,climate,colour,corolla,form,glandular,growth,hair,height,history,inflorescence,leaf,life,midpoint,na,number,ovary,plant,position,presence,pubescence,ray,reproduction,rugulose,seed,shape,size,staman,stem,stipe,surface,texture
299	wfo-0001027900	success	227	122	97	130	25	0.427	.5,0,0.1–0.3,0.2–0.4,0.2–0.5,14–15,18–22,1–3,2,2.8,2–3,3,3.5–4.5,3–5,3–9.5,4–10,5–7.5,7–17,7–8,9–25,absent,acute,adaxially,andromonoecious,anther,apex,base,blade,blue,calyx,capitate,cm,connivent,cordate,coriaceous,deeply,densely,diameter,entire,equal,extraaxillary,flower,fruit,glandular,globose,green,hair,inflorescence,lanceolate,leaf,length,light,likely,lobe,margin,maturity,midpoint,mm,moderately,multangulate,multangulate-stellate,nearly,oblique,obtuse,older,pedicel,peduncle,petiole,plant,porrect-stellate,powdery,pubescence,pubescent,ray,repand,rotate-stellate,sessile,short-stalked,shrub,simple,slightly,small,stalked,stellate,stem,stigma,style,surface,tan,tapered,tree,tube,violet,yellow,young,×,–4	.1,.1–0.2,.1–0.3,0–0.1,1.5–1.8,16–19,16–23,1–,1–4,2–8,3.5–4,3–8,5-merous,5–,5–10,5–6,6–8.2,7–10,7–10+,7–15,8–15,abaxial,abaxially,abundant,abundantly,accrescent,adaxial,age,alyx,anthesi,apart,armed,articulated,axe,ba,bark,becoming,beneath,berry,bilobe,broad-based,brown,congested,connective,curved,cylindrical,db,deltate,difoliate,directed,discolorous,distally,dried,eaf,eed,either,enclosing,falcate,filament,flowering,free,fresh,frui,fruiting,functionally,geminat,glabrous,golden-tan,grey-brown,half,hermaphroditic,heterstylou,interpetalar,lighter,like,lobed,long,long-stalked,longitudinal,lower,major,membranaceous,midvein,mixed,multiseriate,multiseriate-stalked,nflorescence,often,one,opening,orolla,part,pore,prickle,pronounced,rachi,reddish-dark,reflexed,roughened,ruit,runk,sharp,short,side,slit,smooth,spaced,sparsely,stalk,staminate,stellate-pubescen,stellate-pubescent,stout,strongly,subtending,tamen,thickened,time,tissue,unarmed,unbranched,unit,unknown,vary,vein,vestigial,wide,ympodial,–5,–6.2	adhesion,arrangement,bilobed,climate,colour,corolla,form,growth,height,history,life,na,number,ovary,position,presence,present,reproduction,rugulose,seed,shape,size,staman,stipe,texture
300	wfo-0001027901	success	156	104	69	87	35	0.442	.5,0.3-1.2,0.8-1,1-1.5,1-2.5,1.8-4.5,2.5-3,3-5,4-5,4.7-12,abaxial,abaxially,acuminate,acute,adaxially,anther,apex,area,attenuate,base,bright,broadened,brown,calyx,cm,corolla,dark,densely,dia,dry,elliptic,fresh,glabrous,globose,green,inflorescence,leaf,lobe,lobed,material,minutely,mm,nearly,opposite,ovary,ovoid-reniform,pedicel,petiole,pitted,poricidal,pubescent,shape,shiny,shrub,simple,size,sparsely,stem,stigma,style,surface,tip,translucent,trichome,tube,uniseriate,white,x,yellow	.25,0.5-1,0.8-2,0.9-2.3,1-2,1.5-1.8,4-10-flowered,6-7,?,anthesi,ba,bark,beneath,berry,brow,closely,conical,curled,deflexed,differing,difoliate,direction,drying,eaf,edicel,eed,ellipsoid,exserted,filament,firm,fleshy,free,fruiting,geminat,imbedded,immature,keeled,later,lateral,like,lon,long,lower,main,major,matrix,middle,midrib,minor,nflorescence,older,orbicular,oriented,overlappin,pair,papillo,papillose,planar,pore,portion,prominently,reddish,reflexed,rest,ripe,rounded,ruit,scar,shaped,single,slender,spaced,straight,strongly,swollen,tall,tear-drop,triangular,tub,ud,unit,usually,vein,widest,woody,ympodial,young	0.5,1,adhesion,arrangement,blade,climate,colour,diameter,form,fruit,glandular,growth,hair,height,history,length,life,margin,midpoint,na,number,peduncle,perennial,plant,position,presence,pubescence,ray,reproduction,rugulose,seed,staman,stellate,stipe,texture
301	wfo-0001027902	success	128	93	67	61	26	0.523	-2.5,0.5-1,1-1.5,1-2,10-20,2,2-15,2-3,2-8,3-4,3-5,4-25,4-5,5-20,6-37,7-9,abaxially,acute,adaxially,angled,apex,base,calyx,chartaceous,cm,cordate,deeply,densely,diameter,eglandular,entire,fruit,glabrous,glandular,globose,hair,lobe,margin,mm,moderately,narrowly,nearly,ovate,pedicel,peduncle,petiole,puberulent,pubescent,purple,purplish,reticulate,shrub,simple,small,sparsely,stellate,stigma,style,tree,triangular,truncate,tube,unbranched,unknown,whitish,x,yellow	1-6,1.5-3,10-15,15-30,2-12,2-9,20-50,3-foliat,8-13,absen,acuminate,adaxiall,aggregate,apart,articulated,axe,blade,branched,cell,color,connivent,cylindrical,directed,distall,distally,eaf,eed,flower,forked,inflated,leaving,like,lon,long,lower,nflorescence,nther,obtuse,orolla,pedicellar,pore,pubescen,rachi,radiu,remnant,ripe,ruit,spaced,ste,stone,subcoriaceous,tal,tem,time,tip,truncat,unit,usually,vary,wide,ympodial	anther,arrangement,colour,corolla,form,growth,height,history,inflorescence,leaf,length,life,na,ovary,plant,position,presence,pubescence,reproduction,rugulose,seed,shape,size,stem,surface,texture
302	wfo-0001027920	success	228	118	90	138	28	0.395	-25,0.1-0.5,0.2-0.8,0.5-1,1.4-2.5,12-18,2-5,2-7,20-40,25-45,3-5,3.5-4,3.5-4.5,4-10,4-11,4.5-7,5-7,7-11,7-18,8-12,8-18,acute,adaxially,almost,anther,apex,attenuate,base,black,blade,bristly,bristly-hirsute,broadly,brown,calyx,cm,coarsely,connivent,dark,densely,dentate,diameter,ellipsoidal,extra-axillary,flower,fruit,hair,hirsute,inflorescence,lanceolate,leaf,length,lenticular,lobe,long,margin,midpoint,minutely,mm,oblong,obovoid,obtuse,orange,outline,ovate,pedicel,peduncle,perennial,persistently,petiole,pitted,ray,ripe,simple,singled-stemmed,small,smaller,stellate,stellate-pubescent,stem,stigma,style,surface,thin-textured,tree,truncate,tube,white,x,yellow	-3,.1-1.4,0.1-0.2,1-2,1-2.5,1-4,1.5-3,1/5-1/3,11-28,12-25,17-25,2-,2-8,2-foliate,4-6,4-7,4-locular,8-30,abaxially,acicular,acute-,acute-tipped,adaxiall,along,apart,appressed,approximately,articulated,ascending,axe,ba,basally,bristle-like,broad-based,bulbou,campanulate,capitat,cauline,class,close,concealed,concentrated,cylindrical,deltoid,depressed-deltoid,descending,directed,distal,distall,distinct,divergently,eaf,eed,elongate,enlarging,entire,equaling,erect,female-sterile,few-branched,flesh,frui,geminat,glabrous,green,indument,inserted,interlobal,intermixed,large,larger,lateral,less,lignescent,locule,long-stalked,longitudinal,lower,major,minute,much,multiseriate,narrowly,nearly,nflorescence,obtuse-tipped,occasionally,often,one,orolla,ovate-lanceolate,pair,per,persistent,pore,prickle,prickly,principal,proliferation,pubescent,rachi,radiu,receptacular,recurved,rigid,ruit,scattered,section,sessile,short,side,similar,sinus,spaced,sparse,spreading,stalk,stalked,stella,stellae,swollen,tal,tamen,tawny,tem,termination,time,trichome,two,unbranched,unit,usually,vary,vein,vestitur,weakly,wide,ympodial	adhesion,arrangement,capitate,climate,colour,corolla,form,glandular,growth,height,history,life,na,number,ovary,plant,position,presence,present,pubescence,reproduction,rugulose,seed,shape,size,staman,stipe,texture
303	wfo-0001027929	success	193	98	75	118	23	0.389	1,1-10,1.0-1.3,10,2-3,2.0-3.0,20,3.5-5,35,4-5,5-6,6-15,abaxially,adaxially,along,apiculate,calyx,caudate,cell,cm,color,corolla,covering,deep,diameter,distal,elliptic,except,forked,generally,glabrous,globose,green,green-white,hair,hair-like,half,herbaceous,lanceolate,lateral,lobe,long,mm,narrowly,oblong,occasional,odd-pinnate,ovate,ovoid,pedicel,peduncle,perennial,plant,puberulent,purple,rarely,rhizomatous,rotate,seed,shape,size,spot,star,stigma,style,testal,thick,vein,violet,violet-blue,wall,white,wide,without,yellow	0.2-0.9,1-4,1-8,1.5-4,15,2,3-6-foliat,4-30,4-6,5-10,5-lobed,acumen,acuminate,acute,angular,apex,apical,apically,articulate,ba,basal,base,becoming,beyond,branched,cente,center,clasping,coat,connate,cordate,cuneate,cyme,dark,darker-violet-blue,decreasing,dehiscent,dichasial,dichasially,digestion,eaf,ebracteate,eed,embryo,emoval,enzyme,erect,exceeding,filament,flower,formed,globo,honeycomb,included,interjected,introrse,leaflet,light,living,lon,lower,make,maturing,middle,monochasial,mostly,mucilaginous,nearly,nflorescence,nther,obliquely,often,orolla,pair,pattern,pentagonal,perfect,petiolate,petiolulate,petiolule,poricidally,purpl,radiating,reduced,reveal,rhizome,rotate-,rounded,ruit,semi-lunate,sessile,seudostipule,short,slightly,slit,sometimes,somewhat,specimen,stamen,ste,straight,subequal,symmetrically,tem,terete,terminal,tinged,tip,trailing,typically,unbranched,unit,usually,vary,visible,wid,wider,ympodial	anther,arrangement,form,fruit,growth,height,history,inflorescence,leaf,length,life,na,ovary,petiole,position,pubescence,reproduction,rotate-pentagonal,rugulose,stem,surface,texture,tube
304	wfo-0001027930	success	210	110	84	126	26	0.4	0-0.7,0-2,0.2-0.4,0.2-1.2,0.25-0.35,0.25-0.4,0.4-1,0.4-1.5,0.6-0.9,0.7-1.5,1-2,2-2.5,2-3,3-12,3-3.6,3.5-5.5,4-8,4.5-6.5,6-13,absent,acute,adaxially,and/or,andromonoecious,anther,apex,basal,base,blade,calyx,chartaceous,cm,connivent,cuneate,densely,diameter,entire,erect,extra-axillary,flower,fruit,glabrous,gland-tipped,globose,hair,hastate,inflorescence,lanceolate,leaf,length,lilac,linear,linear-hastate,lobe,loosely,margin,midpoint,mm,obtuse,pale,pedicel,peduncle,perennial,perfect,petiole,plant,present,ray,red,rhizomatous,scattered,short,shrub,simple,sparsely,stellate,stellate-pubescent,stigma,style,tube,unbranched,white,x,yellow	%,-2,.1,.4,0,0-0.5,0-0.8,0-1,0-4,0.05-0.7,0.2-0.7,0.3-0.5,0.4-0.8,0.5-0.6,0.5-1,0.8-1.2,1-4,1-locular,13-16,15-60,2-10,2-6,2-9,2-foliate,3-7.5,4-,5-merou,6-12,6-8,7-12,7-8,8-20,9-13,9-26,abaxially,absen,acicular,across,adaxiall,adult,alyx,apart,apparen,articulated,axe,ba,branch,branche,brown,capitat,confined,cylindrical,decimetre,deltate,directed,distall,distributed,dm,eaf,eed,eglandular,exocarp,filament,finger,fruiting,functional,geminat,green,grey,half,heterostylous,homo-,incomplete,interpetalar,juicy,juvenile,lamina,lateral,less,long,longer,lower,mature,mesocarp,mid-point,midrib,midvein,minute,moderately,narrowly,nflorescence,oblique,orolla,part,per,placenta,pore,porrect,prickle,rachi,rostrate,ruit,septum,sessile,spaced,sparse,stellae,straight,strongly,succulent,tal,tamen,tem,thick,throughout,time,tissue,triangular,unarme,unarmed,unit,vary,weakly,wide,yellowish,ympodial	adhesion,arrangement,capitate,climate,colour,corolla,form,glandular,growth,height,history,life,na,number,ovary,position,presence,pubescence,reproduction,seed,shape,size,staman,stem,stipe,texture
305	wfo-0001027943	success	208	127	98	110	29	0.471	-4,0.2-2,0.3-0.5,0.5-1,0.5-6,0.8-1.5,1-1.5,1-3,1-4,2-14,2-2.5,2-3,2-3-lobed,2-4,3-15,3-20,4-7,5-8,5-9,7-10,abaxially,acute,adaxially,andromonoecious,anther,apex,base,blade,brown,calyx,chartaceous,cm,coarsely,densely,diameter,elliptic,elliptic-ovate,entire,equal,extra-axillary,ferruginous,flattened,forked,fruit,glabrescent,glabrous,glandular,globose,green,hair,inflorescence,leaf,lobe,margin,mature,membanaceous,midpoint,mm,moderately,oblique,often,outline,pedicel,peduncle,petiole,plant,porrect-stellate,pubescent,rarely,ray,reniform,ripe,rounded,rugulose,shallowly,shrub,side,simple,slightly,sparsely,stellate,stellate-pubescent,stem,stigma,strongly,style,surface,tan,tapered,truncate,tube,turning,unbranched,white,whitish,x,yellow,young	-1.5,.1,.5,0,0.5-1.5,0.5-4,1-5,1.5-3,10-15,2-10,3-8,4-20,4-6,5-merou,6-.,7-15,accrescent,ag,alyx,apart,armed,articulated,axe,ba,berry,broad,broad-based,brownish,capitat,connivent,covering,curved,cylindrical,difoliate,directed,distally,eaf,eed,erect,filament,flower,free,frui,fruiting,geminat,gland-tipped,half,heterostylous,homo-,initially,interpetalar,interspersed,interwoven,like,linear-acuminate,linear-apiculate,long,longitudinal,lower,major,midline,midrib,minutely,narrowly,nearly,nflorescence,numerous,obtuse,opening,orolla,part,perfect,pericarp,pore,prickle,rachi,recurved,reflexed,ruit,sessile,short,short-stalked,sinus,slit,small,smooth,somewhat,spaced,sparse,splitting,staminate,straight,subtending,tamen,tem,thi,time,tip,tissu,tissue,toward,triangular,unarme,unarmed,unit,vary,vein,wide,woody,ympodial	0.1-0.5,6-8,adhesion,arrangement,capitate,climate,colour,corolla,form,growth,height,history,length,life,na,number,ovary,perennial,position,presence,present,pubescence,reproduction,seed,shape,size,staman,stipe,texture
306	wfo-0001027944	success	175	99	70	105	29	0.4	0-0.3,0.25-0.4,0.3-0.4,0.4-0.5,0.4-0.8,0.5-1.2,0.9-1.2,1-2,1.5-2,2-4.5,3-3.5,3-4.5,4-7,5-7,7-8,7.5-14,absent,acute,adaxially,anther,apex,base,blade,calyx,chartaceous,cm,confined,cuneate,densely,diameter,eglandular,entire,erect,extra-axillary,fruit,glabrous,globose,green,hair,inflorescence,lanceolate,lavender,length,lobe,lobed,margin,midpoint,midrib,mm,ovate,pale,pedicel,peduncle,perennial,petiole,present,ray,red,rhizomatous,shallowly,shrub,simple,stellate,stellate-pubescent,stigma,style,throughout,tube,x,yellow	%,.8,0-4,0.1-0.2,0.2-0.3,0.2-0.4,0.5-0.8,0.5-1,1-1.2,1-3,1-locular,13-16,15-23,2-3,2-6,2-foliate,2.5-5.2,3-20,3-4,3-5,3-7,5-merou,7-20,abaxially,absen,acicular,across,adaxiall,adult,alyx,apart,apparen,articulated,axe,ba,branche,brown,capitat,cylindrical,deltate,directed,distall,dm,eaf,eed,exocarp,finger,flower,fruiting,geminat,gland-tipped,half,incomplete,index,juicy,lamina,lateral,less,lobing,long,longer,lower,mature,mesocarp,mid-point,minute,nflorescence,oblique,obtuse,orolla,part,per,perfect,placenta,pore,porrect,prickle,pseudo-racemose,ruit,rusty,septum,sessile,short,side,spaced,stage,stellae,straight,succulent,tal,tamen,tem,thick,time,unarme,unarmed,unbranched,unit,unknow,uvenile,vary,white,wide,yellowish,ympodial	adhesion,arrangement,capitate,climate,colour,corolla,form,glandular,growth,height,history,leaf,life,na,number,ovary,plant,position,presence,pubescence,reproduction,seed,shape,size,staman,stem,stipe,texture,unknown
307	wfo-0001027948	success	186	101	66	120	35	0.355	-16,-6,.5,0.5-2,0.8-,1-1.2,1.2-2.2,1.3-1.8,1.5-4.5,2.2-,2.5-,3-8.2,3.2-5.2,3.7-4,5-,7-15,7.5-10,abundant,acuminate,anther,apex,attenuate,base,calyx,campanulate,cm,corolla,diameter,ellipsoidal,elliptical,flexuous,glabrous,glandular,globose,herb,leaf,length,light,lobe,long,margin,mm,narrowly,non-glandular,ovate,ovoid,patent,petiole,pubescence,pubescent,purple,seed,serrulate,simple,stem,stigma,style,sub-shrub,tip,trichome,tube,unequal,ventrifixed,violet,viscid-pubescent,x	-15,0-,0.4,0.5-0.7,0.6,1-2,1.6,1/10,10-14,13,14,2-,3.5,5,6-celled,7,8-celled,abaxially,accrescen,adaxially,ag,aggregate,antrorse,ape,articulate,ature,basal,berry,bicellular,branch,c.,cell,connectival,crushed,cuticle,dark,delicate,diamete,difoliate,directed,dorsally,eaf,edentate,erect,filament,finely,fragrance,free,fruiting,generally,head,herbaceous,hig,hollow,ill-smelling,inconspicuous,inserted,lamina,long-stalked,longer,longitudinal,longitudinally,lower,many-,midvein,narrow,near,occasionally,odorles,opening,orolla,pair,papillate,pericarp,pore,poricidal,portion,prolongation,reduced,ree,ridged,ruit,saddle-shape,scarce,scarcely,secondary,seeded,seen,separated,short-stalked,shorter,single-celled,sinus,slightly,slit,small,smooth,solitary,spur-like,stalk,stone,straight,striat,striate,sub-opposite,tem,thecae,thickened,time,tooth,triangular,twice,unit,upward,vary,vein,verrucate,ympodial,¼,½	adhesion,arrangement,blade,climate,colour,form,fruit,growth,hair,height,history,inflorescence,life,midpoint,na,number,ovary,pedicel,peduncle,perennial,plant,position,presence,present,ray,reproduction,rugulose,saddle-shaped,shape,size,staman,stellate,stipe,surface,texture
308	wfo-0001027961	success	177	100	68	109	32	0.384	0.25-0.5,0.5-1,0.9-1,1-1.5,1-4,1-5,1-9,2-2.5,2.3-2.5,2.5-9,4.5-5,8-10,?,abaxially,acute,anther,apex,base,calyx,clavate,cm,cordate,corolla,densely,diameter,ellipsoid,elliptic,entire,fading,glabrous,globose,green,growth,immature,inflorescence,lateral,lobe,lobed,margin,membranous,mm,obovate,occasionally,pedicel,peduncle,petiole,pinnatifid,present,pubescent,purple,rotate-stellate,simple,slightly,sparsely,stem,stigma,style,surface,terminal,triangular,truncate,tube,vine,violet,white,woody,x,yellow	.5,0.25,1,1-3,10-50,3-3.5,5-8,5-merou,6-9,7-9,<,adaxiall,adaxially,age,always,alyx,anthesi,apar,ark,articulated,asymmetric,axil,berry,branched,broadly,brow,c.,clear,conical,connivent,curling,deltate,distributed,eaf,early,eed,equalling,exserted,filament,flower,free,fruiting,fusiform,geminat,ilament,irregularly,lamina,lengthening,lon,long,loosely,lower,many,mature,maturity,midrib,minute,minutely,new,nflorescence,observed,often,older,one,orolla,other,pair,papillo,pendan,perfect,pericarp,pinched,planar,plurifoliate,pore,poricidal,portion,primary,probably,pubescen,reddish,ruit,scar,shiny,sleeve,slender,slit,small,spaced,spreading,tem,thin,time,tip,transition,trichome,tuft,twinin,twining,ud,unequal,uniseriate,unit,upper,vary,vein,way,white-pubescent,ympodial	adhesion,arrangement,blade,climate,colour,form,fruit,glandular,hair,height,history,leaf,length,life,midpoint,na,number,ovary,plant,position,presence,pubescence,ray,reproduction,rugulose,seed,shape,size,staman,stellate,stipe,texture
309	wfo-0001027965	success	265	126	99	166	27	0.374	.25,.9,0.15-0.3,0.2,0.4,0.5,0.6-0.9,0.8-1.6,1.2,1.5-2,1.5-3.2,1/3-1/4,1/4-1/3,2-2.5,2-3,2-3.5,2.2-2.6,2.8-3.3,3.5,3.5-10,4-7,4.5,7-8,abaxially,acuminate,acute,adaxially,along,anther,anthesi,apex,armed,base,branch,calyx,capitate,chartaceous,clavate,clustered,cm,cordate,corolla,densely,development,diameter,distributed,drying,dull,entire,evenly,flattened,free,fruit,glabrous,grey-brown,lateral,leaf,length,liana,lobe,lobed,long,midpoint,mixture,mm,oblong,orange,orange-brown,outside,ovate,pedicel,peduncle,petiole,present,pubescent,ray,red-brown,reniform,rounded,shiny,shrub,simple,somewhat,sparsely,spheroidal,stellate,stellate-pubescent,stem,stigma,style,surface,tapering,throughout,tip,toward,trichome,tube,wrinkled,x	-2,.1,.2,.3,.5,.7,/3,0.1-0.2,0.15,0.3,0.4-0.5,0.5-3,0°,1,1-2,1-8,1.5-2.5,1/3-2/3,2-4,4-merou,6-9,abaxial,absent,accrescent,acicular,adaxial,adjacent,age,almost,alternate,alyx,ame,apar,ape,apically,apparently,articulated,bark,becoming,beneath,berry,branched,brown,brown-green,c.,canaliculate,covered,cupular,curved,deltoid,dense,density,detaching,discolorous,divided,dry,eaf,early,eed,ellipsoi,elongated,equal,erect,even,except,extending,fairly,fasciculate,filament,filiform,finely,fissure,flat,flexuous,flower,forming,fruiting,glabrescent,green,increasing,indumentum,inside,leave,lengt,lengthening,less,like,loop,lower,m.,main,mature,maturity,midvein,minor,nflorescence,nther,obconical,oblique,occasional,often,orolla,pair,pale,papillose,patch,pendulous,perfect,pericarp,pit,pitted,plurifoliat,pore,poricidal,porrect,portion,prickle,primary,protruding,rachi,raised,reduced,regular,remnant,ridged,ruit,scar,series,sessile,short,sinus,small,smooth,sometimes,sparse,spreading,stalk,stalked,straight,strongly,stump,tearing,terete,tertiary,thin,translucent,transverse,ud,unarme,unarmed,underneath,unequal,uneven,unit,usually,variable,vary,vein,venation,visible,white,wide,widening,ympodial,young,youngest	adhesion,arrangement,blade,climate,colour,form,glandular,growth,hair,height,inflorescence,margin,na,number,ovary,plant,position,presence,pubescence,reproduction,rugulose,seed,shape,size,staman,stipe,texture
310	wfo-0001027966	success	207	105	81	126	24	0.391	0.4-0.5,1-1.8,1-2,1-4.2,1-5,1.3-2.2,10,10-30,2.2-2.9,2.5-10.5,3-4,3-5,3-7,40-80,5-6,5-9.5,5.5-14,6-11,abaxially,adaxially,anther,axillary,blue-violet,brownish,bud,chartaceous,ciliate,cm,condition,conical,corolla,densely,diameter,drying,elliptic,fresh,fruit,glabrous,green,greenish,hair,herb,lanceolate,leaf,light,like,lobe,long,margin,membranous,minute,mm,moniliform,mottled,mucilaginous,odd-pinnate,ovate,ovoid,pedicel,peduncle,pentagonal,petiole,plant,pubescent,purple,ripe,rotate,seed,size,sparsely,stem,stigma,subtending,terminal,tube,tuber,wet,whitish,wide,x,yellow	0.7-3,0.8,0.8-2.5,1-10,1-3,1.2-4.5,1.5-3,1.5-5.2,2.8-9,4,5-10,5-merou,absent,acumen,acuminate,ag,along,alyx,apart,apex,apparently,arranged,articulated,asymmetrical,attenuate,axe,base,basiscopic,bead,berry,blade,capitat,cell,commonly,connivent,covering,decreasing,digestion,distal,dorsally,eaf,edge,eed,enzyme,erec,especially,exceeding,filament,flat,flower,folded,forked,geminat,generally,glabrou,gradually,green-white,hair-like,half,homostylous,honeycomb-shaped,interjected,larger,lateral,leaflet,lengthening,less,living,lower,make,medium,middle,multiple,narrow,necklace,nflorescence,orbicular,orolla,pair,pale,perfect,petiolule,plurifoliate,pore,poricidal,proximal,rarely,ray,removed,ruit,secondary,semierect,sessile,seudostipule,shorter,side,slightly,slit,somewhat,spaced,specimen,stamen,ste,stolon,straight,subequal,subsessile,symmetrical,tall,tamen,tem,testal,thick,throughout,tip,tissue,tri-,tyle,typically,unit,usually,violet,wall,white,wing,ympodial	adhesion,arrangement,calyx,capitate,colour,form,growth,height,history,inflorescence,length,life,na,ovary,perennial,position,pseudostipule,pubescence,reproduction,shape,staman,style,surface,texture
311	wfo-0001027978	success	197	121	94	103	27	0.477	0.2-0.5,0.5-1,1-2,1-3,1-6,1.5-2.5,10-14,11,2-2.5,2-3,2.5-3,3-5,3-6,4-10,4-5,4-6,4-8,5-8,6,7-10,7-9,abaxially,absent,acute,adaxially,along,andromonoecious,anther,apex,attenuate,base,blade,brown,calyx,chartaceous,cm,connivent,densely,diameter,entire,except,extra-axillary,flower,fruit,functionally,glabrous,globose,green,hair,hermaphroditic,immature,leaf,length,like,lilac,lobe,lobed,male,margin,mature,midpoint,midvein,mm,moderately,nearly,obtuse,orange-red,ovary,ovate,pedicel,peduncle,per,petiole,plant,porrect-stellate,pubescent,ray,round,shrub,side,simple,stellate,stem,stigma,style,surface,tan,tapering,thin-skinned,tube,white,wide,x,yellow	0.5-1x,1,1-1.5,1.5,1/6,2.5-5.5,20-40,6-10,8-12,abaxial,absen,accrescent,adaxial,alyx,andormonoeciou,apar,apical,apparently,armed,asymmetrical,axe,becoming,berry,beyond,cordate,cut,cylindrical,dark,difoliate,directed,discolorous,distal,eaf,eed,either,end,exserted,filament,filiform,flattened,frui,fruiting,geminate,glabrou,gree,heteromorphic,initially,introrsel,less,long,lower,major,many,midrib,midvei,multicellular,multiseriate,narrowly,netlike,nflorescence,occasionally,often,orange,orolla,pair,pit,pore,prickle,proximal,rachi,raised,recurved,reflexed,ridge,roselike,ruit,scandent,scattered,separated,short,sinus,slightly,small,spaced,sparsely,stalk,stamen,staminate,ste,straight,tamen,tem,triangular,unarmed,unbranched,unequa,unicellular,unit,vary,vegetatio,vein,way,ympodial	adhesion,arrangement,climate,colour,corolla,form,glandular,growth,height,history,inflorescence,life,na,number,perennial,position,presence,present,pubescence,reproduction,rugulose,seed,shape,size,staman,stipe,texture
312	wfo-0001027997	success	174	101	66	108	35	0.379	.2,.5,0.2-2,0.9-1,1,1-2,1-4,1.5-1.7,1.5-2,10-23,2,3.5-10,acute,anther,apex,attenuate,auriculate,base,becoming,bi-lobed,black,blade,calyx,cm,corolla,dia,dirty,dry,glabrous,globose,green,greenish-yellow,inflorescence,leaf,live,lobe,lobed,margin,mm,obovate,occasionally,opposite,ovary,ovoid-reniform,pale,pedicel,petiole,plant,poricidal,pubescent,ripe,shrub,small,somewhat,sparsely,specimen,stem,stigma,style,surface,tan,tip,tree,tube,white,x	.1,.6,0.1-0.7,0.1-0.8,1.5-1.8,10-20-flowered,7-10,7/8,abaxially,along,anthesi,apar,ba,bark,beneath,berry,breaking,bright,brittle,consisting,corky,decurrent,deflexed,deltoid,dense,densely,denser,distal,eaf,edicel,eed,entire,erect,even,evenly,exserted,filament,free,fruiting,glabrate,impressed,inflorescenc,keel,keeled,later,lateral,like,living,long,long-acuminate-triangular,long-ellipsoid,lower,main,middle,minutely,nflorescence,often,old,older,onto,ovoid,pair,papillose,partially,pitted,planar,pore,portion,prominent,pubesent,raised,reddish-brown,remaining,rest,ribbed,ruit,scar,scattered,sessile,shaped,short,simple,slender,slightly,soft,soon,spaced,straight,strongly,tall,tapering,tear-drop,trichome,trunk,ud,ultimately,unifoliat,uniseriate,unit,vasculature,vein,way,widest,wing,winged,woody,ympodial,young	0.5,adhesion,arrangement,climate,colour,diameter,form,fruit,glandular,growth,hair,height,history,length,life,midpoint,na,number,peduncle,perennial,position,presence,present,pubescence,ray,reproduction,rugulose,seed,shape,size,staman,stellate,stipe,texture,unifoliate
313	wfo-0001028014	success	222	111	80	142	31	0.36	-1,-15,-2.5,-4,-6,0.2,0.2-0.4,0.2-1,0.2-1.6,0.5-1,0.5-2,0.5-3,0.6-0.9,0.9-1.2,1-4,1.3-2.4,1.8-3,2-4.5,2-6.5,2.5-4,4.5-7,6-10,abaxially,almost,anther,apex,base,black,blade,calyx,chartaceous,cm,cordate,densely,diameter,equal,flattened-reniform,fruit,glabrescent,glabrous,lateral,leaf,length,lobe,lobed,long,margin,maturity,mauve,membranous,midpoint,mm,moderately,obtuse,orange,ovate,pedicel,peduncle,petiole,poricidal,purple,ray,red,rounded,seed,shrub,simple,smooth,spherical,stellate,stellate-pubescent,stem,style,surface,tapering,terminal,tip,tube,weakly,wide	-0.5,-1/2,-10,-3,-5,.5,/5,0,0.1-0.2,0.15,0.15-0.3,0.25,0.3-0.4,0.5,0.5-1.5,0.7-1,0.7-1.6,1-,1-10,1-2,1-3,1.5,1.5-2,1/4,1/4-2/3,2,2-20,2-3,3-10,4-10,5-merous,6-11,acuminat,alyx,ame,apar,apart,apically,apparently,around,articulated,bark,berry,branched,broad-deltate,brown,brown-green,c.,cell,concolorous,connivent,curved,decurrent,deltate,difoliate,discolorous,distance,drying,eaf,edge,eed,elongating,erect,extending,eye,filament,flattened,flower,free,fruiting,geminat,glabrou,gland,globular,gray,gray-green,herbaceous,infructescence,lon,longer,lower,mature,midvein,naked,nflorescence,occasionally,older,one,open,orange-gra,orolla,oung,outer,outline,pair,pale,pendulous,per,perfec,pericarp,pit,porrect,portion,prickl,prickle,prickly,primary,raised,reduced,reflexed,rough,ruit,scandent,scar,sessile,shiny,shorter,side,slender,sometimes,spaced,spreading,stalk,stalked,straight,strongly,tamen,terete,tertiary,time,trichome,unit,vary,vein,venation,visible,visibly,way,winged,yellow,yellow-green,ympodial	adhesion,arrangement,climate,colour,corolla,form,glandular,growth,hair,height,hermaphroditic,history,inflorescence,life,na,number,ovary,perennial,plant,position,presence,present,pubescence,reproduction,rugulose,shape,size,staman,stigma,stipe,texture
314	wfo-0001028017	success	158	109	81	77	28	0.513	-2.5,0.3-1,1.5-2,10-22,13-40,15-35,2,2-3,2-4,2.5-5,3,3-12,3-14,3-4,5-7,5-9,6-8,abaxially,acute,adaxially,apex,basal,base,brown,calyx,clavate,cm,cuneate,densely,diameter,eglandular,eglandular-puberulent,eglandular-pubescent,ellipsoidal,elliptic,entire,flattened,forked,fruit,fusiform,glabrous,glandular,glandular-,glandular-puberulent,green,greenish,hair,immature,lanceolate,lobe,margin,mm,moderately,oblique,ovate,pedicel,peduncle,petiole,pubescent,purplish,rarely,ripe,short-acuminate,simple,sometimes,sparsely,stellate,stellate-campanulate,stigma,style,subcoriaceous,tomentose,tree,truncate,tube,unbranched,vein,white,without,x,yellow	1,1-10,1-2,1-3,15-50-flower,3-foliat,40-50,5,6-7,9-11,absen,absent,acuminate,aggregate,apart,ape,apiculate,articulated,axe,beyond,blade,cell,chartaceous,ciliat,connective,connivent,cream,cylindrical,directed,distally,eaf,eed,exceeding,exserted,fleshy,flower,introrse,leaving,lon,long,lower,narrowly,near,nflorescence,nther,obtuse,orolla,ovoid,pedicellar,perfect,pointed,pore,puberulen,purple,rachi,radiu,remnant,ruit,shorter,slightly,small,spaced,stamen,stone,tal,tan,tem,thecae,time,tip,triangular,truncat,ud,unit,vary,wide,ympodial	anther,arrangement,ciliate,colour,corolla,form,growth,height,hermaphroditic,history,inflorescence,leaf,length,life,na,ovary,perennial,plant,position,presence,puberulent,pubescence,reproduction,seed,shape,size,stem,texture
315	wfo-0001028025	success	182	99	73	109	26	0.401	.8,0,0.1-2.2,0.15-0.25,0.2-0.3,0.2-0.7,0.5-0.7,0.9-1.2,1.4-2.2,1.5-7,1.6-3.5,13-21,16-23,2-2.3,2.5-4,3.5-4.5,6.5-10,7-13,7-9,acute,anther,apex,base,blade,calyx,chartaceous,cm,cordate,diameter,extra-axillary,flower,fruit,glabrous,gland-tipped,globose,green,hair,inflorescence,lateral,lavender,length,lobe,lobed,long,margin,mid-point,mm,obtuse,ovate,pale,pedicel,peduncle,perennial,petiole,present,ray,shallowly,short,shrub,simple,sparsely,stellate,stellate-pubescent,stem,style,thick,throughout,time,tube,white,x,yellow,yellowish-green	%,0-0.5,0-11,0.3-0.8,0.3-1,0.4-3,1-1.4,1-8,1.1-1.4,1.9-2.4,10-140,11-18,12-17,2-6,2-locular,3-5,3-6,4-10,4-8,5-,5-11,5-20,5-7,50-90,6-,7-8,9-14,abaxially,absen,absent,acicular,across,adaxiall,adaxially,alyx,anvil-shape,apart,armed,articulated,attenuate,axe,ba,broad-based,brown,cross-section,cylindrical,d.,directed,distall,distributed,dult,eaf,eed,eglandular,erect,exocarp,finger,fruiting,half,hig,index,juicy,lamina,less,lobing,lon,longer,lower,mature,merou,mesocarp,midpoint,midvein,minute,moderately,moist,nflorescence,oblique,onl,orolla,part,per,perfect,placenta,pore,porrect,prickle,pseudo-racemose,rhizomatous,ridged,ruit,sessile,side,spaced,stage,stalked,stellae,straight,tamen,transparent,unarmed,unbranched,unit,unknow,uvenile,vary,vein,wide,ympodial	adhesion,arrangement,colour,corolla,form,growth,height,hermaphroditic,history,leaf,life,na,number,ovary,plant,position,presence,pubescence,reproduction,seed,shape,size,staman,stigma,stipe,texture
316	wfo-0001028033	success	157	106	75	82	31	0.478	.6,1.4–1.8,1–5,2–4,3–11,3–4,3–5,4–12,4–5,50,6–12,abaxially,acuminate,acute,along,anther,apex,attenuate,base,blade,calyx,chartaceous,ciliate,cm,connivent,cyme,decurrent,densely,diameter,elliptic,entire,flower,fruit,glabrous,green,growth,herb,hispid-pubescent,lateral,length,light,like,lobe,long,mainly,margin,membranaceous,midrib,mm,oblong,pedicel,petiole,pubescence,pubescent,rhizomatous,shrub,simple,slightly,solitary,sparsely,spreading,stellate,stem,stigma,style,surface,trichome,tube,unbranched,uniseriate,upright,white,wide,yellow,×	1.5,1–4,2–3,2–foliate,3,5-merou,5–7,adaxiall,adaxially,alyx,anthesi,ark,ascending,becoming,branch,brochidodromous,brown,capitat,cell,contiguou,cordate,cylindrical,darker,deeply,denser,directed,discolorous,drying,eaf,eed,emarginate,equal,eye,few-branched,filament,florescence,geminat,glabrescent,greenish,high,introrsely,know,known,linear-lanceolate,lobed,longitudinal,lower,naked,nearly,new,older,onto,opening,order,orolla,ovate-lanceolate,perfect,pore,poricidal,prominent,prostrat,recurved,ruit,secondary,sessile,shin,shiny,shorter,slit,straight,strongly,subapical,tamen,tem,unit,unknown,vary,vein,venation,visible,woody,ympodial	adhesion,arrangement,capitate,climate,colour,corolla,form,glandular,hair,height,history,inflorescence,leaf,life,midpoint,na,number,ovary,peduncle,plant,position,presence,ray,reproduction,rugulose,seed,shape,size,staman,stipe,texture
317	wfo-0001028035	success	172	104	68	104	36	0.395	1,1.3-1.8,1/4-1/3,2,2.5-3.1,2.5-4,3-6,4.2-5.5,5-10,6-13,9-13,along,annual,anther,base,blade,bristly,brown,calyx,capitate,cm,dark,dia,diameter,dry,felty,flattened-ovoid,foveolate,fruit,glabrous,herb,internodal,leaf,lobe,long,long-rayed,main,maturity,midpoint,minutely,mm,narrowly,oblong,ovate,pedicel,pentagonal,petiole,pigmentation,prickly,purple,ray,red,reticulately,seed,slightly,spherical,splitting,stellae,stellate,stellate-pubescent,stem,suffused,surface,tube,undulate,vein,wrinkled,yellow	1.5,2/3,3,3.7-4.2,4-8,5,50-90,7-10,7-10-flowered,accrescent,acicular,across,almost,alyx,ample,anthesi,apically,armed,berry,bristle,broad,broad-based,broadly,campanulate,cauline,closely,confluent,congested,da,dark-based,deep,densely,developing,difoliate,distinct,divided,eaf,erect,exceeding,externall,flattened,flower,geminat,hardly,hilum,incurved,interpetalar,invested,lanceolate,lon,m.,markedly,n,nflorescence,notch,noticeably,numerous,often,one,orolla,other,per,pinnatifid,plicate,prickle,prominent,reaching,recurved,rounded,ruit,scattered,short,shorter,slende,sometimes,somewhat,spaced,spreading,stalk,stellate-wooll,stout,styl,sunken,symmetrically,tall,tamen,tapering,taprooted,terminal,tightly,tigma,tissue,tub,twice,tyle,ultimate,unit,upper,usually,vary,well,wide,yello,ympodial	adhesion,apex,arrangement,climate,colour,corolla,externally,form,glandular,growth,hair,height,history,inflorescence,length,life,margin,na,number,ovary,peduncle,plant,position,presence,present,pubescence,reproduction,rugulose,shape,size,slender,staman,stigma,stipe,style,texture
318	wfo-0001028044	success	195	102	70	125	32	0.359	.9,0.3,0.4-0.5,1.2-1.4,1.5-2,19-22,2-3,2-4,2.7-4,20-21,3-4,3-6,3.4-4.3,31-46,6.5-7.2,9.5-13,abaxial,abaxially,adaxially,anther,apex,attenuate,base,black,blade,blunt-tipped,brown,calyx,cm,corolla,creamy,dark,diameter,drying,entire,fleshy,fruit,glabrate,glabrous,globose,hair,immature,leaf,length,lobe,long-attenuate,margin,mm,multangulate,oblong,obovate-elliptic,pedicel,peduncle,petiole,porrect-stellate,rough-granular,seed,shrub,simple,sparse,stellate,stigma,style,surface,thin-textured,tomentose,tube,white,x,yellow	-3.5,-5,.6,1.3-2.2,1.4-1.6,1/3-1/2,11-13,11-16,16,2.8-3.3,3.5-4.6,4-5,5-merou,50,6-8,7.5-9,accrescent,acute,adaxiall,ag,along,alyx,anthesi,apart,around,articulated,ature,axe,axillary,becoming,berry,branch,branched,bud,bulbous-based,capitat,closely,concentrated,connivent,cylindrical,decurrent,dendritic,directed,distally,eaf,edge,except,exserted,few-rayed,filament,flower,frui,fruiting,geminate,glabrescen,green,greenish,high,homostylous,lackin,lateral,lengthening,lobed,long,long-stalked,longitudinal,lower,main,many,midrib,moderately,mostly,much,multangulat,nearly,nflorescence,obscured,obtuse,occur,orolla,ovate-lanceolate,pale,plurifoliate,pore,poricidal,presumably,pubescent,rachi,rather,resorption,ruit,runk,semi-obtuse,side,slender,slit,somewhat,spaced,sparsely,stalked,stamen,subcampanulate,suture,tamen,terete,thick,thick-stalked,time,tip,tissue,tomentu,unarme,unbranched,unit,unknown,vary,vein,way,weakly,wide,winged,yellow-brown,yellowish,ympodial,young	0.6,adhesion,arrangement,capitate,climate,colour,form,glabrescent,glandular,growth,height,history,inflorescence,life,midpoint,na,number,ovary,perennial,plant,position,presence,pubescence,ray,reproduction,rugulose,shape,size,staman,stem,stipe,texture
319	wfo-0001028046	success	186	96	70	116	26	0.376	0.5-1,1-1.5,1-7,1.5-2,12-13,13-38,2-3,2-4,2.5-3,3-12,4-5,5-18,6-7,8-9,acuminate,acute,anther,apex,attenuate,base,blue,brown,calyx,chartaceous,clavate,cm,compressed,coriaceous,corolla,diameter,elliptic,entire,glandular,globose,green,growth,heterostylous,inflorescence,lanceolate-subulate,leaf,length,lilac,lobe,margin,midpoint,mm,obovate,opposite,ovary,pedicel,peduncle,petiole,pubescence,ray,reniform,rusty-red,shrub,simple,stellate,stem,stigma,style,sub,subglobose,subhirsute,surface,tapering,truncate,tube,x	0.2-0.3,0.3-0.5,0.4-0.5,1-1.3,1-multicellular,1.2-1.5,10,10-15,20,abaxially,adaxially,anthesi,approximately,armed,articulated,bark,basal,berry,c.,campanulate,cylindrical,dark-brown,decurrent,deflexe,densely,denser,difoliat,distal,eaf,eed,erect,exserted,filament,flattened,flower,foliaceous,foveolate,free,fruiting,glabrescent,glabrous,gland-tipped,grayish,half,large,lengthening,lightly,like,lobed,long,long-styled,lower,minute,minutely,mixed,multangulate,multicellular,nearly,new,nflorescence,obverse,occasionally,older,ovoid,papillo,per,perfect,pericarp,pore,poricidal,porrect,portion,prickle,prickly,prominent,pubescent,raise,red,reduced,reflexed,rest,rigid,ruit,rusty,scabrous,scar,sessile,short-styled,slightly,slit,somewhat,spaced,sparse,sparsely,stalked,staminate,subcordate,subscandent,subsessile,tall,testa,thick,tip,tomentose,tomentose-scabrous,trichome,ud,unarmed,unevenly,unicellular,unit,upper,winged,yellow,ympodial,¼	adhesion,arrangement,blade,climate,colour,form,fruit,hair,height,history,life,na,number,perennial,plant,position,presence,present,reproduction,rugulose,seed,shape,size,staman,stipe,texture
320	wfo-0001028059	success	221	107	82	139	25	0.371	-4.5,0-1.2,0-2,0.1-0.7,0.4-0.8,0.5-0.7,0.5-1.3,1-3,1.1-12,1.5-2,1.5-2.1,1.5-3.5,2-10,2-5,2.5-2.6,2.5-3.5,3-17,4-8,4.5-7,8.5-10,absent,acuminate,acute,adaxially,andromonoecious,anther,apex,base,blade,brownish,calyx,chartaceous,cm,connivent,cuneate,densely,diameter,elliptic,entire,erect,fruit,glabrous,glandular,globose,green,hair,inflorescence,leaf,leaf-opposed,length,lilac,lobe,loosely,margin,midpoint,mm,moderately,oblate,oblong,obtuse,ovate,pale,pedicel,peduncle,perennial,petiole,plant,present,purple,ray,rhizomatous,shrub,simple,sparsely,stellate,stellate-pubescent,style,tube,weakly,x,yellow,yellowish-green	%,.4,0-0.2,0-0.3,0-15,0-7,0.1-0.3,0.1-0.6,0.4-0.7,0.4-0.9,0.5-0.8,0.6-0.8,0.6-1,1,1-1.5,1-2,1.1-4.5,15,2-2.6,2-3,2-foliate,2-locular,2.1-2.7,2.5-12,3-10,3-11.5,4-10,4-7,5-7,5-9,5-merou,6-17,60-90,8-18,9-12,9-17,abaxially,absen,accrescent,acicular,across,adaxiall,adult,alyx,anvil-shape,apart,articulated,ascending,attenuate,axe,ba,bark,branch,branche,brown,contiguous,corky,cross-section,cylindrical,decimetre,deltate,directed,distall,distributed,dm,eaf,eed,eglandular,exocarp,filament,finger,flower,fruiting,functional,furrowed,geminat,gland-tipped,half,heterostylous,interpetalar,juicy,juvenile,lamina,lateral,less,lobed,long,longer,lower,mature,mesocarp,mid-point,midvein,minute,moist,nearly,nflorescence,oblique,often,orolla,pair,part,per,placenta,pore,porrect,prickle,pseudo-racemose,rachi,ruit,rusty,shallowly,short,somewhat,spaced,sparse,stalk,stalked,stellae,straight,surface,tal,tamen,tem,thick,throughout,time,tissue,toward,transparent,unarme,unarmed,unbranched,unit,upper,vary,wide,yellowish,ympodial	adhesion,arrangement,climate,colour,corolla,form,growth,height,history,life,na,number,ovary,position,presence,pubescence,reproduction,seed,shape,size,staman,stem,stigma,stipe,texture
321	wfo-0001028067	success	139	101	69	70	32	0.496	0.5-1,0.5-1.5,0.5-2,1-2,1-3,1-7,1.5-2.5,10-25,2,2-2.5,2-3,2.5-3,3-17,3-5,3-7,5-7,6-18,7-11-compound,7-20,7-9,abaxially,acuminate,acute,adaxially,apex,base,blade,calyx,cm,connivent,cuneate,dark,diameter,elliptic-fusiform,elliptic-ovate,entire,flattened,fruit,glabrous,hair,leaf,lobe,margin,mm,moderately,narrowly,pedicel,peduncle,petiole,pink,pinnately,puberulent,purple,rarely,shrub,simple,sparsely,stellate,stigma,strongly,style,subcoriaceous,tomentulose,triangular,truncate,tube,unknown,x,yellow	-30,1,1-10,1-11,3-4,4-foliat,6-12,8-13,adaxiall,aggregate,along,apart,articulated,axe,basiscopically,cell,chartaceous,color,compound,cylindrical,decurrent,directed,distall,eaf,eed,especially,flower,glabrou,lateral,leaflet,leaving,lon,long,lower,midrib,nearly,nflorescence,nther,obtuse,often,orolla,pedicellar,per,pore,puberulen,rachi,radiu,remnant,ripe,ruit,several,slightly,smal,spaced,stone,tal,tem,time,tip,triangular-deltate,truncat,unbranched,unequal,unit,upper,usually,vary,wide,ympodial,zigzag	adhesion,anther,arrangement,climate,colour,corolla,form,glandular,growth,height,history,inflorescence,length,life,midpoint,na,number,ovary,perennial,plant,position,presence,pubescence,ray,reproduction,seed,shape,size,staman,stem,stipe,texture
322	wfo-0001028069	success	253	111	85	168	26	0.336	0.05-0.1,0.3-0.45,0.3-0.6,0.4-0.5,0.4-0.8,0.5,0.5-1.8,0.5-2,0.6-1.1,0.6-4,0.8-1.2,1-3.5,1.5-2.0,1.6-3.2,10,10-12,2-17,3,5-25,acute,anther,apex,base,basioscopically,brown,calyx,cm,composed,conical,corolla,decurrent,deep,deeply,dense,densely,diameter,fruit,glabrescent,glandular,glandular-villous,globose,green,herb,imparipinnate,interrupted,leaf,length,less,lobe,lobed,long,margin,minute,minutely,mm,oblique,obovate,orange,ovary,ovate,pale,pedicel,peduncle,pentagonal,perennial,petiole,plant,present,pubescence,pubescent,rounded,simple,size,stem,stigma,style,surface,tangled,thick,transparent,trichome,tube,uniseriate,wide,yellow	-0.4,-30,-6,.1,.1-0.2,.2,.5,0.1-0.15,0.1-0.2,0.1-0.3,0.1-0.5,0.1-0.6,0.2-0.3,0.2-0.5,0.3,0.3-0.4,0.3-0.7,0.3-1,0.4,0.4-1,0.5-0.7,0.7-1,0.7-1.3,0.7-1.5,1-2-celled,1-2.7,1-4.5,1.4,1.5-3.5,10-30,12,2-3-branched,2-4,2-7,2-locular,3-,3-foliate,4-celled,5-22,6-,<,abaxially,absen,abundant,accrescent,adjacent,adpressed,along,alternate,always,among,anthesi,apical,appearance,appendage,appressed,articulated,axi,ba,basal,becoming,berry,bilaterally,bract,bracteole-like,bright,cell,citru,column,cone-shaped,cordate,cuneate,curving,due,eaf,ebracteate,edicel,eed,eglandular,erect,exserted,filament,flower,forming,fruiting,fusion,giving,gland,gland-tippe,gland-tipped,gree,hair-like,half,halfway,head,included,initially,interjected,internode,larger,later,lateral,leaflet,like,lime,linear,lon,longer,longest,lower,maturity,middl,midvein,multicellular,narrowly,nflorescence,occasionally,often,one,outgrowth,pair,patent,per,petiolule,population,primary,procumbent,pseudostipule,quaternary,rarely,reflexed,robust,ruit,scarcely,scent,secondary,sessile,several,shaggy,short,shorter,silky,single-celled,slender,smaller,somewhat,staminal,sterile,straight,strong,subopposite,symmetric,tem,terminal,tertiary,testa,tightly,toward,ud,unicellular,unit,usually,varying,viny,wall,weak,winged,ympodial	adhesion,arrangement,blade,climate,colour,form,growth,hair,height,history,inflorescence,life,midpoint,na,number,position,presence,ray,reproduction,rugulose,seed,shape,staman,stellate,stipe,texture
323	wfo-0001028070	success	185	96	70	115	26	0.378	0-0.4,0.15-0.4,0.2-0.3,0.3-0.6,0.35-0.5,0.4-0.6,0.5-1.5,1-1.5,1-2,1.5-2.5,3.5-4,4-5.5,4-6,4-7,7-8,8-9.5,absent,acute,anther,apex,base,blade,calyx,chartaceous,cm,cuneate,dark,densely,diameter,entire,extra-axillary,fruit,globose,green,hair,inflorescence,juicy,lanceolate,lavender,length,linear,lobe,margin,midpoint,mm,moderately,moist,obtuse,pale,pedicel,peduncle,perennial,petiole,plant,present,ray,rhizomatous,shrub,simple,sparsely,stellate,stellate-pubescent,stem,stigma,streak,style,tube,white,x,yellow	%,.05,0-0.1,0-0.15,0-2,0-6,0.25-0.35,0.3-0.4,0.4-0.5,0.4-0.8,0.5-0.9,0.5-1,0.6-1.4,0.7-1.3,1-4,1-locular,1.5-7,10-40,3-7,3-8,4-9,5-7,5-9,5-merou,7-11,8-13,8-9,8.5-17,abaxially,absen,accrescent,acicular,across,adaxiall,adaxially,alyx,andromonoecious,apart,articulated,axe,ba,brown,connivent,cross-section,cylindrical,d.,deltate,directed,distall,distributed,dult,eaf,eed,eglandular,erect,exocarp,finger,flower,fruiting,functional,geminat,gland-tipped,half,heterostylous,hig,incomplete,lamina,lateral,less,long,longer,lower,mature,mesocarp,mid-point,midvein,minute,nflorescence,oblique,orolla,part,per,placenta,pore,porrect,prickle,pseudo-racemose,pseudo-umbellate,purple,ruit,rusty,semi-circula,septum,sessile,short,spaced,stage,stalk,stellae,straight,tamen,thick,throughout,time,truncat,unarme,unarmed,unbranched,unit,unknow,uvenile,vary,weakly,wide,ympodial	adhesion,arrangement,climate,colour,corolla,form,glandular,growth,height,history,leaf,life,na,number,ovary,position,presence,pubescence,reproduction,seed,shape,size,staman,stipe,texture,truncate
324	wfo-0001028075	success	196	95	71	125	24	0.362	1-2,1.5-2.5,1.6-2.7,10-35,2-4.5,2-6,3-23.5,4-7,5-17,5-7,5-8,5-9,7-30,8-12,abaxially,adaxially,anther,axillary,broadly,brownish,bud,chartaceous,ciliate,cm,condition,corolla,dark,diameter,drying,elliptic-lanceolate,fresh,fruit,glabrescent,glabrous,globose,green,greenish,herb,lanceolate,leaf,light,lobe,long,margin,membranous,minutely,mm,odd-pinnate,ovate,ovate-elliptic,ovoid,pale,pedicel,peduncle,pentagonal,petiole,plant,puberulent,rotate,seed,size,stigma,style,subtending,terminal,tube,white,whitish,wide,x,yellow	.5,1-10,1-2.7,1-3,1.5-7,2-3,2.5-10,3-11,4-12,5-12,5-14,5-merou,7-13,absent,acuman,acumen,acuminate,acute,ag,along,alyx,apart,apex,apparently,articulated,axe,base,berry,blade,borne,capitat,cell,connivent,covering,cuneate,decreasing,differentiated,digestion,distal,distally,distinctively,dorsally,dot,eaf,edge,eed,end,enzyme,erec,especially,exceeding,filament,flat,flower,folded,forked,geminat,generally,glabrescen,green-white,hair-like,half,homostylous,honeycomb-shaped,interjected,larger,lateral,leaflet,lengthening,ligulate,living,lower,make,middl,midrib,much,mucilaginous,narrow,nflorescence,oblique,obtuse,often,orolla,pair,perfect,petiolule,plurifoliate,pore,poricidal,purple,reflexed,removed,rounded,ruit,scattered,seudostipule,singly,slightly,slit,sometimes,spaced,specimen,stamen,star,stolo,straight,subcordate,tall,tamen,tem,testal,thick,throughout,tip,toward,tri-,tuber,typically,unit,usually,vary,wall,wet,wing,ympodial	adhesion,arrangement,calyx,capitate,colour,form,growth,height,history,inflorescence,length,life,na,ovary,perennial,position,pubescence,reproduction,rugulose,shape,staman,stem,surface,texture
325	wfo-0001028076	success	195	96	70	125	26	0.359	.5,0.4-0.5,1-1.3,1-2,1.8-2.2,110,12-22,13-14,2-5.4,2.2-2.6,2.5-4,4-5,5-20,5-6,5-6.5,7-8,abaxially,adaxially,anther,axillary,brownish,bud,chartaceous,cm,condition,conical,corolla,diameter,drying,elliptic,fresh,fruit,glabrous,green,greenish,herb,lanceolate,leaf,less,light,lobe,long,membranous,mm,odd-pinnate,ovate,ovoid,pedicel,peduncle,pentagonal,petiole,plant,pubescent,purple,rarely,ripe,rotate,seed,size,stem,stigma,style,subtending,tall,terminal,tube,whitish,wide,x,yellow	0.5,1-10,1-3,1.2-2.2,2-12,2-3,2.2-3.7,2.5-3,2.6-3.8,4.5-7,5,5-merou,?,absent,acumen,acuminate,ag,alyx,apart,apex,apparently,articulated,attenuate,axe,base,berry,blade,borne,capitat,cell,ciliate,connivent,covering,decreasing,densely,digestion,distal,dorsally,eaf,edge,eed,end,enzyme,erec,especially,exceeding,filament,flat,flower,folded,forked,geminat,generally,glabrou,gradually,green-white,hair,hair-like,half,homostylous,honeycomb-shaped,interjected,larger,lateral,leaflet,lengthening,like,living,lower,make,margin,medium,minute,mucilaginous,nflorescence,obtuse,orolla,pair,perfect,petiolule,plurifoliate,pore,poricidal,proximal,pubescen,ray,removed,round,ruit,secondary,semierect,sessile,seudostipule,singly,slightly,slit,spaced,specimen,stamen,ste,stolo,straight,subequal,subsessile,symmetrical,tamen,tem,testal,thick,thir,throughout,tip,toward,tri-,tuber,typically,unit,unwinged,usually,vary,wall,wet,white,wing,ympodial	adhesion,arrangement,calyx,capitate,colour,dense,form,growth,height,history,inflorescence,length,life,na,ovary,perennial,position,presence,pubescence,reproduction,rugulose,shape,staman,stellate,surface,texture
326	wfo-0001028080	success	187	110	82	105	28	0.439	0.25-0.5,0.5-1.5,0.5-2,0.5-3,1,1-1.5,1.5-2,1.5-5,2-2.5,2-8,2.5-3,2.5-9,20-30,3-4,30-40,5-6,6-7,8-10,abaxially,acute,adaxially,andromonoecious,anther,apex,base,blade,calyx,chartaceous,clavate,cm,densely,diameter,ellipsoidal,entire,equal,extra-axillary,flattened,flower,form,fruit,glabrous,glandular,green,hair,lanceolate,leaf-opposed,lobe,long,margin,midpoint,mm,moderately,outline,ovate,ovoid,pedicel,peduncle,pendent,perfect,petiole,plant,puberulent,pubescent,ray,reniform,rugulose,shrub,simple,sparsely,stellate,stellate-pubescent,stem,stigma,style,subcordate,surface,truncate,tube,unbranched,white,x,yellow	0.2-1.5,1-2,1-3,2-10,2-3,2-5,4-6,5-12,5-merous,absent,accrescen,acuminate,adaxiall,alyx,andromonoeciou,apart,armed,articulated,axe,ba,bark,berry,branch,brown,brownish,capitat,connivent,cylindrical,directed,distally,eaf,eed,eglandular,filament,fine,fissure,formed,free,fruiting,geminat,gradually,hermaphroditic,heteromorphic,interpetalar,lateral,like,linear-lanceolate,long-,long-stalked,longitudinal,lower,lowering,major,midvein,multangulate,narrowly,needle-like,nflorescence,opening,orolla,part,pericarp,persistent,plurifoliate,pore,porrect-stellate,prickle,projection,rachi,recurved,ruit,scandent,sessile,short-,short-stalked,short-styled,shorter,side,slit,small,sometimes,spaced,staminate,stellate-multangulate,straight,strongly,tall,tamen,tapered,thi,time,tissue,triangular,unarmed,unequal,unit,vary,vein,vertical,weakly,white-pubescent,whitish,wide,without,ympodial	adhesion,arrangement,capitate,climate,colour,corolla,growth,height,history,inflorescence,leaf,length,life,na,number,ovary,perennial,position,presence,pubescence,reproduction,seed,shape,size,staman,stipe,texture,ye
327	wfo-0001028105	success	150	93	73	77	20	0.487	.5,0.3-1.5,0.5,0.5-2,0.6-1,1-1.2,1-1.5,1.5,1.5-1.8,1.5-2,2,2-2.2,3-5-celled,3-6,3.5-4,9.5-15,abaxially,adaxially,anther,apex,axil,base,bilobed,calyx,clavate,cm,corolla,dark,dense,dia,elliptic,flattened-reniform,glabrous,glandular,globose,green,incrassate,leaf,lobed,long,margin,minutely,mm,nearly,opposite,ovary,pedicel,petiole,pitted,pore,poricidal,pubescent,reddish-brown,shaped,shrub,simple,size,slightly,small,stem,stigma,style,surface,tear-drop,tip,tree,trichome,tube,tuft,uniseriate,vein,white,x	.1,.4,0.5-1,1-2.5,1.5-4.5,2-5,5-7-flowered,6-7,acuminate,acute,anthesi,apar,apical,attenuate,axi,ba,bark,berry,conical,deflexed,differing,difoliate,distinct,drying,eaf,edicel,eed,ellipsoid,erect,evenly,exserted,filament,filiform,free,fruiting,geminat,greenish-yello,lamina,lateral,like,lobe,lon,lower,main,major,middle,minor,nflorescence,occasionally,older,olive-green,pair,pale,papillo,papillose,planar,portion,projection,quadrate,reflexed,ruit,scar,scattered,spaced,sparsely,spreading,straight,strongly,tall,tub,ud,unit,widest,woody,yellowish,ympodial,young	colour,diameter,form,fruit,growth,height,history,inflorescence,length,life,na,perennial,plant,position,pubescence,reproduction,rugulose,seed,shape,texture
328	wfo-0001028109	success	205	107	78	127	29	0.38	-20,-4,-7,0.4-1.5,0.45-0.65,0.5-2.5,0.6-0.8,0.8-1.5,1.5-2.5,1.5-5.5,12-40,2-4,2.3-2.9,2.5-3,2.5-5,20-60,3-,4-13,5-13,acuminate,acute,anther,apex,base,blade,bright,calyx,chartaceous,cm,cuneate,densely,diameter,dull,elliptic,entire,evenly,flattened-reniform,fruit,glabrescent,glabrous,green,lateral,leaf,length,lobe,lobed,long,margin,maturity,mauve,midpoint,mm,moderately,orange-brown,pedicel,peduncle,petiole,poricidal,ray,red,shrub,simple,small,sometimes,spherical,stellate,stellate-pubescent,stem,style,tapering,terminal,tip,tree,tube,white,wide,yellow,young	.5,/3,0.05-0.15,0.05-0.2,0.1,0.1-0.2,0.3,0.4-0.8,0.5-1.2,0.7,0.8-1.6,1.5-10,1/8-1/4,10-25,10-30,15-100,2-15,2/3-3/4,3-7,3.5-6,3/4,30-150,4-5-merous,5-30,8-12,8-15,8-25,abaxial,abaxially,acut,adaxial,almost,alyx,ame,apar,apart,apically,apparently,articulated,bark,berry,branching,brow,c.,connivent,curved,deltate,dimorphic,discolorous,drying,eaf,eed,elongating,equal,erect,filament,flower,free,fruiting,fully,geminate,gently,glabrou,gray-green,green-brown,infructescence,light,long-styled,longer,lower,mature,minor,multangulate,nflorescence,obtuse,occasionally,older,one,open,opening,orolla,oung,pair,per,perfec,pericarp,perpendicular,plurifoliat,porrect,portion,prickl,prickle,prickly,primary,recurved,red-brown,reflexed,ruit,scar,secondary,sessile,slender,smooth,spaced,spreading,stalk,stalked,straight,strongly,surface,tamen,terete,tertiary,time,trichome,unarme,unarmed,unit,usually,vary,vein,venation,visible,way,weakly,woody,ympodial	adhesion,arrangement,climate,colour,corolla,form,glandular,growth,hair,height,history,inflorescence,life,na,number,ovary,plant,position,presence,present,pubescence,reproduction,seed,shape,size,staman,stigma,stipe,texture
329	wfo-0001028115	success	165	110	70	95	40	0.424	-1.1,-2.5,-5.2,0.42,0.7-0.8,1.1-1.8,1.4-1.7,1.7-2.2,1.8-3.5,2-3.2,5-15,6-10,abaxially,abundant,acute,adaxially,anther,antrorse,apex,attenuate,base,blade,blue,calyx,campanulate,capitate,cm,diameter,ellipsoidal,elliptical,entire,glabrescent,glabrous,glandular,globose,herb,length,light,lobe,long,margin,mm,moderately,narrowly,non-glandular,one,ovate,pale,petiole,pinnatifid,pinnatipartite,pinnatisect,prostrate,pubescent,rarely,scarce,seed,small,stem,stigma,style,trans-ovoidal,trichome,tube,tuberculate,unifoliate,violet,wide,x,yellow	.2,.6,0.2-0.3,0.5,0.6-0.7,0.8-,1-2.4,1-3,1.3-1.8,12-13.5,2-,2.5-,3-4.5,3-5,3-6.5,4.7-,5-8.5,7-7.5,9-17,accrescent,acuminat,ag,alternate,amply,annular,articulate,basal,berry,coat,connectival,curved,difoliat,dorsal,eaf,eed,embryo,especially,evident,exceeding,filament,fruiting,growing,half,herbaceous,hig,inflated,linear,longer,longitudinal,longitudinally,lower,mixed,much,multi-seeded,near,nerve,oblong,opening,opposite,orolla,pair,papery-scarious,papillo,pore,poricidal,portion,prolongation,ree,reticulate,ridged,ruit,segment,similar,simple,slender,slightly,slit,smooth,sometimes,strongly,styl,subsessil,tem,time,tip,triangular,unequal,uniseriate,unit,vary,venation,wider,width,winged,ympodial	0.6,0.8-2.4,2-6.5,2.5-4.5,adhesion,arrangement,climate,colour,corolla,difoliate,form,fruit,growth,hair,height,history,inflorescence,leaf,life,midpoint,na,number,ovary,pedicel,peduncle,perennial,plant,position,presence,pubescence,ray,reproduction,rugulose,shape,size,staman,stellate,stipe,surface,texture
330	wfo-0001028131	success	208	119	87	121	32	0.418	.5,0.1-0.15,0.2-1.5,0.3-0.7,0.4-0.8,0.5-1.1,0.8-1.1,1.5-3,1.8-2.2,1/5,2-2.8,2-4,2-6.5,4-6,5-6.5,5-8,abaxially,absent,anther,apex,attenuate,base,berry,blade,calyx,chartaceous,cm,connivent,cream,dark,densely,diameter,dull,equal,flattened-reniform,fruit,glabrescent,glabrous,green,herb,lateral,leaf,length,lobe,lobed,long,margin,marking,maturity,mauve,membranous,midpoint,mm,moderately,narrow-obovate,narrow-ovate,obtuse,orange,orange-brown,pale,pedicel,peduncle,petiole,poricidal,porrect,purple,ray,red,rounded,sessile,simple,sparsely,spherical,spreading,stellate,stellate-pubescent,stem,style,surface,tapering,tip,trichome,tube,upper,wide,yellow,young	-1.2,.1,/5,0-0.6,0-2,0-3,0-30,0-4,0.05-0.2,0.1-0.3,0.7-1.1,0.8-1,1-10,1-3,1-4,1-5,1.5-5,1.8-2,1/4-2/3,2-5,2/3,3-6,5-merous,6-7,7-8,abaxial,acuminat,adaxial,alyx,apar,apart,apically,apparently,articulated,bark,branched,broad-deltate,cell,concolorous,curved,deltate,difoliate,distance,drying,eaf,eed,elongating,epidermi,erect,extending,eye,filament,filiform,flattened,flower,free,fruiting,geminat,gland,infructescence,lanceolate,lengt,like,longer,lower,mature,midvein,naked,nflorescence,oblong,often,older,one,open,orolla,oung,outline,pair,pale-brown,pale-gra,pendulous,per,perfec,pericarp,pit,portion,prickl,prickle,prickly,primary,raised,reduced,reflexed,ruit,scar,sessil,shiny,shorter,side,small,smooth,sometimes,spaced,straight,strongly,sunk,tamen,terete,tertiary,time,unarme,unarmed,unit,vary,vein,venation,visible,way,woody,yellow-green,ympodial	adhesion,arrangement,climate,colour,corolla,form,glandular,growth,hair,height,hermaphroditic,history,inflorescence,life,na,number,ovary,perennial,plant,position,presence,present,pubescence,reproduction,rugulose,seed,shape,size,staman,stigma,stipe,texture
331	wfo-0001028147	success	185	83	59	126	24	0.319	.5,3-5,4-5,abaxially,acuminate,adaxially,anthesi,apex,base,brown,chartaceous,cm,cuneate,dark,decurrent,diameter,dry,entire,flattened-reniform,glabrous,globose,green,immature,lateral,light,major,margin,mature,midrib,minutely,mm,mottled,narrowly,oblong,orange,ovate,ovoid,pedicel,peduncle,petiole,pitted,prickle,rachi,recurved,rugose,seed,shape,side,simple,slender,somewhat,spine,stem,surface,terminal,turning,vein,vine,×	0.25,0.5,0.6,1.5–2,1.5–5.5,1.6–2.3,10–15,15–20,1–2,1–4,1–5,2–4,2–7,2–8,3.5–4.5,3.5–9,3–4,3–6,5–10,5–12,6–9,7–10,absent,acute,ag,alyx,anther,appearing,armed,articulated,axe,becoming,berry,blade,branched,break,broadly,bud,calyx,campanulate,cell,connivent,corolla,deciduous,deltate,dr.,eaf,eed,ellipsoid,elongate,elongating,equal,except,exserted,fifth,filament,five,flower,four,fruiting,hairy,herbaceous,internode,interpetalar,lanceolate,larger,lengthening,lobe,lobed,long,long-styled,longer,lower,nearly,nflorescence,often,one,orange-red,orolla,outer,paired,pale,pentagonal,pericarp,plurifoliat,pore,poricidal,puberulent,pulp,rarely,recurve,robust,ruit,season,seen,shallowly,short-styled,slightly,slit,spreading,stellate,stigma,stout,straight,style,subcaudate,tamen,testal,time,tip,tissue,truncat,tube,unequal,unit,vary,wall,white,wide,wood,woody,x,yellow,yellow-green,yellowish-orange,ympodial	0.25-0.6,1-2,1-4,1-5,1.5-5.5,15-20,2-7,2-8,3-6,3.5-9,5-10,7-10,armament,arrangement,color,form,fruit,growth,inflorescence,leaf,length,position,size,texture
332	wfo-0001028148	success	157	121	85	72	36	0.541	-6,0.25-0.5,0.5-1.5,0.6-3.5,0.75-2,1-3.5,1.5,1.5-2.5,12-15,2,2-3,2.5-4,3.5-4,3.5-9,5,5-7,5-8,6-18,abaxially,acute,adaxially,angled,apex,base,blade,blue-black,calyx,cm,connivent,dark,decurrent,densely,diameter,distal,elliptic,entire,especially,fleshy,fresh,fruit,glabrous,glaucous,globose,hair,less,lobe,margin,material,minute,mm,moderately,narrowly,orange,ovate,part,pedicel,peduncle,petiole,pink,plicae,plicate,puberulent,puberulent-pubescent,purple,rarely,rhizomatous,ridge,rotate-stellate,scalloped,shrub,simple,slender,smooth,stigma,style,succulent,surface,tapered,treelet,tube,unbranched,violet,whitish,x,yellow	.5-4,1-15,10-30,15,2-7,20-50,4-10,4.5-10,5-10,5-20,absen,aggregate,apart,apiculate,articulated,axe,ba,branched,broadly,cell,central,chartaceous,cylindrical,deltate,directed,distall,eaf,eed,except,flower,highly,light-colored,long,lower,many-foliat,margi,mature,midrib,nflorescence,nther,obtuse,often,orolla,perfect,pore,puberulence,rachi,radiu,ripe,ruit,slightly,smoot,sometimes,spaced,sparse,star,stone,tal,tem,thickened,time,tip,triangular,truncat,unit,usually,vary,white,wide,winge,ympodial,young	0.5-4,adhesion,anther,arrangement,climate,colour,corolla,form,glandular,growth,height,history,inflorescence,leaf,length,life,midpoint,na,number,ovary,plant,position,presence,pubescence,ray,reproduction,rugulose,seed,shape,size,staman,stellate,stem,stipe,texture,truncate
333	wfo-0001028161	success	124	83	42	82	41	0.339	0.1-0.25,0.25-0.5,1-1.3,1-1.5,1.5-4.5,2-9,2.5-3,3-4,3-7,4-5,7.5-12,acuminate,acute,apex,attenuate,base,brown,calyx,cm,corolla,elliptic,globose,green,lanceolate,leaf,margin,mm,narrowly,opposite,ovoid-reniform,pale,pedicel,petiole,pubescence,pubescent,shape,shrub,size,sparsely,stem,surface,x	.5,0.7-1.7,1-2,1-2.3,1/3,2-5-flowered,6-9,9-11,abaxially,adaxially,along,anthesi,arising,ba,bark,berry,branch,branched,cell,closely,congested,consisting,deflexed,dendritic,densely,denser,dia,differing,difoliate,distal,eaf,edicel,eed,exserted,fruiting,geminat,glabrescen,incrassate,inflorescenc,later,lateral,like,lon,long,main,major,middle,minor,minutely,nflorescence,obovoid,often,older,orbicular,outline,overlappin,pair,pitted,probably,reddish-brown,rest,rounded,ruit,scar,short,simple,sinuate,somewhat,spaced,strongly,tall,tan,tapering,thin,trichome,tub,ud,unit,vein,widest,ympodial,young	0.5,adhesion,anther,arrangement,blade,climate,colour,dense,diameter,form,fruit,glandular,growth,hair,height,history,inflorescence,length,life,lobe,midpoint,na,number,ovary,peduncle,perennial,plant,position,presence,ray,reproduction,rugulose,seed,staman,stellate,stigma,stipe,style,texture,tube,ye
334	wfo-0001028164	success	197	119	95	102	24	0.482	-1,-14,-6,/4,0.05-0.2,0.4-0.8,0.5-0.8,0.5-1,0.7-1.1,0.9-1.6,1-4.5,1.8-2.5,1/3,2.5-4,2.5-4.5,2.8-4,3-17,3-7,3.6-4.8,4-8,8-17,abaxially,acuminate,acute,anther,apex,attenuate,base,berry,blade,bright,calyx,cm,connivent,densely,diameter,dull,elliptic,entire,equal,erect,evenly,flattened-reniform,fruit,glabrescent,glabrous,glandular,green,hair,lateral,leaf,length,lobe,lobed,long,margin,maturity,mauve,membranous,midpoint,midvein,minute,mm,moderately,obtuse,orange-brown,pale,pedicel,peduncle,petiole,poricidal,ray,red,shallowly,shrub,simple,sometimes,spherical,spreading,stellate,stellate-pubescent,stem,style,surface,tapering,terminal,tip,tube,undulate,upper,way,white,wide,yellow,young	-8,0-20,0.05-1.5,0.1,0.3-0.8,0.8-1.5,1,1-1.5,1.5-2.5,1/6-1/4,12-20,2-2.5,4-13,4-5-merous,4-7,6-8,8-15,abaxial,almost,alyx,ame,apar,apically,apparently,articulated,bark,branched,c.,concolorous,curved,dark,deltate,difoliate,drying,eaf,eed,elongating,eye,filament,filiform,flower,free,fruiting,geminat,glabrescen,glabrou,gray,infructescence,less,long-acuminat,longer,lower,mature,multangulate,naked,narrow-deltate,nflorescence,often,older,one,open,orolla,oung,pair,per,perfec,pericarp,porrect,portion,primary,recurved,red-brown,reflexe,ruit,scar,sessile,shorte,shorter,side,smooth,spaced,sparsely,stalk,stalked,straight,tamen,terete,tertiary,time,trichome,unarme,unarmed,unit,variously,vary,vein,venation,visible,woody,yellow-gra,yellow-green,ympodial	adhesion,arrangement,climate,colour,corolla,form,growth,height,inflorescence,na,number,ovary,plant,position,presence,pubescence,seed,shape,size,staman,stigma,stipe,texture,ye
335	wfo-0001028180	success	147	111	77	70	34	0.524	.5,1-1.2,1-1.5,1-1.8,1-3,15-28,2-3,2.5-3,3-4,4.5-5,5-6,5-8,7,abaxially,acute,adaxially,along,anther,apex,attenuate,base,calyx,capitate,cm,corolla,cucullate,dark,darker,densely,dia,drying,elliptic,glabrous,globose,golden,green,lateral,leaf,lobe,lobed,long,main,margin,midrib,minutely,mm,nearly,onto,opposite,ovary,ovoid-reniform,pale,papillose,pedicel,petiole,pinkish-white,pitted,pubescent,shaped,shiny,size,somewhat,stem,stigma,style,surface,tan,tear-drop,tip,tree,trichome,tube,uniseriate,vein,white,winged,x	.05,/2,0.7-1,1.5-5,2-2.2,20-30-flowered,3-10,8-10,anthesi,ba,bark,beginning,berry,c.,closely,conical,deflexed,deltate,differing,difoliate,distinctly,eaf,eed,elongate,erect,falcate,filament,fleshy,four-angled,free,fruiting,geminat,glabrat,gold,irregularly,know,larger,leathery,lon,lower,major,minor,nflorescence,obscure,older,overlappin,pair,planar,pore,poricidal,portion,puberulent,ruit,scar,simple,small,spaced,sparsely,straight,styl,tall,thick,ud,underside,unit,way,woody,yellow-gray,ympodial,young	adhesion,arrangement,blade,climate,colour,diameter,form,fruit,glandular,growth,hair,height,history,inflorescence,length,life,midpoint,na,number,peduncle,perennial,plant,position,presence,pubescence,ray,reproduction,rugulose,seed,shape,staman,stellate,stipe,texture
336	wfo-0001028182	success	150	96	62	88	34	0.413	0.5,0.5-1,0.8-1,0.9-1,1-1.5,2-2.5,2-6.5,3-5,6-9,along,anther,apex,base,beneath,black,blade,calyx,capitate,ciliate,cm,cordate,corolla,dry,glabrous,hemiepiphyte,inflorescence,internodal,leaf,less,like,lobe,lobed,long-acuminate,margin,material,midrib,mm,narrowly,nearly,opposite,ovary,ovate,pedicel,petiole,poricidal,present,pubescent,shiny,shrub,somewhat,sparsely,stem,stigma,style,surface,tip,trichome,truncate,tube,uniseriate,white,x	.5,0-90,0.1-0.2,0.5-0.6,2,3,4-6,5-15-flowered,5-ribbed,anthesi,apart,apiculae,apiculate,arching,axi,bark,bending,branch,brown,conical,deflexed,deltoid,densely,dia,eaf,edicel,eed,ellipsoid,evenly,except,extreme,filament,filiform,flower,free,globose,gre,keeled,know,known,later,lateral,lax,long,lower,main,minute,minutely,nflorescence,obovoid,older,pair,papillo,papillose,planar,pore,portion,prominent,proximal,purplish,reflexed,rib,rounded,ruit,sca,scar,shaped,simple,slender,slightly,spaced,sparser,specimen,spindly,still,strongly,tapering,tear-drop,third,time,ud,unifoliat,unit,vein,widest,ympodial,young,zig-zag	1,adhesion,arrangement,climate,colour,diameter,form,fruit,glandular,growth,hair,height,history,length,life,midpoint,na,number,peduncle,plant,position,presence,pubescence,ray,reproduction,rugulose,seed,shape,size,staman,stellate,stipe,texture,unifoliate
337	wfo-0001028183	success	237	133	101	136	32	0.426	-10,0.2-0.3,0.2-0.5,0.5,0.5-2.5,0.7-1.2,0.8-1.4,1.1-1.8,1.2-1.4,1.3-1.7,1.4-2.8,1.5-3.4,1.9-3.7,11-30,2-4.2,2-5,2.8-4.2,3.5-6.6,4.5-9,5.2-6.2,6.6-20,7.5-23,abaxial,abaxially,adaxially,along,anther,apex,attenuate,axi,base,blade,blunt-tipped,brown,calyx,capitate,central,chartaceous,cm,corolla,cuneate,dark,deltoid,diameter,drying,dull,elliptic,elongated,entire,flower,fruit,glabrescent,glabrous,globose,hair,half,inserted,lanceolate,leaf,lobe,long,margin,mm,narrowly,nearly,oblong,orangish-tan,pedicel,peduncle,petiole,porrect-stellate,pseudoterminal,pubescence,pubescent,purple,reportedly,reticulate-punctate,ripe,scabrous,shrub,simple,small,soon,spherical,stellate,stem,stigma,streak,style,sub-lenticular,surface,tree,tube,upper,usually,violet,white,whitish,x,yellow,yellowish	-5.3,.5-3,0.1,0.1-0.2,0.1-0.4,0.1-0.9,0.2-0.4,0.6,0.7-2,0.8-3.1,1.3-1.4,1.6-2.3,1.7-2.7,1/3-1/2,10-15,2.2-5.7,2.5-4.1,2.6-4.4,3.2-,4.6-6.4,5-8,5-8.5,50-400,8-9.1,9-13,accrescent,acute,ag,alyx,anthesi,apart,apparently,around,articulated,axillary,bark,berry,branch,branched,bud,cell,closely,cylindrical,dendritic-multangulate,directed,distally,distantly,eaf,earl,edge,eed,epidermal,especially,evident,except,exserted,farinose,few-rayed,filament,free,fruiting,glabrescen,granular-punctate,group,high,lackin,lateral,lengthening,lobed,lon,long-decurrent,longitudinal,lower,m.,main,many,midrib,multangulate,nflorescence,obovoid,older,open,orolla,ovate-lanceolate,overlapping,perfec,plurifoliate,pore,poricidal,porrect-stellat,present,prominent,rachi,rarely,relatively,ruit,runk,sessile,short,short-,side,slit,somewhat,spaced,sparingly,sparse,splitting,stage,stalk,stamen,stipitate-glandular,stout,strongly,subcampanulate,suture,tamen,tan,terete,thick,thin,thin-textured,time,tip,tomentose,touching,translucent,ud,unarme,unit,vary,vein,way,wide,yellowish-tomentose,ympodial,young	0.3,3.2-6.4,adhesion,arrangement,climate,colour,form,glandular,growth,height,history,inflorescence,length,life,midpoint,na,number,ovary,perennial,plant,position,presence,ray,reproduction,rugulose,seed,shape,size,staman,stipe,texture,ye
338	wfo-0001028226	success	185	98	71	114	27	0.384	.5,0-0.1,0.1-0.3,0.15-0.3,0.15-0.45,0.4-0.6,0.6-1.3,1.2-2.6,2-5.5,2.5-3,2.7-3.2,3.5-4.5,5-8,5.5-8.5,9-15,absent,adaxially,andromonoecious,anther,apex,base,blade,calyx,chartaceous,cm,cuneate,deeply,densely,diameter,elliptical,extra-axillary,fruit,glabrous,gland-tipped,globose,green,hair,herbaceous,inflorescence,lavender,leaf-opposed,length,lobe,lobed,long,margin,midpoint,mm,obtuse,ovate,pale,pedicel,peduncle,petiole,plant,present,prostrate,ray,resprouter,shallowly,short,simple,sparsely,sprawling,stellate,stellate-pubescent,strongly,style,tube,x,yellow	%,0-1,0-2,0.2-0.3,0.25-0.4,0.25-0.5,0.3-0.7,0.3-1,0.4-0.7,0.5-1,0.5-1.2,0.7-0.9,1,1-2,1-3,1-5,1.5-3,1.5-5,1.6-2.4,10-16,10-45,13-22,15-27,18-50,2-3,2-5,2.5-9,5-merou,6-8,7-8,9-14,abaxially,absen,accrescent,acicular,across,adaxiall,adult,alyx,apart,apparently,armed,articulated,axe,ba,branche,brown,confined,cylindrical,deltate,directed,distall,distributed,dm,eaf,eed,eglandular,finger,flower,fruiting,functional,geminat,half,heterostylous,index,juic,lamina,lateral,less,lobing,lon,longer,lower,mature,mesocarp,midrib,midvein,minute,moderately,moist,nflorescence,oblique,onl,orolla,part,per,plurifoliate,pore,porrect,prickle,pseudo-umbellate,rostrate,ruit,sessile,side,solitary,somewhat,spaced,stage,stellae,straight,tal,tamen,tem,thick,throughout,time,transparent,unbranched,unit,uvenile,vary,wide,ympodial	adhesion,arrangement,climate,colour,corolla,form,glandular,growth,height,history,leaf,life,na,number,ovary,position,presence,pubescence,reproduction,seed,shape,size,staman,stem,stigma,stipe,texture
339	wfo-0001028227	success	236	124	95	141	29	0.403	-6.2,0.2-0.3,0.2-0.4,0.9-1.4,1-1.7,1-2.5,1-4.2,1.2-2,1.3-4,1.4,1.4-2.6,1.5-2.3,1.7-2.8,10-24,2-12,2-3.8,2.5-7.8,3-4.9,3.7-6.3,4.8-7.6,6-16,6.7-15,abaxial,abaxially,acuminate,acute,adaxially,anther,apex,attenuate,base,blade,blunt-tipped,brown,brownish,calyx,cm,corolla,cuneate,dark,deltoid,diameter,drying,echinoid,elliptic,elongate,entire,farinose,fleshy,fruit,globose,granular-tomentose,gray,green,hair,inserted,leaf,lobe,long,margin,mm,multangulate,oblong,oblong-lanceolate,obtuse,orangish-tan,pale,pedicel,peduncle,petiole,porrect-stellate,present,pseudoterminal,pubescence,purple,reticulate-punctate,ripe,scabridulous,shrub,simple,stellate,stem,stigma,style,sublenticular,subspherical,surface,tomentose,tree,tube,velutinous,violet,x,yellow,yellowish	-2/3,.5-4,0-250,0.1,0.2,0.2-0.5,0.3,0.4,0.5,0.7-2.1,0.8,0.8-1.4,0.9,0.9-1.2,1,1.1-3.1,1.9,1.9-4.2,1.9-5.8,1/2,1/2-3/4,10,11-15,2.6-5.9,2.9-4.7,3.7-7,4-13,5-7.5,8.1-18,8.5-22,accrescent,ag,age,along,alyx,anthesi,apart,apparently,appressed,around,articulated,axillary,bark,becoming,berry,blunt-tippe,branch,branched,bud,c.,closely,cylindrical,decurrent,dendritic-echinoid,directed,distally,eaf,early,echinoi,edge,eed,ength,exserted,filament,flower,free,fruiting,glabrescent,glabrous,grayish,high,lacking,lanceolate,lateral,lengthening,less,lobed,lon,longitudinal,lower,m.,main,many,midrib,midvein,mostly,nflorescence,obscured,occasionally,often,older,orbicular,orolla,ovate-lanceolate,ovate-orbicula,overlapping,perfec,plurifoliate,pore,poricidal,prominent,pubescent,quarter,rachi,relatively,rounded,ruit,runk,sessile,side,slightly,slit,somewhat,spaced,sparsely,stalk,stamen,stout,subcampanulate,sulcate,suture,tamen,thick,thicker,thin,time,tip,tomentu,touching,ud,unarme,unit,upper,usually,vary,vein,way,well,wide,ympodial,young	adhesion,arrangement,climate,colour,form,glandular,growth,height,history,inflorescence,length,life,midpoint,na,number,ovary,perennial,plant,position,presence,ray,reproduction,rugulose,seed,shape,size,staman,stipe,texture
340	wfo-0001028228	success	143	98	59	84	39	0.413	0.1-1.7,1-1.5,1.1-1.2,1.2-1.8,1.5-2,2,2-8,2.8-6.5,3/4,6-7,7.5-12.5,acute,anther,apex,area,base,brown,calyx,cm,coriaceous,corolla,dark,dia,elliptic,glabrous,globose,green,leaf,lobe,lobed,margin,minute,minutely,mm,obovate,occasionally,opposite,ovary,ovoid-reniform,papillose,pedicel,petiole,reticulate,rounded,shaped,shining,shrub,small,stem,stigma,style,surface,tear-drop,tip,tree,tube,way,white,x	.5,0.75,1.1-2.5,1.8-3.4,10-30-flowered,2-5,2.1-4.2,6-8,abruptly,age,anthesi,ba,bark,becoming,beginning,beneath,berry,caly,campanulate,clavate,closely,deflexed,deltoid,difoliate,distal,dry,eaf,edicel,eed,erect,exserted,filament,fragrant,free,fruiting,geminat,greenish-yellow,impressed,inflorescenc,lateral,lon,long,lower,main,major,material,middle,minor,narrowing,nflorescence,older,overlapping,ovoid,pair,pale,planar,pore,poricidal,portion,prominent,ruit,scar,shinin,simple,slender,slightly,spaced,straight,styl,sweetly,tall,tapering,terminal,thick-margined,thickened,ud,unit,usually,vein,weight,widest,woody,ympodial,young	0.5,1.5,3,3.5,adhesion,arrangement,blade,climate,colour,diameter,form,fruit,glandular,growth,hair,height,history,inflorescence,length,life,midpoint,na,number,peduncle,perennial,plant,position,presence,pubescence,ray,reproduction,rugulose,seed,shape,size,staman,stellate,stipe,texture
341	wfo-0001028234	success	155	106	68	87	38	0.439	/3,0.15-0.35,0.5-1.0,1-2.5,1.0-1.8,2.6.3.2,3-10,5-11,520,8-11,across,along,annual,anther,around,base,blade,blue-tinged,broadly,brown,calyx,campanulate,capitate,capitate-glandular,cm,dark,dia,dm,dry,extended,few-rayed,fully,glabrous,gland,hair,herb,internodal,leaf,linear-lanceolate,lobe,long,main,margin,maturity,mm,ovate,pedicel,petiole,plump,prickly,radially,ridged,sessile,short-stipitate,simple,spherical,splitting,stellae,stellate,stem,stipitate,strait,tube,unexpanded,unicellular,uniseriate,vein,white	/2,0.25-0.5,15-30,3.5-7,4-10,5-20-flowere,accrescent,acro,acute,alyx,and,anthesi,armed,basally,beneath,berry,black,branched,caly,cauline,central,closely,deltoid,density,developing,difoliate,dissected,divergently,divided,eaf,earliest,eed,enveloped,erect,fleshy,geminat,green,heteromorphic,high,invested,largest,later,lon,many,marking,mostly,narrowly,nflorescence,occasionally,often,one,orolla,per,persisting,pinnatifid,prickle,purple,purplish-tinged,reduced,ruit,scattered,second,short,slende,somewhat,spaced,starlike,ste,stout,subulate,tamen,taprooted,thrice,tightly,tigma,triangular,tub,twice,tyle,ultimate,unit,vary,varying,wholly,year,yello,ympodial	adhesion,apex,arrangement,climate,colour,corolla,diameter,form,fruit,glandular,growth,height,history,inflorescence,length,life,midpoint,na,number,ovary,peduncle,plant,position,presence,pubescence,ray,reproduction,rugulose,seed,shape,size,slender,staman,stigma,stipe,style,surface,texture
342	wfo-0001028250	success	256	134	105	151	29	0.41	.2,.4,.8,0.08,0.2–0.6,0.3–0.5,0.3–0.6,0.3–3.9,0.5–1.3,0.7–0.8,0.8–1.0,0.8–1.3,1,1.0–2.0,1.1–1.6,1.2–1.7,1.2–6.3,1.6–1.8,1.8–2.2,1.9–2.2,12.5,2.3–2.5,2.3–5.1,2.7,3.9–12.2,4–11,5.0,5.8–6.6,8.3–18.0,90°,acute,adnate,anther,apex,apically,attachment,base,blade,calyx,chartaceous,climate,clinate,cm,corolla,cuneate,deltate,depression,diameter,dry,edge,entire,erect,extra-axillary,flattened-orbicular,flower,fruit,glabrous,glandular,globose,hair,interpetalar,lateral,leaf,less,lobe,lobed,margin,mature,midpoint,minute,mm,notched,oblong,ovate,pedicel,peduncle,petiole,point,poorly-developed,ray,red,rounded,shallow,shrub,simple,sinuate,small,stellate,stigma,stipe,straight,style,surface,tissue,tree,tube,white,yellow,yellow-ferruginous,yellow-tan,±equal,±smooth,×,–1.6,–3	.3,.7,0.13,0.17,0.4–0.8,0.5–1.0,0.6–0.7,0.9–1.3,1.0–1.6,1.3–1.6,1.3–2.0,1.5,1.5–3.4,1.7,1.7–2.5,1.8,1/3,1/4–3/4,1–3,2.1,2.2–2.9,2.8,4–6,4–8,5-merou,5.1–6.2,5.7–7.7,6–10,95,abaxially,adaxially,aequilateral,alyx,anthesi,apart,apical,apiculate,apparently,appearing,appressed,articulate,axe,ba,berry,branch,branched,broad,brochidodromous,bud,caudate,channeled,congested,continuing,curved,densely,dentate,development,difoliate,directed,disc-shape,distinct,eaf,eed,egandular,either,emerging,endocarp,entir,evenly,exocarp,fertile,filament,filiform,free,frui,geminate,glabrescent,glossy,growt,homostylous,hooked,increasing,internode,intersepalar,juic,lanceolate,large,lon,long,longer,lower,major,midrib,midvein,minor,moderately,nearly,new,nflorescence,oblique,occasionally,opaque,orolla,overlapping,per,pore,porrect,portion,potentially,pubescent,raised,restricted,rigid,row,ruit,sessile,short-stipitate,shorter,side,sinus,smoot,sparsely,split,splitting,spread,spreading,stamen,stella,stellae,stellate-pubescent,suture,tamen,tardily,tem,thin,time,tip,toward,truncate,two,typically,ud,unarmed,upper,upright,vary,vein,weakly,wide,ympodia,young	adhesion,arrangement,colour,dense,disc-shaped,form,growth,height,history,inflorescence,length,life,na,number,ovary,perennial,plant,position,presence,present,pubescence,reproduction,rugulose,seed,shape,size,staman,stem,texture
343	wfo-0001028263	success	156	83	63	93	20	0.404	0.25,1-3,11-13,11-23,14-44,2-3,2.6,3,3.4,3.5-4.2,4,4-5,5-7.5,6,9,abaxially,adaxially,broadly,calyx,cm,conical,connate,corolla,darker,deep,diameter,distal,elliptical,forked,green,green-white,half,herbaceous,interjected,lateral,leaf,leaflet,light,long,medium,mm,odd-pinnate,ovate,ovoid,pair,pedicel,peduncle,perennial,petiole,plant,puberulent,pubescent,rotate,seed,size,stigma,strigose,style,terminal,throughout,violet,wide,yellow	1-2,1-4,2,2-4,3-6-foliat,5-7,6-8,8-1.,8-14,abaxiall,acumen,acuminate,acute,apex,apical,apically,articulate,atenuate,base,branched,cell,cordate,covering,cuneate,cyme,dehiscent,dichasial,dichasially,digestion,diminishing,dorsally,eaf,ebracteate,edge,eed,emoval,enzyme,equal,exceeding,filament,first,flat,flower,folded,generally,globo,gradually,hair-like,honeycomb,introrse,living,lobe,lon,lower,lunat,make,maturing,monochasial,mucilaginous,nflorescence,nther,oblique,often,orolla,pattern,perfect,plan,poricidally,proximal,reveal,ruit,sessile,seudostipule,short,slit,specimen,stamen,straight,tal,tem,testal,thick,throughou,toward,truncate,tuber-bearing,two,typically,unit,vary,wall,ympodial,¼	8-19,anther,arrangement,color,form,fruit,globose,growth,height,history,inflorescence,length,life,na,ovary,position,reproduction,shape,stem,texture
344	wfo-0001028273	success	225	119	95	130	24	0.422	-2,-8,.5,0,0.4,0.4-0.5,0.4-1,0.5,0.5-1,0.6-0.8,1.5-,1.5-2,2,2-3,2-6,2.3-3,2.5-,2.5-6,2.6-5,3-5,4-11,4-7-lobed,4-8.5,6-8,acute,anther,apex,base,berry,brown,calyx,cm,conical,coriaceous,corolla,dense,densely,diameter,elliptic,flattened,flower,fruit,globose,growth,height,holly-like,inflorescence,known,leaf,less,lobe,lobed,long-styled,margin,markedly,midpoint,minutely,mm,mucronate,ovary,ovate,pedicel,peduncle,petiole,pitted,puberulent,pubescence,pubescent,ray,reddish,reniform,shallowly,shiny,short,shrub,simple,size,sparse,sparsely,stellate,stem,stigma,style,styled,surface,tapering,terminal,toothed,truncate,tube,unknown,way,white,x,½-2/3	0.1,0.2,0.6-1,1,1-1.5,1-2,1-4,1.2,30,4,4-10,4-7,5-8,<,>,?,abaxial,abaxially,abruptly,absent,acicular,adaxial,adaxially,age,alfway,along,also,anthesi,apart,armed,articulated,bark,basal,beneath,branched,broad-based,c.,cell,closer,color,deep,discolorous,distall,eaf,eed,equalling,erect,evenly,exfoliatin,exserted,filament,free,fruiting,glabrous,greyish,heterostylous,impressed,like,linear,lon,long,long-stalked,long-triangular,longer,lower,major,midvein,minute,mixture,multangulate,multiseriate,new,nflorescence,nodding,occasionally,often,older,orange,pair,papillae,per,pericarp,persisting,planar,plurifoliat,poricidal,porrect,portion,prickle,prickly,primary,rachi,rest,rim,ruit,scar,scattered,sessile,shorter,sinuate,slightly,small,smaller,sometimes,spaced,splitting,spreading-campanulate,stalk,stalked,stellate-pubescent,stout,straight,terminating,testal,time,tip,together,tooth,trichome,truncat,ud,unicellular,unit,urceolate,variable,vein,widely,woody,yellow,ympodial	adhesion,arrangement,blade,climate,colour,form,glandular,hair,history,length,life,na,number,plant,position,presence,present,reproduction,rugulose,seed,shape,staman,stipe,texture
345	wfo-0001028278	success	219	123	97	122	26	0.443	0-0.15,0.2-0.3,0.4-2.1,0.45-0.7,0.5-0.75,0.5-0.9,0.5-1.5,0.7-1.2,0.8-3,1,1-5,1.5,1.5-2,1.5-3,2,2-3,2.2-7,2.5-9,2.7-2.9,4-12,4.5-6,5-10,5-11,6-11,7-12,abaxially,acute,adaxially,andromonoecious,anther,apex,base,blade,broadly,brown,calyx,chartaceous,cm,cordate,cylindrical,densely,diameter,ellipsoidal,entire,extra-axillary,flower,fruit,glabrous,gland-tipped,glandular,hair,inflorescence,interpetalar,lanceolate,leaf,length,light,lobe,lobed,margin,midpoint,midrib,mm,obtuse,ovate,pale,pedicel,peduncle,perennial,perfect,petiole,pink,present,purple,ray,red,reniform,rhizomatous,shallowly,shape,short,shrub,simple,sparsely,stellate,stellate-pubescent,stigma,style,surface,throughout,tissue,truncate,tube,weakly,white,x,yellow	%,.5,0-0.7,0-1,0-3,0.1-0.25,0.1-0.5,0.5-2.5,0.7-1,0.8-1.3,0.8-2,1-1.2,1-10,1-2,1-3,1-4,1-locular,1.2-1.6,1.4-1.9,11-15,17-30,2-4,2.5-3,3-4,3-5,3-7,4,4-,4-5,5-merou,6-8,7-10,7-15,7-8,8-10,absen,absent,accrescent,across,adult,alyx,apart,apparen,articulated,ascending,axe,ba,bilobe,connivent,dense,difoliate,directed,distall,eaf,eed,elliptic,erect,exceeding,exocarp,filament,finger,flattened,fruiting,functional,geminat,green,grey-green,heterostylous,incomplete,index,juicy,juvenile,lamina,lateral,leave,lobing,long,lower,mature,mesocarp,mid-point,minute,nflorescence,oblique,orolla,pair,part,per,placenta,pore,porrect,prickle,pseudo-racemose,rachi,rugose,ruit,septum,shallowly-lobed,side,somewhat,spaced,sparse,stalk,stellae,succulent,tal,tamen,tem,thick,time,tissu,transparent,triangular,unarme,unarmed,unbranched,unit,upper,vary,wide,without,ympodial	adhesion,arrangement,bilobed,climate,colour,corolla,form,growth,height,history,life,na,number,ovary,plant,position,presence,pubescence,reproduction,rugulose,seed,size,staman,stem,stipe,texture
346	wfo-0001028280	success	87	75	31	56	44	0.356	.5,0.7-1,1-2,1.5-2.7,2-3,6-9,acuminate,apex,attenuate,base,ciliate,cm,completely,dia,elliptic,glabrous,globose,green,lanceolate,leaf,margin,minutely,mm,narrowly,opposite,pedicel,petiole,shrub,stem,surface,x	1-2-flowered,2-2.5,7-8,almost,anthesi,ape,arching,axil,bark,berry,branch,brow,closely,dark,decurrent,eaf,eed,flattened,fruiting,immature,know,known,lateral,lon,long,lower,main,middle,new,nflorescence,older,onto,pair,papillae,pendant,present,rounded,ruit,scar,sessil,simple,small,somewhat,spaced,tall,tip,ud,ultimate,unifoliat,unit,vein,widest,winged,woody,ympodial,young	adhesion,anther,arrangement,blade,calyx,climate,colour,corolla,diameter,form,fruit,glandular,growth,hair,height,history,inflorescence,length,life,lobe,midpoint,na,number,ovary,peduncle,perennial,plant,position,presence,pubescence,ray,reproduction,rugulose,seed,shape,size,staman,stellate,stigma,stipe,style,texture,tube,unifoliate
347	wfo-0001028281	success	267	117	102	165	15	0.382	-1,-20,-36,-45,-5,0.1-0.15,0.2-0.5,0.3-1,0.5-0.7,0.5-1,0.7-1.2,0.75-1,1-1.5,1-3,1.0-1.6,1.1-1.4,10-30,2-4,2.1-3.0,3-16,5-8-celled,6,7-30,acuminate,acute,almost,anther,apex,base,basiscopically,broadly,brown,calyx,capitate,cm,column,conical,corolla,dark,deep,densely,diameter,doubly,elliptic,entire,extended,filament,form,fruit,globose,golden,green,hair-like,imparipinnate,inflorescence,interrupted,leaf,leaflet,lobe,long,margin,mm,multi-cellular,narrowly,oblique,obovate,occasionally,once-branched,outgrowth,ovary,ovate,pale,patent,pedicel,peduncle,petiolule,pubescent,regularly,rotate,serrate,shrub,size,small,sometimes,sparsely,staminal,stem,stiff,stigma,stripe,style,surface,thick,three,trichome,tube,type,unicellular,uniseriate,vine,wide,yellow	+,-0.9,-10,-3,-7,-8,.2,.4,.5,0.05-0.4,0.15-0.2,0.2-0.3,0.2-0.7,0.3-0.5,0.5-,0.5-0.6,0.5-1.1,0.5-1.2,0.7-,0.7-2.5,0.8-1,1,1-,1-5,1.1-2.4,1.2-1.5,1.2-1.6,1.4-4,1.5-2,1.5-6,1.7-2.5,10-18,2-13,2-4-celled,2-6.5,2-locular,2.5-,20-30,3-5,3-8.5,3-foliate,6-15,abaxial,abaxially,absent,adaxial,alternate,anthesi,apical,appearance,appendage,appressed,arising,articulation,autogamous,axi,bent,berr,blade,bract,bracteate,branching,cell,composed,covering,darker,decreasing,decurrent,developed,distal,dry,eaf,edicel,eed,eglandular,either,elongate,elongate-triangular,enclosing,exerted,exserted,flower,fragile,free,fruiting,generally,giving,glabrous,gland,glandular,gree,hal,half,halfway,head,included,interjected,internode,large,largest,lateral,less,like,lon,longest,lower,material,medial,midvein,minute,mixture,multi-celled,multicellular,nflorescence,node,opposite,orbicular,other,pair,paler,petiole,point,population,portion,present,primarily,primary,probably,proximal,pseudostipule,rachi,rest,ruit,secondary,serrat,sessile,set,shorter,silky,smaller,smooth,sparser,sprawling,sterile,straight,strongly,subopposite,tem,terminal,tertiary,testa,thin,tip,toward,transparent,ud,unit,usually,vein,wall,weak,weak-walled,well,winged,ympodial	0.5,2.5-15,arrangement,color,growth,height,length,na,plant,position,pubescence,seed,shape,texture,width
348	wfo-0001028294	success	222	109	84	138	25	0.378	0-1,0.25-0.4,0.3-0.4,0.5-0.6,0.5-2,0.7-1.2,1.3-1.5,1.5-3.5,1.5-7,1.9-7,11-22,2-2.5,2-3.5,2-5,4-8,4.5-6,5-13,6-8,8-10,8-18,absent,acuminate,acute,adaxially,andromonoecious,anther,apex,base,blade,broadly,calyx,chartaceous,cm,connivent,cordate,cuneate,cylindrical,densely,diameter,entire,extra-axillary,fruit,glabrous,globose,green,hair,inflorescence,lanceolate,lateral,leaf,length,lilac,lobe,lobed,long,loosely,margin,mm,obtuse,ovate,pale,pedicel,peduncle,perennial,petiole,plant,present,ray,repand,scattered,shallowly,simple,sparsely,stellate,stellate-pubescent,stigma,style,time,toward,tube,vine,x,yellow,yellowish-green	%,0-0.2,0-0.4,0-10,0-6,0.1-0.15,0.2-0.3,0.25-0.5,0.3-0.5,0.5-1,0.7-1.5,0.8-1,0.8-1.2,1,1-2,1-2.5,1-3.5,1-6,1.7-2.4,11-15,17-25,18-22,18-40,2-3,2-foliate,2-locular,2.5-7,30-40,4-6,5-12,5-8,5-merou,50-100,50-140,7-10,7-8,9-13,9-15,abaxially,accrescent,across,adaxiall,adult,alyx,anvil-shape,apart,armed,articulated,ascending,axe,ba,branch,branche,broad-based,brown,capitat,cross-section,curved,decimetre,deltate,directed,distall,distally,distributed,dm,eaf,eed,eglandular,elliptic,erect,exocarp,finger,flower,fruiting,functional,geminat,gland-tipped,grey,grey-green,half,heterostylous,juicy,juvenile,lamina,less,longer,lower,markedly,mature,mesocarp,mid-point,midpoint,midvein,minute,moist,nflorescence,oblique,orolla,pair,part,per,placenta,pore,porrect,presen,prickle,rachi,ruit,rusty,scrambling,semi-circular,sessile,short,slightly,spaced,stalk,stalked,stellae,straight,surface,tal,tamen,tem,thick,thicker,throughout,unarme,unarmed,unbranched,unit,upper,vary,vein,weakly,white,wide,yellowish,ympodial	adhesion,arrangement,capitate,colour,corolla,form,glandular,growth,height,history,life,na,number,ovary,position,presence,pubescence,reproduction,seed,shape,size,staman,stem,stipe,texture
349	wfo-0001028298	success	188	104	74	114	30	0.394	0-0.1,0.25-0.4,0.3-0.4,0.4-0.65,0.5-1,0.6-0.7,0.8-1.7,1-1.5,1-2,1.5-2,1.5-3.5,2-7,2.2-2.5,2.5-3,3-7,4-5,4.5-8,5-8,6-8,7-8,9-10,absent,acute,anther,apex,base,blade,calyx,chartaceous,cm,cordate,densely,diameter,entire,extra-axillary,fruit,glabrous,globose,hair,inflorescence,lanceolate,leaf,length,lilac,lobe,lobed,margin,midpoint,mm,moderately,obtuse,ovate,pale,pedicel,peduncle,perennial,petiole,present,ray,red,reniform,rhizomatous,rotate-stellate,shallowly,shrub,simple,stellate-pubescent,stigma,style,surface,truncate,tube,x,yellow	%,.5,0.1-0.2,0.15-0.3,0.2-0.4,0.3-0.5,0.4-0.5,0.7-1,1-3,1-4,1-locular,1.9-2.5,10-11,17-25,2-3,2-foliate,3-5,4-9,5-6,5-7,5-merou,7-12,8-11,abaxially,absen,accrescent,across,acuminate,adaxially,adult,alyx,apart,apparen,articulated,axe,ba,broadly,brown,capitat,connivent,contiguous,cylindrical,deltate,directed,distall,distributed,eaf,eed,eglandular,elliptic,erect,exceeding,exocarp,filament,finger,flower,fruiting,geminat,gland-tipped,grey-green,incomplete,interpetalar,juicy,juvenile,lamina,lateral,long,lower,mature,mesocarp,minute,nearly,nflorescence,oblique,orolla,part,per,perfect,placenta,pore,porrect,prickle,probably,pseudo-umbellate,rachi,reticulate,ruit,septum,sessile,short,soliary,somewhat,spaced,stalk,stellae,succulent,tal,tamen,tem,thick,throughout,time,tissu,tissue,transparent,unarme,unarmed,unbranched,unit,vary,white,wide,yellowish,ympodial	0.5,adhesion,arrangement,capitate,climate,colour,corolla,form,glandular,growth,height,history,life,na,number,ovary,plant,position,presence,pubescence,reproduction,rugulose,seed,shape,size,staman,stellate,stem,stipe,texture
350	wfo-0001028317	success	204	110	80	124	30	0.392	-1.5,0.1-0.4,0.3-1,0.6-0.8,0.6-1.2,0.6-1.5,0.8-2.5,1-1.3,1-3,1.4-2,2-2.8,2-4.5,2.5-6.5,2.8-3.3,4-6,4-8,5-8,acute,anther,apex,base,blade,bright,calyx,chartaceous,cm,cream,cuneate,dark,densely,diameter,dull,equal,flattened-reniform,fruit,glabrous,green,hair,herb,lanceolate,lateral,leaf,length,lobe,lobed,long,margin,marking,maturity,mauve,midpoint,mm,moderately,obtuse,orange-brown,ovate,pale,pedicel,peduncle,petiole,purple,ray,red,shrub,simple,sometimes,sparsely,spherical,spreading,stellate,stellate-pubescent,stem,style,tapering,terminal,tube,white,wide,yellow,young	-5,/5,0,0-1,0-5,0.1,0.1-0.25,0.1-0.3,0.3-0.4,0.5-3.5,0.8-1.1,1-4,1.1-1.9,1.8-2.5,1/,1/3-1/4,1/4-2/3,1/5,2-4,2/3,3-10,3-4,3-5,4-5-merous,6-10,abaxially,absent,acuminat,almost,alyx,apar,apart,apically,apparently,articulated,bark,berry,branched,broad-deltate,brow,brown,concolorous,curved,deltate,difoliate,distance,drying,eaf,eed,elongating,erect,extending,eye,filament,filiform,flower,free,fruiting,geminat,gray,herbaceous,infructescence,longer,lower,mature,midvein,minute,naked,nflorescence,oblong,older,one,open,orolla,oung,pair,pendulous,per,perfec,pericarp,poricidal,porrect,portion,prickl,prickle,prickly,primary,reduced,reflexed,rounded,ruit,scandent,scar,sessile,shorter,side,smooth,spaced,stalk,stalked,straight,subsessile,surface,tamen,terete,tertiary,time,tip,toward,translucent,trichome,truncate,unarme,unarmed,unit,upper,variously,vary,vein,venation,visible,way,yellow-green,ympodial	adhesion,arrangement,climate,colour,corolla,form,glandular,growth,height,hermaphroditic,history,inflorescence,life,na,number,ovary,perennial,plant,position,presence,present,pubescence,reproduction,seed,shape,size,staman,stigma,stipe,texture
351	wfo-0001028323	success	164	119	84	80	35	0.512	0.2-0.5,0.2-1,0.4-1.3,0.6-1,0.8,0.9-1.2,1-1.2,1-2,1.1-4.5,1.5,1.5-2.5,2-3,2-9,3,3-5,3.5-4,7.5-9,abaxially,acute,anther,apex,attenuate,base,blue-green,brown,c.,calyx,cm,conical,coriaceous,corolla,dark,densely,diameter,ellipsoid,elliptic,entire,fading,fleshy,glabrous,growth,inflorescence,internodal,leaf-opposed,lobe,lobed,margin,maturity,minutely,mm,ovary,ovoid,pale,papillose,pedicel,peduncle,perfect,petiole,pitted,poricidal,pubescent,reddish,revolute,rounded,shiny,shoot,short,shrub,simple,soft,sometimes,somewhat,sparsely,stem,stigma,style,surface,thick,tip,tube,violet,way,white,x	-2,0.5,0.5-1,1,1-1.5,3-6,5-6,abscissio,absent,along,anthesi,apart,apparently,appressed,articulated,ba,bark,berry,capiatate,cell,cup-shaped,deltate,dendritic,drying,eaf,eed,erect,filament,flower,free,fruiting,glabrescen,glabrescent,globose,grey,included,lanceolate,lengthening,less,like,longer,lower,main,minute,new,nflorescence,occasionally,ovate,pair,papillat,peg,pericarp,planar,plurifoliat,pore,portion,primary,proceed,remaining,ruit,scar,scattered,sinus,small,soon,sparely,splitting,straight,tearing,testal,thin,trichome,tuft,ud,uniseriate,unit,vein,wall,woody,ympodial	adhesion,arrangement,blade,capitate,climate,colour,dense,form,fruit,glandular,hair,height,history,leaf,length,life,midpoint,na,number,perennial,plant,position,presence,present,pubescence,ray,reproduction,rugulose,seed,shape,size,staman,stellate,stipe,texture
352	wfo-0001028328	success	215	130	102	113	28	0.474	-15,0-0.3,0.2-0.5,0.5-1,1-1.5,1-2,1-6,1.5-2,15-20,16-30,2-10,2-2.5,2-4,2-4-lobed,2-9,2.5-3,20-35,3-4,5-10,5-7,7-9,abaxially,abundantly,acuminate,acute,andromonoecious,anther,apex,apparently,armed,base,blade,broad-based,brown,calyx,chartaceous,cm,coarsely,compressed,connivent,dark,densely,diameter,elliptic,elliptic-ovate,entire,equal,extra-axillary,flattened,flower,fruit,glabrous,globose,green,hair,inflorescence,leaf,leaf-opposed,light,lobe,long,margin,membanaceous,minutely,mm,moderately,nearly,oblique,outline,pedicel,peduncle,petiole,plant,prickle,ray,reflexed,reniform,ripe,rounded,rugulose,shallowly,simple,slightly,small,smooth,stellate,stellate-pubescent,stem,stigma,straight,strongly,style,subcoriaceous,subcuneate,surface,tapered,tree,truncate,tube,white,x,yellow	.2,.5-2,0-4,1,1-7,14,2-3,20-30,4-7,5-merou,50,6-18,6-8,7-.,7-10,7-14,7-30,8-18,absent,accrescent,adaxiall,adaxially,ag,alyx,apart,apiculate,articulated,axe,ba,berry,branched,capitat,congested,covering,cylindrical,differentiated,difoliate,directed,discolorous,distally,eaf,eed,except,ferruginous,filament,flowering,forked,free,frui,fruiting,geminat,half,heterostylous,highly,interpetalar,juvenile,leave,lighter,like,lobed,longitudinal,lower,major,midpoint,minor,multangulate,narrowly,nflorescence,obtuse,often,one,opening,orolla,paired,part,perfect,perhaps,pericarp,pore,porrect,pubescent,rachi,ruit,runk,sessile,sharp,shiny,short,short-stalked,side,slit,somewhat,spaced,sparse,stalk,staminate,subtending,tamen,thi,time,tip,tissue,tomentose,triangular,tubevery,unarmed,unit,vary,vein,whitish,wide,ympodial,young	7-8,adhesion,arrangement,capitate,colour,corolla,form,glandular,growth,height,history,length,life,na,number,ovary,perennial,position,presence,pubescence,reproduction,seed,shape,size,staman,stipe,texture,ye
353	wfo-0001028329	success	215	123	92	123	31	0.428	.75-5.75,0.2-0.3,0.8-1.1,0.8-1.4,1-6,1.1-2.5,1.3-1.8,1.3-2,1.5-2.3,1.5-2.75,1.5-3.5,10-34,2-3,2.2-3.9,2.6-5,3-14,3-8,4-15,5-10,6-8,7-19,acuminate,acute,anther,apex,asperous,base,becoming,blade,brown,calyx,cm,conical,corolla,deltoid,diameter,entire,finely,flower,fruit,glabrous,green,growth,hair,honeycombed,inserted,lateral,leaf,length,lobe,long-attenuate,margin,minutely,mm,moderately,mostly,obelliptic,oblong,occasional,ovate,ovate-elliptic,pedicel,peduncle,petiole,present,pseudo-terminal,pubescent,reniform,reticulate-punctate,ripe,short-,shrub,simple,slightly,small,stellate,stellate-rotate,stem,stigma,style,subglobose,suborbicular,tomentose,tree,tube,turning,velutinous,white,whitish,x,yellow,yellowish	.5-3,.75-2,/10-3/10,0-100,0.9-1.3,1.0-1.4,1.5-8,12,2-4,2.75-4.5,3.75-7,3/4,4-5,6-11,6-9,abaxially,absen,adaxially,ag,angled,anthesi,apart,apical-lateral,apparently,articulated,axe,axillary,ba,bark,berry,blunt-tipped,branch,branched,bud,chartaceous,closely,continued,cylindrical,dehiscing,dendritic-echinoi,dendritic-echinoid,dichotomously,distantly,distinct,due,eaf,echinoid,eed,filament,fleshy,free,glabrescen,granular,granular-tomentose,gray,grooved,high,introrse,large,lengthening,lobed,long,longitudinally,lower,main,midvein,multangulat,multangulate,nflorescence,obovate,obscured,obtuse,older,orbicular,orolla,pale,perfect,plurifoliate,pore,porrect-stellate,rachi,rather,receptacle,relatively,ruit,runk,sessil,sessile,several,short-stalked,side,slit,sometimes,spaced,sparse,sparsely,stalked,stellat,stellate-pubescent,stelliform,subcapitat,suture,swollen,tamen,testa,thick,thickened,thin,time,tomentu,touching,toward,unarme,unarmed,unit,usually,vary,vein,vestigial,way,wide,ympodial,young	adhesion,arrangement,climate,colour,form,glabrescent,glandular,height,history,inflorescence,life,midpoint,na,number,ovary,perennial,plant,position,presence,pubescence,ray,reproduction,rugulose,seed,shape,size,staman,stipe,subcapitate,surface,texture
354	wfo-0001028337	success	195	120	90	105	30	0.462	-2,-2.5,-4,-6,/3,0,0.05-0.15,0.05-1,0.3-0.5,0.4-0.7,0.4-0.8,0.7-0.9,0.7-1,1-1.8,1-2,1.5-3,1.8-2,1/8-1/4,11-16,2-2.2,2-4,4-5,5-6,abaxially,anther,apex,base,berry,blade,calyx,chartaceous,cm,connivent,cuneate,dark,densely,diameter,entire,erect,evenly,flattened-reniform,fruit,glabrescent,glaucous,green,hair,inflorescence,lateral,leaf,length,lobe,lobed,long,margin,marking,mauve,midpoint,minutely,mm,moderately,narrow-oblong,orange-brown,pedicel,peduncle,petiole,pitted,poricidal,ray,rounded,shallowly,shrub,simple,smooth,sparse,spherical,stellate,stellate-pubescent,stem,stout,style,surface,tapering,terminal,tip,toward,tube,way,white,wide,young	.5,.8,0.1-0.3,1,1-3,1.5-4,1/2,1/3-2/3,1/4-1/3,15-50,3-4,5-25,5-8,5-merous,6-7,8-10,8-14,abaxial,acut,adaxial,alyx,apar,apart,ape,apically,apparently,articulated,bark,branched,color,conical,curved,deltate,discolorous,drying,eaf,eed,elongating,equal,eye,filament,flower,free,fruiting,fused,gently,glabrou,glabrous,gray,gray-brown,green-brown,infructescence,juvenil,juvenile,known,long-styled,longer,lower,mature,naked,nflorescence,occasionally,older,one,open,orolla,oung,pale,per,perfect,pericarp,plurifoliat,porrect,porrect-lepidote,portion,prickle,prickly,primary,reddish,reflexed,ruit,scar,sessile,shoot,short,short-styled,shorter,slender,small,spaced,staminate,straight,strongly,tamen,terete,time,trichome,unarme,unarmed,unit,usually,vary,vein,visible,ympodial	adhesion,arrangement,climate,colour,corolla,form,glandular,growth,height,history,life,na,number,ovary,perennial,plant,position,presence,pubescence,reproduction,rugulose,seed,shape,size,staman,stigma,stipe,texture,unknown,ye
355	wfo-0001028339	success	195	126	93	102	33	0.477	.5,1-1.2,1-2,1-5,1.1-1.4,1.2-1.5,1.5,1.5-2,1.7-3.2,10.2-18.5,2.5-5,3.5-4,5-7,5.8-7.9,8182,acuminate,acute,anther,apex,appressed,base,beneath,berry,blue,broadly,brown,calyx,capitate,cm,connate,corolla,covered,cuneate,dark,densely,dia,dried,dry,flattened,flower,glabrous,globose,growth,leaf,little,lobe,lobed,margin,minutely,mm,mustard,nearly,oblique,opposite,ovary,ovate,ovoid-reniform,papillate,papillose,pedicel,petiole,pitted,pore,poricidal,pulp,schwarz,shaped,shrub,size,small,somewhat,sparsely,specimen,stem,stigma,strongly,style,surface,tear-drop,texture,tightly,tip,tree,trichome,tube,uniseriate,vein,white,white-speckled,woody,x,yellow,young	0.05-0.1,0.8-1.2,1-1.5,10-30-flowered,3.4-5.5,43191,5-angled,7-11,8-10,across,almost,anthesi,appearance,appearing,attenuate,bark,becoming,bud,carinate,carpel,closely,crystalline,cup-shaped,decurrent,deflexed,differing,difoliate,distinctly,eaf,edicel,eed,enclosed,epidermi,erect,evenly,exserted,fide,filament,filiform,first,floccose,free,frui,fruiting,geminat,glabrate,grainy,greyish-brown,irregular,large-celled,later,lateral,leave,like,lon,long,long-triangular,lower,main,major,middle,minor,nee,nflorescence,obscure,occasionally,older,one,overlappin,ovoid,papery,planar,portion,proximal,red-brown,reflexed,ruit,scar,secondary,septum,shining,simple,slender,slightly,spaced,speckled,straight,strong,tall,tapering,tub,ud,unit,urceolate,venation,white-lenticellat,white-papillo,wide,widest,winged,yellowish,ympodial	adhesion,arrangement,blade,climate,colour,diameter,form,fruit,glandular,hair,height,history,inflorescence,length,life,midpoint,na,number,peduncle,perennial,plant,position,presence,pubescence,ray,reproduction,rugulose,seed,shape,staman,stellate,stipe,white-papillose
356	wfo-0001028351	success	175	117	85	90	32	0.486	.2,0,0.2,0.5,1.0–2.0,1.4–1.5,2.0–2.5,2.1–3.5,2–2.5,3,3.4–5.0,3–4,40,5.0,5.0–5.5,5.5–10.5,6.5–8.5,6–12,8–15,abaxially,acute,adaxially,along,annual,anther,anthesi,apex,articulated,base,blade,blue,brown,calyx,capitate,clavate,cm,colour,densely,diameter,equal,flattened,fruit,glabrous,glandular,globose,hair,herb,leaf,like,lobe,lobed,long,margin,midvein,mm,moderately,multicellular,number,oblong,opposed,ovate,pale,pedicel,peduncle,pentagonal,perennial,petiole,present,pubescent,regularly,simple,slender,stem,stigma,style,surface,truncate,tube,unicellular,uniseriate,unknown,velutinous,white,x,–3.0	.8,.8–1.0,0.1,0.6,0–,1.0–,1.0–1.6,1.0–2.5,1.5–4.0,1.6–,10,2,2.0–5.0,2/3,2–4,4,5,5–7,absent,adaxiall,ag,apart,apical,axe,ba,basal,becoming,branching,cell,chartaceous,connivent,convex,cylindrical,directed,distally,eaf,eed,erect,filament,fleshy,flower,geminat,green,indumentum,lamin,lanceolate,lon,longitudinal,lower,m.,narrowly,nfloresence,obtuse,occasionally,opening,orolla,pair,perfect,pitted,plurifoliate,pore,probably,ruit,serrate,shallowly,shaped,shiny,side,slit,smaller,spaced,sparsely,stone,straight,tal,tamen,tardily,teardrop,tem,time,unbranched,unit,vary,wide,wing,winged,woody,ympodial,young,–	0–2.5,1.0–4.0,1.5,1.6–5.0,adhesion,arrangement,climate,corolla,form,growth,height,history,inflorescence,lamina,length,life,midpoint,na,ovary,plant,position,presence,pubescence,ray,rugulose,seed,shape,size,staman,stellate,stipe,texture
357	wfo-0001028353	success	177	122	90	87	32	0.508	0.2-0.4,0.5,0.9-1.2,1,1-4,1.4-2,1.5-5,2-4,3-5,6-8,7,8-10,abaxially,acute,anther,apex,base,becoming,beneath,bluntly,bright,calyx,campanulate,capitate,cell,centre,clasping,cm,coarsely,conical,cordate,corolla,dark,deep,deeply,densely,diameter,elliptic,fracturing,glabrous,globose,green,greenish,herb,honey-comb,internodal,leaf,less,like,lobe,margin,midrib,minutely,mm,often,ovary,ovoid,pale,papery,papillose,pedicel,peduncle,petiole,pitted,plant,plump,pubescent,purple,rhomboid,ripe,scattered,simple,size,somewhat,sparsely,stem,stigma,style,surface,tan,testal,thin,toothed,trichome,truncate,tube,uniseriate,vein,x,yellow	.5,/3,0.5-,1-2,1.5-2,2,2-3,3,4-7,accrescent,age,along,anthesi,apart,area,berry,ciliate,cup-shaped,curved,decreasing,decumben,difoliate,distally,dry,drying,eaf,edicel,eed,ellipsoid,emarginated,erect,exerted,filament,fleshy,flower,free,frui,fruiting,geminat,gree,growing,heteromorphic,hollow,horn,horned,inserted,lengthening,lon,long,lower,m.,material,minute,nflorescence,nodding,open,outline,pair,papillate,pericarp,point,pore,poricidal,portion,primary,principal,reddish,ruit,scar,sessil,sessile,shallow,short,sleeve,slender,slightly,slit,straight,strongly,tip,toward,ud,unit,wall,way,wrinkled,ympodial	0.5-1,adhesion,arrangement,blade,climate,colour,form,fruit,glandular,growth,hair,height,history,inflorescence,length,life,midpoint,na,number,perennial,position,presence,pubescence,ray,reproduction,rugulose,seed,shape,staman,stellate,stipe,texture
358	wfo-0001028367	success	178	100	78	100	22	0.438	0.2–0.4,0.4–2.3,1.0–1.8,1.3–9.0,1.4–2.0,1.5,1–1.5,2.0–4.5,2.8–3.1,2–3,3–5,4–10,5–6,6.5–8.5,60,6–9,8.5–9.5,8–17,abaxially,adaxially,anther,anthesi,apex,black,blue,brown,calyx,cm,colour,dark,deeply,densely,diameter,flattened,fruit,glabrous,globose,grey-green,lanceolate,leaf,lobe,lobed,margin,mm,moderately,narrowly,oblong,ovate,pair,pale,pedicel,peduncle,pentagonal,perennial,petiole,pitted,pubescent,purple,regularly,shrub,stigma,style,surface,texture,time,tomentose,toward,tube,unequal,unifoliate,unknown,white,woody,x,yellow,–25,–5.5,–7	0.2,0.5,0.5–3,0.8–0.9,1,1.2–3.0,1.5–1.7,1–,1–2,2.0–4.2,2–10,3.5–6.9,3–3.5,4–7,5,5–5.8,6–8,7–15,8–23,absen,accrescent,adaxiall,ag,apart,apical,arising,articulated,axe,ba,basal,base,blade,branched,cell,chartaceous,concave,connivent,cuneate,cylindrical,diamete,directed,eaf,eed,equal,erect,filament,flower,geminat,glabrescen,hair,half,laterally,lon,long,longer,longitudinal,lower,marking,multicellular,nflorescence,obliquely,obtuse,opening,opposed,orolla,perfect,pore,poricidal,primary,probably,rounded,ruit,secondary,shiny,shorter,side,simple,slit,smaller,spaced,stone,straight,strongly,tal,tamen,tapering,tem,three,tip,two,unicellular,uniseriate,unit,usually,vary,wide,width,ympodial,–10.0,–5.0	absent,adhesion,arrangement,branching,corolla,form,growth,height,history,inflorescence,length,life,ovary,plant,presence,pubescence,rugulose,seed,shape,size,staman,stem
359	wfo-0001028370	success	147	112	71	76	41	0.483	0.2-0.4,0.8,1.0-1.7,1.5-2.2,1/2-2/3,2.5-2.9,3-5,3-7,3.5-5.0,4-10,4-11,9-12,across,along,annual,anther,armed,base,blade,blue,broadly,brown,calyx,capitate,cm,dark,deltoid,developing,dia,dm,dry,eglandular,extended,foveolate,fully,glabrous,gland-tipped,glandular,hair,herb,internodal,invested,lenticular,lobe,long,main,maturity,minutely,mm,oblong,obtuse,often,ovate,pentagonal,petiole,prickly,purple-tinged,ridged,rounded,seed,simple,spherical,splitting,stem,strait,tightly,tube,variously,vein,violet,viscid	-0.6,/3,2-4,2-8,40-70,5-9-flowere,accrescent,acicular,acro,alyx,ample,anthesi,attenuate,ature,beneath,berry,branched,broad,bud,campanulate,coarsely,densely,difoliate,distinct,divided,eaf,few-rayed,geminat,gland,green,hardly,high,incurved,interpetalar,lanceolate,lon,markedly,narrowly,near,nflorescence,obovoid,one,orolla,per,pinnatifid,pinnatisect,plicat,prickle,ruit,scattered,sessile,short,short-stipitate,slende,slightly,somewhat,sparsely,spreadingly,stellae,subulate,surrounding,tamen,taprooted,terete,terminal,tigma,tissue,tub,twice,tyle,ultimate,unti,usually,vary,yellow,ympodial	adhesion,apex,arrangement,climate,colour,corolla,diameter,form,fruit,growth,height,history,inflorescence,leaf,length,life,margin,midpoint,na,number,ovary,pedicel,peduncle,plant,position,presence,present,pubescence,ray,reproduction,rugulose,shape,size,slender,staman,stellate,stigma,stipe,style,surface,texture
360	wfo-0001028390	success	147	96	63	84	33	0.429	0.5,0.5-1,0.5-1.5,1-2.5,1-3,1.5-2,1.5-3.5,1.5-5.5,10-15,2,3-4,3-5,4-11,4-5,5-7,7-8,abaxially,acute,adaxially,angled,apex,base,calyx,chartaceous,cm,connivent,cuneate,dense,densely,diameter,elliptic,entire,forked,glabrous,globose,lanceolate,lobe,margin,mm,moderately,orange,ovate,pedicel,peduncle,petiole,puberulent,pubescent,rarely,shrub,simple,sparsely,stellate,stigma,style,subcordate,subcoriaceous,truncate,tube,unbranched,violet,white-pubescent,x,yellow	-10,.5-3.3,0,0.5-2.5,1,1-5,2.5,6-many-foliat,7,9,absen,adaxiall,aggregate,apart,apiculate,articulated,axe,blade,branched,cell,curled,cylindrical,deltate,dendritically,dendritically-branched,directed,distall,divided,eaf,eed,eglandular,felty-pubescent,flower,gland,hair,leaving,less,like,lon,long,lower,midvein,mixed,mostly,narrowly,near,nflorescence,nther,obtuse,occasionally,often,orolla,peg,perfect,pore,presen,pseudohair,pubescen,rachi,radiu,ripe,ruit,scar,short,slightly,small,spaced,stalked,ste,stone,subcapitat,subclavate,tal,tem,time,tip,triangular,unequally,unit,usually,vary,white,wide,ympodial	abaxial,adhesion,anther,arrangement,colour,corolla,form,fruit,growth,height,history,inflorescence,leaf,length,life,na,ovary,perennial,plant,position,presence,present,pubescence,reproduction,rugulose,seed,shape,size,staman,stem,subcapitate,surface,texture
361	wfo-0001028399	success	273	117	74	199	43	0.271	0.06,4.3,9.1,9.8,abaxially,acute,adaxially,adnate,age,anther,apex,attachment,base,blade,calyx,chartaceous,cm,corolla,cunate,densely,diameter,dry,elliptic,entire,extra-axillary,flattened-orbicular,flattened-reniform,flower,fruit,glabrous,glandular,globose,hair,incurved,lateral,leaf,length,lobe,lobed,long,margin,mature,mm,moderately,notched,oblong,orange,ovate,pedicel,peduncle,petiole,point,position,pubescent,ray,red,rounded,scattered,short,shrub,simple,sinuate,somewhat,sparse,stellate,stem,stigma,stipe,style,surface,toward,tube,yellow-tan,young	.3,.4,.5,.5–2.4,.8,/3,0.04,0.13,0.2–0.3,0.3–0.4,0.3–0.5,0.3–0.6,0.4–0.5,0.4–0.6,0.4–0.7,0.4–0.9,0.5–1.1,0.5–1.3,0.7–1.0,0.7–2.3,0.8–2.5,0.9–1.9,1.0–5.5,1.1–1.4,1.1–1.7,1.2–1.5,1.2–1.7,1.2–2.0,1.3–2.0,1.4–2.4,1.5–2.1,1.6–2.3,1.6–2.5,1.7–2.7,1/2–2/3,1/3–1/2,1/4–1/3,2.0–3.9,2.2–2.6,2.2–2.8,2.2–2.9,2.4–3.2,2.5–11.2,2.8–3.0,3.1–3.8,3.2–3.8,3.4–3.6,4.0–5.4,4.2,4.4,5,5-merou,5.0,5.2–17.8,5.4,5–8,5–9,6.0–6.6,7.0,7–11,8–120,absent,aequilateral,alyx,anthe,anthesi,apart,apiculate,apparently,appearing,appressed,arching,articulate,attenuate,axe,ba,bark,basal,based,becoming,berry,branch,branching,broad,broad-based,brochidodromous,brown,bud,capitat,channeled,deciduous,dehiscent,deltoid,dentate,developed,difoliate,distal,distinct,eaf,eed,either,emerging,erect,exocarp,extending,fertile,filament,filiform,flexed,free,geminat,glossy,gradually,heterostylous,increasing,internodal,internode,interpetalar,intersepalar,juic,lanceolate,large,layer,lon,longer,longitudinally,lower,major,many,midpoint,midrib,midvein,minor,minute,narrowly,nearly,nflorescence,oblique,orolla,per,porrect,porrect-stellate,portion,potentially,prickle,primary,probably,raised,red-orang,reddish,reflexe,restricted,reticulate,ridge,rigid,row,ruit,secondary,sessile,shorter,side,sinus,slit,sloughing,soon,spaced,splitting,spread,spreading,stamen,stellae,stellate-pubescent,stipitate,straight,tamen,tem,thin,time,tip,tissue,translucent,transparent,triangular,truncate,two,ud,unarmed,upper,various,vary,vein,weakly,well,wide,yellow-ferruginous,ympodia,±90°,±equal,×	0.2-0.3,0.3-0.6,0.4-0.5,0.4-0.6,0.4-0.7,0.4-0.9,0.5,0.7-2.3,0.9-1.9,1.0-5.5,1.1-1.4,1.2-1.7,1.2-2.0,1.3,1.3-2.0,1.4-2.4,1.5-2.1,1.7-2.7,2.0-3.9,2.2-2.9,2.8-3.0,3.8,5-8,5.2-17.8,adhesion,arrangement,capitate,colour,form,growth,inflorescence,na,number,ovary,presence,present,pubescence,rugulose,seed,shape,size,staman,texture
362	wfo-0001028405	success	149	76	53	96	23	0.356	0.4-0.5,0.5-3,1-9,1.3-8,1.5-6.5,10-11,2,2-2.5,2-3,3-4,3.5-10,3.5-6.5,4-11.5,4-6,6-7,7-14.5,8-15,calyx,cm,conical,connate,corolla,diameter,distal,elliptic-lanceolate,forked,green,green-white,half,herbaceous,lanceolate,lateral,leaf,leaflet,long,mm,odd-pinnate,ovoid,pedicel,peduncle,perennial,petiole,plant,puberulent,seed,size,stellate,stigma,style,terminal,throughout,wide,yellow	1-4,2-4,3-20,3-6-foliat,9-15,abaxially,absen,acumen,acute,adaxially,apex,apical,apically,apiculate,articulate,attenuate,base,branched,cell,covering,cyme,decurrent,dehiscent,dichasial,dichasially,digestion,diminishing,dorsally,eaf,ebracteate,edge,eed,elliptic,emoval,enzyme,exceeding,filament,flat,flower,folded,generally,globo,gradually,hair-like,honeycomb,interjected,introrse,living,lobe,lon,lower,lunat,make,maturing,monochasial,mucilaginous,nflorescence,nther,oblique,oblong,often,orolla,ovate-elliptic,pair,pattern,perfect,plan,poricidally,proximal,rachi,reveal,ruit,seudostipule,short,short-acuminate,short-petiolate,slit,specimen,stamen,straight,subsessile,tal,tem,testal,thick,throughou,toward,tuber-bearing,typically,unit,vary,wall,whit,without,ympodial,¼	anther,arrangement,color,form,fruit,globose,growth,height,history,inflorescence,length,life,na,ovary,position,pubescence,reproduction,rugulose,shape,stem,surface,texture,white
363	wfo-0001028424	success	253	122	98	155	24	0.387	-28,-3,-9,0-1,0.2-0.35,0.5,0.7-2,1.5-2.5,1.8-3,2-2.5,2-3,2-4,3,3-12,3-16,3-7,4-5,5-10,5-15,5-22,5-8,5.5-10,8-15,abaxially,acute,adaxially,anther,apex,attenuate,base,blade,broadly,calyx,cm,coarsely,connivent,deeply,deltoid-orbicular,densely,dentate,diameter,diverging,elongate-lanceolate,extra-axillary,felty,fruit,glabrous,glandular,globose,hair,inflorescence,leaf-opposed,length,lenticular,less,light,like,lobe,margin,minutely,mm,narrower,obtuse,occasionally,orange,outline,ovate,pedicel,peduncle,pentagonal-stellate,perennial,persistently,petiole,prickle,pubescent,ray,ripe,sessile,simple,size,spreading-hirsute,stellate,stellate-puberulent,stellate-pubescent,stem,stigma,style,subcordate,suffrutescent,surface,tan,thin-textured,truncate,tube,weakly,white,x,yellow	-0.8,-1.2,0-0.5,0.1-0.2,0.15-0.4,0.2-0.7,0.3-0.6,0.3-0.7,1,1-3,1-7,1/3-1/2,10-16,12,12-19,2,2-foliate,3-5,3-6,3-8,4-12,4-6,4-7,8-25,accrescent,acicular,acute-,adaxiall,almost,along,and/or,apart,articulated,ascending,axe,ba,branched,broad-based,broader,campanulate,capitat,capitate-glandular,cauline,closely,commonly,conspicuously,convex,covering,curved,cylindrical,deltoid,dense,depressed-deltoid,diffusely,directed,distal,distally,distributed,divergently,eaf,eed,elongate,entire,equaling,exceeding,female-sterile,filament,flexuous,flower,fruiting,geminat,gland-tipped,inserted,interlobal,larger,lateral,laterall,long,longer,lower,major,midpoint,midrib,mixture,mostly,much,multiple-stemmed,multiseriate,nflorescence,numerous,obsolete,obtuse-,often,orolla,ovate-lanceolate,per,perfect,pitted,pore,prickly,principal,puberulent,rachi,radiu,rarely,recurved,reduced,reflexe,resembling,round-tipped,ruit,scattered,section,short,short-styled,shorter,side,similar,single-,sinus,slender,small,smaller,sometimes,somewhat,spaced,sparsely,species,stalk,stalked,ste,stellae,stout,strongly,tal,tamen,tem,termination,thickened,time,tip,trichome,typically,unarmed,unbranched,unit,upward,usually,variable,vary,vein,white-pubescent,wide,widely,ympodial	adhesion,arrangement,capitate,colour,corolla,form,growth,height,leaf,na,number,ovary,plant,position,presence,pubescence,reproduction,rugulose,seed,shape,staman,stipe,texture,ye
364	wfo-0001028429	success	162	87	67	95	20	0.414	0.2-0.4,0.8-1.2,0.9-2.3,1-2.5,1.5-3,10-27,10.5-21,2-3,2-4,2.5-12,2.5-4,2.5-7.5,2.7-3.6,3-6,5-12,6-28,abaxially,adaxially,broadly,calyx,cm,connate,corolla,darker,diameter,distal,elliptical,forked,glabrescent,glabrous,globose,green,green-white,greenish,hair,half,herbaceous,interjected,lateral,leaf,leaflet,light,long,medium,mm,narrowly,odd-pinnate,ovate,ovoid,pedicel,peduncle,pentagonal,perennial,petiole,plant,rotate,scattered,seed,size,slightly,spot,terminal,throughout,violet,white,wide,yellow	1-4,1.5-4,10-11,2-1.,2-8,3-6-foliat,4-14,6-18,7-7,abaxiall,acumen,acuminate,acute,apex,apical,apically,articulate,base,branched,cell,cordate,covering,cuneate,cyme,dehiscent,dichasial,dichasially,digestion,diminishing,dorsally,eaf,ebracteate,edge,eed,emoval,enzyme,especially,exceeding,filament,flat,flower,folded,generally,globo,gradually,hair-like,honeycomb,introrse,living,lobe,lon,long-attenuate,lower,lunat,make,maturing,monochasial,mucilaginous,nflorescence,nther,oblique,obovate,often,orolla,pair,pattern,perfect,petiolule,plan,poricidally,proximal,reveal,ruit,seudostipule,short,slit,specimen,stamen,stigma,straight,style,tal,tem,testal,thick,throughou,toward,tuber-bearing,typically,unit,vary,vein,wall,ympodial,¼	2-19,anther,arrangement,color,form,fruit,growth,height,history,inflorescence,length,life,na,number,ovary,position,reproduction,shape,stem,texture
365	wfo-0001028436	success	150	94	61	89	33	0.407	0.2-0.4,0.5-1,1-2,1.5,1.5-2,1.5-2.5,10-20,2-3,2-4,2.5-3,4,5-10,5-12,5-8,8-12,abaxially,absent,acute,anther,apex,base,blade,brown,calyx,chartaceous,ciliate,cm,diameter,dm,dried,elliptic,entire,flower,fruit,glabrous,globose,hair,leaf,linear,lobe,margin,membranaceous,mm,moderately,nearly,oblong,pedicel,peduncle,petiole,presence,pubescent,rotate,shrub,stem,stigma,style,surface,tube,unifoliate,white,x	.5,0.5,0.8-1.5,1-2-celled,1-3,1st,2nd,5-15,7,abundant,adaxiall,adaxially,along,apically,appearance,appearing,axe,berry,beyond,cell,center,connected,cordat,decurrent,deflated,dehiscent,difficult,due,eaf,edge,eed,evaluat,explosively,exserted,filament,fine,flat,frui,fruiting,geniculate,glabrescen,interpetalar,lengt,like,linear-lancolate,long,lower,lying,much-branched,nflorescence,notch,often,older,orolla,oung,parallel,per,placenta,pointing,pubescen,rachi,radiating,raised,reaching,rhizomatous,ridge,ruit,running,shallow,small,sparsely,stamen,structure,swollen,tal,tamen,taproot,tear,thick,tissue,triangular,two-celled,unbranched,unit,vary,wid,woody,wrinkled,ympodial	2.5,adhesion,arrangement,climate,colour,corolla,form,glandular,growth,height,history,inflorescence,length,life,midpoint,na,number,ovary,perennial,plant,position,pubescence,ray,reproduction,rugulose,seed,shape,size,staman,stellate,stipe,texture,ye
366	wfo-0001028465	success	159	81	61	98	20	0.384	0.75,1.2-2,1.5-2.9,10-24,11-23,2-3,2-6,2-9.3,2.4-2.8,3-4,3-5,4-8,4.5-5.5,5-7,7-15,8-10,broadly,calyx,cm,connate,corolla,diameter,distal,elliptical,forked,globose,green,green-white,half,herbaceous,interjected,interpetalar,lateral,leaf,leaflet,long,medium,mm,odd-pinnate,ovoid,pair,pedicel,peduncle,perennial,petiole,plant,puberulent,pubescent,purple,rotate,seed,size,spot,stigma,strigose,style,terminal,throughout,white,wide,yellow	1-2,1-4,10,2,2-4,2.5-4,3-6-foliat,3-8,3.8-7,4-1.,9-19,abaxially,acumen,acuminate,acute,adaxially,apex,apical,apically,articulate,attenuate,base,branched,cell,covering,cuneate,cyme,decurrent,dehiscent,dichasial,dichasially,digestion,diminishing,dorsally,eaf,ebracteate,edge,eed,emoval,enzyme,equal,exceeding,filament,first,flat,flower,folded,generally,globo,gradually,hair-like,honeycomb,introrse,living,lobe,lon,lower,lunat,make,maturing,monochasial,mucilaginous,nflorescence,nther,oblique,often,orolla,pattern,perfect,petiolule,plan,poricidally,proximal,rachi,rarely,reveal,ruit,sessile,seudostipule,short,slit,specimen,stamen,straight,tal,tem,testal,thick,tissu,toward,tuber-bearing,two,typically,unit,vary,wall,ympodial,¼	4-18,anther,arrangement,colour,form,fruit,growth,height,history,inflorescence,length,life,na,ovary,position,reproduction,shape,stem,texture,tissue
367	wfo-0001028468	success	255	116	81	174	35	0.318	0.2-0.3,0.4-4,0.5-2,0.6-1.2,0.7-2.5,1,1.2-1.5,1.3-2,16,2-9,2.2-3,2.5-4,2.8-4.1,5-21,5-9,6-9,acute,anther,apex,attenuate,base,berry,blade,blue,brown,calyx,chartaceous,cm,corolla,densely,diameter,extra-axillary,flattened,flower,fruit,glabrous,hair,inserted,length,light,lobe,lobed,margin,midpoint,mm,moderately,narrowly,oblique,oblong-conical,oblong-lanceolate,orange,orangish,pedicel,peduncle,petiole,pubescence,purple,ray,rhombic,rotate-stellate,shallowly,short,shrub,sparsely,stellate-pubescent,stem,stigma,style,subcapitate,subcuneate,subelliptic,subglobose,sublenticular,subreniform,subshrub,surface,tube,unifoliate,x,yellow,yellowish	-1.3,-10,-3,-4,-5.5,-7,.1-0.2,.1-0.3,.1-0.4,.2,.2-0.4,.3,.3-0.4,.5,.5-1.5,.5-1.6,.6-1,/10-1/5,/4-1/3,0.05,0.1,0.2-0.6,0.2-1.5,0.4-1,0.5-3,0.5-3.3,0.5-3.5,0.5-8,0.6-2,0.8-3.5,1.5-2.2,1.5-3.1,1.6,1/3-1/2,1/5-1/2,2,2/3-3/4,20,3-4,4-6,4-9,6-10,abaxially,accrescent,acuminate,adaxially,along,apart,appressed,ark,armed,articulated,axe,becoming,beyond,broad-based,broadly,bu,bud,c.,campanulate,cauline,central,clavate,commonly,compresse,compressed,connivent,d.,dark,decreasing,density,directed,distal,distally,distantly,dry,eaf,eed,ellipsoid,equal,exserted,filament,foveate,fruiting,geminat,glabrescent,gradually,gray,green,greenish,half,increasing,interpetalar,introrsel,lamin,lateral,laterally,long,longer,lower,m.,main,midvein,minutely,mixed,mostly,multangulat,multangulate,nflorescence,obtuse,occasionally,older,orolla,ovate,overlapping,ovoid,pair,pale,papillo,per,perfect,pore,porrect-stellate,prickle,proximal,pubescent,rachi,recurved,reduced,relatively,reticulate,ruit,sessile,short-,short-stalked,side,similar,similarly,simple,slightly,somewhat,spaced,specimen,stalk,stamen,stelliform,straight,subacuminate,subchartaceous,subsessile,tal,tamen,terete,testa,thick,thick-stalked,thicknes,time,tissue,touching,toward,triangular,unarmed,unbranched,unit,upper,usually,vary,vein,way,wide,ympodial,young	0-1.3,0.5-1.5,0.5-1.6,0.6-1,1.5,4-5.5,adhesion,arrangement,climate,colour,form,glandular,growth,height,history,inflorescence,leaf,life,na,number,ovary,perennial,plant,position,presence,present,reproduction,rugulose,seed,shape,size,staman,stellate,stipe,texture
368	wfo-0001028470	success	185	103	70	115	33	0.378	0.25-0.75,0.9-2.2,0.9-2.3,1-12.3,1-2,1-3,11.8-21,12-44,2-7,2-8,2.1-3.9,3-10,3.5-16,4-7,5.5-11.6,abaxially,adaxially,anther,apex,attenuate,base,blade,brownish,chartaceous,clavate,cm,condition,corolla,deep,diameter,dot,drying,elliptic,fresh,fruit,glabrous,green,greenish,hair,herb,lanceolate,leaf,lobe,long,medium,mm,mottled,odd-pinnate,ovate,ovoid,pedicel,peduncle,pentagonal,petiole,plant,purple,rounded,seed,size,stigma,style,substellate,terminal,tube,usually,white,whitish,wide,x,yellow	0-18,1.5-2.8,1.6-3.2,2-10,2-5,3-5,3.2-5.5,3.5-7,4-6,5-merou,6-33,acumen,acute,adaxiall,ag,alyx,apart,apparently,articulated,asymmetric,axe,axillary,basiscopic,berry,bud,capitat,cell,connivent,covering,dark,decreasing,digestion,distal,dorsally,eaf,edge,eed,end,enzyme,erec,exceeding,filament,flat,flower,folded,forked,geminat,generally,glabrescent,glabrou,green-white,hair-like,hal,half,high,homostylous,honeycomb-shaped,interjected,lateral,leaflet,lengthening,light,living,lower,make,mucilaginous,nflorescence,one,orbicular,orolla,pair,perfect,petiolulate,placed,plurifoliate,pore,poricidal,pubescent,removed,ripe,ruit,scarce,sessile,seudostipule,short,side,slit,sometimes,spaced,specimen,stamen,stolo,straight,subequal,subglabrou,subtending,tall,tamen,tem,testal,thick,throughout,tip,tissue,toward,tri-,tuber,typically,unit,unwinged,vary,wall,wet,wing,ympodial	adhesion,arrangement,calyx,capitate,climate,colour,form,glandular,growth,height,history,inflorescence,length,life,margin,midpoint,na,number,ovary,perennial,position,presence,pubescence,ray,reproduction,rugulose,shape,staman,stellate,stem,stipe,surface,texture
369	wfo-0001028476	success	246	87	65	181	22	0.264	-16,-6,-8,0.4-0.6,0.5,0.5-0.6,0.8-1.2,0.8-1.6,1,1-1.4,1-4,1-6,1.1-1.5,1.8-2.5,2.4-3,3.5-13,5-15,7-10,abaxially,abundant,anther,branched,brown,calyx,capitate,cm,conical,corolla,dark,diameter,elliptic,fruit,globose,green,herb,imparipinnate,inflorescence,interrupted,leaf,long,minutely,mm,narrowly,obovate,ovary,pale,pedicel,peduncle,perennial,petiole,puberulent,pubescence,pubescent,purple,sparsely,stellate,stem,stigma,stripe,style,surface,thick,uniformly,wide,yellow	-1,-20,.05-0.1,.5,0-,0-0.5,0.1-0.15,0.1-0.4,0.15-0.2,0.15-0.4,0.2-0.3,0.2-0.5,0.2-0.6,0.25-0.4,0.25-0.5,0.3-0.4,0.3-0.5,0.3-0.7,0.3-1.2,0.4-0.5,0.4-1.5,0.5-1.7,0.7-2.5,1-1.2,1-1.5,1-2,1-2-celled,1-celled,1.1-1.6,1.2-2.5,12-30,2,2-6,2-foliate,2-locular,3-12,3-7,3-foliate,4-celled,6-,8-30,absent,acroscopically,acuminate,acute,age,almost,along,also,alternate,anthesi,ape,apex,apical,appearance,appendage,articulated,axi,basal,base,basiscopically,becoming,bifurcate,bifurcation,bract,bracteate,bright,cell,column,curved,decurrent,deeply,diamete,distal,eaf,ebracteate,edicel,eed,elongate,entire,especially,exserted,filament,first,flower,fortaleza,fruiting,give,glabrescent,glandular,gradually,gree,hair-like,hal,half,head,hyaline,incurved,interjected,internode,irregularly,lanceolate,largest,lateral,leaflet,less,like,lobe,lobed,lon,lower,main,margin,maturity,midvein,minute,mixed,nflorescence,node,numerous,oblique,occasionally,often,outgrowth,pair,petiolule,population,present,primary,prominent,pseudostipule,rachi,rarely,recurve,reflexed,regularly,rest,rounded,ruit,río,scattered,secondary,sessile,set,short,silky,simple,sinus,slightly,smaller,sprawling,spreading,staminal,sterile,stiff,straight,subopposite,tall,tem,terminal,tertiary,testa,tip,toward,trichome,truncate,tube,ud,unicellular,uniseriate,unit,unpaired,usually,vein,wall,weak-walled,white,wid,winged,woody,ympodial	0.05-0.1,6-30,adhesion,arrangement,colour,form,growth,height,history,length,life,na,plant,position,reproduction,rugulose,seed,shape,size,staman,texture,ye
370	wfo-0001028478	success	267	142	109	158	33	0.408	0.1,0.2–0.4,0.3–0.5,0.4–0.5,0.5–0.6,0.5–0.8,0.5–0.9,0.6–1.3,0.9–1.1,1.0–1.5,1.1–1.6,1.4–2.3,1.4–4.4,1.8–2.0,2,2.0–11.0,2.1–2.3,2.2–4.0,2.5,3.3–4.9,4,4.6–7.0,4–6,7.7–9.2,abaxially,acuminate,adaxially,adnate,anther,apex,attachment,attenuate,base,bilobed,blade,brown,calyx,cm,corolla,densely,developed,diameter,dry,elliptic,entire,flattened-orbicular,flower,fruit,glabrous,glandular,globose,hair,incurved,interpetalar,lanceolate,leaf,length,lobe,margin,markedly,mature,midpoint,mm,moderately,nearly,notched,obtuse,occasionally,orange-red,ovate,pedicel,peduncle,petiole,point,poorly,pubescent,ray,reddish,rounded,scattered,shoot,short,shrub,simple,sinuate,slightly,somewhat,sparsely,stellate,stem,stigma,stipe,style,sub-cordate,sub-coriaceous,suborbicular,surface,terminal,tissue,toward,truncate,tube,typically,white,yellow,yellow-tan,±equal,×,–10	.0,.04,.2,.3,.5,.8,.9,0.0,0.2,0.3–0.4,0.4,1.0–1.3,1.3–1.6,1.5–2.4,1.5–4,1/2–1/3,2.3,3.4,3–6,4.6,4.8,4–7,5-merou,5.5–6.6,7,adjacent,aequilateral,ag,alyx,anthesi,apart,apical,apparently,appearing,appresse,around,articulate,axe,ba,bark,based,berry,borne,broad,broad-based,broadly,brochidodromous,bud,capitat,channeled,clinate,connivent,deciduous,deeply,deflexed,deltate,development,difoliate,directed,distal,distally,distinct,distinctly,eaf,edge,eed,either,emerging,endocarp,erect,exocarp,extending,fertile,filament,filiform,flexed,free,geminat,glossy,gradually,hort,increasing,individually,internode,intersepalar,juic,lateral,layer,lobed,lon,long,longer,lower,midrib,midvein,minute,nflorescence,oblique,oblong,opaque,orolla,per,perforated,pitted,pore,porrect,porrect-stellate,portion,potentially,presen,prickle,probably,raised,retrorse,rigid,row,ruit,seen,sessile,shallowly,side,sigmoid,sinus,sloughing,smoot,soon,spaced,spatulate,splitting,spread,stamen,stellae,stellate-pubescent,stipitate,straight,strongly,suture,tamen,tem,thin,time,tip,transparent,triangular,two,ud,unarmed,unbranched,various,vary,vein,well,wide,yellow-ferruginou,ympodia,young,±45°,±90°	0.04,0.3,0.5,0.9,1.8,10.0,3.8,adhesion,arrangement,capitate,climate,colour,form,growth,height,history,inflorescence,life,na,number,ovary,plant,position,presence,present,pubescence,reproduction,rugulose,seed,shape,size,staman,texture
371	wfo-0001028481	success	194	106	92	102	14	0.474	.1,.5,0.6-1,0°,1-4,1.8-2.5,2.5-3,3-4,3-4.5,3-6,5.5-7.5,8,acuminate,almost,along,anther,apex,attenuate,bark,base,branch,brown,canaliculate,chartaceous,clavate,cm,colour,conical,corolla,cuneate,cupular,dendritic,dendritic-pubescent,diameter,distributed,drying,elliptic,entire,equal,erect,evenly,flaking,glabrous,green,leaf,length,less,liana,like,lobe,lobed,long,longitudinally,main,margin,midvein,mm,oblique,oblong,occasional,often,orange-brown,pair,pedicel,peduncle,petiole,primary,pubescent,ray,reddish,ridged,shortly,shrub,side,size,slender,sparsely,stem,stigma,style,surface,terminal,thickly,trichome,tube,unarmed,unknown,vein,white,x,yellowish,young	.3,0-2,0.1-0.2,0.15,0.5-1,1-1.4,1-2,1-3,1.5,1.5-2,1/2-2/3,2-3,3,3-3.5,abaxially,absent,acute,adaxially,age,alyx,anthesi,apar,apically,apparently,articulated,branched,clearly,close,deeply,delineated,deltoid,density,different,dilated,discolorous,divided,domatia,dorsifixed,dry,eaf,eed,ellipsoi,except,extending,extent,eye,faint,filament,flat,flexuous,flower,free,increasing,know,known,lamina,lengthening,linear,lon,long-acuminate,longer,lower,m.,mostly,naked,narrowly,nflorescence,nther,orolla,ovate,perfec,plurifoliat,pore,poricidal,portion,protruding,rachi,raised,ribbed,ruit,scar,see,simple,sinus,small,smoot,smoothly,spreading,stump,tearing,tertiary,tip,together,toward,ud,uneven,unit,vary,venation,visible,wide,ympodial	angle,arrangement,calyx,form,growth,inflorescence,na,number,ovary,position,pubescence,shape,smooth,texture
372	wfo-0001028482	success	224	129	99	125	30	0.442	.5,/3,0.5-1,0.5-5,00,1-1.5,1-11,1-2,1-4,1.1-5,1.2-1.6,1.5-2,10,2-3,2-celled,3-12,3-4,4-5,5-25,abaxially,acuminate,acute,anther,apex,asymmetric,base,bilobed,brownish,calyx,capitate,chartaceous,cm,coriaceous,corolla,creamy,densely,diameter,difoliate,dry,elliptic,emarginate,entire,flattened-reniform,fresh,fruit,glabrous,glandular,globose,green,growth,hard,internodal,leaf-opposed,lobe,lobed,long,margin,material,maturity,minute,minutely,mm,obovate,ovary,pale,pedicel,peduncle,petiole,pitted,poricidal,pubescent,revolute,short,simple,size,slightly,small,somewhat,stem,stigma,style,subcoriaceous,subglobose,subpyramidal,surface,tan,tip,tree,trichome,tube,unifoliate,uniseriate,way,white,x,yellow,yellowish,young,µm	.1,0,0.2,0.5,0.7-1.1,1.5-3,6-50,7-14,adaxially,age,alternate,angled,anthesi,apiculae,ascending,bark,basal,becoming,berr,berry,bifid,bifurcate,branched,bright,broadly,brochiodromous,bud,campanulate,channeled,circinate,closely,constriction,corky,corrugated,cucullate,curved,cymose,deciduous,deflexed,deltate,diffusely,discolorous,distally,distinct,drying,eaf,eed,ellipsoid,embryo,enlarged,exerted,exfoliating,expanding,filament,fleshy,flower,free,fruiting,geminat,glabrou,golden,grayish,halfway,heterostylous,impressed,incrassate,individual,investing,irregular,keeled,lengthening,less,lower,markedly,materia,midrib,midvein,new,nflorescence,nodding,occasionally,olive,overlappin,pair,papillat,pentamerous,per,pericarp,petal,pore,portion,primary,reddish,row,ruit,scandent,scar,shaped,shiny,slit,sometimes,soon,spaced,sparsely,stout,straight,tear-drop,tightly,tiny,transparent,transversely,truncate,tub,tuberculate,tuft,twice,two,ud,unit,usually,vegetative,vein,venation,woody,ympodial	adhesion,arrangement,blade,climate,colour,form,hair,height,history,inflorescence,leaf,length,life,midpoint,na,number,perennial,plant,position,presence,pubescence,ray,reproduction,rugulose,seed,shape,staman,stellate,stipe,texture
373	wfo-0001028487	success	195	99	71	124	28	0.364	0.3-0.7,0.9-3,1-3,1.1-1.5,1.4-1.7,10-4.3,15-28,2-4,2-6,2.5-3.5,3-10,3-19,4-7,4.6-13.6,5-6,7.8-16.4,abaxially,adaxially,anther,brownish,central,clavate,cm,condition,coriaceous,corolla,deep,diameter,drying,elliptic,fresh,fruit,glabrescent,glabrous,green,greenish,hair,herb,lanceolate,leaf,light,lobe,long,medium,mm,odd-pinnate,ovate,ovoid,pedicel,peduncle,pentagonal,petiole,plant,purple,ripe,scabrous,scarce,seed,short,size,star,stigma,style,substellate,terminal,tube,white,whitish,wide,x,yellow	0-9,0.4-1.5,1-2,1-3.2,1.7-7,10-41,2-4.8,3-4,3-5,3.4-7.8,5-merou,acumen,acuminate,acute,adaxiall,ag,along,alyx,apart,apex,apparently,arranged,articulated,asymmetric,attenuate,axe,axillary,base,basiscopic,bead,berry,blade,bud,capitat,cell,connivent,considerably,covering,dark,decreasing,digestion,distal,dorsally,eaf,edge,eed,enzyme,erec,exceeding,filament,flat,flower,folded,forked,geminat,generally,glabrou,green-white,hair-like,hal,half,high,homostylous,honeycomb-shaped,interjected,lateral,leaflet,lengthening,like,living,lower,make,moniliform,mucilaginous,multiple,narrow,necklace,nflorescence,orbicular,orolla,pair,perfect,petiolulate,plurifoliate,pore,poricidal,removed,rounded,ruit,second,sessile,seudostipule,side,slit,smaller,sometimes,spaced,specimen,stamen,stolon,straight,subequal,subglabrou,subtending,tall,tamen,tem,testal,thick,throughout,tip,tissue,toward,tri-,tuber,typically,unit,unwinged,usually,vary,wall,wet,wing,ympodial	adhesion,arrangement,calyx,capitate,colour,form,growth,height,history,inflorescence,length,life,na,number,ovary,perennial,position,presence,pubescence,ray,reproduction,rugulose,shape,staman,stellate,stem,surface,texture
374	wfo-0001028489	success	224	136	105	119	31	0.469	-0.6,-10,-2.5,-6,/4,0-3,0.2-0.4,0.3-1,0.3-1.2,0.5-1.1,0.5-1.5,0.6-1.2,0.7-3,1-3,1-4,1.5-4,1.8-2.2,1.8-4,1/3,2-3,2.1-3,3-7,3.5-6,4-8,5-8,7.5,abaxially,acute,anther,apex,base,berry,blade,calyx,chartaceous,cm,connivent,cordate,cream,cuneate,dark,densely,diameter,dull,elliptic,equal,erect,flattened-reniform,fruit,glabrous,gray,green,hair,lateral,leaf,length,lobe,lobed,long,margin,marking,maturity,mauve,membranous,midpoint,mm,moderately,obtuse,orange,orange-brown,ovate,pale,pedicel,peduncle,petiole,poricidal,purple,ray,rounded,shrub,side,simple,smooth,sometimes,sparsely,spherical,stellate,stellate-pubescent,stem,style,surface,tapering,tip,toward,trichome,truncate,tube,upper,way,weakly,white,wide,yellow,yellow-orange,young	-4,-5,0-10,0-15,0-20,0-50,0.1,0.1-0.6,0.2,0.2-,0.2-0.5,0.2-0.6,0.2-0.7,0.3-0.5,0.3-0.7,0.4-0.8,0.5-0.8,0.5-1,1-6,1-7,1.5-3,1.8-5.5,1/3-1/2,1/4-1/2,2-4,2-6,4-10,4-13,5-25,5-merous,acicular,alyx,apar,apart,apically,apparently,articulated,ba,bark,beyond,branched,broad-deltate,caudat,cell,concolorous,curved,deltate,difoliate,distance,drying,eaf,eed,elongating,extending,eye,filament,flower,free,fruiting,geminat,herbaceous,infructescence,less,lon,longer,lower,mature,midvein,minute,naked,nflorescence,occasionally,often,older,one,open,orange-green,orolla,oung,outline,pair,pendulous,per,perfec,pericarp,perpendicular,porrect,portion,prickle,prickly,primary,protruding,raised,red-brown,ruit,scar,sessile,shiny,slender,spaced,spreading,stalk,straight,subsessile,tamen,terete,tertiary,time,unarme,unarmed,unit,vary,vein,venation,visible,white-gra,woody,yellow-green,ympodial	adhesion,arrangement,climate,colour,corolla,form,glandular,growth,height,history,inflorescence,life,na,number,ovary,perennial,plant,position,presence,present,pubescence,reproduction,rugulose,seed,shape,size,staman,stigma,stipe,texture,unknown
375	wfo-0001028492	success	130	94	57	73	37	0.438	0.5-1,1-2.5,1-4,1.5-2.5,1.5-3,1.5-6,2-2.5,2-3,2-5,2.5-9,3,3-6,4,5-15,5-8,6-11,acute,angled,apex,base,blade,calyx,cm,dark,diameter,elliptic-ovate,entire,fruit,glabrous,globose,hair,herb,lobe,margin,mm,narrowly,pedicel,peduncle,petiole,purple,reticulate,rounded,shrub,simple,somewhat,stellate,stigma,style,subcordate,subcoriaceous,succulent,triangular,tube,unknown,white-punctate,whitish,x	-5-foliat,0.2-2,1-5,1.75-3.5,15-20,2-4,5-25-flower,6-12,8-15,abaxially,absen,adaxially,aggregate,apart,apiculate,articulated,axe,axi,cell,chartaceous,ciliolate,color,colored,connivent,containing,crystal,cylindrical,deltate,directed,distall,eaf,eed,except,forked,glabrou,irregularly,leaving,long,lower,nflorescence,nther,obtuse,orolla,pore,pubescent,punctate,rachi,radiu,rarely,ripe,ruit,san,sand-punctate,scar,spaced,sparse,splitting,stone,tal,tem,time,tip,triangular-ovate,truncat,unbranched,unevenly,unit,vary,veiny,white,wide,x1-3,ympodial	1-3,adhesion,anther,arrangement,climate,colour,corolla,form,glandular,growth,height,history,inflorescence,leaf,length,life,midpoint,na,number,ovary,perennial,plant,position,presence,pubescence,ray,reproduction,rugulose,seed,shape,size,staman,stem,stipe,surface,texture,truncate
376	wfo-0001028501	success	195	98	74	121	24	0.379	0-3.2,0.3-0.7,0.8-1.6,0.8-1.7,1-8,1.8-10.7,13-41,2-4,2.8-18,2.8-4.9,3-10,3-7,3.1-12,4-8,6.6-21.1,8-10,abaxially,adaxially,anther,axillary,brownish,bud,clavate,cm,condition,coriaceous,corolla,diameter,drying,elliptic,fresh,fruit,glabrescent,glabrous,green,greenish,hair,herb,lanceolate,leaf,light,lobe,long,medium,mm,mottled,odd-pinnate,ovate,ovoid,pedicel,peduncle,petiole,plant,purple,pyriform,ripe,rotate,scarce,seed,short,simple,size,sometimes,spot,stigma,style,subtending,terminal,tube,white,whitish,wide,x,yellow	0-3,0-4,0.3-3.3,0.6-5.8,1,1-2,1-3,2-5,3-5,3.1-10.4,4.8-18,5-merou,8-34,acumen,acuminate,acute,adaxiall,ag,along,alyx,apart,apex,apparently,arranged,articulated,attenuate,axe,base,bead,berry,blade,broadly,capitat,cell,connivent,considerably,covering,dark,decreasing,decurrent,digestion,distal,dorsally,eaf,edge,eed,enzyme,erec,exceeding,filament,flat,flower,folded,forked,geminat,generally,glabrou,green-white,hair-like,hal,half,high,homostylous,honeycomb-shaped,interjected,larger,lateral,leaflet,lengthening,like,linear,living,lower,make,moniliform,mucilaginous,multiple,narrow,narrowly,necklace,nflorescence,onto,orbicular,orolla,pair,perfect,plurifoliate,pore,poricidal,present,rachi,removed,ruit,sessile,seudostipule,slit,spaced,specimen,stamen,stolon,straight,subglabrou,tall,tamen,tem,testal,thick,throughout,tip,toward,tri-,tuber,typically,unit,unwinged,usually,vary,wall,wet,wing,ympodial	adhesion,arrangement,calyx,capitate,colour,form,growth,height,history,inflorescence,length,life,na,ovary,perennial,position,pubescence,reproduction,rugulose,shape,staman,stem,surface,texture
377	wfo-0001028502	success	158	84	62	96	22	0.392	/2,0.5-1,1-2,1.5-2.5,1.5-6,1.6-2.4,2-4,2-7,2-8,3.5-15,3.5-4,abaxially,adaxially,anther,base,brown,calyx,clavate,cm,congested,corolla,dark,dendritic,densely,elliptic,fawn,flattened-reniform,glabrous,globose,inflorescence,later,lateral,leaf,lobed,long,minutely,mm,obovate,ovary,papillose,pedicel,petiole,pitted,pubescent,reddish-brown,seed,shining,shrub,small,stem,stigma,style,surface,terminal,tree,tree-like,trichome,tube,way,white,wide,woody	.5,1.5-2,1.5-3,2-2.5,2-5,5-15,5-6,6-8,?,abaxial,acute,age,along,anthesi,apar,apex,ba,bark,beige,blade,body,branch,branched,campanulate,cazalet,christmas-tree-like,closely,cone,constricted,deltate,denser,dia,eaf,edicel,eed,erect,exserted,fide,filament,flat,fleshy,flower,free,fruiting,glabrat,heteromorphic,impressed,included,incrassate,inflorescenc,lengthening,light,like,lobe,lon,long-styled,lower,main,margin,matted,middle,narrower,nflorescence,often,older,packed,pair,papillo,planar,plurifoliat,pore,poricidal,portion,prominent,rest,ruit,scar,scattered,short-styled,slit,spaced,structure,tall,thick,time,tip,tub,ud,unclear,unevenly,vein,warty,widest,within,ympodia,young	4-6,arrangement,colour,diameter,form,fruit,growth,height,history,length,life,na,perennial,plant,plurifoliate,position,pubescence,reproduction,rugulose,shape,size,texture
378	wfo-0001028505	success	168	79	60	108	19	0.357	.1,.5,/3,0.8-1,0.8-1.5,1-3,10-15,2,3.5-5,anther,base,bright,calyx,cm,corolla,dia,dry,drying,erect,glabrous,globose,green,grey,leaf,live,lobe,lobed,margin,material,minutely,mm,narrowly,opposite,ovary,ovate,ovoid-reniform,pale,papillose,pedicel,petiole,pitted,plant,poricidal,pubescent,seed,shape,shrub,size,stem,stigma,style,surface,tan,tip,trichome,unicellular,uniseriate,way,white,x	.01,.3,0.25-0.5,1,1.2-2.5,1/3,10-14-flowered,2.5-4.5,3-5,7-8,acuminate,acute,anthesi,apex,aspect,ba,barely,bark,basal,beneath,berry,black,blade,body,branch,broadly,bud,characteristic,conical,darker,deciduous,decurrent,deflexed,delicate,deltoid,differentiated,differing,difoliate,distance,distinct,dried,eaf,edicel,eed,elliptic,expanded,exserted,exsertion,f,filament,flattened,free,fruiting,geminat,gently,greatly,incrassate,lateral,lon,long,lower,m.,main,major,materia,member,minor,minute,nflorescence,obovoid,obvious,older,overlapping,pair,pore,portion,prominent,proximal,purple,reflexed,rounded,ruit,scar,shaped,short,simple,slightly,somewhat,soon,specimen,straight,strongly,tall,tapering,tear-drop,touching,truncate,tube,ud,unit,usually,vein,whit,widest,woody,yellowish,ympodial,young	.25-0.5,arrangement,colour,diameter,form,fruit,growth,height,history,inflorescence,length,life,na,perennial,position,pubescence,reproduction,rugulose,texture
379	wfo-0001028513	success	240	107	81	159	26	0.338	-17,0.1-0.15,0.2-0.8,0.5-0.6,1-2.5,1-4,1.5-5,2-4,2-5,2.75-3.25,20-35,25-45,3-4,3-4.5,3.5-4,4-6,4-8,5-10,5-9,7-11,8-11,8-15,9-11,acute,anther,apex,base,blade,broadly,brown,calyx,cm,coarsely,dentate,diameter,ellipsoidal,extra-axillary,fruit,globose,hair,inflorescence,lavender,leaf,length,lenticular,light,linear-lanceolate,lobe,margin,mm,obtuse,orange,outline,ovate,pedicel,peduncle,perennial,petiole,pitted,present,pubescent,ray,simple,small,somewhat,stellate,stellate-pubescent,stigma,style,subcordate,surface,texture,thin-textured,tree,trichome,truncate,tube,variable,white,x,yellow	-0.7,-0.8,-5,-6,.1-1.3,.2,.3-0.5,/3,0-0.4,0.1-0.4,0.3-0.5,0.5-2,1,1-2,1-3,1/5-1/3,15-40,2,2-4.5,2-6,2-foliate,30,4-locular,4.5-6,5-6,8-16,8-25,abaxially,accrescent,acute-,acute-tipped,adaxiall,adaxially,along,apart,apiculate,appearing,appressed,approaching,approximately,armed,articulated,attenuate,axe,ba,berr,bristly,broad,broad-based,bud,campanulate,capitat,cauline,close,closely,commonly,compresse,connivent,cylindrical,deciduous,deltoid,densely,depressed-deltoid,directed,distal,distall,doubling,eaf,eed,enclosing,entire,erect,exceeding,female-sterile,filament,flexible,flower,fruiting,geminat,glabrous,horizontal,inserted,interlobal,large,larger,lateral,laterally,less,lignescent,long,lower,major,many,mature,midpoint,minute,near,nflorescence,numerous,obtuse-,often,one,oriented,orolla,ovate-lanceolate,pair,partially,per,pericarp,persisting,plane,pore,prickl,prickle,prickly,principal,purple,rachi,radiu,rarely,reaching,recurved,rigid,ripe,round-tipped,rounded,ruit,rust-colored,scabrous,scattered,sessile,short,short-stalked,side,silvery-gray,sinus,siz,smaller,soft,spaced,sparsely,stalk,stellae,tal,tamen,tem,termination,time,tooth-like,unarmed,unbranched,underdeveloped,unit,usually,vary,vein,weakly,wide,ympodial	adhesion,arrangement,capitate,colour,corolla,form,glandular,growth,height,history,life,na,number,ovary,plant,position,presence,pubescence,reproduction,rugulose,seed,shape,size,staman,stem,stipe
380	wfo-0001028524	success	236	117	90	146	27	0.381	0.3,1-5,1.1-1.2,1.2-1.3,1.5-1.6,1.5-3,1.8-2.5,10-20,11,2-3.8,2-6,2.5-4,2.8-3.5,3-10,3-15,3-4.3,3.4-3.6,4-6,4-8,4.3-6,8-13,9-14,adaxially,anther,becoming,blunt-tipped,brown,calyx,chartaceous,cm,conical,corolla,cream,dark,deltoid,densely,diameter,dm,ferrugineous,fleshy,flower,fruit,glabrescent,granular-tomentose,gray,green,greenish,growth,honeycombed,inserted,lanceolate,lateral,leaf,length,lobe,mm,oblong,ovate,pale,pedicel,peduncle,persistent,petiole,probably,pseudo-terminal,pubescent,rather,reniform,reticulate-punctate,ripe,scabridulous,simple,small,somewhat,sparsely,stellate,stem,stigma,style,subcoriaceous,subglobose,suborbicular,tomentose,tree,tube,velutinous,x,yellow,yellowish,yellowish-green	-2.7,-3,.5-1,/10-3/10,0-150,0.3-0.8,0.5-3.5,0.6-1.4,1/3-2/3,2.5-3.4,2.5-3.8,3.3-4,6-7,6-9,7-10,7-11,abaxially,accrescent,acuminate,acute,ag,along,anthesi,apart,apex,apical-lateral,apparently,articulated,ascending,axe,axillary,ba,bark,base,berry,blade,branch,branched,bud,capitat,closely,continued,dehiscing,distal,due,eaf,echinoi,echinoid,eed,elliptic,entire,exserted,extend,few-,few-rayed,filament,first,free,fruiting,glabrescen,glabrous,hair,half,high,indument,interpetalar,introrse,lacking,lanceolat,large,late,later,lobed,long,longitudinal,lower,m.,main,many-rayed,margin,matted,midvei,midvein,mixed,multangulate,nearly,nflorescence,obscured,obtuse,often,older,orbicular,orolla,ovate-lanceolate,overlapping,partly,perfect,plurifoliate,pore,porrect-stellate,present,prominent,rachi,ray,relatively,rounded,ruit,runk,sessile,short,short-stalked,side,slightly,slit,spaced,sparingly,stalked,stamen,stelliform,stout-stalked,strongly,sulcate,suture,tamen,terete,testa,thick,thick-stalked,thin,thin-stalked,time,tissue,tomentu,touching,translucent,unarme,unarmed,unit,usually,vary,vein,warty,way,wide,ympodial,young	abaxial,adaxial,adhesion,arrangement,capitate,colour,form,height,history,inflorescence,life,na,ovary,perennial,plant,position,pubescence,reproduction,rugulose,seed,shape,size,sparing,staman,surface,texture,unknown
381	wfo-0001028525	success	257	137	109	148	28	0.424	0.2-0.3,0.5,0.5-1.5,0.5-2.5,1.1-1.7,1.2-1.6,1.5-3,1/3-3/4,10,10-13,2,2-2.5,2-3,2.5-5,3,3-5,3-7,4,4-15,4-5,6,7,7.5,acuminate,acute,almost,anther,anthesi,apex,apparently,attenuate,base,black,branch,broadly,brown,calyx,capitate,chartaceous,clavate,cm,conical,cordate,corolla,curved,dark,dendritic,dendritic-pubescent,developed,diameter,drying,elongated,entire,flattened,form,free,fruit,glabrescent,glabrous,grey,inside,lateral,laterally,leaf,liana,light,like,lobe,lobed,long,lumpy,margin,mature,mauve,membranous,mm,oblong,orange-brown,outside,ovate,partly,pedicel,peduncle,petiole,puberulous,pubescent,pyriform,ray,shrub,side,simple,size,slender,smooth,spheroidal,stem,stigma,style,surface,terminal,thick,thin,trichome,truncate,tube,weakly,whitish,x,young	.25,.4,0.2-0.6,0°,1-1.5,1-2,1-2.5,1-4,1.5,1mm,4-7,7-13,accrescent,age,along,alternate,alyx,apar,apart,apically,apice,around,articulated,axil,bark,becoming,berry,brachyblast,branched,branching,centre,clearly,clum,clustered,cup,deeply,delineated,deltoid,densely,density,detaching,developing,dilated,discolorous,divided,domatia-like,dorsal,dorsifixed,eaf,eed,ellipsoi,equal,erect,eye,fertilisation,fewer,filament,fine,flat,flexible,flexuous,flower,formed,forming,frequently,frui,fruiting,green-brown,increasing,known,lamina,leave,lengthening,less,linear,longer,longitudinally,loop,loose,lower,m.,main,midvein,minute,much,multicellular-dendritic,naked,narrowly,nflorescence,nther,obconical,obscuring,often,one,orolla,overlapping,ovoid,pair,pendulous,perfec,pericarp,plurifoliat,pore,poricidal,portion,primary,prominent,protruding,rachi,red-brown,ridged,rounded,ruit,scar,scattered,sessile,sinus,slightly,small,smaller,smoot,sometimes,somewhat,soon,sparsely,spreading,stripe,structure,stump,tangling,tearing,terete,tertiary,tip,toward,ud,unarmed,uneven,unit,vary,vein,venation,visible,well-developed,white,wide,wider,ympodial	adhesion,arrangement,blade,climate,colour,glandular,growth,hair,height,inflorescence,length,midpoint,na,number,ovary,plant,position,presence,present,pubescence,reproduction,rugulose,seed,shape,staman,stellate,stipe,texture
382	wfo-0001028528	success	155	123	91	64	32	0.587	.5,0.9-1.2,1-2,1.1-1.2,2-4,2.5-3,3.5-4,3.5-6,3/4,4-5,4-6,8-9,?,acute,age,along,anther,apex,apical,attenuate,base,becoming,berry,bi-lobed,blackish,branch,branching,calyx,cm,conical,coriaceous,corolla,decurrent,dendritic,densely,denser,diameter,elliptic,erect,flattened,fork,free,glabrous,glandular,globose,growth,immature,later,leaf,lobe,lobed,margin,minutely,mm,mucronate,narrowly,obovate,occasionally,outline,ovary,pedicel,per,pericarp,petiole,pitted,plurifoliate,pore,poricidal,pubescent,reddish-brown,revolute,round,shiny,shrub,slit-like,sparsely,stem,stigma,strongly,style,surface,terminal,thin,tip,trichome,tube,vein,violet,way,white,x	1.5,1.8-2,2-3,6-10,6-7,abaxial,absent,acuminate,adaxial,adaxially,anthesi,ba,bark,basal,dichasia,eaf,edicel,eed,ew,except,exserted,filament,flower,fruiting,glabrat,impressed,inserted,leave,like,long,lower,m.,midvein,minute,nflorescence,nodding,older,pair,papillo,petal,planar,portion,prominent,pyramidal,ruit,scar,secondary,short,sleeve,somewhat,stamen,ste,tall,tapering,time,triangular,tub,ud,unit,wide,winged,woody,ympodial,young	adhesion,arrangement,blade,climate,colour,dichasial,form,fruit,hair,height,history,inflorescence,length,life,midpoint,na,number,peduncle,plant,position,presence,pubescence,ray,reproduction,rugulose,seed,shape,size,staman,stellate,stipe,texture
383	wfo-0001028529	success	164	106	71	93	35	0.433	0.5,0.5-2,0.8-1.3,0.8-3.2,1,1-1.2,1-1.5,1.5,2.5-3,2/3,5-6,8-14,acuminate,anther,apex,attenuate,base,bluish,brown,calyx,capitate,cast,cm,corolla,dark,decurrent,dia,erect,glabrous,globose,green,internodal,lanceolate,leaf,less,lobe,lobed,metallic,minute,minutely,mm,narrowly,nearly,oblanceolate,occasionally,opposite,ovary,ovoid-reniform,papillae,papillose,pedicel,petiole,poricidal,scattered,shape,shrub,size,slightly,smooth,somewhat,stem,stigma,style,subshrub,surface,tip,tube,way,white,winged,x	.2,0.1,0.8-3,3-40-flowered,3-5,6-9,7-8,across,acute,age,anthesi,apart,apiculate,bark,becoming,beginning,beneath,berry,bud,close,cork,course,deflexe,deltoid,distal,eaf,edicel,eed,ellipsoi,elliptic,evenly,exfoliating,exserted,filament,flower,free,fruiting,furcate,growing,heterostylous,hrub,hyaline,immature,indistinct,inflorescenc,lateral,lenticellat,linear,lon,long,lower,main,major,middle,minor,much,nflorescence,older,one,pair,paler,papillo,pitted,planar,pore,portion,present,prominent,range,reflexed,river,ruit,scar,shaped,short,simple,slender,small,soon,spaced,species,straight,tall,tapering,tear-drop,ud,umbonate,variable,vein,widest,woody,yellowish,young	adhesion,arrangement,blade,climate,colour,deflexed,diameter,form,fruit,glandular,growth,hair,height,history,inflorescence,length,life,margin,midpoint,na,number,peduncle,perennial,plant,position,presence,pubescence,ray,reproduction,rugulose,seed,staman,stellate,stipe,texture
384	wfo-0001028532	success	186	88	64	122	24	0.344	0.2-1,1-1.7,1-3,1.3-8.7,17-42,2-3,2-8,2.2-4.2,3-10,3-7,4-7,5.5-15,6.5-9.2,7.5-15.2,anther,axillary,brownish,bud,chartaceous,clavate,cm,condition,corolla,deep,diameter,drying,fresh,fruit,glabrous,globose,green,greenish,herb,lanceolate,leaf,lobe,medium,mm,mottled,odd-pinnate,ovate,ovate-lanceolate,ovoid,pedicel,peduncle,pentagonal,petiole,plant,purple,ripe,rotate,seed,size,sometimes,spot,stigma,style,subtending,terminal,tube,white,whitish,x,yellow	0-19,1-1.6,1-2,1-5,1.4-1.6,15-36,2-6,3-5,3.3-4.4,3.9-5,5-9,5-merou,abaxiall,abaxially,acumen,acuminate,acute,adaxially,ag,along,alyx,apart,apex,apparently,arranged,articulated,asymmetric,attenuate,axe,base,basiscopic,bead,berry,blade,capitat,cell,connivent,covering,dark,decreasing,digestion,distal,dorsally,eaf,edge,eed,enzyme,erec,exceeding,filament,flat,flower,folded,forked,geminat,generally,glabrou,green-white,hair-like,half,homostylous,honeycomb-shaped,interjected,larger,lateral,leaflet,lengthening,like,linear,living,long,lower,make,middl,moniliform,mucilaginous,multiple,necklace,nflorescence,orbicular,orolla,pair,perfect,petiolulate,plurifoliate,pore,poricidal,removed,rounded,ruit,second,sessile,seudostipule,side,slightly,slit,spaced,specimen,stamen,stolon,straight,subequal,symmetric,tall,tamen,tem,testal,thick,throughout,tip,tissue,toward,tri-,tuber,typically,unit,unwinged,usually,vary,wall,wet,ympodial	adhesion,arrangement,calyx,capitate,colour,form,growth,height,history,inflorescence,length,life,na,ovary,perennial,position,pubescence,reproduction,rugulose,shape,staman,stem,surface,texture
385	wfo-0001028546	success	239	120	95	144	25	0.397	%,0-1,0.4-0.5,0.5-0.75,0.5-1,0.5-1.5,1-3,1-3.5,1.1-1.8,1.1-2.2,1.5-1.75,1.5-2,10-22,2-3.5,2.5-3,2.6-3.4,3-4,3.5-19,4-8,4-9,4.5-6,5-10,7-24,7.5-10,9.5-24,acuminate,acute,anther,apex,base,blade,brown,calyx,capitate,chartaceous,cm,cuneate,cylindrical,diameter,ellipsoidal,elliptical,erect,extra-axillary,finely,flattened,fruit,glabrous,gland-tipped,globose,hair,inflorescence,lamina,lanceolate,lateral,leaf,length,lobe,lobed,long,margin,mm,obtuse,ovate,pale,pedicel,peduncle,perennial,petiole,pinkish,plant,present,purple,ray,red,reticulate,rhizomatous,rotate,shallowly,short,shrub,simple,slightly,sparsely,stellate,stellate-pubescent,stigma,style,surface,tan,throughout,time,tube,white,x,yellow	0-0.1,0-0.5,0-18,0-9,0.15-0.25,0.3-0.5,0.3-1,0.5-1.3,0.5-2,0.6-2,0.8-1.4,1-2,1-4,1-7,1-locular,1.5-6,10-14,100-150,11-12,120-400,16-24,2-,2-4,2-9,2.3-2.7,26-38,3-,3-11,3-5,3-7,3.5-7.5,4-13,5-55,5-8,5-merou,6-10,8-15,8-40,9-16,9.5-19,abaxially,absen,absent,accrescent,acicular,across,adaxially,adult,also,alyx,ample,andromonoecious,apart,apparen,articulated,attenuate,axe,ba,bilobe,branch,branche,connivent,deeply,directed,distall,distally,distributed,dm,eaf,eed,eglandular,exocarp,filament,finger,flower,foliate,fruiting,functional,geminat,green,half,heterostylous,incomplete,index,interpetalar,juicy,juvenile,less,lobing,longer,lower,main,markedly,mature,mesocarp,mid-point,midpoint,midvein,minute,moderately,nflorescence,oblique,often,orolla,pair,part,pendent,per,placenta,pore,porrect,prickle,pseudo-racemose,rachi,ruit,septum,sessile,side,somewhat,spaced,stalk,stellae,straight,succulent,tal,tamen,tem,thick,thicker,thicknes,tissu,tissue,triangular,unarme,unarmed,unbranched,unit,upper,usually,vary,vein,weakly,wide,ympodial	adhesion,arrangement,bilobed,colour,corolla,form,growth,height,history,life,na,number,ovary,position,presence,pubescence,reproduction,rugulose,seed,shape,size,staman,stem,stipe,texture
386	wfo-0001028547	success	224	115	84	140	31	0.375	-13,-6,.2,.5,.8,0.2-0.35,1-2.5,1.2-1.4,1.7-2,2.5-2.8,2.8-3.2,3-5,3.5-4.5,4-6,6-8,7-10,7-9,acute,anther,apex,base,berry,blade,bright,calyx,cell,chartaceous,cm,connivent,cuneate,densely,diameter,dull,entire,flattened-reniform,fruit,glabrous,inflorescence,lateral,leaf,length,lobe,lobed,long,long-acuminate,margin,maturity,mauve,midpoint,mm,moderately,orange,orange-brown,outline,ovate,pedicel,peduncle,petiole,pit,poricidal,purple,raised,ray,red,reddish,shallowly,shrub,simple,small,smooth,somewhat,spherical,stellate,stellate-pubescent,stem,style,surface,tapering,terminal,tip,truncate,tube,wide,yellow	-1/2,-3,.7,/2,/5,0,0-1,0-10,0-15,0-2,0-30,0-5,0.05-0.15,0.1-0.2,0.15,0.3-0.4,0.5-,0.7-1,0.8-1,1-2,1-4,1-5,1.5-2.5,1/3,1/5-1/4,10-12,2-1.5,2-2.5,2-4,2-6,4-5,5-merous,abaxial,abaxially,absent,adaxial,alyx,apar,apart,ape,apically,apparently,appearing,articulated,bark,branched,branching,bulbous,conical,cream,curved,dark,deltate,discolorous,distance,drying,eaf,eed,elongate,elongating,equal,erect,extending,faint,filament,flattened,flower,free,fruiting,gently,glabrescent,glabrou,gray-brow,green,infructescence,lon,long-styled,longer,lower,marking,mature,midvein,narrow-deltate,nflorescence,oblong,occasionally,often,older,one,open,orolla,oung,pair,pale,pendulous,per,perfect,pericarp,plurifoliat,porrect,portion,prickl,prickle,prickly,primary,reflexed,rounded,ruit,scandent,scar,sessile,short-styled,side,slender,sometimes,spaced,spreading,stalk,stalked,staminate,straight,subsessile,tamen,terete,tertiary,thin-acuminat,time,trichome,unit,usually,vary,vein,venation,villous,way,woody,yellow-green,yellow-orange,ympodial,young	8,adhesion,arrangement,climate,colour,corolla,form,glandular,gray-brown,growth,hair,height,history,life,na,number,ovary,plant,position,presence,present,pubescence,reproduction,rugulose,seed,shape,size,staman,stigma,stipe,texture
387	wfo-0001028548	success	266	126	76	190	50	0.286	0.6,1/3,2.8,3.1,4.9,acuminate,adnate,anther,apex,attachment,attenuate,base,blade,brown,calyx,chartaceous,cm,corolla,cuneate,developed,diameter,dry,entire,extra-axillary,flattened-orbicular,flower,fruit,glabrous,glandular,globose,growth,hair,incurved,internode,lanceolate,lateral,leaf,length,lobe,lobed,long,margin,midpoint,mm,notched,oblong,occasionally,ovate,pedicel,peduncle,petiole,point,poorly,probably,pubescent,ray,reddish,rounded,short,shortly,shrub,simple,somewhat,sparsely,stellate,stem,stigma,stipe,style,surface,tube,unknown,upper,wave,white,yellow	.2,.4,.6,.7,.8,.8–2.4,.9,/3,0,0.06,0.3–0.8,0.4,0.4–0.5,0.4–0.6,0.4–0.7,0.7–0.8,0.7–1.7,0.8–1.2,0.8–1.9,0.8–2.0,0.8–2.9,0.9–1.2,1.0–4.1,1.1–1.2,1.1–1.4,1.1–1.5,1.3–1.6,1.4–2.3,1.6–2.7,1.7–2.1,1/3–1/2,2.0,2.2–2.8,2.3,2.4–2.7,3.1–3.8,3.6–8.1,3.7–4.0,3.8–4.6,4,4–8,5-merou,5.5–6.6,5.6,6.4–19.8,6–10,6–9,90°,abaxially,absent,acute,adaxially,aequilateral,ag,alyx,anthesi,apart,apical,apiculate,apparently,appearing,arching,area,around,articulate,axe,ba,bark,berry,branch,branching,broad,brochidodromous,bud,capitat,central,channeled,clinate,color,congested,deciduous,deltoid,densely,dentate,development,difolate,directed,distal,distinct,eaf,edge,eed,either,elliptic,emerging,endocarp,erect,exocarp,extending,fertile,filament,filiform,flexed,free,geminat,glossy,gradually,heterostylous,increasing,intact,interpetalar,intersepalar,juic,juvenile,large,layer,less,lon,longer,lower,major,many,mature,midrib,midvein,minor,minute,moderately,nearly,nflorescence,oblique,opaque,orolla,per,pitted,pore,porrect,porrect-stellate,portion,potentially,pubescenc,raised,reflexe,remaining,rigid,row,scarcely,seen,sessile,short-stipitate,shorter,side,sinus,sloughing,smoot,smooth,soon,splitting,spread,spreading,stamen,stellae,stellate-pubescent,straight,suture,swelling,tamen,tem,thin,time,tip,tissue,transparent,truncate,two,ud,unarmed,unbranched,various,vary,vein,weakly,wide,yellow-ferruginous,ympodia,young,±90°,±equal,±glabrous,×	0.2,0.3-0.8,0.4-0.5,0.4-0.6,0.4-0.7,0.7-0.8,0.7-1.7,0.8-1.9,0.8-2.0,0.8-2.9,0.9,1.0-4.1,1.1-1.2,1.1-1.4,1.1-1.5,1.2,1.3-1.6,1.7-2.1,2.2-2.8,3.8,4-8,6-9,6.4-19.8,adhesion,arrangement,capitate,climate,colour,dense,form,height,history,inflorescence,life,na,number,ovary,perennial,plant,position,presence,present,pubescence,reproduction,rugulose,seed,shape,size,staman,texture
388	wfo-0001028551	success	243	138	103	140	35	0.424	.0,.06,.1,.3–0.5,.5,.8,0.4–0.5,0.7–2.3,1.0,1.0–1.6,1.1–2.2,1.4–2.0,1.5–1.8,1.6–1.7,1.8–2.5,1/3,2,2.0–2.6,2.0–3.5,2.0–3.7,2.2–7.5,4.2–5.9,4.5–7.0,8.0–12.0,8.5–20.5,abaxially,acuminate,adaxially,adnate,anther,apex,attachment,attenuate,base,becoming,blade,calyx,chartaceous,cm,corolla,cuneate,dark,densely,diameter,dry,elliptic,entire,extra-axillary,flattened-suborbicular,flower,fruit,glabrous,glandular,globose,green,hair,internode,interpetalar,lacking,lanceolate,lateral,leaf,lilac,lobe,long,margin,markedly,mature,maturing,minute,mm,nearly,notched,pedicel,petiole,point,poorly-developed,porrect,pubescent,red,shiny,shrub,simple,slender,somewhat,stellae,stellate,stigma,style,subcoriaceous,tan,tissue,toward,tree,tube,upper,violet,wavy,white,yellow,young,±globose,×	.6,0,0.5–0.6,0.7–1.0,0.8–1.4,1.0–1.5,1.1,1.1–1.4,1.3,1.5–1.9,1.7,1.7–2.6,2.2–3.4,2.2–5.2,2.3–3.4,2.5,2.75–4.0,3/4,4–6-merou,5–11,7.5–10.5,8.0–11.4,9.0,aequilateral,almost,alveolate,alyx,anthesi,apart,apical,apiculate,apparently,appearing,area,armed,articulated,axe,ba,berry,branch,broad-based,brochidodromous,bud,capitat,caudate,central,channeled,closely,conical,connivent,continuing,dehiscence,deltate,dentate,development,difoliate,distally,distinctly,dorsally,eaf,eed,either,endocarp,enlargement,entir,equal,exocarp,fertile,filament,filiform,forking,free,frui,geminat,glabrou,gradually,homostylous,immature,inclined,increasing,juic,large,line,lobed,lon,longer,lower,major,midrib,midvein,minor,narrowly,nflorescence,numerous,oblique,oblong,occasionally,orolla,outline,pore,portion,potentially,prickle,prominent,pseudo-peduncle,ripe,row,ruit,scattered,side,sinus,smooth,spaced,split,splitting,spread,stamen,stellate-pubescent,straight,suture,tamen,tem,thin,time,tip,triangular,two,typically,ud,unarme,unarmed,unbranched,vary,vein,weakly,wide,yellow-ferruginou,ympodia,±appressed,–4.8	adhesion,arrangement,capitate,climate,colour,form,growth,height,history,inflorescence,length,life,midpoint,na,number,ovary,peduncle,perennial,plant,position,presence,present,pubescence,ray,reproduction,rugulose,seed,shape,size,staman,stem,stipe,surface,texture,yellow-ferruginous
389	wfo-0001028558	success	224	94	69	155	25	0.308	0.1-0.3,0.15-0.5,0.4-1.5,0.8-1.5,1-1.3,1-4,1-9,2.2-2.8,2.4-3,2.5-3.5,2.5-5,3-8,4-15,6-10,6-22,6-7.5,8-12,acute,almost,anther,apex,base,blade,calyx,chartaceous,cm,connivent,cordate,densely,diameter,dull,entire,equal,flattened-reniform,fruit,glabrous,herb,lateral,leaf,length,lobe,lobed,long,margin,mauve,midpoint,mm,often,orange-brown,ovate,pale,pedicel,peduncle,petiole,plant,ray,rounded,shrub,simple,spherical,stellate,stellate-pubescent,stem,style,tapering,terminal,tube,wide,yellow	-2,-5,.5,/6,0-10,0-30,0-4,0-5,0.1,0.1-0.4,0.2,0.5-0.9,0.5-2,0.6,00-200,1,1-3,1.3-1.8,1.5-2.3,1.5-2.5,1.5-3,1.5-6,1.8-2.3,1/3,1/3-1/2,1/4,1/4-1/3,15-60,2-5,3-,3-50,3-9,3/,4,4.2-7,4.5-8,5-10,5-60,5-7,5-merous,6-20,6-9,7-10,abaxially,adaxially,alyx,ame,andromonoecious,apar,apart,apically,apparently,articulated,bark,berry,branched,broad-deltate,c.,clearly,concolorous,conical,cream,curved,dark,deltate,discolorous,distal,distance,drying,eaf,eed,elongated,elongating,erect,extending,filament,flattened,flower,free,fruiting,gently,glabrescent,gra,green,hermaphrodite,heterostylous,infructescence,least,long-styled,longer,lower,lowermost,marking,mature,maturity,midvein,moderately,multangulate,narrow-deltate,nflorescence,obtu,older,one,open,orolla,oung,pair,pendent,pendulous,per,pericarp,plurifoliat,poricidal,porrect,portion,prickl,prickle,prickly,primary,reflexed,ruit,scar,sessile,short-styled,side,smooth,spaced,sparsely,spreading,stalk,stalked,staminat,stout,straight,surface,tamen,terete,tertiary,time,tip,trichome,unarmed,unit,upper,variously,vary,vein,venation,visible,way,weakly,woody,yellowish,ympodial,young	adhesion,arrangement,climate,colour,corolla,form,glandular,growth,hair,height,inflorescence,na,number,ovary,position,presence,present,pubescence,seed,shape,size,staman,stigma,stipe,texture
390	wfo-0001028571	success	230	155	100	130	55	0.435	.1,.5,0.4,1,12,2.5,4-rayed,abaxially,acicular,acute,almost,anther,apex,base,blade,broadly,brown,calyx,cm,cordate,cover,dark,dense,densely,diameter,dilated,elongated,entire,erect,exclusively,extra-axillary,extreme,fertile,flattened,flower,free,fruit,gland-tipped,glandular-puberulent,globose,hair,highly,hyaline,interlocking,lanceolate,larger,length,light,lobe,lobed,long,longer,margin,minutely,mm,multangulate,nearly,one,ovate,pair,pale,pedicel,peduncle,perhaps,petiole,prickle,proportion,pubescence,pubescent,ray,rounded,scattered,sessile,shallow,shrub,similar,simple,size,somewhat,spreading,stellae,stellate,stem,stigma,straight,style,summit,surface,thin-textured,tip,tomentose,tube,unbranched,variable,varying,vestigial,white,wide,x,yellow	'',.2,/3,0.2–0.4,0.3–0.4,0.3–0.6,0.4–0.8,0.5–1,0.6–0.8,0.6–1.4,0.75–4,0.9–1.7,0–,1.1-1.4,1.5–2.4,1.7–2.6,1/2,1/3,10–21,11–12,13–25,18,1–1.4,1–1.5,1–2,1–5,2,2-foliate,2.5–15,2–10,2–3.4,3,3.4–3.7,3.5–16,3–13,3–5-celled,3–7.5,3–8,40–80,4–10,4–15,5,5.2–9.2,5–15,5–8,62,7–16,8–12,8–14,8–15,9,=,``,absent,accrescent,adaxially,also,apical,average,axe,ba,bacca,capitat,cell,compressed,contiguou,curved,cylindrical,differing,dimorphic,directed,distall,divided,eaf,eed,enlarged,especially,fewer,filament,finely,fruiting,geminat,geminate,glabrou,gland,glaziou,half,linear,longest,lower,lutea,marginal,matura,maturing,merely,minute,n,narrowly,near,nflorescence,orolla,p,per,pore,rachi,recurved,ruit,slender,small,smaller,sparsely,stipitate,stout,surrounded,tal,tamen,tem,terete,time,triangular,unarmed,undulate,unit,usually,vary,visible,wing,ympodial,–1.6,–19	0-,0.2-0.4,0.3-0.4,0.3-0.6,0.4-0.8,0.5-1,0.6-0.8,0.6-1.4,0.75-4,1-1.5,1-2,1.7-2.6,11-12,13-25,2-10,2.5-15,3-13,3-5-celled,3-7.5,3-8,3.4-3.7,3.5-16,5-8,5.2-9.2,8-15,adhesion,arrangement,capitate,climate,colour,corolla,form,glabrous,glandular,growth,height,history,inflorescence,leaf,life,midpoint,na,number,ovary,perennial,plant,position,presence,reproduction,rugulose,seed,shape,staman,stipe,texture
391	wfo-0001028583	success	294	119	74	220	45	0.252	.0,.2,.5,.9,abaxially,acute,adnate,anther,ape,apex,base,blade,brown,calyx,capitate,chartaceous,cm,corolla,cuneate,densely,diameter,dry,erect,extra-axillary,flattened-reniform,fruit,glabrous,glandular,globose,green,hair,heterostylous,incurved,lateral,leaf,lobe,lobed,long,many,margin,mature,midpoint,mm,oblong,ovate,pedicel,peduncle,per,petiole,present,pubescence,pubescent,purple,ray,red-brown,reddish,rounded,short,shrub,simple,sinuate,somewhat,sparsely,stellate,stem,stigma,stipe,style,subacute,subcoriaceous,tube,vein,white,yellow	.6,0,0.01,0.06,0.08,0.13,0.2–0.6,0.3–0.6,0.4,0.4–0.6,0.6,0.6–0.9,0.6–1.0,0.6–1.3,0.6–2.2,0.8–1.2,0.8–1.4,0.8–1.5,0.9–1.3,0.9–1.5,1.0–1.2,1.0–2.1,1.1–7.7,1.2–1.9,1.4,1.4–1.5,1.4–1.9,1.4–4.7,1.5–2.4,1.5–3.1,1.8–2.3,1.9–2.6,1.9–3.2,1/2,1/3,1/3–1/2,2.0,2.2–3.1,2.3,2.3–6.8,2.5–2.9,2.6,2.6–3.7,2.6–4.8,2/3,3.1–4.0,3.2–6.2,3.5–3.8,4,4.3,4–8,5-merou,5.1–15.4,5.2,5.2–6.3,5.7,5–9,6.3,6.5–16.0,6.9–9.2,6–8,7.0–1.4,absent,adaxially,aequilateral,ag,alyx,anthesi,apart,apical,apparently,appearing,appressed,around,articulate,attenuate,axe,ba,bark,basal,based,bent,berry,borne,branch,branching,broad,bud,central,channeled,congested,craspedodromous,deciduous,deeply,deltate,deltoid,dentate,developed,difoliate,directed,distal,distinct,eaf,edge,eed,either,emerging,endocarp,evenly,exocarp,extending,ferruginous,fertile,filament,filiform,flexed,flower,free,geminate,glossy,gradually,gree,immature,immediately,increasing,individually,intact,internode,interpetalar,intersepalar,juic,lanceolate,large,layer,lightly,lon,longer,lower,major,midrib,midvein,minor,minute,moderately,narrowly,nearly,nflorescence,oblique,occasionally,opaque,orange,orolla,perforated,pitted,poorly,pore,porrect,porrect-stellate,portion,potentially,prickle,primary,raised,red,red-orang,reflexed,remaining,restricted,ridge,rigid,row,ruit,scattered,secondary,semicraspedodromous,sessile,several,shorter,shot,side,sinus,slightly,sloughing,spaced,splitting,spread,spreading,stamen,stellae,stellate-pubescent,stipitate,straight,surface,suture,tamen,tardily,tem,thin,time,tip,tissue,toward,transparent,triangular,truncate,two,ud,unarmed,unbranched,upper,vary,well,wide,yellow-ferruginous,ympodia,young,±90°,±equal,±erect,×	0.01-0.08,0.06-0.4,0.3-0.6,0.4-0.6,0.6-1.0,0.8-1.4,0.8-1.5,0.9-1.5,1.1-7.7,1.4-1.5,1.4-1.9,1.4-4.7,1.8-2.3,2.2-3.1,2.5-2.9,4-8,5.1-15.4,6-8,6.5-16.0,7.0-14.0,adhesion,arrangement,climate,colour,form,growth,height,history,inflorescence,juicy,length,life,na,number,ovary,perennial,plant,position,presence,reproduction,seed,shape,size,staman,texture
392	wfo-0001028587	success	178	95	61	117	34	0.343	.5,0.3-1,0.5,0.5-1,0.8-1.8,1-1.3,1-2,1-4,2-5,2.1-6.9,2.5,6-8,6.5-17.7,acuminate,acute,anther,apex,base,brown,calyx,cm,corolla,dia,fruit,geminate,glabrous,globose,green,greenish-white,leaf,length,lobe,lobed,long,minutely,mm,obovate,opposite,ovary,ovate,ovoid-reniform,papillose,pedicel,petiole,pitted,poricidal,puberulent,pubescence,pubesent,seed,shrub,stem,stigma,style,surface,tip,trichome,tube,uniseriate,white,x	.4,.75,0,0.3,0.7-1.2,0.8-1.6,0.8-2.9,1-1.5,1.3-5.1,1/4,3-8,8-10,8-10-flowered,abruptly,accrescent,across,anthesi,bark,baseflower,becoming,berry,ca,chartaceou,closely,coat,cracking,cup,deflexed,degree,densely,different,difoliate,distal,drying,eaf,edicel,eed,ellipsoid,erect,filament,flower,forming,free,fruiting,geminat,impressed,keeled,lamina,lateral,layer,like,lon,long-styled,lower,main,major,middle,midrib,minor,minute,narrowing,nearly,nflorescence,obe,obovoid,occasionally,often,older,open,outer,overlappin,pair,paler,papillo,peeling,per,persistent,pore,portion,pubescent,reflexed,ruit,scar,scattered,short,simple,slender,slightly,slit-like,spaced,sparsely,stiff,straight,straw-colored,subumbellate,tall,terminal,thickened,thin,transversel,triangular,two,type,ud,umbonate,unicellular,unit,upon,upper,usually,variable,vein,wide,widest,woody,ympodial,young	1,6,adhesion,arrangement,blade,climate,colour,diameter,form,glandular,growth,hair,height,history,inflorescence,life,margin,midpoint,na,number,peduncle,perennial,plant,position,presence,ray,reproduction,rugulose,shape,size,staman,stellate,stipe,texture
393	wfo-0001028594	success	142	98	64	78	34	0.451	.5,0.8-1.8,1-1.2,1-1.3,1-2,1.5-9,12,12-14,2,3-4,3-9,6-20,abaxially,acuminate,acute,anther,apex,axillary,base,black,bottle-shaped,calyx,cm,conical,corolla,densely,diameter,drying,elliptic,flattened-reniform,fruit,glabrous,globose,green,herb,immature,inflorescence,leaf,length,lobe,margin,maturity,minutely,mm,orange-brown,ovary,ovate,pedicel,petiole,planar,pubescent,purple,reddish,reflexed,slightly,smooth,somewhat,sparsely,stigma,style,surface,tube,violet,x	0-100,0.3-1.0,1-1.5,1-3,3-6,5-6,6-7,adaxially,along,anthesi,axil,bearing,becoming,berry,capitat,cell,climbing,denser,eaf,edicel,eed,ellipsoid,epidermal,especially,exserted,filament,floo,flower,forest,free,fruiting,glabrat,hair-like,inflorescenc,lax,like,lon,long,lower,minute,nflorescence,noddin,obtuse,often,open,pair,papillate,pendent,per,portion,primary,projection,quit,rectangular,regular,rest,rounded,ruit,scar,scattered,side,simple,soft,spreading,strait,strongly,tem,time,tip,trailing,trichome,tub,ud,unifoliat,uniseriate,unit,vein,ympodial	adhesion,arrangement,blade,capitate,climate,colour,form,glandular,growth,hair,height,history,life,midpoint,na,number,peduncle,perennial,plant,position,presence,pubescence,ray,reproduction,rugulose,seed,shape,size,staman,stellate,stem,stipe,texture,unifoliate
394	wfo-0001028660	success	204	116	84	120	32	0.412	0.5-2.8,0.5-5.5,0.8-1,0.9-2.5,1-2,1.5-2.8,1.5-4,1.5-7.6,2-9,3-30,3-7,3.8-13,4-6,5-8,7-10,abaxially,acute,adaxially,anther,apex,axillary,base,blade,blue,broadly,brownish,bud,chartaceous,ciliate,clavate,cm,condition,corolla,decurrent,densely,diameter,drying,elliptic,entirely,fresh,fruit,glabrous,globose,green,greenish,hair,herb,lanceolate,like,linear,lobe,margin,membranous,minutely,mm,narrowly,oblique,obtuse,odd-pinnate,ovoid,pedicel,peduncle,pentagonal,petiole,plant,puberulent,pubescent,purple,rotate,seed,size,sparsely,stem,stigma,style,substellate,subtending,terminal,tinged,tube,white,whitish,x,yellow	0-5,0.1-0.3,0.2-1.1,0.3-1.1,0.7-4.2,1-10,2-11,2-5,2-6,20,3-5,3-9,5-merou,6,absent,acumen,ag,along,alyx,apart,apparently,articulated,attenuate,axe,berry,borne,capitat,cell,connivent,covering,decumbent,digestion,distal,dorsally,dot,eaf,edge,eed,end,enzyme,erec,especially,exceeding,except,filament,flat,flower,folded,forked,geminat,generally,glabrou,greatly,green-white,hair-like,half,homostylous,honeycomb-shaped,interjected,lateral,leaflet,lengthening,less,living,long,lower,make,middl,midrib,mucilaginous,nflorescence,often,orbicular,orolla,ovate,pair,perfect,petiolulate,petiolule,plurifoliate,pore,poricidal,proximal,rarely,reduced,removed,ripe,ruit,scabrous,scattered,sessile,seudostipule,short,singly,slit,spaced,specimen,stamen,ste,stolo,straight,subequal,sunny,tall,tamen,tem,testal,thick,throughout,tip,tri-,tuber,typically,unit,unwinged,usually,vary,wall,wet,ympodial	adhesion,arrangement,calyx,capitate,climate,colour,form,glandular,growth,height,history,inflorescence,leaf,length,life,midpoint,na,number,ovary,perennial,position,presence,pubescence,ray,reproduction,rugulose,shape,staman,stellate,stipe,surface,texture
395	wfo-0001028666	success	159	104	74	85	30	0.465	0-0.1,0.25-0.4,0.3-0.45,0.3-0.6,0.4-0.8,0.7-0.8,0.8-2,1-1.5,2.2-2.3,2.5-7,3-4.5,4-5,4-5.5,5-11,7-8,abaxially,absent,acute,adaxially,anther,apex,base,blade,brown,calyx,chartaceous,cm,connivent,cordate,densely,diameter,ellipsoidal,entire,erect,extra-axillary,fruit,glabrous,gland-tipped,grey-green,hair,inflorescence,lanceolate,lavender,length,lobe,margin,midpoint,mm,moderately,obtuse,ovate,pale,pedicel,peduncle,perennial,petiole,pubescent,purple,ray,red,rhizomatous,short,shrub,simple,stellate,stellate-pubescent,stigma,style,succulent,tube,white,x,yellow,yellowish	%,0-2,0.05-0.1,0.1-0.15,0.2-0.25,0.2-0.3,1,1-2,1-locular,11-19,2.5-5,2.6-4.2,3-4,3-6,4-5-merou,7-11,7-9,absen,accrescent,across,adaxiall,alyx,apart,apparen,articulated,axe,ba,capitat,cylindrical,directed,distall,distributed,eaf,eed,eglandular,elliptic,exceeding,exocarp,finger,flower,fruiting,incomplete,juicy,lamina,lateral,long,lower,mature,mesocarp,minute,nflorescence,oblique,orolla,part,per,perfect,placenta,pore,porrect,prickle,pseudo-umbellate,ruit,scattered,septum,sessile,solitary,somewhat,spaced,stalk,stellae,tal,tamen,tem,thick,throughout,time,transparent,unarme,unarmed,unbranched,unit,unknow,vary,wide,ympodial	adhesion,arrangement,capitate,climate,colour,corolla,form,glandular,growth,height,history,leaf,life,na,number,ovary,plant,position,presence,present,pubescence,reproduction,seed,shape,size,staman,stem,stipe,texture,unknown
396	wfo-0001028667	success	129	91	57	72	34	0.442	-2.6,.5,0.4-0.7,0.7-4,1-1.5,1-4.5,1-6,1.3-2,3,3-11,acute,apex,axillary,base,calyx,cm,completely,coriaceous,corolla,creamy,diameter,dry,elliptic,entire,flattened,glabrous,growth,inflorescence,leaf,lobe,margin,minutely,mm,narrowly,pale,pedicel,peduncle,petiole,pitted,reniform,revolute,shiny,shoot,short,simple,stem,straw-colored,strongly,surface,terminal,tube,vine,white,woody,wrinkling,x,yellow	1-2-1.5,5,5-20,5-merou,8-10,aid,alyx,anthesi,apar,appearing,ark,around,articulated,berry,branch,branched,cell,climbin,climbing,clustered,conical,curling,deciduous,discolorous,eaf,eed,ellipsoid,exfoliatin,exfoliating,exserted,fide,flower,fragrant,fruiting,irregularly,like,long,lower,mentz,midrib,new,nflorescence,occasionally,older,orolla,other,outer,papilla,papillat,pendan,per,perfect,plurifoliat,primary,scar,sleeve,slender,slightly,small,soon,spaced,support,tem,tip,triangular,twice,twining,ud,unit,vein,visible,ympodial	adhesion,anther,arrangement,blade,climate,colour,form,fruit,glandular,hair,height,history,length,life,midpoint,na,number,ovary,plant,position,presence,pubescence,ray,reproduction,rugulose,seed,shape,size,staman,stellate,stigma,stipe,style,texture
397	wfo-0001028672	success	207	118	94	113	24	0.454	.5,0-13,0.2,0.2-0.4,0.3-1,0.5-0.7,0.5-1,0.7-3,0.8-1,1,1.3-8,1.5-3,1.8-2.2,1.8-2.5,1/4,1/4-1/3,2.4-2.8,2.5-12,2.5-3.5,5-10,5-8,6-12,abaxially,acute,almost,ame,anther,apex,base,berry,black,blade,branched,broad,c.,calyx,chartaceous,cm,connivent,cream,dark,diameter,elongated,equal,erect,flattened-reniform,fruit,glabrescent,glabrous,green,lateral,leaf,length,lobed,long,lower,margin,marking,maturity,mauve,midpoint,mm,moderately,obtuse,orange-brown,ovate,pale,pedicel,peduncle,petiole,plant,poricidal,ray,rotate,rounded,shrub,simple,sometimes,sparsely,spherical,stellate-pubescent,stem,straight,style,surface,tapering,terminal,tip,truncate,tube,upper,wide,yellow,young	-6,-merous,/4,0,0-15,0-150,0-5,0.2-0.7,0.5-1.2,0.5-5,1-2,1-3,1.5-2.2,1/,2-10,2-20,2-3,2-30,3-5,3-8,4-6,4-8,5,9-15,acut,adaxially,alyx,andromonoecious,apar,apart,apically,apparently,articulated,bark,broad-deltate,brow,concolorous,deltate,difoliate,discolorous,distal,distance,drying,eaf,eed,elongating,extending,filament,flattened,flower,free,fruiting,geminat,gray,hair,hermaphrodite,heterostylous,infructescence,lobe,long-styled,longer,lowermost,mature,midvein,minute,nflorescence,older,one,open,orolla,oung,pair,pendulous,per,pericarp,porrect,portion,prickl,prickle,prickly,primary,reflexed,ruit,scar,sessile,short-styled,side,smooth,spaced,spreading,stalk,stalked,staminat,tamen,terete,tertiary,time,translucent,trichome,unarmed,unit,usually,variously,vary,vein,venation,visible,way,weakly,woody,yellow-green,yellow-orange,ympodial	1/2,adhesion,arrangement,climate,colour,corolla,form,growth,height,inflorescence,number,ovary,position,presence,pubescence,seed,shape,size,staman,stellate,stigma,stipe,texture,ye
398	wfo-0001028674	success	196	128	102	94	26	0.52	0.1,0.7-1,1-1.5,1-2,1-3,1.5-3,10-15,2-2.5,2-3,2-5.5,2.5-3,3-10,3-11,3-3.5,3-4-lobed,4-4.2,4-5,5-7,abaxially,acuminate,acute,adaxially,angulate,anther,apex,apiculate,attenuate,base,berry,blade,brown,c.,calyx,chartaceous,cm,coriaceous,corolla,densely,diameter,elliptic,entire,flattened,flower,fruit,glabrescent,glabrous,glandular,glandular-pubescent,globose,green,greenish,growth,heterostylous,hirsute,leaf,leaf-opposed,lenticular,like,lobe,lobed,margin,maturing,midpoint,mm,mucilaginous,ovary,pedicel,peduncle,perfect,petiole,plant,poricidal,porrect,ray,reddish,reniform,rounded,rusty,scattered,shrub,simple,sparsely,stellate,stem,stigma,style,subcapitate,subglobose,surface,tapering,terete,tip,tomentose,trichome,tube,variegated,way,white,woody,x,yellow,young	-1,0.2-0.25,0.2-0.3,0.5-0.7,0.5-0.8,0.7-1.0,1/3,1/4,10-30,5-6,8-10,adaxial,armed,articulate,bark,basal,branched,branching,brow,caly,campanulate,confined,conical,cream,curved,dark,directed,distal,distally,eaf,eed,eglandular,erec,erect,especially,exserted,face,fewer,filament,free,fruiting,glandular-puberulent,juvenile,larger,lateral,laterally,leave,lengthening,linear-lanceolate,long-styled,lower,minute,much,new,nflorescence,ochraceous,older,one,partially,pericarp,plurifoliat,pore,portion,prickle,prickly,pubescent,raise,recurved,reduced,reticulate,ruit,scar,sessile,shallowly,short-styled,similar,slightly,staminate,stellate-pubescent,stellate-tomentose,straight,subsessile,testa,thick,time,triangular-lanceolate,ud,unarmed,unicellular,unit,upper,whitish,yellowish,ympodial	adhesion,arrangement,climate,colour,form,hair,height,history,inflorescence,length,life,na,number,perennial,position,presence,present,pubescence,reproduction,rugulose,seed,shape,size,staman,stipe,texture
399	wfo-0001028680	success	236	124	92	144	32	0.39	.0,.2,.3,.5,.8,0.2–0.3,0.3–2.1,0.5–0.8,0.5–2.3,1,1.1–6.5,1.4–1.8,1.7–2.1,1.9–2.4,2.2–2.5,3.8–4.6,6–8,abaxially,acuminate,adnate,aequilateral,anther,apex,appearing,attachment,attenuate,base,blade,brown,calyx,cm,coriaceous,corolla,diameter,dry,elliptic,entire,extra-axillary,fast,flattened-orbicular,flattened-reniform,fruit,glabrous,glandular,globose,growth,hair,lanceolate,lateral,lobe,margin,markedly,mature,midpoint,mm,notched,obtuse,occasionally,ovate,pedicel,petiole,point,pubescent,ray,reddish,revolute,rounded,shoot,short,shortly,shrub,simple,sinuate,slightly,sometimes,sparsely,stellate,stem,stigma,style,sub-cordate,surface,terminal,toward,tube,typically,white,yellow,yellow-tan,±straight,×,–1.75	0.4,0.9,0.9–1.0,0.9–1.2,1.1,1.2,1.2–2.2,1.6–2.5,1.7–2.2,1/2,1/3,1/4–1/3,1–2,2.1–3.0,2.2–3.0,2–3,3.2–3.5,4.3–5.9,4–5,4–5-merou,5.2–7.2,?,adaxially,ag,alyx,anthesi,apical,apiculate,apparently,appresse,around,articulate,ba,bark,based,berry,borne,broad,brochidodromous,capitat,channeled,connivent,deltoid,dentate,developed,development,directed,distal,distally,distinct,eaf,edge,eed,either,emerging,endocarp,exocarp,extending,fertile,filament,filiform,flexed,flower,free,glossy,gradually,homostylous,hort,increasing,individually,intact,internode,interpetalar,intersepalar,isolated,juic,layer,limp,lon,long,longer,lower,many,middle,midrib,midvein,minute,nearly,nflorescence,opaque,orolla,per,perforated,pitted,plurifoliate,poorly,pore,porrect,portion,potentially,presen,prickle,rachi,raised,remaining,retrorse,ruit,scattered,see,sessile,shorter,side,sinus,sloughing,splitting,spread,stamen,stellae,straight,suture,tamen,tem,thin,time,tip,tissue,transparent,truncate,ud,unarmed,unbranched,vary,vein,weakly,wide,yellow-ferruginou,ympodia,young,±90°,±absent,±equal,±glabrous,–3,–6	.1,adhesion,arrangement,capitate,climate,colour,form,height,history,inflorescence,leaf,length,life,na,number,ovary,peduncle,perennial,plant,position,presence,present,pubescence,reproduction,rugulose,seed,shape,size,staman,stipe,texture,unknown
400	wfo-0001028688	success	137	76	48	89	28	0.35	.5,0.4-1,0.5,0.5-0.75,0.9-1,1-5,1.1-1.2,1.4-2.8,2-3,5-11,5-6,anther,base,beneath,calyx,cm,corolla,curl-tipped,glabrous,golden,lanceolate,leaf,lobed,mm,near,nearly,opposite,ovary,overtopping,papillose,pedicel,petiole,pilose,reddish-brown,shaped,shoot,shrub,size,stem,stigma,style,tear-drop,tip,trichome,tube,uniseriate,white,x	0.5-1,0.5-1.5,1-1.5,1-1.8,1-3,2.2-4.8,across,acuminate,acute,along,anthesi,apar,apex,area,bark,bi-cellular,branch,clavate,deciduous,decreasing,deflexed,deltoid,densely,densest,dia,differing,difoliate,eaf,edicel,eed,elliptic,exfoliatin,exserted,filament,free,furcate,geminat,globose,interpetalar,irregularly,know,known,like,lobe,lon,long,lower,major,markedly,membraneous,middle,minor,minutely,nflorescence,occasionally,often,older,paler,planar,pore,poricidal,portion,proximal,pubescent,ruit,scar,shiny,sinus,slender,slightly,soon,spaced,sparsely,straight,styl,tall,tapering,terminal,thickened,thin,tub,ud,unit,usually,vein,wide,widest,ympodial,young	adhesion,alternate,arrangement,colour,diameter,form,fruit,growth,height,history,inflorescence,length,life,na,peduncle,perennial,plant,position,presence,pubescence,reproduction,rugulose,seed,shape,staman,stellate,surface,texture
401	wfo-0001028690	success	191	116	88	103	28	0.461	0-0.2,0-0.5,0.15-0.25,0.3-0.5,0.3-2.5,0.5-0.8,0.5-1,0.8-1,0.8-2,1-5,1.3-6.5,1.5-1.7,2.3-2.8,3-4.5,4-10,4-9,4.5-16.5,6-8,7-10,8-9,abaxially,absent,acute,adaxially,andromonoecious,anther,apex,articulated,base,blade,calyx,chartaceous,cm,connivent,cuneate,densely,diameter,entire,erect,extra-axillary,flower,fruit,glabrous,gland-tipped,globose,green,hair,inflorescence,lanceolate,lateral,leaf,length,lobe,lobed,long,margin,mid-point,midpoint,mm,moderately,obtuse,ovate,pale,pedicel,peduncle,perennial,petiole,plant,present,purple,ray,rhizomatous,shallowly,short,shrub,simple,sparsely,stellate,stellate-pubescent,stigma,style,thick,time,tube,weakly,white,x,yellow	%,.3,0-0.1,0-5,0-7,0.05-0.1,0.1-0.2,0.2-0.6,0.25-0.4,0.3-0.7,0.4-0.6,0.5-6,1-2,1-7,2-3,2-7,2-locular,2.1-4.5,30-50,4-5.5.5,4-7,5-6,5-merou,5.5-6,7-30,7-8,9-13,9.5-14,absen,accrescent,across,adaxiall,adult,alyx,apart,ascending,attenuate,axe,ba,branch,branche,broad-based,capitat,cross-section,cylindrical,directed,distall,distributed,dm,eaf,eed,eglandular,exocarp,finger,fruiting,functional,geminat,grey-green,half,heterostylous,juicy,juvenile,lamina,less,linea,longer,lower,mature,mesocarp,minute,moist,nflorescence,oblique,orolla,pair,part,per,placenta,pore,porrect,prickle,pseudo-racemose,pseudo-umbellate,ruit,sessile,somewhat,spaced,stalk,stellae,straight,surface,tal,tamen,tem,throughout,unarme,unarmed,unbranched,unit,upper,vary,wide,ympodial	4-5.5,adhesion,arrangement,capitate,climate,colour,corolla,form,glandular,growth,height,history,life,linear,na,number,ovary,position,presence,pubescence,reproduction,seed,shape,size,staman,stem,stipe,texture
402	wfo-0001028696	success	224	138	93	131	45	0.415	.5,2.4,5,abaxially,acuminate,adaxially,anther,anthesi,apex,asymmetric,attenuate,base,blade,blue,broadly,calyx,cm,coarsely,color,connivent,cordate,densely,diameter,entire,finely,flower,fruit,glabrous,gland-tipped,glandular,globose,hair,hirsute,intermixed,known,lateral,lavender,length,lenticular,lobe,lobed,long,margin,mature,midpoint,mm,narrowly,oblong,obtuse,occasionally,often,orange,ovate,overtopped,ovoid,pedicel,peduncle,petiole,pilose,pitted,plump,prickle,pubescence,pubescent,ray,reflexed,reniform,repand,rotate-pentagonal,shiny,shrub,simple,sinuate,small,soon,stellate,stellate-pilose,stellate-pubescent,stem,stigma,style,subterminal,surface,tan,trichome,truncate,tube,weakly,well,widely,yellow,young,×	0.8–,1.5–4,12–20,15–17,15–30,1–2,1–4,1–6,2.5,2.8–3.5,2–2.3,2–5,2–7,3.5–5.5,3–5,3–6.5,4–5,4–7,5-merou,5–15,6–13,6–8,7–8,7–9,8–13,8–20,9–10,9–12,accrescent,acicular,adaxiall,along,alyx,ample,apart,apparently,armed,articulated,ascending,axe,ba,bifi,borne,branch,branched,bristle,bristle-like,bristly,chartaceous,deltoid,density,developed,difoliate,directed,distally,diverse,drie,eaf,eed,elongate,erect,filament,fruiting,geminat,glabrou,gland,homostylous,intergrading,internode,interpetalar,lamina,larger,like,linear-caudate,linear-lanceolate,lon,long-stipitate,longitudinally,lower,middle,midvein,midzone,moderately,near,nflorescence,numerous,one,orolla,per,perfect,pericarp,pore,prickly,principal,prominent,resembling,ruit,scattered,sessile,several-celled,short,short-,shorter,side,slender,slightly,smaller,sometimes,somewhat,spaced,sparser,splitting,spreading,stalked,stellae,stellate-hirsute,tall,tamen,tem,tippe,tipped,tissue,toothed,ud,ultimate,vary,varying,vein,wide,woolly,ympodia	1-2,1-6,1.5-4,12-20,2-2.3,2.8-3.5,3.5-5.5,4-7,5-15,6-13,6-8,7-8,8-13,8-20,9-10,9-12,adhesion,arrangement,bifid,climate,colour,corolla,form,growth,height,history,inflorescence,leaf,life,na,number,ovary,perennial,plant,position,presence,present,reproduction,rugulose,seed,shape,size,staman,stipe,texture
403	wfo-0001028698	success	166	74	54	112	20	0.325	0.3-0.75,1-2,1-9.8,1.9-4,13-25,2-10,3-5,5-6,5-8,6-27,8-10,9-35,broadly,calyx,cm,conical,connate,corolla,dark,diameter,distal,ellipsoid,elliptical,green,green-white,half,herbaceous,leaf,light,long,medium,mm,odd-pinnate,ovate,ovoid,pedicel,peduncle,pentagonal,perennial,petiole,plant,puberulent,pubescent,rotate,seed,size,stigma,strigose,style,throughout,violet,white,wide,yellow	0-1.,1-4,1.8-5,2-3,2-4,3-17,3-6-foliat,3.5,4-14,5-15,6,6-13,abaxiall,abaxially,acumen,acuminate,acute,adaxially,apex,apical,apically,articulate,base,branched,cell,commonly,covering,cuneate,cyme,darker,decurrent,dehiscent,dichasial,dichasially,digestion,diminishing,dorsally,dot,eaf,ebracteate,edge,eed,emoval,enzyme,equal,exceeding,filament,first,flat,flower,folded,forked,generally,globo,gradually,hair-like,honeycomb,interjected,introrse,lateral,leaflet,living,lobe,lon,long-attenuate,lower,lunat,make,maturing,minute,monochasial,mucilaginous,nflorescence,nther,oblique,often,orolla,pair,pattern,perfect,petiolule,plan,poricidally,proximal,rachi,raised,rarely,reveal,ruit,sessile,seudostipule,short,slit,smooth,specimen,stamen,straight,tal,tem,terminal,testal,thick,toward,tuber-bearing,two,typically,unit,usually,vary,wall,ympodial,¼	anther,arrangement,colour,form,fruit,globose,growth,height,history,inflorescence,length,life,na,ovary,position,pubescence,reproduction,shape,stem,texture
404	wfo-0001028716	success	145	83	44	101	39	0.303	0.6-1.9,0.75,1-2,11-16.4,2.5-8,3.6-8.8,7-8,8-9,acuminate,anther,apex,base,brown,calyx,cm,corolla,cuneate,dark,fruit,glabrous,glandular,hirsute,leaf,lobe,lobed,minutely,mm,opposite,ovary,ovate,papillose,pedicel,petiole,poricidal,shape,shrub,size,stem,style,tip,truncate,tube,white,x	.2,.5,0.5,1.9-5.5,10-40-flowered,2-4,2.2-7.9,5-6,9-10,across,anisophyllou,anthesi,apart,appearing,asymmetric,ba,bark,becoming,beginning,beneath,bi-cellular,branched,decurrent,deflexed,dia,differing,difoliate,eaf,edicel,eed,ellipsoid,elliptic,evenly,except,fertilization,fifth,filament,filiform,free,geminate,inflorescenc,intermediate,know,known,lateral,lengthening,lenticellat,less,like,lon,long,long-triangular,lower,main,major,markedly,middle,minor,much,nearly,nflorescence,node,often,older,one,orbicular,pair,pointed,pore,portion,prominent,proximal,puberulent,pubescent,raised,reflexed,remaining,rounded,ruit,scar,shaped,simple,slightly,spaced,sparsely,stigm,straight,strongly,tall,tear-drop,triangular,trichome,two,ud,uniseriate,unit,vein,widening,widest,ympodial,young	0.2,1,1.5,2,3,adhesion,arrangement,blade,climate,colour,diameter,form,growth,hair,height,history,inflorescence,length,life,margin,midpoint,na,number,peduncle,perennial,plant,position,presence,pubescence,ray,reproduction,rugulose,seed,staman,stellate,stigma,stipe,surface,texture
405	wfo-0001028723	success	211	113	82	129	31	0.389	-1.5,.5,0.8-1,0.8-2,1-1.8,1-2.2,1-2.5,1/5-1/3,2-2.5,2-2.7,2-4,3.5-4,4-5,5,5-7,acute,almost,another,anther,anthesi,apex,apparently,base,brachyblast,branch,broadly,calyx,capitate,clearly,clustered,cm,conical,corolla,dark,dendritic,diameter,drying,elliptic,entire,except,free,glabrous,leaf,length,liana,lobe,lobed,long,long-attenuate,margin,membranous,middle,mm,oblong,obovate,occasional,one,orange-brown,pedicel,peduncle,petiole,pubescent,ray,separated,short,shrub,side,simple,slender,small,stem,stigma,style,surface,terminal,tip,trichome,tube,unevenly,white,wrinkled,x	.3,0-0.5,0.2,0°,1,1-1.5,1/3-1/2,10-15,10-16,2.5,3-4,4,5-6,abaxial,abaxially,adaxially,age,alternate,alyx,apar,apically,apice,articulated,bark,becoming,branched,branching,brown,common,concolorous,curved,decurrent,delineated,deltoid,densely,density,developed,dilated,divided,domatia,dorsifixed,eaf,eed,ellipsoi,equal,ey,faint,filament,fine,flat,flexuous,flower,formed,frequent,gradual,green,increasing,inner,junction,know,known,lengthening,less,like,longitudinally,lower,m.,main,midvein,minutely,mostly,much,multiply,naked,narrowly,nflorescence,nther,obconical,obtuse,orolla,outer,ovate,overlapping,pair,pale,papillo,perfec,plurifoliat,poorly,pore,poricidal,portion,primary,prominent,protruding,rachi,raised,region,regular,ridged,ruit,scar,sinus,smaller,smooth,sparsely,spreading,stump,surrounding,tearing,tertiary,tissu,toward,transition,tuft,ud,unarmed,uneven,unit,vary,vein,venation,visible,wide,widely,yellow,ympodial,young,youngest	adhesion,arrangement,blade,climate,colour,form,fruit,glandular,growth,hair,height,inflorescence,midpoint,na,number,ovary,perfect,plant,position,presence,present,pubescence,reproduction,rugulose,seed,shape,size,staman,stellate,stipe,texture
406	wfo-0001028725	success	197	104	78	119	26	0.396	-10,0.1-0.2,0.6-1,1.5-1.7,1.5-2,1.5-4,10-12,2.5-3,2.5-8,3-4,3-6,4-12,7-8,acute,anther,apex,base,berry,brown,calyx,chartaceous,clavate-truncate,cm,connate,cordate,corolla,densely,depressed,diameter,elliptic-ovate,entire,flattened,glabrous,glandular,glandular-tomentose,glandular-villose,globose,green,growth,inflorescence,internodal,lanceolate-subulate,leaf,leathery,lobe,margin,midpoint,mm,moderately,oblique,ovary,ovate,pedicel,peduncle,petiole,pubescence,pubescent,ray,reniform,repand-angular,rounded,rusty,rusty-tomentose,shrub,simple,size,slender,stellate,stem,stigma,style,surface,terete,terminal,tomentose,tube,violet,x	.1,0.2-0.5,0.3-0.4,1-1.5,1-2,1.2-1.5,1/4,2,3-plurifoliat,4-5,4-6-celled,4-locular,5-10,7,abaxially,acicular,adaxially,anthesi,armed,articulated,bark,basal,bud,clearly,closely,curved,denser,discolorous,distal,eaf,eed,eglandular,elongate,enlarged,exserted,filament,finely,flower,free,fruiting,glabrescent,gland-tipped,glandular-pubescent,greatly,greyish,heterostylous,inconspicuous,lengthening,like,linear-lanceolate,lobed,long,long-styled,longer,lower,midrib,minute,minutely,mixed,multicellular,nearly,new,nflorescence,obverse,older,papillo,perfect,pericarp,persistently,pore,poricidal,porrect,portion,prickle,prickly,recurved,reduced,reflexe,reflexed,rest,reticulate,ruit,rusty-brown,scar,sessile,short-styled,short-talked,similar,slightly,slit,small,somewhat,space,sparsely,stalked,staminate,stellate-tomentose,straight,strongly,tall,tapering,testa,tip,trichome,turbinate,ud,unarmed,undulate,unevenly,unit,upper,varying,vein,velutinous,viscid,whit,yellow,yellowish,ympodial	adhesion,arrangement,blade,climate,colour,dense,form,fruit,hair,height,history,length,life,na,number,plant,position,presence,reproduction,rugulose,seed,shape,staman,stipe,texture,ye
407	wfo-0001028736	success	180	120	92	88	28	0.511	0.2-0.4,0.5,0.5-1,0.5-1.5,1,1-1.5,1-2,1-3,1.5,10-15,2-5,2-7,3-5,3.5-5,4-12,4-6,5-10,6-13x3-8,6-8,abaxially,absent,acute,adaxially,anther,apex,attenuate,base,blade,brown,calyx,chartaceous,cm,connivent,cylindrical,densely,diameter,either,extra-axillary,flower,fruit,glabrous,glandular,globose,green,hair,immature,leaf,length,like,lobe,lobed,long,mature,midpoint,mm,moderately,mottled,multicellular,nearly,obtuse,occasionally,orange,pedicel,peduncle,per,petiole,porrect-stellate,pubescent,purple,ray,red,reniform,rhombic,shrub,side,simple,sparsely,stalk,stellate,stem,stigma,style,surface,tapering,tube,unarmed,uniseriate,unlobed,white,x,yellow,yellow-white	0.5-1mm,0.5-2,1.5-3,1/6,2-4,3-6,3-8,4-9,40-70,5-15,5-merou,accrescent,adaxiall,alyx,apar,apical,apparently,armed,axe,berry,beyond,contiguous,cordate,created,cut,dark,decurrent,difoliate,directed,discolorous,eaf,eed,exserted,filament,filiform,flattened,frui,fruiting,geminate,glabrou,gree,introsel,less,light,lower,m.,major,many,midrib,midvein,multiseriate,narrowly,netlike,nflorescence,occasional,onto,orolla,pair,perfect,pit,pore,prickle,rachi,raised,recurved,ridge,roselike,ruit,scanden,sinus,slightly,small,spaced,stamen,ste,tamen,tem,thin-skinned,triangular,unbranched,unequa,unicellular,unit,vary,vein,way,wide,ympodial	adhesion,arrangement,climate,colour,corolla,form,growth,height,history,inflorescence,life,margin,na,number,ovary,plant,position,presence,present,pubescence,reproduction,rugulose,seed,shape,size,staman,stipe,texture
408	wfo-0001028737	success	151	87	53	98	34	0.351	0.2-0.5,1,1-6,1.5-3.5,12-14,16-30,2-5,2.8-3.5,4-9,6,7-15,acuminate,acute,apex,apiculate,base,calyx,caudate,cm,connate,corolla,diameter,distal,elliptic-lanceolate,glabrescent,glandular,globose,green,green-white,half,herbaceous,lanceolate,leaf,lobe,long,mm,oblique,oblong,odd-pinnate,ovoid,pedicel,peduncle,perennial,petiole,plant,seed,size,stellate,stigma,style,throughout,wide,yellow	0.7-2,1-2.5,1-4,10,2-3,3-4,3-5,3-6-foliat,4-10,4-6.5,5-6,abaxially,absen,acumen,adaxially,apical,apically,articulate,attenuate,branched,cell,covering,cyme,decurrent,dehiscent,dichasial,dichasially,digestion,diminishing,dorsally,eaf,ebracteate,edge,eed,emoval,enzyme,exceeding,filament,flat,flower,folded,forked,generally,globo,gradually,hair-like,honeycomb,interjected,introrse,larger,lateral,leaflet,living,lon,lower,make,maturing,monochasial,mucilaginous,nflorescence,nther,often,orolla,pair,pattern,perfect,pinnatifi,plan,poricidally,proximal,rachi,reveal,ruit,second,sessile,seudostipule,short,slit,specimen,stamen,straight,strongly,tal,tem,terminal,testal,thick,throughou,toward,tuber-bearing,typically,unit,vary,wall,whit,without,ympodial,¼	adhesion,anther,arrangement,blade,climate,colour,form,fruit,growth,hair,height,history,inflorescence,length,life,margin,midpoint,na,number,ovary,position,presence,pubescence,ray,reproduction,rugulose,shape,staman,stem,stipe,surface,texture,tube,white
409	wfo-0001028773	success	169	104	75	94	29	0.444	0-0.2,0.15-0.3,0.15-0.35,0.4-0.5,0.5-0.58,0.8-0.9,0.9-2.8,1-3,1-4.3,2-6,2.2-2.8,3-4.5,4-6.5,4-7,5-6.5,7-9,abaxially,absent,adaxially,anther,apex,base,blade,broadly,brown,calyx,chartaceous,cm,cordate,densely,diameter,entire,erect,extra-axillary,flower,fruit,glabrous,gland-tipped,glandular,globose,green,greenish-white,grey,hair,inflorescence,leaf,length,lilac,lobe,long,margin,midpoint,mm,obtuse,ovate,pale,pedicel,peduncle,perennial,petiole,ray,red,rhizomatous,rotate,rotate-stellate,rusty,short,shrub,simple,stellate-pubescent,style,tube,white,x,yellow	%,.7,0-1,0.1-0.2,0.15-0.25,0.3-0.4,0.3-0.5,0.3-0.6,1-2,1-locular,1.4-2,10-16,2,2-5,2-foliate,3-5,3.3-3.8,30-55,4.5-5.5,5-merou,6-11,7-8,absen,accrescent,across,adaxiall,adult,alyx,apart,apparen,articulated,axe,ba,directed,distall,distributed,eaf,eed,eglandular,elliptic,exceeding,exocarp,finger,fruiting,geminate,homostylous,incomplete,juicy,juvenile,lamina,lateral,lobed,lower,mature,mesocarp,minute,nflorescence,oblique,onl,orolla,pair,part,per,perfect,placenta,pore,porrect,prickle,probably,pseudo-racemose,ruit,septum,sessile,shallowly,solitary,spaced,stellae,succulent,surface,tal,tamen,tem,thick,throughout,time,unarme,unarmed,unbranched,unit,upper,vary,wide,without,ympodial	0-16,adhesion,arrangement,climate,colour,corolla,form,growth,height,history,life,na,number,ovary,plant,position,presence,present,pubescence,reproduction,seed,shape,size,staman,stellate,stem,stigma,stipe,texture
410	wfo-0001028774	success	141	78	43	98	35	0.305	0.4-0.7,1.4-1.8,1/2-2/3,10-20,2.5-3.5,2.5-4.0,2.7-3.3,3-8,4-8,5-9,9-12,anther,arcuate,blade,bright,broadly,calyx,chocolate-brown,cm,dm,dry,erect,glabrous,grayish-green,hetermorphic,internodal,lenticular,long,mm,ovate,pentagonal-stellate,perennial,petiole,spherical,splitting,spreading,stellate,stellate-pubescent,stem,surface,tube,velvety-farinaceous,yellow	0.5-0.8,12-20-rayed,3-5,3-7,30-60,6-10-flowere,8-12,accrescent,acro,almost,along,alyx,annually,anthesi,appearance,armed,base,beneath,berry,broad,campanulate,closely,deeply,density,developing,dia,difoliate,distinctive,divided,eaf,eed,elongate,emerging,extended,externally,fine,foveolate,fully,geminat,giving,hair,herb,herbage,invested,irregular,least,lengt,linear-lanceolate,lobe,lon,lowermost,margin,maturity,merely,midvein,minutely,nflorescence,numerous,often,orolla,otherwise,per,pinnatifid,prickle,prickly,rounded,ruit,scattered,separated,short,short-stipitate,slende,smooth,somewhat,spaced,stellate-woolly,stout,straight,strait-yellow,surrounding,tall,tamen,thick,tightly,tigma,tub,tyle,unarmed,undulate,unexpande,unit,vary,varying,vestiture,weakly,woody,ympodial,zygomorphic	12-20,adhesion,arrangement,colour,corolla,diameter,form,fruit,growth,height,history,inflorescence,leaf,length,life,na,number,ovary,plant,position,presence,pubescence,ray,reproduction,rugulose,seed,shape,size,slender,staman,stigma,style,texture,unexpanded,ye
411	wfo-0001028777	success	205	120	91	114	29	0.444	-12,-2.5,-4,0-2,0.1-0.3,0.4-0.8,0.5-1.3,0.6-1,0.7-1.2,0.8-2.2,1-2.5,1.5-3,1.5-4,1.8-2.5,2.5,2.5-5,3/4-4/5,4.5-8,8,8-15,abaxially,anther,apex,attenuate,base,berry,blade,calyx,chartaceous,cm,connivent,dark,diameter,entire,equal,flattened-reniform,fruit,glabrescent,glabrous,green,inflorescence,leaf,length,lobe,lobed,long,margin,marking,maturity,mauve,midpoint,minute,mm,moderately,obovate,orange,orange-brown,ovate,pale,pedicel,peduncle,petiole,poricidal,present,ray,red-brown,reflexed,retuse,rounded,shoot,short,shrub,simple,small,sometimes,spherical,stellate,stellate-pubescent,stem,style,tapering,terminal,tip,tree,trichome,truncate,tube,way,white,wide,young	-10,-3,.5,.8,.9,0-30,0.1-0.2,0.2,0.7-1.3,0.8-1,1,1-2,1-3,1.5,1/4,1/4-1/2,2-,2.5-3,3,3.5-5,4-5-merous,6-10,7-11,acuminat,acute,alyx,ame,apar,ape,apically,articulated,bark,branched,briefly,c.,concolorous,curved,deciduou,deltate,discolorous,drying,eaf,eed,elongating,erect,faint,filament,flower,free,fruiting,glabrescen,green-brown,infructescence,lengt,less,long-styled,longer,lower,mature,multangulate,narrow-deltate,nflorescence,occasionally,older,one,open,orolla,oung,pair,per,perfect,pericarp,plurifoliat,porrect,portion,primary,recurved,reflexe,ruit,scar,sessile,short-styled,shorte,shorter,smooth,somewhat,soon,spaced,sparsely,spreading,stalk,stalked,staminate,stout,strongly,surface,tamen,terete,tertiary,time,unarme,unarmed,unit,usually,variously,vary,vein,venation,visible,whole,wider,woody,yellow-green,ympodial	2.9,adhesion,arrangement,climate,colour,corolla,form,glandular,growth,hair,height,history,life,na,number,ovary,perennial,plant,position,presence,pubescence,reproduction,seed,shape,size,staman,stigma,stipe,texture
412	wfo-0001028788	success	189	112	85	104	27	0.45	0-0.3,0.15-0.4,0.2-0.4,0.4-1.3,0.5-1,0.6-1.2,0.7-1.8,1-10,1-2,1.1-2.3,1.4-1.6,2-3,2.5-3.5,2.5-4.5,2.5-8.5,3-10,4.5-6.5,5-15,6-8,8-10,8-11,acute,adaxially,andromonoecious,anther,apex,base,black,blade,brown,calyx,chartaceous,cm,cordate,dark,densely,diameter,entire,erect,extra-axillary,flower,fruit,globose,green,grey,grey-green,hair,inflorescence,juicy,lanceolate,length,lilac,lobe,long,margin,mid-point,midpoint,mm,moist,obtuse,ovate,pale,pedicel,peduncle,perennial,petiole,plant,present,purple,ray,rhizomatous,rusty,shrub,simple,stellate,stellate-pubescent,stem,streak,style,thick,throughout,tube,x,yellow,yellowish-green	%,0-0.4,0-10,0-3.5,0.05-0.1,0.1-0.4,0.3-0.5,0.7-1.3,0.7-1.4,0.8-1.1,0.8-1.5,0.8=2.5,1,1-1.5,10-14,10-20,2-5,2.3-3.6,4-locular,5-merou,6-10,6-14,7-10,7-9,abaxially,absen,absent,acicular,across,adaxiall,alyx,anvil-shape,apart,articulated,ascending,attenuate,axe,ba,broad-based,cross-section,cylindrical,decimetr,directed,distall,distally,distributed,dult,eaf,eed,eglandular,exocarp,finger,fruiting,functional,gland-tipped,half,heterostylous,hig,lamina,lateral,less,longer,lower,markedly,mature,mesocarp,minute,multiradiate,nflorescence,oblique,onl,orolla,part,per,placenta,pore,porrect,prickle,pseudo-racemose,rostrate,ruit,sessile,short,spaced,stage,stalk,stalked,stellae,straight,tamen,thicker,time,unarme,unarmed,unbranched,unit,unknow,uvenile,vary,weakly,white,wide,yellowish,ympodial	0.8-2.5,adhesion,arrangement,climate,colour,corolla,form,glandular,growth,height,history,leaf,life,na,number,ovary,position,presence,pubescence,reproduction,seed,shape,size,staman,stigma,stipe,texture
413	wfo-0001028791	success	257	105	78	179	27	0.304	+,0.3-0.4,0.3-0.6,0.4-0.65,0.45-0.55,0.5,0.8-1,0.8-1.3,1-1.5,1-3-celled,1.5-2,1.7-2.1,1.8-3.3,10,2-7,2.8-3.0,5-15,5-22,50-80,9-30,9-35,acute,anther,apex,base,broadly,brown,calyx,capitate,cm,conical,corolla,densely,diameter,elliptic,entire,free,fruit,glabrous,glandular,globose,green,imparipinnate,interrupted,leaf,less,liana,lobe,long,margin,mm,oblique,obovate,ovary,pale,pedicel,peduncle,petiole,plant,present,pubescence,pubescent,seed,somewhat,sparsely,stellate,stem,stigma,style,surface,trichome,truncate,tube,vine,white,wide,woody,yellow	-0.6,-1.5,-9,.5,0-6,0.05,0.05-0.2,0.2-0.3,0.2-0.4,0.2-0.8,0.25-0.3,0.3-0.5,0.3-0.8,0.4-0.5,0.4-0.6,0.4-1.1,0.6-0.8,0.6-0.9,0.7-1.5,1-2,1-2-celled,1-3,1-celled,1.5-,1.6-4.5,100,2-3,2-3.5,2-7-celled,2-locular,2.5-4.5,20-to,3-,3-4,4-11.5,4-15,4-5+,4-celled,5-,5-10,5-plurifoliate,8-10-celled,abaxially,absen,absent,abundant,acuminate,adaxially,addition,ag,along,anthesi,apical,appearance,appendage,articulated,articulation,basal,basiscopically,beneath,berr,border,branched,breaking,bullate,cell,clambering,colo.,column,consistently,dark,darker,deciduous,deltate,densest,developed,dichotomously,eaf,ebracteate,edicel,eed,eglandular,elongating,enlarged,even,exserted,extended,filament,flower,fruiting,give,glabrescent,gree,grow,growing,hair-like,half,halfway,head,interjected,internode,lamina,large,lateral,leaflet,leaving,like,lon,lower,many,middle,midvein,minutely,mixture,much,multicellular,near,nflorescence,occasionally,often,outgrowth,pair,paler,papillate,per,petiolule,poorly,primary,protuberance,pseudostipule,rachi,reflexed,rest,rough,round,ruit,sandpapery,scandent,secondary,sessile,short,shorter,silky,simple,single,slightly,small,smaller,sometimes,sparse,spreading,stamen,staminal,sterile,stiff,straight,tal,tem,terminal,tertiary,testa,thick,thickened,time,tip,touch,transparent,ud,unicellular,uniseriate,unit,upper,usually,vegetation,vein,wall,winged,ympodial,–1-2-celled	adhesion,arrangement,blade,climate,colour,form,growth,hair,height,history,inflorescence,length,life,midpoint,na,number,perennial,position,presence,ray,reproduction,rugulose,shape,size,staman,stipe,texture
414	wfo-0001028798	success	214	126	95	119	31	0.444	0-1,0.2-0.4,1-3,1-4.5,1.1-2,1.5-1.8,1/20,10,2-3.75,2-6,2-7,2.4-4.4,2.6-4,3-5,3.3-5.6,5-8,5.25-7.5,7-8,8-18,abaxially,acuminate,acute,adaxially,anther,apex,attenuate,base,becoming,blade,blunt-tipped,calyx,chartaceous,cm,conical,continued,corolla,decurrent,diameter,dm,due,entire,fleshy,flower,fruit,granular,greenish,growth,hair,inserted,lanceolate,lateral,leaf,length,less,lobe,long,many,margin,minutely,mm,multangulate,oblanceolate,oblong,obovate,pale,pedicel,peduncle,persistent,petiole,porrect-stellate,probably,pseudo-terminal,pubescent,ray,ripe,rotate-stellate,rough,rough-granular,sessile,short-stalked,shrub,simple,slightly,stem,stigma,style,subcoriaceous,subglobose,tomentose,toward,tube,velutinous,x,yellow,yellowish	.5-5,0-60,0.5-2,0.9-1.2,1-6,1/2-2/3,15-19,2-3,2.5-3.5,2/3,3-4,3.8-4.2,4-5.4,6-10,6-8,8.5-13,accrescent,ag,anthesi,apart,apical-lateral,apparently,articulated,axe,axillary,ba,berry,boat-shaped,branch,branched,bud,capitat,curved,cylindrical,dehiscing,densely,distal,downward,eaf,echinoi,echinoid,eed,exserted,extend,filament,free,fruiting,glabrous,granular-tomentose,green,hal,high,included,introrse,irregularly,lacking,large,lined,lobed,longitudinal,lower,m.,main,midvein,mixed,multangulat,nearly,nflorescence,oblanceolat,obscured,obtuse,often,orbicular,orolla,oung,ovate-lanceolate,overlapping,perfect,persistently,plurifoliate,pore,present,prominent,quite,rachi,rather,ruit,semi-ovate,short,side,slit,small,somewhat,spaced,sparingly,splitting,stalked,stamen,stellate-pubescent,strongly,subcampanulate,sulcate,suture,tamen,thick,time,tip,tomentu,tomentum,translucent,unarme,unarmed,unit,unknow,vary,vein,way,wide,ympodial	adhesion,arrangement,capitate,climate,colour,form,glandular,height,history,inflorescence,life,midpoint,na,number,ovary,perennial,plant,position,presence,pubescence,reproduction,rugulose,seed,shape,size,staman,stellate,stipe,surface,texture,ye
415	wfo-0001028803	success	204	116	87	117	29	0.426	.5,0.5,0.5–3,10,12–14,1–1.2,1–1.5,1–2,1–3.5,2–10,2–3,3–4,4–10,4–7,5–8,6–10,8–12,8–14,abaxial,acute,andromonoecious,anther,anthesi,apex,attenuate,base,berry,blade,brown,bud,calyx,chartaceous,cm,connivent,densely,diameter,entire,extra-axillary,flower,fruit,functionally,glabrous,glandular,globose,green,hair,hermaphroditic,leaf,length,liana,light,lobe,lobed,long,male,margin,midpoint,mm,moderately,nearly,obtuse,ovate,pedicel,peduncle,petiole,plant,pubescent,purple,ray,reniform,rounded,shrub,simple,small,spreading,stellate,stem,stigma,style,surface,tan,tapering,tree,violet,weakly,yellow,×	0.5–1,1,14–20,1–3,2,2–3.5,2–4,3–10,3–6,5,5-merous,75-120,8-12,absent,actinomorphic,adaxial,ag,alyx,apart,apical,apparently,appearing,armed,articulated,asymmetrical,axe,ba,bearing,becoming,branch,branched,cordate,cupular,curve,curved,curving,cylindrical,darker,developed,difoliate,distal,downward,due,eaf,early,eed,elongated,em,end,erect,exceeding,field,filament,flowering,fruiting,geminate,glabrou,held,herbarium,infructescenc,lacking,late,like,longitudinal,main,midrib,midvein,multiseriate,narrowly,nflorescence,occasional,often,older,opening,orolla,ower,pair,per,pinnate,pore,prickle,proximally,rachi,recurved,ruit,scandent,secondary,sheet,side,slightly,slit,spaced,sparsely,splitting,stalk,ste,stellate-pubescent,surfac,tamen,tomentose,triangula,triangular,typically,unarmed,unequa,unit,upright,upward,usually,vary,vein,venation,white,wid,ympodial,young,zygomorphic	1–20,adhesion,arrangement,climate,colour,corolla,form,growth,height,history,inflorescence,life,na,number,ovary,perennial,position,presence,present,pubescence,reproduction,seed,shape,size,staman,stipe,texture,tube,wide
416	wfo-0001028815	success	196	96	72	124	24	0.367	0.4-0.8,0.5-1,1-2,10-15,14-28,2-4,2-9,22-35,3-4,3-5,4-10,5-6,6-10,6-8,7-16,abaxially,adaxially,anther,axillary,broadly,brownish,bud,chartaceous,cm,condition,corolla,dark,diameter,drying,elliptic,fresh,fruit,glabrous,globose,green,greenish,herb,lanceolate,lilac-purple,lobe,medium,membranous,minutely,mm,odd-pinnate,ovate,ovoid,pedicel,peduncle,petiole,plant,puberulent,pubescent,purple,red-purple,ripe,rotate,rugose,seed,size,sparsely,splotched,stem,stigma,style,subtending,terminal,tinged,tube,whitish,x,yellow	1-10,1-3.5,1-4,1-5,2-4.5,2.5-6.5,3-7,5-7,5-merou,acumen,acute,ag,along,alyx,apart,apex,apparently,articulated,articulation,auriculate,axe,base,basiscopic,berry,blade,capitat,cell,ciliate,connivent,covering,cuneate,decreasing,decurrent,developing,digestion,distal,distinct,dorsally,eaf,edge,eed,elliptic-lanceolate,enzyme,especially,exceeding,filament,flat,flower,folded,forked,geminat,generally,glabrou,green-white,hair,hair-like,hal,half,high,homostylous,honeycomb-shaped,indistinct,interjected,lateral,leaflet,lengthening,like,living,long,lower,make,margin,midrib,mucilaginous,narrowly,nflorescence,obtuse,onto,orolla,pair,papillose,perfect,petiolulate,plurifoliate,pointed,pore,poricidal,purpl,rachi,removed,rounded,ruit,semi-erec,semi-rosette,sessile,seudostipule,short,side,slightly,slit,spaced,specimen,stamen,ste,straight,tall,tamen,tem,terminated,testal,thick,throughout,tip,tri-,triangular-lanceolate,unit,unwinged,usually,vary,wall,wet,winged,ympodial,young	adhesion,arrangement,calyx,capitate,colour,form,growth,height,history,inflorescence,leaf,length,life,na,ovary,perennial,position,pubescence,reproduction,rugulose,shape,staman,surface,texture
417	wfo-0001028876	success	127	102	67	60	35	0.528	.5,/4,0.4-1,0.5-2,1-2,1.5-2,1.5-3,2-2.3,3-8,4-5,5-6,abaxial,abaxially,acute,adaxially,along,anther,apex,attenuate,base,branched,brown,calyx,capitate,cm,corolla,dark,dendritic,densely,elliptic,glabrous,internodal,leaf,like,lobe,lobed,long,midrib,mm,occasionally,opposite,ovary,papillae,papillose,pedicel,petiole,pubescent,rest,sagittate,shining,shrub,simple,small,sparsely,speciman,stem,stigma,style,subshrub,surface,trichome,tube,type,uniseriate,way,white,x	3-5,4-8,anthesi,bark,closely,conical,dia,difoliate,drying,eaf,edicel,eed,ellipsoid,filament,flower,free,geminat,glabrat,golden,hroughout,included,inflorescenc,know,known,lamina,lateral,leave,long-triangular,lower,main,middle,minutely,nflorescence,nodding,older,overlappin,pair,papillo,planar,pore,poricidal,portion,reddish,rounded,ruti,scar,shaped,slender,spaced,straight,tall,tear-drop,tip,tub,ud,unit,vein,widest,ympodial,young	adhesion,arrangement,blade,climate,colour,diameter,form,fruit,glandular,growth,hair,height,history,inflorescence,length,life,margin,midpoint,na,number,peduncle,plant,position,presence,pubescence,ray,reproduction,rugulose,seed,shape,size,staman,stellate,stipe,texture
418	wfo-0001028883	success	207	99	63	144	36	0.304	4,5,50,acute,anther,apex,attenuate,base,blade,calyx,capitate,chartaceous,cm,coriaceous,dark,diameter,drying,dull,elliptic,entire,flower,fruit,glabrescent,glabrous,glandular,globose,green,greenish,growth,herb,lateral,leaf,length,light,lobe,margin,mm,moderately,narrowly,oblong,pedicel,peduncle,petiole,pubescence,pubescent,reniform,ripe,seed,similar,simple,size,slightly,sparsely,stellate,stem,stigma,style,subopposite,surface,undulate,white,yellow,×	0.3–0.6,0.4–1.2,0.5–2,0.6,1,1.5–7,1–2,1–6,2,2–3,2–5,3–5,4–6,5-merou,6,6–10,6–12,abaxially,absent,accrescent,acuminate,adaxiall,adaxially,almost,along,alyx,antrorse,antrorsely,apar,arched,ark,articulated,ascending,axi,becoming,berry,branch,brochidodromous,brow,capitat,cell,ciliate,circular,common,completely,concolorous,connivent,curved,cylindrical,cyme,decurrent,deltate,densely,differing,directed,eaf,eed,elliptic-ovate,emarginate,equal,erect,exfoliating,eye,filament,flattened,frui,geminate,geniculat,glabrou,head,hilum,hollow,impressed,introrsely,less,like,long,longitudinal,lower,lying,membranaceous,midrib,minor,multicellular,naked,new,nflorescence,normally,notably,obtuse,often,older,onto,opening,orolla,ovate-lanceolate,parallel,pendan,per,perfect,plurifoliate,pore,poricidal,present,primarily,prominent,rachi,rarely,region,rounded,ruit,secondary,sessile,shap,shiny,shrub,single,single-celled,slit,small,sometimes,spaced,sparse,spreading,stalk,straight,subapical,subsessile,swollen,tall,tamen,tem,trichome,unbranched,uniseriate,unit,vary,vein,venation,visible,whitish,wide,woody,ympodial	0.5-2,1-2,1.5-7,2-3,2-5,3-5,4-6,6-10,6-12,adhesion,arrangement,climate,colour,corolla,form,hair,height,history,inflorescence,life,midpoint,na,number,ovary,perennial,plant,position,presence,ray,reproduction,rugulose,shape,staman,stipe,texture,tube
419	wfo-0001028885	success	214	105	75	139	30	0.35	0.5-1,0.7-2,1-1.2,1-3,1.5-3.5,2-2.5,2.3-2.5,2.5-3.5,3.5-4.5,7-8,9-11,?,acute,adaxially,anther,apex,attenuate,base,berry,black,brown,calyx,capitate,cm,corolla,dark,densely,diameter,ellipsoid,elliptic,entire,fleshy,glabrous,glandular,globose,growth,height,immature,inflorescence,lanceolate,lateral,leaf,lobe,lobed,long,margin,mm,narrowly,pedicel,peduncle,petiole,plant,pubescent,purple,reddish,revolute,ripe,scandent,shiny,shrub,simple,slightly,sometimes,sparsely,stellate,stem,stigma,style,surface,terminal,thin,tube,vine,wide,woody	-1,.5,0.3-0.5,0.5-5,1-1.5,1-2,1.5-1.7,10-20,2,2-,2/3,3-5,3.5-8.5,4-5,5-merou,7-9,9-12,abaxial,adaxial,ag,along,alyx,anthesi,apart,apiculate,apparently,archin,ark,articulated,basal,blackish,branch,branched,broadly,cell,collapsing,connivent,cup-shaped,dark-pigmented,decurrent,deltate,dendriti,distal,dried,drying,eaf,eed,erect,exserted,extending,filament,flower,free,fruiting,furcate,glabrescent,glabrou,golden,gradually,groove,groupe,ilament,inserted,irregularly,known,lamina,leaving,lengthening,less,like,live,loosely,lower,material,midvein,minute,minutely,mostly,multicellular,narrowing,new,nflorescence,noddin,nodding,occasionally,often,older,orolla,pair,papillo,part,peg,perfect,pericarp,pigmentation,plurifoliat,pore,poricidal,portion,primary,quarter,recorded,retaining,rhachi,ruit,scar,scattered,shin,short,sleeve,slender,slit,small,smaller,spaced,spheroidal,spreading,strongly,tangled,tem,third,time,tip,trichome,twinin,ud,uniseriate,unit,upper,usually,vary,vein,wall,way,weak,weak-walled,winged,ympodial,¾	1,2-8.5,abaxially,adhesion,arrangement,blade,climate,colour,form,fruit,hair,history,length,life,midpoint,na,number,ovary,position,presence,pubescence,ray,reproduction,rugulose,seed,shape,size,staman,stipe,texture
420	wfo-0001028888	success	207	129	105	102	24	0.507	0-3.5,0.15-0.5,1-1.5,1-2,10-25,12.5-25,2-6,2.3-7,2.5-3.3,3-4,4-7,5-10,5-7,8-11,8-13.5,abaxially,adaxially,along,anther,articulated,axillary,broadly,brownish,bud,cell,center,chartaceous,ciliate,clavate,cm,condition,corolla,covered,covering,diameter,dot,drying,elliptic,especially,fresh,fruit,glabrous,globose,green,green-white,greenish,hair,hair-like,half,herb,lanceolate,lateral,lobe,long,low,make,margin,membranous,middle,midrib,minutely,mm,mottled,mucilaginous,odd-pinnate,often,ovate,ovoid,pedicel,peduncle,pentagonal,petiole,plant,proximal,puberulent,pubescent,purple,ripe,scattered,seed,short,size,slightly,sometimes,sparsely,stem,stigma,streak,style,subglabrous,substellate,subtending,terminal,testal,thick,throughout,tip,tube,violet,wall,wet,white,whitish,x,yellow	0-5,0-7,1,1-10,1-3,1.5-4,2-5,2.3-5,3-5,3.6-12.5,3.8-8.3,4-25,5-merou,6-11,acumen,acuminate,acute,ag,alyx,apart,apex,apiculate,apparently,axe,base,berry,blade,capitat,central,connivent,cuneate,digestion,distal,dorsally,eaf,edge,eed,end,enzyme,erec,exceeding,except,filament,flat,flower,folded,forked,geminat,generally,glabrou,glaucous,greatly,hal,homostylous,honeycomb-shaped,interjected,leaflet,lengthening,less,like,living,lower,nflorescence,oblique,one,orbicular,orolla,pair,perfect,petiolulate,petiolule,placed,plurifoliate,pore,poricidal,reduced,removed,rounded,ruit,sessile,seudostipule,slit,spaced,specimen,stamen,ste,stolo,straight,subequal,tall,tamen,tem,tri-,truncate,tuber,typically,unit,unwinged,usually,vary,wing,ympodial	adhesion,arrangement,calyx,capitate,colour,form,growth,height,history,inflorescence,leaf,length,life,na,ovary,perennial,position,pubescence,reproduction,rugulose,shape,staman,surface,texture
421	wfo-0001028905	success	210	89	67	143	22	0.319	1,1-3,1.5-2,1.5-3,10,10-15,15-30,2.5-3,3-4,3-5,4,5,5-15,6-9,anther,axil,bilobed,bluntly,broadly,brown,calyx,capitate,cm,concentrically,conical,corolla,deep,dia,floral,fork,form,glabrous,glandular,green,hair,later,leaf,line,minute,mm,oblong,obovoid,orange-yellow,ovary,ovate,ovoid,paling,pedicel,peduncle,petiole,plant,purple-blue,reddish,reticulate,rhachi,rotate,rugose,shortly,shrub,size,stem,stigma,style,succulent,surface,x,yellow	-20,-3.5,-4,-5,-9,1-,1.5,10-20,2,2-2.5,2-3,200-300,38/1-38/2,40-60,5-,7,acuman,acumen,acuminate,adult,age,almost,also,apex,appearing,appressed,aspect,aster,base,becoming,berry,blunt,broad,bud,cell,close,completely,continued,covering,cuneate,cyme,deeply,developed,distance,distinctly,eaf,eed,ellipsoid,emarginate,enlarged,entire,equal,even,exceeding,except,exerted,facetted,filament,firming,first,flower,forked,free,frui,fruiting,general,glabrescent,growing,herbarium,inadequate,interacuminal,intermediate,lanceolate,lasting,lengthening,less,lobe,lobed,lobing,lon,long,lower,main,margin,may,midrib,mucronate,narrowly,nflorescence,occur,often,pair,papillo,pedicellate,pinnatisect,plurifoliat,pore,poricidal,purpli,range,rarely,reaching,readily,rh,ripe,rounded,ruit,ruiting,scarious,scorpioid,seedling,several,shed,short,show,showy,simple,sinus,slende,slit,smaller,soft-wooded,soon,sparse,specimen,spreading,stone,straggly,suffused,tall,tip,tissue,tub,tube,ud,unit,usually,variable,violet,well,year,ympodial,young	adhesion,arrangement,colour,diameter,fruit,growth,height,history,inflorescence,length,life,na,perennial,plurifoliate,position,pubescence,reproduction,rugulose,seed,shape,staman,texture
422	wfo-0001028916	success	212	112	86	126	26	0.406	0-0.5,0.2-0.3,0.2-0.4,0.25-0.3,0.4-0.8,0.5-3.2,0.5-3.5,1-1.5,1-2,1-4.6,1-7,1.5-2.5,1.5-3,2-12,2.5-5,3-4,3.5-4.5,5-7.5,7-10,7-18,adaxially,andromonoecious,anther,apex,brown,calyx,chartaceous,cm,connivent,deeply,depressed-globose,diameter,ellipsoidal,elliptical,extra-axillary,fruit,glabrous,gland-tipped,globose,green,grey,hair,herbaceous,inflorescence,later,lateral,length,light,lilac,lobe,lobed,long,loosely,marbled,margin,mm,oblong-attenuate,obtuse,ovate,pale,pedicel,peduncle,petiole,plant,present,prostrate,purple,ray,resprouter,rotate,rotate-pentagonal,short,simple,sparsely,sprawling,stellate,stellate-pubescent,stigma,style,surface,throughout,time,tube,weakly,x,yellow	%,-8,0-0.4,0-2,0.05-0.1,0.25-0.35,0.3-0.4,0.4-1.3,0.5-3,0.5-5,0.9-1.1,1-3,1-4,1.8-2.2,10-16,14-21,15-25,2-5,3-5,35-50,35-55,4-,4-8,5-10,5-12,5-35,5-9,5-merou,6-20,7-8,8-10,8-9,abaxially,absen,absent,abundant,accrescent,acicular,across,adaxiall,adult,alyx,apart,armed,articulated,axe,ba,base,blade,branche,broad-based,broadly,cuneate,cut,cylindrical,decimetre,deflexed,deltate,densely,directed,distall,distributed,eaf,eed,eglandular,filament,finger,flower,fruiting,functional,half,heterostylous,index,interpetalar,lamina,less,lobing,lon,longer,lower,mature,mesocarp,midpoint,midvein,minute,minutely,moderately,nflorescence,notably,oblique,orolla,part,per,pitted,pore,porrect,presen,prickle,rachi,ruit,sessile,shallowly,side,somewhat,spaced,stage,stellae,straight,succulen,tal,tamen,tem,thick,tissue,triangular,truncat,unbranched,unit,unknow,uvenile,vary,vein,white,wide,winged,ympodial	adhesion,arrangement,colour,corolla,form,growth,height,history,leaf,life,na,number,ovary,position,presence,pubescence,reproduction,rugulose,seed,shape,size,staman,stem,stipe,texture,truncate
423	wfo-0001028920	success	152	106	78	74	28	0.513	.25,.5,0.2-1,0.5-1,0.8-1.1,1-1.2,1-1.5,1-3,2-2.5,2-7,3-3.5,6-15,6-6.5,abaxially,adaxially,anther,apex,arachnoid,arachnoid-pubescent,area,base,brown,brownish,calyx,cm,corolla,dark,decurrent,dendritic,dense,densely,dia,difoliate,elliptic,glabrous,globose,green,leaf,lightly,lobe,lobed,long-styled,minutely,mm,nearly,obovate,occasionally,opposite,ovary,ovoid-reniform,papillose,pedicel,petiole,pitted,poricidal,pubescence,pubescent,shape,short-styled,shrub,simple,size,small,sparsely,stem,stigma,style,surface,tip,tree,trichome,tube,tuft,unifoliate,uniseriate,white,winged,x	1-2.4,1.5-2,3-15-flowered,3-4,5-9,acuminate,acute,anthesi,attenuate,axil,ba,bark,berry,broadly,closely,congested,conical,cucullate,deflexed,deltate,differing,eaf,edicel,eed,ellipsoid,erect,exserted,felty,filament,fleshy,flower,free,fruiting,geminat,glabrate,gray-brow,later,lateral,lon,long,lower,main,major,middle,minor,nflorescence,obovoid,older,overlappin,pair,planar,pore,portion,present,ruit,scar,shaped,somewhat,soon,spaced,strongly,styl,tall,tapering,tear-drop,thick,tub,ud,unit,vein,widest,woody,ympodial,young	adhesion,arrangement,colour,diameter,form,fruit,geminate,gray-brown,growth,height,history,inflorescence,length,life,na,number,peduncle,perennial,plant,position,presence,ray,reproduction,rugulose,seed,staman,stellate,texture
424	wfo-0001028929	success	210	95	72	138	23	0.343	.7,.9,0-3,0.2-0.3,0.2-0.4,0.4-0.8,0.5-1.5,0.5-2,0.7-1,0.7-2,1-1.1,1/4-1/3,2-3,2.2-2.3,2.5-4,2.7-3,4-6,5-6,5-7.5,acute,anther,apex,base,blade,calyx,chartaceous,cm,cuneate,densely,diameter,dull,elliptic,equal,erect,flattened-reniform,fruit,glabrous,hair,inflorescence,lateral,leaf,length,lobe,lobed,long,margin,maturity,midpoint,mm,obovate,obtuse,orange-brown,pedicel,peduncle,petiole,poricidal,ray,red,shrub,smooth,spherical,stellate,stellate-pubescent,stem,style,surface,tapering,tip,tube,white,wide,yellow	-2,-2/3,.5,/5,0,0-1,0-10,0-20,0.1,0.15-0.3,0.2-0.8,0.3-0.6,0.8-1,1,1-3,1.5-2.4,1/2,2-4,2-6,2-9,2/3-3/4,3-20,3-4,5-25,5-merous,6-8,7-9,8-10,abaxial,abaxially,acicular,adaxial,alyx,apar,apart,ape,apically,apparently,articulated,bark,berry,branched,cell,concolorous,connivent,curved,difoliate,discolorous,distance,drying,eaf,eed,elongating,extending,filament,flower,foliaceous,free,fruiting,geminat,gently,glabrescent,glabrou,gra,infructescence,lon,long-styled,longer,lower,mature,midvein,minute,minutely,narrow-deltate,narrow-ovate,nflorescence,oblong,obtu,occasionally,older,one,open,orolla,oung,outline,pair,pale,patch,pendulous,per,perfect,pericarp,perpendicular,pit,porrect,portion,prickl,prickle,prickly,primary,raised,red-brown,red-green,reticulate,rounded,ruit,scar,sessile,short-styled,side,simple,slender,small,sometimes,spaced,spreading,stalk,stalked,staminate,straight,subsessile,tamen,terete,tertiary,time,trichome,unarmed,unit,usually,variously,vary,vein,venation,visible,way,woody,yellow-green,ympodial	adhesion,climate,colour,corolla,form,glandular,growth,height,na,number,ovary,plant,position,presence,present,pubescence,rugulose,seed,shape,size,staman,stigma,texture
425	wfo-0001028934	success	177	117	90	87	27	0.508	0.5,0.5-0.75,0.5-1,0.5-1.5,0.5-2,1-2,1-3,1.5,1.5-2,10-30,2-2.5,2-3,2-4,3-7,5-10,5-6,5-8,6-9,8-14,abaxially,absent,acute,adaxially,anther,apex,armed,attenuate,base,berry,brown,bud,calyx,chartaceous,cm,connivent,dark,densely,diameter,distally,expanded,extra-axillary,filiform,flower,fruit,glabrous,globose,green,hair,immature,leaf,leathery,like,lobe,lobed,margin,mature,mm,moderately,nearly,orange,ovate,pedicel,peduncle,petiole,porrect-stellate,prickle,pubescent,ray,recurved,red,reniform,roselike,simple,skinned,spaced,spreading,stellate,stem,stigma,style,surface,tan,tapering,tube,unlobed,vine,white,wide,x,yellow	1,1-.,1.5-2.5,15-25,3-5,3-6,5-15,5-merou,6-7,accrescent,adaxiall,alyx,apar,apical,apparently,asymmetrical,axe,beyond,blade,cordate,created,cylindrical,difoliate,directed,discolorous,eaf,eed,either,em,exserted,filament,flattened,frui,fruiting,geminate,glabrou,gree,introrsel,lanceolate,light,long,lower,m.,major,many,midpoint,midrib,midvein,multicellular,multiseriate,narrowly,netlike,nflorescence,obscure,obtuse,often,orolla,pair,per,perfect,pirckle,pit,pore,rachi,raised,reflexed,ridge,ruit,secondary,side,slightly,small,stalk,stamen,ste,tamen,thin,triangular,unarmed,unbranched,unequa,unicellular,unit,vary,vein,x1-3,ympodial	1-4,adhesion,apart,armature,arrangement,colour,corolla,form,growth,height,inflorescence,length,na,number,ovary,plant,position,presence,present,pubescence,rugulose,seed,shape,size,staman,stipe,texture
426	wfo-0001028944	success	212	141	112	100	29	0.528	0.5-0.75,0.5-1,0.8-1.5,0.8-5,1-1.5,1-3,1-3-lobed,1-4,10-20,2-15,2-2.5,2-3,2.5-4,3-4,4-6,4-8,5-10,5-25,6-15,6-8,8-13,abaxially,acute,adaxially,anther,apex,base,blade,branched,brown,brownish,calyx,chartaceous,cm,coarsely,cordate,cuneate,dark,densely,diameter,discolorous,elliptic,entire,equal,erect,especially,extra-axillary,ferruginous,flower,forked,fruit,glabrescent,glabrous,globose,green,growth,hair,highly,lanceolate,leaf,light,like,lobe,long,margin,mature,midpoint,mm,moderately,multangulate,nearly,oblique,occasionally,often,outline,ovate,pedicel,peduncle,petiole,porrect-stellate,pubescent,purple,ray,reniform,ripe,rotate-stellate,rounded,sessile,shallowly,short-stalked,shrub,side,simple,slightly,small,smooth,stellate,stellate-pubescent,stem,stigma,style,surface,tapered,tree,tube,unbranched,white,whitish,x,yellow,yellowish,young	.5-2.5,0.5-1.5,0.75-1.25,1-2,1-5,1.5-7,2.5-10,20-50,4-5,5-merou,6-7,7-17,8-10,abundant,accrescent,ag,alyx,apart,apparently,armed,articulated,axe,ba,berry,bright,broad,broad-based,capitat,connivent,covering,curved,cylindrical,deltate,denser,difoliate,directed,distally,divided,eaf,eed,filament,flattened,free,frui,fruiting,geminate,glabrou,halfway,homostylous,interpetalar,linear-acuminate,long-stalked,longitudinal,lower,main,major,membanaceous,midrib,mucilaginou,narrowly,nflorescence,numerous,obtuse,opening,orolla,part,perfect,pericarp,pore,prickle,rachi,recurved,ruit,short-,shorter,slit,sometimes,spaced,sparse,sparsely,stalk,straight,strongly,subtending,tal,tamen,tem,thin,time,tip,tissue,toward,triangular,unarmed,unit,vary,vein,white-pubescent,wide,ympodial	adhesion,arrangement,capitate,climate,colour,corolla,form,glandular,height,history,inflorescence,length,life,na,number,ovary,plant,position,presence,present,pubescence,reproduction,rugulose,seed,shape,size,staman,stipe,texture
427	wfo-0001028963	success	197	105	79	118	26	0.401	.5,/2,0-2,0.3-1,0.3-1.5,0.45-0.6,0.6-0.9,0.6-1,0.9-1.5,1.5-2,1/5,2-2.3,2-4,2-9,2.4-2.8,3.5-4.2,abaxially,anther,base,berry,bright,brown,calyx,cell,chartaceous,cm,connivent,densely,diameter,equal,evenly,flattened-reniform,glabrous,green,herb,inflorescence,lanceolate,lateral,leaf,length,light,lobe,lobed,long,lower,maturity,mauve,mm,moderately,narrow-elliptic,orange,outline,pale,pedicel,peduncle,pit,poricidal,purple,raised,red,shrub,simple,small,smooth,spherical,stellate-pubescent,stem,style,surface,tapering,terminal,tip,tube,unarmed,upper,way,wide,yellow-orange,young	0-0.4,0.1,0.1-0.2,0.1-0.25,0.15-0.3,0.3-0.6,0.3-0.7,0.8-1.8,1-4,1/,1/4-1/3,1/6,2-3,2-5,3-4.5,4-10,4-8,5-25,5-merous,6-10,7-8,acute,alyx,apar,ape,apex,apically,apparently,articulated,attenuate,bark,becoming,blade,broad-deltate,concolorous,curved,cuspidat,deltate,difoliate,discolorous,drying,dull,eaf,eed,elongating,entire,erect,eye,filament,flower,free,frui,fruiting,geminat,glabrescent,gra,gray-green,herbaceous,infructescence,less,long-styled,longer,margin,mature,midpoint,naked,narrow-cuneate,narrowly,nflorescence,obtuse,occasionally,older,one,open,orolla,oung,pair,pendulous,per,perfect,pericarp,petiole,porrect,portion,primary,ray,ruit,scar,sessile,short-styled,shorter,slender,slightly,spaced,spreading,stalk,stalked,staminate,stellate,straight,subsessile,tamen,terete,tertiary,time,trichome,unarme,unbranched,unit,usually,variously,vary,vein,venation,visible,winged,woody,ympodial	1/2,adhesion,arrangement,colour,corolla,form,fruit,gray,growth,height,history,life,na,ovary,perennial,plant,position,pubescence,reproduction,rugulose,seed,shape,size,staman,stigma,texture
428	wfo-0001028971	success	225	120	93	132	27	0.413	0.1-0.4,0.25-0.6,0.4-0.9,1-2,1.5-2.2,1.75-2.5,10-15,15-30,2-5,2.2-3.5,2.5-3.5,2.5-4.5,2.5-5,20-35,3-14,3-5,4-9,5-10,5-8,6-8.5,6-9,abaxially,acute,adaxially,anther,apex,appearance,attenuate,base,blade,branched,broadly,calyx,cm,coarsely,connivent,densely,dentate,diameter,erect,essentially,extra-axillary,farinaceous,flower,form,fruit,glabrous,globose,hair,inflorescence,leaf,length,lenticular,linear-lanceolate,lobe,margin,midpoint,minutely,mixture,mm,obtuse,orange,outline,ovate,pedicel,peduncle,perennial,petiole,pitted,pubescent,ray,reniform-ovate,ripe,sericeous,sessile,simple,spreading-hirsute,spreadingly,stellate,stellate-pubescent,stem,stigma,stipitate,style,surface,tan,thin-textured,trichome,truncate,tube,white,x,yellow	-0.8,-1.4,.1-0.2,0.1-0.5,0.2-0.5,0.25-1.25,0.3-0.6,0.4-1.5,0.8-2.5,05-2.5,1-5,1.5-4,1/5-1/2,2-foliate,3-6,4-5,5-15,6-16,7-16,acute-,adaxiall,along,also,apart,appearing,armed,articulated,ascending,axe,ba,bearing,becoming,broad-based,campanulate,capitat,cauline,close,compressed,cylindrical,delicate,deltoid,directed,distal,distall,eaf,eed,elongate,elongate-deltoid,entire,felty,felty-pubescent,female-sterile,filament,frequently,geminat,grading,growt,inserted,interlobal,invested,lanceolate,largest,later,lateral,laterally,least,lignescent,like,lon,long,longer,longest,lower,major,manifestly,maturit,midrib,minute,much,multiseriate,narrowly,nflorescence,numerous,occasionally,often,one,orolla,other,ovate-apiculate,ovate-lanceolate,pair,per,persistent,pore,prickle,prickly,principal,rachi,reduced,round-tipped,ruit,scattered,short,short-stalked,shorter,side,similar,sinus,smaller,sometimes,spaced,sparse,stalk,ste,stellae,tal,tamen,tem,termination,time,tooth-like,unbranched,underdeveloped,unit,usually,variable,variously,vary,vein,well-developed,wide,ympodial	adhesion,arrangement,capitate,climate,colour,corolla,glandular,growth,height,history,life,na,number,ovary,plant,position,presence,pubescence,reproduction,rugulose,seed,shape,size,staman,stipe,texture,ye
429	wfo-0001028975	success	163	98	62	101	36	0.38	0.5-1,1,1-3,1-5,1.2-1.5,1.5-2,3-3.5,3-6.5,6-6.5,7.5-15,8-9,acuminate,acute,anther,apex,area,base,broad,brown,calyx,cm,corolla,dark,dia,elliptic,fruit,glabrous,globose,golden,green,immature,leaf,length,lobe,lobed,long,margin,minutely,mm,opposite,ovary,ovoid-reniform,pedicel,petiole,pitted,pubescent,shaped,shiny,shrub,size,small,sparsely,stem,stigma,style,surface,tear-drop,tree,tube,white,wide,x	.2,.5,0.1-1,1.5-1.8,2.2-6,3-10-flowered,5-ribbed,5.5-10,?,along,anthesi,apart,appearing,bark,beneath,berry,closely,conical,conically,corky,cup-shaped,decurrent,deflexed,densely,denser,differing,difoliate,eaf,edicel,eed,entire,epidermi,equal,erect,exserted,extension,filament,free,fruiting,geminat,hyaline,large-celled,late,lateral,like,lon,lower,main,mainly,major,member,mere,middle,minor,narrowly,nearly,nflorescence,obscured,occasionally,older,once-furcate,one,pair,papillo,pore,poricidal,portion,prominent,pubescenc,raised,reddi,reflexed,remaining,rib,ruit,scar,short,simple,sinus,slender,slightly,somewhat,spaced,straight,strongly,tall,tapering,tip,triangular,trichome,tub,ud,uniseriate,unit,upper,varying,vein,widest,woody,ympodial,young	0.5,2,9,adhesion,arrangement,blade,climate,colour,dense,diameter,form,glandular,growth,hair,height,history,inflorescence,life,midpoint,na,number,peduncle,perennial,plant,position,presence,pubescence,ray,reproduction,rugulose,seed,shape,staman,stellate,stipe,texture
430	wfo-0001028980	success	168	104	71	97	33	0.423	0.5-1.5,1-1.2,1.2-1.8,1.5-1.8,1.5-2,1.5-6,2.5,3-4,4-5,5-6,6,7-12,acuminate,acute,anther,apex,base,calyx,capitate,cm,coarsely,conical,corolla,densely,dia,elliptic,flattened-reniform,glabrate,glabrous,glandular,globose,green,leaf,lobe,long,margin,minutely,mm,opposite,ovary,ovate,papillose,pedicel,peduncle,petiole,pitted,planar,poricidal,pubescent,reddish,reflexed,seed,sharply,shrub,size,slightly,small,soon,stem,stigma,style,surface,tall,tip,tree,trichome,tube,uniseriate,white,x,yellowish	.1,.5,.75,/3,1.2-3,2.5-5,20-25-flowered,3/4,5-8,6-8,along,anthesi,apart,axil,bark,basal,beginning,beneath,berry,black,broadly,clearly,corky,cucullate,deflexed,deltoid,differentiated,differing,difoliate,dry,drying,eaf,edicel,eed,expanded,exserted,extending,f,filament,fleshy,free,frui,fruiting,furcate,geminat,impressed,incrassate,inflorescenc,lamina,lateral,lenticellat,like,lobed,lon,lower,m.,main,major,material,member,middle,minor,nflorescence,occasionally,older,one,ovoid,pair,pale,paler,pit,pore,portion,prominent,ruit,scar,scarious,shaped,shining,simple,sparsely,speciman,strongly,tapering,tear-drop,thick,ti,type,ud,unit,usually,vein,way,widest,woody,ympodial,young	0.5,1.5,2,adhesion,arrangement,blade,climate,colour,diameter,form,fruit,growth,hair,height,history,inflorescence,length,life,midpoint,na,number,plant,position,presence,pubescence,ray,reproduction,rugulose,shape,staman,stellate,stipe,texture
431	wfo-0001028982	success	213	131	104	109	27	0.488	.3,.5,0-0.2,0.25-0.5,0.3-0.6,0.35-0.5,0.4-0.65,0.4-1.1,0.5-0.6,0.5-1.3,1-1.5,1.5-2,1.5-2.5,1.5-4.5,1.6-2.3,14-24,3-4.5,4-5,4-6,4-7,8-18,abaxially,absent,acute,adaxially,angled,anther,apex,articulated,basal,base,blade,calyx,chartaceous,cm,connivent,contiguous,cuneate,cylindrical,diameter,entire,erect,extra-axillary,flower,fruit,glabrous,gland-tipped,globose,green,hair,hastate,inflorescence,interpetalar,lanceolate,leaf,length,lilac,linear-hastate,lobe,lobed,long,loosely,margin,mid-point,midpoint,mm,moderately,narrowly,nearly,obtuse,pale,pedicel,peduncle,perennial,petiole,present,pseudo-umbellate,ray,red,reniform,rhizomatous,scattered,shallowly,shape,short,shrub,simple,solitary,sparsely,stellate,stellate-pubescent,stigma,straight,style,surface,tan,thick,throughout,tissue,truncate,tube,unbranched,x,yellow	%,0-2.5,0-3,0.2-0.3,0.2-0.4,0.3-0.7,0.3-0.8,0.3-2,0.5-1,0.8-1.5,0.8-2.5,1,1-2,1-3,1-locular,1.5-3,13-18,15-30,2-6,2.5-4.5,35-50,4-,4.5-7.5,5-6,5-9,5-merou,6-8,8-16,9-16,absen,accrescent,acicular,across,adult,alyx,apart,apparen,armed,attemuate,axe,ba,branch,branche,capitat,confined,decimetre,deeply,directed,distall,distributed,dm,eaf,eed,eglandular,exocarp,filament,finger,fruiting,geminat,half,hig,homostylous,incomplete,juicy,juvenile,lamina,lateral,less,longer,lower,mature,mesocarp,midrib,midvein,minute,nflorescence,oblique,orolla,overall,pair,part,per,perfect,placenta,pore,porrect,prickle,rachi,rugose,ruit,septum,sessile,spaced,sparse,stellae,succulent,tamen,tem,time,tissu,transparent,triangular,unarme,unarmed,unit,upper,vary,wide,ympodial	adhesion,arrangement,capitate,climate,colour,corolla,form,glandular,growth,height,history,life,na,number,ovary,plant,position,presence,pubescence,reproduction,rugulose,seed,size,staman,stem,stipe,texture
432	wfo-0001028984	success	180	105	78	102	27	0.433	-3,-9,0.5-,1,1-1.7,1-6,1-9,1.2-4,1.5,10-20,2,2-16,2-2.5,2-3,3-6,4-30,4-5,4-6,4-6.3,4-7,5-10,7-14,abaxially,acuminate,age,also,apex,apical,basal,base,calyx,campanulate,chartaceous,cm,concave,cordate,densely,diameter,eglandular,ellipsoid-fusiform,entire,fruit,glabrous,gland,glandular-puberulent,greenish,lanceolate,lobe,long,margin,mm,moderately,often,ovate,pale,pedicel,peduncle,petiole,pilose,puberulent,puberulent-pubescent,pubescent-pilose,purple,shrub,simple,small,sparsely,stigma,style,subcoriaceous,tree,tube,turning,two,unknown,violet,x,yellow	-14,-2,-2.5,-6,-65,1-,1-2,1-2.5,12-20,15-35,2-,2-4,20-40,3-10,3-26,3-28,4-foliat,5,8-15,abruptly,absen,acute,adaxially,adpressed,aggregate,almost,apart,ape,articulated,axe,blade,broad,broadly,cell,color,connective,dilated,directed,distally,eaf,eed,equalling,especially,exceeding,fleshy,flower,forked,globose,hair,laterally,leaving,lon,longer,lower,minutely,narrowed,near,nflorescence,nther,obconical,obtuse,orolla,ovoid,papillose,pedicellar,perfect,pilo,pore,possibly,presence,present,pubescent-pilo,rachi,radiu,rarely,remnant,ripe,ruit,shorter,slightly,spaced,stamen,stone,strongly,swelling,tal,tem,thecae,time,tip,tomento,tomentose,toward,triangular,truncate,ud,unbranched,unit,unknow,vary,wide,ympodial	abaxial,adaxial,anther,arrangement,colour,corolla,form,growth,height,history,inflorescence,leaf,length,life,na,ovary,plant,position,pubescence,reproduction,rugulose,seed,shape,size,stem,surface,texture
433	wfo-0001028997	success	136	101	66	70	35	0.485	0.5-0.7,0.5-1,0.8-1.1,1-1.2,1-1.5,2-3.5,3-4,3.3.5,4-10,4-4.5,5-6,6-10,acute,anther,apex,appearing,area,attenuate,base,broadened,calyx,cm,coriaceous,corolla,dia,dry,elliptic-obovate,flattened-reniform,glabrous,globose,green,height,leaf,lobe,lobed,margin,merely,minutely,mm,mustard,nearly,opposite,ovary,pale,papillose,pedicel,pericarp,petiole,pitted,poricidal,revolute,shrub,stem,stigma,style,surface,tan,terminal,thick,tip,trifoliate,tube,unknown,white,x,yellow	.5,0.5-1.5,2-2.5,20-50-flowered,4-angled,6-7,abaxially,adaxially,anthesi,apar,ba,bark,berry,branched,conical,cucullate,deflexed,difoliate,drying,eaf,edicel,eed,elliptic,erect,exserted,filament,filiform,fragrant,free,fruiting,geminat,glabrou,golden,greenish-brow,incrassate,later,lateral,lon,long,lower,main,many,matte,middle,nflorescence,older,pair,partially,pore,portion,quadrate,ruit,scar,shaped,shiny,spaced,specimen,strongly,styl,tear-drop,thickened,time,tub,ud,unevenly,vein,widest,woody,ympodia,young	0.5,adhesion,arrangement,blade,climate,colour,diameter,form,fruit,glandular,greenish-brown,growth,hair,history,inflorescence,length,life,midpoint,na,number,peduncle,plant,position,presence,pubescence,ray,reproduction,rugulose,seed,shape,size,staman,stellate,stipe,texture
434	wfo-0001029003	success	207	126	102	105	24	0.493	0.3-0.5,0.5,1-2,1.2-1.9,1.2-2.5,1.5-2.3,11-32,12.2-30,2.5-10,3,3-20,4-8,5-10.5,5-12.5,7-15.5,7-9,9-14,abaxially,adaxially,anther,articulated,axillary,blue-violet,brownish,bud,cell,chartaceous,ciliate,cm,condition,conical,connivent,corolla,covering,diameter,distal,drying,elliptic,especially,fourth,fresh,fruit,glabrous,green,green-white,greenish,hair,hair-like,half,herb,lanceolate,lateral,leaf,light,like,lobe,long,make,margin,membranous,middle,mm,mottled,mucilaginous,odd-pinnate,ovoid,pale,pedicel,peduncle,pentagonal,petiole,plant,proximal,pubescent,purple,rarely,ripe,rotate,seed,size,sparsely,stem,stigma,straight,style,subcapitate,subglabrous,subtending,terminal,testal,thick,throughout,tip,tube,usually,violet,wall,wet,whitish,wide,x,yellow	0-6,0.4-3,1,1-10,1-2.5,1-3,1-5,13-36,2-6,2.5-7.5,3-5,3.5-7.5,5,5-merou,absent,acumen,acuminate,ag,alyx,apart,apex,apparently,attenuate,axe,base,berry,blade,capitat,decreasing,digestion,dorsally,eaf,edge,eed,elongated,end,enzyme,equal,erec,exceeding,filament,flat,flower,folded,forked,geminat,generally,glabrou,gradually,hal,highly,homostylous,honeycomb-shaped,interjected,larger,leaflet,lengthening,living,lower,medium,minute,nflorescence,obtuse,one,orbicular,orolla,ovate,pair,perfect,petiolule,pigmentation,placed,plurifoliate,pore,poricidal,prostrate,ray,removed,rounded,ruit,secondary,sessile,seudostipule,slightly,slit,sometimes,spaced,specimen,stamen,ste,stolo,subequal,symmetrical,tall,tamen,tem,toward,tri-,tuber,typically,unit,vary,white,wing,ympodial	adhesion,arrangement,calyx,capitate,colour,form,growth,height,hermaphroditic,history,inflorescence,length,life,na,ovary,perennial,position,pubescence,reproduction,rugulose,shape,staman,surface,texture
435	wfo-0001029006	success	217	158	125	92	33	0.576	-+,0.2,0.4-2.5,0.5,0.5-2,0.5-4,1,1-1.5,1-4,1-5,1.8-2.2,10,2.5,3.5-4,5,7-8,<,>,abaxially,acuminate,acute,adaxial,along,anther,apex,area,asymmetrical,axil,basal,base,berry,bilobed,blackish,c.,calyx,cell,chartaceous,cm,conical,connivent,corolla,deeply,dense,diameter,ellipsoid,elliptic,entire,extending,flattened,glabrous,globose,green,groove,growth,inflorescence,irregular,lamina,later,lateral,lobe,lobed,long,loosely,lower,margin,membranous,midrib,minutely,mm,narrowly,nearly,oblique,occasionally,often,one,pale,papillate,pedicel,peduncle,pentagonal,petiole,pinnatifid,pitted,poricidal,puberulent,pubescent,purple,purplish,reaching,reddish,reniform,ripe,rotate-stellate,sagittate,shiny,simple,size,smaller,sometimes,somewhat,sparsely,stem,stigma,style,surface,tan,terminal,testal,thin,tiny,tip,trichome,truncate,tube,tuft,uniseriate,variously,vein,vine,violet,way,white,woody,x,young	.5,1.2-1.5,1/3,10-20,2-3,2-6,4-6,5-6,5-merou,50,7-9,adaxiall,ag,age,alyx,anthesi,apar,ark,articulated,axi,beyond,black,branched,bright,broadest,clavat,deltate,depending,drying,eaf,eed,elongate,exserted,filament,filiform,flower,free,fruiting,growing,ilament,inflated,intramarginal,irregularly,keeled,leaving,lengthening,many,markedly,minute,new,nflorescence,nodding,obvious,older,orolla,pair,part,peg,pendan,per,perfect,pericarp,planar,plurifoliat,pore,portion,primary,puberulen,ruit,scar,sleeve,slit,small,spaced,spreading,strong,strongly,sunligh,tem,time,twinin,twining,ud,unit,upper,usually,variable,vary,widest,within,ympodial,zig-zag	adaxially,adhesion,arrangement,blade,clavate,climate,colour,form,fruit,glandular,hair,height,history,leaf,length,life,midpoint,na,number,ovary,plant,position,presence,pubescence,ray,reproduction,rugulose,seed,shape,staman,stellate,stipe,texture
436	wfo-0001029021	success	161	123	91	70	32	0.565	0.5-1,0.8-1,0.8-1.2,0.8-2.1,1-2,1-3.4,1.1-1.3,1.5-2,1.5-3,1.8-2,2,2-2.5,3,3.5,3/4,5.5-6,abaxially,acute,along,anther,apex,appearing,base,bi-lobed,black,blade,branching,broadly,calyx,caudate,cm,coriaceous,corolla,darker,decurrent,dendritic,densely,diameter,elliptic,flattened,fleshy,free,fruit,glabrous,globose,grey-brown,growth,lamina,lateral,lax,leaf,lenticular,lobe,lobed,long,loosely,margin,minutely,mm,ovary,ovate,overtopping,pedicel,pericarp,petiole,pitted,poricidal,pubescent,purple,reddish-brown,revolute,shiny,shoot,shrub,sparsely,stem,stigma,strongly,style,surface,terminal,thin,tiny,tip,trichome,tube,vein,violet,way,winged,x	1-1.5,1-4,3-6,8-10,abaxial,absent,adaxial,adaxially,age,anthesi,apical,axi,ba,bark,basal,becoming,berry,conical,deciduous,deflexed,denser,eaf,edicel,eed,ew,exserted,filament,flower,fruiting,glabrate,im.,impressed,inserted,later,long-triangular,loose,lower,m.,monochasia,nflorescence,nodding,older,outline,pair,papillo,per,planar,plurifoliate,pore,portion,prominently,raised,ruit,scar,scattered,secondary,simple,sleeve,slit-like,stamen,ste,tapering,time,tub,ud,unit,wide,woody,ympodial,young	adhesion,arrangement,climate,colour,form,glandular,hair,height,history,im,inflorescence,length,life,midpoint,na,number,peduncle,perennial,plant,position,presence,pubescence,ray,reproduction,rugulose,seed,shape,size,staman,stellate,stipe,texture
437	wfo-0001029031	success	213	125	98	115	27	0.46	-11.4,-12.3,-8,0.1-0.5,0.5-1.5,0.6-1.2,0.7-1.1,1-1.5,1-2.5,1-3,1-5,1-9.4,1.8-2.7,10,13.5,2-10.7,2-3,2-3.3,2-5,2.5-5.5,3-10,5-17,6-21,abaxially,acuminate,acute,anther,apex,base,black,blade,bluish,brown,calyx,capitate,chartaceous,cm,corolla,cuneate,densely,diameter,eglandular,elliptic,elliptic-ovate,entire,erect,flattened,flower,fruit,glabrescent,glabrous,globose,green,hair,inserted,leaf,leaf-opposed,length,light,lobe,margin,midpoint,mm,oblong,occasionally,orange,outline,pedicel,peduncle,peltate,peltate-stellate,petiole,possibly,pubescence,pubescent,rarely,ray,reniform,ripening,rounded,rugulose,shrub,simple,small,sparsely,stellate,stellate-pubescent,stem,stigma,strongly,style,suborbicular,surface,tree,tube,white,x,yellow	-3.6,.1-0.3,.5-1.2,0-5,0.5,0.5-4,1-2,1-2.6,1.3-3.3,1.5-2.8,1.5-3.5,1.8-4,1/3,2.5-5.6,20-150,4-5-,4-7.5,6-12,absent,accrescent,adaxiall,adaxially,ag,angle,apart,apexacute,apparently,around,articulated,axe,ba,becoming,berry,bilobe,branched,center,connivent,covering,curved,cylindrical,deltate,denser,directed,distally,eaf,edge,eed,eglandula,equal,farinose,filament,fleshy,forked,frui,fruiting,fused,geminate,held,immature,impressed,lanceolate,large,lateral,least,like,long,longitudinal,lower,major,many-foliate,midvein,nearly,nflorescence,obtuse,opening,orolla,paired,perfect,pore,porrect-stellate,prominent,pseudoterminal,pubescen,rachi,ruit,sessile,short,short-stalked,side,silvery,slightly,slit,smaller,sometimes,somewhat,spaced,ste,straight,subtending,tall,tamen,tem,time,tip,trichome,unarme,unbranched,unit,usually,vary,vein,whitish,wide,yellowish,ympodial	0.1-0.3,adhesion,arrangement,bilobed,climate,colour,form,glandular,growth,height,history,inflorescence,life,na,number,ovary,plant,position,presence,reproduction,seed,shape,size,staman,stipe,texture,ye
438	wfo-0001029047	success	168	109	75	93	34	0.446	.25,.5,0.05-0.5,0.1-0.5,0.5-1,0.7-1,0.7-3,1-1.2,1-4,1.25,2.5,3-5,3.6-8.5,4-5,6-7,9.5-19.6,acuminate,acute,anther,apex,back,base,beneath,brown,calyx,cm,corolla,dia,elliptic,glabrous,globose,green,herbarium,leaf,like,lobe,lobed,long,margin,midrib,minutely,mm,mustard,nearly,opposite,ovary,ovate,ovoid-reniform,pale,papillose,pedicel,petiole,pitted,principal,pubescent,reddish-brown,shape,shaped,shrub,soft,somewhat,specimen,stem,stigma,style,surface,tear-drop,trichome,tube,uniseriate,vein,white,x,yellow,young	'',0-2,0.1-0.75,0.3-1.9,0.5-2,1,10-11,2.1-2.6,5-20-flowered,5-9,8365,``,across,amd,anisophyllou,anthesi,arching,aspec,ba,bark,bearing,beginning,berry,branch,broadly,bud,campanulate,deflexed,deltoid,differing,difoliate,distinctly,eaf,edicel,eed,evenly,filament,filiform,flattened,flower,free,fruiting,geminate,giving,glabrou,herb,impressed,inflorescenc,kruckoff,lateral,lenticellate,lon,lower,main,major,markedly,middle,minor,much-branched,nflorescence,occasionally,older,orbicular,part,pically,pore,poricidal,portion,prominent,reflexed,rounded,ruit,scar,shining,shorter,simple,slender,smaller,smooth,spaced,sparsely,strongly,styl,tall,tapering,thread-like,time,tip,ud,unit,widest,woody,ympodial	adhesion,arrangement,blade,climate,colour,diameter,form,fruit,glandular,growth,hair,height,history,inflorescence,length,life,midpoint,na,number,peduncle,perennial,plant,position,presence,pubescence,ray,reproduction,rugulose,seed,size,staman,stellate,stipe,texture
439	wfo-0001029048	success	162	107	73	89	34	0.451	.2,.5,/3,0.5-1,0.5-1.7,0.8-1,1,1-2,1-8,1.5-2,11,14,2,26,3-4,4-6,5-8,9-15,acuminate,anther,apex,attenuate,base,blade,bright,calyx,cm,corolla,decurrent,dia,elliptic,glabrous,globose,green,greenish-white,greenish-yellow,hispidulous,leaf,live,lobe,lobed,margin,matte,minutely,mm,obtuse,opposite,ovary,ovoid-reniform,pale,papillose,pedicel,petiole,pitted,poricidal,puberulent,ripe,sharply,shrub,slightly,small-capitate,specimen,stem,stigma,style,surface,tan,tip,tube,unifoliate,way,winged,x	.01,0.5,25,3-7,3.5-4,8-10,angle,another,anthesi,apar,apparent,arching,basal,bearing,becoming,beneath,berry,bicellular,branch,broadly,conical,eaf,edicel,eed,elongated,except,expanded,f,filament,filiform,flower,free,fruiting,geminate,glabrate,golden,greatly,greenish-yello,hanging,incrassate,lateral,less,like,long,lower,main,middle,midrib,minute,much,nflorescence,node,non-reproductive,obovoid,older,one,pair,papillo,parallel,planar,pore,portion,reflexed,right,rounded,ruit,scar,shaped,slender,somewhat,spaced,straight,tall,tapering,tear-drop,thread-like,time,translucent,trichome,ud,unevenly,uni-,unit,vein,widely,widest,ympodial,young,zig-zag	adhesion,arrangement,climate,colour,diameter,form,fruit,glandular,growth,hair,height,history,inflorescence,length,life,midpoint,na,number,peduncle,perennial,plant,position,presence,pubescence,ray,reproduction,rugulose,seed,shape,size,staman,stellate,stipe,texture
440	wfo-0001029053	success	275	123	83	192	40	0.302	.04,.3,.9,2.5,3.5,4.9,abaxially,across,acuminate,acute,adaxially,adnate,aequilateral,along,anther,apex,attachment,attenuate,base,blade,calyx,cm,corolla,densely,diameter,dry,entire,extra-axillary,flattened-oval,flower,fruit,glabrous,glandular,glandular-pubescent,globose,hair,lanceolate,lateral,length,lobe,long,margin,markedly,mature,mm,moderately,notched,oblique,oblong,orange,ovate,pedicel,peduncle,petiole,point,porrect,probably,pubescence,pubescent,red,rounded,semisucculent,sessile,short,shrub,simple,slightly,smooth,stellae,stellate,stellate-pubescent,stem,stigma,straight,style,surface,tube,unarmed,vein,white,yellow,yellow-tan,×	.7,0.1,0.2,0.2–0.6,0.3–0.4,0.3–0.7,0.4–0.8,0.5–0.6,0.5–1.1,0.6–1.3,0.7–1.0,0.7–1.1,0.7–1.2,0.7–1.3,0.7–1.7,0.7–3.4,0.8–1.0,0.8–1.2,1.0–1.6,1.1–1.3,1.3–2.0,1.4–2.0,1.5,1.5–2.5,1.5–2.7,1.6–9.2,1.7–1.8,1/2–2/3,1/3,1/3–1/2,2.0–2.3,2.0–2.8,2.1–2.4,2.1–3.8,2.4–2.8,2.4–5.1,21,3.5–7.2,4.5–6.2,5-merou,5.4–7.1,5–8,6.6,6.8–15.2,6–12,7.1–9.7,7–8,8,8.0–14.5,8.5–15.8,90°,accrescent,ag,alyx,anthesi,apart,apical,apiculate,apparently,appearing,appressed,around,articulate,axe,ba,bark,basal,becoming,beneath,bent,berry,borne,branch,broad,brochidodromous,bud,capitat,caudate,channeled,clinate,coat,congested,criss-cros,deciduous,deltoid,dentate,development,difoliate,directed,distal,distally,distinct,eaf,edge,eed,either,emerging,endocarp,erect,exocarp,extending,fertile,filament,filiform,free,geminat,glossy,gradually,heterostylous,increasing,individually,intact,internode,interpetalar,intersepalar,juic,lacking,layer,less,lon,longer,lower,main,many,midpoint,midrib,midvein,minute,much,nearly,nflorescence,opaque,ove,overlapping,pattern,per,perforated,pore,portion,potentially,raised,ray,remaining,revealing,rigid,row,ruit,seen,short-stipitate,shorter,side,sinus,sloughing,smoot,sometimes,soon,spaced,sparsely,splitting,spread,spreading,stamen,stipe,subopposite,suture,tamen,tem,thin,time,tip,tissue,transparent,truncate,twice-branched,two,ud,unbranched,unit,upper,various,vary,weakly,well,well-developed,wide,yellow-ferruginous,ympodial,young,±90°,±equal,±glabrous,–10	0.3-0.4,0.5-0.6,0.5-1.1,0.6-1.3,0.7-1.0,0.7-1.2,0.8-1.0,0.8-1.2,1.0-1.6,1.4-2.0,1.5-2.7,1.6-9.2,1.7-1.8,2.0-2.3,2.4-2.8,2.4-5.1,5.4-7.1,6.8-15.2,8.0-14.5,8.5-15.8,adhesion,arrangement,capitate,colour,form,growth,height,inflorescence,leaf,ovary,plant,position,presence,present,rugulose,seed,shape,size,staman,texture
441	wfo-0001029055	success	169	82	61	108	21	0.361	0.4-1.5,1-5,1.8-3.5,14-50,2.2-3,4-6,4-7,5.5-9,6-14,8-9,9-22,abaxially,adaxially,calyx,cm,connate,corolla,covered,dark,densely,diameter,distal,elliptical,gland,green,green-white,hair,half,herbaceous,leaf,long,longitudional,mm,odd-pinnate,outline,ovate,ovoid,pedicel,peduncle,pentagonal,perennial,petiole,pilose,plant,pubescent,purple,rotate,seed,short,short-stalked,size,sometimes,spreading,stigma,stripe,style,throughout,triangular,type,wide,yellow	1-2.6,1-4,1.6-3.5,1.7-2.2,2-1.,2-3,2-4,2.5-8,3,3-10,3-6,3-6-foliat,4-10,5-24,acumen,acuminate,acute,apex,apical,apically,articulate,attenuate,base,branched,cell,cordate,covering,cuneate,cyme,decurrent,dehiscent,dichasial,dichasially,digestion,diminishing,dorsally,eaf,ebracteate,edge,eed,elliptcal,emoval,enzyme,exceeding,filament,first,flat,flower,folded,forked,generally,globo,hair-like,honeycomb,interjected,introrse,lateral,leaflet,living,lobe,lon,long-attenuate,longer,lower,lunat,make,maturing,monochasial,mucilaginous,near,nflorescence,nther,oblique,often,orolla,pair,pattern,perfect,plan,poricidally,proximal,rarely,reveal,ruit,second,sessile,seudostipule,short-petiolate,slit,specimen,stamen,straight,tal,tem,terminal,testal,thick,time,toward,tuber-bearing,typically,unit,vary,wall,whit,widest,ympodial,¼	anther,arrangement,colour,form,fruit,globose,growth,height,history,inflorescence,length,life,na,ovary,position,pubescence,reproduction,shape,stem,texture,white
442	wfo-0001029056	success	140	105	65	75	40	0.464	.2,.5,0.3-0.5,1/3-1/2,3-5-lobed,3-5-rayed,3-6,6-10,7-10,across,acute,annual,anther,anthesi,attenuate,basally,base,blade,broadly,calyx,campanulate,capitate,cm,coarsely,densely,dentate,developing,dm,externally,glabrous,glandular,green,hair,herb,invested,irregularly,length,linear-lanceolate,lobe,long,midpoint,mm,obtuse,ovate,petiole,pinnately,ray,scattered,sessile,sharply,simple,slender,stellate,stellate-pubescent,stem,strongly,surface,swollen,terminally,tightly,tip,tube,uniseriate,upturned,white	-5,0,0.7-1.0,4,5-9,6-8-flowere,along,also,alyx,ample,black,branched,cauline,central,consisting,dia,difoliate,divided,eaf,eed,elongated,erect,externall,flanking,geminat,gland,intermixed,internod,know,known,lacking,large,lon,lower,major,marking,much,nflorescence,numerous,occasional,often,one,orolla,present,prickle,prickly,purplish,reduced,ruit,separated,short-stipitate,shorte,side,slende,somewhat,sparse,spreading,starlike,stellae,strait,subulate,tall,tamen,taprooted,terete,tigma,tub,tyle,unit,vary,vein,vestiture,villous,yellow,ympodial	0.2,3-5,adhesion,apex,arrangement,climate,colour,corolla,diam,diameter,form,fruit,growth,height,history,inflorescence,internodal,leaf,life,margin,na,number,ovary,pedicel,peduncle,plant,position,presence,pubescence,reproduction,rugulose,seed,shape,size,staman,stigma,stipe,style,texture,ye
443	wfo-0001029059	success	199	130	98	101	32	0.492	.5,0.1-0.5,0.1-1,0.2,0.5,0.5-1,1-1.5,1-3,1-4,1-6,1.2-3,1.3-1.7,1.5-2,1.5-2.8,10-19,3-3.5,3.5-6,4-10.5,7-9,acute,along,anther,anthesi,apex,base,berry,branched,calyx,clavate,cm,connivent,corolla,cuneate,deep,dense,densely,dia,dirty,elliptic,extremely,flattened-reniform,glabrous,globose,hispidulous,inflorescence,leaf,lobe,lobed,long,major,margin,minute,minutely,mm,nearly,oblique,occasionally,often,opposite,orange,orangish-yellow,ovary,pale,papillose,pedicel,petiole,pitted,pubescence,pubescent,purplish,ripe,shape,shaped,shrub,size,small,sparse,stem,stigma,style,surface,tear-drop,tightly,tinge,tip,tree,trichome,tube,unicellular,uniseriate,usually,variable,vein,waxy,white,x,yellowish-green,yellowish-tan	0.2-0.5,1-1.2,2.5,3-6.5,3.5-8,5,5-15-flowered,6-10,anisophyllou,apar,ape,apiculae,apiculate,arising,bark,beneath,bout,bud,closely,coiba,cordate,covered,de,deflexed,deltoid,differing,difoliate,eaf,edicel,eed,ellipsoid,expanded,exserted,extending,filament,foetid,free,fruiting,geminate,glabrate,greatly,impressed,incrassate,interpetalar,isla,lamina,lateral,lon,longest,lower,main,member,membranous,middle,minor,narrowly,nflorescence,older,one,orbiculate,pair,paler,panama,papillo,partially,planar,pointed,population,pore,poricidal,portion,prominent,reddish-gre,rest,rounded,ruit,scar,shallowly,simple,sinus,slender,somewhat,soon,spaced,specimen,straight,tall,tapering,terminal,thickened,ti,triangular,ud,underside,unit,wide,widest,woody,yellowish,ympodial,young	adhesion,arrangement,blade,climate,colour,diameter,form,fruit,glandular,growth,hair,height,history,length,life,midpoint,na,number,peduncle,perennial,plant,position,presence,ray,reddish-grey,reproduction,rugulose,seed,staman,stellate,stipe,texture
444	wfo-0001029065	success	202	120	93	109	27	0.46	0.2-0.4,0.5-1,0.5-1.5,0.5-4,1-2.5,1-3,1.5-2,1.5-2.5,10-20,2,2-15,2-2.5,2-3,3-6,3-7,4-8,5-10,5-15,5-7,7-10,8-20,abaxially,absent,acute,andromonoecious,anther,apex,attenuate,base,blade,brown,calyx,chartaceous,cm,connivent,cylindrical,densely,diameter,extra-axillary,flower,fruit,functionally,glandular,globose,green,hair,hermaphroditic,immature,leaf,leathery,like,lobe,lobed,long,male,margin,mature,midpoint,mm,moderately,multicellular,nearly,obtuse,orange,ovary,ovate,pedicel,peduncle,per,petiole,plant,porrect-stellate,pubescent,ray,red,reniform,side,simple,sparsely,stellate,stem,stigma,style,surface,tapering,tube,uniseriate,unlobed,vine,white,woody,x,yellow	0.5,0.5-1mm,1,1-2,1-5,1-6,1.,1.5-3,1/3,2-4,2-5,2-ranke,30-60,4-7,5,8,8-12,abaxial,accrescent,adaxial,adaxiall,adaxially,alyx,apar,apical,armed,asymmetrical,axe,berry,beyond,charteacous,contiguous,cordate,cut,dark,difoliate,directed,discolorous,eaf,eed,either,em,exserted,filament,flattened,frui,fruiting,geminate,generally,glabrou,glabrous,gree,green-brown,heteromorphic,introsel,less,light,long-styeld,lower,m.,major,many,merou,midrib,midvein,multiseriate,narrowly,netlike,nflorescence,often,older,orolla,pair,pit,pore,prickle,rachi,raised,recurved,ridge,roselike,ruit,separated,sessile,short-styled,sinus,slightly,small,spaced,stalk,stamen,staminate,straight,strongly,tamen,triangular,unarmed,unbranched,unequa,unicellular,unit,usually,vary,vein,way,wide,ympodial,young,¼	10,adhesion,arrangement,climate,colour,corolla,form,growth,height,history,inflorescence,length,life,na,number,position,presence,present,pubescence,reproduction,rugulose,seed,shape,size,staman,stipe,texture
445	wfo-0001029072	success	235	105	78	157	27	0.332	0.2-0.4,0.5-2,0.8-1.5,1-1.2,1-25,1/3,2-7,2.2-2.5,2.2-3.2,2.5-3.5,2.5-4.5,3-20,3-8,3.5-6,5-7,7-15,8-27,acute,andromonoecious,anther,apex,base,berry,blade,bright,calyx,chartaceous,cm,connivent,cordate,cuneate,densely,diameter,dull,equal,flattened-reniform,fruit,glabrous,herb,lateral,leaf,length,lobe,lobed,long,margin,maturity,mauve,midpoint,mm,orange-brown,ovate,pale,pedicel,peduncle,petiole,plant,poricidal,ray,rounded,shrub,simple,smooth,sometimes,sparsely,spherical,stellate,stellate-pubescent,stem,style,tapering,terminal,tip,tube,upper,white,wide,yellow	-1/2,-15,-2.5,.5,/6,0,0-2,0-20,0-4,0-8,0.1-0.4,0.2-0.3,0.3,0.4-0.9,0.5-3,0.7,0.8,00-200,1,1-1.5,1-3,1.5-2.5,1.5-2.6,1.5-3.2,1/4-1/2,1/4-1/3,12-19,2-10,2-5,2-8,2.5-3.8,20-50,3-10,3-5,3-50,3/,4-,4-10,4.2-6.5,4.5-9,5-10,5-50,5-9,5-merous,7-10,8-20,abaxial,abaxially,adaxial,adaxially,alyx,ame,angled,apar,apart,apically,apparently,articulated,bark,branched,broad-deltate,broadly,c.,clearly,conical,cream,curved,dark,deltate,dirty,discolorous,distal,distance,drying,eaf,eed,elongated,elongating,erect,extending,filament,flattened,flower,free,fruiting,gently,gra,green,green-brown,hermaphrodite,heterostylous,infructescence,least,long-styled,longer,longitudinal,lower,lowermost,marking,mature,midvein,moderately,multangulate,narrow-deltate,nflorescence,obtu,older,one,open,orolla,oung,pair,pendent,pendulous,per,pericarp,plurifoliat,porrect,portion,prickl,prickle,prickly,primary,raised,reflexed,ridge,ruit,scar,sessile,short-styled,side,spaced,spreading,stalk,stalked,staminat,stout,straight,strongly,surface,tamen,tertiary,time,trichome,unarmed,unit,variously,vary,vein,venation,visible,way,weakly,whitish,woody,ympodial,young	8-15,adhesion,arrangement,climate,colour,corolla,form,glandular,growth,hair,height,inflorescence,na,number,ovary,position,presence,present,pubescence,reproduction,seed,shape,size,staman,stigma,stipe,texture
446	wfo-0001029073	success	211	113	84	127	29	0.398	.5,0.3-1,0.5-1,0.6-2,1-1.5,1-2.5,1.1-1.5,10-16,2,2-3,2-4,2/3,3.5-9,4-5,4-6,5-6,7-10,acuminate,acute,anther,apex,base,brown,calyx,chartaceous,cm,corolla,dark,dense,diameter,elliptic,entire,flattened,glabrous,globose,growth,inflorescence,internodal,lanceolate,leaf,length,lobe,lobed,margin,maturity,midpoint,minutely,mm,narrowly,occasionally,orange,pale,papillose,pedicel,peduncle,perfect,petiole,poricidal,pubescence,purple,ray,reniform,shallowly,shiny,shrub,simple,sinuate,stellate,stem,stigma,style,surface,tan,tapering,thin,tip,truncate,tube,unequally,unisexual,way,x,yellowish,½	.7,0.5,0.6-0.7,1-1.2,1-3,1.2-1.6,1.5-2,10-15,5-8,5-merous,6-9,8-14,abaxially,adaxially,along,another,anthesi,apart,armed,articulated,away,awn-like,ba,bark,basal,beneath,berry,broad-based,cell,conical,cream,curved,darker,densely,difoliate,dimorphic,discolorous,drying,eaf,eed,enlarged,equal,erect,except,exserted,filament,flower,four,free,frui,fruiting,geminat,golden,gre,hooked,interpetalar,lamina,lengthening,like,linear,long,long-styled,lower,midvein,mixture,multangulate,new,nflorescence,nodding,oblique,older,one,opposite,pair,paler,per,pericarp,planar,plurifoliate,pore,porrect,portion,prickle,prickly,primary,pubescent,rectangular,reticulate,ruit,scar,sessile,short,short-stalked,shorter,slightly,slit,sometimes,somewhat,spaced,sparsely,splitting,straight,strongly,styled,testal,three,ti,tissue,triangular,trichome,two,ud,unarmed,underside,unequal,unit,upper,upward,vein,visible,wall,whitish,wide,woody,yellow,ympodial,zygomorphic	0.7,1.5,adhesion,arrangement,blade,climate,colour,form,fruit,glandular,hair,height,history,life,na,number,ovary,plant,position,presence,reproduction,rugulose,seed,shape,size,staman,stipe,texture,ye
447	wfo-0001029074	success	174	108	78	96	30	0.448	0.2-1,0.3-0.8,0.5-1,0.5-1.2,0.7-0.8,1,1-1.2,1-1.5,1.4-1.8,1.5-4,2-4,2-5,2-7,3.5-5,5-6,acute,anther,apex,apparently,base,black,broadly,calyx,capitate,cm,conical,corolla,cuneate,diameter,entire,flattened,glabrous,globose,green,grey,growth,herb,immature,internodal,leaf,less,lobe,margin,midpoint,minutely,mm,opposite,ovary,ovate,pale,pedicel,peduncle,petiole,pitted,pubescent,pulp,purplish,ray,reniform,ripening,rounded,sagittate,simple,sparsely,stellate,stem,stigma,style,subshrub,surface,thin,truncate,tube,uniformly,watery,white,x,yellowish	.1,.5,0,0.3-0.4,0.7-0.95,1-,1-2,1.5-2,11,2-2.3,3-,3-6,5-7,abaxially,absent,adaxially,age,almost,along,anthesi,apart,appearing,articulation,bark,basa,berry,deflexed,densely,denser,eaf,eed,ellipsoid,exerted,expanding,filament,flower,free,frui,fruiting,glabrescen,lacking,lengthening,lignescent,like,lobed,longest,lower,markedly,midvein,mixture,new,nflorescence,obscuring,often,older,pair,papillat,per,perfect,pericarp,petal,planar,plurifoliat,pore,poricidal,portion,primary,prominent,reflexed,ruit,scar,scattered,sessile,slit,small,somewhat,stalk,stalked,stellate-pubescent,strongly,swollen,tip,triangular,trichome,tub,ud,underside,uniseriate,unit,usually,vein,way,woody,yellow,ympodial,¾	adhesion,arrangement,blade,climate,colour,form,fruit,glandular,hair,height,history,inflorescence,length,life,na,number,perennial,plant,position,presence,present,pubescence,reproduction,rugulose,seed,shape,size,staman,stipe,texture
448	wfo-0001029075	success	217	118	91	126	27	0.419	.3,.5,0.8-1.5,1-2,10-20,2-5,2.5-3,30-60,4-14,4-7,4.5-6.5,5-10,5-8,7-17,7-9,8-9,abaxially,adaxially,anther,articulated,axillary,berry,brown,brownish,bud,canescent,cell,cm,condition,connivent,corolla,covering,dark,densely,diameter,dot,drying,elliptic-lanceolate,flecked,fresh,fruit,glabrescent,glabrous,glandular-pilose,glandular-puberulent,gray-green,green,greenish,hair-like,herb,lanceolate,lateral,leaf,lobe,long,minutely,mm,narrowly,odd-pinnate,ovoid,pedicel,peduncle,pentagonal,petiole,plant,puberulent,pubescent,seed,short,size,slightly,small,stem,stigma,straight,style,substellate,subtending,terminal,testal,thick,tube,wall,white,whitish,whitish-gray,wide,x,yellow,yellow-green,yellowish-white	0-3,0-8,0.5-0.8,0.8-1.2,1-10,1-2.5,1-3,2-4,2.7-4.2,4-10,4-5,5-8.5,5-merou,6-12,abruptly,acumen,ag,along,alyx,apart,apex,apparently,attenuate-acuminate,atypically,axe,base,blade,broadly,ciliate,clavifor,cuneate,decreasing,decurrent,digestion,distal,dorsally,eaf,edge,eed,end,enzyme,erect,erect-ascendin,especially,etota,exceeding,filament,flat,flower,folded,forked,geminat,generally,glabrou,gradually,greatly,green-white,hair,half,homostylous,honeycomb-shaped,interjected,larger,leaflet,lengthening,light,like,living,long-spatulate,lower,make,margin,middl,midrib,mucilaginous,narrowed,nflorescence,orbicular,orne,orolla,ovate,pair,perfect,petal,petiolulate,petiolule,plurifoliate,pointed,pore,poricidal,purple,rachi,removed,rounded,ruit,sec,sessile,seudostipule,singly,slit,sometimes,spaced,specimen,stamen,ste,stolo,subequal,subobtuse,subquadrate,tall,tamen,tem,throughout,tip,toward,tri-,tuber,typically,unit,unwinged,upper,usually,vary,wet,woody,ympodial	abaxial,adaxial,adhesion,arrangement,calyx,claviform,colour,form,growth,height,hermaphroditic,history,inflorescence,length,life,middle,na,ovary,perennial,position,pubescence,reproduction,rugulose,shape,staman,surface,texture
449	wfo-0001029084	success	192	102	78	114	24	0.406	.5,0.8-2.1,1-2,1.1-2.2,10-50,2-3.5,3-6,3.5-7.5,3.5-8,4-7,4.5-10,4.5-6.5,5-7,6-13,7-9,8-23,abaxially,adaxially,anther,axillary,berry,brownish,bud,cell,chartaceous,cm,condition,conical,corolla,covering,diameter,drying,fresh,fruit,glabrous,green,greenish,hair-like,herb,lanceolate,lateral,leaf,light,lilac,lobe,long,minutely,mm,mottled,odd-pinnate,ovate-lanceolate,ovoid,pedicel,peduncle,petiole,pilose,plant,puberulent,pubescent,purple,ripe,rotate,seed,size,sparsely,stigma,style,subglabrous,subtending,terminal,testal,thick,tube,wall,whitish,wide,x,yellow	0.8-2,1-10,1-3,1-4,1.5-2.5,2-4,2-5,4-17,5,5-merou,absent,acumen,acuminate,ag,along,alyx,apart,apex,apparently,arranged,articulated,axe,base,bead,blade,capitat,ciliate,connivent,darker,decreasing,digestion,distal,dorsally,eaf,edge,eed,enzyme,especially,exceeding,filament,flat,flower,folded,forked,geminat,generally,glabrou,gradually,green-white,half,homostylous,honeycomb-shaped,interjected,interpetalar,larger,leaflet,lengthening,like,living,lon,lower,make,margin,middle,midrib,minute,moniliform,mucilaginous,multiple,narrow,necklace,nflorescence,obtuse,orolla,pair,perfect,petiolule,plurifoliate,pore,poricidal,proximal,ray,removed,ruit,secondary,semierec,seudostipule,slit,spaced,specimen,stamen,stolon,subequal,subglabrou,subsessile,symmetrical,tall,tamen,tem,thir,throughout,tip,tissue,toward,tri-,tuber,typically,unit,unwinged,usually,vary,wet,wing,ympodial	adhesion,arrangement,calyx,capitate,colour,form,growth,height,history,inflorescence,length,life,na,ovary,perennial,position,pubescence,reproduction,rugulose,shape,staman,stem,surface,texture
450	wfo-0001029087	success	226	100	76	150	24	0.336	0-0.5,0.3-0.5,0.3-0.8,0.5-0.75,0.5-2.3,0.7-0.9,0.7-2.2,0.9-8,1.4-1.7,1.5-1.75,11-20,2-3,2.5-4,2.7-2.9,3-5,3.5-5.5,6-7,6.5-13,8-12,abaxially,adaxially,andromonoecious,anther,calyx,chartaceous,cm,cylindrical,dark,densely,diameter,extra-axillary,finely,flattened,fruit,glabrous,gland-tipped,globose,green,grey,hair,herbaceous,inflorescence,lanceolate,leaf,length,lobe,mm,moderately,ovate,pale,pedicel,peduncle,petiole,plant,present,purple,resprouter,reticulate,rhizomatous,rotate,rotate-stellate,rusty,short,simple,sparsely,stellate,stellate-pubescent,stigma,streak,style,surface,tube,weakly,white,x,yellow	%,.05,.5,0-0.1,0-14,0-2,0-6,0-7,0.1-2,0.2-0.6,0.25-0.4,0.3-0.4,0.3-0.45,0.35-0.45,0.5-1,0.9-1.7,1-1.5,1-3,1-3.5,1-4,1-6,1.3-1.6,10-30,16-20,2-,2-7,2-locular,3,3-7,3-8,3-foliate,4.5-8,4.5-8.5,5-15,5-merou,6-8,7-10.5,7-8,7-9,8-20,8-30,8-9,9-15,absen,absent,accrescent,acicular,across,acute,adult,alyx,ample,anvil-shape,apart,apex,articulated,attenuate,axe,ba,base,blade,branchlet,broadly,capitat,connivent,cross-section,deeply,deltate,directed,distall,distributed,dm,eaf,eed,eglandular,entire,erect,exocarp,filament,finger,flower,fruiting,functional,geminat,grey-green,half,heterostylous,interpetalar,juicy,juvenile,lamina,lateral,less,lobed,long,longer,lower,margin,mature,mesocarp,mid-point,midpoint,midvein,minute,moist,narrowly,nflorescence,oblique,obtuse,orolla,pair,part,pendent,per,placenta,pore,porrect,prickle,proximal,pseudo-racemose,rachi,ray,ruit,sessile,shallowly,slightly,spaced,stalk,stalked,stellae,straight,tal,tamen,tem,thick,throughout,time,tissu,tissue,transparent,triangular,unarme,unarmed,unbranched,unit,upper,vary,wide,yellowish,ympodial	adhesion,arrangement,capitate,colour,corolla,form,growth,height,history,life,na,ovary,perennial,position,presence,pubescence,reproduction,rugulose,seed,shape,size,staman,stem,texture
451	wfo-0001029088	success	149	102	75	74	27	0.503	.2,.3,0.1,0.6–3.2,1.3–4.5,1.5–2,15–25,1–1.5,1–1.6,1–3,2.5–4.2,25–30,2–2.5,3.5–7,3.5–8,3–16,4–8,<,anther,apex,bronze-brown,calyx,capitate,climbing,cm,cylindrical,diameter,extra-axillary,flattened,fleshy,flower,fruit,glabrous,greenish-brown,hair,half,herbaceous,immature,leaf,lenticular,light,lobe,lower,mature,membranous,minutely,mm,moderately,near,ovoid-rhomboid,papillose,pedicel,peduncle,petiole,pubescent,purplish,reddish-brown,rounded,rugose,sand-punctate,simple,slender,somewhat,sparsely,stellate,stigma,stout,straight,style,surface,terrestrial,tube,vine,white,x	0.9–1.5,1.5–3,1–1.2,2-lobe,2.5–20,2–3,5,5-merous,5–8,6-10,abaxially,accrescent,acuminate,acute,adaxially,alyx,apar,apicall,axe,base,berry,blade,c.,ciliate,cordate,densely,eaf,eed,emarginate,entire,filament,flavor,fragrant,fruiting,glabrou,groun,heavy,juicy,lanceolate,long,m.,margin,narrowly,nflorescence,nternode,obtuse,orolla,palmate,perfec,plurifoliat,primary,rachi,revolute,ruit,scent,shortly,slightly,spaced,strongly,swee,sweet,tamen,tem,tip,truncate,truncate-acuminat,unbranched,unit,vary,vein,venation,wider,ympodial,–7	2-lobed,adhesion,arrangement,colour,corolla,form,growth,height,history,inflorescence,length,life,na,number,ovary,plant,position,presence,pubescence,ray,rugulose,seed,shape,size,staman,stem,texture
452	wfo-0001029089	success	177	103	69	108	34	0.39	/4,0.8-1,1,1-1.5,1.5-2,1.5-6,10-25,4.5-5,5-10,5-9,6-7,acute,anther,apex,base,beneath,bilobed,branched,calyx,caniculate,cm,corolla,dark,decurrent,densely,dia,drying,elliptic,flattened-reniform,glabrous,globose,golden,green,leaf,lobe,lobed,margin,minutely,mm,opposite,ovary,pedicel,petiole,pitted,poricidal,pubescent,purplish,reddish-grey,resinous,rounded,shiny,shrub,size,slightly,small,somewhat,stem,stigma,style,surface,tan,tip,tree,tube,uniseriate,usually,way,white,x	.5,.75,0.1-0.25,0.5-0.6,0.5-1,0.8-1.2,1/2,2.5-3.5,5-20-flowered,5-6,8-9,abrupt,along,anthesi,apart,apiculate,axil,ba,bark,beginning,berry,bud,campanulate,closely,completely,covered,covering,cracking,deflexed,differing,difoliate,eaf,edicel,eed,either,enclosed,entire,erect,expand,exserted,filament,free,fruiting,furcate,geminat,glabrou,impressed,incrassate,inflorescenc,lamina,later,lateral,like,lon,long,lower,main,major,material,member,middle,minor,nflorescence,obovoid,occasionally,older,one,otherwise,overlapping,pair,papillo,papillose,part,peeling,persistent,pinkish,planar,pore,portion,primary,prominent,resinou,rounded-deltoid,ruit,scar,secretion,shaped,simple,smooth,spaced,still,straight,tall,tapering,tear-drop,trichome,tub,ud,underside,unit,varnish,varnished,vein,widening,widest,woody,ympodial,young	0.75,adhesion,arrangement,blade,climate,colour,diameter,form,fruit,glandular,growth,hair,height,history,inflorescence,length,life,midpoint,na,number,peduncle,plant,position,presence,pubescence,ray,reproduction,rugulose,seed,shape,staman,stellate,stipe,texture
453	wfo-0001029091	success	212	118	81	131	37	0.382	-4,-4.5,1-2,1.5-,1.5-2,10,10-20,15-40,2-2.5,2-3,2.5-,3-4,4,7-8,acuminate,acute,anther,apex,aromatic,axil,base,broadly,buff,calyx,capitate,cm,colour,corolla,cuneate,dia,discoidal,elliptic,flushed,fork,glandular,globular,grey,hair,intense,irregular,irregularly,larger,lavender,leaf,light,lobe,long,minutely,mm,oblong,obovate,ochre-yellow,ovate,overlain,ovoid,pale,pattern,pedicel,peduncle,pentagonal,petiole,pubescent,reddish-purple,reticulate-concentric,ridge,ridged,shrub,simple,slightly,soft,sparsely,speckled,stellate-rotate,stem,stigma,style,succulent,surface,transverse,violet-purple,x	-1,-15,0.3-,0.5-0.8,0.5-1,1,1-10,10-toothed,170-210,2-12,20-30,3,3-,3-11-lobed,46/1,5,5-7,635/1,age,appearing,articulated,articulation,aspect,ba,becoming,berry,blunt,bluntly,brownish,campanulate,cell,clonal,close,common,conspicuous,cut,cyme,dark,deeply,develop,developed,downward,eed,effect,ellipsoid,emarginated,erect,exceeding,exerted,filament,flattened,floral,flower,forked,fresh,fruiting,general,giving,globose,gree,growing,half,interacuminal,juvenile,lacking,lasting,later,lateral,lavende,lengthening,line,linear,linear-lanceolate,long-triangular,lower,may,mid-vein,mineral,narrowly,nflorescence,obscure,occasionally,ower,pedicellate,petiol,petiolate,plurifoliat,point,pore,poricidal,rachi,raised,readily,relatively,rh,ripe,rounded,ruit,scarcely,separate,several,shallowly,shed,shortly,sigmoid,sinus,slender,slit,soft-wooded,soon,stone,straggly,subulate,swollen,tall,tip,tissue,toward,triangular,tub,ud,unit,upper,usually,violet,well,winged,without,woody,year,ympodial	adhesion,arrangement,blade,climate,diameter,form,fruit,green,growth,height,history,inflorescence,length,life,margin,midpoint,na,number,ovary,perennial,plant,plurifoliate,position,presence,present,pubescence,ray,reproduction,rugulose,seed,shape,size,staman,stellate,stipe,texture,tube
454	wfo-0001029101	success	233	120	95	138	25	0.408	-15,.5,0-2,0.1-0.7,0.4-1.5,0.5-1,1-3,1.3-2,1.5-2.5,1.8-3,10-14,2.5-3.5,2.5-6,2.8-3.3,3-,3-4,5-,5-6,5-7,5-8,5-9,5.5-8,7-13,abaxial,abaxially,anther,apex,base,berry,blade,broad-deltate,calyx,chartaceous,cm,connivent,cream,cuneate,dark,diameter,dull,elliptic,equal,erect,flattened-reniform,flower,fruit,glabrescent,glabrous,green,lateral,leaf,length,lobe,lobed,long,long-styled,margin,marking,maturity,mauve,midpoint,mm,moderately,obovate,obtuse,orange-brown,ovate,pale,pedicel,peduncle,petiole,plant,poricidal,present,ray,rounded,short-styled,shrub,simple,sometimes,sparsely,spherical,spreading,stellate,stellate-pubescent,stem,style,surface,tapering,tip,tube,wide,yellow,yellow-orange,young	-3,/3,/4,0-100,0-20,0-5,0-8,0.1,0.1-0.4,0.1-0.5,0.1-1,0.2,0.7-,0.8-3.5,00-200,1,1-1.5,1-4,1-8,1.3-2.6,1.4-2.2,1.5-2,1.7,1/5-1/4,10-20,2-,2-20,2-6,2/3-3/4,3-10,3-7,30-100,4-12,4-7,5-20,5-merous,6-8,8-15,acute,adaxial,almost,always,alyx,andromonoecious,apar,apart,apically,apparently,articulated,bark,branched,brown-green,cell,concolorous,darker,deltate,discolorous,distal,distance,drying,eaf,eed,elongating,extending,filament,flattened,free,fruiting,green-brow,hermaphrodite,heterostylous,infructescence,lengt,like,lon,longer,lower,lowermost,mature,midvein,multangulate,narrow-deltate,nflorescence,oblong,often,older,one,open,orolla,oung,outline,pair,pendulous,per,pericarp,pit,plurifoliat,porrect,portion,prickl,prickle,prickly,primary,raised,rarely,reduced,reflexed,rounde,ruit,scar,secondary,sessile,side,small,smooth,spaced,stalk,stalked,staminat,straight,suborbicular,tamen,terete,tertiary,thick,time,trichome,unit,variously,vary,vein,venation,visible,way,well-developed,woody,yellow-green,ympodial	adhesion,arrangement,climate,colour,corolla,form,glandular,growth,hair,height,inflorescence,na,number,ovary,position,presence,pubescence,rugulose,seed,shape,size,staman,stigma,stipe,texture
455	wfo-0001029106	success	200	123	101	99	22	0.505	.5,/3,0-2,0-6,0.2-0.4,0.2-1,0.25-0.7,0.5-0.9,0.9-1.2,1.5-2,1.5-3.5,1/5-1/4,2-5.5,2-8,2.2-3,3-3.5,3-4,6-8,abaxially,acute,ame,anther,apex,apically,base,berry,blade,c.,calyx,cell,cm,concolorous,curved,densely,diameter,discolorous,drying,elliptic,equal,flattened-reniform,fruit,glabrescent,glabrous,lateral,leaf,length,lobe,lobed,long,lower,margin,maturity,mauve,membranous,midpoint,mm,orange,orbicular,outline,ovate,pale,pedicel,peduncle,petiole,pit,poricidal,porrect,prickle,prickly,raised,ray,red,rounded,scandent,sessile,shiny,shorter,shrub,size,slender,small,smooth,sometimes,sparsely,spherical,spreading,stellate,stellate-pubescent,stem,style,subentire,surface,tapering,tip,trichome,tube,way,weakly,white,wide,yellow-orange	-6,.1,0,0-0.3,0-10,0-20,0-5,0.1,0.5,0.5-0.8,0.5-1,0.5-2.5,1-1.6,1-2,1-5,1.5-1.8,1/4,2-3.5,2-4,2-6,2/,3-25,4-6,4-8,5-14,5-8,5-merous,acuminat,alyx,apar,apart,apparently,appearing,articulated,bark,branched,cuneate,deltate,distance,eaf,eed,elongating,erect,extending,eye,filament,flattened,flower,free,fruiting,gently,infructescence,light,lon,longer,mature,midvein,naked,nflorescence,obtuse,older,one,open,orange-brow,orange-brown,orolla,oung,pair,pendulous,per,perfec,pericarp,plurifoliat,portion,prickl,primary,reflexed,scar,shallow,side,simple,spaced,stalk,stalked,straight,tamen,terete,tertiary,time,uit,unit,variously,vary,vein,venation,visible,woody,yellowish-green,ympodial	2/3,acuminate,adhesion,climate,colour,corolla,form,growth,height,inflorescence,number,ovary,plant,position,presence,pubescence,rugulose,seed,shape,staman,stigma,texture
456	wfo-0001029112	success	190	115	89	101	26	0.468	0.9-1.7,1-2,1.4-2.5,10-21,2.5-4.5,2.6-3,2.7-5.7,20,3-7,3.5-4.5,3.5-7,5,5-8,6.5-5.5,9.5-13,abaxially,adaxially,anther,articulated,axillary,berry,brownish,bud,cell,chartaceous,ciliate,cm,condition,conical,connivent,corolla,covering,densely,diameter,distal,drying,elliptic-lanceolate,flower,fresh,fruit,glabrous,green,green-white,greenish,hair,hair-like,herb,lanceolate,lateral,leaf,light,like,lobe,long,make,margin,middle,minute,mm,mottled,mucilaginous,odd-pinnate,ovate,ovoid,pale,pedicel,peduncle,plant,pubescent,purple,ripe,rotate,seed,size,stigma,style,subtending,terminal,testal,thick,throughout,tube,violet,wall,wet,whitish,wide,x,yellow	0-2,0.5,1-10,1-3,1-4,1.5-1.8,1.5-2,10-17,2-3.5,2.7-3.5,2.7-4.2,3-4,3-5,3-6,5-merou,acumen,acuminate,ag,along,alyx,apart,apex,apparently,arranged,axe,base,bead,blade,capitat,decreasing,digestion,dorsally,eaf,edge,eed,enzyme,equal,especially,exceeding,filament,flat,folded,forked,geminat,generally,glabrou,gradually,half,homostylous,honeycomb-shaped,interjected,larger,leaflet,lengthening,living,lower,moniliform,multiple,narrow,necklace,nflorescence,obtuse,orolla,pair,perfect,petiole,petiolule,plurifoliate,pore,poricidal,present,pubescen,ray,removed,ruit,secondary,semierec,seudostipule,slightly,slit,spaced,specimen,stamen,ste,stolon,subequal,symmetrical,tall,tamen,tem,thir,tip,toward,tri-,tuber,typically,unit,usually,vary,wing,ympodial	adhesion,arrangement,calyx,capitate,colour,form,growth,height,history,inflorescence,length,life,na,ovary,perennial,position,pseudostipule,pubescence,reproduction,rugulose,shape,staman,stem,surface,texture,third
457	wfo-0001029120	success	168	101	65	103	36	0.387	.5,0.1-0.5,0.7-1,1-1.5,1.1-1.5,1.1-2,2.5-3.5,2.6-7,3-3.5,6-8,6.5-16.5,acuminate,acute,anther,apex,base,calyx,cm,corolla,dark,decurrent,erose,especially,glabrous,golden,greenish-brown,hirsute,internodal,larger,leaf,lobe,lobed,long,margin,minutely,mm,narrowly,nearly,opposite,ovary,ovate,paler,pedicel,peduncle,petiole,pubescent,rest,shaped,shrub,slightly,sparsely,stem,stigma,style,surface,tear-drop,trichome,tube,unifoliate,uniseriate,urceolate,vein,white,x,young	.05,.75,/2,0.5-1.5,5-10-flowered,5-8,8511,abrupt,anthesi,apart,bark,basal,beginning,beneath,black,bud,bullate,cell,deflexed,densely,dia,difoliate,dry,drying,eaf,edicel,eed,epidermi,evenly,f,fide,filament,fleshy,free,geminat,globose,inflorescenc,infloresence,know,known,lanceolate,large,later,lateral,lehmann,like,lon,long-triangular,lower,main,middle,midrib,minor,narrow,narrower,nflorescence,occasionally,often,older,outer,pair,pale,papillose,peduncl,petaloid,point,pore,poricidal,portion,present,prominently,proximal,raised,reproductive,ruit,scar,scattered,simple,slender,spaced,specimen,speckle,straight,sympodial,tall,tapering,terminal,thickened,tip,tub,ud,unbranched,unit,upper,venation,way,white-papillo,wide,widening,widest,yellow,yellow-green,ympodial	adhesion,arrangement,blade,climate,colour,decument,diameter,form,fruit,glandular,growth,hair,height,history,inflorescence,length,life,midpoint,na,number,perennial,plant,position,presence,pubescence,ray,reproduction,rugulose,seed,shape,size,staman,stellate,stipe,texture,white-papillose
458	wfo-0001029121	success	161	74	52	109	22	0.323	0.2-2,1-5,1.1-3.9,15-30,2-13,2-3,2-3-celled,3.8-11,4-10,4-5.5,5-20,5-8,9-33,blue,calyx,cm,conical,connate,corolla,deep,diameter,distal,elliptical,glabrous,green,green-white,hair,half,herbaceous,leaf,long,medium,mm,narrowly,odd-pinnate,ovate,ovoid,pedicel,peduncle,perennial,petiole,plant,purple,rotate,scattered,seed,short,size,stigma,style,wide,yellow	-6,0,0-2,1-4,1.2-2.5,1.2-3.3,10,2-,2-10,3-5,3-6-foliat,3.6-9,4.5-10.0,8-16,abaxiall,abaxially,acumen,acuminate,acute,adaxially,apex,apical,apically,articulate,attenuate,base,branched,cell,commonly,covering,cuneate,cyme,dehiscent,dichasial,dichasially,digestion,diminishing,dorsally,eaf,ebracteate,edge,eed,emoval,enzyme,exceeding,filament,flat,flower,folded,forked,generally,globo,gradually,hair-like,honeycomb,interjected,introrse,lateral,leaflet,living,lobe,lon,lower,lunat,make,maturing,monochasial,mucilaginous,nflorescence,nther,oblique,obtuse,often,orolla,pair,pattern,perfect,petiolule,plan,poricidally,proximal,rarely,reveal,rounded,ruit,sessile,seudostipule,short-attenuate,slit,specimen,stamen,straight,subequal,tal,tem,terminal,testal,thick,throughou,throughout,tip,toward,tuber-bearing,typically,unit,vary,wall,ympodial,¼	anther,arrangement,colour,form,fruit,globose,growth,height,history,inflorescence,length,life,na,ovary,position,pubescence,reproduction,rugulose,shape,stem,surface,texture
459	wfo-0001029125	success	197	115	68	129	47	0.345	abaxially,acuminate,adaxially,anther,apex,appressed,attenuate,base,berry,black,brownish,calyx,central,cm,concave-reniform,corolla,cuneate,densely,diameter,ellipsoid,entire,fruit,glabrous,globose,green,herb,internodal,lateral,leaf,lobe,long,margin,maturity,minutely,mm,orange,ovary,ovate-lanceolate,pale,papillate,pedicel,peduncle,petiole,plant,pubescent,purple,purple-tinged,purplish,ripe,seed,shiny,simple,small,sparsely,star,stellate,stem,stigma,style,subshrub,surface,trichome,tube,turning,uniseriate,white,wide,yellow	.0–3.5,.1,.1–1.4,.2,.4,.5–2.0,.6,0.5,0.5–0.6,0.5–1.0,0.8–0.9,0.9,1,1.0–1.2,1.0–1.5,1.0–4.0,1.5–2.0,1.5–3.0,1.7-,1.8–3.5,1–2-celled,2.5–12.0,2/3,20–100,2–3-celled,2–4,3.0–3.4,3.5–4,35–45,3–5,3–5-celled,4–8,5-merous,5–6,6,6–7,abaxial,acute,adaxial,age,along,anthesi,apar,apparently,arising,articulated,ba,beyond,branching,cell,closely,cone,conical,delicate,deltate,difoliate,eaf,eed,end,especially,exerted,filament,flower,free,fruiting,geminat,growt,hilum,later,lengthening,like,live,lobed,lon,lower,maximum,narrower,nearly,nflorescence,oblique,occasionally,often,one,outline,pair,pentagonal,per,perfect,place,pore,poricidal,portion,positioned,primary,reflexe,reflexed,ridged,ruit,scar,scattered,shorter,single,slightly,slit,spaced,spreading,stemmed,stone,straight,strongly,sub-lateral,tall,tem,terete,testal,tinged,tip,toward,traingular,ud,unequal,unit,usually,vein,whitewith,woody,ympodial,young,¼	0.4-0.5,0.5-0.6,0.5-1.0,1-2-celled,1.0-1.5,1.0-4.0,1.1,1.2,1.5-2.0,1.5-3.0,1.7-3.4,2-4,2.5-12.0,20-100,3.5-4,5-6,6-7,adhesion,arrangement,blade,climate,colour,form,glandular,growth,hair,height,history,inflorescence,length,life,midpoint,na,number,perennial,position,presence,present,pubescence,ray,reproduction,rugulose,shape,size,staman,stipe,texture
460	wfo-0001029138	success	170	100	70	100	30	0.412	0-0.1,0.15-0.3,0.5-0.9,0.6-0.8,0.6-1.1,1-2.5,1.7-4,2-locular,2.4-5.5,2.5-3.5,20-30,3-8,3.5-4.5,3.5-6.7,4-6,6-6.5,6-8,7-8,abaxially,absent,acute,adaxially,anther,apex,base,blade,broadly,brown,calyx,chartaceous,cm,cuneate,densely,diameter,entire,extra-axillary,flower,fruit,glabrous,hair,inflorescence,length,lobe,margin,midpoint,mm,oblate,obtuse,ovate,pedicel,peduncle,perennial,petiole,present,prostrate,purple,ray,rhizomatous,rotate,rusty,shrub,simple,sparsely,stellate-pubescent,stem,style,tube,x,yellow,yellowish	%,0,0-0.6,0-1.5,0-5,0.25-0.5,0.6-0.7,0.8-1.5,0.9-1.2,1-1.5,1-1.8,1-2,1-5,1.6-2.1,2-foliate,20-100,3-4,3-80,5-8,5-merou,6-10,65-115,7-10,absen,accrescent,acicular,adaxiall,alyx,apart,apparently,armed,articulated,axe,ba,broad-based,cylindrical,d.,deltate,directed,distall,distally,distributed,dult,eaf,eed,eglandular,enclosing,finger,fruiting,functional,geminat,glabrou,gland-tipped,green,grey-green,juic,lamina,lateral,lon,long,longer,lower,markedly,mature,mesocarp,mid-point,midvein,minute,moist,nflorescence,oblique,orolla,part,per,pore,porrect,prickle,pseudo-racemose,ruit,short,spaced,stage,stalk,stellae,straight,tal,tamen,thick,thicker,thicknes,throughout,time,unbranched,unit,unknow,unknown,uvenile,vary,wide,ympodial	adhesion,arrangement,climate,colour,corolla,form,glandular,growth,height,history,leaf,life,na,number,ovary,plant,position,presence,pubescence,reproduction,rugulose,seed,shape,size,staman,stellate,stigma,stipe,surface,texture
461	wfo-0001029150	success	177	128	101	76	27	0.571	.5,0.3,0.3–0.5,0.5–1.1,0.8-1,0.8–1,0.8–1.5,0.8–3.5,1.2–1.5,1.5,1.5–2.2,15,1–1.5,1–11,1–5,2.5–3,2.5–5,2.5–8,2–10,3-5,3–10,6,8-shaped,9–12,abaxially,acute,adaxially,anther,apex,apically,apiculate,base,branched,calyx,climbing,cm,conical,cros,cylindrical,diameter,ellipsoidal,elliptical,entire,extra-axillary,filament,fleshy,flower,fruit,glabrous,larger,leaf,light,lobe,margin,membranaceous,midvein,minutely,mm,moderately,nearly,oblique,opposed,ovate,pale,pedicel,peduncle,petiole,pinkish-white,pinnate,pubescent,rachi,rarely,rounded,rounded-deltoid,rugose,sand-punctate,section,shortly,simple,slender,somewhat,sparsely,stellate,stem,stigma,strong,style,surface,tan,teardrop-shaped,thickened,tip,trichome,truncate,tube,venation,vine,white,wiry,woody,x	0.3-0.5,1.5–2,1–2,1–6,2–2.5,2–3,3–4,3–50,5-merous,7–8,accrescent,across,adaxiall,alyx,apar,apicall,attenuate,axe,berry,blade,c.,canopy,capitat,ciliate,color,delicate,distant,dried,eaf,eed,enlarged,except,flattened,flush,fruiting,glabrou,inconspicuous,lamina,lanceolate,living,lon,long,lower,m.,material,mor,nflorescence,nternode,older,orolla,pair,perfec,plurifoliat,pointed,reaching,ruit,scar,secondary,side,slightly,small,spaced,specimen,tamen,tem,thick,time,translucent,tree,understory,unit,vary,vegetation,vein,wide,ympodial	3,abaxial,arrangement,branching,capitate,colour,corolla,form,growth,height,history,inflorescence,internode,length,life,ovary,plant,position,pubescence,reproduction,rugosity,seed,shape,size,staman,texture,thicknes
462	wfo-0001029151	success	197	99	70	127	29	0.355	-10,0.2-0.6,0.25-0.5,0.5-1,1-1.5,1-2,1-2.5,1-5,1-6,1.5-2,1.5-6,10-15,2-2.5,2-4,3.5-5,4-10,4.5-5,5-10,5-8,7-10,8-10,8-15,acute,annual,anther,apex,base,blade,brown,calyx,chartaceous,cm,connivent,dark,diameter,elliptic,entire,fruit,glabrous,globose,green,herb,leaf,leaf-opposed,lobe,loosely,margin,mm,narrowly,oblong,ovate,pedicel,peduncle,petiole,purple,ray,reniform,rounded,simple,stellate,stem,stigma,style,subcordate,surface,truncate,tube,undulate,x,yellow	0-0.5,0.1-0.3,1.5-3,15-20,2-15,2-3,2-6,2-8,5,5-7,6-10,7-9,8,abaxially,abundantly,accrescent,acicular,acro,acumen,adaxial,adaxially,apart,apparently,armed,articulated,axe,ba,capitat,close,completely,cone,covered,covering,curved,cylindrical,deflexed,densely,developed,difoliate,directed,discolorous,distall,downward,eaf,eed,eglandular,equal,filament,flattened,flower,forked,frui,fruiting,geminat,hair,held,high,interpetalar,juic,juvenile,larger,lateral,like,lon,long,lower,main,markedly,mesocarp,midpoint,midrib,minute,minutely,moderately,moist,multangulate,nearly,nflorescence,oblique,obtuse,orolla,outside,pale,perfect,pore,porrect,prickle,prickly,probably,pubescent,rachi,rarely,reticulate,ruit,scarcely,shallow,shorter,side,silvery,small,spaced,sparse,sparsely,sparser,spiny,sprawling,stalk,stellate-pubescent,straight,tamen,tem,time,tissu,tissue,triangular,unarmed,unbranched,unit,usually,vary,vein,vigorous,white,whitish,wide,yellowish,ympodial	adhesion,arrangement,capitate,colour,corolla,dense,form,growth,height,history,inflorescence,length,life,na,number,ovary,plant,position,presence,pubescence,reproduction,rugulose,seed,shape,size,staman,texture,width,ye
463	wfo-0001029152	success	197	91	70	127	21	0.355	0.25-0.5,0.5-1,0.8-1,0.9-1.3,1,1-1.5,1-4,1.1-1.3,1.5-2,2-2.5,2-5,2.5-3,3-5,8.5-16,anther,area,base,brown,calyx,cm,corolla,dark,deep,densely,dia,dry,elliptic,floccose,fruit,glabrous,globose,green,greyish-red,inflorescence,leaf,lightly,lobe,lobed,material,minutely,mm,nearly,obovate,opposite,ovary,ovoid-reniform,pale,papillose,pedicel,petiole,pitted,plant,poricidal,red,red-floccose,reddish-floccose,shape,shrub,size,small,stem,stigma,style,surface,tip,tree,tube,white,winged,x	.1,.5,0.75-1,1-2,1-3,1.5-1.7,2-3,2-4,3-8-flowered,4-6,6-8,61-25,acuminate,acute,anthesi,apex,appearanc,appearing,appressed,attenuate,ba,bark,beginning,beneath,berry,blade,branch,broadened,broadly,bud,citronella,closely,completely,conical,corky,cuneate,deciduous,decurrent,deflexed,deltoid,differing,difoliate,distal,eaf,edicel,eed,ellipsoi,enclosing,erect,et,exsertion,fide,filament,flattened,flower,fragrance,free,fruiting,geminat,giving,held,hyaline,inflorescenc,keeled,large-lenticellate,late,lateral,live,lon,long,long-styled,longer,lower,main,major,margin,middle,midrib,minor,nflorescence,often,older,one,overlapping,pair,per,planar,plane,pore,portion,prominent,prominently,quite,reddish,reflexed,reminiscent,rounded,ruit,scar,shaped,shiny,short-styled,simple,single,slender,slightly,somewhat,soon,spaced,straight,styl,tall,tapering,tear-drop,terminal,third,tillett,trichome,ud,unit,usually,vein,weak,widest,woody,ympodial,young	1.5-4-6,adhesion,arrangement,colour,diameter,form,growth,height,history,length,life,na,peduncle,perennial,position,pubescence,reproduction,rugulose,seed,staman,texture
464	wfo-0001029156	success	65	71	25	40	46	0.385	1.5-2,4-6,6,6-8,apex,berry,cm,diameter,glabrous,growth,liana,long,margin,mm,pale,pedicel,reniform,seed,shiny,stem,surface,tan,vine,wide,woody	-3,0.5,1,10-12,2,<,almost,apparently,bark,cell,center,completely,deeply,eed,epiphytic,exfoliating,fide,flattened,fruiting,golden,lateral,markedly,minute,minutely,multiseriate,nee,new,noddin,occasionally,older,per,pitted,rectangular,rib-like,shreddy,sinuate,testal,thickening,trichome,wall	2-3,adhesion,anther,arrangement,base,blade,calyx,climate,colour,corolla,form,fruit,glandular,hair,height,history,inflorescence,leaf,length,life,lobe,midpoint,na,nodding,number,ovary,peduncle,perennial,petiole,plant,position,presence,present,pubescence,ray,reproduction,rugulose,shape,size,staman,stellate,stigma,stipe,style,texture,tube
465	wfo-0001029156	success	65	70	50	15	20	0.769	0.5,1,1.5-2,10-12,2,4-6,6-8,<,almost,berry,cell,center,cm,completely,deeply,diameter,exfoliating,flattened,fruiting,glabrous,golden,growth,lateral,liana,margin,minute,minutely,mm,multiseriate,new,pale,pedicel,per,pitted,rectangular,reniform,rib-like,seed,shiny,sinuate,stem,surface,tan,testal,thickening,trichome,vine,wall,woody,x	-3,apex,apparently,ark,eed,em,epiphytic,fide,lon,markedly,nee,noddin,occasionally,older,shreddy	2-3,6,bark,colour,form,height,history,length,life,long,na,nodding,number,perennial,plant,pubescence,reproduction,shape,size,texture
466	wfo-0001029160	success	150	107	66	84	41	0.44	/2,0.5,0.7,1.3-1.6,1.3-1.8,1.8-2.2,2-7,3-8,3.0-3.5,5-13,6-8,6.5-8.6,annual,anther,armed,base,blade,bristly,broadly,brown,calyx,capitate,cm,dark,developing,dm,dry,eglandular,few-rayed,glabrous,gland,hair,herb,including,incurved,internodal,invested,less,lobe,long,maturity,mm,occasionally,ovate,petiole,plump,prickly,purple,radially,ridged,scattered,sessile,short-stipitate,size,sometimes,spherical,splitting,stellae,stellate,stem,strait,terminally,tightly,tinged,tube,yellow	0.35-0.50,1.11.4,20-40,4-8,4.5-6.0,5.6-7.5,6-10-flowered,accrescent,acicular,acro,across,acute,adjacent,also,alyx,among,anthesi,appearance,beneath,berry,branched,campanulate,deep,deltoi,dia,difoliate,divergently,divided,eaf,eed,enveloped,erect,exceeding,extende,finer,fully,geminat,giving,heteromorphic,hilum,linear-lanceolate,lon,lowermost,main,many,mostly,much,much-dissected,narrowly,nflorescence,notch,often,one,orolla,ovoid,pair,pinnatifid,prickle,ruit,shorter,shortest,slende,somewhat,spreading,stout,straigh,sunken,tall,tamen,three,thrice,tigma,tub,twice,tyle,ultimate,unit,uppermost,vary,vein,vestiture,whitish-tinged,wholly,ympodial	1.1-1.4,adhesion,apex,arrangement,climate,colour,corolla,diameter,form,fruit,glandular,growth,height,history,inflorescence,leaf,length,life,margin,midpoint,na,number,ovary,pedicel,peduncle,plant,position,presence,pubescence,ray,reproduction,rugulose,seed,shape,slender,staman,stigma,stipe,style,surface,texture
467	wfo-0001029163	success	149	99	68	81	31	0.456	-9,0.3-2.5,0.5-1,1-2,1.5-2.5,1.5-3,10-,2,2-3,2-6,2-7,2.5-3,20-30,3-4,4-20,4-6,4.5-23,5-8,7-9,acuminate,acute,apex,base,blade,calyx,chartaceous,cm,connivent,cuneate,decurrent,densely,diameter,elliptic,elliptic-ovate,entire,free,fruit,glabrous,glandular,globose,hair,herb,lanceolate,lenticular,lobe,margin,mm,moderately,nearly,pedicel,peduncle,perennial,petiole,puberulent-pubescent,pubescence,purple,simple,sparsely,stellate,stem,stigma,style,surface,tube,unknown,white,x,yellow	-25,-4,1,1.5-2,13-18,2-18,3-14,3-5,4-5-foliat,5-12,9-15,abaxial,abaxially,absen,adaxiall,adaxially,aggregate,apart,articulated,axe,band,cell,color,cylindrical,deltate,denser,directed,distall,distally,eaf,eed,eglandular,flower,leaving,like,lon,long,lower,narrowed,narrowly,nflorescence,nther,obtuse,orolla,papillose,pedicellar,pore,projection,pseudohair,puberulent,puberulent-pubescen,rachi,radiu,remnant,ripe,roughened,ruit,scale-like,shrub,slightly,small,sometimes,spaced,stalked,stone,subapical,subcoriaceous,tal,tem,thickened,time,tip,triangular,truncat,unbranched,unit,vary,vein,whitish,wide,ympodial	adhesion,anther,arrangement,climate,colour,corolla,form,growth,height,history,inflorescence,leaf,length,life,midpoint,na,number,ovary,plant,position,presence,ray,reproduction,rugulose,seed,shape,size,staman,stipe,texture,truncate
468	wfo-0001029171	success	137	99	64	73	35	0.467	-15,0.5,1-3,1-4.5,1.5-2,1.5-7.5,10-25,2-3,3-4,3.5-18,3.5-6.5,4-10,4-5,5-6,5-8,7-9,acuminate,acute,angled,apex,base,blade,calyx,chartaceous,cm,cuneate,decurrent,densely,diameter,elliptic,entire,fruit,glabrous,glandular,globose,hair,lanceolate,lobe,margin,mm,moderately,orange,ovate-elliptic,pedicel,peduncle,petiole,puberulent,pubescent,purple,rarely,red,rugose,shrub,simple,slightly,smooth,sparsely,stellate,stigma,style,tube,white,x,yellow	-,-10,1-5,10-35,11-20,6-,8-17,abaxially,abruptly,absen,adaxially,aggregate,also,and/or,apart,articulated,axe,ba,branched,cell,connivent,cylindrical,deltate,dendritically,dense,directed,distall,eaf,eed,eglandular,except,flower,forked,gland,glandula,like,long,lower,many-foliat,midrib,narrowed,narrowly,near,nearly,nflorescence,nther,obtuse,often,orolla,perfect,pore,rachi,radiu,ripe,ruit,shoot,short-stalked,sometimes,spaced,ste,stone,tal,tem,time,tip,triangular,truncat,unbranched,unit,usually,vary,wide,ympodial	adhesion,anther,arrangement,climate,colour,corolla,form,growth,height,history,inflorescence,leaf,length,life,midpoint,na,number,ovary,perennial,plant,position,presence,pubescence,ray,reproduction,rugulose,seed,shape,size,staman,stem,stipe,surface,texture,truncate
469	wfo-0001029215	success	49	45	25	24	20	0.51	0.3-0.5,0.5-0.7,0.5-2.5,1,2.3-2.9,brown,calyx,cm,diameter,fide,hair-like,herb,long,mm,obovate,outgrowth,pubescent,shrub,silky,strong,surface,thick,weigend,wide,xyledecor	-1.8-2.3,.2,appearance,border,cell,coarse,eed,elongating,entire,fruit,give,lateral,lobe,markedly,narrowly,round,small,smelling,spreadin,tall,testa,wall,winged,woody	0.2,1.8-2.3,colour,form,growth,height,history,length,life,na,perennial,plant,reproduction,scent,seed,shape,size,spreading,texture,width
470	wfo-0001029216	success	243	112	84	159	28	0.346	0.2-0.4,0.4-0.5,0.5,0.6-1,1-1.2,1-2,1.2-6,1.5-2.3,1.5-2.5,10,10-14,2.5-3.3,20-35,3,acute,annual,anther,apex,attenuate,base,basiscopically,biennial,bright,brown,calyx,capitate,cm,conical,corolla,crenate,decurrent,deep,dentate,diameter,elliptic,fruit,glabrescent,glandular,globose,green,herb,imparipinnate,inflorescence,interrupted,length,less,like,lobe,long,mainly,margin,minute,minutely,mm,near,oblique,obovate,orange,ovary,ovate,pale,pedicel,peduncle,pentagonal,perennial,petiole,plant,present,pubescent,red,shape,sparsely,stem,stigma,style,surface,tangled,trichome,tube,uniseriate,usually,villous,wide,yellow	+,-0.5,-10,-5,.5,.8-1,0.1-0.3,0.1-0.5,0.1-0.6,0.1-0.8,0.2-0.25,0.2-0.3,0.2-0.8,0.3-0.4,0.3-0.5,0.3-2,0.4,0.5-0.8,0.5-1.5,0.5-2,0.6-0.8,0.8-2.5,1-3,1-4,1-6,1.5-3,1/,10-,2,2-4.5,2-locular,3-,3-4,3-5,3-7,3-foliate,4,5,5-15-flower,6-10,7-10,<,absen,absent,accrescent,acroscopically,adpressed,allogamous,always,and/or,angeld,anthesi,apical,appearance,appendage,articulated,articulation,axi,basal,becoming,branch,cell,cente,column,composed,cone,cordate,cultivar,deeply,distal,eaf,edicel,eed,entire,erect,exserted,extending,facultatively,fasciated,filament,fruited,fruiting,giving,gland-tipped,gree,hair-like,half,halfway,included,initially,interjected,internode,lanceolate,large,larger,later,lateral,leaflet,linear,lobulate,lon,longer,lower,maturity,mixture,multicellular,multilocular,narrowly,nflorescence,numerous,often,one,outgrowth,pair,particularly,petiolule,population,primary,procumbent,pseudostipule,rarely,reflexe,ruit,scen,secondary,sessile,shaggy,shaped,short,silky,simple,sometimes,somewhat,sparse,spreading,staminal,sterile,straight,strong,strongly,tem,terminal,tertiary,testa,thick,thickening,tip,total,toward,truncate,ud,unicellular,unit,variety,varying,viny,wall,winged,ympodial	3-10,adhesion,arrangement,blade,climate,colour,form,growth,hair,height,history,leaf,life,midpoint,na,number,position,presence,pubescence,ray,reproduction,rugulose,seed,size,staman,stellate,stipe,texture
471	wfo-0001029226	success	206	121	91	115	30	0.442	-7,-9,.5,0-1,0.5-5,1-1.5,1-3,2-6,2.5-10,3-3.5,4,5-7,7-11,8-13,acuminate,acute,anther,apex,base,berry,black,blue,bright,calyx,capitate,cm,connivent,cordate,corolla,dark,densely,diameter,ellipsoid,entire,flattened,glabrous,glandular,globose,growth,herbaceous,lateral,lavender,leaf,like,lobe,lobed,long,loosely,lyrate,margin,membranous,minutely,mm,occasionally,pale,pedicel,peduncle,perfect,petiole,pinnatifid,pitted,pubescent,red,reniform,ripe,seed,shiny,short-glandular,shrub,simple,sparsely,stellate,stem,stigma,style,surface,tan,terminal,thin,translucent,trichome,truncate,tube,uniformly,uniseriate,vine,weak,white,wide,woody,yellowish	.75,0.5,1-2,1-celled,10-40+,2,2-3,2-9,3-6,30,4-6,5-merou,>,ag,alyx,anthesi,apart,apparently,ark,articulated,ba,basal,branched,breaking,cell,completely,congested,conical,decurrent,deltate,distall,divided,dry,eaf,eed,elongate,enation,exserted,filament,flexuous,flower,free,fruiting,glabrescent,gland,green,hairy,ilament,irregularly,juice,lengthening,longer,lower,many,material,mature,mere,minute,new,nflorescence,often,older,one,open,orolla,overtopping,pair,papillat,papillate,papillo,per,pinnate,plurifoliat,pore,poricidal,portion,primary,reflexed,remainin,rim,ruit,sagittate,scar,scarlet,shorter,sleeve,slender,slit,small,sometimes,spaced,spot,sprawling,spreadin,spreading,staining,strongly,tangled,tem,testal,third,time,tip,twinin,ud,unit,usually,vary,vein,wall,way,widest,winged,ympodial,¾	adhesion,arrangement,blade,climate,colour,form,fruit,hair,height,history,inflorescence,length,life,midpoint,na,number,ovary,papillose,plant,position,presence,pubescence,ray,reproduction,rugulose,shape,size,staman,stipe,texture
472	wfo-0001029234	success	204	109	79	125	30	0.387	0-2,0.1-0.5,0.2-0.3,0.3-0.9,0.4-0.7,0.5-1,0.5-2,0.8-1.1,0.9-2.1,1-1.5,1.1-1.5,1.5-2.5,2-2.5,2-6,3-3.7,3-5,4-7.5,4-8,5-9.5,5.5-7,9-24,acute,anther,apex,base,blade,brown,calyx,capitate,chartaceous,cm,connivent,cuneate,diameter,entire,erect,flattened,fruit,glabrous,gland-tipped,glandular-puberulent,globose,hair,inflorescence,lanceolate,leaf-opposed,length,lobe,loosely,margin,midpoint,mm,moderately,narrowly,ovate,pale,pedicel,peduncle,perennial,petiole,present,pubescent,purple,ray,red,rhizomatous,rotate-stellate,short,shrub,simple,sparsely,stellate,stellate-pubescent,stigma,style,surface,tube,x,yellow	%,0-0.1,0-1,0-2.5,0-3,0-4,0-6,0.15-0.3,0.4-0.5,0.5-1.5,0.5-5,0.6-0.8,1-10,1-4,1-locular,1.5-2,11-23,18-24,2-3,20-,3-7,3-8,4-,4.7-7,5-merou,7-10,7-11,abaxially,absen,absent,accrescent,acicular,across,adaxiall,adaxially,adult,alyx,apart,apparen,articulated,attenuate,axe,ba,bilobe,branche,confined,cylindrical,dense,directed,distall,distally,dm,eaf,eed,eglandular,exocarp,few-,filament,finger,flower,fruiting,geminat,green,half,incomplete,juicy,lamina,lateral,less,long,longer,lower,markedly,mature,mesocarp,mid-point,midrib,midvein,minute,nflorescence,oblique,orolla,part,per,perfect,placenta,plurifoliate,pore,porrect,prickle,pseudo-racemose,rachi,rugose,ruit,seeded,septum,sessile,spaced,sparse,stage,stalk,stellae,straight,succulent,tal,tamen,tem,thick,thicker,thicknes,throughout,time,tip,toward,triangular,unarme,unarmed,unbranched,unit,unknow,uvenile,vary,white,wide,ympodial	adhesion,arrangement,bilobed,climate,colour,corolla,form,glandular,growth,height,history,leaf,life,na,number,ovary,plant,position,presence,pubescence,reproduction,rugulose,seed,shape,size,staman,stem,stipe,texture,unknown
473	wfo-0001029236	success	159	118	85	74	33	0.535	.5,0.2-0.7,0.2-1,0.45-0.5,0.5,0.9-2.3,1-1.5,1-2,1.4-1.7,1/2,3,6-9,abaxially,absent,adaxial,age,anther,anthesi,apex,apical,apically,base,becoming,calyx,cm,coriaceous,corolla,cupulate,dendritic,densely,diameter,elliptic,except,flattened,fleshy,free,fruit,glabrous,globose,grey-brown,growth,leaf,lenticular,lobe,lobed,margin,midvein,minutely,mm,narrowly,near,obscurely,occasionally,ovary,pale,pedicel,pericarp,petiole,pitted,pointed,pore,poricidal,pubescent,purplish-black,reddish-brown,revolute,scattered,short,shrub,slightly,slit-like,stem,stigma,strongly,style,surface,terminal,thin,tip,trichome,tube,usually,violet,way,x	0.5-1.5,2-4,2-5,apparently,appearing,axi,ba,bark,basal,berry,bi-lobe,branch,branching,branchlet,broadly,compact,completely,conical,decurrent,deflexed,deltate,dichasial,eaf,edicel,eed,erect,ew,exserted,filament,flower,fruiting,inserted,later,lateral,less,long,lower,m.,many,middle,nflorescence,nodding,obscure,older,overtopping,packe,per,persistent,plurifoliate,portion,prominent,purplish,ruit,scar,secondary,shiny,shoot,simple,sleeve,sparsely,stamen,tall,tapering,time,trongly,tub,ud,unit,venation,wide,winged,woody,ympodial,young	adhesion,arrangement,bi-lobed,blade,climate,colour,form,glandular,hair,height,history,inflorescence,length,life,midpoint,na,number,peduncle,perennial,plant,position,presence,pubescence,ray,reproduction,rugulose,seed,shape,size,staman,stellate,stipe,texture
474	wfo-0001029244	success	233	127	101	132	26	0.433	0-0.5,0-2,0-2.5,0.15-0.25,0.2-0.3,0.4-0.7,1-4,1.4-6,1.5-2.5,1.8-3.5,2-3,2-4,2.5-3.6,22-31,3-10,4-5.5,4-7,5-7,6-12,6-8,9-25,absent,acuminate,acute,adaxially,andromonoecious,anther,apex,base,blade,brown,calyx,chartaceous,cm,connivent,cuneate,cylindrical,densely,diameter,elliptic,entire,erect,extra-axillary,flower,fruit,gland-tipped,globose,green,hair,inflorescence,juicy,lanceolate,lateral,leaf,length,lilac,lobe,lobed,long,loosely,margin,midpoint,mm,moist,obovate,obtuse,occasionally,orange,ovate,pale,pedicel,peduncle,perennial,petiole,plant,present,purple,ray,red,reniform,rhizomatous,rusty,shallowly,short,shrub,simple,sparsely,stellate,stellate-pubescent,stigma,style,summit,surface,thick,throughout,time,toward,tube,weakly,x,yellow	%,0-0.2,0-0.3,0-1,0-16,0-55,0-80,0-9,0.2-0.25,0.2-0.5,0.25-0.4,0.5-2,0.8-5,1-1.5,1-2,1.1-1.8,10-18,100-150,12-25,2-12,2-foliate,2-locular,2.1-3.2,3-5,3-7,3-7.5,3-8,4.7-5,5-10,5-merou,6-9,7-10,7-12,7-30,7-9,8-10,9-16,90-200,abaxially,absen,accrescent,acicular,across,adaxiall,adult,alyx,anvil-shape,apart,apiculate,articulated,axe,ba,branch,branche,capitat,confined,contiguous,cross-section,decimetre,deltate,directed,distall,distally,distributed,dm,eaf,eed,eglandular,especially,exocarp,filament,finger,flattened,fruiting,functional,geminat,half,hetereostylous,juvenile,lamina,less,longer,lower,markedly,mature,mesocarp,mid-point,midrib,midvein,minute,minutely,moderately,narrowly,nearly,nflorescence,oblique,orolla,pair,part,per,placenta,pore,porrect,prickle,rachi,rostrate,rugose,ruit,scarcely,sessile,side,sometimes,spaced,stalked,stellae,straight,tal,tamen,tem,thicker,tip,transparent,triangular,unarme,unarmed,unbranched,unit,upper,vary,vein,wide,ympodial	adhesion,arrangement,capitate,climate,colour,corolla,form,glandular,growth,height,history,life,na,number,ovary,position,presence,pubescence,reproduction,rugulose,seed,shape,size,staman,stem,texture
475	wfo-0001029246	success	209	112	82	127	30	0.392	-1.5,0.1-0.4,0.3-0.5,0.7-1.3,0.7-2,0.8-1.1,0.8-3,0.9-1.3,1.5-2.3,1.5-2.5,1.7-6,1/3,2,2.5-3.2,2.8-4,3.5-5,4-6,6-8,7-12,abaxially,acuminate,acute,anther,apex,base,berry,blade,calyx,chartaceous,cm,connivent,cuneate,diameter,dull,elliptic,entire,flattened-reniform,fruit,glabrescent,glabrous,lateral,leaf,length,less,lobe,lobed,long,margin,maturity,mauve,midpoint,midvein,mm,moderately,obtuse,orange-brown,orange-red,pale,pedicel,peduncle,petiole,poricidal,purple,ray,shrub,simple,smooth,sometimes,sparsely,spherical,stellate,stellate-pubescent,stem,style,tapering,tip,tube,upper,white,wide,yellow,yellow-orange	-1,-4,/5,0,0-15,0-5,0.1-0.3,0.15-0.3,0.2-1.5,0.3-0.8,0.5,0.5-1.5,0.7-1.5,1-1.5,1-1.8,1-10,1-3,1-4,1-5,1-8,1.2-2,1.5-6,1.8-3,1/10-1/5,2-3,2-3.5,2-5,2/3,2/3-3/,3-20,3-5,5-,5-20,5-merous,6-10,8-16,abaxial,acuminat,adaxial,almost,alyx,apar,apart,apically,apparently,articulated,bark,broad-deltate,c.,concolorous,curved,deltate,densely,discolorous,distance,drying,eaf,eed,elongating,equal,erect,extending,eye,filament,flattened,flower,free,fruiting,infructescence,lon,longer,lower,mature,naked,narrow-deltate,narrow-ovate,nflorescence,oblong,older,one,open,orange-brow,orolla,oung,pair,pendulous,per,perfec,pericarp,plurifoliat,porrect,portion,prickl,prickle,prickly,primary,procumbent,pubescent,recurved,rounded,ruit,scar,sessile,side,spaced,spreading,stout,straight,strongly,surface,tamen,terete,tertiary,time,trichome,unarmed,unbranched,unit,usually,vary,vein,venation,visible,way,woody,ympodial,¼	adhesion,arrangement,climate,colour,corolla,form,glandular,growth,hair,height,history,inflorescence,life,na,number,ovary,perennial,plant,position,presence,present,pubescence,reproduction,seed,shape,size,staman,stigma,stipe,texture
476	wfo-0001029263	success	211	130	100	111	30	0.474	0-2.5,0-5,0.3-1,0.5-1,0.6-1.5,1.2-2.5,1/2,10-35,12-35,2-3,2.2-3.2,2.8-3.8,3-5,3.5-5,4-10,4-6,4-7,6-20,6-30,almost,andromonoecious,anther,apex,attenuate,base,berry,black,blade,calyx,cell,chartaceous,cm,connivent,corolla,cream,cultivar,cuneate,dark,deep,diameter,dull,elliptic,entire,equal,evenly,flattened-reniform,flower,fruit,glabrous,glandular,green,hair,herb,lateral,leaf,length,lobe,lobed,long,long-styled,margin,marking,maturity,mauve,minute,mm,obtuse,often,orange,orange-brown,outline,pale,pedicel,peduncle,petiole,pit,plant,poricidal,purple,raised,rotate,short-styled,simple,small,smooth,sometimes,spherical,stem,style,surface,tapering,tearing,tip,tube,upper,usually,white,wide,yellow,young	-2,0-100,0.5-1.5,1,1-10,1-4,1-7,1/3-2/3,1/3-3/4,1/4-1/3,1/6,10-20,2-4,30-60,5-10,5-8,5-merous,7-10,acute,alyx,apar,apically,apparently,articulated,ba,bark,becoming,broad,broad-deltate,concolorous,curved,decurren,deltate,difoliate,distal,distance,drying,eaf,eed,elongating,erect,extending,extensive,filament,foliaceou,free,fruiting,fully,geminat,glabrescent,hermaphrodite,heterostylous,infructescence,less,lobing,long-acuminat,longer,lower,lowermost,mature,midvein,near,nflorescence,older,one,onl,open,opening,orolla,oung,ovoi,pair,part,pendulous,per,pericarp,portion,primary,red-brown,reddi,reflexed,rounded,ruit,scar,secondary,side,spaced,sparsely,spreading,staminat,stellate-pubescent,stout,straight,tamen,terete,tertiary,time,trichome,ud,unarme,unarmed,unbranched,unit,vary,vein,venation,visible,way,wider,woody,ympodial	adhesion,arrangement,climate,colour,form,growth,height,history,inflorescence,life,midpoint,na,number,ovary,perennial,position,presence,pubescence,ray,reddish,reproduction,rugulose,seed,shape,size,staman,stellate,stigma,stipe,texture
477	wfo-0001029286	success	224	103	74	150	29	0.33	.5,0.8,1-1.5,1-2,1.5-2,1.5-4,1/8,2.5-3,3-4,4-5,4.5,4.5-7,5,5-6,6-8,6-9,7-10,acute,almost,anther,anthesi,apex,apiculate,attenuate,base,broadly,brown,capitate,chartaceous,clustered,cm,conical,corolla,diameter,drying,entire,free,glabrescent,glabrous,green,grey,hair,inside,leaf,length,less,liana,light,lilac,lobe,lobed,long,margin,mauve,membranous,minutely,mm,oblong,obovate,outside,pedicel,peduncle,petiole,slender,stem,stigma,style,surface,terminal,tube,unarmed,wide,x,yellowish	.4,0-0.5,0.1,0.15-0.4,0.4-1.2,0.6-1.2,0°,1.5-8,15-50,2-3,4-6,abaxial,abaxially,abscising,adaxially,age,along,altered,alyx,another,apar,apart,apically,apice,apparently,arising,around,articulated,articulation,axil,bark,becoming,branch,branched,branching,canaliculate,clearly,closer,concave,concolorous,crenulate,curved,cuspidate,delineated,deltoid,dendritic,density,dilated,distributed,domatia,eaf,eed,equal,except,extending,faint,fertilization,filament,flat,flexuous,flower,formed,forming,fresh,globo,increasing,inflorescenc,isolated,junction,know,known,lamina,lengthening,lower,m.,main,margi,mas,meeting,middle,midvein,much,multicellular,narrowly,nflorescence,nther,obconical,occasional,often,one,orolla,ovate,pair,papillo,perfec,plurifoliat,pore,poricidal,portion,primary,prominent,protruding,rachi,raised,rarely,regular,rounded,ruit,scar,separated,shallowly,side,simple,smaller,smooth,sometimes,somewhat,soon,sparsely,specimen,spreading,stretchy,stump,tangled,tearing,terete,tertiary,textur,thick,thickened,thinner,time,tip,tissue,together,toward,translucent,translucent-violet,trichome,tuft,ud,uneven,unit,vary,vein,venation,visible,widely,ympodial,young	adhesion,arrangement,blade,calyx,climate,colour,form,fruit,glandular,growth,inflorescence,midpoint,na,number,ovary,papillose,position,presence,pubescence,ray,rugulose,seed,shape,size,staman,stellate,stipe,texture,ye
478	wfo-0001029289	success	292	151	125	167	26	0.428	.2,.5,0.4-1.1,0.4-2,0.5-1,0.5-1.2,1-2,1-2.5,1.2,1.5-4,1.5-5,1/6-1/3,12,1mm,2-3,2.5,2.5-4,25,3-7,4-9,4.5,5-20,6-12,acuminate,acute,almost,along,always,anther,anthesi,apex,apparently,attenuate,base,berry,black,branch,broadly,brown,calyx,capitate,chartaceous,clavate,close,cm,collapsing,conical,corolla,cuneate,deeply,dendritic,developing,development,diameter,distributed,drying,elongated,entire,evenly,finely,flattened,free,glabrescent,glabrous,green,hair,half,honeycomb,inside,leaf,length,liana,lobe,lobed,lower,margin,maturity,midvein,mm,oblong,obovate,one,orange,outline,outside,pale,pattern,pedicel,peduncle,petiole,pit,pitted,puberulous,pubescent,rarely,reddish,reniform,reveal,seed,shape,side,size,sometimes,somewhat,spheroidal,stem,stigma,style,surface,terminal,thick,thin,thin-coriaceous,together,trichome,truncate,tube,undulate,usually,violet,white,x,yellow,yellowish,young	.05,0-2,0.15-0.25,0.2-1.5,0.4-1,0.5,0.5-0.7,1-1.2,1-4,1.5-2,100,15,15-45,3,5-12,60-90°,8,abaxially,accrescent,adaxial,adaxially,age,alyx,apar,apically,apice,appendage,arachnoid,arising,aristate,around,articulated,articulation,bark,becoming,boundary,branched,branching,canaliculate,clear,clearly,complex-dendritic,complexity,concolorous,covering,crenulate,cupular,curved,cuspidate,delineated,deltoid,dense,detaching,dilated,discolorous,domatia,dorsally,eaf,eed,ellipsoi,equal,erect,eye,faint,fertilisation,filament,flexuous,flower,forming,found,fruiting,globose,hard,indumentum,inner,irregular,lamina,leave,lengthening,less,light-coloured,line,linear,long,longitudinally,loop,m.,main,margi,may,middle,minute,minutely,mixture,multicellular,naked,narrowly,nflorescence,nther,obconical,often,orolla,outer,pair,papillae,papillo,papillose,pendulous,perfec,pericarp,pili,plurifoliat,point,pointed,pore,poricidal,portion,primary,prominent,pronounced,protruding,rachi,raised,ridged,rising,rounded,ruit,scar,see,shallow,shallowly,shiny,short,simple,sinus,slightly,smooth,soon,sparse,sparsely,spreading,straight,strongly,stump,sturdy,sunken,tearing,terete,tertiary,thickened,time,tip,toward,tuft,ud,unarmed,unicellular,unit,variable,various,vary,vein,venation,visible,wide,widely,ympodial	adhesion,arrangement,blade,climate,colour,form,fruit,glandular,growth,height,inflorescence,midpoint,na,number,ovary,plant,position,presence,pubescence,ray,reproduction,rugulose,staman,stellate,stipe,texture
479	wfo-0001029295	success	191	121	90	101	31	0.471	-5,-9,.5,0.5,0.7-1,1-1.5,1.2-3.5,2-3,2.5-3.5,2.5-6,2/3,3/4,4-4.5,5-6,6-8,<,acuminate,acute,along,anther,anthesi,apex,attenuate,base,berry,calyx,capitate,cm,corolla,diameter,drying,elliptic,entire,fide,fruit,glabrescent,glabrous,globose,green,grey,height,herb,internodal,lateral,leaf,length,lobe,lobed,margin,membranous,midrib,minutely,mm,obtusely,ovary,ovoid,pale,pedicel,peduncle,petiole,pitted,pointed,prolonged,purple,red,reniform,rhomboidal,ripe,scattered,shallowly,shrub,simple,sinuate,slightly,small,stem,stigma,style,surface,tan,thin,tip,trichome,tube,uniseriate,urban,way,whitish,x,yellowish	0,1,2,2-4,4-5-celled,4-6,4-merous,?,abaxial,apparently,appearing,articulated,bark,become,cell,closely,continuous,crystal,cup-shaped,dark,deciduous,defined,defoliate,dense,distal,eaf,eed,ellipsoid,elongate,erect,essentially,exserted,filament,flower,free,fruiting,geminat,glabrou,half,irregular,known,lamina,lengthen,lobe-lik,long,lower,minute,narrowly,nflorescence,nodding,older,opening,orientation,outline,pair,papillat,papillate,peduncl,peelin,pentagonal,per,perfect,pericarp,pore,portion,primary,puberulent,pubescent,rim,rooting,rounded,ruit,sand,scar,seen,sessile,short,slit,soon,spaced,sparsely,splitting,sprawling,strongly,testal,tissue,top,ud,unarmed,undulation,unifoliate,unit,upper,usually,vein,widest,wing,wiry,woody,ympodial,young	adhesion,arrangement,blade,climate,colour,form,glandular,growth,hair,history,inflorescence,life,midpoint,na,number,perennial,plant,position,presence,pubescence,ray,reproduction,rugulose,seed,shape,size,staman,stellate,stipe,texture,unknown
480	wfo-0001029299	success	201	104	81	120	23	0.403	0.5-1.5,1-2,1-4,10-21,16-28.6,2.3-3.3,3-12,3-4.5,3-5,3-7.5,4-10,4-16,5-15,7-8,8.5-19,abaxially,adaxially,along,anther,axillary,broadly,brownish,bud,chartaceous,clavate,cm,condition,corolla,dense,diameter,drying,elliptic,especially,fresh,fruit,glabrous,glandular,green,greenish,hair,herb,lanceolate,leaf,like,lobe,medium,membranous,midrib,minutely,mm,moderately,mottled,multicellular,non-glandular,odd-pinnate,ovate,ovoid,pedicel,peduncle,pentagonal,petiole,plant,puberulent,pubescence,pubescent,purple,rotate,seed,size,slightly,stem,stigma,style,subtending,terminal,trichome,tube,white,whitish,x,yellow	0-3,0-5,1-10,1.6-5,10-16,2-4,3,3-13,3.5-7.5,5-merou,6-5-15.3,acumen,acuminate,acute,ag,alyx,apart,apex,apparently,articulated,attenuate,axe,base,blade,borne,capitat,cell,ciliate,connate,cordate,covering,cuneate,decreasing,decurrent,digestion,distal,dorsally,eaf,edge,eed,end,enzyme,erec,exceeding,filament,flat,flower,folded,forked,geminat,generally,grading,gradually,green-white,hair-like,half,homostylous,honeycomb-shaped,interjected,invested,lateral,leaflet,lengthening,living,long,lower,make,margin,middl,mucilaginous,nflorescence,oblique,orbicular,orolla,pair,perfect,petiolulate,petiolule,plurifoliate,pore,poricidal,removed,rounded,ruit,sessile,seudostipule,shallowly,short,singly,slit,spaced,specimen,spreading,stamen,ste,stolo,straight,subsessile,tall,tamen,tem,testal,thick,throughout,tip,tissue,toward,tri-,truncate,tuber,typically,unit,unknow,usually,vary,wall,wet,wide,wing,ympodial	adhesion,arrangement,calyx,capitate,colour,form,growth,height,history,inflorescence,length,life,na,ovary,perennial,position,pseudostipule,reproduction,rugulose,shape,staman,surface,texture
481	wfo-0001029308	success	221	114	89	132	25	0.403	0.2-0.3,0.2-1.5,0.4-0.7,1-5,1.5-2.5,1.5-2.7,1.5-4,2-6,2.5-3,2.7-3.1,3-4,3.5-4.5,4-15,4-8,6-8,7-8,9-18,absent,acuminate,acute,adaxially,andromonoecious,anther,apex,base,blade,brown,calyx,chartaceous,cm,connivent,cuneate,cylindrical,densely,diameter,eglandular,elliptical,entire,erect,extra-axillary,flattened,fruit,glabrous,globose,hair,inflorescence,lanceolate,leaf,length,lilac,lobe,lobed,long,loosely,margin,midpoint,minutely,mm,ovate,pale,pedicel,peduncle,perennial,petiole,plant,present,purple,ray,reticulate,rhizomatous,rotate-stellate,rusty,seed,shallowly,shrub,simple,sparsely,stellate,stellate-pubescent,stigma,style,surface,throughout,toward,tube,weakly,x,yellow,yellowish-green	%,0-10,0-25,0-4.5,0.05-0.3,0.25-0.3,0.25-0.35,0.25-0.4,0.25-1,1,1-4,1.2-2.5,1.5-3,1.5-5.5,168,19-30,1981,2-5,2-foliate,2-locular,2.2-2.7,20-40,3-6,30-50,4-5,4-6,4.3-15,4.5-6,5-merou,6-11,6-18,7-10,8-19,9.5-28,abaxially,absen,acicular,across,adaxiall,adult,alyx,anvil-shape,apart,articulated,axe,ba,branch,branche,broad-based,broadly,capitat,confined,counted,cross-section,decimetre,deltate,directed,distall,distributed,dm,eaf,eed,elliptic,exocarp,finger,flower,fruiting,functional,furrowed,geminat,gland-tipped,green,half,heterostylous,interpetalar,juicy,juvenile,lamina,lateral,less,longer,lower,margi,mature,mesocarp,mid-point,midrib,midvein,minute,moderately,moist,nearly,nflorescence,oblique,one,orolla,pair,part,per,placenta,pore,porrect,prickle,rachi,ruit,sessile,short,side,spaced,stalked,star,stellae,straight,tal,tamen,tem,thick,thickened,time,tissue,triangular,unarme,unarmed,unbranched,unit,upper,vary,vein,wide,yellowish,ymon,ympodial	adhesion,arrangement,capitate,climate,colour,corolla,form,glandular,growth,height,history,life,na,number,ovary,position,presence,pubescence,reproduction,rugulose,shape,size,staman,stem,texture
482	wfo-0001029310	success	216	114	86	130	28	0.398	-16,-25,0.2-0.3,0.6-1.1,1-1.5,1.2-1.5,1.8-3,10-13,10-15,15-20,2-3.5,2-4,3-4,3.5,4-8,5-12,5-6,5-7,6-8,7-12,8,abaxially,acute,andromonoecious,anther,apex,base,berry,blade,brown,calyx,cm,connivent,cordate,dark,deltate,diameter,dull,elliptic,equal,flattened-reniform,flower,fruit,glabrescent,hair,herb,lateral,leaf,length,lobe,lobed,long,long-styled,margin,maturity,mauve,membranous,midpoint,mm,ornately,pedicel,peduncle,petiole,pinnatifid,plant,poricidal,ray,short-styled,shrub,simple,smooth,sparsely,spherical,spreading,stellate,stellate-pubescent,stem,style,surface,tapering,tip,toward,truncate,tube,wide,yellow	.1,.5,.6,/4,/6,0-20,0-5,0.1-0.2,0.2-0.8,0.5,0.5-3,00,1,1-2,1-4,1/,10,10-20,2.5-6,2/3-3/4,20-40,20-60,200-500,3-5,4-10,45-60,5,5-10,5-20,5-30,5-8,5-merous,7-13,accrescent,alyx,ame,apar,apart,apically,apparently,articulated,bark,beyond,branched,c.,concolorous,conical,difoliate,distal,distance,drying,eaf,eed,elongating,enclosing,erect,extending,filament,filifor,free,fruiting,geminat,gently,glabrous,gray,hermaphrodite,heterostylous,inflated,infructescence,lobing,lon,longer,lower,lowermost,mature,midvein,minute,moderately,narrow-deltate,nflorescence,older,one,open,orange-green,orolla,oung,pair,pendent,pendulous,per,pericarp,perpendicular,porrect,portion,prickl,prickle,prickly,primary,recurved,red-brow,retrorse,ruit,scar,secondary,sessile,shorter,side,sometimes,spaced,stalk,stalked,staminat,stout,straight,strongly,tamen,terete,tertiary,time,tissue,trichome,unit,variously,vary,vein,venation,visible,way,woody,ympodial	adhesion,arrangement,climate,colour,corolla,form,glandular,growth,height,history,inflorescence,life,na,number,ovary,perennial,position,presence,present,pubescence,reproduction,seed,shape,size,staman,stigma,stipe,texture
483	wfo-0001029317	success	151	84	53	98	31	0.351	0.5,0.5-0.75,0.5-1,0.8-1,1,1-1.5,10-16,2-3,2.5-5,7-8,8-9,anther,area,base,ca,calyx,cm,corolla,densely,glabrous,grayish,inflorescence,leaf,lobe,lobed,long,minutely,mm,narrowly,nearly,opposite,ovary,ovate,paler,papillose,pedicel,petiole,pubescent,shaped,shrub,size,slightly,sparsely,stem,stigma,style,tear-drop,thickened,trichome,tube,uniseriate,white,x	.5,0.25,1.5-3.5,10-30-flowered,11-14,6-8,6.5-11,acuminate,along,anthesi,apar,apex,attenuate,barely,beneath,broadly,brow,bud,channeled,closely,cup-like,deciduou,deflexed,deltoid,denser,dia,differing,difoliate,dry,eaf,edicel,eed,ellipsoi,epidermi,erect,exserted,extreme,filament,free,frui,fruiting,geminate,glabrate,globose,immature,known,lateral,like,lon,lower,main,major,margin,middle,minor,nflorescence,occasionally,often,older,one,otherwise,overlapping,ovoid,pair,pore,poricidal,portion,probably,prominent,proximal,rachi,raised,reflexed,remaining,rest,rounded,ruit,scar,simple,slender,soft,soon,spaced,specimen,straight,styl,tall,tapering,tip,tuft,ud,unit,vein,visible,widest,yellowish,ympodial,young	2,5,adhesion,arrangement,brown,colour,diameter,form,fruit,growth,height,history,length,life,na,number,peduncle,perennial,plant,position,presence,pubescence,ray,reproduction,rugulose,seed,shape,staman,stellate,surface,texture
484	wfo-0001029332	success	197	100	75	122	25	0.381	0-5,0.1,0.1-0.2,0.15-0.2,0.5-1,1-2,1-4,1.3-1.5,1.5-2,1/2,2,2-2.5,2.5-3.5,2.8-3.7,3-4,3-6,3.5-5,5-8,6-8,8.5-9.5,abaxially,anther,apex,base,berry,blade,calyx,chartaceous,cm,connivent,cordate,densely,diameter,equal,erect,flattened-reniform,fruit,glabrescent,glabrous,lateral,leaf,length,less,lobe,lobed,long,margin,maturity,mauve,midpoint,mm,moderately,orange-brown,ovate,pedicel,peduncle,petiole,plant,ray,rounded,scandent,shorter,shrub,spherical,spreading,stellate,stellate-pubescent,stem,style,terminal,tube,upper,weakly,wide,yellow	-5,.5,/3,0,0-0.5,0-100,0-2,0-20,0-4,0.15-0.25,0.8-1,1-1.5,1-3,1/3,1/4,1/4-1/3,10-30,2-4,2/,2/3-3/4,4-10,4-15,5-6,5-merous,abaxial,adaxial,alyx,andromonoecious,apar,apart,apically,apparently,articulated,bark,becoming,broad-deltate,concolorous,conical,curved,difoliate,distal,distance,drying,eaf,eed,elongating,extending,filament,flattened,flower,free,fruiting,geminat,gland,globular,grayi,herbaceous,hermaphrodite,heterostylous,infructescence,long-acuminat,long-styled,longer,lower,lowermost,mature,midvein,narrow-deltate,nflorescence,often,older,one,open,orolla,oung,pair,pale,pendulous,per,pericarp,poricidal,porrect,portion,prickl,prickle,prickly,primary,pubescent,reduced,ruit,scar,sessile,short-styled,side,simple,slender,smooth,spaced,stalk,stalked,staminat,subsessile,surface,tamen,tapering,terete,tertiary,time,tip,trichome,unbranched,unit,variously,vary,vein,venation,visible,way,woody,yellow-green,yellow-orange,ympodial	8,adhesion,climate,colour,corolla,form,glandular,growth,hair,height,inflorescence,na,number,ovary,position,presence,pubescence,seed,shape,size,staman,stigma,stipe,texture,ye
485	wfo-0001029333	success	155	93	67	88	26	0.432	.5,/4,0.5,0.7-1,1-1.2,1-1.5,1-15,1-3,1-7,1.5-2.5,1.5-3,17-26,2-2.5,5-6,8-15,abaxially,adaxially,anther,apex,base,calyx,clavate,cm,corolla,dendritic,dendritic-pubescent,densely,dia,elliptic-obovate,flattened-reniform,glabrous,globose,green,leaf,lobe,lobed,long,long-styled,minutely,mm,obovate,opposite,ovary,pale,pedicel,petiole,pitted,pubescence,pubescent,reddish-brown,shape,shaped,shining,short-styled,shrub,size,small,stem,stigma,style,surface,tear-drop,tree,trichome,tube,way,wide	.25,0.5-1,1-2,1.5-2,10-15-flowered,100,3-7,3-7.5,9-13,abaxial,acuminate,acute,along,anisophyllou,anthesi,auriculate,ba,bark,beige,beneath,berry,broadly,conical,contracted,deflexed,denser,differing,difoliate,dry,eaf,edicel,eed,erect,exserted,filament,flower,free,fresh,fruiting,geminate,golden,heteromorphic,incrassate,inflorescenc,lateral,like,lon,lower,main,major,margin,minor,nflorescence,occasionally,older,orbicular,overlappin,pair,paler,papillo,planar,pore,poricidal,portion,present,rest,rounded,ruit,scar,sessile,simple,slender,somewhat,spaced,sparsely,strongly,tall,time,tip,triangular,truncate,type,ud,unit,vein,woody,ympodial,young	adhesion,arrangement,colour,diameter,form,fruit,growth,height,history,inflorescence,length,life,na,number,peduncle,perennial,plant,position,presence,ray,reproduction,rugulose,seed,staman,stellate,texture
486	wfo-0001029334	success	211	92	70	141	22	0.332	0.15-0.3,1,1-2,1-3,1-6,1.3-4.5,1.5-6,1.8-2.9,2-2.5,2.5-3,3-7,4-5.5,4-8.5,5-10,7.5-15.5,8-30,9-12,abaxially,adaxially,almost,anther,brownish,chartaceous,clavate,cm,condition,corolla,densely,diameter,drying,fresh,fruit,glabrous,globose,green,greenish,herb,lanceolate,lobe,long,membranous,minutely,mm,odd-pinnate,orbicular,ovate,ovoid,pedicel,peduncle,petiole,plant,puberulent,pubescent,pure,ripe,seed,size,stellate,stem,stigma,style,terminal,tinged,tube,violet,white,whitish,wide,x,yellow	.2,0-4,1-10,1.5-3.9,2,2-4,2-5,2-8,3-5,3.2-5.8,3.3-6.5,5-merou,absent,acumen,acute,ag,along,alyx,among,apart,apex,apparently,articulated,attenuate,axe,axillary,base,berry,blade,borne,broadly,bud,capitat,cell,ciliate,connivent,cordate,covering,cuneate,decreasing,decurrent,digestion,distal,dorsally,eaf,edge,eed,elliptic,end,enzyme,erect,especially,exceeding,except,filament,flat,flower,folded,forked,geminat,generally,glabrou,gradually,grassland,greatly,green-white,hair,hair-like,half,homostylous,honeycomb-shaped,interjected,lateral,leaflet,lengthening,like,living,low-growin,lower,make,margin,middl,midrib,mucilaginous,narrowly,nflorescence,oblique,obtuse,often,orolla,pair,perfect,petiolulate,petiolule,plurifoliate,pore,poricidal,proximal,rarely,reduced,removed,rounded,ruit,semi-rosette,sessile,seudostipule,shady,short,singly,situation,slightly,slit,spaced,specimen,stamen,ste,stolo,straight,subequal,subsessile,subtending,sunny,tall,tamen,tem,testal,thick,throughout,tip,toward,tri-,tuber,typically,unit,unwinged,usually,vary,wall,wet,woodland,ympodial	adhesion,arrangement,calyx,capitate,colour,form,growth,height,history,inflorescence,leaf,length,life,na,ovary,perennial,position,pubescence,reproduction,shape,staman,texture
487	wfo-0001029340	success	286	114	73	213	41	0.255	1-2,2,4,abruptly,acute,anther,apex,base,blade,bluish,bright,brown,calyx,capitate,cm,conical,connivent,cordate,curved,densely,depressed-spherical,diameter,expanded,flattened-reniform,fruit,glabrous,gland,glandular,green,hair,lateral,leaf,lobe,lobed,long,margin,midpoint,minute,mm,narrowed,orange-yellow,pale,pedicel,peduncle,petiole,pilose,purple,ray,shiny,shrub,simple,size,soft,soft-pilose,somewhat,spherical,spreading,spreading-pilose,stellate,stem,stigma,stipitate,style,suborbicular,surface,thin-textured,tinged,tough,tube,variously,wide,yellow,yellowish	'',-celled,.05,.2,.2–1.6,0,0.15–0.6,0.2–0.5,0.4,0.5,0.5–2,0.5–2.5,0.8–3.2,0–,1,1.2–2.0,1.2–2.2,1.4–1.8,1.5-3,1/2,1/4,10,100,13–15,1–,1–1.2,1–2,1–2-celled,2.5,20,2–10,2–2.2,2–3,2–3.2,2–5-celled,2–8,3,3.5–5.5,3–3.5,3–5-celled,3–5.3,3–6-celled,3–7,4–4.5,4–8,5,5-merous,5°,5–12,8–12.5,8–17,9–20,>,``,abaxial,abaxially,absent,acicular,adaxial,age,almost,alyx,angle,anthesi,apical,apicall,armed,around,articulated,ba,basal,becoming,berry,bilobed,branched,broad-based,coarse,column,compressed,concentrated,curving,cylindrical,darker,developin,difoliate,directed,duller,eaf,eed,elongate,embedded,equal,evenly,exceeding,exceptionally,expanding,extending,falling,fertile,filament,flower,foveolate,free,frui,fruiting,geminat,geminate,gland-tipped,glandular-puberulent,grading,gradually,greater,greenish,held,heterostylous,hyaline,infructescence,irregularly,lanceolate,larger,largest,less,light,like,linea,lon,long-styled,lower,lowermost,main,major,many,mature,maturity,mesocarp,midrib,minutely,mixture,mostly,much,narrowly,near,nearly,nflorescence,nipple,occasionally,often,one,orange,orolla,oung,ovoid,pair,papillat,per,pericarp,perpendicular,pore,poricidal,portion,prickle,prickly,pulp,rarely,recurved,reflexed,ruit,secondary,senescent,sessile,sharp,short,short-styled,shorter,shrivelling,similar,single,slightly,small,smaller,smooth,soon,sparsely,spongy,ste,stipitate-glandular,stout,straight,strongly,tall,tamen,tapering,terete,thin,tip,tooth,triangular,trichome,twice,two,unarme,unarmed,unbranched,uniseriate,unit,usually,vary,vein,viciously,way,white,whole,ympodial	0.2-0.5,0.5-2,12,3-3.5,3-5.3,3.5-5.5,4-4.5,4-8,5-12,8-12.5,8-17,9-20,adhesion,arrangement,climate,colour,corolla,form,growth,height,history,inflorescence,length,life,na,number,ovary,perennial,plant,position,presence,present,pubescence,reproduction,rugulose,seed,shape,staman,stipe,texture,unknown
488	wfo-0001029344	success	147	101	70	77	31	0.476	0.4-1,0.5-1,0.5-1.5,0.5-3,1,1-3,1-6,1.5,1.5-3,1.5-4,10-20,2-4,2-7,3-10,4-6,5-12,5-15,absent,acute,anther,apex,base,brown,calyx,chartaceous,ciliate,cm,densely,diameter,dm,drying,elliptic,elliptic-ovoid,entire,filament,flower,fruit,glabrous,globose,hair,herb,immature,lobe,margin,maturing,membranaceous,mm,moderately,nearly,oblong,obtuse,one-,pedicel,peduncle,petiole,pubescent,rotate,rounded,semitransparent,sparsely,stigma,straight,style,surface,tube,two-celled,unbranched,white,x,yellow	.5,1-2,1-5,10-35,2-3,2-3-celled,abaxially,abundant,adaxiall,adaxially,along,axe,berry,beyond,blade,center,connected,cordate,decurrent,dehiscing,denser,difoliate,eaf,edge,eed,emarginat,equal,explosively,exserted,fine,flat,frui,geminat,held,interpetalar,lacking,linear-lanceolate,long,lower,lying,maturit,mesocarp,nflorescence,notch,obvious,often,orolla,parallel,per,placenta,pressure,pubescen,rachi,radiating,raised,rhizomatous,ridge,ruit,running,shallow,short,slightly,sometimes,stamen,swollen,tal,tamen,tem,tissue,triangular,unit,vary,vein,watery,wid,woody,ympodial	2.5,abaxial,adaxial,arrangement,colour,corolla,form,geminate,growth,height,history,inflorescence,leaf,length,life,na,ovary,perennial,plant,position,pubescence,reproduction,rugulose,seed,shape,size,staman,stem,texture,type,ye
489	wfo-0001029363	success	152	94	71	81	23	0.467	.25,/4,0.1-0.5,0.2-1.1,0.5-1,1-1.2,1.5-3.5,2-6,3-7,4-11,6-7,6-8,anther,axil,base,beneath,berry,bi-lobed,bud,calyx,capitate,cm,corolla,cup-shaped,deep,dia,elliptic,except,fruit,glabrous,globose,green,immature,internodal,lateral,leaf,lobe,lobed,long,main,maroon,minutely,mm,narrowly,occasionally,opposite,ovary,papillose,pedicel,petiole,poricidal,pubescent,shiny,shrub,small,somewhat,stem,stigma,style,surface,tip,tree,trichome,tube,tuft,uniseriate,vein,way,white,white-papillose,wide	.75,0-0.1,0.5,1,1.5-1.7,5-7-flowered,7-10,acuminate,acute,anthesi,apex,ba,bark,becoming,beginning,closely,coroll,deflexed,deltoid,densely,drying,eaf,edge,edicel,eed,erect,exsertion,filament,free,fruiting,greyish,inflorescenc,known,lamina,larger,later,lon,lower,margin,mature,meeting,middle,minute,much,near,nflorescence,obtuse,often,older,overlapping,pair,pale,paler,papillo,pore,portion,prominent,reflexed,ruit,scar,simple,slender,slit-like,spaced,sparse,sparsely,straight,tall,tapering,terminal,thickened,ud,unifoliat,unit,upon,usually,widest,woody,yellowish,ympodial,young	arrangement,colour,diameter,form,growth,height,history,inflorescence,length,life,na,peduncle,perennial,plant,position,pubescence,reproduction,rugulose,seed,shape,size,texture,unifoliate
490	wfo-0001029364	success	153	114	80	73	34	0.523	.5,0.2-0.5,1-3,1-5,1.5-2,10-27,2,2-6,3-4,4-12,4-9,5-9,6-8,?,abaxially,acuminate,adaxially,anther,apex,base,blade,blue,calyx,center,chartaceous,cm,corolla,cream,cuneate,curled,darker,deep,diameter,distally,elliptic,entire,extra-axillary,fide,finger,fruit,glabrous,gland-tipped,globose,green,greenish,hair,herb,immature,lobe,margin,minutely,mm,moderately,narrowly,nearly,obtuse,pedicel,peduncle,petiole,presence,puberulent,pubescent,rusby,sagittate,shrub,simple,sparsely,spot,stellate,stigma,strongly,style,tapered,triangular,tube,unknown,white,wide,x,yellow	-2,-3,-6,1,1-,1-4,191.,2-,2-foliat,5-,5-11,7-9,8-10,8-15,according,acute,aggregate,apart,around,articulated,axe,ba,bitter,cell,color,connivent,cylindrical,directed,distall,eaf,ed,filament,flower,free,glandular-puberulen,inserted,long,lower,major,membranaceous,mesocarp,nflorescence,orolla,ovate,part,perfect,pore,present,puberulen,rachi,radiu,ripe,ruit,shallow,short-tomentose,shorter,side,small,spaced,stone,tal,tamen,tem,thecae,tightly,time,tomento,truncat,unbranched,unit,vary,vein,ympodial	1-2,4-6,adhesion,arrangement,climate,colour,form,glandular,growth,height,history,inflorescence,leaf,length,life,midpoint,na,number,ovary,plant,position,pubescence,ray,reproduction,rugulose,seed,shape,size,staman,stem,stipe,surface,texture,truncate
491	wfo-0001029368	success	139	78	49	90	29	0.353	.2,0.5-2,0.9-1,1.5-1.6,1.5-2,1.5-3,1.5-4,11-13,16-25,2-5,2.5-4,5-6,abaxially,anther,broadly,calyx,capitate,cm,conical,corolla,densely,dia,elliptic,fruit,glabrous,globose,green,herb,inflorescence,internodal,leaf,lobe,minutely,mm,opposite,ovary,pedicel,petiole,poricidal,puberulent,shrub,somewhat,stem,stigma,style,tip,tube,white,x	.25,.5,0,?,acuminate,acute,adaxially,along,anthesi,apex,apparently,bark,base,bearing,berry,bitter,borne,breaking,brow,closely,coarse,crumpled,cup,deflexed,distal,eaf,edicel,eed,erect,exserted,few-branched,fide,filament,flattened,flower,free,fruiting,golden,half,indistinct,inflorescenc,known,lamina,lanceolate,lateral,leaving,like,long,lower,main,margi,margin,middle,midrib,minute,nflorescence,non-flower,obtuse,older,one,overlappin,pair,papillo,papillose,parallel,pore,portion,reflexed,rest,ruit,scar,shaped,simple,spaced,straight,strongly,tall,tear-drop,trichome,ud,unifoliat,uniseriate,unit,upper,vein,widest,winged,woody,ympodial,young	1,adhesion,arrangement,brown,colour,diameter,form,growth,height,history,length,life,na,peduncle,perennial,plant,position,presence,pubescence,reproduction,rugulose,seed,shape,size,staman,stellate,surface,texture,unifoliate
492	wfo-0001029370	success	224	105	75	149	30	0.335	-20,0-35,0.1,0.5-2.2,1-2,1.5-6,1.8-2.8,10-17,12-17,2.5-3.5,3-4,3.5-4,3.5-8,4-7,5.5-7,7-13,8-23,abaxially,almost,andromonoecious,anther,apex,base,berry,blade,calyx,chartaceous,cm,connivent,cordate,densely,diameter,equal,flattened-reniform,fruit,glabrescent,glabrous,herb,lateral,leaf,length,lobe,lobed,long,margin,maturity,mauve,midpoint,mm,moderately,obtuse,orange,orange-brown,ovate,pale,pedicel,peduncle,petiole,plant,poricidal,ray,rotate,rounded,shrub,simple,spherical,stellate-pubescent,stem,surface,tapering,tip,tube,white,wide,yellow	-32,.1,.3,.5,/4,0-10,0-100,0-3,0.1-0.15,0.2,0.3,0.5-1,1,1-3,1-4,1.8-2.5,1/3-1/2,1/4-1/3,10-40,10-50,15-30,2-10,2-20,2-3,2-6,3/,4-6,4-9,5-10,5-12,5-merous,6-15,7-11,8-14,8-20,abaxial,acut,adaxial,alyx,ame,apar,apart,apically,apparently,articulated,bark,basal,branched,broad-deltate,c.,clearly,conical,cream,curved,dark,discolorous,distal,distance,drying,eaf,eed,elongate,elongating,erect,extending,fewer,filament,fine,flattened,flower,free,fruiting,fully,gently,green,greenish,hermaphrodite,heterostylous,infructescence,long-styled,longer,lower,lowermost,marking,mature,midvein,mixture,multangulate,nflorescence,often,older,one,open,opening,ornate,orolla,oung,overlapping,pair,pattern,pendulous,per,pericarp,perpendicular,plurifoliat,porrect,portion,prickl,prickle,prickly,primary,red-brown,reticulate,ruit,scar,sessile,shiny,short-styled,side,slightly,smooth,sometimes,spaced,spreading,stalk,stalked,staminat,stout,straight,strongly,style,tamen,terete,tertiary,time,trichome,unarmed,unit,variously,vary,vein,venation,visible,way,white-gra,whitish,woody,ympodial,young	adhesion,arrangement,climate,colour,corolla,form,glandular,growth,hair,height,history,inflorescence,life,na,number,ovary,perennial,position,presence,pubescence,reproduction,rugulose,seed,shape,size,staman,stellate,stipe,texture,ye
493	wfo-0001029373	success	199	86	47	152	39	0.236	6.8,anther,apex,base,berry,calyx,clavate,cm,conical,corolla,densely,diameter,ellipsoid,flattened-reniform,fruit,glabrous,green,growth,herb,internodal,lateral,leaf,lobe,long,mm,moderately,ovary,ovate-lanceolate,pedicel,peduncle,petiole,plant,pubescent,shallowly,shape,simple,stellate,stem,stigma,style,surface,tube,white,wide,yellow,yellow-green,yellowish	.0–1.2,.2,.3,.5,.5–2.0,0.3–0.5,0.4–1.6,0.5–1.2,0.5–1.8,0.6–0.7,1.0–1.2,1.0–1.6,1.2–1.5,1.3–2.2,1.4–3.5,1.5–2.0,1.5–2.5,1.5–2.7,1.8–2.0,1.8–2.3,180°,2-celled,2.0–2.5,2.7–3.0,20–30,2–4-celled,3,3.5–4.0,30–40,3–5,4–5,4–6,5,5-merous,5–6,8–9,abaxial,abaxially,accrescent,acuminate,acute,adaxial,adaxially,age,anthesi,apar,appearanc,appressed,arising,articulated,bark,basal,bayonet,beyond,broadly,bud,capped,cell,cone,curved,deltate,developing,distal,eaf,eed,elongate,enclosed,enclosing,entire,exerted,filament,finger,flower,free,fruiting,fully,geminat,glandular-tipped,globose,grey-brown,hair,half,halfway,hilum,immature,individual,laterally,lengthening,less,like,live,lobed,lon,lower,margin,mature,mesocarp,middle,minute,minutely,mouth,new,nflorescence,node,obtuse,older,outline,pair,papillate,pentagonal,per,perfect,pitted,plurifoliate,pore,poricidal,portion,positioned,primary,reflexed,resembling,root,rounded,ruit,scar,seen,seudostipule,short,slightly,slit,smoot,spaced,spreading,still,straight,tall,tem,terete,testal,thicker-walled,tip,trailing,trichome,tub,ud,uniseriate,unit,upper,vein,woody,ympodial,–5	0.3,0.4-1.6,0.5-1.2,0.6-0.7,1.0-1.2,1.0-1.6,1.2-1.5,1.4-3.5,1.5-2.0,1.5-2.5,1.5-2.7,2.0-2.5,2.7-3.0,20-30,5-6,8-9,adhesion,arrangement,colour,form,height,history,inflorescence,length,life,na,number,perennial,position,presence,present,pubescence,ray,reproduction,rugulose,seed,size,staman,texture
494	wfo-0001029402	success	113	83	49	64	34	0.434	0.5-1,0.5-2,1-2.5,2,2-3,3-5,3-6,4-6,5-25,6-16,7-8,7-9,8-15,acute,apex,base,blade,calyx,ciliolate,cm,connivent,diameter,elliptic,free,glabrous,hair,lanceolate,lobe,margin,mm,moderately,narrowly,pedicel,peduncle,petiole,pubescence,pubescent,shrub,simple,sparsely,stellate,stigma,style,surface,tapered,tube,unknown,violet,x	11-17,15-30,2-10,3-4,4-7,4-8,7-11,abaxial,abaxially,acuminate,adaxially,apart,articulated,axe,band,branched,chartaceous,color,cylindrical,deltate,denser,directed,distall,eaf,eed,fleshy,flower,forked,glabrate,glabrou,inrolled,leaving,long,lower,many-foliat,narrowed,nearly,nflorescence,nther,often,orolla,papillose,pore,rachi,rachise,radiu,roughened,ruit,scale-like,scar,somewhat,spaced,tal,tem,thickened,time,tip,triangular,truncat,unit,unknow,vary,wide,ympodial	adhesion,anther,arrangement,climate,colour,corolla,form,fruit,glandular,growth,height,history,inflorescence,leaf,length,life,midpoint,na,number,ovary,plant,position,presence,ray,reproduction,rugulose,seed,shape,size,staman,stem,stipe,texture,truncate
495	wfo-0001029404	success	154	114	79	75	35	0.513	-3,0.5-1,1,1-4,2-3,2-4,2-5,2.5-22,2.5-3,20-35,3-4,3-8.5,5-10,5-20,5-24,5-6,6-8,6-9,6.5-34,abaxially,acuminate,adaxially,anther,apex,auriculate,basal,base,blade,calyx,center,chartaceous,cm,cordate,cream,dark,darker,densely,diameter,eglandular,ellipsoidal,entire,flattened,fruit,glabrous,glandular,green,hair,lanceolate,less,light,lobe,long,longitudinal,margin,mm,moderately,mottling,orange,ovate,pedicel,peduncle,petiole,pink,puberulent,purple,shrub,simple,star,stellate,stigma,style,toward,tree,tube,unbranched,vein,white,x,yellow	-1.5,-10,-5,0-60-flower,1.5-2,15-25,2,2-8,3-5,4-foliat,8-12,absent,acute,aggregate,apart,ape,apiculate,articulated,axe,beyond,branched,cell,connective,connivent,cylindrical,deltate,directed,distally,eaf,eed,exserted,fleshy,flower,glandular-puberulen,leaving,lemon,lon,lower,narrowly,nflorescence,nther,obtuse,orang,orolla,ovoid,pedicellar,perfect,pore,presen,pubescent,rachi,radiu,remnant,ripe,ruit,shorter,slightly,small,somewhat,spaced,sparsely,stone,subcoriaceous,tal,tem,thecae,time,tomento,triangular,truncat,ud,unit,vary,wide,ympodial	adhesion,arrangement,climate,colour,corolla,form,growth,height,history,inflorescence,leaf,length,life,midpoint,na,number,ovary,perennial,plant,position,presence,present,pubescence,ray,reproduction,rugulose,seed,shape,size,staman,stem,stipe,surface,texture,truncate
496	wfo-0001029406	success	136	87	60	76	27	0.441	0.6-1,0.7-1.5,1-1.5,1-10,1-2,1.5-2.2,2,2-11,2-3,2.5-3.5,28,30,4-18,4-6,anther,arachnoid-pubescent,brown,calyx,clavate,cm,corolla,dark,dia,elliptic,glabrous,globose,grayish-brown,grayish-green,green,greenish-white,leaf,lobe,lobed,long,maturity,minutely,mm,often,ovary,ovoid,ovoid-reniform,pedicel,petiole,pitted,poricidal,shiny,shrub,size,slightly,small,stem,stigma,style,surface,tip,tree,tube,waxy,white,wide	.5,0.3-1,0.5-1,1.5-2.5,1.5-5,3-9,7-12,abaxially,acute,adaxially,along,anthesi,apex,arachnoid,ba,bark,base,berry,broadly,brownish,bullate,conical,conspicuously,deciduous,deflexed,deltate,densely,differing,difoliate,dry,eaf,eed,felt-like,filament,free,fruiting,geminat,impressed,large,lateral,lenticel,lilac,lon,lower,main,major,margin,matted,middle,minor,nearly,occasionally,older,pair,pale,papillo,papillose,planar,pointed,population,pore,portion,pubescent,ruit,shaped,soon,tall,tear-drop,tinge,trichome,unit,vein,widest,woody,ympodial,young	adhesion,arrangement,colour,diameter,form,fruit,growth,height,history,inflorescence,length,life,na,number,peduncle,plant,position,presence,pubescence,ray,reproduction,rugulose,seed,shape,staman,stellate,texture
497	wfo-0001029407	success	208	72	54	154	18	0.26	-25,-6,-7,.5,0.4-0.7,0.5-1.5,0.5-2,0.6-0.9,1-1.4,1-4,1-4.5,1.8-2.5,2.5-3,3-4,3-6,4-15,abaxial,adaxial,anther,bright-red,calyx,chartaceous,cm,densely,diameter,equal,erect,evenly,flattened-reniform,fruit,green,lateral,leaf,length,lobed,long,maturity,mauve,mm,moderately,orange,ovate,pedicel,peduncle,petiole,prickly,shrub,smooth,spherical,stellate-pubescent,stem,white,wide,young	-10,-2,-4,/3,0,0-15,0-2,0-4,0-5,0.1-0.2,0.1-0.25,0.15-0.4,0.2-0.3,0.4-1,0.5-0.7,0.6,0.7-1.2,1,1-2,1-3,1.5,1/3,1/3-1/2,1/5,1/8-1/5,2-3,2-4,2-5,3.5-4.5,4-9,4.5-6,5-7,5-merous,6-13,6-20,7-8,abaxially,acut,acute,almost,alyx,apar,apart,apex,apically,apparently,articulated,bark,base,berry,blade,brow,connivent,cuneate,curved,dark,deltate,difoliate,discolorous,drying,dull,eaf,eed,elliptic,elongating,entire,filament,flattened,flower,free,fruiting,geminat,geminate,glabrescent,glabrous,gray-greenish,green-brown,infructescence,lengt,lobe,longer,lower,margin,mature,midpoint,nflorescence,obtuse,occasionally,older,one,open,orange-brown,orolla,oung,pair,pale,pendulous,per,perfec,pericarp,poricidal,porrect,portion,prickl,prickle,primary,pubescent,rarely,ray,recurved,reflexed,rounded,ruit,scar,sessile,shorter,side,simple,slender,sometimes,spaced,sparsely,spreading,stalk,stalked,stellate,stout,straight,straw-yellow,strongly,style,surface,tamen,tapering,terete,tertiary,thick,time,tip,trichome,tube,unbranched,unit,upper,vary,vein,venation,visible,way,weakly,woody,yellow,yellow-green,ympodial	.5-3,adhesion,colour,corolla,form,growth,height,inflorescence,ovary,plant,position,pubescence,seed,shape,size,staman,texture,ye
498	wfo-0001029408	success	244	114	88	156	26	0.361	0,0.2-0.3,0.7-1.2,0.9-1.3,1-8,1.1-1.5,1.4-1.9,1.6-2.8,1.7-2.4,11-31,2-12,2-4,2-5,2.2-3.7,2.5-7,4-14,4-20,4-7.5,5-24,5-6.5,abaxially,adaxially,anther,becoming,blunt-tipped,broadly,brown,calyx,clavate,cm,conical,corolla,dark,deltoid,diameter,elliptic,fleshy,fruit,glabrous,globose,gray,green,growth,honeycombed,inserted,lanate,lateral,leaf,length,lilac,lobe,mm,mostly,oblong,ovate,pale,pedicel,peduncle,perfect,persistent,petiole,plurifoliate,present,pseudo-terminal,purplish,rarely,rather,ray,reniform,reticulate-punctate,ripe,rotate-stellate,shrub,small,stem,stigma,style,suborbicular,thick-textured,tomentose,tree,tube,velutinous,white,whitish,x,yellow,yellowish	-1.5,-10.5,-4.5,.2-3.5,/10,0-100,0.3-5,0.5-2.5,0.9-1.6,1.5-3,1.8-3.5,1/2,1/2-3/4,1/4,2-3.5,2/3,3-5,3.5-5,5-6,5-8,5-merou,7-12,accrescent,acuminate,acute,adaxiall,ag,alyx,anthesi,apart,apex,apical-lateral,articulated,axe,axillary,ba,barely,bark,base,berry,blade,branch,branched,bud,capitat,chartaceous,continued,cuneate,decurrent,dehiscing,dendritic-echinoi,dendritic-multangulate,densely,develope,directed,distal,distall,due,eaf,echinoi,echinoid,eed,entire,exserted,extend,faintly,few-rayed,filament,flower,free,fruiting,hair,high,homostylous,indument,interpetalar,introrse,lacking,lanceolate,large,lobed,long,long-,long-attenuate,long-stalked,longitudinal,lower,m.,main,many,margin,midvein,mixed,moderately,multangulate,near,nearly,nflorescence,obscured,obtuse,often,older,orbicular,orolla,ovate-lanceolate,overlapping,part,partly,pore,porrect-stellate,pubescent,rachi,relatively,ribbed,ruit,runk,sessile,short-,short-attenuate,short-stalked,side,simple,slightly,slit,sometimes,spaced,stamen,stelliform,subcampanulate,subovate,suture,tamen,terete,testa,thick,thick-stalked,thin-stalked,time,tissue,tomentu,tomentum,top,touching,toward,turbinate,unarme,unarmed,unit,usually,vary,vein,way,well,wide,ympodial,young	adhesion,arrangement,capitate,colour,form,height,history,inflorescence,life,na,number,ovary,perennial,plant,position,presence,pubescence,reproduction,rugulose,seed,shape,size,staman,stellate,surface,texture
499	wfo-0001029417	success	213	127	101	112	26	0.474	.5,0.2-0.6,0.7-3,1-2,1.3-8,1.5-1.8,1.5-8,12,2.5-10,2.8-3.5,3-5,4-7,5-15,6-11,8-15,8-9,abaxially,adaxially,along,anther,articulated,axillary,blue,broadly,brownish,bud,chartaceous,clavate,cm,coarsely,condition,corolla,dark,deep,diameter,distal,dot,drying,erect,especially,flower,fresh,fruit,glabrous,globose,green,greenish,hair,half,herb,lanceolate,like,lobe,long,lunate,medium,membranous,midrib,minute,minutely,mm,moderately,narrowly,non-glandular,odd-pinnate,often,orbicular,ovate,ovoid,pedicel,peduncle,pentagonal,petiole,pilose,plant,puberulent,pubescent,purple,rarely,ripe,rotate,scattered,seed,size,slightly,sometimes,stem,stigma,style,subtending,terminal,tinged,trichome,tube,typically,violet,white,whitish,wide,x,yellow	0-7,0.4-8,1,1-1.5,1-10,1-4,1-8,1.5-10,2-4,3-14,5-merou,acumen,acuminate,acute,ag,alyx,apart,apex,apiculate,apparently,attenuate,axe,base,basiscopic,berry,blade,borne,capitat,cell,central,ciliate,connivent,covering,decreasing,decurrent,digestion,dorsally,eaf,edge,eed,end,enzyme,erec,exceeding,filament,flat,folded,forked,geminat,generally,glabrou,greatly,green-white,hair-like,hal,homostylous,honeycomb-shaped,interjected,lateral,leaflet,lengthening,linear,living,lower,make,margin,mucilaginous,nflorescence,orolla,pair,perfect,petiolulate,plurifoliate,pore,poricidal,rapidly,removed,rounded,ruit,sessile,seudostipule,short,short-petiolulate,side,singly,slit,spaced,specimen,stamen,star,ste,stolo,straight,subequal,tall,tamen,tem,testal,thick,throughout,tip,tri-,tuber,unit,unwinged,usually,vary,wall,wet,widely,wing,ympodial	adhesion,arrangement,calyx,capitate,colour,form,growth,height,hermaphroditic,history,inflorescence,leaf,length,life,na,ovary,perennial,position,pseudostipule,pubescence,reproduction,rugulose,shape,staman,surface,texture
500	wfo-0001029437	success	198	117	90	108	27	0.455	1,1-1.5,1-3,1.5-2,10-12,2-3,2.5-3.5,2.5-5,3-3.5,3-5,5-9,6-8,7-10,acute,anther,apex,axi,base,beige,berry,blue,branched,brownish,calyx,chartaceous,clavate-truncate,cm,cordate,coriaceous,corolla,dark-green,diameter,elliptic,elliptic-lanceolate,entire,flattened,glandular,globose,green,growth,heterostylous,hirsute,inflorescence,internodal,irregularly,lamina,leaf,like,lobe,lobed-angulate,margin,membranous,midpoint,mm,oblong-lanceolate,orange,ovary,ovate,ovate-elliptic,pedicel,peduncle,petiole,plant,pubescence,reniform,rest,rounded,rusty,shrub,similar,simple,stellate,stem,stigma,style,subcordate,subglobose,suborbicular,subscabrous,subulate,surface,tapering,tomentose,tube,velutinous,villous,violet,visible,woody,x	-10,.5,0.5-1,1-2,1/3,3-7,30-50,4-5,9-13,abaxially,acicular,adaxially,anthesi,antrorse,apar,apical,armed,articulated,bark,basal,brow,c.,compressed,cylindrical,densely,distal,eaf,eed,eglandular,enclosed,erect,except,filament,flower,free,fruiting,glabrescent,glabrous,gland,golden,greyish,juvenile,leaving,lengthening,linear-oblong,lobed,long,long-styled,loose,lower,maturity,minute,minutely,multangulate,multicellular,near,nearly,new,nflorescence,oblong,obverse,older,ovoid,packed,papillo,per,perfect,pericarp,persistently,plurifoliat,pore,poricidal,porrect,portion,prickle,prickly,pubescent,recurved,reticulate,rotate,ruit,scar,sessile,short-styled,slit,spaced,sparsely,stalked,staminate,stellate-pubescent,subscandent,tall,testa,thick,tip,triangular,trichome,ud,unarmed,unevenly,unicellular,unit,upper,whitish,without,yellow,ympodial,¼	adhesion,arrangement,blade,climate,colour,form,fruit,hair,height,history,length,life,na,number,perennial,position,presence,present,ray,reproduction,rugulose,seed,shape,size,staman,stipe,texture
501	wfo-0001029440	success	218	136	106	112	30	0.486	-10,0.5-0.6,0.9-1,1,1-1.2,1-1.5,1-2,1.5-2,2-2.5,2-3,2-4,2-6,2.5-7,4-5,4-6,5-15,5-5.5,6.5-8,8-10,>,abaxial,across,acute,adpressed,anther,anthesi,apex,armed,articulate,base,beige,blade,brown,calyx,canaliculate,clavate,cm,coriaceous,deeply,diameter,enlarged,entire,exserted,ferruginous,flower,fruit,glabrous,glandular-pubescent,glandular-stellate,glandular-tipped,globose,lanceolate-attenuate,leaf,leathery,leaving,length,lobe,lobed,long,minutely,mm,oblong-elliptic,oval-elliptic,papillose,parted,pedicel,peduncle,peg,perennial,perfect,petiole,plant,porrect-stellate,prickle,rarely,ray,reddish,rounded,rugose,scabrous,sessile,shiny,shrub,similar,slender,small,solitary,staminate,stellate,stellate-glandular,stem,stigma,strigose,style,sub-coriaceous,sub-truncate,subreniform,subsagittate,surface,terete,terminal,trichome,tube,white,wide,within	0.2-0.3,0.3-1,1-2-celled,1-nerved,2,20,30,4-6-forked,4-8,5-6,5-merous,9-10,9-12,<,accrescent,acicular,along,alyx,ape,apical,bark,basal,bicolorous,branch,brow,caly,central,compressed,curved,cyme,dark,dark-green,deciduous,distal,eaf,eed,elongate,enclosed,epicarp,equal,erect,exceeding,filament,finely,floral,free,fruiting,functional,fused,geminat,glabrescent,gynoeci,held,indument,lanate,longer,lower,midrib,mucilaginous,nflorescence,numerous,oblong-lanceolate,obver,older,orolla,part,partially,persistent,petiol,plurifoliate,pore,primary,prominent,rachi,recurved,reduced,reflexed,reticulated,ruit,secondary,sepal,short,somewhat,sparse,sparsely,stalked,stamen,stiff,straight,strongly,sub-terete,subcampanulate,surfac,tall,tamen,testa,tomentose,touch,tri-,triangular,unarmed,unit,upright,vary,vein,velutinous,without,yellowish,ympodial,young,¼,¾	adhesion,arrangement,climate,colour,corolla,form,glandular,growth,hair,height,history,inflorescence,life,margin,midpoint,na,number,ovary,position,presence,present,pubescence,reproduction,rugulose,seed,shape,size,staman,stipe,texture
502	wfo-0001029461	success	217	113	87	130	26	0.401	-1.5,-14,-3,-3.2,-4.5,-5,0.1-0.25,0.6-1,1-1.6,1.2-1.8,1.3-2.2,1.5-,1/3,2-2.4,2-2.8,2-3,2-4,2.5-3,4-10,4-6.5,4.5-7,abaxially,almost,anther,apex,attenuate,base,becoming,berry,black,blade,brown,calyx,chartaceous,cm,cuneate,densely,diameter,elliptic,erect,evenly,flattened-reniform,fruit,glabrous,green,leaf,length,lobe,lobed,long,margin,maturity,mauve,midpoint,mm,moderately,oblong,orange,ovate,pedicel,petiole,plant,poricidal,ray,rounded,shiny,shrub,simple,sparsely,spherical,spreading,staman,stellate,stellate-pubescent,stem,style,subentire,surface,tip,tube,unequal,upper,weakly,wide,yellow,young,zygomorphic	-2,-3/4,-4,.5,0,0.1,0.15-0.25,0.7-1,0.8,0.8-1.5,1-,1-2,1-3,1-4,1-6,1.2-1.7,1.5-2,1/3-2/3,1/4,1/4-1/2,3-20,3-6,4-7,4.7-7.2,5-10,5-25,5-merous,7-10,7-12,8-9,acuminat,alyx,ame,andromonoecious,apart,apically,bark,breaking,brittle,broad-deltate,c.,cell,concolorous,curved,dark,discolorous,distal,distance,drying,dull,eaf,eed,elongating,extending,faint,fifth,filament,fine,flattened,flower,four,free,fruiting,glabrescent,gra,hermaphrodite,heterostylous,infructescence,lengt,long-styled,longer,lower,lowermost,mature,midvein,obovate,obtuse,older,orolla,oung,outline,pair,pendulous,per,pericarp,pit,plurifoliat,porrect,portion,prickl,prickle,prickly,primary,raised,reddish,reduced,reflexed,ruit,sessile,shallow,short-styled,shorter,side,slender,slightly,small,smooth,sometimes,spaced,stalk,stalked,staminat,straight,strongly,tamen,terete,tertiary,time,trichome,unarme,unarmed,unit,variously,vary,vein,venation,visible,way,woody,ympodial	adhesion,arrangement,climate,colour,corolla,form,glandular,growth,hair,height,inflorescence,na,number,ovary,peduncle,position,presence,present,pubescence,rugulose,seed,shape,size,stigma,stipe,texture
503	wfo-0001029462	success	166	98	66	100	32	0.398	0.5-1,0.5-2,1-3,1-6,1.5-2,1.5-7,2-6.5,2.5-3.5,2.5-5.5,3-18,3-4,3-7,5-30,6-9,7-8,abaxially,acuminate,adaxially,apex,base,calyx,campanulate,chartaceous,cm,cuneate,dark,densely,diameter,ellipsoidal,elliptic,entire,flattened,fruit,glabrous,green,lanceolate,light,lobe,longitudinal,margin,membranaceous,minutely,mm,moderately,occasionally,ovate,pedicel,peduncle,petiole,puberulent,pubescent,pubescent-pilose,purplish,rounded,simple,sparsely,stigma,stripe,style,tree,truncate,tube,unbranched,white,x,yellow	-2,-30,-4,-5,1,1-,1-2,1.5,1.5-3,10-,10-22,15-25,2-3,20-35,3,3-27,3-5,3-6,4-15,4-20,4-foliat,7-19,8-9,abruptly,absent,acute,aggregate,apart,ape,articulated,axe,basal,beyond,blade,broad,cell,ciliate,connective,connivent,constricted,curled,cylindrical,dentate,directed,eaf,eed,eglandular,equal,exceeding,exserted,flower,hair,laterally,leaving,lon,long,lower,m.,narrowly,near,nflorescence,nther,obtuse,often,orolla,oval,ovoid,pedicellar,perfect,pore,pubescent-pilo,purpl,rachi,radiu,remnant,reticulate,ruit,shorter,slightly,small,smooth,somewhat,spaced,stamen,stellate-,stone,tal,tem,thecae,time,tip,tomentose,triangular,truncat,ud,unit,vary,wide,without,ympodial	10-25,2-4,anther,arrangement,colour,corolla,form,growth,height,hermaphroditic,history,inflorescence,leaf,length,life,na,ovary,perennial,plant,position,presence,present,pubescence,reproduction,rugulose,seed,shape,size,stellate,stem,surface,texture
504	wfo-0001029464	success	235	120	92	143	28	0.391	.9,0-80,0.2-0.5,1-10,1/4,10-23,10-40,2-3,2-3.5,2.2-2.5,2.5-5,2.9-3.2,3-20,3-7,5-17,5.5-7.5,6-15,9-15,abaxially,acute,andromonoecious,annual,anther,apex,base,black,blade,brown,calyx,chartaceous,cm,connivent,cordate,curved,dark,diameter,ellipsoid,equal,flattened-reniform,fruit,glabrescent,globular,green,hair,herb,lateral,leaf,length,lobe,lobed,long,margin,maroon,maturity,mauve,midpoint,mm,moderately,mottled,oblong,obtuse,orange-brown,ovate,ovoid,pedicel,peduncle,petiole,pink,plant,poricidal,purple,ray,simple,smooth,sometimes,sparsely,stellate,stellate-pubescent,stem,striped,style,tapering,terminal,tip,tube,upper,usually,variously,white,wide,yellow-orange,young	-2/3,-3,-30,-5,0,0-2,0.2,0.2-0.7,0.3-0.7,0.3-1,0.5,0.5-2,0.8-2,00-200,1,1-3,1-8,1.2-3,1.5-2,1/,1/4-1/2,1/4-1/3,10-15,10-50,12-50,2,2-4,2.4-4,2.5-8,3-5,3.5-5,4-7,4-8,4-8-merous,5-8,5.5-6,7-10,8-13,8-15,abaxial,acicular,adaxial,alyx,ame,apar,apart,apically,apparently,around,articulated,bark,berry,branched,broad,broad-deltate,brow,c.,cultivar,cup-shaped,deltate,difoliate,discolorous,distal,distance,drying,eaf,eed,elongated,elongating,erect,extending,filament,flower,free,fruiting,fully,geminat,glabrous,glaucous,green-brown,hermaphrodite,heterostylous,infructescence,less,long-acuminat,long-styled,longer,lower,lowermost,mature,midvein,minute,narrow-deltate,nflorescence,occasionally,often,older,one,open,opening,orolla,oung,pair,pendent,pendulous,per,pericarp,porrect,portion,prickl,prickle,prickly,primary,red-brown,rounded,ruit,scar,sessile,short-styled,side,spaced,spreading,stalk,stalked,staminat,straight,surface,tamen,terete,tertiary,time,translucent,trichome,unarmed,unit,vary,vein,venation,visible,way,woody,yellow-green,ympodial	adhesion,arrangement,climate,colour,corolla,form,glandular,growth,height,history,inflorescence,life,na,number,ovary,perennial,position,presence,present,pubescence,reproduction,seed,shape,size,staman,stigma,stipe,texture
505	wfo-0001029505	success	169	100	73	96	27	0.432	%,.1,0-0.3,0.15-0.2,0.3-0.5,0.5-1.1,1-1.2,1-3,2-4,2.4-3.2,2.7-4,4.5-5.5,5-7.5,5.5-7,6-18,6-8,7-12,7-20,adaxially,andromonoecious,anther,apex,base,brown,calyx,chartaceous,cm,cylindrical,densely,diameter,elliptical,entire,extra-axillary,fruit,glabrous,gland-tipped,globose,green,hair,inflorescence,juicy,lamina,length,lobe,margin,mm,moist,obtuse,ovate,pale,pedicel,peduncle,perennial,petiole,plant,present,prostrate,ray,red,rotate-stellate,short,shrub,simple,sparsely,stellate,stellate-pubescent,stoloniferous,style,tube,white,x,yellow,yellowish	.05,0-10,0-3,0-3.5,0.15-0.25,0.2-0.3,0.8-1,1-6,1-locular,1.5-2.2,2-5,2-7,22-25,5-merou,7-8,8-10,abaxially,absen,absent,acicular,across,adaxiall,adult,alyx,apart,articulated,axe,ba,blade,branche,confined,cross-section,cuneateor,decimetre,deltate,directed,distall,eaf,eed,elliptic,elliptica,exocarp,finger,flower,fruiting,functional,half,heterostylous,incomplete,lateral,less,long,longer,lower,mature,mesocarp,midpoint,midrib,midvein,minute,moderately,nflorescence,oblique,onl,orolla,part,per,placenta,pore,porrect,prickle,pseudo-racemose,ruit,semi-circular,septum,sessile,solitary,spaced,stellae,straight,tal,tamen,tem,thick,throughout,time,transparent,unarme,unarmed,unbranched,unit,unknow,vary,weakly,wide,ympodial	abaxial,adaxial,adhesion,arrangement,colour,corolla,cuneate,form,growth,height,history,leaf,life,na,number,ovary,position,presence,pubescence,reproduction,seed,shape,size,staman,stem,stigma,texture
506	wfo-0001029524	success	212	132	102	110	30	0.481	-5,-6,-8,.5,0.1-0.3,0.7-0.8,1-,1-2,1-3,1.2-1.5,1.5-2,12-25,2-,2-2.5,2-4,3-,3-3.5,3-8,4-4.5,4-6,4-7,5-15,6-7,7-9,acicular,acuminate,acute,angulate,anther,apex,base,beige,berry,calyx,cm,corolla,diameter,eglandular,entire,flattened,flower,glandular,glandular-hirsute,globose,green,growth,heterostylous,internodal,lanate,linear-oblong,lobe,lobed,long,long-styled,margin,maturity,membranous,midpoint,mixture,mm,oblique,obtuse,ovary,ovate,ovate-elliptic,ovate-lanceolate,pedicel,peduncle,petiole,plant,prickle,pubescence,reniform,rounded,rusty,short-styled,shrub,size,slightly,somewhat,stellate,stem,stigma,style,sub-cordate,subcordate,subcoriaceous,suborbicular,subscabrous,subspherical,surface,tapering,tiny,trichome,tube,unarmed,villous,viscid,white,woody,x,yellowish	0.2-0.3,0.9-1.2,1-1.5,10,2-3,25,6,9-10,abaxially,adaxially,adult,anthesi,articulated,bark,basal,branched,brown,campanulate,cell,channelled,clavate-truncat,congested,corymbose,cyme,decumbent,densely,discolorous,distal,distall,doubling,eaf,eed,elongating,erec,erect,exceeding,exserted,filament,filamentous,flexuous,flowering,foliaceous,free,fruiting,glabrescen,glabrous,grey,impressed,leaving,light,like,long-stalked,loosely,lower,m.,minute,multicellular,new,nflorescence,numerous,oblong,oblong-lanceolate,obverse,occasionally,older,one,partially,perfect,pericarp,plurifoliat,pore,poricidal,porrect,portion,prickly,pubescent,recurved,reticulate,rugose,ruit,scar,sessile,single,slit,spaced,sparsely,stalked,staminate,stellate-pilose,stellate-pubescent,subbsessile,tall,testa,time,tip,tomentose,triangular-lanceolate,turbinate,ud,unevenly,unit,upper,vein,velvety,venation,way,yellow,yellow-green,ympodial,¾	adhesion,arrangement,blade,clavate-truncate,climate,colour,form,fruit,hair,height,history,inflorescence,leaf,length,life,na,number,perennial,plurifoliate,position,presence,present,ray,reproduction,rugulose,seed,shape,staman,stipe,texture
507	wfo-0001029546	success	203	131	106	97	25	0.522	0.3-1,1-2,1-4.5,1.5-2,1.5-6.2,2.2-2.8,3.5-5,4-10,4.5-12.5,4.5-7,5-8,7-10,8-17,8-19.5,abaxially,adaxially,anther,articulated,axillary,blue,broadly,brownish,bud,cell,chartaceous,clavate,cm,condition,connivent,corolla,covered,covering,densely,diameter,distal,dot,drying,elliptic,frequently,fresh,fruit,generally,glabrous,glandular,globose,green,green-white,greenish,hair,hair-like,half,herb,lanceolate,lateral,leaf,like,lobe,long,longer,make,membranous,minutely,mm,mucilaginous,nearly,non-glandular,odd-pinnate,often,orbicular,ovate,ovoid,pedicel,peduncle,pentagonal,petiole,plant,pubescent,purple,rarely,ripe,rotate-pentagonal,seed,short,simple,size,slightly,soft,sometimes,stem,stigma,straight,style,subtending,terminal,testal,thick,throughout,tinged,trichome,tube,wall,wet,white,whitish,x,yellow	0-2,1-10,1-3.2,1-5,1.6-6.5,2-4,2-9,3-8,5,5-10,5-18,5-merou,6.3-19.5,8,absent,acumen,acuminate,acute,adaxiall,ag,alyx,apart,apex,apiculate,apparently,attenuate,axe,base,berry,blade,capitat,cordate,curved,decreasing,decumben,decurrent,digestion,dorsally,eaf,edge,eed,elliptical,enzyme,erect,exceeding,filament,flat,flower,folded,forked,geminat,glabrou,greatly,homostylous,honeycomb-shaped,interjected,leaflet,lengthening,living,lower,lunate,middl,mottle,nflorescence,oblique,pair,perfect,petiolule,plurifoliate,pore,poricidal,rachi,regular,removed,ruit,sessile,seudostipule,slit,spaced,specimen,stamen,ste,subequal,tall,tamen,tem,tip,tri-,truncate,typically,unit,unwinged,usually,vary,wide,wing,ympodial	adhesion,arrangement,calyx,capitate,colour,form,growth,height,history,inflorescence,length,life,middle,mottled,na,ovary,perennial,position,pubescence,reproduction,rugulose,shape,staman,surface,texture
508	wfo-0001029552	success	161	109	75	86	34	0.466	0.1-0.5,0.5,0.6-1,1-1.3,1-1.5,1-3,1-5,1.5-2,10-20,12,2-2.5,2.5-3,5.5-8,abaxially,acuminate,acute,adaxially,along,anther,apex,area,base,broadened,calyx,cm,corolla,dendritic,densely,dia,elliptic,flattened-reniform,glabrous,globose,green,incrassate,inflorescence,leaf,lobe,lobed,long,long-styled,margin,minutely,mm,nearly,opposite,ovary,pale,paler,pedicel,petiole,pitted,poricidal,pubescent,shape,shining,short-styled,shrub,size,small,sparsely,stem,stigma,style,surface,tan,tip,tree,tree-like,trichome,tube,vein,white,wide,x	.25,.5,1-2,1.5-6.5,2-9,5-10-flowered,6-9,abaxial,abruptly,anthesi,bark,berry,branched,broadly,clavate,closely,conical,contracted,decurrent,deflexed,deltate,denser,differing,difoliate,drying,eaf,edicel,eed,erect,exserted,filament,flower,free,fruiting,geminat,greyish-brow,heteromorphic,inflorescenc,lamina,later,lateral,like,lon,lower,main,major,middle,minor,minute,nflorescence,occasionally,older,onto,orbicular,overlappin,pair,papillo,persistent,planar,pore,portion,present,reflexed,rest,rounded,ruit,scar,scattered,shaped,simple,slender,slightly,somewhat,spaced,strongly,swollen,tall,tear-drop,tub,ud,unit,widest,woody,yellowish,ympodial,young	adhesion,arrangement,blade,climate,colour,dense,diameter,form,fruit,glandular,greyish-brown,growth,hair,height,history,length,life,midpoint,na,number,peduncle,perennial,plant,position,presence,pubescence,ray,reproduction,rugulose,seed,staman,stellate,stipe,texture
509	wfo-0001029558	success	184	100	70	114	30	0.38	0.05-0.1,0.1-0.2,0.1-0.9,0.3-0.5,0.5,1-1.1,1-1.5,1.5-2,2-4,2.5-3.5,6-10,6-9,acute,anther,apex,base,calyx,capitate,cm,conical,corolla,densely,diameter,elongate,entire,flattened,glabrous,globose,growth,inflorescence,internodal,leaf,lobe,margin,midpoint,minutely,mm,narrowly,obovate,obspathulate,obtuse,ovary,pale,pedicel,peduncle,petiole,pubescent,ray,red,reddish,reniform,rhombic,rounded,shape,shiny,shrub,simple,size,sparsely,stellate,stem,stigma,style,surface,tan,tapering,thin,tube,white,x	.5,0.1-,0.15-0.2,0.2-,0.4,0.4-0.6,0.4-1.1,0.5-2,1,1-3,1-4,10-16,2,2-3,4-merous,<,?,abaxially,adaxially,along,anthesi,armed,articulated,bark,bearing,berry,branched,cell,closely,deflexe,difoliate,divaricately,eaf,easily,eed,ellipsoid,elliptic,enclosed,equal,erect,filament,filiform,flower,free,fruiting,geminat,geminate,glabrescent,gre,highly,hyaline,including,interlocking,larger,later,leave,lengthening,like,lobed,long,long-triangular,lower,mere,midvein,mixture,nearly,new,nflorescence,node,occasionally,older,overlapping,pair,paired,papillo,per,perfect,pericarp,pitted,planar,pore,poricidal,porrect,portion,prickle,prickly,primary,rest,rhachi,ruit,scar,sessile,short-stalked,shorter,sinus,slit,small,spaced,square,stalked,straight,testal,tiny,tip,trichome,ud,unit,upper,usually,vein,visible,wall,widening,ympodial	0.1-1.1,0.2-2,adhesion,arrangement,blade,climate,colour,form,fruit,glandular,hair,height,hermaphroditic,history,length,life,na,number,perennial,plant,position,presence,present,pubescence,reproduction,rugulose,seed,staman,stipe,texture
510	wfo-0001029569	success	265	99	58	207	41	0.219	.0,.2,.3,1.6,2,3.2,4.9,8.1,abaxially,across,acuminate,adaxially,adnate,along,anther,calyx,chartaceous,cm,corolla,diameter,dry,elliptic,evenly,extra-axillary,flattened-reniform,flower,fruit,glabrous,globose,lamina,lateral,length,lobe,mature,mm,orange,ovate,pedicel,peduncle,petiole,ray,red,reticulate,shrub,simple,stellae,stellate,stem,stigma,style,surface,tube,unarmed,vein,white,yellow,yellow-tan,×	.4,.9,/2,/3,0.03,0.05,0.1,0.2,0.2–0.5,0.3–0.5,0.4–0.6,0.5–0.8,0.6–0.8,0.6–0.9,0.7–0.9,0.8–1.0,0.9,0.9–1.3,0.9–1.4,0.9–2.0,1.0–1.3,1.3–1.8,1.4–2.4,1.5–1.7,1.6–4.5,1.7–2.3,1.8–2.5,1/2–2/3,1/3,130,14.6–16.5,2.0–3.2,2.3–3.0,2.3–4.4,3.2–3.8,3.4–3.7,4.0,4.5,4–6,5-merou,5.0,5.1,5.3–16.6,5.7–6.6,6.3–18.5,6.8–7.8,6–12,6–8,7.4–9.1,7–10,90°,aequilateral,ag,alyx,anthesi,apart,apex,apical,apiculate,apparently,appearing,around,articulate,attenuate,axe,ba,bark,basal,base,becoming,berry,blade,branch,branching,broad,brochidodromous,bud,capitat,channeled,clinate,cuneate,deciduous,densely,dentate,development,difoliate,directed,distal,distally,distinct,eaf,edge,eed,either,emerging,endocarp,entire,exocarp,extending,fertile,filament,filiform,flexed,free,geminat,glandular,glossy,gradually,hair,homostylous,increasing,intact,internode,interpetalar,intersepalar,juic,lacking,layer,less,light,lon,long,longer,lower,many,margin,middle,midpoint,midrib,midvein,minute,moderately,nearly,nflorescence,oblique,oblong,orolla,ove,per,perforated,pore,porrect,porrect-stellate,portion,potentially,probably,pubescent,raised,reduced,reflexe,remaining,restricted,rigid,rounded,row,ruit,scarcely,sessile,short,short-stipitate,shorter,side,sinuate,sinus,sloughing,smoot,spaced,sparsely,splitting,spread,spreading,stamen,stellate-pubescent,stipe,stipitate,straight,suture,tamen,tardily,tem,terete,thin,time,tip,tissue,toward,translucent,transparent,triangular,truncate,two,ud,unit,upper,various,vary,weakly,well,well-developed,wide,yellow-ferruginous,ympodial,young,±90°,±equal,±glabrous,±well	0.2-0.6,0.3-0.5,0.5-0.8,0.6-0.9,0.7-0.9,0.9-1.3,0.9-2.0,1.3-1.8,1.5-1.7,14.6-16.5,2.0-3.2,2.3-3.0,3.2-3.8,5.3-16.6,5.7-6.6,6-12,6-8,6.3-18.5,adhesion,arrangement,capitate,colour,dense,form,growth,height,inflorescence,leaf,number,ovary,plant,position,presence,present,pubescence,seed,shape,size,sparse,staman,texture
511	wfo-0001029584	success	180	92	68	112	24	0.378	1,1-6,1.5-6.5,16.2-33,2-3,2-4,3-10,3-7,4-5,4.5-11.5,6-7,7-14,8-15,9.7-23.4,abaxially,adaxially,anther,axillary,brownish,bud,clavate,cm,condition,coriaceous,corolla,densely,diameter,drying,elliptic,fresh,fruit,glabrescent,glabrous,green,greenish,hair,herb,leaf,lobe,long,mm,mucilaginous,oblong-lanceolate,odd-pinnate,ovate,ovoid,pedicel,peduncle,pentagonal,petiole,plant,pubescent,purple,seed,short,simple,size,stigma,style,substellate,subtending,terminal,tube,wet,white,whitish,x,yellow	0-30,1-2,1-3,2.4-6.3,3-5,4-14,4-15,5-merou,5.3-13.3,6.1-9.4,9.8-17,acumen,acuminate,acute,ag,alyx,apart,apex,apparently,articulated,asymmetric,attenuate,axe,base,basiscopic,blade,borne,capitat,cell,connivent,considerably,covering,dark,decreasing,dense,digestion,distal,dorsally,eaf,edge,eed,end,enzyme,erry,filament,finer,flat,flower,folded,forked,geminat,generally,green-white,hair-like,hal,half,homostylous,honeycomb-shaped,interjected,larger,lateral,leaflet,lengthening,light,linear,living,lower,make,margin,middle,nflorescence,orbicular,orolla,pair,perfect,petiolulate,plurifoliate,pore,poricidal,present,proximal,removed,second,semi-erec,sessile,seudostipule,side,singly,slit,spaced,specimen,stolo,straight,tall,tamen,tem,testal,thick,throughout,tip,tissue,toward,tri-,tuber,typically,unit,unknow,unwinged,usually,vary,wall,ympodial	adhesion,arrangement,calyx,capitate,colour,form,growth,height,history,inflorescence,length,life,na,ovary,perennial,position,pubescence,reproduction,rugulose,shape,staman,stem,surface,texture
512	wfo-0001029592	success	207	99	72	135	27	0.348	0-0.1,0.25-0.7,0.3-0.6,0.4-0.7,0.5-1.5,0.5-1.8,0.8-0.9,1.1-2.8,1.8-2.4,1.8-8,2-3.5,2.1-4,3-6,3.5-5.5,4-8,5.5-11.5,6-8,6.5-8.5,7-10,acute,anther,apex,base,black,blade,brown,calyx,chartaceous,cm,cordate,densely,depression,diameter,entire,erect,extra-axillary,fruit,glabrous,globose,green,hair,inflorescence,leaf,length,lobe,lobed,margin,midpoint,mm,moderately,obtuse,ovate,pedicel,peduncle,perennial,petiole,present,purple,ray,rhizomatous,shallowly,shrub,simple,sparsely,stellate,stellate-pubescent,style,throughout,tube,vein,x,yellow	%,.05,.4,0,0-0.15,0-0.3,0-3.5,0.1-0.2,0.25-0.5,0.5-0.8,0.5-1,0.8-1.2,0.8-1.5,1-1.5,1-1.9,1-10,1-3,1-8,1-locular,1.5,1.5-3,1.8-6.5,14-20,18-30,2-10,2-3-branched,2-foliate,240-1400,3-4,5-8,5-merou,5.5-10.5,7-17,7-25,7-9,8,8-10,8-20,abaxially,absent,acicular,across,adaxiall,adaxially,adult,alyx,apart,apparen,apparently,armed,articulated,attenuate,axe,ba,branch,branche,decimetre,deeply,deltate,directed,distall,distally,distributed,dm,eaf,eed,eglandular,exocarp,finger,flower,fruiting,geminat,gland-tipped,half,hemispherical,homostylous,incomplete,index,juicy,juvenile,lamina,lateral,less,lobing,long,longer,lower,markedly,mature,mesocarp,mid-point,midvein,minute,nflorescence,oblique,orolla,pair,part,per,perfect,placenta,pore,porrect,presen,prickle,ridged,ruit,septum,sessile,short,side,spaced,sparse,stalk,stellae,straight,succulent,surface,tal,tamen,tem,terete,thick,thicker,thicknes,time,transparent,unarme,unbranched,unit,upper,vary,white,wide,ympodial	adhesion,arrangement,climate,colour,corolla,form,glandular,growth,height,history,life,na,number,ovary,plant,position,presence,pubescence,reproduction,seed,shape,size,staman,stem,stigma,stipe,texture
513	wfo-0001029593	success	181	73	55	126	18	0.304	0.5-5,0.8-1.2,1,1-1.2,1-1.5,1-2,1.6-2.3,10-50,2.3-3.0,3-4,4-6,5-15,7-25,abaxially,anther,axillary,broadly,brown,calyx,capitate,cm,conical,densely,diameter,elliptic,fruit,glabrous,globose,green,leaf,long,mm,obovate,ovary,ovoid-reniform,papillose,pedicel,petiole,pinnate,plant,pubescence,pubescent,seed,shape,shrub,simple,slightly,smooth,sparsely,stigma,style,trichome,tube,uniseriate,x	-10,0.05,0.5-1,0.8-1,1-8,100,2,2-14,2-3,2-5,2.3,3.5-8,35-60,5-10,7.5-15,9-15,abruptly,acuminate,acute,adaxially,age,always,anthesi,anticlinal,apex,apically,arising,attenuate,axil,basal,base,basiscopically,bearing,berry,cateniform,cell,clavat,colony,cone,decurrent,deltate,dry,drying,eaf,edicel,eed,enlarged,entire,epidermal,exserted,extremely,filament,filiform,flower,free,fruiting,glabrescent,growing,half,hollow,included,irregular,lamina,large,lateral,leaflet,lobe,lower,markedly,minutely,much,narrowing,nflorescence,noddin,oblique,occasionally,often,once-branched,onto,open,opposite,pair,per,perfectly,petiolule,place,pointed,poricidal,portion,primary,projection,pubescen,purple,rachi,rarely,reflecting,rest,ruit,scar,short-styled,similar,single-stemmed,sinuous,small,smaller,somewhat,surface,tall,tem,terminal,thickening,tip,tub,ud,unifoliat,unit,usually,variable,vein,white,white-lenticellate,wider,winged,without,woody,ympodial	arrangement,clavate,colour,corolla,form,growth,height,history,inflorescence,length,life,na,perennial,position,reproduction,size,stem,texture
514	wfo-0001029601	success	187	91	64	123	27	0.342	0.2-0.8,0.5-5.8,1-3,1-4,1.1-2.7,2-12,2-9,2.3-5.9,3-10,3-7,4-13.5,5-41,6-10,6.6-22,6.8-14.5,abaxially,adaxially,anther,brownish,clavate,cm,condition,connivent,coriaceous,corolla,diameter,dot,drying,elliptic,fresh,fruit,glabrescent,glabrous,globose,green,greenish,hair,herb,lanceolate,leaf,light,lobe,mm,odd-pinnate,ovate,ovoid,pedicel,peduncle,pentagonal,plant,puberulent,rotate,seed,short,size,small,stigma,style,terminal,tube,white,whitish,x,yellow	0-37,0.5-8,1-2,1-53,1.2-2.3,1.7-6.5,2,2-3,2-7,2.2-4.5,2.8-10.5,3-5,5-merou,abaxiall,acumen,acuminate,acute,ag,alyx,apart,apex,apparently,articulated,asymmetric,attenuate,axe,axillary,base,basiscopic,berry,blade,borne,bud,capitat,cell,covering,dark,decreasing,digestion,distal,dorsally,eaf,edge,eed,end,enzyme,erec,exceeding,filament,flat,flower,folded,forked,geminat,generally,glabrou,green-white,hair-like,half,homostylous,honeycomb-shaped,interjected,larger,lateral,leaflet,lengthening,linear,living,long,lower,make,middl,middle,mucilaginous,narrow,nflorescence,orbicular,orolla,pair,perfect,petiole,petiolulate,plurifoliate,pore,poricidal,removed,ripe,rounded,ruit,sessile,seudostipule,side,singly,slightly,slit,spaced,specimen,stamen,stolo,straight,subequal,subglabrou,subtending,tall,tamen,tem,testal,thick,throughout,tip,tissue,toward,tri-,tuber,typically,unit,unwinged,usually,vary,wall,wet,wing,ympodial	adhesion,arrangement,calyx,capitate,colour,form,growth,height,history,inflorescence,length,life,na,ovary,perennial,position,pseudostipule,pubescence,reproduction,rugulose,shape,staman,stem,subglabrous,surface,texture,ye
515	wfo-0001029606	success	179	111	79	100	32	0.441	0.2-0.5,0.4-0.5,0.5-1,1,1.5-2,1.5-3.5,1.8-2.5,2-2.5,2-3,3,3-9,4-8,4.5-5,5,5-6,7-9,abaxially,acuminate,acute,adaxially,anther,apex,base,beneath,bilobed,broadly,brownish,calyx,cm,coriaceous,corolla,densely,diameter,elliptic,elongate,entire,flattened,flower,form,glabrous,globose,growth,heterostylous,inflorescence,internodal,leaf,lobe,lobed,long-styled,margin,midpoint,minutely,mm,narrowly,oblong,orbicular,pedicel,peduncle,petiole,pubescence,pubescent,ray,reddish,reniform,revolute,shiny,shrub,simple,stellate,stem,stigma,style,surface,tapering,terminal,thin,tube,white,x	.5,/2,0.5,1.5-3,15,4-5,4-6,7,aciculate,along,anthesi,apparently,arching,armed,articulated,bark,berry,brown,cell,closely,color,deciduous,defoliate,dense,eaf,eed,ellipsoidal,elongation,equalling,erect,especially,exerted,filament,free,fruiting,geminat,gre,herbarium,impressed,inshort-styled,known,lengthening,like,long,long-stalked,lower,m.,many,marginal,midrib,mixture,multangulate,multiseriate,new,nflorescence,nodding,older,once-branched,pair,papillat,per,pericarp,pore,poricidal,porrect,portion,prickle,primary,prominent,red,redder,ruit,rusty,scar,sessile,slightly,slit,sometimes,soon,space,specimen,stalk,stalked,stellate-pubescent,straggling,straight,strongly,testal,tip,triangular,trichome,ud,unit,urceolate,usually,vein,way,woody,yellowish,ympodial	2,4,6,adhesion,arrangement,blade,climate,colour,fruit,glandular,hair,height,history,length,life,na,number,ovary,perennial,plant,position,presence,present,reproduction,rugulose,seed,shape,short-styled,size,staman,stipe,texture
516	wfo-0001029619	success	188	115	86	102	29	0.457	0.25-0.75,0.5-1,0.5-1.5,0.5-2,1,1-1.5,1-2,1-5,1.5-2,10-12,2-11,2-3,2-5,3-4,4-6,5-20,6-10,7,8-12,abaxially,acute,adaxially,anther,apex,attenuate,base,blade,brown,bud,calyx,chartaceous,cm,connivent,densely,diameter,extra-axillary,flower,fruit,glabrous,glandular,globose,green,hair,immature,leaf,leaf-opposed,length,like,lobe,lobed,margin,mature,midpoint,mm,moderately,nearly,obtuse,orange,ovate,pedicel,peduncle,per,petiole,porrect-stellate,pubescent,ray,reniform,rusty,scandent,shrub,side,simple,sparsely,spreading,stellate,stem,stigma,style,surface,tan,tapering,tube,unlobed,white,x,yellow	1-.,1-2.5,1-3,1-3.5,2,25-40,3-8,5-merou,6,6-8,7-10,7-12,absent,accrescent,adaxiall,alyx,andromonoecy,apar,apart,apical,apparently,appearing,armed,axe,berry,beyond,clavat,contiguous,cordate,cut,cylindrical,dark,difoliate,directed,discolorous,eaf,eed,either,elongated,em,exserted,filament,flattedned,frui,fruiting,geminate,glabrou,gland-tipped,implying,introrsel,less,long,lower,m.,major,many,midrib,midvein,multicellular,multiseriate,narrowly,netlike,nflorescence,occasionally,often,orolla,pair,perfect,pit,pore,prickle,rachi,raised,recurved,reduced,ridge,roselike,ruit,separated,sinus,slightly,small,spaced,sparse,stalk,stamen,ste,tamen,triangular,unarmed,unbranched,unequa,unicellular,unit,usually,vary,vein,way,whitish,wide,ympodial,¼	adhesion,arrangement,clavate,climate,colour,corolla,form,growth,height,history,inflorescence,life,na,number,ovary,perennial,plant,position,presence,present,pubescence,reproduction,rugulose,seed,shape,size,staman,stipe,texture
517	wfo-0001029621	success	165	105	70	95	35	0.424	0.5-1,0.7-1.1,0.8-1,0.8-4.5,1-1.5,1.5-2,1.5-2.5,1.5-5,2.5-3,3-3.5,3.5-4.5,6-20,7-9,acute,anther,apex,area,attenuate,base,becoming,brown,calyx,cm,corolla,dark,decurrent,dia,dry,fleshy,fruit,glabrous,globose,green,lanceolate,later,lateral,leaf,live,lobe,lobed,margin,material,merely,minutely,mm,oblanceolate,ovary,ovoid-reniform,pale,pedicel,pitted,plant,poricidal,puberulent,ripe,sessile,shrub,stem,stigma,style,surface,tan,terminal,tip,tube,white,whorl-like,widened,x,yellowish	.1,0.5-0.75,0.5-1.2,0.5-1.5,1-2,1/3,2/3,5-20-flowered,6-8,accrescent,along,anthesi,apar,appearing,appressed,bark,beneath,berry,borne,branched,caudate,cluster,completely,constricted,course,cup-shaped,deltoid,densely,distal,eaf,edicel,eed,ellipsoid,elongate,enclosed,erect,exsertio,filament,free,fruiting,geminate,glabrate,irregularly,late,like,lon,long,lower,main,many,middle,nflorescence,occasionally,often,older,onto,pair,papillate,papillo,papillose,planar,plurifoliat,pore,portion,prominent,quite,rarely,reddish,reddish-gre,river,ruit,scar,shaped,shiny,small,somewhat,spaced,ste,straight,tall,tapering,tear-drop,thick,time,trichome,ud,uniseriate,unit,vein,way,widest,woody,yellow,ympodial,young	adhesion,arrangement,blade,climate,colour,diameter,form,glandular,growth,hair,height,history,inflorescence,length,life,midpoint,na,number,peduncle,perennial,petiole,position,presence,pubescence,ray,reddish-grey,reproduction,rugulose,seed,shape,size,staman,stellate,stipe,texture
518	wfo-0001029622	success	182	90	66	116	24	0.363	.1,.5,0.5-1,0.8-1,1-1.2,1-1.5,1-4,1.5,2-11,2.5-3,3-4,3-5,30-35,4-6.5,abaxially,adaxially,anther,base,brown,calyx,chartaceous,cm,connivent,corolla,deflexed,diameter,elliptic,except,fruit,glabrous,globose,green,inflorescence,internodal,leaf,lobe,lobed,minutely,mm,narrowly,oblong,occasionally,opposite,ovate,papillose,pedicel,peduncle,petiole,reddish,sagittate,shiny,shrub,simple,size,slightly,somewhat,stellate,stem,stigma,style,tapering,tip,tube,white,x,yellow	.2,/3,0.3,0.5,0.5-0.7,0.6-0.9,1-2.7,2-4,2-5,40,45-50,5-6,7-11,absent,accrescent,acute,ag,alyx,anthesi,apex,apparently,appearing,arising,attenuate,axe,axil,bark,beneath,blade,bud,capitat,consisting,cylindrical,deciduous,differing,difoliate,dimorphic,eaf,eed,elongate,entire,filament,flower,free,fruiting,geminate,glabrou,ilament,immature,included,interlaced,jointed,known,lamina,lateral,less,long,long-acuminate,long-triangular,longitudinal,m.,main,major,margin,mature,measured,midrib,minor,minute,nflorescence,obconic,often,older,one,onto,opening,orolla,oung,ovate-lanceolate,pair,pendent,pore,portion,present,probably,rachi,raised,reflexed,remaining,rounded,ruit,scar,second,shaped,single,slende,slender,slit,straight,tal,tear-drop,thin,thus,trichome,tuft,ud,unarme,unifoliat,uniseriate,unit,vary,vein,way,within,ympodial,young	0.2-1,adhesion,arrangement,capitate,colour,form,growth,height,history,length,life,na,ovary,perennial,plant,position,pubescence,reproduction,rugulose,seed,shape,staman,surface,texture
519	wfo-0001029625	success	168	103	68	100	35	0.405	..,0.5-1,0.5-1.3,0.8-1.4,1-1.5,1-2,1.2-1.6,3-,3-3.5,4-10,4-4,4-9,5,5-6,5-8,9-25,anther,base,beneath,calyx,cm,conical,corolla,darker,densely,diameter,elliptic,flattened,four,fruit,glabrous,glandular,globose,green,greenish,growth,herb,inflorescence,lobe,lobed,long,margin,mm,nearly,occasionally,ovary,ovate-reniform,pale,pedicel,peduncle,pubescent,purplish,reddish,smooth,sparsely,stem,stigma,stripe,style,surface,tan,tinged,trichome,tube,uniseriate,white,x,young	-15,.1-0.2,.5,0.5-2,0.5-2mm,0.8-1.8,1-3,100,2,2.5-.,3,3-3,4-5-celled,4-7-celled,5-10,6-9,8-13,abaxial,along,anthesi,apical,bark,branc,branch,branched,brittle,brow,capitat,cel,cell,cucullate,deflexe,deflexed,deltate,denser,distinct,dry,eaf,edicel,eed,erect,filament,flower,frui,fruiting,glabrescent,gland,gland-tipped,hyaline,lamina,later,lighter,like,lower,markedly,middle,midline,minute,mixed,narrowly,new,nflorescence,open,outer,outline,pair,papillate,per,pericarp,planar,plurifoliat,point,pointed,primary,rarely,regularly,ruit,scar,scattered,shrub,single,single-stemmed,sinuate,slightly,small,striate,strongly,testa,thin,time,tip,triangular,tuft,ud,unit,vein,wall,weight,without,ympodial	adhesion,apex,arrangement,blade,brown,capitate,climate,colour,form,hair,height,history,leaf,length,life,midpoint,na,number,perennial,petiole,plant,plurifoliate,position,presence,pubescence,ray,reproduction,rugulose,seed,shape,size,staman,stellate,stipe,texture
520	wfo-0001029630	success	286	132	102	184	30	0.357	.5,.8,/6,0-5,0.4,0.5-1.5,1.5-4,12-17,2-6,2.5,2.5-3,3.5-5,4-8,5-9,6-8,7-10,8-9,abaxially,acuminate,acute,almost,along,anther,apex,apparently,base,berry,blade,brachyblast,calyx,capitate,chartaceous,clavate,climber,cm,corolla,cuneate,dark,densely,diameter,discolorous,distributed,drying,dull-yellow,elliptic,entire,equal,evenly,finely,flattened-reniform,free,fruit,glabrous,globose,green-brown,grey-brown,lateral,leaf,length,like,lobe,lobed,margin,maturity,mauve,midpoint,mm,oblique,often,orange,orange-brown,ovate,papillose,pedicel,peduncle,petiole,purple,ray,red-brown,rounded,shiny,side,smooth,sometimes,somewhat,stellate,stellate-pubescent,stem,stigma,strongly,style,suborbicular,surface,tapering,terminal,thin,tube,unequal,weakly,yellow-brown,young,×	.1,.15,.7,/2,0,0-10,0-8,0.1-0.2,0.15-0.3,0.2-0.3,0.2-0.4,0.2-0.7,0.3-0.5,0.5,0.5-1,0.5-2,0.5-4.5,0.6-0.8,1,1-3,1.2-1.5,1.5-2,1/3,1/3-1/5,1/3-2/3,10-30,12-15,2.5-6,3-10,4-5,45-60°,5,5-20,5-merou,8,abaxial,accrescent,across,adaxially,age,always,alyx,apar,apart,apically,area,armed,articulated,ascendant,attachment,bark,beyond,branch,branched,broadly,brown,cell,clearly,coroll,cupular,curved,delineated,deltoid,development,difoliate,distance,divided,downward,eaf,eed,ellpsoid,elongating,exserted,extending,eye,fertile,filament,flat,flattened,flower,fruiting,geminat,glabrescent,glaucous,greyi,hooked,infructescence,irregula,lengthening,less,lighter,lon,long,longer,longitudinal,lower,main,mature,midvein,mostly,naked,narrow-ovate,nflorescence,orolla,outline,ovoid,pair,pale,papillo,patchily,pendulous,per,perfect,pericarp,pit,point,pore,poricidal,porrect,portion,prickle,primary,prominently,rachi,raised,recurved,reduced,reflexe,relatively,rest,robust,ruit,scar,secondary,shorter,simple,sinus,slender,slit,small,spaced,sparsely,species,spherical,spreading,stalk,stalked,stout,straight,strong,stump,sunk,tamen,terete,tertiary,thicker,throughout,time,tip,toward,translucent,trichome,ud,undulate,unequal-deltoid,uniform,unit,usually,variously,vary,vein,venation,visibl,visible,visibly,white,white-translucent,wide,widest,woody,yellow,yellow-green,yellow-translucent,ympodial	adhesion,arrangement,climate,colour,form,glandular,greyish,growth,hair,height,history,inflorescence,life,na,number,ovary,perennial,plant,position,presence,present,pubescence,reproduction,rugulose,seed,shape,size,staman,stipe,texture
521	wfo-0001029632	success	202	143	109	93	34	0.54	.5,0.2,0.5,0.5–1.4,0.6–1.1,0.8–,0.8–1.0,0.9,0–1.5,1.0–2.0,1.0–3.5,1.0–6.0,1.1–,1.2,1.2–1.4,1.5–,1.5–2.6,1.7–8.5,11–25,2.0–11.5,2.0–2.2,2.7–3.5,2–3,3.5–5.0,3–8,4.5–6.0,5.5–9.5,abaxially,acute,along,anther,anthesi,apex,arising,associated,base,black,blade,brown,calyx,clavate,cm,dark,decurrent,deeply,densely,diameter,elliptic,especially,flattened,fruit,glabrous,globose,green,hair,herb,leaf,like,lilac,lobe,lobed,long,margin,marking,midrib,midvein,midway,mm,moderately,multicellular,oblong,ovate,pair,pale,pedicel,peduncle,pentagonal,perennial,petiole,pitted,pubescent,purple,rarely,semi-succulent,simple,sometimes,sparsely,stigma,style,subentire,succulent,surface,tube,unifoliate,uniseriate,violet,white,whitish,x,yellow,–1.4,–11.0,–11.5,–13.5,–19.0,–2.0,–4.5,–5.2,–50	.0,0.3–2.0,0.4–1.0,0.5–0.7,0.7,0.8–1.5,0.8–2.2,1,1.0–1.5,1.2–2.5,10–30,2,4–8,5,5–10,6–13,7.5–13,75,abaxial,absent,adaxiall,adaxially,ag,angular,apart,appressed,articulated,axe,ba,branching,caudex,cell,chartaceous,connivent,cylindrical,eaf,eed,elongate,equal,filament,flower,geminat,indistinct,lamin,lon,longitudinal,lower,m.,nflorescence,obtuse,occasionally,often,opening,orolla,particularly,perfect,pore,poricidal,present,prostrate,purplish,rapidly,ruit,scandent,shaped,side,slender,slit,spaced,spheroidal,stone,straight,subterranean,swollen,tall,tamen,tear-drop,tem,time,tip,unbranched,unicellular,unit,vary,vein,wide,wing,ympodial,–10,–15,–2.2,–4.0,–40	10-30,adhesion,arrangement,climate,colour,corolla,form,glandular,growth,height,history,inflorescence,lamina,length,life,midpoint,na,number,ovary,plant,position,presence,pubescence,ray,reproduction,rugulose,seed,shape,size,staman,stellate,stem,stipe,texture
522	wfo-0001029645	success	160	119	85	75	34	0.531	0.2-0.5,0.3-0.5,0.5-2.5,0.5-7,1-1.5,1-2,1.3-7,1.5,2.5-17,2.5-4,3-15,3-7,337,6-12,7-12,750,?,abaxially,acuminate,adaxially,anther,apex,base,blade,blue,brown,calyx,chartaceous,cm,corolla,cuneate,diameter,distally,entire,et,extra-axillary,fide,finger,flattened,fruit,glabrous,gland-tipped,globose,green,greenish,hair,herb,immature,kayap,line,lobe,margin,membranaceous,minutely,mm,moderately,obtuse,ovate,ovate-elliptic,pedicel,peduncle,petiole,puberulent,purple,rarely,red,rotate-stellate,rugose-verrucate,sagittate,simple,smith,sparsely,stigma,strongly,style,subcordate,tapered,triangular,truncate,tube,white,wide,x,yellow,±	-1,.5-1,1,1-4,1.5-2,2-3-foliat,2-4,3-10,3.5-4,4-5,4-8,5,5-8,abundantly,acute,aggregate,along,apart,around,articulated,axe,ba,cell,connivent,cylindrical,decurrent,deltate,directed,distall,eaf,eed,except,filament,flower,free,glabrou,inserted,knapp,long,lower,major,mesocarp,nearly,nflorescence,orolla,part,perfect,pore,puberulen,rachi,radiu,ruit,sand-punctate,short,short-tomentose,shorter,shru,side,small,spaced,stone,tal,tamen,tem,thecae,tightly,time,tomento,truncat,unbranched,unit,vary,vein,veiny,ympodial	0.5-1,adhesion,arrangement,climate,colour,form,glandular,growth,height,history,inflorescence,leaf,length,life,midpoint,na,number,ovary,perennial,plant,position,presence,pubescence,ray,reproduction,seed,shape,shrub,size,staman,stellate,stem,stipe,texture
523	wfo-0001029646	success	141	92	56	85	36	0.397	0.1-0.6,0.5,0.5-0.8,0.7-2.2,1-4,1.5-2,1.5-4.9,10-15,2-3,3-14,4-5.5,6-8,abaxially,acuminate,acute,adaxially,apex,attenuate,base,calyx,cm,corolla,diameter,distal,elliptic,finely,free,globose,green,green-white,half,herbaceous,leaf,lobe,long,mm,narrowly,ovate,ovoid,pedicel,peduncle,perennial,petiole,plant,pubescent,seed,simple,stellate,stigma,style,throughout,tone,white,wide,yellow,yellow-green	3-6-foliat,5-15,7-15,acumen,apical,apically,articulate,branched,cell,commonly,covering,cyme,dehiscent,dichasial,dichasially,digestion,dorsally,eaf,ebracteate,edge,eed,emoval,enzyme,epiphytic,equaling,filament,flat,flower,folded,forked,generally,globo,ground,growing,hair-like,honeycomb,introrse,lateral,linear,living,lon,lower,make,maturing,monochasial,mos,mould,mucilaginous,mucronate,nflorescence,nther,oak,often,orolla,ovat,pattern,perfect,pine,plan,poricidally,proximal,rarely,reveal,ruit,seudostipule,short,slit,specimen,stamen,straight,tall,tem,testal,thick,throughou,tree,tuber-bearing,typically,unit,vary,viole,wall,without,ympodial,¼	adhesion,anther,arrangement,blade,climate,colour,form,fruit,glandular,growth,hair,height,history,inflorescence,length,life,margin,midpoint,na,number,ovary,position,presence,pubescence,ray,reproduction,rugulose,shape,size,staman,stem,stipe,surface,texture,tube,violet
524	wfo-0001029652	success	160	114	80	80	34	0.5	.25,.5,0.5-1,0.5-4,0.75-1,0.8-1,1-3,1.5-2,2-2.5,2-4,2.5-3,3.5-4,3/4,4-4.5,6-15,abaxially,adaxially,along,anther,apex,attenuate,base,calyx,cm,corolla,curling,dia,elliptic-ovate,flower,glabrous,globose,golden,green,greenish-white,hard,hispid,leaf,lobe,lobed,long,long-acuminate,long-styled,margin,maturity,minutely,mm,narrowly,occasionally,opposite,ovary,ovoid-reniform,pale,papillose,pedicel,pericarp,petiole,pitted,pore,poricidal,pubescent,reddish-brown,shaped,short-styled,shrub,size,stem,stigma,style,surface,tan,tear-drop,tip,trichome,tube,undulate,uniseriate,vein,way,white,x	.3,1,1-2,2,25,7-9,anthesi,apar,ape,apical,arch,arching,ba,bark,bearing,berry,broadly,cone,conical,deciduous,deflexed,deltate,denser,differing,difoliate,drying,eaf,edicel,eed,evenly,exserted,filament,filiform,free,fruiting,geminat,golden-red,heteromorphic,included,joining,lamina,lateral,like,lon,lower,main,major,middle,midrib,minor,minute,near,nflorescence,older,pair,papillo,portion,projection,reflexed,ruit,scar,series,simple,slende,slender,slightly,soon,spaced,sparsely,swollen,tall,thickened,time,tub,ud,unit,widest,within,ympodial,young	adhesion,arrangement,blade,climate,colour,diameter,form,fruit,glandular,growth,hair,height,history,inflorescence,length,life,midpoint,na,number,peduncle,perennial,plant,position,presence,pubescence,ray,reproduction,rugulose,seed,shape,staman,stellate,stipe,texture
525	wfo-0001029662	success	181	122	96	85	26	0.53	.3,.5,0.5,0.7–1,0.7–3,1,1.4,1.5,15,20,2–3,2–3-celled,3.5–6,3–4,4-rayed,5-6,5–7.5,6-7,7-14,9–11,abaxially,adaxially,andromonecious,anther,apart,apex,armed,articulated,base,calyx,caudate,chartaceous,cm,cylindrical,diameter,distally,expanded,extra-axillary,flower,fruit,glabrous,hair,herb,including,lateral,leaf,like,linear-tapered,lobe,lobed,long,margin,midpoint,mm,nearly,oblong-ovoid,obtuse,opposite,ovate,pedicel,peduncle,petiole,pilose,plant,prickle,pubescent,ray,recurved,repand,sessile,shallowly,shape,shorter,simple,size,small,somewhat,spaced,sparsely,stellae,stellate,stellate-pentagonal,stem,stigma,style,thickened,tip,tomentose,tube,unknown,vine,white,wide,widely,x,yellow	1.7–3.5,12,1–3.5,2,2-,3-foliate,3.2,3.5,4–5,absent,accrescent,acicular,adaxiall,ag,axe,ba,blade,campanulate,capitat,color,connivent,creeping,curve,directed,eaf,eed,equal,erect,fertile,filament,fragrant,free,fruiting,geminat,glabrou,half,ilament,immature,less,lightly,longitudinal,lower,lowest,m.,major,minute,nflorescence,node,oblong-ovate,offset,one,opening,orolla,per,perhaps,pore,portion,probably,rachi,reflexed,ripe,rooting,rounded,ruit,side,slender,slightly,slit,straight,striaght,subcordate,tal,tem,triangular,truncate,two,unarmed,unbranched,unequal,uniform,unit,vary,vein,way,ympodial	adhesion,arrangement,capitate,colour,corolla,form,growth,height,history,inflorescence,length,life,na,number,ovary,perennial,position,presence,pubescence,reproduction,rugulose,seed,staman,stipe,surface,texture
526	wfo-0001029673	success	159	107	74	85	33	0.465	.5,0.7-1.1,0.75-1,0.8-1,1-10,1-2,1-5,1.2-3.5,1.5-2,2-2.5,2.5,4-6,5.5-15,acuminate,acute,anther,apex,appearing,base,black,blade,branch,calyx,clavate,cm,corolla,deep,dendritic,diameter,elliptic,fork,fruit,glabrous,globose,greyish-yellow,growth,later,lateral,leaf,length,lenticular,lobe,minutely,mm,narrowly,occasionally,ovary,overtopping,pedicel,pericarp,petiole,pitted,planar,plurifoliate,poricidal,purple,reddish-brown,reflexed,shoot,shrub,slightly,small,stem,stigma,style,surface,terminal,thin,tip,tree,trichome,tube,violet,x	0.5-1,1.5-1.8,10-20,2-3,2-4,3-5,3/4,5-25,abaxial,abaxially,absent,accrescent,adaxial,adaxially,age,along,anthesi,apical,bark,basal,becoming,berry,branching,broadly,conical,decurrent,deflexed,deltoid,densely,denser,dichasia,eaf,edicel,eed,ew,exserted,filament,flower,free,fruiting,greyish,greyish-yello,individual,inserted,lamina,like,lon,long,longer,lower,m.,monochasial,nflorescence,nodding,older,pair,papillo,petal,pore,portion,prominent,pubescent,pyramidal,ruit,scar,secondary,sleeve,slit-like,somewhat,sparsely,stamen,strongly,tall,tapering,time,triangular,tub,ud,unit,vein,wide,winged,woody,ympodial,young	adhesion,arrangement,climate,colour,dense,form,glandular,hair,height,history,inflorescence,life,margin,midpoint,na,number,peduncle,perennial,plant,position,presence,pubescence,ray,reproduction,rugulose,seed,shape,size,sparse,staman,stellate,stipe,texture
527	wfo-0001029680	success	212	143	113	99	30	0.533	0.1,0.5–1.5,0.6–1.2,0.6–2.0,1,1.0,1.0–1.1,1.0–1.8,1.1–1.2,1.4–7.5,1.7–7,1.8–3.8,11–16,11–25,12,2.2–4.2,3.0–4.2,3.3–5.5,3–6,4.0–16,4.0–6.5,4.5–20,4.5–7.0,50,5–11,abaxially,acute,adaxially,annual,anther,anthesi,apex,arequipa,axillary,base,becoming,bipinnate,blade,blue,brown,calyx,clavate,cm,densely,diameter,divided,equal,flattened,fleshy,fruit,glabrous,globose,green,hair,herb,indistinct,leaf,length,light,lobe,long,margin,mm,moderately,multicellular,oblong,obovate,obtuse,pair,pale,pedicel,peduncle,pentagonal,perfect,petiole,pinnae,pinnate,pitted,primary,pubescent,purple,rarely,red,ripe,rotate,shallowly,shoot,simple,size,sometimes,sparsely,specimen,stem,stigma,style,subglabrous,surface,tacna,terminal,tripinnate,tube,turning,unicellular,uniseriate,violet,white,winged,woody,x,yellow,–10,–12.5,–19	.0,0.4,0.6,0.9–1.0,1.0–1.5,1.4–2.5,1.5,1.6–2.7,10,1–2,1–3,1–6,1–8,2–20,3–22,4–10,4–30,5,5.5–8.5,7–10,8–32,absen,adaxiall,ag,along,apart,appressed,arranged,articulated,asymmetrically,axe,ba,beyond,borne,branched,cell,connivent,cylindrical,decreasing,decurrent,difoliate,eaf,eed,entire,erect,extending,filament,flange,flower,forming,geminat,irregularly,lon,longitudinal,lower,m.,midrib,narrow,nflorescence,node,occasionally,often,opening,orolla,ovate,parallel,pendant,plurifoliate,pore,poricidal,prostrate,rapidly,ruit,running,secondary,shaped,side,spaced,split,stone,straight,tal,tamen,tear-drop,tem,tertiary,time,tip,unit,usually,vary,wide,wing,winge,ympodial,–3,–3.2,–46,–48	adhesion,arrangement,climate,colour,corolla,decurred,form,glandular,growth,height,history,inflorescence,life,midpoint,na,number,ovary,plant,position,presence,pubescence,ray,reproduction,rugulose,seed,shape,staman,stellate,stipe,texture
528	wfo-0001029685	success	288	105	79	209	26	0.274	.2,0.2-0.8,0.5-1.5,1-4,1-5,1.3-1.5,2-3,2-6,2.1-3,2.5-3.7,3-7,3.5-16,3.5-4,4-7,4-9,5-20,5.5-7,6-8,6.5-9,acute,anther,apex,base,berry,blade,bright,brown,calyx,chartaceous,clavate,cm,corolla,cuneate,curved,densely,diameter,drying,equal,erect,flattened-reniform,free,fruit,globose,lateral,leaf,length,lobe,lobed,margin,maturity,mauve,midpoint,mm,orange,orange-brown,ovate,ovoid,pedicel,peduncle,petiole,ray,red-brown,shiny,shrub,simple,smooth,stellate,stellate-pubescent,stem,stigma,strongly,style,surface,tapering,thin,truncate,tube,yellow,×	.4,.5,.8,/3,0-15,0.1,0.1-0.2,0.1-0.3,0.2,0.5,0.5-1,0.7-1.5,0.7-1.8,1-1.3,1-2,1-7,1.5,1.5-5,1.5-6,1/2-2/3,1/3,1/3-2/3,1/3-4/5,1/6-1/3,10,10-20,2.5-3,20,3,3-20,3-5,3-6,3.5,3/4-1/2,30-60°,4,4-10,4.5-6,5,5-11,5-merou,abaxially,accrescent,adaxially,age,almost,alyx,apar,apart,apically,apparently,armed,articulated,axe,bark,beyond,black,branched,breaking,brittle,broad-deltate,cell,clearly,clump,covering,cupular,dark,deep,deltate,dense,development,difoliate,discolorous,distance,divided,dorsal,downward,eaf,eed,elongating,exserted,extending,faint,filament,filiform,finely,finger-hair,flat,flattened,flower,fruiting,geminat,glabrescent,glabrous,grey-brow,growing,inflated,infructescence,irregula,irregular,lengthening,less,long,long-acuminate,long-deltate,longer,longitudinal,lower,mature,midvein,minute,mixture,moderately,much,nflorescence,obconical,oblique,obovate,often,older,one,open,opening,orange-translucent,orolla,oung,outline,ovoi,pair,papillae,papillo,partly,patch,per,perfect,pericarp,persisting,pit,point,pore,poricidal,porrect,portion,prickle,primary,pronounced,pubescent,rachi,raised,rarely,reduced,reflexed,regular,rest,ri,ridged,robust,rounded,ruit,scar,secondary,sessile,side,sinus,slender,slightly,slit,small,sometimes,somewhat,spaced,sparsely,specimen,spherical,spreading,stalk,stalked,stout,straight,stump,tamen,terete,terminal,tertiary,thick,throughout,time,tip,toward,translucent,trichome,ud,unarmed,unbranched,unit,upper,usually,variously,vary,vein,venation,visible,well-developed,wide,widest,woody,x1.5-2,yellow-green,ympodial	adhesion,arrangement,climate,colour,form,glandular,growth,hair,height,inflorescence,na,number,ovary,papillose,plant,position,presence,present,pubescence,reproduction,rugulose,seed,shape,size,staman,texture
529	wfo-0001029691	success	223	123	96	127	27	0.43	-8,0-0.1,0.2-0.4,0.25-0.45,0.3-0.45,0.5-0.8,1.2-1.7,1.6-2.1,1.7-2.7,11-14,2.5-4,2.5-8,3-4,3-6,3-7,3.3-3.5,5-8,5.5-9,6.5-10,6.5-8.5,8-14,abaxially,absent,acute,adaxially,andromonoecious,anther,apex,base,blade,broadly,brown,calyx,chartaceous,cm,connivent,cuneate,cylindrical,densely,diameter,entire,extra-axillary,fruit,glabrous,gland-tipped,globose,green,hair,herbaceous,inflorescence,juicy,lanceolate,length,lilac,lobe,lobed,long,margin,midpoint,minutely,mm,moist,obtuse,orbicular,ovate,pale,pedicel,peduncle,petiole,plant,present,prostrate,ray,resprouter,reticulate,rotate,shallowly,shape,short,simple,sparsely,sprawling,stellate,stellate-pubescent,stigma,style,summit,surface,throughout,toward,tube,weakly,white,x,yellow,yellowish-green	%,0-6,0.3-0.7,0.3-1.4,0.4-0.5,0.5-0.7,0.5-1,0.8-1.2,0.8-1.6,0.8-2.5,1-1.1,1-2,1-5,1-6,1-locular,1.1-2.1,1.4-2,1.5-4,10,100-400,13-18,13-20,13-25,140-320,18-23,2-3,36-50,4-8,40-250,5-,5-merou,6-10,6-8,absen,abundant,accrescent,acicular,across,adaxiall,adult,alyx,apart,armed,articulated,attenuate,axe,ba,branche,bursting,cone,cross-section,curved,decimetre,directed,distall,eaf,eed,eglandular,elliptica,equalling,exocarp,filament,finger,flower,fruiting,functional,half,heterostylous,included,incomplete,index,interpetalar,lamina,lateral,less,lobing,lon,longer,lower,mature,maturity,mesocarp,mid-point,midvein,minute,moderately,nflorescence,oblique,orolla,part,per,petal,placenta,pore,porrect,presen,prickle,rachi,readily,rounded,ruit,septum,sessile,side,slightly,spaced,stage,stalk,stellae,straight,tal,tamen,tem,thick,time,tip,tissue,transparent,truncat,unbranched,unit,unknow,uvenile,vary,vein,wide,ympodial	adhesion,arrangement,climate,colour,corolla,form,glandular,growth,height,history,leaf,life,na,number,ovary,position,presence,pubescence,reproduction,rugulose,seed,size,staman,stem,stipe,texture,truncate
530	wfo-0001029704	success	146	92	67	79	25	0.459	0-1.5,1.5-2.5,1.5-3,15-25,2-2.5,2-3,3-4-celled,4,4-7,7-10,9-20,along,anther,base,blue,branch,broadly,brown,calyx,cm,conical,corolla,dark,deeply,dia,ellipsoid,extra-axillary,fork,glabrous,globose,green,halfway,leaf,less,lobed,minute,minutely,mm,mottled,obovate,occasionally,one,ovary,pedicel,peduncle,petiole,pinnatisect,poricidal,pubescent,purple,record,reddish,reticulate,shrub,simple,stellate,stigma,stout,striped,style,subdiscoidal,surface,tip,trichome,vein,white,x	-17,-3,.5,0.5,1,1-2,1-4,1.5,10-14,1000-1200,140-185,2-5,3-5,5,7-,acuman,acuminate,acute,also,anthesi,apex,apparently,aspect,axi,berry,c.,cell,composed,cunate,cuneate,cut,deflexed,diam,eaf,eed,enlarged,erect,especially,exerted,few-flowered,filament,flower,flowering,fruiting,gradually,lanceolate,lengthening,lobe,long,lower,midrib,moderately,nflorescence,obovoid,plurifoliat,pore,rounded,ruit,shoot,short,single,sinus,slit,sombre,sprawling,stone,straight,subglobo,swollen,tub,tube,twig,ud,unit,variable,variously,within,ympodial,young	arrangement,colour,diameter,form,fruit,growth,height,history,inflorescence,length,life,na,perennial,plant,plurifoliate,position,pubescence,reproduction,rugulose,seed,shape,size,stem,subglobose,texture
531	wfo-0001029727	success	260	103	80	180	23	0.308	-1/3,-10,-3,/3,0-4,0.4-1,1-1.2,1-4,1.5-5.5,1.6-3,1/4,1/8-1/5,2.5-3.2,2.5-5.5,2.8-4,3-11,3-7,4.5,5-9,5.5-7,abaxially,acuminate,acute,anther,apex,base,berry,blade,calyx,chartaceous,clavate,climber,cm,connivent,cordate,corolla,densely,diameter,erect,flattened-reniform,lateral,leaf,length,lobe,lobed,long,margin,mauve,midpoint,mm,moderately,oblong,orange-brown,ovate,pedicel,peduncle,petiole,ray,red-brown,rounded,scandent,seed,shallowly,shape,shrub,simple,size,stellate,stellate-pubescent,stem,stigma,style,subentire,surface,tapering,terminal,tube,upper,way,wide	.5,0-15,0-2,0-20,0-30,0-40,0-5,0-8,0.1-5,0.15-0.2,0.15-0.3,0.2,0.2-0.5,0.2-2.5,0.3,0.4,0.5,0.5-1.2,0.5-3,0.7-0.9,0.7-1,1,1-,1-2,1.2-2,1.5-2.3,1.5-2.5,1.5-3,1/2-2/3,1/3-1/2,2-5,2.5,3-6,3/,4-7,4-merou,4-merous,4.5-,5-12,5-8,6-11,7-10,abaxial,acicular,adaxial,age,almost,along,alternate,alyx,ame,anthesi,apar,apart,apically,apparently,articulated,bark,branched,bristle,brown,c.,colourles,covered,cupular,curved,darker,deltate,deltoid,developing,different,dimorphic,discolorous,divided,drying,eaf,edge,eed,elongating,equal,except,extending,ferrugineous,filament,filiform,filiform-acuminat,finely,fissure,flower,free,geminate,glabrous,increasing,inside,lengthening,less,like,lon,longer,lower,m.,mature,middle,midvein,minor,minutely,mixture,narrow-deltate,nflorescence,nther,obconical,occasional,older,one,open,orolla,oung,outside,pair,papillo,papillose,per,perfec,perfect,pit,pitted,plurifoliat,pore,poricidal,porrect,portion,prickl,prickle,prickly,primary,protruding,pubescent,raised,rarely,red-brow,reddish,reduced,regular,scar,series,sessile,short,sinus,smooth,sometimes,spaced,spreading,stalk,stalked,straight,strongly,tamen,tearing,terete,tertiary,time,tip,toward,translucent,transverse,trichome,unarmed,uneven,unit,variable,variously,vary,vein,venation,violet,visible,x,yellowish,ympodial,young	adhesion,arrangement,climate,colour,form,fruit,glandular,growth,hair,height,inflorescence,na,number,ovary,plant,position,presence,present,pubescence,rugulose,staman,stipe,texture
532	wfo-0001029728	success	238	119	77	161	42	0.324	0.5-1.5,2.7-3.1,abaxially,abundantly,acute,anther,anthesi,apex,base,becoming,blade,broadly,brownish,bud,calyx,cm,cylindrical,diameter,early,enlarged,erect,extra-axillary,flattened-reniform,flower,free,fruit,glabrous,glandular,glandular-pilose,globose,golden,green,hair,lanceolate,late,leaf,length,light,lobe,lobed,margin,mature,maturity,midpoint,minutely,mm,narrowly,nearly,ovate,pedicel,peduncle,petiole,pilose,pubescence,pubescent,ray,scarcely,shallowly,shrub,simple,size,stellate,stem,stigma,style,subcordate,suborbicular,surface,tan,terete,thin-textured,truncate,tube,white,x,yellow,yellowish	.6,0.2,0.3,0.3–0.4,0.4–2,0.5–0.9,0.6–1.5,0.7–1.2,0.8,0.8–1.6,0.8–2.5,0–0.5,1.2–2.3,1.5–2,1.6,1.7–2.5,1/3,11,12–20,1–,1–2,1–2-celled,2,2-foliate,2.4–3.6,2.8,200-310,260,2–3,2–4,2–4-celled,3,3.4–4.5,3.5–5.5,3–18,3–5,4,4.5-5.5,4–10,4–14cm,4–15,4–6-rayed,5,6.2–8.1,7,7-10,7–12,7–14,7–15,8–10.5,9,=,absent,accrescent,acicular,adaxiall,adaxially,admixture,armed,around,ascending,auxiliary,axe,branche,capitat,cell,column,compressed,contiguou,curled,curved,densely,differing,dimorphic,directed,distall,eaf,eed,exceeding,fallen,fertile,fewer,filament,frui,fruiting,geminate,generally,glabrou,gland-tipped,grading,half,horizontally,hyaline,intermixed,larger,least,long,longer,lower,lowermost,main,major,many,minute,mixed,much,n,nflorescence,numerous,obtuse,often,one,orolla,pair,per,pitted,plane,pore,prickle,rachi,recurved,reflexed,relatively,ruit,scattered,sessile,short-pilose,shorter,similar,similarly,single-stemmed,slender,slightly,small,smaller,sparsely,spine,spreading,stellae,stout,straight,tall,tamen,tem,terminal,tip,triangular,triangular-lanceolate,unbranched,undulate,unit,usually,various,vary,vein,wid,wide,withered,ympodial,–4,–5	0-0.5,0.3-0.4,0.8-1.6,1-2,1.2-2.3,1.7-2.5,12-20,2-3,2.4-3.6,3.5-5.5,4-10,4-14,4-15,6.2-8.1,7-12,adhesion,arrangement,capitate,climate,colour,corolla,form,growth,height,history,inflorescence,life,na,number,ovary,perennial,plant,position,presence,present,reproduction,rugulose,seed,shape,staman,stipe,texture
533	wfo-0001029731	success	246	92	67	179	25	0.272	0.1-0.8,1,1-2,1-2.5,1.5,1.5-2.5,10-20,2.5-4.5,3-4,31,4,4-9,6,6-7,7-11,8-9,acquiring,almost,along,anther,base,black,branch,brown,calyx,clavate,cm,conical,connate,coriaceous,corolla,diameter,distributed,elliptic,epiphyte,evenly,filiform,fleshy,fruit,glabrous,ground,leaf,less,liana,linear,lobed,long,long-ellipsoid,maturity,mauve,mm,oblong,obovate,pedicel,peduncle,petiole,pyriform,stem,stigma,style,succulent,surface,terminal,thick,white,woody,x	.5,.6,0.05,0.25-0.3,1-1.5,1.5-3,1/3,1994,2,2-3,2-6,2.5,3,3-10,4-5,abaxially,accrescent,acuminate,acute,adaxially,age,alyx,anthesi,apar,apex,apically,apparently,arcy,articulated,bark,basal,basally,beak,becoming,berry,boundary,branched,branching,broadly,bumpy,clearly,concolorous,crinkled,cuneate,darker,delimited,delineated,deltoid,dense,development,different,dilated,domatia,dorsal,dorsifixed,dry,drying,dull,eaf,early,elongating,enlarge,entire,equal,erect,even,exserted,faint,filament,fine,finely,flaring,flattened,flower,free,fruiting,hair,iscoid,lamina,large,later,lateral,lengthening,like,lobe,lon,longitudinal,longitudinally,lower,main,margin,mature,midvein,much,narrowly,nflorescence,nther,obconical,obtuse,occasionally,often,orange-brown,orolla,pair,papillae,papillose,part,pendulous,perfec,pericarp,persisting,plurifoliat,pore,poricidal,portion,primary,prominent,protruding,rachi,raised,rakotozafy,rarely,reflexed,reported,revolute,ribbed,ridge,ridged,rounded,ruit,scar,see,several,shallowly,shorter,simple,sinus,slender,slightly,small,smaller,smoot,sometimes,sparsely,straight,stretched,stump,sunk,tearing,thickened,thinner,though,time,tip,toward,trichome,tub,tube,tuft,ud,unit,usually,vary,vein,venation,ventral,visibl,visible,well-developed,wide,widely,wing,winged,wrinkling,yellow,yellow-green,ympodial,young,’	adhesion,arrangement,colour,form,growth,height,inflorescence,length,na,number,ovary,plant,position,presence,pubescence,ray,reproduction,rugulose,seed,shape,size,smooth,staman,stellate,texture
534	wfo-0001029741	success	137	90	54	83	36	0.394	0.9-1.2,1-1.5,1-3.5,1.1-1.3,1.5,1.5-4,1.5-6,2.5-7.8,9.5-22.5,?,acute,age,anther,apex,attenuate,base,calyx,capitate,cm,corolla,dark,dia,elliptic,fruit,glabrous,globose,green,growth,inflorescence,leaf,lenticellate,lighter,lobe,lobed,minutely,mm,opposite,ovary,ovate,papillose,pedicel,petiole,poricidal,shrub,size,stem,stigma,style,tip,tree,tube,weak,white,x	.4,.5,0.5-1.5,0.8-3.5,10-50-flowered,2-2.5,2.2-9,3,accrescent,anthesi,apiculate,becoming,berry,black,branched,ca,caly,closely,completely,deflexed,deltoid,differing,difoliate,divisio,dry,drying,eaf,early,edicel,eed,erect,exserted,filament,flower,free,fruiting,furcate,geminat,glabrou,immature,known,lateral,lon,long,lower,main,major,middle,minor,nearly,new,nflorescence,overlapping,pair,papillo,planar,pore,portion,produced,prominent,proximal,quite,raised,reddish-brown,ruit,scar,shaped,slender,slightly,spaced,straight,tall,tapering,tear-drop,ud,unit,usually,variable,vein,widest,wood,woody,ympodial	0.5,1.4,3.5,7.5,adhesion,arrangement,blade,climate,colour,diameter,form,glandular,hair,height,history,length,life,margin,midpoint,na,number,peduncle,plant,position,presence,pubescence,ray,reproduction,rugulose,seed,shape,staman,stellate,stipe,surface,texture
535	wfo-0001029744	success	113	98	59	54	39	0.522	0.3-0.6,1.5-3.2,2,5-8,50,7-15,abaxially,acute,adaxially,apex,base,blunt,calyx,cm,dendritic,densely,difoliate,elliptic,entire,extreme,flattened,form,fruit,geminate,glabrous,golden,lanceolate,leaf,lobe,long-acuminate,margin,minutely,mm,narrowly,oblanceolate,oblique,occasionally,opposite,ovoid-reniform,pale,pedicel,petiole,pitted,pubescence,pubescent,revolute,shape,shrub,slightly,sometimes,somewhat,stem,surface,tip,trichome,unifoliate,uniseriate,white,x	0.5-1,1,1.5,2-4,8-10-flowered,8-11,along,apart,bark,beginning,branch,brow,deltate,denser,distinct,eaf,eed,examined,fide,flexuous,glabrescent,incrassate,inflorescenc,lamina,leave,looping,lower,major,marginal,mature,minor,nflorescence,node,non-reproductive,older,pair,primary,scar,see,similar,simple,single-celled,small,smaller,smith,spaced,thee,thin,ud,unicellular,unit,vein,ympodial,young	3,adhesion,anther,arrangement,blade,brown,climate,colour,corolla,diameter,glandular,growth,hair,height,history,inflorescence,length,life,midpoint,na,number,ovary,peduncle,perennial,plant,position,presence,ray,reproduction,rugulose,seed,size,staman,stellate,stigma,stipe,style,texture,tube
536	wfo-0001029746	success	179	107	75	104	32	0.419	0.3-2,0.7-1,1,1-1.3,1-1.5,2-2.5,2-7,2-8,3,3-4,4-9,8-10,8-11,acuminate,acute,anther,apex,base,bearing,berry,blackish,brown,calyx,capitate,centre,cm,conical,cordate,corolla,curved,dark,darker,densely,diameter,entire,flattened,fruit,glabrous,glandular,globose,greenish,herb,horn,inflorescence,internodal,leaf,lobe,margin,minutely,mm,orange,ovary,ovate,ovoid,pale,papillose,pedicel,peduncle,petiole,principal,pubescent,purple,red,reddish,simple,stem,stigma,style,subshrub,surface,thin,triangular,tube,vein,x	.5,0.5-1,1.2-1.5,1.5,2,2-4,3-4-pluri-foliate,3-4.5,3-6,6,6-7,abaxially,adaxially,age,anthesi,apart,becoming,broadly,c.,cell,ciliate,color,crenate,crowded,cup-shaped,eaf,edicel,eed,ellipsoid,elliptic,enlarged,erect,exerted,filament,fleshy,flower,flush,free,fruiting,gland-tipped,growing,heteromorphic,hollow,irregularly,lamina,lengthening,less,lon,long,longer,longest,lower,markedly,mature,maturit,mid-length,mixed,narrowly,near,nflorescence,nodding,occasionally,pair,papillo,pericarp,pitted,plan,pore,poricidal,portion,primary,pubescen,rachi,reflexed,ruit,scar,shallowly,shortest,single,slender,slightly,slit,somewhat,spaced,sparse,sparsely,spreading,straight,strongly,testal,third,tip,trichome,ud,uniseriate,unit,upper,upward,wall,widely,widest,woody,ympodial,–3	1.5-3,adhesion,annual,arrangement,blade,climate,colour,form,growth,hair,height,history,length,life,midpoint,na,number,perennial,plant,position,presence,pubescence,ray,reproduction,rugulose,seed,shape,size,staman,stellate,stipe,texture
537	wfo-0001029751	success	158	132	104	54	28	0.658	.5,0.6–1.6,1,1.2,1.7,1.8–4,10–11,10–19,1–2,2.2–2.5,2.5–5,2–4-celled,2–5,3,3–9,4,5–10,6,8–9,9–18,acicular,anther,apex,armed,attenuate,base,blade,broad-based,broadly,calyx,capitate,celled,clavate,cm,compressed,corolla,covered,cuneate,deltoid,diam,diameter,eglandular,extra-axillary,fruit,geminate,glabrous,glandular,globose,globose-ellipsoid,hair,immature,inner,leaf,length,lobe,long,membranaceous,midpoint,mm,moderately,needlelike,orbicular,outside,ovary,pedicel,peduncle,petiole,prickle,prickly,pubescent,ray,recurved,ripe,sessile,shallow,short,short-stalked,shrub,simple,size,small,solitary,sometimes,sparsely,spreading,stalked,stellate,stigma,straight,style,subcordate,surface,tooth,triangular,trichome,truncate,unarmed,variegated,white,wide,winged,yellow,±,×	1.3–2.6,12–14,1–3,2,2–3,4.5–6,5-merous,5–25-flowered,also,apical,central,di-,eaf,eed,elongate,enlarged,equal,geminat,gree,lanceolate,lateral,linear,linear-lanceolate,little,lon,longer,lower,midvein,nflorescence,one,opening,pair,pedunculate,perfect,planar,pore,ruit,scorpioid,shorter,smaller,somewhat,subtended,tal,tem,toward,trifoliate,twice,unbranched,unequal,unit,upper,usually,whitish,ympodial	adhesion,armature,arrangement,climate,colour,form,green,growth,height,history,inflorescence,life,margin,na,number,perennial,plant,position,presence,present,pubescence,reproduction,seed,shape,staman,stem,texture,tube
538	wfo-0001029758	success	261	125	106	155	19	0.406	.2,.5,0.2,0.5–0.7,0.6–0.9,0.7–0.8,0.7–1.3,0.8–1.3,0.9–1.0,0.9–1.2,0.9–1.5,1.0–3.4,1.1–1.8,1.2–1.4,1.2–1.9,1.3–1.7,1.7–2.8,10.3–14.5,2.1–6.2,2.2–2.9,2.3–3.3,2.3–6.4,2.8–2.9,2.8–4.2,5.8,7.6,7–9,8–11,abaxially,acuminate,adaxially,adnate,anther,apex,appearing,arcuate,attachment,attenuate,base,black,blade,calyx,capitate,chartaceous,cm,cordate,corolla,dark,deltoid,densely,diameter,dry,entire,evenly,extra-axillary,flattened-orbicular,flattened-reniform,flower,fruit,glabrous,globose,green,lateral,length,lobe,lobed,long,margin,markedly,mature,mm,nearly,notched,obtuse,occasionally,orbicular,oval,ovate,pedicel,peduncle,petiole,point,prostrate,pubescent,purple,ray,red-brown,reticulate,rounded,shrub,simple,stellate,stem,stigma,stipe,style,sub-coriaceous,surface,toward,tube,unarmed,vein,white,yellow,yellow-brown,×	.3,/4,0.4–1.2,0.8–1.1,1.1–1.5,1.8,1.9–2.6,1.9–2.7,1/3,1/4–1/3,3.1–3.8,3.2–3.5,3.5–4.8,3.6,4.1–6.3,4.3–4.8,4.3–6.2,4–6,5-merou,5.7–7.8,7–17,8.0–33.1,absent,aequilateral,ag,alyx,anthesi,apart,apical,apparently,appresse,arching,around,articulate,axe,ba,basal,bent,berry,broad,brochidodromous,bud,bulge,channeled,cream,curved,cylindrical,dentate,development,directed,directly,distal,distally,distinct,eaf,edge,eed,either,emerging,endocarp,equal,erect,exocarp,extending,fertile,filament,filiform,flexed,free,geminat,glossy,gradually,gree,heterostylous,immature,increasing,intact,internode,interpetalar,intersepalar,juic,lanceolate,layer,least,lon,longer,lower,many,midpoint,midrib,midvein,minute,moderately,nflorescence,observed,often,opaque,orolla,ove,per,perforated,persistent,petalar,pore,porrect,portion,potentially,presumably,raised,remaining,ridge,rigid,row,ruit,short,short-stipitate,shorter,side,sinus,sloughing,spaced,splitting,spread,spreading,stamen,stellae,stellate-pubescent,stipitate,straight,suture,tamen,tem,tetrafoliate,thin,though,tip,tissue,transparent,trifoliate,two,ud,unbranched,unit,various,vary,weakly,well,well-developed,wide,yellow-ferruginous,ympodial,young,±90°,±a,¼	adhesion,arrangement,colour,form,growth,inflorescence,leaf,number,ovary,position,presence,present,pubescence,rugulose,seed,shape,size,staman,texture
539	wfo-0001029769	success	142	94	58	84	36	0.408	.25,.5,0.5-1.5,1-3,1.5-2.5,2.5-3,2.5-8,3.5-4,5-8,6-17,7-8,8.5-17,acuminate,acute,anther,apex,base,brown,calyx,capitate,cm,corolla,dark,densely,dia,elliptic,fresh,glabrous,globose,green,hen,internodal,leaf,lobe,lobed,margin,minutely,mm,opposite,ovary,ovoid-reniform,papillose,pedicel,petiole,pitted,pubescent,shaped,shrub,smooth,sparsely,stem,stigma,style,surface,tear-drop,tube,white,x	1-1.2,1.5-2,30-60-flowered,4,4-5,8-9,abaxially,adaxially,along,anthesi,apar,ape,archin,ba,bark,bearing,berry,branch,brochidodromu,cerro,conical,curl-tipped,cyathiform,deflexed,deltoid,eaf,edicel,eed,exserted,filament,filiform,flower,free,fruiting,golden,horizontally,inglé,lateral,less,like,lon,long,lower,main,midrib,nearly,nflorescence,older,onto,pair,papillo,pore,poricidal,portion,puberulent,reflexed,ried,ruit,scar,scattered,simple,somewhat,spaced,straight,swollen,tall,three,time,tip,trichome,tub,two,ud,unevenly,unifoliat,uniseriate,unit,vein,wide,widely,winged,woody,ympodial,young	adhesion,arrangement,blade,climate,colour,diameter,form,fruit,glandular,growth,hair,height,history,inflorescence,length,life,midpoint,na,number,peduncle,perennial,plant,position,presence,pubescence,ray,reproduction,rugulose,seed,shape,size,staman,stellate,stipe,texture,unifoliate
540	wfo-0001029771	success	196	108	80	116	28	0.408	.5,0-0.5,0.1-0.3,0.3-0.6,0.3-1,0.4-0.7,0.4-1.4,0.45-0.9,0.9-1,1-1.5,1-2,1.2-2.8,2-2.3,2-3,2.5-10,2.5-7,3-4,4-7,4.5-12,5.5-8,7-8,absent,acute,anther,apex,base,blade,calyx,chartaceous,cm,connivent,cordate,densely,diameter,entire,erect,extra-axillary,fruit,glabrous,gland-tipped,globose,grey,hair,inflorescence,lanceolate,leaf,length,lilac,lobe,margin,mm,obtuse,ovate,pale,pedicel,peduncle,perennial,petiole,present,pubescent,purple,ray,red,reniform,reticulate,rhizomatous,rotate,rotate-stellate,scattered,short,shrub,simple,stellate-pubescent,stigma,style,surface,tube,white,x,yellow	%,0-0.25,0-0.6,0-3,0-4,0-5,0.05-0.15,0.2-0.25,0.2-0.4,0.4-1,0.5-0.7,0.5-1.2,0.7-1.2,0.7-1.8,0.8-1.2,1,1-5,1-locular,1.8-3,15-35,2,2-3-foliate,4-,5-10,5-9,5-merou,6-11,7-10,abaxially,absen,accrescent,across,adaxially,adult,alyx,apart,apparen,articulated,axe,ba,branch,capitat,contiguous,curved,cylindrical,deltate,directed,distall,distributed,dm,eaf,eed,eglandular,elliptic,exceeding,exocarp,filament,finger,flower,fruiting,geminate,green,grey-green,incomplete,interpetalar,juicy,juvenile,lamina,lateral,lon,long,lower,mature,mesocarp,mid-point,midpoint,minute,nearly,nflorescence,oblique,orolla,part,per,perfect,placenta,pore,porrect,prickle,pseudo-umbellate,rachi,ruit,septum,slightly,somewhat,spaced,stalk,stellae,straight,succulent,tal,tamen,tem,thick,throughout,time,tissu,tissue,unarme,unarmed,unbranched,unit,upper,vary,wide,yellowish,ympodial	adhesion,arrangement,capitate,colour,corolla,form,glandular,growth,height,history,life,na,number,ovary,plant,position,presence,pubescence,reproduction,rugulose,seed,shape,size,staman,stellate,stem,stipe,texture
541	wfo-0001029775	success	54	75	29	25	46	0.537	0.25-1.5,0.5-4,3-4,4-5.5,alveolate,base,brown,cm,diameter,flattened,glabrous,globose,light,margin,mm,orange,perennial,puberulent,sparsely,stigma,strongly,subshrub,surface,trichome,unbranched,unifoliate,vine,x,yellow	2-6,2-8,6-16,absen,aggregate,ecuador,eed,hollow,internode,long,prickle,recurve,ripe,robust,ruit,shin,straight,tal,tem,thickened,tone-cell,truncat,unit,wide,ympodial	adhesion,anther,apex,arrangement,blade,calyx,climate,colour,corolla,form,fruit,glandular,growth,hair,height,history,inflorescence,leaf,length,life,lobe,midpoint,na,number,ovary,pedicel,peduncle,petiole,plant,position,presence,pubescence,ray,reproduction,rugulose,seed,shape,size,staman,stellate,stem,stipe,style,texture,truncate,tube
542	wfo-0001029780	success	204	102	74	130	28	0.363	1-1.2,1-2,11-24,15-22,15-45,2-2.8,2-3.5,2-5.5,3.5-7.3,4-6,4.5-6,5.5-13,50-70,8-12,?,abaxially,adaxially,anther,articulated,brownish,chartaceous,cm,condition,cordate,corolla,dark,densely,diameter,distal,drying,fresh,fruit,glabrous,globose,green,greenish,half,herb,high,invested,lanceolate,length,lobe,membranous,minutely,mm,non-glandular,odd-pinnate,ovate,ovoid,pale,pedicel,peduncle,petiole,pinkish,plant,puberulent,pubescent,rotate,seed,short,size,stem,stigma,streak,stripe,style,terminal,trichome,tube,white,whitish,x,yellow	1-10,1.4-1.9,1.5-2,120-210,2-12,2-2.5,2.4-4.2,20-60,3,3-6,5-7,5-merou,5.5,600-950,absent,acumen,acute,ag,along,alyx,apart,apex,apparently,attenuate,axe,axillary,base,berry,blade,borne,bud,capitat,cell,ciliate,connivent,covering,cuneate,decumbent,digestion,dorsally,eaf,edge,eed,end,enzyme,erec,especially,exceeding,except,filament,flat,flower,folded,forked,geminat,generally,glabrou,gland,glandular,greatly,green-white,hair,hair-like,hal,head,homostylous,honeycomb-shaped,interjected,lateral,leaflet,lengthening,like,living,long,longer,lower,make,margin,midrib,minute,mucilaginous,nflorescence,obtuse,often,orbicular,orolla,pair,perfect,petiolulate,petiolule,plurifoliate,pore,poricidal,proximal,rarely,reduced,removed,ripe,ruit,sessile,seudostipule,singly,slit,spaced,specimen,stamen,ste,stolo,straight,subequal,subtending,tall,tamen,tem,testal,tetralobulate,thick,throughout,tip,tri-,truncate,tuber,typically,unit,unwinged,usually,vary,wall,wet,ympodial	adhesion,arrangement,calyx,capitate,colour,form,growth,height,history,inflorescence,leaf,life,na,number,ovary,perennial,position,presence,present,pubescence,ray,reproduction,rugulose,shape,staman,stellate,surface,texture
543	wfo-0001029784	success	237	114	90	147	24	0.38	-5,.1,.5,0.25-0.3,0.4-0.45,0.4-0.6,0.5-1.5,0.6-1,1-1.1,1-1.2,1-4,1.0-1.3,1.5-,1.7-2.6,2,2-,2-2.5,2-3-celled,2/3,3-,3-5,5-14,5-8,abaxially,adaxially,anther,apex,base,brown,calyx,capitate,cm,corolla,dark,densely,diameter,eglandular,elliptic,fruit,glabrescent,glabrous,glandular,globose,golden,green,head,herb,imparipinnate,inflorescence,interrupted,like,lobe,long,maturing,mm,mostly,multicellular,narrowly,obovate,ovary,pale,patent,pedicel,peduncle,pentagonal,perennial,petiole,plant,proximal,pubescence,pubescent,ripe,scattered,soft,sparsely,stem,stigma,stout,stripe,style,surface,thick,trailing,trichome,tube,uniseriate,velvety,white,wide,yellow	-12,.2,0-4,0.1-,0.1-0.15,0.1-0.5,0.2,0.2-,0.2-0.3,0.2-0.5,0.3-0.35,0.3-0.4,0.3-0.5,0.3-1,0.4-,0.4-0.5,0.5,0.5-,0.7-1.2,0.9-1.2,1,1-,1-1.5,1-2,1-2-celled,1.2-2.5,1/3,2-4,2-4.5,2-foliate,2-locular,2.5-3.5,5-10,abaxial,absent,abundant,acuminate,acute,adpressed,along,angled,anthesi,apical,appearance,appendage,arising,articulated,articulation,axi,basal,basicopically,beneath,berry,bract,broadly,cell,column,conical,crenate-serrate,crenation,decurrent,deeper,developed,distal,distributed,due,eaf,edicel,eed,enclosing,entire,evenly,exserted,filament,flower,fruiting,giving,gree,hair-like,hal,half,halfway,included,interjected,internode,interspersed,irregularly,lamina,lanceolate,larger,lateral,leaflet,live,lon,long-acuminate,loosely,lower,margin,markedly,nflorescence,node,northern,occasionally,often,orbicular,outgrowth,pair,paler,petiolule,population,present,primary,pseudostipule,rarely,reflexed,robust,ruit,secondary,sessile,silky,simple,smaller,sometimes,somewhat,sparse,spreadin,staminal,sterile,straight,strongly,tem,terminal,tertiary,testa,truncate,ud,undulate,unicellular,unit,unseriate,usually,vein,wall,winged,woody,x,ympodial	adhesion,arrangement,colour,form,growth,height,history,leaf,length,life,na,number,position,presence,ray,reproduction,rugulose,seed,shape,size,staman,stellate,texture,ye
544	wfo-0001029785	success	223	113	92	131	21	0.413	0.1-0.5,0.8-1,1-1.2,1-2,1-5,1.2-3.2,1.5-3.6,1.8-3.5,10-26,2-4,3-6,3.5-5,3.8-7.2,5-16,5-9,8-11,abaxially,adaxially,along,anther,axillary,broadly,brownish,bud,chartaceous,clavate,cm,commonly,condition,corolla,dark,darker,denser,diameter,drying,especially,fresh,fruit,glabrous,globose,green,greenish,hair,herb,invested,lanceolate,leaf,like,lobe,long,margin,medium,membranous,midrib,minutely,mm,mottled,multiple-celled,non-glandular,odd-pinnate,outer,ovate,ovoid,pedicel,peduncle,pentagonal,petiole,plant,puberulent,pubescent,purple,ripe,rotate,seed,short,size,slightly,sparsely,stem,stigma,style,subglabrous,subtending,terminal,tube,unbranched,vein,violet,whitish,wide,x,yellow	0-2,0-3,0.3-2.2,0.4-4.9,1-10,1.8-7,3-4,3-8,4-10.5,5-merou,6,absent,acumen,acute,ag,alyx,apart,apex,apparently,articulation,attenuate,axe,base,berry,blade,borne,capitat,cell,connivent,cordate,covering,cuneate,decreasing,decumbent,digestion,distal,dorsally,eaf,edge,eed,elliptic,end,enzyme,erec,exceeding,filament,flat,flower,folded,forked,geminat,generally,glabrou,greatly,green-white,hair-like,half,homostylous,honeycomb-shaped,interjected,larger,lateral,leaflet,lengthening,living,lower,make,markedly,middle,minute,much,mucilaginous,nflorescence,oblique,obovate,obtuse,one-quarte,orbicular,orolla,pair,pale,perfect,petiolulate,petiolule,plurifoliate,point,pore,poricidal,present,purple-tinged,quite,rarely,removed,rounded,ruit,scale-like,sessile,seudostipule,shallowly,singly,slit,sometimes,spaced,specimen,stamen,ste,stolo,straight,stripe,tall,tamen,tem,testal,thick,throughout,tip,toward,tri-,truncate,tuber,typically,unequal,unit,unwinged,usually,variable,vary,wall,wet,white,ympodial	adhesion,arrangement,calyx,capitate,colour,form,growth,height,history,inflorescence,length,life,na,ovary,perennial,position,pubescence,reproduction,shape,staman,texture
545	wfo-0001029788	success	194	121	96	98	25	0.495	.7,0.5,1-10,1-2,1.2-2,12-15,2-2.5,25-30,3.5-6,4,4-5,4.5-5,5-13,6,6.5-7,7-21,abaxially,adaxially,along,anther,apart,articulated,axillary,berry,brownish,bud,cell,chartaceous,ciliate,cm,condition,conical,connivent,corolla,covering,densely,diameter,distal,drying,especially,fresh,glabrous,green,green-white,greenish,hair-like,half,herb,lanceolate,lateral,leaf,light,lobe,long,make,margin,midrib,minutely,mm,mottled,mucilaginous,narrow,odd-pinnate,ovoid,pedicel,peduncle,petiole,plant,puberulent,pubescent,purple,ripe,rotate,seed,size,spaced,sparsely,stigma,straight,style,subtending,terminal,testal,thick,throughout,tip,tube,unwinged,violet,wall,wet,whitish,wide,wing,x,yellow	.4,0-5,0.7-2,1.5-2,2-4,2.4-5.5,3-4,4-6,5,5-merou,absent,acumen,acuminate,ag,alyx,apex,asymmetrical,attenuate,axe,base,basiscopic,blade,borne,c.,capitat,commonly,decreasing,digestion,dorsally,eaf,edge,eed,elliptic,elliptic-lanceolate,end,enzyme,equal,erec,filament,flat,flower,folded,forked,geminat,generally,glabrou,gradually,hal,homostylous,honeycomb-shaped,increasing,interjected,larger,leaflet,lengthening,living,lon,lower,middle,minute,nflorescence,orbicular,orolla,pair,petiolule,pilo,plurifoliate,pore,poricidal,ray,removed,ruit,secondary,semierect,sessile,seudostipule,side,singly,slightly,slit,specimen,stolo,subequal,subsessile,symmetrical,tall,tamen,tem,tissue,toward,tri-,tuber,typically,unit,usually,vary,white,ympodial	adhesion,arrangement,calyx,capitate,colour,form,fruit,growth,height,history,inflorescence,length,life,na,ovary,perennial,position,pubescence,reproduction,rugulose,shape,staman,stem,surface,texture
546	wfo-0001029789	success	167	96	69	98	27	0.413	0.2-0.5,1-2,1-3,12,2-6,2-6.5,2.7-4.7,3-8.5,4-10,4-13,5-7,6,6-7,7-16.6,7-21,8-9,abaxially,adaxially,anther,axillary,blue,broadly,bud,chartaceous,clavate,cm,connivent,corolla,dark,diameter,fruit,glabrous,green,herb,lanceolate,leaf,light,lilac,lobe,lunate,membranous,minute,minutely,mm,narrowly,odd-pinnate,ovary,ovate,pedicel,peduncle,pentagonal,petiole,plant,pubescent,rachi,rarely,rotate,size,sparsely,stigma,style,subglabrous,subtending,terminal,tinged,tube,white,x,yellow	0-2,0.5-2.8,0.8-3.5,1-10,1.5-2,1.7-8.5,1.8-6.5,2-25,2-3,3-5,5-merou,acumen,acuminate,acute,adaxiall,ag,alyx,apart,apex,apparently,articulated,attenuate,axe,base,basiscopic,blade,capitat,decreasing,decurrent,distal,dorsally,eaf,edge,eed,erec,exceeding,filament,flat,flower,folded,forked,formed,geminat,generally,greatly,hair,hal,half,homostylous,interjected,lant,lateral,leaflet,lengthening,like,linear,long,long-attenuate,lower,maturing,mottled,never,nflorescence,orbicular,orolla,pair,perfect,petiolulate,plurifoliate,pore,poricidal,pubescen,purpl,sessile,seudostipule,short,side,simple,slightly,slit,spaced,stamen,star,ste,sterile,straight,subequal,tall,tamen,tem,tip,toward,tri-,typically,unit,usually,vary,ympodial	adhesion,arrangement,calyx,capitate,colour,form,growth,height,hermaphroditic,history,inflorescence,length,life,na,perennial,position,pseudostipule,pubescence,purple,reproduction,rugulose,seed,shape,staman,stem,surface,texture
547	wfo-0001029810	success	149	119	86	63	33	0.577	.5,0.5-1,0.5-3,1-1.3,1-1.5,1-10,1-2,1.1-2.3,1.5-3,2.5-3,3-3.5,3-4,3-6,5-16,5-6,acuminate,acute,adaxially,along,anther,apex,apically,arachnoid,attenuate,base,brown,calyx,capitate,cm,compact,compressed,corolla,dark,dendritic,densely,dia,elliptic,glabrous,globose,green,inflorescence,internodal,leaf,like,lobe,lobed,long,margin,minutely,mm,narrowly,nearly,occasionally,opposite,ovary,ovoid-reniform,pale,papillose,pedicel,petiole,pitted,pointed,pore,poricidal,pubescent,reddish-brown,rest,shaped,shining,shrub,size,small,sparsely,stem,stigma,style,surface,tan,tear-drop,tip,tree,trichome,tube,vein,white,wide	.25,1-3,2-3,2-5,4-10,5-15-flowered,8-12,abaxially,anthesi,ape,bark,berry,closely,congested,conical,deflexed,deltate,differing,difoliate,drying,eaf,edicel,eed,ellipsoid,exserted,filament,fleshy,free,fruiting,geminat,glabrou,large,later,lateral,lenticel,less,lon,lower,main,major,middle,minor,nflorescence,older,overlappin,papillo,planar,portion,ruit,scar,simple,slender,spaced,tall,tapering,tub,ud,unit,widest,woody,yellowish,ympodial,young	adhesion,arrangement,blade,climate,colour,diameter,form,fruit,glandular,growth,hair,height,history,length,life,midpoint,na,number,peduncle,perennial,plant,position,presence,pubescence,ray,reproduction,rugulose,seed,shape,staman,stellate,stipe,texture
548	wfo-0001029811	success	225	101	77	148	24	0.342	-3,0-35,0.1-0.4,0.3-1,1.3-1.7,1.5-6,1/3,13-20,2-2.5,2.5-3,2.8-3.2,3-5.5,4-8,4.5-5,5-11,5-17,6-12,7-9,8-12,anther,apex,base,berry,blade,brown,calyx,chartaceous,cm,connivent,cordate,cuneate,dark,diameter,equal,flattened-reniform,fruit,glabrous,glandular,hair,herb,lateral,leaf,length,lobe,lobed,long,margin,maturity,mauve,midpoint,mm,moderately,obtuse,orange-brown,ovate,pedicel,peduncle,petiole,plant,poricidal,ray,scandent,shrub,simple,sometimes,spherical,stellate,stellate-pubescent,stem,style,surface,tapering,tip,tube,upper,wide,yellow	-6,-merous,.5,/3,0,0-30,0.1-0.3,0.2,0.2-0.6,0.3-1.5,0.5-2,0.8-1.5,1,1-1.5,1-2.5,1-3,1.5-2.5,1/,1/2-2/3,1/3-2/3,10-22,15-23,15-50,2-5,2-5.5,20-100,3-5,3-7,3.5-4.5,5,5-40,5-9,7-18,8-18,abaxial,abaxially,acicular,adaxial,alyx,andromonoecious,apar,apart,apically,apparently,articulated,bark,broad-deltate,cell,cream,densely,discolorous,distal,distance,drying,eaf,eed,elongate,elongating,erect,extending,eye,faint,fewer,filament,flattened,flower,free,fruiting,green,green-brow,hermaphrodite,heterostylous,inflated,infructescence,less,lobing,long-acuminat,long-styled,longer,lower,lowermost,marking,mature,midvein,minute,multangulate,naked,narrow-deltate,nflorescence,often,older,one,open,orolla,oung,outline,pair,pale,pendulous,per,pericarp,perpendicular,pit,plurifoliat,porrect,portion,prickl,prickle,prickly,primary,raised,ruit,scar,secondary,sessile,short,short-styled,shorter,side,slightly,small,smooth,spaced,sparsely,spreading,stalk,stalked,staminat,stout,straight,tamen,terete,tertiary,time,trichome,unarmed,unbranched,unit,usually,vary,vein,venation,visible,way,woody,yellow-green,ympodial,young	adhesion,arrangement,climate,colour,corolla,form,growth,height,inflorescence,na,number,ovary,position,presence,present,pubescence,rugulose,seed,shape,size,staman,stigma,stipe,texture
549	wfo-0001029938	success	179	109	85	94	24	0.475	0.5,0.7-1,0.7-1.2,1,1-1.5,1-2.5,1-3,1-4,1.5-2,1.5-2.5,12,2-2.5,2.5-3,3-7,3/4,5,6-8,6-9,abaxially,anther,apex,appearing,base,becoming,berry,black,bright,calyx,capitate,clavate,cm,corolla,dendritic,densely,diameter,elliptic,fine,flattened,free,fruit,glabrate,glabrous,globose,greenish,grey,growth,later,lateral,leaf,length,lenticular,lobe,maturity,minutely,mm,narrowly,near,occasionally,ovary,pedicel,pericarp,petiole,pitted,plant,plurifoliate,poricidal,pubescent,red,reddish-brown,shrub,small,stem,stigma,style,surface,terminal,thin,tip,tree,trichome,tube,violet,way,white,x	.5,0,1.2-1.5,1/2,10-20,12-15,4,8-10,absent,accrescent,acute,adaxially,along,anthesi,apical,ba,bark,basal,blade,branching,broader,conical,deciduous,deflexed,deltoid,denser,dichasia,discussion,drying,eaf,edicel,eed,elliptical,entire,ew,exserted,filament,flower,fruiting,glabrou,growing,horizontal,inserted,larger,lon,long,long-triangular,lower,m.,margin,monochasial,nflorescence,older,overtopping,pair,papillo,parallel,per,perhaps,planar,plane,pore,portion,prominent,pyramidal,raised,ruit,scar,secondary,see,shade,shoot,sleeve,slit-like,somewhat,soon,sparsely,specimen,stamen,strongly,tall,tapering,time,tub,ud,unit,upon,upper,vein,wide,winged,woody,ympodial,young	adhesion,arrangement,colour,form,height,history,inflorescence,life,na,number,peduncle,perennial,position,presence,pubescence,ray,reproduction,rugulose,seed,shape,size,staman,stellate,texture
550	wfo-0001029945	success	211	113	90	121	23	0.427	0-0.6,0.15-0.25,0.2-0.3,0.4-0.5,0.7-1.2,1.3-3.5,1.5-4,1.8-2.4,10-17,15-24,2.1-3.3,2.5-2.8,3-17,3-6,4-5.5,5-8,6-8,7-24,9-10,abaxially,absent,acute,adaxially,andromonoecious,anther,apex,base,blade,broadly,calyx,chartaceous,cm,cordate,cylindrical,dark,deeply,densely,diameter,erect,extra-axillary,flower,fruit,glabrous,gland-tipped,globose,green,grey,hair,inflorescence,lanceolate,leaf,length,lobe,lobed,long,margin,mid-point,mm,oblique,obtuse,ovate,pale,pedicel,peduncle,perennial,petiole,plant,present,purple,ray,rhizomatous,rotate,shallowly,short,shrub,simple,sparsely,stellate,stellate-pubescent,stem,stigma,streak,style,thick,throughout,tube,weakly,white,x,yellow	%,.05,0,0-0.3,0-0.5,0-1,0-10,0-2,0.35-0.45,0.4-0.7,0.5,0.8-1,1-1.3,1-1.5,1-3,1-8,1.2-1.6,1.4-2.7,1.7-4,17-26,2-30,2-4,2-5,2-locular,3-5,3-9,4-10,4-7,4-9,5-merou,5.5-17,6-10,6-7,7-14,7-9,9-24,abaxial,absen,accrescent,acicular,across,adaxial,adaxiall,adult,alyx,anvil-shape,apart,armed,articulated,attenuate,ba,broad-based,connivent,cross-section,d.,directed,distall,distally,dult,eaf,eed,eglandular,exocarp,filament,finger,fruiting,functional,geminate,half,heterostylous,hig,index,juicy,juvenile,lateral,less,lobing,lon,longer,lower,markedly,mature,mesocarp,midpoint,midvein,minute,mixed,moist,nflorescence,orolla,pair,part,per,placenta,pore,porrect,prickle,pseudo-racemose,ruit,sessile,side,stalk,stalked,stellae,straight,surface,tamen,thicker,time,transparent,triangular,truncat,unarmed,unbranched,unit,upper,vary,vein,wide,yellowish,ympodial	adhesion,arrangement,colour,corolla,form,glandular,growth,height,history,life,na,number,ovary,position,presence,pubescence,reproduction,seed,shape,size,staman,texture,truncate
551	wfo-0001029968	success	299	133	107	192	26	0.358	.25,0.2-0.4,0.25,0.25-0.3,0.3-1,0.4,0.7-0.9,0.7-2,0.8-1.2,1-2.5,1.2-5.5,1.5-2.5,1/4-1/3,2-2.3,2-3,2.5-3.5,2.8-3,3-11,3-4,4-6,6-8,7-9,abaxially,acuminate,adaxially,along,anther,anthesi,apex,base,berry,black,branch,brown,calyx,capitate,chartaceous,clavate,clustered,cm,corolla,cuneate,dark,deltoid,densely,diameter,distributed,drying,entire,evenly,flattened-reniform,free,fruit,glabrous,gray,inflorescence,large,lateral,leaf,length,like,lobe,long,margin,mature,midpoint,mixture,mm,oblique,oblong,orange,orange-brown,outside,ovate,pale,pedicel,peduncle,petiole,present,pubescent,ray,rounded,rounded-undulate,seed,shiny,shoot,shrub,simple,size,small,sparsely,spheroidal,stellate,stellate-pubescent,stem,stigma,strongly,style,surface,tapering,terminal,tip,toward,trichome,tube,x,young	-2,-3,.2,.5,.7,/3,0,0.1-0.25,0.15,0.3,0.3-0.4,0.4-0.6,0.5,0.7-1,0°,1,1-3,1.5,1.5-3,1/6-1/8,2.5-4,2.5-5.5,4,4-7,4-8,4-merou,absent,accrescent,acicular,acute,adjacent,age,almost,alternate,alyx,apart,apically,apparently,area,arising,armed,articulated,articulation,bark,basally,becoming,brachyblast,branched,branching,ca,canaliculate,central,cordate,covered,cupular,curved,dehiscence,detaching,development,dilated,discolorous,divided,dry,eaf,early,edge,eed,ellipsoi,elongating,equal,erect,except,extending,fasciculate,filament,filiform,finely,flat,flattened,flexuous,flower,forming,fruiting,glabrescent,grey-green,greyish,increasing,indumentum,inside,invisible,irregular,irregularly,large-leaved,leave,leaved,lengt,lengthening,less,line,lobed,lobing,looping,lower,m.,main,maturity,middle,midvein,minor,network,nflorescence,nther,obconical,obscured,obscurely,occasionally,often,opposite,orolla,ovoid,pair,paler,papillose,patch,pendulous,per,perfect,pericarp,pit,pitted,plurifoliat,pore,poricidal,porrect,portion,prickle,primary,prior,prominent,protruding,rachi,raised,red,reddish,reduced,regular,remnant,ridged,ruit,scar,secondary,seemingly,seen,sessile,shorter,sinus,small-leaved,smoot,smooth,sometimes,somewhat,sparse,specimen,spreading,stalk,stalked,straight,stump,tearing,terete,tertiary,thicker,thin,translucent,ud,unarme,unarmed,undulate,uneven,unit,usually,variable,vary,vein,venation,virtually,visible,white,wide,widening,wrinkled,ympodial	adhesion,arrangement,blade,climate,colour,form,glandular,growth,hair,height,history,life,na,number,ovary,perennial,plant,position,presence,pubescence,reproduction,rugulose,shape,staman,stipe,texture
552	wfo-0001029978	success	208	107	84	124	23	0.404	0.3-0.4,0.5-0.6,1-2,1.3-1.5,1.4-1.5,1.5-3.1,15-27,3-5,3-7,3.2-2.5,3.5-9.5,3.7-8.1,4-11,4-7,4.2-5.2,5-16.5,8-10,abaxially,adaxially,along,anther,axillary,brownish,bud,chartaceous,ciliate,clavate,cm,coarsely,condition,conical,corolla,diameter,drying,elliptic,especially,finely,fresh,fruit,glabrous,green,greenish,hair,herb,lanceolate,leaf,light,like,lobe,long,margin,membranous,midrib,minutely,mm,mottled,odd-pinnate,ovate,ovoid,pedicel,peduncle,pentagonal,petiole,plant,puberulent,pubescent,purple,ripe,rotate,seed,simple,size,sparsely,stem,stigma,style,subtending,terminal,tip,tube,whitish,wide,x,yellow	0.3-0.7,0.7-1.9,0.8,0.9-2.3,1-10,1.8-5,11-19,2-4,3.1-6.3,5,5-merou,acumen,acuminate,ag,alyx,apart,apex,apparently,arranged,articulated,asymmetrical,attenuate,axe,base,basiscopic,bead,berry,blade,capitat,cell,commonly,connivent,covering,dark,darker,decreasing,digestion,distal,dorsally,eaf,edge,eed,enzyme,erec,exceeding,filament,flat,flower,folded,forked,fourt,geminat,generally,glabrou,gradually,green-white,hair-like,half,homostylous,honeycomb-shaped,interjected,larger,lateral,leaflet,lengthening,less,living,lower,make,medium,middle,minute,moniliform,mucilaginous,multiple,narrow,necklace,nflorescence,orbicular,orolla,pair,perfect,petiolule,plurifoliate,pore,poricidal,pubescen,ray,removed,ruit,secondary,semierect,sessile,seudostipule,side,slightly,slit,spaced,specimen,stamen,ste,stolon,straight,subequal,subsessile,symmetrical,tall,tamen,tem,testal,thick,throughout,tissue,toward,tri-,tuber,typically,unit,usually,vary,wall,wet,wing,ympodial	adhesion,arrangement,calyx,capitate,colour,form,growth,height,history,inflorescence,length,life,na,ovary,perennial,position,pubescence,reproduction,rugulose,shape,staman,surface,texture
553	wfo-0001029980	success	173	122	90	83	32	0.52	0.25-0.5,0.25-1,0.5-1,0.5-1.2,0.5-2.5,0.5-5,0.7-1.3,0.8-1.2,1-1.5,1.2-2.5,1.5-2,2-5,2/3,3-4,3-9,6.4-17,abaxially,acute,anther,apex,axil,base,bright,brown,calyx,cm,corolla,dark,decurrent,deflexed,dia,elliptic,flattened-reniform,glabrous,globose,gray,green,greenish-white,lateral,leaf,live,lobe,lobed,long,main,margin,minutely,mm,near,node,onto,opposite,ovary,ovate,pale,papillose,pedicel,petiole,pitted,plant,pore,poricidal,puberulent,rounded,shape,shaped,shiny,shrub,size,slender,slightly,small-capitate,somewhat,stem,stigma,style,surface,tan,tapering,tear-drop,tip,trichome,tube,tuft,uniseriate,vein,way,white,winged,x	.1,.5,0.1-0.25,0.9-4.5,1-1.7,1.5-6,2-6,5-10,5-50-flowered,adaxially,anthesi,apar,appearing,appressed,ba,bark,berry,black,bud,closely,conical,curved,deltoid,density,differing,difoliate,dried,drying,eaf,edicel,eed,elevation,especially,exserted,filament,five,free,fruiting,geminat,greatly,high,impressed,incrassate,knob,lon,lower,major,material,middle,minor,nflorescence,often,older,one,orbicular,overlapping,pair,paler,portion,prominent,proximal,race,reflexed,ruit,scar,side,simple,soon,spaced,specimen,straight,tall,ud,unicellular,unit,varying,venezuelan,whit,widest,woody,yellowish,ympodial,young	adhesion,arrangement,blade,climate,colour,diameter,form,fruit,glandular,growth,hair,height,history,inflorescence,length,life,midpoint,na,number,peduncle,perennial,position,presence,pubescence,ray,reproduction,rugulose,seed,staman,stellate,stipe,texture
554	wfo-0001029989	success	161	92	69	92	23	0.429	0.25-0.5,0.5-1,0.5-1.5,1-1.5,1-2.5,1.3-2.3,2.5-3,3-5,3-8,3.5-8,4-4.5,7-20,abaxially,adaxially,anther,base,calyx,capitate,cm,corolla,dendritic,densely,dia,difoliate,elliptic,flattened,glabrous,globose,golden,gray,green,greenish-black,incrassate,inflorescence,internodal,leaf,lenticular,lobed,long,margin,minutely,mm,nearly,occasionally,opposite,ovary,pedicel,petiole,pitted,poricidal,pubescence,pubescent,reddish-brown,shining,shrub,small,sparsely,stem,stigma,style,surface,tip,tree,tree-like,trichome,unifoliate,white,wide,x	.2,.5,/2,1-2,1-4,1.5-2.5,10-14,5-10-flowered,5-6,abaxial,acute,anthesi,apex,bark,berry,branch,branched,broadly,brownish-re,central,closely,collection,congested,conical,deflexed,deltoid,dense,described,dimaeter,discussion,drying,due,eaf,edicel,eed,erect,exserted,filament,fleshy,free,fruiting,geminat,heteromorphic,inflorescenc,lamina,lateral,like,lobe,lon,lower,main,middle,nflorescence,nodding,northern,older,overlappin,pair,papillo,peru,peruvian,perú,petal,petaloid,planar,population,pore,portion,probably,reddish,rest,ruit,scar,scattered,see,shaped,short-style,simple,somewhat,spaced,tall,tear-drop,tube,ud,unit,vein,way,widest,woody,yellow,ympodial,young	2.5-6,arrangement,brownish-red,colour,diameter,form,fruit,growth,height,history,length,life,na,peduncle,perennial,plant,position,reproduction,rugulose,seed,shape,size,texture
555	wfo-0001030000	success	155	94	65	90	29	0.419	-7,0.5-,0.5-1,0.5-3,1-,1-10,1-2,1.5-,1.5-2,15-25,2-2.5,2-5,2.5-,2.5-3,2.5-3.5,3-16,3-4,3.5-5,4-4.5,4-5,abaxially,adaxially,also,calyx,cm,densely,diameter,eglandular,ellipsoidal,flattened,fruit,glabrous,globose,green,hair,immature,lobe,long,mature,mm,moderately,oblong,occasionally,orange,pedicel,peduncle,pilose,puberulent,purplish,shrub,small,sparsely,spotted,stellate,stigma,style,tinge,tree,truncate,tube,white,x,yellow,yellow-brown,yellowish	-4,-5,-50,-pilose,0.5-14,1,10-,10-20,2-3,2-4,25-30,3-,30-50,4,4-foliat,7-15,absent,acute,aggregate,apart,ape,apex,apiculate,articulated,axe,base,biglandula,cell,chartaceous,ciliat,connective,connivent,conspicuous,coriaceous,creamy-whit,cucullate,deltate,dia,dilated,directed,distally,eed,equal,exceeding,flower,laterally,leaving,lon,lower,margin,narrowly,nflorescence,nther,obtuse,orolla,ovoid,pedicellar,perfect,pore,produced,pubescen,pubescent,rachi,radiu,rarely,remnant,ruit,scar,shorter,slightly,smal,spaced,stamen,stone,strongly,subcoriaceous,swelling,tal,tem,thecae,tip,tomentose,triangular,ud,umbrella-shaped,unbranched,unit,vary,wide,ympodial	adhesion,anther,arrangement,biglandular,colour,corolla,form,growth,height,history,inflorescence,leaf,length,life,na,ovary,plant,position,presence,pubescence,reproduction,rugulose,seed,shape,size,staman,stem,surface,texture
556	wfo-0001030000	success	178	109	82	96	27	0.461	-7,-pilose,0.5-,0.5-1,0.5-13,0.5-3,1-10,1-5,1.5-,15-25,2-,2-2.5,2-3,2-5,2.5-,2.5-3.5,3-,3-16,3-4,3.5-5,4-25,4-4.5,4-5,5-25,abaxially,acuminate,acute,adaxially,also,apex,basal,base,calyx,cm,cordate,densely,diameter,ellipsoidal,entire,flattened,fruit,glabrescent,glabrous,globose,green,immature,lobe,margin,mature,mm,moderately,oblique,oblong,occasionally,often,orange,ovate,pedicel,peduncle,petiole,pilose,puberulent,purplish,shrub,simple,small,sparsely,spotted,stellate,stigma,style,subcoriaceous,tinge,tree,truncate,tube,vein,white,x,yellow,yellow-brown,yellowish	-2,-4,-5,-50,0.5-14,1,1-,1-1.5,1-2,1.5-2,10-,10-20,2-4,2.5-3,25-30,30-50,4,4-foliat,7-15,absent,aggregate,apart,ape,apiculate,articulated,axe,biglandula,blade,cell,chartaceous,ciliat,connective,connivent,conspicuous,coriaceous,creamy-whit,cucullate,deltate,dia,dilated,directed,distally,eaf,eed,eglandular,elliptic,equal,exceeding,flower,hair,laterally,leaving,lon,long,lower,narrowly,nflorescence,nther,obtuse,orolla,ovoid,pedicellar,perfect,pilo,pore,produced,pubescen,pubescent,rachi,radiu,rarely,remnant,ruit,scar,shorter,slightly,smal,spaced,stamen,stone,strongly,swelling,tal,tem,thecae,time,tip,tomentose,triangular,ud,umbrella-shaped,unbranched,unit,vary,wide,ympodial	0.5-2.5,anther,arrangement,biglandular,colour,corolla,form,growth,height,history,inflorescence,leaf,length,life,na,ovary,plant,position,pubescence,reproduction,rugulose,seed,shape,size,stem,surface,texture
557	wfo-0001030004	success	177	109	78	99	31	0.441	0-1.5,0.2-1,0.3-1,1-1.5,1-2,1.2-2,1.5-2.5,2-20,3-3.5,3-4,3.5-5,4-15,5-25,9-30,acuminate,acute,adaxially,anther,apex,base,blade,calyx,capitate,cm,corolla,dendritic,dia,elliptic,flattened-reniform,glabrous,globose,green,hard,inflorescence,later,lateral,leaf,lobe,lobed,long,loose,margin,minutely,mm,nearly,obovate,occasionally,ovary,pale,pedicel,petiole,pitted,plant,plurifoliate,pubescence,pubescent,seed,sessile,shaped,shrub,small,sparsely,stem,stigma,style,surface,tan,tear-drop,terminal,translucent,tree,trichome,tube,white,wide,woody,x,yellowish-green	.3,0-0.5,0.8-1.1,15,15-20,20-200-flowered,abaxial,abaxially,across,along,always,anthesi,apar,appearanc,axillary,barely,bark,basal,berry,body,branched,branching,broadly,bushy,collection,cone,conical,crotaloid,decurrent,deltate,dense,densely,denser,diamete,distal,drying,eaf,edicel,eed,erect,especially,exserted,filament,flat,fleshy,free,fruiting,giving,greenish-yello,incrassate,juvenile,knob,lamina,large,like,lower,main,many,middle,much,nflorescence,obovoid,often,older,onto,pair,papillate,papillo,pericarp,planar,pore,poricidal,portion,possessing,prominent,rest,ruit,scar,simple,spaced,stout,strongly,surpassing,tall,thick,thin,time,tip,tub,tuft,ud,unevenly,variously,vein,widest,winged,yellowish,ympodia,young	adhesion,arrangement,climate,colour,diameter,form,fruit,glandular,greenish-yellow,growth,hair,height,history,length,life,midpoint,na,number,peduncle,perennial,position,presence,ray,reproduction,rugulose,shape,size,staman,stellate,stipe,texture
558	wfo-0001030007	success	168	96	70	98	26	0.417	0.1-0.5,0.2-1,0.5-1,0.8-1,1-1.5,1-15,1-2,1.6-2.2,15-20,2-4,3/4,4.5-5,7-10,7-9,along,anther,base,beneath,brown,calyx,clavate,cm,corolla,decurrent,densely,dia,dry,elliptic,flattened,glabrous,globose,golden,golden-pubescent,green,leaf,live,lobe,lobed,long,material,midrib,minutely,mm,opposite,ovary,pale,pedicel,petiole,pitted,plant,poricidal,pubescent,reniform,shrub,small,soft,sparsely,stem,stigma,style,surface,tip,tree,trichome,tube,uniseriate,way,white,winged,x	.05,.4,.5,1.5-5,2-7,3-5,6-10-flowered,abrupt,acuminate,acute,anthesi,apart,apex,ba,bark,becoming,berry,branched,broadly,bud,campanulate,closely,cork,dark,deltoid,difoliate,edicel,eed,erect,exserted,filament,fleshy,free,fruiting,geminateleaf,glabrate,gre,hooded,impressed,incrassate,inflorescenc,lateral,like,lon,longer,lower,main,major,margin,middle,minor,nflorescence,oblique,obovoid,occasionally,older,one,onto,outline,pair,papillo,papillose,planar,pore,portion,prominent,raised,rest,rounded,ruit,scar,shaped,short,shorter,simple,slender,slightly,soon,spaced,specimen,straight,tall,tapering,tear-drop,thick,thickened,trunk,tub,two,type,ud,unit,vein,widening,widest,woody,ympodial,young	0.5,2,adhesion,arrangement,colour,diameter,form,fruit,growth,height,history,inflorescence,length,life,na,peduncle,perennial,position,pubescence,reproduction,rugulose,seed,shape,size,staman,texture
559	wfo-0001030010	success	156	100	81	75	19	0.519	.75,/4,0.5-5,0.9-1.1,1-1.3,1-2,1.2-1.5,1.5-2,10-15,2-2.2,2-7,2.5,20-40,4-4.5,5-7,anther,area,bark,base,beneath,brown,calyx,cm,corolla,dark,deciduous,decurrent,deflexed,dia,fruit,glabrate,glabrous,globose,green,grey,leaf,lobe,lobed,midrib,minute,minutely,mm,near,nearly,obovate,occasionally,older,opposite,ovary,ovoid-reniform,papillose,pedicel,petiole,pitted,pore,poricidal,puberulent,reddish,shaped,shrub,size,slightly,small,smooth,soon,stem,stigma,style,surface,tear-drop,tiny,tip,tree,trichome,tube,uniseriate,way,white,winged,woody,x	.5,0.7-1,1-1.5,10-50-flowered,11-12,3-5,7-10,acuminate,acute,anthesi,apex,appearing,attenuate,basal,berry,bud,closely,cyathiform,deltate,differing,difoliate,distal,dry,eaf,edicel,eed,ellipsoid,exserted,f,filament,fleshy,free,fruiting,furcate,geminat,hooded,lateral,lon,long,lower,m.,main,major,margin,materia,material,middle,minor,nflorescence,often,one,orange,overlappin,pair,persistent,planar,portion,prominent,rather,ruit,scar,shin,simple,spaced,straight,styl,tall,tapering,trunk,ud,unit,vein,widest,ympodial,young	colour,diameter,form,growth,height,history,inflorescence,length,life,na,perennial,plant,position,pubescence,reproduction,seed,shape,shiny,texture
560	wfo-0001030023	success	171	105	75	96	30	0.439	0.5-1,1,1-8,1.5-7,10-25,2,2-3,2.5-3.5,3-4.5,3-5,30-50+,4,4-12,5-16,5-6,6-26,6-7,7-9,abaxially,acute,adaxially,apex,base,calyx,cm,cordate,cuneate,deeply,densely,diameter,ellipsoidal,elliptic,entire,especially,finely,flattened,fruit,glabrous,glandular-puberulent,globose,greenish-white,lobe,margin,mm,moderately,narrowly,oblique,oblong,occasionally,often,ovate,pedicel,peduncle,peltiform,petiole,puberulent,pubescence,pubescent,purplish-,radiu,short-acuminate,simple,sparsely,stellate,stigma,style,subcoriaceous,tree,triangular,truncate,unknown,villous,x,yellowish,young	-,0-100+,1-,1-2,1.5-2,10-,11-40+,12-18,13-20,20-30,4-10,4-foliat,5,5-,aggregate,apart,ape,apiculate,articulated,axe,basal,beyond,blade,branched,capitat,cell,ciliate,color,connective,connivent,cylindrical,denser,dilated,directed,distally,eaf,eed,exceeding,except,exserted,fleshy,flower,forked,glandular-puberulen,hair,highly,lanceolate,leaving,lon,long,loosely,lower,main,membranaceous,narrow,near,nflorescence,nther,obtuse,orolla,pedicellar,perfect,pore,presen,present,probably,prominent,pubescen,pubescent-pilo,rachi,remnant,ripe,ruit,shorter,slightly,small,somewhat,spaced,stamen,stone,swelling,tal,tem,thecae,time,tip,tube,ud,unbranched,unit,unknow,usually,vary,vein,wide,ympodial	abaxial,adaxial,anther,arrangement,capitate,colour,corolla,form,growth,height,hermaphroditic,history,inflorescence,leaf,length,life,na,ovary,perennial,plant,position,pubescent-pilose,reproduction,rugulose,seed,shape,size,stem,surface,texture
561	wfo-0001030032	success	250	92	70	180	22	0.28	0.2-0.5,0.25-0.4,0.5-0.6,0.5-0.7,1-1.3,1-1.5,11-20,13-35,2-3-locular,2-4,2-5,2.4-3.5,3.0-3.5,3.5-12,30,4.3-5.0,60-80,8-10,8-20,anther,bright,brown,calyx,capitate,cm,conical,corolla,densely,diameter,elliptic,free,fruit,glabrous,golden,green,greenish-brown,imparipinnate,interrupted,leaf,length,lobe,long,mm,oblanceolate,obovate,orbicular,ovary,pale,pedicel,peduncle,petiole,present,pubescence,pubescent,rotate,rotate-stellate,seed,simple,stem,stigma,style,surface,thick,trichome,tube,uniseriate,vine,wide,woody,yellow	+,.05,.5,0.1-0.4,0.1-0.5,0.2,0.2-0.3,0.4-1.5,0.5,0.5-1,0.5-1.5,0.5-2,0.6-1.1,0.7-0.8,0.8-1.0,0.8-1.1,1-2-celled,1-3,1-celled,1.5-2,1.5-2.5,2,2-10,2-3.5,2-60,2-lobed,3,3-5,4-5,4-6-celled,4-celled,5-plurifoliate,6-11,7-16,7.5-10,8-10-celled,abaxially,absent,abundant,acuminate,acute,adaxial,adaxially,along,also,anthesi,apex,apical,appearance,appendage,articulated,articulation,basal,basally,base,basiscopically,bent,border,branche,branched,breaking,cell,clambering,column,completely,conspicuou,dark,decurrent,deltate,densest,desne,dry,eaf,ebracteate,edicel,eed,entire,exserted,filament,flower,fruiting,give,glandular,gree,hair-like,halfway,hea,head,herbarium,interjected,internode,irregularly,lamina,large,larger,lateral,leaflet,leave,like,longest,lower,many,margin,markedly,middle,midvein,mixed,moderately,much,multicellular,nflorescence,node,oblique,occasionally,often,older,onto,opposite,outgrowth,pair,paler,patent,petiolule,pithy,primary,pseudostipule,rachi,reflexed,rest,rough,round,ruit,secondary,set,shorter,silky,slightly,smaller,soft,sometimes,somewhat,sparsely,sparser,specimen,splitting,spreading,stamen,staminal,sterile,straight,subopposite,swollen,tall,tangled,tem,terminal,tertiary,testa,thickened,time,tiny,tip,touch,transparent,truncate,ud,unicellular,unit,usually,vegetatio,vein,venation,wall,weaker-walled,well-developed,white,winged,ympodial,younger,½-3/4	adhesion,arrangement,colour,dense,form,growth,height,history,inflorescence,life,na,perennial,plant,position,presence,reproduction,rugulose,shape,size,staman,stellate,texture
562	wfo-0001030048	success	156	116	80	76	36	0.513	0.5-1.5,1-1.5,1-2,1.2-2,1.3-1.6,1.5-7,2-3,2-5,3-3.5,3-5,4-15,4-4.5,5-8,abaxially,acute,adaxially,along,anther,apex,apically,arachnoid,base,bi-lobed,blue,calyx,clavate,cm,corolla,decurrent,densely,dia,difoliate,elliptic,felt-like,glabrous,globose,green,greyish,internodal,leaf,lobe,lobed,long,main,margin,matted,minutely,mm,nearly,occasionally,onto,opposite,ovary,ovoid-reniform,pale,pedicel,petiole,pitted,pointed,poricidal,pubescent,reddish-brown,shiny,shrub,small,somewhat,sparsely,stem,stigma,style,surface,tan,tip,tree,trichome,trifoliate,tube,vein,white,wide	.5,1.5-3.5,10-16,5-10-flowered,5973,abaxial,anthesi,ape,apparently,bark,becoming,berry,bi-colored,broadly,brown,closely,completely,conical,covered,deflexed,deltate,drying,eaf,edicel,eed,ellipsoid,exserted,fide,filament,fleshy,four-angle,free,fruiting,geminat,glabrate,golden,impressed,inflorescenc,lamina,lateral,lightly,like,lon,lower,middle,nflorescence,older,overlappin,pair,papillo,papillose,planar,pore,portion,prominent,rather,rest,ruit,scar,shaped,simple,solomon,spaced,strongly,tall,tear-drop,thick,thickened,tub,ud,unit,widest,woody,yellowish,ympodial,young	adhesion,arrangement,blade,climate,colour,diameter,form,fruit,geminate,glandular,growth,hair,height,history,inflorescence,length,life,midpoint,na,number,peduncle,perennial,plant,position,presence,pubescence,ray,reproduction,rugulose,seed,shape,size,staman,stellate,stipe,texture
563	wfo-0001030053	success	141	88	52	89	36	0.369	0.5,0.5-1,1-1.3,1-13,1.3-3.5,1.8-2,2-2.5,2.5-3,3.5-4,<,abruptly,acuminate,acute,apex,base,brown,calyx,cm,coriaceous,corolla,decurrent,diameter,elliptic,entire,flattened,glabrous,greenish,growth,inflorescence,lobe,margin,minutely,mm,pale,pedicel,peduncle,petiole,pitted,reniform,revolute,simple,slightly,stem,surface,terminal,truncate,tube,vine,white,woody,x,yellowish	1.5-5.5,10-20,100,4-,5,5-merou,7-11,7-9,abscission,aiding,alyx,anthesi,apart,apical,apiculae,ark,around,articulated,berry,bfeore,branch,branched,cell,climbin,completely,cyathiform,eaf,eed,exserted,far,fide,filiform,fine,flower,fragrant,frui,fruiting,hyaline,irregularly,leaving,lobed,long,lower,many,mentz,near,new,nflorescence,nipple,older,orolla,pair,papilla,papillo,parallel,peg,pendant,per,perfect,plurifoliat,primary,rectangular,rim,scar,secondary,shallowly,shin,shining,shiny,sleeve,small,spaced,spreadin,spreading,strongly,support,tem,testal,time,tiny,tip,turbinate,twining,ud,unit,usually,vein,venation,ympodial	4-11,adhesion,anther,arrangement,blade,climate,colour,form,fruit,glandular,hair,height,history,leaf,length,life,midpoint,na,number,ovary,plant,position,presence,pubescence,ray,reproduction,rugulose,seed,shape,size,staman,stellate,stigma,stipe,style,texture
564	wfo-0001030057	success	141	78	60	81	18	0.426	-2,2-3-celled,2-4,2-4.5,20-30,20-80,3.5-8,4-10,5.5-12,7-14,8-19,abaxially,adaxially,articulated,axillary,broadly,brownish,bud,chartaceous,cm,condition,diameter,distal,drying,elliptic,fresh,fruit,globose,green,greenish,hair,herb,high,leaf,leaflet,like,long,membranous,mm,mottled,odd-pinnate,ovate,ovoid,pedicel,peduncle,petiole,plant,pubescent,purple,seed,short,size,sometimes,stem,subglabrous,suborbicular,subtending,terminal,whitish,x	1-10,1-2,2-6,2.1-4.1,3-5,4.3-8.2,8,absent,acuminate,acute,apart,apex,apparently,axe,base,berry,blade,borne,cell,cordate,covering,cuneate,decreasing,digestion,eaf,eed,end,enzyme,erec,extremely,flower,forked,geminat,generally,glabrou,greatly,green-white,hair-like,half,honeycomb-shaped,interjected,larger,lateral,living,lunate,make,mucilaginous,narrow,nflorescence,pair,perfect,petiolule,plurifoliate,removed,ruit,scale-like,seudostipule,singly,small,spaced,specimen,ste,stolo,tall,tem,testal,thick,thir,throughout,toward,tri-,truncate,tuber,typically,unit,unwinged,usually,wall,wet,wing,ympodial	arrangement,colour,form,glabrous,growth,height,history,inflorescence,length,life,na,perennial,position,pubescence,reproduction,shape,texture,third
565	wfo-0001030057	success	197	101	81	116	20	0.411	-10,-2,.5-3.5,1-2,2-3-celled,2-4,2-4.5,20-30,20-80,4-10,5-10,5-6,7-14,8-19,abaxially,adaxially,along,anther,axillary,brownish,bud,chartaceous,ciliate,cm,condition,corolla,diameter,drying,elliptic,especially,fresh,fruit,glabrous,globose,green,greenish,greenish-yellow,hair,herb,lanceolate,leaf,like,lobe,margin,membranous,middle,midrib,minutely,mm,mottled,odd-pinnate,ovate,ovoid,pedicel,peduncle,pentagonal,petal,petiole,plant,puberulent,pubescent,purple,rotate,seed,short,size,sometimes,star,stem,stigma,striped,style,subglabrous,subtending,terminal,tip,tube,white,whitish,x,yellow	1-10,2-3,2-5,2-6,2.1-4.1,3-5,3.5-8,4.3-8.2,5-merou,5.5-12,8,absent,acumen,acuminate,acute,ag,alyx,apart,apex,apparently,articulated,axe,base,berry,blade,borne,broadly,cell,connivent,cordate,covering,cuneate,decreasing,digestion,distal,dorsally,eaf,edge,eed,end,enzyme,erec,exceeding,extremely,filament,flat,flower,folded,forked,geminat,generally,glabrou,globo,greatly,green-white,hair-like,half,high,homostylous,honeycomb-shaped,interjected,larger,lateral,leaflet,lengthening,linear,living,long,lower,lunate,make,mucilaginous,narrow,nflorescence,orolla,ovate-lanceolate,pair,perfect,petiolule,plurifoliate,pore,poricidal,removed,ruit,scale-like,seudostipule,singly,slit,small,spaced,specimen,stamen,ste,stolo,straight,suborbicular,tall,tamen,tem,testal,thick,thir,throughout,toward,tri-,truncate,tuber,typically,unit,unwinged,usually,vary,wall,wet,wing,ympodial	adhesion,arrangement,calyx,colour,form,growth,height,history,inflorescence,length,life,na,ovary,perennial,position,pubescence,reproduction,shape,staman,texture
566	wfo-0001030067	success	206	124	97	109	27	0.471	%,0-1,0-1.5,0.1-0.3,0.1-0.5,0.15-0.3,0.2-0.4,0.2-1,0.4-1.1,0.5-0.8,0.6-0.9,0.9-2.8,1-3,12-16,13-15,2-2.5,2-3,2.5-3.5,2.5-7,3-8,3.5-5.5,3.6-5.3,4.5-6,6-18,7-8,adaxially,anther,apex,basal,base,black,broad,broadly,brown,calyx,chartaceous,cm,connivent,cylindrical,densely,depressed-globose,diameter,entire,extra-axillary,flower,fruit,glabrous,gland-tipped,globose,grey,hair,herbaceous,inflorescence,lamina,lateral,length,lobe,long,loosely,margin,mid-point,mm,moderately,obscure,obtuse,orbicular,ovate,ovate-oblong,pedicel,peduncle,perennial,petiole,present,pseudo-racemose,purple,ray,recurved,resprouter,rhizomatous,rotate,shallow,short,shrub,simple,stellate-pubescent,stem,stigma,straight,style,thick,time,tube,unbranched,undulate,white,x,yellow	.05,.5,0-0.1,0-0.2,0-0.7,0-2,0-30,0.1-0.25,0.2-0.35,0.3-0.4,0.3-0.8,0.5-13,0.7-1.3,0.8-1.4,1-6,1-7,10-16,2-foliate,5-merou,8-11,9-18,?,abaxially,absen,absent,abundant,accrescent,acicular,adaxiall,alyx,apart,armed,articulated,axe,ba,blade,capitat,coating,cordate,decimetr,deltate,directed,distall,distinct,distributed,dult,eaf,eed,eglandular,equal,erect,filament,finger,frequently,fruiting,functional,geminat,green,half,homostylous,interpetalar,juic,less,longer,lower,mature,mesocarp,midpoint,midvein,minute,moist,multiradiate,nflorescence,oblique,obscured,often,orolla,part,per,perfect,petal,pore,porrect,prickle,probably,pubescent,rachi,resinous,ruit,sessile,slightly,spaced,stage,stalk,stellae,tal,tamen,thickened,throughout,tip,tissue,triangular,unarmed,unit,unknow,uvenile,vary,wide,ympodial	adhesion,arrangement,capitate,colour,corolla,form,growth,height,history,leaf,life,na,number,ovary,plant,position,presence,pubescence,reproduction,seed,shape,size,staman,stellate,stipe,texture,unknown
567	wfo-0001030080	success	186	96	70	116	26	0.376	0.3-7,0.4-1.5,0.5-4,1.5-2,1.5-2.5,2-3,2-4,2.1-7.1,3-10,4-12,4-7,5-13.5,5-7,6.5-18.6,8-23,9.9-33,abaxially,adaxially,anther,axillary,brownish,bud,clavate,cm,condition,coriaceous,corolla,diameter,dot,drying,elliptic,fresh,fruit,glabrescent,glabrous,green,greenish,hair,herb,lanceolate,leaf,lobe,medium,mm,mottled,odd-pinnate,ovate,ovoid,pedicel,peduncle,petiole,plant,purple,pyriform,seed,size,sometimes,stellate,stigma,style,subtending,terminal,throughout,tiny,tube,white,whitish,winged,x,yellow	1-2,1-3,1.8-4.5,1999,3-5,3.3-7.7,5-merou,5.5-9.9,8-16,abaxiall,absent,acumen,acuminate,ag,along,alyx,apart,apex,apparently,arranged,articulated,axe,base,bead,berry,blade,capitat,ccording,cell,connivent,covering,cuneate,dark,decreasing,decurrent,digestion,distal,dorsally,eaf,edge,eed,enzyme,erec,exceeding,filament,flat,flower,folded,forked,geminat,generally,glabrou,green-white,hair-like,hal,half,high,homostylous,honeycomb-shaped,inconspicuous,interjected,larger,lateral,leaflet,lengthening,light,like,linear,living,long,lower,make,moniliform,mucilaginous,multiple,necklace,nflorescence,ochoa,onto,orolla,pair,perfect,plurifoliate,pore,poricidal,rachi,removed,second,seudostipule,slightly,slit,spaced,specimen,stamen,stolon,straight,strongly,subequal,tall,tamen,tem,testal,thick,tip,toward,tri-,tuber,typically,unit,unknown,usually,vary,wall,wet,width,ympodial	adhesion,arrangement,calyx,capitate,colour,form,growth,height,history,inflorescence,length,life,na,ovary,perennial,position,presence,pseudostipule,pubescence,reproduction,rugulose,shape,staman,stem,surface,texture
568	wfo-0001030081	success	157	130	100	57	30	0.637	.5,0.5-1,0.5-1.5,0.5-2.5,1,1-2-celled,1-3,1-4,1.5,1.5-3,1.5-7,10-20,1st,2-4,2-7,2-foliate,2nd,3-10,4-6,5-12,5-15,absent,abundant,acute,along,anther,apex,apically,base,berry,blade,brown,calyx,cell,center,chartaceous,ciliate,cm,decurrent,densely,denser,diameter,dm,drying,edge,elliptic,elliptic-ovoid,entire,filament,fine,flat,flower,fruit,geniculate,glabrous,globose,hair,herb,immature,interpetalar,lobe,long,lying,margin,maturing,membranaceous,mm,moderately,nearly,oblong,obtuse,often,parallel,pedicel,peduncle,petiole,pointing,pubescent,radiating,raised,ridge,rotate,rounded,running,semitransparent,shallow,sparsely,stigma,style,surface,tissue,tube,two-celled,unbranched,unit,usually,vein,white,x,yellow	0.25-0.5,1-2,1-5,10-35,3-6,abaxially,adaxiall,adaxially,axe,beyond,connected,cordate,dehiscing,eaf,eed,emarginat,equal,explosively,exserted,few-branched,frui,geminat,held,linear-lanceolate,longer,lower,maturit,mesocarp,nfloresence,notch,one,orolla,other,per,placenta,pressure,pubescen,rachi,rarely,ruit,short,single-,slightly,small,sometimes,stamen,straight,swollen,tal,tamen,tem,triangular,vary,watery,wid,woody,ympodial	arrangement,colour,corolla,form,geminate,growth,height,history,inflorescence,leaf,length,life,na,orientation,ovary,perennial,plant,position,pubescence,reproduction,rugulose,seed,shape,size,staman,stem,sympodial,texture,type,wide
569	wfo-0001030083	success	146	107	69	77	38	0.473	.5,0.25-0.5,0.5-1,0.5-2,0.8-1,0.8-3,1-1.5,1-2,1.5-3,10-30,2,3/4,4-15,4-6,acute,anther,apex,base,calyx,cm,corolla,decurrent,deeply,dia,drying,elliptic,flower,fruit,glabrous,globose,green,greenish-white,internodal,leaf,lobe,lobed,long-acuminate,long-styled,membranous,minutely,mm,narrowly,opposite,ovary,ovate,ovoid-reniform,pale,papillose,pedicel,petiole,pitted,poricidal,red-papillose,short-styled,shrub,small-capitate,stem,stigma,strongly,style,surface,tan,thin,tip,tube,way,white,winged,x	.75,0.1,2-3,2-5-flowered,3-4,9-11,accrescent,anthesi,bark,beginning,berry,broadly,closely,cup-shaped,dar,deciduous,deflexed,deltoid,dry,eaf,edicel,eed,elongate,exserted,fleshy,fruiting,greyish-re,hyaline,inflorescenc,lateral,lon,long,lower,main,middle,near,nflorescence,older,onto,overlapping,pair,paler,papillae,pore,prominent,proximal,raised,reddish-gold,reflexed,ruit,scar,shallowly,shaped,simple,single-stemmed,slender,slightly,somewhat,soon,spaced,specimen,straight,tall,tapering,tear-drop,terminal,thickened,translucent,tub,ud,unifoliat,unit,vein,widest,woody,ympodial,young	adhesion,arrangement,blade,climate,colour,dark,diameter,form,glandular,greyish-red,growth,hair,height,history,inflorescence,length,life,margin,midpoint,na,number,peduncle,perennial,plant,position,presence,pubescence,ray,reproduction,rugulose,seed,shape,size,staman,stellate,stipe,texture,unifoliate
570	wfo-0001030093	success	181	104	69	112	35	0.381	0.2-1,0.5-1.1,1-1.5,1-12,1-5,2-2.5,3-4,3.5-12,4-6,7-30,8-9,acuminate,acute,anther,apex,attenuate,base,brownish-tan,calyx,clavate,cm,corolla,cuneate,densely,elliptic,glabrous,globose,golden,green,greenish-white,growth,hirsutulous,leaf,lobe,lobed,margin,minutely,mm,obovate,often,opposite,ovary,ovoid-reniform,pale,pedicel,petiole,pitted,plant,puberulent,pubescent,shaped,shiny,shrub,simple,size,slightly,small,stem,stigma,style,surface,tear-drop,tree,trichome,tube,uniseriate,vein,white,x	.2,.5,0,0.1-0.3,0.2,0.2-0.5,0.6-1.5,0.75-1,1.3-4.5,2.5-11,5-50-flowered,5-8,7-9,anthesi,apar,bark,becoming,beneath,berry,branched,campanulate,case,closely,collection,commonly,continues,deflexed,deltoid,dia,differing,difoliate,eaf,edicel,eed,ellipsoid,erect,especially,evenly,except,expanded,exserted,filament,flower,forest,free,fruiting,furcate,geminat,greyish-brow,guyanese,hyaline,impressed,inundated,lateral,like,lon,long,long-styled,lower,main,major,many,member,middle,minor,narrowly,nearly,new,nflorescence,occasionally,older,one,onto,open,orbicular,pair,paler,papillo,persisting,population,pore,poricidal,portion,present,quite,reflexed,remaining,ruit,scar,shoot,short-styled,slender,soon,southern,spaced,straight,tall,tapering,terminal,thickened,time,tiny,tip,tub,ud,underside,unit,widest,woody,yellowish,ympodial,young	0.5,1.5-4,adhesion,arrangement,blade,climate,colour,diameter,form,fruit,glandular,greyish-brown,hair,height,history,inflorescence,length,life,midpoint,na,number,peduncle,perennial,position,presence,pubescence,ray,reproduction,rugulose,seed,shape,staman,stellate,stipe,texture
571	wfo-0001030115	success	192	128	100	92	28	0.521	-30,.2,.5,0.2,0.5,1-1.2,1.5-2,1.5-3,10,12,12-22,2.5-3,3,3-4,3.5-5,5-10,5-5.5,5-8,>,abaxially,acuminate,acute,anther,apex,base,berry,c.,calyx,cm,conical,cordate,corolla,densely,diameter,echinoid,echinoid-stellate,elliptic,entire,flower,glabrescent,glandular,globose,green,growth,inflorescence,irregular,lanceolate-elliptic,leaf,like,lobe,lobed,long,long-styled,margin,midpoint,minutely,mm,near,oblique,ovary,pale,pedicel,peduncle,pentagonal,petiole,poricidal,pubescent,purple,ray,scattered,shallowly,shiny,short-styled,shrub,simple,sinus,slightly,small,somewhat,sparsely,stellate,stem,stigma,style,surface,tapering,terminal,thin,tip,tree,trichome,truncate,tube,underside,undulate,violet,way,white,x,yellowish	-100,0.1,0.5-0.6,1,10-,30-60,4,7,9-11,<,adaxially,anthesi,apart,armed,bark,basal,basall,beneath,branched,broad-based,brow,closely,completely,curved,dark,deep,discolorous,distant,drying,eaf,eed,ellipsoid,equalling,erect,exserted,filament,free,fruiting,glabrous,heterostylous,impressed,included,irregularl,know,known,lamina,later,lengthening,linear,long-triangular,lower,many,new,nflorescence,obscured,obvious,occasionally,often,older,pair,papillate,papillo,pericarp,planar,plurifoliat,pore,portion,prickle,prickly,primary,prominent,reddish,ruit,scar,sessile,slit,spaced,splitting,stout,strongly,tearing,time,translucent,trichoem,ud,unarmed,unit,upper,usually,vein,ympodial,young	adhesion,arrangement,blade,climate,colour,form,fruit,hair,height,history,length,life,na,number,papillose,plant,position,presence,pubescence,reproduction,rugulose,seed,shape,size,staman,stipe,texture,ye
572	wfo-0001030145	success	153	111	75	78	36	0.49	-3,0.2-2,0.3-,0.5,0.5-1,0.5-4,1,1-1.5,1-2,1-2.5,1-3,1.5,1.5-2,1.5-7,2-3,2-4,2.5-6.5,3-10,3-4,3-5,abaxially,acute,adaxially,adpressed,also,apex,basal,base,blade,calyx,campanulate,cm,compound,cuneate,densely,diameter,ellipsoidal,elliptic-ovate,entire,fruit,glabrous,glandular,globose,hair,herb,leaf,less,lobe,long,margin,mm,moderately,ovate-elliptic,pedicel,peduncle,petiole,pilose,puberulent,shrub,simple,sinuate,slightly,sparsely,stigma,style,subcordate,subcoriaceous,ternately,toward,truncate,tube,unknown,violet,x,yellow	-2,1-5,1.5-4.5,10-12,3,4-5,4-8,4-foliat,6-40,8-11,absent,aggregate,apart,ape,articulated,axe,beyond,cell,chartaceous,color,connective,cylindrical,deltate,directed,distally,dunal,eaf,eed,elliptic,exceeding,exserted,fide,fleshy,flower,forked,lanceolate,larger,lateral,leaflet,leaving,lon,lower,narrowly,near,nflorescence,nther,obtuse,orolla,pedicellar,pore,presen,puberulen,rachi,radiu,reddish,remnant,ripe,ruit,shorter,slender,somewhat,spaced,stamen,stone,tal,tem,terminal,thecae,time,tomento,triangular,truncat,ud,unbranched,unit,vary,wide,ympodial	adhesion,anther,arrangement,climate,colour,corolla,form,growth,height,history,inflorescence,length,life,midpoint,na,number,ovary,perennial,plant,position,presence,present,pubescence,ray,reproduction,rugulose,seed,shape,size,staman,stellate,stem,stipe,surface,texture,tomentose
573	wfo-0001030146	success	210	104	62	148	42	0.295	0.5,acuminate,acute,anther,apex,base,berry,bright,brown,calyx,capitate,cm,coriaceous,corolla,dense,diameter,ellipsoidal,elliptic,entire,flattened-reniform,globose,golden,green,growth,inflorescence,leaf,length,lobe,lobed,long,margin,midpoint,minutely,mm,narrowly,pedicel,peduncle,petiole,pitted,plant,pubescence,pubescent,ray,reddish,revolute,shiny,simple,small,stellate,stem,stigma,style,surface,terminal,thin,tree,treelet,tube,unevenly,white,wide,yellow	.1,.2,.5,0.2–0.4,0.5–1,0.6–0.7,0.6–2,0.9–1,1.2–1.5,1.5–2,16–20,1–1.1,1–1.5,2.5–9,20,20–30,2–5,3–4,3–6,40–50,4–30,4–4.5,5-merou,5–8,6.5–16,60+,6–7,8–15,9–9.5,>,abaxial,abaxially,absent,adaxial,ag,almost,along,alyx,anthesi,apar,appearing,ark,articulated,axe,beig,beneath,branched,branching,brownish,c.,cell,center,closely,connivent,covered,cup-shaped,dark,deeply,deltate,densely,dichasia,discolorous,drying,eaf,echinoid,edge,eed,elongate,erec,exserted,filament,flower,free,fresh,fruiting,fused,glabrous,gradually,halfway,ilament,impressed,lamina,layer,lengthening,less,like,loosely,lower,many,multangulate,narrowing,new,nflorescence,nodding,older,olive,orolla,pair,pale,papillose,part,peltate,per,perfect,pericarp,persistent,plurifoliate,pore,poricidal,portion,primary,projection,reflexed,regularly,rhachi,ripe,ruit,scar,scurfy,sessile,short-stalked,slit,spaced,sparsely,stout,strongly,subtended,tall,tan,tangled,tem,testal,time,tiny,tip,trichome,ud,undersurface,unit,upper,vary,varying,vein,visible,way,woody,ympodial,–18	0.2-0.4,0.6-0.7,0.6-2,0.9-1,1.2-1.5,1.5-2,18,2-5,2.5-9,20-30,3-4,3-6,5-8,6.5-16,8-15,9-9.5,adhesion,arrangement,blade,climate,colour,form,fruit,glandular,hair,height,history,life,na,number,ovary,position,presence,present,reproduction,rugulose,seed,shape,size,staman,stipe,texture
574	wfo-0001030147	success	158	83	60	98	23	0.38	-8,0.5-2,1-5,1.0-2.2,10-19,14-35,15-30,2-10.5,2-13,2-3,2-5,4-5.5,4.2-7.5,4.5-10,5-8,abaxially,adaxially,blue,calyx,cm,conical,connate,corolla,deep,diameter,distal,elliptical,finely,forked,green,green-white,half,herbaceous,interjected,lateral,leaf,leaflet,long,medium,mm,narrowly,odd-pinnate,ovate,ovoid,pair,pedicel,peduncle,perennial,petiole,plant,pubescent,purple,rotate,seed,size,stigma,style,terminal,wide,yellow	0-5,1-4,1.0-2.0,2,2-10,2.5-7.5,3-,3-6-foliat,4-3.,5-7,8-38,abaxiall,acumen,acuminate,acute,apex,apical,apically,articulate,attenuate,base,branched,cell,covering,cuneate,cyme,dehiscent,dichasial,dichasially,digestion,diminishing,dorsally,eaf,ebracteate,edge,eed,emoval,enzyme,exceeding,filament,flat,flower,folded,generally,globo,gradually,hair-like,honeycomb,introrse,living,lobe,lon,long-attenuate,lower,lunat,make,maturing,monochasial,mucilaginous,nflorescence,nther,oblique,obtuse,often,orolla,pattern,perfect,petiolule,plan,poricidally,proximal,reveal,rounded,ruit,sessile,seudostipule,short,slit,specimen,stamen,straight,subequal,subsessile,tal,tem,testal,thick,throughou,throughout,tip,toward,tuber-bearing,typically,unit,vary,wall,ympodial,¼	3-7,4-31,anther,arrangement,colour,form,fruit,globose,growth,height,history,inflorescence,length,life,na,ovary,position,reproduction,rugulose,shape,stem,surface,texture
575	wfo-0001030151	success	175	127	94	81	33	0.537	0.2-0.5,0.5,0.5-1,1-1.5,1-17,1-2,1-3,1.5-2.5,10-25,2-25,2-3,2-6,2-7-compound,3-14,3-5,3.5-32,4-5,5-6,6-9,abaxially,abundantly,acuminate,adaxial,adaxially,apex,basal,base,blade,blotch,calyx,chartaceous,cm,cordate,cuneate,decurrent,diameter,eglandular,elliptic,entire,except,fruit,glabrate,glabrous,glandular,glandular-puberulent,globose,hair,leaf,less,lilac-tinged,line,lobe,long,longitudinal,margin,membranaceous,mm,narrowly,oblique,oblong,obovate,often,pedicel,peduncle,petiole,pinnately,presence,probably,puberulent,pyriform,ripe,sand-punctate,scattered,shallowly,short,simple,slender,slightly,sometimes,stellate,stigma,stripe,style,surface,toward,tree,truncate,tube,vein,white,white-puberulent,x,yellow,yellow-green	-3,-50,0.3-0.5,1,1-5,1.5-2,10-20,15-35,2-11,20-30,4-foliat,?,absent,acute,aggregate,apart,ape,apiculate,around,articulated,axe,beyond,cell,channe,ciliat,compound,connate,connective,cylindrical,deltate,directed,distally,eaf,eed,exceeding,exserted,flower,lanceolate,leaflet,leaving,lon,lower,near,nflorescence,nther,obtuse,orolla,pedicellar,perfect,pore,purplish,rachi,radiu,remnant,ring,ruit,sand-punctat,shorter,small,somewhat,spaced,sparsely,stalked,stamen,stone,tal,tem,thecae,time,tip,triangular,truncat,ud,unbranched,unit,unknow,vary,veiny,whitish,wide,ympodial	adhesion,anther,arrangement,channel,climate,colour,corolla,form,growth,height,history,inflorescence,length,life,midpoint,na,number,ovary,perennial,plant,position,present,pubescence,ray,reproduction,rugulose,seed,shape,size,staman,stem,stipe,texture
576	wfo-0001030153	success	147	115	82	65	33	0.558	.1,.2,/3,0.2-1,0.8-0.9,1-1.2,1-1.5,1-2,1-2.5,1.3-1.5,1.3-1.9,1.5-2,2-8,2-lobed,2.5-4,3-5,3.5-10.5,5-6,abaxially,acuminate,acute,adaxially,age,anther,anthesi,apex,apparently,attenuate,base,berry,calyx,campanulate,clavate,cm,conical,corolla,dark,diameter,distinct,domatia,elliptic,entire,glabrous,globose,green,growth,internodal,lanceolate,lengthening,lobe,lobed,margin,mm,narrowly,older,ovary,pedicel,peduncle,petiole,pit-like,pore,poricidal,revolute,ripe,simple,slightly,slit,small,stem,stigma,style,surface,terminal,tip,tree,treelet,tube,way,white,x,yellowish,young	0.8-1.3,1-10,3-4,3-50,6-8,absent,apart,ape,apiculate,axil,bark,branched,brittle,broadly,caly,deltate,densely,dot,dry,eaf,ellipsoid,enlarged,erect,exerted,filament,flower,free,fruiting,glabrou,impressed,irregularly,known,less,lower,markedly,membranous,minutely,new,nflorescence,nodding,occasionally,ot,pair,paler,papillat,papillate,perfect,plane,plurifoliat,portion,primary,rachi,resinous,ruit,scar,spaced,specimen,straight,strongly,thin,time,ud,unit,vein,ympodial	adhesion,arrangement,blade,climate,colour,form,fruit,glandular,hair,height,history,inflorescence,leaf,length,life,midpoint,na,number,perennial,plant,position,presence,pubescence,ray,reproduction,rugulose,seed,shape,size,staman,stellate,stipe,texture
577	wfo-0001030155	success	183	84	53	130	31	0.29	0,0.5,2,2.5-3,3.5,4,anther,anthesi,armed,berry,brown,calyx,chartaceous,cm,connivent,corolla,diameter,flattened,fruit,glabrous,globose,immature,imparipinnately,lateral,light,lobe,mature,minutely,mm,oblong,pedicel,peduncle,petiole,pinnatifid,pitted,prickle,purple,recurved,size,spreading,stellate,stem,stigma,strongly,style,surface,tapering,terminal,tube,vine,white,yellow,×	0.2,0.4,0.5-0.6,0.5–1.2,0.7,1-1.2,1/2,12–19,12–20,1–2,2-4,2.5,2/3,2–,2–3,3,3–5,4–5,4–6,4–8,4–9,5–10,5–6,5–8,607,6–8,abaxially,acuminate,acute,ag,alyx,apex,articulated,ba,basal,basally,base,becoming,blade,branched,bud,campanulate,cell,central,clustered,confluent,connecting,corresponding,decurrent,deeply,degree,deltate,densely,eaf,eed,ellipsoid,elongating,entire,equal,et,exserted,filament,flower,fresh,glabrou,green,internode,knob,leaflet,lengthening,lobed,long,long-styled,lower,major,margin,middle,midrib,narrowly,nflorescence,often,orolla,outline,papillate,part,pericarp,petiolulate,plant,plurifoliat,pore,poricidal,present,prominent,protuberant,rachi,rectangular,recurve,robust,rodriguez,rounde,rounded,ruit,side,slender,slit,soon,stout,straight,subwoody,tamen,terminally,testal,third,time,tip,tissue,truncat,ttriangular,tub,unit,vary,vein,way,wide,widest,wing,woody,ympodial,–17,–27	0.4-0.7,1-2,12-19,12-20,17,2-3,27,3-5,4-5,5-10,5-6,5-8,adhesion,arrangement,colour,form,growth,inflorescence,leaf,length,na,ovary,position,presence,pubescence,rugulose,seed,shape,staman,texture,truncate
578	wfo-0001030160	success	177	130	103	74	27	0.582	.2,.5,.8,0.2,1,1-1.5,1-2,1-3,1-5,1.5-4.5,3,3-11,3-3.5,3-4,4-rayed,5-6,?,acuminate,acute,anther,apex,base,berry,bluish-violet,calyx,cm,conical,coriaceous,corolla,densely,diameter,dioecious,dry,elliptic,elongate,entire,female,flower,fruit,glabrous,globose,growth,height,inflorescence,internodal,irregularly,like,lobe,lobed,long,male,margin,midpoint,minutely,mm,narrowly,near,nearly,oblique,occasionally,orange-red,ovary,pale,pedicel,peduncle,petiole,pitted,plant,poricidal,prickle,pubescent,ray,red,reniform,scattered,several,shallow,shiny,short-stalked,shrub,simple,sometimes,sparsely,stellate,stem,stiff,stigma,strongly,style,surface,terete,terminating,thin,tip,trichome,truncate,tube,undulate-toothed,unknown,usually,winged,x,yellow	00,1.5-2,1030.,10300,2,2.5-3,7-10,8-9,absent,acicular,almost,amshoff,apart,apparently,armed,bark,beneath,broad-based,bud,capitat,closely,completely,consisting,conspicuous,eaf,eed,ekman,exserted,fide,filament,flattened,flowered,forming,free,fruiting,glabrescen,long-triangular,m.,marginal,markedly,mere,midrib,minute,new,nflorescence,often,older,other,ower,pair,per,pericarp,plurifoliat,portion,primary,prominent,ruit,scar,single,small,somewhat,spaced,stub,ti,tiny,triangular,ud,unisexual,unit,vein,vestigial,woody,ympodial,young	adhesion,arrangement,blade,capitate,climate,colour,form,glandular,hair,history,leaf,length,life,na,number,position,presence,present,pubescence,reproduction,rugulose,seed,shape,size,staman,stipe,texture
579	wfo-0001030161	success	179	113	84	95	29	0.469	0.1-0.2,0.2-0.5,0.2-1.3,0.4-0.8,0.5,0.8-1,1,1.1-1.3,1.5-2,1.5-5,2-2.5,2.5-3,3-15,3-3.5,4,4-5,8-9,9-10,abaxially,acuminate,acute,almost,anther,apex,base,calyx,clavate,cm,conical,coriaceous,corolla,densely,diameter,elliptic,entire,flattened,fruit,glabrous,globose,growth,internodal,leaf,lepidote,lobe,lobed,margin,midpoint,mm,narrowly,nearly,occasionally,orange,ovary,pale,pedicel,peduncle,petiole,porrect,pubescent,ray,red,reddish,reniform,scattered,sessile,shiny,simple,slightly,somewhat,sparsely,stellate,stem,stigma,style,surface,tapering,thick,treelet,trichome,tube,undulate-toothed,white,x,yellowish	.1,.2,.25,.5,0,0.1,0.5-0.6,12-16,2-3,4-20,5197,<,?,adaxially,anthesi,apar,apparently,articulated,bark,bearing,beneath,berry,breaking,broad-based,cell,curved,difoliate,eaf,eed,egger,ellipsoid,erect,especially,exserted,fide,filament,filiform,flower,free,fruiting,furcate,fused,geminat,glabrescent,impressed,irregularly,later,leave,lengthening,like,long,long-triangular,looping,lower,marginal,midvein,minutely,near,new,nflorescence,older,outline,pair,papillo,per,perfect,pericarp,pitted,planar,pore,poricidal,portion,prickle,prickly,primary,prominent,rhomboid,ruit,scar,shorter,slit,small,spaced,stalked,straight,strongly,testal,tip,tooth,tub,ud,unit,vein,woody,ympodial	adhesion,arrangement,blade,climate,colour,form,glandular,hair,height,history,inflorescence,length,life,na,number,perennial,plant,position,presence,present,pubescence,reproduction,rugulose,seed,shape,size,staman,stipe,texture
580	wfo-0001030167	success	141	97	61	80	36	0.433	.9,0.1–0.2,0.5–0.6,0.5–0.7,0.6,0.7–1.2,0.8–1,1.5–2,14–19,15–20,1–1.2,1–1.5,2–4.5,4.5–8,4–10,4–4.5,8–10,abaxially,acuminate,adaxially,anther,apex,base,blade,calyx,chartaceous,cm,densely,diameter,entire,extra-axillary,flower,fruit,glabrous,green,herbaceous,lanceolate,lobe,margin,membranaceous,mm,near,obtuse,ovate,ovoid,pedicel,peduncle,petal,petiole,rounded,sand-punctate,simple,stellate,stigma,style,subequal,thinly,tube,vine,white,x	.8,0.6–0.8,1.2–2.5,1.5–7,12,17–58,2–3,4–5,4–7,5-merous,accrescent,acute,along,alyx,apar,apically,axe,berry,branch,c.,ciliat,ciliate,clavate,climbing,contiguously,eaf,eed,enlarged,fertile,filament,flattened,fruiting,gap,glabrou,immature,less,long,lower,m.,maturity,membranous,minutely,moderately,nearly,nflorescence,nternode,orolla,pair,penden,perfec,pinnate,plurifoliat,pointed,rachi,reflexed,ruit,scar,secondary,seen,slender,slightly,somewhat,spaced,sparsely,symmetrical,tamen,tem,time,tip,truncat,unbranched,unit,unknown,vary,vegetation,vein,venation,weakly,wide,ympodial	adhesion,arrangement,climate,colour,corolla,form,glandular,growth,hair,height,history,inflorescence,leaf,length,life,midpoint,na,number,ovary,perfect,plant,position,presence,pubescence,ray,reproduction,rugulose,seed,shape,size,staman,stem,stipe,surface,texture,truncate
581	wfo-0001030170	success	230	110	70	160	40	0.304	-6,0,1,2,8.5,abaxially,acute,anther,apex,around,base,blade,blue,calyx,cm,connivent,cordate,densely,diameter,extra-axillary,flattened,flower,fruit,glabrous,gland-tipped,glandular,glandular-puberulent,globose,hair,lanceolate,leaf,less,lobe,margin,maturity,minutely,mm,nearly,obtuse,orbicular,pair,pedicel,peduncle,perennial,petiole,puberulent,pubescence,rarely,ray,reniform,shrub,similar,simple,size,smooth,stellate,stem,stigma,stipitate-glandular,style,subdeltoid,surface,thin-textured,truncate,tube,violet,white,x,yellow,yellowish	.2,/2,0.1,0.15–0.35,0.2–0.5,0.2–2,0.5–15,0.5–2,0–30,1.5,10–15,12.5,15–20,1–2-celled,1–2.5,1–4.5,2-foliate,2.5–3,20–25,20–30,2–3-celled,2–4,2–5,2–8,3,3.5–4,3.5–4.4,3–10,4,4–13-rayed,4–22,5,5–10,5–12,5–15,5–apiculate,absent,accrescent,acicular,adaxially,also,apart,appearing,articulated,axe,ba,bud,capitat,coarse,confined,conspicuously,curved,cylindrical,directed,disappearing,distall,eaf,eed,enlarged,entire,erect,eventually,falling,fertile,few-branched,few-rayed,filament,flexuous,frui,fruiting,geminat,geminate,gland,ground,horizontal,hyaline,interpetalar,larger,like,lobed,lon,long,longer,longest,lower,lowest,major,male,many,mesocarp,minute,mostly,multangulate,near,nflorescence,numerous,oblique,oblong-apiculate,often,one,orolla,perfect,pore,prickle,pubescent,rachi,ranging,rare,reflexed,rootstock,ruit,scarcely,scattered,senescent,sessile,shallow,short-puberulent,shorter,single,slightly,small,solitary,sometimes,somewhat,spaced,spongy,spreading,stella,stellae,sterile,stiffly,stipitate,stout,straight,strongly,surfac,tall,tamen,tem,thic,thick,tissue,tooth,toward,triangular,twice,ultimately,unbranched,unit,upper,usually,various,vary,vein,vestigial,way,wide,without,ympodial,–4	-4,0.2-0.5,0.2-2,10-15,2-4,2-5,2-8,2.5-3,3.5-4,3.5-4.4,5-12,5-15,adhesion,arrangement,capitate,climate,colour,corolla,form,growth,height,history,inflorescence,length,life,midpoint,na,number,ovary,plant,position,presence,reproduction,rugulose,seed,shape,staman,stipe,texture,ye
582	wfo-0001030176	success	171	106	70	101	36	0.409	.2,.7,0.5-2,0.6-0.9,0.7-1.4,0.7–0.8,1.2,1.2-2.5,1.5-2,1.6,2.25-3.25,2–3,3-5,3-lobed,6-8,6–8,acute,anther,apex,attenuate,base,bilobed,blade,broadly,calyx,chartaceous,ciliate,cm,depressed-globose,diameter,especially,extra-axillary,flattened-reniform,flower,fruit,glabrous,hair,herb,hermaphroditic,light,lobe,long,margin,mm,nearly,oblong,ovate,pale,pedicel,peduncle,petiole,plant,pubescent,rarely,recurved,ripe,rotate-stellate,simple,slightly,sometimes,sparsely,stigma,style,tube,violet,white,x,yellow,yellow-orange,young	-1.4,-4.25,-6.25,.75-1.5,0.4-1.5,0.5,1,1-2,1-5,1.5-2.5,1/3,1/6,2-3,2-foliate,2.5,2.5–7.5,2.5–9,3.75-5,4-9,5-merou,abaxially,accrescent,adaxiall,adaxially,alyx,angulate,apart,apparently,articulated,asymmetrically,axe,ba,basal,berry,bi-lobed,branch,broad,capitat,connivent,contact,covering,cylindrical,decumbent,dehiscent,downward,eaf,eed,erec,few-branched,filament,forming,fruiting,geminat,hold,interlobal,juic,lance-ovate,lanceolate-oblong,lateral,line,lon,longitudinall,lower,major,mesocarp,midrib,minutely,near,nflorescence,node,numerous,often,orolla,partially,patch,perfect,pore,prostrate,rachi,recurve,rooting,round,ruit,sinus,soil,somewhat,spaced,tamen,tem,terminal,time,tip,triangular,unbranched,unit,vary,vein,white-puberulent,wide,winged,ympodial	0.75-1.5,2.5-7.5,2.5-9,adhesion,arrangement,capitate,climate,colour,corolla,form,glandular,growth,height,history,inflorescence,leaf,length,life,midpoint,na,number,ovary,perennial,position,presence,pubescence,ray,reproduction,seed,shape,size,staman,stellate,stem,stipe,texture
583	wfo-0001030180	success	135	100	77	58	23	0.57	0.05-1,0.5-1,0.8-2,0.9-1.8,1-1.5,1.1-1.2,3-8,4.5-5,6,8-10,8.5-23,?,anther,anthesi,apex,apiculate,appearing,attenuate,bark,base,berry,calyx,clavate,cm,corolla,decurrent,deltoid,dia,erect,fruit,glabrous,globose,green,height,lateral,leaf,linear,lobe,lobed,long,long-acuminate,main,minutely,mm,nearly,occasionally,opposite,ovary,pair,papillate,papillose,pedicel,petiole,planar,pore,poricidal,puberulent,shaped,shrub,slightly,sparsely,stem,stigma,style,surface,tear-drop,terminal,tip,trichome,tube,uniseriate,unknown,vein,white,widely,winged,x	.1,.5,.75,10-30-flowered,3-4,abruptly,accrescent,apart,becoming,clu,dark,deflexe,eaf,edicel,eed,ellipsoid,exserted,filament,free,fruiting,furcate,glabrate,immature,inflorescenc,interpetalar,known,lenticellat,lon,lower,middle,minute,narrowing,nflorescence,older,overlapping,peduncl,plurifoliat,portion,prominent,proximal,raised,rounded,ruit,scar,sinus,slender,soon,spaced,straight,thin,ud,unevenly,unit,widest,woody,yellowish,ympodial,young	0.75,club,colour,deflexed,diameter,form,growth,history,inflorescence,length,lenticellate,life,na,plant,position,pubescence,rugulose,seed,shape,size,texture,type,venation
584	wfo-0001030182	success	205	128	105	100	23	0.512	-12,0.2-0.3,0.5-1,1-4.5,1-celled,1.2-1.5,12-15,15-20,2-2.2,2-3,2-5,2.4-2.5,3-12,3-4,3-5,3-8,4-10,abaxially,acute,adaxially,angulate-lobed,anther,apex,base,berry,blue,brown,brownish,calyx,clavate-truncate,cm,coriaceous,corolla,diameter,elliptic,entire,flattened,flower,fruit,glabrescent,glandular,globose,green,growth,heterostylous,hirsute,immature,internodal,juvenile,leaf,like,linear-lanceolate,lobe,long-styled,margin,midpoint,mixed,mm,multicellular,oblique,obtuse,ovary,ovate,ovate-elliptic,papillose,pedicel,peduncle,petiole,plant,porrect,pubescence,pubescent,ray,red,reddish,reduced,repand,ripe,rounded,rusty,sessile,short,short-styled,shrub,simple,stellate,stellate-glandular,stem,stigma,style,subcoriaceous,subreniform,subsessile,surface,tapering,terminal,tomentose,treelet,trichome,tube,uniseriate,variegated,violet,x,yellowish	0.3-0.5,1,1-1.5,1-1.7,1-celle,1-multicellular,1-nerved,1.5-2,1/4,2-15,2-8,4-5,accrescent,adult,anthesi,armed,articulated,asymmetric,bark,basal,branched,cell,closely,dark,den,discolorous,distal,e,eaf,eed,eglandular,erect,evident,exserted,ferruginous-tomentose,filament,finely,free,fruiting,later,lengthening,lobed,long,lower,many,microscope,midrib,minute,minutely,mixture,multangulat,nearly,new,nflorescence,older,one,ovoid,papillo,per,perfect,pericarp,plurifoliat,pore,poricidal,porrect-,porrect-stellate,portion,prickle,prickly,recurved,reflexed,reticulate,ruit,scar,seen,similar,slightly,slit,space,sparse,sparsely,stalked,staminate,strongly,tall,testa,tip,triangular-lanceolate,tub,turbinate,ud,unarmed,unit,upper,vein,velutinous,wood,yellow,ympodial,¼	adhesion,arrangement,blade,climate,colour,form,hair,height,inflorescence,length,na,number,position,presence,present,reproduction,rugulose,seed,shape,size,staman,stipe,texture
585	wfo-0001030185	success	206	89	69	137	20	0.335	1,1-10,1.0-1.3,10,2-3,2.0-3.0,21,3.5-4.2,35,5-7,9-18,beyond,blue,blue-violet,calyx,center,cm,commonly,corolla,dark,darker,deep,densely,diameter,distal,elliptic,forked,generally,glabrous,glandular-pubescent,globose,green,green-white,hair,half,herbaceous,lanceolate,light,long,medium,mm,moderately,narrowly,occasional,odd-pinnate,ovate,ovoid,pedicel,peduncle,perennial,plant,puberulent,purple,rhizomatous,rotate,scarcely,seed,shape,size,sometimes,spot,star,stem,tinged,violet,white,wide,without,yellow	-0.5-1.3,0.2,1-4,1-8,1.5-4,1.7,15,2,20-65,25,3-6-foliat,4,4-7,5-10,5-lobed,8-11,abaxially,acumen,acuminate,acute,adaxially,angular,apex,apical,apically,apiculate,articulate,b,ba,basal,base,becoming,branched,caudate,cell,cente,clasping,coat,collection,color,connate,cordate,covering,cuneate,cyme,decreasing,dehiscent,dichasial,dichasially,digestion,eaf,ebracteate,eed,embryo,emoval,enzyme,erect,exceeding,filament,flower,formed,glabrescent,gland,globo,hair-like,honeycomb,interjected,introrse,lateral,leaflet,living,lobe,lon,lower,make,maturing,middle,monochasial,mucilaginous,nearly,nflorescence,nther,obliquely,oblong,often,one,orolla,pair,pattern,pentagonal,perfect,petiolate,petiolulate,petiolule,poricidally,purpl,radiating,rare,reduced,reveal,rhizome,rotate-,rounded,ruit,semi-lunate,sessile,seudostipule,short,slightly,slit,somewhat,specimen,stamen,ste,stigma,straight,style,subequal,symmetrically,tem,terete,terminal,testal,thick,tip,trailing,type,typically,unbranched,unit,usually,vary,visible,wall,wid,wider,ympodial	anther,arrangement,colour,form,fruit,growth,height,history,inflorescence,leaf,length,life,na,ovary,petiole,position,pubescence,reproduction,rotate-pentagonal,texture
586	wfo-0001030189	success	188	116	85	103	31	0.452	-1/2,-4,/3,0-1,0.5-1.6,0.9-1.1,1,1-1.5,1.1-2.7,1.3-4.2,1.5-5,1/3,1/6-1/3,2-5.5,2.5-4,3.2-4.5,4-5.5,5-10,5-6,6-12,abaxially,anther,apex,base,blade,calyx,chartaceous,cm,cordate,densely,diameter,dull,entire,equal,evenly,flattened-reniform,fruit,glabrescent,glabrous,gray,green,lateral,leaf,length,lobe,lobed,long,margin,maturity,mauve,midpoint,mm,moderately,oblong,obtuse,orange,ovate,pedicel,peduncle,petiole,poricidal,purple,ray,red,rounded,scandent,shrub,simple,slender,sometimes,sparsely,spherical,stellate,stellate-pubescent,stem,style,tapering,terminal,tip,tube,upper,way,wide,yellow,young	.2,0-15,0-30,0.1,0.1-0.2,0.2-0.3,0.2-0.5,1-2,1-3-cellular,1-4-cellula,1-4-cellular,1.5-2,1.5-4.5,1/,2,2-3,3-4,4-13,5-,5-merous,6-10,8,8-10,8-18,acut,alyx,apar,apically,apparently,appressed,articulated,bark,berry,branched,concolorous,connivent,curved,deltate,drying,eaf,eed,elliptic,elongating,erect,faint,filament,flower,foliaceous,free,frui,fruiting,glabrescen,gland-tipped,infructescence,longer,lower,mature,nflorescence,often,older,one,open,orolla,oung,pair,per,perfec,pericarp,plurifoliat,porrect,portion,primary,recurved,red-brow,reflexed,ruit,scar,sessile,shorter,smooth,somewhat,spaced,spreading,stalk,stalked,strongly,surface,tamen,terete,tertiary,time,trichome,unarme,unarmed,unit,variously,vary,vein,venation,visible,woody,yellow-green,ympodial	adhesion,arrangement,climate,colour,corolla,form,glandular,growth,hair,height,history,inflorescence,life,na,number,ovary,perfect,plant,position,presence,present,pubescence,red-brown,reproduction,seed,shape,size,staman,stigma,stipe,texture
587	wfo-0001030195	success	255	105	60	195	45	0.235	2,acuminate,adnate,anther,apex,base,blade,brown,calyx,capitate,chartaceous,cm,corolla,cuneate,densely,diameter,entire,flattened-orbicular,fruit,glabrous,glandular,globose,green,hair,lateral,leaf,lobe,long,margin,midpoint,mm,moderately,notched,oblong,obtuse,ovate,pedicel,petiole,pubescent,ray,red,reddish,rounded,shoot,short,shrub,simple,spatulate,stellate,stellate-pubescent,stem,stigma,style,subcoriaceous,surface,terminal,tube,white,yellow,yellow-tan	.2,.3,.5,.6,.7,/3,0.1–0.2,0.2–0.3,0.2–0.5,0.2–1.0,0.3–0.7,0.5,0.5–0.6,0.5–1.3,0.5–4.0,0.7–1.0,0.8,0.8–0.9,0.9–4.8,1,1.0,1.0–1.4,1.0–1.5,1.2–1.6,1.3–1.5,1.3–2.6,1.4–1.6,1.5–1.7,1.5–1.9,1.7–2.2,1.7–3.2,1.8–2.0,1.8–2.5,1/3,2.2–2.7,2.3,3.8–4.8,3–6,3–7.3,4-merou,4.9–7.0,5.5–6.5,6.3–7.7,6–8,6–9,abaxially,adaxial,adaxially,aequilateral,ag,along,alyx,anthesi,apical,apiculate,apparently,appearing,appresse,around,articulate,attachment,attenuate,ba,bark,based,berry,borne,broad,broad-based,brochidodromous,bud,channeled,connivent,dark,deltate,dentate,developed,directed,distal,distally,distinct,dry,eaf,edge,eed,either,elliptic,emerging,endocarp,evenly,exocarp,extending,extra-axillary,fertile,filament,filiform,flat,flattened-irregular,flexed,flower,free,glossy,gradually,gree,homostylous,hort,immature,increasing,indistinct,individually,intact,internode,interpetalar,intersepalar,isolated,juic,layer,laying,light,lon,longer,lower,m.,many,markedly,mature,middle,midrib,midvein,minute,mottled,narrowly,nearly,nflorescence,nodding,oblique,occasionally,opaque,orolla,per,perforated,pitted,plurifoliat,point,poorly,pore,porrect,portion,potentially,presen,prickle,raised,reflexed,remaining,restricted,ruit,scattered,sessile,shot,side,sinus,slightly,sloughing,smoot,sparsely,splitting,stamen,stellae,straight,striped,suture,tamen,tem,thin,time,tip,tissue,transparent,truncate,typically,ud,unarmed,unit,vary,vein,weakly,wide,yellow-ferruginou,yellow-ferruginous,ympodial,young,±90°,±equal,±glabrous,×	0.1-0.2,0.2,0.2-0.3,0.2-0.5,0.3,0.5-0.6,0.5-4.0,0.6,0.9-4.8,1.0-1.5,1.2-1.6,1.3-2.6,1.5-1.7,1.5-1.9,3.8-4.8,5.5-6.5,6-8,adhesion,arrangement,climate,colour,form,growth,height,history,inflorescence,length,life,na,number,ovary,peduncle,plant,position,presence,present,pubescence,reproduction,rugulose,seed,shape,size,staman,stipe,texture
588	wfo-0001030198	success	234	134	80	154	54	0.342	0.8,1,16,abaxially,acute,angulate,anther,apex,attenuate,base,black,blade,calyx,closely,cm,cordate,deeply,densely,diameter,drying,entire,finely,flattened-reniform,flower,free,fruit,glabrate,glabrous,globose,green,hair,initially,interpetalar,irregularly,lateral,leaf,lilac,lobe,margin,midpoint,minute,mm,nearly,orange,overtopped,pedicel,peduncle,persistently,petiole,purple,ray,rounded,sessile,shiny,shrub,simple,sinuate,somewhat,soon,stellae,stellate,stellate-tomentose,stem,stigma,style,surface,tan,terminal,tissue,tomentose,truncate,tube,turning,weak,well-developed,whitish,whitish-tomentose,yellow,yellowish,×	.2,0.6,0.7–,0.7–0.8,0.7–0.9,0.7–1.1,0.8–1.4,0.9–1.7,0.9–2,1.2,1.4–1.6,1.5–3.5,1.5–6.5,10–12,13–20,1–2.5,2,2.5,2.5–14,2.5–3.0,2–2.8,2–3,2–3-lobed,3.4–4.0,3.5–7,3–3.5,3–4,3–9,4,4.5,4–12-branched,5-merou,5.3–7,5.5–13,5–12,60–150,6–10,7.5–10,acicular,adaxiall,adaxially,alyx,ampliate,apart,apical,apparently,appearing,articulated,axe,basal,berry,branch,broad,broadly,capitat,caudate,contrasting,coroll,dark,darker,deltoid,directed,distall,distally,eaf,eed,except,extra-axillary,fewer,filament,filiform,formed,frui,geminat,glabrescent,gland-tipped,gradually,hal,high,homostylous,immature,internode,interwoven,larger,like,lobed,lon,long,lower,major,many,midri,midrib,midvein,midzone,minutely,much,near,nflorescence,oblong-lanceolate,often,one,orolla,ovate,ovoid,part,perfect,pitted,plurifoliate,pore,porrect,prickle,principal,recurved,reflexed,relatively,ruit,short-stalked,shorter,side,sinus,slightly,sometimes,spaced,sparse,splitting,spreading,stalk,stella,stout,straight,strongly,tamen,tem,thickened,time,tip,triangular,ud,unarmed,unit,upper,usually,vary,vein,white,white-tomentose,wide,ympodial,–17,–18,–20,–3,–3.5	0.7-1.5-3.5,0.8-1.4,0.9-1.7,1-2.5,10-12,13-20,17,18,2-2.8,2-3,2-3-lobed,2.5-14,2.5-3.0,20,3,3-3.5,3.4-4.0,3.5,5-12,5.3-7,5.5-13,6-10,7.5-10,adhesion,arrangement,capitate,climate,colour,corolla,form,glandular,growth,height,history,inflorescence,length,life,na,number,ovary,perennial,plant,position,presence,pubescence,reproduction,rugulose,seed,shape,size,staman,stipe,texture,ye
589	wfo-0001030212	success	188	104	74	114	30	0.394	0.2-0.4,0.5-0.6,1-1.2,1-1.5,1.2-1.8,1.5-2,2-2.5,2-4,2-5,2.1-3.4,2.4-3.3,2.5-6,2.6-6.5,3.5-5,4-23,4-9,4.5-6,6-9,absent,acute,anther,apex,base,blade,broadly,brown,calyx,capitate,chartaceous,cm,compound,cuneate,deeply,depressed-globose,diameter,fruit,glabrous,gland-tipped,glandular-puberulent,green,hair,herbaceous,inflorescence,leaf-opposed,length,lobe,lobed,margin,mm,narrowly,ovate,pedicel,peduncle,petiole,pinnately,plant,prostrate,purple,resprouter,rotate,rotate-stellate,short,simple,slightly,sparse,sparsely,sprawling,stigma,style,surface,tube,x,yellow,yellowish-green	%,0-4,0.5-1,0.5-7,0.9-1.3,1-15,1-2,1-3,1-5,1-6,1.4-1.8,12-40,15-40,20-50,25-60,28-37,3-5,30-150,4-27,4-6,5-merou,7-11,8-9,9-10,abaxial,abaxially,absen,abundant,accrescent,acicular,adaxial,adaxiall,adaxially,alyx,andromonoecious,apart,apparently,armed,articulated,attenuate,axe,ba,bilobe,bristle-like,center,connivent,cylindrical,d.,deltate,directed,distall,divided,eaf,eed,filament,finger,flower,fruiting,functional,geminat,half,heterostylous,index,interpetalar,juic,lamina,lateral,lobing,lon,long,lower,mature,mesocarp,mid-point,midvein,minute,moist,nflorescence,oblique,orolla,part,per,plurifoliate,pore,presen,present,pricke,prickle,rachi,ruit,side,spaced,stage,straight,strongly,tal,tamen,tem,thick,throughout,time,tissue,toothed,triangular,unbranched,unit,unknown,uvenile,vary,vein,weakly,wide,winged,ympodial	adhesion,arrangement,bilobed,climate,colour,corolla,form,glandular,growth,height,history,leaf,life,midpoint,na,number,ovary,position,presence,pubescence,ray,rugulose,seed,shape,size,staman,stellate,stem,stipe,texture
590	wfo-0001030219	success	191	122	63	128	59	0.33	0.5,1.5,60,abaxially,acute,adaxially,anther,anthesi,apex,base,black,blade,blue,brown,calyx,cm,deeply,densely,diameter,flattened,fruit,glabrous,globose,green,hair,incised,leaf,lilac,lobe,long,margin,marking,mm,moderately,multicellular,number,oblong,ovate,pair,pale,pedicel,peduncle,pentagonal,perennial,petiole,pitted,pubescent,purple,regularly,shallowly,shrub,simple,size,spaced,sparsely,stigma,style,surface,tube,uniseriate,velutinous,x,yellow	0.1–0.3,0.2–2.3,0.4–1.0,0.5–,0.7–1.1,0.8–3.0,0–,1.0–1.2,1.0–1.5,1.0–2.0,1.0–2.2,1.3–2.9,1.4–2.8,1.6–,10,15,1–2.5,2.0–2.5,2.0–3.2,2.0–5.5,2.4–6.0,2–,2–2.5,2–3,2–4.5,3,4.5–5.5,4.8–11.5,4–5,4–7,5,5–,5–8,6–,6–10,6–8,7–11,8–18,9–10,9–12,abaxiall,acut,adaxiall,adnate,ag,along,anisophyllous,apart,apical,apparently,appearing,arising,arranged,articulated,axe,ba,basal,bract–like,branched,cell,chartaceous,clavat,concave,connivent,convex,cylindrical,decreasing,decurrent,diamete,difoliate,directed,distally,eaf,eed,elliptic,equal,erect,filament,flower,geminat,glabrescent,indistinct,internode,lanceolate,longitudinal,lower,nflorescence,olive,opening,opposed,oppositely,orolla,paler,perfect,pore,present,procumbent,rapidly,red–purple,rounded,ruit,serrate,sessile,sid,side,smaller,split,stone,straight,stripe,strongly,tal,tamen,tem,time,two,unicellular,unit,vary,white,wide,wing,winged,woody,ympodial,–3.0,–7.0,–9.5	-3.0,-7.0,-9.5,0.1-0.3,0.2-2.3,0.5-,0.7-1.1,1.0-1.2,1.0-2.0,1.0-2.2,1.6-,2-,2-4.5,2.0-3.2,2.0-5.5,2.4-6.0,4-5,4-7,4.5-5.5,4.8-11.5,5-,5-8,7-11,9-10,adhesion,arrangement,clavate,climate,colour,corolla,decurren,form,glandular,growth,height,hermaphroditic,history,inflorescence,leaf-opposed,length,life,midpoint,na,opposite,ovary,plant,position,presence,pubescence,ray,reproduction,rugulose,seed,shape,staman,stellate,stem,stipe,texture
591	wfo-0001030224	success	191	110	85	106	25	0.445	0.5-1,0.5-1.5,1-2,1-3.5,12-14,14-17,2-10,2-4,2-5,2.5-4,2.5-4.5,2.5-8,4-10,4-4.5,4.5-5,6-15,7-10,8-12,abaxially,adaxially,anther,apart,armed,articulated,base,black,brown,calyx,cell,chartaceous,clavate,cm,dark,densely,diameter,elliptic,equal,extra-axillary,ferruginous,finely,flattened,form,fruit,glabrous,globose,green,greyish,hair,lateral,lighter,lobe,mm,moderately,orange,outline,pedicel,peduncle,petiole,pink,plant,pseudohair,pubescent,purple,red,reniform,scandent,shiny,shrub,simple,spaced,sparsely,stellate,stellate-pubescent,stem,stigma,style,subcoriaceous,suborbicular,surface,tan,testal,tube,wall,x,yellow	-2.5,.25,.5,0.5-3,1-1.5,1.5-9,10-20,2-3-celled,20-25,3-4-foliate,4-6,5-10,5-merous,6-10,6-8,absent,accrescen,acuminate,acute,adaxiall,ag,alyx,andromonoeciou,andromonoecious,apex,axe,ba,bark,berry,blade,broad-based,capitat,connivent,cylindrical,deflexed,directed,distally,dry,eaf,eed,eglandular,filament,fissure,flower,forked,free,fruiting,functionally,geminat,gradually,hermaphroditic,heteromorphic,interpetalar,like,linear-lanceolate,long,long-,longer,longitudinal,lower,lowering,major,mature,maturit,midpoint,midvein,narrowly,nflorescence,occasionally,one,opening,orolla,other,part,perfect,pericarp,pore,prickle,rachi,ray,recurved,reddish-brown,reflexed,ruit,sessile,short-styled,side,slit,small,sparse,staminate,strongly,tamen,tapered,tightly,time,tissue,triangular,unbranched,unit,vary,vein,wide,wtih,yellowish,ympodial	abaxial,adaxial,adhesion,arrangement,capitate,colour,corolla,fissured,growth,height,history,inflorescence,leaf,length,life,na,ovary,position,pubescence,rugulose,seed,shape,size,staman,texture
592	wfo-0001030225	success	155	113	79	76	34	0.51	-11,-30,-4,-7,.5-2.5,1,1-4,1-6,1.5-2.5,10-15,2,2-18,2-2.5,2-3,2-6,3-11-compound,3-20,3-4,3-5,4-5,abaxially,acuminate,acute,adaxially,apex,apical,basal,base,bilobed,blade,calyx,campanulate,cm,conivent,cordate,cuneate,densely,diameter,elliptic-ovate,entire,especially,expanded,fruit,glabrous,gland,globose,leaf,less,lobe,long,margin,mm,moderately,oblong,obtuse,papillose,pedicel,peduncle,petiole,pinnately,possibly,puberulent,purple,shallowly,shrub,simple,small,somewhat,stellate,stigma,style,succulent,toward,tree,truncate,tube,two,unknown,x	-1.5,-45,.5,0,0-20,0-5,1.5,10-30,3-foliat,8-15,absent,apart,ape,apically,articulated,ature,axe,beyond,color,compound,connective,coriaceous,cylindrical,deltate,dilated,directed,distally,eaf,eed,equal,exceeding,exserted,fleshy,flower,forked,glabrate,immature,laterally,leaflet,leaving,lower,minutely,narrowly,nflorescence,nther,one,orolla,perfect,pore,prominent,puberulen,rachi,radiu,scar,see,seen,slightly,spaced,sparsely,stalked,stamen,strongly,tal,tem,thecae,time,tip,tomento,triangular,ud,unbranched,unit,unknow,vary,wide,ympodial	adhesion,anther,arrangement,climate,colour,corolla,form,glandular,growth,hair,height,history,inflorescence,length,life,midpoint,na,number,ovary,plant,position,presence,pubescence,ray,reproduction,rugulose,seed,shape,size,staman,stem,stipe,surface,texture
593	wfo-0001030244	success	226	117	90	136	27	0.398	%,0-0.6,0-1,0.2-0.6,0.2-1.3,0.25-0.5,0.3-0.5,0.4-0.7,0.5-1,0.5-1.2,0.5-3.5,0.6-0.8,0.8-1.2,1-1.5,1-5,1.5-2,1.5-2.3,1.5-3,2.5-6.5,3.5-9,4-5,7-16,7-24,7-8,abaxially,adaxially,andromonoecious,anther,base,blue,brown,calyx,chartaceous,cm,densely,diameter,erect,extra-axillary,fruit,glabrous,gland-tipped,globose,green,grey,hair,inflorescence,interpetalar,lamina,lanceolate,lateral,length,linear,lobe,long,midpoint,mm,moderately,narrow,narrowly,oblong,pale,pedicel,peduncle,perennial,petiole,plant,present,purple,ray,red,reniform,rhizomatous,rotate,scattered,short,shrub,simple,sparsely,stellate,stellate-pubescent,stigma,style,surface,tan,time,tissue,tube,white,x,yellow	.05,.3,0-0.1,0-0.3,0-3,0.1-1.5,0.2,0.2-0.5,0.2-1,0.25-0.4,0.3-0.4,0.3-5,0.5-7,1-2,1-20,1-6,1-8,1-locular,1.5-,11-33,2-2.5,2-4,2-foliate,2.5-13.5,3.3-7.5,4-5-merou,4-6,5-6,6-8,7-15,7-9,8-18,absen,absent,accrescent,acicular,across,acute,alyx,apart,apex,apparen,articulated,attenuate,axe,ba,blade,capitat,common,confined,connivent,cuneate,cylindrical,decimetre,deltate,directed,distall,distally,distributed,eaf,eed,eglandular,entire,exocarp,filament,finger,flower,fruiting,geminat,half,heterostylous,homostylous,incomplete,juicy,less,longer,lower,margin,markedly,mature,mesocarp,mid-point,midrib,minute,nflorescence,oblique,obtuse,orolla,part,per,perfect,placenta,plump,pore,porrect,prickle,pseudo-racemose,pubescent,rachi,reticulate,ruit,septum,sessile,slightly,solitary,spaced,sparse,stage,stalk,stalked,stellae,straight,strongly,succulent,tal,tamen,tem,thick,thicker,thicknes,throughout,tissu,triangular,unarme,unarmed,unbranched,unit,unknow,usually,uvenile,vary,weakly,wid,wide,yellowish,ympodial	1.5-13.5,adhesion,arrangement,capitate,climate,colour,corolla,form,growth,height,history,leaf,life,na,number,ovary,position,presence,pubescence,reproduction,rugulose,seed,shape,size,staman,stem,texture
594	wfo-0001030250	success	169	70	50	119	20	0.296	0.5-1,1-1.5,1-3,1.1-1.2,1.4-1.5,1.7-7,11.2-22,11.3,2-2.5,2.5-3.25,25,3.4-6.6,3.5-4,5-6,anther,brown,calyx,capitate,cm,corolla,elliptic-ovate,glabrous,globose,green,greenish-white,greenish-yellow,inflorescence,leaf,lobed,minutely,mm,opposite,ovary,ovoid-reniform,pale,pedicel,petiole,pitted,seed,shape,shaped,shrub,size,stem,stigma,style,surface,tan,tear-drop,x	.5,/4,0-seeded,1.1-3.5,1.25-1.5,1.9-2.6,2.1-6,3-5,4-7,5-50-flowered,6-8,across,anthesi,apart,apex,appearing,arching,attenuate,bark,base,beginning,beneath,berry,broadly,bullate,carinate-hooded,conical,consisting,cuneate,cup-shaped,curved,dark,decurrent,deflexed,dia,differing,difoliate,dry,eaf,edicel,eed,elliptic,exerted,filament,five,free,fresh,fruiting,geminat,glabrou,horizontally,inflorescenc,irregularly,lateral,lobe,lon,long,long-acuminate,lower,main,major,maturity,middle,minor,n,nflorescence,node,occasionally,older,one,orbicular,orbiculate,pair,paler,papillo,papillose,pendulous,pit,pore,poricidal,portion,projection,prominent,proximal,raised,reflexed,rim,ruit,scar,sea-green,shallow,simple,slender,slightly,smooth,soon,spaced,specimen,spreading,straight,tall,tapering,tip,translucent,translucent-green,tube,two,ud,unit,usually,vein,way,white-lenticellat,white-lenticellate,wide,widest,winged,woody,ympodial	arrangement,colour,diameter,form,fruit,growth,height,history,length,life,na,peduncle,perennial,plant,position,pubescence,reproduction,rugulose,sympodial,texture
595	wfo-0001030271	success	195	101	75	120	26	0.385	0.15-0.75,0.7-9.5,0.9-2.5,1-2.5,1-3,1-7,1.4-2.1,1.9-6.6,15-61,2-4,2.4-5.6,3-10,4-7,5-8,5.6-12.3,6-15,abaxially,adaxially,anther,axillary,blue,brownish,bud,clavate,cm,coloration,completely,condition,coriaceous,corolla,dark,deep,diameter,drying,elliptic,fresh,fruit,glabrous,green,greenish,herb,lanceolate,leaf,light,lilac,lobe,long,medium,mm,mottled,odd-pinnate,ovate,ovoid,pedicel,peduncle,pentagonal,petiole,plant,purple,ripe,rotate,seed,size,spot,stigma,style,subtending,terminal,tube,vein,white,whitish,wide,x,yellow	0-2,0.5-1.2,0.9-3.6,1-2,1-4,1-6,2-2.7,2-3,2-6,3-5,3.4-7.5,4-22,5-merou,acumen,acute,adaxiall,ag,along,alyx,apart,apex,apparently,arranged,articulated,asymmetric,attenuate,axe,base,basiscopic,bead,berry,blade,capitat,cell,connivent,considerably,covering,decreasing,digestion,distal,dorsally,eaf,edge,eed,enzyme,erect,exceeding,filament,flat,flower,folded,forked,geminat,generally,glabrou,green-white,habi,hair-like,half,homostylous,honeycomb-shaped,interjected,larger,lateral,leaflet,lengthening,like,linear,living,lower,make,middl,moniliform,mucilaginous,multiple,necklace,nflorescence,orbicular,orolla,pair,perfect,petiolulate,plurifoliate,pore,poricidal,removed,rosette,rounded,ruit,sessile,seudostipule,side,slightly,slit,sometimes,spaced,specimen,stamen,stolon,straight,symmetric,tall,tamen,tem,testal,thick,throughout,tip,tissue,toward,tri-,tuber,typically,unit,unwinged,usually,vary,wall,wet,ympodial	abaxial,adaxial,adhesion,arrangement,calyx,capitate,colour,form,growth,height,history,inflorescence,length,life,na,ovary,perennial,position,pubescence,reproduction,rugulose,shape,staman,stem,surface,texture
596	wfo-0001030272	success	179	115	85	94	30	0.475	-6,/4,0.5-1.5,0.5-2,0.6-0.9,0.65-1,0.7-2.5,0.8-1.5,1,1-2.8,1.2-1.8,1.5-2.5,1/3,2-6.5,2.5-3,2.5-3.5,2.8-3.5,3.5-5,abaxially,acute,anther,apex,base,blade,bright,calyx,cm,connivent,diameter,elliptic,entire,equal,evenly,flattened-reniform,fruit,glabrescent,glabrous,glandular,green,hair,lateral,leaf,length,less,lobe,lobed,long,long-attenuate,margin,maturity,mauve,membranous,midpoint,minute,mm,obtuse,orange-brown,pedicel,peduncle,petiole,poricidal,ray,red,rounded,shallowly,shrub,simple,sometimes,sparsely,spherical,spreading,stellate,stellate-pubescent,stem,style,surface,tapering,terminal,tip,tube,undulate,upper,way,wide,young	.3,.5,0-20,0.05-0.1,0.05-1.5,0.5-1,1-1.5,1.5-3,1/3-2/3,10-20,2-2.5,3-8,4-10,4-15,4-6,4-8,5-7,5-merous,acut,almost,alyx,ame,apar,apically,apparently,articulated,ba,bark,berry,c.,concolorous,deltate,densely,difoliate,drying,eaf,eed,elongating,erect,filament,flower,free,fruiting,geminat,glabrescen,gland,gra,infructescence,longer,lower,mature,moderately,multangulate,narrow-deltate,near,nflorescence,older,one,open,orolla,oung,pair,per,perfec,pericarp,porrect,portion,primary,red-brown,reduced,reflexe,ruit,scar,sessile,shorte,slender,smooth,spaced,straight,tamen,terete,tertiary,time,trichome,unarme,unarmed,unbranched,unit,vary,vein,venation,visible,woody,ympodial	adhesion,arrangement,climate,colour,corolla,form,gray,growth,height,hermaphroditic,history,inflorescence,life,na,number,ovary,perennial,plant,position,presence,present,pubescence,reproduction,seed,shape,size,staman,stigma,stipe,texture
597	wfo-0001030278	success	235	162	135	100	27	0.574	0-0.2,0.6-1,1-2,10-20,10-30,12-25,2,2-6,2.5-3,3-4,3-5,3-7,3.5-5,4-8,5-20,6-12,7-10,7-12,8-30,9-18,abaxially,achlorophyllous,acute,acute-,adaxial,adaxially,along,also,anther,apex,articulated,ascending,attenuate,base,blade,branched,broadly,brown,calyx,capitate-glandular,closely,cm,coarsely,collection,concentrated,connivent,contiguous,cordate,corolla,dark,deltoid,densely,dentate,diameter,divergently,ellipsoid,elliptic,elongate,erect,extra-axillary,fine,flexuous,flower,fruit,glabrous,hair,hermaphroditic,hirsute,inflorescence,intermixed,lateral,length,lenticular,lignescent,linear-lanceolate,lobe,long,longer,margin,midpoint,minutely,mixed,mm,moderately,nearly,obtuse,obtuse-tipped,occasionally,orange,outline,ovate,pedicel,peduncle,perennial,petiole,pitted,prickle,prickly,pubescent,ray,resembling,rigid,ripe,sessile,short-stalked,similar,simple,slender,smaller,sometimes,somewhat,spaced,sparsely,spreading,stalked,stellae,stellate,stem,stigma,style,subglobose,surface,tan,termination,thin-textured,trichome,truncate,tube,unbranched,uniseriate,vein,weakly,white,x,yellow	0-1,0.1-0.3,1-several,1/3-1/2,15-20,2-4,2-7,2-foliate,3.5-7,4-12,4-locular,5-8,6-18,7-20,absent,accrescent,adaxiall,armed,axe,ba,basally,breaking,broad-based,capitat,cauline,commonly,completely,compressed,covering,cylindrical,density,directed,distal,distall,eaf,eed,entire,female-sterile,filament,finally,flesh,fruiting,geminat,glabrou,gland-tipped,glandular-puberulen,immature,inserted,interlobal,large,laterally,less,lower,major,maturit,medium-sized,midrib,mostly,much,narrowly,nflorescence,numerous,often,open-campanulate,orolla,ovate-lanceolate,pale,per,petaloid,pore,principal,prominent,rachi,recurved,reduced,ruit,section,short-styled,side,sinus,small,spreading-hirsute,ste,straight,straighter,subequal,surrounding,tal,tamen,tem,tip,toothlike,unarmed,unit,usually,vary,varying,wide,widely,ympodial	adhesion,arrangement,capitate,climate,colour,form,glandular,growth,height,history,leaf,life,na,number,ovary,plant,position,presence,pubescence,reproduction,rugulose,seed,shape,size,staman,stipe,texture
598	wfo-0001030281	success	193	101	81	112	20	0.42	0.2-0.8,0.5-1,0.5-1.0,0.5-1.5,0.5-3,1,1-2,1.5,10-13,12-16,12-20,2-4,2-5,2.5-3,2.5-3.5,2.5-5,3-6,4-7,5-10,5-16,abaxially,absent,anther,attenuate,base,brown,calyx,capitate,chartaceous,cm,connivent,densely,diameter,extra-axillary,flower,fruit,functionally,glabrous,glandular,globose,green,hair,hermaphroditic,leaf,leathery,like,lobe,lobed,male,mature,midpoint,mm,moderately,nearly,orange,ovate,pedicel,peduncle,petiole,porrect-stellate,pubescent,red,reniform,rusty,short,simple,slightly,sparsely,stellate,stem,stigma,style,surface,tan,tapering,tube,unlobed,vine,white,x,yellow	0.5,1-.,1-2.5,1.5-3,10-14,10-25,2-4.5,20-30,3-12,4-6,4-8,5-merou,6-8,abaxial,absen,accrescent,acute,adaxial,adaxiall,adaxially,alyx,andromonoecious,anthesi,apar,apex,apical,armed,asymmetrical,axe,berry,beyond,blade,cordate,curved,cylindrical,dark,difoliate,directed,discolorous,distally,eaf,eed,either,em,expanded,exserted,filament,flattened,frui,fruiting,geminate,glabrou,gree,heteromorphic,interpetelar,introrsel,lacking,long,long-styeld,lower,major,many,midrib,midvein,multicellular,multiseriate,narrowly,netlike,nflorescence,obtuse,often,older,orolla,pair,per,pit,planst,plant,pore,prickle,rachi,raised,ray,recurved,reflexed,ridge,roselike,ruit,separated,short0styled,side,small,spaced,stalk,stamen,staminate,ste,tamen,tissue,triangular,unarmed,unbranched,unequa,unicellular,unit,usually,vary,vein,whitish-green,wide,ympodial,young	adhesion,arrangement,colour,corolla,form,growth,inflorescence,length,na,ovary,position,presence,present,pubescence,rugulose,seed,shape,size,staman,texture
599	wfo-0001030285	success	279	117	99	180	18	0.355	.1,0.2–0.3,0.3–0.4,0.3–0.6,0.4–0.6,0.6–0.9,0.7–1.5,1.0–2.2,1.3–1.8,1.4–1.9,1.6–2.3,1.6–5.0,1/3,13.5,15.0–25.5,2.2–4.8,3.5–6.0,3.7–5.4,4,4.0–7.0,4.3–11.8,5,6.0–9.0,6–10,9.9–14.9,adnate,anther,apex,attenuate,base,becoming,calyx,capitate,chartaceous,cm,corolla,densely,diameter,dry,elliptic,erect,extra-axillary,flattened-irregular,flattened-orbicular,flattened-reniform,flower,fruit,glabrous,glandular,globose,green,growth,hair,internode,interpetalar,lateral,lavender,leaf,long,mature,maturing,minute,mm,obovate,ovoid,pedicel,peduncle,petiole,poorly-developed,porrect,porrect-stellate,pubescence,pubescent,purple,ray,red,sessile,shrub,simple,slightly,small,sparse,stellae,stellate,stem,stigma,style,tall,tissue,toward,tree,tube,upper,white,yellow,yellow-ferruginous,young,±glabrous,×	.04,.4,.6,.8,0.1–1.1,0.3–0.7,0.4–0.5,0.5–0.7,0.7–1.1,0.7–1.3,0.7–1.7,0.9–1.5,1.0–1.3,1.2–2.1,1.2–2.3,1.4–2.0,1.9–4.0,10.8–12.3,10–14,1984,2.4–3.2,2.8–3.1,3/4,4.6–8.8,45,4–5-merou,5.7–6.5,6–8-ray,9.2–15.2,90°,abaxially,acuminate,adaxial,adaxially,aequilateral,age,alveolate,alyx,anthesi,apart,apical,apiculate,apparently,appearing,appressed,area,armed,articulated,attached,attachment,axe,ba,basal,berry,bilobe,blade,branch,brochidodromous,bu,bud,central,channel,channeled,clinate,congested,conical,connivent,cuneate,deciduous,dehiscence,dentate,difoliate,distally,dorsally,eaf,eed,either,emerging,enclosing,endocarp,entire,exocarp,fertile,filament,filiform,flat,flexed,fork,forking,free,frui,fully,geminat,gradually,homostylous,immature,inclined,increasing,intersepalar,juic,lanceolate,large,laying,less,line,lobe,lon,lower,major,many-flowered,margin,midpoint,midrib,midvein,minor,moderate,moderately,nearly,nflorescence,notched,oblique,occasionally,often,orolla,peekel,per,perforate,point,pore,portion,potentially,prickle,protuberance,raised,reduced,reported,restricted,rigid,ripe,rounded,row,ruit,shiny,shorter,side,single,sinus,smooth,soon,sparsely,splitting,spread,stellate-pubescent,straight,surface,suture,tamen,tem,thin,time,tip,transparent,triangular,truncate,two,ud,unarme,unarmed,unbranched,vary,vein,vigorous,wavy,weakly,wide,ympodia,±90°,±90°and,±equal,±overlapping	6–8,adhesion,arrangement,bilobed,colour,form,height,inflorescence,length,number,ovary,plant,position,seed,shape,size,staman,texture
600	wfo-0001030287	success	150	104	71	79	33	0.473	-11,0-15,0.5-1,1-2,1-2.5,1-3,1-4,1-5.5,1.5-10,1.5-2.5,1966,2,2-,2-10,2-12,2-5,3,3-9,4-5,4.5-6,abaxially,adaxially,bluish,calyx,chartaceous,cm,compound,connivent,dendritically,densely,diameter,down,ellipsoidal,elliptic-ovate,fide,flattened,glabrous,glandular,hair,herb,lanceolate,leaf,lilac,lobe,mm,moderately,narrowly,oblong,ovoid,pedicel,peduncle,petiole,pinnately,puberulent,pubescent,purple,rugulose,shrub,simple,smith,sparsely,stellate,stigma,strongly,style,subcoriaceous,truncate,tube,unknown,x,yellow	-40,-foliat,-many,.5-2.5,1,1-10,1-15,2.5-4,4-6,5-10,8-13,?,acute,adaxiall,aggregate,apart,apex,articulated,axe,base,basiscopically,blade,branched,cell,color,cylindrical,decurrent,deltate,dendritic,dendritic-pubescen,directed,distall,eaf,eed,eglandular,entire,flower,forked,gland,lateral,leaflet,leaving,lon,long,long-stalked,lower,margin,membranaceous,nflorescence,nther,obtuse,often,orolla,pedicellar,pore,presen,rachi,radiu,ruit,scar,scattered,slightly,spaced,sparser,stalked,stone,subcapitat,subcordate,tal,tem,time,tip,triangular,unbranched,unit,upper,vary,wide,ympodial	adhesion,anther,arrangement,colour,corolla,dendritic-pubescent,form,fruit,growth,height,history,inflorescence,length,life,na,number,ovary,perennial,plant,position,presence,present,pubescence,ray,reproduction,seed,shape,size,staman,stem,subcapitate,surface,texture
601	wfo-0001030299	success	179	128	103	76	25	0.575	-50,-6,1-1.5,1-10,1-2,1-3,1-5,1.5-2,1.5-3,10-20,2,2-,2-10,2-20,2-4,20-30,3,3-13,3-30,3-4,3-9-compound,4,4-5,4-6,4-8,5-40,6-22,6-9,?,acuminate,acute,adaxially,apart,apex,apiculate,articulated,basal,base,calyx,campanulate,capitate,chartaceous,cm,connivent,cordate,cylindrical,densely,diameter,dilated,distally,ellipsoidal,entire,expanded,flattened,forked,fruit,glabrous,hair,leaf,leaving,lobe,long,margin,mm,moderately,narrowly,obtuse,often,ovate,pedicel,pedicellar,peduncle,petiole,pilose-hirsute,pink,pinnately,pubescent,pubescent-pilose,purple,radiu,remnant,rugose-reticulate,shrub,simple,slightly,small,spaced,sparsely,stigma,style,thickened,tip,tomentose,tree,triangular,truncate,unbranched,unequal,urceolate-,violet,white,x,yellow	-2,-40,.5-2,0.5-1,1.5-4,10-16,2.5-12,25-50,3-5,4-foliat,5-10,5-8,abaxially,absen,absent,aggregate,also,ape,axe,basiscopically,beyond,blade,cell,color,compound,connective,coriaceous,decurrent,diamete,directed,eaf,eed,equal,exceeding,exserted,fide,flower,globose,lateral,laterally,leaflet,lon,lower,midnerve,nflorescence,nther,orolla,pavón,perfect,perhaps,pore,present,prominent,puberulent-pubescen,puberulent-pubescent,pubescent-pilo,rachi,ruit,ruiz,shorter,stamen,stone,tal,tem,thecae,time,tomento,toward,tube,ud,unit,unknow,upper,vary,wide,ympodial	abaxial,anther,arrangement,colour,corolla,form,growth,height,history,inflorescence,length,life,na,ovary,pilose,plant,position,presence,pubescence,reproduction,seed,shape,size,stem,texture
602	wfo-0001030300	success	235	92	72	163	20	0.306	-1,-7,.5,0.5-0.6,0.5-4,0.6-0.8,0.7-1.2,0.9-1,1,1-1.3,1-2,1-4,1.2-,1.4-2.4,1.5-,2-2.1,2.2-7.5,3.5-13,4-11,9-12,abaxially,absent,anther,bifid,broadly,brown,calyx,capitate,cm,coherent,corolla,densely,diameter,elliptical,fruit,glabrous,globose,golden,green,herb,imparipinnate,inflorescence,interrupted,large,like,long,mm,moderately,obovate,orbicular,ovary,pale,partially,pedicel,peduncle,pentagonal,perennial,petiole,plant,pubescence,pubescent,slightly,sparsely,stem,stigma,style,surface,thick,wide,yellow,yellowish-green,zygomorphic	-0.9,0.1,0.1-0.15,0.15-1,0.2,0.2-0.5,0.2-1.5,0.4-0.5,0.4-1.5,0.4-4.5,0.5,0.5-1,0.5-5,0.6-0.7,0.7-0.8,0.7-1.5,0.8-1,0.8-3,0.8-4,1-2-celled,1-6,1-celled,1.5-2.5,2-2.5,2-3,2-4,2-foliate,2-locular,3/4,4-celled,6-15,6-8-celled,abundant,acute,adaxial,adaxially,almost,although,always,anthesi,apex,apical,appearance,appendage,articulated,articulation,ba,basal,base,bent,beyond,bract,bracteate,brittle,cell,column,cordate,crenat,crenate,curved,deltate,developed,diamete,distal,eaf,edicel,eed,eglandular,ellipsoidal,elongate,entire,even,exserted,face,filament,finely,flower,frequently,fruiting,give,glandular,glutinous-viscose,gree,hair-like,halfway,head,interjected,internode,introrse,irregularly,lamina,larger,lateral,leaflet,leave,less,lobe,lon,longer,margin,markedly,midvein,minute,multicellular,narrowly,nflorescence,node,oblique,occasionally,once-branched,outgrowth,pair,papillae,petal,petiolule,pith,population,pore,present,primary,pseudostipule,reflexed,rest,rounded,ruit,secondary,silky,simple,spathulate,spreadin,spreading,staminal,sterile,straight,strongly,tall,tem,terminal,tertiary,testa,tip,triangular,trichome,tube,two,ud,underlying,unicellular,uniseriate,unit,united,upper,usually,vein,velvety,wall,weak,well,wider,winged,woody,yellowish,ympodial	adhesion,arrangement,colour,form,growth,height,history,leaf,length,life,na,position,reproduction,rugulose,seed,shape,size,staman,texture,ye
603	wfo-0001030311	success	182	108	60	122	48	0.33	.2,5-pinnate,abaxially,acuminate,acute,adaxially,anther,apex,base,blade,brown,calyx,chartaceous,cm,cordate,densely,diameter,entire,extra-axillary,flattened,flower,fruit,glabrous,granular,green,hair,herbaceous,lanceolate,lenticular,lobe,margin,membranaceous,minutely,mm,oblique,obtuse,orangish,ovoid-rhomboid,pedicel,peduncle,petiole,pubescence,pubescent,purplish,rounded,sand-punctate,slightly,sparsely,stellate,stem,stigma,style,surface,tan,terrestrial,tip,tube,vine,white,x	.5,.5–1.8,0.1,0.1–0.2,0.3–1.5,0.4–2,0.5–0.8,0.5–1,0.5–2,0.5–2.5,0.6–1,0.6–2.4,0.8–1.2,0.8–4,0.8–4.5,1.2–7,1.5–2,1.5–3,1.5–5.5,1.5–6,1.5–8,1.8–2,15–22,1–1.2,1–1.5,1–2,1–2.5,1–3,2.2–2.5,2.2–3,2.5–9,2–10,2–2.5,2–6,3–5,3–7,5–10,<,accrescent,adaxial,along,alyx,apar,apical,appearance,axe,basal,berry,c.,capitat,ciliat,ciliate,clavate,color,cuneate,deltoid,dense,distal,eaf,eed,elliptical,especially,falcate,fallen,filament,fruiting,giving,glabrou,groov,groove,ground,half,lateral,leaflet,like,log,lon,long,lower,m.,membranous,midvein,nflorescence,nternode,obovate,occasionally,orolla,pair,papillose,petiolulate,petiolule,plurifoliat,present,proximal,rachi,rhomboid,ruit,scattered,sessile,short,shortly,side,slender,smaller,spaced,strongly,tamen,tem,thick,thickened,thinner,trailing,trichome,unbranched,unit,upper,vary,vein,wide,wide-diameter,widely,ympodial	0.5-0.8,0.5-1,0.8-1.2,1-1.2,1-1.5,1-2.5,1.2-7,1.5-2,1.5-5.5,1.5-8,1.8-2,15-22,2-2.5,2-6,2.2-2.5,2.2-3,3-5,3-7,5-10,adhesion,arrangement,capitate,climate,colour,corolla,form,glandular,growth,height,inflorescence,leaf,length,midpoint,na,number,ovary,plant,position,presence,ray,reproduction,rugulose,seed,shape,size,staman,stipe,texture
604	wfo-0001030311	success	203	111	76	127	35	0.374	.2,0.5-0.8,0.5-1,0.8-1.2,1-1.2,1-1.5,1-2.5,1-3,1.2-7,1.5-2,1.5-5.5,1.5-8,1.8-2,15-22,2-2.5,2-6,2.2-2.5,2.2-3,3-5,3-7,5-10,5-pinnate,abaxially,acuminate,acute,adaxially,anther,apex,basally,base,blade,brown,chartaceous,cm,cordate,densely,diameter,entire,flattened,flower,fruit,glabrous,granular,green,hair,herb,lenticular,lobe,margin,membranaceous,minutely,mm,oblique,oblong,obtuse,orangish,ovoid-rhomboid,pedicel,peduncle,petiole,pubescent,purplish,rounded,slender,slightly,sparsely,stellate,stem,stigma,style,surface,tan,tube,white,x,yellow	.5,.5-1.8,0-2.5,0.1,0.4-2,0.5-2,0.6-1,0.6-2.4,0.8-4,0.8-4.5,1.5-3,1.5-6,2-10,2224,5-merou,8031,<,[,],absen,absent,accrescent,adaxial,ag,aggregate,along,alyx,apart,apical,apparently,appearance,articulated,axe,ba,basal,capitat,cell,ciliat,ciliate,clavate,color,connivent,cuneate,deltoid,dense,dig,directed,distal,distally,eaf,eed,elliptical,equal,especially,falcate,fallen,filament,formation,g,geminat,gh,giving,groov,groove,ground,half,interjected,large,lateral,leaflet,like,log,lon,long,longitudinal,lower,m.,midvein,nflorescence,node,obovate,occasionally,opening,orolla,pair,papillose,perfect,petiolulate,petiolule,pittier,plurifoliate,pore,present,proximal,rachi,rhomboid,rooting,ruit,scattered,sessile,short,shortly,side,simple,sinple,slit,smaller,spaced,stone,strongly,tamayo,tamen,tem,thick,thickened,thinner,tip,trailing,unbranched,uniseriate,unit,upper,vary,vein,wide,widely,ympodial	adhesion,arrangement,calyx,capitate,climate,colour,corolla,form,glandular,growth,height,hermaphroditic,history,inflorescence,leaf,length,life,midpoint,na,number,ovary,perennial,plant,position,presence,pubescence,ray,reproduction,rugulose,seed,shape,size,staman,stipe,texture
605	wfo-0001030335	success	153	122	85	68	37	0.556	.1,.25,.5,0-5,0.05-0.2,0.5-1,0.7-1,1-1.5,1-2,1.1-1.4,1.1.5,2-2.5,2-4.5,2-5,2.5-3,3/4,5-6,7-13,acuminate,acute,along,anther,apex,base,beneath,berry,bi-lobed,calyx,cm,conical,corolla,dark,decurrent,densely,dia,dry,elliptic,filiform,gently,glabrous,globose,green,greyish-red,leaf,lobe,lobed,long,material,minute,minutely,mm,narrowly,onto,opposite,ovary,ovoid-reniform,pale,papillose,pedicel,petiole,pitted,pore,poricidal,puberulent,pubescent,ripe,shaped,shrub,sparsely,stem,stigma,style,surface,tan,tapering,tear-drop,tip,trichome,tube,uniseriate,vein,way,white,x,yellowish-green	.75,0.1-0.5,0.25-0.5,1-3-flowered,2-2.2,5-7,anthesi,aspec,ba,bark,branch,bud,deciduous,deflexed,deltoid,eaf,edicel,eed,erect,except,expanded,exserted,filament,flattened,free,fruiting,geminate,giving,horizontally,lamina,lateral,lenticellate,lightly,like,lon,lower,main,middle,nflorescence,obovoid,occasionally,often,older,pair,papillo,portion,prominent,puberulen,raised,reflexed,ruit,simple,slightly,soon,spreading,straight,strongly,tall,ud,underside,unifoliat,unit,widest,winged,woody,yellow,ympodial,young	adhesion,arrangement,blade,climate,colour,diameter,form,fruit,glandular,growth,hair,height,history,inflorescence,length,life,margin,midpoint,na,number,peduncle,perennial,plant,position,presence,pubescence,ray,reproduction,rugulose,seed,shape,size,staman,stellate,stipe,texture,unifoliate
606	wfo-0001030336	success	266	112	89	177	23	0.335	-10,-19,.5,0.5,0.5-0.7,0.6-0.8,1,1-1.5,1-3,1.0-1.4,1.6-7,1.7-2.3,1.8-3.0,3-5,4-10,4-celled,almost,anther,apex,bright,brown,calyx,capitate,cm,completely,conical,corolla,dark,densely,diameter,elliptic,entire,flushed,fruit,glandular,globose,grayish,green,greenish,head,herb,imparipinnate,inflorescence,interrupted,leaf,lobe,long,margin,minutely,mixed,mm,obovate,orbicular,ovary,pale,pedicel,peduncle,perennial,petiole,puberulent,pubescent,purple,rotate,scattered,shorter,shrub,simple,slightly,small,soft,sparse,stellate,stem,stigma,style,surface,ten,thick,tip,trichome,tube,uniformly,uniseriate,united,velvety,weak-walled,white,wide,yellow	-1.5,-2,0-,0.1-0.3,0.1-0.5,0.1-0.7,0.1-1,0.15-0.2,0.15-0.9,0.2,0.2-0.25,0.2-0.8,0.2-1,0.2-1.5,0.3-0.4,0.3-1.1,0.5-1,0.5-1.5,0.6-1.5,0.8-0.9,0.8-1.2,0.8-1.3,0.8-3,1-1.4,1-celled,1.5-,1.5-2,1.5-3.5,1.5-5,1/4-1/3,10,2-4,2-9,2-foliate,2-locular,2/3,4,4-,6,8-16,8-20,8-celled,absent,acute,adpressed,amongst,anthesi,apical,appearance,appearing,appendage,articulated,articulation,basal,base,basiscopically,bent,berry,bifurcate,bluntly,bract,bracteate,branch,cell,clavat,coat,column,cordate,crenate,curved,darker,decurrent,deeply,developed,diamete,distal,divided,eaf,edicel,eed,eglandular,elongate,entir,erect,essentially,exserted,extremely,filament,first,flower,fruiting,giving,glandula,hair-like,half,halfway,interjected,internode,investing,lanceolate,large,larger,largest,lateral,leaflet,leave,less,like,lobed,lon,longer,loosely,lower,markedly,maturity,mere,middl,midvein,minute,mostly,narrowing,narrowly,nflorescence,node,oblique,occasionally,often,once-branched,outgrowth,pair,papillate,part,petiolule,population,present,primary,proximal,pseudostipule,rachi,range,reflexed,rest,rounded,ruit,secondary,sessile,shaggy,silky,sinus,sometimes,southern,spreadin,spreading,staminal,sterile,straight,stripe,strongly,surrounding,tall,tem,terminal,tertiary,testa,truncate,two,ud,unicellular,unit,upper,usually,wall,way,winged,woody,ympodial,young	1.5-4-10,4-16,adhesion,arrangement,clavate,colour,form,growth,height,history,length,life,na,plant,position,pubescence,reproduction,rugulose,seed,shape,size,staman,texture
607	wfo-0001030342	success	155	121	85	70	36	0.548	.2,.5,0.1–0.2,0.3–1.2,0.5–1,0.8–1.5,1.5,1.5–13,1.5–2,1.5–5,1.5–7.5,10–25,1–1.5,1–2.5,1–7,2–2.5,2–4,3-pinnate,3–12,4–5,4–8,abaxially,acuminate,adaxially,anther,apex,apiculate,base,blade,brown,calyx,chartaceous,cm,cordate,cuneate,dense,diameter,entire,extra-axillary,flattened,flower,fruit,glabrous,greenish,herbaceous,leaf,lenticular,light,lobe,long,margin,membranous,minutely,mm,mottled,oblique,obtuse,often,ovoid-rhomboid,pedicel,peduncle,petiole,pointed,pubescent,rarely,revolute,sand-punctate,scattered,slender,smooth,spaced,stellate,stem,stigma,style,surface,trichome,tube,undulate,vine,white,wide-diameter,widely,x,yellowish	0.5–3,0.5–5,0.8–4,1-5,1-6.5,1.2–3,1–1.2,1–3,1–5.5,1–6,2–,3,5-merous,6–7,abundant,accrescent,acute,along,alyx,apar,apical,axe,berry,broadly,c.,capitat,ciliat,cylindrical,deltoid,eaf,eed,elliptical,filament,fruiting,glabrou,lanceolate,lateral,leaflet,like,lon,lower,m.,nflorescence,nternode,orolla,perfec,petiolule,plurifoliat,proximal,pubescen,rachi,rhomboid,rounded,ruit,side,slightly,sparsely,tamen,tem,terrestria,tip,truncate,truncate-acuminat,unbranched,unit,vary,vein,wide,ympodial,–7	adhesion,apart,arrangement,capitate,ciliate,climate,colour,corolla,form,glandular,growth,hair,height,history,inflorescence,length,life,midpoint,na,number,ovary,plant,position,presence,pubescence,ray,reproduction,rugulose,seed,shape,size,sparingly,staman,stipe,terrestrial,texture
608	wfo-0001030342	success	153	105	73	80	32	0.477	.2,.5,0.5-1,1-1.5,1-7,1.5-13,1.5-2,1.5-5,1.5-7.5,10-25,2-2.5,2-3,3-12,3-pinnate,4-5,abaxially,acuminate,adaxially,anther,apex,apiculate,basally,base,blade,brown,calyx,chartaceous,cm,cordate,cuneate,diameter,entire,equal,extra-axillary,fruit,glabrous,hair,herb,leaf,lenticular,light,lobe,margin,membraceous,minutely,mm,oblique,oblong,obtuse,pedicel,peduncle,petiole,pubescent,rarely,revolute,sagittate,scattered,simple,smooth,stellate,stigma,style,surface,terrestrial,trailing,tube,unbranched,undulate,uniseriate,white,widely,x,yellow	-7,0.5-3,0.5-5,0.8-4,1-1.2,1-3,1-5,1-5.5,1-6,1-6.5,1.2-3,2-,3,4-8,5-merou,6-7,absent,abundant,accrescent,acute,ag,along,alyx,apart,apical,apparently,articulated,axe,ba,broadly,capitat,ciliat,connivent,cylindrical,deltoid,directed,distally,eaf,eed,elliptical,filament,flower,fruiting,geminat,interjected,lanceolate,lateral,leaflet,long,longitudinal,lower,nflorescence,node,opening,orolla,perfect,petiolule,plurifoliate,pore,proximal,pubescen,rachi,rhomboid,rooting,rounded,side,slender,slightly,slit,spaced,tamen,tem,tip,truncate,truncate-acuminat,unit,vary,vein,wide,ympodial	adhesion,arrangement,capitate,climate,colour,corolla,form,glandular,growth,height,history,inflorescence,length,life,midpoint,na,number,ovary,plant,position,presence,pubescence,ray,reproduction,rugulose,seed,shape,size,staman,stem,stipe,texture
609	wfo-0001030353	success	227	116	88	139	28	0.388	.7,0-6,0.1-0.2,0.15-0.3,0.5-0.9,1-6,1.8-2.2,1.8-3,1/2-2/3,1/5,11-16,2.5-4,2.8-3.7,3-4,3-5.5,3.5-4,4-4.5,5,6-8,7-10,abaxially,acute,andromonoecious,anther,apex,base,berry,blade,brown,calyx,chartaceous,cm,connivent,cuneate,densely,diameter,ellipsoid,elliptic,equal,erect,evenly,flattened-reniform,fruit,glabrescent,green,lateral,leaf,length,lobe,lobed,long,margin,maturity,mauve,midpoint,mm,moderately,orange-brown,pedicel,peduncle,petiole,plant,poricidal,ray,shape,shrub,simple,small,smooth,sometimes,stellate,stellate-pubescent,stem,stout,style,subentire,tapering,terminal,tip,tree,tube,upper,warty,way,weakly,wide,yellow,young	-0.2,-1.5,-1/2,-2,-3,-5,-6,-merous,.1,.2,.5,0,0-15,0-2,0.1-0.3,0.5,0.8,0.8-1.2,1,1-2,1-3,1-7,1.2-1.8,1/,1/3,1/6,1/6-1/4,10-15,2-10,2-7,20-200,4-,4-5,5-6,6,6-15,8-15,abaxial,adaxial,almost,alyx,apar,apart,apically,apiculat,apparently,articulated,bark,broad-deltate,c.,conical,curved,deltate,development,discolorous,distal,distance,drying,eaf,eed,elongating,extending,filament,flattened,flower,free,fruiting,glabrous,half,hermaphrodite,heterostylous,infructescence,less,long-styled,longer,lower,lowermost,mature,midvein,multangulate,narrow-deltate,nflorescence,older,one,open,orolla,oung,pair,patch,pendulous,per,pericarp,plurifoliat,pointed,porrect,portion,prickle,prickly,primary,red-brown,reddish-green,reflexed,retaining,rounded,ruit,scar,sessile,short-styled,shorter,side,somewhat,spaced,sparsely,spreading,stalk,stalked,staminat,straight,strongly,surface,tamen,terete,tertiary,throughout,time,trichome,unarme,unarmed,unbranched,unit,vary,vein,venation,visible,whit,white-gray,wo,woody,ympodial	adhesion,arrangement,climate,colour,corolla,form,glandular,growth,hair,height,history,inflorescence,life,na,number,ovary,perennial,position,presence,present,pubescence,reproduction,seed,size,staman,stigma,stipe,texture
610	wfo-0001030407	success	182	91	67	115	24	0.368	.2,.5,1-2,12-14,2-5,2-7,3-6.5,3-9,3.5-9.5,30-60,4-5,6-7,6.5-18.5,7-8,abaxially,adaxially,anther,axillary,berry,brownish,bud,chartaceous,ciliate,cm,condition,conical,corolla,densely,diameter,drying,elliptic-lanceolate,fresh,fruit,glabrous,green,greenish,herb,lanceolate,leaf,light,lobe,long,margin,mm,mottled,odd-pinnate,ovate,ovoid,pedicel,peduncle,pentagonal,petiole,plant,pubescent,purple,ripe,seed,size,stigma,style,subtending,terminal,tube,whitish,wide,x,yellow	0.7-3.2,1-10,1-3,1-4,1.5-5,12-15,2-2.5,2-6.7,3-10.5,3-4,5,5-merou,absent,acumen,acuminate,ag,alyx,apart,apex,apparently,articulated,axe,base,blade,capitat,cell,connivent,covering,decreasing,digestion,distal,dorsally,eaf,edge,eed,end,enzyme,especially,exceeding,filament,flat,flower,folded,forked,geminat,generally,glabrou,gradually,green-white,hair,hair-like,half,homostylous,honeycomb-shaped,interjected,larger,lateral,leaflet,lengthening,like,living,lower,make,middle,minute,mucilaginous,nflorescence,obtuse,one,orolla,pair,perfect,petiolule,placed,plurifoliate,pore,poricidal,proximal,pubescen,ray,removed,round,ruit,secondary,semierec,seudostipule,slit,spaced,specimen,stamen,ste,stolo,subequal,subsessile,symmetrical,tall,tamen,tem,testal,thick,thir,throughout,tip,toward,tri-,tuber,typically,unit,unwinged,usually,vary,wall,wet,white,ympodial	adhesion,arrangement,calyx,capitate,colour,form,growth,height,history,inflorescence,length,life,na,ovary,perennial,position,pubescence,reproduction,rugulose,shape,staman,stem,surface,texture
611	wfo-0001030417	success	242	86	67	175	19	0.277	-5,0.05-0.1,0.5-0.7,0.5-0.8,0.7-1,1-1.3,1-2.3,1.2-3,1.5-8,2-3,4-12,4-25,8-11,abaxially,abundant,along,annual,anther,biennial,bright,broadly,brown,calyx,capitate,cm,conical,corolla,densely,diameter,elliptic,fruit,glabrous,glandular,globose,green,herb,imparipinnate,inflorescence,interrupted,leaf,length,long,mm,obovate,ovary,ovate,pale,pedicel,peduncle,perennial,petiole,pubescence,pubescent,rarely,red,size,sparsely,stellate,stem,stigma,style,surface,thick,vein,velvety,wide,yellow	.5,0.1-0.25,0.2,0.2-0.4,0.2-0.7,0.25-0.4,0.25-0.5,0.3-0.4,0.5-1,0.5-1.2,0.5-2,0.8,1,1-1.2,1-1.5,1-2,1-2-celled,1-3.5,1-4,1.5-2,1.5-3.5,1.5-5,1/3,2-4,2-8,2-locular,2.5-5,2/3,3,3-foliate,3/4,7-30,absen,absent,acuminate,acute,also,anthesi,apex,apical,appearance,appendage,articulation,basal,base,basiscopically,bent,branch,cell,cente,column,common,cordate,crenate,decreasing,decurrent,dentate,distal,eaf,ebracteate,edicel,eed,eglandular,elongate,entire,erect,exserted,extended,extending,extremely,filament,flower,free,fruiting,generally,giving,gree,hair-like,hal,head,hybrid,included,initially,interjected,internode,lanceolate,larger,largest,later,lateral,leaflet,like,lobe,lon,lower,margin,maturation,mature,minute,minutely,mixture,multicellular,narrowly,nflorescence,northern,oblique,occasionally,often,once-branched,outgrowth,pair,parallel,part,patent,pedice,peruvian,petiolule,point,population,portion,primary,procumbent,proximal,pseudostipule,putatively,rachi,range,reflexed,rest,ripe,robust,round-crenate,rounded,ruit,scattered,secondary,sessile,several,shaggy,short,silky,simple,slightly,sometimes,somewhat,species,staminal,sterile,straight,strongly,tem,terminal,tertiary,testa,theseadpressed,thin,third,tip,toward,trichome,truncate,tube,type,ud,unicellular,uniseriate,unit,usually,variable,viny,wall,way,white,winged,ympodial	0.8-5,adhesion,arrangement,colour,form,growth,height,history,life,na,plant,position,reproduction,rugulose,seed,shape,staman,texture,ye
612	wfo-0001030420	success	170	112	85	85	27	0.5	-2,-30,-pubescent,0.5-,0.5-1,0.5-4,0.5-8,1,1-1.5,1-2,1-3,1-4,1-7.5,1.5-3,1.5-5,10-,15-25,2-14.5,2-3,2-5,2-9,4-7,5-,6-7,abaxially,acuminate,acute,adaxially,also,apex,basal,base,calyx,chartaceous,cm,connivent,cordate,densely,diameter,eglandular,ellipsoidal,elliptic-ovate,elongated,entire,fruit,glabrate,glabrous,glandular-,glandular-puberulent,hair,lanceolate,leaf,lobe,lobed,long,margin,mm,moderately,often,ovate,pedicel,peduncle,petiole,pilose,pinnately,puberulent,puberulent-pubescent,pubescent,pubescent-pilose,purple,shrub,simple,small,sparsely,stellate,stigma,style,subcoriaceous,tree,truncate,tube,unknown,vein,x,yellow	-20,-35,-4,-9,1-,1-6,1/2,10-25,2-,2-6,3-7,3-lobed,4-foliat,5-15,5-6,7-19,7-22,7/8,absent,aggregate,apart,ape,articulated,axe,beyond,blade,cell,color,connective,cylindrical,dark,deltate,directed,distally,divided,eaf,eed,eglandular-pilo,eglandular-puberulent,equal,exserted,flower,forked,leaving,lon,lower,midrib,narrowly,nearly,nflorescence,nther,obtuse,orolla,pedicellar,perfect,pore,presen,pubescent-pilo,rachi,radiu,rarely,remnant,ripe,ruit,shorter,sinus,spaced,stamen,stone,tal,tem,thecae,time,tip,tomento,triangular,truncat,ud,unbranched,unit,unlobed,vary,wide,yello,ympodial	adhesion,anther,arrangement,colour,corolla,eglandular-pilose,form,growth,height,history,inflorescence,length,life,na,ovary,plant,position,pubescence,reproduction,rugulose,seed,shape,size,staman,stem,surface,texture
613	wfo-0001030426	success	158	68	48	110	20	0.304	-30,0.4-0.7,1-4.2,15-25,2,2-3,2.5-4,2.5-6,3-6,4-10,4-6.5,6-11.5,6-8,9,calyx,cm,connate,corolla,diameter,distal,forked,glandular,globose,green,green-white,half,heart-shaped,herbaceous,leaf,long,mm,odd-pinnate,ovoid,pedicel,peduncle,perennial,petiole,pilose,plant,seed,size,stellate,stigma,style,throughout,white,wide,yellow	0.3-7,0.3-8,1-4,1.5-3,1.5-6.5,1.7-3.2,10,3-12,3-4,3-6-foliat,abaxially,absen,acumen,acute,adaxially,apex,apical,apically,apiculate,articulate,base,branched,caudate,cell,covering,cyme,decurrent,dehiscent,dichasial,dichasially,digestion,diminishing,dorsally,eaf,ebracteate,edge,eed,elliptic-lanceolate,emoval,enzyme,exceeding,filament,flat,flower,folded,generally,globo,gradually,hair-like,honeycomb,interjected,introrse,lanceolate,larger,lateral,leaflet,linear,linear-lanceolate,linear-oblong,living,lobe,lon,lower,make,maturing,monochasial,mucilaginous,nflorescence,nther,oblique,oblong,obtuse,often,orolla,pair,pattern,perfect,pinnatifi,plan,poricidally,proximal,rachi,reveal,rounded,ruit,second,sessile,seudostipule,short,slit,specimen,spot,stamen,straight,stripe,tal,tem,terminal,testal,thick,toward,tuber-bearing,typically,unit,vary,wall,whit,without,ympodial,¼	anther,arrangement,colour,form,fruit,growth,height,history,inflorescence,length,life,na,ovary,pinnatifid,position,pubescence,reproduction,shape,stem,texture
614	wfo-0001030430	success	171	111	68	103	43	0.398	.2,0.5,abaxially,acute,anther,anthesi,apex,axillary,base,blade,blue,brittle,brown,calyx,capitate,clavate,cm,densely,diameter,equal,erect,flattened,fleshy,fruit,glabrous,globose,green,hair,indumentum,leaf,lobe,lobed,long,margin,mm,moderately,multicellular,oblong,occasionally,pair,pale,pedicel,peduncle,pentagonal,perennial,petiole,pitted,pubescent,purple,regularly,rounded,shallowly,shoot,shrub,simple,stigma,style,subglabrous,surface,terminal,tube,unifoliate,uniseriate,violet,white,woody,x,yellow	.5,0.25,0.3,0.4,0.5–12,0.6,0.6–0.8,0.6–1.0,0.8–3.0,0.8–5.6,0.9–1.0,0–20,1.0–1.2,1.0–1.5,1.0–2.0,1.2–2.0,1.3–8.0,1.4–1.5,1.5–1.7,1.6–1.8,1.8–5.0,12–20,12–30,1–3,1–9,2.0–3.0,2.0–4.2,2–3,3.0–4.5,30–200,3–17,3–24,3–4,3–5,3–8,5,5.5–12,5–10,5–6,6–10,abundant,adaxiall,adaxially,ag,apart,apical,appressed,articulated,axe,ba,basal,borne,branched,bud,cell,chartaceous,connivent,convex,cylindrical,decurrent,dentate,diamete,eaf,eed,elliptic,especially,few-seeded,filament,flower,geminat,lon,longitudinal,lower,m.,nflorescence,opening,orolla,ovate,perfect,pore,poricidal,present,ruit,serrate,shaped,side,slit,spaced,stone,straight,tal,tamen,tear-drop,tem,time,tip,toward,unit,vary,wide,ympodial,–2.7,–40	0-20,0.5-12,0.6-1.0,0.8-3.0,0.8-5.6,1.0-1.5,1.3-8.0,1.4-1.5,1.6-1.8,12-20,2.0-4.2,3-17,3-4,3-5,3-8,3.0-4.5,30-200,5-10,5-6,adhesion,arrangement,colour,corolla,decurred,form,growth,height,history,inflorescence,length,life,na,ovary,plant,position,pubescence,rugulose,seed,shape,size,staman,stem,texture
615	wfo-0001030441	invalid_json	178	99	62	116	37	0.348	.5,0.5-1,0.5-3,1,1-1.4,2,2-10,2-5.5,2.5,3-4,4-5,5-14,5-7.5,6-11,anther,bright,calyx,capitate,cm,corolla,diameter,ellipsoid,elliptic,flattened,glandular,globose,green,growth,juicy,lateral,lobe,lobed,long,membranous,minutely,mm,narrowly,pale,papillose,pedicel,peduncle,petiole,plant,red,reniform,shrub,simple,spot,stellate,stem,stigma,style,surface,terminal,trichome,tube,vine,violet,white,wide,woody,yellow	+,0.5,0.5-0.75,1-1.5,1-2-celled,1.2-1.4,1.5-2,10-40,2-3,30,5-6,5-7,5-merou,<,>,acuminate,acute,ag,along,alyx,anthesi,apart,apex,ark,articulated,attenuate,base,berry,branched,brow,c.,cell,closely,decurrent,deltate,distall,eaf,eed,entire,exerted,eye,filament,flexuous,flower,free,fruiting,glabrou,glabrous,glandula,hair,ilament,impressed,irregularly,leaving,lengthening,lon,lower,making,many,margin,markedly,midvein,new,nflorescence,occasionally,older,onto,open,orolla,otherwise,pair,papillat,peg,per,perfect,pericarp,plurifoliat,pore,poricidal,portion,primary,pubescent,reflexed,ridged,ripe,ruit,scandent,scar,shiny,short,shrubby,slightly,slit,small,somewhat,spaced,spreadin,spreading,strongly,tem,thin,time,tip,trailing,triangular,ud,undulate,uniseriate,unit,upper,usually,vary,vein,wall,way,ympodial	'','hair,[,],``,adhesion,arrangement,brown,characteristic,colour,form,fruit,height,hermaphroditic,history,inflorescence,leaf,length,life,na,number,ovary,perennial,position,presence,pubescence,ray,reproduction,rugulose,seed,shape,size,staman,texture,value,{,}
616	wfo-0001030444	success	196	90	64	132	26	0.327	0.15-0.8,0.8-2,1-10,1-2,1-4,1.2-1.8,11-45,2-8,2.4-3.8,3-10,3-5,4-7,6.1-12.8,7.1-17.5,9.4-20.1,anther,blue,brownish,clavate,cm,condition,coriaceous,corolla,deep,diameter,dot,drying,elliptic,fresh,fruit,glabrous,green,greenish,herb,lanceolate,leaf,lilac,lobe,long,medium,mm,odd-pinnate,ovate,ovoid,pedicel,peduncle,pentagonal,petiole,plant,purple,ripe,rotate,seed,size,sometimes,stigma,style,terminal,tube,white,whitish,wide,x,yellow	0-24,1,1-5,1.1-2.7,2-3,2-6,2.3-3.6,3.7-6.8,4-17,4-39,5-merou,5.3-9,abaxiall,abaxially,acumen,acuminate,acute,adaxially,ag,along,alyx,apart,apex,apparently,arranged,articulated,asymmetric,attenuate,axe,axillary,base,basiscopic,bead,berry,blade,bud,capitat,cell,ciliate,connivent,covering,dark,decreasing,digestion,distal,dorsally,eaf,edge,eed,enzyme,erec,exceeding,filament,flat,flower,folded,forked,geminat,general,generally,glabrou,green-white,hair-like,hal,half,high,homostylous,honeycomb-shaped,interjected,larger,lateral,leaflet,lengthening,light,like,linear,living,lower,make,margin,moniliform,mucilaginous,multiple,narrow,necklace,nflorescence,orbicular,orolla,pair,perfect,petiolulate,plurifoliate,pore,poricidal,removed,rough,rounded,ruit,sessile,seudostipule,shortly,side,slit,spaced,specimen,stamen,stolon,straight,subequal,subtending,symmetric,tall,tamen,tem,testal,thick,throughout,tip,tissue,touch,toward,tri-,tuber,typically,unit,unwinged,usually,vary,wall,wet,wing,ympodial	adhesion,arrangement,calyx,capitate,colour,form,growth,height,history,inflorescence,length,life,na,ovary,perennial,position,presence,pubescence,reproduction,rugulose,shape,staman,stellate,stem,surface,texture
617	wfo-0001030445	success	226	130	100	126	30	0.442	0.2-0.4,0.2-0.5,0.6-2.2,0.7,1-1.3,1-7,1.1-4.3,1.3,1.5-2.1,1.6-2,1.7-2.4,14,15-35,2.2-2.9,2.2-3.5,2.4-4.7,3.5-4.2,4.1-8.7,4.2-10,5.2-7.1,5.9-15,6.1-9.1,7.5-16,8.2-18,abaxial,abaxially,acuminate,adaxially,anther,apex,around,base,black,blade,blunt-tipped,brown,brownish-yellow,bulbous-based,calyx,capitate,cm,corolla,decurrent,deltoid-reniform,diameter,drying,elliptic,elliptical,elongated,entire,ferruginous-granular,ferruginous-tomentose,flower,fruit,glabrate,glabrous,globose,green,greyish-tan,hair,inserted,leaf,lobe,long,margin,mm,mostly,oblong,oblong-lanceolate,orange,orangish-tan,pedicel,peduncle,petiole,pseudoterminal,pubescence,ray,relatively,reniform,reticulate-punctate,semi-spherical,shrub,simple,small,somewhat,sparse,stellate,stem,stigma,style,surface,thin,tomentose,tree,tube,white,x,yellow,yellowish,yellowish-tan	.1,.5,/5-2/3,0.1-0.7,0.2,0.2-0.7,0.3,0.4,0.5,0.6-3.5,0.8,1,1.3-1.8,1.3-2,1.8-3.5,10-14,10-16,2.1-5.2,3-5.4,3.1-5,3.4-5.6,5-125,5-merou,5.9-8.3,8.1-10,accrescent,acute,ag,along,alyx,apart,appressed,articulated,axillary,bark,berry,blunt-tippe,branch,branched,bud,concentrated,cylindrical,directed,distally,eaf,earl,edge,eed,erect,exserted,ferruginous,filament,free,fruiting,geminate,glabrescen,high,homostylous,intermediate,lackin,lateral,lengthening,lobed,lon,longitudinal,lower,m.,main,many,midrib,midvein,multangulat,multangulate,nflorescence,obovate,obscured,obtuse,older,open,orbicular,orolla,ovate,ovate-lanceolate,plurifoliate,pore,poricidal,porrect-stellat,porrect-stellate,pubescent,rachi,resorption,rounded,ruit,runk,sessile,side,slightly,slit,soon,spaced,sparsely,splitting,stalk,stamen,stout,subcampanulate,sulcate,suture,tamen,thick,thick-textured,thicknes,thin-,time,tip,tissue,tomentum,unarme,unit,vary,vein,vestigial-rayed,way,wide,ympodial,young	adhesion,arrangement,climate,colour,form,glabrescent,glandular,growth,height,history,inflorescence,length,life,midpoint,na,number,ovary,perennial,plant,position,presence,present,reproduction,rugulose,seed,shape,size,staman,stipe,texture
618	wfo-0001030447	success	276	112	90	186	22	0.326	.3,.5,0.2,0.2-0.4,0.5-0.65,0.5-10,0.7-1,0.8-3.5,1-1.5,1-2,1.8-2.5,2-4,2.2-2.8,2.5-6.5,3-4.5,3-5,6-10,6-8,6.5-9,7-8,abaxially,acute,anther,apex,base,berry,blade,calyx,chartaceous,clavate,cm,corolla,cuneate,cupular,densely,diameter,drying,erect,filiform,flattened-reniform,free,fruit,glabrous,globose,lateral,leaf,length,lobe,lobed,margin,maturity,midvein,mm,moderately,obconical,oblong,orange,orange-brown,orange-red,ovate,pedicel,peduncle,petiole,prostrate,purple,ray,red-brown,rounded,shallowly,shiny,shrub,simple,slender,smooth,sometimes,sparsely,stellate,stellate-pubescent,stem,stigma,stout,style,surface,tapering,thin,tube,white,x,yellow,×	.2,/5,0,0.1,0.1-0.3,0.15-0.3,0.4-0.7,0.4-0.9,0.5,0.5-3,0.8-1.7,1,1-10,1-2.5,1-3,1-5,1-6,1.5,1.5-2.5,1.5-7,1/3,1/3-1/2,1/3-2/3,1/4-1/3,2.5-10,3,30-45°,4-8,5,5-15,5-merou,6,6-16,6-7,6-9,8,accrescent,adaxially,age,always,alyx,apar,apart,apical,apically,apparently,armed,articulated,axe,bark,beyond,branche,broad-deltate,c.,cell,characteristically,covering,curved,dark,deltate,development,difoliate,discolorous,distance,divided,eaf,eed,elongating,equal,exserted,extending,filament,fine,finely,finger-hair,flat,flattened,flower,fruiting,geminat,gently,glabrescent,herbaceous,infructescence,irregula,irregular,lengthening,less,long,long-ovoi,long-styled,longer,longitudinal,lower,mature,midpoint,minute,mostly,narrow-deltate,nflorescence,oblique,obtuse,often,older,one,open,opening,orange-translucent,orolla,oung,outline,pair,pale,papillo,pendulous,per,perfect,pericarp,persisting,pit,point,pore,poricidal,porrect,portion,prickle,primary,pronounced,pubescent,rachi,raised,reduced,rest,ri,ridge,ridged,ruit,scar,sessile,shallow,short-styled,shorter,shortly,side,sinus,slit,small,somewhat,spaced,sparse,spherical,spreading,stalk,stalked,straight,straw-yellow,stump,subsessile,tamen,terete,terminal,tertiary,thick,throughout,time,tip,toward,translucent,trichome,ud,unarmed,unbranched,unequal,unit,usually,variously,vary,vein,venation,visible,weakly,wide,widest,woody,yellow-orange,ympodial	adhesion,arrangement,colour,form,growth,height,inflorescence,number,ovary,papillose,plant,position,presence,present,pubescence,rugulose,seed,shape,size,staman,stipe,texture
619	wfo-0001030452	success	199	114	83	116	31	0.417	0.2–0.3,0.4,1.5–3,10–15,1–4,2.5–3,20–30,2–2.5,3.7–5.2,4,5,5–6,5–7,80,abaxially,acuminate,acute,adaxially,anther,apex,attenuate,base,black,blade,broadly,calyx,cm,cordate,diameter,drying,dull,flower,free,fruit,glabrous,glandular-puberulent,globose,hair,half,immature,leaf,less,lobe,long,margin,mature,minutely,mm,nearly,opposite,orbicular,ovate,pedicel,petiole,pilose,proximal,pubescence,ray,reddish,shape,shrub,similar,simple,sinuate,size,slightly,smooth,somewhat,stellate,stem,stigma,style,subopposite,surface,thin-textured,tip,truncate,tube,white,x,yellow,yellowish,–9	.5–4.5,.6,0.1–0.4,0.6,0.7,0.8,1.2,1.2–1.6,100,1–1.3,1–2,1–3-celled,2,2.5–4,2.5–6,2–4,2–5.5,2–foliate,3,4–5-rayed,6–12,8–11,911,absent,accrescent,also,apparently,appressed,axe,broad,canthophora,capitat,central,collected,contiguou,counted,curved,cylindrical,deflexed,dense,developing,directed,distall,eaf,eed,eglandular,enlarged,enlarging,f,filament,flattened,fruiting,fully,geminat,glabrou,gland-tipped,gland–tipped,gradually,herter,hig,hyaline,imple,initially,internode,larger,lon,longer,lower,major,matur,maturity,moderately,narrowly,nflorescence,numerous,often,one,orolla,per,pore,prickle,probably,pubescent,rachi,reflexed,ruit,sec,sessile,short,small,sof,sometimes,sparse,sprawling,spreading,ste,stellae,straight,strongly,sulcate,tamen,tem,terete,thin–textured,toward,triangular,ultimately,uniform,unit,usual,various,vary,vein,wide,wing,ympodial	2.5–4.5,adhesion,arrangement,capitate,climate,colour,corolla,form,glandular,growth,height,history,inflorescence,length,life,midpoint,na,number,ovary,peduncle,perennial,plant,position,presence,present,reproduction,rugulose,seed,staman,stipe,texture
620	wfo-0001030453	success	127	91	55	72	36	0.433	.5,/4,0.25-0.5,0.8-1.5,1-1.3,1-1.5,1.5-1.6,1.5-2.5,3-3.5,4-5,9-14,abaxially,acuminate,acute,adaxially,anther,apex,arachnoid,arachnoid-pubescent,attenuate,base,calyx,clavate,cm,corolla,dark,divided,elliptic,glabrous,leaf,lobe,long,margin,mm,narrowly,occasionally,opposite,ovary,pedicel,petiole,poricidal,pubescent,shiny,shrub,sparsely,stem,stigma,style,surface,tip,trichome,tube,way,white,wide	.25,9-12,along,anthesi,axi,bark,broadly,closely,cup-shaped,deflexed,delicate,deltate,dendritic,densely,dia,eaf,edicel,eed,ellipsoid,especially,exserted,filament,fine,flat,floccose,free,glabrate,know,known,later,lateral,less,lon,lower,main,middle,midrib,minute,minutely,near,nearly,nflorescence,older,overlappin,pair,papillat,papillose,planar,pore,portion,reddish,reddish-brow,rounded,ruit,scar,shaped,simple,slender,soon,spaced,straight,strongly,tall,tear-drop,tub,ud,unifoliat,unit,vein,widest,ympodial,young	adhesion,arrangement,blade,climate,colour,diameter,form,fruit,glandular,growth,hair,height,history,inflorescence,length,life,midpoint,na,number,peduncle,plant,position,presence,pubescence,ray,reddish-brown,reproduction,rugulose,seed,shape,size,staman,stellate,stipe,texture,unifoliate
621	wfo-0001030486	success	141	100	66	75	34	0.468	1-1.5,1-5,1.1-1.4,1.5-2,1.7-2,10-14.5,2-3,3-3.5,3/4,4-4.5,4-6.5,4.5-5,6-7,acute,anther,apex,base,brown,calyx,clavate,cm,completely,conical,corolla,dark,dia,dry,drying,elliptic,fleshy,fresh,glabrous,globose,green,internodal,leaf,lobe,lobed,margin,material,minutely,mm,opposite,ovary,ovoid-reniform,papillose,pedicel,petiole,pitted,poricidal,shrub,size,slightly,small,stem,stigma,style,surface,tan,tip,treelet,tube,way,white,x,yellow-green	.5,0.8-2.2,1/2,1/4,10-12,2-5.5,3-5,5-8-flowered,abaxially,adaxially,anthesi,ba,bark,basal,beneath,berry,closely,clustered,deflexed,deltate,differing,difoliate,distal,eaf,edicel,eed,ellipsoid,erect,exserted,f,filament,free,fruiting,geminat,inflorescenc,later,lateral,lon,long,lower,m.,main,major,middle,minor,nflorescence,older,overlapping,pair,pale,papillo,planar,pore,portion,reddish,ruit,scar,shaped,shin,simple,spaced,stout,tall,tapering,tear-drop,thickened,tub,ud,unit,usually,vein,widest,woody,ympodial,young	adhesion,arrangement,blade,climate,colour,diameter,form,fruit,glandular,growth,hair,height,history,inflorescence,length,life,midpoint,na,number,peduncle,perennial,plant,position,presence,pubescence,ray,reproduction,rugulose,seed,shape,staman,stellate,stipe,texture
622	wfo-0001030489	success	196	133	99	97	34	0.505	0.25-0.4,0.5-3,0.6-0.9,0.75-0.9,0.9-1.1,1-1.3,1-3,1.1-1.3,1.2-1.6,1.7-2,1.75-2,1.9-2.6,12-24,2.1-2.9,3-8,4-8,5,6-8,7-15,abaxially,abruptly,adaxially,anther,apart,apex,appressed-pubescent,articulated,attenuate,base,becoming,blade,blunt-tipped,broadly,brown,calyx,chartaceous,closely,cm,conical,corolla,deltoid,densely,diameter,echinoid,elliptic,entire,fleshy,fruit,glabrate,greenish,growth,hair,high,honeycombed,inserted,lateral,leaf,length,lobe,long-acuminate,margin,minutely,mm,multangulate,narrowly,oblong,ovate-lanceolate,pale,pedicel,peduncle,petiole,probably,pseudo-terminal,pubescent,pulverulent,reniform,reticulate-punctate,ripe,short,shrub,simple,small,somewhat,spaced,stellate-pubescent,stellate-rotate,stem,stigma,style,subglobose,suborbicular,tomentose,toward,tree,tube,white,x,yellow,yellowish	-6.5,.5-2.8,.5-3,.75-5.25,1-3.75,1.2-1.5,1.6-2.1,1/3-1/2,1/5-1/2,100,3-6,4.5-9,5-6,absen,acuminate,acute,adaxiall,ag,anthesi,apical-lateral,apparently,appressed,axe,axillary,ba,bark,berry,branch,branched,bud,cinereous,continued,cylindrical,dehiscing,dichotomously,due,eaf,echinoi,eed,elongate,filament,flower,free,glabrous,globose,introrse,large,lobed,long,long-exserted,longitudinal,lower,main,midvein,minute,mostly,nflorescence,obtuse,older,orolla,ovate,perfect,plurifoliate,pore,porrect-stellate,puberulent,pulverulen,rachi,ruit,runk,sessile,several,short-stalked,side,slender,slit,smooth,sparingly,sparse,subcampanulate,subcapitat,tamen,terete,testa,thick,time,turn,unarme,unarmed,unit,usually,vary,vein,way,wide,ympodial,young	2.5-2.8,5-6.5,adhesion,arrangement,climate,colour,form,glandular,height,history,inflorescence,life,midpoint,na,number,ovary,perennial,plant,position,presence,pubescence,ray,reproduction,rugulose,seed,shape,size,staman,stellate,stipe,subcapitate,surface,texture,ye
623	wfo-0001030492	success	221	120	95	126	25	0.43	.5,0.1-0.5,0.25-0.5,1-1.5,1.5-2,1.5-6,10-35+,15-20,2,2-3,2-4,2-5,3-10,3-8,4,4-6,4-8,5-30+,5-7,9-11,?,abaxially,acute,adaxially,anther,apart,apex,articulated,base,blade,brown,calyx,chartaceous,cm,coarsely,connivent,densely,diameter,elliptic,entire,extra-axillary,ferruginous-pubescent,flattened,flower,fruit,fully,glabrous,glandular,glandular-puberulent,globose,green,hair,leaf,light,lobe,margin,maturity,mm,moderately,near,ovate,pedicel,peduncle,perhaps,petiole,pinnatifid,plant,pubescent,ray,ripe,sessile,shape,short-stalked,shrub,simple,size,small,spaced,sparsely,stellate,stellate-pubescent,stem,stigma,style,subcordate,surface,tapered,toothed,tree,truncate,tube,white,x,yellow,yellowish	-2,.1,0.1-1,0.3-0.5,0.5-1,1,1-8,1.5,10,10-50+,12-25,2-2.5,25-50+,3-5,3-7,30-40+,4-7,5-6,7-18,accrescent,adaxiall,also,apparently,armed,axe,ba,branched,broad-based,capitat,caudate-acuminate,coarse,covering,cylindrical,deeply,difoliate,directed,distall,divided,eaf,eed,eglandular,emerging,erect,female-sterile,ferruginous,filament,first,forked,frui,fruiting,geminat,gland,halfway,held,interpetalar,juvenile,lanceolate,larger,later,lateral,less,like,lobed,lon,long,longer,lower,lowering,major,midpoint,midrib,midvein,minutely,mostly,much,narrow,nearly,nflorescence,oblique,occasionally,often,orolla,pair,part,perfect,pitted,pore,prickle,rachi,rectangular,recurved,ruit,rusty,scattered,short,shorter,similar,sinus,slightly,sometimes,somewhat,sparse,splitting,sprout,stalk,ste,stellae,straight,tal,tamen,time,tip,tissue,unarmed,unbranched,uniform,unit,upper,uprigh,vary,vein,wide,woody,ympodial,younger,youngest	adhesion,arrangement,capitate,colour,corolla,form,growth,height,history,inflorescence,length,life,na,number,ovary,position,presence,present,pubescence,reproduction,rugulose,seed,staman,stipe,texture
624	wfo-0001030509	success	220	109	81	139	28	0.368	0-5,0.1-0.3,0.3-2.5,0.8-1.2,1-1.5,1-2,1-4,1.3-2,2-2.5,2-4.2,2-4.5,2-6,2.8-3,2/3-3/4,4.5-12,4.5-8,7-9,8-16,abaxially,andromonoecious,anther,apex,base,berry,blade,calyx,chartaceous,cm,connivent,cordate,cuneate,densely,diameter,entire,equal,flattened-reniform,fruit,herb,lateral,leaf,length,lobe,lobed,long,margin,maturity,mauve,mm,moderately,obtuse,orange,orange-brown,ovate,pale,pedicel,peduncle,petiole,plant,poricidal,purple,ray,rounded,shrub,simple,smooth,sometimes,sparsely,spherical,stellate,stellate-pubescent,stem,style,surface,tapering,terminal,tip,tube,way,weakly,wide,yellow	-10,-2,-6,/3,0,0-0.3,0-100,0-15,0-3,0.1,0.1-0.2,0.1-0.25,0.2,0.5-1.5,0.6-1,0.8-4,1,1-3,1-6,1.5-2,1.7-2,1/,1/3-2/3,1/4,2-3,3-10,3-4,4.5-10,5-10,5-merous,7-15,alyx,apar,apart,apical,apically,apparently,articulated,bark,becoming,broad-deltate,brow,cream,curved,dark,difoliate,discolorous,distal,distance,drying,eaf,eed,elongating,erect,extending,eye,filament,flower,free,fruiting,geminat,glabrescent,glabrous,gland,globular,gray,green,half,herbaceous,hermaphrodite,heterostylous,inflated,infructescence,long-acuminat,long-styled,longer,lower,lowermost,marking,mature,midpoint,midvein,naked,narrow-deltate,narrow-oblong,nflorescence,occasional,occasionally,often,older,one,open,orolla,oung,pair,pendulous,per,pericarp,perpendicular,porrect,portion,prickle,prickly,primary,reduced,ruit,scar,short-styled,shorte,shorter,side,slender,spaced,spreading,stalk,stalked,staminat,straight,subsessile,tamen,terete,tertiary,time,trichome,unarme,unarmed,unbranched,unit,upper,usually,variously,vary,vein,venation,visible,woody,yellow-green,ympodial,young	adhesion,arrangement,colour,corolla,form,glandular,growth,hair,height,history,inflorescence,life,na,number,ovary,perennial,position,presence,present,pubescence,reproduction,seed,shape,size,staman,stigma,stipe,texture
625	wfo-0001030511	success	166	109	79	87	30	0.476	-6,.5,0.1-0.15,0.4-0.5,0.5,0.5-0.6,0.5-1,0.8-1,1.5,1.5-4,4-7,5-9,abaxially,adaxially,anther,apex,attenuate,base,bright,calyx,cm,conical,corolla,densely,diameter,entire,flattened,glabrous,globose,growth,inflorescence,internodal,lanceolate,leaf,less,linear,lobe,lobed,margin,membranous,midpoint,minute,minutely,mm,nearly,ovary,pale,pedicel,peduncle,petiole,plant,poricidal,porrect,pubescent,ray,red,reniform,ripe,rounded,sessile,shiny,shrub,simple,sparsely,stellate,stem,stigma,style,surface,tan,tapering,thin,tip,trichome,tube,violet,white,x,yellowish	0.1,1,1-2,4-8,4-merous,5-7,6-8,?,absent,acicular,almost,along,also,anthesi,arising,articulated,barely,bark,berry,brow,cell,closely,curved,deeply,deltate,difoliate,eaf,eed,either,ellipsoid,erect,especially,exserted,filament,filiform,flower,free,fruiting,geminat,leave,lengthening,like,long,lower,midrib,midvein,new,nflorescence,noddin,nodding,older,overlappin,pair,papillo,per,perfect,pericarp,pitted,planar,pore,portion,prickle,prickly,primary,rarely,rest,ruit,scar,short-stalked,sinuate,sometimes,spaced,strongly,tall,testal,toward,triangular,ud,unit,upper,vein,visible,woody,yellow,ympodial,½,¾	adhesion,arrangement,blade,climate,colour,form,fruit,glandular,hair,height,hermaphroditic,history,length,life,na,number,papillose,perennial,position,presence,pubescence,reproduction,rugulose,seed,shape,size,staman,stipe,texture,ye
626	wfo-0001030516	invalid_json	172	93	64	108	29	0.372	0.4-1.5,1-7,1.5-2,1.8-2.4,2-3,3-8,4-22,4-6,4-7,6-15,8-9,9-22,abaxially,adaxially,calyx,cm,connate,corolla,covered,darker,densely,diameter,distal,elliptical,forked,generally,gland,globose,green,green-white,hair,half,herbaceous,leaf,light,long,mm,odd-pinnate,outline,ovate,ovoid,pedicel,peduncle,pentagonal,perennial,petiole,pilose,plant,puberulent,pubescent,rotate,seed,short-stalked,size,slightly,sometimes,spreading,stigma,stripe,style,throughout,triangular,wide,yellow	1-2.5,1-4,1.1-3.5,1.1-4.1,1.7,2-12,2-2.,2-4,3-6,3-6-foliat,3-9.8,4-4,4.2-10.7,9-32,acumen,acuminate,acute,apex,apical,apically,articulate,base,branched,cell,cordate,covering,cuneate,cyme,decurrent,dehiscent,dichasial,dichasially,digestion,diminished,dorsally,eaf,ebracteate,edge,eed,emoval,enzyme,exceeding,filament,first,flat,flower,folded,globo,gradually,hair-like,honeycomb,interjected,introrse,lateral,leaflet,less,living,lobe,lon,long-attenuate,longer,lower,lunat,make,maturing,monochasial,mucilaginous,nflorescence,nther,oblique,often,orolla,pair,pattern,perfect,plan,poricidally,proximal,rarely,reveal,ruit,second,sessile,seudostipule,short,short-petiolate,slit,specimen,stamen,straight,tal,tem,terminal,testal,thick,time,toward,triangulat,tuber-bearing,type,typically,unit,vary,wall,whit,ympodial,¼,’	'','type,[,],``,anther,arrangement,characteristic,colour,form,fruit,growth,height,history,inflorescence,length,life,na,ovary,position,pubescence,reproduction,shape,stem,texture,value,white,{,}
627	wfo-0001030522	success	192	106	82	110	24	0.427	-4,-8,0.3-0.7,0.5-0.6,1-1.4,1-1.5,1.7-3,2-lobed,2.5-6,3,3-4.5,3-5,4,4-9,7-10,abaxially,absent,acute,adaxially,anther,apex,base,berry,brown,calyx,cm,completely,cordate,corolla,densely,diameter,dioecious,elliptic,entire,flattened,fleshy,fruit,glabrous,globose,green,growth,inflorescence,internodal,leaf,lobe,lobed,margin,membranous,midpoint,minutely,mm,obtuse,orange,ovary,ovate,pedicel,petiole,pitted,plant,poricidal,porrect,pubescence,pubescent,ray,reddish,reniform,ripening,sessile,shrub,small,stellate,stem,stigma,style,surface,tip,treelet,trichome,tube,vestigial,white,x	.2,.5,.7,/4,0,0.05-0.15,0.3-0.4,0.5,0.5-1,0.7,0.9-1.3,1,1-5-2,1.5,2,2.5-2.8,20-30,3-4,4-10,5-10,6-7,almost,also,anthesi,apart,armed,articulated,ba,bark,bearing,broad-based,brow,cell,conical,consisting,cup-shaped,dark,darker,dense,diamete,difoliate,directed,eaf,eed,ellipsoid,erect,female,filament,flower,free,fruiting,geminat,impressed,included,irregularly,juvenile,lamina,le,less,like,lon,long,lower,male,mature,minute,mixture,new,nflorescence,notably,oblique,obscured,occasionally,often,orbicular,pair,per,pericarp,pistillate,planar,pollen-bearing,pore,portion,prickle,primary,rounded,ruit,scar,shallowly,short-stalked,single,somewhat,sparsely,sparser,staminate,straight,testal,thin,toward,ud,unarmed,unisexual,unit,upper,upwardly,usually,vein,way,woody,ynpodial	adhesion,arrangement,blade,climate,colour,form,glandular,hair,height,length,na,number,peduncle,position,presence,present,reproduction,rugulose,seed,shape,size,staman,stipe,texture
628	wfo-0001030551	success	167	107	76	91	31	0.455	-12,-30,0.5-1,0.6-1.5,1-,1-2,1-2.5,1-3.5,1-4,1-5,1.5-2.5,10-20,2-6,2.5-5,20-25,3-12,3-8,4-5,abaxially,acuminate,acute,adaxially,also,apart,apex,articulated,base,blue,calyx,campanulate,chartaceous,cm,concave,cordate,densely,diameter,entire,fading,fruit,glabrous,glandular-puberulent,globose,lanceolate,leaving,lobe,long,margin,mm,moderately,oblong-fusiform,often,ovate,ovate-elliptic,papillose,pedicel,pedicellar,peduncle,petiole,pilose,puberulent,pubescent-pilose,radiu,remnant,shrub,simple,spaced,sparsely,stellate,stigma,style,subcoriaceous,truncate,unknown,violet,x,yellowish	-5,0-2,1,1-10,1.5-,10-40,13.,2,2-3,2.5-4,3-,3-5,4-,4-7,4-foliat,5-17,5-6,9-20,abruptly,absent,adpressed,aggregate,ape,axe,basal,beyond,bilobe,blade,broad,cell,clavate,color,connective,dia,dilated,directed,distally,eaf,ed,ellipsoidal,equal,et,exceeding,exserted,fleshy,flower,hair,laterally,lon,lower,martinelli,narrow,narrowed,narrowly,nflorescence,nther,obtuse,orolla,ovoid,perfect,pore,puberulen,puberulent-pubescent,pubescent-pilo,rachi,ripe,round,ruit,seen,shorter,slightly,small,stamen,stone,tal,tem,thecae,time,tip,tomento,triangular,triangular-elliptic,tube,ud,unbranched,unit,unknow,vary,wide,widening,ympodial	3-7,4-6,anther,arrangement,bilobed,colour,corolla,form,glandular,growth,height,history,inflorescence,leaf,length,life,na,ovary,perennial,pilosity,plant,position,pubescence,reproduction,rugulose,seed,shape,size,stem,surface,texture
629	wfo-0001030570	success	173	97	68	105	29	0.393	0.3-0.5,1-3,1-4,1-8,10-25,2-3,2-5,2-8,2.5-22,3-10,3-5,3-6,3.5-5,4-25,4-5,4-7,abaxially,acuminate,acute,adaxially,apex,base,calyx,campanulate,cm,cordate,cylindrical,diameter,ellipsoidal,elliptic-oblong,entire,flattened,forked,fruit,glabrous,glandular-puberulent,globose,green,lanceolate,leaf,lobe,lobed,margin,mm,ovate,pedicel,peduncle,petiole,pilose,pinnately,purplish,rarely,rounded,simple,sparsely,stellate,stigma,style,subcoriaceous,tree,truncate,tube,unbranched,unknown,vein,white,x,yellow	-1,.3-0.5,0-,0.5-,0.5-1,1,1-,1-1.5,1-2,1-5,1.5,1.5-2.5,1/2,10-17,15-20,15-35,2-2.5,2-4,2-7,2-7-lobed,20-30,4-foliat,4/5,5-,8-,absent,aggregate,apart,ape,apiculate,articulated,axe,basal,beyond,blade,cell,color,connective,connivent,dilated,directed,distally,divided,eaf,eed,eglandular,exceeding,exserted,fleshy,flower,glabrat,hair,leaving,lon,long,lower,midrib,narrowly,near,nflorescence,nther,obtuse,occasionally,often,orolla,ovoid,pedicellar,perfect,pilo,pore,presen,pubescent,punctate,purpl,rachi,radiu,remnant,ripe,rugose,ruit,shorter,sinus,slightly,small,sometimes,somewhat,spaced,stamen,stone,submarginally,tal,tem,thecae,time,tip,tomento,triangular,truncat,ud,unequal,unit,unlobed,vary,wide,ympodial	abaxial,anther,arrangement,colour,corolla,form,growth,height,hermaphroditic,history,inflorescence,length,life,na,ovary,perennial,plant,position,presence,present,pubescence,reproduction,rugulose,seed,shape,size,stem,surface,texture
630	wfo-0001030580	success	230	102	54	176	48	0.235	2,abaxially,acute,adaxially,adnate,anther,apex,attenuate,base,black,blade,brown,bud,calyx,chartaceous,cm,corolla,densely,diameter,elliptic,entire,extra-axillary,ferruginous,flattened-orbicular,flattened-reniform,fruit,glabrous,globose,hair,lateral,leaf,lobe,margin,mm,moderately,ovate,pedicel,petiole,pubescent,ray,rounded,scattered,shrub,simple,sparsely,stellate,stem,stigma,straight,style,surface,tube,white,yellow	.0,.0–6.2,.2,.3,.5,.7,/2,/3,0.2–0.3,0.3–0.4,0.3–0.7,0.4–0.5,0.4–0.7,0.6–1.1,0.6–2.1,0.7–0.8,0.9–1.2,1.2–1.5,1.3–1.5,1.3–3.0,1.5–,1.5–2.0,1.5–4.0,1.5–9.0,1.6–1.8,1.6–2.5,1.7–1.8,1/3,1–2,2.0–2.2,2.0–3.1,2.3–5.5,3,3.7–5.4,3–5,4–6,4–8,5-merou,5–5.4,6–8,8.3–10.0,ag,along,alyx,anthesi,apical,apparently,appearing,appresse,arching,area,around,articulate,attachment,ba,becoming,berry,broad,brochidodromous,capitat,caudate,central,channeled,connivent,curved,deltoid,dentate,developed,difoliate,directed,distal,distally,distinct,dramatically,dry,eaf,edge,eed,either,emerging,endocarp,erect,exocarp,extending,fertile,filament,filiform,flat,flexed,flower,free,geminat,glabrescent,glossy,gradually,homostylous,increasing,indistinct,inter-sepalar,internode,interpetalar,intersepalar,juic,laying,lon,long,longer,lower,mainly,many,mature,middle,midpoint,midrib,midvein,minute,much,nearly,nflorescence,notched,oblong,orolla,per,perforate,persistent,pitted,point,pore,porrect,portion,potentially,probably,raised,ruit,sepal,sessile,side,sinus,slightly,smoot,smooth,sometimes,splitting,spread,stamen,stellae,stellate-pubescent,strongly,suture,tamen,tardily,tem,thin,though,time,tip,tissue,toward,translucent,truncate,typically,ud,unarmed,unit,vary,vein,weakly,well,wide,ympodial,young,±90°,±aequilateral,×,–2.5,–8	0.2-0.3,0.3,0.3-0.4,0.3-0.7,0.4-0.7,1.0,1.3-3.0,1.5-2.0,1.5-4.0,1.5-9.0,1.6-1.8,2.0,2.0-2.2,2.3-5.5,3.7-5.4,4-6,4-8,7.0,8,adhesion,age,arrangement,capitate,colour,form,growth,height,history,inflorescence,length,life,na,number,ovary,peduncle,perennial,plant,position,presence,present,pubescence,reproduction,rugulose,seed,shape,size,staman,texture
631	wfo-0001030581	success	187	129	99	88	30	0.529	.3,1-4-celled,abaxial,abaxially,acute,adaxial,adaxially,aggregate,along,angle,angled,anther,apex,appressed,basal,base,berry,black,bright,calyx,capitate,cell,central,clustered,cm,conical,corolla,densely,denser,diameter,ellipsoid,elliptic,entire,filament,flattened-reniform,fruit,glabrous,globose,green,growth,herb,inflorescence,intermodal,lacking,lateral,leaf,less,like,live,lobe,long,margin,markedly,maturity,minutely,mm,near,occasionally,often,outline,ovary,ovate,pedicel,peduncle,pentagonal,petiole,pitted,plant,portion,pubescent,purplish,ridge,ripe,shallow,shiny,simple,somewhat,sparsely,stellate,stem,stigma,stone,style,surface,tangled,terete,testal,third,translucent,trichome,tube,turning,uniseriate,upper,vein,white,wide,yellow,yellowish	.5,0.2–0.8,0.4–0.6,0.4–1.6,0.5,0.5–0.7,0.5–2.5,0.6–0.7,0.7–0.8,0.9–1,1,1.2–1.5,1.8–8,1–2,1–2-celled,1–2.5,1–4-celled,2,20–50,2–3-celled,35–45,3–4,3–5,4.5–12,4–7,4–9,5-merous,5–6,5–8,9,anthesi,apar,articulated,becoming,beyond,branched,cone,decurrent,difoliate,drop,eaf,eed,exserted,florescence,flower,free,fruiting,geminat,halfway,individual,later,leave,lobed,lon,lower,minute,narrowly,new,once-branched,pair,papillate,per,perfect,primary,rachi,reflexe,reflexed,remaining,rounded,ruit,scar,shorter,slightly,spaced,sprawlin,spreading,straight,strongly,tall,tem,ud,unit,usually,winged,woody,ympodial,–15,–5	0.4-1.6,0.5-2.5,0.6-0.7,0.9-1,1-2-celled,1-2.5,1.2-1.5,1.8-8,15,20-50,3-4,4-9,4.5-12,5,5-6,colour,form,height,history,length,life,na,perennial,position,pubescence,reproduction,seed,shape,size,texture
632	wfo-0001030582	success	190	97	50	140	47	0.263	.5,1.5,acute,anther,apex,attenuate,base,blade,blue,brown,cm,cordate,diameter,entire,flattened-reniform,free,fruit,glabrous,globose,lateral,leaf,light,linear-attenuate,lobe,margin,mm,moderately,obscurely,orange,ovate-lanceolate,pedicel,peduncle,petiole,red,rounded,shrub,simple,sinuate,stellate-pentagonal,stellate-tomentose,stem,stigma,style,surface,terminal,thick-chartaceous,tomentose,tube,yellow,×	.1,0,0.1,0.2,0.4,0.4–0.5,0.4–1,0.6,0.8–1,1.4–2,1.5–3,10,10–12,12,1–1.5,2.5–3,2–10-branched,2–2.5,2–4.5,3.5–9.5,3–3.2,3–3.5,3–5,4–4.5,4–9-rayed,5,5-merou,5–8,6–8-rayed,7–11,7–20,abaxially,adaxiall,adaxially,age,alyx,apart,apparently,articulated,axe,ba,becoming,branch,branched,broad,c.,capitat,caudate,closely,dark,densely,dichotomously,directed,distall,eaf,eed,ellipsoid,evenly,except,extra-axillary,filament,filiform,finely,flower,geminat,glabrescent,gland-tipped,hair,homostylous,initially,internode,interpetalar,larger,later,lea,less,lighter-colored,like,lon,long,lower,maturit,midpoint,midzone,minute,minutely,narrowly,nearly,nflorescence,numerous,often,orolla,overtopped,ovoid,part,per,perfect,pitted,plurifoliate,pore,principal,probably,ripe,ruit,sessile,shiny,short,short-stipitate,side,sinus,slender,somewhat,soon,spaced,sparsely,splitting,stellae,stellate-tomento,stipe,tall,taller,tamen,tardily,tem,tip,tissue,triangular,truncate,ud,ultimate,unarme,unarmed,underside,vary,vein,visible,well-developed,wide,ympodia,young	0.4-0.5,0.4-1,0.8-1,1-1.5,1.4-2,10-12,2-2.5,2-4.5,3-3.2,3-3.5,3.5-9.5,4-4.5,4-9,6-8,7-11,7-20,adhesion,arrangement,calyx,capitate,colour,corolla,form,growth,height,history,inflorescence,length,life,na,number,ovary,perennial,plant,position,presence,pubescence,ray,reproduction,rugulose,seed,shape,size,staman,stellate,texture,ye
633	wfo-0001030583	success	166	115	83	83	32	0.5	.5,0.1-0.5,0.2-1,0.3-1,0.7-4.5,1,1-1.5,1-2,1.5-4,1/2,2.5,2.5-3,2.5-9,3-4,3/4,5-6,abaxial,abaxially,acute,adaxially,anther,apex,base,calyx,cm,corolla,crisped,cultivar,dark,deep,dendritic,densely,elliptic,flattened-reniform,form,fruit,glabrous,globose,golden,green,immature,incrassate,irregular,leaf,live,lobe,lobed,long,margin,minutely,mm,narrowly,opposite,orange-red,ovary,pale,papery,papillose,pedicel,petiole,pitted,plant,pubescent,ripe,rounded,shaped,shrub,size,small-capitate,stem,stigma,style,surface,tan,tear-drop,thin,tip,trichome,tube,way,white,x,yellow	.2,0.4-2.7,0.5-1,0.8-1,0.9-3.5,1-8,4-6,5-7,6-7,along,anthesi,ba,bark,berry,brow,cell,closely,conical,corky,cultivated,deflexed,dia,differing,difoliate,dry,eaf,edicel,eed,ellipsoid,enlarged,erect,especially,filament,flower,free,frui,fruiting,geminat,included,lateral,leave,like,lon,long-rectangular,long-triangular,lower,main,major,midvein,minor,nflorescence,occasionally,often,older,outline,overlapping,pair,papillo,pericarp,planar,pore,poricidal,portion,prostrate,rest,ruit,scar,simple,small,soon,spaced,spathulate,specimen,stout,tall,testal,ud,uniseriate,unit,vein,woody,ympodial,young	adhesion,arrangement,blade,brown,climate,colour,diameter,glandular,growth,hair,height,history,inflorescence,length,life,midpoint,na,number,peduncle,perennial,position,presence,pubescence,ray,reproduction,rugulose,seed,shape,staman,stellate,stipe,texture
634	wfo-0001030605	success	144	118	83	61	35	0.576	.4,.5,0.3-0.5,1,1-4,1.5-2,1.5-5.5,1.7,2,2-3,2.5,5-12.5,7,acute,adaxially,almost,along,anther,apex,area,attenuate,base,brown,calyx,cm,commonly,coriaceous,corolla,dark,dendritic-echinoid,dia,difoliate,dry,glabrate,glabrous,globose,green,growth,inflorescence,internodal,leaf,less,lobe,lobed,margin,material,minutely,mm,nearly,obovate,obtuse,occasionally,opposite,ovary,ovoid-reniform,pedicel,peduncle,petiole,pore,poricidal,pubescent,revolute,rounded,scattered,shaped,shiny,shrub,slightly,smooth,sparsely,stigma,style,surface,tear-drop,thickened,tip,trichome,tube,unifoliate,vein,way,white,x	0.1,1/3-1/2,12-19-flowered,abaxially,anthesi,apart,ape,apical,beginning,beneath,berry,branch,branched,cinereous,conical,covered,cylindrical,deflexed,densely,drying,eaf,edicel,eed,ellipsoid,entire,exerted,filament,free,fruiting,geminat,gold,inflorescenc,light,long,lower,midrib,new,nflorescence,olive,otherwise,ovate,overlapping,papillate,papillosefruit,pitted,portion,rarely,reflexed,scar,simple,slender,somewhat,soon,sparesly,tinged,tub,ud,unit,woody,yellow,ympodial	adhesion,arrangement,blade,climate,colour,diameter,form,fruit,geminate,glandular,hair,height,history,length,life,midpoint,na,number,papillose,perennial,plant,position,presence,pubescence,ray,reproduction,rugulose,seed,shape,size,staman,stellate,stem,stipe,texture
635	wfo-0001030611	success	217	113	88	129	25	0.406	-35,0,0-0.5,0.1-0.3,0.5,0.5-1.5,0.5-2.5,0.7-1.5,1.5-10,1.5-2,1.5-3,1/4-1/3,2,2-3.5,2-4,2-6,2-7,2.2-2.5,3.5-5.5,4-5,4-8,5-8,7-25,9-30,abaxially,adaxially,anther,blade,blunt-tipped,broadly,calyx,cm,connate,densely,development,diameter,elliptic,elongated,erect,felty-pubescent,flower,fruit,glabrous,globose,hair,inflorescence,lacking,leaf-opposed,length,lenticular,lobe,minutely,mm,oblong-tapering,orange,outline,ovate,pedicel,peduncle,perennial,petiole,pitted,present,pubescent,ray,resembling,ripe,sessile,slightly,spreading,spreading-hirsute,stellae,stellate,stellate-pubescent,stigma,style,suffrutescent,surface,tan,thin-textured,truncate,tube,usually,white,whitish,x,yellow,yellow-orange	-1.3,1,1-2,1-3,12-10,12-15,15,1mm,2-foliate,3,3-4,3-5,4-6,5-10,5-15,6-9,abaxiall,acicular,acute,adaxiall,along,apart,apex,appearing,articulated,attenuate,axe,ba,basally,base,branched,campanulate,capitat,cauline,coarsely,commonly,composed,connivent,crowded,cylindrical,deltoid,dentate,depressed-deltoid,directed,distal,distally,divergently,eaf,eed,elongate,entire,equaling,exceeding,female-sterile,filament,finally,flesh,free,geminat,glabrou,glandula,hermaphroditic,inserted,interlaced,interlobal,intermixed,larger,lateral,less,light,lon,long,long-stalked,longer,longest,lower,main,margin,midpoint,midrib,midvein,much,nflorescence,numerous,obtuse,often,one,orolla,ovate-lanceolate,part,per,pore,predominantly,prickle,principal,prominent,rachi,radiu,reduced,round-tipped,ruit,section,short,short-stalked,short-styled,side,simple,sinus,small,sometimes,somewhat,spaced,stalk,ste,stellate-woolly,stipitate,tal,tamen,tem,termination,time,unarmed,unbranched,unit,vary,vein,wide,widely,ympodial	adhesion,capitate,colour,corolla,form,growth,height,history,leaf,life,na,number,ovary,plant,position,presence,pubescence,reproduction,rugulose,seed,shape,size,staman,stem,texture
636	wfo-0001030624	success	170	104	71	99	33	0.418	.5,0.9-1,1-3,1.2-1.8,1.2-2,1.5-2,2-10,2.5-5.5,3-3.5,3.5-4,6-13,acute,anther,anthesi,apex,apiculate,attenuate,axil,base,calyx,clavate,cm,corolla,dia,dry,elliptic,falcate,flattened-reniform,glabrate,glabrous,glandular,globose,green,greyish,lateral,leaf,like,lobe,lobed,long,main,margin,material,minutely,mm,narrowly,nearly,opposite,ovary,pedicel,petiole,pitted,planar,puberulent,shrub,size,small,soon,square,stem,stigma,style,surface,tree,tube,vein,white,x,yellowish,yellowish-green,young	.25,0.5,0.5-1,0.5-1.5,2,2-3,25-40-flowered,3,4.5-8,7-9,apart,appearing,ba,bark,beginning,berry,branch,caly,cell,decurrent,deflexed,differing,difoliate,dimorphic,distal,eaf,edicel,eed,ellipsoid,end,erect,except,expanded,exserted,extreme,filament,free,fruiting,furcate,geminat,hyaline,incrassate,inflorescenc,large,later,lon,longitudinally,lower,major,middle,midrib,minor,near,nflorescence,occasionally,older,one,outer,pair,pale,papillose,pore,poricidal,portion,prominent,raised,remaining,round,rugo,ruit,scar,shining,short,simple,slender,slightly,somewhat,spaced,straight,tall,tapering,thickened,three,ti,tip,trichome,trunk,tuft,two,ud,unevenly,uniseriate,unit,wall,widest,woody,yellow,yellowish-grey,ympodial	adhesion,arrangement,blade,climate,colour,diameter,form,fruit,growth,hair,height,history,inflorescence,length,life,midpoint,na,number,peduncle,perennial,plant,position,presence,pubescence,ray,reproduction,rugulose,seed,shape,staman,stellate,stipe,texture
637	wfo-0001030628	success	229	137	98	131	39	0.428	.1,.5,1,4,abaxial,adaxial,adaxially,age,andromonoecious,anther,apart,articulated,base,becoming,branched,brown,calyx,capitate,chartaceous,cm,congested,connivent,dark,densely,diameter,ellipsoidal,elliptical,extra-axillary,flattened,flower,fruit,glabrous,glandular,green,hair,hermaphroditic,inclusion,inflorescence,interpetalar,juicy,lanceolate,leaf,length,light,like,lobe,maturity,mm,moderate,moderately,multangulate,multangulate-stellate,ovary,ovate,pedicel,peduncle,pericarp,petiole,plant,porrect-stellate,pubescent,purple,reddish,reddish-tan,reniform,rotate-stellate,sclerified,sessile,similar,simple,slightly,spaced,sparsely,stalked,stellate,stem,stigma,strongly,style,surface,tapered,thick,tissue,tree,tube,turbinate,unequal,violet,whitish-,whitish-golden,yellow,yellowish-green,young,×,–30,–5,–50,–9	.2,.5–1.7,0.1–0.3,0.5–3,0.7–0.9,10+,10–20,10–40,10–55,11–16,12–20,16–18,1–1.5,1–10,1–2,2.5–8,20–35,2–10,2–3,3.5–4,3.5–5,4–4.4,4–6,4–6.5,4–8,5-merous,5–,5–6,5–8.5,6–10,6–8,7–25,7–40,8–1,8–25,abaxially,acuminate,acute,along,alyx,andromoneciou,anthesi,apex,axe,ba,bark,berry,bilobe,blade,broad-based,broadly,central,cordate,curved,cylindrical,db,difoliate,directed,discolorous,distally,dried,eaf,eed,eglandular,either,entire,filament,fissure,flowering,free,fresh,frui,fruiting,functionally,geminat,half,heterstylous,inflated,knobby,lobed,long,longitudinal,lower,major,margin,maturit,membranaceous,midpoint,midvein,multiseriate,near,nearly,nflorescence,oblique,often,one,opening,orolla,part,point,pore,portion,prickle,rachi,ratio,ray,remaining,rounded,rugose,ruit,runk,shallow,shallowly,sharp,side,slit,stalk,staminate,stellate-pubescent,stout,straight,subtending,tamen,thin,unarmed,unit,vary,vein,width,woody,ympodial	1-2,10-20,10-40,10-55,11-16,16-18,2-10,2-3,3.5-4,4-6.5,5-6,5-8.5,6-10,7-25,7-40,8-25,adhesion,arrangement,bilobed,colour,corolla,dbh,form,growth,height,history,life,na,perennial,position,pubescence,reproduction,rugulose,seed,shape,size,staman,texture,true
638	wfo-0001030638	success	177	70	51	126	19	0.288	0.5-1.5,0.7-1.5,1-1.2,1-2,1.4-1.7,1.5-2,1.6-2.2,2-5,3-10,3-13,4-6,8,8-9,anther,calyx,cm,corolla,dia,elliptic,fruit,glabrous,glandular,globose,green,inflorescence,leaf,lobed,minutely,mm,obovate,opposite,ovary,pale,papillose,pedicel,petiole,poricidal,red,red-glandular,seed,shape,shrub,size,stem,stigma,style,surface,tip,tree,white,x	0.1,0.5,0.5-0.7,0.5-1,0.5-2,1-1.5,2-3,2-7-flowered,2.5-4,8-11,acute,along,anthesi,apex,apically,appear,appearing,axi,axil,ba,bark,base,beginning,beneath,berry,blade,branched,broadly,bud,closely,conspicuously,corky,cucullate,cup-shaped,deflexed,deltoid,densely,differing,difoliate,dry,eaf,eed,entire,erect,exfoliating,extending,filament,flattened,fleshy,free,fruiting,geminat,geminate,glabrate,gre,impressed,irregular,known,lamina,large,later,lateral,less,like,lobe,lon,long,lower,main,major,margin,material,middle,minor,near,nearly,nflorescence,occasionally,often,older,one,open,overlapping,ovoi,pair,paler,papillae,papillo,persistent,planar,pore,portion,present,prominent,rather,reddish,rest,roundish,rugose,ruit,scar,shaped,simple,soon,spaced,speciman,straight,tall,tapering,tear-drop,terminal,thick,thickened,thickening,transversely,trichome,tube,uniseriate,unit,usually,vein,wall,widest,woody,ympodial,young	alternate,arrangement,colour,diameter,form,grey,growth,height,history,length,life,na,perennial,plant,position,pubescence,reproduction,rugulose,texture
639	wfo-0001030661	success	183	116	84	99	32	0.459	.5,0.5-0.6,0.5-0.75,0.5-2,0.7-0.8,1-,1-1.3,1-1.4,1.2-7,1.5-2,1.5-7,2-,2-2.5,3-20,3-3.5,4-15,5-5.5,acute,anther,apex,attenuate,base,brown,calyx,capitate,cm,conical,corolla,densely,diameter,ellipsoid,elliptic,entire,flattened,glabrous,globose,growth,inflorescence,lateral,leaf,lobe,lobed,margin,mature,membranous,minutely,mm,narrowly,occasionally,pale,pedicel,peduncle,perfect,petiole,pitted,pubescent,red,reddish,reniform,shiny,shrub,simple,small,sparsely,stellate,stem,stigma,style,surface,terminal,thin,tinged,tip,tree,trichome,tube,uniseriate,violet,way,white,x,yellowish,½,¾	-24,.2,0,1-.,1-1.2,1-1.5,12-16,3-4,4-6,5-10,5-merou,50-100+,ag,along,alyx,anthesi,ark,articulated,berry,branch,branched,brow,cell,clustered,connivent,dar,deltate,denser,drying,eaf,eed,em,erec,erect,exserted,extending,filament,flower,free,fruiting,glabrescent,glabrou,group,ilament,insertion,lamina,lengthening,lon,long,loosely,lower,many,midrib,minute,near,never,new,nflorescence,nodding,older,onto,orolla,otherwise,pair,papillo,per,pericarp,planar,platform,plurifoliat,point,pore,poricidal,portion,primary,rectangular,ruit,scar,scattered,sleeve,slender,slightly,slit,spreading,strongly,tangled,testal,time,twinin,ud,unit,upper,usually,vary,vein,winged,woody,yellow,ympodial	1-5,adhesion,arrangement,blade,climate,colour,form,fruit,glandular,hair,height,history,length,life,midpoint,na,number,ovary,perennial,plant,position,presence,pubescence,ray,reproduction,rugulose,seed,shape,size,staman,stipe,texture
640	wfo-0001030665	success	191	120	88	103	32	0.461	-5,-7,0.2-0.4,0.2-0.6,0.4-0.6,0.5-1,0.5-2,0.7-1,0.8-1.1,1-2,1.1-2.8,1.5-2.5,1.5-3,1.6-4.5,2.5-3.5,3-3.8,3-5,5-8,absent,acute,adaxially,anther,apex,base,blade,brown,calyx,campanulate,chartaceous,cm,cordate,deeply,deflexed,depressed-globose,depression,diameter,ellipoidal,elliptical,extra-axillary,finally,flower,flushed,fruit,glabrous,gland-tipped,globose,greenish,grey,hair,herbaceous,inflorescence,leaf-opposed,length,light,lilac,lobe,lobed,long,margin,minutely,mm,obtuse,ovate,pale,papery,pedicel,peduncle,petiole,present,prostrate,puberulent,purple,resprouter,reticulate,rotate,short,simple,sparsely,sprawling,stigma,style,surface,thick,throughout,tube,vein,x,yellow	%,0.5-11,1-17,1-4,1.4-1.7,1.5-2,10-200,2-16,2-3,2-5,2-6,2-8,2.3-10,2.5-9,20-30,3-10,4-5,5-merou,6-8,abaxially,absen,abundant,accrescent,acicular,adaxiall,adult,alyx,appearance,appessed,armed,articulated,axe,ba,branche,broad,broad-based,capitat,cut,cylindrical,decimetre,deltate,directed,distall,dr.,eaf,eed,filament,finger,folded,fruiting,geminat,give,green,grey-green,half,homostylous,index,interpetalar,inward,lamina,lateral,less,lobing,lon,longer,lower,mature,mesocarp,midvein,minute,nflorescence,oblique,orolla,part,per,perfect,pore,prickle,rachi,rather,reflexed,rounded,ruit,scarcely,side,sinus,stage,stellate-campanulate,straight,tal,tamen,tem,thin,time,tissue,unbranched,unifoliate,unit,uvenile,vary,wide,ympodial,¾	adhesion,arrangement,capitate,climate,colour,corolla,form,glandular,growth,height,history,leaf,life,midpoint,na,number,ovary,plant,position,presence,pubescence,ray,reproduction,rugulose,seed,shape,size,staman,stellate,stem,stipe,texture
641	wfo-0001030676	success	220	128	98	122	30	0.445	-1.6,-3.9,0.4,0.6-1.2,1,1.1-1.4,1.1-1.9,1.2-1.3,1.3-1.5,1.7-2,14-17,16,19-35,2.1-2.6,2.2-5.7,2.75-3.25,3-5,3-6,4-6,4-6.5,7-8,8-10,8-12,abaxially,adaxially,anther,anthesi,apex,appressed-tomentose,base,berry,blade,blunt-tipped,brown,calyx,cm,conical,corolla,deltoid,densely,diameter,entire,exserted,finely,fleshy,fruit,glabrescent,glabrous,granular-tomentose,green,greenish,growth,hair,honeycombed,initially,inserted,leaf,length,lobe,margin,minutely,mm,moderately,nearly,oblique,oblong,oblong-elliptic,pedicel,peduncle,petiole,probably,pseudo-terminal,ray,reniform,reticulate-punctate,ripe,scabrous,scattered,short-attenuate,shrub,simple,small,stellate,stellate-pubescent,stem,stigma,strongly,style,suborbicular,tomentose,tree,tube,velutinous,white,whitish,x,yellow,yellowish	-2.5,-8.5,/10-1/5,0-100,1-1.2,1-3,1/4,11-14,2.1-2.3,2.4-3.1,2.5-5.5,3-3.5,7-10,7-9,abruptly,acute,along,angled,apart,apical-lateral,apparently,appearing,articulated,axillary,ba,bark,becoming,branch,branched,bud,chartaceous,closely,continued,crown,cylindrical,dehiscing,dichotomously,due,eaf,echinoi,echinoid,eed,elongate,except,filament,flat-topped,flower,forming,free,glabrescen,globose,grooved,high,horizontal,introrse,lackin,lamina,large,lateral,lengthen,lined,lobed,long,longitudinal,longitudinally,lower,main,midvei,midvein,minute,mostly,multangulate,nflorescence,obtuse,occasional,often,older,opening,openly,orolla,ovate,ovate-lanceolate,parallel,perfect,plurifoliate,pore,pubescent,pulverulent,rachi,rather,ridged,ruit,runk,sessile,short-stalked,side,slit,somewhat,spaced,sparsely,spreading,subcampanulate,subcapitat,subglobose,tamen,tending,terete,testa,thick,thin,time,tip,tuft,unarme,unit,usually,vary,vein,way,wide,ympodial,young	adhesion,arrangement,climate,colour,form,glandular,height,history,inflorescence,life,midpoint,na,number,ovary,perennial,plant,position,presence,present,pubescence,reproduction,rugulose,seed,shape,size,staman,stipe,subcapitate,surface,texture
642	wfo-0001030686	success	182	116	89	93	27	0.489	.2,.5,1-1.1,1-1.2,1-1.5,1.2-1.5,1.5-4.5,1.6-3,15,2-2.5,2-3,2-6.5,2.5-4,2.5-8,3-3.5,5-12,5-25,5-6,abaxially,abruptly,acuminate,acute,anther,apex,base,berry,bifid,brittle,brown,c.,calyx,cm,conical,corolla,cup-shaped,dark,deeply,densely,diameter,dry,elliptic,entire,flattened,form,fruit,globose,height,internodal,leaf,leaf-opposed,lepidote,lilac,lobe,lobed,long,margin,maturity,mm,orange,ovary,pale,pedicel,peduncle,petiole,pitted,plant,poricidal,pubescent,purple,seed,shallowly,shiny,short,simple,sparsely,spreading,stellate,stem,stigma,style,surface,thin,tip,tree,tube,uniformly,way,x,yellow	.5-1,0.5-1,1-2,1.5-2,1972,5-30,8-9,?,aborted,adam,adaxially,age,anthesi,apart,bark,basal,beneath,black,branched,breast,bu,centre,closely,darker,denser,different,difoliate,discolorous,drying,eaf,edicel,eed,empty,erect,exerted,fide,filament,flower,fragrant,free,fruiting,geminat,glabrescen,glabrous,golden,half,heteromorphic,lamina,lengthening,less,lower,many,midrib,midvein,minutely,nflorescence,noddin,oblique,older,overlapping,pair,paler,papillae,papillose,pericarp,planar,pore,portion,primary,pubescen,rachi,ruit,scar,scarious,shallow,slightly,slit,somewhat,space,spaced,strongly,styl,time,tissue,trichome,ud,unit,usually,vein,visible,woody,ympodial,–	adhesion,arrangement,blade,climate,colour,glandular,growth,hair,history,inflorescence,length,life,midpoint,na,number,perennial,position,presence,pubescence,ray,reproduction,rugulose,shape,size,staman,stipe,texture
643	wfo-0001030696	success	202	99	72	130	27	0.356	.5,0.1-0.3,0.4-0.6,0.8-1.2,0.8-1.3,0.8-1.7,0.8-1.8,1-2.5,1-4,1.5-2,1.5-3,2-5.5,3-4,3-6,3.8-4,4-4.5,4-7,acute,andromonoecious,anther,apex,base,blade,brown,calyx,chartaceous,cm,cuneate,cylindrical,deeply,densely,diameter,elliptical,extra-axillary,fruit,glabrous,gland-tipped,globose,green,hair,herbaceous,inflorescence,lanceolate,length,lobe,lobed,long,margin,midpoint,mm,obtuse,ovate,pale,pedicel,peduncle,petiole,plant,present,prostrate,ray,resprouter,short,simple,sparsely,sprawling,stellate,stellate-pubescent,style,tube,white,x,yellow	%,0-0.1,0-3,0.05-0.2,0.1-0.4,0.2-1,0.3-1.1,0.5-3,0.7-1,0.7-1.1,0.8-1.5,0.9-1.5,1,1-1.5,1-3,1-9,1.6-2.2,10-16,10-50,12-18,2-3-foliate,2-4,2-8,2-locular,2.3-4,2.5-6,20-35,4-17,4-8,5-merou,7-10,8-18,abaxially,absen,absent,accrescent,acicular,across,adaxiall,adaxially,adult,alyx,apart,armed,articulated,ascending,axe,ba,branche,contiguous,cross-section,decimetre,deltate,directed,distall,distally,distributed,eaf,eed,eglandular,exocarp,filament,finger,flower,frui,fruiting,functional,geminate,half,heterostylous,index,juicy,lamina,lateral,less,lobing,longer,lower,markedly,mature,mesocarp,mid-point,midvein,minute,moderately,moist,nearly,nflorescence,oblique,onl,orolla,part,per,placenta,pore,porrect,prickle,probably,pseudo-umbellate,rachi,ruit,semi-circula,sessile,side,solitary,spaced,sparse,stage,stalk,stellae,straight,strongly,tal,tamen,tem,thick,thicker,thicknes,throughout,time,unbranched,unit,usuallu,uvenile,vary,vein,wide,winged,yellowish,ympodial	adhesion,arrangement,climate,colour,corolla,form,glandular,growth,height,history,leaf,life,na,number,ovary,position,presence,pubescence,reproduction,seed,shape,size,staman,stem,stigma,stipe,texture
644	wfo-0001030699	success	195	129	101	94	28	0.518	-13,-8.5,0.5-0.7,1-1.5,1-2,12-15,2-3,2-4,2.5-3,3-10,3-5,4-5,4-6,4-7,5-6,6-,8-10,9-11,acute,anther,antrorse,apex,apical,base,berry,blue,brown,calyx,clavate,cm,cordate,corolla,corymbose,cyme,diameter,elongate,entire,flower,glandular,glandular-lanate,globose,green,greenish,grey,growth,heterostylous,hirsute,inflorescence,juvenile,lanate,length,like,lobe,lobed,lobed-angulate,long,long-styled,margin,middle,midpoint,mixed,mm,multicellular,nearly,ovary,ovate,ovate-elliptic,ovate-lanceolate,pedicel,peduncle,petiole,plant,poricidal,porrect,prickle,pubescence,purple,ray,rusty,sessile,short-styled,shrub,simple,stalked,stellate,stem,stigma,style,subcoriaceous,subrounded,surface,tapering,tip,tomentose-lanate,trichome,tube,velutinous,winged,x,yellow,¼	0,0.2-0.3,1.4-1,1.5-2,1/10,1/6,11-12,2-2.5,2-5,3-6,4-6-celled,5,abaxially,adaxially,anthesi,apart,apically,armed,articulated,bark,basal,branched,brow,cell,compressed,curved,decurrent,densely,discolorous,distal,eaf,eed,erect,exserted,filament,foliaceous,free,fruiting,glabrous,golden,half,immersed,induman,known,lengthening,linear-lanceolate,lower,many,minute,multangulate,new,nflorescence,older,onto,ovoid,papillat,partially,perfect,pericarp,plurifoliat,pore,portion,prickly,pubescent,rarely,red,reduced,reflexed,rotate,ruit,scar,single,slightly,slit,spaced,sparsely,staminate,stellate-puberulent,straight,subscabrous,subscandent,subsessile,tall,time,ud,unevenly,unit,upper,vein,villous,without,wood,yellowish,ympodial	adhesion,arrangement,blade,climate,colour,dense,form,fruit,hair,height,history,leaf,life,na,number,papillate,perennial,position,presence,present,reproduction,rugulose,seed,shape,size,staman,stipe,texture
645	wfo-0001030709	success	217	106	78	139	28	0.359	-9,0.1-0.2,0.15-0.5,0.7-1,1-1.2,1-1.6,1-4.5,1.3-1.4,1.6-2.1,1.9-2.8,1/4,2-6,2.3-3,5-20,5-6,6-21,6-7,6-8,7-8,8-11,acuminate,acute,anther,apex,base,berry,blade,calyx,chartaceous,cm,connivent,cordate,diameter,dull,elliptic,erect,flattened-reniform,fruit,inflorescence,lateral,leaf,length,lobe,lobed,long,margin,maturity,mauve,midpoint,mm,moderately,orange-brown,pedicel,peduncle,petiole,poricidal,purple,ray,seed,shrub,simple,size,smooth,sparsely,spherical,stellate,stellate-pubescent,stem,style,surface,tapering,terminal,tip,truncate,tube,upper,wide,yellow	-2,-5,0,0-,0-20,0-30,0.2-0.5,0.3-1.5,0.4,0.8-4,0.9-1.5,1-6,1.4-2,1/2-2/3,1/3-1/2,1/4-1/3,10-14,10-50,2-4,2-5,2-8,2/3-3/4,3-,4-5-merous,5-10,5-7,5-9,6-10,7-9,8-15,abaxially,adaxially,almost,alyx,ame,apar,apart,ape,apically,apparently,articulated,bark,branched,bright,broad-deltate,brow,c.,conical,cuspidate,deltate,discolorous,distance,drying,eaf,edge,eed,elongating,equal,extending,filament,finely,flower,free,fruiting,glabrescent,glabrous,increasing,infructescence,lanceolate,lengt,lobing,lon,long-acuminat,longer,lower,mature,middle,midvein,narrow-deltate,nflorescence,occasionally,often,older,one,open,orolla,oung,pair,pendulous,per,perfect,pericarp,perpendicular,pit,pitted,plurifoliat,porrect,portion,prickl,prickle,prickly,primary,red-green,red-orange,reflexed,retrorse,rounded,ruit,scar,secondary,short-styled,shorter,side,slender,sometimes,spaced,spreading,stalk,stalked,straight,tamen,terete,tertiary,time,toward,trichome,unarmed,unit,usually,variously,vary,vein,venation,visible,way,weakly,woody,yellow-green,ympodial	adhesion,arrangement,climate,colour,corolla,form,glandular,growth,hair,height,history,life,na,number,ovary,perennial,plant,position,presence,pubescence,reproduction,rugulose,shape,staman,stigma,stipe,texture,ye
646	wfo-0001030714	success	178	125	111	67	14	0.624	-3,.2,/3,0.1-0.3,0.5,0.5-0.8,0.5-1.9,0.7-0.8,1-1.2,1-1.3,1-2.5,1.2-1.5,1.2-4,1.4-3.5,1/3,2-2.5,2-2.6,3-3.5,3-7,7-17,abaxial,acuminate,acute,adaxially,age,along,anther,apex,articulating,bark,basal,base,becoming,beneath,berry,blue,blue-black,clavate,cm,conical,cordate,corolla,dark,densely,denser,diameter,ellipsoid,elliptic,entire,especially,except,flattened,fruit,glabrous,globose,greyish,growth,herbaceous,leaving,lengthening,liana,lobed,long,margin,membranous,midrib,minute,minutely,mm,narrowly,new,node,ob-ellipsoid,ob-elliptic,oblique,ovary,overall,pale,papillate,pedicel,peduncle,peg,petiole,pitted,pore,poricidal,pubescent,reniform,ripe,scar,shape,simple,slightly,slit,sparsely,stellate,stem,stigma,style,surface,tip,trichome,truncate,uniseriate,vein,vine,violet,way,woody,x,yellow	.5,0.3-0.4,0.8-1,1-1.5,1.5-2,20,5-100,5-6,>,abaxially,aid,anthesi,apar,branching,calyx,campanulate,climbin,cup,eaf,eed,exserted,fide,filament,flower,free,grading,gradually,gree,howard,joined,leaf-opposed,like,lobe,lower,many,narrow,nflorescence,nodding,occasionally,older,pair,paler,papillat,pedice,per,perfect,planar,plurifoliat,portion,primary,prominent,quadrate,ruit,spaced,strongly,submarginal,tapering,terminal,thickened,time,tub,tube,twining,ud,unit,widely,ympodial	apart,arrangement,bud,colour,form,green,inflorescence,leaf,length,pubescence,seed,size,spacing,texture
647	wfo-0001030730	success	205	126	97	108	29	0.473	0-1,0.1-0.3,0.5-1,0.6-1.2,0.8-4.4,1-1.2,1-1.7,1.1-1.9,1.5-4.5,11-17,2-2.5,2-2.9,2-4,2.3-6,2.5-7,3-15,4-11,4-7,5.5-14.5,5.5-6.5,7-8,9-10.5,absent,acute,adaxially,anther,apex,articulated,base,blade,bony,calyx,chartaceous,cm,connivent,cuneate,densely,depressed,diameter,drooping,entire,extra-axillary,finally,first,flower,fruit,glabrous,globose,green,grey,hair,hard,herbaceous,inflorescence,lanceolate,later,length,light,lobe,lobed,long,loosely,marbled,margin,mid-point,mm,obtuse,ovate,pale,pedicel,peduncle,perennial,petiole,pink,present,purple,ray,resprouter,rhizomatous,rusty,shallowly,shrub,simple,spreading,stellate,stellate-pubescent,stigma,style,subcordate,surface,thick,toward,tube,x,yellow,yellow-brown,yellowish-green	%,0-0.8,0-1.2,0-1.6,0-6,0.05-0.1,0.05-0.2,0.5-0.9,0.7-1.2,0.8-1.2,1-10,1-3,1-8,1.7-2.3,10,11-20,15-60,2-5,2-8,2-foliate,240-700,3-20,4-locular,5-40,5-merou,9-15,abaxially,accrescent,acicular,across,adaxiall,alyx,apart,armed,ascending,attenuate,axe,ba,curved,cylindrical,d.,deltate,directed,distall,distributed,eaf,eed,eglandular,filament,finger,fruiting,geminate,glabrou,gland-tipped,half,lamina,lateral,less,lon,longer,lower,mature,midpoint,midvein,minute,minutely,nflorescence,oblique,orolla,part,per,perfect,pore,porrect,presen,prickle,probably,pseudo-racemose,rachi,ridged,rugose,ruit,short,slightly,smooth,spaced,sprawling,stage,stalk,stellae,straight,tal,tamen,tem,throughout,time,truncat,unarmed,unbranched,unit,unknow,uvenile,vary,vein,white,wide,yellowish,ympodial	adhesion,arrangement,colour,corolla,form,glandular,growth,height,history,leaf,life,na,number,ovary,plant,position,presence,pubescence,reproduction,rugulose,seed,shape,size,staman,stem,stipe,texture,truncate,unknown
648	wfo-0001030733	success	130	92	53	77	39	0.408	1-1.2,1-1.5,1-2,1.5-5,2-2.5,3-4,3-5,4-15,4.5-5,6-7,acuminate,acute,anther,apex,base,bi-lobed,brown,calyx,capitate,cm,coriaceous,corolla,dark,elliptic,glabrous,globose,green,leaf,lobe,lobed,margin,minutely,mm,narrowly,opposite,ovary,ovoid-reniform,pedicel,petiole,poricidal,shrub,smooth,somewhat,stem,stigma,style,surface,thick,tip,treelet,tube,white,x	.5,/4,0.5-1,1.7-2.7,5-8-flowered,6-9,?,abaxially,adaxially,along,anthesi,ape,bark,berry,broadly,clearly,closely,conical,decurrent,deltate,densely,denser,dia,eaf,eed,ellipsoid,elongate,embryo,erect,exserted,filament,free,fruiting,grayish-brow,lamina,later,lateral,like,lon,long,lower,main,middle,moderately,nflorescence,older,onto,overlappin,pair,papillo,planar,pore,portion,pubescent,rounded,ruit,scar,shaped,simple,spaced,sparsely,strongly,tall,tear-drop,testa,trichome,ud,unifoliat,uniseriate,unit,vein,visible,way,widest,woody,ympodial,young	adhesion,arrangement,blade,climate,colour,dense,diameter,form,fruit,glandular,grayish-brown,growth,hair,height,history,inflorescence,length,life,midpoint,moderate,na,number,peduncle,perennial,plant,position,presence,pubescence,ray,reproduction,rugulose,seed,shape,size,staman,stellate,stipe,texture,unifoliate
649	wfo-0001030751	success	226	113	88	138	25	0.389	-7,0,0-0.5,0.5-1mm,1,1-2,1-3,11-40,13-50,14-20,2-3,2-3.5,2.5-4,3-5,3-6.5,5-15,5-8,7-13,7-15,abaxially,acute,adaxially,anther,apart,apex,attenuate,base,blade,branched,broadly,calyx,closely,cm,coarsely,cordate,densely,dentate,diameter,divergently,elliptic,erect,felty-pubescent,flower,form,fruit,globose,hair,inflorescence,lanceolate,leaf-opposed,length,lenticular,light,lobe,long,margin,minutely,mm,orange,ovate,pedicel,peduncle,perennial,petiole,pitted,present,pubescence,pubescent,ray,ripe,shallowly,simple,spaced,spreading-hirsute,stellate,stellate-pubescent,stem,stigma,style,surface,tan,thin-textured,truncate,tube,white,x,yellow,young	-5,.2,.5,0-1,0.1-0.3,0.1-0.4,0.5-1.5,0.6-1.5,1-24,1-4,1/4-1/2,10-15,2,2-foliate,20-25,3.5-4.5,4-6,5-6,5-7,6-9,8-13,accrescent,acute-,adaxiall,along,also,among,articulated,axe,ba,basally,broad,campanulate,capitat,cast,cauline,clas,commonly,completely,connivent,covering,cylindrical,deciduou,deltoid,depressed-deltoid,directed,distal,distall,distinct,divergent,dominant,eaf,eed,elongate,entire,equaling,especially,essentially,female-sterile,filament,finally,flesh,foliar,frui,fruiting,geminat,glabrous,green,inserted,interlobal,interwoven,larger,lateral,less,lignescent,like,longest,lower,major,midpoint,mixture,mostly,multiseriate,nflorescence,numerous,obtuse-tipped,occasionally,often,one,orolla,ovate-lanceolate,per,petaloid,pore,prickl,prickle,prickly,principal,prolonged,purplish,rachi,recurve,ruit,scattered,sessile,short,shorter,side,sinus,small,smaller,somewhat,sparsely,spreading,stalk,stalked,stellae,stellate-woolly,stipitate,straight,tal,tamen,tem,termination,tip,tooth-like,trichome,typically,unarmed,unbranched,unit,usually,variable,vary,vein,vivo,wide,ympodial	adhesion,arrangement,capitate,colour,corolla,glandular,growth,height,history,leaf,life,na,number,ovary,plant,position,presence,reproduction,rugulose,seed,shape,size,staman,stipe,texture
650	wfo-0001030772	success	155	86	53	102	33	0.342	-2,0.2-0.8,0.5-1,0.9-1,1-2,1-2.5,1.4-1.6,1.5-2,3-3.5,3-5,4.2-6.5,5-6,9-15,acuminate,anther,apex,attenuate,base,calyx,capitate,cm,corolla,elliptic,fruit,glabrous,globose,green,grey,leaf,lobe,lobed,margin,minutely,mm,opposite,ovary,ovoid-reniform,pale,pedicel,petiole,pitted,poricidal,shape,shrub,size,stem,stigma,style,surface,tan,tube,white,x	.05,.2,.25,.5,0.25-0.5,0.75-1,0.9-3.1,1.2-5,2-7,5-10-flowered,8-10,acute,anthesi,archin,ba,bark,becoming,beginning,beneath,berry,branch,bud,closely,dark,deflexed,dia,differing,difoliate,eaf,edicel,eed,ellipsoid,erect,extreme,filament,free,fruiting,geminat,gently,impressed,inflorescenc,large,later,lateral,lenticellate,lon,long,long-acuminate,long-triangular,lower,main,major,methyl,middle,minor,nearly,nflorescence,node,occasionally,older,one,overlapping,pair,paler,papillo,papillose,per,pore,portion,prominent,reflexed,ripe,rounded,ruit,salicylate,scar,shaped,shining,simple,slender,slightly,smelling,soon,spaced,straight,strongly,swollen,tall,tapering,tear-drop,tip,trichome,ud,uniseriate,unit,usually,vein,widest,wintergreen,woody,ympodial,young	0.5,adhesion,arrangement,blade,climate,colour,diameter,form,glandular,growth,hair,height,history,inflorescence,length,life,midpoint,na,number,peduncle,perennial,plant,position,presence,pubescence,ray,reproduction,rugulose,seed,staman,stellate,stipe,texture
651	wfo-0001030781	success	213	137	113	100	24	0.531	1-10,1-2,1-4,1.5-2,1.5-9,1.6-2.2,10-40,15-35,2-20,2.5-14,2.5-3.5,3-4,4-15,5-6,5-7,5-8,6-7,7.5-9,abaxially,adaxially,along,anther,apart,articulated,axillary,base,brown,brownish,bud,cell,chartaceous,ciliate,cm,condition,corolla,covering,deep,densely,diameter,distal,dot,drying,especially,finely,fresh,fruit,glabrous,glandular,globose,green,green-white,greenish,hair,hair-like,half,herb,high,lanceolate,lateral,leaf,light,like,lobe,long,make,margin,membranous,midrib,minutely,mm,mucilaginous,obovate,odd-pinnate,ovate,ovoid,pedicel,peduncle,pentagonal,pilose,plant,puberulent,pubescent,purple,rarely,rotate-pentagonal,scattered,seed,simple,size,small,sometimes,somewhat,spaced,sparsely,stem,stigma,style,subovoid,subtending,terminal,testal,thick,throughout,tip,tube,violet,wall,wet,white,whitish,wide,x,yellow	0-5,0.2-4,0.5-6,0.5-8,1-1.5,1-12,1-8,1.5-12,2-3,3-6,5-merou,abruptly,acumen,ag,alyx,apex,apiculate,apparently,axe,berry,blade,borne,broadly,caly,capitat,connivent,cuneate,dark,decreasing,decurrent,digestion,dorsally,eaf,edge,eed,elliptic,end,enzyme,erect,exceeding,filament,flat,flower,folded,forked,geminat,generally,glabrou,gradually,gray-green,homostylous,honeycomb-shaped,interjected,larger,leaflet,lengthening,living,low-growin,lower,narrowed,nflorescence,orbicular,orolla,ovate-lanceolate,pair,papillose,perfect,petiole,petiolulate,plurifoliate,pointed,pore,poricidal,rachi,removed,rounded,ruit,sessile,seudostipule,short,singly,slightly,slit,specimen,stamen,ste,stolo,straight,tall,tamen,tem,toward,tri-,tuber,typically,unit,unwinged,usually,vary,ympodial	adhesion,arrangement,calyx,capitate,colour,form,growth,height,history,inflorescence,length,life,na,ovary,perennial,position,pseudostipule,pubescence,reproduction,rugulose,shape,staman,surface,texture
652	wfo-0001030782	success	198	100	74	124	26	0.374	0.4-1.5,1-3,1.3-1.6,1.5-2,1.5-7.5,11-47,13-22,15,2,2.2-4,3-10,4-6,4.6-26,6-8,7-15.6,abaxially,adaxially,anther,axillary,brownish,bud,clavate,cm,condition,coriaceous,corolla,dark,deep,diameter,drying,elliptic,fresh,fruit,glabrescent,glabrous,globose,green,greenish,hair,herb,lanceolate,leaf,light,lilac,lobe,long,medium,mm,mottled,odd-pinnate,ovate,ovoid,pedicel,peduncle,pentagonal,petiole,plant,purple,ripe,rotate,scarce,seed,short,size,stigma,style,subtending,terminal,tube,white,whitish,wide,x,yellow	0-1,0-7,1-2,1-5,1-6,1.2-3.9,1.6-4.6,12-30,2-3,2.4-11.5,3-5,4-11.6,5-20,5-merou,abaxiall,acumen,acuminate,acute,ag,along,alyx,apart,apex,apparently,arranged,articulated,asymmetric,attenuate,axe,base,basiscopic,bead,berry,blade,broadly,capitat,cell,connivent,covering,cuneate,decreasing,digestion,distal,dorsally,eaf,edge,eed,enzyme,exceeding,filament,flat,flower,folded,forked,geminat,generally,glabrou,green-white,hair-like,hal,half,high,homostylous,honeycomb-shaped,inconspicuous,interjected,lateral,leaflet,lengthening,like,living,lower,make,moniliform,mucilaginous,multiple,necklace,nflorescence,orbicular,orolla,pair,perfect,petiolulate,plurifoliate,pore,poricidal,prominently,rachi,removed,rounded,ruit,second,sessile,seudostipule,side,slit,smaller,sometimes,spaced,specimen,stamen,stolon,straight,subequal,tal,tamen,tem,testal,thick,throughout,tip,tissue,totally,toward,tri-,tuber,typically,unit,usually,vary,wall,wet,winged,ympodial	abaxial,adaxial,adhesion,arrangement,calyx,capitate,colour,form,growth,height,history,inflorescence,length,life,na,ovary,perennial,position,pubescence,reproduction,rugulose,shape,staman,stem,surface,texture
653	wfo-0001030802	success	171	100	65	106	35	0.38	0.5-0.75,0.5-1,0.75-1,1,1-1.1,1-1.2,1-1.5,2-2.5,2-3,2-5,2.5-3,3-4,3-6,acuminate,acute,anther,apex,base,brown,calyx,cm,cordate,corolla,deeply,dia,difoliate,flattened-reniform,fruit,glabrous,glandular,globose,heart-shaped,internodal,leaf,length,lobe,lobed,margin,minutely,mm,ovary,ovoid,pale,papillate,pedicel,petiole,pitted,plant,poricidal,pubescent,red,shrub,somewhat,stem,stigma,style,subshrub,surface,tip,tube,unifoliate,white,x,yellow,yellowish	.3,.5,.5mm,0,0.25-0.4,0.5-1.5,0.7-1cm,0.9-1,3-3.5x,4-5mm,4-6,5-10-flowered,abaxially,abrupt,adaxially,along,anthesi,appearing,bark,basal,becoming,beginning,beneath,berry,bud,campanulate,cucullate,deflexed,densely,denser,dry,eaf,edicel,eed,ellipsoid,evenly,except,exerted,exudate,filament,filiform,free,fruiting,geminat,gland,glandurla,halfway,hanging,incrassate,inflorescenc,invest,irregularly,lamina,later,lateral,line,live,long,long-triangular,lower,m.,main,markedly,material,midvein,near,nflorescence,obconic,older,pair,palmate,papillose,per,persistently,pore,portion,prominent,pubescen,raised,reddish,ruit,scar,shaped,simple,single-celled,slender,soon,spaced,specimen,stigm,straight,strongly,tapering,tear-drop,tipped,trichoem,trichome,ud,uniseriate,unit,variable,vein,widely,woody,ympodial,young	0.7-1,3-3.5,4-5,adhesion,arrangement,blade,climate,colour,diameter,form,growth,hair,height,history,inflorescence,life,midpoint,na,number,peduncle,perennial,position,presence,present,pubescence,ray,reproduction,rugulose,seed,shape,size,staman,stellate,stipe,texture
654	wfo-0001030803	success	185	82	58	127	24	0.314	0.2,1.5-3,5,abaxially,adaxially,anthesi,armed,articulated,base,berry,brown,chartaceous,cm,diameter,elliptic,flattened-reniform,glabrous,globose,green,hair,imparipinnately,internode,leaf,leaflet,light,long,minute,minutely,mm,often,ovate,papillae,pedicel,peduncle,pericarp,petiole,pinnatifid,pitted,present,prickle,puberulent,rachi,ranging,rarely,recurved,rugose,shape,simple,size,slender,stem,stout,strongly,surface,terminal,variable,vine,×	.5,0.2–0.3,0.3,0.4,0.5,0.5–1.5,0.75–1,0.9–1.5,1,1-,1.5,1.5-,1/3,10967,10–15,1–2.5,1–3,2.5,20–40,2–,3-6,3–10,3–4,3–5,4–10,6–12,6–8,7–9,?,absent,acuminate,acute,adaxiall,adjacent,ag,almost,alyx,anther,apex,axe,basal,becoming,blade,branched,broadly,bud,calyx,campanulate,confluent,connecting,connivent,corolla,corresponding,dr.,eaf,eed,elongating,entire,equal,exserted,filament,flower,fruiting,hinton,lanceolate,lateral,lengthening,lobe,lobed,long-styled,lower,major,margin,middle,midri,midrib,narrowly,nflorescence,orolla,outline,petiolule,pinnate,plurifoliat,pointed,pore,poricidal,purple,recurve,rounded,ruit,sharply,side,slit,somewhat,spreading,stellate,stigma,straight,style,subwoody,swolle,tamen,tapering,time,tip,tissue,triangular,truncat,truncate,tube,turbinate,unit,usually,variously,vary,vein,wide,widest,wing,wood,woody,yellow,yellowish,ympodial,–10,–16,–5	0.2-0.3,0.5-1.5,1-2.5,1.5-6,10,10-15,16,2-10,3,3-10,3-5,6-12,colour,dry,form,fruit,growth,inflorescence,length,position,presence,pubescence,seed,texture
655	wfo-0001030809	success	154	105	68	86	37	0.442	0.2,0.5-1,1-1.5,1.2-1.4,1.4-1.5,1.5-3.5,4.5-5,6-8,8,9.9-12,acute,anther,apex,appearing,base,beneath,calyx,clavate,cm,corolla,dia,elliptic,falcate,fruit,glabrous,globose,golden,green,hair,lateral,leaf,like,lobe,lobed,long,long-papillose,main,midrib,mm,nearly,opposite,ovary,ovate,overtopping,pedicel,petiole,pubescent,scattered,shining,shoot,size,small,stem,stigma,style,terminal,tip,tomentose,tree,trichome,tube,underside,unequal,uniseriate,vein,white,x,yellow-brown	.5,1-1.25,1.5-2.4,2-2.5,2.3-5.5,20-60-flowered,5-8,across,along,also,anthesi,apar,bark,berry,branched,broadly,caly,campanulate,curl-tipped,curved,dark-papillo,deciduous,deflexed,deltoid,dense,densely,difoliate,distally,eaf,edicel,eed,ellipsoid,erect,especially,evenly,exserted,filament,free,fruiting,geminat,hidden,interpetalar,known,large,leave,lon,lower,major,markedly,mature,membranous,middle,minor,minutely,nflorescence,older,one,planar,pore,poricidal,portion,present,round,ruit,scar,several,shinin,simple,sinus,slender,slightly,soon,spaced,straight,tall,tapering,three,time,triangular,two,ud,unit,wide,widest,ympodial,young	0.5,2,adhesion,arrangement,blade,climate,colour,dark-papillose,diameter,form,glandular,growth,height,history,inflorescence,length,life,margin,midpoint,na,number,peduncle,perennial,plant,position,presence,pubescence,ray,reproduction,rugulose,seed,shape,staman,stellate,stipe,surface,texture
656	wfo-0001030810	success	191	104	57	134	47	0.298	abaxially,acute,adaxially,anther,apex,axillary,base,bipinnate,blade,blue,brown,calyx,clavate,cm,colour,dark,densely,diameter,elliptical,flattened,fleshy,fruit,glabrous,globose,green,hair,leaf,lobe,margin,mm,moderately,oblong,older,pale,pedicel,peduncle,pentagonal,petiole,pinnate,pitted,pubescent,rounded,shallowly,shrub,size,stem,stigma,style,subglabrous,surface,tomentose,tube,unknown,violet,woody,x,yellow	0.2,0.2–0.3,0.3,0.4,0.5–,0.5–0.8,0.6–1.0,0.7–1.4,0.8–5.5,0.95–2.0,0–,1,1.0–1.5,1.0–2.0,1.0–3.0,1.1–2.0,1.1–2.2,1.2–1.5,1.5–1.9,1–2,1–3,1–5,2.9–4.5,20–100,2–3,2–4,3.0–5.0,3.3–5.5,3.3–8.5,3.5–4.6,3–19,4–14,4–5,4–7,5,5–15,5–30,5–32,6–10,6–22,7–10,7–11,8–10,absen,accrescent,adaxiall,ag,along,anthesi,apart,articulated,axe,ba,borne,branched,cell,chartaceous,connivent,cylindrical,decreasing,denser,divided,eaf,eed,elliptic,equal,erect,especially,filament,flower,geminat,greyish,half,hig,indumentum,irregular,leafy,lon,long,longitudinal,lower,m.,midrib,midvein,multicellular,narrow,nflorescence,obtu,occasionally,opening,opposed,orolla,oung,pair,perfect,pinnae,plurifoliate,pore,poricidal,primary,rarely,reflexed,ruit,secondary,shaped,shiny,shoot,side,simple,slit,sometimes,spaced,sparsely,stone,straight,tamen,tardily,tear-drop,time,tip,unicellular,uniseriate,unit,vary,white,wide,wing,ympodial,–2.5,–3,–3.4,–4.5,–5.0,–8	0.8-5.5,1.0-2.0,1.0-3.0,1.1-2.2,1.2-1.5,1.5-1.9,2.9-4.5,20-100,3.3-5.5,3.3-8.5,3.5-4.6,4-14,4-7,5-32,7-10,8-10,adhesion,arrangement,climate,corolla,form,glandular,growth,height,history,inflorescence,length,life,midpoint,na,number,ovary,perennial,plant,position,presence,pubescence,ray,reproduction,rugulose,seed,shape,staman,stellate,stipe,texture,young
657	wfo-0001030814	success	223	131	103	120	28	0.462	.5,.5-3,0-0.3,0.1-0.2,0.4,0.5-1.5,1-4,1.5,1.8-3.5,10-12,15-20,16-30,2-3,23-31,3-5,4-5,5-15,5-9,5.5,6-15,6-9,7-11,7.5-11,abaxially,acute,adaxially,almost,anther,apex,apiculate,asymmetric,attenuate,base,blade,broadly,calyx,cm,coarsely,connivent,cultivated,densely,dentate,diameter,divided,elongating,extra-axillary,flower,form,fruit,glabrous,globose,hair,immature,inflorescence,lanceolate,length,lenticular,lignescent,lobe,long,margin,mature,midpoint,minutely,mm,narrower,obtuse,often,oval,ovate,ovoid,pedicel,peduncle,perennial,petiole,pitted,pubescence,pubescent,ray,ripe,sericeous,sessile,simple,simple-,somewhat,specimen,stellae,stellate,stellate-,stellate-pubescent,stem,stigma,style,swollen,tan,thin-textured,truncate,tube,unknown,weakly,white,x,yellow	-0.5,-1.5,-3.5,-4,0-0.2,0.1-0.3,0.3-0.6,1-2,1.5-2,1/8-1/3,10-25,14-15,15-16,2-foliate,3-7,4-,4-6,5,5-12,5-8,6-locular,absent,acute-tipped,adaxiall,along,apart,appressed,articulated,ascending,axe,ba,basal,become,becoming,branched,bulge,campanulate,capitat,capitate-glandular,cylindrical,depressed-deltoid,developed,diffusely,directly,distal,distall,divergently,eaf,eed,elongate,entire,essentially,felty,female-sterile,filament,geminat,glabrescent,hirsute,inserted,interlobal,intermixed,interwoven,invested,lateral,less,lon,lower,major,midvein,minute,much,nflorescence,obsolete,obtuse-tipped,orolla,oung,ovate-lanceolate,per,pericarp,pore,prominent,rachi,replaced,rip,rounded,ruit,scattered,short,short-stalked,shorter,side,similar,simple-haired,sinus,slightly,small,sometimes,soon,spaced,spreading,stalk,stellate-pubescen,strongly,tal,tamen,termination,time,trichome,unarme,unarmed,unbranched,uniseriate,unit,usually,vary,vein,weak,wide,ympodial,young	adhesion,arrangement,capitate,climate,colour,corolla,glandular,growth,height,history,leaf,life,na,number,ovary,plant,position,presence,present,reproduction,rugulose,seed,shape,size,staman,stipe,surface,texture
658	wfo-0001030822	success	146	85	52	94	33	0.356	0-0.5,0.5-1.5,0.8-1,0.9-1,1-1.5,1.5-2,11-15.5,2-2.5,2-5,3-3.5,3.5-7,5-6,acute,anther,apex,attenuate,base,calyx,clavate,cm,corolla,elliptic-obovate,flattened-reniform,glabrous,globose,green,inflorescence,internodal,leaf,lobe,lobed,margin,minutely,mm,ovary,pale,pedicel,petiole,pitted,poricidal,revolute,shrub,size,stem,stigma,style,surface,tan,tube,white,x,yellowish-brown	.2,0.1-0.2,0.4,0.4-1,1-1.2,2-3.8,3-5,5-7,8-9,abaxially,adaxially,anthesi,ba,beneath,berry,broadly,closely,clustered,completely,cucullat,cucullate,cup,decurrent,deflexed,deltate,dia,differing,difoliate,eaf,edicel,eed,erect,exserted,filament,filiform,fleshy,flower,free,fruiting,geminat,incrassate,inflorescenc,later,lateral,lon,long,long-ellipsoid,lower,main,major,middle,minor,minute,near,nearly,nflorescence,occasionally,older,onto,open,opposite,pair,papillo,papillose,perhaps,planar,pore,portion,present,red-papillose,ruit,scar,shaped,shiny,simple,slightly,somewhat,spaced,sparsely,strongly,tall,tapering,tear-drop,tip,ud,unit,usually,vein,widest,winged,woody,yellowish,ympodial,young	adhesion,arrangement,blade,climate,colour,diameter,form,fruit,glandular,growth,hair,height,history,length,life,midpoint,na,number,peduncle,perennial,plant,position,presence,pubescence,ray,reproduction,rugulose,seed,shape,staman,stellate,stipe,texture
659	wfo-0001030846	success	214	121	95	119	26	0.444	-0.8,-11,-4,0.1,0.2-0.4,0.5-0.7,1-2,1-2.5,1-3,1-4,1.5-2,10-15,2.5-3,3-,3-3.5,4-4.5,4-6,5-15,5-8,6-18,8-10,abaxially,acute,adult,angulate,anther,apex,assymetric,base,beige,berry,brown,calyx,chartaceous,clavate,cm,corolla,cuneate,dark-green,decurrent,diameter,elliptic,entire,flattened,flower,fruit,glandular,glandular-viscous,growth,heterostylous,hirsute,inflorescence,juvenile,leaf,like,lobe,lobed,margin,midpoint,mm,nearly,oblanceolate,obovate,opposite,ovary,ovate-elliptic,pedicel,peduncle,perfect,petiole,plant,poridical,pubescence,pubescent,ray,reddish,reniform,rhombic,rugose,rusty,scabrous,shrub,simple,slightly,stellate,stem,stigma,style,subglobose,surface,tip,tomentose,tube,white,x	.3,0.1-0.3,0.2-0.5,0.8-1,1-1.2,1-1.5,1-2-celled,1-multicellular,2-10,2-3,3/4,4-5,6-8,abaxial,acuminate,adaxially,anthesi,anthesisflower,antrorse,apart,apical,armed,articulating,bark,basal,branching,brownish,cream,curved,deciduous,densely,discolorous,distal,eaf,eed,erect,exserted,ferruginous,filament,free,fruiting,glabrescent,gland,golden,grey,lanceolate,larger,lateral,lengthening,linear,linear-lanceolate,long,long-styled,longer,lower,many,midrib,mixture,much-branched,multiangulate,multicellular,near,new,nflorescence,obliqu,oblong,obverse,ochraceous,older,oval,papillat,pendant,pericarp,persistent,plurifoliat,pore,porrect,portion,prickle,prickly,prominent,puberulent,rachi,raised,red,reflexed,relatively,rest,rotate,ruit,scar,sessile,short,short-styled,similar,slit,sometimes,sparsely,stalked,staminate,stipitate,straight,terete,testa,thick,time,tomentose-velutinous,trichome,ud,unarmed,undulate-reticulate,unit,upper,wide,without,yellowish,ympodial,young,¼	adhesion,arrangement,blade,climate,colour,form,hair,height,history,length,life,na,number,papillate,perennial,position,presence,present,reproduction,rugulose,seed,shape,size,staman,stipe,texture
660	wfo-0001030850	success	240	90	72	168	18	0.3	1-2.5,1/3,2-25,3-3.7,3-5,3.5-6,4,5-12,5-13,6-11,7-15,7-22,8.5-11.5,abaxial,abaxially,adaxial,anther,berry,bright,calyx,cell,chartaceous,climber,cm,connivent,densely,diameter,elliptic,equal,flattened-reniform,fruit,glabrescent,lateral,leaf,length,lobe,lobed,long,mauve,mm,moderately,orange,orange-brown,outline,ovate,pale,pedicel,peduncle,pit,plant,poricidal,purple,raised,red-brown,red-orange,scandent,shrub,simple,small,smooth,sparsely,spherical,stellate-pubescent,stem,surface,tapering,terminal,tip,tube,upper,wide,yellow	-6,.5,/4,0-,0-0.5,0-30,0-40,0.1-0.2,0.1-0.3,0.1-0.4,0.1-0.5,0.2,0.5-2,00,1-,1-10,1-2,1-20,1-3,1-4,1-5,1-8,1.2,1.5,1.5-2.5,1/2,1/2-1/5,1/2-3/4,1/3-3/,1/3-3/4,10-100,10-20,15-20,2-15,2-3,2-4,2-6,3-10,3-15,3-4,3-6,4-8,5-10,5-merous,6-8,8-20,acuminat,acuminate,acute,alyx,andromonoecious,apar,apart,apex,apically,apparently,articulated,bark,base,blade,branched,broad-deltate,broadly,brow,cordate,cream,cuneate,curved,dark,deltate,difoliate,discolorous,distal,distance,drying,eaf,eed,elongate,elongated,elongating,entire,erect,extending,filament,flattened,flower,free,fruiting,geminat,gently,glabrous,gray,green,green-brown,hermaphrodite,heterostylous,infructescence,lobing,long-styled,longer,lower,lowermost,margin,marking,mature,maturity,midpoint,midvein,nflorescence,oblong,obovate,obtuse,often,older,one,open,orolla,oung,pair,pendulous,per,pericarp,petiole,porrect,portion,prickl,prickle,prickly,primary,pubescent,ray,red-green,reduced,rounded,ruit,scar,secondary,sessile,short-styled,shorter,side,sometimes,somewhat,spaced,spreading,stalk,stalked,staminat,stellate,stout,straight,style,tamen,terete,tertiary,time,trichome,truncate,unit,variously,vary,vein,venation,visible,way,woody,ympodial,young	adhesion,arrangement,colour,corolla,form,growth,height,inflorescence,na,ovary,position,pubescence,rugulose,seed,shape,size,staman,texture
661	wfo-0001030867	success	259	131	112	147	19	0.432	-6,.25,.3,.5,0-,0.3,0.6,0.6-1.5,1,1-1.5,1-2,1-2.5,1.5-4.5,12-15,14,18,2.5-3,2.5-3.5,3-4,3-5,3.5-8.5,4-4.5,4-5,4-6,4.5-14,6-7,abaxially,acute,adaxially,anther,apex,attenuate,base,berry,calyx,chartaceous,cm,corolla,densely,diameter,elliptic,equal,expanded,flower,fruit,glabrous,globose,green,growth,herbaceous,immature,inflorescence,infructescence,internodal,lateral,leaf,leathery,length,lobe,lobed,long,long-styled,margin,mature,maturing,membranous,midpoint,mm,mottled,occasionally,opposite,ovary,ovoid,pale,pedicel,peduncle,pentagonal,per,petiole,plant,pubescent,ray,reniform,sessile,shallowly,short-stalked,short-styled,shrub,size,slightly,somewhat,sparsely,stellate,stellate-pubescent,stem,stigma,style,subshrub,tan,tapering,thick,tip,translucent,trichome,tube,usually,violet,white,whitish,x,yellow,yellowish	-1/3,0.5,1-5,1.5,1/4,10,100,2-2.5,2-3,2-5,2-6,4,5-25,5-6,5-merous,6,<,>,abundant,acumen,alyx,andromonoecious,anthesi,apart,approximately,area,armed,articulated,band,bark,bi-lobe,borne,branched,broad-based,brown,bud,cast,cell,concolorous,cup-shaped,curve,curved,dark,decurrent,denser,difoliate,directed,distal,distall,distance,dry,drying,eaf,easily,eed,either,ellipsoid,elongate,erect,exposed,exserted,filament,flowering,free,fruiting,functionally,geminate,glabrescen,greatest,greyish,halfway,hermaphroditic,heterostylous,interpetalar,lamina,larger,less,like,lon,longer,lower,lowermost,mal,markedly,maturit,midrib,midvein,narrowly,near,new,nflorescence,nodding,often,older,onto,orolla,outline,pair,pendent,pericarp,petal,planar,pore,poricidal,portion,prickle,prickly,primary,re,reflexed,rest,ruit,scar,shap,side,simple,sinuate,small,spaced,splitting,still,stouter,straight,strongly,surface,tall,tamen,testal,thickened,thinne,tissue,triangular,type,ud,unevenly,unit,upper,vary,varying,vein,visible,way,wide,winged,woody,ympodial,¼	adhesion,bi-lobed,blade,climate,colour,form,glandular,hair,height,na,number,position,presence,pubescence,seed,shape,staman,stipe,texture
662	wfo-0001030871	success	248	135	104	144	31	0.419	0.2-0.4,0.3-4,0.7-1.3,0.7-2.5,1-1.3,1-18,1.3-2,1.3-3,1.5-6,1.8-2.6,2-3,2-8,2.8-4.5,3-32,3-4.4,3.5-14,30,4.5-6.5,5-33,6-40,abaxially,abruptly,acuminate,acute,adaxially,anther,apex,attenuate,base,becoming,berry,blade,blunt-tipped,brown,calyx,chartaceous,cm,conical,continued,corolla,dark,deltoid,diameter,due,echinoid,entire,fleshy,fruit,glabrescent,granular-tomentose,green,greenish,growth,hair,honeycombed,inserted,lateral,leaf,length,lobe,long,margin,mixed,mm,mostly,multangulate,narrowly,oblong,orbicular,ovate,pale,pedicel,peduncle,petiole,present,probably,purple,ray,reniform,reticulate-punctate,ripe,rotate-stellate,scabridulous,sessile,short,short-stalked,shrub,simple,stellate-tomentose,stem,stigma,style,suborbicular,terminal,tomentose,tree,tube,velutinous,violet,white,x,yellow,yellowish,young	.2-3,.8-3.5,.9-1.2,/30-1/5,0-120,0.4-1.8,0.6-1.5,1.4-2.7,1.5-3,1.8-3.5,1/2,1/2-3/4,1/4,1/4-1/3,11,3-5,3-6,4.8-9.5,5-7,7-12,9-13,accrescent,adaxial,ag,along,anthesi,apart,apical-lateral,apparently,appressed,appressed-tomentose,articulated,axe,axillary,ba,bark,branch,branched,bud,campanulate,capitat,closely,decurrent,dehiscing,dendritic-echinoi,dendritic-echinoid,dendritic-multangulate,densely,directed,distal,eaf,earl,early,echinoi,eed,elliptic,elongate,equal,erect,evident,exserted,extend,filament,flower,free,fruiting,glabrescen,glabrous,grayish,held,high,introrse,large,lobed,long-,long-stalked,longer,longitudinal,lower,m.,main,midvein,minute,multangulat,nearly,nflorescence,nodding,obtuse,occasionally,often,older,open,orbicula,orolla,ovate-lanceolate,overlapping,partly,perfect,plait,plurifoliate,pore,porrect-stellate,prominent,pubescent,rachi,rather,reflexed,relatively,ruit,runk,short-,side,slit,small,sometimes,somewhat,soon,spaced,sparingly,sparsely,splitting,stamen,striate,strongly,subglobose,sulcate,suture,tamen,terete,testa,thick,thick-stalked,thin-stalked,time,toward,unarme,unarmed,unit,usually,vary,vein,way,wide,ympodial	adhesion,arrangement,capitate,climate,colour,form,glandular,height,hermaphroditic,history,inflorescence,life,midpoint,na,number,ovary,perennial,plant,position,presence,pubescence,reproduction,rugulose,seed,shape,size,staman,stellate,stipe,surface,texture
663	wfo-0001030872	success	166	78	55	111	23	0.331	.5,0.5-1,0.8-1,1-1.2,1-1.5,1.2-1.5,1.5-5,12-18,2-5,4-6,5.5-7,6-12.5,anther,area,base,black,brown,calyx,cm,corolla,dark,dia,elliptic,fleshy,glabrate,glabrous,globose,green,leaf,lobed,minutely,mm,nearly,opposite,ovary,ovate,papillose,pedicel,petiole,poricidal,puberulent,red-glandular-puberulent,reddish-glandular,shining,size,small,soon,stem,stigma,style,tip,tree,treelet,white,x	0.5,0.8-2,1-2,1.2-3,1.5-2,3-7,4-6-flowered,5-6,acuminate,acute,adaxial,age,along,anthesi,apex,appearing,bark,beginning,berry,broadly,caly,center,closed,closely,completely,consisting,corky,crateriform,cucullate,darker,deflexed,deltoid,densely,difoliate,dry,eaf,edicel,eed,ellipsoid-ovoid,erect,exserted,filament,free,fruiting,full,geminat,hooded,incurved,inflorescenc,known,large,lenticel,lenticellate,less,like,live,lobe,lon,long,lower,major,margin,material,middle,minor,nerve,nflorescence,oblique,older,one,overlapping,pair,pale,paler,petal,planar,pore,portion,primary,prominent,proximal,raised,rather,reddish-glandular-puberulent,relative,rest,ridge,rounded,ruit,scar,shaped,shorter,side,simple,slightly,spaced,specimen,straight,strongly,styl,tall,tapering,tear-drop,thickened,tube,ud,unit,widest,woody,ympodial,young	arrangement,colour,diameter,form,fruit,growth,height,history,inflorescence,length,life,na,peduncle,perennial,plant,position,pubescence,reproduction,rugulose,seed,shape,surface,texture
664	wfo-0001030877	success	223	121	97	126	24	0.435	0.1-0.6,0.1-1,0.2-0.6,0.5-0.8,0.5-1,0.7-1.4,1-1.5,1-2,1.5-2.4,1.5-3,17-26,2,2-3,2.2-2.7,2.9-8,5-11,5-6,6-11,6-15,6-9,7-9,7.5-10,abaxially,acute,adaxially,andromonoecious,anther,apex,base,blade,broadly,calyx,chartaceous,cm,connivent,cuneate,cylindrical,densely,diameter,entire,erect,extra-axillary,flattened,flower,fruit,glabrous,gland-tipped,globose,green,hair,inflorescence,interpetalar,lanceolate,leaf,length,lobe,lobed,loosely,margin,midrib,minutely,mm,moderately,obtuse,ovate,pale,pedicel,peduncle,perennial,petiole,plant,present,pubescent,purple,ray,reticulate,rhizomatous,rotate-stellate,rusty,shallowly,short,shrub,simple,sparsely,stellate,stellate-pubescent,stem,stigma,style,surface,tissue,tube,weakly,x,yellow,yellowish,yellowish-green	%,0-0.2,0-0.5,0-10,0-15,0-4,0-5,0.1-0.4,0.3-0.4,0.4-0.5,0.4-0.8,0.5-0.6,0.7-1.6,0.9-1.2,1-1.3,1-1.4,1-3,1.5-2,1.8-2.6,10-14,10-30,10-40,2-15,2-3-locular,2-foliate,2.9-4.8,3-10,4-10,4-6,4-8,5,5-merou,6-12,8-14,8-15,8-9,9-14,9-15,absen,absent,abundant,accrescent,acicular,across,adult,alyx,anvil-shape,apart,articulated,ascending,attenuate,axe,ba,branch,branche,brown,capitat,cross-section,directed,distall,distributed,dm,dult,eaf,eed,eglandular,exocarp,filament,finger,fruiting,functional,geminat,half,heterostylous,index,juicy,juvenile,lamina,lateral,less,lobing,long,longer,lower,mature,mesocarp,mid-point,midpoint,midvein,minute,moist,nflorescence,oblique,orolla,pair,part,per,placenta,pore,porrect,prickle,pseudo-racemose,rachi,ruit,side,spaced,stalk,stalked,stellae,straight,tal,tamen,thick,throughout,time,tissu,triangular,unarme,unarmed,unbranched,unit,upper,vary,vein,wide,ympodial	adhesion,arrangement,capitate,colour,corolla,form,growth,height,history,life,na,number,ovary,position,presence,pubescence,reproduction,rugulose,seed,shape,size,staman,stipe,texture
665	wfo-0001030882	success	144	96	60	84	36	0.417	0.5-1,0.5-1.1,0.8-1.1,0.9-1.1,1-1.3,1-1.5,1-4,2,2.2-4.6,3-3.5,3/4,6.5-15.6,acuminate,anther,apex,attenuate,base,calyx,capitate,cm,corolla,crenulate,dia,elliptic,fruit,glabrous,globose,green,leaf,lightly,lobe,lobed,margin,minutely,mm,narrowly,occasionally,opposite,ovary,ovoid-reniform,pale,papillose,pedicel,petiole,pitted,poricidal,shrub,size,small,stem,stigma,style,surface,tan,tip,tree,tube,way,white,x	.1,.5,0.5-0.75,0.75-1,0.8-2.4,1.6-2,2-5.4,2-6,8-12,?,accrescent,anthesi,bark,beginning,beneath,berry,closely,conical,deflexed,deltoid,differing,difoliate,eaf,edicel,eed,erect,exserted,extreme,filament,free,fruiting,geminat,inflorescenc,lateral,lon,long,lower,main,major,middle,minor,nearly,nflorescence,older,one,overlapping,ovoid,pair,paler,papillo,peelin,planar,pore,portion,prominent,raised,ruguse,ruit,scar,shaped,short,simple,slender,slightly,soon,spaced,straight,tall,tapering,tear-drop,terminal,thick,thickened,transversely,truncate,tub,ud,unit,vein,widest,woody,yellowish,ympodial,young	0.5,3,5.5,adhesion,arrangement,blade,climate,colour,diameter,form,glandular,growth,hair,height,history,inflorescence,length,life,midpoint,na,number,peduncle,perennial,plant,position,presence,pubescence,ray,reproduction,rugulose,seed,shape,staman,stellate,stipe,texture
666	wfo-0001030883	success	179	101	71	108	30	0.397	-3,.05,.5,0.5-3,0.5-5,1-1.1,1-1.2,1-1.3,1-1.5,1.5-2,1.5-3.5,18-44.5,2-5,3-3.5,5-6,9.5-27.5,acuminate,acute,anther,apex,base,brown,calyx,clavate,cm,corolla,dark,dia,dry,elliptic,fruit,glabrous,glandular,globose,green,hard,inflorescence,leaf,live,lobe,lobed,long,material,minutely,mm,occasionally,opposite,ovary,ovate,ovoid-reniform,pale,pedicel,petiole,pitted,plant,puberulent,russet,seed,shaped,shrub,size,stem,stigma,style,surface,tan,tear-drop,tube,white,woody,x	.1,1-4,10-18,20-50-flowered,3-4,3/4,accrescent,across,anthesi,apart,appearing,approximatately,arching,bark,becoming,berry,branched,bu,cell,collapsed,collection,deflexed,differing,difoliate,eaf,edicel,eed,epidermal,erect,evenly,filament,finely,fleshy,free,fruiting,furcate,geminat,geminate,hollow,imbedded,laminar,large,later,lateral,lenticellat,less,like,little,living,lon,long-acuminate,lower,main,malodorous,markedly,massive,middle,midrib,minute,narrowly,nflorescence,oblique,older,pair,papillate,papillo,papillose,perpendicular,petaloid,placenta,pore,poricidal,portion,present,proximal,pulp,quite,rather,reflexed,reticulate,ruit,scar,slender,slightly,sometimes,soon,spaced,stout,straight,strongly,tall,tapering,thick,time,tip,triangular,trichome,two,ud,uniseriate,unit,upper,vein,wall,way,widest,ympodial,young	adhesion,arrangement,blade,climate,colour,diameter,form,growth,hair,height,history,length,life,margin,midpoint,na,number,peduncle,perennial,position,presence,pubescence,ray,reproduction,rugulose,shape,staman,stellate,stipe,texture
667	wfo-0001030884	success	218	111	85	133	26	0.39	0.4-3,0.5,0.5-1.2,0.8-1,0.9-5,1-1.5,1.5,1.5-2,1.5-2.5,2-5,4-13,4-5,4.5-5,5.5-7,6-25,6-8,9-11,abaxially,abruptly,acute,anther,apex,base,blade,brown,calyx,capitate,cm,conical,connivent,dark,densely,di-,diameter,elliptic,glabrous,glandular,green,greenish,growth,inflorescence,lateral,leaf,length,like,lobe,lobed,long,margin,mature,midpoint,mm,moderately,ovary,ovoid-reniform,pedicel,peduncle,petiole,plant,present,prickly,pubescent,ray,reddish,rest,sagittate,shallowly,shrub,simple,size,sparsely,spherical,stellate,stellate-pubescent,stem,stigma,style,surface,tapering,treelet,trifoliate,tube,white,wide,yellow	.2,.5,.7,0.3,0.3-0.5,1,1-1.2,1-3,10,100,2,5,5-30,5-6,5-merous,6-10,7-8,>,abaxial,adaxial,adaxiall,along,also,alyx,andromonoeciou,anthesi,apar,arme,articulated,bark,basal,berry,broad-based,c.,curved,decurrent,differing,directed,discolorous,distal,eaf,eed,equal,extend,extending,filament,flower,flowering,free,fruiting,geminate,gray-tinged,gree,half,herbaceous,heterostylous,infructescence,leafy,long-stalked,long-styled,long-triangular,lower,magnification,midrib,minute,minutely,mixture,new,nflorescence,node,occasionally,older,one,onto,open,orolla,oung,outlin,pair,pale,papillat,per,pore,poricidal,porrect,portion,prickle,primary,principal,red,reflexe,reflexed,regularly,ruit,scar,scattered,sessile,shap,short,short-stalked,short-styled,similar,slender,spaced,spreading,stiff,still,strongly,tall,tamen,tannish,time,tip,trichome,unarmed,unicellular,uniformly,uniseriate,unit,upward,usually,vary,varying,vein,visible,way,weakly,wing,winged,without,woody,ympodial,young	0.2,0.5-0.7,adaxially,adhesion,arrangement,climate,colour,corolla,form,fruit,hair,height,history,life,na,number,perennial,position,presence,pubescence,reproduction,seed,shape,staman,stipe,texture
668	wfo-0001030899	success	146	97	61	85	36	0.418	.5-2,0.3-0.5,1-2,10-20,2,2-3,2-3.5,2.5-3.5,3-12,3-4,3-5,3.5-4,4-5,5-6.5,6.5-31,7-27,?,acuminate,apex,base,blade,bronze,calyx,chartaceous,cm,cordate,deeply,densely,diameter,ellipsoidal,end,entire,flattened,fruit,glabrous,glandular-puberulent,green,inside,lobe,margin,mm,obconical,oblong,outside,ovate,pedicel,peduncle,petiole,puberulent,purple,shrub,simple,splotch,stellate,stigma,stripe,style,tube,white,x,yellow	-45,0.5,0.5-1,1,1-1.5,1-3,1-6,1.5-2,10-13,20-25,3-foliate,5-10,8-11,abaxially,absent,acute,adaxially,aggregate,apart,ape,articulated,axe,basal,beyond,cell,connective,connivent,coriaceous,desc,dilated,directed,distally,eaf,eed,ex,exceeding,exserted,extrorse,flower,globose,leaving,less,light,lon,long,lower,mucronate,narrowly,nflorescence,nther,obtuse,orang,orolla,ovoid,pedicellar,peltifor,perfect,pore,presen,puberulen,pubescent,rachi,radiu,remnant,ruit,shorter,slightly,spaced,stamen,stone,strongly,tal,tem,thecae,time,tomento,triangular,ud,unbranched,unit,upward,vary,vein,wide,ympodial	adhesion,anther,arrangement,climate,colour,corolla,form,glandular,growth,hair,height,history,inflorescence,leaf,length,life,midpoint,na,number,ovary,peltiform,plant,position,presence,pubescence,ray,reproduction,rugulose,seed,shape,size,staman,stem,stipe,surface,texture
669	wfo-0001030902	success	159	113	78	81	35	0.491	-2,0.6-1.5,1-2,1-6,1.5-13,1.5-2.5,10-15,2,2-3,2-5,2.5,2.5-4,3-13,3-4,3.5-4,4,4-22,4-7,5-7,5-9,6-24,abaxially,acuminate,adaxially,along,angled,apex,basal,base,blade,brown-pilose,calyx,cm,cordate,dark,densely,diameter,eglandular,ellipsoidal,entire,except,flattened,fruit,glabrescent,glabrous,glandular,globose,hair,lobe,long,margin,mature,mm,oblong,occasionally,orange,ovate,pedicel,peduncle,petiole,pinkish,present,puberulence,purple,purplish,reddish,simple,sparse,stellate,stigma,style,subcoriaceous,tree,truncate,tube,vein,x,yellow	-20,-5,0-15,1.5-,1.5-2,15-50,3-20,30-50,4-6,4-foliat,8-14,absent,acute,aggregate,apart,ape,apically,apiculate,articulated,axe,beyond,branched,brow,cell,connective,connivent,cylindrical,deltate,dilated,directed,distally,eaf,eed,equalling,exceeding,exserted,fleshy,flower,forked,glabrat,glandular-puberulen,laterally,leaving,lon,lower,narrowly,nflorescence,nther,obtuse,orolla,pedicellar,perfect,pore,presen,rachi,radiu,rarely,remnant,ruit,shorter,slightly,small,somewhat,spaced,sparsely,stamen,stone,subcapitat,tal,tem,thecae,time,tip,tomento,triangular,ud,unbranched,unit,vary,wide,ympodial	adhesion,anther,arrangement,climate,colour,corolla,form,glabrate,growth,height,history,inflorescence,leaf,length,life,midpoint,na,number,ovary,perennial,plant,position,presence,pubescence,ray,reproduction,seed,shape,size,staman,stem,stipe,subcapitate,texture,tomentose
670	wfo-0001030906	success	134	96	55	79	41	0.41	1-1.4,1.0-1.4,1.5-2.5,1/3-2/3,2.0-2.6,2.3-3.5,4-11,6-10,7-16,8-13,9-12,across,along,annual,anther,arcuate,armed,base,blade,broadly,calyx,cm,dia,dry,flattened-ovoid,foveolate,glabrous,herb,internodal,length,lobe,long,main,maturity,minutely,mm,obtuse,ovate,pedicel,pentagonal,petiole,prickly,purple,red,rounded,seed,spherical,splitting,stellate-pubescent,stellate-tomentose,stem,surface,tube,vein,yellow	1,38,40-80,6-8,7-12-flowere,accrescent,almost,alyx,ample,anthesi,ascending,bearing,berry,branched,bristly,broad-based,campanulate,cauline,da,densely,developing,difoliate,divided,eaf,essentially,exceeding,externall,faces,flat,geminat,interpetalar,invested,lateral,linear,long-stalked,n,near,nearly,nflorescence,numerous,often,orolla,partly,per,pinnatifid,pinnatisect,plicate,prickl,prickle,purpli,ruit,sessil,short,slender,slightly,sometimes,somewhat,spreadingly,stellae,strait,subulate,suffused,tamen,taprooted,throughout,tightly,tigma,tissue,tub,twice,tyle,ultimate,undulate,unexpande,unit,usually,vary,yello,ympodial	adhesion,apex,arrangement,climate,colour,corolla,diameter,externally,form,fruit,glandular,growth,hair,height,history,inflorescence,leaf,life,margin,midpoint,na,number,ovary,peduncle,plant,position,presence,present,pubescence,ray,reproduction,rugulose,shape,size,staman,stellate,stigma,stipe,style,texture,unexpanded
671	wfo-0001030914	success	186	106	80	106	26	0.43	/4,0.5-1,0.7-1,1-1.5,1-2,1.2-1.5,1.5-3,1.5-8,2-10,2-2.5,2.5-3,3-4,3.5-17,7-8,9-35,along,anther,base,beneath,berry,calyx,capitate,cm,corolla,dark,decurrent,densely,dia,elliptic,erect,glabrous,globose,golden,green,inflorescence,leaf,lemon-yellow,length,lobe,lobed,long-styled,minutely,mm,obovate,opposite,ovary,ovoid-reniform,pale,papillose,pedicel,petiole,pitted,plant,poricidal,puberulent,pubescent,reddish-brown,ripe,shape,short-styled,shrub,size,small,sparsely,stem,stigma,style,surface,tan,tip,tree,trichome,tube,uniseriate,usually,vein,way,white,winged,x	.1,.5,0-0.25,0.1-0.5,0.8-1,0.8-1.3,1.5-2,2.5-11,5-17,5-25-flowered,7-10,acute,anthesi,apex,attenuate,bark,blade,bud,campanulate,closely,constriction,deflexed,deltoid,differing,difoliate,distal,dry,eaf,edicel,eed,ellipsoid,equal,even,evenly,exserted,filament,flower,free,fruiting,furcate,geminat,glabrate,greyish-brow,individual,later,lateral,like,live,lon,long,lower,main,major,many,margin,middle,minor,narowly,nflorescence,occasionally,often,older,one,onto,otherwise,overlappin,pair,papillo,planar,pore,portion,prominent,quite,raised,rest,rounded,ruit,scar,shaped,simple,slender,slightly,sometimes,soon,spaced,specimen,straight,tall,tapering,tear-drop,thick,third,ti,time,trunk,tub,ud,unit,variable,weight,widest,within,woody,yellow,ympodial,young	0.5,adhesion,arrangement,colour,diameter,form,fruit,growth,height,history,life,na,number,peduncle,perennial,position,presence,pubescence,ray,reproduction,rugulose,seed,staman,stellate,texture,unripe
672	wfo-0001030918	success	230	123	92	138	31	0.4	-3.2,-40,-6,-9,0.2-0.4,0.6-2.5,0.7-1.2,0.7-1.7,1,1-1.5,1.5-2.5,1.5-5.5,1/3,2-2.5,2-25,2-8,2.8-3,3-6.5,3.5-6,5-8,5.5-7,6-8,acute,anther,apex,base,berry,blade,calyx,chartaceous,cm,connivent,cuneate,densely,diameter,dull,elliptic,equal,erect,evenly,flattened-reniform,fruit,glabrescent,green,lateral,leaf,length,lobe,lobed,long,margin,maturity,mauve,midpoint,mm,moderately,obtuse,orange,orange-brown,pale,pedicel,peduncle,petiole,poricidal,porrect,pubescent,purple,ray,red,scandent,seed,sessile,shrub,simple,smooth,sometimes,sparsely,spherical,spreading,stellate,stellate-pubescent,stem,style,surface,tapering,terminal,tip,tube,upper,wide,yellow,young	-12,-2.3,-4,-4.5,-5,.5,.7,0-10,0-20,0-25,0-4,0-6,0.1,0.1-0.25,0.25-0.45,0.3-1.5,0.5-0.7,0.5-2,0.5-2.5,0.6,1-1.8,1-2,1-4,1.5-2,1/2-2/3,1/2-3/4,1/3-,1/3-1/2,1/4-1/3,2-10,2-3,2-4,2-7,2/,3-15,3-4,3-7,4-7,5-7,5-merous,7-10,abaxial,abaxially,acicular,adaxial,alyx,ame,apar,apart,apically,apparently,articulated,bark,branched,brow,c.,caudat,cell,curved,dark,deltate,difoliate,discolorous,distance,drying,eaf,elongated,elongating,extending,faint,filament,flattened,flower,free,fruiting,geminat,glabrous,green-brown,infructescence,lobing,longer,lower,mature,midvein,mixture,narrow-deltate,nflorescence,oblong,occasionally,older,one,open,orolla,oung,outline,pair,pendulous,per,perfec,pericarp,perpendicular,pit,portion,prickl,prickle,prickly,primary,raised,red-brown,reduced,reflexed,ruit,scar,secondary,side,slender,small,somewhat,spaced,stalk,stalked,straight,strongly,tamen,terete,tertiary,time,trichome,unit,usually,vary,vein,venation,visible,way,weakly,woody,ympodial	adhesion,arrangement,climate,colour,corolla,form,glandular,growth,hair,height,history,inflorescence,life,na,number,ovary,perennial,plant,position,presence,pubescence,reproduction,rugulose,shape,size,staman,stigma,stipe,texture,unknown,ye
673	wfo-0001030919	success	219	110	62	157	48	0.283	12,2,2.5,3,acute,andromonoecious,anther,apex,attenuate,base,blade,brown,calyx,chartaceous,cm,connivent,coriaceous,densely,diameter,elliptic,entire,extra-axillary,flower,fruit,glabrous,glandular,globose,green,hair,leaf,length,linear-lanceolate,lobe,margin,midpoint,mm,moderately,obtuse,orange,ovate,pedicel,peduncle,petiole,plant,pubescent,ray,reniform,scandent,shrub,simple,stellate,stellate-pubescent,stem,stigma,style,subopposite,surface,tan,tube,white,yellow,×	.2–0.4,.2–0.6,0.1–0.2,0.1–0.3,0.3–0.6,0.5–1,0.5–1.5,0.5–3,1.2–2,1.5,10–13,10–14,10–20,12–16,12–18,1971,1–2,1–3,25–50,2–3,2–4,2–8,3–4,3–6,3–8,4–7,4–8,5-merous,5–10,5–7,5–8,7–10,7–11,8–12,abaxial,abaxially,absent,accrescent,adaxial,adaxially,alyx,anthesi,apart,apparently,armed,articulated,asymmetrical,axe,ba,berry,beyond,branched,capitat,connected,cordate,covering,cylindrical,directed,discolorous,distally,eaf,eed,exserted,festooning,filament,flattened,frui,fruiting,functionally,fused,glabrou,hard,hermaphroditic,horizontal,incompletely,interpetalar,introrsely,lateral,like,lobed,long,longitudinal,lower,male,maturity,midrib,midvein,moderate,multicellular,multiseriate,narrowly,nearly,nflorescence,notch,occasionally,often,older,opening,orolla,partially,per,perfec,petiolate,pinnate,placenta,plurifoliat,pore,porrect-stellate,positioning,prickle,protrusion,proximally,rachi,recurved,reddish,reflexed,roe,roselike,rugose,ruit,rusty,secondary,see,shortly,side,slightly,slit,small,spaced,sparsely,spine,stalk,stamen,ste,subsessile,swollen,tal,tamen,tapering,tem,terminology,tissue,triangular,triangular-ovate,twice,unarmed,unbranched,unicellular,uniseriate,unit,vary,vein,venation,whitish,wide,ympodial,young	0.2-0.4,0.2-0.6,0.3-0.6,0.5-1.5,0.5-3,1-2,1-3,1.2-2,10-13,10-20,12-18,2-3,3-4,3-6,3-8,4-7,5-10,5-8,7-10,7-11,adhesion,arrangement,capitate,climate,colour,corolla,form,growth,height,history,inflorescence,life,na,number,ovary,perennial,position,presence,present,pubescence,reproduction,rugulose,seed,shape,size,staman,stipe,texture
674	wfo-0001030921	success	185	106	78	107	28	0.422	0,0.4-0.5,1-1.5,1-3,2-2.5,3-3.5,3-4,3-5,3.5-5,4-10,6-7,7-8,9-15,acuminate,acute,anther,apex,asymmetric,base,berry,brown,calyx,cm,coriaceous,corolla,deep,diameter,elliptic,entire,flattened,fruit,globose,green,growth,inflorescence,internodal,lanceolate-elliptic,liana,like,linear-lanceolate,lobe,lobed,margin,midpoint,mm,nearly,ovary,pedicel,peduncle,petiole,porrect,pubescence,pubescent,purple,ray,reniform,rusty,scabrous,sessile,stellate,stellate-pubescent,stem,stigma,style,subequal,subspherical,subtruncate,surface,tapering,tomentose,trichome,tube,unicellular,violet,white,woody,x,yellowish	.5,1-1.2,1-2,1/3,10,2-3,2-6,4-6,abaxially,adaxially,anthesi,antrorse,apart,appressed,armed,articulated,bark,basal,branched,caly,campanulate,channelled,compressed,congested,corymbose,curved,cyme,deeply,densely,diamete,discolorous,distal,eed,elongating,erec,erect,exceeding,exserted,filament,flower,free,fruiting,glabrescent,glabrous,grey,half,hermaphroditic,heterostylous,included,long,long-styled,longer,lower,many,minute,multicellular,near,new,nflorescence,oblong,obverse,older,one,ovoid-conical,partially,perfect,pericarp,plurifoliateleaf,pore,poricidal,porrect-stellate,portion,prickle,prickly,puberulent,raise,recurved,reddish,reduced,reflexed,reticulate-undulate,rugose,ruit,scar,short-styled,shorter,shrub,slightly,slit,spaced,sparse,sparsely,staminate,straight,strongly,terete,testa,time,tip,triangular,ud,unevenly,unit,upper,velutinous,ympodial,young	adhesion,arrangement,blade,climate,colour,form,glandular,hair,height,history,leaf,length,life,na,number,plant,plurifoliate,position,presence,reproduction,rugulose,seed,shape,size,staman,stipe,texture,ye
675	wfo-0001030941	success	259	110	88	171	22	0.34	0.1-0.3,0.8-1.1,0.8-1.3,1-9,1.1-1.7,1.1-2.8,1.2-2.1,1.2-2.2,1.3-2.5,1.4-1.6,1.5-4.5,10,10-25,2-3.2,2-5,3-4.5,3.5-10,4-6,6-22,7-23,9,abaxially,adaxially,anther,apex,becoming,blunt-tipped,brown,calyx,chartaceous,cm,conical,corolla,deltoid,diameter,elliptic,fleshy,flower,fruit,glabrescent,glabrous,globose,gray,growth,honeycombed,inserted,lateral,leaf,length,lobe,minutely,mm,moderately,mostly,narrowly,oblong,obovate,obtuse,ovoidal,pale,pedicel,peduncle,perfect,pubescent,reticulate-punctate,ripe,scabridulous,scabrous,shrub,small,sometimes,sparingly,sparsely,stelliform,stem,stigma,stipitate-glandular,style,suborbicular,subreniform,terminal,tomentose,tree,tube,white,x,yellow,yellowish	-1.5,-16,-4,-6,.01-0.3,.03-0.25,.04-0.1,.04-0.12,.04-0.22,.04-0.4,.2-0.8,.5-5,/50-1/15,0-100,0.01-0.22,0.02-0.04,0.02-0.06,0.02-0.25,0.02-0.3,0.02-0.4,0.03-0.05,0.03-0.06,0.03-0.6,0.04-0.08,0.04-0.1,0.04-0.35,0.04-0.5,0.04-0.6,0.06-0.35,0.06-0.42,0.07-0.4,0.08-0.35,0.08-0.5,0.5-1.5,1-1.4,1.1-1.3,1.3-4.5,1.4-3.5,1.5-3.5,1/3-1/2,2-3.3,3-5,3/4,4-12,4-8,4-9,5-9,5-merou,6-10,6-9,7-10,absen,accrescent,acuminate,acute,ag,along,alyx,anthesi,apart,apical-lateral,apparently,appressed-tomentose,articulated,axe,axillary,bark,base,berry,blade,branch,branched,bud,campanulate,color,continued,darker,decurrent,dehiscing,dense,densely,directed,due,eaf,eed,ellipsoid,entire,exserted,extend,few-rayed,filament,free,fruiting,glandular,hair,high,introrse,lanceolate,large,less,lobed,lon,long,long-attenuate,longer,longitudinal,lower,m.,main,margin,midpoint,midvein,mixed,multangulat,multangulate,multiseriate,nearly,nflorescence,obscured,occasionally,often,older,orolla,ovate,petiole,plurifoliate,pore,porrect-stellat,porrect-stellate,rachi,rarely,rather,ray,ruit,runk,sessile,short,short-stalked,side,simple,slit,somewhat,spaced,sparse,stalk,stamen,strongly,subcapitat,subcoriaceous,suture,tamen,terete,testa,thick,thick-stalked,time,tomentu,touching,toward,triangular,unarme,unarmed,unit,usually,vary,vein,way,weakly,wide,ympodial,young	adhesion,colour,form,height,history,inflorescence,life,na,ovary,perennial,plant,position,pubescence,reproduction,rugulose,seed,shape,size,staman,subcapitate,surface,texture
676	wfo-0001030943	success	167	124	88	79	36	0.527	.5,0.5-1,1-1.2,1-1.5,1.1,1.8-2.2,1/2,12-15,2-6,3,3-4,3/4,4-4.5,4-5,4-6,7-13.5,abaxial,abaxially,acuminate,acute,adaxial,adaxially,along,anther,apex,base,becoming,bi-lobed,black,branching,calyx,cm,corolla,dendritic,densely,diameter,drying,echinoid,elliptic,flattened,glabrous,globose,golden,golden-yellow,growth,im,lateral,leaf,lenticular,lobe,lobed,main,minutely,mm,narrowly,ovary,overtopping,pale,pedicel,pericarp,petiole,pitted,plurifoliate,poricidal,pubescent,purplish-black,reddish-brown,scattered,shoot,shrub,small,sparsely,stem,stigma,style,surface,terminal,thin,tip,tree,tree-like,trichome,tube,vein,violet,way,x,yellowish-white	0,0.5-3,1.5-2,10-25,7-8,8-10,absent,age,anthesi,apical,bark,basal,belo,berry,branch,conical,cupulate,dark,decurrent,deflexed,denser,eaf,edicel,eed,elongate,erect,ew,exserted,fide,filament,flower,free,fruiting,glabrat,horizontal,inserted,large,lon,long,lower,m.,minute,monochasia,nflorescence,nodding,often,older,outline,pair,papillo,pearce,per,planar,pore,portion,raised,ruit,scar,secondary,showy,sleeve,slightly,slit-like,somewhat,stamen,strongly,tall,tapering,time,triangular,tub,ud,unit,upper,wide,woody,yellow,ympodial,young	?,adhesion,arrangement,blade,climate,colour,form,fruit,glandular,hair,height,history,inflorescence,length,life,margin,midpoint,monochasial,na,number,peduncle,perennial,plant,position,presence,pubescence,ray,reproduction,rugulose,seed,shape,size,staman,stellate,stipe,texture
677	wfo-0001030959	success	164	91	62	102	29	0.378	.05,.8,0.5-1.5,0.7-1.2,1.2-1.8,1.5-3.5,10-15,2-4,2.5-4.5,2.5-5,5-6,5-9,9-12,abaxially,almost,anther,apex,base,blade,brown,cm,color,connivent,cuneate,diameter,elliptic,fresh,glabrous,glandular,hair,inflorescence,known,lateral,leaf,length,lobe,lobed,long,long-acuminate,margin,membranous,midpoint,mm,pedicel,peduncle,petiole,present,ray,shrub,simple,sparsely,stellate,stellate-pubescent,stem,straw,style,subentire,surface,tapering,tube,wide,yellow	.2,/5,0.5,1-10,1-2,1-7,1.5-2,1/5-1/10,2.5-4,4-6,4-8,5-merous,6-8,alyx,ame,apar,apart,apically,apparently,armed,articulated,bark,branched,brown-green,c.,concolorous,curved,deltate,densely,difoliate,distributed,drying,eaf,eed,equal,erect,evenly,filament,flower,free,geminat,gently,glabrescent,glabrou,green-brow,know,less,like,long-acuminat,longer,lower,minute,narrow-deltate,nflorescence,numerous,older,one,open,orolla,oung,pair,part,perfec,perpendicular,poricidal,porrect,portion,prickl,prickle,prickly,primary,prominent,ruit,scar,scrambling,secondary,sessile,several,short,side,slender,spaced,spreading,straight,tamen,terete,tertiary,time,tip,toward,trichome,unarmed,unit,usually,vary,vein,venation,visible,way,whole,ympodial,youngest	adhesion,arrangement,calyx,climate,colour,corolla,form,fruit,growth,height,history,life,na,number,ovary,perennial,plant,position,presence,pubescence,reproduction,rugulose,seed,shape,size,staman,stigma,stipe,texture
678	wfo-0001030982	success	215	109	83	132	26	0.386	-2-2.5,0.05-0.5,0.2-3,0.5-0.9,0.5-1,1,1-1.5,1-8,1.5,1.5-2,1.5-3,2/3,3-21,4-5,6-8,acuminate,acute,anther,apex,base,berry,broadly,brown,brownish,calyx,capitate,chartaceous,cm,conic,conical,corolla,cuneate,diameter,dry,drying,elliptic,entire,flattened-reniform,fleshy,form,fresh,fruit,glabrous,glandular,globose,green,growth,leaf,lobe,lobed,margin,material,maturity,mm,opposite,ovary,ovate,pale,papillose,pedicel,peduncle,petiole,plant,poricidal,pubescent,reddish,rhizomatous,sagittate,seed,sinuate,size,slightly,sparsely,stem,stigma,style,subshrub,surface,tip,tube,way,white,x	.1,.2,.5,0.05,0.1,0.1-0.15,0.3-2,0.5,0.5-3,3-8,4-12,abaxially,adaxially,age,angular,anisophyllous,anthesi,ape,appressed,ba,beneath,bud,caducous,central,channelled,ciliate,closely,cream,cucullate,curved,dark,deflexed,deltate,differing,difoliate,distall,distally,distichou,eaf,edicel,eed,ellipsoid,enlarged,exerted,extension,external,filament,flower,foliage,free,fruiting,geminate,glabrescent,glandular-papillose,golden-green,greenish,hilum,impressed,inconspicuously,internal,isostylous,larger,later,lengthening,less,like,live,long,lower,major,materia,midvein,minor,minutely,mostly,near,new,nflorescence,oblique,obovate,occasionally,often,olive,one,overlappin,packed,pair,papillae,papillat,papillate,pitted,planar,pore,portion,primary,projection,prominent,prominently,puberulent,reflexed,rest,revolute,ruit,scar,separated,shoot,sigmoidally,simple,situated,slit,somewhat,stamen,straight,stripe,strongly,testa,tetramerous,tightly,time,transverse,trichome,tub,ud,uniseriate,unit,vegetative,vein,veined,weakly,yellowish,ympodial,young	adhesion,arrangement,blade,climate,colour,distichous,hair,height,history,inflorescence,length,life,midpoint,na,number,position,presence,pubescence,ray,reproduction,rugulose,shape,staman,stellate,stipe,texture
679	wfo-0001030989	success	177	94	69	108	25	0.39	.5,0.5-1,1-2,12-15,15-27.5,3-4,3-7.5,4-5,5,6-6.5,9-10,abaxially,adaxially,anther,articulated,axillary,berry,brownish,bud,chartaceous,ciliate,cm,condition,conical,corolla,densely,diameter,drying,fresh,fruit,glabrous,green,greenish,hair,herb,lanceolate,leaf,light,like,lobe,long,margin,minute,mm,odd-pinnate,ovate-lanceolate,ovoid,pedicel,peduncle,petiole,plant,proximal,pubescent,ripe,rotate,seed,size,sparsely,stem,stigma,style,subtending,terminal,tube,violet,whitish,wide,x,yellow	1-1.5,1-10,2-3.5,3-20,3-5.5,4-7,4-8,5-merou,5.5-7.9,6-13,acuminate,ag,alyx,apart,apex,apparently,axe,base,blade,capitat,cell,connivent,covering,decreasing,digestion,distal,dorsally,eaf,edge,eed,end,enzyme,erec,especially,filament,flat,flower,folded,forked,geminat,generally,glabrou,gradually,green-white,hair-like,half,homostylous,honeycomb-shaped,interjected,larger,lateral,leaflet,lengthening,living,lower,make,mucilaginous,nflorescence,obtuse,occurring,orbicular,orolla,ovate,pair,pale,perfect,petiolule,plurifoliate,pore,poricidal,present,pubescen,ray,removed,ruit,secondary,semierect,seudostipule,singly,slit,spaced,specimen,ste,stolo,subequal,subsessile,symmetrical,tall,tamen,tem,testal,thick,thir,throughout,tip,toward,tri-,triangular,tuber,typically,unit,unwinged,usually,vary,wall,wet,wider,ympodial	adhesion,arrangement,calyx,capitate,colour,form,growth,height,history,inflorescence,length,life,na,ovary,perennial,position,pseudostipule,pubescence,reproduction,rugulose,shape,staman,surface,texture,third
680	wfo-0001030991	success	204	122	91	113	31	0.446	.5,0.5-0.7,0.5-1.5,0.7-1.2,1-1.5,1-1.6,1-2.2,1-2.5,1-7,1.5,2.5-10,2.5-3,3-,3-5-lobed,5-5.5,9-11,abaxially,absent,acuminate,acute,along,anther,apex,apparently,attenuate,base,berry,brown,calyx,capitate,cm,conical,corolla,densely,diameter,ellipsoidal,elliptic,entire,flattened,glabrous,globose,grey,growth,herb,inflorescence,lanceolate,lateral,leaf,leaf-opposed,lobe,lobed,margin,minutely,mm,narrowly,nearly,occasionally,pedicel,peduncle,petiole,pinnatifid,pitted,pubescent,red,reniform,ripe,scattered,shiny,short,shrub,simple,small,sparsely,stellate,stem,stigma,style,suffrutescent,surface,terminal,thin,trichome,tube,uniformly,uniseriate,variably,violet,white,winged,x,yellowish	0,0.1,0.2,0.2-0.7,0.3-0.4,0.5,0.5-1,0.5-3.5,0.6-0.8,10-20,2-plurifoliat,2/3,4-10,5-merou,<,adaxiall,adaxially,ag,alyx,angled,anthesi,appressed,arising,ark,articulated,ascending,basal,bulbous,cell,color,connivent,different,distally,drying,eaf,eed,ellipsoid,elongate,enlarged,exerted,eye,filament,filiform,flower,free,frui,fruiting,furcate,fusiform,glabrescen,ilament,incised,leave,lengthening,less,like,long-triangular,loosely,lower,midrib,minute,new,nflorescence,nodding,often,older,orolla,outline,packed,pair,papillo,part,particularly,pendant,per,perfect,pericarp,platfor,pointing,pore,poricidal,portion,primary,pseudoumbel,rectangular,reflexed,rest,rootstoc,ruit,scar,shallowly,sleeve,slightly,slit,somewhat,spreading,strongly,tangled,tem,testal,tightly,tip,twinin,ud,unit,upper,vary,vein,weak,weight,woody,ympodial,young	adhesion,arrangement,blade,climate,colour,form,fruit,glandular,hair,height,history,length,life,midpoint,na,number,ovary,perennial,plant,position,presence,pubescence,ray,reproduction,rugulose,seed,shape,size,staman,stipe,texture
681	wfo-0001031005	success	231	134	121	110	13	0.524	.5,/3-1/2,0.1,0.8,0.9,1-1.5,1-2,1-2.5,1-3,10,2-3.2,2.5,2.5-4,3-4,3-6.5,5,5-7,5-8,6-12,abaxially,adaxially,almost,along,anther,anthesi,apex,bark,base,berry,black,blue,brachyblast,branch,branched,branching,brown,calyx,capitate,chartaceous,clearly,clustered,cm,common,conical,corolla,cupular,dendritic,denser,diameter,domatia,drying,elliptic,elongated,evenly,eye,fine,flat,flattened,flexuous,form,fruit,glabrous,greenish,lateral,leaf,length,liana,like,lobed,long,longitudinally,main,membranous,midvein,mm,naked,network,oblong,obovate,occasional,occasionally,often,older,orange-brown,ovoid,pair,pedicel,peduncle,petiole,primary,prominent,pubescent,purple,rachi,raised,ray,ridged,short,side,slender,sometimes,somewhat,sparsely,stem,stigma,style,terete,terminal,tertiary,thick-chartaceous,tip,toward,trichome,unarmed,usually,vein,venation,visible,white,x,young	.4,0-0.5,0.3-0.5,0.5-1.5,1,1.5-2.5,1.5-4,2.3-3,3-10,4-6,5°,abaxial,accrescent,acuminate,acute,age,alyx,apar,apically,apparently,articulated,attenuate,clum,concolorous,curved,dark,datum,deeply,delineated,deltoid,dendritic-pubescent,density,detaching,developing,dilated,discolorous,divided,eaf,ellipsoi,entire,equal,extending,fertilisation,filament,flower,forming,free,fruiting,immature,increasing,inside,junction,known,leave,lengthening,linear,lobe,loop,lower,m.,margin,minute,much,nflorescence,nther,obscure,onl,orolla,ou,outside,ovate,pendulous,perfec,pericarp,plurifoliat,pointed,pore,poricidal,portion,protruding,region,rest,ruit,scar,secondary,seed,simple,smaller,smoot,smooth,soon,spread,spreading,standing,strongly,stump,surface,surrounding,tangling,tearing,thin,tube,ud,uneven,unit,vary,weakly,well-developed,wide,ympodial	arrangement,colour,growth,inflorescence,na,number,ovary,position,presence,pubescence,shape,size,texture
682	wfo-0001031007	success	207	118	103	104	15	0.498	0.2,0.5-1,1,1-1.2,1-1.5,1-3.5,1.2-1.5,1.3-,1.5-2,1.9-3,15,2.5-,2.5-5,3-4,4.5-5,5-12,5.5-6,6,7-10,<,acute,alfway,along,anther,apex,base,berry,bifid,black,branched,broad,brown,c.,calyx,capitate,chartaceous,cm,connivent,corolla,cuneate,dendritic,densely,diameter,dull,elliptic,entire,extending,filament,flattened-reniform,fleshy,fruit,glabrous,globose,growth,inflorescence,lamina,lax,lilac,lobe,lobed,long,loose,loosely,many,margin,matte,minutely,mm,narrowly,occasionally,outline,papillate,pedicel,peduncle,pericarp,petiole,pitted,pubescent,reddish,revolute,sagittate,shrub,slender,sparsely,stellate,stellate-pentagonal,stem,stigma,stout,style,surface,tangled,thin,time,tip,trichome,tube,usually,vein,vine,woody,x,yellow	.5,0.5,0.5-10,0.75-1.5,1.6-2,1/3,11-14,4-6,4-7,5,5-merou,50-100,8-10,abaxiall,abruptly,ag,almost,alyx,anthesi,apar,apparently,ark,articulated,becoming,beginning,branching,broadly,campanulate,cell,clustered,completely,cup-shaped,dark,deltate,dilated,drying,eaf,eed,ellipsoid,exserted,flower,free,fruiting,geminat,glabrescen,glabrou,herbarium,ilament,impressed,intramarginal,irregularly,junction,leaving,lengthening,looping,lower,m.,markedly,midvein,multi-celled,narrowing,near,new,nflorescence,nodding,often,older,orolla,pale,papillat,peg,per,perfect,planar,plurifoliate,pore,poricidal,portion,primary,prominent,rat,round-rectangular,ruit,scar,shiny,simple,sleeve,slightly,slit,spaced,specimen,splitting,spreading,strongly,terminal,testal,tiny,twining,ud,unit,upper,vary,way,ympodial	abaxial,adaxial,bark,colour,form,height,leaf,length,ovary,plant,pubescence,seed,shape,size,texture
683	wfo-0001031007	success	206	117	85	121	32	0.413	0.5-1,1,1-1.2,1-1.5,1-3.5,1.2-1.5,1.3-,1.5-2,1.9-3,15,2.5-,2.5-5,3-4,4.5-5,5-12,5.5-6,6,7-10,acute,anther,apex,base,berry,bifid,black,brown,calyx,capitate,chartaceous,cm,corolla,cuneate,dendritic,densely,diameter,dull,elliptic,entire,flattened,fleshy,fruit,glabrous,globose,growth,inflorescence,lax,lilac,lobe,long,loose,lower,margin,matte,mm,narrowly,papillate,pedicel,peduncle,perfect,petiole,poricidal,pubescent,reddish,reniform,revolute,sagittate,shrub,simple,sparsely,stellate,stellate-rotate,stem,stigma,style,surface,tall,terminal,thin,tip,trichome,tube,usually,vine,wide,woody	.5,0.2,0.5,0.5-10,0.75-1.5,1.6-2,1/3,11-14,4-6,4-7,5,5-merou,50-100,8-10,<,abaxially,abruptly,adaxial,ag,alfway,almost,along,alyx,anthesi,apar,apparently,articulated,bark,becoming,beginning,branched,branching,broad,broadly,c.,campanulate,cell,clustered,completely,cup-shaped,dark,deltate,dilated,drying,eaf,eed,ellipsoid,exserted,extending,filament,flower,free,fruiting,glabrescen,glabrou,herbarium,ilament,impressed,intramarginal,irregularly,junction,lamina,leaving,lengthening,lobed,looping,m.,many,markedly,midvein,minutely,multi-celled,narrowing,near,new,nflorescence,nodding,occasionally,often,older,orolla,outline,pale,papillat,peg,per,pericarp,pitted,planar,plurifoliat,pore,portion,primary,prominent,rat,round-rectangular,ruit,scar,shiny,sleeve,slender,slightly,slit,spaced,specimen,splitting,spreading,stout,strongly,tangled,testal,time,tiny,twinin,ud,unit,upper,vary,vein,way,ympodial	adhesion,arrangement,blade,climate,colour,form,glandular,hair,height,history,leaf,length,life,midpoint,na,number,ovary,perennial,plant,position,presence,present,pubescence,ray,reproduction,rugulose,seed,shape,size,staman,stipe,texture
684	wfo-0001031022	success	287	155	130	157	25	0.453	.04,0.2–0.3,0.2–0.9,0.3–0.6,0.3–0.8,0.5–1.4,0.5–5.8,0.6–1.0,0.6–1.2,0.6–1.6,0.6–2.4,0.7,0.7–1.7,0.8–1.2,0.8–2.9,0.8–3.4,0.9–1.9,1.0–4.5,1.1–8.3,1.2–2.3,1.4–4.0,1.8–12.1,1.9–2.8,1/3,12.9,14.9,2.3–3.1,3.2–4.9,3.9–6.5,4.5–21.9,4–9,6–10,abaxially,acuminate,acute,adaxially,adnate,anther,apex,arcuate,attenuate,base,becoming,black,blade,brown,calyx,capitate,chartaceous,cm,corolla,cream,cuneate,densely,diameter,dry,either,emerging,entire,erect,evenly,extra-axillary,flattened-reniform,flower,fruit,glabrous,glandular,globose,green,hair,heterostylous,internode,interpetalar,lanceolate,lateral,leaf,length,lobe,lobed,long,longer,margin,markedly,mature,midpoint,midrib,mm,moderately,ovate,pedicel,peduncle,petiole,poorly,porrect,pubescent,purple,ray,reddish,rounded,sessile,several,short,shorter,shrub,side,simple,small,sparsely,stellae,stellate,stem,stigma,stipe,stipitate,style,tissue,toward,tree,truncate,tube,unarmed,upper,vein,well-developed,white,yellow,yellow-tan,young,±glabrous,×	0.1,0.4–0.5,0.4–1.2,0.4–1.3,0.5–1.5,0.5–2.2,0.6–2.6,0.8–1.3,1.0–2.6,1.1–3.4,1.2–2.6,1.5–2.5,1.6–4.8,1/4,1/4–1/3,10,10.5,17–145,2.8–6.3,2/3,3.2–7.0,3.8,4–6-merou,5.1–8.7,5.8–11.4,5–7,5–8,6.9,8.2,8.8,8.9,90°,absent,aequilateral,along,alyx,anthesi,apart,apical,apiculate,apparently,appearing,appressed,arching,area,around,articulate,axe,ba,bark,basal,bent,berry,branch,broad,brochidodromous,bud,bulge,caudate,central,channeled,clinate,crea,deciduous,dentate,development,difoliate,directed,directly,distal,distally,distinct,eaf,edge,eed,endocarp,exocarp,extending,ferruginous,fertile,filament,filiform,forking,free,geminat,glossy,gradually,immature,increasing,intac,intersepalar,juic,large,layer,less,lon,lower,major,many,midvein,minor,minute,nearly,nflorescence,oblique,opaque,opposed,orolla,oval,ove,per,perforated,pore,portion,potentially,raised,reflexe,remaining,reticulate,ridge,rigid,row,ruit,semicraspedodromous,sinus,sloughing,smooth,sometimes,spaced,splitting,spread,spreading,stellate-pubescent,straight,surface,suture,tamen,tardily,tem,terete,thin,time,tip,transparent,two,ud,unbranched,unit,various,vary,weakly,well,wide,yellow-ferruginous,ympodial,±90°,±equal	adhesion,arrangement,climate,colour,form,growth,height,history,inflorescence,life,na,number,ovary,perennial,plant,position,presence,present,pubescence,reproduction,seed,shape,size,staman,texture
685	wfo-0001031036	success	150	91	57	93	34	0.38	.25,.5,0.5-1,0.8-1,0.8-1.2,1-1.3,1-2.5,1.2-1.5,1.5-3,12-15,2-2.5,3-4,4.5-6.5,5-6,acuminate,acute,anther,apex,base,bi-lobed,brown,calyx,cm,corolla,crisped,dark,dia,elliptic,filiform,flattened-reniform,glabrous,globose,green,greenish-white,leaf,lobe,lobed,margin,minutely,mm,nearly,opposite,ovary,pedicel,petiole,pitted,sagittate,shrub,size,slightly,stem,stigma,style,surface,tube,winged,x	.2,10-20-flowered,2.2-3.7,3-5,3.5-5.5,7-8,abaxially,adaxially,along,angle,anthesi,arising,axil,ba,becoming,berry,broadly,closely,conical,decurrent,deflexed,differing,difoliate,dry,drying,eaf,edicel,eed,ellipsoid,enlarged,erect,exserted,filament,fleshy,free,fresh,fruiting,geminat,knob-like,lamina,lateral,lon,long,lower,main,major,material,middle,minor,nflorescence,oblique,older,onto,overlappin,pair,papillo,papillose,perhaps,planar,pointed,pore,poricidal,portion,rounded,ruit,scar,shaped,shiny,short,simple,sinus,soon,spaced,spathulate,strongly,tall,tapering,tear-drop,thickened,tip,trichome,tub,ud,uniseriate,unit,usually,vein,white,widest,woody,yellowish,ympodial,young	adhesion,arrangement,blade,climate,colour,diameter,form,fruit,glandular,growth,hair,height,history,inflorescence,length,life,midpoint,na,number,peduncle,perennial,plant,position,presence,pubescence,ray,reproduction,rugulose,seed,shape,staman,stellate,stipe,texture
686	wfo-0001031040	success	217	139	96	121	43	0.442	10,6,abaxially,acuminate,acute,adaxially,age,anther,apex,attenuate,base,blade,branch,broad-based,broadly,calyx,cm,deeply,diameter,dull,entire,flattened-reniform,flower,flowering,free,fruit,glabrescent,glabrous,gland-tipped,glandular,globose,green,hair,inflorescence,interpetalar,lanceolate,lateral,lavender,leaf,lighter,lobe,long,longer,margin,midpoint,minute,mm,narrowly,older,ovate,pedicel,peduncle,petiole,pinnatifid,plant,porrect,prickle,purple,rarely,ray,rounded,scabrous,sessile,sessile-stellate,shape,shrub,simple,size,slightly,small,sometimes,somewhat,soon,sparse,sparsely,sprout,stellae,stellate,stem,stigma,straight,style,subcordate,subcoriaceous,surface,tissue,tree,triangular,tube,turning,unarmed,vigorous,violet,white,yellow,yellow-brown	.5,0.1–0.3,0.2–0.6,0.3–3,0.8–7.5,1.2–1.3,1.2–2.1,1.4–2.7,1.5–4,1.5–5,1.7,1.7–3.1,10–10.5,10–13,12–14,15–23,1–1.4,2,2.2–2.5,2.4–3,2.5–4,2.5–9,2–10,2–5-branched,3,3.5–5,3–26,3–4.5,3–5,4–6,5,5-merou,6.5–25,6–6.5,6–8,7–9,8–30,accrescent,adaxiall,also,alyx,anthesi,apart,apical,apparently,articulated,axe,ba,becoming,berry,capitat,contrasting,dark,densely,depending,difoliate,directed,distall,eaf,eed,either,especially,filament,filiform,finely,geminat,glabrou,highly,homostylous,immature,internode,larger,like,lobed,lon,lower,major,midvein,midzone,minutely,much,nflorescence,numerous,orolla,outside,ovoid,pale,perfect,persistent,pitted,pore,principal,probably,recurved,ruit,scarcely,several-celled,short,side,similar,spaced,splitting,stellate-pubescent,tamen,tem,thickened,time,triangular-attenuate,ud,unit,upward,usually,variable,vary,vein,vigor,wide,yellowish-tawny,ympodial,×,–6	0.1-0.3,0.2-0.6,0.3-3,0.8-7.5,1-1.4,1.2-2.1,1.5-4,1.7-3.1,10-10.5,12-14,15-23,2-10,2.2-2.5,2.4-3,2.5-4,6-8,6.5-25,7-9,adhesion,arrangement,capitate,climate,colour,corolla,form,growth,height,history,length,life,na,number,ovary,position,presence,pubescence,reproduction,rugulose,seed,staman,stipe,texture,ye
687	wfo-0001031062	success	216	115	75	141	40	0.347	-5.5,.5,0.3,0.5,1,2,2.5,20,4,?,abaxially,acute,adaxially,anther,apex,appearing,base,blade,brownish,calyx,chartaceous,cm,cuneate,densely,diameter,entire,extra-axillary,ferruginous-tomentose,flattened-reniform,flower,foveolate,fruit,fully,glabrous,globose,green,hair,leaf,lobe,margin,midrib,minutely,mm,ovate-lanceolate,pedicel,per,perhaps,petiole,plant,pubescent,ripe,rotate-stellate,shallow,shape,shub,side,simple,size,sparsely,stellate,stellate-tomentose,stem,stigma,style,surface,tapered,terminal,tomentose,treelet,truncate,tube,usually,white,x,yellow	0,0.5–0.6,0.7–0.8,1.2–1.4,1/3,13–15,15,16,17,1–2.5,1–4,2-3.5,22,2–3,2–5.5,3,3-8,3–10,4–10,4–4.5,5,5–7-rayed,7,7–15,7–8-rayed,9–11,absent,accrescent,adaxiall,ag,ample,apart,apiculate,armed,articulated,axe,ba,bottom,branch,bud,campanulate,capitat,clustered,colored,connivent,count,curved,cylindrical,diamete,difoliate,directed,distally,eaf,eed,even,eventually,except,fertile,filament,forked,fragrance,fruiting,geminat,glabrou,grading,heavily,ilament,interpetalar,juvenile,larger,lateral,least,less,lighter,lobed,long,longitudinal,loosely,lower,m.,main,midpoint,much,nearly,nflorescence,numerous,obscuring,obsolete,often,one,opening,orolla,overtopped,part,partially,pentagonal,perfect,pore,prickle,rachi,rarely,recurved,rest,ruit,scabrous,sessile,short,short-stalked,slightly,slit,small,sometimes,spaced,sprout,stellae,stipitate,straight,sweet,tall,tem,thick,thick-based,tip,tissue,toward,triangular,unarme,unarmed,unbranched,unifoliate,uniform,unit,uppermost,vary,vigorous,visible,wide,ympodial,young,younger,–3	0.5-0.6,0.7-0.8,1-2.5,1-4,1.2-1.4,13-15,2-5.5,4-10,4-4.5,5-7,7-15,7-8,9-11,adhesion,arrangement,capitate,colour,corolla,form,growth,height,history,inflorescence,length,life,na,number,ovary,peduncle,position,presence,present,pubescence,ray,reproduction,rugulose,seed,staman,stipe,texture
688	wfo-0001031064	success	179	107	83	96	24	0.464	.0-2.5,.5,.5-1,0.5,0.5-0.7,1-2,1-3,1.2,1.5-2,1.7-4.2,10-12,10-12.5,10-17,2.5-3,3,3-5.5,3-7,3.5-4,5-10.5,5-6,6-16,7-16,abaxially,anther,arising,axil,basal,base,bright,calyx,cm,completely,conical,corolla,densely,diameter,elongate,fruit,glabrous,green,half,inflorescence,lateral,leaf,leaflet,lightly,lobe,lobed,lower,margin,minutely,mm,nearly,obovate,ovary,ovoid-reniform,papillate,pedicel,petiole,pinnate,poricidal,pubescent,purple,rachi,rugose,scattered,short-pubescent,shrub,simple,single,sparsely,stem,stigma,style,surface,terminal,tip,trichome,tube,uniseriate,white,winged,x	.05,0,0-15,0.5-0.8,1,1-1.2,2,4-5-celled,8-10-celled,acroscopic,acuminate,adaxially,along,anthesi,anticlinal,apex,attenuate,bearing,berry,blade,broader,cell,clavat,commentary,conspicuous,dark,deltate,denser,distal,dr.,eaf,edicel,eed,epidermal,erec,exserted,filament,fleshy,flower,free,fruiting,globose,highly,irregular,irregularly,lamina,leave,lenticel,like,lon,long,lost,minute,narrower,near,nflorescence,nodding,node,occasionally,often,open,ovate,pair,per,petiolule,planar,portion,projection,prominent,pubescen,ruit,scar,see,side,sinuous,sinus,slender,smaller,somewhat,splitting,strongly,swollen,tal,tem,thickening,time,translucent,tub,ud,unifoliat,unit,usually,vein,wand-like,without,ympodial	adaxial,arrangement,clavate,colour,form,growth,height,history,length,life,na,peduncle,perennial,plant,position,pubescence,reproduction,rugulose,seed,shape,size,texture,unifoliate,ye
689	wfo-0001031065	success	140	86	53	87	33	0.379	.4,.6,1-,1-celled,aculeate,almost,anther,attenuate,calyx,celled,chestnut,cm,corolla,dense,dia,eglandular,externally,extra-axillary,ferruginous,fruit,glabrous,glandular,green,green-striate,herb,light,lilac,lobe,margin,mm,non-glandular,ovary,ovate-lanceolate,ovoid,pale,pedicel,peduncle,petiole,puberulous,rarely,rough,simple,sometimes,sparse,spheroid,stellate,stem,stigma,style,subshrub,trichome,white,x	.1–0.3,.2,.3,.5–2,0.2–1.1,0.5–1.6,0.5–5,0–30,1,1.8–7.8,2,4,4-merous,5-merous,accrescent,acicular,acuminate,acute,also,alyx,apex,apical,apparently,armed,asymmetrical,base,berry,beyond,cell,central,color,composed,concolorous,deltate,difoliate,eaf,eed,either,entire,erect,filament,flower,frui,geminate,held,indumentum,lamina,lateral,lobed,lower,many,many-celled,midpoint,midvein,multi-celled,narrowly,nflorescence,nonglandular,occasionally,orolla,per,perfec,perhaps,persistent,porrect-stellate,portion,radial,rare,rounded,ruit,scabrid,sessile,shor,short,short-pedunculate,slightly,solitary,spine,surface,tall,terete,umbelliform,unifoliat,unit,upper,usually,ympodial	.5-2,0.2-1.1,0.3,0.5-1.6,0.5-5,1.8-7.8,20-30,adhesion,annual,arrangement,colour,diameter,form,growth,height,history,inflorescence,leaf,length,life,na,plant,position,presence,present,pubescence,reproduction,seed,shape,size,staman,texture,tube
690	wfo-0001031071	success	186	92	66	120	26	0.355	0.2-0.8,1-1.5,1-2,1-3,2-8,2.1-3,2.4-3.4,3-10,3-6,4-6,5-9.4,7-16.5,7-8,8-28,abaxially,adaxially,anther,blue,brownish,clavate,cm,condition,coriaceous,corolla,dark,deep,diameter,drying,elliptic,fresh,fruit,glabrous,globose,green,greenish,herb,lanceolate,leaf,lilac,lobe,long,medium,mm,mottled,odd-pinnate,ovate,ovoid,pedicel,peduncle,pentagonal,petiole,plant,purple,rotate,seed,size,spot,star,stigma,style,terminal,tube,white,whitish,x,yellow	0-10,0.4-2,1-7,1.5-2.2,2-3,2-5,3-5,3.8-5.4,4-25,5-merou,5.7-8.8,6-8,abaxiall,acumen,acute,ag,along,alyx,apart,apex,apparently,arranged,articulated,asymmetric,attenuate,axe,axillary,base,basiscopic,bead,berry,blade,bud,capitat,cell,color,connivent,covering,decreasing,digestion,distal,dorsally,eaf,edge,eed,enzyme,erec,exceeding,filament,flat,flower,folded,forked,geminat,generally,glabrou,green-white,hair-like,half,homostylous,honeycomb-shaped,interjected,lateral,leaflet,lengthening,like,living,lower,make,middl,moniliform,mucilaginous,multiple,narrowly,necklace,nflorescence,orbicular,orolla,pair,perfect,petiolulate,plurifoliate,pore,poricidal,removed,ripe,round,ruit,sessile,seudostipule,short,side,slightly,slit,spaced,specimen,stamen,stolon,straight,subequal,subtending,tall,tamen,tem,testal,thick,throughout,tip,tissue,toward,tri-,tuber,typically,unit,usually,vary,wall,wet,winged,ympodial	adhesion,arrangement,calyx,capitate,colour,form,growth,height,history,inflorescence,length,life,na,ovary,perennial,position,presence,pubescence,reproduction,rugulose,shape,staman,stellate,stem,surface,texture
691	wfo-0001031097	success	174	78	60	114	18	0.345	0.45,1-4,1-4.5,1.6-5.5,1.8-2.5,13-30,2-3.3,2-4,3-5,3.7-8.4,4-6,5-12,5-9,9-21,abaxially,adaxially,calyx,cm,connate,corolla,darker,deep,diameter,distal,elliptical,green,green-white,half,herbaceous,lateral,leaf,leaflet,light,long,medium,mm,obovate,odd-pinnate,ovate,ovoid,pair,pedicel,peduncle,pentagonal,perennial,petiole,plant,puberulent,pubescent,purple,rotate,seed,size,strigose,terminal,throughout,violet,violet-blue,wide,yellow	0.5,1,1-3,1.5,1.8-2.6,2-3,3-6-foliat,3.5-6,4-7,5-11,8-11,abaxial,acumen,acuminate,acute,along,apex,apical,apically,articulate,base,branched,cell,covering,cuneate,cyme,decurrent,dehiscent,dichasial,dichasially,digestion,diminishing,dorsally,dotted,eaf,ebracteate,edge,eed,emoval,enzyme,exceeding,filament,flat,flower,folded,forked,frequently,generally,globo,gree,hair-like,highly,honeycomb,interjected,interpetalar,introrse,lighter,living,lobe,lon,lower,lunat,make,margin,maturing,monochasial,mottled,mucilaginous,narrow,nflorescence,noticeably,nther,oblique,often,orolla,pattern,perfect,petal,petiolulate,petiolule,plan,poricidally,proximal,rachi,rapidly,rarely,reveal,ruit,sessile,seudostipule,short,side,slit,sometimes,specimen,stamen,stigma,straight,style,tal,tem,testal,thick,tissu,toward,tuber-bearing,typically,unit,vary,vbase,wall,without,ympodial,¼	anther,arrangement,colour,form,fruit,growth,height,history,inflorescence,length,life,na,ovary,position,reproduction,shape,stem,texture
692	wfo-0001031101	success	197	124	93	104	31	0.472	-1,-16,-20,-30,-5,-8,0.5-0.8,0.5-3,0.6-0.8,0.8-,1-,1-2,1-2.3,1.3-2,1/4-1/2,2-2.8,2-4,2-5,2-6,2.5-,2.5-3.8,3-15,3-8,3.5-4.5,4-10,6-10,8-15,abaxially,acuminate,anther,apex,apical,base,blade,bright,calyx,cm,connivent,diameter,dull,entire,equal,evenly,flattened-reniform,glabrescent,glabrous,glandular,green,hair,lateral,leaf,length,lobe,lobed,long,long-acute,margin,maturity,mauve,membranous,midpoint,minute,mm,moderately,obtuse,orange-brown,orange-red,ovate,pale,pedicel,peduncle,petiole,poricidal,ray,red,rounded,shrub,simple,smooth,sparsely,spherical,stellate,stellate-pubescent,stem,style,tapering,terminal,tip,tube,white,wide,yellow,young	/2,/2-equal,0.05-0.2,0.1-0.2,0.1-0.3,0.3-0.5,0.7-0.8,1-3,1.3-2.5,1.4-1.7,1.5-3,1/3-1/2,10-30,2.5-3.5,3-10,4-5-merous,4-7,4.5-9,5-20,5-6,abaxial,adaxial,almost,alyx,ame,apar,apically,apparently,articulated,ba,bark,berry,branched,c.,concolorous,deltate,difoliate,drying,eaf,eed,elongating,erect,filament,filiform,flower,free,frui,fruiting,geminat,green-brown,herbaceous,infructescence,long-acuminat,longer,lower,mature,multangulate,narrow-deltate,near,nflorescence,often,older,one,open,orolla,oung,pair,pendulous,per,perfec,pericarp,porrect,portion,primary,red-brow,resembling,ruit,scandent,scar,sessile,spaced,spreading,stalk,stalked,stellate-pubescen,straight,surface,tamen,terete,tertiary,time,trichome,umbel,unarme,unarmed,unit,variously,vary,vein,venation,visible,way,yellow-green,ympodial	adhesion,arrangement,climate,colour,corolla,form,fruit,growth,height,history,inflorescence,life,na,number,ovary,perennial,perfect,plant,position,presence,present,pubescence,red-brown,reproduction,seed,shape,size,staman,stigma,stipe,texture
693	wfo-0001031114	success	208	115	85	123	30	0.409	.2,0.3-0.5,0.5,0.7-1.5,0.8-1.2,1-10,1-2,1-7,2-17,2-3,2-4,2-7,2.5-3,3-10,3-4,4-10,4-8,4.5-6,5-10,abaxially,acuminate,acute,anther,apex,base,becoming,blade,brown,calyx,chartaceous,cm,connivent,densely,diameter,elliptic-ovate,entire,equal,first,flattened,fruit,globose,green,hair,leaf,leaf-opposed,light,lobe,margin,membanaceous,midpoint,mm,oblong,outline,ovate,pedicel,peduncle,petiole,pubescent,purple,ray,reniform,ripe,rounded,rugulose,shrub,simple,small,sparsely,stellate,stellate-pubescent,stem,stigma,strongly,style,subcoriaceous,subcuneate,surface,tree,truncate,tube,white,white-pubescent,x,yellow,yellowish	.1,.5,0-0.3,0.5-1,1-1.5,1-4.5,1-8,1.5-2.5,1.5-4,10-15,2/3,25-50,3-5,3-7,4-5,5-8,5-merou,6-7,7-15,absen,accrescent,adaxiall,adaxially,ag,alyx,apart,apparently,articulated,axe,ba,berry,branched,capitat,covering,cylindrical,dark,deltate,differentiated,directed,discolorous,distal,distally,dried,eaf,echinoid,eed,erect,especially,filament,fleshy,flower,free,frui,fruiting,geminate,glabrous,highly,homostylous,impressed,interpetalar,introrsely,juic,lacking,large,like,long,long-stalked,longitudinal,lower,major,minor,multangulate,nearly,nflorescence,nodding,obtuse,often,one,opening,orolla,paired,part,perfect,pericarp,plurifoliate,pore,porrect,prominent,rachi,ruit,sessile,short,short-,short-stalked,side,slightly,slit,somewhat,spaced,stalk,ste,straight,subcucullate,subtending,tall,tamen,tem,thickened,thin,time,tip,tissue,toward,triangular,unarme,unit,vary,vein,white-stellate,whitish,wide,without,ympodial	adhesion,arrangement,capitate,climate,colour,corolla,form,glandular,growth,height,history,inflorescence,length,life,na,number,ovary,perennial,plant,position,presence,pubescence,reproduction,seed,shape,size,staman,stipe,texture,ye
694	wfo-0001031116	success	191	108	79	112	29	0.414	.5,.8,/4,0.3-0.5,0.7-1,1-5,1/2,10-14,15-25,2-5,2.7-3.2,3.5-4,4-7,8-11,abaxially,acuminate,anther,apex,base,berry,blade,calyx,caudate,cm,densely,diameter,dirty-white,dull,elliptic,erect,evenly,flattened-reniform,fruit,glabrescent,green,hair,lateral,leaf,length,lobe,lobed,long,margin,maturity,mauve,membranous,midpoint,mm,moderately,obovate,obtuse,orange-brown,orange-red,pedicel,peduncle,petiole,poricidal,ray,rounded,sharply,shortly,shrub,simple,small,spherical,stellate,stellate-pubescent,stem,style,subentire,tapering,tip,tree,tube,upper,way,wide,yellow,young	-10,.2,0,0.05-0.15,0.1,0.4-0.7,0.7-0.9,1,1/3-2/,1/6-1/4,30-100,30-50,4-10,5,5-15,5-merous,9-13,abaxial,adaxial,almost,alyx,ame,apar,apart,apically,apparently,arachnoid,articulated,attenuate,bark,branching,bristle,broad-deltate,brow,c.,clearly,collapsed,connivent,discolorous,drying,eaf,eed,elongated,elongating,epidermi,equal,filament,flat,flexuous,flower,fragile,free,fruiting,glabrous,glaucous-green,infructescence,less,longer,lower,mature,minute,multangulate,narrow-deltate,nflorescence,obtu,often,older,one,open,orolla,oung,pair,per,perfec,pericarp,perpendicular,plurifoliat,portion,primary,recurved,red-brown,reflexed,ruit,scar,secondary,sessile,single,slender,smooth,soft,sometimes,spaced,sparsely,stalk,stalked,straight,surface,tamen,terete,tertiary,time,trichome,unarme,unarmed,unit,vary,vein,venation,visible,weakly,woody,ympodial	adhesion,arrangement,climate,colour,corolla,form,glandular,glaucous,growth,height,history,inflorescence,life,na,number,ovary,plant,position,presence,present,pubescence,reproduction,seed,shape,size,staman,stigma,stipe,texture
695	wfo-0001031127	success	196	114	91	105	23	0.464	+,0.5,0.5-1,0.5-1.3,0.8-2,1,1-1.5,1.5-2,1.5-2.5,1.5-3,2,2-3,2-lobed,3-4,3-5,3.5-4,3.5-7,4,6-6.5,7-30,8-16,abaxially,acute,adaxially,almost,anther,apex,attenuate,base,calyx,capitate,chartaceous,cm,conical,corolla,deep,densely,diameter,elliptic,elongate,flattened,flower,fruit,glabrous,globose,growth,inflorescence,internodal,lanceolate-elliptic,leaf,lobe,lobed,long-styled,margin,membranous,mm,number,opposite,ovary,pale,pedicel,peduncle,pentagonal,petiole,pinnatifid,poricidal,prickly,pubescent,purple,ray,red-violet,reniform,shallowly,shiny,short-styled,shrub,simple,somewhat,sparsely,stellate,stem,stigma,style,surface,tan,tapering,thin,tip,tube,x,yellowish	-2,.5,0.3-0.4,0.4-1.5,0.5-3,0.8-1,1-5-2,12268,3/4,30-100,5,5-8,8,?,acicular,anthesi,apar,apparently,armed,articulated,bark,berry,brown,cell,cupuliform,eaf,eed,ekman,ellipsoid,elongating,equal,even,extremely,fide,filament,free,fruiting,heterostylous,hyaline,included,individual,lamina,like,linear,long,long-triangular,lower,m.,midpoint,midrib,minute,minutely,near,new,nflorescence,nodding,older,open,outline,pair,papillat,per,pericarp,pitted,planar,plurifoliat,pore,porrect,portion,prickle,primary,prominent,rectangular,reddish,reduced,relatively,rest,ruit,scar,scattered,sessile,shin,short-stalked,sinuate,sinus,slightly,slit,sometimes,spaced,spreading,stout,testal,time,trichome,ud,unit,upper,variable,vein,way,widely,woody,yellow,ympodial,½	adhesion,arrangement,blade,colour,form,height,history,length,life,na,plant,position,presence,present,pubescence,reproduction,rugulose,seed,shape,size,staman,stipe,texture
696	wfo-0001031128	success	213	118	91	122	27	0.427	-100,-4.5,-6.5,/4,0.5-0.7,0.5-1.5,0.6-1,0.8-1.7,1-,1.5-3,1.5-3.5,2-5,2-9.5,2.3-,20-60,3-4,3.5-4.5,5-19,8-23,abaxially,anther,apex,base,berry,blade,calyx,cm,cuneate,densely,diameter,dull,elliptic,entire,equal,erect,evenly,flattened-reniform,fruit,glabrescent,glabrous,glandular,green,hair,inflorescence,lateral,leaf,length,lobe,lobed,long,long-acuminate,margin,maturity,mauve,membranous,midpoint,minute,mm,moderately,near,orange-brown,pale,pedicel,peduncle,petiole,poricidal,purple-black,ray,red,shallowly,short-attenuate,shrub,simple,smooth,spherical,stellate,stellate-pubescent,stem,style,surface,tapering,terminal,tip,trichome,tube,undulate,way,white,wide,yellow,young	-10,0,0-30,0.05-0.2,0.05-0.25,0.2,0.2-0.4,0.3-0.8,0.5-0.8,0.5-5,1,1-1.6,1.2-2,1/,1/6-1/3,10-20,10-35,2.5-10,2.5-3.5,20-50,4-5-merous,4-7,5-,5-15,5-30,8-12,abaxial,acute,almost,alyx,apar,apart,ape,apically,apparently,articulated,bark,branched,branching,bristle,brown,concolorous,connivent,deltate,drying,eaf,eed,elongated,elongating,eye,filament,filiform,flexuous,flower,free,fruiting,gland,gra,infructescence,less,lon,long-acuminat,longer,lower,mature,multangualte,multangulate,naked,narrow-deltate,nflorescence,occasionally,often,older,one,open,orolla,oung,pair,per,perfect,pericarp,perpendicular,plurifoliat,portion,primary,recurved,red-brown,reduced,reflexed,ruit,scar,secondary,sessile,short-styled,side,single,soft,spaced,spreading,stalk,stalked,staminate,straight,tamen,terete,tertiary,time,unarme,unarmed,unit,usually,variously,vary,vein,venation,visible,weakly,whitish,woody,yellow-brown,yellow-green,ympodial	adhesion,arrangement,climate,colour,corolla,form,growth,height,history,life,na,number,ovary,perennial,plant,position,presence,present,pubescence,reproduction,seed,shape,size,staman,stigma,stipe,texture
697	wfo-0001031135	success	189	157	121	68	36	0.64	0-2,0.7-2,1-,1-1.5,1-10,1-3,1-4,1.5-2,1.5-3,10-20,2,2-,2-2.5,2-23,2-3,2-3.5,2-4,2.5-28,3-10,3-4,3-5,3.5-12,4-5,5-30,5-9-pinnate,abaxially,acuminate,adaxially,adpressed,along,also,apart,apex,articulated,basal,base,basiscopically,blade,calyx,campanulate,cm,compound,cordate,cuneate,cylindrical,darker,decurrent,deflexed,densely,diameter,dilated,distally,eglandular-pubescent,ellipsoidal,elliptic,entire,especially,fading,flattened,frequently,fruit,fusiform,glabrous,glandular-,green,hair,lateral,leaf,leaflet,leaving,light,lobe,lobed,long,longitudinal,margin,midrib,mm,moderately,obconical,oblique,oblong,often,ovate,ovoid,papillose,pedicel,pedicellar,peduncle,peltiform,petiole,pilose,pink,pinnately,pinnatifid,puberulent,pubescent,purple,remnant,ripe,shrub,simple,spaced,sparsely,stigma,stripe,strongly,style,subcoriaceous,toward,tree,truncate,tube,unlobed,upper,violet,white,whitish,x,yellow-green,yellowish	-7,0.5-2,1-2.5,1.5-9,2-5,4-foliat,5-11,7-15,absent,acute,aggregate,ape,axe,beyond,biglandula,broad,cell,chartaceous,color,connective,coriaceous,deltate,directed,eaf,eed,ellipsoida,equal,exceeding,exserted,flower,interstitial,irregularly,laterally,lon,lower,narrowed,nflorescence,nther,obtuse,occasionally,orolla,perfect,pilo,pore,present,rachi,radiu,ruit,shorter,slightly,small,smaller,stamen,stone,tal,tem,thecae,time,tip,tomento,triangular,ud,unbranched,unit,unknow,vary,wide,ympodial	adhesion,anther,arrangement,biglandular,climate,colour,corolla,form,glandular,growth,height,history,inflorescence,length,life,midpoint,na,number,ovary,plant,position,presence,pubescence,ray,reproduction,rugulose,seed,shape,size,staman,stellate,stem,stipe,surface,texture,tomentose
698	wfo-0001031143	success	217	134	81	136	53	0.373	2,3,4,acute,anther,apex,attenuate,base,blade,broadly,cm,densely,diameter,elliptic,entire,evenly,extra-axillary,flattened-reniform,flower,free,fruit,glabrescent,glabrous,globose,green,hair,interpetalar,irregularly,lateral,leaf,length,like,lobe,margin,maturing,midpoint,minute,minutely,mm,moderately,narrowly,near,nearly,often,ovate,pale,pedicel,peduncle,per,petiole,pitted,ray,repand,sessile,shallow,shrub,side,simple,slender,smooth,soon,stellae,stellate,stellate-tomentose,stem,stigma,stipe,style,subcordate,surface,thick-chartaceous,tissue,truncate,tube,usually,weak,well-developed,white,yellow,yellow-orange,×	0.3–0.5,0.3–0.8,0.4–0.8,0.4–1,0.7–0.9,0.9–1,0–50,1.1–2,1.4–1.7,1.5,1.5–1.9,1.5–2.5,1.5–3,1.5–5.5,10,10.5–11,15–23,1–1.2,1–1.5,1–4,2.3–2.5,2.5,2.5–4,2.5–4.5,2–2.5,2–3,2–3-branched,2–9,3–3.5,4–8-rayed,5,5-merou,5–7,6–8,7–12,8–10,9,abaxially,acicular,adaxially,alyx,apart,apical,apparently,appearing,armed,articulated,axe,ba,berry,bifoliate,blad,branch,broad,broad-based,bud,capitat,contrast,dark,directed,distall,dried,eaf,eed,except,fertile,filament,filiform,finely,forming,geminat,glabrou,half,high,homostylous,immature,internode,lanceolate,large,layer,leaving,lon,long,lower,major,material,midrib,midvei,midvein,minor,mixed,mostly,much,nflorescence,oblong,orolla,overlapping,ovoid,pore,porrect,potentially,prickle,principal,rarely,remaining,ruit,set,several,short-caudate,shorter,sinus,spaced,splitting,stellate-tomento,stipitate,straight,tamen,tardily,tem,time,tip,tomentum,ud,unarme,unarmed,various,vary,vein,wide,yellow-ferruginous,ympodia,–11,–2.5,–4,–4.5,–8	0.3-0.5,0.3-0.8,0.4-0.8,0.7-0.9,1-1.2,1-1.5,1-4,1.1-2,1.4-1.7,1.5-1.9,1.5-2.5,1.5-3,15-23,2-3,2.3-2.5,2.5-4.5,3-3.5,4-8,4.5,6-8,7-12,8,8-10,adhesion,arrangement,calyx,capitate,climate,colour,corolla,form,glandular,growth,height,history,inflorescence,life,na,number,ovary,perennial,plant,position,presence,present,pubescence,reproduction,rugulose,seed,shape,size,staman,texture
699	wfo-0001031144	success	231	108	94	137	14	0.407	-13,.2,.5,0.2,0.8-1.4,1-4,1.1-2.5,2-3,2.5-3,25,3-7,3.5-10,4-4.5,6,7-10,<,acuminate,acute,adaxially,anther,apex,asymmetric,base,berry,bright,broadly,brown,calyx,capitate,cm,commonly,cordate,corolla,densely,diameter,divaricate,ellipsoid,elliptic,entire,filament,flattened-reniform,form,glabrous,globose,groove,growth,inflorescence,leaf,less,lobe,lobed,margin,membranous,minute,minutely,mm,new,oblique,occasionally,pale,pedicel,peduncle,petiole,pinnately,pinnatifid,pitted,pubescent,red,reddish,seed,shiny,simple,slightly,sparsely,stellate-rotate,stem,stigma,style,surface,tan,terete,tiny,triangular,trichome,truncate,tube,uniseriate,usually,vine,violet,woody,x,yellow,yellowish	-11,0.5,1-,1-1.5,100,2,2-,2-6,2-9,2/3,3-4.5,4,4-20,4-6,5,5-9,5-merou,ag,alyx,anthesi,apart,apicula,apiculae,appearing,ark,around,articulated,away,axi,basal,basiscopically,blac,branch,branche,brow,cell,closer,connivent,corresponding,cupped,curved,drying,eaf,eed,elongate,elongating,exserted,extending,flattened,flower,four,free,fruiting,geminat,ilament,inflated,irregularly,lamina,larger,later,lateral,leaflet,leaving,lengthening,like,long,longer,longest,loosely,lower,many,markedly,mere,near,nflorescence,number,often,older,one,open,orolla,outline,pair,papillo,peg,pendant,pentagonal,per,perfect,pericarp,plurifoliate,pore,poricidal,portion,primary,progress,quite,rim,ripe,ruit,scar,sleeve,slit,small,smaller,sometimes,spaced,spreading,strongly,tangle,tem,terminal,testal,thin,third,tip,together,tuft,twinin,twining,two,ud,unequal,unit,upper,variable,vary,vein,wall,way,weight,white,widest,wing,wood,ympodial,½	-,abaxial,adaxial,arrangement,bark,branching,colour,fruit,length,ovary,pubescence,shape,size,texture
700	wfo-0001031152	success	232	133	107	125	26	0.461	-1.5,-10,.4,/100-1/16,0.2-0.3,0.2-1.5,1-3,1-6,1.1-2.2,1.1-3,1.2-1.8,1.3-4,1.4-2.6,1.5-3,11,13-27,2-5,2.5-7.5,2.7-3.7,3.7-7,4-19,4-6,4-8,8-20,abaxially,adaxially,anther,apart,base,becoming,blade,blunt-tipped,brown,bullate,calyx,cm,conical,continued,corolla,deltoid,densely,diameter,due,flower,fruit,globose,granular-tomentose,greenish,growth,hair,honeycombed,inserted,lanceolate,lateral,lavender,leaf,length,lilac,lobe,long-,mixed,mm,mostly,multangulate,oblanceolate,oblong,pale,pedicel,peduncle,persistently,petiole,pitted,porrect-stellate,probably,pubescent,rather,reddish,reniform,reticulate-punctate,ripe,rotate-stellate,scabrous,sessile,short-,shrub,simple,sparsely,stellate-pubescent,stem,stigma,style,suborbicular,surface,terete,terminal,testa,thick-stalked,thin-,tomentose,tree,tube,variously,violet,x,yellow,yellowish,young	-5.5,0-100,0.3-1.3,0.3-3,1-1.5,1.5-3.5,1/2-2/3,1/2-3/4,2.7-4.5,2.7-6,2.8-4,4-7,5-6,6.5-10,9-13,accrescent,acuminate,acute,ag,along,anthesi,apex,apical-lateral,apparently,articulated,attenuate,axe,axillary,ba,basal,berry,blister,branch,branched,bud,capitat,chartaceous,closely,decurrent,dehiscing,directed,eaf,earl,eed,entire,evident,exserted,extend,few-rayed,filament,fleshy,free,fruiting,glabrescen,glabrous,green,high,introrse,lackin,large,less,lobed,long,longer,longitudinal,lower,m.,main,margin,midvein,moderately,multangulat,narrowly,nearly,nflorescence,obtuse,occasionally,one,open,openly,orbicular,orolla,ovate,partly,perfect,plurifoliate,pore,rachi,ray,reddish-brown,relatively,ruit,runk,short-stalked,side,slightly,slit,somewhat,soon,spaced,sparingly,splitting,stamen,stelliform,stipitate-glandular,stout-stalked,strongly,suture,swelling,tamen,thick,thin,thin-stalked,time,touching,toward,unarme,unarmed,unit,usually,vary,vein,way,wide,ympodial	.3-3,abaxial,adhesion,arrangement,capitate,colour,form,glabrescent,height,history,inflorescence,life,ovary,perennial,plant,position,pubescence,reproduction,rugulose,seed,shape,size,sparing,staman,texture,unknown
701	wfo-0001031155	success	193	113	83	110	30	0.43	0.2,0.5,1-1.2,1-1.5,1.5,1.5-2,1.5-5,2-5,2.5-3.2,4-,4-6,4.5-7,7-15,8.5-13,abaxially,acuminate,acute,almost,anther,apex,base,beneath,bilobed,calyx,climbing,cm,corolla,cream,dark,deeply,densely,diameter,elliptic,evenly,glabrous,glandular,growth,height,inflorescence,internodal,lanceolate,leaf-opposed,like,lobe,lobed,margin,midpoint,minutely,mm,multangulate,oblique,obtuse,orange,pedicel,peduncle,petiole,poricidal,prickly,pubescent,ray,shallowly,shiny,shrub,simple,size,slightly,sparsely,stellate,stem,stigma,strongly,style,surface,tapering,terminal,tip,trichome,tube,unknown,white,whitish,x,yellowish	.5,0,0.1,0.2-1.2,0.3-0.4,0.7,0.7-1.5,1,1.5-1.6,3-4-foliate,5-20,5-7,adaxially,age,along,anthesi,apart,apparently,appearing,armed,articulate,axi,bark,broader,bullate,cell,central,closely,common,cup-shaped,deltate,discolorous,distall,distally,due,eaf,echinoid,eed,enlarged,equal,exserted,ferrugineous,filament,fine,flower,glabrescen,globose,halfway,heavily,heterostylous,hub-like,intertwined,know,known,larger,leaving,lengthening,long,longer,los,lower,midrib,mixed,mixture,multiseriate,narrowly,new,nflorescence,occasionally,older,once-branched,open,outline,pair,pale,papillat,part,peg,plurifoliate,pore,porrect,prickle,primary,principal,purple,reddish,ruit,scar,seen,sessile,short-stalked,short-styled,small,somewhat,spaced,sparse,sparser,split,stalk,stout,straight,tan,ud,unevenly,unit,variable,vein,widely,within,ympodial	10,8,adhesion,arrangement,blade,climate,colour,form,fruit,hair,history,leaf,length,life,na,number,ovary,papillate,plant,position,presence,present,pubescence,reproduction,rugulose,seed,shape,staman,stipe,texture
702	wfo-0001031162	success	241	129	101	140	28	0.419	.5,0.1-0.15,0.15-0.4,0.4-0.8,0.5-0.7,0.5-0.8,0.5-1.5,0.7-5,0.8-1.2,1-1.5,1-2,1-5,1.5-2,1.5-2.5,1.5-3,1.7-4.5,2-2.8,3-10,3.5-10,3.5-5.5,4-6,4-8,5-10,5-7,7-17,7-9,8-14,abaxially,acute,adaxially,angled,anther,apex,base,black,blade,broadly,calyx,chartaceous,cm,cordate,cylindrical,deeply,densely,diameter,eglandular,erect,extra-axillary,flower,fruit,glabrous,gland-tipped,globose,green,hair,inflorescence,interpetalar,irregularly,lanceolate,leaf,length,lobe,lobed,long,margin,midpoint,minutely,mm,moderately,obtuse,outline,ovate,pale,pedicel,peduncle,perennial,petiole,present,pseudohair,pubescent,purple,ray,reniform,reticulate,rhizomatous,short,shrub,simple,sparsely,stellate,stellate-pubescent,stigma,style,surface,tan,thick,throughout,tissue,tube,x,yellow	%,-74,0,0-1.2,0-1.5,0-2.5,0-25,0.05-0.1,0.1-0.2,0.1-0.8,0.25,0.5-2,0.5-3,0.5-7,0.6-0.8,0.7-1.2,1-1.7,1-10,1-13,1-15,1-locular,1.2-1.4,1.5-1.9,1.5-8,10,10-12,10-30,15-20,2-,2-7,2-foliate,20-40,26-,3-4,3-branched,35-200,4-5,4-9,5-6,5-merou,6,6-7,6-8,60,600-1400,7-70,absent,accrescent,acicular,across,adult,alyx,apart,apparen,armed,articulated,ascending,attenuate,axe,ba,branch,branche,capitat,connivent,decimetre,deltate,directed,distall,distributed,dm,eaf,eed,exocarp,filament,finger,fruiting,geminat,generally,half,homostylous,incomplete,index,juicy,juvenile,lamina,lateral,less,lobing,lon,longer,lower,mature,mesocarp,mid-point,midvein,minute,moderate,narrow,nflorescence,oblique,orolla,pair,part,pendant,per,perfect,placenta,pore,porrect,presen,prickle,rachi,ruit,septum,sessile,side,somewhat,spaced,sparse,stalk,stellae,straight,succulent,tal,tamen,tem,time,tissu,transparent,triangular,unbranched,unit,upper,vary,vein,white,wide,wing,yellowish,ympodial	adhesion,arrangement,capitate,climate,colour,corolla,form,glandular,growth,height,history,life,na,number,ovary,plant,position,presence,pubescence,reproduction,rugulose,seed,shape,size,staman,stem,stipe,texture
703	wfo-0001031178	success	167	110	81	86	29	0.485	0-0.2,0-0.25,0-5,0.3-0.6,0.6-0.9,0.6-1,0.7-1.7,0.8-1.2,0.9-1.2,1.2-1.4,1.2-1.5,1.5-5.2,2-3.5,3.5-9,4-4.5,4-9,5-11,6-14,7-8,7.5-8.5,absent,acute,adaxially,anther,apex,articulated,base,blade,brown,calyx,chartaceous,cm,cuneate,densely,diameter,entire,erect,extra-axillary,flower,fruit,glabrous,globose,green,grey,hair,inflorescence,lanceolate,lateral,length,lobe,lobed,long,margin,midpoint,mm,oblique,ovate,part,pedicel,peduncle,perennial,petiole,present,purple,ray,rhizomatous,rusty,shallowly,shrub,simple,sparsely,stellate,stellate-pubescent,stem,style,thick,time,tube,unknown,x,yellow	%,0-0.4,0-0.6,0-10,0-6,0.1-0.2,0.1-0.25,0.4-0.6,0.6-1.2,0.7-1,1-2,1-3,1-4,1.2-3.4,1.5-6,11-18,180-400,19-30,2-5,40-65,5-merou,6-8,7-11,abaxially,accrescent,acicular,across,adaxiall,alyx,apart,armed,ascending,attenuate,axe,ba,cylindrical,d.,directed,distall,distributed,dult,eaf,eed,eglandular,finger,fruiting,glabrou,gland-tipped,half,hig,juic,lamina,lon,longer,lower,mature,mesocarp,midvein,minute,moist,nflorescence,orolla,per,pore,porrect,presen,prickle,pseudo-racemose,ruit,short,solitary,spaced,stage,stalk,stellae,straight,tamen,throughout,unbranched,unit,unknow,uvenile,vary,vein,wide,ympodial	adhesion,arrangement,climate,colour,corolla,form,glandular,growth,height,history,leaf,life,na,number,ovary,plant,position,presence,pubescence,reproduction,rugulose,seed,shape,size,staman,stigma,stipe,surface,texture
704	wfo-0001031185	success	213	127	104	109	23	0.488	-10,-8,.5,0.5-1.5,0.5-3,0.8-1,0.9-,1,1-,1-1.2,1-1.5,1-5,1.2-5,2-9,2.5-16,3-4,4.5-7.5,7-10,acuminate,acute,anther,apex,attenuate,base,blade,bright,broadly,brown,calyx,capitate,cm,conical,connivent,corolla,deeply,densely,diameter,dry,ellipsoid,entire,eye,flattened,glabrous,globose,green,growth,inflorescence,lateral,lax,leaf,living,lobe,lobed,long,loosely,margin,material,meter,minutely,mm,moderately,ovate,pale,papillate,pedicel,peduncle,petiole,pinnatifid,pitted,pubescent,red,reniform,ripe,rounded,seed,several,shape,shiny,shrub,simple,size,slightly,sparsely,stellate,stem,stigma,style,surface,tan,terminal,thin,tip,trichome,truncate,tube,uniseriate,vine,violet,white,whitish,wide,woody,yellow,yellowish	.2,0.5,0.8-1.3,1-10,1-4,1.5-4,10-40,2/3,20,4-6,5-merou,>,ag,alyx,anthesi,apart,apically,appearing,appressed,ark,articulated,away,axi,basal,berry,branched,cell,closer,commonly,curved,deltate,distal,eaf,eed,elongate,exserted,extremely,filament,flower,free,fruiting,glabrescen,ilament,inflorescenc,irregular,irregularly,leaving,lengthening,like,lobbing,lon,lower,many,materia,mature,midrib,new,nflorescence,older,onto,open,orolla,outline,pair,part,particularly,peg,per,perfect,pericarp,plurifoliat,pointing,pore,poricidal,portion,reflexed,ruit,scar,sinus,slender,slit,small,spaced,spreadin,spreading,still,strongly,tem,thickened,third,time,toward,ud,ultimate,unit,upper,usually,variable,variously,vary,visible,wall,way,weak,widest,winged,within,ympodial,½	adhesion,arrangement,climate,colour,form,fruit,glandular,hair,height,length,midpoint,na,number,ovary,plant,position,presence,pubescence,ray,rugulose,staman,stipe,texture
705	wfo-0001031195	success	216	121	95	121	26	0.44	0-0.7,0.2-0.5,0.25-0.35,0.3,0.5-1,0.6-0.8,0.6-1.5,1,1-1.5,1.4-1.6,1.5-2.5,11-28,2-2.5,2.5-4,20-32,3-3.5,3.5-4,3.5-5.5,4-7,5-9,5.5-10,7-8,7.5-8,abaxially,absent,acute,adaxially,anther,apex,base,blade,broadly,calyx,center,chartaceous,cm,cuneate,deeply,densely,diameter,distal,ellipsoidal,entire,extra-axillary,finely,flattened,flower,fruit,glabrous,gland-tipped,globose,green,grey,hair,half,inflorescence,leaf,length,lobe,lobed,margin,midpoint,mm,moderately,narrowly,obtuse,ovate,pale,pedicel,peduncle,perennial,petiole,plant,present,prostrate,purple,ray,reticulate,rusty,shallowly,short,shrub,simple,sparsely,stellate,stellate-pubescent,stigma,stoloniferous,style,surface,tube,whitish,x,yellow,yellowish-green	%,0-3,0-8,0.05-0.3,0.2-0.4,0.3-0.4,0.5-0.7,0.6-3,1-2,1-4,1-locular,1.4-2.9,10-13,10-14,10-19,15-35,2,2-4,2-5,3-4,3-5,3-6,4-5,4-9,5-merou,6-10,8-9,9-15,absen,accrescent,acicular,across,alyx,andromonoecious,apart,articulated,attenuate,axe,ba,capitat,confined,connivent,cylindrical,d.,difoliate,directed,distall,distributed,eaf,eed,eglandular,exocarp,filament,filiform,finger,fruiting,functional,geminate,heterostylous,incomplete,interpetalar,irregularly,juic,lamina,lateral,less,long,longer,loosely,lower,mature,mesocarp,midrib,midvein,minute,moist,nflorescence,oblique,orolla,part,per,pore,porrect,presen,prickle,probably,pseudo-racemose,rachi,ruit,septum,sessile,solitary,spaced,sparse,splitting,stage,stellae,straight,tal,tamen,tem,thick,throughout,time,tip,tissu,tissue,transparent,triangular,unarme,unarmed,unbranched,unit,uvenile,vary,vein,weakly,white,wide,yellowish,ympodial	adhesion,arrangement,capitate,climate,colour,corolla,form,glandular,growth,height,history,life,na,number,ovary,position,presence,pubescence,reproduction,rugulose,seed,shape,size,staman,stem,texture
706	wfo-0001031202	success	198	116	84	114	32	0.424	0-1,0.5,0.6-1.1,0.8-1,1-1.5,1.5-2.5,15-40,2-3,2-8,2.5-3.5,2.5-4,2/3,3.5-4,6-25,9-20,acute,along,anther,apex,base,beneath,calyx,capitate,cm,cordate,corolla,densely,dia,fleshy,fruit,glabrous,globose,green,hard,inflorescence,later,lateral,leaf,lobe,lobed,margin,minute,minutely,mm,obovate,occasionally,opposite,ovary,overtopping,ovoid-reniform,pale,pedicel,petiole,plant,puberulent,pubescent,reddish-brown,sessile,shape,shaped,shoot,shrub,size,slightly,small,sparsely,stem,stigma,style,surface,tan,tear-drop,terminal,tip,tree,trichome,tube,uniseriate,variable,vein,way,white,woody,x	.1,.5,0-0.5,0.1-0.3,0.5-1,1-1.7,1-5,1.5-2,1.5-9,2.5-13,20-100-flowered,9-11,abrupt,accrescent,anthesi,apart,apiculate,axi,bark,berry,broadly,bud,completely,complex,condition,corky,cup-shaped,decurrent,deflexed,deltoid,differing,difoliate,distal,dry,due,eaf,edicel,eed,enclosed,erect,exserted,extremely,filament,flower,free,frui,fruiting,furcate,geminat,glabrate,golden,greenish-white,greyi,irregularly,large,like,live,lon,long,long-ellipsoid,long-styled,longer,lower,main,major,many,material,middle,minor,narrowing,nflorescence,occasional,often,older,one,orbicular,pair,paler,papillo,papillose,pitted,planar,pore,poricidal,portion,prominent,quite,raised,rounded,ruit,scar,scattered,short-styled,slender,spaced,specimen,straight,tall,tapering,thick,thickened,thicker,third,time,tub,ud,unit,usually,weight,whitish,widest,winged,ympodial,young	adhesion,arrangement,blade,climate,colour,diameter,form,glandular,greyish,growth,hair,height,history,length,life,midpoint,na,number,peduncle,perennial,position,presence,present,pubescence,ray,reproduction,rugulose,seed,staman,stellate,stipe,texture
707	wfo-0001031203	success	218	125	98	120	27	0.45	0-0.5,0.3-0.6,1-2,1.5-2.5,1.8-2.8,2-7,2.1-2.7,2.5-9.5,21-39,25-45,3-10,3.2-4,4-16,4-6.5,5-8,5-8.5,5.5-8,6.5-9.5,8-11,8-14,abaxially,acute,adaxially,almost,anther,apex,asymmetric,base,berry,blade,broadly,calyx,cm,coarsely,deciduous,deep,densely,dentate,diameter,erect,essentially,extra-axillary,first,flower,foveolate,fruit,glabrous,globose,greenish-white,hair,inflorescence,lanceolate,length,lenticular,lignescent,linear-lanceolate,lobe,margin,maturity,midpoint,minutely,mm,obtuse,often,orange-red,outline,ovate,ovoid,pedicel,peduncle,perennial,petiole,present,pubescence,rarely,ray,red,reniform-ovate,ripe,sericeous,simple,smooth,somewhat,sparsely,spreading,stellate,stellate-pubescent,stem,stigma,style,surface,thin-textured,truncate,tube,usually,white,x,yellow	-1.5,-2,.2,.7-1,0-0.8,0-2.5,0.05-0.15,0.05-0.2,0.1,0.1-0.8,0.3,0.4-1,0.5-1.8,1-3,1-5,1/10-1/4,11-18,15-22,15-50,2-3.5,2-5,2-foliate,4-12,4-6-locular,5-7,5-9,6-16,abaxiall,acute-tipped,adaxiall,along,apart,apparently,articulated,attenuate,axe,ba,campanulate,capitat,cinereous-tomentose,connivent,consisting,curved,cylindrical,deltoid,directed,distall,distributed,downcurved,eaf,eed,elongate,filament,flesh,geminat,interlobal,interwoven,invested,lateral,less,lon,long,longer,lower,lowermost,lying,major,midvein,much,nflorescence,numerous,obsolete,orolla,ovate-lanceolate,pair,parallel,per,perfect,plane,pore,prickl,projecting,prominent,rachi,reduced,relatively,ruit,sessile,short,short-stalked,shorter,side,sinus,smaller,spaced,stalk,stellae,stellate-pubescen,surfac,tal,tamen,tem,terete,termination,thickened,three,time,tip,tooth-like,unarmed,unbranched,unit,uppermost,upward,vary,vein,weakly,well-developed,wide,ympodial	adhesion,arrangement,capitate,climate,colour,corolla,form,glandular,growth,height,history,leaf,life,na,number,ovary,plant,position,presence,reproduction,rugulose,seed,shape,size,staman,stipe,texture
708	wfo-0001031207	success	219	121	91	128	30	0.416	-0.4,-11,-4,-7,-8,0,0.1-0.2,0.1-0.3,0.5-1,0.6-0.9,0.6-1.2,0.7-2,0.85-1.4,1.4-2,1.5-5,1/4-1/3,2-3,2.1-2.3,2.8-3,3-5,3.5-7,5-8,6-8,anther,apex,base,berry,blade,calyx,cell,chartaceous,cm,cordate,densely,diameter,dull,evenly,flattened-reniform,fruit,glabrous,gray,green,herb,lateral,leaf,length,lobe,lobed,long,margin,maturity,mauve,midpoint,mm,moderately,obtuse,orange-brown,outline,ovate,pale,pedicel,peduncle,petiole,pit,poricidal,raised,ray,red,scandent,shrub,simple,small,smooth,sometimes,spherical,spreading,stellate,stellate-pubescent,stem,style,subentire,surface,tapering,terminal,tip,tube,upper,white,wide,yellow,young	-1/2,-5,.1,/5,0-0.5,0-10,0-20,0.1-0.5,0.2,0.2-0.3,0.25-0.5,0.3-0.5,0.8,0.9-1.6,1,1-3,1-4,1-5,1/,1/3,1/3-equal,2-4,2.5-,5-merous,6.5-8,9,abaxially,acuminat,acute,alyx,ame,apar,apart,apically,apparently,articulated,bark,branched,bristle,bristly,broad-deltate,brow,c.,concolorous,curved,dark,difoliate,discolorous,distance,drying,eaf,eed,elongated,elongating,equal,erect,extending,eye,filament,filiform,flower,free,fruiting,geminat,gently,glabrescent,herbaceous,infructescence,lanceolate,less,like,longer,lower,mature,midvein,multangulate,naked,narrow-deltate,nflorescence,oblong,occasionally,older,one,open,orolla,oung,pair,pendulous,per,perfec,pericarp,perpendicular,persistent,porrect,portion,prickl,prickle,prickly,primary,reflexed,rounded,ruit,scar,sessile,shorter,side,spaced,stalk,stalked,straight,tamen,terete,tertiary,time,toward,trichome,unarmed,unit,usually,variously,vary,vein,venation,visible,way,weakly,yellow-green,ympodial	adhesion,arrangement,climate,colour,corolla,form,glandular,growth,hair,height,history,inflorescence,life,na,number,ovary,plant,position,presence,present,pubescence,reproduction,rugulose,seed,shape,size,staman,stigma,stipe,texture
709	wfo-0001031217	success	222	121	94	128	27	0.423	%,.5,0.1-0.3,0.2-0.3,0.25-0.4,0.25-1.3,0.3-0.4,0.3-1,0.35-0.6,0.5-0.75,0.6-1.8,1-1.5,1-2,1.5-4.2,13-21,2-2.5,2-3,2.5-4,2.6-3,3.5-4.5,4-11,5-12,5.5-7,6-8,7-17,abaxially,absent,acuminate,acute,adaxially,anther,apex,base,blade,brown,calyx,chartaceous,cm,connivent,cuneate,densely,diameter,elliptical,entire,erect,extra-axillary,flower,fruit,glabrous,gland-tipped,globose,green,hair,inflorescence,lamina,lanceolate,lateral,leaf,length,light,lobe,long,loosely,margin,mm,moderately,narrowly,ovate,pale,pedicel,peduncle,perennial,petiole,present,purple,ray,red,rhizomatous,scattered,shape,short,shrub,simple,sparsely,stellate,stellate-pubescent,stigma,style,surface,time,tube,violet,x,yellow	.5-2,0-0.1,0-3.5,0-5,0-6,0.1-0.2,0.15-0.25,0.3-0.5,0.4-0.7,0.5-3,0.8-4,1,1-20,1-4,1-locular,1.5-2,1.5-4,2-5,2-8,2-9,3-4,3-4.2,4-6,5-7,5-merou,6-12,7-8,7-9,9-10,absen,accrescent,acicular,across,adult,alyx,apart,apparen,articulated,axe,ba,borwn,branch,branche,broad-based,confined,contiguous,cylindrical,directed,distall,distributed,dm,eaf,eed,eglandular,elliptic,exocarp,filament,finger,fruiting,geminate,greenish-white,half,incomplete,interpetalar,juicy,juvenile,less,lobed,longer,lower,mature,mesocarp,mid-point,midpoint,midrib,midvein,minute,much,nearly,nflorescence,oblique,orolla,overlapping,pair,paired,part,pendent,per,perfect,placenta,plurifoliate,pore,porrect,prickle,pseudo-umbellate,rachi,reticulate,ruit,scarcely,septum,sessile,shallowly,smaller,sometimes,spaced,sparse,stalk,stellae,straight,succulent,tal,tamen,tem,thick,throughout,tissu,tissue,transparent,triangular,truncat,unarme,unarmed,unbranched,unit,upper,vary,wide,ympodial	adhesion,arrangement,colour,corolla,dioecious,form,glandular,growth,height,history,life,na,number,ovary,plant,position,presence,pubescence,reproduction,rugulose,seed,size,staman,stem,stipe,texture,truncate
710	wfo-0001031218	success	154	106	74	80	32	0.481	0.5-1,1-2,1-3,15-25,2-2.5,2-22,2-3,3,3-5,4-28,4-5,4-7,4-8,5-37,5.5-7,6-10,6-7,6-9,8-20,acuminate,adaxially,apex,base,branched,calyx,cm,cordate,dark,diameter,eglandular-pilose,ellipsoidal,entire,especially,flattened,fruit,glabrous,glandular,glandular-puberulent,globose,greenish-purple,hair,lanceolate,lavender,lobe,margin,minutely,mm,moderately,mottled,oblique,orange,ovate,ovate-elliptic,ovoid,pedicel,peduncle,petiole,present,puberulent,purple,ripe,simple,sometimes,sparsely,stellate,stigma,style,subcoriaceous,toward,tree,tube,violet,x,yellow	-5,0.5,1-4,10-19,2.5-3,3-14,4-foliat,40,40-100+,5-7,8-17,abaxially,acute,aggregate,apart,ape,apiculate,articulated,axe,basal,beyond,blade,cell,connective,connivent,coriaceous,cylindrical,densely,directed,distally,eaf,eed,eglandular,equal,exceeding,exserted,flower,glabrou,introrse,leaving,less,lon,long,lower,narrowly,nflorescence,nther,obtuse,orolla,papillo,pedicellar,perfect,pore,presen,pubescent,purpl,rachi,radiu,remnant,ruit,shorter,slightly,small,spaced,stamen,stone,succulent,tal,tem,thecae,time,tip,tomento,triangular,truncat,ud,unit,vary,wide,ympodial	abaxial,adaxial,anther,arrangement,colour,corolla,form,growth,height,hermaphroditic,history,inflorescence,leaf,length,life,na,ovary,papillose,perennial,plant,position,presence,pubescence,reproduction,rugulose,seed,shape,size,stem,surface,texture,truncate
711	wfo-0001031225	success	163	81	62	101	19	0.38	.5,0.2-0.75,0.7-6,0.75-1,0.8-1,1-1.5,1-5,2,2.5-3,3-9,3/4,5-6,7-9,9-16,along,anther,base,calyx,cm,corolla,dia,elliptic,glabrous,globose,green,growth,inflorescence,leaf,like,lobed,long,minutely,mm,opposite,ovary,ovate,ovoid-reniform,papillose,pedicel,petiole,pitted,plant,poricidal,pubescent,shape,shrub,size,small,stem,stigma,style,surface,tip,tree,trichome,tube,uniseriate,vein,way,white,x,young	.25,/3,0.1-0.75,0.2,0.5,0.5-1,1-1.7,1-3,1.5-5,5-50-flowered,6-8,acute,anthesi,apart,apex,bark,beginning,berry,broadly,bud,characteristic,closely,conspicuous,cup-shaped,darker,decurrent,deltoid,differentiated,differing,difoliate,dry,eaf,edicel,eed,ellipsoid,erect,exserted,filament,flattene,fragrant,free,fruiting,furcate,geminat,glabrate,greyish-brow,inflorescenc,lateral,less,live,lobe,lon,lower,main,major,margin,middle,minor,minute,much,narrowly,nflorescence,often,older,one,outline,pair,pale,papillo,pore,portion,prominent,proximal,raised,red-papillose,reflexed,rest,rhomboidal,rounded,ruit,scar,shaped,slender,slightly,soon,spaced,specimen,straight,strongly,sweetly,swelling,tall,tan,tapering,tear-drop,ud,unevenly,unit,widest,woody,ympodial	0.25,colour,diameter,form,fruit,height,history,length,life,na,perennial,position,presence,pubescence,reproduction,rugulose,seed,stellate,texture
712	wfo-0001031231	success	175	115	83	92	32	0.474	-2,.5,0.5-1.5,1-1.5,1-2,1.5-2,2-3,2.5-3,3-4,37/2,37/3,4-8,5-7,8-10,absent,acuminate,acute,almost,anther,apex,aromatic,axillary,base,branch,brown,calyx,campanula,cm,colour,corolla,dark,discoidal,elliptic,entire,equal,erect,fork,glabrous,glandular,globose,green,greyish,hair,juvenile,lanceolate,leaf,len,less,lobe,long,loosely,marbled,margin,mauve,minute,mm,oblong,often,ovary,pedicel,peduncle,pentagonal,pinnatisect,plant,purple,rh,ripe,ripening,rotate,rounded,seed,short,shrub,simple,sometimes,stigma,stout,style,succulent,surface,tinged,violet,x	1-3,1-4,13,2-4,25-35,80-110,acumen,adherent,along,anthesi,aspect,axi,basal,becoming,berry,beyond,blunt,bluntly,branched,campanulate,cell,clonal,cluster,declinate,developed,dia,eaf,eed,ellipsoid,exceeding,except,exerted,expanded,facetted,filament,fleshy,flower,flowering,folded,general,gree,habit,herbarium,interacuminal,lasting,lengthening,lon,lower,mature,midrib,nflorescence,occasionally,pedice,pedicellate,petal,plurifoliat,pore,poricidal,projecting,rarely,readily,recurve,rugose-ruminate,ruit,sessile,several,shallow,shed,sinus,slightly,slit,small,soft,specimen,stone,stonrgly,tip,tissue,toward,translucent,triangular,tub,ud,unit,usually,variable,vigorous,well,without,wooded,year,ympodial	adhesion,arrangement,blade,climate,diameter,form,fruit,growth,height,history,inflorescence,length,life,midpoint,na,number,perennial,petiole,position,presence,pubescence,ray,reproduction,rugulose,shape,size,staman,stellate,stem,stipe,texture,tube
713	wfo-0001031252	success	170	87	61	109	26	0.359	0.2-1.5,0.3-1.1,1-3,1.3-1.9,1.75-5.2,16-33,2-3,2.5-7,2.8-3.6,3-10,3-6,5-17,5-8,5-9,5.5-6.5,anther,axillary,brownish,bud,clavate,cm,condition,coriaceous,corolla,dark,deep,diameter,drying,elliptic,fresh,fruit,glabrous,globose,green,greenish,herb,lanceolate,lobe,medium,mm,mottled,ovate,ovoid,pedicel,peduncle,petiole,plant,purple,rotate,seed,simple,stigma,stripe,style,subtending,terminal,tube,white,whitish,x,yellow	0.4-3,1-2,12-20,3-5,5-merou,7-18,abaxially,absent,acumen,acute,adaxiall,adaxially,ag,along,alyx,apart,apex,apparently,arranged,articulated,attenuate,axe,base,bead,berry,blade,capitat,cell,ciliate,connivent,covering,cuneate,digestion,distal,dorsally,eaf,edge,eed,entire,enzyme,erec,exceeding,filament,flat,flower,folded,forked,geminat,generally,glabrou,green-white,hair-like,hal,half,high,homostylous,honeycomb-shaped,interjected,lateral,leaflet,lengthening,light,like,linear,living,long,lower,make,margin,moniliform,mucilaginous,multiple,necklace,nflorescence,orolla,perfect,plurifoliate,pore,poricidal,removed,ripe,rounded,ruit,serrate,seudostipule,slit,sometimes,spaced,specimen,stamen,stolon,straight,tall,tamen,tem,testal,thick,throughout,tip,tri-,tuber,typically,unit,unwinged,usually,vary,wall,wet,ympodial	adhesion,arrangement,calyx,capitate,colour,form,growth,height,history,inflorescence,leaf,length,life,na,ovary,perennial,position,pubescence,reproduction,rugulose,shape,size,staman,stem,surface,texture
714	wfo-0001031257	success	206	108	72	134	36	0.35	-12,-22.5,-5,-6,0.7-1,0.75-2.5,1-1.3,1.1-1.2,1.5-1.7,10-16,2-4.5,3.5-5.7,4-4.5,5-8.5,7.5-9,abundant,acuminate,anther,anthesi,apex,attenuate,basal,base,blue-violet,bud,calyx,campanulate,cm,coarsely,corolla,cuneate,dark,dentate,diameter,ellipsoidal,flexuous,glabrous,glandular,globose,half,herb,leaf,length,light,lobe,long,margin,mm,non-glandular,ovate,patent,petiole,pubescent,purple,ring,robust,seed,serrate,shrub,simple,stem,stigma,striate,style,subglobose,trans-ovoidal,trichome,tube,white,within,x,yellow	0,0.4,0.5,0.5-0.8,1-1.2,1.5,1.5-2,1/10,11.5-15,2-,3,3.5-,4-10,4.5-,5,5-,6-12,6-celled,7-,8,8-celled,abaxially,accrescen,adaxially,ag,aggregate,antrorse,ascending,berry,bicellular,branch,broad,cell,coat,connectival,cotyledon,curved,cuticle,deep,densely,diamete,difoliate,directed,dorsally,eaf,edentate,eed,elliptical,embryo,endosperm,epidermal,erect,filament,finely,foliage,free,fruiting,geminat,hair-like,head,herbaceous,high,hollow,honey-combed,inconspicuous,inserted,lamina,lateral,like,little,lon,long-stalked,longer,longitudinal,longitudinally,lower,many-seeded,midvein,narrowly,odorles,opening,orolla,outward,pair,papillate,pericarp,pore,poricidal,portion,prolongation,rarely,reduced,ree,rest,ridged,ruit,saddle-shape,scarce,scarcely,secondary,separated,short-stalked,shorter,single-celled,sinus,slightly,slit,small,smooth,solitary,somewhat,spur-like,stalk,stone,strand,tem,thecae,thickened,thickening,time,tip,tooth,triangular,unequal,unit,upward,vary,vein,ventrifixed,verrucate,viscid,viscid-pubescen,wall,ympodial	4.5-12,adhesion,arrangement,blade,climate,colour,form,fruit,growth,hair,height,history,inflorescence,life,midpoint,na,number,ovary,pedicel,peduncle,plant,position,presence,pubescence,ray,reproduction,rugulose,saddle-shaped,shape,size,staman,stellate,stipe,surface,texture,viscid-pubescent
715	wfo-0001031270	success	234	151	123	111	28	0.526	+,.5,0.4-1.5,1,1-1.2,1-4,1.2-1.6,1.5,1/3,10,10-12,2-2.5,2-3,2-4,2-7,2.5-3,3-10,3-5,4-5,5,5-15,6-17,9-10,abaxially,acute,anther,anthesi,apex,base,beginning,bipinnatifid,blade,bright,brown,calyx,capitate,clavate,cm,conical,connivent,deeply,densely,depressed-spherical,diameter,elliptic,flower,glabrous,glandular,glandular-pubescent,green,growth,herb,inflorescence,later,lateral,leaf,leaf-opposed,length,like,live,lobe,lobed,long,long-styled,loosely,margin,membranous,midpoint,minutely,mixture,mm,obovate,ovoid,pale,pedicel,peduncle,petiole,pinnatifid,plant,poricidal,prickle,prickly,pubescent,ray,red,reddish,reniform,rest,ripe,rounded,scattered,sessile,shallowly,shining,short-stalked,short-styled,simple,size,slightly,sparsely,spherical,spreading,stellate,stem,stigma,straight,straw-colored,style,surface,tan,tapering,thin,tip,trichome,truncate,tube,uniseriate,way,white,wide,yellow,yellowish,½	0.5-1,1-3,1.5-2,100,2-20,3-20,5-10,5-6,5-merous,6-50,7-12,8,>,abaxial,accrescent,adaxial,adaxiall,along,alyx,apart,arme,articulated,associated,bark,basal,berry,brow,c.,cell,celled,colored,consistently,curved,differentiated,difoliate,directed,distal,eed,ellipti,entire,equal,erect,few-rayed,filament,free,frui,fruiting,geminat,gland,heavily,heterostylous,infructescence,investing,leafy,lon,longer,lower,midvein,minute,multangulate,multiseriate,narrowly,new,nflorescence,occasionally,often,older,orolla,oung,outline,pair,papillo,per,pericarp,pitted,pore,portion,primary,rachi,reflexed,ruit,scar,secondary,shallow,shrub,single,sinuate,slender,small,stalk,staminat,strongly,tall,tamen,terete,testal,thus,tightly,tissue,unit,upward,usually,vary,varying,vein,well,wice,wid,wing,woody,ympodial	adaxially,adhesion,arrangement,climate,colour,corolla,dioecious,form,fruit,hair,height,history,life,na,number,ovary,perennial,position,presence,present,pubescence,reproduction,rugulose,seed,shape,staman,stipe,texture
716	wfo-0001031283	success	52	51	33	19	18	0.635	-0.25,0.1-0.15,0.4-0.5,0.5-0.7,0.7,2.2-2.8,30-40,acute,apex,base,brown,calyx,cell,cm,diameter,hair-like,lateral,lobe,long,mm,narrowly,obovate,outgrowth,pale,pubescent,shrub,surface,testa,thick,wall,wide,winged,woody	.7-2.3,appearance,eed,elongating,erect,fide,fruit,give,lo,markedly,moore,pleasant,silky,small,smelling,somewhat,sprawling,spreadin,tall	1.7-2.3,colour,feature,form,growth,height,history,length,life,na,plant,reproduction,seed,shape,size,spreading,texture,width
717	wfo-0001031287	success	147	111	75	72	36	0.51	.5,0.5-1.5,0.9-1,1,1-1.2,1-1.5,1-5,1.5-2,1.5-5.5,2-2.5,3-4,4-5,4.5-5,5-14,6-7,abaxially,acute,adaxially,anther,apex,attenuate,base,bi-lobed,calyx,cm,corolla,dark,dendritic,densely,dia,divergently,elliptic,glabrous,globose,green,greenish-white,internodal,leaf,lobe,lobed,margin,minutely,mm,nearly,onto,ovary,ovoid-reniform,pale,papillose,pedicel,petiole,pitted,pore,poricidal,pubescent,red-papillose,rounded,shaped,shoot,short,shrub,stem,stigma,strongly,style,surface,tan,tear-drop,tip,trichome,tube,tuft,white,winged,x	1-1.3,3-5,4-6,6-10-flowered,anthesi,apar,ape,axil,bark,bearing,berry,branch,conical,connective,coriaceous,deflexed,deltate,difoliate,eaf,edicel,eed,ellipsoid,elongate,enlarged,erect,exserted,filament,fleshy,free,frui,fruiting,geminate,knob,lamina,later,lateral,lon,long,lower,main,many,membranous,middle,nflorescence,occasionally,older,pair,papillo,planar,plurifoliate,pointed,portion,reddish-brow,reflexed,ruit,scar,simple,sinus,small,somewhat,spaced,thick,thin,tub,ud,unevenly,unit,vein,widest,woody,ympodial,young	adhesion,arrangement,blade,climate,colour,diameter,form,fruit,glandular,growth,hair,height,history,inflorescence,length,life,midpoint,na,number,peduncle,perennial,plant,position,presence,pubescence,ray,reddish-brown,reproduction,rugulose,seed,shape,size,staman,stellate,stipe,texture
718	wfo-0001031300	success	219	113	82	137	31	0.374	-2.2,0.2-0.4,0.3,0.5-0.9,0.5-18,0.5-2,0.7-0.9,0.7-1.2,0.8-1.5,1-2,1.5-3.5,2-5.5,2.2-2.3,2.2-2.7,2.5-3.2,3-4,4,abaxially,acute,anther,apex,attenuate,base,berry,blade,calyx,chartaceous,cm,creeping,densely,diameter,dull,equal,flattened-reniform,fruit,glabrescent,glabrous,hair,lateral,leaf,length,lobe,lobed,long,margin,maturity,membranous,midpoint,mm,moderately,near,oblanceolate,orange,orange-brown,pale,pedicel,peduncle,petiole,poricidal,pubescent,rarely,ray,red,rounded,shrub,simple,smooth,sparsely,spherical,stellate,stellate-pubescent,stem,style,surface,tapering,tip,trichome,tube,white,wide,yellow,yellow-orange	-4,-5,-6,.5,/4,0-15,0-20,0-3,0-8,0.1,0.1-0.5,0.1-0.6,0.15-0.7,0.2-0.5,0.2-0.7,0.2-1,0.3-0.6,0.3-1.3,0.5-1.5,0.6-0.8,0.6-1,0.6-1.2,1-4,1-5,1.2-1.7,1.3-2,1/2-3/4,1/3-1/2,1/6-1/4,10-30,2-,2-3,2-4,2-6,3-,4.5-6,5-15,5-merous,6-8,absent,also,alyx,apar,apart,apically,apparently,articulated,ba,bark,branched,brow,brown-green,bulbous,caudat,cell,concolorous,connivent,curved,deltate,difoliate,distance,drying,eaf,eed,elongating,erect,extending,eye,filament,filiform,flattened,flower,free,fruiting,geminat,geniculate,gray-green,herbaceous,highly,infructescence,lon,longer,lower,mature,midvein,minute,naked,nflorescence,oblong,obtuse,older,one,open,orange-green,orolla,oung,outline,pair,pendulous,per,perfec,pericarp,pit,porrect,portion,prickl,prickle,prickly,primary,raised,reduced,ruit,scar,sessile,side,small,spaced,spreading,stalk,stalked,tamen,terete,tertiary,thin,time,uniradiate,unit,vary,vein,venation,visible,way,weakly,wider,winged,yellow-green,ympodial	adhesion,arrangement,climate,colour,corolla,form,glandular,growth,height,history,inflorescence,life,na,number,ovary,perennial,plant,position,presence,present,pubescence,reproduction,rugulose,seed,shape,size,staman,stigma,stipe,texture,unknown
719	wfo-0001031310	success	203	104	83	120	21	0.409	.5,1-2,1-3,1-6,1.5-4,15-40,2-3,2.5-8.5,3-10,4.5-4.8,5-6,5.5-21,6-7,abaxially,adaxially,along,anther,axillary,blue,blue-purple,brown,brownish,bud,chartaceous,cm,condition,corolla,diameter,drying,especially,fresh,fruit,glabrous,globose,green,greenish,hair,herb,lanceolate,leaf,less,light,like,lobe,long,membranous,midrib,minutely,mm,mottled,multicellular,odd-pinnate,ovate,ovate-elliptic,ovoid,pale,pedicel,peduncle,petiole,pilose,plant,puberulent,pubescent,purple,rotate,seed,simple,size,slightly,sometimes,somewhat,sparsely,stem,stigma,streak,style,subtending,terminal,tube,white,whitish,x,yellow	0-3,0-4,0.5-3,1-10,1-5.5,2.5-5.5,4-10,4-12,5-7,5-merou,absent,acumen,acuminate,ag,alyx,apart,apex,apparently,articulated,attenuate,axe,base,berry,blade,borne,broadly,caly,cell,ciliate,connivent,conspicuously,covering,cuneate,decreasing,decurrent,digestion,distal,dorsally,eaf,edge,eed,elliptic,end,enzyme,erect-decumben,exceeding,extremely,filament,flat,flower,folded,forked,geminat,generally,glabrou,gradually,green-white,hair-like,half,high,homostylous,honeycomb-shaped,interjected,larger,lateral,leaflet,lengthening,living,lower,make,margin,mucilaginous,narrowly,nflorescence,obtuse,orolla,ovate-lanceolate,pair,perfect,petiolule,plurifoliate,pointed,pore,poricidal,rachi,removed,rosette-forming,ruit,seudostipule,shortly,singly,slit,small,spaced,specimen,stamen,ste,stolo,straight,subellipsoi,subrosette-forming,tall,tamen,tem,testal,thick,throughout,tip,tissue,toward,tri-,tuber,typically,unit,unwinged,usually,vary,wall,wet,ympodial	adhesion,arrangement,calyx,colour,form,growth,height,history,inflorescence,length,life,na,ovary,perennial,position,pubescence,reproduction,shape,staman,subellipsoid,texture
720	wfo-0001031316	success	207	109	84	123	25	0.406	-2,0.05-0.15,0.3-1,0.5-2,0.8-1.2,0.8-1.8,0.9-1.3,1.3-3.5,1.5-3.5,2-3,2.5-8,3-8,3.5-3.8,3.8-5,4-7,5-10,5-15,5-8,abaxially,acuminate,acute,almost,anther,apex,base,blade,blue-mauve,bright,calyx,cm,cream,dark,densely,diameter,dull,entire,erect,flattened-reniform,fruit,glabrescent,glabrous,gray,green,hair,lateral,leaf,length,lobe,lobed,long,margin,marking,maturity,membranous,midpoint,mm,moderately,obtuse,orange,orange-brown,ovate,pale,pedicel,peduncle,petiole,purple,ray,red-brown,shrub,simple,sparsely,spherical,stellate,stellate-pubescent,stem,style,tapering,terminal,tube,unequal,white,wide,yellow,young	.1,/3,0.05-0.1,0.1-0.2,0.4-0.6,0.4-0.8,0.6-1,1-5,1.2-2.1,1.5-,1.5-2,1.5-5,1/3-1/2,1/3-2/3,2-20,2-4,3-10,4,4-9,5-6,5-merous,6-20,8-11,8-12,8-25,abaxial,adaxial,alyx,ame,apar,apically,apparently,articulated,bark,becoming,berry,branched,broad,c.,colored,concolorous,connivent,contrast,curved,difoliate,discolorous,drying,eaf,eed,elongating,eye,fifth,filament,flower,foliaceou,four,free,fruiting,geminat,glabrou,held,herbaceous,infructescence,inward,long-acuminat,longer,lower,lowermost,mature,minute,multangulate,naked,narrow-deltate,nflorescence,older,one,open,orolla,oung,pair,pendulous,per,perfec,pericarp,poricidal,porrect,portion,primary,red-brow,reflexed,ruit,scar,sessile,slender,smooth,sometimes,spaced,spreading,stalk,stalked,stellate-pubescen,strongly,surface,tamen,terete,tertiary,time,tip,trichome,unarme,unarmed,unit,usually,variously,vary,vein,venation,visible,way,white-green,whitish,yellow-green,ympodial	adhesion,arrangement,climate,colour,corolla,form,glandular,growth,height,inflorescence,na,number,ovary,plant,position,presence,present,pubescence,seed,shape,size,staman,stigma,stipe,texture
721	wfo-0001031333	success	194	109	77	117	32	0.397	+,.5,0.5,1-1.5,1-4,1-5,1.5,1.5-2,2,2.5-3,2.7-7,3-4,7-10,7-9,<,?,acuminate,acute,anther,apex,base,berry,bilobed,broadly,brown,calyx,capitate,cm,conical,densely,diameter,ellipsoidal,elliptic,entire,flattened,glabrous,globose,golden,green,greenish,growth,immature,inflorescence,lobe,margin,matte,membranous,minutely,mm,narrowly,ovate,pale,pedicel,peduncle,pentagonal,petiole,pitted,pubescent,pubescent-papillate,reniform,simple,somewhat,sparsely,stellate,stem,stigma,style,surface,terminal,thin,truncate,tube,vine,white,woody,x,yellow	0.1-0.5,1.2-2,1.5-1.7,1/2,2-3,3/4,30-40,5-7,5-8,5-merou,50,>,abaxially,adaxiall,adaxially,adjacent,ag,almost,alyx,anthesi,apart,appearing,ark,articulated,branche,branched,cell,clustered,collection,composed,crea,cupped,denser,eaf,eed,exserted,filament,flower,free,fruting,glabrescen,glabrescent,half,high,ilament,lamina,leaving,lengthening,less,like,lobed,long,lower,m.,many,mere,minute,near,new,nflorescence,nodding,occasionally,older,orolla,outline,pair,papillat,peg,penden,per,perfect,pericarp,planar,plurifoliat,pore,poricidal,portion,primary,quadrate,rest,rhachi,ruit,scar,sinus,slightly,slit,small,soon,splitting,ste,striped,strongly,tangled,tem,testal,thickened,time,tip,trailing,triangular,trichome,twining,ud,undersurface,undulation,unequal,unevenly,uniseriate,unit,upper,vary,vein,venation,way,whitish,yellowish,ympodial	adhesion,arrangement,blade,climate,colour,corolla,form,fruit,glandular,hair,height,history,leaf,length,life,midpoint,na,number,ovary,plant,position,presence,pubescence,ray,reproduction,rugulose,seed,shape,size,staman,stipe,texture
722	wfo-0001031333	success	194	108	76	118	32	0.392	+,.5,0.5,1-1.5,1-4,1-5,1.5,1.5-2,2.5-3,2.7-7,3-4,7-10,7-9,<,?,acuminate,acute,anther,apex,base,berry,bilobed,broadly,brown,calyx,capitate,cm,corolla,densely,diameter,ellipsoid,elliptic,entire,flattened,glabrous,globose,golden,green,greenish,growth,immature,inflorescence,lobe,long,margin,matte,membranous,minutely,mm,narrowly,ovate,pale,pedicel,peduncle,petiole,pitted,pubescent,pubescent-papillate,reniform,rotate-stellate,simple,somewhat,sparsely,stellate,stem,stigma,style,surface,terminal,thin,truncate,tube,vine,white,wide,woody	0.1-0.5,1-5-2,1.5-1.7,1/2,2,2-3,3,3/4,30-40,5-7,5-8,5-merou,50,>,abaxially,adaxiall,adaxially,adjacent,ag,almost,alyx,anthesi,apart,appearing,articulated,bark,branche,branched,cell,clustered,composed,conical,cream,cupped,denser,eaf,eed,exserted,filament,flower,free,fruiting,glabrescen,glabrescent,half,high,ilament,lamina,leaving,lengthening,less,like,lobed,lower,m.,many,mere,minute,near,new,nflorescence,nodding,occasionally,older,orolla,outline,pair,papillat,peg,penden,per,perfect,pericarp,planar,plurifoliat,pore,poricidal,portion,primary,quadrate,rest,rhachi,ruit,scar,sinus,slightly,slit,small,soon,spaced,splitting,striped,strongly,tangled,testal,thickened,time,tip,trailing,triangular,trichome,tub,twinin,ud,undersurface,undulation,unequal,unevenly,uniseriate,unit,upper,vary,vein,venation,way,whitish,yellowish,ympodial	0.5-1,adhesion,arrangement,blade,climate,colour,form,fruit,glandular,hair,height,history,leaf,length,life,midpoint,na,number,ovary,plant,position,presence,pubescence,ray,reproduction,rugulose,seed,shape,size,staman,stipe,texture
723	wfo-0001031359	success	166	97	63	103	34	0.38	0.5-1,0.5-6,1-4,1.1-1.6,1.2-1.6,1.2-2.5,1.3-1.6,1.5-2,12-21,2.5-3,3-3.5,3.6-8.8,6-7,acuminate,anther,apex,attenuate,base,beneath,bi-lobed,calyx,cm,corolla,dull,elliptic,flattened-reniform,glabrous,globose,green,leaf,lobe,lobed,margin,minutely,mm,narrowly,nearly,occasionally,opposite,ovary,papillose,pedicel,petiole,pitted,plant,round,shaped,shrub,size,stem,stigma,style,surface,tan,tear-drop,trichome,tube,tuft,uniseriate,white,x,yellow,yellow-orange	.02,.25,.5,/4,0.75-1,1.6-2.8,1.9-2.3,5-30-flowered,5-7,5-angled,5.3-7.5,angle,anthesi,apart,apiculate,appearing,axil,ba,bark,beginning,berry,broadly,brown,curled,dark,deflexed,dia,differing,difoliate,distal,dried,eaf,edicel,eed,evenly,extending,filament,free,fruiting,geminat,incrassate,inflorescenc,internodal,interpetalar,lamina,lateral,live,lon,long,lower,main,major,membraneous,middle,minor,near,nflorescence,obovoid,often,older,one,originating,outline,pair,paler,papillae,papillo,pit,planar,pore,poricidal,portion,reflexed,ridged,ripe,ruit,rusty,scar,shiny,simple,sinus,slender,slightly,somewhat,spaced,specimen,straight,strongly,tall,tapering,tip,triangular,tub,ud,undulate,unit,vein,way,white-lenticellat,widest,woody,ympodial,young	0.5,adhesion,arrangement,blade,climate,colour,diameter,form,fruit,glandular,growth,hair,height,history,inflorescence,length,life,midpoint,na,number,peduncle,perennial,position,presence,pubescence,ray,reproduction,rugulose,seed,shape,staman,stellate,stipe,texture
724	wfo-0001031362	success	138	92	73	65	19	0.529	.2,.3,.5,0.5-1,1-1.1,1-1.5,1-4,1.5-2,2-2.5,3-4,3-6,along,anther,bark,base,branch,brown,calyx,closely,cm,corolla,dendritic,densely,denser,dia,flattened-reniform,glabrous,globose,golden,incrassate,lanceolate,lateral,leaf,like,lobed,long,main,margin,middle,minutely,mm,nearly,older,orange-red,ovary,packed,pair,papillose,pedicel,petiole,pitted,poricidal,pubescent,red,rest,shiny,shrub,simple,small-capitate,sparsely,stem,stigma,style,subshrub,surface,thin,tip,trichome,tube,vein,widest,x,young	0.4-0.5,0.7-1,1-3,1-3-flowered,?,abaxially,acute,adaxially,anthesi,apex,appearance,attenuate,berry,bushy,cell,conical,eaf,edicel,eed,ellipsoid,erect,exceeding,exserted,filament,flattened,free,fruiting,giving,golden-brow,inflorescenc,internodal,lamina,lobe,lon,long-triangular,lower,nflorescence,nodding,opposite,outline,overlappin,pale,papillo,pericarp,planar,plurifoliat,pore,portion,pubesent,rectangular,rounded,ruit,scar,shaped,slender,somewhat,spaced,straight,tan,tear-drop,ud,unit,white,woody,ympodial	abaxial,adaxial,arrangement,colour,density,diameter,form,fruit,golden-brown,growth,inflorescence,length,number,pubescence,seed,shape,size,texture,width
725	wfo-0001031363	success	198	94	66	132	28	0.333	0.3-0.6,0.4-0.5,0.5-0.8,1-2,1-2.2,1.1-1.6,1.5-4,10-11.5,2-3,2.5-7.5,3.5-6,4-8,4.5-7.5,5-10,5-8,6.5-11,7-12,absent,acute,adaxially,anther,apex,base,blade,broadly,brown,calyx,chartaceous,cm,diameter,extra-axillary,fruit,glabrous,globose,green,hair,inflorescence,leaf,length,lobe,lobed,margin,midpoint,mm,obtuse,ovate,pale,pedicel,peduncle,perennial,petiole,plant,present,purple,ray,rhizomatous,shallowly,shrub,simple,sparsely,stellate,stellate-pubescent,style,tube,x,yellow	%,.3,.5,0-15,0-3,0-30,0-6,0.3-0.5,0.3-0.7,0.4-0.8,0.5-0.9,0.5-1,0.7-1.5,0.9-1.6,1-5,1-6,1-locular,1.1-1.4,1.6-2.1,10-12,13-25,2-foliate,2.3-2.5,3-4,3-5,3-7,3.5-5.5,30,4-7,5-6,5-7,5-merou,6-13,6-8,6.5-8.5,80-120,abaxially,absen,acicular,across,adaxiall,adult,alyx,andromonoecious,apart,articulated,attenuate,axe,ba,bark,branch,branche,corky,cross-section,cylindrica,decimetre,deltate,densely,directed,distall,distributed,dm,eaf,eed,eglandular,erect,exocarp,finger,flower,fruiting,functional,furrowed,geminat,gland-tipped,half,heterostylous,incomplete,index,juicy,juvenile,lamina,lateral,less,lobing,long,longer,lower,mature,mesocarp,midvein,minute,moderately,moist,nflorescence,oblique,orolla,pair,part,per,placenta,pore,porrect,prickle,pseudo-racemose,ruit,semi-circula,septum,sessile,short,side,spaced,stalks-0.1,stellae,straight,surface,tal,tamen,tem,thick,throughout,time,transparent,unarme,unarmed,unbranched,unit,upper,vary,vein,weakly,wide,ympodial	0.1,2.5,adhesion,arrangement,climate,colour,corolla,form,glandular,growth,height,history,life,na,number,ovary,position,presence,pubescence,reproduction,seed,shape,size,staman,stem,stigma,stipe,texture
726	wfo-0001031372	success	192	110	78	114	32	0.406	0,0-15,0.2-0.8,1,1-2,1.5,10-14,10-30,2-2.5,2-5,2-7,2.5,2.5-4.5,3,5-10,6-9,7,7-10,8-10,8-15,acute,anther,apex,base,blade,broadly,brown,calyx,cm,coarsely,connivent,dark,densely,diameter,elliptic,extra-axillary,flattened,flower,fruit,glabrous,globose,green,hair,lanceolate,leaf-opposed,length,light,lilac,lobe,margin,midpoint,minutely,mm,obtuse,ovate,pedicel,peduncle,perennial,petiole,pitted,present,pubescent,ray,repand,several,simple,sparsely,stellate,stellate-pubescent,stem,stigma,style,thin-textured,tube,ultimately,white,x,yellow	-1.5,0.05-0.2,0.4-0.6,1/4-1/3,10,10-12,2-foliate,25-30,4-5,5-20,abaxiall,abaxially,accrescent,acute-,adaxiall,adaxially,along,apart,armed,articulated,axe,ba,blunt-tipped,broad-based,capitat,central,closely,completely,compressed,concealing,covering,cylindrical,decurrent,deltoid,directed,distal,distally,eaf,eed,entirely,enveloping,female-sterile,filament,foliaceous,fruiting,geminat,glabrou,interwoven,large,lateral,laterally,lighter,long,longer,lower,m.,main,midrib,minute,mostly,much,multiseriate,nflorescence,often,onto,orolla,ovate-lanceolate,perfect,pore,prickle,prickly,probably,rachi,reaching,recurved,reddish,round-tipped,ruit,scattered,short,short-styled,shorter,side,similar,soft-wooded,somewhat,spaced,spreading,stalk,star,ste,stellae,stellate-woolly,stelliform,stipitate,tal,tamen,tem,termination,time,unarmed,unbranched,unit,vary,vein,weakly,well-developed,whitish,wide,widely,winged,woolly,ympodial,young	adhesion,arrangement,capitate,climate,colour,corolla,decurren,form,glandular,growth,height,history,inflorescence,leaf,life,na,number,ovary,plant,position,presence,pubescence,reproduction,rugulose,seed,shape,size,staman,stipe,surface,tall,texture
727	wfo-0001031389	success	242	134	107	135	27	0.442	0-2,0.25-0.75mm,0.3-0.5,0.3-0.8,0.4-0.6,0.4-1.8,0.5-1.5,0.5-3,0.65-1,0.8-2.5,0.9-4.5,1-1.5,1.5-2.5,1.5-3,1.5-5,1.9-2.2,14-30,2-6,2.5-13,4-5.5,4-8,5.5-8,7-8,8-15,abaxially,absent,acute,adaxially,almost,andromonoecious,anther,apex,base,blade,brown,calyx,chartaceous,cm,connivent,cuneate,cylindrical,dark,densely,diameter,entire,erect,extra-axillary,flower,fruit,glabrous,gland-tipped,globose,hair,inflorescence,lanceolate,lateral,leaf,length,lilac,lobe,long,lower,margin,midpoint,minutely,mm,obtuse,ovate,pale,part,pedicel,peduncle,perennial,perfect,petiole,pitted,plant,present,purple,ray,red,reniform,reticulate,reticulately,rhizomatous,rotate-stellate,scattered,short,shrub,simple,solitary,sometimes,sparsely,stellate,stellate-pubescent,stigma,style,summit,surface,time,tip,tube,unbranched,weakly,white,x,yellow	%,0-0.1,0-0.4,0-0.5,0-0.6,0-1,0-10,0-3,0.05-0.1,0.25-0.4,0.25-0.5,0.3-0.6,0.5-1,0.6-0.7,1-2,1-3,1-4,1-5,1-locular,1.3-2.4,1.5-4,1.8-3.5,11-16,14-18,2-foliate,20-60,4-5,4-7,5-8,5-merou,6-10,6-12,6-7,6-9,absen,accrescent,acicular,across,adult,alyx,apart,apparen,articulated,axe,ba,becoming,branch,branche,capitat,confined,decimetre,deltate,directed,distall,distally,distributed,dm,eaf,eed,eglandular,exocarp,filament,finger,first,fruiting,functional,geminat,green,half,heterostylous,homo-,incomplete,interpetalar,juicy,juvenile,lamina,less,lobed,longer,loosely,markedly,mature,mesocarp,mid-point,midrib,midvein,minute,moderate,narrowly,nflorescence,oblique,often,orolla,pair,per,placenta,plump,pore,porrect,prickle,pseudo-racemose,pseudo-umbellate,rachi,reddish,rostrate,ruit,septum,sessile,shallowly,somewhat,spaced,sparse,stalk,stellae,straight,succulent,tal,tamen,tem,thick,thicker,thicknes,throughout,tightly,tissu,tissue,triangular,unarme,unarmed,unit,upper,vary,wide,yellowish,ympodial	adhesion,arrangement,capitate,climate,colour,corolla,form,glandular,growth,height,history,life,na,number,ovary,position,presence,pubescence,reproduction,rugulose,seed,shape,size,staman,stem,stipe,texture
728	wfo-0001031394	success	217	113	66	151	47	0.304	0.5,abaxially,acute,alternate,anther,apex,apparently,base,blade,calyx,cm,crenulate,diameter,extra-axillary,finely,flattened,flower,free,fruit,glabrous,glandular-pubescent,globose,hair,lanceolate,length,light,lobe,margin,midpoint,mm,ovate,pedicel,peduncle,per,petiole,pilose,pitted,plant,pubescence,pubescent,purple,recurved,red,rounded,short,side,similar,sometimes,stellate,stem,stigma,stipitate-glandular,style,subcordate,subreniform,subshrub,tan,taprooted,thin-textured,tooth,tube,usually,white,x,yellow,yellow-orange	-celled,-rayed,0.2–0.4,0.3,0.3–1.5,0.5–1,0.6–1.6,0.8,1,1.1–1.6,1.2–3.2,1.4–2.1,1.7–4.5,1/2,1/3,1–,1–1.5,1–2,1–3,1–4,2,2-foliat,2.2–2.5,2.5–3,2–3,2–3-celled,2–3.2,2–4,3,3.7–7.6,33–80,3–4,3–5,3–6,4,4–8,5,5–8,64,6–11,6–8,9–13,=,?,accrescent,acicular,adaxially,additional,almost,apart,appearing,armed,articulated,axe,ba,basal,beginning,bottom,branch,branched,broadly,bulbous,caudate,curved,cylindrical,densely,directed,distal,distall,eaf,eed,enlarging,even,eventually,fertile,filament,fruiting,glabrou,gland-tippe,gland-tipped,glandular-pilosulose,halfway,hyaline,investing,leafy,least,less,lon,long,longest,lower,main,male,many,maturity,midrib,minute,n,narrowly,nflorescence,numerous,one,orolla,overtopped,pore,prickle,quite,rachi,reaching,reflexed,ruit,scattered,sessile,shorter,simple,single-celled,slightly,small,smaller,somewhat,spaced,sparse,spreadin,staminate,stellae,sterile,stout,straight,tall,taman,tem,terminal,thick,thickened,time,tip,triangular,truncat,unbranched,unit,variable,vary,vein,wide,ympodial,±,–1.5,–2,–3,–5,–6	0.2-0.4,0.3-1.5,0.5-1,1-1.5,1-2,1-3,1-4,1.4-2.1,2-4,2.2-2.5,2.5-3,3-5,3-6,3.7-7.6,4-8,5-8,6-8,adhesion,arrangement,climate,colour,corolla,form,glandular,growth,height,history,inflorescence,leaf,life,na,number,ovary,position,presence,present,ray,reproduction,rugulose,seed,shape,size,staman,stipe,surface,texture,truncate
729	wfo-0001031400	success	161	69	50	111	19	0.311	0.25-0.8,0.4-1.7,0.6-1.8,0.7-6,0.8-1.1,1.2-2,1.5-5,2-5,2-9,4-13,4-6.5,4-7,5-12.5,7-28,calyx,cm,connate,corolla,deeply,diameter,distal,globose,green-white,half,herbaceous,lateral,leaf,leaflet,linear,linear-lanceolate,long,mm,odd-pinnate,ovoid,pedicel,peduncle,perennial,petiole,plant,puberulent,seed,size,stellate,subglabrous,terminal,tone,violet,white,wide,yellow	-3,1,1-,1-4,10-11,2,2-3,3-6-foliat,4-,4-17,6-23,7-25,abaxial,abaxially,abruptly,absen,acumen,acute,adaxially,apex,apical,apically,apiculate,articulate,base,branched,cell,covering,cuneate,cyme,dark,decurrent,dehiscent,dichasial,dichasially,digestion,diminishing,dorsally,eaf,ebracteate,edge,eed,emoval,enzyme,exceeding,filament,flat,flower,folded,forked,forming,generally,globo,green,hair-like,honeycomb,interjected,introrse,living,lobe,lon,lower,lunat,make,maturing,monochasial,mucilaginous,nflorescence,nther,oblique,oblong,occasionally,often,orolla,pair,pattern,perfect,plan,poricidally,proximal,rachi,reveal,ruit,sessile,seudostipule,short,side,slit,specimen,stamen,stigma,straight,stripe,structure,style,tal,tem,testal,thick,throughout,tip,toward,trilobe,tuber-bearing,typically,unit,vary,wall,without,ympodial,¼	4-25,anther,arrangement,colour,form,fruit,growth,height,history,inflorescence,length,life,na,ovary,position,reproduction,shape,stem,texture
730	wfo-0001031401	success	182	109	77	105	32	0.423	0.5,0.6-1.2,1-1.4,1-6,1.1-3,2-2.4,2-5,2.5-4,3,3.5-4,5-9,7-9,acute,anther,apex,attenuate,base,bi-lobed,blade,brown,calyx,cm,conical,corolla,dark,deltoid,dendritic,diameter,elliptic,finely,flattened,fruit,glabrous,globose,golden,growth,leaf,lenticular,lobe,lobed,long-triangular,matted,minutely,mm,narrowly,occasionally,ovary,pedicel,pericarp,petiole,pitted,poricidal,puberulent,pubescent,purplish-black,reddish-brown,rounded,roundish,shrub,small,sparsely,stem,stigma,strongly,style,surface,terminal,thin,tip,tree,tree-like,trichome,tube,violet,white,winged,x	0.8-1.2,1,1-1.5,1.5-2,1/2,3/4,5,5-7,8-10,abaxial,abaxially,adaxial,adaxially,age,along,anthesi,apical,appearing,axi,bark,basal,becoming,berry,black,branch,branching,clearly,deciduous,deflexed,densely,denser,dichasial,differentiated,drying,eaf,ecuador,ecuadorian,edicel,eed,ew,exserted,filament,flower,fork,free,fruiting,golden-yellow,impressed,inserted,lateral,less,long,lower,m.,mesophyll,monochasia,near,new,nflorescence,noddin,nodding,node,often,older,outline,overtopping,pair,papillo,per,planar,plurifoliate,pore,portion,prominently,pubescen,pyramidal,raised,ruit,scar,secondary,shiny,shoot,short,sleev,slit-like,sometimes,somewhat,specimen,stamen,ste,tall,tapering,time,tub,ud,unit,usually,vein,visible,way,wide,woody,yellow,ympodial,young	adhesion,arrangement,climate,colour,form,glandular,hair,height,history,inflorescence,length,life,margin,midpoint,na,number,peduncle,perennial,plant,position,presence,pubescence,ray,reproduction,rugulose,seed,shape,size,staman,stellate,stipe,texture
731	wfo-0001031402	success	200	107	78	122	29	0.39	0-0.2,0-0.3,0-3,0.2-0.4,0.3-1.1,0.4-1.2,0.5-0.7,0.5-1,0.5-1.3,0.5-2.6,1-3,1.5-2,1.5-2.5,10-38,2-2.5,2-3,3-4,3-5,3-5.5,4-7,7.5-8.5,acute,andromonoecious,anther,apex,base,blade,calyx,cm,cuneate,deeply,diameter,entire,fruit,glabrous,gland-tipped,globose,green,hair,herbaceous,inflorescence,leaf,leaf-opposed,length,linear,lobe,lobed,long,margin,midpoint,mm,moderately,oblique,ovate,ovoid,part,pedicel,peduncle,petiole,plant,present,purple,ray,resprouter,rotate-stellate,shallowly,short,simple,sparsely,stellate-pubescent,stem,stigma,style,throughout,tube,unknown,x,yellow	%,0.3-0.6,0.6-1.2,0.7-1.4,0.8-2.5,0.8-3,1,1-15,1-2,1-4,1-5,10-15,10-18,14-18,2-4,2-6,2-8,2-foliate,2.2-12,3-15,4-8,5-40,5-merou,6-9,7-15,8-10,abaxially,absen,absent,abundant,accrescent,acicular,across,adaxiall,adaxially,adult,alyx,apart,armed,articulated,axe,ba,branche,capitat,chartaceous,color,confined,connivent,contiguous,cylindrical,deltate,densely,directed,distall,distributed,dm,dult,eaf,eed,eglandular,erect,filament,finger,flower,fruiting,functional,geminate,glabrou,half,heterostylous,index,interpetalar,lamina,lateral,lobing,lon,longer,lower,mature,midrib,midvein,minute,narrowly,nearly,nflorescence,obtuse,orolla,per,pore,porrect,possibly,prickle,projecting,pseudo-umbellate,rachi,ripe,ruit,sessile,shorter,side,single-flowered,spaced,sprawling,stage,stellae,straight,strongly,tal,tamen,thick,time,tissue,unarmed,unbranched,unit,uvenile,vary,vein,weakly,wide,winged,ympodial	adhesion,arrangement,capitate,climate,colour,corolla,form,glandular,growth,height,history,life,na,number,ovary,perennial,position,presence,pubescence,reproduction,rugulose,seed,shape,size,staman,stellate,stipe,surface,texture
732	wfo-0001031480	success	237	114	86	151	28	0.363	0.1-0.4,0.5-2,0.8-1,1-1.3,1-1.5,1-3,1.7-2.2,1.8-3,2-2.7,2-3,2-6,3-7,3.5-7,4-6,6-13,6-8,acute,andromonoecious,anther,apex,base,berry,blade,bright,calyx,cm,cuneate,densely,diameter,dull,ellipsoid,entire,equal,flattened-reniform,fruit,glabrescent,glabrous,glandular,hair,lateral,leaf,length,lobe,lobed,long,margin,maturity,mauve,mm,moderately,near,obtuse,orange-brown,ovate,pale,pedicel,peduncle,petiole,plant,poricidal,purple,ray,red,red-brown,scandent,shallowly,shrub,simple,smooth,spherical,spreading,stellate,stellate-pubescent,stem,style,surface,tapering,terminal,thick-chartaceous,tip,trichome,truncate,tube,weakly,wide,yellow	-0.25,-2,/3,0,0-0.5,0-1,0-2,0-30,0-5,0.1,0.1-0.3,0.15-0.3,0.2-0.35,0.4,0.4-0.8,0.5-,0.6-0.8,0.7,0.8,1-2,1-4,1.5-2.2,1/2,1/3,1/4,1/6-1/5,2-,2-5,3,3-10,3-6,4-5,5-8,5-merous,6-30,7-8,8-12,abaxial,abaxially,acuminat,adaxial,alyx,apar,apart,apically,apparently,articulated,ba,bark,branched,branching,broad-deltate,cell,cream,curved,dark,deltate,difoliate,discolorous,distal,distance,drying,eaf,eed,elongate,elongating,erect,extending,eye,faint,filament,flattened,flower,free,fruiting,geminat,green,hermaphrodite,heterostylous,inconspicuous,infructescence,long-styled,longer,lower,lowermost,marking,mature,midpoint,midvein,minutely,naked,nflorescence,often,older,one,open,orolla,oung,outline,pair,pendulous,per,pericarp,persistent,pit,porrect,portion,prickle,prickly,primary,pubescent,raised,red-brow,red-green,red-yellow-green,reduced,reticulate,rounded,ruit,scar,sessile,short-styled,shorter,side,slender,slightly,small,somewhat,spaced,sparsely,stalk,stalked,staminat,straight,tamen,terete,tertiary,time,unarme,unarmed,unit,upper,variously,vary,vein,venation,visible,way,woody,ympodial,young	8,adhesion,arrangement,colour,corolla,form,growth,height,history,inflorescence,life,na,number,ovary,perennial,position,presence,present,pubescence,reproduction,rugulose,seed,shape,size,staman,stigma,stipe,texture
733	wfo-0001031482	success	275	146	116	159	30	0.422	-0.2,-0.5,-0.6,-16,-18,.2-1.6,0-0.2,0.02-0.03,0.02-0.04,0.03-0.3,0.2-0.3,0.7-1.3,1-4.5,1.2-1.5,1.2-3,1.3-4,1.4-2.2,1.6-2.8,1.9-2.5,2-3.3,2-4.7,2.5-10,2.5-4,3/4,4-13,4-5,4-6,4-7,6-16,8,abaxially,acuminate,acute,adaxially,anther,apex,attenuate,base,becoming,blade,blue,blunt-tipped,brown,calyx,cm,commonly,continued,corolla,deltoid,densely,diameter,due,echinoid,elliptic,elongate,entire,flower,fruit,glabrous,granular-tomentose,grayish,growth,hair,inserted,lanceolate,lateral,leaf,length,lobe,margin,mixed,mm,moderately,mostly,multangulate,oblong,obtuse,often,pale,pedicel,peduncle,petiole,porrect-stellate,present,pubescence,pubescent,ray,reniform,rotate-stellate,rounded,scabridulous,sessile,short-stalked,shrub,simple,slightly,small,somewhat,sparsely,stellate,stem,stigma,style,subcapitate,subconical,subglobose,suborbicular,subspherical,terminal,tomentose,tree,tube,velutinous,x,yellow,yellowish	-0.06,-0.4,-1.4,-150,-5,-5.3,-5.5,-6,.04-0.1,.04-0.35,.04-0.5,.06-1,.5-0.7,.5-3.5,.5-5,/20-,0-0.3,0-0.4,0-0.6,0-0.7,0.02-0.06,0.03-0.04,0.04-0.3,0.04-0.4,0.04-0.5,0.04-0.6,0.04-1.4,0.3-0.5,0.5-1.5,0.6-1.8,1,1/10-1/4,1/2-2/3,2-3.5,2-4.6,2.5-4.5,3.5-4.8,3.7-8,4.5,5-7,5-80,5-merou,6-11,9-13,accrescent,adaxiall,ag,along,alyx,anthesi,apart,ape,apical-lateral,apparently,appressed,articulated,axe,axillary,ba,bark,berry,beyond,branch,branched,bud,decurrent,dehiscing,directed,eaf,eed,ellipti,evident,exserted,extend,farinose,few-rayed,filament,free,fruiting,glabrescent,green,high,honeycombed,immature,interpetalar,introrse,irregular,lacking,large,later,line,lobed,long,long-stalked,longer,longitudinal,lower,m.,main,midvein,minute,multiseriate,narrowly,nearly,nflorescence,oblong-orbicular,occasionally,older,orolla,ovate,overlapping,perfect,persistent,plurifoliate,pore,possibly,prominent,rachi,rather,relatively,reticulate-punctate,ribbed,ripe,ruit,runk,short-,side,slender,slit,sometimes,spaced,splitting,stalk,stamen,stelliform,subcampanulate,sulcate,suture,tamen,terete,testa,thick,thin,time,tissue,toward,unarme,unarmed,unevenly,unit,usually,vary,vein,way,weakly,white,wide,ympodial,young	0-0.06,0.04-0.35,0.5-3.5,1-1.4,adhesion,arrangement,climate,colour,form,glandular,height,history,inflorescence,life,midpoint,na,number,ovary,perennial,plant,position,presence,reproduction,seed,shape,size,staman,stipe,texture,unknown
734	wfo-0001031483	success	154	93	58	96	35	0.377	0.5,0.5-2,1,1-2,1.7-5.5,11-20.5,2-2.5,3-4,6-10,acuminate,acute,almost,anther,anthesi,apex,attenuate,base,blade,calyx,clavate,cm,corolla,dia,distal,dry,end,fresh,glabrous,green,indistinct,leaf,linear,lobe,lobed,mm,oblanceolate,obovate,opposite,ovary,ovoid-reniform,pale,paler,pedicel,petiole,poricidal,shape,shrub,slightly,stem,stigma,style,subshrub,tan,tip,tube,turbinate,white,x	.5,/2,0,1.1-2.5,1.2-1.4,1/3,2-3,2.5-3.2,3-8-flowered,7-10,across,anew,apart,ba,bearing,beginning,beneath,berry,ca,caly,continuous,cork,corky,decurrent,deflexed,deltoid,difoliate,eaf,edicel,eed,evenly,exserted,filament,filiform,flower,free,fruiting,fusiform,geminat,indistinc,internode,larger,lateral,lea,lenticellate,less,long,lower,main,major,markedly,minor,minutely,nflorescence,oblong,obovoid,often,orbiculate,pair,papillo,papillose,per,planar,pointed,pore,portion,prominent,quite,raised,rounded,ruit,scar,shaped,short,short-triangular,simple,slender,somewhat,soon,spaced,straight,strongly,tall,tapering,tear-drop,third,ud,unit,variable,vein,way,widest,wing,winged,woody,ympodial	1.5,2.5,5,adhesion,arrangement,climate,colour,diameter,form,fruit,glandular,growth,hair,height,history,inflorescence,length,life,margin,midpoint,na,number,peduncle,plant,position,presence,pubescence,ray,reproduction,seed,size,staman,stellate,stipe,texture
735	wfo-0001031486	success	166	94	74	92	20	0.446	0.2-0.7,0.9-1.7,1-2.2,1.5-4,1.8-3.3,11-37,2-3,2-3.5,2-6,2.5-3.2,2.8-6,3.4-10,3.5-6.5,3.5-8,5-10,7.5-22,9-37,abaxially,adaxially,almost,calyx,cm,commonly,connate,corolla,darker,deep,diameter,distal,elliptic,forked,globose,green,green-white,half,herbaceous,interjected,lateral,leaf,leaflet,less,light,lightly,long,mm,odd-pinnate,ovate,ovoid,pedicel,peduncle,pentagonal,perennial,petiole,plant,puberulent,pubescent,pure,purple,rotate,seed,size,sometimes,spot,stigma,strigose,stripe,style,terminal,throughout,tinged,tip,white,wide,yellow	0-1.,0-4.5,1-3,1-4,1.5-6,3-26,3-6-foliat,5-16,abruptly,acumen,acuminate,acute,apex,apical,apically,articulate,base,branched,cell,cordate,covering,cuneate,cyme,decurrent,dehiscent,dichasial,dichasially,digestion,diminishing,dorsally,eaf,ebracteate,edge,eed,emoval,enzyme,exceeding,filament,flat,flower,folded,generally,globo,hair-like,highly,honeycomb,introrse,living,lobe,lon,long-attenuate,lower,lunat,make,maturing,monochasial,mucilaginous,nflorescence,nther,oblique,obovate,often,orolla,pair,pattern,perfect,petiolule,plan,poricidally,proximal,reveal,ruit,seudostipule,short,slit,specimen,stamen,straight,tal,tem,testal,thick,throughou,toward,tuber-bearing,typically,unit,usually,vary,wall,ympodial,¼	0-15,anther,arrangement,colour,form,fruit,growth,height,history,inflorescence,length,life,na,number,ovary,position,reproduction,shape,stem,texture
736	wfo-0001031492	success	175	135	104	71	31	0.594	/4,0.5,0.7-1.3,0.9-1.1,1-1.3,1-1.5,1.3-2,1.5-1.8,1.5-2.5,2-10,2-3,20,3-4,3-5,4-10,4-4.5,6-8,abaxially,acuminate,acute,adaxially,age,anther,apex,appearing,attenuate,base,becoming,beneath,bi-lobed,bitter,calyx,cm,corolla,dark,decurrent,dendritic,densely,denser,diameter,distinguishable,drying,dull,echinoid,elliptic,flattened,free,fruit,glabrous,globose,golden,grey,growth,juice,lamina,lateral,leaf,lenticular,lightly,lobe,lobed,medium,minutely,mm,narrowly,ovary,overtopping,pedicel,pericarp,petiole,pitted,pore,poricidal,pubescent,purplish-black,reddish-brown,scarcely,scattered,shiny,shoot,shrub,size,slightly,slit-like,sometimes,sparsely,stem,sticky,stigma,style,sunken,surface,terminal,thin,tip,tree,tree-like,trichome,tube,vein,violet,way,winged,x	.5,08,10-15,2-5,8-11,8-9,absent,anthesi,apical,axe,ba,bark,basal,berry,branching,conical,dbh,deciduous,deltoid,eaf,edicel,eed,erect,ew,exserted,filament,flower,fruiting,inserted,long,lower,m.,monochasia,nflorescence,nodding,occasionally,older,pair,papillo,per,planar,plurifoliate,portion,predominantly,prominent,pyramidal,rather,remaining,ruit,scar,secondary,short,sleeve,somewhat,stamen,ste,strongly,tall,tapering,time,tub,ud,undersurface,unit,upper,upturned,wide,woody,ympodial,young,younger	adhesion,arrangement,blade,climate,colour,form,glandular,hair,height,history,inflorescence,length,life,margin,midpoint,na,number,peduncle,plant,position,presence,pubescence,ray,reproduction,rugulose,seed,shape,staman,stellate,stipe,texture
737	wfo-0001031497	success	264	117	89	175	28	0.337	0.05-0.2,0.1-0.2,0.1-0.8,0.2-0.5,0.5-2.5,1-2,1.2-2,1.2-2.4,1.5-2.5,2.25-3,2.5-4,2.8-3.5,3-10,3-5,3-6,3-9,4.5-7,5-8,6-13,6-9,abaxially,actinomorphic,acuminate,acute,adaxially,anther,apex,attenuate,base,blade,broadly,calyx,cm,deciduous,deeply,densely,diameter,erect,extra-axillary,flower,fruit,glabrous,globose,hair,incised,inflorescence,lanceolate,leaf,length,lenticular,light,lobe,margin,midpoint,mm,obtuse,orange,outline,ovate,pedicel,peduncle,perennial,perfect,petiole,presence,pubescence,pubescent,ray,red,reniform-ovate,ripe,simple,spreading,stellate,stellate-puberulent,stellate-pubescent,stem,stigma,style,surface,tan,thin-textured,truncate,tube,weakly,white,x,yellow,zygomorphic	-1.4,-30,-35,-7,.1,.1-0.2,0.2-0.4,0.4-1,1,1.5-4,1/3,1/5-1/3,10-25,12-30,14-,15-,18-25,2-5,2-foliate,2.25-4.75,2.5-5,20-30,3-15,4-12,4-locular,4.5-9,5-15,7-12,along,apart,ape,appearance,appearing,appressed,articulated,axe,ba,berry,broa,c.,campanulate,cast,cauline,clearly,close,closely,coarsely,compressed,connivent,curved,cylindrical,deltoid,dense,denser,depressed-deltoid,directed,distal,distall,distributed,downcurved,due,eaf,eed,entire,equaling,essentially,external,falcate,female-sterile,filament,foliar,geminat,giving,glabrescent,green,high,interlobal,intermixed,large,largely,larger,lateral,laterally,less,lignescent,lon,long,longer,lower,main,major,mature,maturity,minute,minutely,nectary,never,nflorescence,numerous,oblique,obsolete,occasionally,often,one,orolla,other,otherwise,oung,outer,ovate-lanceolate,pair,per,persistent,pigmented,pitted,pore,present,prickle,prickly,projecting,purple,purplish,rachi,readily,recurved,reduced,rigid,ring,ruit,scabrous,scattered,section,seldom,sessile,sharp-tipped,short,short-stalked,short-stipitate,side,similar,sinus,slightly,small,smaller,sometimes,somewhat,spaced,species,stalk,stellae,strongly,subcapitat,summi,tamen,thickened,three,time,tip,toothlike,two,type,unarmed,unbranched,unit,unlobed,uppermost,upward,usually,vary,varyingly,vein,vestiture,wide,widely,ympodial	14-25,15-30,adhesion,arrangement,climate,colour,corolla,form,glandular,growth,height,history,life,na,number,ovary,plant,position,reproduction,rugulose,seed,shape,size,staman,stipe,subcapitate,texture,ye
738	wfo-0001031503	success	142	104	68	74	36	0.479	-10,-15,-25,-7,0.3-3,0.5-1,0.5-4,1-,1-3,1-5,1.5-2,1.5-3,1.5-7,2-3,2.5-10,3-15,3-4,3-5,3-6,6-7,7-10,abaxially,acuminate,acute,adaxially,angled,apex,base,blade,calyx,chartaceous,cm,cuneate,decurrent,densely,diameter,elliptic,entire,glabrous,globose,hair,lanceolate,lobe,margin,mm,moderately,orange,ovate,pedicel,peduncle,petiole,puberulent,pubescent,reddish,rounded,shrub,simple,slightly,sparsely,stellate,stigma,style,truncate,tube,vein,white,x,yellow	-30,-6,1-2.5,1-7,1.5-8,1.7-3.5,10-19,5613,6-many-foliat,7-15,abruptly,absen,aggregate,apart,articulated,axe,ba,branched,cell,connivent,curled,cylindrical,deltate,directed,distall,distally,eaf,eed,eglandular,except,fide,flower,forked,gland,long,lower,mostly,narrowed,narrowly,nflorescence,nther,obtuse,occasionally,often,orolla,perfect,pore,present,rachi,radiu,rarely,ripe,rugose-pubescent,ruit,spaced,stalked,stone,subcapitat,subclavate,tal,tem,time,tip,toward,triangular,unbranched,unequal,uniseriate,unit,usually,vary,venturi,wide,ympodial	adhesion,anther,arrangement,climate,colour,corolla,form,fruit,glandular,growth,height,history,inflorescence,leaf,length,life,midpoint,na,number,ovary,plant,position,presence,pubescence,ray,reproduction,rugulose,seed,shape,size,staman,stem,stipe,subcapitate,surface,texture
739	wfo-0001031511	success	231	129	102	129	27	0.442	-12,-15,-3.5,-5,-7,0-0.3,0.3-0.8,0.4-0.7,0.5-0.7,0.5-0.9,0.7-2.1,0.8-2,1-1.5,1-2,1.8-2.6,10-25,2-4,2-6,2.2-4.3,2.5-3,2.8-3.5,3-5,4.5-7,4.5-9,5-15,6-8,6-9,7-11,abaxially,acute,adaxially,andromonoecious,anther,apex,base,black,blade,brown,calyx,chartaceous,cm,conspicuously,cordate,cuneate,densely,diameter,discoid,eglandular,ellipsoidal,entire,erect,extra-axillary,forked,fruit,glabrous,globose,green,hair,inflorescence,interpetalar,lanceolate,length,light,lobe,lobed,margin,midpoint,midrib,mm,moderately,obtuse,orange,ovate,pale,pedicel,peduncle,perennial,petiole,plant,present,pubescent,purple,ray,rhizomatous,ripe,rotate,shallowly,shrub,simple,sparsely,stellate-pubescent,stem,stigma,style,surface,tissue,tomentose,tube,violet,white,x,yellow	%,0,0-1.1,0-2,0-3,0.1-0.2,0.3-0.5,0.3-1.7,0.5-1,0.5-5,0.6-1.5,1,1-3,1-7,1.1-1.6,1.7-2.4,10-12,10-18,15-25,17-25,2-3,2-locular,2.2-3,25-45,4-10,5-10,5-6,5-7,5-9,5-merou,7-8,8-15,9-15,9-20,absen,absent,accrescent,acicular,across,adaxiall,alyx,ample,anvil-shape,apart,armed,articulated,axe,ba,basal,bisexual,broadly,connivent,contiguous,cross-section,cylindrical,deltate,dense,directed,distal,distall,dm,dult,eaf,eed,exocarp,filament,finger,flower,fruiting,functional,geminat,gland-tipped,half,heterostylous,hig,juicy,lamina,lateral,less,lon,long,longer,lower,male,mature,mesocarp,mid-point,midvein,minute,minutely,moist,nearly,nflorescence,oblique,orolla,part,per,pitted,placenta,plurifoliate,pore,porrect,prickle,pseudo-racemose,rachi,ruit,rusty,short,somewhat,spaced,stage,stalk,stalked,stellae,straight,strongly,tamen,thick,throughout,time,triangular,unbranched,unit,unknow,uvenile,vary,wid,wide,ympodial	adhesion,arrangement,climate,colour,corolla,form,glandular,growth,height,history,leaf,life,na,number,ovary,position,presence,pubescence,reproduction,rugulose,seed,shape,size,staman,stellate,stipe,texture
740	wfo-0001031512	success	199	126	99	100	27	0.497	-3,0.15-0.3,0.3-0.5,0.3-1,0.3-1.5,0.5-0.8,0.5-1.5,0.5-1.8,0.8-1,0.9-1.5,1-1.5,1-2.5,1.5-3,12-16,13-15,3-4,3-5.1,4-8,4.5-6,4.5-7,7-10,7-12,absent,acute,adaxially,and/or,andromonoecious,anther,apex,articulated,base,black,blade,brown,brownish-black,calyx,chartaceous,cm,connivent,cuneate,cylindrical,densely,diameter,entire,extra-axillary,flat,flower,fruit,glabrous,gland-tipped,globose,green,grey,grey-green,hair,inflorescence,lanceolate,later,length,lilac,lobe,long,loosely,marbled,margin,mid-point,midpoint,mm,moderately,obtuse,pedicel,peduncle,perennial,petiole,plant,present,pubescent,purple,ray,rotate-stellate,short,shrub,simple,slightly,sometimes,stellate,stellate-pubescent,stem,stigma,style,surface,thick,though,tube,twisted,undulate,white,x,yellow	%,0-10,0-3,0.05-0.1,0.1-0.2,0.15-0.2,0.15-0.25,0.2-0.3,0.5-0.6,1-2,1-3,12-15,13-16,15-25,2-6,2-foliate,3.8-5.7,5-12,5-7,5-merou,6-13,8-10,abaxially,absen,abundant,accrescent,adaxiall,alyx,apart,axe,ba,broad,broad-based,capitat,decimetr,deltate,directed,distall,distinct,distributed,dr.,dult,eaf,eed,erect,filament,finger,first,fruiting,functional,geminat,half,heterostylous,interpetalar,lamina,lateral,less,longer,lower,mature,mesocarp,minute,nflorescence,oblique,orolla,part,per,pore,porrect,prickle,pseudo-racemose,rachi,raised,rhizomatous,rounded,ruit,scarcely,sessile,smooth,spaced,stage,stellae,straight,strongly,tal,tamen,throughout,time,tissue,tubercle,unarmed,unbranched,unit,unknow,uvenile,vary,weakly,wide,yellowish,ympodial	adhesion,arrangement,capitate,climate,colour,corolla,form,glandular,growth,height,history,leaf,life,na,number,ovary,position,presence,pubescence,reproduction,rugulose,seed,shape,size,staman,stipe,texture
741	wfo-0001031586	success	167	78	51	116	27	0.305	-2,0.1-1,0.5-0.8,0.5-1,1-1.2,1-1.5,1-2,1.3-5,1.4-2.5,1.5-2,2,2-2.5,3-11,5-6,anther,base,calyx,capitate,cm,corolla,cream-colored,elliptic,glabrous,green,greenish,inflorescence,leaf,lobe,lobed,mm,nearly,opposite,ovary,pale,paler,pedicel,petiole,poricidal,ridged,shiny,shrub,size,stem,stigma,style,surface,tip,tube,white,x,yellow	.25,1,5-10,7-10-flowered,abrupt,absent,acute,anthesi,apart,apex,apparently,appearing,attenuate,bark,becoming,beneath,borne,branch,bright,broadly,bud,campanulate,closer,completely,conical,cucullate,deflexed,deltate,dia,differing,difoliate,distance,drying,eaf,edicel,eed,ellipsoid,exerted,exfoliatin,filament,fleshy,flower,free,fresh,geminate,globose,gree,inflorescenc,know,known,later,lateral,leave,long,lower,main,major,margin,material,may,minor,minutely,mucro,near,new,nflorescence,notched,occasionally,older,olive,one,onto,open,overtopping,pair,papillate,papillose,planar,pore,portion,present,prominent,raised,remaining,rounded,ruit,scar,shap,shaped,shin,simple,slender,small,sometimes,somewhat,soon,spaced,sparsely,straight,swollen,tall,tapering,tear-drop,thick,thickened,trichome,truncate,trunk,ud,uniseriate,unit,vein,widely,yellowish,ympodial,young	adhesion,arrangement,colour,diameter,form,fruit,growth,height,history,length,life,na,number,peduncle,perennial,plant,position,presence,pubescence,ray,reproduction,rugulose,seed,shape,staman,stellate,texture
742	wfo-0001031587	success	142	70	41	101	29	0.289	0.8-1,1.5-2,1.7-2,12-16,17-30,2,2-2.5,3-4,5,6-7,anther,bi-lobed,calyx,cm,corolla,elliptic-ovoid,glabrous,golden-red,inflorescence,leaf,lobe,lobed,minutely,mm,ovary,pedicel,petiole,pubescent,shape,size,stem,stigma,style,surface,thickened,tree,tube,verrucose,white,winged,x	.5,1-1.5,10-15,2-9-celled,2/3,6-8,7-9,abaxially,acute,adaxially,along,anthesi,apart,apex,attenuate,axi,bark,base,broadly,clavate,closely,cone,conical,decurrent,deflexed,deltate,dendritic,densely,denser,dia,differing,drying,eaf,edicel,eed,elliptic,erect,evenly,exserted,fide,filament,fleshy,free,furcate,globose,included,irregular,know,known,lamina,later,lateral,like,long,loose,lower,lowered,main,major,middle,minor,mostly,oblique,ocasionally,occasional,older,overlappin,pair,pale,papillate,papillo,parallel,perpendicular,persisten,pore,poricidal,portion,rarely,rect,reddish-grey,rest,ruit,scar,shaped,simple,soft,somewhat,spaced,steinbach,tall,tear-drop,thick,tip,trichome,tub,ud,uniseriate,vein,way,widest,young	2.5-1.5,adhesion,arrangement,colour,dense,diameter,form,fruit,growth,height,history,length,life,na,number,papillose,peduncle,perennial,plant,position,presence,pubescence,ray,reproduction,rugulose,seed,staman,stellate,texture
743	wfo-0001031589	success	222	126	95	127	31	0.428	-15,-6.5,0.1,0.1-0.5,0.2-0.5,0.4,0.5-1,0.55-0.7,0.8-2.3,0.9-1.3,1-1.8,1.2-1.5,1.7-2.5,1.8-2.9,1/3,1/3-1/4,2-3.5,2.5-6,2.8-4,3/4,4-6.5,5-8,acute,anther,apex,attenuate,base,berry,blade,bright,calyx,chartaceous,cm,connivent,cream,dark,densely,diameter,dull,elliptic,flattened-reniform,fruit,glabrescent,glabrous,green,lateral,leaf,length,lobe,lobed,long,long-obovate,lower,margin,marking,maturity,mauve,membranous,midpoint,mm,moderately,narrow-cuneate,occasionally,often,orange-brown,pale,pedicel,petiole,plant,poricidal,ray,rounded,scandent,shrub,simple,smooth,sparsely,spherical,stellate,stellate-pubescent,stem,style,subentire,surface,tapering,tip,tube,upper,way,white,whole,wide,yellow,yellow-orange,young	-0.5,-6,.5,/6,0,0-1,0-10,0-3,0-30,0.15-0.3,0.2-0.4,0.2-3,0.6-1.2,0.7,0.9-1.6,1,1-5,1.5-5,1/3-1/2,10-30,2-,2-10,2.5-4.5,3-4,3-5,4/5,5-merous,6-8,8-14,8-30,abaxially,alyx,ame,apart,apically,apparently,articulated,bark,broadly,brow,brown-green,c.,caudat,cell,concolorous,deltate,density,difoliate,discolorous,distance,drying,eed,elongating,equal,erect,extending,eye,filament,flower,free,fruiting,geminat,gray-green,higher,infructescence,lengt,lon,longer,mature,midvein,multangulate,naked,narrow,nflorescence,oblong,obovate,older,orange-green,orolla,oung,outline,pair,part,pendulous,per,perfec,pericarp,pit,porrect,portion,prickl,prickle,prickly,primary,raised,reflexed,ruit,sessile,shiny,shorter,side,small,solitary,sometimes,somewhat,spaced,spreading,stalk,stalked,stout,straight,subsessile,tamen,terete,tertiary,time,trichome,unit,vary,vein,venation,visible,weakly,winged,woody,yellow-green,ympodial	8,adhesion,arrangement,climate,colour,corolla,form,glandular,growth,hair,height,history,inflorescence,life,na,number,ovary,peduncle,position,presence,pubescence,reproduction,rugulose,seed,shape,size,staman,stigma,stipe,texture,ye
744	wfo-0001031609	success	154	101	67	87	34	0.435	0.5-3,1-10,1-6,1.3-3,1.5-2,1.5-3,10-25,2-,2-3,2.5-4,3-24,3-5,3-9-lobed,4,4-5,4-6,4.5-60,abaxially,acute,adaxially,apex,around,base,blade,brownish,calyx,campanulate,cm,cuneate,dia,diameter,elliptic,entire,flattened,fruit,glabrous,globose,green,inflorescence,leaf,lobe,lobed,margin,mm,obovate,obtuse,orange,papillose,pedicel,peduncle,petiole,pinnately,puberulent,ripe,shrub,simple,small,stellate,stigma,style,succulent,tree,truncate,tube,unlobed,x,yellow	.5,/4,0-30,0.4-3,0.5-1,2,20-25,3-foliat,5-25,5/6,8-20,absen,absent,aggregate,ape,apiculate,articulated,axe,barely,beyond,bilobe,branch,brow,cell,connective,connivent,conspicuous,contiguous,dark,deltate,dilated,directed,distally,divided,eaf,eed,ellipsoidal,elliptic-ovate,emerging,equal,exceeding,exserted,fleshy,flower,forked,glabrou,laterally,leaving,long,lower,midrib,minutely,nearly,nflorescence,nther,obconical,occasionally,orolla,pedicellar,point,pore,rachi,radiu,reticulate,rounded,ruit,scar,shallowly,sinus,stamen,stone,strongly,succulen,tal,tem,thecae,time,tip,tomento,triangular,two,ud,unbranched,unit,vary,wide,ympodial	adhesion,anther,arrangement,bilobed,climate,colour,corolla,form,glandular,growth,hair,height,history,length,life,midpoint,na,number,ovary,plant,position,presence,pubescence,ray,reproduction,rugulose,seed,shape,size,staman,stem,stipe,surface,texture
745	wfo-0001031615	success	154	104	72	82	32	0.468	.5,0.5-1,0.8-1,0.9-1.1,1-1.6,1.3-1.8,1.5,1.5-5,11-15.5,4-6.5,5-6,acuminate,acute,anther,apex,attenuate,axil,base,bilobed,brown,calyx,capitate,cm,corolla,decurrent,dia,elliptic,flattened-reniform,fruit,glabrous,glandular,globose,green,inflorescence,lateral,leaf,lobe,lobed,long,main,major,margin,minutely,mm,nearly,opposite,ovary,papillose,pedicel,petiole,pitted,shaped,shrub,size,small,stem,stigma,style,surface,tear-drop,tip,tree,trichome,tube,tuft,unicellular,uniseriate,vein,white,winged,x,young	0,0.5,2-3,2-4.2,3.8-6.1,5-20-flowered,6-8,8-10,anthesi,arising,ba,bark,becoming,berry,caly,closely,dark,dark-papillo,deep,deflexed,deltoid,differing,difoliate,distal,eaf,edicel,eed,expanded,exserted,filament,free,fruiting,furcate,geminat,impressed,incrassate,interpetalar,lamina,less,lon,lower,maroo,middle,minor,minute,nflorescence,occasionally,older,one,overlappin,packed,pair,paler,papillae,per,pore,poricidal,portion,prominent,reflexed,ruit,scar,scarcely,shiny,simple,sinus,slender,slightly,somewhat,straight,subumbellate,tall,tapering,terminal,thickened,thin,ud,unit,urceolate,widest,woody,ympodial	adhesion,arrangement,blade,climate,colour,dark-papillose,diameter,form,growth,hair,height,history,length,life,midpoint,na,number,peduncle,perennial,plant,position,presence,pubescence,ray,reproduction,rugulose,seed,shape,staman,stellate,stipe,texture
746	wfo-0001031618	success	184	98	62	122	36	0.337	-2,0-3,1-1.5,1.5-2,10-18,2-2.5,2-3,3-4,3-8,4-5,5,acute,anther,apex,axil,base,branch,calyx,capitate,cm,corolla,darker,discoidal,equal,finely,glabrous,glandular,green,greyish,hair,lavender-purple,leaf,lobe,marbled,minute,mm,oblong,obovoid,ovary,ovate-lanceolate,ovoid,pale,pedicel,peduncle,petiole,purple,reddish-brown,reticulate,rotate,rounded,rugose,shrub,simple,somewhat,stem,stigma,stripe,succulent,surface,tinged,unequal,x	0.5-1.5,1-7,1.5-3.5,10-lobed,13,3,40-60,5-12,90-110,acuman,almost,also,anthesi,appearance,appearing,aspect,becoming,berry,beyond,blunt,bluntly,broadly,c.,cell,clonal,cluster,column,conical,covering,cuneate,cut,cyme,developed,dia,eaf,eed,ellipsoid,elliptic,emarginate,enlarged,erect,except,exerted,extending,facetted,filament,fleshy,floral,flower,fork,forked,frui,general,giving,greatly,gree,growing,habit,half,interacuminal,lanceolate,lasting,lengthening,less,lobed,lon,long,loosely,lower,maturity,mauve,may,mid-vein,midrib,narrowly,nflorescence,occasional,occur,often,pal,pedicellate,petal,pinatisect,plurifoliat,point,pore,poricidal,rarely,rhachi,ripe,ruit,scorpioid,sessile,several,shallowly,side,single,sinus,slit,soft-wooded,sometimes,specimen,stone,stout,strongly,styl,tapering,terete,tip,tissue,triangular,tub,ud,unit,variable,vigorous,way,well,year,ympodial,young,younger	adhesion,arrangement,blade,climate,colour,diameter,form,fruit,growth,height,history,inflorescence,length,life,margin,midpoint,na,number,perennial,plant,plurifoliate,position,presence,pubescence,ray,reproduction,rugulose,seed,shape,size,staman,stellate,stipe,style,texture,tube
747	wfo-0001031646	success	171	113	85	86	28	0.497	-7,-pinnate,.2,.5,0.8-1.5,1-1.8,1-6,1.2-2.5,15-25,2-2.5,2-3,2.5-10,20,3.5-4,4-18,4-20,4-5,5,5-6,7-8,8-15,abaxially,acuminate,acute,adaxially,anther,apex,base,blade,blue,brown,calyx,chartaceous,cm,cuneate,darker,densely,diameter,ellipsoidal,entire,flattened,flower,fruit,glabrous,glandular,globose,green,hair,immature,leaf,light,lobe,margin,maroon,mature,mm,multicellular,oblique,oblong,pedicel,peduncle,petiole,pubescence,pubescent,red,rotate-pentagonal,rounded,rugulose,scandent,shortly,shrub,simple,size,smooth,stem,stigma,style,surface,tawny,tube,uniseriate,vine,violet,x,yellow	0.2-0.8,0.5-2,1-10,1.5-3.5,1.5-4,18-38,1962,2-10,4-8,4-foliate,5-7,5-7.5,5-merou,absen,absent,accrescent,acut,aggregate,alyx,apart,apical,apparently,articulated,axe,ba,basally,berry,branched,cell,ciliat,climbing,connivent,correll,covered,cylindrical,decreasing,directed,distall,eaf,eed,elliptic,elliptic-lanceolate,equal,fide,filament,fruiting,geminat,high,highly,homostylous,hyaline,interjected,lateral,leaflet,long,lower,nflorescence,obliquely,obtuse,orolla,ovate-lanceolat,ovate-lanceolate,part,perfect,petiolule,pore,present,pubescen,rachi,ruit,seudostipule,slightly,small,spaced,spreading,stone,stout,tamen,tem,tip,toward,tree,truncat,unit,vary,ympodial	adhesion,arrangement,climate,colour,corolla,form,growth,height,history,inflorescence,length,life,midpoint,na,number,ovary,plant,position,presence,ray,reproduction,seed,shape,staman,stellate,stipe,texture,truncate
748	wfo-0001031651	success	201	119	86	115	33	0.428	-3.5,.6,0.1-0.15,0.1-0.25,0.3-0.5,0.3-0.8,0.3-1.5,0.6-1,0.6-1.3,0.7-1,1-1.7,1.2-2,1.2-3,1/5,2-3.5,4-5,4-6,abaxially,anther,apex,base,berry,blade,brown,calyx,cell,chartaceous,cm,densely,diameter,dull,elliptic,entire,equal,flattened-reniform,fruit,gray,herb,lateral,leaf,length,lobe,lobed,long,lower,margin,maturity,midpoint,mm,obtuse,orange-brown,outline,ovate,pedicel,peduncle,petiole,pit,poricidal,prickly,purple,raised,ray,red,rounded,shrub,simple,small,smooth,spherical,spreading,stellate,stellate-pubescent,stem,style,subentire,surface,tapering,terminal,tip,tube,unarmed,upper,weakly,white,wide,yellow	-2,-3,.1,.7,/3,/5,0-20,0.1,0.1-0.2,0.15-0.2,0.2-0.5,1,1-2,1-4,1.3-1.6,1.5-2,1/6-1/4,2-10,2-3,2/3-3/,3-5,4.5-7,5-merous,abaxial,absent,acuminat,acute,adaxial,alyx,ame,apar,apart,apically,apparently,articulated,bark,branched,c.,concolorous,cordate,curved,dark,deltate,difoliate,discolorous,drying,eaf,eed,elongating,erect,eye,faint,filament,filiform,flower,free,fruiting,geminat,glabrescent,glabrous,gra,herbaceous,infructescence,lanceolate,longer,mature,naked,nflorescence,oblong,older,one,open,orolla,oung,pair,pendulous,per,perfec,pericarp,persistent,porrect,portion,prickl,prickle,primary,red-green,reflexed,ruit,scandent,scar,shorter,sometimes,spaced,stalk,stalked,straight,subsessile,tamen,terete,tertiary,thick,thick-stalked,time,toward,trichome,unarme,unit,variously,vary,vein,venation,visible,way,yellow-green,ympodial	2/3-3/4,8,adhesion,arrangement,climate,colour,corolla,form,glandular,growth,hair,height,history,inflorescence,life,na,number,ovary,perennial,plant,position,presence,present,pubescence,reproduction,rugulose,seed,shape,size,staman,stigma,stipe,texture
749	wfo-0001031654	success	191	118	96	95	22	0.503	0.5-0.75,0.5-2,1-1.5,1-2,1-3,1-4,1.5-2,1.5-2.0,2-3,2-5,2-6,4-16,4-6,4-7,5-8,abaxial,abaxially,acute,adaxial,adaxially,anther,apex,armed,attenuate,base,brown,bud,calyx,chartaceous,cm,connivent,cream,cylindrical,dark,decurrent,densely,diameter,extra-axillary,filament,flower,fruit,glabrous,globose,green,hair,immature,leaf,leaf-opposed,like,lobe,lobed,many,margin,mature,mm,moderately,nearly,netlike,obtuse,onto,ovate,pedicel,peduncle,per,petiole,pit,porrect-stellate,prickle,pubescent,raised,recurved,red,reniform,ridge,rusty,scandent,separated,shrub,side,simple,slightly,small,sparsely,spreading,stellate,stem,stigma,style,surface,tan,tapering,tube,white,whitish,x,yellow	0.5,0.5-1,0.5-1.5,0.5-3.5,1,1-.,1.5-3,1/3-1/2,10-20,2-8,2-ranked,3,3-10,3-6,5-merou,8-15,absent,accrescent,adaxiall,alyx,apar,apical,apparently,axe,berry,beyond,blade,contiguous,cordate,cut,cylindrica,difoliate,directed,discolorous,eaf,eed,either,em,equa,exserted,flattened,frui,fruiting,geminate,glabrou,interpetaler,introrsel,lacking,less,long,lower,m.,major,midpoint,midrib,midvein,multicellular,multiseriate,narrowly,nflorescence,obscure,occasional,occasionally,often,orolla,pair,parallel,perfect,perpendicular,pore,rachi,ray,ruit,secondary,sinus,spaced,spine,stalk,stamen,ste,straight,tamen,thin-skinned,tissue,triangular,unarmed,unbranched,unicellular,unit,usually,vary,vein,way,wide,ympodial	armature,arrangement,colour,corolla,form,growth,height,history,inflorescence,length,life,na,ovary,plant,position,pubescence,seed,shape,size,staman,texture,type
750	wfo-0001031656	success	154	91	59	95	32	0.383	/4,0.5-1,1-1.5,1-2.5,1.2-1.5,1.5-2,1.5-5,10-20,3-3.5,4-9,6-8,acuminate,acute,anther,apex,base,bright,calyx,capitate,cm,corolla,densely,dia,ellipsoid,elliptic,fruit,glabrous,globose,green,greyish,leaf,live,lobe,lobed,margin,minutely,mm,oblique,opposite,ovary,ovate,papillose,pedicel,petiole,plant,red-papillose,rounded,shaped,shrub,size,stem,stigma,style,surface,tear-drop,tube,way,white,x	.5,0.5,1-2,2.5-3.5,3-5,5-7,5-ribbed,also,anthesi,arising,ba,bark,berry,closely,cork,differing,difoliate,directly,drying,eaf,edicel,eed,enclosing,erect,extremely,filament,fleshy,flower,free,fruiting,geminat,hooded,known,lateral,lon,long,long-acuminate,lower,main,major,matte,mature,middle,minor,minute,nflorescence,node,often,older,one,pair,pale,paler,papillo,peelin,persistent,planar,pore,poricidal,portion,prominent,proximal,rather,reddish,reflexed,rib,ridged,ruit,scar,sessile,shiny,slightly,somewhat,spaced,specimen,straight,strongly,swollen,tall,terminal,thick,thickened,tip,top,transversely,ud,unit,upper,vein,visible,wide,widest,woody,ympodial,young	adhesion,arrangement,blade,climate,colour,diameter,form,glandular,growth,hair,height,history,inflorescence,length,life,midpoint,na,number,peduncle,perennial,position,presence,pubescence,ray,reproduction,rugulose,seed,shape,staman,stellate,stipe,texture
751	wfo-0001031667	success	153	96	62	91	34	0.405	0.6-1,1-1.5,1.4-3,1.5-2,10-13,12-35,2.5-5,3-13,5-9,6-10,8-13,8-15,abaxially,acute,adaxially,apex,apiculate,base,calyx,caudate,cm,connate,cordate,corolla,cuneate,dark,diameter,distal,elliptic-lanceolate,globose,green,green-white,half,herbaceous,lanceolate,leaf,lobe,long,mm,oblique,oblong,odd-pinnate,ovoid,pedicel,peduncle,perennial,petiole,pilose,plant,rounded,seed,size,spot,stellate,stigma,stripe,style,throughout,tuber-bearing,white,wide,yellow	0.6-1.5,1-4,2-3,2-5,2-6,3-5,3-6-foliat,3-8,4-1.,5-15,abruptly,acumen,acuminate,apical,apically,articulate,branched,cell,covering,cyme,dehiscent,dichasial,dichasially,digestion,diminishing,dorsally,eaf,ebracteate,edge,eed,emoval,enzyme,exceeding,filament,flat,flower,folded,forked,generally,globo,hair-like,honeycomb,interjected,introrse,irregularly,lateral,leaflet,living,lobed,lon,lower,lunat,make,maturing,monochasial,mucilaginous,nflorescence,nther,often,orolla,pair,pattern,perfect,petiolate,petiolule,plan,poricidally,proximal,reveal,ruit,sessile,seudostipule,short,slit,specimen,stamen,straight,tal,tem,terminal,testal,thick,toward,typically,unit,vary,wall,whit,without,ympodial,¼	adhesion,anther,arrangement,blade,climate,colour,form,fruit,glandular,growth,hair,height,history,inflorescence,length,life,margin,midpoint,na,number,ovary,position,presence,pubescence,ray,reproduction,rugulose,shape,staman,stem,stipe,surface,texture,tube
752	wfo-0001031672	success	157	105	79	78	26	0.503	0-2,0.3-0.5,0.5-1.5,1,1-1.5,1-5,1.5-2,1.5-2.5,1.5-3.5,1.5-5,10-20,15-20,2-12,2-28,4,4-34,4.5-5,6,9-lobed,abaxially,acuminate,adaxially,apex,articulated,basal,base,calyx,chartaceous,cm,cordate,densely,diameter,entire,flattened,fruit,glabrous,glandular-puberulent,globose,green,greenish-brown,leaf,leaving,lobe,lobed,long,margin,mature,mm,moderately,narrowly,near,often,ovate,ovoid,pedicel,pedicellar,peduncle,petiole,pilose,pinnately,puberulent,pubescent,radiu,remant,simple,sparsely,stellate,stigma,style,subcoriaceous,toward,tree,triangular,truncate,unbranched,white,whitish,x,yellow	0,0.5,0.5-1,1-,1-10,1-2,15-50,3-4-foliat,3/4,4/5,5-6,absent,acute,aggregate,apart,ape,apiculate,aublet,axe,beyond,blade,cell,ciliat,connective,cylindrical,directed,distally,divided,eaf,eed,exceeding,exserted,fide,fleshy,flower,hair,lanceolate,lon,lower,membranaceous,midrib,nflorescence,nther,obtuse,occasionally,one,orolla,perfect,pilo,pore,presen,present,purple,rachi,represented,rounded,ruit,shorter,sinus,slightly,small,spaced,stamen,stone,tal,tem,thecae,time,tip,truncat,tube,ud,unit,unlobed,vary,wide,yello,ympodial	anther,arrangement,colour,corolla,form,growth,height,hermaphroditic,history,inflorescence,length,life,na,ovary,perennial,plant,position,pubescence,reproduction,rugulose,seed,shape,size,stem,surface,texture
753	wfo-0001031684	success	161	107	71	90	36	0.441	.25,.5,0.4-1.5,0.5-0.8,0.5-1,0.7-1,0.75-1,1-1.2,1-5,2,2-9,3-30,4-17,acuminate,acute,anther,apex,base,calyx,clavate,cm,corolla,decurrent,densely,dia,difoliate,elliptic,geminate,glabrous,globose,green,inflorescence,internodal,leaf,like,lobe,lobed,long,minutely,mm,occasionally,opposite,ovary,ovoid-reniform,pale,papillose,pedicel,petiole,pitted,poricidal,pubescent,rest,shrub,size,slightly,small,sparsely,stem,stigma,style,surface,tan,tip,tree,trichome,tube,unifoliate,uniseriate,white,winged,x	.75,/4,0.1,0.5-0.7,10-100,3-3.5,5-7,along,anthesi,apar,bark,bearing,beneath,berry,black,borne,branched,causing,curly,deflexed,denser,differing,drying,eaf,edicel,eed,elongated,except,expanded,exserted,extremely,filament,filiform,flower,free,fruiting,gre,greatly,irregularly,lateral,less,lon,long-triangular,lower,main,major,middle,midrib,minor,nflorescence,obconic,older,one,pair,papillo,persistently,planar,pore,portion,present,previously,pulled,raised,reflexe,reflexed,ruit,scar,shaped,short,single,siz,slender,soon,spaced,straight,tall,tapering,tear-drop,time,tipped,ud,unevenly,unit,varying,vein,way,widely,widest,ympodial,young	adhesion,arrangement,blade,climate,colour,diameter,form,fruit,glandular,grey,growth,hair,height,history,length,life,margin,midpoint,na,number,peduncle,perennial,persistent,plant,position,presence,pubescence,ray,reproduction,rugulose,seed,shape,staman,stellate,stipe,texture
754	wfo-0001031690	success	140	114	78	62	36	0.557	1.2-2.0,1/2-2/3,2-3,2-5,2.5-3.5,2.7-3.6,4-9,7-10,accrescent,acute,anther,apex,apically,arcuate,base,bearing,beneath,berry,blade,blue,broadly,brown,calyx,campanulate,cm,da,dark,depressed-spherical,developing,dm,dry,eglandular,erect,foveolate,glabrate,glabrous,green,hair,herb,internodal,invested,lanceolate,length,linear,lobe,long,maturity,minutely,mm,numerous,often,ovate,pedicel,perennial,petiole,prickly,reflexed,reniform,sessile,shape,slender,slightly,splitting,spreading,stellae,stellate,stem,stipitate-glandular,strait,tapering,tightly,tube,uniseriate,violet,violet-tinged,viscid-glandular,yellow,zygomorphic	.5,2-8,2/3,6-9-flowere,8-40,acro,along,always,alyx,anthesi,cauline,completely,corky,covered,difoliate,divided,eaf,eed,emerging,exceeded,geminat,least,lon,main,nflorescence,obtuse,orolla,per,persistent,pinnatifid,prickle,rarely,rhizome,root,rounded,ruit,scattered,separated,short,slende,somewhat,space,tall,tamen,terete,thrice,throughout,tigma,tub,twice,tyle,ultimate,unexpande,unit,usually,variable,vary,vein,widely,yearly,ympodial,young	adhesion,arrangement,climate,colour,corolla,diameter,form,fruit,glandular,growth,height,history,inflorescence,leaf,life,margin,midpoint,na,number,ovary,peduncle,plant,position,presence,pubescence,ray,reproduction,seed,size,staman,stigma,stipe,style,texture,unexpanded,ye
755	wfo-0001031695	success	185	113	78	107	35	0.422	0.5-1,1-2,1-9,1.5-8,2-3,2-4,2-5,2.5-5,20-30,3-19,3-7,4-10,4-5,4-6,5-20,5-7,6-10,6-20,abaxially,abruptly,acuminate,adaxially,also,apex,base,blade,calyx,campanulate,chartaceous,cm,cordate,dark,deep,densely,diameter,ellipsoidal,entire,flattened,fruit,glabrous,glandular-puberulent,green,greenish,hair,immature,lavender,leaf,lobe,lobed,margin,mm,moderately,mottled,narrowly,oblique,ovate,pedicel,peduncle,petiole,pilose,pilose-hirsute,puberulent,pubescent,purple,purplish,shrub,simple,sometimes,sparsely,stigma,stripe,style,subcoriaceous,tree,triangular,tube,x,yellow	0.5-2,1,1-3,1.5-2,1/2,1/3,10-,10-15,10-35,15-20,3-,3-10,3-17,30-40,4-foliat,5,6-8,7-,?,acute,aggregate,apart,ape,apically,apiculate,articulated,axe,basal,beyond,branched,broadened,capitat,cell,color,connective,connivent,cylindrical,d,dilated,directed,divided,eaf,eed,eglandular,eglandular-pilose,exceeding,exserted,fleshy,flower,glabrate,glabrescent,hard,lanceolate,lateral,laterally,leaving,lilac,lon,long,lower,midrib,nflorescence,nther,oblong,obtuse,occasionally,often,orolla,ovoid,pedicellar,perfect,pilo,pilose-hirsut,pore,presen,present,puberulent-pubescent,rachi,radiu,remnant,ripe,rounded,ruit,shorter,sinus,slight,slightly,small,somewhat,spaced,stamen,stone,swelling,tal,tem,thecae,time,tip,tomento,unbranched,unequal,unit,unknown,unlobed,vary,wide,ympodial	adhesion,anther,arrangement,capitate,climate,colour,corolla,form,glandular,growth,height,history,inflorescence,length,life,midpoint,na,number,ovary,plant,position,presence,pubescence,ray,reproduction,rugulose,seed,shape,size,staman,stellate,stem,stipe,surface,texture
756	wfo-0001031697	success	185	102	65	120	37	0.351	.4,.5,.7,1,1.2,2-celled,3,4,4.5,?,abaxially,adaxially,anther,apex,attenuate,base,blade,calyx,cm,cordate,densely,diameter,entire,except,flattened,flower,free,fruit,glabrous,gland-tipped,globose,hair,herbaceous,lobe,long,margin,midpoint,minute,mm,mostly,ovate-lanceolate,pedicel,peduncle,petiole,pilose,plant,pubescence,purple,similar,simple,size,sparsely,stellate,stem,stigma,style,subreniform,subshrub,thin-textured,tip,tube,white,x,yellow,yellow-brown	-celled,.6,.8,0.1,0.3,0.4,0.5,0.6–1.0,0.8,1.2–2.5,1.4,1.5–7,10-celled,15,15–60,1–1.6,1–2,2-foliate,2.2,2–3,2–4,3.5,3–4,3–8,4-rayed,4–5,5,6–13,accrescent,acute,apparently,around,axe,branch,completely,consistently,covering,cylindrical,directed,distall,divergent,eaf,eed,especially,face,fertile,few-celled,filament,flowering,foveolate,frui,fruiting,geminat,glabrou,gland-tippe,hilum,hyaline,indentation,lacking,less,linear,lon,longer,longest,lower,lowermost,lowest,major,many,mixed,nflorescence,non-glandular,often,orolla,ovate,part,per,pigment,pore,prickle,pubescent,raised,ruit,scattered,sessile,several-celled,shallowly,sharp,shiny,short,shorter,single,slender,small,smaller,somewhat,ste,stellae,straight,tall,tamen,taproo,tem,terminal,thick,time,truncat,tuberculate,ultimate,unarme,unarmed,unbranched,unit,upper,vary,varying,vein,wide,ympodial,–3	1-1.6,1.2-2.5,15-60,3-4,3-8,4-5,6-13,adhesion,arrangement,climate,colour,corolla,form,glandular,growth,height,history,inflorescence,leaf,length,life,na,number,ovary,position,presence,present,ray,reproduction,rugulose,seed,shape,staman,stipe,surface,texture,truncate
757	wfo-0001031698	success	58	72	27	31	45	0.466	2-2.5,2.5,2.5-3,4-4.5,base,cm,dull,elliptic,flattened,glabrous,green,leaf,margin,minutely,mm,pale,pedicel,pitted,reddish-brown,reniform,repandly,rugose,shrub,stem,surface,woody,x	'',``,ape,bark,branch,decurrent,deflexed,dia,difoliate,eaf,eed,fide,fruiting,geminat,incrassate,long,maguire,older,otherwise,paler,papillae,persistin,stout,strongly,tall,unit,wing,winged,yellowish,ympodial,young	1,adhesion,anther,apex,arrangement,blade,calyx,climate,colour,corolla,diameter,form,fruit,glandular,growth,hair,height,history,inflorescence,length,life,lobe,midpoint,na,number,ovary,peduncle,petiole,plant,position,presence,pubescence,ray,reproduction,rugulose,seed,shape,size,staman,stellate,stigma,stipe,style,texture,tube
758	wfo-0001031707	success	178	101	84	94	17	0.472	.5,/4,1-1.2,1-1.3,1-1.5,1-3,1.2-1.8,1.2-2,1.5-6,16-20,2-10,2-4,2-6,4-5,6-7,8-12,9-15,abaxially,adaxially,almost,along,anther,apically,axillary,base,brown,calyx,capitate,climbing,cm,conical,corolla,dense,densely,diameter,elliptic,erect,flattened,glabrous,globose,green,greenish,high,lanceolate,lateral,leaf,leaflet,lobed,long,mm,narrowly,obovate,ovary,pair,pedicel,petiole,pink,pinnate,plant,pointed,poricidal,pubescent,reddish,round,sagittate,scattered,simple,slightly,smooth,sparsely,stigma,style,terminal,ternate,tip,trichome,tube,uniseriate,vein,vine,way,white,woody,x	-3,0.5-1,1.5-1.7,1.5-2,1/3,2,2-3,24,3,4-6,5-10-celled,80-140,absent,acuminate,acute,anthesi,apex,apical,attenuate,axil,basal,basiscopically,bearing,berry,c.,cateniform,cell,clavat,conspicuously,cucullate,distal,distinct,drying,eaf,edicel,eed,endrophilum,enlarged,epidermal,exserted,filament,flap-like,flat,fleshy,flower,four-lobed,free,fruiting,horizonta,inflorescenc,less,like,lobe,lon,lower,margin,minutely,narrower,nflorescence,oblique,occasionally,open,papillate,penden,per,petiolule,planar,portion,primary,quadrate,quite,raised,regular,rest,ruit,scar,smaller,somewhat,spaced,stout,strongly,surface,tem,thickening,time,tub,type,ud,unifoliat,unit,usually,white-lenticellate,widely,ympodial	arrangement,clavate,colour,form,fruit,growth,height,horizontal,inflorescence,length,position,pubescence,seed,shape,size,stem,texture
759	wfo-0001031714	success	201	116	93	108	23	0.463	-3.5,-6,-8,0.2-0.5,0.3-0.5,0.4-,0.5,0.5-,0.5-0.8,0.7-2.2,1,1-1.4,1-2,1-3,1-4,1.5-2,1.5-2.4,2-3,3-3.5,6-8.5,7-10,7-8,abaxially,absent,anther,apex,base,berry,bright,broadly,calyx,capitate,cm,conical,corolla,dense,diameter,elliptic,entire,flattened,glabrous,globose,greyish,growth,inflorescence,juicy,leaf,less,lobe,lobed,margin,membranous,minutely,mm,narrowly,nearly,often,orbicular,ovary,pale,pedicel,peduncle,petiole,poricidal,pubescence,pubescent,rarely,ray,red,reniform,ripe,rounded,shallowly,shoot,short,shrub,simple,size,sparsely,stellate,stem,stigma,style,surface,tapered,terminal,thin,tip,trichome,tube,white,x,yellow	.25,0.15-0.3,0.5-0.6,0.8-1.2,2,2-3.5,2-4,3-4,3-6,4-merous,6,7,<,?,abaxial,adaxially,anthesi,appearing,arising,armed,articulated,axi,bark,basal,broad,broad-based,caly,cell,closely,cup-shaped,densely,eaf,eed,ellipsoid,elongate,enlarged,equal,erect,especially,exserted,extending,filament,flower,foliose,free,frui,fruiting,irregular,leafy,lengthening,like,lon,long,longer,lower,markedly,midpoint,midrib,mixture,new,nflorescence,numerous,oblique,obvious,occasionally,older,pair,papillo,per,perfect,pericarp,pitted,planar,plate,plurifoliat,pore,portion,prickle,prickly,primary,rectangular,ruit,scar,sessile,short-stalked,shorter,sinuate,slightly,slit,smaller,sometimes,spaced,spreading,stalked,stout,straight,strongly,testal,tiny,truncate,ud,unarmed,unit,upper,usually,vein,woody,ympodial	arrangement,colour,form,fruit,height,hermaphroditic,history,length,life,na,number,papillose,perennial,plant,position,presence,present,reproduction,rugulose,seed,shape,stipe,texture
760	wfo-0001031721	success	208	113	87	121	26	0.418	%,0.2-0.5,0.25-0.5,0.3-1.1,0.4-0.6,0.4-2.2,0.6-1.2,0.8-1.3,1-1.5,1-3.5,1.1-3.2,1.2-1.7,11-30,2-4,2.5-3,2.7-3.5,3-4.5,3-7,4-7,5-20,5-7,6-9,7-8,8.5-12.5,andromonoecious,anther,apex,base,black,blade,brown,calyx,chartaceous,cm,cuneate,dark,densely,diameter,elliptic,entire,extra-axillary,flattened,fruit,glabrous,globose,green,grey,herbaceous,inflorescence,lamina,lanceolate,lateral,lavender,leaf-opposed,length,lobe,long,margin,minutely,mm,moderately,obtuse,ovate,pale,pedicel,peduncle,petiole,plant,present,purple,ray,resprouter,reticulate,simple,sparsely,stellate,stellate-pubescent,stem,stigma,streak,style,surface,time,tube,x,yellow,yellowish-green	.1,0-0.1,0-1,0-3,0-5,0.1-0.2,0.1-0.5,0.25-0.4,0.4-0.7,0.4-1.6,0.6-1.1,0.7-1.2,0.7-1.3,1,1-20,1-3,1.5,2.2-3.2,3-10,3-foliate,4-5,4-locular,5-11,5-merou,6-15,7-10,7-9,8-15,8-20,abaxially,absen,absent,accrescent,acicular,across,adaxiall,adaxially,alyx,anvil-shape,apart,articulated,axe,ba,capitat,confined,connivent,cross-section,curved,cylindrical,d.,deltate,directed,distall,distributed,dult,eaf,eed,eglandular,erect,exocarp,filament,finger,flower,fruiting,functional,geminat,gland-tipped,hair,half,heterostylous,hig,juicy,less,longer,lower,mature,mesocarp,mid-point,midpoint,midrib,midvein,minute,moist,nflorescence,oblique,orolla,part,per,placenta,pore,porrect,possibly,prickle,pseudo-racemose,rachi,ruit,semi-circular,sessile,short,solitary,somewhat,spaced,stage,stalk,stalked,stellae,straight,tamen,thick,throughout,unarme,unarmed,unbranched,unit,uvenile,vary,weakly,white,wide,yellowish,ympodial	adhesion,arrangement,capitate,colour,corolla,form,growth,height,history,leaf,life,na,number,ovary,perennial,position,presence,pubescence,reproduction,rugulose,seed,shape,size,staman,stipe,texture
761	wfo-0001031723	success	228	137	107	121	30	0.469	-1.5,-16,-5,-6.5,0.1-0.5,0.4-,0.4-1,0.55-0.9,0.6-1,1-,1-2,1-2.5,1-3,1.2-2,1.5-,10-30,2-,2-3.5,2-5.5,2.5-4.5,2.5-5,2/3-3/4,4-10,4-11,4-20,4-6,abaxial,abaxially,acuminate,acute,anther,apex,base,berry,blade,brown,calyx,chartaceous,cm,connivent,cuneate,dark,densely,diameter,drying,dull,entire,equal,erect,evenly,flattened-reniform,fruit,glabrescent,glabrous,glandular,green,hair,lateral,leaf,length,lobe,lobed,long,margin,marking,maturity,mauve,midpoint,minute,mm,moderately,near,obtuse,orange,orange-brown,ovate,pale,pedicel,peduncle,petiole,poricidal,ray,red,rounded,shrub,simple,smooth,sometimes,sparsely,spherical,stellate,stellate-pubescent,stem,style,subentire,surface,tapering,terminal,tip,trichome,tube,way,weakly,white,wide,yellow,young	-1/2,-15,-2,-6,-8,-merous,0,0.05-0.2,0.1-0.2,0.1-0.3,0.15,0.2-1,0.4,0.4-0.9,0.7-1,0.8-1.5,1-5,1.5-10,1.5-2.5,1/3-1/2,1/4-1/3,1/6-,15-45,2-7,2/3,3-10,3-15,4-,4-5,5-40,5-9,8-20,acut,adaxial,alyx,ame,apar,apart,apically,apparently,articulated,ba,bark,branched,branching,brow,c.,conical,curved,deltate,discolorous,eaf,eed,elongated,elongating,eye,filament,filiform,finely,flower,free,fruiting,gently,gland,gland-tipped,gray,herbaceous,inflated,infructescence,longer,lower,mature,multangulate,naked,narrow-deltate,nflorescence,older,one,open,orolla,oung,pair,per,perfec,pericarp,perpendicular,plurifoliat,porrect,portion,prickle,prickly,primary,recurved,reflexed,ruit,scar,secondary,sessile,spaced,spreading,stalk,stalked,straight,strongly,tamen,terete,tertiary,time,unarme,unarmed,unit,usually,variously,vary,vein,venation,visible,whitish,woody,yellow-green,ympodial	1-15-45,adhesion,arrangement,climate,colour,corolla,form,growth,height,history,inflorescence,life,na,number,ovary,perennial,plant,position,presence,present,pubescence,reproduction,seed,shape,size,staman,stigma,stipe,texture,unknown
762	wfo-0001031729	success	161	89	62	99	27	0.385	-2,-45,0.5-1,1-1.5,1-2,1.5-2,11-30,2.5-5,3-4,4.1-16,5-6,5-7,along,anther,base,beneath,calyx,cm,conical,corolla,dark,darker,diameter,elliptic,flattened,fruit,glabrous,globose,green,greenish,lobe,lobed,long,minutely,mm,mottling,nearly,obovate,occasionally,ovary,ovate-reniform,pale,papillae,papillose,pedicel,peduncle,petiole,pink,purplish,reddish,scattered,shrub,smooth,stem,stigma,stripe,surface,tan,tube,vein,white,x	-0.5,..,0.5,0.5-4,0.6-,1-2.5,1.0-1.3,1.5,10-20,12-13,2-2.5,2-3,2.5-,3-celled,3.5-4,5-,50,8-9,abruptly,acuminate,anthesi,apex,apicula,apiculate-deltate,attenuate,branc,branch,branched,brittle,brow,c.,cell,cucullate,curve,deltate,dry,drying,eaf,edicel,eed,elongate,erec,filament,flattened-capitat,flower,fruiting,glandular,gradually,later,less,lower,markedly,membranous,middle,minute,narrowly,never,nflorescence,noddin,open,outer,outline,pair,papillate,per,pericarp,planar,plurifoliat,point,pointed,primary,quadrate,regularly,ruit,scar,short,single,single-stemmed,sinuate,small,somewhat,striate,testa,thin,thing,time,tip,toward,triangular,trichome,tuft,ud,unit,usually,wall,wand-like,widening,ympodial,young	0.5-2,0.6-2.5,arrangement,brown,colour,flattened-capitate,form,growth,height,history,inflorescence,leaf,length,life,na,perennial,plant,plurifoliate,position,pubescence,reproduction,rugulose,seed,shape,size,style,texture
763	wfo-0001031738	success	231	119	88	143	31	0.381	-15,0.25-0.8,0.3-1,0.7-1.1,1-1.5,1-4,1.4-1.7,1.5-4,1/3,10-15,15-40,2.3-3,3.5-3.8,3.5-4.5,4-6,4-8,5-8,7-12.5,8-10,8-18,abaxially,acute,adaxially,andromonoecious,anther,apex,auriculate,base,berry,blade,calyx,chartaceous,cm,connivent,cordate,densely,diameter,dull,erect,evenly,flattened-reniform,fruit,glabrescent,green,lateral,leaf,length,lobe,lobed,long,lower,margin,maturity,midpoint,mm,orange,orange-brown,ovate,pale,pedicel,peduncle,petiole,plant,poricidal,ray,shrub,simple,small,smooth,sometimes,spherical,stellate,stellate-pubescent,stem,style,surface,tapering,terminal,tip,tree,truncate,tube,upper,weakly,white,wide,yellow,young	-5,-6,-merous,.5,0,0-2,0-3,0.1-0.25,0.2-0.3,0.7-1,0.9-2.1,1-1.8,1-3,1.5-,1/,1/2-2/3,1/3-2/3,1/4-1/3,1/6-1/4,2-,2-4,20-200,3-4,3-6,3-7,4,4-10,4-5,5,6-15,7-12,abaxial,acuminat,adaxial,almost,always,alyx,apar,apart,apically,apparently,articulated,bark,branched,cell,curved,dark,deltate,discolorous,distal,distance,drying,eaf,eed,elongating,equal,extending,filament,flattened,flower,free,frequently,fruiting,glabrous,gray,held,hermaphrodite,heterostylous,infructescence,inside,lobing,long-styled,longer,lowermost,mature,midvein,multangulate,narrow-deltate,nflorescence,oblong,obovate,often,older,one,open,orolla,oung,outline,pair,per,pericarp,pit,plurifoliat,poorly,porrect,portion,prickl,prickle,prickly,primary,prominent,pubescent,raised,reflexed,resin,rounded,ruit,scar,secondary,sessile,short-styled,shorter,side,spaced,sparsely,spreading,stalk,stalked,staminat,sticky,stout,straight,strongly,tamen,terete,tertiary,time,trichome,unarmed,unit,usually,variously,vary,vein,venation,visible,way,white-brow,woody,yellow-green,yellow-orange,yellowish,ympodial	1/4,adhesion,arrangement,climate,colour,corolla,form,glandular,growth,hair,height,history,inflorescence,life,na,number,ovary,perennial,position,presence,present,pubescence,reproduction,rugulose,seed,shape,size,staman,stigma,stipe,texture
764	wfo-0001031752	success	172	131	96	76	35	0.558	-10,-47,-6,-pubescent,0.5-1,0.5-1.5,1,1-1.5,1-2,1-4,1.5-2,1.5-3,1.5-3.5,15-25,2-2.5,2-3,2-5,20-35,3-11.5,3-4,3-7,3.5-15,3.5-5,5-23,5-6,5-8,abaxially,acuminate,acute,adaxially,apex,basal,base,blade,calyx,chartaceous,ciliate,cm,cuneate,darker,densely,diameter,ellipsoidal,elliptic,entire,flattened,fruit,fusiform,glabrate,glabrescent,glabrous,gland,glandular-puberulent,green,immature,lanceolate,less,light,lobe,margin,mm,moderately,oblong,often,older,ovate,pedicel,peduncle,petiole,pink,puberulent,pubescent,purplish,ripe,rounded,rugose,shrub,simple,small,sparsely,stalked,stellate,stigma,stripe,style,subcordate,subcoriaceous,tomentose,tree,truncate,tube,white,wide,x,yellow,young	-100,-3,-44,1-,1-3,1.5-10.5,1.5-2.5,15-40,3-4-foliat,8-15,9-16,aggregate,apart,ape,apiculate,articulated,axe,beyond,cell,ciliat,connective,connivent,cylindrical,deltate,directed,distally,eaf,eed,equal,exceeding,exserted,fleshy,flower,glandular-puberulen,leaving,linear,lon,long,lower,membranaceous,narrowly,near,nearly,nflorescence,nther,obtuse,olde,orolla,ovoid,pedicellar,perfect,pore,presen,present,purpl,rachi,radiu,remnant,ruit,slightly,spaced,stamen,stone,swelling,tal,tem,thecae,time,tip,triangular,truncat,ud,unbranched,unit,vary,ympodial	adhesion,anther,arrangement,climate,colour,corolla,form,glandular,growth,hair,height,history,inflorescence,leaf,length,life,midpoint,na,number,ovary,plant,position,presence,pubescence,ray,reproduction,rugulose,seed,shape,size,staman,stem,stipe,surface,texture
765	wfo-0001031756	success	186	109	77	109	32	0.414	.5,0-2,0.02-0.2,0.4-1.6,0.5-1,0.5-1.3,0.6-1.2,0.7-1.7,0.8-1,1-1.8,1-4,1.5-2,1.5-3.5,1.8-2.5,4-5,7-10,9-14,anther,apex,base,berry,blade,calyx,chartaceous,cm,color,cordate,densely,diameter,entire,erect,evenly,flattened-reniform,fruit,glabrous,gray,green,known,leaf,lobe,lobed,long,margin,mature,mauve,midpoint,mm,moderately,orange-brown,ovate,pale,pedicel,peduncle,petiole,poricidal,ray,red-brown,rounded,scandent,shoot,short,shrub,simple,spherical,stellate,stellate-pubescent,stem,style,surface,tapering,terminal,tip,truncate,tube,white,wide,young	-1,-5,.1,.8,/2,0,0-5,0.1,0.15-0.25,0.2,0.6-1.6,00,1-2,1-3,1/2,1/3,10,2-6,3-15,3-5,3-7,4.5,5-merous,6-9,abaxially,accrescent,acut,alyx,apar,apart,apically,apparently,articulated,bark,branched,broad-deltate,concolorous,conical,connivent,curved,deltate,drying,eaf,eed,elongating,enclosing,equal,eye,filament,finely,flower,free,fruiting,fully,glabrescent,glabrou,herbaceous,inflated,infructescence,invested,longer,lower,naked,nflorescence,older,one,open,orolla,oung,pair,pendulous,per,perfec,pericarp,perpendicular,pitted,plurifoliat,porrect,portion,prickl,prickle,prickly,primary,ruit,scar,sessile,shorter,slender,small,smooth,spaced,sparsely,spreading,stalk,stalked,straight,tamen,terete,time,trichome,unarmed,unit,variously,vary,vein,visible,way,yellow-green,ympodial	adhesion,arrangement,climate,colour,corolla,form,glandular,growth,hair,height,history,inflorescence,length,life,na,number,ovary,perennial,plant,position,presence,pubescence,reproduction,rugulose,seed,shape,size,staman,stigma,stipe,texture,ye
766	wfo-0001031761	success	207	113	81	126	32	0.391	-6.5,0-12,0.2-0.4,0.3,0.3-2.8,0.5-0.7,0.7-1.3,0.75-1.7,0.9-2,1,1.5-4.2,1.5-6,1.8-2.3,1/2,1/3,2-3.5,2-8,2.5-3.1,2.5-5.5,3.2-3.5,7-9,abaxially,acute,anther,apex,base,berry,blade,calyx,cm,connivent,cordate,densely,diameter,dull,erect,flattened-reniform,fruit,glabrous,lateral,leaf,length,lobe,lobed,long,lower,margin,maturity,mauve,midpoint,mm,orange,orange-brown,ovate,pedicel,peduncle,petiole,poricidal,purple,ray,red,rounded,scandent,shrub,simple,smooth,sparsely,spherical,stellate,stellate-pubescent,stem,style,surface,tapering,thick-chartaceous,tip,tube,upper,weakly,wide,yellow	-12,-20,-3/,-7,.4,.5,0,0-0.4,0-10,0-15,0-25,0-4,0-5,0.3-0.4,0.5,0.5-1.5,0.6-1.2,0.7-1.6,1-3,1-4,1-8,1.5,1/2-2/3,1/3-2/3,1/4-1/3,2,2-4,3-15,3-5,4-6,4-7,5-merous,acicular,acut,alyx,ame,apar,apart,apically,apparently,articulated,bark,branched,brow,c.,cell,concolorous,curved,deltate,difoliate,discolorous,distance,drying,eaf,eed,elongating,equal,extending,faint,filament,flattened,flower,free,fruiting,fully,geminat,gray-green,infructescence,longer,mature,midvein,moderately,narrow-oblong,nflorescence,older,one,open,opening,orolla,oung,outline,pair,pale,per,perfec,pericarp,perpendicular,pit,porrect,portion,prickle,prickly,primary,raised,recurved,red-green,scar,sessile,shallow,side,slender,small,sometimes,spaced,spreading,stalk,stalked,straight,tamen,terete,tertiary,time,trichome,uit,unarme,unarmed,unit,variously,vary,vein,venation,visible,way,woody,yellow-green,ympodial	-3/4,adhesion,arrangement,climate,colour,corolla,form,glandular,growth,hair,height,history,inflorescence,life,na,number,ovary,perennial,plant,position,presence,present,pubescence,reproduction,rugulose,seed,shape,size,staman,stigma,stipe,texture
767	wfo-0001031786	success	209	116	83	126	33	0.397	0.2-2.5,0.25-0.5,0.5-1.5,0.7-1.6,0.8-1.2,1-3,1-6,1.2-1.6,1.5-2.5,2-3,2.5-3.5,3-4,4-5,6-8,abaxially,acute,anther,apex,base,becoming,berry,blade,calyx,chartaceous,cm,cuneate,deep,densely,diameter,elliptic,equal,evenly,flattened-reniform,fruit,glabrescent,glabrous,gray,green,herb,lateral,leaf,length,lobe,lobed,long,margin,maturity,mauve,membranous,midpoint,minute,mm,orange,orange-brown,ovate,pale,pedicel,peduncle,petiole,poricidal,ray,red,shrub,simple,smooth,sparsely,spherical,stellate,stellate-pubescent,stem,stigma,style,surface,tapering,tip,trichome,truncate,tube,weakly,white,wide,yellow-orange,young	-5,.4,.5,/2,/3,0,0-2,0-20,0-3,0-5,0.1,0.1-0.4,0.2-0.3,0.7-1,0.7-4,0.8,1,1-2,1-4,1.5-1.9,1/3-1/2,2-13,2-7,2-8,3-5.5,5-7,5-merous,8-12,acut,almost,alyx,ame,apar,apart,apically,apparently,articulated,bark,branched,c.,cell,clavat,concolorous,connivent,curved,dark,deltate,distance,drying,eaf,eed,elongating,erect,extending,eye,filament,filiform,flattened,flower,free,fruiting,gray-brow,herbaceous,inconspicuous,infructescence,lon,longer,lower,mature,midvein,naked,nflorescence,obtuse,older,one,open,orolla,oung,outline,pair,pendulous,per,perfec,pericarp,pit,plurifoliat,porrect,portion,prickl,prickle,prickly,primary,raised,red-brown,reflexed,rounded,ruit,scandent,scar,sessile,shiny,shorter,side,slightly,small,sometimes,spaced,spreading,stalk,stalked,straight,tamen,terete,tertiary,thick,time,unarmed,unit,variously,vary,vein,venation,visible,way,woody,ympodial	4,adhesion,arrangement,clavate,climate,colour,corolla,form,glandular,growth,hair,height,history,inflorescence,life,na,number,ovary,perennial,plant,position,presence,present,pubescence,reproduction,rugulose,seed,shape,size,staman,stipe,texture,unknown
768	wfo-0001031791	success	288	114	70	218	44	0.243	.3,.5,.9,3,acute,adnate,anther,apex,attenuate,base,blade,calyx,chartaceous,cm,cordate,corolla,diameter,dry,entire,erect,extra-axillary,flattened-reniform,flattened-suborbicular,fruit,glabrous,glandular,globose,green,hair,inflorescence,lanceolate,lateral,lavender,leaf,length,lobe,margin,maturing,midpoint,mm,nearly,orange-red,oval,pedicel,peduncle,petiole,ray,rounded,shiny,shrub,simple,slender,small,somewhat,stellate,stem,stigma,stipe,style,subcoriaceous,surface,tree,triangular,truncate,tube,wavy,white,yellow,yellow-brown,yellow-tan	.08,.2,.4,0.04,0.2,0.3–0.5,0.3–0.6,0.3–0.7,0.4–0.6,0.5,0.5–0.6,0.5–1.0,0.7,0.7–0.8,0.7–1.0,1.1–1.4,1.3–1.8,1.5,1.5–1.9,1.5–2.3,1.5–3.0,1.6,1.6–2.2,1.7–2.3,1.8,1.9–2.2,1/3,11–14,11–15,13.0–30.0,15.0,2.0–11.0,2.0–2.5,2.6–3.4,2.8–3.3,2/3,3.0,3.0–3.5,33–54,4.6–5.4,4.9,4.9–7.4,5-merou,6.0,6.0–14.0,6.2–8.5,7.0–9.0,7–10,7–8,8.0–11.0,8–12,9.0–16.0,abaxially,across,adaxiall,adaxially,alveolate,alyx,anthesi,apical,apiculate,apparently,appearing,appressed,area,around,articulated,attachment,axe,ba,backward,berry,branch,broad,broad-based,brochidodromous,bud,capitat,central,channeled,congested,connivent,curved,dehiscence,densely,dentate,developed,development,difoliate,distally,distinct,dorsally,drying,eaf,eed,either,emerging,endocarp,entir,especially,fertile,filament,filiform,first,flexed,flower,fork,free,frui,geminat,glabrescent,gradually,homostylous,immature,inclined,increasing,internode,interpetalar,intersepalar,juic,juvenile,lamina,large,largest,light,like,line,lon,long,longer,lower,m.,major,material,mature,membranaceous,middle,midrib,midvein,minor,minute,moderately,multangulate,nflorescence,notched,numerous,oblique,obscured,often,one,orolla,oung,ovoid,particularly,persisting,point,poorly,pore,porrect,porrect-stellate,portion,potentially,preserved,prickle,project,pubescent,raised,rigid,ripe,row,rugose,ruit,scarcely,scattered,sessile,short,shorter,side,single,sinus,slightly,smaller,smooth,sometimes,sparsely,splitting,stamen,stellae,stellate-pubescen,stipitate,straight,suture,tamen,tardily,thrice-branched,time,tip,tissue,totally,translucent,twice,two,ud,unarmed,undulate,various,vary,vein,weakly,well,wide,ympodia,young,±90°at,±equal,±glabrous,±laterally,×	0.08,0.3-0.5,0.3-0.6,0.3-0.7,0.4-0.6,1.5-1.9,1.5-3.0,13.0-30.0,2.0-11.0,2.0-2.5,2.8-3.3,6.2-8.5,7-8,7.0-9.0,8-12,8.0-11.0,adhesion,arrangement,capitate,climate,colour,dense,form,growth,height,history,life,moderate,na,number,ovary,perennial,plant,position,presence,present,pubescence,reproduction,rugulose,seed,shape,size,staman,texture
769	wfo-0001031793	success	188	104	75	113	29	0.399	-4,1-1.5,1-2,1-8,1.5-4,10-15,13-20,15-20,2-3,2-5,8-11,acuminate,aging,almost,anther,apex,base,black,blade,broadly,brown,brownish,calyx,capitate,chartaceous,cm,cuneate,densely,diameter,elliptic,extra-axillary,flattened,flower,fruit,glandular,globose,hair,inflorescence,leaf,lobe,long,margin,midpoint,minutely,mm,mucilaginous,oblong-lanceolate,orange-yellow,orbicular-ovate,pedicel,peduncle,petiole,pubescent,reddish,rounded,rusty,shallow,shrub,simple,size,small,stellate,stellate-pubescent,stem,stigma,style,surface,tree,trichome,tube,well-developed,white,x,yellow,yellow-brown	.5,0,1,1-3,1.5-2,1/3,1/4,1/5,20,26,3-4,3-8,3/4,4,40,5-merous,7,absent,abundant,accrescent,acumen,acute,adult,alyx,apparently,armed,articulated,aspect,axe,ba,berry,bilobe,branche,branched,broad,central,cut,difoliate,distal,eaf,eed,elongatin,erec,erect,evident,extreme,ferrugineous,filament,forked,fruiting,geminat,general,homostylou,interpetalar,larger,linear,lobing,lon,lower,main,many,maturing,midrib,mostly,nflorescence,oblique,obtuse,often,older,orolla,ovate,per,perfect,pore,porocidal,porrect,prickle,principal,rachi,reduced,reticulation,ruit,scarcely,scattered,sessile,side,similar,single,sinus,smaller,sparsely,stellate-pubescen,stipitate,stout,tall,tamen,tem,testa,thickened,tip,tissue,triangular,triangular-acuminat,unarmed,unbranched,unit,upward,usually,uvenile,vary,way,woody,ympodial	adhesion,arrangement,bilobed,climate,colour,corolla,form,growth,height,history,length,life,na,number,ovary,perennial,plant,position,presence,present,pubescence,ray,reproduction,rugulose,seed,shape,staman,stipe,texture
770	wfo-0001031795	success	234	113	85	149	28	0.363	0.5,0.5-2,1-1.2,1-1.3,1.5-2,1.5-4,10-12,2-2.5,2-6,2.5-3,3,3-4,4-6,6-8,9-17,acuminate,acute,anther,apex,base,blade,calyx,capitate,cm,conical,connivent,densely,diameter,elliptic,entire,evenly,flattened,glabrous,glandular,globose,grayish,green,growth,lateral,leaf,leaf-opposed,lobe,lobed,long,margin,matte,membranous,midpoint,minutely,mm,oblique,occasionally,ovate,pale,pedicel,peduncle,petiole,plant,poricidal,pubescent,ray,reniform,shallowly,shape,shiny,shrub,simple,size,slightly,sparsely,stellate,stellate-pubescent,stem,stigma,style,surface,tan,tapering,thin,tip,truncate,tube,white,wide,yellowish	..,.2,.5,0.5-1,1,1-3,1-4,1/3,10,100,2/3,4-,4-5,5,5-12,5-40+,5-merous,5.5-,50,7-9,<,>,abaxial,abaxially,absent,adaxial,adaxiall,alf,almost,along,always,alyx,anthesi,apar,armed,around,articulated,bark,berry,branched,broad-based,broadly,brownish,c.,caudate,cell,clearly,curved,dark,deeply,denser,differing,difoliate,directed,discolorous,distally,dry,eaf,eed,equal,filament,flower,free,fruiting,geminat,geminate,glabrescent,gland-tipped,gra,infructescence,irregularly,lamina,like,live,lon,long-stalked,longer,lower,major,many-branched,midrib,midvein,minor,mixture,much,multangulate,multiseriate,never,new,nflorescence,often,older,orolla,oung,outline,pair,papillat,pendant,per,perfec,pericarp,persistent,pitted,pore,porrect,portion,prickle,prickly,primary,reduced,reflexed,ripe,ruit,scar,scattered,sessile,short,short-,short-stalked,sinuate,slender,smooth,somewhat,spaced,spreading,stalk,straigh,tamen,terete,testal,thicker,time,toward,triangular,trichome,unarme,unarmed,unicellular,unit,upward,usually,vary,vein,visible,way,woody,ympodial,young,½	0.2,4-12,adhesion,arrangement,climate,colour,corolla,form,fruit,hair,height,history,inflorescence,length,life,na,number,ovary,position,presence,present,pubescence,reproduction,rugulose,seed,staman,stipe,texture
771	wfo-0001031829	success	138	85	52	86	33	0.377	.5,0.7-1,1-2,1.3-1.5,1.5-2,1.5-2.5,1.5-3.5,2-4,4-4.5,4-8.5,acute,anther,apex,base,calyx,capitate,cm,corolla,densely,elliptic,globose,green,greenish-brown,growth,inflorescence,leaf,leathery,lobe,lobed,long,margin,mm,opposite,ovary,pedicel,petiole,poricidal,pubescent,revolute,shrub,size,somewhat,sparsely,stem,stigma,style,surface,thick,tip,tube,white,x	.25,0.5-2.1,1,1.5-4.5,3-5-flowered,3/4,7-10,abaxially,absent,adaxial,adaxially,along,anthesi,ape,apiculae,bae,bark,berry,branched,broadly,conical,crystalline,deflexed,denser,dia,differing,difoliate,drying,eaf,edicel,eed,epidermi,erect,exserted,filament,free,fruiting,geminat,glabrat,glabrous,immature,known,large-celled,lateral,like,lon,lower,main,major,minor,minute,minutely,nflorescence,occasionally,often,older,overlappin,packed,pair,papillo,papillose,planar,pore,portion,quadrate,ruit,scar,shaped,simple,soft,tall,tapering,tear-drop,trichome,tub,tuft,ud,uniseriate,unit,vein,waxy,way,woody,yellowish,ympodial,young	0.5-1,adhesion,arrangement,blade,climate,colour,diameter,form,fruit,glandular,hair,height,history,length,life,midpoint,na,number,peduncle,perennial,plant,position,presence,pubescence,ray,reproduction,rugulose,seed,shape,staman,stellate,stipe,texture
772	wfo-0001031832	success	232	131	109	123	22	0.47	.5-1,0.1-0.3,0.2-1.5,0.3-3,0.7-1.5,0.7-1.6,0.8-1.2,1-12,1.1-2.4,1.2-1.6,1.2-2,1.2-2.5,1.3-4.2,14,2-3.6,2-4,2-6,2.5-6.5,3-6.5,4-20,5-21,8-25,9,abaxially,adaxially,anther,apart,articulated,basal,base,becoming,blunt-tipped,brown,brownish,bullate,calyx,closely,cm,conical,continued,corolla,dark,deltoid,diameter,due,ferrugineous,few-rayed,fleshy,flower,fruit,glabrescent,globose,granular-tomentose,green,greenish,growth,hair,half,honeycombed,inserted,lanceolate,lateral,leaf,length,lobe,mixed,mm,mostly,multangulate,oblanceolate,oblong,pale,pedicel,peduncle,persistent,petiole,pitted,porrect-stellate,probably,pubescence,reniform,reticulate-punctate,ripe,rotate-stellate,rough,scabrous,sessile,short-,short-stalked,shrub,simple,somewhat,spaced,sparse,stem,stigma,style,suborbicular,surface,terete,terminal,thick-stalked,tree,tube,violet,white,x,yellow,yellowish	-8,/50-1/10,0-150,0.2-0.6,0.3-0.8,0.7-2,1.5-4,1.7-4,1.8-4,1/2-3/4,2.8-4.8,3-7,3.5-7,4-7,5.5-10,7-10,accrescent,acuminate,acute,ag,anthesi,apex,apical-lateral,apice,apparently,attenuate,axe,axillary,ba,bark,berry,blade,blister,branch,branched,bud,capitat,chartaceous,connate,decurrent,dehiscing,directed,eaf,eed,entire,evident,exserted,extend,filament,forming,free,fruiting,glabrescen,glabrous,high,indument,introrse,lackin,large,line,lobed,long,long-,longer,longitudinal,lower,m.,main,margin,midvein,minute,nearly,nflorescence,obovoid,obtuse,occasionally,older,orbicular,orolla,ovate,partly,perfect,plurifoliate,pore,porrect-stellat,pubescent,rachi,rather,ray,relatively,ruit,runk,side,slit,smooth,sometimes,soon,sparingly,splitting,stamen,stellate-pubescent,stipitate-glandular,subcampanulate,suture,swelling,tamen,testa,thick,time,toward,translucent,unarme,unarmed,unit,usually,vary,vein,way,weakly,whitish,wide,ympodial,young	adhesion,arrangement,capitate,colour,form,height,history,inflorescence,life,na,ovary,perennial,plant,position,reproduction,rugulose,seed,shape,size,sparing,staman,texture
773	wfo-0001031834	success	150	95	61	89	34	0.407	0.5-3,0.5-3.5,0.6-1.4,0.8-1,0.8-1.3,1,1.5,1.6-2,1.9-6.5,6-7,6.5-14,acuminate,acute,anther,apex,apiculate,base,calyx,cm,corolla,flattened-reniform,fruit,glabrous,globose,green,greenish-yellow,hooked,leaf,less,lobe,lobed,margin,minutely,mm,opposite,ovary,ovate,pale,papillose,pedicel,petiole,pitted,pubescent,scabrous,shaped,short,shrub,slightly,sparsely,stem,stigma,style,surface,tan,tear-drop,trichome,tube,uniseriate,white,x,yellow	.5,0.5,0.5-1,0.9-1.4,1.5-4,2.9-7,2/3,accrescent,across,anthesi,apar,apically,appear,attenuate,berry,bi-cellular,borne,campanulate,covered,deciduou,deciduous,decurrent,deflexed,deltoid,depression,dia,difoliate,eaf,edicel,eed,expanded,eye,few-flowered,filament,free,fruiting,geminat,glabrou,hook,incrassate,lamina,larger,leaving,like,lon,long,lower,major,markedly,middle,minor,minute,mound-like,multicellular,naked,nflorescence,often,papillo,persistent,planar,pore,poricidal,portion,proximal,ruit,scar,simple,slender,small,soon,spaced,speck,straight,tall,tapering,tip,tufted,ud,unevenly,uni-,unit,upper,usually,vein,way,widest,woody,ympodial,young	adhesion,arrangement,blade,climate,colour,diameter,form,glandular,growth,hair,height,history,inflorescence,length,life,midpoint,na,number,peduncle,perennial,plant,position,presence,pubescence,ray,reproduction,rugulose,seed,shape,size,staman,stellate,stipe,texture
774	wfo-0001031839	success	138	109	62	76	47	0.449	1-1.4,1.2-1.5,1/3-2/3,2.5-3.5,3-7,6-15,8-15,9-12,anther,apically,arcuate,armed,base,beneath,blade,blue,blue-tinged,broadly,brown,calyx,cm,dark,developing,dry,foveolate,glabrous,green,herb,internodal,invested,lenticular,lobe,long,maturity,minutely,mm,olivaceous,otherwise,ovary,ovate,pale,perennial,petiole,pinnatifid,pubescent,purple,smooth,spherical,splitting,stellate-pentagonal,stellate-pubescent,stellate-tomentose,stem,tawny,tightly,tube,twice,velvety-tomentose,weakly,white,whitish,yellow	.5,1,2/3,4-8,7-10,8-14-rayed,9-13-flowere,accrescent,across,along,alyx,annually,anthesi,becoming,berry,bristly,broad,campanulate,cauline,confluent,da,dark-based,deltoid,densely,density,dia,difoliate,divided,eaf,eed,emerging,erect,extended,externall,fully,geminat,ligneous,linear-lanceolate,lon,long-stalked,long-stipitate,main,nearly,nflorescence,often,orolla,persisting,prickle,prickly,root,rounded,ruit,several,short,slende,somewhat,spreading,stella,stellae,stellate-tomento,stipitate,subulate,tamen,throughout,tigma,tub,tyle,ultimate,unexpande,unit,usually,varying,vein,year,ympodial,zygomorphic	0.5,8-14,adhesion,apex,arrangement,climate,colour,corolla,diameter,externally,form,fruit,glandular,growth,hair,height,history,inflorescence,leaf,length,life,margin,midpoint,na,number,pedicel,peduncle,plant,position,presence,pubescence,ray,reproduction,rugulose,seed,shape,size,slender,staman,stellate,stigma,stipe,style,surface,texture,unexpanded,ye
775	wfo-0001031842	success	161	101	72	89	29	0.447	.5,0.6-1,0.7-1,1,1-1.5,1-1.8,10-20,2-10,2-3,2.5-3,2.5-6,3-8,3/4,4.5-6,7-9,9-15,anther,apex,base,beneath,bi-lobed,brown,calyx,capitate,cm,corolla,dark,deeply,dia,dry,elliptic,flattened-reniform,glabrous,globose,green,leaf,lobe,lobed,long,mm,near,new,often,opposite,ovary,overtopping,pale,pedicel,petiole,pitted,poricidal,shiny,shoot,shrub,size,specimen,stem,stigma,strongly,style,surface,terminal,tip,tree,trichome,tube,tuft,uniseriate,way,white,woody,x	.1,.4,.75,0.1-0.5,0.5-1,0.5-2,1-3.5,1.5-2,10-12,10-30-flowered,acute,anthesi,apart,attenuate,axil,ba,bark,bearing,beginning,berry,cup-shaped,cusp,decurrent,deflexed,densely,differing,difoliate,eaf,edicel,eed,ellipsoid,exserte,exsertion,filament,free,fruiting,geminat,incrassate,inflorescenc,irregularly,later,lateral,leaf-opposed,lon,lower,main,major,margin,middle,minor,minutely,nflorescence,older,one,onto,pair,paler,papillo,papillose,pore,portion,prominent,pubescent,quadrate,reddish,reddish-resinous,reflexed,ruit,scar,shaped,simple,slender,somewhat,soon,spaced,sparsely,straight,tall,tapering,tear-drop,time,ud,unit,vein,widest,yellowish,yellowish-whit,ympodial,young	0.4,adhesion,arrangement,colour,diameter,form,fruit,growth,height,history,inflorescence,length,life,na,number,peduncle,plant,position,presence,pubescence,ray,reproduction,rugulose,seed,shape,staman,stellate,texture,yellowish-white
776	wfo-0001031843	success	245	112	83	162	29	0.339	.5,0.6-1.2,1-2,1-7,1.2-2,1.2-2.2,1.5,1.8-2.5,1/6-1/4,1mm,2-3,2.5,3-4,5-10,5-12,6-9,acuminate,almost,anther,anthesi,apex,apparently,base,berry,black,brown,calyx,capitate,caudate,cm,completely,conical,corolla,curved,dark,diameter,discoid,distributed,drying,dull,equal,erect,evenly,free,glabrous,largely,leaf,length,liana,lobe,lobed,long,margin,mm,oblique,oblong,obovate,orange,orange-brown,orange-yellow,partly,pedicel,peduncle,petiole,present,pubescent,red,seed,shrub,side,slender,slightly,spheroidal,stem,stigma,style,surface,terminal,thick-chartaceous,tube,unarmed,violet,x	.2,.3,.6,0-4,0.2-2,0.4-0.5,0.5-1,0.5-1.5,0.7-1.2,0.7-2,0.8-2,1.5-2,2-4,3-7,4-12,45-60°,abaxially,accrescent,adaxially,age,along,always,alyx,apar,apically,apice,appressed,around,articulated,attenuate,bark,basal,becoming,branch,branched,branching,broadly,canaliculate,clearly,collapsing,cupular,cuspidate,deeply,delineated,deltoid,dendritic,density,detaching,dilated,discolorous,domatia,eaf,eed,ellipsoi,entire,even,eye,fertilisation,filament,fine,finely,flat,flexuous,flower,forming,fruiting,green,hand,honeycomb,inner,leave,len,lengthening,lignified,like,longitudinally,loop,looping,lower,m.,main,midvein,much,multiseriate,naked,network,never,nflorescence,nther,obscure,older,opening,orolla,outline,ovate,pair,papillo,part,pattern,pendulous,perfec,pericarp,pit,pitted,plurifoliat,pore,poricidal,portion,primary,prominent,pronounced,protruding,rachi,raised,rarely,recurve,reddish,reveal,ribbed,ridged,rounded,ruit,scar,see,shallowly,shiny,shortly,simple,sinus,small,smaller,smooth,sometimes,soon,sparsely,spreading,straight,strongly,stump,surfac,tearing,tertiary,thickened,thin,tip,trichome,tuft,twice,ud,unit,variable,vary,vein,venation,visible,weakly,white,wide,wider,without,ympodial,young	adhesion,arrangement,blade,climate,colour,form,fruit,glandular,growth,hair,height,inflorescence,midpoint,na,number,ovary,plant,position,presence,pubescence,ray,reproduction,rugulose,shape,size,staman,stellate,stipe,texture
777	wfo-0001031852	success	155	75	51	104	24	0.329	-8,0.1-1,1-4,1-4.2,1-9,1.3-2.5,1.4-3,12-35,2.6-9.5,4-,4-5,4-6,5-15,7-,9-11,abaxially,adaxially,calyx,cm,conical,connate,corolla,diameter,distal,elliptic-lanceolate,green,green-white,half,herbaceous,lanceolate,leaf,light,long,mm,odd-pinnate,ovoid,pedicel,peduncle,perennial,petiole,plant,pubescent,seed,size,stellate,stigma,style,throughout,white,wide,yellow	0.5-1.3,0.5-3,1-,1.5-3,2-3,2-5.5,3-4,3-6-foliat,3-9,3.5-10,4-10,abruptly,absen,acumen,acuminate,acute,apex,apical,apically,apiculate,articulate,attenuate,base,branched,cell,covering,cyme,decurrent,dehiscent,dichasial,dichasially,digestion,diminishing,dorsally,eaf,ebracteate,edge,eed,elliptic,emoval,enzyme,exceeding,filament,flat,flower,folded,forked,generally,globo,hair-like,honeycomb,interjected,introrse,lateral,leaflet,living,lobe,lon,lower,lunat,make,maturing,monochasial,mucilaginous,nflorescence,nther,oblique,oblong,often,orolla,ovate-elliptic,pair,pattern,perfect,plan,poricidally,proximal,rachi,reveal,ruit,sessile,seudostipule,short,shortly,slit,specimen,stamen,straight,tal,tem,terminal,testal,thick,throughou,toward,tuber-bearing,typically,unit,vary,wall,white-crea,without,ympodial,¼	anther,arrangement,colour,form,fruit,globose,growth,height,history,inflorescence,length,life,na,ovary,position,pubescence,reproduction,rugulose,shape,stem,surface,texture,true,white-cream
778	wfo-0001031864	success	140	111	77	63	34	0.55	.2,.25,.5,0.2-0.5,0.5-13.5,0.7-0.8,0.8-1,1-1.2,1-1.8,1-2,1-5,1-6.5,1.2-1.5,1.5-2.5,15-60,2.5-6,3-3.5,3-pinnate,abaxially,adaxially,anther,apex,apiculate,base,blade,calyx,chartaceous,ciliate,cm,cuneate,dense,diameter,entire,extra-axillary,fine,flattened,fleshy,fruit,glabrous,hair,herbaceous,lenticular,lobe,long,margin,minutely,mm,near,oblique,ovoid-deltoid,pedicel,peduncle,petiole,pointed,pubescence,pubescent,rotate,rounded,scattered,short,slender,slightly,sparsely,stem,stigma,style,surface,tip,trichome,truncate,tube,unknown,vine,violet,wide-diameter,widely,x	0.4-3,0.5-4,0.6-3.5,0.6-4,1-3,1.5,1.5-10,2,2-3,5-15,5-9,5-merous,7.5-8,accrescent,acuminate,acute,alyx,apar,apical,axe,berry,c.,capitat,clavate,color,deltoid,densely,eaf,eed,emarginate,filament,flower,fruiting,glabrou,lateral,leaflet,like,lon,lower,m.,middle,moderately,nflorescence,nternode,orolla,papillose,perfec,petiolule,plurifoliat,pubescenc,rachi,ruit,sand-punctate,spaced,tamen,tem,terrestria,typical,unbranched,unit,vary,vein,ympodial	adhesion,arrangement,capitate,climate,colour,corolla,form,glandular,growth,height,history,inflorescence,leaf,length,life,midpoint,na,number,ovary,perfect,plant,position,presence,ray,reproduction,rugulose,seed,shape,size,staman,stellate,stipe,terrestrial,texture
779	wfo-0001031864	success	148	127	93	55	34	0.628	.2,.25,.5,0.5-13.5,1-1.2,1-1.8,1-2,1-3,1-5,1-6.5,1.2-1.5,1.5-2.5,15-60,2.5-6,3-3.5,3-5-celled,3-pinnate,5-15,abaxially,acute,adaxially,anther,apart,apex,apiculate,articulated,basally,base,blade,blue-purple,calyx,center,ciliate,clavate,cm,color,connivent,cordate,cuneate,deltoid,dense,diameter,emarginate,entire,equal,extra-axillary,filament,fine,fleshy,flower,fruit,glabrous,hair,herb,lenticular,lobe,long,margin,minutely,mm,near,oblique,oblong,papillose,pedicel,peduncle,pubescence,pubescent,rotate,rounded,scattered,short,simple,slender,somewhat,spaced,sparsely,stigma,style,surface,terrestrial,thick,tip,trailing,truncate,tube,unbranched,uniseriate,unknown,weakly,widely,x,yellow	0.4-3,0.5-4,0.6-3.5,0.6-4,1.5,2,2-3,5-9,5-merou,7.5-8,absent,accrescent,acuminate,ag,alyx,apical,apparently,axe,ba,capitat,densely,directed,distally,eaf,eed,etiole,fruiting,geminat,interjected,large,lateral,leaflet,longitudinal,lower,m.,nflorescence,node,opening,orolla,perfect,petiolule,plurifoliate,pore,pubescenc,rachi,rooting,slightly,slit,tamen,tem,unit,vary,wiry,woody,ympodial	adhesion,arrangement,capitate,climate,colour,corolla,form,glandular,growth,height,history,inflorescence,leaf,length,life,midpoint,na,number,ovary,petiole,plant,position,presence,ray,reproduction,rugulose,seed,shape,size,staman,stellate,stem,stipe,texture
780	wfo-0001031871	success	185	95	70	115	25	0.378	0.4-2,0.6-1.2,1.5-11,1.5-2,1.5-2.1,2-4,3-10,3.5-4,33-40,5.4-12.3,6-12,6-7,6.5-20.5,7-9,7.5-23,abaxially,adaxially,anther,axillary,brownish,bud,chartaceous,clavate,cm,condition,corolla,deep,diameter,dot,drying,elliptic,fresh,fruit,glabrous,globose,green,greenish,hair,herb,lanceolate,lobe,long,medium,mm,mottled,odd-pinnate,ovate,ovoid,pedicel,peduncle,petiole,plant,pubescent,purple,rotate,seed,short,size,stigma,style,subglabrous,subtending,terminal,tiny,tube,white,whitish,wide,x,yellow	1-2,1.4-2.1,1.6-2.7,14-22,2-3,2.9-6,3-4,3-5,36-44,4-6,4-7,5-merou,acumen,acute,adaxiall,ag,alyx,apart,apex,apparently,articulated,asymmetric,attenuate,axe,base,basiscopic,berry,blade,capitat,cell,connivent,covering,dark,digestion,distal,dorsally,eaf,edge,eed,end,enzyme,erec,exceeding,filament,flat,flower,folded,forked,geminat,generally,glabrou,green-white,hair-like,hal,half,high,homostylous,honeycomb-shaped,interjected,lateral,leaflet,lengthening,linear,living,lower,make,mucilaginous,narrowly,nflorescence,one,orbicular,orolla,pair,perfect,petiolulate,placed,plurifoliate,pore,poricidal,removed,ripe,round,rounded,ruit,sessile,seudostipule,side,slit,sometimes,spaced,specimen,stamen,stolo,straight,subequal,subglabrou,symmetric,tall,tamen,tem,testal,thick,throughout,tip,tissue,tri-,tuber,typically,unit,usually,vary,wall,wet,winged,ympodial	adhesion,arrangement,calyx,capitate,colour,form,growth,height,history,inflorescence,leaf,length,life,na,ovary,perennial,position,pubescence,reproduction,rugulose,shape,staman,stem,surface,texture
781	wfo-0001031874	success	197	114	85	112	29	0.431	-1.2,0.2,0.5-1,0.5-1.5,0.5–0.9,0.6-1,1.2,1.2-1.8,1.3–1.4,1.4–1.5,1.8–2.3,1/10,1/5,2-5,2–2.5,3-8,3-lobed,3–5,6–7,7–8,9–11,abaxially,acute,anther,apex,base,bilobed,blade,blue,broadly,calyx,chartaceous,cm,completely,connivent,diameter,elliptic,especially,extra-axillary,flattened-reniform,flower,fruit,fully,glabrous,globose,green,herb,hermaphroditic,least,length,light,lobe,margin,midrib,minutely,mm,near,nearly,oblong,orange,ovate,pedicel,peduncle,petiole,pitted,puberulent,pubescent,red,ripe,rotate-stellate,slightly,somewhat,sparsely,stem,stigma,style,surface,tip,tube,violet,white,white-puberulent,x,yellow,young	-1.5,-3.5,-4,-7,.5-1.2,0.2–0.8,0.4,1-4,1.5-,1.8,1/3,2,2-3,2-3.5,2-4,2-foliate,2–9-branched,3.5–11,4.5-6,5,5-merou,accrescent,adaxiall,adaxially,always,alyx,angulate,apart,articulated,asymmetrically,axe,ba,barely,berr,bi-lobed,bifurcation,branch,broad,capitat,ciliate,contact,covering,cylindrical,decumbent,dehiscent,downward,eaf,eed,erect,even,filament,fruiting,geminat,generally,hair,hold,juic,lanceolate,lateral,level,line,lobed,long,long-attenuate,longitudinall,lower,lowermost,main,mesocarp,nflorescence,node,numerous,obtuse,often,one,orolla,ovate-triangular,partially,passing,petiol,pore,prostrate,rachi,rarely,recurved,rooting,ruit,several,short,side,simple,soil,sometimes,spaced,spreading,swollen,tall,tamen,tem,terete,terminal,time,triangular,unit,usually,vary,vein,way,well,wide,winged,ympodial	0.5-1.2,1.5-4,3.5-11,abaxial,adaxial,adhesion,capitate,colour,corolla,form,growth,height,history,inflorescence,leaf,life,na,ovary,perennial,plant,position,pubescence,reproduction,rugulose,seed,shape,size,staman,texture
782	wfo-0001031876	success	140	84	47	93	37	0.336	.1,.5,0.8-1,1-1.5,1-1.6,1.5-2.2,27-35,9-15,acute,anther,apex,base,calyx,cm,corolla,decurrent,dia,elliptic,glabrous,globose,granular,green,greenish-yellow,leaf,lightly,lobe,lobed,long-acuminate,margin,minutely,mm,nearly,oblanceolate,opposite,ovary,papillose,pedicel,petiole,shrub,slightly,stem,stigma,style,tube,white,winged,x	0-flowered,0.5,1,1-4,3,5,?,across,anthesi,apiculate,arc,arising,ba,bark,bearing,beneath,berry,bright,closely,convergence,corky,cup-like,differing,eaf,edicel,eed,erect,family,filament,flower,free,fruiting,glabrou,immature,irregularity,known,lateral,lenticellat,less,long,lower,main,major,melastomataceae,member,middle,minute,nflorescence,oblique,often,otherwise,overlappin,pair,parallel,perpendicular,persistent,point,pore,poricidal,portion,present,primary,prominent,raised,recurved,reflexed,resemble,ruit,running,scar,secondary,shaped,simple,slender,spaced,straight,styl,tall,tapering,tear-drop,time,tip,ud,unifoliat,unit,vein,venation,wide,widest,woody,yellow,ympodial,young	adhesion,arrangement,blade,climate,colour,diameter,form,fruit,glandular,growth,hair,height,history,inflorescence,length,life,midpoint,na,number,peduncle,perennial,plant,position,presence,pubescence,ray,reproduction,rugulose,seed,shape,size,staman,stellate,stipe,surface,texture,unifoliate
783	wfo-0001031877	success	216	117	94	122	23	0.435	+,0.3-,0.3-1,0.3-1.2,0.5,0.5-1,0.6-1.2,1-1.5,1-3,1-3.5,1.1-,1.5,1.5-1.9,1.5-2,1.8-5,2,2.5,3.5-4,6-8,abaxially,adaxially,anther,basally,base,bright,brown,calyx,capitate,clavate,cm,connivent,corolla,deltate,diameter,ellipsoid,ellipsoidal,flattened,fruit,glabrous,globose,greenish,growth,hastate,lateral,line,lobe,lobed,long,loosely,margin,minutely,mm,nearly,outline,pale,pedicel,peduncle,perfect,petiole,pitted,plant,plump,pubescence,pubescent,purple,red,reddish,reniform,ripe,scrambler,seed,semi-woody,shiny,simple,slightly,somewhat,sparsely,stellate,stem,stigma,style,surface,terminal,thin,tinged,triangular,trichome,tube,uniseriate,vein,vine,weak,white,x	.3,.5,0.2,0.8-0.9,1,1-4,2-,3-5,3-6,5-merou,6-10,abruptly,acuminate,acute,adaxiall,ag,along,alyx,angled,anthesi,apar,apex,apparently,ark,articulated,ascending,basal,berry,cell,conical,deep,deflexed,densely,distal,dried,eaf,eed,enlarged,entire,erect,especially,exposed,exserted,eye,filament,fleshy,flower,free,fruiting,furcate,green,ilament,impressed,internal,irregularly,lamina,later,lengthening,like,linear,long-acuminate,lower,material,mature,midvein,minute,new,nflorescence,occasionally,often,older,orolla,pair,papillate,papillo,parallel,part,per,pericarp,plurifoliat,pointing,pore,poricidal,portion,primary,prominently,purplish,rectangular,reflexed,rest,rounded,ruit,scar,short,shorte,silky,sinuate,sleeve,slender,slit,sometimes,spaced,spreadin,strongly,subshru,tem,testal,tip,truncate,twinin,ud,uniformly,unit,upper,usually,vary,visible,wall,woody,yello,ympodial,young	adhesion,arrangement,colour,form,height,history,inflorescence,leaf,length,life,na,number,ovary,position,presence,ray,reproduction,rugulose,shape,size,staman,texture,yellow
784	wfo-0001031880	success	180	109	79	101	30	0.439	0.5-2,0.7-0.8,1,1-1.3,1-1.5,1.5,2-3,2-9,2.5-8,3-3.5,3-foliate,3-lobed,4,4-8,5-6,7-9,acuminate,acute,anther,apex,base,brown,calyx,capitate,cm,conical,cordate,corolla,dark,densely,diameter,elliptic,entire,flattened,fleshy,fruit,glabrous,glandular,globose,green,herb,inflorescence,internodal,leaf,lobe,long,margin,minutely,mm,narrowly,orange,ovary,ovoid,pale,papillose,pedicel,peduncle,petiole,pubescent,purple,red,reddish,shallowly,simple,stem,stigma,style,subshrub,surface,thin,toothed,triangular,trichome,truncate,tube,uniseriate,x,yellow,–5	.5,0.5-1,1-2,2,2-4,3-4-pluri-foliate,5,6-9,abaxially,adaxially,age,anthesi,apart,basal,bearing,becoming,berry,broadly,c.,cell,ciliate,color,crenate,crowded,cup-shaped,curved,eaf,edicel,eed,ellipsoid,enlarged,erect,exerted,filament,flower,flush,free,fruiting,gland,gland-tipped,growing,heteromorphic,hollow,horn,irregularly,lamina,lengthening,less,lon,longest,lower,markedly,mature,maturit,mid-length,middle,near,nflorescence,nodding,ovate,pair,papillo,pericarp,pitted,plan,pore,poricidal,portion,primary,pubescen,rachi,reflexed,ruit,scar,shortest,single,slender,slightly,slit,sometimes,spaced,sparse,sparsely,spreading,straight,strongly,terminal,testal,tip,ud,unicellula,unit,unlobed,upper,upward,vein,wall,widely,widest,woody,ympodial	adhesion,arrangement,blade,climate,colour,form,growth,hair,height,history,length,life,midpoint,na,number,perennial,plant,position,presence,pubescence,ray,reproduction,rugulose,seed,shape,size,staman,stellate,stipe,texture
785	wfo-0001031881	success	168	116	84	84	32	0.5	.5,0.5-1,1-1.3,1-1.5,1-7,1.2-6,1.5-2.5,10-30,2,3.5-4,3/4,5-6,7-14,acute,along,anther,apex,attenuate,axil,base,beneath,branched,brown,calyx,capitate,cm,corolla,dark,decurrent,densely,dia,dry,elliptic,fruit,glabrous,globose,golden-puberulent,golden-pubescent,green,inflorescence,lateral,leaf,lightly,like,lobe,lobed,main,margin,material,midrib,minutely,mm,obovate,opposite,ovary,ovoid-reniform,papillose,pedicel,petiole,pitted,poricidal,puberulent,pubescent,rest,shape,shrub,simple,size,small,sparsely,stem,stigma,style,surface,tip,tree,trichome,tube,uniseriate,vein,way,white,winged,x	0.1-0.5,0.2,0.2-0.6,0.4-1,0.5-0.7,1/3,10-12,2-9,3-19,absent,anthesi,apar,apparent,ba,bark,branch,broadly,bud,campanulate,constriction,deflexed,deltoid,differing,difoliate,distal,drying,eaf,edicel,eed,either,ellipsoid,erect,evenly,exserted,filament,fleshy,free,fruiting,geminat,golden,greyish-brow,incrassate,inflorescenc,junction,lon,long,lower,major,maturity,middle,minor,minute,nflorescence,occasionally,older,one,orbicular,pair,papillo,planar,pore,portion,puberulen,rounded,ruit,scar,shaped,slender,slightly,somewhat,soon,spaced,straight,strong,tall,tapering,tear-drop,ud,unit,usually,widest,woody,ympodial,young	adhesion,arrangement,blade,climate,colour,diameter,form,glandular,greyish-brown,growth,hair,height,history,length,life,midpoint,na,number,peduncle,perennial,plant,position,presence,pubescence,ray,reproduction,rugulose,seed,staman,stellate,stipe,texture
786	wfo-0001031886	success	169	86	56	113	30	0.331	-9,.5,1-1.5,1-4,1.2-2.5,10-40,2,2-2.5,2-5,2.0-2.5,3.0,5-10,5-6,9-10,anther,axillary,bright,brown,calyx,capitate,cm,completely,conical,corolla,diameter,elliptic,fleshy,free,fruit,glabrous,green,greenish,long,minutely,mm,occasionally,open-conical,ovary,ovoid-reniform,papillose,pedicel,petiole,pinnate,poricidal,rugose,seed,shape,shrub,somewhat,stigma,style,surface,tip,tube,white,x	-1.2,-25,-4,0,0.1,0.5-1,1.5-2,2-3,2-4,20-30,3-6,4,4-15,5-ridged,6-20,6-8,abaxially,abruptly,absent,acuminate,adaxially,along,anthesi,anticlinal,apex,arising,attenuate,axil,basal,base,beak,bearing,berry,broadly,bud,cell,clavat,commonly,deltate,distinctly,dry,eaf,earl,edicel,eed,either,em,epidermal,equal,erec,exserted,filament,flower,fruiting,half,irregular,lanceolate,lateral,le,leaflet,lobe,lobed,lower,margin,narrowed,near,nearly,nflorescence,noddin,node,oblique,pair,papillae,papillate,per,petiolule,portion,primary,projection,purple,rachi,raised,reddish,reflexed,ripe,ruit,scar,scattered,similar,simple,single,sinuous,smaller,smelling,sparse,specimen,strongly,terminal,thickening,time,triangular,trichome,tub,ud,unifoliat,uniseriate,unit,usually,vein,wintergreen,without,woody,ympodial	1,1-1.2,adhesion,arrangement,clavate,colour,form,growth,height,history,inflorescence,leaf,length,life,na,peduncle,perennial,plant,position,presence,pubescence,reproduction,rugulose,size,staman,stellate,stem,texture,unifoliate,ye
787	wfo-0001031895	success	160	124	90	70	34	0.562	-1.5,1-1.5,1.5-3,1.5-6,2-2.5,2.5-3,3-4,3-8,3.5-6,4,4-5,4.5-16.5,5,5-6,6-7,acute,anther,anthesi,apex,attenuate,base,beneath,berry,bluish,broadly,calyx,campanulate,capitate,cm,completely,conical,corolla,cup-shaped,dark,deltate,densely,diameter,elliptic,entire,glabrous,globose,green,growth,immature,leaf-opposed,leafy,lobe,lobed,margin,matte,minutely,mm,new,older,ovary,overlapping,ovoid,pale,papillate,pedicel,peduncle,petiole,pitted,planar,poricidal,reniform,revolute,shiny,shoot,short,shrub,simple,slightly,small,somewhat,stem,stigma,style,surface,tan,terminal,thin,tip,tree,tube,violet,way,white,x,¼-1/2	0.5,0.5-1,0.5-2,1.5-2,3-10,5-8,6-9,age,apparently,articulating,bark,blac,cell,drying,eaf,eed,ellipsoid,emarginated,enlarging,erec,erect,exerted,exfoliating,expand,filament,fleshy,flower,fragrant,free,fruiting,glabrou,inflorescenc,intensely,irregular,leaving,lengthening,less,lower,nflorescence,occasionally,once-branched,pair,papillat,part,patch,peeling,peg,perfect,pericarp,plurifoliat,pore,portion,primary,reddish,ruit,scar,sinuate,slender,slit,stout,straight,strongly,testal,thick,tub,ud,unit,vein,woody,ympodial	adhesion,arrangement,blade,climate,colour,form,fruit,glandular,hair,height,history,inflorescence,leaf,length,life,midpoint,na,number,perennial,plant,position,presence,pubescence,ray,reproduction,rugulose,seed,shape,size,staman,stellate,stipe,texture,unknown
788	wfo-0001031896	success	196	116	88	108	28	0.449	0.3-0.7,0.3-0.8,0.5-1,0.5-2,1-1.2,1-1.5,1-10,1-3,10-20,13,2-2.5,2-3,2-4.5,2-7,3-30+,3-5,4-7,5-15,5-9,6-30+,6-9,abaxially,acute,adaxially,anther,apex,base,blade,brown,calyx,chartaceous,cm,coarsely,densely,diameter,elliptic,entire,erect,extra-axillary,ferruginous,flattened,flower,fruit,glabrous,glandular,glandular-puberulent,globose,green,hair,lobe,long-acuminate,margin,midpoint,mm,moderately,orange,pedicel,peduncle,perfect,petiole,pinnatifid,pubescence,pubescent,ray,rounded,shape,shrub,simple,size,small,sparsely,stellate,stellate-pubescent,stem,stigma,style,subcordate,surface,tapered,tip,toothed,tree,truncate,tube,white,whitish,x,yellow	-1.5,0-1.2,0.1-0.6,0.3-0.5,0.3-1,0.4-0.8,1-2,1.5,10-20+,15-20,2,2-5,5,5-10,5-6,6-10,7-10,9-18,accrescent,adaxiall,ample,apart,apparently,armed,articulated,axe,ba,branched,broad-based,capitat,connivent,conspicuously,contiguous,covering,curved,cylindrical,denser,difoliate,directed,distall,eaf,eed,eglandular,equal,ferruginous-pubescent,filament,forked,frequently,frui,fruiting,geminate,gland-tipped,held,interpetalar,lanceolate,lateral,less,like,lon,long,long-stalked,longer,lower,midrib,midvein,minutely,mixed,mostly,multangulate,nearly,nflorescence,oblique,occasional,occasionally,often,orolla,pitted,pore,porrect,prickle,rachi,recurved,ruit,sessile,short,shorter,slightly,sometimes,spaced,stalk,stalked,ste,stellae,straight,tal,tamen,tem,time,tissue,unarmed,unbranched,uniform,unit,uprigh,vary,vein,wide,ympodial	adhesion,arrangement,capitate,climate,colour,corolla,form,growth,height,history,inflorescence,leaf,length,life,na,number,ovary,perennial,plant,position,presence,reproduction,rugulose,seed,staman,stipe,texture,ye
789	wfo-0001031897	success	264	118	101	163	17	0.383	.5,0.1-0.5,0.15,0.4-1.1,0.5-3,0.6,1.1,1.3-2,1.5-8,1.7-3,13,2-4,5-6,6-9,abaxial,almost,along,anther,apex,base,berry,black,brachyblast,branch,brown,calyx,cell,chartaceous,clavate,clustered,cm,conical,coriaceous,corolla,dark,dense,diameter,distributed,drying,elliptic,enlarged,epiphyte,erect,evenly,except,fruit,glabrous,grey,hair,inner,inside,lanceolate,leaf,light,linear,lobe,lobed,long,margin,mauve,midvein,mm,multicellular,multiseriate,obconical,oblong,orange-brown,outside,ovate,ovoid,papillose,pedicel,peduncle,petiole,plant,pubescent,shrub,side,simple,smooth,sometimes,sparse,sparsely,stem,stigma,style,surface,terminal,thick,thin,toward,trichome,tube,unarmed,unbranched,unicellular,usually,weakly,white,x,young	.1,.8,0-1,0.2-0.4,0.5-1,0.8-1.5,0°,1,1-1.5,1-2,1-2.5,1.5,2/3,4-5,462.,8,abaxially,absent,accrescent,acute,adaxial,adaxially,age,alyx,anthesi,apar,apically,apparently,appearing,appendage,arising,aristate,articulated,attenuate,axillary,bark,bendy,boiteau,branched,clearly,concolorous,condensed,connate,covering,cuneate,curved,datum,dehiscing,delineated,dendritic,densely,developed,developing,development,dilated,divided,domatia,dorsal,dorsifixed,dry,dull,eaf,earliest,ed,entire,equal,even,extending,eye,faint,filament,filiform,fine,flower,foliaceous,free,fruiting,green,immature,indistinc,known,lamina,larger,lateral,least,lengthening,like,longitudinal,longitudinally,looped,lower,m.,main,margi,membranous,minute,minutely,naked,never,nflorescence,nther,oblon,obtuse,occasional,occasionally,one,orange,orolla,overlapping,pair,part,partly,pendulous,perfec,pericarp,persisting,plurifoliat,pointed,pore,poricidal,portion,primary,prominent,pronounced,protruding,raised,rarely,reach,reddish,revolute,ribbed,ridge,ridged,ruit,scar,secondary,see,seen,shoot,short,sinus,slender,slightly,smaller,smoot,stump,subulate,sunk,tearing,terete,tertiary,tip,ud,unit,vary,vein,venation,visible,well-developed,wide,winged,wrinkle,ympodial	arrangement,colour,form,growth,height,inflorescence,length,na,ovary,position,pubescence,reproduction,rugulose,seed,shape,size,texture
790	wfo-0001031908	success	213	118	96	117	22	0.451	0-22,0-9,0.4-1.4,1-2,1-4,10-35,2-6,3-8,5-11,5-13,5-19,8-22,9-13,abaxially,acute,adaxially,anther,attenuate,axillary,band,base,blue,broadly,brownish,bud,cell,chartaceous,cm,condition,cordate,corolla,covering,densely,diameter,distal,drying,dull,elliptic,elliptic-lanceolate,fresh,fruit,glabrous,globose,green,greenish,hair,hair-like,half,herb,lanceolate,lateral,leaf,like,lilac,lobe,long,membranous,minutely,mm,nearly,odd-pinnate,ovate,ovoid,papillose,pedicel,peduncle,petiole,pink,plant,puberulent,pubescent,purple,red-purple,ripe,rotate,rotate-pentagonal,seed,shiny,short,size,spot,stem,stigma,style,subtending,surface,terminal,testal,thick,tinged,tube,wall,white,whitish,x,yellow	0-25,0-45,1-10,1-5.5,1-8,1.5-5.5,3-5,3.5-9,4-25,5,5-merou,7,absent-10,acumen,acuminate,ag,almost,along,alyx,apart,apex,apparently,approximately,articulated,ascending,auriculate,axe,berry,blade,capitat,ciliate,color,connivent,cuneate,dark,decreasing,decumbent,digestion,dorsally,eaf,edge,eed,enzyme,erect,especially,exceeding,falcate,filament,flat,flower,folded,forked,geminat,generally,glabrou,green-white,homostylous,honeycomb-shaped,interjected,leaflet,lengthening,living,lower,make,margin,medium,middle,midrib,mottle,mucilaginous,nflorescence,oblique,often,orolla,pair,perfect,petiolulate,plurifoliate,pore,poricidal,prominent,prostrat,rarely,removed,rounded,ruit,secondary,semi-elliptic,semi-erect,sessile,seudostipule,shortly,slightly,slit,spaced,specimen,stamen,star,ste,stippled,straight,tall,tamen,tem,thir,throughout,tip,tri-,truncate,uniform,unit,unwinged,usually,vary,wet,wing,ympodial	adhesion,arrangement,calyx,capitate,colour,form,growth,height,history,inflorescence,length,life,mottled,na,ovary,perennial,position,pubescence,reproduction,shape,staman,texture
791	wfo-0001032157	success	136	71	50	86	21	0.368	.5,0.5-1,0.6-1,0.75-1,1-3,2-3,2.2,3-6,7-9,9-17,anther,base,bi-lobed,calyx,cm,completely,corolla,deltoid,dia,elliptic,glabrous,globose,green,leaf,lobe,lobed,minutely,mm,nearly,opposite,ovary,ovoid-reniform,papillose,pedicel,petiole,pitted,plant,poricidal,reddish,shrub,size,stem,stigma,style,surface,tip,tube,white,x,yellowish	.75,0.25,1.9-2.2,2-5,5-15-flowered,5-8,5-9,acute,anthesi,apart,apex,bark,becoming,beginning,beneath,berry,caly,crystalline,decurrent,deflexed,differing,difoliate,dry,eaf,edicel,eed,evenly,exserted,filament,free,frui,fruiting,geminat,glabrou,golden,incrassate,inflorescenc,lateral,less,live,living,lon,long,longitudinal,lower,main,major,margin,middle,minor,nflorescence,obscure,older,one,pair,paler,papillo,peeling,persistent,pore,portion,raised,reflexed,rounded,ruit,scar,shaped,shiny,simple,slender,slightly,soon,spaced,straight,strip,tall,tapering,tear-drop,translucen,ud,unit,vein,widest,woody,ympodial,young	arrangement,colour,diameter,form,fruit,growth,height,history,inflorescence,length,life,na,peduncle,perennial,position,pubescence,reproduction,rugulose,seed,shape,texture
792	wfo-0001032161	success	146	101	67	79	34	0.459	0.4-1.2,0.5-1,0.7-4,0.75-1,0.8-1,1-1.5,1-11,1-3,1.2-1.3,2-7,2.5-3,3.5-4,acute,anther,apex,base,calyx,cm,conical,coriaceous,corolla,dark,deltate,dia,drying,elliptic,glabrous,globose,golden,green,inflorescence,internodal,leaf,lobe,lobed,margin,minute,minutely,mm,mustard,opposite,ovary,ovoid-reniform,pale,papillose,pedicel,pericarp,petiole,pitted,plant,quadrate,revolute,shaped,shrub,stem,stigma,style,surface,tan,tear-drop,thin,trichome,tube,uniseriate,white,x,yellow	.5,1.4-2,2-8-flowered,?,abaxially,adaxiall,adaxially,anthesi,apical,area,ba,bark,beneath,berry,branched,brownish-blac,closely,color,deflexed,delicate,dendritic,densely,difoliate,eaf,edicel,eed,ellipsoid,exserted,filament,filiform,free,fruiting,giving,hanging,lamina,later,like,long,lower,many,merely,middle,nearly,nflorescence,obovate,occasionally,older,overlappin,persistent,plurifoliate,pore,poricidal,portion,projection,pubescent,reflexed,rest,ruit,scar,shiny,shoot,short,simple,spaced,sparsely,strongly,styl,sulcate,tall,tip,tub,ud,unit,usually,vein,widest,yellowish,ympodial,young	adhesion,arrangement,blade,brownish-black,climate,colour,diameter,form,fruit,glandular,growth,hair,height,history,length,life,midpoint,na,number,peduncle,perennial,position,presence,pubescence,ray,reproduction,rugulose,seed,shape,size,staman,stellate,stipe,texture
793	wfo-0001032165	success	197	108	78	119	30	0.396	0.3-1,0.75-1,1-1.2,1-1.5,1-2,1.5-4,10-25,2-2.5,2.5-3.5,3-6,5-15,5-6,5-7,acute,anther,apex,base,berry,broadly,brown,calyx,capitate,center,cm,continued,corolla,cup-shaped,dark,deltoid,densely,dia,dry,due,dull,elliptic,glabrous,globose,golden,golden-puberulent,golden-pubescent,green,inflorescence,leaf,lobe,lobed,margin,minute,minutely,mm,obovate,ovary,ovoid-reniform,pedicel,petiole,pitted,plant,poricidal,presence,purplish,ripe,shape,size,small,specimen,stem,stigma,style,surface,terminal,tinged,tip,tree,trichome,tube,uniseriate,white,x,young	.25,.5,0.1,0.1-0.3,0.25-0.5,3-4,3.5-8.5,4-6,5-30-flowered,5-9.5,8-9,abaxial,adaxial,along,anthesi,apparent,appearing,ba,bark,beginning,beneath,bud,closely,cucullate,deciduous,decurrent,denser,differing,difoliate,distal,eaf,edged,edicel,eed,ellipsoid,end,entire,erect,even,expansion,exserted,exsertion,filament,free,fruiting,geminat,greyish-brown,immature,inflorescenc,later,lateral,less,like,live,lon,long,lower,main,major,markedly,medial,middle,midrib,minor,near,nearly,nflorescence,node,occasionally,older,once-furcate,one,onto,opposite,orbicular,overlapping,pair,pale,paler,papillo,papillose,planar,pore,portion,prominent,puberulent,rather,rest,ridge,rounded,ruit,scar,shaepd,simple,single,slender,slightly,slow,smoot,spaced,stout,straight,stripe,strongly,swollen,tall,tapering,tear-drop,thickened,time,tub,ud,unit,vein,widest,winged,woody,yellowish,ympodial	adhesion,arrangement,blade,climate,colour,diameter,form,fruit,glandular,growth,hair,height,history,length,life,midpoint,na,number,peduncle,perennial,position,pubescence,ray,reproduction,rugulose,seed,staman,stellate,stipe,texture
794	wfo-0001032167	success	163	107	81	82	26	0.497	.5,0.5-1,0.5-1.5,0.5-2.5,0.75-3,1-2,1-2-celled,1-2.5,1-3,1-7,1.5,10-20,12-20,2-4,2-7,2-foliate,4-6,5-15,7-10,abaxially,absent,acute,adaxially,anther,apex,base,brown,calyx,chartaceous,ciliate,cm,densely,diameter,dm,drying,elliptic,elliptic-ovoid,entire,flattened,flower,fruit,geniculate,glabrous,globose,growth,hair,herb,immature,linear-lanceolate,lobe,margin,membranaceous,mm,moderately,nearly,oblong,obtuse,one-celled,pedicel,peduncle,petiole,pubescent,purple,rotate,rounded,seed,semitransparent,sparsely,staman,stigma,straight,style,surface,tube,twisted,two-celled,unbranched,usually,white,x,yellow	1,1-5,10-35,3-6,3-7,4-10,abundant,adaxiall,along,appressed,axe,berry,blade,cell,closely,common,connected,cordate,curved,decurrent,dehiscing,dense,denser,eaf,eed,emarginat,explosively,few-,filament,flat,forming,frui,geminat,growt,held,interpetalar,larger,long,longer,lower,lowermost,lying,many-branched,maturing,maturit,mesocarp,near,netlike,new,nfloresence,notch,often,older,orolla,per,placenta,pressure,projection,pubescen,rachi,raised,ruit,shorter,slightly,small,smaller,sometimes,stamen,tal,tamen,tem,tissue,triangular,unit,upper,vary,vein,wall,watery,wid,woody,ympodial	adhesion,arrangement,colour,corolla,form,geminate,height,history,inflorescence,leaf,length,life,na,ovary,perennial,plant,position,pubescence,reproduction,rugulose,shape,size,stem,texture,type,ye
795	wfo-0001032176	success	177	75	53	124	22	0.299	.5,0.5-0.7,0.8-6,1-1.2,1-10,1.5-1.6,1.5-2.5,2.5-10,3-15,3-3.5,3-4,6,6-10,7,anther,axillary,calyx,cm,conical,corolla,densely,diameter,elliptic,glabrous,green,greenish,grey-brown,greyish,herb,leaf,lobed,long-papillose,minutely,mm,ovary,ovoid-reniform,pale,papillose,pedicel,petiole,pinnate,poricidal,pubescent,seed,size,sparsely,stem,stigma,style,tip,tube,white,x	0,0.42,0.5,0.5-0.75,0.5-1,0.8-1,1.5-6,1/2,100,2-3,3-7,5-6-celled,adaxially,adhering,along,anthesi,apart,apex,apical,arising,attaining,attenuate,axil,basal,base,beak,becoming,berry,branched,capitat,cateniform,cell,containing,copiously,creeping,cucullate,denser,drying,eaf,edicel,eed,ellipsoid,epidermal,equal,especially,exserted,fallen,filament,filiform,flower,free,fruiting,globose,hangin,inflorescenc,lateral,leaflet,lengt,lengthening,like,lobe,log,long,lower,margin,minute,nearly,nflorescence,nodding,node,obovate,obtuse,occasionally,often,onto,open,pair,per,petiolule,pore,portion,projection,quadrate,rachi,reflexed,rest,rooting,rounded,ruit,scar,separate,simple,single,sinuous,slightly,slit,smaller,somewhat,soon,spaced,strait,strongly,tem,terminal,thickening,tightly,time,tree,trichome,truncate,trunk,tub,ud,ultimate,unevenly,unifoliat,uniseriate,unit,vein,wall,whit,winged,without,ympodial	arrangement,capitate,colour,form,fruit,growth,height,history,inflorescence,length,life,na,peduncle,perennial,plant,position,pubescence,reproduction,rugulose,shape,surface,texture
796	wfo-0001032183	success	162	99	69	93	30	0.426	0-0.1,0.3-0.6,0.4-0.6,0.5-1.5,0.6-0.9,0.7-1.4,0.9-1,1.1-2.3,2.4-2.7,3.5-4.5,4-6,5-9,5.5-7,7-8,7-9,absent,acute,adaxially,anther,apex,base,blade,calyx,chartaceous,cm,cuneate,densely,diameter,elliptic,entire,erect,extra-axillary,fruit,glabrous,gland-tipped,globose,grey,hair,inflorescence,lanceolate,length,lobe,margin,midpoint,mm,obtuse,ovate,pale,pedicel,peduncle,perennial,petiole,pubescent,purple,ray,red,rhizomatous,rotate-stellate,short,shrub,simple,sparsely,stellate-pubescent,stigma,style,tube,white,x,yellow	%,0-1.5,0.1-0.2,0.2-0.8,0.25-0.4,0.4-0.5,0.4-0.8,0.4-4,0.5-1,1-2,1-3,1.5-1.9,16-23,2-foliate,2.7-3.6,4-,4.5-7,5-merou,7-12,8-9,abaxially,absen,accrescent,across,adaxiall,alyx,apart,articulated,axe,ba,capitat,confined,contiguous,cylindrical,directed,distall,distally,distributed,eaf,eed,eglandular,exceeding,finger,flower,fruiting,geminat,glaberous,green,homostylous,juicy,lamina,lateral,long,lower,markedly,mature,mesocarp,mid-point,midrib,minute,nearly,nflorescence,oblique,orolla,part,per,perfect,pore,porrect,prickle,pseudo-umbellate,rachi,ruit,sessile,solitary,spaced,stalk,stellae,succulen,tal,tamen,tem,thick,thicker,throughout,time,unarme,unarmed,unbranched,unit,vary,wide,ympodial	adhesion,arrangement,capitate,climate,colour,corolla,form,glandular,growth,height,history,leaf,life,na,number,ovary,plant,position,presence,present,pubescence,reproduction,seed,shape,size,staman,stellate,stem,stipe,texture
797	wfo-0001032187	success	139	95	70	69	25	0.504	-4,-4.2,-5,-9,0.1–1.4,0.5,0.5-,0.6–1.3,1.1–3.2,1.3–1.8,1.6–2.1,1.8–2.8,3.1–3.5,3–3.2,3–4,5–7,7–11,adherent,angular,appressed,aromatic,berry,broadly,brown,brownish,cm,corolla,dark,eglandular,elliptic,equal,erect,glabrescent,globose,hair,herb,leaf,light,lobe,long,margin,marked,mature,mm,obovate,occasionally,ovate,pedicel,peduncle,pentagonal,persistent,petiole,plant,purple,ridge,simple,soft,sparse,stellate,stem,style,sub-glabrous,texture,tinged,triangular,well,yellowish,±,±1,×	-11,-2.1,0.5–1,1.8–2,100,1–1.7,22,24.6–26.3,2–9,5-merous,9,acuminate,acute,alyx,anther,ape,apex,base,blade,branch,changing,consisting,cyme,di-foliate,dia,dull,eaf,eed,entire,filament,flowered,forked,fully,geminat,granule,green,hite,hooked,hydrated,lower,many,nflorescence,numerous,penden,per,perfec,petiolate,pollen,predominantly,presen,protruding,rarely,ruit,running,sclerotic,short,small,sometimes,spreading,stage,straight,tooth,truncate,unit,widest,wing,yellow,ympodial,µm	arrangement,calyx,colour,diameter,form,fruit,growth,height,history,inflorescence,length,life,na,perennial,perfect,position,presence,pubescence,reproduction,seed,shape,size,stigma,tube,white
798	wfo-0001032190	success	230	125	103	127	22	0.448	-1,-3.4,0-0.6,0.2-0.3,0.6-1.5,0.7-1.1,0.8-1.1,1-1.5,1-1.7,1-6,1.2-2.1,1.2-3,1.3-5,1.5-3.5,1.8-3,1.9-4.5,10,2-6,2.5-10,3-21,4-5,5-22,6-11,7-28,acuminate,acute,anther,apex,attenuate,bark,becoming,blunt-tipped,branch,brown,calyx,campanulate,chartaceous,cm,conical,coriaceous,corolla,deltoid,densely,diameter,entire,few-rayed,filament,fruit,glabrescent,glabrous,globose,granular-pubescent,green,growth,hair,hirsute,honeycombed,lanceolate,lateral,leaf,length,lobe,margin,mm,moderately,mostly,multangulate,oblong,occasional,ovate,pale,pedicel,peduncle,petiole,plurifoliate,pubescent,reniform,reticulate-punctate,ripe,rotate-stellate,scabridulous,scabrous,shrub,simple,small,somewhat,sparsely,stelliform,stem,stigma,style,suborbicular,terete,terminal,tree,truncate,tube,white,whitish,x,yellow,yellowish,young	-6,.5-6,/100-1/20,0-80,0.4-1.5,0.5-3,1.5-4,1.6-4.4,1/2-3/4,2.5-4.3,2.7-6.8,3.5-8,4-6,4.5-7,6x,7-11,abaxially,absent,accrescent,adaxially,ag,along,anthesi,apart,apical-lateral,apparently,appressed-tomentose,articulated,axe,axillary,ba,base,berry,blade,branched,bud,closely,coarse-stalked,continued,decurrent,dehiscing,due,eaf,eed,ellipsoid,elliptic,evident,exserted,extend,fleshy,flower,free,fruiting,glabrou,high,inserted,introrse,large,line,lobed,long,long-,long-attenuate,long-stalked,longitudinal,lower,m.,magnification,main,midvein,minute,mixed,multangulat,multiseriate-stalked,near,nearly,nflorescence,oblanceolate,obtuse,occasionally,older,openly,orolla,ovat,overlapping,partly,perfect,pore,porrect-stellat,porrect-stellate,present,rachi,rarely,rather,relatively,ruit,runk,sessile,short-,short-stalked,side,slit,spaced,sparse,stamen,stipitate-glandular,strongly,subcapitat,subcoriaceous,suture,tamen,testa,thick,thin-stalked,time,tomentose,touching,toward,unarme,unarmed,unit,usually,vary,vein,way,wide,ympodial	abaxial,adaxial,arrangement,colour,form,height,history,inflorescence,life,ovary,perennial,plant,position,reproduction,seed,shape,size,staman,subcapitate,surface,texture,unknown
799	wfo-0001032206	success	216	127	97	119	30	0.449	-0.8,0.2–0.5,0.8–1.2,1.1–1.2,1.5–2.5,1/4–1/2,11–22,1–2.3,1–3,2.5–3.3,2.7–3.5,2–2.5,3.5–9,3–4,4.5–5.8,5–15,5–6,5–9,6–8,7–10,8–20,abaxially,acute,andromonoecious,anther,apex,base,berry,blade,calyx,chartaceous,cm,connivent,cream,cuneate,dark,deltate,diameter,elliptic,equal,flattened-reniform,flower,foliaceous,fruit,glabrescent,glabrous,green,lateral,leaf,length,lobe,lobed,long,long-styled,margin,marking,maturity,mauve,midpoint,midvein,mm,moderately,obtuse,orange-brown,ovate,pale,pedicel,peduncle,petiole,plant,poricidal,purple,ray,short-styled,shrub,smooth,sometimes,sparsely,spherical,stellate,stellate-pubescent,stem,stout,style,surface,tapering,tip,toward,trichome,truncate,tube,usually,white,wide,yellow,yellow-orange,young	-2,-20,-5,..,.2,.5,0,0.2,0.2–0.4,0.5–1,00–200,0–20,0–30,0–5,1,1.2–2.2,1.5–2,1/3,1/4–1/3,1/6,10–80,1–2,1–4,2–3,2–8,30–80,4–6,5-merous,5–20,5–8,6–10,6–15,accrescent,adaxially,alyx,apar,apart,apically,apparently,approximately,armed,articulated,bark,bluntly,branched,broad-deltate,brow,clearly,concolorous,covering,curved,discolorous,distal,distance,drying,eaf,eed,erect,extending,filament,flattened,free,fruiting,functionally,gently,green-brown,hermaphroditic,heterostylous,infructescence,lengt,lobing,longer,lowermost,mal,mature,nflorescence,often,older,one,open,orolla,ower,pair,pendent,pendulous,per,pericarp,plurifoliat,porrect,portion,prickle,primary,rarely,reflexed,scar,secondary,sessile,side,slender,spaced,spreading,stalk,stalked,straight,tamen,tertiary,time,uit,unarmed,ung,unit,variously,vary,vein,venation,visible,weakly,woody,ympodial	0.5–1.5,adhesion,arrangement,climate,colour,corolla,form,glandular,growth,hair,height,history,inflorescence,life,na,number,ovary,perennial,position,presence,present,pubescence,reproduction,seed,shape,size,staman,stigma,stipe,texture
