	coreid	status	nwords_original	nwords_result	nwords_recovered	nwords_omitted	nwords_created	prop_recovered	common_words	original_only	result_only
0	wfo-0001025652	success	156	79	67	89	12	0.429	0.5-1,1,1-1.5,1.5-2,15-19,2-3,2-6,3-3.5,3-5,4,4-6,4-7,9-11,acuminate,acute,anther,bark,base,bilobed,calyx,cm,corolla,decurrent,densely,elliptic,fleshy,furcate,glabrate,glabrous,green,growth,irregular,leaf,lobe,margin,minor,minutely,mm,occasionally,ovary,ovoid-reniform,pale,paler,papillose,pedicel,petiole,pinkish-grey,pitted,plant,red-papillose,shape,shiny,shrub,simple,size,small,stem,stigma,straight,strongly,style,surface,tan,tree,white,winged,x	.3,.5,10-20,15-17,2-5,20-50,3-5-flowered,abruptly,anthesi,apex,appearing,blade,broad,campanulate,closed,closely,completely,connate,dia,differing,difoliate,dry,eaf,edicel,eed,emerge,envelope,filament,flower,free,fruit,geminat,greyi,greyish,growing,lateral,like,live,lobed,lon,long,lower,main,major,matte,middle,minute,narrowing,nearly,new,nflorescence,older,one,onto,opposite,overlappin,ovoid,pair,papillae,papillo,parallel,planar,pore,poricidal,portion,rather,ry,scar,shaped,soon,spaced,specimen,tall,tapering,tear,tear-drop,thick,thicker,tightly,tip,tube,ud,unit,vein,wider,widest,wing,ympodial,young	1.3,abaxial,characteristic,colour,diameter,form,height,inflorescence,length,peduncle,seed,texture
1	wfo-0001025657	success	239	110	87	152	23	0.364	0.1-0.4,0.2-0.4,0.5-2.5,1-1.3,1-1.6,1-3,1.2-1.5,1.3-2,1.5-1.8,2-10,2-3.5,2.7-4.3,3-6,4-4.4,5-16,6-8,8-10.5,8.3-12,acute,anther,apart,apex,articulated,base,berry,bluish,branched,brown,bud,chartaceous,closely,cm,conical,cordate,corolla,dark,deltoid,diameter,dried,elliptic,entire,expanded,filament,fleshy,flower,fruit,glabrous,granular,green,hair,half,lanate-pubescent,leaf,length,lower,margin,mm,narrowly,oblong,orbicular,ovate,pale,pedicel,peduncle,petiole,porrect-stellate,rachi,reticulate-punctate,ripe,shrub,simple,slightly,soft,spaced,style,suborbicular,surface,tan,tomentose-pubescent,tree,unarmed,vein,velutinous-pubescent,white,x,yellow,yellowish	-2,/3,1-1.1,1.7-1.9,12x,2.2-5.5,2.5-9.3,2/3,25-60,3-4,3-4.8,3.2-6,4-4.5,4-7,5-14,6-12,6.5-10,7-27,7-9,7-9.5,abaxially,accrescent,adaxially,ag,also,anthesi,apparently,appearing,ark,around,ascending,axe,axillary,ba,blade,blunt-tipped,branch,broadly,calyx,capitat,central,cylindrical,dendritic-multangulat,dendritic-multangulate,dense,densely,directed,distally,due,eaf,earl,edge,eed,especially,evident,exerted,exserted,farinose,few-rayed,free,fruiting,glandula,glandular,inserted,lanceolate,lateral,lengthening,light,lobe,lobed,long,long-stalked,longitudinal,m.,magnification,main,midrib,minutely,mixed,multangulate,nearly,nflorescence,obtuse,occasional,often,older,open,orolla,ovat,ovate-lanceolate,overlapping,part,parted,partly,perfect,persistent,persistently,plurifoliate,pore,poricidal,present,pseudo-terminal,pubescence,pubescent,ray,reportedly,ruit,scented,semi-ovate,sessile,short,short-,short-stalked,side,slit,somewhat,splitting,stamen,stellate,stellate-pubescent,stem,stigma,stipitate-glandular,stipitate-multangulate,strongly,subcampanulate,subcoriaceous,suture,tall,tamen,terete,thick-stalked,thickened,thin-stalked,time,tip,tomentose,tomentum,transparent,tube,two-third,ud,unarme,unit,upper,usually,vary,way,weakly,wide,ympodial,young	abaxial,adaxial,arrangement,branching,characteristic,colour,form,growth,height,history,inflorescence,life,midvein,na,ovary,plant,primary,seed,shape,staman,texture,true,type
2	wfo-0001025669	invalid_json	216	129	92	124	37	0.426	'',.5,0.1-0.3,1,1-2,1-2.2,1-4,1.4-2.5,13-35,2,2-3,2-4,2.2-6.5,3-5,``,absent,acuminate,acute,anther,apex,articulation,base,berry,blue,broadly,brownish,cell,chartaceous,cm,condition,contracted,corolla,covering,cuneate,diameter,distinct,drying,elliptic,filament,flower,flowered,fresh,fruit,glabrous,globose,green,greenish,hair,herb,highly,lateral,like,lobe,long,margin,membranous,minute,mm,moderately,monochasium,mottled,oblique,obtuse,odd-pinnate,often,ovate,ovoid,pedicel,peduncle,petiole,plant,pubescent,purple,rarely,ripe,scale-like,seed,single,slightly,sometimes,species,stem,streaked,style,subglabrous,testal,thick,tinged,typically,wall,white,whitish	0-1,0-5,0-7,0.8-2.4,1-10,1-3,1.3-4.2,1.6-4.4,2.2-6,2.4-7,3-7,4-6,5-merou,9-24.5,abaxially,absen,acumen,adaxially,ag,along,alyx,apart,apparently,axe,blade,capitat,ciliate,clavate,clearly,connivent,decurrent,digestion,discussion,distal,dorsally,eaf,edge,eed,end,enzyme,erec,especially,exceeding,except,extra,flat,folded,forming,geminat,glabrou,greatly,green-white,hair-like,half,homostylous,honeycomb-shaped,interjected,lanceolate,larger,leaflet,lengthening,living,lower,make,midrib,minutely,mucilaginous,multicellular,near,nflorescence,obovate,one,orbicular,orolla,pair,perfect,petiolulate,petiolule,placed,plurifoliate,pore,poricidal,proximal,puberulent,reduced,removed,rosette,rotate,rounded,ruit,see,sessile,seudostipule,short,size,slit,spaced,specimen,stamen,ste,stigma,stolo,straight,subequal,tall,tamen,tem,terminal,throughout,tip,tri-,truncate,tube,tuber,unbranched,unequal,unit,unwinged,vary,wet,wide,x,yellow,ympodial	'extra,'hair-like,[,abaxial,adaxial,arrangement,branching,calyx,characteristic,colour,form,growth,height,history,inflorescence,leaf,length,life,midvein,na,ovary,perennial,primary,pseudostipule,rachi,shape,staman,surface,tertiary,texture,true,unarmed,value,vein,venation,{,}
3	wfo-0001025697	success	181	128	98	83	30	0.541	-9,0.15-0.75,1-1.7,1-2,1.7-8.6,10-26,2-6,25-35,3-10,3-4,3-5,3-6,abaxially,acuminate,acute,adaxially,anther,apart,apex,articulated,asymmetric,attenuate,axillary,base,basiscopic,berry,blue,brownish,bud,cell,cm,condition,coriaceous,corolla,covering,dark,deep,diameter,distal,drying,elliptic,filament,flower,forked,fresh,fruit,generally,glabrescent,glabrous,globose,green,green-white,greenish,hair,hair-like,half,herb,high,lanceolate,lateral,leaf,light,lilac,lobe,long,make,medium,mm,mucilaginous,odd-pinnate,ovate,ovoid,pedicel,peduncle,petiole,plant,purple,rachi,ripe,rounded,seed,sessile,short,side,spaced,stripe,style,subtending,terminal,testal,thick,throughout,tissue,typically,usually,wall,wet,whitish	0-14,0.6-3.5,0.8-2,1-3,1.5-1.8,2-10.5,2-2.6,2-4,3.3-11,4-7.5,5-merou,5.5-11.5,6.5-13.5,acumen,adaxiall,ag,alyx,apparently,axe,blade,capitat,clavate,connivent,decreasing,decurrent,digestion,dorsally,eaf,edge,eed,enzyme,erec,exceeding,flat,folded,geminat,glabrou,hal,homostylous,honeycomb-shaped,interjected,leaflet,lengthening,linear,living,lower,nflorescence,orbicular,orolla,pair,pentagonal,perfect,petiolulate,plurifoliate,pore,poricidal,removed,rotate,ruit,seudostipule,size,slightly,slit,specimen,stamen,stigma,straight,subequal,subglabrou,tall,tamen,tem,tip,toward,tri-,tube,unit,unwinged,vary,wood,x,yellow,ympodial	2,abaxial,adaxial,arrangement,branching,calyx,characteristic,colour,form,growth,height,inflorescence,length,margin,midvein,na,ovary,primary,pseudostipule,shape,staman,stem,subglabrous,surface,tertiary,texture,unarmed,vein,venation,woody
4	wfo-0001025699	success	181	111	97	84	14	0.536	.2,1,1-1.5,1-2.5,1-3,1.5-2,10,15-20,2,2-2.5,2cm,3-3.5,3-8,4-5,5-8,5-winged,8-9,abaxially,absent,acute,almost,anther,anthesi,apex,attenuate,base,berry,branching,brown,c.,calyx,cm,completely,conical,conspicuously,corolla,crystal,dark,darker,diameter,elliptic,entire,exerted,filament,glabrous,globose,green,grey-brown,growth,immature,inclusion,inflorescence,lanceolate,leaf,leaf-opposed,leafy,lobe,margin,markedly,midrib,minutely,mm,narrowly,nodding,older,ovary,oxalate,pair,pale,pedicel,peduncle,petiole,primary,red,reticulate-pitted,rounded,sand,shoot,short,small,somewhat,stem,strongly,style,surface,time,tip,tree,triangular,tube,vein,way,white,white-spotted,winged,x,young	.5,0.5,1-2,1.5,1/3,2-6,3-15,3-5.5,499,5.5-14,adaxially,age,apart,apparently,appearing,articulating,bark,becoming,campanulate,capitate,continuing,corrugate,cup-shaped,deltate,densely,difoliate,dorsal,dry,drying,eaf,eed,ellipsoid,erect,face,fide,flower,free,fruiting,glabrou,included,inflorescenc,irregularly,leaving,lengthening,less,lobed,lower,new,nflorescence,one,onto,papillat,papillose,peg,penden,per,perfect,plurifoliate,pore,poricidal,portion,reddish,reniform,rounded-sagittate,ruit,scar,simple,slightly,slit,spaced,stearn,stigma,straight,tangled,thickened,trichome,ud,unit,wide,wing,woody,yellow,ympodial,Â½	abaxial,adaxial,characteristic,colour,corrugated,form,fruit,height,length,plant,seed,shape,texture,type
5	wfo-0001025700	invalid_json	189	108	72	117	36	0.381	0.30-2.0,0.5-2,0.8-2.6,1-2,10.5-12,15-40,2-12,2-7,2.5-4,3-8,5-15,5-20,5.5-8,acuminate,acute,anther,apex,apiculate,articulated,attenuate,base,berry,brownish,cell,chartaceous,cm,condition,corolla,covering,diameter,distal,dot,drying,elliptic,filament,fresh,fruit,glabrescent,glabrous,globose,green,greenish,hair-like,half,herb,high,lateral,leaf,light,lilac,lobe,long,medium,mm,odd-pinnate,ovate,ovoid,pedicel,peduncle,petiole,petiolulate,plant,purple,rounded,seed,sometimes,style,testal,thick,wall,white,whitish	0-16,0.7-2.7,0.8-4,1-3,1.1-2.3,1.5-2,10-40,3-4,3.5-10.5,3.7-8.6,4-5,5-merou,5.3-17.5,5.5-18,9-31,abaxially,acuman,acumen,adaxially,ag,alyx,apparently,asymmetric,axe,axillary,basal,basiscopic,blade,bud,capitat,clavate,connivent,considerably,decrease,decreasing,digestion,dorsally,eaf,edge,eed,enzyme,erec,exceeding,except,flat,flower,folded,forked,geminat,generally,glabrou,green-white,hair,hal,homostylous,honeycomb-shaped,interjected,lanceolate,larger,leaflet,lengthening,linear,living,lower,make,mucilaginous,narrowly,nflorescence,orbicular,orolla,pair,par,pentagonal,perfect,plurifoliate,pore,poricidal,proximal,removed,ripe,rotate-pentagonal,ruit,sessile,seudostipule,short,side,size,slightly,slit,specimen,stamen,stigma,straight,subequal,subglabrou,subtending,tall,tamen,tem,terminal,throughout,tip,tissue,toward,tri-,tube,typically,unit,unwinged,usually,vary,wet,whose,winged,x,yellow,ympodial	'',2,[,``,abaxial,adaxial,arrangement,branching,calyx,characteristic,colour,form,growth,height,inflorescence,length,margin,midvein,na,ovary,primary,pseudostipule,rachi,shape,staman,stem,subglabrous,surface,tertiary,texture,unarmed,value,vein,venation,{,}
6	wfo-0001025704	success	248	132	113	135	19	0.456	0-100,0-2,0-3.5,0.3-0.8,0.5-1.5,0.7-1,1-3.5,1-6,1.2-3,1.5-3.2,1/2-4/5,1/5,2-3,2-4.5,2-7,2.7-4,3-15,3-5,3-6,4-5,4.5-6.5,abaxial,acute,adaxial,almost,anther,apex,apically,apiculate,apparently,articulated,auriculate,base,berry,branched,calyx,cell,chartaceous,cm,cordate,deltate,densely,diameter,discolorous,drying,ellipsoid,elliptic,erect,evenly,filament,flattened-reniform,fruit,glabrous,green,green-yellow,lateral,leaf,length,lobe,lobed,long,margin,maturity,mauve,mm,near,orange,orange-brown,outline,ovate,pale,pedicel,peduncle,per,petiole,pit,plant,prickle,prickly,raised,rarely,red-green,round,rounded,shape,shrub,side,small,smooth,sometimes,sparsely,spherical,stellate,stellate-pubescent,stem,strongly,style,surface,terminal,tree,truncate,unarmed,unbranched,unit,upper,way,white,white-gray,yellow,yellow-green,yellowish,young,Ã	-10,-2,-3,-5,/6,0,0-5,0.1,0.1-0.3,0.1-0.5,0.15-0.8,1,1-4,1.5-2,1.5-4.5,1.8-3.5,1/4-3/4,2,2-10,2-5,2.5-4.5,3-10,4-12,5-20,5-merous,6-12,6-15,8-12,8-15,8-17,abaxially,age,alyx,andromonoecious,apar,apart,axe,ba,bark,blade,broad-deltate,brow,connivent,covering,curved,development,distal,distance,eaf,eed,elongating,end,equal,extending,flattened,flower,free,fruiting,glabrescent,gray,half,hermaphrodite,heterostylous,infructescence,irregular,less,lobing,long-styled,longer,lower,lowermost,mature,midpoint,midvein,moderately,multangulate,nflorescence,obtuse,occasionally,often,older,one,open,orolla,oung,pair,pendulous,pericarp,plurifoliat,poricidal,porrect,portion,prickl,primary,prominent,ray,recurved,red-brown,reflexed,retaining,ruit,scar,secondary,sessile,short-styled,shorter,slender,somewhat,spaced,spreading,stalk,stalked,staminat,stellate-pubescen,stout,straight,tamen,tapering,terete,tertiary,throughout,time,tip,trichome,tube,variously,vary,vein,venation,visible,warty,wide,widening,woody,ympodial	arrangement,branching,characteristic,colour,corolla,form,growth,hair,height,inflorescence,na,ovary,plurifoliate,seed,staman,sympodial,texture,type,width
7	wfo-0001025729	success	177	129	103	74	26	0.582	.5,0.25-0.5,0.7-1.2,1-1.5,1-5,1.1-1.5,1.2-1.8,1.5-2,1.75,2,20,4-5,5-50-flowered,7-8,abaxial,abaxially,abrupt,acute,adaxially,anther,apex,apiculate,appearing,axil,basal,base,berry,black,bright,calyx,cm,corolla,covering,deltoid,densely,dia,diam,dirty,drying,elliptic,f,filament,flattened-reniform,fleshy,furcate,glabrous,globose,green,greenish-yellow,greyish-brown,growing,incrassate,lamina,lateral,leaf,like,live,lobe,long,main,margin,minute,minutely,mm,oblique,occasionally,often,opposite,ovary,overtopping,pair,pale,papillose,pedicel,petiole,pit,pitted,plant,pubescent,ripening,rounded,shiny,simple,sparsely,stem,straight,style,surface,tapering,terminal,tip,tree,treelet,trichome,tube,tuft,uniseriate,usually,vein,white,widening,x,yellow	-20,/4,2-3.5,3-6,4-8,6-8,9-17,along,anthesi,apar,apical,bark,blackish,branched,bristly,bud,covered,cyathiform,dark,deflexed,denser,differing,difoliate,eaf,edicel,eed,enclosed,expanded,free,fruiting,geminat,gently,glabrou,lat,lobed,lon,lower,m.,mainly,major,member,middle,minor,nflorescence,older,one,overlapping,papillo,partially,pore,poricidal,portion,prominent,quite,raised,reflexed,ruit,scar,shaped,short,size,stigma,stout,tall,tear-drop,touching,tub,ud,unit,way,widest,woody,ympodial,young	4-20,adaxial,arrangement,branching,characteristic,colour,diameter,form,fruit,growth,height,inflorescence,length,midvein,na,peduncle,primary,pseudostipule,rachi,seed,shape,staman,tertiary,texture,unarmed,venation
8	wfo-0001025749	success	217	128	105	112	23	0.484	0-10,0-3,0-5,0-6,0.2-1.5,0.3-1.5,0.5-0.8,0.5-0.9,0.8-0.9,1-10,1-13,1-2,1-3,1-6,1-9,1.5-2,1.5-2.5,2-2.5,2.5-6,3-5,5-20,abaxial,acute,adaxial,anther,apex,apically,apparently,articulated,base,berry,branched,calyx,chartaceous,cm,cuneate,curved,dark,densely,diameter,dull,filament,flattened-reniform,flower,fruit,gently,glabrous,green-brown,indistinct,infructescence,lateral,leaf,length,lobe,lobed,long,long-ovate,lower,magnification,margin,maturity,mauve,midvein,mm,moderately,narrow-deltate,orange-brown,orange-red,orbicular,ovate,pair,pale,pedicel,peduncle,per,petiole,prickle,prickly,primary,rarely,red-brown,rounded,shrub,sparsely,spherical,stellate,stellate-pubescent,stem,straight,straw-yellow,style,surface,tertiary,toward,trichome,usually,vein,venation,visible,white,wide,without,yellow,yellow-green,yellow-orange	-1,-12,.5,/5,0-8,0.1,0.1-0.2,0.1-0.3,0.1-0.4,0.2,0.4-0.7,0.5,0.5-1.3,0.5-3,0.6-4.5,1,1-8.5,1.5,1/4-1/3,1/5-1/2,2-10,2/3,3-20,4-8,5-,5-10,5-merous,6-8,abaxially,acuminat,adaxially,adnate,almost,alyx,apar,apart,bark,blade,broad-deltate,concolorous,difoliate,discolorous,distance,drying,eaf,eed,elongating,equal,erect,extending,filiform,flattened,free,fruiting,geminat,glabrescent,gray,herbaceous,light,lon,longer,markedly,mature,midpoint,narrow-ovate,nflorescence,oblong,obtuse,occasionally,older,one,open,orange-brow,orolla,oung,pendulous,perfec,pericarp,poricidal,porrect,portion,prickl,procumbent,purple,ray,recurved,reduced,ruit,scar,sessile,shorter,side,smooth,sometimes,spaced,spreading,stalk,stalked,strongly,tamen,tapering,terete,time,tip,tube,unit,variously,vary,way,yellowish,ympodial,Â½-2/	acuminate,arrangement,branching,characteristic,colour,corolla,form,growth,height,history,inflorescence,life,na,ovary,plant,pseudostipule,rachi,seed,shape,staman,texture,unarmed,Â½-2/3
9	wfo-0001025754	success	164	114	91	73	23	0.555	-celled,.5,0.5-1,0.5-1.5,1,1-2,1-3,1.5,1.5-3,10-20,10-35,2-7,3-10,3-5,3-6,4,4-6,5-15,absent,acuminate,acute,anther,apex,asymmetrical,base,berry,beyond,brown,calyx,center,chartaceous,ciliate,cm,cordate,cordiform,decurrent,densely,diameter,drying,edge,eglandular,entire,equal,exserted,filament,fine,flower,fruit,glabrous,globose,hair,herb,immature,leaf,leaving,linear-lanceolate,lobe,margin,maturing,membranaceous,mm,moderately,much-branched,nearly,often,palmately,parallel,pedicel,peduncle,per,petiole,pubescent,rachi,radiating,raised,ridge,running,semitransparent,shallow,slightly,solitary,sparsely,stamen,style,surface,truncate,unbranched,vein,white,x,yellow	0.1-0.2,1-3.5,1.5-4,2-4,2-5-celled,2-foliate,5-12,abaxially,abundant,adaxiall,adaxially,along,axe,barely,blade,branch,connected,decumbent,dehiscing,denser,dm,dried,eaf,eed,emarginat,erect,explosively,flat,geminat,glandular,held,interpetalar,like,long,lower,lying,main,material,maturit,mesocarp,mixed,nfloresence,notch,oblong,orolla,penden,placenta,pressure,probably,pubescen,rotate,ruit,short,small,sometimes,stem,stigma,straight,swollen,tal,tamen,tem,tissue,triangular,tube,unit,upright,vary,visible,watery,wid,woody,ympodial	2.5,abaxial,adaxial,arrangement,branching,characteristic,colour,corolla,form,geminate,growth,inflorescence,length,midvein,na,ovary,pendent,primary,seed,shape,staman,texture,unarmed
10	wfo-0001025760	success	210	127	107	103	20	0.51	-6,0-0.5,0-100,0.3-1,0.4-0.8,0.45-0.9,0.5-2,0.8-1.8,1-1.8,1-4,1.5,1.5-5,1/5,2-2.5,2.1-3.5,2.3-4,2/3,3,3-6,3.5-9,abaxial,acute,adaxial,almost,annual,anther,apex,apically,articulated,base,berry,black,broad-deltate,calyx,chartaceous,cm,concolorous,cream,cultivar,cuneate,curved,dark,diameter,discolorous,drying,dull,elliptic,filament,flattened-reniform,fruit,gently,glabrous,green,herb,lateral,leaf,length,lobe,lobed,long,margin,marking,maturity,membranous,midvein,mm,moderately,orange,orange-brown,ovate,pair,pale,pedicel,peduncle,per,perennial,petiole,primary,recurved,red-brown,rounded,shape,side,slender,sometimes,spherical,stellate-pubescent,stem,stout,straight,style,surface,terete,tertiary,unarmed,unbranched,upper,usually,various,vein,venation,visible,white,wide,yellow,yellow-green,young	-10,-12,-3,-5,.5,/3,0.1,0.1-0.2,0.15-0.3,0.2-0.35,0.5-1.5,0.7-2.5,1,1-,1-2,1.5-2.5,1.5-4.5,1/4,1/4-1/2,1/4-1/3,2-3,2.5-10,2.5-8,3.5-17,5-10-merous,5-18,8-10,abaxially,acut,alyx,apar,apparently,bark,blade,brow,connivent,deltate,difoliate,distance,eaf,eed,elongating,equal,erect,extending,flower,free,fruiting,geminat,geminate,glabrescent,hair,infructescence,lengt,longer,lower,mature,midpoint,minute,nflorescence,often,older,one,open,orolla,oung,pendulous,perfec,pericarp,poricidal,porrect,portion,ray,reflexe,ruit,scar,sessile,shorter,shrub,simple,smooth,spaced,spreading,stalk,stalked,stellate,stellate-pubescen,subentire,tamen,tapering,thick-stalked,time,tip,trichome,tube,unarme,unit,variously,vary,way,weakly,woody,ympodial	arrangement,branching,characteristic,colour,corolla,form,growth,height,history,inflorescence,life,na,ovary,plant,pseudostipule,rachi,seed,staman,texture,ye
11	wfo-0001025782	success	200	116	97	103	19	0.485	.5,0-10,0-5,0.4-0.6,0.55-0.75,0.9-1.3,1-2,1-4,1.2-6,1.3-1.6,2-10,2-2.5,2-3,3-4,3-5,4,4-4.5,5-20,5.5-6,abaxial,acuminate,adaxial,anther,apex,apically,apparently,articulated,base,berry,brown,calyx,chartaceous,cm,cuneate,curved,deltate,diameter,difoliate,dull,elliptic,evenly,filament,flattened-reniform,flower,fruit,geminate,gently,glabrous,green,green-brown,hair,lateral,leaf,length,lobe,lobed,long,margin,maturity,membranous,midvein,mm,moderately,orange-brown,pair,pedicel,peduncle,per,petiole,plant,porrect,prickle,prickly,primary,sessile,shrub,sparsely,spherical,stellate,stellate-pubescent,stem,style,surface,tertiary,toward,trichome,unbranched,unit,vein,venation,visible,weakly,white,wide,yellow,yellow-green,young	-2,0.1-0.15,0.1-0.2,0.1-0.25,0.3-1,0.5-1,1,1-1.7,1-2.5,1.5-3,1/4-1/2,1/4-1/3,1/6,10-13,2-5,2-7,2.5-3.5,2/3-3/4,20,4.5-9,5-6.5,5-8,5-merous,6-14,6-8,abaxially,acuminat,also,alyx,andromonoecious,apar,apart,bark,blade,climbing,concolorous,conical,connivent,densely,discolorous,distal,distance,drying,eaf,eed,elongated,elongating,equal,extending,flattened,free,fruiting,geminat,glabrescent,hermaphrodite,heterostylous,infructescence,lengt,less,long-styled,longer,lower,lowermost,mature,midpoint,minute,nflorescence,occasionally,older,one,open,orolla,oung,pendulous,pericarp,poricidal,portion,prickl,ray,red-brow,reduced,ruit,scar,short-styled,shorter,side,simple,smooth,spaced,spreading,staminat,stout,straight,tamen,tapering,terete,time,tip,tube,vary,way,woody,ympodial	arrangement,branching,characteristic,colour,corolla,form,growth,height,inflorescence,na,ovary,rachi,seed,shape,staman,sympodial,texture,type,unarmed
12	wfo-0001025783	success	179	122	96	83	26	0.536	.5,0.5,0.5-1.5,1-1.2,1-1.5,1-3,2-3+,2-5,3-4,5,7-10,<,acute,anther,apex,articulated,base,berry,branched,branching,brown,calyx,cell,cm,coriaceous,corolla,dendritic,diameter,elliptic,entire,erect,filiform,flattened,fleshy,flower,glabrous,globose,growth,inserted,keeled,lateral,lax,less,lobe,long,margin,midvein,minutely,mm,narrowly,nodding,obtuse,pair,pale,pedicel,peduncle,pentagonal,pericarp,petiole,pitted,point,primary,pubescent,purple,reniform,revolute,ripe,scarious,shiny,shoot,short,shrub,simple,sleeve,slightly,sometimes,somewhat,sparsely,stem,style,surface,terminal,testal,thin,time,transparent,triangular,trichome,truncate,tuft,uniseriate,vein,vine,violet,wide,woody	0.5-1,0.8-3.5,1.8-2,2,2-6.5,5-merou,abaxiall,abaxially,adaxiall,adaxially,along,alyx,anthesi,apart,ape,ark,axil,bud,c.,cluster,completely,confined,conical,densely,eaf,eed,ellipsoid,expanded,exposed,exserted,flexuous,free,fruiting,glabrou,green,greyish,groove,hromosome,ilament,known,lobed,long/tall,lower,mature,midrib,minute,mmm,near,new,nflorescence,number,obscured,occasionally,older,orolla,outlin,penden,perfect,plurifoliat,portion,possibly,ruit,sagittate,scar,see,spaced,sparse,stellate,stigma,strongly,suture,tube,twinin,type,ud,unit,upper,vary,way,weak,within,yellowish,ympodial	abaxial,adaxial,arrangement,characteristic,colour,filament,form,fruit,hair,height,inflorescence,leaf,length,na,outline,ovary,plant,pseudostipule,rachi,seed,shape,staman,tertiary,texture,unarmed,venation
13	wfo-0001025788	invalid_json	158	110	81	77	29	0.513	-8,0.5-2,1-5,15-30,2-13,2-3,2-5,2.8-9.5,4-5.5,4.5-12.5,5-8,6-7,acuminate,acute,apex,apical,apically,base,blue,branched,calyx,cell,cm,conical,corolla,covering,cuneate,cyme,dehiscent,diameter,dichasial,dichasially,ebracteate,elliptical,exceeding,finely,hair-like,herbaceous,interjected,introrse,lateral,leaf,leaflet,long,make,maturing,mm,monochasial,mucilaginous,narrowly,oblique,obtuse,odd-pinnate,often,ovate,ovoid,pair,pedicel,peduncle,perennial,petiole,plant,poricidally,pubescent,purple,rounded,seed,sessile,short,slit,stamen,stigma,straight,style,subsessile,terminal,testal,thick,tip,tuber-bearing,wall	0-6,1-4,1.8-2.7,1.8-3.9,10-24,14-48,2-10,2m,3-,3-6-foliat,4-3.,4.5-10.1,6.2-12.5,8-38,abaxiall,abaxially,acumen,adaxially,articulate,attenuate,connate,deep,digestion,diminishing,distal,dorsally,eaf,edge,eed,emoval,enzyme,filament,flat,flower,folded,forked,generally,globo,gradually,green,green-white,half,honeycomb,living,lobe,lon,long-attenuate,lower,lunat,medium,nflorescence,nther,orolla,pattern,perfect,petiolule,plan,proximal,reveal,rotate,ruit,seudostipule,size,specimen,subequal,tal,tem,throughou,throughout,toward,typically,unit,vary,wide,yellow,ympodial,Â¼	'',4-31,[,``,anther,arrangement,attachment,characteristic,colour,dehiscence,form,fruit,globose,growth,height,history,inflorescence,length,life,ovary,shape,stem,surface,texture,value,wet,ye,{,}
14	wfo-0001025792	success	203	104	74	129	30	0.365	0.4-0.7,1-2,1-3,10-15,2-11,2-3,2.5-3.5,21-28,4-12,4-6,5,7.5-8,8-10,acute,anther,apex,base,berry,blue-mauve,blue-purple,brownish,cell,cm,condition,corolla,covering,dark,densely,diameter,distinctly,drying,elliptic,filament,fresh,fruit,glabrous,globose,green,greenish,hair,hair-like,herb,lanceolate,lateral,like,lobe,long,margin,mauve,minute,mm,narrowly,oblique,odd-pinnate,ovoid,papillose,pedicel,peduncle,petiole,plant,pubescent,purple,rachi,rounded,seed,stem,streak,style,testal,thick,tinged,wall,white,whitish	1-10,1-4,2-3.5,2.5-4,3-4,3-5,3.5-6,4.5-7,5-10,5-6,5-9,5-merou,7-10,9-12,abaxially,acumen,acuminate,adaxially,ag,along,alyx,apart,apparently,articulated,articulation,auriculate,axe,axillary,basiscopic,blade,broadly,bud,capitat,chartaceous,ciliate,connivent,decurrent,developing,digestion,distal,distinct,dorsally,eaf,edge,eed,enzyme,especially,exceeding,except,flat,flower,folded,forked,geminat,generally,glabrou,greatly,green-white,hal,half,high,homostylous,honeycomb-shaped,indistinct,interjected,leaflet,lengthening,living,lower,make,membranous,midrib,minutely,mottle,mucilaginous,narrow,nflorescence,often,onto,orolla,pair,perfect,petiolulate,plurifoliate,pore,poricidal,proximal,puberulent,reduced,removed,ripe,rotate-pentagonal,ruit,semi-erec,semi-rosette,sessile,seudostipule,short,shortly,side,size,slightly,slit,spaced,specimen,stamen,ste,stigma,straight,sub-rosette,subequal,subtending,tall,tamen,tem,terminal,throughout,tip,tri-,tube,unit,usually,vary,wet,wing,x,yellow,ympodial,young	2,abaxial,adaxial,arrangement,branching,calyx,characteristic,colour,form,growth,height,history,inflorescence,leaf,length,life,midvein,mottled,na,ovary,primary,pseudostipule,shape,staman,surface,tertiary,texture,unarmed,vein,venation
15	wfo-0001025804	success	155	106	77	78	29	0.497	.5,0.5-1,1-1.5,1-3,1.2-1.5,1.4-1.7,1.5-2,2-2.5,3-4.5,3.5-12,6-8,7-10,abaxially,acute,adaxially,anther,apex,apiculate,attenuate,base,berry,calyx,clavate,cm,corolla,cream,dark,deflexed,dia,difoliate,drying,elliptic,erect,filament,flattened,fleshy,glabrous,globose,green,incrassate,internodal,leaf,light,lobe,margin,mere,minutely,mm,near,obovate,occasionally,opposite,ovary,pair,paler,papillose,pedicel,pitted,plurifoliate,projection,red-papillose,reddish-brown,reniform,rim,shrub,somewhat,stem,strongly,style,surface,thick,tip,vein,white,whitish-green,winged,x	.25,10-20,11-20,16-35,2.5-4,4-10,5,?,age,anthesi,apar,ape,ba,bark,bilobed,branched,c.,conical,covered,cucullate,decurrent,densely,differing,eaf,edicel,eed,ellipsoid,exserted,flower,free,fruiting,geminat,glandular,later,lateral,lengthening,lobed,long,lower,main,major,many,middle,minor,minute,nearly,nflorescence,often,older,onto,papillae,papillat,papillate,planar,pore,poricidal,portion,red,reddish-brow,regularly,ruit,scar,sessile,size,slit,spaced,stigma,tall,time,tub,tube,ud,unit,widest,wing,woody,ympodial,young	abaxial,adaxial,arrangement,branching,characteristic,colour,diameter,form,fruit,geminate,growth,height,inflorescence,length,midvein,na,peduncle,petiole,plant,primary,pseudostipule,rachi,seed,shape,staman,tertiary,texture,unarmed,venation
16	wfo-0001025813	invalid_json	197	114	80	117	34	0.406	'',1-1.5,1-2,1-4,1.5-1.8,15-30,2-3,3-3.5,3-4,3-5,5-6,6-7,``,acuminate,acute,anther,apex,articulated,base,berry,blue,broadly,brownish,cell,chartaceous,cm,condition,contracted,corolla,covering,cuneate,dark,densely,diameter,distal,drying,elliptic,filament,flower,fresh,fruit,glabrous,globose,green,greenish,hair,highly,lanceolate,lateral,light,like,lobe,long,margin,membranous,mm,monochasium,obtuse,odd-pinnate,often,ovoid,pedicel,peduncle,petiole,pilose,pubescent,rachi,rarely,seed,single-flowered,stem,style,suborbicular,testal,thick,vein,violet,wall,white,whitish	0-2,0.7-1.7,1-10,1.2-4.5,1.3-7,1.5-2,1.5-6.5,2-4,2-5,3-6,3-7,5-18.5,5-merou,abaxially,absent,acumen,adaxially,ag,along,alyx,apart,apparently,axe,blade,borne,ciliate,connivent,decreasing,decurrent,digestion,discussion,distinct,dorsally,eaf,edge,eed,end,enzyme,especially,exceeding,extra,flat,folded,geminat,glabrou,green-white,hair-like,half,herb,homostylous,honeycomb-shaped,interjected,larger,leaflet,lengthening,living,longer,lower,make,midrib,minute,minutely,mucilaginous,near,nflorescence,orbicular,orolla,ovate,ovoi,pair,perfect,petiolulate,plant,plurifoliate,pore,poricidal,puberulent,removed,rosette-formin,rotate,ruit,see,sessile,seudostipule,short,singly,size,slit,sometimes,spaced,species,specimen,stamen,ste,stigma,stolo,straight,strongly,tamen,tem,terminal,thir,throughout,tip,toward,tri-,tube,tuber,typically,unforked,unit,unwinged,vary,wet,x,yellow,ympodial	'extra,'hair-like,2,[,],abaxial,adaxial,arrangement,branching,calyx,characteristic,colour,form,growth,inflorescence,leaf,length,midvein,na,ovary,primary,pseudostipule,rosette-forming,shape,staman,surface,tertiary,texture,third,unarmed,value,venation,{,}
17	wfo-0001025825	success	187	116	89	98	27	0.476	0.4-1,0.5-10.4,1-2,1-5.5,1.1-1.4,10-24,2-3.7,2-5,22-86,3-10,3-5,4-8,4-9,acuminate,acute,anther,apex,articulated,axillary,back,base,berry,brownish,bud,cell,cm,condition,coriaceous,corolla,covering,dark,decurrent,diameter,distal,drying,elliptic,filament,flower,forked,fresh,fruit,generally,glabrescent,glabrous,green,green-white,greenish,hair,hair-like,half,herb,high,lanceolate,lateral,leaf,light,lilac,lobe,long,make,medium,mm,mucilaginous,odd-pinnate,ovate,ovoid,pedicel,peduncle,petiole,petiolulate,plant,rachi,seed,sessile,shiny,short,slightly,streak,style,subtending,terminal,testal,thick,throughout,usually,wall,wet,white,whitish	0-0.21,0.4-3,0.5-0.8,0.7-2.2,0.9-2,0.9-4,1-3,10.5-26,14-85,3-8.5,3.7-6.5,5-10,5-7,5-merou,6-10,6.6-14,abaxially,acumen,adaxiall,adaxially,ag,alyx,apart,apparently,asymmetric,attenuate,axe,basiscopic,blade,capitat,clavate,connivent,cuneate,decreasing,digestion,dorsally,eaf,edge,eed,enzyme,erec,exceeding,flat,folded,geminat,glabrou,hal,homostylous,honeycomb-shaped,increasing,interjected,leaflet,lengthening,living,lower,middle,nflorescence,orbicular,orolla,pair,pentagonal,perfect,plurifoliate,pore,poricidal,removed,rotate-pentagonal,rounded,ruit,seudostipule,side,size,slit,smaller,spaced,specimen,stamen,stigma,straight,subequal,subglabrou,tall,tamen,tem,tip,tissue,toward,tri-,tube,unit,unwinged,vary,wide,wing,winged,x,yellow,ympodial	2,abaxial,adaxial,arrangement,calyx,characteristic,colour,form,growth,height,inflorescence,length,margin,midvein,na,ovary,primary,pseudostipule,shape,staman,stem,subglabrous,surface,tertiary,texture,vein,venation
18	wfo-0001025838	success	217	107	92	125	15	0.424	0.5,0.5-1,0.7-2,1-1.2,1-1.5,1.5-2,1.5-2.5,1.5-3.5,1.5-5,1.8-2,2-2.5,2.5-3,20-40,4-15,4.5-5.5,6.5-7,acuminate,anther,apex,apiculate,articulated,attenuate,base,berry,black,branched,brown,calyx,cm,corolla,densely,diameter,elliptic,entire,erect,filament,flattened,fruit,glabrous,greenish,growth,inflorescence,inserted,lanceolate,lateral,leaf,like,lobe,long,many,margin,minutely,mm,narrowly,nodding,often,onto,pale,pedicel,peduncle,per,petiole,pitted,pubescent,purple,quadrate,reddish,reniform,revolute,ripe,seed,short,shrub,simple,sleeve,slender,sometimes,sparsely,stem,style,surface,terminal,time,tinged,tip,tree,trichome,uniseriate,white,winged,x,yellow	-20,.5,1.2-5,1.5-1.7,10-15,10-60,2-5,2/3,3.5-,5,5-merou,6-15,abruptly,adaxial,adaxially,ag,along,alyx,anthesi,apart,appearing,archin,ark,axil,basall,branch,broad,capitate,cell,clavate,clustered,connivent,cucullate,cup-shaped,dark,decurrent,dendritic,dense,denser,disintegrating,drying,eaf,eed,ellipsoidal,exserted,extending,fleshy,flower,free,fruiting,glabrescent,globose,hairy,ilament,insertion,irregularly,keeled,lamina,lengthening,less,lobed,loosely,lower,m.,membranous,midrib,minute,mostly,narrowing,never,new,nflorescence,occasionally,older,orolla,ovoid,pair,papillat,papillo,perfect,pericarp,platform,plurifoliat,point,pointed,pore,poricidal,portion,primary,ruit,scar,shin,shiny,sinus,slightly,slit,small,spaced,spreading,square,stellate,stigma,strongly,tall,tem,testal,thi,thin,tube,tuft,turbinate,twinin,ud,unit,upper,vary,vein,wall,way,weight,wing,woody,yellowish,ympodial,Â¾	arching,arrangement,branching,characteristic,colour,form,height,length,na,ovary,plant,shape,staman,texture,type
19	wfo-0001025845	success	180	89	71	109	18	0.394	0.3-0.5,0.4-1.5,0.5-11,0.5-2.5,1-4.5,1.5-2,2-3,3-13,4-5,4-6,5-6,6-6.5,6-9,acuminate,acute,anther,apart,apex,apiculate,base,branch,brown,calyx,chartaceous,cm,corolla,cuneate,deltate,diameter,ellipsoidal,entire,extra-axillary,filament,flattened,fork,fruit,glabrous,greenish,herb,leaf,light,lobe,lobed,located,margin,membranaceous,minutely,mm,obtuse,orange,ovate,ovoid,pedicel,peduncle,petiole,pinnately,puberulent,rachi,radiu,rugose-verrucate,shrub,simple,sparsely,style,subcordate,tip,truncate,unbranched,white,x,yellow	.5,1,1-1.8,1-2,1.5,1.5-13,1.5-2.5,1.5-7,2,2-15,2-5-lobed,2.5-4,3,3-4,3-6,3-foliat,7-10,abaxially,abundantly,adaxial,adaxially,aggregate,along,around,articulated,ascending,axe,ba,blade,cell,channe,compressed,connivent,cylindrical,dark,decurrent,diamete,directed,distall,distally,divided,eaf,eed,eglandular,elliptic,especially,flower,free,glabrou,green,inserted,lateral,laterally,long,longitudinal,lower,major,mesocarp,midrib,narrowly,near,nearly,nflorescence,obovate,often,orolla,part,patch,perfect,pore,pubescent,purple,rarely,rotate-stellate,rounded,ruit,sagittate,sand-punctate,shorter,side,sinus,small,spaced,stigma,stone,stripe,strongly,tal,tamen,tapered,tem,terminal,thecae,thick,tightly,time,tomento,triangular,truncat,tube,unit,unlobed,vary,vein,veiny,wide,yellowish,ympodial,youn	abaxial,arrangement,characteristic,colour,form,growth,height,inflorescence,length,ovary,plant,seed,shape,spacing,staman,stem,surface,texture
20	wfo-0001025850	invalid_json	197	135	105	92	30	0.533	-7,.5,.8,0.5-1,0.5-3,0.6-1,1,1-1.5,1.5,15-20,2,2-6.5,30,4-5,6-7,abaxial,acute,anther,anthesi,apex,articulated,axi,base,berry,branched,broadly,brown,calyx,cell,cm,corolla,deltate,diameter,divaricate,elliptic,elongate,entire,filament,flattened,flower,glabrous,glandular,globose,green,growth,inflorescence,later,lateral,lax,leaving,lobe,lobed,long,many,margin,minutely,mm,narrowly,nodding,often,openly,orange,outline,pair,pale,pedicel,peduncle,peg,per,petiole,pitted,primary,pubescent,reddish,reniform,rhomboid,ripe,rounded,scattered,shallowly,shiny,shrub,simple,sinuate,sleeve,slender,small,stem,style,surface,tan,terminal,testal,thin,time,tiny,tip,trichome,truncate,uniseriate,vein,vine,white,woody,x	-5,0.5,0.5-,1-3,1-celled,1.5-5,2-12,3-4,5-7,5-merou,ag,along,alyx,apar,apparently,ark,basal,capitate,connivent,cupped,cyathiform,deciduous,deflexed,densely,denser,divided,drying,eaf,eed,ellipsoid,em,erect,exserted,extending,fleshy,free,fruiting,geminat,glabrou,gland,half,halfway,ilament,irregularly,lamina,lengthening,less,loosely,lower,membranous,midrib,minute,nearly,new,nflorescence,node,occasionally,older,orolla,papillate-puberulent,papillo,perfect,pinnatifid,planar,plurifoliate,pore,poricidal,portion,puberulen,ruit,scar,sinus,slightly,slit,sometimes,soon,spaced,splitting,spreadin,spreading,stellate,stigma,strongly,surfac,tube,twinin,ud,unit,vary,yellow,ympodial,young	'',[,``,adaxial,arrangement,branching,characteristic,colour,form,fruit,height,leaf,length,midvein,na,ovary,plant,pseudostipule,puberulent,rachi,seed,shape,staman,tertiary,texture,unarmed,value,venation,{,}
21	wfo-0001025872	success	160	104	86	74	18	0.537	.5,0.25-0.5,0.5,0.5-1,0.6-1,1,1-1.5,1-2,1.2-1.6,2-5,4-4.5,6-8,anther,auriculate,bark,base,becoming,berry,branched,bright,brownish,calyx,capitate,cm,coriaceous,corolla,crinkled,dark,deeply,deflexed,densely,dia,dry,elliptic,filament,flattened-reniform,fleshy,flower,glabrous,globose,green,greenish-tan,later,lateral,leaf,live,lobe,margin,material,mm,narrowly,occasionally,often,opposite,ovary,paler,pedicel,petiole,pitted,plant,pore,poricidal,pubescent,red-papillose,revolute,rounded-triangular,several,shaped,shrub,simple,stem,stigma,straight,style,surface,tapering,tear-drop,terminal,thick,thickened,time,tip,tube,uniseriate,white,x	.1,1-1.3,1.2-1.5,1.7-3,10-25-flowered,2-2.5,2/3,3.5-4,4.5-13,6-10,acute,along,anthesi,apart,apex,apically,ba,beginning,beneath,blade,broadly,crowded,cup-shaped,decurrent,dense,eaf,edicel,eed,exserted,flattened,free,fruiting,glandular-resinous,grayish-brow,incrassate,inflorescenc,irregularly,junction,lobed,lon,long,lower,main,midrib,minutely,nflorescence,older,onto,pair,papillae,papillo,papillose,planar,plurifoliat,portion,prominent,rounded,ruit,scar,somewhat,soon,spaced,specimen,tall,trichome,tub,ud,unit,vein,visible,way,woody,ympodial,young	10-25,abaxial,characteristic,colour,diameter,form,fruit,grayish-brown,growth,hair,height,inflorescence,length,number,seed,shape,texture,type
22	wfo-0001025893	success	157	94	75	82	19	0.478	.4,0.5-1.5,0.8-1,1-1.2,1-1.5,1-2.5,1-4,1.5-2,2-2.5,2-3,5-6,along,anther,attenuate,bark,base,beneath,berry,bi-lobed,branched,brownish-green,calyx,capitate,cm,corolla,decurrent,deflexed,deltoid,dia,elliptic,fruit,glabrate,glabrous,globose,golden-puberulent,green,greyish,internodal,leaf,lobe,long,long-acuminate,longitudinally,margin,minutely,mm,narrowly,nearly,obovate,occasionally,opposite,ovary,ovoid-reniform,pale,papillose,pedicel,petiole,pitted,puberulent,red-papillose,shrub,slender,sometimes,stem,stigma,straight,style,surface,tapering,tip,tube,vein,white,winged,x	.25,.5,1.5-1.7,11-20,3-5,6-10,accrescent,anthesi,apex,bank,barely,bearing,beginning,blade,broadly,closely,cup-shaped,densely,difoliate,dry,eaf,early,eed,ellipsoid,erect,even,exserted,faintly,filament,flower,free,fruiting,geminate,gravelly,growing,impressed,inflorescenc,lateral,lobed,lon,lower,main,many,material,middle,nflorescence,older,overlapping,pair,papillo,planar,plurifoliat,pore,poricidal,portion,reflexed,river,rocky,ruit,sandy,scar,shaped,slightly,spaced,specimen,stream,striat,tall,tear-drop,thickened,time,trichome,ud,unicellular,unit,usually,visible,widest,woody,yellowish,ympodial,young	abaxial,characteristic,colour,diameter,form,growth,height,history,inflorescence,length,life,peduncle,perennial,plant,seed,shape,striate,texture,type
23	wfo-0001025896	success	146	91	64	82	27	0.438	-3,0.5,0.5-2,1-1.5,1-3,1-6.5,1-8,1.5-2,1.5-9,10-25,2-2.5,2.5-5,4,4-5,4-6,5-15,6-10,abaxial,acuminate,angled,apex,articulated,base,brownish,calyx,cm,cuneate,deltate,densely,diameter,elliptic-ovate,entire,forked,fruit,glabrous,globose,lobe,margin,mm,moderately,nearly,orange,ovate,pale,pedicel,peduncle,petiole,pubescent,purple,rachi,red,rugose,shrub,simple,smooth,stem,style,subcordate,surface,triangular-subulate,unbranched,vein,white,x	-30,.5-2.5,1-25,10-15,2-14,2.5-14,4-12,4-23,5-7,6-13,7-,7743,abaxially,absen,acosta,acute,adaxiall,adaxially,aggregate,also,apart,axe,ba,blade,branched,cell,chartaceous,connivent,constricted,cylindrical,dendritically,directed,distall,eaf,eed,eglandular,especially,flower,gland,greenish,hair,inflated,like,long,lower,many-foliat,membranaceous,near,nflorescence,nther,obtuse,occasionally,often,orolla,perfect,pore,present,puberulent,pubescen,radiu,ripe,rotate-stellate,ruit,short-stalked,solÃ­,spaced,sparsely,stalked,stigma,stone,tal,tem,time,tip,triangular-ovate,truncat,tube,unit,vary,wide,yellow,ympodial	adaxial,anther,arrangement,branching,characteristic,colour,corolla,filament,form,growth,height,inflorescence,leaf,length,midvein,na,ovary,plant,primary,pseudostipule,seed,shape,staman,tertiary,texture,unarmed,venation
24	wfo-0001025902	invalid_json	211	155	134	77	21	0.635	.2,.5,/2,0.1-0.5,0.5-2.5,1-1.2,1-1.5,1.2-1.5,1.5,1/3,11-15,1983,2.5-4,3-10,4,4-13,4-5,4-6,40,5-6,8-15,>,abaxially,absent,acute,adaxially,along,anther,apex,articulated,attenuate,axi,bark,base,becoming,beginning,berry,black,branch,branched,branching,cabrera,cell,circular,clavate,cm,completely,corolla,densely,diameter,dull,ellipsoid,entire,except,fide,filament,flattened-reniform,flower,fruiting,glabrous,globose,green,growth,inflorescence,lanceolate,lateral,leaf,leaf-opposed,leaving,length,linear,lobed,lower,margin,mature,minute,minutely,mm,new,occasionally,ovary,pair,pale,papillose,pedicel,peduncle,peg,per,perfect,pericarp,petiole,pitted,primary,pubescent,ridged,rotate-stellate,rounded,scar,scattered,simple,sleeve,small,sometimes,spaced,sparsely,stem,stigma,strongly,style,surface,tangled,tapering,terminal,testal,thin,time,tip,trichome,tube,uniseriate,usually,vein,vine,violet,way,weak,whitish,widely,wing,woody,x,yellow,yellowish,Â½	0.5-2,1.5-2,1.5-3,2-6,5-merou,8-10,8-9,accompanied,ag,aid,always,alyx,anthesi,apar,ark,berr,broadly,c.,calyx,chartaceous,climbin,conical,connivent,deciduou,deltate,eaf,eed,either,exfoliatin,exserted,fleshy,free,geminat,ilament,lengthening,less,lobe,long,loosely,low,markedly,midvei,nflorescence,obscured,often,older,one,orolla,papillat,pendant,planar,plurifoliate,pore,poricidal,portion,prominent,revolute,ruit,scrambling,semi-aquati,semi-circular,shallow,slender,slit,somewhat,soon,spreading,tem,twining,ud,ultimate,unit,vary,vegetation,water,weight,ympodial	'',5-merous,[,``,apart,arrangement,bud,characteristic,colour,form,fruit,midvein,number,papillate,seed,shape,texture,type,value,{,}
25	wfo-0001025906	success	188	128	99	89	29	0.527	0.1-2,0.20-0.60,1-2,1.1-2,1.6-12.4,16-51,2-4.4,2-6,3-10,3-5,4-12,4-5,4-7,5-6,5-7,abaxially,acumen,acute,adaxially,anther,apart,apex,articulated,axillary,base,berry,blue,brownish,bud,cell,cm,condition,coriaceous,corolla,covering,cuneate,dark,decurrent,diameter,distal,drying,filament,flower,forked,fresh,fruit,generally,glabrous,globose,green,green-white,greenish,hair,hair-like,half,herb,high,lanceolate,lateral,leaf,light,lilac,linear,lobe,long,make,mm,mucilaginous,obtuse,odd-pinnate,ovoid,pedicel,peduncle,petiole,plant,pubescent,purple,rachi,ripe,seed,shiny,short,slightly,spaced,sparsely,stripe,style,sub-glabrous,subglabrous,subtending,terminal,testal,thick,throughout,usually,wall,wet,white,whitish	0-14,0.15-0.6,0.2-0.6,1-3,1-6,1.8-4.8,2.6-5.2,4-10,5-merou,5.2-9,8-16,8.5-12.5,adaxiall,ag,alyx,apparently,axe,blade,capitat,clavate,connivent,decreasing,decurrency,delimited,digestion,diminishing,dorsally,eaf,edge,eed,enzyme,erec,exceeding,falcate,first,flat,folded,geminat,glabrou,hal,homostylous,honeycomb-shaped,interjected,leaflet,lengthening,living,lower,next,nflorescence,orolla,pair,pentagonal,perfect,plurifoliate,pore,poricidal,removed,rotate,ruit,second,sessile,seudostipule,size,slit,smaller,specimen,stamen,stigma,straight,subequal,subglabrou,tall,tamen,tem,third,tip,toward,tri-,tube,typically,unit,unwinged,vary,well,width,wood,x,yellow,ympodial	2,abaxial,adaxial,arrangement,branching,calyx,characteristic,colour,form,growth,height,inflorescence,length,margin,midvein,na,ovary,primary,pseudostipule,shape,staman,stem,surface,tertiary,texture,unarmed,vein,venation,woody
26	wfo-0001025907	success	148	131	104	44	27	0.703	-4,.5,.5-1,0,0-60,1-1.2,1-2.3,1-3,1-5,1.5-2,1.5-2.2,10-15,2,2-3.5,2-8,2/3,3-4,4-5,absent,acuminate,acute,along,anther,anthesi,anticlinal,apex,appearing,attenuate,axil,axillary,base,beak,bearing,berry,breaking,brown,calyx,cm,conical,densely,diameter,elliptic,filament,flattened,flower,fruit,glabrous,green,greenish,growth,highly,iquito,irregular,isolated,lobe,lobed,long,lower,margin,minutely,mm,near,nearly,new,obovate,occasionally,open,ovary,ovoid-reniform,pair,papillate,papillose,pedicel,per,petiole,plant,population,portion,primary,projection,pubescent,raised,red-papillate,reflexed,round,rugose,scar,scattered,seed,shrub,simple,sinuous,style,surface,thickening,time,tip,trichome,truncate,uniseriate,vein,white,without,x	.05,0.8-1.8,1,12-45,3-,3/2,5-15,anthesis5-7,c,cell,clavat,conspicuously,deciduous,eaf,edicel,eed,epidermal,erec,free,fruiting,globose,included,lamina,lon,nflorescence,poricidal,remaining,ruit,single-stemmed,size,slender,soon,sparsely,stigma,tal,tem,tub,tube,ud,unifoliat,unit,variable,white-lenticellate,ympodial	0.05,5-7,abaxial,adaxial,arrangement,branching,characteristic,colour,corolla,form,height,history,inflorescence,leaf,length,life,midvein,na,peduncle,pseudostipule,rachi,shape,staman,stem,texture,unarmed,unifoliate
27	wfo-0001026203	invalid_json	197	132	95	102	37	0.482	0.06-0.86,0.3-11,0.38-11.3,0.4-3,0.7-2.6,1-13,1-2,1-9,2-10,2-4.9,2-43,3-10,3-11,7-47,acuminate,acute,anther,apex,articulated,attenuate,axillary,base,berry,blue,brownish,bud,cell,cm,condition,coriaceous,corolla,covering,dark,deep,diameter,distal,drying,elliptic,filament,flower,forked,fresh,fruit,generally,glabrescent,glabrous,globose,green,green-white,greenish,hair,hair-like,half,herb,high,lanceolate,lateral,leaf,light,lilac,lobe,long,make,medium,middle,mm,mucilaginous,odd-pinnate,ovate,ovoid,pedicel,peduncle,petiole,plant,rachi,ripe,rounded,seed,sessile,short,sometimes,stripe,style,subglabrous,subtending,terminal,testal,thick,throughout,typically,usually,wall,wet,white,whitish	0-39,0-7,0.3-6,0.5-2.3,0.5-3.2,1-4,1-5,1.1-7.9,1.2-5.5,2-5,2-8.5,2.2-13.3,3-5,3.2-22,3.2-23,5-merou,abaxially,acumen,adaxially,ag,along,alyx,apart,apparently,arranged,asymmetric,axe,basiscopic,bead,blade,capitat,clavate,connivent,decreasing,decurrent,digestion,dorsally,eaf,edge,eed,enzyme,erect,exceeding,flat,folded,geminat,glabrescen,glabrou,hal,homostylous,honeycomb-shaped,interjected,leaflet,lengthening,like,linear,living,lower,moniliform,multiple,necklace,nflorescence,orbicular,orolla,pair,pentagonal,perfect,plurifoliate,pore,poricidal,removed,rosett,rotate,ruit,seudostipule,side,size,slightly,slit,spaced,specimen,stamen,stigma,stolon,straight,subequal,tall,tamen,tem,tip,tissue,toward,tri-,tube,tuber,unit,unwinged,vary,wide,x,yellow,ympodial	'',2,[,``,abaxial,adaxial,arrangement,branching,calyx,characteristic,colour,form,growth,height,history,inflorescence,length,life,margin,midvein,na,ovary,perennial,primary,pseudostipule,shape,staman,stem,surface,tertiary,texture,unarmed,value,vein,venation,{,}
28	wfo-0001026208	success	214	126	105	109	21	0.491	0-20,0-4,0-5,0.5-1.2,0.6-0.8,0.6-0.9,0.7-2,0.8-1.5,1-2,1-5,1.8-2.3,1.8-2.5,2-20,2.5-6,3-5,3.5-5,4-7,6-22,abaxial,acuminate,acute,adaxial,anther,apex,apically,apparently,articulated,base,berry,branched,bright,brown,calyx,chartaceous,cm,cuneate,dark,deltate,densely,diameter,dull,elliptic,erect,evenly,filament,flattened-reniform,fruit,glabrous,green,green-brown,infructescence,lateral,leaf,length,lobe,lobed,long,lower,margin,maturity,mauve,membranous,midvein,mm,moderately,orange,orange-brown,ovate,pair,pale,pedicel,peduncle,per,petiole,prickle,prickly,primary,pubescent,recurved,red,rounded,shrub,side,sometimes,somewhat,sparsely,spherical,stellate,stellate-pubescent,stem,straw-yellow,style,surface,terminal,tertiary,toward,trichome,unarmed,vein,venation,visible,white,wide,yellow,young	-1/2,-10,-3,-5,.5,/3,0,0-8,0.1,0.1-0.2,0.1-0.25,0.1-0.3,0.5-0.8,0.8-1.3,1-4,1.5,1.5-2.5,1/3,1/4-1/3,1/4-1/6,11-25,2,2-3,2-4,2.5-5,3-30,3-6,3/,4-9,5,5-,5-17,5-22,5-merous,6-8,abaxially,acut,alyx,apar,apart,bark,becoming,blade,broad-deltate,conical,connivent,curved,difoliate,discolorous,distance,drying,eaf,eed,elongated,elongating,equal,extending,flattened,flower,free,fruiting,geminat,geminate,glabrescent,gray-greenish,longer,mature,midpoint,nflorescence,older,one,open,orolla,oung,pendulous,perfec,pericarp,poricidal,porrect,portion,ray,red-brow,ruit,scar,sessile,shorter,slender,smooth,spaced,spreading,stalk,stalked,stout,straight,subentire,tamen,tapering,terete,time,tip,tube,unarme,unit,usually,variously,vary,way,woody,ympodial	3/4,arrangement,branching,characteristic,colour,corolla,form,growth,height,history,inflorescence,life,na,ovary,plant,pseudostipule,rachi,seed,shape,staman,texture
29	wfo-0001026215	success	150	123	101	49	22	0.673	-3,.05,.5,0,0.5-1,1,1-3,1.5,1.5-2,1.5-2.2,2,2-3,2-3.5,2-4,4-5,7-8,abruptly,acuminate,along,anther,anticlinal,apex,axil,axillary,base,beak,berry,broadly,brown,calyx,cell,clavate,cm,completely,conical,conspicuously,continually,corolla,deltate,densely,diameter,elliptic,enlarged,entire,epidermal,erect,flattened-round,flower,fruit,fruiting,glabrous,green,greenish,herb,highly,horizontal,irregular,kink,length,lobe,long,marked,markedly,minutely,mm,narrowing,nodding,occasionally,often,onto,ovary,ovoid-reniform,papillae,papillate,pedicel,per,petiole,portion,projection,purple,raised,red-papillose,rounded,rugose,seed,shrub,simple,sinuous,stem,stigma,strongly,style,surface,thickening,white,white-lenticellate,white-pubescent,wing,winged,without,x	0.05,13-35,15-2,18-20,3/4,4-15,abaxially,absent,anthesi,ape,bifi,eaf,edicel,eed,exserted,filament,free,globose,internode,less,lobed,lower,nearly,nflorescence,noddin,pair,papillat,poricidal,primary,reflexed,ruit,scar,shortsympodial,single-stemmed,small,ste,tal,tem,time,tip,tub,tube,ud,unifoliat,unit,usually,vein,way,wide	-5,abaxial,arrangement,bifid,branching,characteristic,colour,form,growth,height,inflorescence,leaf,margin,peduncle,plant,rachi,shape,tall,texture,type,unifoliate,width
30	wfo-0001026229	success	299	110	81	218	29	0.271	1,35,5,abaxial,abaxially,acute,adaxial,anther,apex,articulated,asymmetric,attenuate-caudate,base,berry,black,branching,brown,calyx,cm,corolla,covered,cuneate,cylindrical,cyme,dark,densely,diameter,elliptic,elongated,entire,flattened,flower,fruit,glabrescent,glabrous,globose,golden,green,growth,hirsute,immature,inflorescence,irregular,lanceolate,leaf,lobe,long,margin,mature,mm,moderately,narrow-ovate,narrowly,ovate-elliptic,pale,pedicel,peduncle,per,petiole,pink,pit,pubescent,purple,purplish,rachi,reniform,revolute,rounded,shiny,shrub,simple,slightly,stem,style,surface,trichome,type,unbranched,white,wide,yellowish-white	0.1â1.47,0.2â0.8,0.35,0.3â0.9,0.3â1.2,0.4,0.8â1.2,0.8â2,0.9,0.9â4.3,1-celled,1.2â4.8,1.3â1.5,1.3â1.7,1.4,1.7â11.8,1.7â2.3,1.8,1.8â5.5,1.9â2.5,1/3,13,1â1.4,1â2,1â4,2,2.3â3.4,2.8â4,2â3,2â3-celled,2â4-celled,3,3â4,3â5,4.5â6.5,4â6,5-merou,5â9,6â15,6â7,6â8,8.6â12,8â10,9â31,accrescent,acuminate,adaxiall,adaxially,ag,almost,also,always,alyx,anthesi,ark,associated,axe,ba,barely,beneath,blade,branch,broadly,broken,camptodromous,capitate,celled,central,changing,clavate,commentary,commonly,completely,concentrated,connivent,cordate,creating,deltoid,develope,developed,differing,directed,discolorous,diÂ­,dried,drying,eaf,eed,eglandular,ellipsoidal,even,faces,few-rayed,found,free,frequently,fresh,fully,geminate,gland,glandular,glandular-capitate,hair,head,hispid,hyaline,ilament,impressed,included,insertion,internodal,introrsely,involute,lamina,larger,lateral,less,like,lobed,long-stalked,longer,longitudinal,lower,mainly,material,maturit,membranaceous,midpoint,midri,midvein,minute,mixed,much,multangulate,multangulate-stellate,multiseriate,near,nearly,new,nflorescence,oblong,often,old,older,one,open,opening,orientation,orolla,other,oung,ovate,pair,paired,papillose,pedunculate,perfect,plurifoliate,point,poorly,pore,poricidal,porrect-stellate,portion,primary,ra,raised,rarely,ray,remnant,ruit,secondary,see,sessile,shin,short-,short-stalked,shorter,size,slit,small,smaller,solitary,sometimes,somewhat,sparsely,spread,spreadin,spreading,stalk,stellate,stigma,strongly,subopposite,subsessile,supported,surfac,terminal,three,tree,trifoliate,tube,tuft,ud,unequal,unit,upper,usually,vary,vein,venation,vestiture,visible,weakly,whitish-green,yellow,ympodial,Â¾	0.1-1.47,0.3-1.2,0.35-4.3,1-2,1.3-1.7,1.7-2.3,1.8-5.5,1.9-2.5,2.3-3.4,2.8-4,6-7,6-8,8.6-12,9-31,arrangement,characteristic,colour,filament,form,height,length,ovary,plant,seed,shape,specified,staman,texture,ye
31	wfo-0001026230	success	144	85	64	80	21	0.444	.5,.8,0.3-1.5,0.5-3,0.75-1,0.9-2,1-1.4,1-1.5,1.1-1.8,1.8-2.3,1.9-4.1,2-4,2-5,3-4,5-20-flowered,anther,area,bark,berry,calyx,clavate,cm,corolla,deflexed,deltoid,dia,elliptic,fruit,fruiting,glabrous,globose,grey,large,leaf,lobe,long,long-triangular,minor,minutely,mm,orbicular,ovary,papillose,pedicel,petiole,poricidal,shrub,simple,slightly,small,stem,stigma,straight,strongly,style,surface,tapering,tip,tree,tube,unknown,white,winged,x	.25,1-4,12.6-20.8,4.6-9.3,5-10,acuminate,acute,anisomorphic,anisophyllou,anthesi,apart,apex,apiculate,appears,back,base,beginning,beneath,broadly,bud,clu,completely,cordate,coroll,difoliate,distal,eaf,edicel,eed,enclosing,erect,evenly,except,filament,free,geminate,green,immature,inflorescenc,lateral,lobed,lon,long-acuminate,lower,main,major,margin,middle,nearly,nflorescence,obtuse,older,opposite,ovoid,pair,pointed,pore,portion,raised,reflexed,rounded,ruit,rusty-papillose,scar,shaped,sinus,slender,spaced,tall,tear-drop,thickened,ud,umbonate,unit,vein,white-lenticellat,widest,woody,ympodial,young	abaxial,adaxial,anisophyllous,arrangement,characteristic,colour,diameter,form,growth,height,inflorescence,length,na,peduncle,plant,seed,shape,size,texture,type,white-lenticellate
32	wfo-0001026233	success	165	115	93	72	22	0.564	-1,-1.9,-3.8,-5.5,-50,-8.1,.25,.75,0.7-0.8,0.8-1.55,1.1,1.2-2.7,1.5,1/2,2,2.1,2.4-3.5,2.6,2/3,3.5-4.5,5-30,6,acute,annual,annular,anther,antrorse,apex,ascending,basal,base,bearing,berry,broadly,calyx,capitate,cm,coat,conspicuous,cuneate-attenuate,densely,diameter,elliptic,embryo,entire,evident,filament,glabrous,globose,hair,herb,herbaceous,leaf,less,lilac,lobe,lobed,longitudinally,margin,mm,moderately,narrowly,non-glandular,ovate,ovule,pale,papery-scarious,petiole,pinnatisect,protuberance,pubescent,reticulate,ridged,scarcely,seed,simple,slender,sparsely,stigma,striate,style,subglobose,surface,trans-ovoidal,trichome,tube,tuberculate,unifoliate,uniseriate,wider,winged,x,yellow	0.3,0.5,0.7-,0.8-1.3,0.8-4,1,1-,2-,2.3-7,3.2-3.7,3.2-4.7,4-,5-6.2,abundant,accrescent,ag,articulated,campanulate,curved,cylindrical,difoliat,dimorphic,eaf,eed,ellipsoidal,few-,fruiting,hig,interlobular,investing,lamina,larger,long,longitudinal,lower,membrane,minutely,multicellular,near,obtuse,occasionally,opening,orolla,other,outer,partially,pinnatipartite,pore,poricidal,portion,present,pubescen,ree,rounded,ruit,seede,serrate,shorter,slightly,slit,small,smaller,strongly,styl,tem,tip,unequal,unit,vary,venatio,verrucose,ympodial	0.7-1.3,4-6.2,arrangement,characteristic,colour,corolla,difoliate,form,fruit,growth,height,history,length,life,ovary,plant,shape,size,stem,texture,type,venation
33	wfo-0001026241	success	220	121	85	135	36	0.386	0.5,10-20,109,2-flowered,abaxially,adaxially,anther,apex,appearing,appears,base,basiscopically,berry,black,branching,brown,calyx,cell,cm,conical,corolla,covered,densely,dia,dry,elliptic,entire,erose,et,extended,filament,fruit,galiano,glabrous,glandular-pubescent,globose,herb,inflorescence,internodal,irregularly,leaf,lobe,margin,midvein,mm,near,oblique,orangish,outline,ovary,ovate,ovoid,papillate,pedicel,peduncle,per,perennial,petiole,pinnatifid,pitted,pubescent,pulp,rachi,remain,reniform,robust,seed,shallowly,sinuate,somewhat,spatulate,stem,stout,style,subshrub,surface,ternate,testa,triangular,truncate,tuberculate,usually,vein,white,x	.2,.3,.5,0.1â0.15,0.2â,0.3â,0.3â0.4,0.3â0.6,0.3â1,0.5â0.7,0.5â0.8,0.5â1,0.7â1.1,1-,1-celled,1.2â1.5,1.2â2,1.5â1.7,1.5â2.5,1.5â3.5,1.9â2.1,1/3â1/2,1â,1â1.1,1â1.4,1â1.5,1â2,2.5â3,2â2.1,2â3,3,3-,30â50,3â3.1,4-,4.5â5,5,5-celled,5-merous,6,always,anthesi,apical,articulated,attenuate,ba,basal,beak,brittle,broader,campanulate,capitate,center,connecting,cordate,cup,curved,curving,darker,decurrent,deflexe,dehiscing,deltate,denser,depressed-globose,difoliate,discrete,drying,dwarf,eaf,eglandular,enclosed,equal,erect,flower,foliat,foliose,free,fruiting,geminate,gland,glandular,intially,larger,lateral,leaflet,like,lobed,lon,long,longitudinal,main,mixture,much,nflorescence,one,onto,open,papillat,perfect,pericarp,pore,portion,prolonged,pubescen,ruit,shiny,simple,slightly,slit,small,smaller,sometimes,stamen,stellate,stigma,strongly,succulent,sulcate,taproot,terminal,thick,thickened,tip,tissue,trichome,tube,ud,uniseriate,unit,way,wide,wing,woody,ympodial	0.5-0.7,1-1.1,1-1.4,1-1.5,1-2,1.5-1.7,1.9-2.1,2-2.1,2-3,2.5-3,3-3.1,30-50,4.5-5,abaxial,adaxial,arrangement,characteristic,colour,decurrenct,diameter,form,growth,height,history,length,life,na,plant,primary,pseudostipule,shape,staman,tertiary,texture,unarmed,venation
34	wfo-0001026242	success	210	122	100	110	22	0.476	-2,-6,0,0-2,0.4-0.5,0.4-2,0.5-1,0.55-0.9,0.7-1.3,1-1.5,1-2.5,1-3,1.5-3,1.5-4,1/2,2-2.5,2.5-2.8,2.5-4.5,5-18,5-7,abaxial,acute,anther,apex,apically,apparently,articulated,base,berry,branched,bright,calyx,cm,concolorous,cuneate,deltate,diameter,drying,dull,erect,evenly,eye,filament,flattened-reniform,fruit,glabrescent,glabrous,glandular,green,hair,infructescence,lateral,leaf,length,lobe,lobed,long,margin,maturity,membranous,midvein,minute,mm,moderately,naked,obtuse,orange-brown,pair,pale,pale-brown,pedicel,peduncle,per,petiole,prickle,prickly,primary,recurved,red,red-brown,shrub,side,sometimes,spherical,stellate-pubescent,stem,style,subentire,surface,tertiary,unarmed,upper,vein,venation,visible,weakly,white,wide,yellow,young	-0.9,-1.5,-5,/4,0.05-0.2,0.1,0.3-0.5,0.35-,0.4-0.55,0.5,0.5-0.7,0.7,1.2-2,1/5-1/3,1/6-1/4,10-,10-20,2-5,3-6.5,30-80,4-10,4-13,4-5-merous,4.5-5.5,5-,6.5-8,7-17,8-20,abaxially,acut,almost,alyx,ame,apar,apart,bark,blade,broad-deltate,c.,connivent,curved,densely,difoliate,distance,eaf,eed,elliptic,elongating,equal,extending,filiform,flattened,flower,free,fruiting,geminat,glabrou,green-gra,irregularly,largely,longer,lower,mature,midpoint,multangulate,narrow-deltate,nflorescence,occasionally,older,one,open,orolla,oung,perfec,pericarp,poricidal,porrect,portion,prickl,ray,reflexed,rounded,ruit,scar,sessile,shorte,shorter,simple,smooth,spaced,sparsely,spreading,stalk,stalked,stellate,straight,tamen,tapering,terete,time,tip,trichome,tube,unarme,unit,variously,vary,way,woody,ympodial	0.35-0.55-0.9,adaxial,arrangement,branching,characteristic,colour,corolla,form,growth,height,history,inflorescence,life,na,ovary,plant,pseudostipule,rachi,seed,shape,staman,texture
35	wfo-0001026259	success	233	100	80	153	20	0.343	.1,.7,1.5,2/3,6,acuminate,acute,anther,anthesi,apex,base,becoming,berry,broadly,brown,calyx,central,cm,concave-reniform,corolla,cylindrical,decurrent,deltate,densely,diameter,end,entire,filament,fruit,glabrous,green,green-orange,herb,inflorescence,internodal,lateral,leaf,length,lilac,lobe,long,margin,mm,narrower,nearly,often,once-branched,one,ovary,ovate-lanceolate,pedicel,peduncle,per,petiole,plant,pubescent,purple,purple-coloured,rachi,rarely,recurving,ripe,rounded,shrub,simple,sparsely,spreading,star,stem,straight,style,surface,tinged,translucent,turning,white,wide,woody,yellow,yellow-green	.8,0.1â0.2,0.2â0.4,0.3â1.2,0.4â0.6,0.5,0.5â0.6,0.7â0.9,0404,0â2,1,1-celled,1.0â1.2,1.0â3.3,1.2â8.4,1.4â4.0,1.5â2.0,11â22,12â24,1m,1â2,1â2-celled,1â3-celled,2-ridged,2â17,2â3-celled,3.0â3.4,35â45,4â5,5-merous,5â14,5â7-celled,7â10,8â11,?,abaxial,abaxially,adaxial,adaxially,affected,age,apar,appressed,arising,beyond,branch,branched,branching,cell,close,coloured,cone,congested,conical-ellipsoid,cream-coloured,dehiscing,difoliate,drop,eaf,eed,ellipsoid,elongating,especially,et,exerted,fleshy,flower,free,fruiting,geminat,globose,gradually,growt,halfway,hilum,individual,knapp,larger,leave,lengthening,less,like,live,lobed,lon,longer,lower,lowermost,membranous,minutely,much,narrowly,near,nflorescence,node,occasionally,outline,pair,pale,papillate,pathogen,pentagonal,perfect,pericarp,pore,poricidal,portion,positioned,primary,purple-black,reduced,reflexed,relatively,remaining,ruit,scar,shiny,short,shorter,similar,slightly,slit,smooth,sometimes,somewhat,spaced,splitting,stellate,stigma,stone,stout,strongly,sub-laterally,tall,tapering,tem,testal,thick,tightly,tip,together,toward,trichome,tube,two,ud,uniseriate,unit,vein,winged,ympodial,young,â15	0.2-0.4,0.3-1.2,0.7-0.9,1.0-1.2,1.0-3.3,1.5-2.0,12-24,2.8-3.4,35-45,characteristic,colour,form,growth,height,seed,shape,specified,staman,texture,type
36	wfo-0001026267	success	162	111	80	82	31	0.494	0.5-1,0.6-1.7,0.7-1.1,1-1.2,1-2.6,1.5-2,2.5-3,20-30-flowered,3-15,5-7,8-10,acuminate,acute,anther,apex,attenuate,base,berry,blackish,body,bright,broadly,calyx,cm,corolla,cuneate,densely,dia,distally,drying,except,filament,flattened-reniform,glabrous,globose,green,greyish-green,incrassate,larger,lavender,leaf,lobe,long,margin,minutely,mm,narrowly,occasionally,often,ovary,ovate,pair,pale,pedicel,petiole,pitted,pitting,pubescent,ripening,scattered,shrub,simple,slightly,small,sparsely,stem,straight,style,surface,tan,tinge,tree,triangular,trichome,tuft,uniseriate,vein,white,x,yellow-green	.25,.5,0.1-1,1-1.5,1-4,1.5-2.3,3-6.1,3.2-8.6,4-8,8.5-15,anthesi,axil,ba,bark,beginning,beneath,closely,crateriform,decurrent,deflexed,depressed,differing,difoliate,distinct,eaf,edicel,eed,exerted,free,fruiting,geminat,greenish-white,hard,inflorescenc,lateral,lobed,lon,longinflorescence,lower,main,major,maturity,middle,minor,nearly,older,one,opposite,overlapping,papillo,papillose,pore,poricidal,portion,quickly,raised,reflexed,remaining,rough,ruit,scar,scarious,shaped,size,slender,softening,soon,spaced,stigma,tall,tapering,tear-drop,tip,tube,ud,unit,widest,wing,winged,woody,ympodial,young	0.25,1,abaxial,adaxial,arrangement,branching,characteristic,colour,diameter,form,fruit,growth,height,history,inflorescence,length,life,midvein,na,peduncle,plant,primary,pseudostipule,rachi,seed,shape,staman,tertiary,texture,unarmed,venation
37	wfo-0001026279	success	248	96	80	168	16	0.323	-11.4,-2.9,-34.3,-5.9,0.2-0.4,0.9-1.8,1-1.4,1-10,1-3.5,1.1-1.6,1.1-1.9,1.5-1.8,11.5-19.7,3-4,3.1-4.2,3.4-5.2,8,8.5-10.5,adaxially,anther,apex,attenuate,base,berry,black,branched,brown,bud,cm,conical,corolla,cuneate,dark,diameter,drying,elliptic,entire,fleshy,flower,fruit,glabrescent,granular,grayish,grayish-green,green,lanceolate,lavender,leaf,length,lilac,many,margin,mm,narrowly,obovate,orbicular,pale,pedicel,peduncle,petiole,plant,rachi,reticulate-punctate,scabridulous,scabrous,short,shrub,simple,stem,style,surface,time,tomentose-pubescent,tree,unarmed,white,whitish,x,yellowish,yellowish-tan	-4,/14-1/8,0.25-0.4,0.8-2.3,0.9-1,1.5-3,1.7-2.3,1.9-3,1.9-3.2,1/2,14-27,2.4-3.2,2.5-3.2,2.6-4.8,2/3,3.1-3.6,3.5-7.8,3.8-5.1,4-7.5,5-200,5-8,8-11,9-22,abaxially,accrescent,acuminate,acute,adaxiall,ag,anthesi,apart,apparently,appearing,appressed,ark,around,articulated,axe,axillary,ba,blade,blunt-tipped,branch,calyx,capitate,chartaceous,closely,completely,covering,cylindrical,deltoid,dendritic-echinoi,dendritic-echinoid,dense,directed,distally,due,eaf,earl,echinoi,echinoid,edge,eed,elongated,enveloping,equal,evident,exerted,expanded,farinose,few-rayed,filament,free,fruiting,glabrescen,glabrous,globose,hair,half,immature,inserted,lateral,lengthening,lobe,lobed,long,long-stalked,longer,longitudinal,longitudinall,lower,m.,main,mature,midrib,minute,mixed,multangulate,multangulate-pubescent,multiseriate,nflorescence,oblong,occasional,occasionally,often,older,open,orolla,ovate-lanceolate,overlapping,partly,perfect,plurifoliate,pore,poricidal,porrect-stellate,present,prominent,pseudo-terminal,pubescence,rounded,ruit,scattered,secondary,semi-ovate,sessile,short-,short-decurrent,short-stalked,side,slightly,slit,slowly,somewhat,spaced,splitting,stalk,stamen,stellate,stigma,subcampanulate,subcoriaceous,suborbicular,subsessile,sulcate,suture,tall,tamen,tertiary,thickened,thin,thin-stalked,tip,tomentose,tube,ud,unarme,unit,unwinged,upper,usually,vary,vein,way,wide,yellow,ympodial,young	abaxial,arrangement,bark,characteristic,colour,form,growth,height,inflorescence,ovary,pseudoterminal,seed,shape,texture,type,ye
38	wfo-0001026299	success	239	127	104	135	23	0.435	-0.8,-3.5,0.25-0.5,0.4-0.5,0.5-0.6,0.5-0.7,0.5-1,0.5-2.5,0.8-1,1,1.1-1.7,1.8-2,2-locular,2.2-3.2,5-20,7-12,acute,almost,anther,apex,articulated,basal,base,basiscopically,beneath,bracteate,broadly,brown,calyx,cell,cm,corolla,crenate-serrate,dark,decurrent,densely,diameter,distal,ebracteate,elliptic,entire,erect,filament,flower,fruit,glabrous,glandular,globose,green,hair-like,half,imparipinnate,inflorescence,interrupted,irregularly,jequetepeque,lanceolate,lateral,leaf,lobe,lobed,margin,middle,minute,minutely,mm,nearly,node,oblique,obovate,often,outgrowth,ovary,pale,pedicel,peduncle,perennial,petiole,primary,prostrate,pseudostipule,pubescent,rachi,regularly,short,silky,simple,sparsely,spreading,stem,stripe,style,surface,tall,tertiary,testa,trichome,truncate,variously,vein,velvety,wall,white,yellow	--,-1,-10,-2.5,-5,.5,0-8,0.1-0.2,0.1-0.25,0.1-0.4,0.1-0.5,0.15-0.2,0.2-0.25,0.2-1,0.3-0.4,0.4-2,0.5,0.6-2,0.7-3.5,0.8-0.9,0.9-1,1-1.4,1-celled,1.2-1.6,1.2-5,1.5-,1.5-2.3,2-4,2-6,2-foliate,2.5,2.5-7,25,3-,3.5-10,5,5-15,6-20,abaxially,absent,abundant,acroscopically,adaxially,along,angled,anthesi,apical,appearance,appendage,approximately,axi,berr,bract,capitate,change,chota,column,conical,could,crenat,developed,diamete,eaf,edicel,eed,eglandular,exserted,fruiting,give,gree,hal,head,herb,interjected,intermixed,internode,investing,lacking,larger,leaflet,less,like,lon,long,long-acuminate,longer,loosely,lower,maraÃ±Ã³n,maturity,mixture,multicellular,narrowly,nflorescence,occasionally,pair,patent,pentagonal,petiolule,population,present,pubescence,purple,reflexed,rest,ruit,scarcely,scattered,secondary,sessile,size,sparse,staminal,sterile,stigma,stout,straight,tem,terminal,thick,tip,toward,tube,ud,unicellular,uniseriate,unit,usually,valley,way,weak-walled,wide,winged,woody,ympodial	1.5-10,abaxial,adaxial,arrangement,branching,characteristic,colour,form,growth,height,history,length,life,midvein,na,plant,reproduction,seed,shape,staman,texture,unarmed,venation
39	wfo-0001026305	success	135	80	51	84	29	0.378	0.2-1,0.5-2,0.6-1,0.7-1,1-1.5,2-2.5,2.5-3,4-4.5,5-7,6-9,7-9,abaxial,acute,anther,apex,attenuate,base,calyx,cm,corolla,deflexed,deltate,elliptic,filament,glabrous,globose,green,greenish-white,leaf,lobe,margin,minutely,mm,ovary,ovoid-reniform,pair,pale,pedicel,petiole,pitted,pubescent,rounded,shrub,simple,stem,style,surface,tan,unifoliate,vein,x	.25,/4,0.25-0.5,1.3-1.5,2-6-flowered,3-8.5,7-16,abaxially,adaxially,along,anthesi,apical,area,ba,bark,beige-tan,berry,closely,congested,conical,dark,dendritic,densely,dia,difoliate,drying,eaf,edicel,eed,exserted,free,fruiting,geminat,glabrate,interlocking,knob-like,lamina,lateral,leaf-opposed,like,lobed,lon,long,lower,main,middle,midrib,minute,nflorescence,occasionally,older,overlappin,papillose,planar,pore,poricidal,portion,projection,reddish-brow,ruit,scar,scattered,shaped,shining,slender,spaced,sparsely,stigma,strongly,styl,tall,tear-drop,tip,trichome,tub,tube,ud,unit,visible,way,widest,woody,ympodial,young	0.25,adaxial,arrangement,branching,characteristic,colour,diameter,form,fruit,growth,height,history,inflorescence,length,life,midvein,na,peduncle,plant,primary,pseudostipule,rachi,seed,shape,staman,tertiary,texture,unarmed,venation
40	wfo-0001026307	success	193	148	128	65	20	0.663	.3,.5,.6,.8,0.2â1.5,0.4,0.5â0.6,0.5â0.7,0.5â5.0,0.6,0.8â0.9,0.8â2,1.0â1.2,1.0â2.0,1.0â2.4,1.0â2.5,2.0,2/3,3.0â4.0,3.5â7.0,35â45,3â8,3â8-celled,4â5.7,5â7,8â12,9,abaxial,acute,acute-acuminate,adaxial,anther,apex,appressed,articulated,base,berry,black,broadly,calyx,cell,central,clavate,cm,corolla,cuneate,cylindrical,decurrent,densely,diameter,ellipsoid,end,entire,eye,filament,flattened-reniform,flower,free,fruit,fruiting,glabrous,glandular,globose,green,growth,herb,hilum,internodal,lateral,length,lobe,lobed,margin,membranous,minutely,mm,narrower,narrowing,one,outline,ovary,ovate,pair,paler,pedicel,peduncle,pentagonal,per,petiole,portion,positioned,primary,pubescent,purple,purple-yellow,reflexed,ripe,scar,shallowly,shape,shrub,simple,slightly,sparsely,spreading,stellate,stem,stigma,stone,straight,style,sub-laterally,surface,testal,tinged,tip,toward,trichome,tube,turning,undulate,unequal,uniseriate,variable,vein,white,yellow,yellow-green	.0â1.2,.5â4.0,0.2â0.5,0.8â5,1.0â1.5,1â3-celled,1â6-celled,2.0â3.0,2.0â3.5,2.6â13,5-merous,abaxially,adaxially,age,angled,anthesi,apar,becoming,beyond,cone,difoliate,eaf,eed,exerted,facing,geminat,gradually,later,lengthening,like,long,longer,lower,middle,new,nflorescence,papillat,perfect,pore,poricidal,recurved,reflexe,restricted,ruit,shallow,shorter,side,slit,spaced,ste,strongly,tal,tem,three,translucent,triangular,two,ud,unevenly,unit,upper,vigorous,weak-stemmed,wide,ympodial	apart,arrangement,bud,characteristic,colour,form,height,inflorescence,leaf,lobing,na,number,papillate,plant,position,seed,spacing,texture,width,ye
41	wfo-0001026317	success	169	91	71	98	20	0.42	0.3-1.2,0.5,0.5-0.6,0.8-1,1-1.2,1-1.5,2-2.5,2-4,3-3.5,4-5,6-8,abaxially,acuminate,acute,anther,apex,attenuate,base,berry,branched,bright,brown,calyx,clonal,cm,conical,corolla,dark,dendritic,densely,diameter,elliptic,entire,filament,flattened,glabrous,globose,growth,inflorescence,internodal,lobe,many,margin,minutely,mm,narrowly,orange,ovary,pale,pedicel,peduncle,per,petiole,pitted,plant,pubescent,rachi,red,reniform,shrub,simple,sparsely,stem,style,surface,terminal,time,triangular,white,x,yellowish	.5,/4,0.25-1,0.5-0.8,0.5-1,0.6-,0.7-0.9,1-5.7,10-12,2-,2.5-10,3,3-foliate,3.5-15,50-200,6x,?,absent,adaxially,age,anthesi,apart,apically,approximately,bark,capitate,closely,correlated,deltate,dense,distally,drying,eaf,eed,em,erec,erect,essentially,exerted,extremely,flower,found,free,fruiting,geminat,halfwa,lamina,lengthening,less,like,lobed,longer,lower,maturity,new,nflorescence,nodding,occasionally,often,packed,pair,papillat,papillate,perfect,pericarp,planar,plane,population,pore,poricidal,portion,primary,pubescen,pubescence,pulp,reflexed,ruit,scar,shiny,slightly,slit,sticky,stigma,straight,swollen,thin,tip,toward,trichome,tube,ud,uniseriate,unit,variable,vein,way,woody,ympodial	2,abaxial,adaxial,arrangement,branching,characteristic,colour,form,fruit,height,history,leaf,length,life,na,seed,shape,staman,texture,unarmed
42	wfo-0001026335	success	157	101	75	82	26	0.478	.5,0.25-0.5,0.5-1,0.6-1,1,1-1.5,1-2,1-4,1.5-2,10-20,2,2-3,2-4,4-5,5-15,acuminate,acute,anther,apart,apex,articulated,base,branched,calyx,chartaceous,cm,cuneate,deltate,dense,densely,diameter,elliptic,elliptic-ovate,entire,erect,filament,flattened,flower,forked,fruit,glabrescent,glabrous,globose,green,hair,held,leaf,lobe,margin,mm,pedicel,peduncle,petiole,probably,pubescence,pubescent,rachi,reticulate,ripe,rounded,shrub,simple,spaced,stellate,stellate-pubescent,stem,style,surface,tip,unripe,vein,white,whitish,x,yellowish	.5-3.5,0.1-0.3,0.8-1.3,1-3,1.5-4,10-30,2-7.5,3-18,3-5,5-,5-7,7-8,abaxially,accrescent,adaxiall,adaxially,ag,apparently,axe,ba,blade,capitat,connivent,covering,curved,cylindrical,directed,distally,eaf,eed,equal,especially,frui,fruiting,geminate,glandula,glandular,lanceolate,large,leaf-opposed,like,long,longitudinal,lower,many-foliate,midpoint,moderately,much,multangulate,nflorescence,oblong,often,opening,orolla,paired,perfect,pore,ray,ruit,scattered,sessile,slightly,slit,smaller,sometimes,ste,stigma,straight,subtending,tal,tamen,tem,time,toward,tube,unit,uprigh,usually,vary,wide,yellow,ympodial	abaxial,adaxial,arrangement,branching,characteristic,colour,corolla,form,growth,height,inflorescence,length,midvein,na,ovary,plant,primary,pseudostipule,seed,shape,staman,tertiary,texture,unarmed,upright,venation
43	wfo-0001026343	success	221	115	96	125	19	0.434	-4,0-2,0-4,0-40,0-5,0.05-0.5,0.45-1,0.5-1.5,1-2,1.3-1.7,1.8-2.2,1.8-3,1/3,2-3,2-3.2,2-6,2.2-3.2,3-4,3-5,5.5-9,abaxial,acute,adaxial,anther,apex,apparently,articulated,base,berry,branched,broadly,calyx,chartaceous,cm,cream,cuneate,dark,deltate,densely,diameter,dull,erect,faint,filament,flattened-reniform,fruit,glabrescent,green,green-brown,infructescence,lateral,leaf,length,lobe,lobed,long,lower,margin,marking,maturity,mauve,midvein,mm,orange,orange-brown,ovate,pair,pale,pedicel,peduncle,per,petiole,plant,prickle,primary,purple,rounded,shrub,small,sparsely,spherical,stellate-pubescent,stem,style,surface,tertiary,tree,unarmed,upper,vein,venation,visible,weakly,wide,yellow,young	-1,-1.5,-15,-3.5,-7,.5,/2,/5,0,0-10,0.05-0.2,0.1-0.2,0.15,0.2,0.2-0.3,0.2-0.7,0.3,0.5,0.8-1.5,1-3,1-4,1.5-2,1.5-2.5,1/,1/4-2/3,1/5,10-30,2-4,2-5,2-8,2.5-8,3.5-4.5,5-10,5-merous,6-9,7-12,7-14,7-8,7-9,abaxially,acuminat,alyx,andromonoecious,apar,apart,apically,bark,blade,brow,concolorous,connivent,curved,distal,distance,drying,eed,elliptic,elongating,equal,extending,flattened,flower,free,fruiting,glabrous,hermaphrodite,heterostylous,less,lobing,lon,long-styled,longer,lowermost,mature,midpoint,moderately,multangulate,narrow-deltate,nflorescence,obtuse,older,one,open,orolla,oung,pendulous,pericarp,plurifoliat,poricidal,porrect,portion,prickl,prickly,ray,reddish,reduced,reflexed,ruit,scar,secondary,sessile,short-styled,side,smooth,sometimes,spaced,spreading,stalk,stalked,staminat,stellate,stout,tamen,tapering,terete,time,tip,trichome,tube,unit,variously,vary,way,woody,ympodial	5.5,arrangement,branching,characteristic,colour,corolla,false,form,growth,height,inflorescence,na,ovary,pseudostipule,rachi,seed,shape,staman,texture
44	wfo-0001026352	invalid_json	209	111	84	125	27	0.402	.3,.5,0.5,0.5-0.8,0.5-1,0.5-3,0.7-2,1-2-celled,1.2-1.7,1.5,10+,3-15,4-4.5,5-6,7-9,?,acuminate,acute,anther,apex,base,berry,blue,branching,broadly,calyx,chartaceous,cm,cordate,corolla,deltate,densely,diameter,ellipsoid,entire,filament,flattened,glabrous,globose,green,growth,immature,impressed,inflorescence,leafy,length,lobe,long,many,margin,membranous,mm,narrowly,outline,ovate,pair,pedicel,peduncle,per,petiole,pink,primary,pubescent,rachi,reniform,shallowly,shoot,short,simple,stem,style,surface,terminal,time,trichome,truncate,unspecified,vein,vine,violet,weak,white,woody,yellowish	0.5-1.5,0.6-,0.9-1,1-,1-1.5,1-10,1.5-2,1.5-4.6,12-60,2,2-3-celled,3.5-9,5-merou,6-7,<,abaxially,adaxiall,ag,almost,alyx,angle,anthesi,antrorsely,apart,apparently,appearance,arising,articulated,articulation,axi,bark,basal,bending,branch,brown,capitate-truncate,cell,conical,curved,deciduous,denser,discolorous,eaf,eed,evenly,eventually,expanded,exserted,few-celled,flower,free,fruiting,giving,greenish,half,heigh,herbarium,ilament,inflorescenc,irregularly,junction,lamina,large,largest,leave,leaving,lengthening,like,lobed,lower,mature,minutely,near,nearly,new,nflorescence,older,orolla,pale,papillate,papillo,peg,perfect,pericarp,plurifoliat,point,pore,poricidal,portion,principal,reflexed,rest,revolute,right,ruit,scar,seen,shiny,sleeve,slit,small,spaced,sparser,specimen,spreadin,spreading,stellate,stigma,straw-colored,strongly,tem,thin,third,tip,tub,tube,tuberculate,ud,uniseriate,unit,upper,vary,wide,widest,ympodial	'','pale,[,],``,abaxial,adaxial,arrangement,characteristic,colour,form,fruit,height,leaf,midvein,na,ovary,plant,pseudostipule,seed,shape,staman,texture,unarmed,value,{,}
45	wfo-0001026352	success	214	104	87	127	17	0.407	.3,.5,0.5,0.5-0.8,0.5-1,0.5-3,0.7-2,1-2-celled,1.2-1.7,1.5,10+,3-15,4-4.5,5-6,7-9,?,acuminate,acute,anther,apex,base,berry,blue,branching,broadly,calyx,chartaceous,cm,cordate,corolla,deltate,densely,diameter,ellipsoid,entire,filament,flattened-reniform,form,glabrous,globose,green,growth,immature,impressed,inflorescence,leaf,leafy,length,lobe,long,many,margin,membranous,mm,narrowly,outline,ovate,pair,pale,pedicel,peduncle,per,petiole,pink,primary,pubescent,rachi,shallowly,shiny,shoot,short,simple,stem,style,surface,terminal,time,trichome,truncate,unspecified,vein,vine,weak,white,woody,x,yellowish	0.5-1.5,0.6-,0.9-1,1-,1-1.5,1-10,1.5-2,1.5-4.6,12-60,2,2-3-celled,3.5-9,5-merou,6-7,<,abaxially,adaxially,ag,almost,alyx,angle,anthesi,antrorsely,apart,apparently,appearance,arising,ark,articulated,articulation,axi,basal,bending,branch,brown,capitate-truncate,cell,conical,connivent,curved,deciduous,denser,discolorous,eaf,eed,evenly,eventually,expanded,exserted,few-celled,flower,free,fruiting,geminat,giving,greenish,half,heigh,herbarium,ilament,inflorescenc,irregularly,junction,lamina,large,largest,leaving,lengthening,like,lobed,lower,mature,minutely,near,nearly,new,nflorescence,older,orolla,papillate,papillo,peg,perfect,pericarp,plurifoliate,point,pore,poricidal,portion,principal,reflexed,rest,revolute,right,ruit,scar,seen,sleeve,slit,small,spaced,sparser,speciman,specimen,spreadin,spreading,stellate,stigma,straw-colored,strongly,tem,thin,third,tip,tub,tube,tuberculate,twining,ud,uniseriate,unit,upper,vary,violet,widest,yellow,ympodial	abaxial,adaxial,arrangement,characteristic,colour,fruit,height,midvein,na,ovary,plant,pseudostipule,seed,shape,staman,texture,unarmed
46	wfo-0001026379	invalid_json	219	131	109	110	22	0.498	-4.5,0.2-0.4,0.7-1,0.7-2.5,0.8-1.2,0.9-1.2,1-1.7,1-10,1-2,1.3-2.1,1.5-2.3,1.8-2.6,1.9-3.4,1/2,13,2-7,2.6-3.7,2/3,4.1-7,5.3-10.2,50-450,8-13,8-15,8.3-10,abaxially,acute,adaxially,along,anther,apart,apex,articulated,attenuate,bark,basal,base,branch,branched,brown,calyx,closely,cm,conical,corolla,dark,dendritic-echinoid,densely,diameter,dried,echinoid,echinoid-pubescent,ellipsoid,entire,filament,finely,flower,fruit,globose,granular,gray-brown,grayish,growth,hair,leaf,length,lobe,long-attenuate,many,margin,minutely,mm,multangulate,multangulate-pubescent,nearly,obovate,ovate,pale,pedicel,peduncle,persistently,petiole,pitted,plant,porrect-stellate,rachi,reniform,rich,scabrous,semi-ovate,shrub,simple,small,spaced,stellate-,stellate-tomentose,stelliform,stem,stigma,style,terete,time,tomentose-pubescent,tree,upper,velutinous-pubescent,violet,whitish,x,young	0.2-0.38,1-3.7,1.7-4.9,1.8-3.2,1.8-5,2-2.8,2.4-5.1,2.9-4,3-11,3/4,4-5,6-10.6,8-29,9-14,accrescent,adaxiall,ag,anthesi,apparently,around,axillary,ba,berry,blade,blunt-tipped,capitat,chartaceous,completely,covering,cylindrical,directed,distal,distally,eaf,echinoi,edge,eed,enveloping,evident,farinose,few-rayed,fleshy,free,fruiting,glabrous,hig,included,inserted,lacking,large,lateral,lengthening,line,lobed,long,lower,m.,main,mature,midrib,minute,mostly,multangulat,nflorescence,oblong,obtuse,often,older,orolla,ovate-lanceolate,partly,perfect,plurifoliate,pore,poricidal,present,pubescen,rather,recent,ruit,runk,scattered,sessile,short-stalked,side,size,slit,sometimes,somewhat,sparse,stellate,stellate-pubescent,suture,tamen,testa,thin,tip,translucent,tube,ud,uneven,unit,usually,vary,vein,vestigial,way,whitish-brown,yellow,ympodial	'',[,],``,arrangement,bud,capitate,characteristic,colour,form,height,inflorescence,ovary,pubescent,seed,shape,staman,surface,texture,value,{,}
47	wfo-0001026400	invalid_json	187	128	104	83	24	0.556	0.2-0.8,0.4-1,0.5-1.2,1-10,1-2,1.7-2.2,10-18,12-27,3.4-4.8,30-55,4-7,5-7,6.5-20,8-12,9-13,abaxially,acuminate,acute,adaxially,anther,apart,articulated,asymmetric,attenuate,axillary,base,basiscopic,berry,blue,brownish,bud,cell,cm,condition,coriaceous,corolla,covering,dark,deep,diameter,distal,drying,elliptic,filament,finely,flower,forked,fresh,fruit,generally,glabrescent,glabrous,globose,green,green-white,greenish,hair,hair-like,half,herb,high,lateral,leaf,light,lilac,linear,lobe,long,make,mm,moderately,mucilaginous,odd-pinnate,ovoid,pedicel,peduncle,petiole,plant,puberulent,pubescent,purple,ripe,rounded,seed,sessile,short,side,simple,spaced,stripe,style,subtending,terminal,testal,thick,throughout,tip,tissue,typically,usually,wall,wet,white,whitish	0.5-1,0.7-1.1,1.3-2.6,10-28,13-30,2-6,2-8,2.4-5.9,3-6,3.5-5.9,5-merou,6-13,6-15,acumen,adaxiall,ag,alyx,apex,apparently,axe,blade,capitat,clavate,connivent,decreasing,decurrent,digestion,dorsally,eaf,edge,eed,enzyme,erec,exceeding,flat,folded,geminat,glabrou,gree,hal,homostylous,honeycomb-shaped,interjected,lanceolate,leaflet,lengthening,living,lower,nflorescence,orbicular,orolla,ovate,pair,pentagonal,perfect,petiolulate,plurifoliate,pore,poricidal,removed,ruit,semi-stellate,seudostipule,size,slightly,slit,specimen,stamen,stigma,straight,subequal,tall,tamen,tem,toward,tri-,tube,unit,unwinged,vary,x,yellow,ympodial	'',2,[,``,arrangement,calyx,characteristic,colour,form,growth,height,inflorescence,length,margin,ovary,pseudostipule,shape,staman,stem,surface,texture,value,{,}
48	wfo-0001026406	success	219	137	118	101	19	0.539	.2,.5,0-3,0-30,0-5,0.4-0.9,0.5-1.5,00-200,1,1-2,1.8-2.4,1/3,1/4,12-19,2-2.7,2-3,2-6,2.5-8,2.9-3.2,3-10.5,3.2-3.8,30-60,5-25,5-6,5-8,6-15,6.5-7,7-10,abaxial,abaxially,acute,adaxially,anther,apex,apparently,articulated,base,berry,branched,calyx,cm,cordate,cream,dark,deltate,densely,diameter,dirty-whitish,erect,filament,flattened-reniform,flower,foliaceous,fruit,glabrous,green,herb,infructescence,lateral,leaf,length,lobe,lobed,long,long-styled,lower,margin,marking,maturity,mauve,midvein,mm,moderately,oblong,obtuse,one,open,orange-brown,ovate,pair,pale,pedicel,peduncle,pendent,per,pericarp,petiole,plant,porrect,prickle,prickly,primary,purple,red-brown,short-styled,shrub,smooth,sometimes,spherical,stalked,stellate-pubescent,stem,style,surface,terminal,tertiary,time,trichome,unit,upper,vein,velvety,venation,visible,white,wide,yellow,young	-1,0,0.3,0.3-0.5,0.3-0.7,0.4-0.8,0.5,0.5-2.5,0.8,1.3-1.5,1.5-2,1.5-5,1/,1/4-1/2,1/4-1/3,10-30,20-60,3-4,5,5-50,5-7,5-merous,6-12,7-8,7-9,9-15,adaxial,alyx,ame,andromonoecious,apar,apart,apically,bark,blade,broad-deltate,c.,chartaceous,conical,connivent,curved,discolorous,distal,distance,drying,eaf,eed,elongated,elongating,equal,extending,flattened,free,fruiting,fully,gently,hermaphrodite,heterostylous,least,lon,longer,lowermost,mature,midpoint,nflorescence,older,opening,orolla,oung,pendulous,plurifoliat,poricidal,portion,prickl,ray,reflexed,rounded,ruit,scar,sessile,side,spaced,sparsely,spreading,stalk,staminat,stellate,stout,straight,tamen,tapering,terete,tip,tube,variously,vary,way,weakly,woody,yellow-brow,ympodial	arrangement,branching,characteristic,colour,corolla,form,growth,hair,height,inflorescence,mentioned,ovary,plurifoliate,seed,shape,staman,sympodial,texture,unarmed
49	wfo-0001026407	success	221	106	85	136	21	0.385	0.5-0.6,0.5-2,1.2-1.5,1.5-1.7,1.5-2,2-2.5,2.5-3,20-30,3.5,4-5,5,7-10,7-8,acute,anther,apex,appearing,base,becoming,berry,black,brown,calyx,chartaceous,cm,corolla,deep,deltate,dense,densely,diameter,elliptic,entire,evenly,filament,fleshy,glabrous,globose,golden,growth,inflorescence,internodal,lateral,lax,lobe,margin,markedly,membranous,midvein,minutely,mm,narrowly,oblique,occasionally,pair,papillate,pedicel,peduncle,per,petiole,pitted,primary,pubescence,pubescent,purple,purplish,reddish,revolute,shiny,short,shrub,simple,slightly,sparsely,stem,stout,style,surface,terminal,truncate,vein,vine,violet,woody,x	+,-11,-6,.5,/3,0.5,0.5-1,0.9-3,1,1-1.2,1-10,1.3,1.5-7,20-40,3.5-5.5,5-10,5-7,5-merou,abaxially,adaxially,ag,aid,along,always,alyx,anthesi,apart,area,ark,around,articulated,axi,basal,beneath,berr,blunt,branch,branched,broadly,brownish,capitate,cell,clear,climbin,congested,conical,connivent,dendritic,denser,discolorous,eaf,eed,ellipsoid,erect,exserted,flattened-reniform,flower,free,fruiting,geminat,glabrescen,glabrou,golden-pubescent,ilament,interpetalar,irregularly,lamina,leafy,leaving,lengthening,like,lobed,long,loosely,lower,many,mixture,near,new,nflorescence,numerous,obscured,often,older,open,orolla,outline,pale,paler,papillat,pedice,peg,pentagonal,perfect,pericarp,persistent,planar,plurifoliate,pore,poricidal,portion,pubescenc,ripe,ruit,scar,sinus,sleeve,slit,small,spaced,sparser,spreading,stellate,stiff,stigma,strongly,tangled,tem,testal,thin,time,tip,transition,trichome,tube,twining,ud,undulate,unit,upper,usually,vary,way,weak,yellow,ympodial	abaxial,adaxial,arrangement,branching,characteristic,colour,form,fruit,height,leaf,length,na,ovary,plant,pseudostipule,rachi,seed,shape,staman,texture,unarmed
50	wfo-0001026424	success	138	73	51	87	22	0.37	0.75-1.5,1-1.5,1.5-2,10,12-60,3-4,acuminate,acute,apex,base,blush-violet,broadly,calyx,campanulate,cell,cm,conspicuous,corolla,cuneate,cyme,distinct,elliptic,facetted,flower,glabrous,glandular,hair,lacking,larger,leaf,lobed,minute,mm,oblique,obovate,pedicel,peduncle,petiole,pinnatisect,rarely,rotate-stellate,rounded,scorpioid,shrub,simple,soft-wooded,stem,stone,unit,unwinged,usually	-25,-3.5,-4,1,1-,1-10,1-2,10-15,15,15-30,2,3-11,637/1,8-,acuman,acumen,age,angular,anthesi,aspect,axil,ba,becoming,blunt,bluntly,broad,clonal,close,common,cut,dia,downard,eaf,ellipsoid,erect,exceeding,except,exerted,facing,floral,fork,forked,general,gree,growing,interacuminal,lanceolate,lanceolate-elliptic,lasting,lavender,line,lobe,lon,long,lower,midvein,nflorescence,often,part,pedicellate,plurifoliat,point,rachi,raised,rh,second,several,shallowly,short,sinus,slightly,soon,straggly,time,tip,tissue,toward,triangular,tub,ud,violet,within,woody,x,year,ympodial,young	1-4,arrangement,branching,characteristic,colour,diameter,form,green,growth,height,history,inflorescence,length,life,margin,perennial,plant,plurifoliate,seed,shape,sympodial,texture
51	wfo-0001026440	success	181	127	98	83	29	0.541	0-15,1-5,1.1-1.4,1.1-1.5,1.5-2.1,1.9-3.7,2-2.8,2-4,2.9-4.4,3-5,3-7,3-8,7-14,9,abaxially,acute,adaxially,along,anther,apex,articulated,base,berry,bract-like,branched,broadly,brown,calyx,closely,cm,conical,corolla,dendritic-echinoid,diameter,dichotomy,echinoid,elliptic,entire,filament,first,fleshy,flower,globose,granular,green,greenish-yellow,hair,leaf,length,lobe,long-attenuate,many,margin,minutely,mm,multangulate,multangulate-pubescent,nearly,obovate,obtuse,openly,ovate,pair,pale,pedicel,peduncle,persistently,petiole,pitted,plurifoliate,porrect-stellate,reniform,ripe,scabrous,semi-ovate,sessile,short-acuminate,short-stalked,shrub,simple,small,sometimes,spaced,sparse,stellate-pubescent,stem,style,terete,testa,thick,time,tomentose,tomentose-pubescent,tree,turning,white,x,yellow	1.3-1.7,1.8-4.5,1/2,1/2-2/3,14-30,3.9-6.5,3/4,4-12,5-7,accrescent,adaxiall,ag,always,anthesi,apparently,appressed,axillary,ba,bark,basal,blade,blunt-tipped,branch,branche,capitat,chartaceous,dense,developed,directed,distal,distally,eaf,echinoi,eed,free,fruiting,high,included,inserted,large,lengthening,lobed,long,lower,m.,minute,mostly,multangulat,nflorescence,oblong,obovoid-oblong,obscure,often,older,orolla,perfect,pore,poricidal,pubescen,rather,ruit,runk,size,slit,somewhat,stellate,stigma,suture,tamen,thin,tip,tomentum,translucent,truncate,tube,ud,uneven,unit,usually,vary,way,ympodial,young	abaxial,adaxial,arrangement,branching,characteristic,colour,form,fruit,greyish,growth,height,hirsute,inflorescence,midvein,na,ovary,plant,primary,pseudostipule,pubescent,seed,shape,staman,surface,tertiary,texture,unarmed,vein,venation
52	wfo-0001026441	success	197	102	74	123	28	0.376	0.3-0.7,1-2,10,15-20,2-2.5,2-8,4-8,4.5-6.5,5,7-8,9-14,acuminate,anther,apex,articulated,attenuate,base,berry,brownish,cell,chartaceous,cm,condition,conical,corolla,covering,diameter,distal,drying,elliptic-lanceolate,filament,fresh,fruit,glabrous,green,greenish,hair,hair-like,herb,lateral,leaf,light,like,lobe,long,margin,middle,minute,mm,mottled,obtuse,odd-pinnate,ovate,ovoid,pale,pedicel,peduncle,petiole,plant,pubescent,purple,ripe,rounded,seed,slightly,sparsely,stem,style,testal,thick,usually,violet,wall,whitish	.5,0-2,0.4-3,0.5-1.5,0.8,1-1.5,1-10,1.5-2,1.5-2.5,10-14,2-5.5,3-5,4-6,4-8.5,5-10.5,5-merou,6-15,7-20,abaxially,absent,acumen,adaxially,ag,alyx,apart,apparently,axe,axillary,blade,bud,capitat,ciliate,connivent,decreasing,digestion,dorsally,eaf,edge,eed,end,enzyme,equal,erec,especially,exceeding,flat,flower,folded,forked,fourt,geminat,generally,glabrou,gradually,green-white,half,homostylous,honeycomb-shaped,interjected,internal,lanceolate,larger,leaflet,lengthening,living,lower,make,minutely,mucilaginous,narrow,nflorescence,one,orbicular,orolla,pair,perfect,petiolule,placed,plurifoliate,pore,poricidal,puberulent,removed,rotate,ruit,secondary,semierect,seudostipule,short,size,slit,spaced,specimen,stamen,star,ste,stigma,stolo,straight,subequal,subsessile,subtending,symmetrical,tall,tamen,tem,terminal,throughout,tip,toward,tri-,tube,tuber,typically,unit,vary,wet,white,wide,wing,x,yellow,ympodial	2,abaxial,adaxial,arrangement,branching,calyx,characteristic,colour,form,fourth,growth,height,inflorescence,length,midvein,na,ovary,primary,pseudostipule,rachi,shape,staman,surface,tertiary,texture,unarmed,vein,venation
53	wfo-0001026460	success	131	65	45	86	20	0.344	.5,0.5-1.5,1-1.5,1.5-2,2.5-3,4.5-5,6-7,7-9,acute-acuminate,anther,base,berry,brown,calyx,cm,completely,corolla,dark,deltate,elliptic,erect,filament,filiform,glabrous,green,greenish,inflorescence,leaf,lobe,long-exserted,membraneous,minutely,mm,ovary,ovoid-reniform,pedicel,pitted,shrub,simple,stem,style,subshrub,surface,white,x	.1,1/2,10-15,13.5-21,2-2.5,5,513,6-9,8-10,abaxially,acut,adaxially,anthesi,apex,axi,becoming,branched,capitate,closely,conical,deflexed,dia,distal,do,drying,eaf,edicel,eed,fide,floccose,flower,free,frui,fruiting,globose,inflorescenc,internodal,less,like,lobed,long,lower,major,middle,nearly,nflorescence,often,older,opposite,pair,pale,papillo,papillose,pore,poricidal,portion,puberulent,reddish,reddish-brow,reflexed,ruit,santo,scar,shaped,slightly,somewhat,soon,spaced,stigma,tall,tapering,tear-drop,tiny,tip,trichome,tub,tube,ud,unifoliat,unit,vein,widest,woody,yellow,ympodial,young	acute,arrangement,characteristic,colour,diameter,form,fruit,growth,height,length,margin,peduncle,plant,reddish-brown,seed,shape,staman,texture,type,unifoliate
54	wfo-0001026489	success	153	85	58	95	27	0.379	0.05-0.1,0.5-1,0.5-2,0.8-1.2,0.8-1.3,1-1.5,1.5-5,2-3,2-4,2-5,2-8-flowered,2.5-4,5-6,8-13,acute,anther,apex,base,beneath,berry,broadly,brown,calyx,cm,corolla,dark,deltoid,elliptic,filament,flattened-reniform,glabrous,globose,green,leaf,lobe,long,margin,middle,minutely,mm,ovary,pair,pedicel,petiole,pitted,prominent,pubescent,shiny,shrub,simple,stem,straight,style,surface,vein,white,widest,x	.3,0.25-0.5,0.5,0.5-0.75,0.6-1.4,0.8-3.7,1.3-3,2.5-13,2/3,along,anthesi,appearing,area,axil,ba,bark,branched,closely,cup-shaped,deflexed,densely,dia,differing,difoliate,dry,eaf,edicel,eed,erect,exserted,extending,flattened,fleshy,free,fruiting,geminat,gra,incrassate,lamina,later,lateral,lobed,lon,lower,main,major,minor,nflorescence,occasionally,often,older,one,opposite,overlappin,paler,papillo,papillose,parallel,perpendicular,planar,pore,poricidal,portion,red-papillose,rhachi,ruit,scar,shaped,size,slender,somewhat,soon,spaced,specimen,stigma,strongly,tall,tapering,tear-drop,terminal,thickened,tip,trichome,tub,tube,ud,uniseriate,unit,usually,way,whitish,widened,woody,ympodial,young	abaxial,adaxial,arrangement,branching,characteristic,colour,diameter,form,fruit,growth,height,inflorescence,length,midvein,na,peduncle,plant,primary,pseudostipule,rachi,seed,shape,staman,tertiary,texture,unarmed,venation
55	wfo-0001026490	success	272	119	95	177	24	0.349	1.5,7-pinnate,abaxially,acute,adaxially,along,anther,apex,axillary,branched,brown,calyx,chartaceous,cm,corolla,covered,crisped,cylindrical,darker,densely,diameter,elliptic,entire,extra-axillary,filament,flower,fruit,glabrous,green,immature,inflorescence,irregularly,lacking,leaf,length,light,lobe,long,lower,main,margin,mature,medium,middle,midvein,mm,moderately,mottled,near,nearly,obliquely,oblong,obtuse,orange,ovate,ovate-lanceolate,papillose,pedicel,peduncle,petiole,pseudostipule,pubescence,pubescent,punctate,rachi,radial,revolute,sand,seed,shape,shoot,short,simple,smooth,sometimes,sparsely,spur,stem,striation,striping,style,surface,tawny,terminal,tip,transparent,trichome,vine,violet,white,wing,woody,yellow,yellowish-tan,Â½	.5,0.1â0.2,0.1â2.5,0.2â1,0.2â1.5,0.3â3.5,0.4â0.8,0.5â1,0.5â1.5,0.5â3.5,0.5â8,0.7â3,0.8â1.5,0.8â12,1.2â8,1.5â2,1.5â3.5,1.5â5,1.8â2.2,1.9,10â20,1â1.2,1â15,1â2.5,1â3,1â8,2,2.5â3.5,2â2.5,2â4,2â6,2â8,3,3â4.2,3â4.5,3â5,3â5-pinnate,3â8,4.6,4â4.5,4â5,5-merous,5â7,6,7,7â15,=,[,],absent,accrescent,acuminate,ag,alyx,anthesi,apart,apical,apicall,apparently,around,articulated,axe,ba,base,becoming,blade,bract,bracteate,broadly,capitat,cauline,ciliate,climbing,commonly,completely,connivent,contiguously,cordate,decreasing,directed,distal,distally,eaf,eed,eglandular,ellipsoidal,equal,exceeding,expanded,flat,flattened,free,fruiting,fused,geminat,ground,incurved,interjected,large,lateral,latrorse-introrse,leaflet,lenticular,lobed,longitudinal,lowermost,lunate,markedly,match,mean,mean=,minute,multicellular,nflorescence,node,obliqu,oblique,oblon,obtusely,occasionally,one,opening,orolla,pair,part,pentagonal,per,perfec,perfect,petiolule,plurifoliate,pointed,pore,present,pubescen,pur,reflexed,reniform,resulting,rooting,rounded,ruit,seudostipule,shorter,similar,size,slender,slightly,slit,smaller,somewhat,spaced,stamen,stigma,strongly,tamen,teardrop-shaped,tem,thickened,toward,trailing,trichomessympodial,truncate,tube,typically,unbranched,undulate,unit,vary,vegetation,wide,youn,Ã,â4,â4.5,â8,â9.5	0.1-2.5,0.5-1,0.5-1.5,0.8-1.5,1.5-3.5,10-20,2-2.5,2-6,2.5-3.5,3-4.2,3-4.5,4-5,4.5,5-7,7-15,abaxial,arrangement,characteristic,colour,form,growth,ovary,staman,texture
56	wfo-0001026491	success	165	102	72	93	30	0.436	.5,1,1-2,1.5-2,1.5-2.5,1.7,2-4,2.5-3.5,3,3-pinnate,5-6,5-8,abaxially,acuminate,acute,adaxially,anther,apex,articulated,averaging,base,branched,branching,broadly,cellular-papillose,cm,cuneate,deep,deltoid,diameter,elliptic-lanceolate,entire,filament,globose,green,highly,inflorescence,lanceolate,leaf,less,light,lobe,margin,middle,minutely,mm,obtuse,often,ovate,ovate-elliptic,ovoid,pale,pedicel,peduncle,petiole,pubescent,purple,rachi,rounded,shortly,shrub,simple,slender,spotted,strigose,subacute,suborbicular-ovate,surface,tawny,tip,white,whitish	1.5-3.5,10-50,1977,2-3,2-celled,5-merou,6-8,7-8,abaxiall,absent,alyx,anderson,apparently,appressed,axe,ba,bayonet,bent,berry,blade,bract,capitat,cellular-pilose,central,connivent,conspicuously,crinkly,deciduous,densely,directed,distall,eaf,eed,equal,first,flower,geminat,glistening,greatly,growing,hair,homostylous,interjected,lateral,leaflet,long,lower,lunulat,mean,near,nflorescence,oblong-elliptic,orolla,perfect,pilose,plurifoliate,point,pore,poricidal,porrect-incurved,present,rarely,readily,reduced,rotate-pentagonal,rotate-substellate,row,ruit,scandent,seudostipule,sharp,similar,small,stigma,straight,strigo,strong,strongly,tal,tamen,tem,terminal,tightly,tube,tyle,uniseriate,unit,upright,usually,ventral,x,yellow,ympodial	abaxial,adaxial,arrangement,calyx,characteristic,colour,corolla,distally,form,fruit,growth,height,length,lunulate,midvein,na,ovary,plant,primary,pseudostipule,seed,shape,staman,stem,style,tertiary,texture,unarmed,vein,venation
57	wfo-0001026501	success	195	98	75	120	23	0.385	.5,.6,0,0-1,0.27-0.7,0.5-0.9,0.5-1,0.9-2.2,1-2,1/4,2.5-4,2.8-3,3-4,3.5-4,?,acute,anther,apex,apically,articulated,base,berry,branched,brown,brown-green,calyx,cm,cuneate,deltate,densely,diameter,dull,elliptic,entire,erect,filament,fruit,glabrous,gray,green,leaf,length,light,lobe,margin,mauve,mm,moderately,orange-brown,orbicular,ovate,pair,pale,pedicel,peduncle,per,petiole,primary,rounded,shoot,short,shrub,simple,spherical,stellate-pubescent,stem,style,surface,terminal,unarmed,upper,vein,white,yellow,yellow-green	-1.7,-3,.1,.35,.7,/3,0-2,0.05-0.3,0.1,0.2-1.8,0.5,0.5-0.6,0.6-1,0.6-1.1,0.6-2,1,1-2.5,1.8-2.2,1/2-2/3,1/6-1/2,2-10,3-5,3-9,4-5,4-7,5-merous,6-9,7-9,abaxially,acicular,almost,alyx,apar,apart,apparently,bark,becoming,blade,borne,chartaceous,color,concolorous,curved,discolorous,drying,eaf,eed,elongated,elongating,equal,eye,filiform,filiform-acuminat,flattened,flattened-reniform,flower,free,fruiting,glabrou,infructescence,known,lobed,long,longer,lower,mature,midpoint,naked,nflorescence,often,older,one,open,orolla,oung,pendulous,perfec,pericarp,plurifoliat,poricidal,porrect,portion,prickl,prickle,prickly,ray,reddish,ruit,scandent,scar,sessile,shorter,slender,small,smooth,sometimes,somewhat,spaced,sparsely,spreading,stalk,stalked,stellate,straight,subsessile,tamen,tapering,terete,time,tip,trichome,tube,unarme,unit,variously,vary,visible,way,wide,ympodial	abaxial,adaxial,arrangement,branching,characteristic,colour,corolla,filiform-acuminate,form,growth,height,inflorescence,midvein,na,ovary,plant,pseudostipule,rachi,seed,shape,staman,texture,true
58	wfo-0001026513	success	138	77	59	79	18	0.428	.25,.3,0.8-2,1-1.5,1-3,3-5,3-6-flowered,4-5,6-8,acute,anther,apex,apiculate,bark,base,berry,broadly,calyx,cm,corolla,decurrent,deflexed,deltoid,dia,elliptic,except,filament,flower,fruit,glabrous,globose,green,immature,lanceolate,leaf,lobe,long,long-styled,minute,minutely,mm,opposite,ovary,pale,pedicel,petiole,plant,short-styled,shrub,simple,slender,small,stem,straight,style,surface,tip,treelet,white	.1,.75,/3,2-2.2,2-5,7-9,8-16,anthesi,area,ba,caly,closely,completely,darkish,delicate,differentiated,dry,eaf,edicel,eed,erect,exserted,free,fruiting,gre,hirsute,known,lateral,leave,less,live,lobed,longer,lower,main,mature,middle,much,nflorescence,obscure,older,overlappin,pair,papillose,pore,poricidal,portion,prominent,raised,reflexed,rest,ruit,scar,shaped,shiny,somewhat,soon,spaced,specimen,stigma,styl,tall,tear-drop,trichome,tube,ud,undersurface,unifoliat,uniseriate,unit,vein,venation,way,wide,widest,woody,x,ympodial,young	abaxial,characteristic,colour,diameter,form,grey,growth,height,inflorescence,length,margin,na,peduncle,rachi,seed,shape,staman,texture
59	wfo-0001026529	success	219	146	118	101	28	0.539	0.3-1,0.5-4.5,1-10,1-2,1-3,1.1-2.5,1.5-2.5,10,11-14,12-22,2,3-5,3-9.5,4-8,5-15,5-17,5-9,abaxially,acumen,acuminate,adaxially,anther,apart,apex,articulated,attenuate,axillary,base,berry,blue,brownish,bud,cell,chartaceous,cm,condition,cordate,corolla,covering,creamy,dark,deep,densely,diameter,distal,dot,drying,faintly,filament,flower,forked,fresh,fruit,generally,glabrous,glandular,globose,greatly,green,green-white,greenish,hair,hair-like,half,herb,lateral,length,light,like,lilac,lobe,long,make,margin,medium,membranous,mm,moderately,mucilaginous,non-glandular,oblique,odd-pinnate,often,ovoid,pedicel,peduncle,petiole,petiolule,plant,pubescent,pure,rarely,ripe,rounded,scattered,seed,shape,short,size,slightly,spaced,stem,style,subsessile,subtending,terminal,testal,thick,throughout,trichome,typically,usually,varying,wall,wet,white,whitish,yellowish	0-25,1,1-4.5,1.5-4,10-28,120-210,2-5,2-7.5,20-60,3-12,3-6,5-merou,50-70,6-20,600-950,?,acute,ag,along,alyx,apparently,axe,blade,broadly,capitat,ciliate,clavate,connivent,digestion,dorsally,eaf,edge,eed,elliptic,enzyme,erec,especially,exceeding,except,flat,folded,geminat,glabrou,gland,gree,hal,head,homostylous,honeycomb-shaped,interjected,lanceolate,leaflet,lengthening,living,longer,lower,lunate,midrib,minutely,narrowly,nflorescence,orbicular,orolla,ovate,pair,pentagonal,perfect,petiolulate,plurifoliate,pore,poricidal,proximal,puberulent,reduced,removed,ruit,sessile,seudostipule,slit,specimen,stamen,ste,stigma,straight,subequal,substellate,tall,tamen,tem,tetralobulate,tip,tri-,tube,unit,unwinged,vary,wide,wing,x,yellow,ympodial	abaxial,adaxial,arrangement,branching,calyx,characteristic,colour,form,growth,height,history,inflorescence,leaf,life,midvein,na,ovary,perennial,primary,pseudostipule,rachi,staman,surface,tertiary,texture,unarmed,vein,venation
60	wfo-0001026534	success	150	94	74	76	20	0.493	0.5-1,1-2,1-3,1.5-9,10-15,10-20,15-50,2-2.5,2-3,2-7,2-8,2.5-15,3-10,3-25,3-5,5-6,acuminate,apart,apex,apiculate,articulated,auriculate,base,branched,calyx,chartaceous,cm,connivent,cordate,cylindrical,deltate,densely,diameter,ellipsoidal,entire,flattened,fleshy,fruit,glabrous,lanceolate,leaving,lobe,long,margin,mm,moderately,obtuse,orange,ovate,ovoid,pale,pedicel,pedicellar,peduncle,petiole,pinkish,puberulent,pubescent,purple,rachi,red,remnant,simple,spaced,sparsely,stigma,style,tip,tree,truncate,unbranched,white,x,yellow	-1.5,1-2.5,1.5-6,10-50,2.5-4,3-,3-4,3.5-4,4-10,4-foliat,4.5-5,6-35,7-12,7-40,abaxially,absent,acute,adaxially,aggregate,ape,axe,basal,beyond,blade,bright,cell,connective,darker,directed,distally,eaf,eed,eglandular,equal,exserted,flower,glandular,hair,lemon-yello,lon,longitudinal,lower,m.,narrowly,nflorescence,nther,often,orolla,perfect,pore,presen,puberulen,radiu,ruit,shorter,slightly,small,stamen,stellate,stone,stripe,subcoriaceous,tal,tem,thecae,time,tomento,triangular,truncat,tube,ud,unit,vary,vein,wide,ympodial	abaxial,adaxial,anther,arrangement,characteristic,colour,corolla,form,growth,height,inflorescence,leaf,length,ovary,plant,seed,shape,stem,surface,texture
61	wfo-0001026535	success	248	136	121	127	15	0.488	.5,0.7-1.5,1,1-2,1-3,1.2-2,1.3,1/2-2/3,1/3,2-3,2-5,2.5,3.5-4,5-7,7-8,abaxial,abaxially,acute,adaxially,age,almost,along,anther,anthesi,apex,apically,base,becoming,berry,black,brachyblast,branch,branched,branching,brown,calyx,chartaceous,clustered,cm,concolorous,condensed,conical,corolla,cuneate,deltoid,dendritic,dendritic-pubescent,dense,developed,diameter,dilated,discolorous,distributed,dry,drying,elliptic,elongated,entire,evenly,filament,fine,flat,flower,fruit,glabrous,green-brown,known,leaf,length,liana,like,lobe,lobed,long,lower,margin,membranous,midvein,mm,network,obovate,older,orange-brown,ovate,ovoid,pair,partly,pedicel,peduncle,petiole,plant,pointed,primary,prominent,pubescent,rachi,raised,rarely,ridged,rounded,short,shrub,side,sparsely,stem,style,surface,terminal,tertiary,trichome,truncate,unarmed,vein,venation,violet,visible,weakly,white,x,yellowish,young	.1,.2,.4,.8,0-0.5,0.1-0.2,0.15,0.2,0.2-0.3,0.2-1.5,0.5-1,1-5,1.5-2,1.5-3,3,3-4.5,3-5,4-15,5-10,5Â°,absent,accrescent,alternate,alyx,apar,apparently,area,around,articulated,bark,broadly,clavate,clearly,cup,cupular,curved,dark,deeply,delineate,delineated,detaching,developing,divided,domatia,dorsal,eaf,eed,ellipsoi,equal,except,eye,fertilisation,flexuous,forming,free,frui,fruiting,increasing,inside,leave,lengthening,linear,lon,loop,loose,m.,main,marginal,minute,minutely,mostly,much,naked,nflorescence,nther,number,oblong,obscure,orolla,outside,papillo,pendulous,perfec,pericarp,plurifoliat,pore,poricidal,portion,protruding,ray,reaching,ruit,scar,secondary,see,simple,sinus,slender,slightly,smaller,smooth,soon,spaced,spreading,stigma,stump,tearing,terete,thin,tip,tissue,toward,translucent,tube,tufted,two,ud,uneven,unevenly,unit,unlignified,vary,wide,widely,wider,ympodial,youngest	1.5,adaxial,arrangement,characteristic,colour,form,growth,inflorescence,na,ovary,seed,shape,staman,texture,ye
62	wfo-0001026604	success	192	142	130	62	12	0.677	.4,.5,.75,0,0.8-0.9,1-1.2,1.1-1.3,1.2-1.7,1.5-2,1.5-9,10-30,2-2.3,2-2.5,2.3-3.5,3-3.5,4-4.5,5,5-7,50-100,acuminate,age,along,always,anther,apart,apex,articulated,articulation,bark,basal,base,berry,branching,brown,c.,calyx,capitate,cell,cm,conical,cordate,corolla,dark,densely,diameter,distal,distinct,due,ellipsoid,elongate,entire,filament,flattened,flower,fruit,fruiting,glabrous,globose,growth,inflated,leaf-opposed,leaving,lengthening,liana,lobed,margin,midrib,minute,minutely,mm,narrowly,new,oblique,occasionally,outline,ovary,ovate,overall,ovoid,pair,pale,papillose,pedicel,peduncle,peg,per,petiole,pitted,point,pore,poricidal,primary,pubescent,purple,quarter,red,reddish,reniform,ripe,scar,series,shape,shrub,simple,sinuate,slit,somewhat,spaced,stellate,stem,stigma,stout,style,surface,terminal,testal,time,tip,trichome,truncate,tube,uniseriate,vein,vining,violet,way,widely,woody,x,Â½	0.1,0.4-0.6,0.8-1,3-5,3.5-4,4.5-7,<,?,absent,aid,anthesi,appearing,atop,brow,clearly,climbing,comical,cucullate,cupped,deflexed,differentiated,drying,eaf,eed,expanding,exserted,flexuous,free,later,lobe,lower,mere,nflorescence,nodding,older,papillo,part,particularly,perfect,pericarp,planar,plurifoliat,poin,portion,receptacle-like,rim,ruit,shiny,slender,slightly,strongly,structure,support,swolle,thin,tub,twisting,ud,undulation,unit,upper,ympodial	arrangement,bud,characteristic,colour,form,inflorescence,leaf,length,number,pubescence,seed,texture
63	wfo-0001026607	invalid_json	204	143	111	93	32	0.544	0.1-0.3,0.8-3.4,0.8-4.5,1-10,1-2,1-5,1-8,1.5-4,10-30,2-10,2.5-3.8,3-8,4-10,4-6,5,6-10,abaxially,absent,acumen,acute,adaxially,anther,apart,apex,articulated,attenuate,axillary,base,basiscopic,berry,brownish,bud,cell,chartaceous,cm,coarse,condition,corolla,covering,decurrent,deep,diameter,distal,dot,drying,elliptic,filament,finely,flower,forked,fresh,fruit,generally,glabrous,globose,green,green-white,greenish,hair,hair-like,half,herb,high,lateral,leaf,like,lobe,long,make,margin,medium,membranous,minute,mm,moderately,mucilaginous,obtuse,odd-pinnate,often,ovate,ovoid,pedicel,peduncle,petiole,plant,puberulent,pubescent,rachi,rarely,ripe,rounded,scattered,seed,sessile,side,simple,spaced,stem,style,subtending,terminal,testal,thick,throughout,typically,usually,violet,wall,wet,white,whitish	0-3,0-4,0.3-1.8,0.5-5.8,0.8-5,1-3.8,2-2.5,2-3,2.4-5.8,2.7-19,5-merou,5.8-19.8,ag,along,alyx,apparently,axe,blade,capitat,ciliate,clavate,clearly,connivent,decreasing,digestion,dorsally,eaf,edge,eed,enzyme,especially,exceeding,flat,folded,forming,geminat,glabrou,greatly,gree,hal,homostylous,honeycomb,interjected,lanceolate,larger,leaflet,lengthening,living,lower,marked,midrib,minutely,much,nflorescence,orbicular,orolla,pair,pentagonal,perfect,petiolulate,plurifoliate,pore,poricidal,present,removed,rosette,ruit,semierec,seudostipule,shaped,short,size,slit,sometimes,specimen,stamen,ste,stigma,straight,tall,tamen,tem,tip,toward,tri-,tube,unit,unwinged,vary,without,x,yellow,ympodial	'',2,[,``,abaxial,adaxial,arrangement,branching,calyx,characteristic,colour,form,growth,height,inflorescence,length,midvein,na,ovary,primary,pseudostipule,shape,staman,surface,tertiary,texture,unarmed,value,vein,venation,{,}
64	wfo-0001026613	success	159	94	66	93	28	0.415	1-2,2.3-8,2.5-2.8,3-5,4-5,5,5-6,5-7,6-12,6-8,8-18,8.5-9,acuminate,anther,apex,articulated,attenuate,axillary,base,berry,bud,chartaceous,cm,conical,cordate,corolla,densely,diameter,distal,filament,flower,forked,fruit,generally,glabrous,green,hair,half,herb,immature,leaf,like,lobe,long,margin,mature,membranous,middle,minute,mm,mottled,odd-pinnate,pedicel,peduncle,petiole,plant,proximal,pubescent,purple,sparsely,stem,style,subtending,terminal,unknown,usually	0.5-1,0.6,1-10,1.5-4,11-19.5,2-7.5,3-10,4.5-8.5,5-merou,5.5-7,6.2-9.5,8.5-10,9.5-13.5,abaxially,absent,acumen,adaxially,ag,along,alyx,apart,apparently,axe,blade,borne,capitat,ciliate,connivent,decreasing,dorsally,eaf,edge,eed,end,erec,especially,flat,folded,geminat,greatly,hal,homostylous,interjected,lanceolate,larger,lateral,leaflet,lengthening,lower,m-1.2,midrib,minutely,nflorescence,orolla,ovate,pair,perfect,petiolule,plurifoliate,pore,poricidal,puberulent,pubescen,rotate-pentagonal,ruit,secondary,semierect,seudostipule,singly,size,slit,spaced,ste,stigma,stolo,subequal,symmetrical,tall,tamen,tem,tip,toward,tri-,tube,tuber,typically,unit,unknow,unwinged,vary,x,yellow,ympodial	0.6-1.2,abaxial,adaxial,arrangement,branching,calyx,characteristic,colour,form,growth,height,inflorescence,length,midvein,na,ovary,primary,pseudostipule,rachi,seed,shape,staman,surface,tertiary,texture,unarmed,vein,venation
65	wfo-0001026614	success	200	116	79	121	37	0.395	.8,0.4-0.7,1.3-1.8,11-15,2.2,2.2-5.5,2.5,3-foliate,4-7,5,acuminate,acute,anther,apex,base,berry,black,brown,calyx,closely,cm,commonly,dark,densely,diameter,dried,entire,erect,extra-axillary,filament,flattened-reniform,flower,foveolate,fruit,glabrous,gland-tipped,globose,hair,irregularly,leaf,lobe,lobed,margin,midvein,minute,minutely,mm,mottled,oblique,orange,orange-red,ovate,ovate-lanceolate,pair,pedicel,peduncle,petiole,pubescent,rachi,reflexed,repand,ripe,shallowly,shrub,simple,sometimes,spaced,sparsely,stellate-pubescent,stem,style,surface,unarmed,usually,vein,white,x,yellow,yellowish	0.2,0.2â0.3,0.5,0.5â2,1-,1.5â2,15â30,1â2,1â3,1â5,2.5â3,20â25,2â4,2â4-branched,2â6.5,3.2-5.2,3â10,4.5â11,4.5â5.5,5-merou,5.3-8.2,50,6.4-8.4,6â8,7.2-9.8,8â10,9â16,>,abaxially,absent,across,adaxiall,adaxially,alyx,apart,apparently,armed,articulated,axe,ba,blade,blunt-tipped,broad-based,campanulate,capitat,chartaceous,clavate,concentrated,cylindrical,denser,developed,directed,distally,eaf,eed,especially,evenly,expanded,fleshy,fruiting,geminate,glabrescent,globo,golden,homostylous,internode,interpetalar,lanceolate-attenuate,lateral,less,linear,lon,long,lower,midpoint,nearly,nflorescence,obtuse,often,orolla,ovoid,per,perfect,pore,prickle,pubescence,rarely,ray,rotate-pentagonal,rounded,ruit,scattered,sessile,shin,side,similar,slightly,smaller,somewhat,soon,spreading,stellae,stellate,stigma,tall,tamen,tapering,tem,time,tissu,tissue,tube,ud,unarme,vary,weakly,well,wide,ympodia,young,â5	0.2-0.3,0.5-3,1-2,1-4-branched,1-5,1.5-2,2-4,2.5-3,20-25,4.5-5.5,8-10,9-16,abaxial,adaxial,arrangement,branching,characteristic,colour,corolla,form,growth,height,history,inflorescence,length,life,na,ovary,plant,primary,pseudostipule,seed,shape,staman,tertiary,texture,venation
66	wfo-0001026642	success	193	100	58	135	42	0.301	6,abaxial,along,annual,anther,apex,articulated,base,bipinnate,black,blade,blue,branched,brown,calyx,cm,cylindrical,dark,densely,denser,diameter,elliptic,filament,flattened,fruit,glabrous,globose,green-purple,herb,indumentum,lavender,leaf,length,lilac,lobe,mm,moderately,ovate,pale,pedicel,peduncle,perennial,petiole,pinnate,pitted,primary,pubescent,shallowly,sometimes,sparsely,straight,style,subglabrous,surface,time,vein,violet,x	.05,.1,.8,0.1,0.1â0.3,0.2,0.25,0.4,0.4â2.2,0.5,0.5â,0.5â0.7,0.5â1.7,0.5â2.0,0.5â3.5,0.6,0.6â1.0,0.75â1.0,0.75â2.0,0.7â1.6,0.8â1.2,1.0,1.0â2.0,1.2â1.7,1.2â2.0,1.2â3.5,1.2â6.2,1.6â8.0,1.9â3.0,12â30,1â10,1â3,2.0â4.0,2.5â3.5,2.5â4.0,2.8â3.0,3.0â5.1,3â5,4.0â6.0,4â7,5,5.0â7.0,50â100,<,abaxially,acute,adaxiall,adaxially,ag,anthesi,apart,appressed,axe,axillary,ba,borne,cell,chartaceous,circular,clavate,connivent,decreasing,decumbent,divided,eaf,eed,either,equal,erect,fleshy,flower,geminat,glabrescen,gland,glandular,hair,half,lon,long,longitudinal,lower,m.,multicellular,narrow,nflorescence,number,oblong,obtuse,occasionally,often,opening,orolla,pair,pentagonal,perfect,pinnae,pore,poricidal,present,probably,rapidly,rounded,ruit,secondary,sessile,shoot,side,simple,slit,spaced,stigma,stone,tal,tamen,tem,tip,tube,unicellular,unifoliate,uniseriate,unit,usually,vary,white,wide,wing,woody,yellow,ympodial,â1.2,â11.0,â2.0,â4.5,â6,â7	0.1-0.3,0.4-2.2,0.5-0.7,0.5-3.5,0.75-1.0,0.75-2.0,0.8-1.2,1-3,1.2-1.7,1.2-2.0,1.2-3.5,2.0-4.0,2.8-3.0,5.0-7.0,50-100,adaxial,arrangement,branching,characteristic,colour,corolla,form,growth,height,history,inflorescence,life,margin,midvein,na,ovary,plant,pseudostipule,rachi,seed,shape,staman,stem,tertiary,texture,unarmed,venation
67	wfo-0001026651	success	222	117	82	140	35	0.369	1.8,3,3-plurifoliate,8,abaxially,acuminate,acute,adaxially,anther,apex,articulated,attenuate,base,berry,brochidodromous,calyx,chartaceous,ciliate,dark,densely,diameter,discolorous,drying,dull,entire,eye,filament,flattened,flower,fruit,geminate,glabrous,globose,green,herb,lanceolate,lateral,leaf,length,light,like,lobe,margin,mm,moderate,moderately,mostly,much-branched,naked,narrowly-elliptic,ovate-deltate,ovate-reniform,pedicel,peduncle,pedunculate,per,petiole,plant,pubescence,pubescent,revolute,ripe,rounded,seed,shape,shrub,similar,slightly,sometimes,spaced,stem,style,sub-opposite,surface,terminal,translucent,undulate,vein,venation,visible,white,Ã	-celled,0.2â1.3,0.35â2.6,0.9â3,1,1â2,2.2â10,2.8,2â11.5,2â13,2â3,2â3.3,2â4,2â4.5,2â8,3â5,3â7,4,4â6,4â7.8,5-merou,6â10,6â14,absent,accrescent,adaxiall,along,alyx,anisophyllous,antror,antrorse,antrorsely,apar,appressed,arcuate,ark,asymmetric,axi,beneath,beyond,branch,broadly,brown,brownish-green,capitat,capitate,cell,circular,cm,connivent,cordate,cylindrical,cyme,decumbent,decurrent,differing,directed,eaf,eed,elliptic,emarginate,equal,erect,exfoliating,exserted,flexuous,frui,geniculate,glabrescent,glabrou,glandular,growt,hair,head,highly,hilum,hollow,impressed,introrsely,less,long,longitudinal,lower,lying,major,markedly,matte,membranaceous,midrib,minor,multicellular,new,nflorescence,normally,oblong-ellipsoid,obtuse,older,one,onto,opening,orolla,ovate-lanceolate,parallel,perfect,pore,poricidal,prominent,reduce,region,ruit,secondary,shiny,simple,single-celled,size,slit,small,smaller,stalk,stamen,stellate,stigma,straight,subapical,tall,tamen,tem,trichome,turning,unbranched,uniseriate,unit,upper,usually,vary,wide,woody,yellow,ympodial,young	1-2,2-13,2-3.3,2-4,2-4.5,2-8,2.2-10,4-6,6-10,6-14,abaxial,adaxial,apart,arrangement,branching,characteristic,colour,corolla,form,growth,height,history,inflorescence,life,midvein,na,ovary,perennial,primary,pseudostipule,rachi,staman,tertiary,texture,unarmed
68	wfo-0001026656	invalid_json	211	127	95	116	32	0.45	0.3-3,1-10,1-2,1-3.8,1.1-8.1,1.5-7,2-6,20-60,4-10,4-8,5-35,9-11,abaxially,acuminate,acute,anther,apex,articulated,attenuate,base,blue,broadly,brownish,cell,chartaceous,cm,condition,corolla,covering,cuneate,dark,densely,diameter,distal,dot,drying,elliptic,especially,filament,fresh,fruit,glabrous,glaucous,globose,green,greenish,hair,hair-like,herb,lanceolate,lateral,light,like,lobe,long,lunate,make,margin,membranous,midvein,mm,moderately,mottled,mucilaginous,narrowly,oblique,odd-pinnate,ovate,ovoid,pedicel,peduncle,petiole,plant,pubescent,purple,rachi,scale-like,scattered,seed,sometimes,somewhat,stem,style,subglabrous,symmetrical,tertiary,testal,thick,tinged,truncate,violet,wall,wet,white,whitish	0-4,0.3-4.2,0.4-6.5,0.7-10.5,0.9-13,1,1-1.8,1-4,1-5,10,2-8,2.5-17,4-13,5,5-18,5-merou,5.5-27,absent,acumen,adaxially,ag,along,alyx,apart,bearing,blade,borne,bud,capitate,ciliate,clavat,connate,connivent,curved,decurrent,digestion,dorsally,eaf,edge,eed,end,enzyme,erec,exceeding,flat,flower,folded,forked,geminat,generally,greatly,green-white,greenish-yellow,half,homostylous,honeycomb-shaped,interjected,larger,leaflet,lengthening,living,lower,middl,minutely,nflorescence,non-glandular,occasionally,often,orolla,pair,pentagonal,petiolulate,petiolule,plurifoliate,pore,poricidal,puberulent,pubescen,ranging,removed,rotate-pentagonal,ruit,seudostipule,short,singly,slightly,slit,spaced,specimen,stamen,star,ste,stigma,stolo,straight,subequal,subtending,tall,tamen,tem,terminal,therefore,throughout,tip,tri-,tube,tuber,typically,unit,unwinged,vary,wide,wing,without,yellow,ympodial	'',2,[,``,abaxial,adaxial,arrangement,branching,calyx,characteristic,colour,form,growth,height,inflorescence,leaf,length,middle,na,ovary,primary,pseudostipule,shape,staman,surface,texture,unarmed,value,vein,venation,{,}
69	wfo-0001026663	success	251	110	86	165	24	0.343	-15,-2.9,0.2-0.6,0.4-2.2,0.9-1.5,1,1-2.5,1-3.2,1-5,1.1,1.1-2.1,1.2-2,1.4-2.6,1.6-2.3,10.3-13.2,12-14,2-12,2.1-2.6,2.9-5,3.8-5.7,31,4.7-25.9,abaxially,acuminate,acute,adaxially,anther,apex,attenuate,base,berry,branched,brown,calyx,cm,conical,corolla,dark,diameter,drying,echinoid-pubescent,entire,filament,fleshy,flower,fruit,granular,green,greenish-brown,leaf,length,less,lobe,long,margin,midrib,midvein,mm,openly,ovate,ovate-lanceolate,pale,pedicel,peduncle,petiole,plurifoliate,rachi,rich,scabrous,short,shrub,side,slightly,small,stem,style,subglobose,tomentose,tomentose-pubescent,tree,unarmed,vein,violet,white,whitish,x	-8,-9.7,.5-2.5,/25-1/15,/3,0-160,0.3-0.8,1.4-3.1,1.9-2.6,1/2,1/3,1/4-1/2,10-26,2.5-3.7,2.8-5.3,2/3,24-45,3-5,3.5-5,4.5-5.7,5-8,5.5-,5.5-8.8,7.5-9,8-17,accrescent,adaxiall,ag,along,angled,anthesi,apart,apparently,appressed,around,articulated,ascending,axe,axillary,bark,becoming,blade,blunt-tipped,branch,broadly,bud,capitat,chartaceous,closely,completely,constricted,covering,cylindrical,densely,directed,distally,distributed,eaf,echinoi,echinoid,edge,eed,elongated,enveloping,especially,evident,exserted,farinose,flared,free,fruiting,glabrescen,glabrescent,glabrous,globose,granular-tomentose,grooved,hair,immature,inserted,lanceolate,lateral,lengthening,light,line,lined,lobed,long-stalke,long-stalked,longer,longitudinal,longitudinally,lower,m.,main,many,matur,minute,multangulate,multangulate-pubescent,nearly,nflorescence,obtuse,occasional,occuring,older,opening,orolla,ovate-lanceolat,perfect,persistent,pore,poricidal,porrect-stellate,present,pseudo-terminal,pubescence,pubescent,rather,ray,ridged,robust,ruit,runk,sessile,short-stalked,simple,slit,sometimes,somewhat,soon,spaced,sparsely,stalk,stalked,stamen,stellate,stigma,strongly,subcampanulate,subcoriaceous,subglabrous,suture,tall,tamen,tangled,terete,thick,thin,time,tip,tomentum,touching,tube,ud,unarme,unit,upper,usually,vary,way,wide,yellow,ympodial,young	5.5-9,abaxial,adaxial,arrangement,branching,characteristic,colour,form,growth,height,history,inflorescence,life,na,ovary,plant,primary,pseudoterminally,seed,shape,staman,surface,texture,ye
70	wfo-0001026686	success	196	116	87	109	29	0.444	0.6-0.9,1-2,1.5-7,1.7-2.5,10-28,2.4-3.6,3-4,4-6,5,5-8,7-9,8-10,8-14,abaxially,acuminate,adaxially,anther,apex,articulated,axillary,base,berry,brownish,bud,cell,chartaceous,cm,condition,conical,corolla,covering,densely,diameter,distal,drying,filament,flower,forked,fresh,fruit,generally,glabrous,green,green-white,greenish,hair,hair-like,half,herb,lateral,leaf,light,like,lobe,long,make,margin,middle,minute,mm,mottled,mucilaginous,obtuse,odd-pinnate,ovoid,pedicel,peduncle,petiole,plant,pubescent,purple,purple-violet,ripe,round,seed,sparsely,style,subtending,terminal,testal,thick,throughout,usually,wall,wet,whitish,x	.4,0.2-0.5,1,1-10,1-2.5,1.2-3.4,1.2-3.6,2-10,2-9,2.5-8,3-5,3.7-8,5-16.5,5-merou,6.5-12.7,8-27,absent,acumen,ag,along,alyx,apart,apparently,axe,blade,borne,capitat,ciliate,connivent,decreasing,digestion,dorsally,eaf,edge,eed,elliptic-lanceolate,end,enzyme,equal,erec,especially,exceeding,flat,folded,geminat,glabrou,gradually,homostylous,honeycomb-shaped,interjected,lanceolate,larger,leaflet,lengthening,living,lower,midrib,minutely,nflorescence,often,orbicular,orolla,ovate,pair,perfect,petiolule,plurifoliate,pore,poricidal,puberulent,pubescen,removed,rotate-stellate,ruit,secondary,semierect,seudostipule,singly,size,slightly,slit,spaced,specimen,stamen,star,ste,stigma,stolo,straight,stripe,subequal,subsessile,symmetrical,tall,tamen,tem,tip,toward,tri-,tube,tuber,typically,unit,vary,white,wide,wing,yellow,ympodial	2,abaxial,adaxial,arrangement,branching,calyx,characteristic,colour,form,growth,height,inflorescence,length,midvein,na,ovary,primary,pseudostipule,rachi,shape,staman,stem,surface,tertiary,texture,unarmed,vein,venation,Â¼
71	wfo-0001026696	invalid_json	139	115	78	61	37	0.561	0.3-4.5,0.8-7,1,1-1.3,1-4,1.3-2.1,3-17,3-3.5,3-6,3-8.5,4-16,9,acumen,acute,apex,apiculate,articulate,base,branched,broadly,calyx,cell,cm,corolla,covering,cuneate,cyme,decurrent,densely,diameter,dichasial,dichasially,distal,ebracteate,entire,filament,globose,green,green-white,hair-like,herbaceous,honeycomb,lanceolate,lateral,light,linear,lobe,long,make,margin,mm,monochasial,mucilaginous,oblong,obtuse,odd-pinnate,often,ovate,ovoid,pattern,pedicel,peduncle,perennial,petiole,plant,proximal,pubescent,rounded,seed,sinuate,style,testal,thick,throughout,tuber-bearing,wall,white-cream,Â¼	0.9-7.2,1.5-3,2-17,2-3,3-6-foliat,5-35,abaxially,adaxially,apical,apically,connate,dehiscent,digestion,dorsally,eaf,edge,eed,emoval,enzyme,exceeding,flat,flower,folded,forked,generally,globo,half,introrse,light-yello,living,lon,lower,lunat,maturing,nflorescence,nther,orolla,perfect,plan,poricidally,reveal,ruit,seudostipule,short,simple,slit,specimen,stamen,stellate,stigma,straight,tal,tem,throughou,typically,unit,vary,wide,without,yellow,ympodial	'',[,``,abaxial,adaxial,anther,arrangement,branching,characteristic,colour,form,fruit,growth,height,inflorescence,leaf,length,light-yellow,midvein,na,ovary,primary,pseudostipule,rachi,shape,staman,stem,surface,tertiary,texture,unarmed,value,vein,venation,wet,{,}
72	wfo-0001026706	success	232	130	105	127	25	0.453	-3.1,-4.4,0-240,0.2-0.3,0.6-2.2,0.8-1.2,0.8-1.5,0.8-2.8,0.9-2,1-2.2,1-5,1.1-4,1.5-3,10-15,12,2.5-3,2/3-3/4,3-4.6,3.1-3.8,3.6-5.7,4,4.5-5.5,5.3-6.4,8-14,abaxially,acute,adaxially,anther,apart,apex,appearing,articulated,attenuate,base,berry,branched,brown,calyx,chartaceous,closely,cm,corolla,crisped,cuneate,dark,densely,diameter,entire,filament,fleshy,flower,fruit,glabrate,globose,green,herbarium,leaf,length,lobe,lower,many,margin,midrib,mm,obtuse,occasionally,ovate,ovate-elliptic,pale,pedicel,peduncle,petiole,pubescent,rachi,reticulate-punctate,semi-ovate,shrub,side,simple,slightly,small,softly,somewhat,spaced,sparsely,specimen,stem,style,subconical,subglobose,suborbicular,sulcate,surface,time,tomentose-pubescent,translucent,tree,unarmed,vein,velutinous,wavy,white,whitish,x,yellowish-tan	-5.5,-6.1,.5,/14-1/6,0.2-0.5,0.9-1.9,1/2-2/3,14-32,2.2-3.3,2.3-3.8,2.7-4,2.9-6,4.2-12,5-6.5,6-10,6-8,6.1-,7-16,9.8-15.4,accrescent,adaxiall,ag,anthesi,apparently,around,axe,axillary,ba,bark,becoming,blade,blunt-tipped,branch,bud,capitat,completely,coriaceous,covering,cylindrical,dendritic-echinoid,dendritic-multangulate,directed,distally,eaf,edge,eed,enveloping,exserted,farinose,fourth,free,fruiting,furfuraceou,glabrous,golden,grayish,hair,indument,inserted,lackin,lacking,lanceolate,lateral,lengthening,lobed,long,long-stalked,longitudinal,m.,main,matted,minute,mixed,multangulat,multangulate,nearly,nflorescence,oblong,obscured,often,older,orolla,ovate-lanceolate,perfect,persistent,plurifoliate,pore,poricidal,porrect-stellate,pseudo-terminal,pubescence,rather,reddish,ruit,runk,sessile,short-,short-stalked,slit,soon,splitting,stalked,stamen,stellate,stigma,strongly,subcampanulate,suture,tall,tamen,thin-walled,tip,tomentu,touching,transparent,tube,ud,unarme,unevenly,unit,upper,vary,way,wide,yellow,ympodial,young	6.1-15.4,abaxial,adaxial,arrangement,branching,characteristic,colour,form,growth,height,history,inflorescence,life,midvein,na,ovary,plant,primary,pseud-terminal,pseudostipule,seed,shape,staman,texture,ye
73	wfo-0001026707	success	196	114	95	101	19	0.485	-5,.5,0,0.5-1,0.6-0.7,0.7-1.4,0.7-1.5,1-3,1-5,1.5-1.8,1.6-2,1/3,2-2.3,2.5-4,3-4,3-4.5,3-8,5-merous,8-15,?,acute,anther,apart,apex,apically,apparently,articulated,attenuate,base,berry,branched,broad-deltate,calyx,chartaceous,clustered,cm,concolorous,decurrent,diameter,discolorous,drying,entire,erect,filament,flattened-reniform,flower,fruit,glabrous,green,lateral,leaf,length,lobe,long,lower,margin,mauve,mm,moderately,narrow-oblong,obtuse,one,open,orange-brown,pedicel,peduncle,petiole,prickle,prickly,pubescent,red-brown,rounded,scar,shrub,small,smooth,sometimes,spaced,sparsely,spherical,stellate-pubescent,stem,style,surface,terete,terminal,time,tip,tree,unarmed,upper,weakly,white,yellow-green,Â¼	-1/3,-3,.8,/3,0-20,0.05,0.05-0.15,0.1-0.2,0.3-0.8,0.5-3,0.6-0.8,0.7-1,1-1.7,1/3-1/2,1/3-3/4,1/4-1/3,1/8-1/4,11-16,2-10,2-6,2.5-3,2.5-6,3-7,4,5-10,5-25,5-7,5-8,abaxially,alyx,apar,bark,blade,branche,broadly,color,connivent,curved,cuspidat,densely,eaf,eed,elongating,equal,eye,foliaceous,free,fruiting,fused,gently,glabrescent,glabrou,gray,inflated,infructescence,juvenil,known,less,lobed,longer,mature,midpoint,naked,narrow-deltate,nflorescence,older,orolla,oung,per,perfec,pericarp,plurifoliat,poricidal,porrect,porrect-lepidote,portion,ray,reflexed,ruit,sessile,shorter,simple,slender,spreading,stalk,stalked,stellate,stout,straight,tamen,tapering,trichome,tube,unit,variously,vary,venation,visible,way,wide,ympodial	arrangement,branch,characteristic,colour,corolla,cuspidate,form,growth,inflorescence,juvenile,ovary,perfect,seed,shape,specified,staman,texture,type,width
74	wfo-0001026711	success	210	124	103	107	21	0.49	-2,-5,-7,.8,0,0-25,0-4,0-6,0.3-1,0.5-1.5,0.7-1.4,0.75-1,1.5-2.2,1/3,2-2.2,2-3.5,2.1-2.5,3-4.5,3-7,3.5-5.2,4.5-7,acute,anther,apex,apically,apparently,articulated,base,berry,branched,calyx,cell,cm,cuneate,curved,densely,diameter,dull,elliptic,erect,evenly,faint,filament,flattened-reniform,fruit,glabrous,green,lateral,leaf,length,lobe,lobed,long,lower,margin,maturity,mauve,midvein,mm,narrow-deltate,obtuse,occasionally,orange,orange-brown,outline,pair,pale,pedicel,peduncle,per,petiole,pit,prickle,prickly,primary,purple,raised,red,rounded,shallowly,shrub,slender,small,smooth,sometimes,spherical,stellate-pubescent,stem,style,surface,terminal,tertiary,trichome,unarmed,uniform,upper,vein,venation,visible,wide,yellow,yellow-green,young	-15,-6,.2,.5,0-0.2,0.1,0.15,0.2-0.3,0.7-,0.7-0.9,0.8,0.8-2.2,0.9-1.1,0.9-1.5,1-,1-2,1-30,1.5-,1.7-4,1/,1/2-2/3,1/4,1/4-1/3,2-2.5,2-4,2-6,3-4,3-5,4-8,5-merous,7-8,abaxially,acicular,acuminat,alyx,ame,apar,apart,bark,blade,brow,c.,concolorous,connivent,deltate,difoliate,discolorous,distance,drying,eaf,eed,elongating,equal,extending,flower,free,fruiting,geminat,infructescence,less,longer,mature,midpoint,moderately,nflorescence,older,one,open,orolla,oung,pendulous,perfec,pericarp,perpendicular,poricidal,porrect,portion,prickl,ray,reduced,reflexed,ruit,scar,sessile,shorter,side,somewhat,spaced,spreading,stalk,stalked,stellate,straight,tamen,tapering,terete,thick-chartaceous,time,tip,tube,unit,variously,vary,way,weakly,woody,ympodial	abaxial,acuminate,adaxial,arrangement,branching,characteristic,colour,corolla,form,growth,height,inflorescence,na,ovary,plant,pseudostipule,rachi,seed,shape,staman,texture
75	wfo-0001026717	success	207	90	62	145	28	0.3	0.6-1.5,1-2,1-2.5,1.4-2.2,13-28,2.5-4.5,2.5-5.5,3-4,3-6,3.3-11,4-6,5,5-11,5-6,acuminate,anther,apex,articulated,attenuate,base,berry,chartaceous,cm,conical,corolla,dark,diameter,elliptic,filament,fruit,glabrous,green,greenish,herb,lanceolate,leaf,light,lobe,long,margin,medium,membranous,minute,mm,mottled,mucilaginous,obtuse,odd-pinnate,ovoid,pedicel,peduncle,petiole,plant,pubescent,purple,round,seed,sparsely,style,subglabrous,violet,whitish	0.3-0.6,0.3-2.5,0.3-5,0.8,1-10,1-3,1.3-2.5,1.8-3,14-22,15-34,2.2-5,3-5,4-8,4-9,5-13.5,5-merou,5.3-9,7-11,abaxially,acumen,adaxially,ag,along,alyx,apart,apparently,axe,axillary,blade,borne,brownish,bud,capitat,cell,ciliate,condition,connivent,covering,darker,decreasing,decurrent,digestion,distal,dorsally,drying,eaf,edge,eed,end,enzyme,equal,erec,especially,exceeding,flat,flower,folded,forked,fresh,geminat,generally,glabrou,gradually,green-white,hair,hair-like,half,homostylous,honeycomb-shaped,interjected,larger,lateral,leaflet,lengthening,like,living,lower,make,middle,midrib,minutely,narrow,nflorescence,often,one-quarte,orbicular,orolla,ovate,pair,pentagonal,perfect,petiolule,plurifoliate,pore,poricidal,present,puberulent,pubescen,removed,ripe,rotate,ruit,secondary,semierect,sessile,seudostipule,singly,size,slightly,slit,spaced,specimen,stamen,ste,stigma,stolo,straight,stripe,subequal,subsessile,subtending,symmetrical,tall,tamen,tem,terminal,testal,thick,throughout,tip,toward,tri-,tube,tuber,typically,unit,usually,vary,wall,wet,wide,wing,x,yellow,ympodial	abaxial,adaxial,arrangement,branching,calyx,characteristic,colour,form,growth,height,inflorescence,length,midvein,na,ovary,primary,pseudostipule,rachi,shape,staman,stem,surface,tertiary,texture,unarmed,vein,venation,width
76	wfo-0001026725	success	166	101	83	83	18	0.5	.5,/4,0.7-1.2,1-1.2,1-1.5,1-4.5,1-5,1.2-1.7,1.5,1.5-2,1.6-2,2,2.2-4,3.5-4,3.6-7.7,5-20-flowered,5-5.5,5-6,8-18.6,acute,anther,apex,attenuate,bark,base,beneath,broadly,calyx,capitate,cm,corolla,dark,drying,elliptic,flattened-reniform,fruit,fruiting,glabrous,globose,green,greenish-white,incrassate,large,leaf,lobe,lobed,long,major,margin,minor,minutely,mm,onto,ovate,pale,paler,papillose,pedicel,petiole,pitted,poricidal,pubescent,reddish-brown,rounded,shrub,simple,size,slender,stem,stigma,stretching,style,subshrub,surface,tan,tapering,tip,triangular,tube,way,white,winged,x	.3,0.2,1/2,8-9,accrescent,anthesi,apart,axil,becoming,berry,black,bluish,brownish-papillose,character,crackin,cup-shaped,deflexed,dia,differing,difoliate,dry,eaf,edicel,eed,ellipsoid,evenly,extremely,filament,free,geminat,geographically,glandular-papillose,inflorescenc,interpetalar,lateral,less,lon,lower,main,margine,material,middle,nflorescence,occasionally,often,older,one,open,opposite,ovary,ovoid,pair,papillo,planar,pore,portion,prominent,proximal,reflexed,ruit,scar,scarious,shaped,short,sinus,slightly,spaced,split,straight,tall,tear-drop,trichome,tuft,ud,uniseriate,unit,upper,varying,vein,widest,woody,ympodial,young	abaxial,colour,cracking,diameter,flower,form,greyish,growth,hair,height,inflorescence,length,number,plant,seed,shape,texture,type
77	wfo-0001026733	success	188	131	100	88	31	0.532	-11,-15,-2,-7,0.3-0.5,0.3-2,0.5-2,1,1-1.5,1-3,1-7,1.5-14,1.5-2,1.5-2.5,10-20,15-,2-2.5,2-3,2-6,2.5-7.5,20-50,25-40,3-3.5,4,4-5,5-8,8-12,abaxially,acuminate,acute,adaxially,apex,articulated,axe,basal,base,calyx,chartaceous,cm,color,cordate,curled,deltate,densely,diameter,eglandular-pubescent,ellipsoidal,elliptic-ovate,entire,flattened,flower,forked,fruit,fusiform,glabrate,glabrous,glandular-,glandular-puberulent,green,greyish,hair,hirsute,immature,leaving,lobe,long,longitudinal,margin,mm,moderately,near,oblique,ovate,pedicel,pedicellar,peduncle,perfect,petiole,pilose,pubescent-pilose,rachi,remnant,ripe,shining,simple,sometimes,stripe,style,submarginally,tree,truncate,unbranched,unknown,vein,villous,white,white-puberulent,wide,x,yellowish	-1,-13,-14,-4,-8,.5-3,0.5,0.5-1,0.5-4,1-2,2-4,3-15,3-4-foliat,3-7,4-23,4.5-5,7-10,acute-acuminate,aggregate,apart,ape,beyond,blade,capitat,cell,ciliat,connective,connivent,cylindrical,dense,dia,directed,distally,eaf,eed,eglandular-pilose,eglandular-villous,equal,especially,exceeding,exserted,gland-tipped,glandula,glandular-tomentose,lanceolate,linear-triangular,lon,lower,membranaceous,midrib,narrowly,nflorescence,nther,orolla,ovoid,ovum,pore,present,pubescent,pubescent-pilo,radiu,round,ruit,shorter,slightly,small,smooth,spaced,sparsely,stamen,stellate,stigma,stone,swelling,tal,tem,thecae,time,toward,triangular,tube,ud,unit,unknow,usually,vary,yellow,ympodial	abaxial,adaxial,anther,arrangement,branching,characteristic,colour,corolla,filament,form,glandular,growth,height,inflorescence,leaf,length,midvein,na,ovary,plant,primary,pseudostipule,seed,shape,staman,stem,surface,tertiary,texture,unarmed,venation
78	wfo-0001026734	success	266	111	81	185	30	0.305	0.5,1,3,abaxial,abaxially,absent,acuminate,adaxial,anther,apex,articulated,barely,base,becoming,berry,branched,broadly,brown,calyx,camptodromous,chartaceous,cm,congested,corolla,covered,cuneate,cyme,densely,diameter,distally,elliptic,entire,flower,fruit,geminate,glabrous,globose,green,growth,immature,irregular,lanceolate,leaf,length,lobe,long-attenuate,margin,mature,maturity,membranaceous,mm,moderately,much,narrow,oblong,observed,obtuse,ovary,pair,pale,pedicel,peduncle,petiole,pit,porrect-stellate,pubescent,purple,purplish,rachi,shape,shrub,sparsely,stem,style,surface,trichome,unbranched,vein,venation,visible,white	0.1,0.2,0.3,0.6,0.7â0.9,0.7â1,0.8â1,1.6â2,1.6â2.5,1.8â2.2,1.8â3,1/4,1â1.2,1â3,2.2â7,2.3â5,2.5â3,2â2.4,2â3,3.2â3.8,3â4,3â4-celled,3â8,4â6,4â7,4â8,4â9,5-merou,5â9,8,accrescent,acute,adaxiall,adaxially,ag,also,always,alyx,anthesi,apical,apice,archin,ark,associated,asymmetric,axi,beneat,beneath,blade,branch,bright,caly,capitate,celled,central,clavate,closely,commonly,connivent,covering,cylindrical,dark,dense,denser,differing,directed,discolorous,downward,dried,drying,due,eaf,eed,eglandular,emergent,erect,f.,fewer,flat,flattened,foliate,forked,found,free,frequently,glabrescen,glabrescent,glandular,gray,hair,held,ilament,initially,internodal,introrsely,j,lamina,large,lateral,less,lobed,long,longer,longitudinal,lower,lying,material,maturit,midpoint,midri,minute,mostly,multiseriate,near,new,nflorescence,normally,obovate,often,old,older,one,one-celled,opening,orolla,other,oung,ovate,paired,papillose,perfect,plane,pointing,pore,poricidal,porrect,portion,pubescence,raised,rarely,ray,rayed,reaching,reniform,rounded,ruit,scandent,secondary,sessile,shiny,short-stalked,shorter,simple,size,slightly,slit,smaller,sometimes,spaced,sparse,spread,spreading,stalk,stellate,stigma,still,subopposite,subsessile,surfac,terminal,tube,tuft,ud,unequal,uniseriate,unit,upward,vary,vestiture,whole,wide,yellow,yellowish,ympodial,Â¾	0.8-1,1.6-2,1.6-2.5,1.8-3,2-3,2.3-5,2.5-3,3-8,4-6,5-9,arrangement,branching,characteristic,colour,filament,form,height,history,inflorescence,life,midvein,na,plant,primary,pseudostipule,seed,staman,tertiary,texture,unarmed
79	wfo-0001026740	success	171	128	111	60	17	0.649	0-10,0.5-1,1-10,1-12,1-2,1-3,1-5,10-20,10-30,2-3,2-4,2.5-27,2.5-3,2.5-4.5,2.5-6,20-50,3-3.5,3-5,4-5,4.5-10,5-8,6-10,8-19,abaxially,acuminate,acute,adaxially,also,apart,apex,apiculate,articulated,basal,base,branched,calyx,cm,connivent,cordate,corky,curled,cylindrical,darker,deltate,densely,diameter,directed,distally,eglandular,ellipsoidal,elliptic,entire,especially,flattened,fleshy,flower,fruit,glabrate,glabrous,greenish,hair,immature,lanceolate,leaving,lobe,long,margin,mature,mm,moderately,near,nearly,oblong,obtuse,often,ovate,pedicel,pedicellar,peduncle,perfect,petiole,pilose,pore,present,puberulent,purple,rachi,remnant,reticulate,scar,sessile,simple,sometimes,spaced,sparsely,stigma,stripe,style,tomentose,tree,truncate,unbranched,vein,villous,violet,white-puberulent,whitish,woody,x,yellow,young	-17,-2,1-4,3-15,3-foliat,3.5-40,5-40,absen,absent,acute-acuminate,aggregate,ape,axe,beyond,blade,browni,cell,ciliate,connective,eaf,eed,equal,exceeding,exserted,glandular-puberulent,lon,lower,narrowly,nflorescence,nther,orange,orolla,ovoid,pilo,pubescent,radiu,rarely,ruit,shorter,slightly,small,stamen,stellate,stone,subcoriaceous,swelling,tal,tems,thecae,time,toward,triangular,truncat,tube,ud,unit,unlobed,vary,wide,ympodial	anther,arrangement,characteristic,colour,corolla,form,growth,height,inflorescence,leaf,length,plant,seed,shape,stem,surface,texture
80	wfo-0001026752	success	169	111	92	77	19	0.544	-25,-3,-4,0-,1,1-1.5,1-12,1-2,1-5,1-6,1.5-12,1.5-2,1.5-2.5,10-20,2-2.5,2-3,2.5-5,20-30,3-4,3.5-4,4-5,8-16,abaxially,abruptly,adaxially,also,apex,apiculate,articulated,basal,base,black,branched,calyx,cm,connivent,cordate,cuneate,darker,deltate,densely,diameter,ellipsoidal,elliptic-oblong,elliptic-ovate,entire,finely,flattened,fleshy,forked,fruit,glabrous,globose,green,greenish-brown,immature,lanceolate,leaving,less,lobe,long,margin,mm,moderately,near,pedicel,pedicellar,peduncle,petiole,pilose,possibly,pubescent,pubescent-pilose,purplish,rachi,rarely,remnant,ripe,short-acuminate,simple,stigma,stripe,style,tree,truncate,unbranched,vein,violet,white,whitish,x,yellow	-50,1-3,15-35,2,2-4,2.5-20,3,3-18,3-5,3-foliat,4-45,7-15,absent,acute,aggregate,apart,ape,axe,beyond,blade,campanulate,capitat,cell,chartaceous,connective,coriaceous,cylindrical,dilated,directed,distally,eaf,eed,equal,exceeding,exserted,flower,hair,laterally,lon,lower,narrowly,nearly,nflorescence,nther,obtuse,orolla,ovoid,papillose,perfect,pilo,pore,presence,present,radiu,rather,ruit,slightly,small,somewhat,spaced,stamen,stellate,stone,tal,tem,thecae,time,tomento,triangular,tube,ud,unit,unknow,vary,wide,yello,ympodial	anther,arrangement,capitate,characteristic,colour,corolla,form,growth,height,inflorescence,leaf,length,ovary,plant,seed,shape,stem,surface,texture
81	wfo-0001026754	success	176	105	86	90	19	0.489	-6+,.5,0.5,0.5-1,0.9-1.1,1,1-,1.5-3,1/2,10,2,2-2.5,2/3,3-4-celled,5,5-lobed,abaxially,acute,anther,apex,asymmetric,basal,base,berry,branched,broadly,clavate,cm,corolla,deeply,dendritic,densely,diameter,ellipsoid,elliptic,entire,filament,flower,glabrous,globose,growth,half,inflorescence,later,lateral,leaf,lobed,long,many,margin,membranous,minute,minutely,mixture,mm,mostly,narrowly,new,oblique,pedicel,peduncle,perfect,petiole,pubescent,simple,sparsely,stellate-rotate,stem,stigma,style,surface,tangled,terminal,time,transparent,trichome,truncate,tube,uniseriate,vine,way,weak,woody,x,yellow,yellowish	198.,2-3,2-4,2.5-3.5,30+,4-5,5-merou,5.5-9,7-9,9,9-11,adaxially,ag,along,alyx,anthesi,apar,apparently,ark,articulated,axi,brow,cabrera,calyx,complete,conical,connivent,cucullat,denser,distal,divided,eaf,ed,especially,exerted,extending,fide,free,halfway,ilament,irregularly,lamina,leaving,lengthening,like,lobe,loosely,lower,mature,midvein,nflorescence,older,orolla,outline,pair,papillo,peg,pinnate,planar,plurifoliat,pore,poricidal,portion,primary,puberulent,ruit,scandent,scar,seen,sleeve,slender,slit,small,sometimes,spaced,splitting,spreading,tem,tip,tub,twinin,twining,ud,unit,upper,vary,vein,white,within,ympodial	5-merous,abaxial,adaxial,arrangement,bark,brown,bud,characteristic,colour,form,fruit,length,na,ovary,papillose,seed,shape,texture,type
82	wfo-0001026756	success	147	87	59	88	28	0.401	0-7-1.2,0.5-3,1-1.5,1.5-10,1.5-2,1.8-3,3-4,5-10,5-10-flowered,5-5.5,6-10,abaxial,acute,anther,apex,attenuate,base,berry,brown,calyx,cm,corolla,dark,deltate,densely,difoliate,elliptic,erect,filament,glabrous,globose,green,leaf,lobe,long,minutely,mm,ovary,ovate,ovoid-reniform,pair,pale,pedicel,petiole,pinkish-white,pitted,pubescent,shape,shrub,simple,sparsely,stem,style,surface,thick,tree,unifoliate,vein,white	.25,.5,0.25-0.5,0.5-1,1-2,1.5-1.7,1.5-3,3.5-8.5,6-16,abaxially,adaxially,along,anthesi,apiculate,ba,bark,bilobed,broadly,closely,conical,corresponding,deflexed,dendritic,denser,dia,differing,distal,eaf,edicel,eed,exserted,fleshy,free,fruiting,geminat,glabrescent,grayish-brow,hard,inflorescenc,irregular,lamina,lateral,lax,like,lobed,lower,main,major,middle,minor,nearly,nflorescence,occasionally,older,opposite,overlappin,papillo,perhaps,pericarp,planar,pore,poricidal,portion,present,pubescence,rest,ruit,scar,shaped,somewhat,soon,spaced,stigma,strongly,tall,tear-drop,tip,trichome,tub,tube,ud,uniseriate,unit,wide,widest,woody,ympodial,young	0.25,adaxial,arrangement,branching,characteristic,colour,diameter,form,fruit,grayish-brown,growth,height,inflorescence,length,margin,midvein,na,peduncle,plant,primary,pseudostipule,rachi,seed,staman,tertiary,texture,unarmed,venation
83	wfo-0001026777	success	168	88	72	96	16	0.429	0.5-1,0.5-1.5,0.5-5,0.9-3,1-10,1-2,1-4,1.2-1.8,1.5-3,1.5-5,2-4,3-3.5,5-7,acute,anther,apart,base,beneath,berry,blue,branching,brown,calyx,cm,corolla,decurrent,elliptic,exserted,fide,filament,flattened-reniform,flexuous,fruiting,glabrous,globose,green,growth,leaf,long,minor,mm,narrowly,near,new,occasionally,often,onto,opposite,overtopping,pedicel,petiole,pubescent,russet,scar,seed,shaped,shiny,shrub,size,slightly,soon,sparsely,stem,style,tear-drop,trichome,tube,tuft,uniseriate,vellozo,white,x	.25,.5,/3,0.25-0.5,1-1.3,1-1.5,2-4.5,2-5,4-8,5-14,5-50-flowered,acuminate,anthesi,apex,apiculate,axil,ba,beginning,body,campanulate,capitate,cell,cup,deflexed,dense,dia,differing,difoliate,distal,eaf,edicel,eed,end,filiform,flattened,free,geminat,glabrate,greyi,hyaline,incrassate,inflorescenc,irregularly,lateral,like,lobe,lobed,lon,lower,main,major,margin,matted,middle,minutely,nearly,nflorescence,older,one,outline,ovary,pair,papillo,papillose,pitted,planar,pore,poricidal,portion,prominent,quadrate-deltoid,quite,rest,ruit,sinuate,smooth,somewhat,spaced,stigma,straight,surface,tall,tapering,testa,thread-like,tip,ud,unit,vein,wall,way,widest,woody,yellowish,ympodial,young	bud,characteristic,colour,diameter,exsertion,form,fruit,height,inflorescence,length,plant,pubescence,shape,spacing,texture,type
84	wfo-0001026819	success	218	118	92	126	26	0.422	0.5-1.5,1-2,1.5-10,1.5-12,1.5-3.3,10-26,2-5,2.5-5,3-120,4-10,4-7,5-30,6-11,abaxially,acuminate,acute,anther,apex,articulated,attenuate,base,blue,broadly,brownish,cell,chartaceous,cm,condition,corolla,covering,cuneate,dark,densely,diameter,distal,dot,drying,elliptic,especially,filament,fresh,fruit,glabrous,glaucous,globose,green,greenish,hair-like,herb,lanceolate,lateral,light,lobe,long,margin,membranous,middle,midvein,mm,moderately,mottled,narrowly,oblique,odd-pinnate,ovate,ovoid,pedicel,peduncle,petiole,plant,pubescent,purple,rachi,scattered,seed,slightly,sometimes,somewhat,stem,stripe,style,subglabrous,symmetrical,tertiary,testal,thick,tinged,truncate,violet,wall,white,whitish	0-27,0.3-4.7,1-10,1-2.3,1-5,1.2-36,1.5-3.0,1.5-3.5,1.6-3.5,10,2-6,3-18,3-20,3-35,3-38,4,5-merou,7,absent,acumen,adaxially,ag,along,alyx,apart,ascending,bearing,blade,borne,bud,capitate,ciliate,clavat,connate,connivent,curved,decurrent,digestion,dorsally,eaf,edge,eed,end,enzyme,erec,exceeding,flat,flower,folded,forked,geminat,generally,glabrou,greatly,green-white,greenish-yellow,hair,half,homostylous,honeycomb-shaped,interjected,larger,leaflet,lengthening,like,living,lower,lunate,make,minutely,mucilaginous,nflorescence,non-glandular,often,orolla,pair,pedice,pentagonal,petiolule,plurifoliate,pore,poricidal,puberulent,ranging,removed,rotate-pentagonal,ruit,scale-like,seudostipule,short,singly,slit,spaced,specimen,stamen,star,ste,stigma,stolo,straight,subequal,suborbicular,subrosette,subtending,tall,tamen,tem,terminal,therefore,throughout,tip,tri-,tube,tuber,typically,unit,unwinged,usually,vary,wet,wide,wing,within,without,yellow,ympodial	abaxial,adaxial,arrangement,branching,calyx,characteristic,colour,form,growth,height,history,inflorescence,leaf,length,life,na,ovary,primary,pseudostipule,shape,staman,surface,texture,unarmed,vein,venation
85	wfo-0001026821	success	204	94	77	127	17	0.377	.2,0.3-2.5,0.4-1.5,0.7-1.8,0.8-1,1-1.5,1-2,1-20,1-5,1.5-2.5,10-15,2-3.5,2-celled,2.5-18,3-branched,4-4.5,5-10,5-12,5-20,adaxial,anther,apart,apically,appressed,auriculate,bayonet,broadly,brown,cm,dark,diameter,due,ellipsoidal,elliptic,filament,flower,forked,fruit,gglobose,glabrous,green,hair,herb,incurved,lanceolate,lateral,length,light,mature,mm,obliquely,odd-pinnate,pale,pedicel,peduncle,petiole,pilose,puberulent,pubescent,rachi,rarely,remnant,reniform,slender,spaced,sparsely,stellate,stripe,style,subglabrous,substellate,surface,thickening,unbranched,wall,white,x	/3,0-20,0.2-1.5,0.3-1.2,0.5-1.2,0.5-3.5,1-3,1.2-1.5,17,1977,2-15,2-6,3-11,3-18,3-6,3-7,3-celled,5-34,5-merou,abaxially,acuminate,acut,adaxially,ag,alyx,anderson,angular,apex,apical,apiculate,articulated,axe,ba,basal,base,berry,blade,bract,cell,chartaceous,ciliat,cordate,cuneate,deltate,directed,distal,distally,eaf,eed,equal,especially,exceeding,flattened,frequent,fused,geminat,glabrou,gland-tipped,greatly,homostylous,interjected,interstaminal,large,leaf-opposed,leaflet,lobe,long,long-attenuate,longitudinal,lower,lowermost,many,margin,mean,membrane,membranous,minute,minutely,moderately,much,narrowly,nflorescence,oblique,oblong,obtuse,occasional,occasionally,one-celled,opening,orolla,pair,paired,per,perfect,petiolule,plurifoliate,pore,present,pseudostipular,pubescen,reduced,rounded,ruit,scandent,seudostipule,short,slightly,slit,small,smaller,somewhat,stamen,stigma,subtended,tamen,tem,terminal,time,tri-,truncat,tube,unit,vary,wide,winged,yellow,ympodial	abaxial,arrangement,branching,colour,corolla,form,growth,inflorescence,leaf,ovary,pseudostipule,seed,shape,staman,stem,texture,type
86	wfo-0001026827	success	143	84	64	79	20	0.448	0.2-0.5,0.4-0.6,0.5-2,1-1.1,1-1.5,1.3-1.6,1.5-2,2-2.2,2-4,5-6,acute,anther,apex,arachnoid,attenuate,base,branched,broadly,calyx,cm,conical,corolla,deltate,dendritic,densely,diameter,especially,filament,fleshy,glabrescent,glabrous,growth,inflorescence,irregularly,lanceolate,leaf,like,lobe,margin,mm,narrowly,near,oblanceolate,ovary,pedicel,peduncle,petiole,pubescent,rachi,reddish,revolute,shrub,simple,slender,sparsely,stem,style,surface,thick,tip,trichome,uniseriate,white,x	.5,/3,0.6-1,1-,1-2,1-2.1,2-2.5,3-9,7-9,?,abaxially,adaxiall,age,and/or,anthesi,apart,appearing,bark,branch,clavate,crowded,deciduou,dense,distally,dry,drying,eaf,ellipsoid,erect,exerted,flower,free,internodal,know,known,lamina,lengthening,less,lobed,lower,minutely,new,nflorescence,nodding,ot,pair,paler,papillat,papillate,perfect,planar,plane,plurifoliat,pore,poricidal,portion,primary,scar,sinus,slit,small,soon,stigma,stout,straight,strongly,surfac,terminal,thickened,third,tub,tube,ud,unit,upper,vein,way,widest,ympodial	1-2.5,abaxial,adaxial,adaxially,arrangement,branching,characteristic,colour,form,fruit,height,length,na,plant,pseudostipule,seed,shape,staman,texture,unarmed
87	wfo-0001026830	invalid_json	198	143	108	90	35	0.545	0.3-1.3,0.4-1,0.5-1.0,1-10,1-11,1-2,1.5-4,10-57,2.5-5,4-10,4-7,5-11,6-13,7-18,abaxially,acuminate,acute,adaxially,anther,apart,apex,articulated,asymmetric,attenuate,axillary,base,basiscopic,berry,brown,brownish,bud,cell,ciliate,cm,condition,coriaceous,corolla,covering,deep,diameter,distal,drying,elliptic,filament,finely,flower,forked,fresh,fruit,generally,glabrescent,glabrous,globose,green,green-white,greenish,hair,hair-like,half,herb,high,lateral,leaf,light,linear,lobe,long,make,margin,medium,mm,moderately,mucilaginous,odd-pinnate,ovate,ovoid,pedicel,peduncle,petiole,plant,puberulent,pubescent,purple,ripe,rounded,seed,sessile,short,side,simple,spaced,stripe,style,subglabrous,subtending,terminal,testal,thick,throughout,tissue,typically,usually,wall,wet,white,whitish,yellow,yellowish	0-10,0.5-1.2,0.9-1.9,1.1-2.7,1.4-4,2-4,2-6,2.5-4.4,2.7-8,3.5-8.5,4-14.5,4.4-14.5,4.5-17.5,5-merou,acumen,adaxiall,ag,along,alyx,apparently,arranged,axe,bead,blade,capitat,clavate,connivent,decreasing,digestion,dorsally,eaf,edge,eed,enzyme,erec,exceeding,flat,folded,geminat,glabrou,hal,homostylous,honeycomb,interjected,lanceolate,leaflet,lengthening,like,living,lower,moniliform,multiple,necklace,nflorescence,orbicular,orolla,pair,pentagonal,perfect,petiolulate,plurifoliate,pore,poricidal,removed,rotate,ruit,seudostipule,shaped,size,slit,specimen,stamen,stigma,stolon,straight,subequal,subglabrou,tall,tamen,tem,tip,toward,tri-,tube,tuber,unit,unwinged,vary,x,ympodial	'',2,[,``,abaxial,adaxial,arrangement,branching,calyx,characteristic,colour,form,growth,height,inflorescence,length,midvein,na,ovary,primary,pseudostipule,rachi,shape,staman,stem,surface,tertiary,texture,true,unarmed,value,vein,venation,{,}
88	wfo-0001026831	success	207	125	100	107	25	0.483	.5,0-10,0-20,0-3,0-6,0.2-1,0.3-0.65,0.5-1.2,0.6,0.7-2,1-2.2,1/3,2-2.5,2-4,2.3-2.9,2.5-4.5,3-6,acute,anther,apex,apically,apparently,articulated,attenuate,base,berry,branched,bright,calyx,cell,cm,cream,curved,dark,deltate,densely,diameter,dull,elliptic,erect,eye,filament,flattened-reniform,fruit,glabrous,gray-brown,green,lateral,leaf,length,lobe,lobed,long,lower,margin,marking,maturity,mauve,midvein,mm,moderately,naked,narrow-cuneate,orange,orange-brown,outline,pair,pale,pedicel,peduncle,per,petiole,prickle,prickly,primary,raised,red-brown,rounded,shiny,shrub,slender,smooth,sometimes,sparsely,spherical,stellate-pubescent,stem,style,surface,tertiary,upper,usually,vein,venation,visible,white,wide,yellow,yellow-green,young	-0.25,-5,-6.5,-9,/4,0.1,0.1-0.2,0.1-0.25,0.15-0.25,0.2-0.4,0.3-0.6,0.6-2,0.65-1,0.7-1.1,1-10,1-2,1-2.5,1-3,1-4,1-6,1.2-2,1.5-2.5,1/3-1/,1/3-2/3,1/5-1/4,2-3,3-5,3.5-10,5-merous,7-10,7-8,abaxially,alyx,apar,apart,bark,blade,broad-deltate,brow,caudat,chartaceous,concolorous,connivent,difoliate,distance,drying,eaf,eed,elongating,equal,extending,flower,free,fruiting,fully,geminat,glabrescent,herbaceous,infructescence,less,longer,mature,membranous,midpoint,multangulate,nflorescence,oblong,occasionally,older,one,open,opening,orolla,oung,ovate,pendulous,perfec,pericarp,poricidal,porrect,portion,prickl,ray,reduced,ruit,scandent,scar,sessile,shorter,side,spaced,spreading,stalk,stellate,subsessile,tamen,tapering,terete,time,tip,trichome,tube,unit,vary,way,white-gray,ympodial	1/3-1/2,abaxial,adaxial,arrangement,branching,caudate,characteristic,colour,corolla,form,growth,height,history,inflorescence,life,na,ovary,plant,pseudostipule,rachi,seed,shape,staman,texture,unarmed
89	wfo-0001026841	success	139	83	54	85	29	0.388	0.25-0.3,0.25-0.5,0.5-1,0.6-1,0.75-1,0.8-1,0.8-3,1.5,1.5-2,3.5-5,4-8,5-8-flowered,6-8,7-9,acute,anther,apex,base,berry,calyx,cm,corolla,decurrent,deltoid,elliptic,filament,glabrate,glabrous,globose,green,hyaline,inflorescence,leaf,lobe,long,margin,mm,ovary,pair,pedicel,petiole,prominent,pubescent,raised,shrub,simple,slightly,sparsely,stem,straight,style,vein,white,x	.25,.5,/4,0.05,0.5-0.75,0.5-2,2-2.5,3-6.5,9.2-18,along,anthesi,apart,arch,axi,ba,bark,beneath,bi-lobed,broadly,clavate,conical,coroll,curly-tipped,deflexed,dia,eaf,edicel,eed,ellipsoid,exsertion,filiform,free,fruiting,greyish-gree,immature,joined,known,later,lateral,like,lobed,lon,lower,main,middle,minutely,nflorescence,older,opposite,paler,papillo,papillose,pore,poricidal,portion,reddish,reflexed,rest,ruit,scar,series,shaped,shining,slender,spaced,stigma,tall,tapering,tear-drop,terminal,thickened,tip,trichome,tube,ud,unevenly,unifoliat,uniseriate,unit,way,widest,winged,woody,ympodial,young	abaxial,adaxial,arrangement,branching,characteristic,colour,diameter,form,fruit,greyish-green,growth,height,length,midvein,na,peduncle,plant,primary,pseudostipule,rachi,seed,shape,staman,surface,tertiary,texture,unarmed,unifoliate,venation
90	wfo-0001026849	success	180	83	66	114	17	0.367	0-10,0.5-1,1,1-2,1.5-2.5,1.75-2,2-3,38/2,5,637/2,7-8,acute,adult,anther,apex,aster,base,berry,brown,calyx,capitate,cell,cm,colour,corolla,cyme,discoidal,distinctly,entire,expanded,filament,floral,glabrous,green,grey-brown,growth,inflorescence,lavender,leaf,linear-lanceolate,long-cuneate,margin,minutely,mm,oblong-lanceolate,ovary,pale,pedicel,peduncle,petiole,reticulate,rh,rhachi,rounded,sea,seed,short-lived,shrub,slightly,stigma,stone,style,surface,unarmed,undulate,violet	-50,1-1.5,1-6,100-130,11,2,30-,40,5-10,80-,adherent,amongst,appearing,aspect,australian,axil,composed,conical,conspicuous,curved,cut,deflexed,developed,dia,distinct,eed,ellipsoid,emarginate,enlarge,erect,exceeding,except,exerted,facetted,filled,flesh,flower,flowered,fork,free,fruiting,general,glandular,globose,globular,granule,greater,gree,hair,half,interacuminal,large,leave,lengthening,less,little,lobe,lon,long,loosely,lower,mature,maturity,mid-vein,minute,native,nflorescence,oblong,occasionally,often,pal,pedicellate,petal,plurifoliat,pore,poricidal,preparation,pruinose,purple,rarely,relatively,reproducing,rotate,ruit,ruiting,shallow,shed,simple,sinus,slende,slit,soft-wooded,solanum,solitary,sometimes,somewhat,soon,stem,stony,stout,thus,tip,tissue,tub,tube,ud,unit,uvenile,vegetatively,way,well,x,ympodial,young	30-50,arrangement,characteristic,diameter,form,fruit,height,history,juvenile,length,life,plant,plurifoliate,shape,texture,true,type
91	wfo-0001026858	success	153	96	74	79	22	0.484	0.5,0.8,1-11.5,1.3-1.5,1.5-4,2-2.5,2-4,2.5-3,3-4,6-10,6-18,6-7,abaxially,acumen,adaxially,apical,branched,calyx,cell,cm,corolla,covering,cyme,dehiscent,diameter,dichasial,dichasially,ebracteate,exceeding,glabrescent,glabrous,globose,green,hair-like,herbaceous,introrse,lateral,leaf,light,lobe,long,make,maturing,minute,mm,monochasial,mucilaginous,mucronate,oblong,odd-pinnate,often,ovate,ovate-lanceolate,ovoid,pedicel,peduncle,perennial,petiole,plant,poricidally,seed,shiny,short,slit,stamen,stellate,stigma,straight,style,testal,thick,throughout,triangular,wall	-30,-4,0-.,0.8-1,1-,1-10,1-4,1-5,2-3,3-,3-6-foliat,4-24,4.5-10.5,5-15,abruptly,acute,apex,apically,articulate,base,connate,cordate,cuneate,digestion,diminishing,distal,dorsally,eaf,edge,eed,emoval,enzyme,filament,flat,flower,folded,forked,generally,globo,green-white,half,honeycomb,interjected,leaflet,living,lon,lower,lunat,nflorescence,nther,oblique,obtuse,orolla,pair,pattern,perfect,plan,proximal,reveal,rounded,ruit,seudostipule,size,slightly,specimen,tal,tem,throughou,toward,tuber-bearing,typically,unit,vary,white-crea,wide,without,yellow,ympodial,Â¼	anther,arrangement,characteristic,colour,dehiscence,form,fruit,growth,height,history,inflorescence,length,life,lunate,ovary,pseudostipule,shape,stem,surface,texture,wet,white-cream
92	wfo-0001026895	success	166	127	111	55	16	0.669	.5,0.5-1,0.5-1.2,0.5-1.5,0.5-2,0.8-1,1-1.5,1-5,1.4-2.1,1.5-2,2-2.3,2-2.5,2-3,2.5-3.2,3-12,4.5-5,5-6,5-8-flowered,abaxial,acute,adaxial,along,anther,apex,apically,appearing,attenuate,bark,base,borne,brown,calyx,capitate,cm,contracted,corolla,dark,deflexed,deltoid,dendritic,denser,dia,drying,elliptic,erect,filament,filiform,flattened,fruiting,glabrate,glabrous,globose,green,incrassate,internodal,lamina,lateral,leaf,like,lobe,long,main,margin,minutely,mm,mustard,narrowly,often,ovary,pair,pale,pedicel,petiole,pitted,pointed,pore,poricidal,pubescent,reddish,reniform,scattered,shape,shaped,shoot,short,shrub,shrublet,side,simple,small,somewhat,soon,sparsely,stem,stigma,style,surface,swollen,swollen-based,tan,tear-drop,tip,toothed,trichome,tube,type,uniseriate,vein,white,x,yellow	0-0.5,2/3,anthesi,apical,ba,berry,broad,broadly,campanulate,closely,conical,differing,difoliate,eaf,edicel,eed,ellipsoid,elongate,free,geminat,hard,lobed,lon,long-exserted,lower,major,middle,minor,minute,nflorescence,obovate,older,overlappin,papillo,pericarp,portion,present,projection,reddish-brow,ruit,scar,size,spaced,tall,thin,tub,tuft,ud,unit,usually,way,widest,woody,ympodial,young	characteristic,colour,diameter,form,fruit,growth,height,inflorescence,length,papillose,plant,pubescence,reddish-brown,seed,texture,width
93	wfo-0001026905	success	204	116	91	113	25	0.446	0-2,0.4-1,0.5-0.7,0.5-1.5,0.6-0.7,0.9-1.3,1-2,1/3,2.5-2.9,2.5-3.5,3-5,5-6,acute,anther,apex,apically,articulated,attenuate,base,berry,branched,calyx,cell,cm,cream,dark,deltate,densely,diameter,dull,erect,eye,filament,flattened-reniform,fruit,gray-green,green,inflorescence,lateral,leaf,length,lobe,lobed,lower,margin,marking,maturity,mauve,midvein,mm,moderately,naked,oblong,orange,orange-brown,outline,ovate,pair,pale,pedicel,peduncle,petiole,pit,prickle,prickly,primary,raised,red,rounded,shallowly,shrub,small,smooth,sometimes,spherical,stellate-pubescent,stem,style,surface,tertiary,unarmed,upper,usually,vein,venation,visible,weakly,white,yellow,yellow-green,young	-1.5,-10,-2,-2/3,-3,-4,.2,.5,0,0-20,0-25,0.1,0.15,0.2-0.3,0.2-0.5,0.3-0.4,0.4,0.4-0.9,0.7-1.4,0.75-1.1,1,1-2.5,1-20,1-3.7,1-4,1-6,1.9-2.5,1/2-3/4,1/4,1/5-1/3,2-3,2/3-3/,3-8,5-merous,6-8,7-8,abaxially,acuminat,alyx,ame,apar,apart,apparently,bark,blade,brow,c.,chartaceous,connivent,curved,difoliate,discolorous,distance,drying,eaf,eed,elongating,equal,extending,flower,free,fruiting,geminat,glabrous,infructescence,long,longer,mature,midpoint,older,one,open,orolla,oung,pendulous,per,perfec,pericarp,poricidal,porrect,portion,prickl,ray,reduced,ruit,scar,sessile,shorter,side,slender,somewhat,spaced,sparsely,spreading,stalk,stalked,stellate,straight,subentire,tamen,tapering,terete,time,tip,trichome,tube,unit,variously,vary,way,wide,woody,ympodial	0-10,0.5,2/3-3/4,abaxial,acuminate,adaxial,arrangement,branching,characteristic,colour,corolla,form,growth,height,history,life,na,ovary,plant,pseudostipule,rachi,seed,shape,staman,texture
94	wfo-0001026923	success	177	104	79	98	25	0.446	.5,0-5,0.25-0.5,0.5-1,0.6-0.8,1,1-1.5,1.5-4,2,2-2.5,2-6,3-5,5-10,5-15,5-6,acuminate,acute,anther,apart,apex,articulated,base,black,branched,brown,calyx,chartaceous,cm,cuneate,deltate,densely,diameter,elliptic,elliptic-ovate,entire,erect,filament,flattened,flower,forked,fruit,glabrescent,glabrous,globose,green,leaf,light,lobe,margin,midvein,mm,moderately,pedicel,peduncle,petiole,possibly,pubescent,purple,rachi,red,ripening,rounded,rugulose,shrub,simple,small,spaced,sparsely,stem,strongly,style,surface,tip,tree,white,whitish,x,yellow,yellowish	-5,.1-0.3,0.5,0.8-1,1-3,1-4,1-7,1.5-2,10,2-3,20-50,3-4,4-18,4-5-,5-9,abaxially,absent,accrescent,adaxiall,adaxially,ag,apparently,axe,ba,blade,capitat,center,connivent,covering,curved,cylindrical,denser,directed,distally,eaf,eed,eglandular,equal,frui,fruiting,fused,geminate,gland-tippe,glandular,hair,held,intermediate,lanceolate,large,lateral,leaf-opposed,like,long,longitudinal,lower,many-foliate,midpoint,much,multangulate,nearly,nflorescence,oblong,opening,orange,orolla,paired,peltate,perfect,pore,pubescence,ray,relatively,ruit,scale,sessile,short,slightly,slit,smaller,sometimes,somewhat,ste,stellate,stigma,straight,subtending,tal,tamen,tem,time,trichome,tube,unit,uprigh,usually,vary,wide,ympodial	abaxial,adaxial,arrangement,branching,characteristic,colour,corolla,form,growth,height,inflorescence,length,na,ovary,plant,primary,pseudostipule,seed,shape,staman,tertiary,texture,unarmed,vein,venation
95	wfo-0001026925	success	215	121	100	115	21	0.465	0-20,0-5,0-7,0.5-1.5,0.7-1.8,0.9-1.8,00-200,1-1.3,1-1.4,1-25,1-3.5,1.8-2,1.8-2.5,1/3,2.4-2.6,2.4-3,2.5-6,3-7,4-5,4-7,5-6,5.5-10,6-8,7-12,acute,anther,apex,apparently,articulated,attenuate,base,berry,branched,calyx,chartaceous,cm,cream,dark,deltate,diameter,erect,filament,flattened-reniform,fruit,glabrescent,glabrous,green,green-brown,lateral,leaf,length,lobe,lobed,long,long-styled,lower,margin,marking,maturity,mauve,membranous,midvein,mm,moderately,narrow-deltate,orange-brown,pair,pale,pedicel,peduncle,pendent,per,petiole,plant,prickle,prickly,primary,rarely,red-brown,short-styled,shrub,smooth,sparsely,stellate-pubescent,stem,style,surface,terminal,tertiary,unarmed,unit,upper,vein,venation,visible,white,wide,yellow,yellow-orange,young	-2,.5,/6,0,0-10,0.1,0.1-0.2,0.1-0.3,0.2,0.5-4,1-3,1-4,1.5-2,1.5-2.5,1.5-4.5,1/3-1/2,1/4-2/3,1/6-1/3,2-4,2-5,2/,3-20,4-10,4-14,5-8,5-merous,6-10,6-17,abaxially,acuminat,alyx,ame,andromonoecious,apar,apart,apically,bark,blade,broad-deltate,brow,c.,concolorous,connivent,curved,distal,distance,drying,eaf,eed,elliptic,elongating,equal,extending,flattened,flower,free,fruiting,gently,hair,hermaphrodite,heterostylous,infructescence,lobing,longer,lowermost,mature,midpoint,minute,nflorescence,oblong,older,one,open,orolla,oung,ovate,pendulous,pericarp,plurifoliat,poricidal,porrect,portion,prickl,ray,reduced,reflexed,rounded,ruit,scar,secondary,sessile,side,simple,sometimes,spaced,spherical,spreading,stalk,stalked,staminat,stellate,stout,straight,tamen,tapering,terete,time,tip,translucent,trichome,tube,vary,way,woody,ympodial	0-2,2/3,abaxial,adaxial,branching,characteristic,colour,corolla,form,growth,height,inflorescence,na,ovary,plurifoliate,seed,shape,staman,sympodial,texture,type
96	wfo-0001026946	success	205	114	87	118	27	0.424	0.5-2,1-2,1-4,1.6-3.7,12-23,2,2.5-10.5,3-20,3-5,3.5-10,5-7,8-15,acuminate,acute,anther,apex,attenuate,base,berry,brownish,cell,chartaceous,cm,condition,corolla,covering,creamy,densely,diameter,dot,drying,elliptic,filament,fresh,fruit,glabrous,globose,green,green-white,greenish,hair,hair-like,herb,lateral,like,lobe,long,make,margin,membranous,mm,mottled,mucilaginous,oblique,odd-pinnate,often,ovate,ovoid,pedicel,peduncle,petiole,plant,pubescent,pure,purple,ripe,rounded,scattered,seed,short,short-pubescent,slightly,stem,streak,style,testal,thick,throughout,truncate,typically,unwinged,wall,wet,white,whitish,wing,yellow-white	0-20,0-5,0.9-3.5,0.9-4.3,1,1-10,1.5-2,10-39,2-15,2-5,2.7-9,3-6,4-7,4.1-9.4,5-merou,6-24,8-25,abaxially,acumen,adaxially,ag,along,alyx,apart,apparently,articulation,axe,axillary,blade,borne,broadly,bud,capitat,ciliate,clavate,connivent,deeply,digestion,distal,dorsally,eaf,edge,eed,end,enzyme,erec,especially,exceeding,except,extremely,flat,flower,folded,forked,geminat,generally,glabrou,greatly,half,homostylous,honeycomb-shaped,interjected,lanceolate,leaflet,lengthening,living,lower,midrib,minutely,narrowly,nflorescence,orbicular,orolla,pair,pentagonal,perfect,petiolulate,petiolule,plurifoliate,pore,poricidal,proximal,puberulent,pubescen,reduced,removed,ruit,sessile,seudostipule,singly,size,slit,spaced,specimen,stamen,ste,stellate,stigma,stolo,straight,subequal,subtending,tall,tamen,tem,terminal,thir,tip,tri-,tube,tuber,unit,usually,variable,vary,x,yellow,ympodial	abaxial,adaxial,arrangement,branching,calyx,characteristic,colour,form,growth,height,inflorescence,leaf,length,midvein,na,ovary,primary,pseudostipule,rachi,shape,staman,surface,tertiary,texture,unarmed,vein,venation
97	wfo-0001026962	success	205	104	82	123	22	0.4	.05,0,0.3-0.7,0.8-1,1,1-1.5,1-3,1-4.5,1.5-2,10-12,10-20,15-22,2-2.5,2-6,3-3.5,4-5,6-7,9-12,acute,anther,apex,base,beneath,broadly,calyx,chartaceous,cm,corolla,deflexed,deltate,densely,diameter,difoliate,dry,elliptic,entire,evenly,filament,flattened-reniform,flower,fruit,glabrous,globose,green,inflorescence,leaf,lobe,margin,material,minutely,mm,narrowly,pair,pale,pedicel,peduncle,petiole,pitted,prominent,pubescent,purplish,rachi,raised,rounded,shrub,small,sometimes,stem,style,surface,tinged,tip,tree,triangular,unarmed,unbranched,unifoliate,vein,white,x,yellow,yellowish	.5,0.5,0.5-0.8,0.5-1,0.5-1.5,1-1.2,1-2,1-6,1.5-17,1.5-3,1.5-5,2-5,2/3-3/4,3-6,9-17,abaxially,abrupt,abruptly,accrescent,adaxially,ag,alyx,anthesi,apparently,appearing,arising,articulated,axe,bark,basebud,becoming,blade,brittle,bud,capitat,cell,closely,composed,connivent,constricted,cucullat,cylindrical,darker,denser,differing,dimorphic,eaf,eed,elongate,except,exerted,free,fruiting,geminat,glabrate,glabrou,ilament,incrassate,internodal,later,lateral,like,lobed,long,longitudinal,main,major,minor,nflorescence,obconic,oblong,obovoid,occasionally,often,older,one,opening,opposite,orolla,oung,outline,ovate-lanceolate,overlapping,packed,papillose,paten,pendent,perfect,pore,portion,pubescen,reflexed,remaining,rest,rounder,ruit,sagittate,shaped,simple,size,slender,slightly,slit,somewhat,soon,stellate,stigma,straight,tal,tapering,tear-drop,tooth,trichome,trunk,tube,uniseriate,unit,vary,way,whit,woody,ympodial,young	abaxial,adaxial,arrangement,branching,characteristic,colour,form,geminate,growth,height,length,midvein,na,ovary,plant,primary,pseudostipule,seed,shape,staman,texture,ye
98	wfo-0001026964	success	128	86	53	75	33	0.414	0.5,0.5-1,10-30,2-2.5,3-5,7-8,acuminate,acute,anther,apex,attenuate,axillary,base,berry,calyx,cm,conical,corolla,diameter,elliptic,filament,filiform,fleshy,glabrous,green,greenish,herb,horizontal,lightly,lobe,margin,mm,obovate,ovary,pair,pedicel,petiole,pinnate,primary,pubescent,purple,rachi,shape,simple,sparsely,style,surface,trichome,uniseriate,vein,winged,x,yellow	.2,.5,0,1-1.2,1-2.5,10,2-4,3.5-7,4.5-8.5,?,along,anthesi,basal,beak,bearing,capitat,conspicuously,differentiated,distinct,eaf,edicel,equal,erec,exserted,flower,free,fruiting,glabrou,globose,immature,known,lateral,leaflet,lenticellate,line,lobed,long,long-attenuate,lower,minutely,nearly,nflorescence,noddin,often,one,onto,open,ot,papillate,petiolule,poricidal,portion,purpli,reflexed,rugose,ruit,scar,side,size,slender,small,smooth,somewhat,stigma,tal,tem,terminal,time,tip,tub,tube,ud,unifoliat,unit,ympodial	1,1.5,3,5,abaxial,adaxial,arrangement,branching,characteristic,colour,form,fruit,growth,height,history,inflorescence,leaf,length,life,midvein,na,nodding,peduncle,plant,pseudostipule,purplish,seed,staman,stem,tertiary,texture,unarmed,venation
99	wfo-0001026981	success	252	119	96	156	23	0.381	-0.8,-2.5,-35,0.05-0.1,0.2-0.4,0.3-0.5,0.5-30,0.6-2,1-2,1-3.3,1.5-2.0,1.8-2.8,1/3,2-3-branched,2-locular,4,6-10,abaxially,adaxially,anther,apex,articulated,articulation,asymmetric,base,becoming,brown,calyx,cell,cm,conical,cordate,corolla,dark,densely,diameter,distal,entire,filament,fruit,glabrescent,glandular,globose,green,hair-like,herb,imparipinnate,interrupted,irregularly,lateral,leaf,like,lime,linear,lobe,lobed,long,margin,maturity,minutely,mm,obovate,occasionally,orange,orbicular,outgrowth,ovary,ovate,pale,pedicel,peduncle,perennial,petiole,plant,primary,pseudostipule,pubescent,rachi,rounded,short,simple,sometimes,sparsely,stem,style,surface,tertiary,testa,trichome,uniseriate,variously,velvety,villous,wall,without,yellow	-0.4,-14,-2,-4,-8,.2,.2-0.2,0-5,0.1-0.2,0.1-0.3,0.15-0.2,0.2,0.2-2,0.25-0.4,0.3.6,0.4-0.5,0.4-0.7,0.4-2,0.45-1.3,0.5,0.5-0.3,0.6-1.4,0.7-0.8,0.8-1.2,0.8-6,0.9-1.4,0.9-1.5,1,1-2-cellular,1-3,1-3-celled,1-4,1.5-5,1.5-8.5,11,196.,2-3,3-foliate,3.5-14,4-8,4-celled,7.5,<,absen,absent,abundant,academy,accrescent,acute,adpressed,along,amongst,angled,anthesi,apical,appearance,appendage,appressed,axi,basiscopically,bay,beak,bract,bracteole-like,capitate,citrus-like,coastal,column,composed,cone,d,deltate,eaf,ebracteate,edicel,eed,erect,exserted,flower,fruiting,giving,gree,half,halfway,head,included,initially,interjected,internode,jointles,larger,later,leaflet,less,lon,lower,mainly,mixed,much,multicellular,narrowly,nflorescence,pair,patent,pentagonal,per,petiolule,population,present,procumbent,pronounced,proximal,pubescence,reflexed,rick,robust,ruit,scen,secondary,see,sessile,several,shaggy,shaped,shorter,silky,slender,smaller,sparser,specimen,spreadin,staminal,sterile,stigma,straight,strong,tangled,tem,terminal,thick,tightly,transparent,tub,tube,type,uni-,unicellular,unit,upto,usually,viny,wide,winged,ympodial,â,â	0.3-0.6,abaxial,adaxial,arrangement,branching,characteristic,colour,form,growth,height,history,inflorescence,length,life,midvein,na,seed,shape,staman,texture,unarmed,vein,venation
100	wfo-0001026992	success	243	121	99	144	22	0.407	0.2-0.5,0.25-0.45,0.5-1.2,0.6-1.5,1-4,1.2-1.7,1.3-2.6,1.3-4.3,1.4-1.6,1.4-1.9,1.7-2.4,1.7-4.3,10-12,2-10,2.8-4.7,3-4,3.3-5.6,5.3-12.1,6-10,8,8-11,abaxial,abaxially,abruptly,acuminate,acute,adaxially,along,anther,apex,articulated,attenuate,base,berry,branched,broadly,brown,calyx,cm,corolla,deltoid,diameter,elliptic,entire,filament,fleshy,flower,fruit,glabrous,granular-tomentose,greenish,hair,lance-ovate,leaf,length,lobe,lower,many,margin,midrib,mm,moderately,occasional,orange-tan,ovate,pedicel,peduncle,petiole,plant,pubescent,rachi,reniform,reticulate-punctate,ripe,scabridulous-,semi-ovate,short,shrub,side,simple,small,sometimes,stellate,stem,style,surface,terminal,time,tomentose,tree,unarmed,vein,velutinous,violet,white,x,yellow,yellowish,Â½	-2.5,/7,0.8-3.4,00-170,1.2-1.4,1.5-3.4,1.7-1.9,1/2,12-33,2-5.6,2.3-3.3,2.6-4.6,2.8-4.6,3.3-5.5,4-8,5-15,5-merou,8-14,accrescent,adaxiall,ag,alyx,angled,anthesi,apart,apparently,appressed,approximately,around,axe,axillary,ba,bark,blade,blunt-tipped,branch,capitat,chartaceous,completely,coriaceous,covering,crown,cylindrical,dark,densely,directed,distally,drying,eaf,echinoi,echinoid,edge,eed,enveloping,equal,evident,exserted,farinose,flat-topped,forming,free,fruiting,geminate,glabrescen,globose,grooved,high,homostylous,immature,inserted,lacking,lanceolate,lateral,lengthening,less,line,lobed,long,long-stalked,longitudinal,longitudinally,m.,main,mature,maturity,minute,mostly,multangulate,nearly,nflorescence,oblong,obtuse,occasionally,often,older,orolla,ovate-lanceolate,overlapping,perfect,plurifoliate,pore,poricidal,porrect-stellate,pubescence,rare,rather,ruit,runk,sessile,short-,short-stalked,shorter,size,slit,somewhat,spaced,sparingly,split,spreading,stalked,stamen,stigma,stout-stalked,subcampanulate,subglobose,suture,tamen,tan,terete,thin-textured,tip,tube,ud,unarme,unequal,unit,usually,vary,way,weakly,whitish,wide,ympodial,young	adaxial,arrangement,branching,characteristic,colour,form,growth,height,history,inflorescence,life,midvein,na,ovary,primary,pseudostipule,seed,shape,sparing,staman,texture,ye
101	wfo-0001026994	success	266	125	103	163	22	0.387	-0.7,-30,0.05-0.1,0.4-0.5,0.5,0.5-0.6,0.5-0.7,0.5-0.8,0.5-0.9,0.5-2,1,1-1.4,1-1.5,1-1.6,1.2-1.6,2-2.6,2-5-locular,2.2-3.2,4,4-15,6-20,acuminate,acute,anther,apex,articulate,basal,base,beneath,bifurcate,branched,bright,broadly,brown,calyx,cell,cm,corolla,crenate,dark,darker,deeply,densely,diameter,distal,elliptic,filament,fruit,glabrous,globose,grayish,green,greenish,hair-like,half,herb,imparipinnate,inflorescence,interrupted,irregularly,lanceolate,lateral,leaf,less,lobe,lobed,locule,long,margin,medial,midvein,minutely,mm,narrowly,obovate,outgrowth,ovary,paler,pedicel,peduncle,perennial,petiole,primary,pseudostipule,puberulent,pubescent,purple,rachi,regularly,ripe,stem,stripe,style,surface,tertiary,testa,thick,usually,velvety,wall,white,wide,yellow	-10,-20,-foliate,.2,.5,0.05-0.2,0.1,0.1-0.2,0.1-0.3,0.15-0.2,0.2-0.4,0.2-0.5,0.25,0.3-0.4,0.4-1.2,0.5-1.2,0.5-1.3,0.7-2.5,0.9-1.2,0.9-1.3,1-1.2,1-2,1.2-3.5,1.4-2.1,10-20,12-,2,2-,2-4,2.5-6.5,20-50,3,3-branched,4-celled,5,5-,5-7,7-13,8,8-12,abaxially,absent,abundant,acroscopically,additional,adpressed,along,also,amongst,andscattered,anthesi,apical,apically,appearance,appendage,articulation,basally,basiscopically,becoming,bent,berry,bifurcation,bract,bracteate,broader,capitate,celled,column,conical,crenat,crowded,decreasing,decumbent,decurrent,developed,eaf,ebracteate,edicel,eed,eglandular,erect,especially,essentially,exserted,fewer,flower,fruiting,giving,glandular,gree,habitat,hal,halfway,head,interjected,internode,investing,lamina,large,larger,largest,leaflet,leave,like,lon,loosely,lower,markedly,moderately,much,narrower,narrowing,nearly,nflorescence,node,oblique,occasionally,often,pair,papillate,petiolule,present,rarely,reflexed,robust,rocky,rotate-stellate,secondary,sessile,set,shaggy,short,silky,simple,sinus,size,slightly,sometimes,sparsely,specimen,spreadin,spreading,staminal,sterile,stigma,straight,tall,tem,terminal,tip,toward,trichome,tube,ud,unicellular,uniseriate,unit,weak-walled,well,winged,woody,ympodial,young	abaxial,adaxial,arrangement,branching,characteristic,colour,decurren,form,growth,height,history,length,life,na,plant,seed,shape,staman,texture,unarmed,vein,venation
102	wfo-0001026996	success	188	90	66	122	24	0.351	0.6-1,1-2,1.8-4.4,14-33,15-28,2-3,3-10,3-7,3.3-6,4-8,5-8,6-8,acumen,anther,axillary,berry,blue,brownish,bud,cm,condition,coriaceous,corolla,dark,deep,diameter,distal,drying,elliptic,filament,flower,forked,fresh,fruit,generally,glabrous,globose,green,greenish,half,herb,lanceolate,leaf,lilac,lobe,long,medium,mm,mottled,odd-pinnate,ovate,ovoid,pedicel,peduncle,plant,purple,ripe,seed,stripe,style,subtending,terminal,unwinged,usually,white,whitish	0-6,0.9-2.7,1-3,1-4,1-5,1.2-1.8,1.3-7.7,3-5,3.8-14.1,4-4.4,4.5-10.5,5-merou,6.9-10.9,8.7-18.6,abaxiall,abaxially,acuminate,acute,adaxially,ag,along,alyx,apart,apex,apparently,arranged,articulated,asymmetric,attenuate,axe,base,basiscopic,bead,blade,capitat,cell,clavate,connivent,considerably,covering,decreasing,digestion,dorsally,eaf,edge,eed,enzyme,erec,exceeding,flat,folded,geminat,glabrou,green-white,hair-like,homostylous,honeycomb-shaped,interjected,larger,lateral,leaflet,lengthening,like,linear,living,lower,make,middl,moniliform,mucilaginous,multiple,necklace,nflorescence,orbicular,orolla,pair,pentagonal,perfect,petiole,petiolulate,plurifoliate,pore,poricidal,removed,rotate,rounded,ruit,sessile,seudostipule,side,size,slightly,slit,sometimes,spaced,specimen,stamen,stigma,stolon,straight,subglabrou,symmetric,tall,tamen,tem,testal,thick,throughout,tip,tissue,toward,tri-,tube,tuber,typically,unit,vary,wall,wet,x,yellow,ympodial	2,abaxial,adaxial,arrangement,calyx,characteristic,colour,form,growth,height,history,inflorescence,length,life,na,ovary,perennial,pseudostipule,shape,staman,stem,subglabrous,surface,texture
103	wfo-0001027010	success	198	102	73	125	29	0.369	0.4-5.1,0.5-1.5,1-10,1-2,1.2-1.9,14-46,2.1-4.3,2.2-12.9,3-10,3-8,4-8,5-13,5-14,acuminate,acute,anther,apex,articulated,attenuate,base,brownish,cell,cm,condition,coriaceous,corolla,covering,deep,diameter,distal,drying,elliptic,filament,fresh,fruit,glabrescent,glabrous,green,greenish,hair,hair-like,half,herb,high,lanceolate,lateral,leaf,light,lobe,long,mm,odd-pinnate,ovate,ovoid,pedicel,peduncle,petiole,petiolulate,plant,purple,rounded,scabrous,seed,sessile,short,stripe,style,testal,thick,usually,wall,white,whitish	0-2,0-2.5,0-3,1-4,1-7,1.2-1.7,1.4-6.9,10-60,2-6,2-9.4,2.1-15.3,3-5,3-6,3.5-13.6,4-12,4.4-29,4.9-31,5-merou,abaxially,acumen,adaxiall,adaxially,ag,along,alyx,apart,apparently,arranged,asymmetric,axe,axillary,basiscopic,bead,blade,bud,capitat,clavate,coloration,connivent,decreasing,digestion,dorsally,eaf,edge,eed,enzyme,erec,exceeding,flat,flower,folded,forked,geminat,generally,glabrescen,glabrou,green-white,hal,homostylous,honeycomb-shaped,interjected,larger,leaflet,lengthening,like,living,lower,make,moniliform,mucilaginous,multiple,narrow,necklace,nflorescence,occasionally,orbicular,orolla,pair,pentagonal,perfect,plurifoliate,pore,poricidal,present,removed,ripe,rotate,ruit,scabrou,seudostipule,side,size,slightly,slit,sometimes,spaced,specimen,spot,stamen,stigma,stolon,straight,subequal,subtending,tall,tamen,tem,terminal,throughout,tip,tissue,toward,tri-,tube,tuber,typically,unit,vary,wet,wide,wing,winged,x,yellow,ympodial	2,abaxial,adaxial,arrangement,branching,calyx,characteristic,colour,form,growth,height,inflorescence,length,margin,midvein,na,ovary,primary,pseudostipule,rachi,shape,staman,stem,surface,tertiary,texture,unarmed,vein,venation
104	wfo-0001027019	success	142	88	61	81	27	0.43	0-0.5,1-1.5,1-2,1.5-2,1.5-3,10,10-40-flowered,2-3,2-8,4-5,abaxial,acute,anther,apex,attenuate,base,berry,branched,calyx,cm,corolla,deflexed,deltoid,densely,erect,filament,flattened,glabrate,glabrous,globose,golden,green,inflorescence,leaf,lobe,long,minutely,mm,obovate,onto,ovary,ovoid-reniform,pale,pedicel,petiole,pitted,plant,pubescent,shrub,small,somewhat,sparsely,stem,style,surface,tan,tapering,tree,white,winged,x	.5,/4,0.5-1,1/2,12-30,2-5,4-8.5,7-14,abaxially,abruptly,adaxially,along,anthesi,apparent,ba,bark,bright,capitate,constriction,cyathiform,dia,difoliate,distal,eaf,edicel,eed,ellipsoid,elliptic,even,exserted,fleshy,free,fruiting,geminat,inflorescenc,largely,later,like,live,lobed,lon,lower,major,midrib,minor,narrowed,nflorescence,older,opposite,overlapping,papillo,papillose,planar,pore,poricidal,portion,reddish-brow,rest,ruit,scar,shaped,spaced,stigma,straight,strongly,tall,tear-drop,third,tip,trichome,tub,tube,ud,unit,waxy,way,widest,wing,woody,ympodial,young	adaxial,arrangement,branching,characteristic,colour,diameter,form,fruit,growth,height,length,margin,midvein,na,peduncle,primary,pseudostipule,rachi,reddish-brown,seed,shape,staman,tertiary,texture,unarmed,vein,venation
105	wfo-0001027030	success	234	110	88	146	22	0.376	-11,.5,0.05-0.1,0.3-0.5,0.4-0.5,0.5-0.7,0.5-1,0.6-0.7,0.7-1,0.8-0.9,1,1-,1-1.3,1-3,1.6-2,2-4,2-locular,2.2-3.2,abaxial,acute,anther,apex,articulated,base,branched,bright,brown,calyx,cm,corolla,crenate,dark,decurrent,deeply,densely,denser,diameter,distal,elliptic,entire,evenly,filament,fruit,globose,grayish,green,half,imparipinnate,inflorescence,interrupted,lanceolate,like,lobe,margin,minutely,mm,narrowly,oblique,obovate,ovary,pale,paler,papillate,pedicel,peduncle,perennial,petiole,primary,pseudostipule,pubescent,silky,simple,soft,sometimes,sparsely,spread,spreading,stem,style,surface,tall,tertiary,trailing,truncate,vein,velvety,white,yellow	-15,.2,0-4,0.1-0.7,0.1-0.9,0.15-0.2,0.2,0.2-0.3,0.2-1,0.3-,0.3-0.7,0.4-0.8,0.4-1.5,0.5,0.5-,0.5-0.8,0.6-0.8,0.6-1.8,0.8-1,0.9-1.1,1-1.2,1-3.4,1.2-1.6,1.5-,2-,2-3,2-4.8,2-6,2-7,2-foliate,3-4-celled,3-8,3-9,4-celled,5-12,8-celled,abaxially,absent,abundant,acuminate,adaxially,adpressed,angled,anthesi,apical,appearance,appendage,articulation,axi,basal,basiscopically,beneath,berry,beyond,bract,capitate,cell,column,conical,crenat,crenation,darker,deeper,diamete,due,eaf,edicel,eed,eglandular,exserted,extremely,flower,fruiting,giving,gland,glandular,gree,growt,hair-like,hal,halfway,herb,interjected,internode,interspersed,investing,irregularly,lamina,larger,lateral,leaflet,less,lon,long,longer,loosely,lower,multicellular,near,nflorescence,node,occasionally,often,outgrowth,pair,petiolule,present,pubescence,reflexed,robust,rotate-stellate,ruit,secondary,sessile,similar,size,slender,slightly,small,smaller,somewhat,spreadin,staminal,sterile,stigma,straight,stripe,tem,terminal,testa,thick,tiny,trichome,tube,ud,unicellular,uniseriate,unit,usually,wall,weak,wide,winged,woody,ympodial,young	adaxial,arrangement,branching,characteristic,colour,form,growth,height,history,leaf,length,life,midvein,na,plant,rachi,seed,shape,staman,texture,unarmed,venation
106	wfo-0001027035	invalid_json	199	131	94	105	37	0.472	0.1-0.9,0.3-2.3,0.4-12.8,0.5-7,1-2,1-3.4,1-8,1.8-5.2,10-80,3-10,3-5,4-18,acuminate,acute,anther,apart,apex,articulated,attenuate,axillary,base,blue,brownish,bud,cell,cm,coloration,completely,condition,corolla,covering,deep,diameter,distal,drying,elliptic,filament,forked,fresh,fruit,generally,glabrescent,glabrous,globose,green,green-white,greenish,hair,hair-like,half,herb,high,lanceolate,lateral,leaf,light,lilac,lobe,long,make,medium,mm,mucilaginous,odd-pinnate,ovate,ovoid,pedicel,peduncle,petiole,petiolulate,plant,purple,ripe,rounded,seed,sessile,shape,short,sometimes,spaced,stripe,style,subglabrous,subtending,terminal,testal,thick,throughout,usually,variable,wall,wet,white,whitish	0-36,0-7,0.5-3.4,0.5-5,0.8-3,0.8-4.2,0.9-3.1,1-3,1.5-5.9,1.7-8,2-38,2-7,2.8-10.3,4-18.5,4.9-23.5,5-merou,abaxially,acumen,adaxiall,adaxially,ag,along,alyx,apparently,arranged,asymmetric,axe,basiscopic,bead,blade,capitat,clavate,connivent,decreasing,digestion,dorsally,eaf,edge,eed,enzyme,erec,exceeding,flat,flower,folded,geminat,glabrescen,glabrou,hal,homostylous,honeycomb,interjected,larger,leaflet,lengthening,like,living,lower,moniliform,multiple,necklace,nflorescence,orbicular,orolla,pair,pentagonal,perfect,plurifoliate,pore,poricidal,present,removed,rotate,ruit,second,seudostipule,shaped,side,size,slightly,slit,smaller,specimen,stamen,stigma,stolon,straight,subequal,tall,tamen,tem,tip,tissue,toward,tri-,tube,tuber,typically,unit,unwinged,vary,wide,x,yellow,ympodial	'',2,[,``,abaxial,adaxial,arrangement,branching,calyx,characteristic,colour,form,growth,height,history,inflorescence,length,life,margin,midvein,na,ovary,perennial,primary,pseudostipule,rachi,staman,stem,surface,tertiary,texture,unarmed,value,vein,venation,{,}
107	wfo-0001027050	success	244	120	97	147	23	0.398	-12,-9,0.3-1.5,0.5-3,1-1.5,1-2,1.5-6,10-13.5,2-2.5,2-5,2-8,2.5-3,3-5,5-10,5-9,7-30+,abaxial,acuminate,acute,adaxial,anther,apex,base,berry,branched,broadly,brown,calyx,chartaceous,cm,coarsely,conical,cordate,cuneate,densely,diameter,drying,elliptic,entire,ferruginous,filament,flattened-reniform,fruit,glabrous,glandular-puberulent,green,growth,inflorescence,infructescence,lanceolate,lateral,leaf,leaf-opposed,length,lobe,lobed,long,margin,midvein,mm,moderately,narrowly,numerous,obtuse,often,ovate,pale,pedicel,peduncle,per,petiole,plant,pubescent,ripe,rounded,several,shallowly,shrub,small,sparsely,spherical,stellate-pubescent,stem,style,surface,time,toothed,tree,triangular,truncate,unarmed,unbranched,white,whitish,wide,yellow,yellowish-green	.2,.5,/3,0-0.2,0-3,0.1-0.3,0.1-3,0.2-0.5,0.2-1,0.8,0.9-2.1,1,1.5-2,12-15,15-50+,2-3,2-4,4-20,4-8,5,5-6,5-7,5-merous,50,6-8,8-26,abaxially,absen,absent,abundant,adaxiall,adult,alyx,andromonoeciou,apar,arme,articulated,axe,bark,basal,blade,branch,broad,broad-based,brow,capitate,closely,connivent,curved,deeply,difoliate,directed,distal,distall,distally,eaf,eed,eglandular,equal,erec,erect,except,flattened,flower,free,fruiting,geminat,hair,half,heterostylous,inside,interpetalar,juicy,juvenile,larger,least,less,like,long-styled,longer,lower,markedly,mature,mid-way,midpoint,midrib,minute,minutely,moist,mucilaginous,multiseriate,near,nflorescence,oblique,occasionally,older,orolla,oung,ovate-lanceolate,papillat,pericarp,pore,poricidal,porrect,portion,present,prickle,pricklier,prickly,ray,rest,ruit,scar,scattered,secondary,sessile,shiny,short-stalked,short-styled,shorter,side,slightly,somewhat,spaced,stalk,stalked,stellate,stigma,straight,tall,tamen,terete,thicker,tip,tissue,touching,trichome,tube,unit,usually,vary,way,weakly,woody,ympodial,young,younger	armed,arrangement,branching,characteristic,colour,corolla,form,height,history,life,na,ovary,perennial,primary,pseudostipule,rachi,seed,shape,staman,tertiary,texture,vein,venation
108	wfo-0001027050	success	234	132	110	124	22	0.47	0.5-1,0.5-3,1-1.5,1-2,1-5,1.5-2,1.5-6,10-13.5,11-21,14-20,2-10,2-2.5,2-3,2-3-locular,2-5,2-8,2.5-3,3-15,3-5,5,5-10,5-9,7-30+,acuminate,acute,anther,apart,apex,armed,articulated,base,branched,broadly,brown,calyx,chartaceous,cm,coarsely,contiguous,cordate,cuneate,densely,diameter,distally,drying,elliptic,entire,extra-axillary,ferruginous,filament,flattened,flower,forked,fruit,glabrous,glandular-puberulent,globose,green,growth,hair,inflorescence,lanceolate,leaf,leaf-opposed,length,like,lobe,lobed,margin,markedly,midvein,minutely,mm,moderately,narrowly,nearly,obtuse,often,ovate,pale,pedicel,peduncle,per,petiole,pitted,plant,rachi,rounded,shallowly,shrub,simple,small,spaced,sparsely,stellate-pubescent,stem,style,surface,thicker,toothed,tree,triangular,truncate,unarmed,unbranched,white,whitish,x,yellow,yellowish-green	.2,0-0.2,0-0.5,0-1,0-3,0.1-3,0.2-0.6,0.2-1,0.3-0.6,0.4-1,0.5-0.8,0.8,10-30,12-15,15-50+,16-40,2-4,2-6,2-foliate,23-40+,4-19,4-40,4-8,5-6,5-7,5-merous,6-8,8-26,8-40+,abaxially,absen,absent,abundant,accrescent,across,adaxiall,adaxially,adult,andromonoecious,anvil-shape,axe,ba,blade,branche,broad-based,capitat,connivent,cross-section,curved,cylindrical,deeply,directed,distall,distributed,eaf,eed,eglandular,erect,except,exocarp,fruiting,functional,geminat,half,held,interpetalar,juicy,juvenile,lateral,less,long,longer,lower,mature,mesocarp,midpoint,minute,moist,mucilaginous,multiseriate,nflorescence,oblique,orolla,ovate-lanceolate,pair,pinnatifid,placenta,pore,porrect,present,prickle,ray,ruit,scattered,sessile,shorter,side,slightly,somewhat,stalk,stalked,stellae,stellate,stigma,straight,tal,tamen,tem,thick,throughout,time,tip,tissue,tube,unarme,unit,upper,upright,usually,vary,weakly,wide,ympodial,younger	abaxial,adaxial,arrangement,branching,characteristic,colour,corolla,form,height,history,life,na,ovary,primary,pseudostipule,seed,shape,staman,tertiary,texture,vein,venation
109	wfo-0001027091	success	142	112	80	62	32	0.563	1-1.6,1.1-1.6,1.8-2.6,1/2-2/3,2.3-2.9,2.5-3.5,3-8,3-9,5-11,6-10,9-13,acute-tipped,along,annual,anther,armed,base,berry,blade,blue,branched,bristly,broadly,brown,calyx,cm,dark,densely,developing,dm,extended,few-rayed,fully,glabrous,gland,glandular,green,hair,herb,internodal,invested,lenticular,linear-lanceolate,lobe,long,low,main,mm,near,oriented,ovate,pedicel,petiole,pinnatifid,pinnatisect,prickly,radially,reticulately,ridge,scattered,sessile,short-stipitate,simple,sometimes,sparsely,spherical,spreadingly,stellae,stem,strait,surface,tightly,tube,twice,undulate,usually,variously,vein,violet,wrinkled	.3,0.7,0.8,30-60,4-10,6-10-flowere,8.5-11.5,accrescent,across,alyx,anthesi,arcuate,beneath,campanulate,capitate-glandular,cauline,deltoid,dia,difoliate,divided,dry,eaf,eed,enveloped,geminat,high,lon,longer,maturity,mostly,narrowly,nflorescence,obtuse,occasionally,orolla,per,rounded,ruit,short,slende,somewhat,splitting,ste,stellate-pentagonal,suffused,tamen,tapering,taprooted,terete,terminally,tigma,tub,tyle,unexpande,uniseriate,unit,vary,vestiture,wholly,yello,ympodial,younger	6-10-flowered,abaxial,adaxial,arrangement,branching,characteristic,colour,corolla,diameter,filament,form,fruit,growth,height,history,inflorescence,leaf,length,life,na,ovary,peduncle,plant,rachi,seed,shape,slender,staman,style,texture,unarmed,various
110	wfo-0001027102	success	167	117	88	79	29	0.527	.5,0.2-2,0.5-1,0.5-2,1-1.5,1-2,1-2.5,1-4,1-6,1.5-2,10-20,15-35,2-3,3,3-4,4-5,4-7,abaxially,acuman,acuminate,acute,adaxial,adaxially,almost,anther,apart,apex,articulated,base,broadly,calyx,ciliate,cm,congested,cuneate,curved,cylindrical,deltate,densely,diameter,elliptic,entire,filament,flattened,flower,forked,fruit,glabrous,globose,hair,lanceolate,leaf,leaf-opposed,lobe,long-tapered,margin,mm,moderately,narrowly,obtuse,orange,pedicel,peduncle,petiole,pubescent,rachi,rarely,ripe,rugulose,short,shrub,simple,slender,small,somewhat,spaced,sparsely,stem,straight,style,surface,tip,tomentose,truncate,unbranched,white,x,yellow-brown	.5-6,0.5,0.5-3,1-3,15,2-2.5,3-12,3-5,5-12,<,absen,absent,accrescent,adaxiall,ag,aggregate,alyx,appearance,axe,ba,blade,broad,cell,channe,chartaceous,connivent,corky,differing,difoliate,dimorphic,directed,distally,eaf,eed,few-,free,fruiting,geminat,giving,ilament,long,longitudinal,m.,major,minor,multiseriate,nflorescence,oblong,often,one,opening,orolla,ovate,per,perfect,pore,portion,roughened,ruit,size,slit,stellate,stigma,stone,subcoriaceous,tal,tem,time,triangular,truncat,tube,unarme,unit,usually,vary,wide,yellow,ympodial,young	abaxial,arrangement,branching,channel,characteristic,colour,corolla,form,growth,height,history,inflorescence,length,life,midvein,na,ovary,plant,primary,pseudostipule,seed,shape,staman,tertiary,texture,unarmed,vein,venation,ye
111	wfo-0001027104	success	141	86	57	84	29	0.404	0.15-0.35,1-1.5,1-3,1-4,1.2-6,1.5-2.3,10-15,2-3,2.2-5,3-5.5,5-15,6-7.5,acute,articulate,branched,calyx,cell,cm,corolla,covering,cyme,diameter,dichasial,dichasially,ebracteate,filament,finely,globose,green,green-white,hair-like,herbaceous,lateral,lobe,long,mm,monochasial,mucilaginous,mucronate,odd-pinnate,ovate,ovoid,pedicel,peduncle,perennial,petiole,plant,pubescent,seed,style,testal,thick,throughout,tone,wall,white,yellow-green	0.5-0.8,1.5-4.2,2-6,3-6-foliat,4-15,abaxially,acumen,acuminate,adaxially,apex,apical,apically,attenuate,base,condition,connate,cordate,dehiscent,digestion,distal,dorsally,eaf,edge,eed,emoval,enzyme,epiphyti,epiphytic-like,exceeding,flat,flower,folded,forked,generally,globo,growing,half,honeycomb,introrse,linear,living,lon,lower,make,maturing,mos,narrowly,nflorescence,nther,often,orolla,ovat,pattern,perfect,plan,poricidally,proximal,rarely,reveal,ruit,seudostipule,short,simple,slit,specimen,stamen,stellate,stigma,straight,tall,tem,terrestrial,throughou,truncate,tuber-bearing,typically,unit,vary,viole,wide,without,yellow,ympodial,Â¼	2,abaxial,adaxial,anther,arrangement,branching,characteristic,colour,form,fruit,growth,height,history,inflorescence,leaf,length,life,na,ovary,pseudostipule,rachi,shape,staman,stem,surface,texture,unarmed,violet,wet
112	wfo-0001027114	success	154	69	48	106	21	0.312	-2,0.5-1,1-1.1,1-1.2,1-1.5,1.5-2,2-2.5,2-3,3-4,3-7,6-8,abaxial,acute,anther,apex,appearing,base,berry,calyx,cm,corolla,dark,deltate,densely,elliptic,filament,glabrous,green,inflorescence,leaf,lobe,margin,minutely,mm,opposite,ovary,pedicel,petiole,pitted,pubescent,reddish,reddish-brown,shoot-terminal,shrub,stem,style,surface,white	-17,-30,.5,1-2,1.5-1.7,1/2,13-21,20-40,5,6-9,7-10,7-9,abaxially,adaxially,along,alternating,anthesi,apar,axillary,ba,bark,branched,bushy,capitate,closely,commonly,conical,dendritic,dia,differing,difoliate,drying,due,eaf,edicel,eed,erect,exserted,flattened-reniform,flowered,free,fruiting,geminate,glabrou,globose,growt,halfway,inflorescenc,investing,lamina,lateral,like,lobed,lon,long,lower,main,major,many,minor,minute,nflorescence,occasionally,older,opening,pair,papillo,planar,plurifoliate,pore,poricidal,portion,projection,rapid,rest,ruit,scar,scattered,several,shoot,simple,size,slit,soft,spaced,stigma,tall,tapering,thickened,time,tip,triangular,trichome,tub,tube,ud,unevenly,uniseriate,unit,vein,way,wide,woody,yellowish,ympodial,young	0.5,characteristic,colour,diameter,form,fruit,growth,height,history,length,life,peduncle,perennial,plant,rachi,seed,shape,staman,texture,type,width
113	wfo-0001027117	success	235	111	88	147	23	0.374	-12,0-25,0-5,0.1-0.7,0.6-0.9,0.7-1.3,0.7-1.5,1-2,1.5-2.3,1/3,2-3,2.3-2.8,4-6.5,4-8,4.5-6.5,5-11,acute,almost,anther,apex,articulated,attenuate,base,berry,black,branched,brown,calyx,cell,chartaceous,cm,cordate,dark,densely,diameter,erect,evenly,filament,fine,fruit,glabrous,green,herb,lateral,leaf,length,lobe,lobed,lower,margin,maturity,mauve,midvein,mm,narrow-deltate,narrow-lanceolate,outline,ovate,pair,pale,pedicel,peduncle,per,petiole,pit,prickly,primary,raised,rounded,shallowly,small,smooth,sparsely,spherical,staman,stellate-pubescent,stem,style,surface,tertiary,unit,upper,vein,venation,visible,yellow,yellow-green,young	-1.5,-11,-2.8,-3/4,.5,/3,0-10,0-15,0-20,0-40,0.1,0.1-,0.15-0.25,0.15-0.35,0.2,0.2-0.45,0.5,0.5-1.5,0.7-0.9,0.8-,1-4,1-6,1.2,1.5-,1.5-6.5,1.7-2.5,1.8-2.5,1/,1/4,1/8-1/2,10-20,2-6,2-8,25-100,3-10,3-15,3-6,4-7,4.5-8,5-14,5-merous,6-10,6-9,7-,8,abaxially,accrescent,acicular,alyx,ame,apar,apart,apically,apparently,bark,beyond,blade,brittle,c.,concolorous,connivent,curved,deltate,discolorous,distance,drying,eaf,eed,elongating,enclosing,extending,fifth,flattened-reniform,flower,four,free,fruiting,gently,glabrescent,gra,herbarium,infructescence,irregularly,less,lon,long,long-acuminat,longer,mature,membranous,midpoint,moderately,narrow-elliptic,nflorescence,oblong,obovate,older,one,open,orolla,oung,pendulous,perfec,pericarp,perpendicular,plurifoliat,poricidal,porrect,portion,prickl,prickle,ray,red-brown,reduced,reflexed,ruit,scar,sessile,shiny,shorter,side,sometimes,spaced,specimen,spreading,stalk,stalked,stellate,straight,tamen,tapering,tearing,terete,time,tip,tissue,translucent,trichome,tube,unequal,variously,vary,way,weakly,wide,woody,ympodial	1.5-2.5,abaxial,adaxial,arrangement,branching,characteristic,colour,corolla,form,growth,height,inflorescence,na,ovary,plant,plurifoliate,rachi,seed,shape,sympodial,texture,type,unarmed
114	wfo-0001027123	success	181	111	88	93	23	0.486	-10,0.8-1.3,1,1-1.2,1-1.5,1.5-2,2-2.6,2-5.5,2.5-4,2.5-6,3-4,4-5,4-6,5-10,5-6,abaxial,acute,adaxial,adaxially,anther,apex,attenuate,base,branched,broadly,brown,calyx,cell,cm,commonly,conical,corolla,dark,deltate,densely,diameter,elliptic,filament,flattened,glabrous,inflorescence,leaf,less,lobe,long,loosely,margin,mauve-purple,midvein,minute,minutely,mm,narrowly,nodding,outline,ovary,pair,papillate,pedicel,peduncle,petiole,pitted,primary,pubescent,reddish,reniform,revolute,scattered,shining,shiny,simple,sinuate,sparsely,stem,stoutish,strongly,style,subshrub,surface,terminal,testal,time,trichome,turned,vein,violet,white,x	-20,.3,.5,0.3-1.6cm,0.5,0.5-0.8,0.7-3.5,0.9-1.3,2-2.2,2-2.5,2-3,2-lobed,2.5-10.4,3-15,along,anthesi,appearing,axe,axi,bark,bright,campanulate,clavate,completely,constricted,coriaceous,cup-shaped,darker,dendritic,denser,drying,eaf,edge,eed,enlarged,erect,exerted,fide,flower,free,fruiting,glandular,globose,green,inserted,lamina,lax,lewi,like,lobed,lon,loose,lower,monopodia,nflorescence,older,papillae,perfect,perhaps,petal,planar,plurifoliate,portion,prominent,scar,scatted,shin,shinin,short,sleeve,slightly,sometimes,soon,spaced,stellate,stigma,straight,thick,tip,trailing,tub,tube,ud,unit,upper,usually,warty,way,widely,wood,ympodial,young,Â¾	0.3-1.6,arrangement,branching,characteristic,colour,form,fruit,growth,height,history,length,life,na,plant,pseudostipule,rachi,seed,shape,staman,tertiary,texture,unarmed,venation
115	wfo-0001027146	success	213	140	111	102	29	0.521	0.3-2.2,0.7-2.4,0.8,1-10,1-2,1-2.5,1-9.5,10,13-36,2-13,2-4.2,3.3-6.1,4-11,4-12.5,4-38,4-8,6,6-10,6-17.5,abaxially,acuminate,adaxially,anther,apart,apex,articulated,attenuate,axillary,base,berry,brownish,bud,cell,chartaceous,cm,coarsely,condition,conical,corolla,covering,dark,deep,diameter,distal,drying,elliptic,filament,finely,flower,forked,fourth,fresh,fruit,generally,glabrous,green,green-white,greenish,hair,hair-like,half,herb,lateral,leaf,like,lobe,long,make,margin,medium,membranous,minute,mm,mottled,mucilaginous,odd-pinnate,ovate,ovoid,pedicel,peduncle,petiole,petiolule,plant,proximal,puberulent,pubescent,purple,ripe,seed,simple,spaced,stem,style,subglabrous,subsessile,subtending,terminal,testal,thick,throughout,tinged,unwinged,usually,violet,wall,wet,white,whitish,wide,wing,x	0-11,0.5-3.2,0.6-3.3,0.8-3.1,0.8-5.8,1.9-10,2-12.2,2-5,3.5-22,5-merou,6.5-52,acumen,ag,along,alyx,apparently,arranged,asymmetrical,axe,basiscopic,bead,blade,capitat,ciliate,clavate,commonly,connivent,darker,decreasing,digestion,dorsally,eaf,edge,eed,enzyme,erec,especially,exceeding,flat,folded,fourt,geminat,glabrou,gradually,homostylous,honeycomb-shaped,interjected,lanceolate,leaflet,lengthening,living,lower,midrib,minutely,moniliform,multiple,necklace,nflorescence,orbicular,orolla,pair,pentagonal,perfect,plurifoliate,pore,poricidal,rarely,ray,removed,rotate,ruit,secondary,semierect,sessile,seudostipule,side,size,slit,sometimes,specimen,stamen,ste,stigma,stolon,straight,subequal,subglabrou,symmetrical,tall,tamen,tem,tip,tissue,toward,tri-,tube,tuber,typically,unit,vary,yellow,ympodial	abaxial,adaxial,arrangement,branching,calyx,characteristic,colour,form,growth,height,history,inflorescence,length,life,midvein,na,ovary,perennial,primary,pseudostipule,rachi,shape,staman,surface,tertiary,texture,unarmed,vein,venation
116	wfo-0001027157	invalid_json	207	104	68	139	36	0.329	0.15-0.3,0.9-2.8,1,1-2,1-3,1-6,1.5-6.5,10-30,2,2-2.5,2-3,2.5-3,3-7,4-5,9-12,acuminate,acute,anther,apex,attenuate,base,berry,brownish,chartaceous,cm,condition,conical,cordate,corolla,densely,diameter,drying,filament,fresh,fruit,glabrous,green,greenish,herb,leaf,lobe,long,margin,membranous,mm,mucilaginous,oblique,odd-pinnate,orbicular,ovate,ovoid,pedicel,peduncle,petiole,plant,puberulent,pubescent,ripe,rounded,seed,sometimes,stem,style,tinged,violet,wet,white,whitish	0-3,0.7-2,1-10,1-3.8,2-15,2-5,2.3-4,3-12,3.3-7.8,3.8-8.3,5-merou,6.5-14.5,abaxially,absent,acumen,adaxially,ag,along,alyx,among,apart,apparently,articulated,axe,axillary,blade,broadly,bud,capitat,cell,ciliate,clavate,connivent,covering,cuneate,decreasing,decurrent,deeply,digestion,distal,dorsally,eaf,edge,eed,elliptic,end,enzyme,erec,especially,exceeding,flat,flower,folded,forked,geminat,generally,glabrou,grassland,greatly,green-white,hair,hair-like,half,homostylous,honeycomb-shaped,interjected,lanceolate,lateral,leaflet,lengthening,like,living,low-growing,lower,make,markedly,middl,midrib,minutely,narrowly,nflorescence,obtuse,one,orolla,pair,perfect,petiolulate,petiolule,placed,plurifoliate,pore,poricidal,rarely,removed,ruit,semi-rosette,sessile,seudostipule,shady,short,situation,size,slightly,slit,spaced,specimen,stamen,ste,stellate,stigma,stolo,straight,subsessile,subtending,sunny,tall,tamen,tem,terminal,testal,thick,throughout,tip,toward,tri-,tube,tuber,typically,unequal,unit,unwinged,usually,vary,wall,wide,woodland,x,yellow,ympodial	'',[,``,abaxial,adaxial,arrangement,branching,calyx,characteristic,colour,form,growth,height,history,inflorescence,length,life,midvein,na,ovary,perennial,primary,pseudostipule,rachi,shape,staman,surface,tertiary,texture,unarmed,value,vein,venation,width,{,}
117	wfo-0001027184	success	219	140	120	99	20	0.548	.3,.5,.7,.8,0-0.2,0.2-0.4,0.4-2,0.8,13â18,19,1â2,1â4,2,2â4-celled,3-4-,3.5â8,3â,4,5,5-7,7,abaxially,acute,adaxially,along,anther,apex,axi,axillary,base,blue,borne,bract-like,brown,calyx,cm,covered,cylindrical,densely,diameter,entire,epidermal,especially,extension,filament,flattened,fleshy,flower,foliaceous,fruit,generally,glabrescent,glabrous,globose,hair,hairlike,half,herbaceous,imparipinnate,lanceolate,leaf,leaflet,leafy,least,light,lobe,long,lower,margin,membranous,meter,midrib,mm,mostly,obtuse,older,orange,pedicel,peduncle,per,petiole,pilose,plurifoliate,prominently,pseudostipule,pubescent,rachi,raised,rarely,red,reticulate,revolute,ripe,several,shape,shoot,short,simple,slightly,small,soft-woody,somewhat,sparsely,stem,straight,style,sulcate,surface,tertiary,truncate,unbranched,unequal,unit,vein,vine,wall,white,x,young,â9	0-,0.4â0.9,0.5-2,0.8â1.6,0â3,1-2,1.5,1.5-5,1.8â3.5,1â2.5,2.8â4.1,3-foliolate,3â4-celled,4â12,9,absent,accrescent,adaxiall,adventitious,ag,always,alyx,apart,appressed,articulated,axe,ba,basal,blade,branch,broad,broadly,cell,chartaceous,clavat,cluster,connivent,cordat,directed,eaf,eed,elliptic,fasciculate,free,fruiting,geminat,glabrou,grading,ilament,introrsely,larger,largest,lateral,less,like,longitudinal,m.,minutely,much,narrowly,nearly,nflorescence,node,oblong,often,opening,opposite,orolla,ovate,ower,petiolule,pore,portion,prominent,puberulent,root,ruit,scarcely,secondary,size,slit,spaced,stellate,stigma,subopposite,terminal,tightly,tip,tree,trunk,tube,unarme,uniform,usually,vary,visible,weak,yellow,ympodial	arrangement,branching,characteristic,colour,cordate,corolla,form,growth,height,history,inflorescence,length,life,ovary,plant,seed,staman,sympodial,texture,unarmed
118	wfo-0001027186	success	168	102	77	91	25	0.458	1-1.5,1-2.5,1.4-1.6,1.5,1.5-2,1.5-2.5,15,2-6,3.5-4,5-10,6-7,9-10,abaxial,acute,anther,anthesi,apex,attenuate,base,berry,brown,calyx,cm,conical,corolla,dark,deflexed,deltate,dendritic,densely,diameter,elliptic,entire,filament,filiform,fruit,glabrous,globose,green,growth,keeled,less,lobe,longer,margin,minutely,mm,much,narrowly,new,ovary,ovoid,pair,pale,pedicel,peduncle,petiole,pitted,primary,pubescent,rachi,reddish,reniform,seed,shiny,simple,slightly,sparsely,stem,style,surface,terminal,tree,vein,white,x,yellow	-6,.4,.5,0.5-1,1.6-5,2-lobed,2.5-3,3-4,30-40,4-15,4-9,?,abaxially,adaxially,age,always,apart,apparently,axil,bark,branch,branched,broadly,clavate,dbh,denditic,denser,dry,eaf,ellipsoid,enlarging,exerted,flower,free,fruiting,glabrescent,golden,immature,incrassat,irregularly,lamina,lengthening,like,lobed,loose,lower,m.,maturity,midrib,nflorescence,occasionally,papillat,papillate,pendent,perfect,pericarp,planar,plane,plurifoliat,pointed,pore,poridical,portion,pubescen,rough,ruit,scar,scattered,short,slit,small,soon,spaced,spreading,stalk,stigma,straight,strongly,time,tip,treelet,trichome,tub,tube,ud,uniseriate,unit,variably,way,woody,ympodial	2,adaxial,arrangement,branching,characteristic,colour,form,height,history,inflorescence,leaf,length,life,midvein,na,perennial,plant,pseudostipule,shape,staman,tertiary,texture,unarmed,variously,venation
119	wfo-0001027198	success	191	123	93	98	30	0.487	.5,0.5-1,0.8-1,1-1.5,1-10,1.5-10,1.5-2,10-11,5-6,abruptly,acuminate,acute,anther,apex,attenuate,axil,base,beneath,berry,broadening,calyx,channeled,cm,complex,corolla,deltoid,dendritic,densely,dia,elliptic,entire,extremely,filament,flower,furcate,glabrate,glabrous,globose,golden,green,impressed,inflorescence,large,lateral,leaf,like,lobe,long,main,many,margin,minute,minutely,mm,obovate,often,opposite,ovary,ovoid-reniform,pale,paler,pedicel,petiole,pitted,plant,puberulent,pubescent,rounded,set,shining,short,shrub,simple,slender,slightly,speciman,stem,style,styled,surface,tannish-yellow,testae,thin,time,trichome,tube,two,type,vein,white,x,yellowish,young	.4,0.05-1.0,0.5-0.75,0.7-1,1-5,11-20,2-5.5,3/4,4-9,5-120-flowered,7.5-9,always,anthesi,apart,ba,beginning,bushy,caly,clavate,closely,constriction,corky,corresponding,cyathiform,decurrent,differing,difoliate,dry,eaf,edge,edicel,eed,erect,evenly,exserted,eye,female,found,free,fruiting,geminat,inflorescenc,invisible,live,lobed,lon,lower,major,male,medium,meet,middle,minor,naked,nearly,nflorescence,older,overlapping,ovoid,papillo,papillose,pendan,planar,pore,poricidal,portion,pubescence,rather,reddi,reflexed,rest,ruit,scar,sessile,shaped,size,small,soon,spaced,specimen,stigma,straight,strong,tall,tear-drop,thickened,tip,top,tree,ud,undersurface,uniseriate,unit,usually,way,widest,woody,ympodial	5,abaxial,adaxial,arrangement,branching,characteristic,colour,diameter,form,fruit,growth,height,history,length,life,midvein,na,peduncle,perennial,primary,pseudostipule,rachi,reddish,seed,shape,staman,tertiary,texture,unarmed,venation
120	wfo-0001027200	success	139	106	88	51	18	0.633	0.05-0.25,0.25-0.5,0.5-0.75,0.5-1,0.6-1,0.7-2.5,1-1.4,1-1.5,1.2-1.5,1.5-2,1.5-5,1.6-6,2-3,2.5-3,3-3.5,3.5-6,6-8,8-15,9-11,acute,anther,apex,bark,base,berry,brown,calyx,capitate,cm,corolla,dark,decurrent,deeply,deflexed,deltoid,densely,dia,elliptic,filament,free,fruiting,glabrous,globose,golden,grey-brown,horizontally,inflorescence,lateral,leaf,lobe,main,minor,minute,minutely,mm,onto,ovary,ovoid-reniform,papillose,pedicel,petiole,pitted,poricidal,portion,puberulent,shrub,size,slightly,small,sparsely,spreading,stem,stigma,straight,style,surface,tip,tree,trichome,tube,unicellular,unifoliate,uniseriate,vein,white,widened,woody,x	across,anthesi,aspec,ba,beneath,branch,branche,broadly,conical,converging,differing,eaf,eed,except,flattened,geminate,giving,green,impressed,lightly,like,lobed,lon,long,lower,major,margin,middle,near,nearly,node,non-reproductive,occasionally,older,papillo,planar,pore,prominent,reflexed,rest,ruit,shaped,sparse,tall,tear-drop,unit,widest,winged,yellowish,ympodial,young	arrangement,branching,characteristic,colour,diameter,form,fruit,growth,height,length,na,plant,pubescence,seed,shape,texture,type,venation
121	wfo-0001027213	success	231	123	98	133	25	0.424	-19,-230,-3.3,-4.5,0-160,0-2.5,0.2-0.4,0.2-0.5,0.7-2.3,0.8-1.8,1-5,1.2-1.6,1.2-2.5,1.3-2.2,12.3-16.3,2-5,2.9-3.8,2.9-4.8,2/3,4-9.5,5-8,5.7-6.2,8.2-10.5,9-13,abaxially,acuminate,acute,adaxially,anther,anthesi,apart,apex,articulated,attenuate,basal,base,branched,broadly,cm,conical,corolla,cuneate,dark,deltoid,diameter,elliptic,entire,filament,flower,fruit,glabrescent,glabrous,globose,green,hair,immature,leaf,length,long,long-stalked,margin,midrib,mm,multangulate,oblanceolate,obovate,orbicular,pale,pedicel,peduncle,petiole,porrect-stellate,pubescent,rachi,reniform,reticulate-punctate,scabrous,short-,short-attenuate,short-stalked,shrub,side,simple,spaced,sparsely,style,surface,tomentose,tomentose-pubescent,tree,unarmed,vein,violet,white,whitish-green,x,yellow-green,yellow-tan	/10,1-2,1.1-1.7,1.2-1.7,1.7-3.6,1.7-3.9,1.8-2.8,1.8-3.2,1/2-2/3,10-24,2.4-4.7,2.5-5.1,3.5-5,3.5-8,4.2-5.9,5-7.5,5-merou,8-24,accrescent,ag,along,alyx,apparently,ark,around,axe,axillary,ba,blade,blunt-tipped,branch,brown,calyx,capitat,cell,completely,covering,cylindrical,decurrent,directed,distally,drying,eaf,early,edge,eed,enveloping,epidermal,eventually,exserted,farinose,few-rayed,free,fruiting,glabrescen,granular,grayish-brown,group,high,homostylous,inserted,lackin,lanceolate,lateral,lengthening,lobe,lobed,long-,longitudinal,lower,m.,main,many,mixed,moderately,mostly,multangulat,nearly,nflorescence,obscured,obtuse,often,older,orolla,ovate,ovate-lanceolate,partly,perfect,plurifoliate,pore,poricidal,porrect-stellat,prominent,pseudo-terminal,pubescence,rather,relatively,ruit,sessile,short,slit,sometimes,somewhat,stamen,stellate,stem,stigma,subcampanulate,suture,tamen,terete,thick,thick-stalked,thin-stalked,ti,time,tip,tomentu,touching,tube,ud,unarme,unit,unwinged,vary,vestigial-rayed,way,whitish,wide,yellow,yellowish,ympodial,young	1,abaxial,adaxial,arrangement,branching,bud,characteristic,colour,form,growth,height,history,inflorescence,life,midvein,na,ovary,plant,primary,pseudoterminally,seed,shape,staman,texture,true
122	wfo-0001027214	success	181	95	71	110	24	0.392	.5,0.5-0.8,0.5-1,0.7-2.5,1-1.5,1.5,1.5-1.8,10-13,2,2-9,abaxially,adaxially,anther,apex,apical,base,berry,broadly,calyx,climbing,cm,conical,corolla,deltate,densely,diameter,elliptic,erect,filament,finely,flattened-round,fruit,glabrous,green,greenish,grown,height,herb,inflorescence,length,lobe,long-acuminate,long-conical,margin,mm,oblique,occasionally,once-branched,ovary,papillate,pedicel,petiole,pinnate,pointed,projection,pubescent,rachi,rugose,rugosity,scrambling,seed,sharply,simple,somewhat,style,surface,triangular,truncate,vein,white,x	-20,-38,-9,..,.25,0,0-16,0.25,0.3-1.5,0.3-1.7,0.7-2,0.8-1,1-2.8,1.2-3,1.5-6,10-,12-17,15-25,3-,3-6,4-5,5-6,6-,6-12,7-12,8-9,absent,acuminate,acute,along,anthesi,anticlinal,basal,capitat,cell,composed,conspicuously,decurrent,dr.,drying,eaf,edicel,eed,epidermal,exserted,extending,flower,free,fruiting,globose,groove,horizontal,inflorescenc,irregular,lamina,lanceolate,lateral,leaflet,less,like,lobed,lon,long,lower,markedly,midrib,minutely,narrowly,nearly,nflorescence,noddin,nodding,obovate,often,onto,open,opposite,pair,paired,papilla,per,perfectly,petiolule,poricidal,portion,reflexed,rest,ruit,scar,scattered,sinuous,smaller,stigma,tem,terminal,thickening,time,tip,trichome,tub,tube,ud,unevenly,unifoliat,uniseriate,unit,white-lenticellate,whitish,without,ympodial	.0,2.0,abaxial,adaxial,arrangement,branching,characteristic,colour,form,growth,leaf,midvein,na,peduncle,plant,primary,pseudostipule,shape,staman,stem,tertiary,texture,unarmed,venation
123	wfo-0001027219	success	143	126	111	32	15	0.776	.5,/4,0.3,0.4-0.6,0.5,0.5-0.8,1,1-15,1-2,1-3,1.5-2,2,2-2.5,2-3,2-3.5,2-4,3-5,6-8,7-8,absent,acuminate,acute,age,anther,anthesi,apex,axillary,bark,base,berry,bright,broadly,brown,calyx,capitate,cm,conical,corolla,cup-shaped,deltate,densely,diameter,edge,elliptic,entire,erect,filament,flower,fruiting,glabrescent,glabrous,green,greyish,growth,hard,known,leaf-opposed,lengthening,less,lobe,lobed,long-conical,long-styled,margin,maturity,minutely,mm,new,ovary,pair,pale,papillose-pubescent,pedicel,peduncle,pendent,pericarp,petiole,planar,pore,poricidal,primary,pubescent,purple,shoot,short,short-styled,shrub,simple,slightly,slit,soon,stem,stigma,stout,style,surface,terminal,thickened,tip,trichome,tube,tuft,uniseriate,vein,violet,way,weight,white,woody,x,â1/3	1.5-2.5,3-6,berr,c.,closely,completely,drying,eaf,eed,exerte,exfoliatin,free,glabrou,globose,heterostylous,lower,nflorescence,overlappin,papillo,plurifoliat,pointed,portion,ruit,scar,sharply,sometimes,somewhat,spaced,ud,unit,yellowish,ympodial	arrangement,characteristic,colour,form,fruit,height,inflorescence,leaf,length,mentioned,papillose,plant,seed,shape,texture
124	wfo-0001027223	invalid_json	189	121	83	106	38	0.439	0.19-0.75,0.3-1.2,1-2,1.8-3.5,16-41,3-10,3-11,3-5.2,3.5-4,3.7-9.3,4-6,5-8,9-35,acuminate,anther,apex,articulated,attenuate,base,berry,brownish,cell,cm,condition,conical,corolla,covering,deep,densely,diameter,distal,dot,drying,elliptic,filament,flower,forked,fresh,fruit,glabrous,green,greenish,hair,hair-like,half,herb,hyaline,lanceolate,lateral,leaf,light,like,lobe,long,make,middle,mm,mucilaginous,odd-pinnate,ovoid,pedicel,peduncle,petiole,petiolulate,plant,pubescent,purple,ripe,rounded,seed,sessile,short,shortly,sometimes,stripe,style,testal,thick,usually,wall,wet,white,whitish	.5,1-3,1.3-2,1.5-3.5,2-4,2-7,3-5,3.5-6,3.5-7,5-10,5-21,5-merou,5.9-12.2,9-15,9-22,abaxially,acumen,adaxiall,adaxially,ag,alyx,apart,apparently,asymmetric,axe,axillary,basiscopic,blade,bud,capitat,clavate,connivent,decreasing,digestion,dorsally,eaf,edge,eed,end,enzyme,erec,exceeding,flat,folded,geminat,generally,glabrou,green-white,hal,homostylous,honeycomb-shaped,interjected,larger,leaflet,lengthening,living,lower,nflorescence,one,orbicular,orolla,ovate,pair,pentagonal,perfect,placed,plurifoliate,pore,poricidal,present,removed,rotate,ruit,seudostipule,side,size,slightly,slit,spaced,specimen,stamen,ste,stigma,stolo,straight,subequal,subtending,tall,tamen,tem,terminal,throughout,tip,tissue,toward,tri-,tube,tuber,typically,unit,unwinged,vary,wide,x,yellow,ympodial	'',2,[,``,abaxial,adaxial,arrangement,branching,calyx,characteristic,colour,form,growth,height,history,inflorescence,length,life,margin,midvein,na,ovary,perennial,primary,pseudostipule,rachi,shape,staman,stem,surface,tertiary,texture,unarmed,value,vein,venation,{,}
125	wfo-0001027237	success	122	96	67	55	29	0.549	.5,0.5-1,1-1.2,1.5-2,1.5-2.5,2-3,3-3.5,3-4,30-100-flowered,6-11,6-8,8,anther,apiculae,apiculate,bark,base,berry,black,branched,broadly,brown,calyx,cm,completely,corolla,dark,deflexed,deltoid,dia,drying,filament,flattened,glabrous,globose,green,greenish-white,inflorescence,internodal,leaf,lobe,long,many,margin,minutely,mm,ovary,paler,papillate,pedicel,pitted,regularly,reniform,shining,shrub,slender,small,stem,style,surface,tapering,time,tip,tree,tube,white,x	/4,5,anthesi,apart,appearing,ba,blac,branc,clavate,cucullate,cup-shaped,difoliate,edicel,eed,ellipsoid,erect,exsertion,free,fruiting,geminate,greyi,later,lobed,lower,nflorescence,occasionally,older,papillo,papillose,part,plurifoliat,pore,poricidal,portion,reflexed,regulary,ruit,scar,shaped,spaced,stigma,straight,tall,tear-drop,terminal,ud,unit,upper,usually,way,widely,woody,x.,ympodial,young	0.5,abaxial,adaxial,apex,arrangement,characteristic,colour,diameter,form,fruit,greyish,growth,height,length,midvein,na,peduncle,petiole,plant,primary,pseudostipule,rachi,seed,shape,staman,tertiary,texture,vein,venation
126	wfo-0001027238	success	204	128	105	99	23	0.515	-25,.3,0-0.7,0-1,0-1.5,0.5-1,1-1.5,1.5-3,1.5-4,15-30,2-4,3-4,3-5,3-6,5-15,5-7,6-15,6-8,acuminate,acute,anther,apex,articulated,base,berry,black,blade,brown,calyx,chartaceous,cm,contiguous,cuneate,dark,deltate,densely,diameter,elliptic,elliptic-ovate,entire,extra-axillary,filament,flattened,fleshy,flower,foliaceous,fruit,glabrescent,glabrous,globose,green,greenish,hair,lavender,leaf,light,lobe,long,major,margin,membranaceous,minutely,mm,multangulate,near,nearly,oblique,obtuse,outline,pale,pedicel,peduncle,petiole,pitted,porrect-stellate,pubescent,purple,rachi,reniform,ripe,rounded,scandent,shiny,shrub,side,simple,small,sometimes,sparsely,sprawling,stellate-pubescent,stem,strongly,style,surface,tip,tree,unbranched,unequal,vein,white,whitish,x,yellow,yellowish	-5,.5,0.3-0.5,0.3-0.8,0.3-1,0.3-5,0.5-16,0.5-2,1-2,1.5-7,10,2-3,4-,4-10,4-16,4-5,4-8,5-merou,abaxially,accrescent,adaxiall,adaxially,ag,alyx,apparently,axe,ba,branch,capitat,connivent,covering,cylindrical,differentiated,directed,discolorous,distally,eaf,eed,equal,fork,free,frui,fruiting,geminate,gland,gland-tipped,growt,homostylous,interpetalar,introrsely,juic,large,lighter,like,longitudinal,lower,midpoint,minor,mixed,narrowly,new,nflorescence,oblong,often,one,opening,orolla,paired,part,perfect,pericarp,plurifoliate,pore,ray,ruit,sessile,short-stalked,similar,slit,somewhat,sparse,ste,stellate,stigma,straight,subtending,tamen,tem,time,tissue,toward,triangular,tube,unarme,unit,vary,wide,without,ympodial	abaxial,adaxial,arrangement,branching,characteristic,colour,corolla,form,growth,height,inflorescence,length,midvein,na,ovary,plant,primary,seed,shape,staman,texture,unarmed,ye
127	wfo-0001027244	success	294	126	105	189	21	0.357	-12,-2,-3.2,0.2-1,0.3-0.6,0.3-0.8,0.4-1,0.45-0.6,0.5,0.5-0.8,0.7-1.5,1,1.1-1.3,1.2-1.6,1.5-2.4,1.7-3.0,1/2,2-locular,2.1-8,3/4,7-12,acute,anther,apex,articulated,base,bifurcate,branched,broadly,brown,calyx,cell,cm,cordate,corolla,crenate,dark,decumbent,deltate,densely,dentate,diameter,distal,elliptic,erect,filament,fruit,glabrous,glandular,globose,green,greenish,hair-like,half,imparipinnate,inflorescence,interrupted,irregularly,lanceolate,lateral,length,like,lobe,lobed,long,margin,middle,midvein,mm,narrowly,obovate,often,orbicular,outgrowth,ovary,pedicel,peduncle,perennial,petiole,primary,pseudostipule,pubescent,purple,rachi,rounded,simple,slender,spreading,stem,stripe,style,surface,tertiary,testa,thick,trichome,truncate,uniseriate,vein,velvety,vivid,wall,white,wide,yellow	-1.2,.5,0-,0.02-,0.04-,0.05,0.05-1,0.07-0.15,0.1-,0.1-0.3,0.1-0.5,0.1-0.6,0.15-0.2,0.2,0.2-,0.25-0.4,0.3,0.3-0.4,0.3-0.5,0.4-,0.4-0.6,0.5-1,0.6-0.9,0.6-09,0.7-1,0.7-2,0.7-3,0.8-1.2,0.9-1.3,0.9-1.7,1-2-celled,1-2.5,1-3.5,1-celled,1.5-2,1.5-2.1,1.5-6.5,2-,2-4,2-4-celled,2-9,2-foliate,3-5,3.5-13,4-12,4-celled,5-,5-10,5-9-celled,8-16,8-celled,abaxially,absent,abundance,abundant,acroscopically,acuminate,adaxially,adpressed,alfway,along,also,always,amongst,angled,anthesi,apical,apparently,appearance,appendage,arequipa,around,articulatio,articulation,axi,basal,berr,berry,bract,bracteate,c.,cage,capitate,column,common,conical,curved,deciduous,decurrent,deeper,dense,density,developed,diamete,eaf,edicel,eed,eglandular,either,elliptical,exserted,extremely,flower,flushed,forming,fruiting,general,giving,glabrescent,gland,gree,halfway,head,herb,hyaline,interjected,internode,investing,lamina,larger,largest,leaflet,leave,lobing,lon,longer,lower,minute,mixed,mixture,multicellular,near,node,oblique,occasionally,onto,pair,papillate-pubescent,patent,petiolule,population,present,reflexed,rest,ripe,rotate-stellate,ruit,scattered,secondary,sessile,shaggy,short,shorter,silky,sinus,size,small,sometimes,somewhat,sparse,sparsely,sparser,staminal,sterile,stigma,stout,straight,strongly,tall,tem,terminal,tiny,tip,tipped,toward,tube,two,ud,undulate,unicellular,unit,united,upper,usually,variable,variety,winged,woody,ympodial	abaxial,adaxial,arrangement,branching,characteristic,colour,form,growth,height,history,leaf,life,na,plant,reproduction,seed,shape,staman,texture,unarmed,venation
128	wfo-0001027248	success	158	87	70	88	17	0.443	0,0.5-1,0.5-2.5,0.7-1.2,1-1.5,1-2,1-3,1-5,2-2.5,3-4,3-7-flowered,3.5-4,5-5.5,6.5-8,abaxial,along,anther,apex,arachnoid,arachnoid-pubescent,base,beige,berry,broadly,brown,calyx,cm,corolla,dark,deltate,densely,denser,dirty,elliptic,fruit,fruiting,glabrous,globose,grayish-green,green,leaf,lobe,long,minutely,mm,ovary,ovoid-reniform,patch,pedicel,per,petiole,pitted,poricidal,pubescence,pubescent,scattered,shrub,simple,small,sparsely,stem,style,surface,tip,tree,trichome,tube,vein,white,wide	.5,2-4.5,3-7,4-8,6-13,7-9,abaxially,acute,adaxially,anthesi,ape,appearing,arachnoid-pubescen,area,bark,beneath,broadened,brownish,brownish-gra,closely,conical,deflexed,dia,differing,difoliate,eaf,edicel,eed,ellipsoid,erect,exserted,felty,filament,fleshy,free,geminate,glabrescent,impressed,lamina,later,lateral,lightly,lobed,lower,main,major,margin,merely,minor,nearly,nflorescence,node,occasionally,older,opposite,overlappin,pair,pale,papillo,papillose,planar,pore,portion,present,ruit,scar,shaped,shoot,size,somewhat,soon,spaced,specimen,stigma,strongly,tall,tear-drop,thick,top,tub,ud,unifoliate,unit,wid,winged,woody,ympodial,young	0.5,characteristic,colour,density,diameter,form,growth,hair,height,inflorescence,length,plant,seed,shape,texture,type,width
129	wfo-0001027258	success	178	90	77	101	13	0.433	.25,0.25-0.5,0.5-1,0.6-2,0.9-1.3,1-1.5,1-2.3,1-4,1.2-2,1.5-1.6,2.5-8,3-4,4-5,4.5-5,5-10-flowered,6-8,abaxially,adaxially,along,anther,apical,attenuate,base,berry,calyx,capitate,cm,corolla,darker,decurrent,deltate,densely,elliptic,entire,flattened-reniform,fruit,fruiting,glabrous,globose,incrassate,leaf,length,lobe,long,margin,minor,minute,minutely,mm,onto,ovary,ovate,pedicel,petiole,pitted,projection,prominent,pubescent,scattered,shrub,simple,size,slightly,sparsely,stem,stigma,straight,style,surface,treelet,trichome,tube,uniseriate,white,winged,x,yellowish-tan	.5,/4,2-2.5,3-6,3.5-4,7-13,7-9,abruptly,acuminate,acute,age,anthesi,apar,apex,apiculae,axil,ba,bark,beneath,broadly,crystal,deflexed,dense,deposit,dia,differing,difoliate,dissecting,drying,eaf,edicel,eed,ellipsoid,enlarge,evenly,exserted,extending,fide,filament,fragrant,free,geminat,glabrou,green,greenish-yellow,internodal,lamina,large,lateral,lengthening,lenticel,lobed,lower,main,major,microscope,middle,nee,nflorescence,occasionally,often,older,opposite,pair,pale,papillo,papillose,planar,pore,poricidal,portion,red-papillose,reddish,ruit,sand,scar,slender,slit,small,spaced,speck,strongly,sweetly,swollen,tall,tiny,tip,tub,tuft,ud,unit,urceolate,vein,visible,way,widening,widest,woody,yellowish,ympodial,young	characteristic,colour,diameter,form,growth,height,inflorescence,plant,pubescence,seed,shape,texture,type
130	wfo-0001027260	success	176	126	93	83	33	0.528	-60,0.25-1,0.5-3,0.5-6.5,0.8-2,1-2,1-3,1-6,1.5-13,1.5-2,15-30,2-10,2-18,2-2.5,2.5-3.5,3-11,3-4.5,3-6,5-25,5-40,acuminate,acute,acute-,age,also,apex,articulated,basal,base,berry,beyond,branched,chartaceous,cm,cordate,cylindrical,darker,densely,diameter,ellipsoidal,elliptic,elliptic-ovate,entire,exserted,fading,flattened,flower,fruit,glabrate,glabrous,globose,greenish,lanceolate,lavender,leaving,lobe,long,longitudinal,margin,mm,moderately,obtuse,often,ovate,pedicel,pedicellar,peduncle,petiole,pilose,pink,puberulent,puberulent-pubescent,pubescent,pubescent-pilose,purple,rachi,remnant,shrub,simple,small,sparsely,stamen,stripe,style,subcoriaceous,tree,unbranched,usually,vein,white,x,yellow-green,yellowish	-17,-2,-7,0.5-1,0.75-1,1-,1-4,1-7,10-25,2-,2.5-14,3-,3-10,3.5-25,4-25,4-32,4-5-foliat,4-6,4.5-14,5-,5-merous,6-20,abaxially,absent,adaxially,aggregate,alyx,apart,ape,axe,blade,cell,clavate,connective,connivent,diamete,directed,distally,eaf,eed,eglandular,equal,exceeding,hair,lon,lower,membranaceous,narrowly,nearly,nflorescence,nther,orolla,perfec,perfect,pilo,pore,presen,puberulent-pubescen,radiu,ruit,shorter,slightly,spaced,stellate,stigma,stone,strongly,tal,tapered,tem,thecae,time,tomento,triangular,truncate,tube,ud,unit,vary,wide,yellow,yellow-orang,ympodial	1-4.5-14,5-10-25,abaxial,adaxial,anther,arrangement,branching,calyx,characteristic,colour,corolla,filament,form,growth,height,inflorescence,leaf,length,midvein,na,ovary,plant,primary,pseudostipule,seed,shape,staman,stem,surface,tertiary,texture,unarmed,venation
131	wfo-0001027265	success	159	94	73	86	21	0.459	.2,0.1â2,0.2-0.4,0.5,0.5-1,1-3,1.2-1.3,1.2-2,1.2â1.4,1.5â1.8,1.5â2,2,2-3,2/3,20-30,2â2.5,4-5,4â6,4â7-branched,acute,anther,apart,apex,articulated,base,berry,calyx,chartaceous,cm,diameter,entire,extra-axillary,filament,flattened-reniform,flower,fruit,glabrous,globose,herb,leaf-opposed,light,lobe,long,long-attenuate,lower,margin,minutely,mm,nearly,numerous,orange,ovate-lanceolate,pedicel,peduncle,petiole,pitted,puberulent,pubescent,purple,rachi,recurved,red,seed,simple,spaced,sparsely,style,subcoriaceous,surface,triangular,white,x,yellow	-2.5,.3,.5,0.5â0.6,1-1.3,1-2.5,1.5-2.5,1.5â4,2-,2-4,2â3,3-,3-lobed,30â50,4.5â8,5-merou,58409,abaxially,accrescent,adaxiall,adaxially,alyx,apparently,axe,ba,blade,broad,capitat,ciliate,connivent,covering,croat,cylindrical,dehiscent,eaf,eed,erect,foliate,frui,fruiting,geminat,granule,hair,hermaphroditic,juic,larger,lon,longitudinall,low,mesocarp,near,nflorescence,node,oblong,obtuse,orolla,paired,partially,pore,present,prominent,rarely,ripe,rooting,rotate-stellate,ruit,scarcely,sclerotic,slightly,sometimes,somewhat,stigma,tall,tamen,tem,time,tip,tube,unit,usually,vary,weak,white-puberulent,wide,winged,ympodial	0.5-0.6,30-50,abaxial,adaxial,arrangement,characteristic,colour,corolla,form,growth,height,inflorescence,leaf,length,ovary,plant,shape,staman,stem,texture,type
132	wfo-0001027265	success	156	97	78	78	19	0.5	.2,.5,0.1â2,0.2-0.4,0.5,0.5-1,0.5â0.6,1-3,1.2-1.3,1.2-2,1.2â1.4,1.5â1.8,1.5â2,2,2-3,2/3,20-30,2â2.5,2â3,4-5,4â6,4â7-branched,acute,anther,apart,apex,articulated,base,calyx,chartaceous,cm,cylindrical,diameter,entire,extra-axillary,filament,flattened-reniform,flower,fruit,glabrous,globose,herb,leaf-opposed,light,lobe,long,long-attenuate,lower,margin,minutely,mm,nearly,numerous,obtuse,orange,ovate-lanceolate,pedicel,peduncle,petiole,pitted,puberulent,pubescent,purple,rachi,recurved,red,ripe,seed,simple,spaced,sparsely,style,subcoriaceous,surface,triangular,white,x,yellow	-2.5,.3,1-1.3,1-2.5,1.5-2.5,1.5â4,2-,2-4,3-,3-lobed,30â50,4.5â8,5-merou,58409,abaxially,accrescent,adaxiall,adaxially,alyx,apparently,axe,ba,blade,broad,capitat,ciliate,connivent,covering,croat,dehiscent,eaf,eed,erect,foliate,frui,fruiting,geminat,granule,hair,hermaphroditic,juic,larger,lon,longitudinall,low,mesocarp,near,nflorescence,node,oblong,orolla,paired,partially,pore,prominent,rarely,rooting,rotate-stellate,ruit,scarcely,sclerotic,slightly,sometimes,somewhat,stigma,tall,tamen,tem,time,tip,tube,unit,vary,weak,white-puberulent,wide,winged,ympodial	30-50,abaxial,adaxial,arrangement,characteristic,colour,corolla,form,growth,height,inflorescence,leaf,length,ovary,plant,shape,staman,stem,texture
133	wfo-0001027284	success	172	130	101	71	29	0.587	.3,0.1â0.5,0.1â2,0.7â0.9,0.7â1,1.2â1.5,1.5â2,1.5â2.5,1.8â2,1â1.5,2.5â3.5,2â16,2â2.2,3â4,4,4â12,4â6,5â7,5â8,9â18,abaxially,acuminate,acute,adaxially,anther,apex,axillary,base,branched,brownish,calyx,cm,cordate,cylindrical,deflected,deltoid,densely,diameter,elliptic,entire,extra-axillary,filament,fine,flattened,flattened-reniform,flower,fruit,glabrous,globose,green,inflorescence,lobe,margin,maturity,midvein,minutely,mm,nearly,oblique,one,orangish,ovate,ovoid,pair,pale,pedicel,peduncle,petiole,pinnate,pointed,pubescence,pubescent,rachi,rarely,reticulate-rugulose,rounded,sand-punctate,scandent,scar,shortly,shrub,side,simple,slightly,sometimes,somewhat,soon,spaced,sparsely,stem-terminal,style,surface,tan,tip,truncate,unbranched,vein,venation,vine,white,x	0.2â,1.5â5.5,1.5â8,1â2,1â3,2.5â3,3.5â14,5-merous,accrescent,alyx,anthesi,axe,berry,blade,branch,c.,capitat,ciliat,climbing,conspicuous,contiguousl,distally,eaf,eed,enlarged,fleshy,fruiting,glabrescen,glabrou,gradually,herbaceous,immature,leafy,long,lower,m.,near,nflorescence,nternode,orolla,pendulou,perfec,pink,planar,plurifoliate,prominent,reduced,ruit,sand-punctat,secondary,seen,size,spreading,stellate,stigma,tamen,tem,thickened,thickly,time,toward,tree,tube,understory,unifoliat,unit,vary,weakly,wide,woody,ympodial	abaxial,adaxial,arrangement,branching,characteristic,colour,contiguously,corolla,dense,form,glabrescent,growth,height,history,leaf,length,life,na,ovary,plant,primary,pseudostipule,seed,shape,staman,stem,tertiary,texture,unarmed
134	wfo-0001027302	success	188	102	77	111	25	0.41	0.4-5,0.5-1,0.6-1,1-1.3,1-1.5,1.2-2.5,2,2-3,2-6,2.2,3.5-5,6-12,abaxial,acuminate,acute,adaxial,anther,apex,appearing,base,berry,branching,bright,brownish-yellow,calyx,cm,cordate,corolla,crispate,deltoid,dendritic,diameter,filament,flattened,glabrous,globose,growth,later,lateral,leaf,length,lenticular,lobe,long-triangular,margin,minutely,mm,monochasial,narrowly,ovary,ovate,pair,pale,petiole,pitted,plant,plurifoliate,puberulent,pubescent,red,reddish-brown,scattered,shrub,simple,small,somewhat,sparsely,stem,style,surface,terminal,tree,trichome,truncate,undulate,vein,violet	.5,0.5,0.8-1,1,1-2,1-3,1.2-1.6,1.5-2,10,10-20,2.7-7.5,3/4,5-7,7,7/8,abaxially,adaxially,age,along,anthesi,apical,ba,bark,basal,becoming,blade,broader,capitate,clavate,conical,cultivation,decurrent,deflexed,densely,denser,dichasia,discussion,eaf,edicel,eed,elliptic,entire,especially,ew,exserted,fine,flat-topped,flower,free,fruiting,growing,inserted,juvenile,larger,lax,less,like,lobed,lon,long,lower,m.,main,nflorescence,nodding,occasionally,older,otherwise,overtopping,papillo,pedicle,per,pericarp,planar,pore,poridical,portion,prominent,pyramidal,reflexed,ruit,scar,scrambling,secondary,see,shade,shin,shoot,sleeve,slit-like,stamen,stigma,strongly,tall,tapering,thin,time,tiny,tip,tub,tube,ud,unit,usually,way,wide,winged,woody,x,ympodial,young	arrangement,characteristic,colour,dichasial,form,fruit,height,history,inflorescence,life,midvein,na,pedicel,peduncle,primary,pseudostipule,rachi,seed,shape,shiny,staman,tertiary,texture,unarmed,venation
135	wfo-0001027310	success	215	97	83	132	14	0.386	0-5,0.6-1,0.7-2,1-1.2,1-1.7,2-3.1,2-4,2.2-2.5,2.8-3,20-60,4-9,4.5-5.5,5-7,abaxial,acute,adaxial,anther,apex,apically,apparently,articulated,base,berry,branched,branching,calyx,chartaceous,cm,cuneate,dark,deltate,densely,diameter,entire,erect,evenly,filament,fruit,glabrescent,glabrous,glaucous,green,green-brown,hair,lanceolate,lateral,leaf,length,lobe,long,margin,maturity,mauve,minutely,mm,moderately,pedicel,peduncle,petiole,pitted,prickle,prickly,primary,purple,red,rounded,secondary,shallowly,shrub,simple,sometimes,sparse,stellate-pubescent,stem,style,surface,terminal,toward,tree,truncate,unarmed,yellow,young	-2.2,-20,.8,/3,0,0-20,0.05,0.05-0.15,0.1,0.1-0.2,0.15-0.3,0.9-0.17,1-6,1.1-1.5,1.5-2.2,1.5-5,1/10-1/6,1/3-1/2,1/3-3/4,11-16,2-10,2-5,2/3,22-30,3-15,4-10,4.5-7,5-10,5-20,5-merous,6-8,7-10,8-10,9-13,abaxially,acut,alyx,andromonoecious,apar,apart,bark,blade,broadly,connivent,curved,discolorous,distal,drying,eaf,eed,elongating,equal,faint,flattened,flattened-reniform,flower,foliaceous,free,fruiting,fused,gently,glabrou,gray,hermaphrodite,heterostylous,inflated,infructescence,less,lobed,long-styled,longer,lower,lowermost,mature,midpoint,nflorescence,older,one,open,orange-brown,orolla,oung,pair,pale,pendulous,per,pericarp,plant,plurifoliat,poricidal,porrect,porrect-lepidote,portion,pubescent,ray,reddi,reflexed,ruit,scar,sessile,short-styled,shorter,smooth,spaced,sparsely,spherical,spreading,stalk,stalked,staminat,stellate,stout,straight,strongly,tamen,tapering,terete,tertiary,time,tip,trichome,tube,unarme,unit,vary,vein,venation,visible,way,wide,woody,ympodial	characteristic,colour,corolla,form,growth,inflorescence,na,ovary,seed,shape,staman,texture,type,width
136	wfo-0001027317	success	144	101	78	66	23	0.542	.5,0.1-0.2,0.4-1.5,0.5-1,0.5-3,0.8-3.5,1,1-1.5,1-2,1-5,1.4-1.6,1.5-2,2-9,4.5-5,?,abaxial,anther,apex,apical,apically,bark,base,berry,bilobed,broadly,calyx,cm,conical,corolla,deltoid,densely,difoliate,drying,ellipsoid,elliptic,elongated,erect,filament,fruit,fruiting,glabrous,globose,golden,green,leaf,lobe,lobed,long-exserted,major,minor,minutely,mm,nearly,ovary,pale,papillose,pedicel,petiole,pointed,pore,poricidal,projection,pubescent,shaped,shrub,simple,size,sparsely,stem,stigma,style,surface,tear-drop,tip,trichome,tube,uniseriate,x	.25,0.3-1,2-3-flowered,3-3.5,7-9,acuminate,acute,adaxially,along,anthesi,arch,ba,beneath,closely,cucullate,deciduous,deflexed,dia,differing,eaf,edicel,eed,expanded,filiform,free,geminat,greyish-whit,immature,inflorescenc,joined,known,lateral,like,lon,long,lower,main,margin,mature,minute,nflorescence,offset,older,opposite,overlappin,pair,papillo,portion,prominent,reflexed,rest,ruit,scar,series,slightly,soon,spaced,strongly,tall,tub,ud,vein,white,woody,ympodia,young	adaxial,arrangement,bud,characteristic,colour,dense,diameter,exsertion,form,geminate,greyish-white,growth,height,inflorescence,length,na,plant,pubescence,seed,shape,sympodia,texture,type
137	wfo-0001027323	success	175	91	62	113	29	0.354	0.5-1,1-1.5,1.2-1.5,2-3,2-6,2.5-3,3-5,5-7,7-9,acute,adaxial,anther,apex,attenuate,base,berry,calyx,cm,corolla,decurrent,densely,elliptic,filament,fleshy,fruit,furcate,glabrate,glabrous,globose,grey,immature,leaf,lobe,long-triangular-deltoid,margin,matte,minutely,mm,occasionally,opposite,ovary,ovoid-reniform,pair,papillose,partially,pedicel,petiole,pinkish-grey,pitted,plant,red-papillose,reddish-grey,stem,straight,style,surface,tan,treelet,vein,white,winged,x	.75,/3,1-2,10-15,14-21,20-45,5-20-flowered,6-11,along,anthesi,apparent,appearing,area,arising,asymmetric,ba,bark,broadened,bud,campanulate,character,closed,closely,cork,deflexed,dia,differing,difoliate,dried,dry,eaf,edicel,eed,elongate,entire,erect,erose,exserted,five-pointed,flopping,flower,free,fruiting,geminat,growing,held,higher,hood,hooded,interpetalar,lateral,like,live,lobed,lon,long,lower,main,major,mature,measured,middle,minor,nflorescence,older,one,onto,overlapping,ovoid,papillae,papillo,persistent,planar,pore,poricidal,portion,prominent,proximal,rather,rest,ridge,ruit,scar,secondary,seen,shaped,sinus,size,slightly,small,smoot,soon,spaced,specimen,stigma,tall,tear-drop,thickened,thin,tiny,tip,trunk,tube,two,ud,unit,upper,visible,way,widest,woody,ympodial,young	3,5,7,abaxial,arrangement,branching,characteristic,colour,diameter,form,growth,height,history,inflorescence,length,life,midvein,na,peduncle,primary,pseudostipule,rachi,seed,shape,staman,tertiary,texture,unarmed,venation
138	wfo-0001027340	success	189	129	98	91	31	0.519	0.5-0.9,1-10,1-2,10-16,16-22,2-4,3.5-5,4-7.5,5-6,6-8.5,7-8,8-14,8-9.5,absent,acuminate,anther,apart,apex,articulated,articulation,axillary,base,berry,brownish,bud,cell,chartaceous,cm,condition,cordate,corolla,covering,dark,diameter,distal,distinct,drying,elliptic,filament,flower,forked,fresh,fruit,generally,glabrous,globose,green,green-white,greenish,hair,hair-like,half,herb,high,indistinct,lanceolate,lateral,like,lilac-purple,lobe,long,make,margin,membranous,minute,mm,mucilaginous,odd-pinnate,ovate,ovoid,papillose,pedicel,peduncle,petiole,plant,pubescent,purple,ripe,rounded,seed,shortly,slightly,spaced,sparsely,splotched,stem,style,subtending,terminal,testal,thick,throughout,tinged,truncate,usually,wall,wet,whitish	1-3,1.5-2.7,2-3,2-3.5,2.5-4.5,2.7-4.5,3-4,3.5-9,4-6,5-11,5-merou,7-18,abaxially,abruptly,acumen,adaxially,ag,along,alyx,apparently,auriculate,axe,blade,capitat,ciliate,connivent,decreasing,developing,digestion,dorsally,eaf,edge,eed,enzyme,especially,exceeding,flat,folded,geminat,glabrou,hal,homostylous,honeycomb-shaped,interjected,leaflet,lengthening,living,lower,midrib,minutely,narrow,narrowed,nflorescence,orolla,pair,perfect,petiolulate,plurifoliate,pointed,pore,poricidal,puberulent,purpl,removed,rotate,ruit,semi-erec,semi-rosette,sessile,seudostipule,short,size,slit,specimen,stamen,ste,stigma,straight,tall,tamen,tem,tip,tri-,tube,unit,vary,wing,x,yellow,ympodial,young	2,abaxial,adaxial,arrangement,branching,calyx,characteristic,colour,form,growth,height,history,inflorescence,leaf,length,life,midvein,na,ovary,perennial,primary,pseudostipule,rachi,shape,staman,surface,tertiary,texture,unarmed,vein,venation
139	wfo-0001027354	success	166	97	77	89	20	0.464	0.5-2,0.7-1.3,1-1.2,1-1.5,1-7,1.5-1.8,1.5-2,3-4,3.4-4,4-10,5-7,8-12,abaxial,abaxially,acute,adaxial,along,anther,apex,appearing,base,berry,branch,branching,calyx,cm,corolla,dark,deltoid,dendritic,densely,diameter,elliptic,entire,filament,flattened,fork,fruit,glabrate,glabrous,globose,golden,growth,later,lateral,leaf,length,lenticular,lobe,loose,minutely,mm,monochasial,narrowly,occasionally,ovary,pair,pedicel,petiole,pitted,plurifoliate,pubescent,purplish-black,reddish-brown,shrub,small,sparsely,stem,style,surface,terminal,tree,tree-like,trichome,vein,violet,white	.5,0,0.5,1,1.7-5,10,10-20,2.5-3.5,3/4,6.5-13,absent,age,anthesi,apical,ba,bark,basal,becoming,belo,bi-lobed,blade,conical,covered,denser,dichasia,drying,eaf,edicel,eed,erect,ew,exserted,flower,free,fruiting,inserted,less,like,lobed,long,loosely,lower,m.,mostly,near,nflorescence,nodding,older,papillo,per,pericarp,planar,pore,poricidal,portion,pubescen,pyramidal,raised,ruit,scar,secondary,side,simple,sleeve,slightly,slit-like,somewhat,stamen,stigma,strongly,tall,tapering,thecalyx,thin,time,tiny,tip,tub,tube,type,ud,unit,way,wide,winged,woody,x,ympodial,young	arrangement,characteristic,colour,dichasial,form,height,inflorescence,margin,midvein,na,peduncle,plant,primary,pseudostipule,rachi,seed,shape,staman,texture,unarmed
140	wfo-0001027359	success	224	114	95	129	19	0.424	-2,-20,.5,0-9,0.1-1.5,0.3-1.2,1-1.2,1-2,1.2-1.5,2-4,2.5-3.5,4-,4-5,5-6.5,6-8,acute,anther,apex,apically,apparently,base,berry,branched,bright,calyx,cell,chartaceous,cm,cuneate,deltate,diameter,difoliate,dull,entire,eye,filament,fruit,glabrous,lateral,leaf,length,like,lobe,lobed,margin,maturity,membranous,minutely,mm,moderately,naked,near,obtuse,occasional,orange-brown,outline,ovate,pair,pale,pedicel,peduncle,per,petiole,pit,prickly,primary,purple,rachi,raised,red,reticulate,shallowly,shrub,simple,small,smooth,spherical,stellate,stellate-pubescent,stem,style,surface,terminal,tertiary,trichome,unarmed,undulate,unit,vein,venation,visible,white,yellow,yellow-brown,young	-0.25,-3,-4,-7,-9,.1,.2,/3,/4,0,0-2,0-3,0-5,0.1,0.1-0.2,0.3-0.5,0.5,0.5-1,0.5-2,0.6-0.8,0.6-1,1-3,1-4,1-5,1.2-2,1.5-2,1.5-2.5,1.8-3.2,1/5-1/4,2-10,2-3,2.5-5.5,3-10,5-,5-merous,7-8,abaxially,acut,alyx,apar,apart,articulated,ba,bark,blade,brow,concolorous,coroll,cream,curved,dark,densely,distinctive,drying,eaf,eed,elongate,elongating,equal,erect,filiform,flattened,flattened-reniform,flower,free,fruiting,geminat,glabrescent,gray,green,herbaceous,infructescence,less,long,longer,lower,marking,mature,midpoint,narrow-deltate,narrow-ovate,nflorescence,often,older,one,open,orolla,oung,ovoid,perfec,pericarp,poricidal,porrect,portion,prickle,rarely,ray,reflexed,ruit,scandent,scar,sessile,shorter,slender,slightly,sometimes,spaced,sparsely,spreading,stalk,stalked,stump,tamen,tapering,terete,time,tinge,tip,tube,ud,unarme,usually,variously,vary,way,weakly,wide,woody,ympodial	abaxial,adaxial,arrangement,branching,characteristic,colour,corolla,form,growth,inflorescence,midvein,na,ovary,pseudostipule,seed,shape,staman,sympodial,texture
141	wfo-0001027366	success	136	88	58	78	30	0.426	0.5-1,0.7-1,1-1.5,1-2,1-3,2-2.5,3-10-flowered,3-9,4-4.5,4-5,5-7,acute,anther,apex,base,berry,bright,broadly,brown,calyx,cm,conspicuously,corolla,dark,deltate,drying,elliptic,filament,glabrous,globose,golden,green,greenish-white,leaf,lobe,long-triangular,margin,minutely,mm,orbicular,ovary,ovoid-reniform,pair,pale,parallel,pedicel,petiole,pitted,rounded,shining,shrub,simple,somewhat,stem,style,surface,vein,venation	.5,/2,/4,0.25-0.5,1.5-2,11-21,6-19,603,abaxially,adaxially,anthesi,ape,axe,ba,bark,capitate,closely,conical,deflexed,dia,eaf,edicel,eed,erect,et,except,exserted,fide,free,fruiting,internodal,lamina,lateral,less,lobed,lon,long,lower,main,middle,nflorescence,older,opposite,overlappin,ovoid,packed,papillo,papillose,planar,pointed,pore,poridical,portion,ramo,reddish,ruit,scar,secondary,shaped,sometimes,stigma,straight,tall,tear-drop,tip,trichome,tub,tube,ud,unifoliat,unit,way,wide,widest,woody,yellowish-gre,ympodial,young	abaxial,adaxial,arrangement,branching,characteristic,colour,diameter,form,fruit,growth,height,history,inflorescence,length,life,midvein,na,peduncle,plant,primary,pseudostipule,rachi,seed,shape,staman,tertiary,texture,unarmed,unifoliate,yellowish-grey
142	wfo-0001027368	success	145	97	75	70	22	0.517	-15,-20,-5,.5,0.3-2.5,0.5-3.5,0.8-2,1-2,1-6,1.5-2,1.5-2.5,2,2-2.5,2-9,3,4-6,5-15,5-6,8-13,abruptly,apart,articulated,base,branched,calyx,chartaceous,cm,contiguous,cuneate,decurrent,deltate,dendritically,densely,diameter,distally,ellipsiodal,elliptic,elliptic-ovate,entire,forked,glabrous,globose,lanceolate,lenticular,lobe,margin,mm,moderately,narrowed,narrowly,nearly,occasionally,often,otherwise,ovoid-fusiform,pedicel,peduncle,petiole,puberulent,pubescent,purple,rachi,shrub,simple,small,spaced,sparsely,style,subcoriaceous,subhastate,triangular,unbranched,unknown,white,x	-10,-2,0.5-5,1-15-flower,2-3,2-4,3-12.5,4-many-foliat,5-10,abaxially,absen,acuminate,acute,adaxiall,adaxially,aggregate,also,apex,axe,ba,blade,cell,color,connivent,cylindrical,darker,denser,directed,eaf,eed,except,gland,hair,lighter,long,long-stalked,lower,midvein,nflorescence,nther,oblong,obtuse,orolla,pore,pubescen,radiu,ray,ruit,sometimes,stalked,star,stellate,stigma,stone,subcapitat,tal,tem,terminal,three,time,tip,truncate,tube,unit,usually,vary,vein,wide,yellow,ympodial	abaxial,adaxial,anther,arrangement,branching,characteristic,colour,corolla,form,fruit,growth,height,inflorescence,leaf,length,ovary,plant,seed,shape,stem,surface,texture
143	wfo-0001027369	success	191	105	81	110	24	0.424	.5,.7,0-1,0-3,0-5,0.5-0.8,0.6-0.8,1-,1-2.5,1-3,1-4,1.5-2,2-4,2-5,3-4,almost,anther,apex,apically,apparently,articulated,base,berry,branched,calyx,cm,color,cordate,diameter,erect,filament,filiform,flower,fruit,glabrous,glaucous,green,infructescence,known,lanceolate,lateral,leaf,length,lobe,lobed,long,margin,mauve,membranous,midvein,mm,moderately,narrowly,one,open,orbicular,pale,pedicel,peduncle,per,pericarp,petiole,prickle,prickly,reniform,rounded,shrub,simple,smooth,sparsely,spherical,stellate-pubescent,stem,style,surface,terminal,time,unarmed,venation,winged,yellow	-1,-10,-11,-2,.1,.4,/4,0,0-15,0-6,0.05-0.15,0.1,0.1-0.2,0.1-0.3,0.2-0.5,0.25-0.4,0.3-1.5,0.5,0.5-1.5,1-2,1.2-2.5,1.2-3,1/3,2-3,3,3-10,4-5,4-8,5,5-merous,7-15,abaxially,acut,alyx,ame,apar,apart,bark,blade,broad-deltate,c.,concolorous,curved,deltate,densely,difoliate,distance,drying,eaf,eed,elongating,equal,extending,eye,free,fruiting,geminat,glabrou,gra,hair,herbaceous,know,less,lon,lower,mature,midpoint,multangulate,naked,nflorescence,older,orolla,oung,pendulous,perfec,perpendicular,poricidal,porrect,portion,prickl,ray,reflexed,ruit,scandent,scar,sessile,side,slender,slightly,spaced,spreading,stalk,stalked,stellate,straight,strongly,tamen,tapering,terete,tip,trichome,tube,unequal,unit,vary,visible,way,wide,wider,ympodial	abaxial,acute,adaxial,arrangement,branching,characteristic,colour,corolla,form,growth,height,inflorescence,na,ovary,plant,primary,pseudostipule,rachi,seed,shape,staman,tertiary,texture,vein
144	wfo-0001027378	success	149	111	70	79	41	0.47	.2,abaxially,acuminate,acute,adaxial,anther,apex,base,blue,broadly,calyx,chartaceous,cm,cordate,deeply,diameter,extra-axillary,filament,flattened,fleshy,flower,fruit,glabrous,hair,half,herbaceous,lanceolate,leaf,light,lobe,lower,margin,markedly,minutely,mm,ovate,ovoid,palmate,papillose,pedicel,peduncle,petiole,pointed,primary,pubescent,rachi,revolute,rounded,sand-punctate,scattered,short,simple,slender,slightly,small,somewhat,spaced,sparsely,stem,style,tip,tooth,unbranched,unknown,vein,venation,vine,white,widely,x	0.5â1,0.7â1,0.8â2.5,1.2â1.5,1.2â1.8,1.5â1.8,1.5â8,15â35,1â1.5,1â3,2.3â5,2.5â7,2â11,2â2.2,2â2.5,3â4.5,3â5,3â6,4â6,4â9,5-8,5-merous,5â10,5â13,5â7,6â10,6â7,adaxially,alyx,apar,apicall,axe,berry,blade,c.,capitat,ciliate,clavate,climbin,color,cylindrical,deltoid,densely,eaf,eed,fruiting,glabrou,hair-tipped,like,lon,long,longer,m.,membranous,moderately,narrowly,nflorescence,nternode,obscure,often,orolla,pentagonal,perfec,plurifoliat,rotate-stellate,ruit,sand-punctat,side,stigma,tamen,tem,terrestrial,trichome,tube,unit,unknow,vary,wide,ympodial	0.7-1,0.8-2.5,1-3,1.2-1.5,1.2-1.8,1.5-1.8,15-35,2-11,2-2.2,2-2.5,2.5-7,3-4.5,3-6,4-6,5-7,6-10,abaxial,arrangement,branching,characteristic,colour,corolla,form,growth,height,history,inflorescence,length,life,midvein,na,ovary,plant,pseudostipule,seed,shape,staman,surface,tertiary,texture,unarmed
145	wfo-0001027378	success	141	95	76	65	19	0.539	.2,0.7-1,0.8-2.5,1-3,1.2-1.5,1.5-1.8,15-35,2-11,2-2.2,2.5-7,3-4.5,3-6,4-6,5-8,6-10,abaxially,acuminate,acute,anther,apart,apex,articulated,base,blue,broadly,calyx,chartaceous,clavate,cm,cordate,cylindrical,deeply,densely,diameter,extra-axillary,filament,fleshy,flower,fruit,glabrous,hair,hair-tipped,herb,lanceolate,leaf,light,lobe,margin,minutely,mm,obscure,often,ovate,pedicel,peduncle,petiole,pubescent,rachi,revolute,rounded,scattered,short,simple,slender,small,somewhat,spaced,sparsely,style,tip,tooth,trailing,unbranched,white,widely,x	1-1.5,1.5-8,2-4,2.3-5,3-5,4-9,5-13,5-merou,6-7,adaxially,ag,alyx,apicall,apparently,axe,ba,basally,blade,capitat,ciliate,climbing,connivent,deltoid,directed,distally,eaf,eed,equal,fruiting,geminat,large,long,longer,longitudinal,lower,moderately,multicellular,narrowly,nflorescence,node,oblong,opening,orolla,perfect,plurifoliate,pore,pubescen,rooting,rotate-pentagonal,slightly,slit,stigma,tamen,tem,terrestrial,tube,unit,unknow,unknown,vary,vein,weakly,wide,yellow,ympodial	abaxial,adaxial,arrangement,branching,characteristic,colour,corolla,form,growth,inflorescence,length,na,ovary,seed,shape,staman,surface,texture,unarmed
146	wfo-0001027384	success	155	116	100	55	16	0.645	/3,0.4-1.1,0.5-1,0.9-1,1-1.3,1-1.5,1-3,1-4,1.5-2,2.5-6.5,3-3.5,3-4,4-7,5-15-flowered,5-5.5,7-14,7.5-8,acute,anther,anthesi,apart,apex,bark,base,beginning,berry,broadly,bud,calyx,capitate,clavate,closely,cm,corolla,cuneate,deep,dia,drying,ellipsoid,filament,flattened-reniform,fruiting,glabrous,globose,green,herbarium,incrassate,later,lateral,leaf,lobe,long,long-exserted,main,margin,minutely,mm,mustard,narrowly,obovate,opposite,ovary,overlapping,pair,pale,papillose,pedicel,petiole,pitted,pore,poricidal,pseudo-terminal,reddish-purple,rounded,scar,shaped,shining,shrub,simple,small,spaced,specimen,stem,stigma,style,sulcate,surface,tear-drop,tip,tree,triangular,tube,vein,way,white,widely,x,yellow,yellowish,young	.25,.5,.75,3/4,abov,anothe,ba,beneath,breaking,brown,difoliate,distal,eaf,edicel,eed,equal,erect,free,geminate,hard,inflorescenc,lobed,lower,member,middle,nflorescence,occasionally,older,paler,papillo,peeling,planar,portion,prominent,rarely,ruit,section,siz,slender,straight,subcoriaceous-fleshy,tall,tapering,thick,transverse,trichome,tub,tuft,ud,uniseriate,unit,widest,without,woody,ympodial	1.5,characteristic,colour,diameter,form,fruit,growth,height,inflorescence,length,plant,seed,shape,size,texture,type
147	wfo-0001027389	success	154	85	56	98	29	0.364	.5,0.25-0.3,0.25-0.5,0.5-1.5,0.6-1,1-1.5,2-2.5,3-3.5,5-7,7-8,acuminate,acute,anther,apex,base,berry,brown,calyx,cm,corolla,dark,decurrent,deltoid,elliptic,filament,glabrous,globose,green,hispidulous,inflorescence,leaf,lobe,margin,minutely,mm,ovary,ovate,ovoid-reniform,pair,pedicel,petiole,pitted,puberulent,shrub,simple,sparsely,stem,straight,style,surface,thread-like,truncate,vein,white,winged,x	.1,.25,0.5-0.75,1,1-2,1.8-1.9,11-14,3-4.5,4-5-flowered,along,anthesi,apart,ba,bark,beneath,broadening,broadly,bud,conical,deflexed,dia,dry,eaf,edicel,eed,ellipsoid,erect,evenly,except,expanded,exserted,filiform,foetid,foliage,free,fruiting,geminate,lateral,like,lobed,lon,long,lower,main,making,material,middle,nearly,nflorescence,node,non-reproductive,obovoi,occasionally,often,older,one,opposite,paler,papillo,papillose,pore,poricidal,portion,prominent,prominently,proximal,raise,raised,reddish-golden,reflexed,rest,ruit,scar,shaped,shin,side,slender,slight,slightly,soon,spaced,stigma,tall,tapering,tear-drop,tip,top,trichome,tube,ud,unifoliat,uniseriate,unit,widest,woody,yellowish,ympodial,young	abaxial,adaxial,arrangement,branching,characteristic,colour,diameter,form,fruit,growth,height,history,length,life,midvein,na,peduncle,plant,primary,pseudostipule,rachi,seed,shape,staman,tertiary,texture,unarmed,unifoliate,venation
148	wfo-0001027395	success	153	84	68	85	16	0.444	.5,0.25-0.5,0.75-1,1-1.5,1-5,1.1-1.5,1.5-1.9,1.5-2.5,1.6-2.9,2-3,2.2-7,3.5-4,8,anther,apiculate,bark,base,black,calyx,capitate,cm,corolla,deltoid,densely,depressed,dia,exfoliating,fruit,fruiting,glabrous,globose,green,immature,large,leaf,lobe,lobed,minor,mm,narrowly,nearly,obovate,occasionally,once-furcate,papillose,pedicel,petiole,piece,poricidal,primary,pubescent,raised,shiny,shrub,simple,size,small,stem,stigma,style,tip,transverse,trichome,tube,vein,within,without,x	.25,0.6-1.1,1-2,10-20-flowered,11-15,12.5-17.3,4-6,5-6.5,acute,anthesi,apex,apically,attenuate,becoming,beginning,beneath,berry,caly,closely,conical,constricted,cucullate,decurrent,deflexed,differing,difoliate,drying,eaf,edicel,eed,enlarging,erect,exserted,filament,fleshy,free,geminat,imperceptibly,inflorescenc,known,lateral,lon,long,lower,main,major,margin,midrib,minutely,nflorescence,older,opposite,ovary,overlapping,ovoid,pair,papillo,partially,planar,pointed,pore,portion,restricted,robust,ruit,rusty-papillate,scar,secondary,shaped,shining,somewhat,spaced,straight,tall,tapering,tear-drop,thick,thickened,ud,uniseriate,unit,white,woody,ympodial,young	abaxial,characteristic,colour,diameter,form,growth,height,inflorescence,length,midvein,na,plant,seed,shape,surface,texture
149	wfo-0001027396	success	244	126	107	137	19	0.439	0-3,0-30,0-4,0-5,0.5-1,0.5-1.5,0.7-2.5,0.8-1.3,1.5-3.5,1/3,10-30,12-25,2-3,2.8-4.5,20-100,3.5-6,5-30,5-8,5.5-7.5,6.5-7.5,7-10,8-20,abaxial,abaxially,acute,adaxial,almost,anther,apex,apically,apparently,articulated,attenuate,base,berry,black,brown,calyx,cm,cream,cuneate,dark,deltate,densely,diameter,elliptic,elongate,erect,fewer,filament,flattened-reniform,fruit,glabrous,glandular,green,hair,herb,lateral,leaf,length,lobe,lobed,long-styled,margin,marking,maturity,mauve,midvein,mm,near,obtuse,orange,pair,pale,pedicel,peduncle,petiole,plant,prickle,primary,pubescent,purple,red-brown,short-styled,shrub,simple,sometimes,somewhat,sparsely,spherical,stellate-pubescent,stem,style,surface,tertiary,trichome,unarmed,unbranched,upper,vein,venation,visible,white,yellow,yellow-green,yellowish,young	-2,-5,-6,/3,0-100,0.1-0.5,0.1-1,0.4-0.7,0.5-2,0.5-2.5,0.8,1,1-4,1.2-2,1.5-3,1.8-3,1/2-2/3,1/4-1/3,1/6,10-15,10-25,10-35,15-40,2-3.5,2-7,2.5-4,3-,3-9,4,4-5,4-6,4-7,5-10,5-20,5-50,5-merous,6-20,7-15,alyx,ame,andromonoecious,apar,apart,ba,bark,blade,broad,broad-deltate,bulbous,c.,chartaceous,concolorous,connivent,curved,decurrent,difoliate,discolorous,distal,distance,drying,eaf,eed,elongating,equal,extending,extensive,flattened,flower,free,fruiting,fully,geminat,glabrescent,gray-brow,hermaphrodite,heterostylous,infructescence,less,lignified,lobing,lon,long,long-acuminat,longer,lower,lowermost,mature,midpoint,moderately,nflorescence,often,older,one,open,opening,orolla,oung,pendulous,per,pericarp,perpendicular,poricidal,porrect,portion,prickl,prickly,ray,reflexed,rotate,ruit,scar,secondary,sessile,side,smooth,spaced,spreading,stalk,stalked,staminat,stout,straight,tamen,tapering,tearing,terete,time,tip,tube,unit,usually,variously,vary,way,wide,woody,ympodial	arrangement,branching,characteristic,colour,corolla,false,form,growth,height,inflorescence,long-acuminate,na,ovary,pseudostipule,rachi,seed,shape,staman,texture
150	wfo-0001027449	success	160	86	66	94	20	0.412	.75,0.5-1,0.5-1.5,0.8-1.5,0.9-1.1,1.4-1.5,10-15-flowered,2-4,3,3-3.5,5-6,acuminate,acute,anther,bark,base,beneath,berry,brown,calyx,cm,corolla,dark,densely,elliptic,filament,fruit,glabrate,glabrous,globose,green,inflorescence,leaf,lobe,long,long-triangular,minutely,mm,narrowly,oblique,often,older,ovary,ovoid-reniform,pale,papillose,pedicel,petiole,pitted,pubescent,red-papillose,shrub,simple,small,sparsely,stem,straight,style,surface,tree,trichome,trunk,uniseriate,white,x,young	.4,.5,/3,1.2-1.5,1.5-2.5,2-3,3-7,4-6,8-15,anthesi,apex,appearing,area,arising,around,axil,becoming,beginning,bud,closely,cup,deciduous,deflexed,dense,density,dia,differing,difoliate,dry,eaf,edicel,eed,ellipsoid,erect,exserted,extreme,forming,free,frui,fruiting,geminat,inflorescenc,lamina,later,lateral,like,lobed,lon,long-acuminate,lower,main,major,material,minor,nflorescence,obconic,one,opposite,orangish,overlapping,packed,pair,persistent,pointed,pore,poricidal,portion,prominent,raised,reddish-brow,reflexed,rest,ruit,scar,shaped,size,slender,soon,sparse,stigma,styl,tall,tapering,tear-drop,tip,tube,tuft,ud,unit,varying,vein,way,woody,ympodial	abaxial,characteristic,colour,diameter,form,growth,hair,height,length,margin,na,peduncle,plant,rachi,reddish-brown,seed,shape,staman,texture,type
151	wfo-0001027452	success	152	120	98	54	22	0.645	.5,0.5-1,0.5-1.5,0.5-2,1,1-2,1-3,1-5,1.5,1.5-3,10-20,2-6,2-foliate,3-6,3-9,4,4-6,5-12,5-20,absent,acute,anther,apex,base,berry,beyond,branched,brown,calyx,cell,celled,center,chartaceous,ciliate,cm,connected,decurrent,densely,diameter,dm,drying,elliptic,elliptic-ovoid,entire,equal,exserted,filament,flower,fruit,glabrous,globose,hair,herb,immature,large,linear-lanceolate,lobe,margin,maturing,membranaceous,mm,moderately,nearly,notched,obtuse,often,one-,outer,parallel,pedicel,peduncle,per,perpendicular,petiole,placenta,pubescent,rachi,raised,ridge,rounded,running,seed,semitransparent,significantly,single,smaller,smoother,stamen,straight,style,swollen,two-celled,unbranched,usually,wall,white,x,yellow	0.5-2.5,1-4.5,2-4,abaxially,abundant,adaxiall,adaxially,along,axe,blade,cordate,dehiscing,denser,eaf,eed,emarginat,explosively,flat,frui,geminat,growt,held,interpetalar,long,lower,lying,maturit,mesocarp,new,nfloresence,oblong,orolla,pressure,pubescen,rotate,ruit,short,slightly,sometimes,sparsely,stigma,tal,tamen,tem,tissue,triangular,tube,unit,vary,vein,watery,wid,woody,ympodial	abaxial,adaxial,arrangement,branching,characteristic,colour,corolla,form,geminate,growth,height,inflorescence,leaf,length,ovary,plant,shape,staman,stem,surface,texture,type
152	wfo-0001027471	success	165	95	76	89	19	0.461	.5,0.1-0.2,0.4-1,0.5-0.6,0.5-1.5,0.9-1,1-1.2,1-1.5,2-2.5,2-3,3-4,4-5,6-7,acute,anther,apex,base,berry,branched,calyx,cm,conical,corolla,dendritic,densely,diameter,elliptic,entire,filament,flattened,flower,glabrous,globose,growth,herb,inflorescence,lamina,leaf,lobe,long-triangular,margin,maturity,midvein,minutely,mixture,mm,ovary,ovate,pair,pale,pedicel,peduncle,petiole,pitted,primary,pubescent,rachi,red-orange,reniform,shape,shrub,simple,slender,small,sparsely,stem,style,subshrub,surface,tan,trichome,uniseriate,vein,white,x,yellowish	/4,0.2-0.4,0.2-0.5,0.5,0.5-0.7,0.7-0.9,1-1.6,1.4-3,1.5-2,2-lobed,3-7,abaxially,adaxially,age,along,anthesi,appressed,ascending,bark,bifid,brittle,c.,closely,deltate,desnsely,differing,difoliate,distant,drying,eaf,eed,erec,erect,especially,free,fruiting,furcate-dendritic,geminate,included,internodal,leaf-opposed,lengthening,less,like,lobed,lower,major,minor,new,nflorescence,nodding,node,occasionally,open-conical,orbicular,overlapping,papillat,perfect,pericarp,petal,planar,plane,pore,poridical,portion,pubscent,reflexed,ruit,scar,scattered,similar,size,slightly,slit,somewhat,spaced,stigma,straight,thickened,thin,tip,trifoliat,tube,ud,unit,usually,way,woody,ympodial	abaxial,adaxial,arrangement,branching,characteristic,colour,form,fruit,height,length,na,plant,pseudostipule,seed,staman,tertiary,texture,unarmed,venation
153	wfo-0001027473	success	138	92	62	76	30	0.449	0.5-1,0.8-1,1-1.5,1-2,1.3-2,1.8-2,2.5-3,3.5-5,6-9,?,acute,anther,apex,base,berry,brown,calyx,cm,corolla,decurrent,deflexed,dendritic,densely,di-,filament,flattened-reniform,glabrous,globose,green,incrassate,leaf,lobe,long-triangular,margin,minute,minutely,mm,near,obovate,occasionally,ovary,pair,pedicel,petiole,pitted,pointed,pubescent,rusty,sessile,shape,shrub,somewhat,sparsely,stem,style,subshrub,surface,trichome,trifoliate,vein,white,woody	.25,/2,0.25-0.5,1.5-2,1/3,2-2.5,4.5-13,5,8.5-37,abaxially,absen,adaxially,along,anthesi,ape,apparently,bark,clavate,conical,deccurent,deep,denser,dia,differing,drying,eaf,eed,empty,erect,free,fruiting,geminat,giving,later,lateral,less,like,lobed,long,lower,main,major,middle,minor,older,overall,pale,papillo,planar,pore,poricidal,portion,pubesent,rootstock,ruit,sac,shaped,sterile,stigma,strongly,tall,tear-drop,thick,tip,tube,unit,usually,way,wide,widest,wing,winged,yellowish,yellowish-brow,ympodial,young	0,abaxial,absent,adaxial,arrangement,branching,characteristic,colour,diameter,form,fruit,growth,height,history,inflorescence,length,life,midvein,na,peduncle,plant,primary,pseudostipule,rachi,seed,staman,tertiary,texture,unarmed,venation
154	wfo-0001027483	success	164	72	54	110	18	0.329	0.2-1.9,0.6,1.5-2.6,1.5-3,2-4,2-4.5,3-15,3-6,4.5-8,5-6,branched,calyx,cell,cm,coarsely,corolla,covering,cyme,diameter,dichasial,dichasially,ebracteate,elliptical,finely,globose,green,hair-like,herbaceous,lateral,leaf,leaflet,light,long,medium,mm,monochasial,odd-pinnate,ovate,ovoid,pair,pedicel,peduncle,perennial,petiole,plant,pubescent,seed,style,terminal,testal,thick,violet,violet-purple,wall	0-1.,1,1-2,1-2.5,1-4,1-5,1.2-2.5,1.5-10,2,2-3,3-6-foliat,3.5-20,5-10,abaxially,acumen,acute,adaxially,apex,apical,apically,articulate,basal,base,connate,cuneate,decurrent,dehiscent,digestion,diminishing,distal,dorsally,dot,eaf,edge,eed,emoval,enzyme,erec,exceeding,filament,flat,flower,folded,forked,generally,globo,gradually,green-white,half,honeycomb,interjected,interpetiolar,introrse,lighter,living,lobe,lon,lower,lunat,make,maturing,minute,mucilaginous,nflorescence,nther,obtuse,often,orolla,pattern,perfect,petiolule,plan,poricidally,proximal,purple,rachi,ray,reveal,rosette,rotate,rounded,ruit,sessile,seudostipule,short,size,slit,smooth,sometimes,specimen,stamen,stigma,straight,subsessile,tall,tem,throughout,tissu,toward,tuber-bearing,typically,uniform,unit,vary,varying,white,wide,yellow,ympodial,Â¼	anther,arrangement,characteristic,colour,form,fruit,growth,height,history,inflorescence,length,life,ovary,shape,stem,surface,texture,width
155	wfo-0001027506	success	215	105	90	125	15	0.419	.2,0-10,0-2,0-6,0-60,0.5-1.5,0.5-6,0.7-1.3,0.8-1.5,1.2-1.5,1.8,1/3,2-3.2,3-5,3.5-5,6.5-10,acuminate,acute,anther,apex,apically,apparently,articulated,base,becoming,berry,branched,brown,calyx,cell,cm,cordate,cream,cuneate,dark,densely,diameter,entire,erect,filament,fine,flattened-reniform,fruit,green,lateral,leaf,length,lobe,long,margin,marking,maturity,mauve,mm,moderately,narrow-deltate,occasionally,orange,orange-brown,outline,ovate,pale,pedicel,peduncle,per,petiole,pit,plant,prickle,prickly,purple,raised,shrub,small,smooth,sometimes,stellate-pubescent,stem,style,subentire,surface,terminal,tree,truncate,twice,unarmed,upper,wide,yellow,young	-0.35,-1,-20,-3,-7,-7.5,.5,/2,/6,0,0.1-,0.1-0.3,0.2,0.2-0.3,0.25,1-2,1-3,1-4,1.5-2.2,1/6-1/4,10-40,2.2-3.5,2.5-5,2.5-8,3-10,3-6,5-10,5-7,5-merous,6-13,7-8,7-9,8-10,9-13,abaxially,acuminat,alyx,ame,andromonoecious,apar,apart,bark,blade,brow,c.,chartaceous,concolorous,connivent,curved,distal,dry,drying,eaf,eed,elongating,equal,flattened,flower,free,fruiting,glabrescent,glabrous,hard,hermaphrodite,heterostylous,infructescence,lengt,lobed,long-styled,longer,lower,lowermost,mature,midpoint,multangulate,nflorescence,older,one,open,orolla,oung,pair,pendulous,pericarp,plurifoliat,poricidal,porrect,portion,prickl,primary,ray,reddish,reduced,reflexed,ruit,scar,sessile,short-styled,simple,spaced,spherical,spreading,stalk,stalked,staminat,stellate,stout,tamen,tapering,terete,tertiary,time,tip,trichome,tube,unit,variously,vary,vein,venation,visible,way,woody,yellow-green,ympodial	abaxial,characteristic,colour,corolla,form,growth,height,inflorescence,na,ovary,seed,shape,staman,texture,type
156	wfo-0001027548	success	216	112	96	120	16	0.444	.3,0.3-1.2,0.5-2,1,1-1.5,1-2.5,1.2,1.5-2.5,10-12,4-8,4.5,6-9,acuminate,acute,almost,along,anther,apex,attenuate,base,berry,black,branched,branching,brown,calyx,cell,cm,corolla,dark,deltate,dendritic,densely,depressed-elliptic,diameter,elliptic,elongate,entire,filament,flattened-reniform,glabrous,globose,green,growth,immature,inflorescence,lamina,leaf,like,lilac,lobe,long,loose,loosely,many,margin,membranous,minutely,mm,narrowly,near,outline,pedicel,peduncle,per,petiole,pitted,puberulent,pubescent,rectangular,revolute,ripe,scattered,simple,slender,small,sparsely,stem,style,surface,terminal,testal,thickened,time,tinged,tiny,trichome,type,uniseriate,upper,usually,vein,vine,white,woody,x	-11.5,0.2,0.5,1-10,1-3.5,1.5,1.5-2,10-50,3-7,4-6,5-merou,7-10,8-9,abaxiall,adaxially,ag,also,although,alyx,anthesi,apart,apical,apparently,appearing,area,ark,articulated,articulation,axi,basal,beneath,bent,branch,bu,c.,capitate,conical,connivent,darker,deflexe,denser,drying,dull,eaf,early,eed,ellipsoid,em,exserted,extending,flexuous,flower,free,fruiting,geminat,glabrescen,glandular,half,herbarium,ilament,irregularly,leaving,lengthening,less,lobed,lon,long-styled,lower,matte,minute,mixed,new,nflorescence,occasionally,older,orolla,pair,pale,papillae,papillate,papillo,perfect,pericarp,planar,plurifoliate,point,pore,poricidal,portion,primary,prominent,rachi,reddish,ruit,scar,size,slit,sometimes,somewhat,spaced,sparse,specimen,spreading,stellate,stigma,strongly,swollen,tapering,thin,tip,transparent,tube,twinin,ud,unit,vary,warty,way,yellow,ympodial	8,abaxial,arrangement,characteristic,colour,form,fruit,height,length,na,ovary,plant,seed,shape,staman,texture
157	wfo-0001027581	success	200	95	61	139	34	0.305	abaxial,abaxially,acute,adaxial,anther,anthesi,apex,base,berry,branched,branching,broadly,brown,calyx,cm,corolla,dark,deltate,densely,diameter,elliptic,entire,evenly,filament,flattened-reniform,globose,golden,green,greyish,growth,inflorescence,leaf,length,lobe,many,margin,mm,moderately,nodding,pair,pedicel,peduncle,petiole,plane,primary,pubescent,purple,reddish,ripe,shrub,simple,small,sparsely,stem,stout,style,surface,terminal,time,tree,vein	0.2â0.3,0.3,0.3â1,0.5â1,0.5â1.5,1,1.2â1.5,1.3â1.5,1.5,1.5â2,1.5â3,10,100+,10â16,12,12â30,15â20,1â1.5,1â3-rayed,2.5â3,200,3.5â4.5,3â3.5,4.5â16,4â8,5-merou,6â7,7â10,7â9,8,8â10,9â11,9â9.5,>,ag,along,alyx,apar,ark,articulated,axe,beneath,brow,bulbous,c.,clavate,clearly,closely,connivent,cup-shaped,dichasia,discolorous,distally,drying,eaf,echinoid,eed,ellipsoidal,erec,exserted,flower,free,fruiting,glabrescent,glabrous,gradually,ilament,lamina,largest,lengthening,less,like,lobed,long,longest,loosely,lower,midvei,minute,minutely,mixed,multangulate,multiseriate,narrowing,near,new,nflorescence,older,orolla,papillo,part,per,perfect,pericarp,pitted,plurifoliate,pore,poricidal,porrect-stellate,portion,ray,reflexed,rhachi,ruit,scar,scarcely,sessile,shiny,short-stalked,size,slit,smaller,spaced,spreading,stalk,stellate,stigma,tall,tem,thin,tip,trichome,tube,ud,undersurface,unevenly,unit,upper,vary,varying,visible,way,weak,whit,wide,woody,yellow,yellowish,ympodial	1-1.5,1.3-1.5,1.5-2,1.5-3,2.5-3,3-3.5,4-8,7-10,7-9,9-11,9-9.5,arrangement,characteristic,colour,form,fruit,height,history,life,midvein,na,ovary,plant,pseudostipule,rachi,seed,shape,staman,tertiary,texture,unarmed,venation,white,ye
158	wfo-0001027584	success	144	100	72	72	28	0.5	-16,-2,0.5-1,0.5-1.5,0.9-1,0.9-2.5,1-1.2,1.5-2,1.6-1.9,10-15,2,2-10,3,3-.,4-6,4-7,7-10,abruptly,acuminate,anther,apex,attenuate,base,branched,broadly,calyx,cm,conical,corolla,darker,deltate,densely,diameter,ellipsoid,elliptic,filament,flattened,four,fruit,glabrous,green,herb,lobe,long,margin,minutely,mm,ovary,ovate,pair,pale,papillate,pedicel,peduncle,per,petiole,primary,reddish,reniform,shrub,smooth,sparsely,stem,stripe,style,suffruticose,surface,tan,time,vein,white,x	..,.5,1.2-1.4,1.5-8,100,11.5-45,2.5-3,4.5-20,8-9,absent,anthesi,apical,bark,becoming,beginning,beneath,branch,brittle,brow,c.,capitat,cell,cucullate,deflexe,dry,eaf,edicel,eed,erec,flower,fruiting,irregular,lamina,lobed,lower,markedly,narrowly,nearly,nflorescence,open,outer,outline,pericarp,planar,plurifoliat,pointed,present,regularly,ruit,scar,scattered,single,single-stemmed,sinuate,small,sparse,stigma,striate,testal,thickening,thin,tip,triangular,trichome,tube,tuft,ud,uniseriate,unit,wall,without,ympdoial	abaxial,adaxial,arrangement,branching,characteristic,colour,deflexed,form,growth,height,history,inflorescence,leaf,length,life,midvein,na,plant,plurifoliate,pseudostipule,rachi,seed,shape,staman,tertiary,texture,unarmed,venation
159	wfo-0001027600	success	185	140	109	76	31	0.589	0.5-1.5,1,1-14,1-2,1-4,1-5,1.5-2,10-,10-20,15-25,2-11,2-3,2-3.5,2-4,2-4.5,2-6,20-30,3-15,3-5,3-5-lobed,3-6,8-17,abaxially,acuminate,acute,adaxial,adaxially,along,apex,articulated,axe,basal,base,beyond,calyx,cm,collection,cordate,cuneate,deltate,densely,diameter,dilated,distally,ellipsoidal,entire,especially,except,exserted,fading,flattened,fleshy,flower,forked,fruit,glabrescent,glabrous,greenish-white,leaf,leaving,lobe,lobed,long,main,margin,mature,midrib,minutely,mm,moderately,obconical,obtuse,occasionally,older,orange,pedicel,pedicellar,peduncle,perfect,petiole,pilose,pinnately,puberulence,puberulent,pubescent,purple,rachi,rarely,remnant,rounded,simple,slightly,somewhat,sparsely,stamen,strongly,style,subcoriaceous,surface,tip,tree,truncate,unbranched,unlobed,vein,x,yellow,yellow-green,young	-10,-3,0.5-1,1.5-2.5,1/2-3/4,2-18,2-5,2.5-21,2.5-6,4-6,4-foliat,5-13,abruptly,absen,absent,adpressed,aggregate,apart,ape,apical,apiculate,blade,brow,campanulate,cell,channe,concave,connective,coriaceous,cream,directed,divided,eaf,eed,elliptic,exceeding,gland,glandular-puberulent,laterally,lon,lower,narrowed,nflorescence,nther,oblong,orolla,ovate,ovoid,papillose,pilo,pore,puberulen,purplish,radiu,ruit,shorter,sinus,small,spaced,stigma,stone,tal,tem,thecae,time,tomento,triangular,tube,two,ud,unit,vary,white,wide,yellowish,ympodial	abaxial,anther,arrangement,branching,channel,characteristic,colour,corolla,filament,form,green,growth,height,history,inflorescence,length,life,midvein,na,ovary,plant,primary,pseudostipule,seed,shape,staman,stem,tertiary,texture,unarmed,venation
160	wfo-0001027607	success	167	101	72	95	29	0.431	0.25-0.5,0.5-1,0.8-1,1-4,2-2.5,2-3,2-4,2.5-3,3-3.5,4-10-flowered,5-7,8-9,acuminate,acute,anther,apex,arching,base,berry,brown,calyx,cm,corolla,dark,decurrent,deltoid,densely,dia,dry,elliptic,filament,filiform,flattened,gently,glabrous,globose,golden,green,leaf,lobe,long,material,minutely,mm,narrowly,ovary,ovoid-reniform,pair,papillose,pedicel,petiole,pitted,plant,present,pubescent,raised,short,shrub,simple,slender,stem,straight,style,surface,tan,tapering,treelet,unifoliate,vein,white,winged,x	.1,.25,.5,0.5,1,1.2-1.5,1.5-3,3/4,5-10,age,anthesi,apar,area,aspect,ba,bark,basal,becoming,branch,branche,corky,curling,deflexed,eaf,edicel,eed,ellipsoid,elongate,erect,evenly,except,exserted,f,free,fruiting,geminate,giving,glabrate,lamina,lateral,lenticellat,less,like,lobed,lon,lower,m.,main,middle,midrib,minute,narrow,nflorescence,non-reproductive,obovoid,occasionally,older,opposite,pagoda-like,pore,poricidal,portion,prominent,rarely,reddish-brown,reflexed,ruit,scar,shaped,slight,slightly,small,soon,spaced,stigma,strongly,styl,tall,tear-drop,tip,trichome,tub,tube,ud,uniseriate,unit,way,widened,widening,widest,woody,yellowish,ympodial,young,zig-zag	0.25,2.5,abaxial,adaxial,arrangement,branching,characteristic,colour,diameter,form,fruit,growth,height,inflorescence,length,margin,midvein,na,peduncle,primary,pseudostipule,rachi,seed,shape,staman,tertiary,texture,unarmed,venation
161	wfo-0001027618	success	202	101	80	122	21	0.396	-pubescent,1-14,1-23,1-3,1-5,1-9,1.4-4,11-pinnate,15-35,2-11,2-5,2.5-6,3-5,3-7-pinnate,4,4-8,5-7.5,6-40,8-16,8-35,abaxially,acute,adaxially,also,apex,base,branched,bud,chartaceous,cm,compound,cordate,cuneate,deltate,densely,diameter,ellipsoidal,entire,flower,fruit,fusiform,glabrous,globose,greenish,leaf,length,lobe,margin,membranaceous,minutely,mm,obtuse,orange,pedicel,peduncle,per,pilose,pinnately,puberulent,puberulent-pubescent,pubescent-pilose,purple,rachi,reticulate,ripe,shrub,simple,sometimes,sparsely,style,sympodial,tree,triangular,truncate,unbranched,unit,white,width,x,yellow	-10,0-10,0.5,0.5-1,0.5-6,1,1-,1-1.5,1-13,1.5-13,1.5-3,1.5-7,1.5-8.5,11-16,11-22,12-27,15-30,2-11.5,2-12,2-27,2-8.5,2-9,3-18,3-30,3-7,3.5-6,5-18,5-20,5-30,5-merous,5.5-12,6-25,7-25,acuminat,acut,aggregate,alyx,apart,ape,articulated,ascending,axe,basal,beyond,blade,campanulate,capitate,cell,connective,cylindrical,darker,dia,diamete,dilated,directed,distally,eaf,eed,elliptic,elliptic-ovate,exceeding,exserted,fleshy,lateral,laterally,leaflet,leaving,less,lon,long,longitudinal,lower,mesocarp,moderately,near,nflorescence,nther,oblong,obovate,obtu,often,orolla,ovate,papillose,pedicellar,perfec,perfect,petiole,petiolule,pilo,pore,presen,puberulent-pilo,pubescent,radiu,ranch,ratio,remnant,rown,ruit,runk,shallowly,shorter,slightly,small,somewhat,spaced,spreading,stamen,stigma,stone,stripe,tal,terminal,thecae,tomentose,tube,uni,urceolate,vary,wide,without	1-8.5,acuminate,anther,arrangement,branching,calyx,characteristic,colour,corolla,crown,form,growth,height,inflorescence,ovary,plant,seed,shape,surface,texture,trunk
162	wfo-0001027622	invalid_json	203	129	94	109	35	0.463	.5,0-14,0.3-10,1,1-2,1.5-3.5,2-25,2-6,2.5-3.5,3-4,3-4.5,3.5-11,6-7,abaxially,acuminate,acute,adaxially,anther,apex,articulated,base,berry,blue,blue-purple,broadly,brownish,cell,chartaceous,cm,condition,corolla,covering,diameter,distal,drying,elliptical,filament,fresh,fruit,glabrescent,glabrous,globose,green,green-white,greenish,hair,hair-like,herb,lateral,light,like,lobe,long,make,margin,membranous,middle,mm,mottled,mucilaginous,narrowly,oblique,odd-pinnate,ovate,ovate-lanceolate,ovoid,pale,pedicel,peduncle,petal,petiole,plant,pubescent,purple,rounded,seed,shortly,slightly,star,stem,striped,style,subglabrous,testal,thick,throughout,truncate,unwinged,wall,wet,whitish,wide,wing,yellow	0-16,1-10,1.5-4.2,1.6-4.5,1/,12-23,2-3,3-16,4-5,4-9.5,5-11,5-merou,6-17,8-16,8-20,acumen,ag,along,alyx,apart,apparently,axe,axillary,blade,borne,bud,capitat,ciliate,clavate,connivent,decumben,different,digestion,dorsally,eaf,edge,eed,elliptic,end,enzyme,erect,especially,exceeding,except,flat,flower,folded,forked,geminat,generally,glabrou,greatly,half,homostylous,honeycomb-shaped,interjected,lanceolate,leaflet,lengthening,living,lower,midrib,minutely,nflorescence,often,orolla,pair,pentagonal,perfect,petiolule,plurifoliate,population,pore,poricidal,proximal,puberulent,reduced,removed,ruit,seudostipule,singly,size,slit,sometimes,spaced,specimen,stamen,ste,stellate,stigma,stolo,straight,subequal,subtending,tall,tamen,tem,terminal,tip,tri-,tube,tuber,typically,unit,usually,vary,varying,x,ympodial	'',1/3,2,[,``,abaxial,adaxial,arrangement,branching,calyx,characteristic,colour,form,growth,height,inflorescence,leaf,length,midvein,na,ovary,primary,pseudostipule,rachi,shape,staman,surface,tertiary,texture,unarmed,value,vein,venation,{,}
163	wfo-0001027624	success	189	107	78	111	29	0.413	0.1-0.9,0.3-1,0.5-1.5,1-2,1.1-8.4,1.3-2.9,2-20,2.4-4.8,3-10,3-4,4-7,4-8,5-9,9-41,acuminate,acute,anther,apex,articulated,base,berry,brownish,cell,cm,condition,corolla,covering,decurrent,deep,densely,diameter,drying,elliptic,entirely,filament,flower,forked,fresh,fruit,glabrous,globose,green,greenish,hair,hair-like,herb,lanceolate,lateral,leaf,light,like,lobe,long,mm,mottled,odd-pinnate,onto,ovate,ovoid,pedicel,peduncle,petiole,plant,pubescent,purple,rachi,seed,short,sometimes,style,testal,thick,unwinged,usually,wall,white,whitish,widely	0-3,0-7,0.4-3,0.8-5.6,1-3,1-5,1.2-2.6,1.5-6.6,2-5,2-7,2.9-12,3-11,3-5,4-15.2,5-merou,6-18.5,abaxially,acuman,acumen,adaxially,ag,along,alyx,apart,apparently,arranged,axe,axillary,bead,blade,bud,capitat,clavate,connivent,considerably,cuneate,decreasing,decumben,digestion,distal,dorsally,eaf,edge,eed,enzyme,erect,exceeding,flat,folded,geminat,glabrou,green-white,half,homostylous,honeycomb-shaped,interjected,larger,leaflet,leave,lengthening,living,lower,make,middl,moniliform,mucilaginous,multiple,necklace,nflorescence,orbicular,orolla,pair,pentagonal,perfect,plurifoliate,pore,poricidal,present,removed,rotate,ruit,sessile,seudostipule,size,slightly,slit,spaced,specimen,stamen,stigma,stolon,straight,subtending,tall,tamen,tem,terminal,throughout,tip,toward,tri-,tube,tuber,typically,unit,vary,wet,wide,x,yellow,ympodial	2,abaxial,adaxial,arrangement,branching,calyx,characteristic,colour,form,growth,height,inflorescence,length,margin,mentioned,middle,midvein,ovary,primary,pseudostipule,shape,staman,stem,surface,tertiary,texture,unarmed,vein,venation
164	wfo-0001027626	success	152	107	81	71	26	0.533	.3,.5,0.2â0.6,0.5-1,0.5â1,0.7â1,1,1.5â2,1.5â8,13â14,2â49,2â5,3â4,3â5,4â6,5â6,8,9â18,acuminate,adaxially,anther,apex,arrangement,base,broadly,calyx,chartaceous,cm,cordate,coriaceous,densely,diameter,distichous,elliptical,entire,extra-axillary,filament,fleshy,flower,fruit,glabrous,greenish-white,leaf-opposed,liana,lobe,margin,midvein,minutely,mm,moderately,nearly,oblique,ovate,pair,pedicel,peduncle,petiole,pinnate,pointed,possibly,pubescent,rachi,rounded,sand-punctate,shortly,shrub,slender,somewhat,spaced,sparsely,spindle-shaped,style,terminal,tip,unbranched,unknown,vein,venation,white,wiry-woody,x	0.1â0.2,0.7â2.8,1.3â4.5,14â116,2â3,3â4.5,3â55,4.4â11,5-merous,abaxially,accrescen,acute,along,alyx,apar,axe,berry,blade,c.,capitat,center,ciliat,clavate,climbing,color,distant,distinct,eaf,eed,frequently,fruiting,glabrou,immature,lamina,lanceolate,line,long,lower,m.,maturity,membranous,mor,nflorescence,nternode,orolla,perfec,petal,plurifoliat,reflexed,ruit,sand-punctat,scandent,scar,secondary,seen,side,simple,ste,stellate,stigma,tamen,tem,time,trichome,truncate,tube,two,unit,vary,wide,ympodial	abaxial,adaxial,apart,branching,characteristic,colour,corolla,form,growth,height,inflorescence,leaf,length,na,ovary,plant,primary,pseudostipule,seed,shape,staman,stem,surface,tertiary,texture,unarmed
165	wfo-0001027630	success	149	79	56	93	23	0.376	0.5-1,0.5-1.2,0.5-2,1-5,1.5-2,2-6-flowered,4-6,8-9,acute,anther,base,berry,broadly,calyx,ciliate,climbing,cm,corolla,decurrent,deflexed,deltoid,densely,erose,filament,fruit,glabrous,globose,golden,hirsute,knob-like,lanceolate,leaf,linear,lobe,long,margin,mm,ovary,pedicel,petiole,puberulent,pubescent,shrub,simple,sparsely,stem,straight,strongly,style,swollen,tapering,trichome,uniseriate,white,winged,yellowish	.1,.2,.5,0.05-0.1,1-1.5,1.4-1.7,2-3,3/4,5.5-11.2,6-10,also,anthesi,apart,apex,arising,bark,beginning,blunt,branchlet,de,dia,distinguishable,eaf,edicel,eed,elongat,except,extreme,free,fruiting,glabrate,globo,green,immature,indistinct,inflorescenc,internodal,irregularly,known,lateral,lobed,lon,long-acuminate,lower,main,middle,midrib,minutely,near,nflorescence,novo,occasionally,older,opposite,pair,paler,papillose,partially,pore,poricidal,portion,prominent,proximal,raised,reflexed,rest,rounded,ruit,scar,seen,shaped,slender,spaced,stigma,tall,tear-drop,terminal,thickened,ti,tip,tube,ud,ultimate,unifoliat,unit,vein,way,wide,widest,wing,x,ympodial,young	abaxial,adaxial,arrangement,branching,characteristic,colour,diameter,form,growth,hair,height,inflorescence,length,na,peduncle,plant,rachi,seed,shape,staman,surface,texture,unifoliate
166	wfo-0001027661	success	222	110	85	137	25	0.383	+,0.5,0.5-,0.5-2,0.6-1.1,1-1.5,1-7,1.5-2,4.5-6,5-9,6-12,6-9,8-10,<,acuminate,acute,anther,apex,base,berry,bright,broadly,calyx,cm,cordate,corolla,densely,diameter,ellipsoid,entire,extremely,filament,flattened,glabrous,globose,green,grey,growth,herbaceous,lateral,leaf,leaf-opposed,lobe,lobed,margin,minutely,mm,moderately,often,pair,pale,pedicel,peduncle,petiole,pinnatifid,pitted,primary,pubescent,purple,purplish,rachi,red,reniform,ripe,shape,simple,slender,sparsely,spreading,stem,style,surface,tan,terminal,ternately,triangular,truncate,variable,vein,vine,violet,white,woody,yellow,yellowish	-10,0.6-1.5,1-,1-5,1.2-6,1.3,1.5,2,2.5-3,2.5-7,30,4-15,4-8-celled,40,5-merou,6-8,>,abaxially,adaxiall,ag,along,alyx,anthesi,apart,ark,articulate,axi,basal,branch,branched,capitate,cell,column,commonly,conical,connivent,creeping,deeply,dendritic,denser,density,eaf,eed,elliptic,even,flower,free,fruiting,fused,gre,ground,hue,ilament,irregularly,lamina,leaving,lengthening,like,long,long-exserted,lower,many,markedly,membraneous,minute,mixture,narrowing,near,new,nflorescence,occasionally,older,open,orolla,outline,ovate,papillat,papillate,papillo,peg,pentagonal,per,perfect,pericarp,plurifoliat,pointed,pore,poricidal,portion,prominent,pubescen,pubescence,rarely,reflexed,ruit,scar,shiny,short,single,sinus,size,sleeve,slit,small,spaced,spot,spreadin,stellate,stigma,strongly,swollen,tangled,tem,testa,thin,tightly,time,tip,trailing,trichome,tube,turbinate,two,type,ud,underground,unieriate,uniseriate,unit,upper,usually,vary,way,wide,ympodial,zig-za,Â¾	abaxial,adaxial,arrangement,branching,characteristic,colour,form,fruit,height,history,inflorescence,length,life,midvein,na,ovary,plant,plurifoliate,pseudostipule,seed,staman,tertiary,texture,unarmed,venation
167	wfo-0001027714	success	251	118	110	141	8	0.438	+,.5,/3,0.5,1-1.5,1-1.6,1-2,1.5-2,1.5-2.5,1.5-5,14-16,2-,2-2.5,2.5-4,3-3.5,4-5,4.5-5,5,5-6,7-20,<,acuminate,acute,almost,anther,anthesi,apex,basal,base,berry,branched,bright,brown,calyx,cm,conical,cordate,corky,corolla,deep,deflexed,densely,diameter,ellipsoid,elliptic,elongate,entire,filament,flattened,fruit,fruiting,furcate,glabrate,glabrous,globose,growth,inflorescence,juicy,lateral,leaf,lobe,lobed,longer,many,margin,mm,new,nodding,obovate,occasionally,often,ovary,pair,pale,pedicel,peduncle,petiole,pinnatifid,pubescent,purple,red,reddish,reniform,ripe,seed,shiny,simple,slender,somewhat,sparsely,stellate-rotate,stem,style,surface,tangled,terminal,time,tip,trichome,truncate,tube,uniseriate,usually,vine,violet,way,weak,woody,x,yellowish	0,0.4,0.5-0.7,0.6-0.7,0.9-1.5,1,1-,1.5-3,2-8,2.5-,2373.,4-10,5-10,5-merou,6-7,80,abaxial,abaxially,adaxial,adaxially,age,aid,along,alyx,angle,apar,apice,appearance,ark,around,articulated,axi,canop,capitate,cell,channelled,climbin,confined,connected,connivent,creating,cucullate,cupped,dendritic,denser,drying,eaf,eed,enlarged,especially,exserted,fide,fleshy,flower,free,giving,glabrou,groove,hairy,hanging,ilament,immature,individual,inflated,irregularly,lamina,large,leaving,lengthening,like,lon,long,loosely,lower,marginal,mature,mere,minute,minutely,mpodial,nee,nflorescence,older,orolla,otherwise,outline,papillate,papillo,peg,per,perfect,pericarp,petal,petiolule,pitted,plat,plurifoliat,pore,poricidal,portion,primary,prominent,pubescence,reaching,rectangular,rim,ruit,scar,showy,similar,sleeve,slightly,slit,small,spaced,spreading,stigma,strongly,tem,testa,testal,thecae,thick,thickened,thin,third,tiny,tooth,twining,ud,uniformly,unit,upper,vein,visible,wall,weight,widest,wing,yellow,younger	arrangement,bark,characteristic,colour,form,length,shape,texture
168	wfo-0001027720	success	184	108	86	98	22	0.467	0,0-15,0.3-5,0.5-0.8,0.5-1,0.8-1,1-1.5,1-2,1-3.5,1-locular,15-25,2-3,2-4,2-7,2-branched,2-foliate,3-13,4-5.5,4-7,7-8,7-9,8-16,absent,acute,anther,apex,base,berry,brown,calyx,chartaceous,cm,cuneate,cylindrical,deltate,densely,diameter,elliptic,entire,extra-axillary,filament,flattened,flower,fruit,glabrous,globose,green,hair,inflorescence,leaf,length,lilac,lobe,long,margin,mm,narrowly,notched,oblique,ovate,pale,part,pedicel,peduncle,per,perennial,petiole,present,pubescent,rachi,red,shrub,simple,slightly,sparsely,stellate,stellate-pubescent,straight,style,subreniform,surface,toward,triangular,unarmed,unit,yellow	%,.25-0.3,0.15-0.25,0.25-0.35,0.4-0.7,0.4-0.8,0.6-1.2,1.5-2,13-23,13-35,2.8-3.1,23-35,4-,4.3-15,4.3-7.5,5-merous,6,7-10,8-11,9-15,abaxially,absen,adaxiall,adaxially,adult,alyx,apparently,articulated,axe,ba,blade,capitat,confined,connivent,directed,distall,distally,eaf,eed,eglandular,erect,finger,fruiting,geminat,gland-tipped,half,hig,homostylous,incomplete,intepetalar,juicy,juvenile,lamina,lanceolate,lateral,less,loosely,lower,markedly,mature,mesocarp,mid-point,midpoint,midrib,minute,nflorescence,orolla,perfec,perfect,pore,porrect,prickle,ray,rhizomatous,ruit,scarce,septum,sessile,short,stellae,stigma,succulen,tamen,tem,thick,thicker,time,tissue,tube,unarme,upper,vary,white,wide,without,x,yellowi,ympodial	abaxial,adaxial,arrangement,branching,characteristic,colour,corolla,form,geminate,growth,height,history,life,ovary,plant,pubescence,seed,shape,staman,stem,sympodial,texture
169	wfo-0001027720	success	272	122	104	168	18	0.382	0.1â0.6,0.8â1.9,1.5â2.5,1.5â3.3,1.5â9.0,1.7â2.5,1.8â2.0,10.0,12â16,2.0,2.5â2.8,2â3,3.7â5.7,4.0â12.6,5.1â18.6,6.5â9.5,8.0,8.0â11.9,abaxially,acuminate,acute,adaxially,anther,apex,apiculate,attachment,attenuate,base,berry,calyx,cancellate,channeled,cm,conical,corolla,curved,developed,diameter,distally,elliptic,entire,filament,filiform,flattened-irregular,flattened-orbicular,flattened-reniform,flower,fruit,glabrous,globose,gradually,growth,hair,hooked,increasing,interpetalar,lavender,leaf,lobe,long,margin,mature,midvein,mm,notched,occasionally,often,orange,ovate,pedicel,peduncle,petiole,point,poorly,prickle,raised,red,scattered,short,shrub,simple,slightly,small,stellae,stellate,stem,straight,style,subacute,subcoriaceous,surface,tissue,tree,twice-branched,unarmed,vein,violet,wavy,white,yellow,yellow-ferruginous,yellow-tan,Ã,â4	.0,.04,.2,.3,.5,.9,0,0.2â0.4,0.3â0.4,0.7â0.9,0.7â1.1,0.7â1.2,0.8â1.3,0.8â2.0,0.9,1.4â1.9,1.5â1.7,1.5â2.0,1.7â1.8,1.7â2.0,1.9â2.2,1/2,1/3,1/3â1/2,10.8â18.2,13.0,19.7â30.0,2.5,2.5â2.9,3.2,3.6,3.9,4.0â18.0,4â5-merou,6â8,8.2â10.5,8.5â9.4,9.5â16.0,adnate,aequilateral,alyx,anthesi,apical,apparently,appearing,armed,articulated,axe,ba,becoming,bilobed,blade,branch,broad,broad-based,brochidodromous,bud,capitate,channel,colore,concave,congested,connivent,cream,crisped,deciduous,dehiscence,densely,dentate,difoliate,dorsally,dry,eaf,eed,either,emerging,endocarp,erect,especially,exocarp,extra-axillary,fertile,free,geminat,glandular,glossy,heavily,homostylous,inclined,internode,intersepalar,juic,juvenile,lamina,large,lateral,least,like,line,lon,longer,lower,m.,major,midpoint,midrib,minor,minute,moderately,narrowly,nearly,nflorescence,oblique,oblong,orolla,part,per,perforate,pore,porrect,porrect-stellate,portion,potentially,presumably,proximal,pubescent,ray,reflexed,rigid,rip,row,ruit,sessile,shorter,side,sinus,soon,sparsely,splitting,spread,stamen,stellate-pubescen,stellate-pubescent,stigma,suture,tall,tamen,tem,thin,time,tip,toward,translucent,triangular,truncate,tube,two,ud,upper,vary,way,weakly,wide,yellow-ferruginou,ympodia,young,youngest,Â±equal	abaxial,adaxial,arrangement,branching,characteristic,colour,form,height,inflorescence,length,ovary,plant,primary,rachi,seed,shape,staman,texture
170	wfo-0001027757	success	186	108	64	122	44	0.344	12,2,acute,anther,anthesi,apex,axillary,base,blue,borne,branching,brown,calyx,cm,colour,cylindrical,dark,decurrent,deeply,densely,diameter,elliptic,erect,filament,flattened,fruit,glabrous,globose,irregularly,lanceolate,leaf,leafy,lilac,lobe,lobed,margin,mm,moderately,narrowly,oblong,obtuse,occasionally,often,ovate,pale,pedicel,peduncle,perennial,petiole,pitted,primary,pubescent,regularly,shoot,shrub,simple,sparsely,straight,style,surface,unknown,violet,woody,x	0.2,0.2â0.3,0.3â2.0,0.5,0.6,0.6â1.0,0.7,0â1.4,1.0â1.1,1.0â2.5,1.2â4.0,1.5â1.6,1.5â2.5,1.6â2.4,1.9â2.7,1â1.5,1â11,1â2,1â3,2.5,2.5â4,2.5â5.5,2.5â7,2â,2â10,3â12,3â5,4â9,5,5â,60â100,6â9,7â8,8â16,abaxially,absen,accrescent,adaxiall,adaxially,ag,along,apart,apical,arising,articulated,axe,ba,basal,blade,campanulate,cell,chartaceous,clavate,concave,connivent,convex,directed,distally,eaf,eed,entire,equal,erose,fleshy,flower,geminat,glabrescen,glabrou,hair,lon,long,longitudinal,lower,m.,multicellular,nflorescence,opening,opposed,orolla,pair,perfect,plurifoliate,pore,poricidal,probably,rootstock,rotate,ruit,secondary,serrate,side,slit,smaller,sometimes,spaced,stigma,stone,tall,tamen,tem,thic,thickened,time,tip,toward,tube,unbranched,unicellular,uniseriate,unit,vary,white,wide,yellow,ympodial,â19,â2.7,â3.2,â4.0,â5.5,â6,â9	0-1.4,0.2-0.3,1-1.5,1.0-1.1,1.0-2.5,1.5-1.6,1.5-2.5,19,2-10,2.5-4,2.5-5.5,2.5-7,4-9,5-8,6-9,60-100,8-16,abaxial,adaxial,arrangement,characteristic,corolla,form,growth,height,history,inflorescence,length,life,midvein,na,ovary,plant,pseudostipule,rachi,seed,shape,staman,stem,tertiary,texture,unarmed,vein,venation
171	wfo-0001027765	success	167	103	83	84	20	0.497	-44,0.8,1-10,1-11.5,1-5,10-13,2-2.5,2-4,2.5-4,2.5-4.2,20-30,5-6,acute,apex,apical,apically,base,branched,calyx,cell,cm,cordate,corolla,covering,cyme,dehiscent,diameter,dichasial,dichasially,ebracteate,exceeding,glandular,globose,green,hair,hair-like,herbaceous,introrse,lateral,leaf,leaflet,light,long,make,maturing,mm,monochasial,mucilaginous,oblique,obtuse,odd-pinnate,often,ovate,ovate-lanceolate,ovoid,pedicel,peduncle,perennial,petiole,pilose,plant,poricidally,rounded,seed,short,simple,size,slightly,slit,stamen,stigma,straight,style,testal,thick,throughout,tone,truncate,tuber-bearing,violet,wall,white,wide	-30,-4,0-.,1,1-,1-2,1-4,1.5-6,2-3,3-,3-12,3-20,3-6-foliat,5,5-15,5-8,7-20,abaxial,abaxially,abruptly,acumen,acuminate,apiculate,articulate,connate,cuneate,digestion,diminishing,distal,dorsally,eaf,edge,eed,elliptic,elliptic-lanceolate,emoval,enzyme,filament,flat,flower,folded,forked,generally,globo,green-white,half,honeycomb,interjected,living,lobe,lon,lower,lunat,nflorescence,nther,orolla,ovate-elliptic,pair,pattern,perfect,petiolate,petiolule,plan,proximal,reveal,ruit,sessile,seudostipule,side,specimen,stellate,tal,tem,terminal,throughou,tip,toward,typically,unit,vary,without,yellow,ympodial,Â¼	anther,arrangement,characteristic,colour,dehiscence,form,fruit,growth,height,history,inflorescence,length,life,ovary,shape,stem,surface,texture,wet,ye
172	wfo-0001027807	invalid_json	116	102	80	36	22	0.69	.5,0-0.2,0.2-0.3,0.2-0.9,0.3-0.4,0.9-1,1-1.5,15-30,2-5,2-6,abaxially,acuminate,acute,adaxially,apex,attenuate,barely,bark,base,berry,brown,bud,closely,cm,decurrent,deflexed,diameter,dry,elliptic,flattened,flower,fruiting,glabrous,globose,gray,grayish,green,growth,known,lanceolate,leaf,margin,material,maturity,minutely,mm,narrowly,new,overlapping,pair,pale,papillate,parallel,pedicel,peduncle,petiole,pitted,plane,primary,prominent,rachi,reddish,reniform,revolute,scar,shrub,simple,slender,slightly,small,somewhat,spaced,sparsely,stem,surface,tree,vein,visible,white,winged	0.1-1,0.9-2.5,3.5-9,almost,brittle,deflexe,difoliate,drying,eaf,eed,ellipti,geminat,internodal,know,leaf-opposed,midrib,nflorescence,occasionally,older,ot,paler,papillae,reddi,reproductive,ruit,seemingly,shoot,thickened,ud,unifoliate,unit,usually,x,yellowish,ympodial,young	'',[,``,arrangement,characteristic,colour,form,fruit,height,inflorescence,length,midvein,papilla,plant,seed,shape,texture,type,value,width,{,}
173	wfo-0001027816	success	187	86	66	121	20	0.353	.5,0.5-1,0.6-0.8,0.7-1,1,1-1.5,1-3,1.5-2,3-3.5,3.5-4,4-5,6-9,acuminate,acute,anther,apex,attenuate,base,berry,bluish,branched,brown,calyx,cm,corolla,dark,diameter,entire,filament,filiform,flattened,glabrous,glandular,globose,growth,inflorescence,lanceolate,lateral,leaf,linear,lobe,margin,minutely,mm,occasionally,orange,pair,pedicel,peduncle,petiole,pitted,plant,primary,pubescent,purple,reddish,reniform,shrub,simple,stem,style,surface,terminal,triangular,vein,x	..,0.2,0.5,0.5-2,1-1,1-4,1.2-2,1.8-6,12-14,2-2.5,2-4,2/3,5-30,5-merou,<,ag,almost,along,alyx,anthesi,apar,ark,articulated,axi,becoming,capitate,cell,confined,conical,connivent,cupped,dense,densely,drying,eaf,eed,ellipsoid,em,erect,exserted,fleshy,flower,free,fruiting,gland-tipped,half,ilament,irregularly,leaving,lengthening,less,like,lobed,loosely,lower,m.,markedly,minute,new,nflorescence,nodding,often,older,orolla,papillo,patent,peg,per,perfect,perhaps,pericarp,plurifoliat,pore,poricidal,portion,prominen,pubescen,rectangular,red,ripe,rounded,ruit,scar,several,shiny,sleeve,slightly,slit,small,sometimes,somewhat,spaced,sparse,sparsely,spreadin,spreading,square,stellate,stigma,testal,thin,time,tip,trichome,tube,twinin,ud,ultimate,uniformly,uniseriate,unit,upper,usually,variable,vary,viscous,way,woody,yellowish,ympodial,Â½	abaxial,adaxial,arrangement,branching,characteristic,colour,form,fruit,height,length,midvein,na,ovary,pseudostipule,rachi,seed,shape,staman,texture,unarmed
174	wfo-0001027819	success	199	100	79	120	21	0.397	1-2,10-20,10-50,16-25,2-,2-15,2-3,20-35,25-35,3-40,3-5,3-5-lobed,4,4-10,4-5,5-6,8-10,9-12,abaxially,acute,adaxially,apex,base,blade,branched,cm,cordate,cuneate,cylindrical,densely,diameter,ellipsoidal,elliptic,entire,especially,fading,finely,forked,fruit,glabrous,globose,green,leaf,length,lobe,lobed,margin,mm,narrowly,oblong,obtuse,occasionally,ovate,pedicel,peduncle,per,petiole,pinnately,probably,puberulent,purple,rachi,rarely,rugose,simple,sparsely,style,subcoriaceous,sympodial,tree,unbranched,unit,unknown,unlobed,usually,whitish,width,x,yellow	-100,0.5-1,1,1-,1-5,1.5-2,12-21,15-22,2,20-25,20-40,22-35,4-15,4-25,5,5-merous,aggregate,also,alyx,apart,ape,apical,apiculat,articulated,axe,ba,basal,beyond,cell,ciliate,color,concave,connective,deeply,denser,dia,diamete,dilated,directed,distally,divided,eaf,eed,eglandular,eglandular-pilose,elliptic-ovate,equal,exceeding,except,exserted,fleshy,flower,hair,halfway,leaving,lon,long,lower,main,mesocarp,midrib,moderately,narrow,near,nflorescence,nther,oblique,obtu,often,orolla,pedicellar,perfec,perfect,pilose,pore,present,prominent,protuberance,puberulen,puberulence,purplish,radiu,ranch,ratio,remnant,ripe,rounded,rown,ruit,runk,shallowly,short-acuminat,shorter,sinus,slightly,small,sometimes,spaced,stamen,stellate,stigma,stone,strongly,swelling,tal,thecae,toward,triangular,truncate,tube,two,ud,umbrella-shaped,uni,vary,vein,villous,wide,without,young	anther,arrangement,branching,bud,calyx,characteristic,colour,corolla,crown,form,growth,height,inflorescence,ovary,plant,seed,shape,short-acuminate,surface,texture,trunk
175	wfo-0001027834	success	236	121	98	138	23	0.415	-6.1,0.2-0.3,0.2-0.4,0.2-0.6,0.5-2,0.9-1.8,1-1.6,1-1.9,1-10,1.1-1.6,1.1-1.8,1.4-2,1.8-4.9,2-8,2.2-4.3,2.3-3.4,25,4-5.2,4.8-6.9,5-20,6.9-18.1,9-11.9,9-13,abaxial,abaxially,acuminate,acute,adaxial,adaxially,anther,apex,attenuate,base,berry,branched,branching,brown,bud,calyx,cm,coriaceous,corolla,deltoid,diameter,entire,filament,finely,fleshy,flower,fruit,glabrous,globose,granular-tomentose,gray,leaf,lenticular,lobe,many,margin,mm,numerous,obtuse,ovate,ovate-elliptic,pair,pedicel,peduncle,petiole,primary,pubescence,rachi,reticulate-punctate,ripe,rounded,scabridulous,semi-ovate,short,shrub,simple,small,soft,sometimes,sparsely,stellate-pubescent,stem,style,surface,time,tomentose,tree,vein,velutinous-tomentose,white,whitish-tomentose,x,yellow,yellowish-tan,yellowish-tomentose	.5-3,0-110,0.4-1.1,1-2.5,1.6-2.7,1/2,10-25,2-3.8,2.4-6.2,2.7-7.3,2.9-4.2,3-15,3-4.3,4-6,5-merous,5.1-8,absent,accrescent,ag,alyx,angled,anthesi,apar,apical,around,articulated,axillary,ba,bark,becoming,blade,blunt-tipped,branch,capitat,closely,completely,concentrated,connivent,covering,crown,cylindrical,dendritic-echinoi,dendritic-echinoid,densely,dichasia,directed,discolorous,distally,drying,eaf,echinoi,echinoid,edge,eed,ellipsoid,enclosing,enveloping,equal,erec,exserted,farinose,flat-topped,forming,fruiting,glabrescent,grooved,hair,high,included,inserted,lengthening,less,light,lobed,long,long-stalked,longitudinal,longitudinally,lower,mostly,multangulat,multangulate,near,nflorescence,obovate,obscured,older,orbicular,orolla,ovate-lanceolate,perfec,persistent,plurifoliate,pore,poricidal,porrect-stellate,pseudo-terminal,pubescent,rarely,ray,ruit,runk,scar,semi-spherical,sessile,short-stalked,slit,somewhat,spaced,spreading,stalked,stamen,stellate,stigma,subcampanulate,subcoriaceous,suture,tamen,though,tip,tomentu,tomentum,toward,trichome,tube,turbinoid,ud,unarme,unit,usually,vary,villous,way,whitish,wide,yellowish,ympodial,young	arrangement,characteristic,colour,dichasial,form,growth,height,history,inflorescence,length,life,midvein,na,ovary,plant,pseud-terminal,pseudostipule,seed,shape,staman,texture,unarmed,ye
176	wfo-0001027843	success	154	73	47	107	26	0.305	0.5-1,0.8-3.5,1-1.2,1-1.3,1-1.5,1.2-1.5,2-2.5,5-6,6-9,acute,anther,apex,base,calyx,cm,corolla,deltoid,erose,filament,glabrous,globose,green,leaf,lobe,long-acuminate,margin,mm,ovary,ovate,pair,pedicel,petiole,pubescent,shape,shrub,simple,slender,sparsely,stem,straight,style,surface,tapering,vein,white,winged,x	.5,.75,/3,0.5-0.75,1.2-2.5,2-4,3-15-flowered,3-6,6-13,along,anthesi,apart,apiculate,ba,bark,bearing,becoming,beginning,beneath,berry,broadly,clavate,conical,coroll,curly,deflexed,densely,denser,dia,differing,difoliate,distally,eaf,edicel,eed,ellipsoid,exsertion,flower,free,fruiting,geminat,glabrate,hairy,impressed,irregularly,known,lamina,larger,later,lateral,like,lobed,lon,long,lower,main,major,middle,minor,minutely,near,nearly,nflorescence,occasionally,older,one,opposite,orbicular,papillo,papillose,pleated,pore,poricidal,portion,prominent,proximal,reddish-gre,reflexed,rounded,ruit,scar,shaped,sinus,size,slightly,somewhat,spaced,sparser,stiff,stigma,strongly,tall,tear-drop,time,tip,tipped,trichome,tube,two,ud,uniseriate,unit,way,widest,woody,ympodial,young	abaxial,adaxial,arrangement,branching,characteristic,colour,diameter,form,fruit,growth,height,inflorescence,length,midvein,na,peduncle,plant,primary,pseudostipule,rachi,seed,staman,tertiary,texture,unarmed,venation
177	wfo-0001027847	success	219	104	83	136	21	0.379	-2.5,0-2,0.4-1,0.8-1.2,1.5-2,1.5-2.5,1/4,2-2.8,2.2-3,3-5,3-6,5-25,5.5-8,acute,anther,apex,apparently,articulated,base,berry,calyx,cm,cordate,deltate,densely,diameter,dull,elliptic,erect,evenly,faint,filament,finely,fruit,glabrous,gray,green,lateral,leaf,length,lobe,lobed,lower,margin,maturity,mauve,midvein,mm,narrow-deltate,orange,orange-brown,ovate,pair,pedicel,peduncle,per,petiole,pitted,primary,purple,red,red-brown,rounded,seed,shrub,simple,sometimes,sparsely,spherical,stellate-pubescent,stem,style,surface,terminal,tertiary,unarmed,upper,vein,venation,visible,white,yellow,young	-0.8,-2,-3,-4,-5,-6,.35,.7,/2,/3,0,0-7,0.1-0.4,0.15-0.2,0.2,0.5,0.5-1,0.8,0.8-0.9,1,1-2,1-2.5,1.5-5,1.9-2.3,1/2,1/6-1/3,2-3,2-4,2-5,2.5-3.5,2/,3-15,3.5-6,4-5-merous,5-6,6-11,6-8,7-10,abaxially,almost,alyx,ame,apar,apart,apically,bark,blade,branched,broadly,brow,c.,chartaceous,connivent,curved,dimorphic,discolorous,distance,drying,eaf,edge,eed,elongating,equal,extending,filiform,filiform-acuminat,flattened,flattened-reniform,flower,free,fruiting,geminate,glabrescent,increasing,infructescence,lon,long,longer,mature,middle,midpoint,minor,moderately,nflorescence,older,one,open,orbicular,orolla,oung,pendulous,perfec,pericarp,perpendicular,pit,plurifoliat,poricidal,porrect,portion,prickl,prickle,prickly,ray,reddish,retrorse,ruit,scandent,scar,sessile,side,size,slender,smooth,spaced,spreading,stalk,stalked,stellate,straight,strongly,tamen,tapering,terete,time,tip,toward,trichome,tube,unit,usually,variously,vary,way,weakly,wide,ympodial	2/3,abaxial,adaxial,arrangement,branching,characteristic,colour,corolla,false,form,growth,height,inflorescence,na,ovary,plant,pseudostipule,rachi,shape,staman,texture
178	wfo-0001027872	success	190	116	96	94	20	0.505	1,1-8,10,2,2.2-3.5,5-7,5-8,6-20,8-11,abaxially,adaxially,apiculate,b,base,branched,ca,calyx,caudate,cell,celled,cm,commonly,cordate,covering,cuneate,cyme,deep,densely,diameter,dichasial,dichasially,ebracteate,elliptic,four-celled,glabrescent,gland,glandular,glandular-pubescent,globose,gray-green,green,hair-like,herbaceous,homogeneously,interjected,lanceolate,lateral,leaflet,light,lobe,long,longer,make,middle,mm,moderately,monochasial,mottled,mucilaginous,narrowly,nearly,obliquely,oblong,odd-pinnate,ovate,ovoid,pedicel,peduncle,perennial,petiolulate,petiolule,plant,pubescent,purple,rhizomatous,rounded,seed,sessile,shape,short,single,size,slightly,sometimes,style,terminal,testal,thick,tinged,tip,type,usually,wall,wide,wider,yellowish-green	0.5,1-1.2,1-4,1.0-1.3,1.5-4,12-35,15,2-3,2.8,20,3-6-foliat,35,4-6,5-10,5-lobed,acumen,acuminate,acute,angular,apex,apical,apically,articulate,ba,basal,becoming,clasping,connate,decreasing,dehiscent,digestion,distal,eaf,eed,emoval,enzyme,erect,exceeding,externally,filament,flower,forked,generally,globo,green-white,half,honeycomb,introrse,living,lon,lower,maturing,nflorescence,nther,often,orolla,pair,pattern,pentagonal,perfect,petiolate,poricidally,puberulent,purpl,rarely,reduced,reveal,rhizome,rotate,rotate-,ruit,semi-lunate,seudostipule,slit,somewhat,specimen,stamen,ste,stigma,straight,subequal,symmetrically,tem,terete,trailing,typically,unbranched,uniformly,unit,vary,viole,wid,yellow,ympodial	anther,arrangement,branching,characteristic,colour,corolla,form,fruit,growth,height,inflorescence,leaf,length,margin,ovary,stem,surface,texture,violet,wet
179	wfo-0001027880	success	185	126	101	84	25	0.546	.25,0.5-1.5,0.5-5,0.6-1,0.6-1.5,0.8-1.5,1-14,1-15,1-2,1-3,1.5-2,1.5-3,10-15,2-3,2-80,3-4,4-10,4-6,5-8,8,abaxially,acuminate,acute,adaxially,anther,apart,apex,apiculate,articulated,base,blade,branching,calyx,cm,contiguously,cordate,coriaceous,curled,cylindrical,deltate,densely,diameter,discolorous,entire,extra-axillary,filament,flattened,flower,fruit,glabrous,globose,greenish,hair,inflorescence,leaf,leaf-opposed,lobe,margin,midvein,minutely,mm,nearly,oblique,oblong-ovate,often,ovate,ovoid,pair,papillose,pedicel,peduncle,petiole,pink,pubescent,purple,rachi,red-brown,revolute,ripe,rounded,rugulose,scar,shrub,simple,slightly,sometimes,somewhat,spaced,style,surface,tan,thickened,tip,truncate,unbranched,undulate,uniseriate,vein,vine,white,x	-3,-3.5,0.3-3,1-2.5,2/,5-11,5-merou,absen,accrescen,ag,aggregate,along,alyx,apparently,axe,ba,branch,cell,chartaceous,ciliat,clavate,conical,connivent,dense,diminishing,directed,distally,distichous,distinct,distinctly,eaf,eed,epiphytic,equal,fruiting,geminat,green,growing,increasing,internode,line,long,longer,longitudinal,lower,multicellular,nflorescence,node,oblong,occasionally,opening,orolla,pale,perfect,plurifoliate,point,pore,pubescen,reddish,rooting,ruit,secondary,size,slender,slit,sparsely,ste,stellate,stigma,stone,tamen,tem,time,trailing,tree,trunk,tube,typically,unit,usually,vary,wide,yellow,ympodial	abaxial,adaxial,arrangement,characteristic,colour,corolla,form,growth,height,history,length,life,na,ovary,plant,primary,pseudostipule,seed,shape,staman,stem,tertiary,texture,unarmed,venation
180	wfo-0001027880	success	170	113	91	79	22	0.535	.25,0.5,0.5â1.5,0.6â1,0.6â1.5,0.8â1.5,1.5â2,1.5â3,10â15,1â14,1â15,1â2,2/3,2â3,4â10,4â6,5-merous,5â8,absent,acuminate,acute,anther,apex,apiculate,arrangement,base,bluish-purple,calyx,chartaceous,clavate,cm,conical,cordate,coriaceous,cylindrical,densely,diameter,distichous,entire,extra-axillary,filament,flower,fruit,glabrous,globose,greenish,leaf,leaf-opposed,longer,lower,margin,membranous,midvein,minutely,mm,nearly,oblique,oblong-ovate,often,ovate,ovoid,papillose,pedicel,peduncle,petiole,pink,pubescent,rachi,red,reddish-brown,revolute,rounded,rugulose,sand-punctate,shrubby,sometimes,somewhat,sparsely,stellate,stigma,style,surface,tan,trichome,truncate,unbranched,undulate,vine,white,x,â3.5	0.2-0.5,0.3â3,0.5â5,1â2.5,1â3,2-80,3â4,5â11,8,abaxially,accrescen,adaxially,along,alyx,apar,axe,berry,blade,c.,capitat,ciliat,climbing,contiguously,curled,deltate,dense,discolored,distinct,distinctly,eaf,eed,flattened,fruiting,green,hair,lanceolate,line,lobe,long,m.,mottled,nflorescence,nternode,occasionally,orolla,pair,pale,perfec,pinnate,plurifoliat,reddish,rip,ruit,sand-punctat,scar,secondary,simple,slender,slightly,spaced,ste,tamen,tem,thickened,time,tip,tree,trunk,tube,typically,uniseriate,unit,vary,vegetatio,vein,venation,wide,woody,ympodial	abaxial,adaxial,branching,capitate,colour,corolla,form,growth,inflorescence,internode,length,merosity,ovary,position,punctation,ripe,seed,shape,size,staman,stem,texture
181	wfo-0001027881	success	215	113	75	140	38	0.349	-3,abaxially,absent,acute,almost,anther,apex,articulated,attenuate,barely,base,berry,calyx,camptodromous,chartaceous,ciliate,cm,contiguous,cordate,cordiform,densely,diameter,entire,extra-axillary,eye,few-,filament,flattened,flower,fruit,glabrous,globose,greenish,groove,herb,immature,lateral,leaf,lobe,many-branched,margin,maturity,membranaceous,mm,moderately,naked,ovate-elliptic,parallel,pedicel,peduncle,petiole,primary,projection,pubescence,pubescent,rachi,raised,reniform,seed,sessile,short,similar,simple,sparsely,staman,stem,style,subopposite,surface,translucent,vein,venation,visible,white,Ã	.3â0.5,0.5â2.2,0.8â1.5,1-celled,1.3â2,1.8â2.9,10â25,1â2,1â2-celled,1â2.5,1â2.6,1â3,1â3-celled,1â4,2.5â3.6,20â40,2â4,2â6,2â7,4â6,4â9.5,5,5-merous,6â10,7â14,7â9,8,abundant,accrescent,acuminate,adaxiall,adaxially,alyx,appressed,asymmetric,axe,ba,blackish,blade,bulge,capitat,case,central,closely,commonly,connected,connivent,curved,cylindrical,decurrent,dehiscing,denser,difoliate,directed,dorsally,drying,eaf,ed,eglandular,emarginate,emerging,equal,erect,exceeding,exclusively,explosively,fewer,forming,frequent,geminate,giving,glandular,hair,half,held,hollow,impression,interpetalar,introrsely,larger,less,light-brown,like,long,longer,longitudinal,lower,mainly,maturit,mesocarp,mixed,much,multicelled,multicellular,near,netlike,nflorescence,normally,one,opening,orolla,other,pair,part,per,perfec,placenta,pore,pressure,prominent,rotate,ruit,secondary,side,size,slightly,slit,small,smaller,solitary,sometimes,stalk,stamen,stigma,subapically,tal,tamen,tem,tissue,triangular,tube,two,unbranched,unit,vary,watery,winged,woody,yellow,ympodial	0.5-2.2,1-2,1-2.5,1-2.6,1.3-2,1.8-2.9,2-6,2-7,2.5-3.6,20-40,4-6,6-10,7-14,7-9,abaxial,adaxial,arrangement,branching,characteristic,colour,corolla,form,growth,height,history,inflorescence,length,life,midvein,na,ovary,perennial,plant,pseudostipule,shape,tertiary,texture,unarmed
182	wfo-0001027882	success	184	148	130	54	18	0.707	0.1,0.5-1,1,1-1.5,1-5,1.5-2,1.5-2.2,1.5-6,10-40,2-3,2-6,2-lobed,2.1-2.6,2.5-3,3-4,3.5-4,3.5-5,4-5,6-9,9-13,acuminate,along,anther,anthesi,apart,apex,apparently,appearing,attenuate,axil,bark,base,berry,branch,branched,brown,calyx,clavate,cm,completely,conical,corolla,cucullate,dark,deltate,dense,densely,diameter,elliptic,entire,erect,exerted,filament,flattened,flower,fork,fruiting,fusiform,glabrous,globose,green,growth,hairy,hollow,hooked,inflorescence,irregularly,leaf-opposed,less,lobe,margin,maturity,midrib,minutely,mm,new,nodding,occasionally,ovary,ovoid,pair,pale,papillate,paulo,pedicel,peduncle,perfect,petiole,pitted,plane,pointed,population,primary,pulp,rachi,rarely,reddish,reniform,scar,shiny,shrub,simple,slender,small,sometimes,spaced,sparse,sparsely,stem,sticky,stigma,stout,strongly,structurally,style,surface,swollen,sÃ£o,time,tip,tree,trichome,tube,tuft,uniseriate,usually,vein,white,x,yellow	.25,.5,06a,1.5-,1.6-2.2,10-25,3.2-6,7-,abaxially,absent,adaxially,age,branching,broadly,c.,caly,difoliate,dry,drying,eaf,eed,et,fide,free,geminat,glabrou,junction,kallunki,lamina,lengthening,lobed,lower,markedly,nflorescence,papillat,penden,planar,pore,poricidal,portion,red-papillat,ruit,shattering,slit,specimen,straight,sweet-scented,thickened,ud,unit,way,woody,yellowish,ympodial	abaxial,adaxial,arrangement,bud,characteristic,colour,form,fruit,height,leaf,length,plant,red-papillate,seed,shape,texture,type,unknown
183	wfo-0001027889	success	151	106	80	71	26	0.53	-pubescent,0,0.5-1,0.5-11,0.7-2,1,1-3,1-3.5,1.5,1.5-2,10-12,10-20,10-30,2-3,3-4,3-8,acute,acute-acuminate,apart,apex,apiculate,articulated,basal,base,calyx,chartaceous,cm,darker,deltate,densely,diameter,eglandular-puberulent,eglandular-pubescent,elliptic,entire,finely,flower,fruit,glabrous,glandular-,green,greenish,immature,leaving,length,light,lobe,long,longitudinal,margin,mm,moderately,ovate,ovoid,pedicel,pedicellar,peduncle,perfect,petiole,probably,puberulent,puberulent-pubescent,rachi,remnant,ripe,shrub,simple,spaced,sparsely,stripe,style,subcordate,tip,tree,truncate,unbranched,violet,white,x,yellowish	-2.5,.5,.5-2,1-10,2-20,3-9,4-foliat,5-10,abaxially,acuminate,adaxially,aggregate,ape,axe,beyond,blade,capitat,cell,color,connective,connivent,cylindrical,dilated,directed,distally,eaf,eed,equal,exceeding,exserted,extending,introrse,laterally,lon,lower,narrow,nflorescence,nther,oblong,orolla,pore,presen,present,puberulen,puberulent-pubescen,radiu,ruit,slightly,small,somewhat,stamen,stellate,stigma,stone,subcoriaceous,swelling,tal,tem,thecae,time,tomento,tomentose,triangular,tube,ud,unit,unknown,vary,wide,yello,ympodial	1-2.5,abaxial,adaxial,anther,arrangement,branching,characteristic,colour,corolla,filament,form,growth,height,inflorescence,leaf,na,ovary,plant,pseudostipule,seed,shape,staman,stem,surface,texture,unarmed
184	wfo-0001027901	success	156	99	72	84	27	0.462	.25,.5,0.3-1.2,0.8-1,1-2.5,2.5-3,3-5,4-5,6-7,abaxial,abaxially,acuminate,acute,adaxially,anther,anthesi,apex,attenuate,base,berry,bright,brown,calyx,cm,corolla,dark,dry,elliptic,filament,firm,fleshy,fresh,glabrous,globose,green,imbedded,immature,inflorescence,keeled,leaf,lobe,long,material,matrix,minutely,mm,ovary,ovoid-reniform,pair,pedicel,petiole,pitted,prominently,pubescent,reflexed,ripe,shape,shiny,shrub,simple,sparsely,stem,style,surface,translucent,triangular,trichome,uniseriate,vein,white,x,yellow	0.5-1,0.8-2,0.9-2.3,1-1.5,1-2,1.5-1.8,1.8-4.5,4-10-flowered,4.7-12,?,area,ba,bark,beneath,broadened,brow,closely,conical,curled,deflexed,densely,dia,differing,difoliate,direction,drying,eaf,edicel,eed,ellipsoid,exserted,free,fruiting,geminat,later,lateral,like,lobed,lon,lower,main,major,middle,midrib,minor,nearly,nflorescence,older,opposite,orbicular,oriented,overlappin,papillo,papillose,planar,pore,poricidal,portion,reddish,rest,rounded,ruit,scar,shaped,single,size,slender,spaced,stigma,straight,strongly,swollen,tall,tear-drop,tip,tub,tube,ud,unit,usually,widest,woody,ympodial,young	adaxial,arrangement,branching,characteristic,colour,diameter,form,fruit,growth,height,history,length,life,margin,midvein,na,peduncle,plant,primary,pseudostipule,rachi,seed,staman,tertiary,texture,unarmed,venation
185	wfo-0001027902	success	128	88	62	66	26	0.484	-2.5,0.5-1,1-1.5,1-6,10-15,10-20,2,2-12,2-15,2-3,2-8,3-4,3-5,4-5,7-9,acuminate,acute,angled,apex,articulated,base,branched,calyx,chartaceous,cm,cordate,deeply,densely,diameter,entire,forked,fruit,globose,leaving,lobe,long,margin,mm,moderately,obtuse,ovate,pedicel,pedicellar,peduncle,petiole,puberulent,pubescent,purple,rachi,remnant,reticulate,shrub,simple,small,sparsely,style,tip,tree,truncate,unknown,whitish,x	1-2,1.5-3,15-30,2-9,20-50,3-foliat,4-25,5-20,6-37,8-13,abaxially,absen,adaxiall,adaxially,aggregate,apart,axe,blade,cell,color,connivent,cylindrical,directed,distall,distally,eaf,eed,eglandular,flower,glabrous,glandular,hair,inflated,like,lon,lower,narrowly,nearly,nflorescence,nther,orolla,pore,pubescen,purplish,radiu,ripe,ruit,spaced,ste,stellate,stigma,stone,subcoriaceous,tal,tem,time,triangular,truncat,tube,unbranched,unit,usually,vary,wide,yellow,ympodial	abaxial,adaxial,anther,arrangement,branching,characteristic,colour,corolla,filament,form,growth,height,inflorescence,leaf,length,na,ovary,plant,pseudostipule,seed,shape,staman,stem,surface,texture,unarmed
186	wfo-0001027929	success	193	119	94	99	25	0.487	1,1-10,1.0-1.3,10,2.0-3.0,20,3.5-5,4-5,5-6,5-lobed,6-15,along,apical,apically,apiculate,beyond,branched,calyx,caudate,cell,center,clasping,cm,coat,connate,corolla,covering,cyme,dark,darker-violet-blue,deep,dehiscent,diameter,dichasial,dichasially,ebracteate,elliptic,embryo,except,formed,glabrous,globose,green,green-white,hair,hair-like,herbaceous,introrse,lanceolate,lateral,light,lobe,make,maturing,middle,mm,monochasial,mucilaginous,narrowly,oblong,occasional,odd-pinnate,often,ovate,pedicel,peduncle,perennial,plant,poricidally,puberulent,purple,rhizomatous,rotate,seed,semi-lunate,shape,short,slit,sometimes,spot,stigma,straight,style,symmetrically,testal,thick,tinged,usually,vein,violet,violet-blue,visible,wall,yellow	0.2-0.9,1-4,1-8,1.5-4,15,2,2-3,3-6-foliat,35,4-30,4-6,5-10,abaxially,acumen,acuminate,acute,adaxially,angular,apex,articulate,ba,basal,base,becoming,cente,color,cordate,cuneate,decreasing,digestion,distal,eaf,eed,emoval,enzyme,erect,exceeding,filament,flower,forked,generally,globo,half,honeycomb,included,interjected,leaflet,living,lon,long,lower,mostly,nearly,nflorescence,nther,obliquely,orolla,ovoid,pair,pattern,pentagonal,perfect,petiolate,petiolulate,petiolule,purpl,radiating,rarely,reduced,reveal,rhizome,rotate-,rounded,ruit,sessile,seudostipule,size,slightly,somewhat,specimen,stamen,star,ste,subequal,tem,terete,terminal,tip,trailing,typically,unbranched,unit,vary,white,wid,wide,wider,without,ympodial	abaxial,adaxial,anther,arrangement,branching,characteristic,colour,form,fruit,growth,height,history,inflorescence,leaf,length,life,ovary,petiole,pseudostipule,reproduction,rotate-pentagonal,stem,surface,texture,wet
187	wfo-0001027948	success	186	107	79	107	28	0.425	-15,-6,.5,0-,0.5-2,1-1.2,1.3-1.8,1.5-4.5,10-14,13,3.7-4,7,7.5-10,abaxially,abundant,acuminate,adaxially,anther,apex,attenuate,basal,base,berry,calyx,cm,corolla,diameter,directed,elliptical,filament,flexuous,generally,glabrous,glandular,globose,herb,herbaceous,ill-smelling,leaf,length,light,lobe,long,longitudinally,many-,margin,midvein,mm,narrowly,occasionally,ovate,ovoid,pair,patent,petiole,pubescent,purple,ridged,seed,seeded,serrulate,simple,slightly,small,stem,straight,style,sub-shrub,tooth,triangular,trichome,unequal,upward,vein,violet,viscid-pubescent,x,Â¼,Â½	-16,0.4,0.5-0.7,0.6,0.8-,1-2,1.2-2.2,1.6,1/10,14,2-,2.2-,2.5-,3-8.2,3.2-5.2,3.5,5,5-,6-celled,7-15,8-celled,accrescen,ag,aggregate,antrorse,ape,articulate,ature,bicellular,branch,c.,campanulate,cell,connectival,crushed,cuticle,dark,delicate,diamete,difoliate,dorsally,eaf,edentate,ellipsoidal,erect,finely,fragrance,free,fruiting,head,hig,hollow,inconspicuous,inserted,lamina,long-stalked,longer,longitudinal,lower,narrow,near,non-glandular,odorles,opening,orolla,papillate,pericarp,pore,poricidal,portion,prolongation,pubescence,reduced,ree,ruit,saddle-shape,scarce,scarcely,secondary,seen,separated,short-stalked,shorter,single-celled,sinus,slit,smooth,solitary,spur-like,stalk,stigma,stone,striat,striate,sub-opposite,tem,thecae,thickened,time,tip,tube,twice,unit,vary,ventrifixed,verrucate,ympodial	0.8-2.2,2.5-5.2,abaxial,adaxial,arrangement,branching,characteristic,colour,form,fruit,growth,height,inflorescence,na,ovary,pedicel,peduncle,plant,primary,pseudostipule,rachi,shape,staman,surface,tertiary,texture,unarmed,venation
188	wfo-0001027961	success	177	103	83	94	20	0.469	.5,0.5-1,0.9-1,1-1.5,1-5,1-9,10-50,2-2.5,2.3-2.5,3-3.5,4.5-5,7-9,8-10,?,acute,anther,anthesi,apex,asymmetric,base,berry,branched,broadly,calyx,cm,cordate,corolla,curling,deltate,densely,diameter,elliptic,entire,fading,filament,flower,glabrous,globose,green,growth,immature,inflorescence,lateral,lobe,lobed,many,margin,maturity,mm,obovate,occasionally,often,one,other,pair,pedicel,peduncle,petiole,primary,probably,pubescent,purple,shiny,simple,slender,slightly,sparsely,spreading,stem,style,surface,terminal,time,triangular,truncate,twining,vein,vine,violet,white,white-pubescent,woody,x	0.25,0.25-0.5,1,1-3,1-4,2.5-9,5-8,5-merou,6-9,<,abaxially,adaxiall,adaxially,age,always,alyx,apar,ark,articulated,axil,brow,c.,clavate,clear,conical,connivent,distributed,eaf,early,eed,ellipsoid,equalling,exserted,free,fruiting,fusiform,geminat,ilament,irregularly,lamina,lengthening,lon,long,loosely,lower,mature,membranous,midrib,minute,minutely,new,nflorescence,observed,older,orolla,papillo,pendan,perfect,pericarp,pinched,pinnatifid,planar,plurifoliate,pore,poricidal,portion,present,pubescen,reddish,rotate-stellate,ruit,scar,sleeve,slit,small,spaced,stigma,tem,thin,tip,transition,trichome,tube,tuft,twinin,ud,unequal,uniseriate,unit,upper,vary,way,yellow,ympodial	abaxial,adaxial,arrangement,branching,characteristic,colour,form,fruit,leaf,length,midvein,na,ovary,pseudostipule,rachi,seed,shape,staman,texture,unarmed
189	wfo-0001027966	success	207	89	61	146	28	0.295	1-1.8,1-2,1-4.2,1-5,1.3-2.2,10,10-30,2.2-2.9,3-4,3-5,3-7,40-80,5-6,6-11,acuminate,anther,apex,attenuate,base,berry,blue-violet,chartaceous,cm,conical,corolla,densely,diameter,elliptic,filament,fruit,glabrous,green,greenish,herb,leaf,light,lobe,long,margin,medium,membranous,minute,mm,mottled,mucilaginous,odd-pinnate,ovate,ovoid,pedicel,peduncle,petiole,plant,pubescent,purple,seed,sessile,slightly,sparsely,stem,subsessile,whitish	0.4-0.5,0.7-3,0.8,0.8-2.5,1-10,1-3,1.2-4.5,1.5-3,1.5-5.2,2.5-10.5,2.8-9,4,5-10,5-9.5,5-merou,5.5-14,abaxially,absent,acumen,adaxially,ag,along,alyx,apart,apparently,arranged,articulated,asymmetrical,axe,axillary,basiscopic,bead,blade,brownish,bud,capitat,cell,ciliate,commonly,condition,connivent,covering,decreasing,digestion,distal,dorsally,drying,eaf,edge,eed,enzyme,erec,especially,exceeding,flat,flower,folded,forked,fresh,geminat,generally,glabrou,gradually,green-white,hair,hair-like,half,homostylous,honeycomb-shaped,interjected,lanceolate,larger,lateral,leaflet,lengthening,less,like,living,lower,make,middle,moniliform,multiple,narrow,necklace,nflorescence,orbicular,orolla,pair,pale,pentagonal,perfect,petiolule,plurifoliate,pore,poricidal,proximal,rarely,ray,removed,ripe,rotate,ruit,secondary,semierect,seudostipule,shorter,side,size,slit,somewhat,spaced,specimen,stamen,ste,stigma,stolon,straight,subequal,subtending,symmetrical,tall,tamen,tem,terminal,testal,thick,throughout,tip,tissue,tri-,tube,tuber,tyle,typically,unit,usually,violet,wall,wet,white,wide,wing,x,yellow,ympodial	abaxial,adaxial,arrangement,branching,calyx,characteristic,colour,form,growth,height,inflorescence,length,midvein,na,ovary,primary,pseudostipule,rachi,shape,staman,style,surface,tertiary,texture,unarmed,vein,venation,width
190	wfo-0001028014	success	222	124	103	119	21	0.464	-15,-2.5,-5,-6,0,0.2-1,0.2-1.6,0.25,0.5-1,0.5-2,0.7-1,0.9-1.2,1-4,1.3-2.4,1.8-3,2-3,2-4.5,2-6.5,2.5-4,4.5-7,almost,anther,apex,apically,apparently,around,articulated,base,berry,black,branched,brown,brown-green,calyx,cell,chartaceous,cm,cordate,deltate,densely,diameter,difoliate,edge,erect,eye,filament,flattened-reniform,fruit,glabrous,gray-green,lateral,leaf,length,lobe,lobed,long,margin,maturity,mauve,membranous,midvein,mm,moderately,naked,obtuse,orange,outer,outline,ovate,pair,pale,pedicel,peduncle,per,petiole,pit,prickle,prickly,primary,purple,raised,red,rough,rounded,seed,shiny,shrub,simple,stellate-pubescent,stem,style,surface,terminal,tertiary,unit,vein,venation,visible,visibly,weakly,wide,yellow,yellow-green	-0.5,-1,-1/2,-10,-3,-4,.5,/5,0.1-0.2,0.15,0.15-0.3,0.2,0.2-0.4,0.3-0.4,0.5,0.5-1.5,0.5-3,0.6-0.9,0.7-1.6,1-,1-10,1-2,1-3,1.5,1.5-2,1/4,1/4-2/3,2,2-20,3-10,4-10,5-merous,6-10,6-11,abaxially,acuminat,alyx,ame,apar,apart,bark,blade,broad-deltate,c.,concolorous,connivent,curved,decurrent,discolorous,distance,drying,eaf,eed,elongating,equal,extending,flattened,flower,free,fruiting,geminat,glabrescent,glabrou,gland,globular,gray,herbaceous,infructescence,lon,longer,lower,mature,midpoint,nflorescence,occasionally,older,one,open,orange-gra,orolla,oung,pendulous,perfec,pericarp,poricidal,porrect,portion,prickl,ray,reduced,reflexed,ruit,scandent,scar,sessile,shorter,side,slender,smooth,sometimes,spaced,spherical,spreading,stalk,stalked,stellate,straight,strongly,tamen,tapering,terete,time,tip,trichome,tube,vary,way,winged,ympodial	abaxial,acuminate,adaxial,arrangement,branching,characteristic,colour,corolla,form,growth,height,inflorescence,na,ovary,plant,shape,staman,sympodial,texture,type,unarmed
191	wfo-0001028017	success	158	130	104	54	26	0.658	-2.5,0.3-1,1,1-10,1-2,1-3,1.5-2,15-35,15-50-flower,2,2-4,2.5-5,3,3-12,3-4,40-50,5-7,6-7,6-8,abaxially,absent,acuminate,acute,adaxially,apart,apex,apiculate,basal,base,brown,calyx,chartaceous,clavate,cm,connective,connivent,cuneate,cylindrical,densely,diameter,eglandular,eglandular-puberulent,eglandular-pubescent,ellipsoidal,elliptic,entire,exceeding,flattened,fleshy,flower,forked,fruit,fusiform,glabrous,glandular,glandular-,glandular-puberulent,green,greenish,hair,immature,lanceolate,lobe,long,margin,mm,moderately,narrowly,oblique,obtuse,ovate,ovoid,pedicel,peduncle,perfect,petiole,pointed,pubescent,purplish,rachi,radiu,rarely,remnant,ripe,short-acuminate,shorter,simple,slightly,sometimes,sparsely,stellate,stellate-campanulate,stigma,style,subcoriaceous,thecae,tip,tree,truncate,unbranched,white,without,x,yellow	10-22,13-40,2-3,3-14,3-foliat,5,5-9,9-11,absen,aggregate,ape,articulated,axe,beyond,blade,cell,ciliat,cream,directed,distally,eaf,eed,exserted,introrse,leaving,lon,lower,near,nflorescence,nther,orolla,pedicellar,pore,puberulen,purple,ruit,small,spaced,stamen,stone,tal,tan,tem,time,tomentose,triangular,truncat,tube,ud,unit,vary,vein,wide,ympodial	anther,arrangement,bud,characteristic,colour,corolla,form,growth,height,history,inflorescence,leaf,length,life,ovary,perennial,plant,puberulent,seed,shape,spacing,stem,surface,texture,theca,type
192	wfo-0001028033	success	157	96	82	75	14	0.522	.6,1.4â1.8,1â4,2â4,3,3â4,3â5,4â12,4â5,50,6â12,abaxially,acuminate,acute,adaxially,along,anther,apex,attenuate,base,blade,brochidodromous,brown,calyx,cell,chartaceous,ciliate,cm,cylindrical,cyme,darker,decurrent,densely,denser,diameter,discolorous,drying,elliptic,entire,filament,flower,fruit,glabrescent,glabrous,growth,herb,known,lateral,length,light,like,linear-lanceolate,lobe,long,margin,mm,onto,order,pedicel,petiole,pubescence,pubescent,sessile,shiny,shrub,simple,slightly,solitary,sparsely,spreading,stem,straight,style,surface,trichome,unbranched,uniseriate,unknown,upright,vein,venation,white	1.5,1â5,2â3,2âfoliate,3â11,5-merou,5â7,adaxiall,alyx,anthesi,ark,ascending,becoming,branch,capitat,connivent,contiguou,cordate,deeply,directed,eaf,eed,emarginate,equal,eye,few-branched,florescence,geminat,green,greenish,high,hispid-pubescent,introrsely,know,lobed,longitudinal,lower,mainly,membranaceous,midrib,naked,nearly,new,oblong,older,opening,orolla,ovate-lanceolate,perfect,pore,poricidal,prominent,prostrat,recurved,rhizomatous,ruit,secondary,shin,shorter,slit,stellate,stigma,strongly,subapical,tamen,tem,tube,unit,vary,visible,wide,woody,yellow,ympodial,Ã	arrangement,characteristic,colour,corolla,form,height,inflorescence,leaf,ovary,plant,seed,shape,staman,texture
193	wfo-0001028067	success	139	105	73	66	32	0.525	0.5-1,0.5-1.5,0.5-2,1,1-11,1-2,1-3,1-7,1.5-2.5,10-25,2,2-2.5,2.5-3,3-5,3-7,5-7,6-12,7-11-compound,7-9,acuminate,acute,apex,articulated,base,calyx,cm,cuneate,dark,diameter,elliptic-fusiform,elliptic-ovate,entire,flattened,flower,fruit,glabrous,hair,leaf,leaving,lobe,long,margin,mm,moderately,nearly,obtuse,often,pedicel,pedicellar,peduncle,petiole,pink,pinnately,puberulent,purple,rachi,rarely,remnant,ripe,shrub,simple,slightly,sparsely,strongly,style,tip,tomentulose,triangular-deltate,truncate,unbranched,unequal,x,yellow	-30,1-10,2-3,3-17,3-4,4-foliat,6-18,7-20,8-13,abaxially,adaxiall,adaxially,aggregate,along,apart,axe,basiscopically,blade,cell,chartaceous,color,compound,connivent,cylindrical,decurrent,directed,distall,eaf,eed,especially,glabrou,lateral,leaflet,lon,lower,midrib,narrowly,nflorescence,nther,orolla,per,pore,puberulen,radiu,ruit,several,smal,spaced,stellate,stigma,stone,subcoriaceous,tal,tem,time,triangular,truncat,tube,unit,unknown,upper,usually,vary,wide,ympodial,zigzag	abaxial,adaxial,anther,arrangement,branching,characteristic,colour,corolla,filament,form,growth,height,history,inflorescence,length,life,midvein,na,ovary,plant,primary,pseudostipule,seed,shape,staman,stem,surface,tertiary,texture,unarmed,vein,venation
194	wfo-0001028069	success	253	99	77	176	22	0.304	0.05-0.1,0.3-0.45,0.3-0.6,0.4-0.8,0.5,0.5-0.7,0.5-1.8,0.6-4,1-2.7,1-3.5,1.5-2.0,1.6-3.2,10-12,2-3-branched,2-locular,3,<,acute,anther,apex,articulated,base,basioscopically,bright,brown,calyx,cm,conical,corolla,decurrent,deep,deeply,densely,diameter,filament,fruit,glandular-villous,globose,green,hair-like,herb,imparipinnate,interrupted,leaf,length,lime,linear,lobe,lobed,margin,midvein,minutely,mm,oblique,obovate,occasionally,orange,outgrowth,ovary,ovate,pale,pedicel,peduncle,perennial,petiole,plant,primary,pseudostipule,pubescent,rounded,simple,stem,straight,style,surface,tertiary,yellow	-0.4,-30,-6,.1,.1-0.2,.2,.5,0.1-0.15,0.1-0.2,0.1-0.3,0.1-0.5,0.1-0.6,0.2-0.3,0.2-0.5,0.3,0.3-0.4,0.3-0.7,0.3-1,0.4,0.4-0.5,0.4-1,0.5-2,0.6-1.1,0.7-1,0.7-1.3,0.7-1.5,0.8-1.2,1-2-celled,1-4.5,1.4,1.5-3.5,10,10-30,12,2-17,2-4,2-7,3-,3-foliate,4-celled,5-22,5-25,6-,abaxially,absen,abundant,accrescent,adjacent,adpressed,along,alternate,always,among,anthesi,apical,appearance,appendage,appressed,axi,ba,basal,becoming,berry,bilaterally,bract,bracteole-like,cell,citru,column,composed,cone-shaped,cordate,cuneate,curving,dense,due,eaf,ebracteate,edicel,eed,eglandular,erect,exserted,flower,forming,fruiting,fusion,giving,glabrescent,gland,gland-tippe,gland-tipped,glandular,gree,half,halfway,head,included,initially,interjected,internode,larger,later,lateral,leaflet,less,like,lon,long,longer,longest,lower,maturity,middl,minute,multicellular,narrowly,nflorescence,often,one,pair,patent,pentagonal,per,petiolule,population,present,procumbent,pubescence,quaternary,rarely,reflexed,robust,ruit,scarcely,scent,secondary,sessile,several,shaggy,short,shorter,silky,single-celled,size,slender,smaller,somewhat,staminal,sterile,stigma,strong,subopposite,symmetric,tangled,tem,terminal,testa,thick,tightly,toward,transparent,trichome,tube,ud,unicellular,uniseriate,unit,usually,varying,viny,wall,weak,wide,winged,ympodial	abaxial,adaxial,arrangement,branching,characteristic,colour,form,growth,height,history,inflorescence,life,middle,na,rachi,seed,shape,staman,texture,unarmed,vein,venation
195	wfo-0001028075	success	196	73	51	145	22	0.26	1-2,1.5-2.5,1.6-2.7,10-35,2-4.5,2-6,3-23.5,4-7,5-7,5-8,5-9,7-13,7-30,8-12,anther,berry,chartaceous,ciliate,cm,corolla,dark,diameter,filament,fruit,glabrescent,glabrous,globose,green,greenish,herb,leaf,light,lobe,long,margin,membranous,mm,obtuse,odd-pinnate,ovoid,pale,pedicel,peduncle,petiole,plant,rounded,seed,style,white,whitish,x	.5,1-10,1-2.7,1-3,1.5-7,2-3,2.5-10,3-11,4-12,5-12,5-14,5-17,5-merou,abaxially,absent,acuman,acumen,acuminate,acute,adaxially,ag,along,alyx,apart,apex,apparently,articulated,axe,axillary,base,blade,borne,broadly,brownish,bud,capitat,cell,condition,connivent,covering,cuneate,decreasing,differentiated,digestion,distal,distally,distinctively,dorsally,dot,drying,eaf,edge,eed,elliptic-lanceolate,end,enzyme,erec,especially,exceeding,flat,flower,folded,forked,fresh,geminat,generally,glabrescen,green-white,hair-like,half,homostylous,honeycomb-shaped,interjected,lanceolate,larger,lateral,leaflet,lengthening,ligulate,living,lower,make,middl,midrib,minutely,much,mucilaginous,narrow,nflorescence,oblique,often,orolla,ovate,ovate-elliptic,pair,pentagonal,perfect,petiolule,plurifoliate,pore,poricidal,puberulent,purple,reflexed,removed,rotate,ruit,scattered,seudostipule,singly,size,slightly,slit,sometimes,spaced,specimen,stamen,star,stigma,stolo,straight,subcordate,subtending,tall,tamen,tem,terminal,testal,thick,throughout,tip,toward,tri-,tube,tuber,typically,unit,usually,vary,wall,wet,wide,wing,yellow,ympodial	2,abaxial,adaxial,arrangement,branching,calyx,characteristic,colour,form,growth,height,inflorescence,length,na,ovary,pseudostipule,shape,staman,stem,surface,texture,unarmed
196	wfo-0001028076	success	195	86	59	136	27	0.303	1-1.3,1-2,1.8-2.2,110,12-22,2-5.4,2.2-2.6,2.5-4,4-5,5,5-20,5-6,7-8,acuminate,anther,apex,attenuate,base,berry,chartaceous,cm,conical,corolla,densely,diameter,elliptic,filament,fruit,glabrous,green,greenish,herb,leaf,less,light,lobe,long,margin,medium,membranous,minute,mm,mucilaginous,odd-pinnate,ovate,ovoid,pedicel,peduncle,petiole,plant,pubescent,purple,seed,sessile,slightly,stem,style,subsessile,whitish	.5,0.4-0.5,0.5,1-10,1-3,1.2-2.2,13-14,2-12,2-3,2.2-3.7,2.5-3,2.6-3.8,4.5-7,5-6.5,5-merou,?,abaxially,absent,acumen,adaxially,ag,alyx,apart,apparently,articulated,axe,axillary,blade,borne,brownish,bud,capitat,cell,ciliate,condition,connivent,covering,decreasing,digestion,distal,dorsally,drying,eaf,edge,eed,end,enzyme,erec,especially,exceeding,flat,flower,folded,forked,fresh,geminat,generally,glabrou,gradually,green-white,hair,hair-like,half,homostylous,honeycomb-shaped,interjected,lanceolate,larger,lateral,leaflet,lengthening,like,living,lower,make,nflorescence,obtuse,orolla,pair,pentagonal,perfect,petiolule,plurifoliate,pore,poricidal,proximal,pubescen,rarely,ray,removed,ripe,rotate,round,ruit,secondary,semierect,seudostipule,singly,size,slit,spaced,specimen,stamen,ste,stigma,stolo,straight,subequal,subtending,symmetrical,tall,tamen,tem,terminal,testal,thick,thir,throughout,tip,toward,tri-,tube,tuber,typically,unit,unwinged,usually,vary,wall,wet,white,wide,wing,x,yellow,ympodial	abaxial,adaxial,arrangement,branching,calyx,characteristic,colour,form,growth,height,inflorescence,length,midvein,na,ovary,primary,pseudostipule,rachi,shape,staman,surface,tertiary,texture,unarmed,vein,venation,width
197	wfo-0001028105	success	150	115	93	57	22	0.62	.4,.5,0.3-1.5,0.5,0.5-1,0.5-2,0.6-1,1-1.2,1-1.5,1-2.5,1.5,1.5-1.8,1.5-4.5,2-2.2,2-5,3-5-celled,5-7-flowered,acuminate,acute,anther,anthesi,apex,apical,attenuate,axil,bark,base,berry,bilobed,calyx,clavate,cm,conical,corolla,dark,dense,dia,distinct,ellipsoid,elliptic,exserted,filament,flattened-reniform,fruiting,glabrous,glandular,globose,green,incrassate,leaf,lobe,lobed,long,margin,minor,minutely,mm,nearly,ovary,pale,papillose,pedicel,petiole,pitted,pore,poricidal,projection,pubescent,quadrate,reddish-brown,scar,scattered,shaped,shrub,simple,size,slightly,small,stem,stigma,strongly,style,surface,tear-drop,tip,tree,trichome,tube,tuft,uniseriate,vein,white,x	.1,1.5-2,2,3-6,3.5-4,6-7,9.5-15,abaxially,adaxially,apar,axi,ba,deflexed,differing,difoliate,drying,eaf,edicel,eed,erect,evenly,filiform,free,geminat,greenish-yello,lamina,lateral,like,lon,lower,main,major,middle,nflorescence,occasionally,older,olive-green,opposite,pair,papillo,planar,portion,reflexed,ruit,spaced,sparsely,spreading,straight,tall,tub,ud,unit,widest,woody,yellowish,ympodial,young	abaxial,adaxial,apart,bud,characteristic,colour,diameter,exsertion,form,fruit,greenish-yellow,growth,height,inflorescence,length,plant,pubescence,seed,shape,spacing,texture,type
198	wfo-0001028109	success	205	114	96	109	18	0.468	-20,-4,-7,0.4-0.8,0.4-1.5,0.45-0.65,0.5-2.5,0.6-0.8,0.8-1.5,1.5-2.5,1.5-5.5,2-4,2.3-2.9,2.5-3,2.5-5,20-60,5-13,abaxial,acuminate,acute,adaxial,almost,anther,apex,apically,apparently,articulated,base,berry,branching,bright,calyx,chartaceous,cm,cuneate,curved,deltate,densely,diameter,discolorous,drying,dull,elliptic,entire,erect,evenly,filament,flattened-reniform,fruit,gently,glabrescent,glabrous,gray-green,green,green-brown,lateral,leaf,length,light,lobe,long,margin,maturity,mauve,mm,moderately,obtuse,orange-brown,pedicel,peduncle,petiole,prickly,recurved,red,red-brown,shrub,slender,small,smooth,sometimes,spherical,stellate-pubescent,stem,straight,strongly,style,surface,terminal,tree,unarmed,unit,usually,weakly,white,yellow,young	.5,/3,0.05-0.15,0.05-0.2,0.1,0.1-0.2,0.3,0.5-1.2,0.7,0.8-1.6,1.5-10,1/8-1/4,10-25,10-30,12-40,15-100,2-15,2/3-3/4,3-,3-7,3.5-6,3/4,30-150,4-13,4-5-merous,5-30,8-12,8-15,8-25,abaxially,acut,alyx,ame,apar,apart,bark,blade,brow,c.,connivent,dimorphic,eaf,eed,elongating,equal,flower,free,fruiting,fully,geminate,glabrou,infructescence,lobed,long-styled,longer,lower,mature,midpoint,minor,multangulate,nflorescence,occasionally,older,one,open,opening,orolla,oung,pair,per,perfec,pericarp,perpendicular,plurifoliat,poricidal,porrect,portion,prickl,prickle,primary,ray,reflexed,ruit,scar,secondary,sessile,simple,spaced,spreading,stalk,stalked,stellate,tamen,tapering,terete,tertiary,time,tip,trichome,tube,unarme,vary,vein,venation,visible,way,wide,woody,ympodial	characteristic,colour,corolla,form,growth,hair,height,inflorescence,ovary,plant,plurifoliate,seed,shape,staman,sympodial,texture,type,width
199	wfo-0001028115	success	165	89	54	111	35	0.327	0.7-0.8,1.1-1.8,1.7-2.2,1.8-3.5,2-3.2,5-15,6-10,abaxially,acute,adaxially,anther,apex,attenuate,base,berry,blue,calyx,cm,diameter,ellipsoidal,elliptical,entire,filament,glabrescent,glabrous,globose,herb,length,light,linear,lobe,margin,mm,moderately,narrowly,ovate,pale,petiole,pinnatifid,pinnatipartite,pinnatisect,pubescent,rarely,seed,simple,small,stem,style,trans-ovoidal,triangular,tuberculate,venation,violet,yellow	-1.1,-2.5,-5.2,.2,.6,0.2-0.3,0.42,0.5,0.6-0.7,0.8-,1-2.4,1-3,1.3-1.8,1.4-1.7,12-13.5,2-,2.5-,3-4.5,3-5,3-6.5,4.7-,5-8.5,7-7.5,9-17,abundant,accrescent,acuminat,ag,alternate,amply,annular,antrorse,articulate,basal,blade,campanulate,capitate,coat,connectival,curved,difoliat,dorsal,eaf,eed,embryo,especially,evident,exceeding,fruiting,glandular,growing,half,herbaceous,hig,inflated,long,longer,longitudinal,longitudinally,lower,mixed,much,multi-seeded,near,nerve,non-glandular,oblong,one,opening,opposite,orolla,pair,papery-scarious,papillo,pore,poricidal,portion,prolongation,prostrate,ree,reticulate,ridged,ruit,scarce,segment,similar,slender,slightly,slit,smooth,sometimes,stigma,strongly,styl,subsessil,tem,time,tip,trichome,tube,unequal,unifoliate,uniseriate,unit,vary,wide,wider,width,winged,x,ympodial	0.6,2.5-4.5,4.7-8.5,abaxial,adaxial,arrangement,branching,characteristic,colour,corolla,form,fruit,growth,height,history,inflorescence,leaf,life,midvein,na,ovary,pedicel,peduncle,perennial,plant,primary,pseudostipule,rachi,shape,staman,surface,tertiary,texture,unarmed,vein
200	wfo-0001028131	success	208	106	88	120	18	0.423	.5,0.3-0.7,0.4-0.8,0.5-1.1,0.8-1,0.8-1.1,1-5,1.5-5,1.8-2.2,1/5,2-2.8,2-4,2-5,4-6,5-6.5,abaxial,absent,adaxial,anther,apex,articulated,attenuate,bark,base,berry,branched,calyx,cell,cm,cream,curved,dark,deltate,densely,diameter,erect,filament,flattened,flower,fruit,glabrescent,glabrous,green,herb,infructescence,lateral,leaf,length,lobe,lobed,long,margin,marking,maturity,mauve,mm,narrow-obovate,narrow-ovate,oblong,obtuse,orange,outline,pale,pale-brown,pedicel,peduncle,per,petiole,pit,prickle,purple,raised,red,rounded,shiny,simple,small,smooth,sparsely,stellate-pubescent,stem,style,surface,upper,wide,yellow,yellow-green,young	-1.2,.1,/5,0-0.6,0-2,0-3,0-30,0-4,0.05-0.2,0.1-0.15,0.1-0.3,0.2-1.5,0.7-1.1,1-10,1-3,1-4,1.5-3,1.8-2,1/4-2/3,2-6.5,2/3,3-6,5-8,5-merous,6-7,7-8,abaxially,acuminat,alyx,apar,apart,apically,apparently,blade,broad-deltate,chartaceous,concolorous,connivent,difoliate,distance,drying,dull,eaf,eed,elongating,epidermi,equal,extending,eye,filiform,flattened-reniform,free,fruiting,geminat,gland,lanceolate,lengt,like,longer,lower,mature,membranous,midpoint,midvein,moderately,naked,nflorescence,often,older,one,open,orange-brown,orolla,oung,pair,pale-gra,pendulous,perfec,pericarp,poricidal,porrect,portion,prickl,prickly,primary,ray,reduced,reflexed,ruit,scar,sessil,sessile,shorter,side,sometimes,spaced,spherical,spreading,stellate,straight,strongly,sunk,tamen,tapering,terete,tertiary,time,tip,trichome,tube,unarme,unarmed,unit,vary,vein,venation,visible,way,woody,ympodial	arrangement,characteristic,colour,corolla,form,growth,hair,height,inflorescence,ovary,pale-gray,plant,seed,shape,staman,texture,type,width
201	wfo-0001028148	success	157	117	83	74	34	0.529	-6,0.25-0.5,0.5-1.5,0.75-2,1-15,1-3.5,1.5,1.5-2.5,10-30,12-15,2,2-3,2-7,2.5-4,3.5-4,5-20,5-7,acute,angled,apart,apex,apiculate,articulated,base,blue-black,branched,calyx,cm,cylindrical,dark,decurrent,deltate,diameter,elliptic,entire,except,fruit,glabrous,glaucous,globose,hair,highly,less,light-colored,lobe,margin,mature,minute,mm,moderately,narrowly,obtuse,often,pedicel,peduncle,petiole,pink,puberulence,puberulent-pubescent,purple,rachi,rarely,rhizomatous,ridge,ripe,scalloped,shrub,simple,slender,slightly,smooth,sometimes,spaced,sparse,style,surface,tapered,treelet,unbranched,violet,whitish,x,young	.5-4,0.6-3.5,15,20-50,3.5-9,4-10,4.5-10,5,5-10,5-8,6-18,abaxially,absen,adaxially,aggregate,axe,ba,blade,broadly,cell,central,chartaceous,connivent,densely,directed,distal,distall,eaf,eed,especially,fleshy,flower,fresh,long,lower,many-foliat,margi,material,midrib,nflorescence,nther,orange,orolla,ovate,part,perfect,plicae,plicate,pore,puberulent,radiu,rotate-stellate,ruit,smoot,star,stigma,stone,succulent,tal,tem,thickened,time,tip,triangular,truncat,tube,unit,usually,vary,white,wide,winge,yellow,ympodial	0.5-4,abaxial,adaxial,anther,arrangement,branching,characteristic,colour,corolla,filament,form,growth,height,history,inflorescence,leaf,length,life,midvein,na,ovary,plant,primary,pseudostipule,seed,shape,staman,stem,tertiary,texture,unarmed,vein,venation,winged
202	wfo-0001028161	success	124	63	49	75	14	0.395	0.1-0.25,0.25-0.5,0.7-1.7,1-1.3,1-1.5,1-2,1-2.3,2-9,2.5-3,3-4,3-7,4-5,6-9,acuminate,acute,apex,attenuate,bark,base,cm,dendritic,densely,elliptic,fruiting,globose,lanceolate,leaf,minor,minutely,mm,narrowly,orbicular,ovoid-reniform,pedicel,petiole,pitted,pubescence,pubescent,reddish-brown,rounded,shape,shrub,simple,size,sparsely,stem,surface,trichome,x	.5,1.5-4.5,1/3,2-5-flowered,7.5-12,9-11,abaxially,adaxially,along,anthesi,arising,ba,berry,branch,branched,brown,calyx,cell,closely,congested,consisting,corolla,deflexed,denser,dia,differing,difoliate,distal,eaf,edicel,eed,exserted,geminat,glabrescen,green,incrassate,inflorescenc,later,lateral,like,lon,long,main,major,margin,middle,nflorescence,obovoid,often,older,opposite,outline,overlappin,pair,pale,probably,rest,ruit,scar,short,sinuate,somewhat,spaced,strongly,tall,tan,tapering,thin,tub,ud,unit,vein,widest,ympodial,young	0.5,1,colour,diameter,form,fruit,glabrescent,growth,height,inflorescence,length,plant,seed,texture
203	wfo-0001028164	success	197	97	80	117	17	0.406	-1,-6,0.4-0.8,0.5-0.8,0.5-1,0.7-1.1,0.9-1.6,1-1.5,1-4.5,1.8-2.5,1/3,2.5-4,2.5-4.5,2.8-4,3-17,3.6-4.8,abaxial,acuminate,acute,anther,apex,apically,apparently,attenuate,base,berry,branched,bright,calyx,cm,deltate,densely,diameter,dull,elliptic,entire,evenly,filament,flattened-reniform,fruit,glabrescent,glandular,green,hair,lateral,leaf,length,lobe,long,margin,maturity,mauve,membranous,midvein,minute,mm,moderately,obtuse,orange-brown,pale,pedicel,peduncle,petiole,red,shallowly,shrub,sometimes,spherical,stellate-pubescent,stem,style,surface,terete,terminal,unarmed,undulate,upper,white,yellow,young	-14,-8,/4,0-20,0.05-0.2,0.05-1.5,0.1,0.3-0.8,0.8-1.5,1,1.5-2.5,1/6-1/4,12-20,2-2.5,3-7,4-13,4-5-merous,4-7,4-8,6-8,8-15,8-17,abaxially,almost,alyx,ame,apar,articulated,bark,blade,c.,concolorous,connivent,curved,dark,difoliate,drying,eaf,eed,elongating,equal,erect,eye,filiform,flower,free,fruiting,geminat,glabrescen,glabrou,glabrous,gray,infructescence,less,lobed,long-acuminat,longer,lower,mature,midpoint,multangulate,naked,narrow-deltate,nflorescence,often,older,one,open,orolla,oung,pair,per,perfec,pericarp,poricidal,porrect,portion,primary,ray,recurved,red-brown,reflexe,ruit,scar,sessile,shorte,shorter,side,simple,smooth,spaced,sparsely,spreading,stalk,stalked,stellate,straight,tamen,tapering,tertiary,time,tip,trichome,tube,unarme,unit,variously,vary,vein,venation,visible,way,wide,woody,yellow-gra,yellow-green,ympodial	characteristic,colour,corolla,form,growth,height,inflorescence,long-acuminate,ovary,plant,seed,shape,staman,texture,type,width,ye
204	wfo-0001028180	success	147	78	51	96	27	0.347	1-1.5,1-1.8,1-3,2-3,2.5-3,3-4,4.5-5,5-6,7,8-10,acute,anther,apex,attenuate,base,calyx,cm,corolla,dark,deltate,elliptic,filament,glabrous,globose,green,irregularly,leaf,lobe,margin,minutely,mm,ovary,ovoid-reniform,pair,pale,pedicel,petiole,pinkish-white,pitted,puberulent,pubescent,simple,sparsely,stem,style,surface,tan,tree,vein,white,x	.05,.5,/2,0.7-1,1-1.2,1.5-5,15-28,2-2.2,20-30-flowered,3-10,5-8,abaxially,adaxially,along,anthesi,ba,bark,beginning,berry,c.,capitate,closely,conical,cucullate,darker,deflexed,densely,dia,differing,difoliate,distinctly,drying,eaf,eed,elongate,erect,falcate,fleshy,four-angled,free,fruiting,geminat,glabrat,gold,golden,know,larger,lateral,leathery,lobed,lon,long,lower,main,major,midrib,minor,nearly,nflorescence,obscure,older,onto,opposite,overlappin,papillose,planar,pore,poricidal,portion,ruit,scar,shaped,shiny,size,small,somewhat,spaced,stigma,straight,styl,tall,tear-drop,thick,tip,trichome,tube,ud,underside,uniseriate,unit,way,winged,woody,yellow-gray,ympodial,young	abaxial,adaxial,arrangement,branching,characteristic,colour,diameter,form,fruit,growth,height,inflorescence,length,midvein,na,peduncle,plant,primary,pseudostipule,rachi,seed,shape,staman,tertiary,texture,unarmed,venation
205	wfo-0001028182	success	150	81	50	100	31	0.333	0.5-0.6,0.5-1,0.8-1,0.9-1,1-1.5,2-2.5,2-6.5,3-5,4-6,anther,apex,apiculate,base,beneath,calyx,ciliate,cm,cordate,corolla,deflexed,deltoid,filament,filiform,glabrous,inflorescence,keeled,leaf,lobe,long-acuminate,margin,mm,narrowly,ovary,ovate,pair,pedicel,petiole,pubescent,purplish,shiny,shrub,simple,somewhat,sparsely,stem,style,surface,truncate,vein,white	.5,0-90,0.1-0.2,0.5,2,3,5-15-flowered,5-ribbed,6-9,along,anthesi,apart,apiculae,arching,axi,bark,bending,black,blade,branch,brown,capitate,conical,densely,dia,dry,eaf,edicel,eed,ellipsoid,evenly,except,extreme,flower,free,globose,gre,hemiepiphyte,internodal,know,known,later,lateral,lax,less,like,lobed,long,lower,main,material,midrib,minute,minutely,nearly,nflorescence,obovoid,older,opposite,papillo,papillose,planar,pore,poricidal,portion,present,prominent,proximal,reflexed,rib,rounded,ruit,sca,scar,shaped,slender,slightly,spaced,sparser,specimen,spindly,stigma,still,strongly,tapering,tear-drop,third,time,tip,trichome,tube,ud,unifoliat,uniseriate,unit,widest,x,ympodial,young,zig-zag	abaxial,adaxial,arrangement,branching,characteristic,colour,diameter,form,fruit,growth,height,hemiautotrophic,history,length,life,midvein,na,peduncle,plant,primary,pseudostipule,rachi,seed,shape,staman,sympodial,tertiary,texture,unarmed,unifoliate,venation
206	wfo-0001028183	success	237	98	81	156	17	0.342	-10,-5.3,0.2-0.3,0.2-0.5,0.5-2.5,0.7-1.2,0.7-2,0.8-1.4,0.8-3.1,1.1-1.8,1.2-1.4,1.3-1.7,1.4-2.8,1.5-3.4,10-15,2-4.2,2-5,2.8-4.2,3.5-6.6,5.2-6.2,6.6-20,8-9.1,abaxial,abaxially,adaxially,anther,apex,attenuate,base,berry,branched,calyx,cm,corolla,cuneate,diameter,dull,elliptic,entire,filament,flower,fruit,glabrous,granular-punctate,hair,half,lanceolate,leaf,lobe,lower,many,margin,mm,narrowly,orangish-tan,pedicel,peduncle,petiole,porrect-stellate,pseudoterminal,pubescent,purple,rachi,reticulate-punctate,ripe,scabrous,shrub,sparingly,spherical,stem,streak,style,surface,tan,time,tree,upper,violet,white,x,yellowish	.5-3,0.1,0.1-0.2,0.1-0.4,0.1-0.9,0.2-0.4,0.5,0.6,1.3-1.4,1.6-2.3,1.7-2.7,1.9-3.7,1/3-1/2,11-30,2.2-5.7,2.5-4.1,2.6-4.4,3.2-,4.5-9,4.6-6.4,5-8,5-8.5,50-400,7.5-23,9-13,accrescent,acute,ag,along,alyx,anthesi,apart,apparently,around,articulated,axi,axillary,bark,blade,blunt-tipped,branch,brown,bud,capitate,cell,central,chartaceous,closely,cylindrical,dark,deltoid,dendritic-multangulate,directed,distally,distantly,drying,eaf,earl,edge,eed,elongated,epidermal,especially,evident,except,exserted,farinose,few-rayed,free,fruiting,glabrescen,glabrescent,globose,group,high,inserted,lackin,lateral,lengthening,lobed,lon,long,long-decurrent,longitudinal,m.,main,midrib,multangulate,nearly,nflorescence,oblong,obovoid,older,open,orolla,ovate-lanceolate,overlapping,perfec,plurifoliate,pore,poricidal,porrect-stellat,present,prominent,pubescence,rarely,relatively,reportedly,ruit,runk,sessile,short,short-,side,simple,slit,small,somewhat,soon,spaced,sparse,splitting,stage,stalk,stamen,stellate,stigma,stipitate-glandular,stout,strongly,sub-lenticular,subcampanulate,suture,tamen,terete,thick,thin,thin-textured,tip,tomentose,touching,translucent,tube,ud,unarme,unit,usually,vary,vein,way,whitish,wide,yellow,yellowish-tomentose,ympodial,young	3.2-6.4,characteristic,colour,form,growth,height,inflorescence,length,ovary,plant,seed,shape,staman,texture,type,unarmed,ye
207	wfo-0001028227	success	236	103	85	151	18	0.36	-6.2,0.2-0.3,0.2-0.4,0.7-2.1,0.8-1.4,0.9-1.4,1-1.7,1-4.2,1.2-2,1.3-4,1.4,1.5-2.3,1.7-2.8,1/2,10,2-12,3-4.9,3.7-7,4.8-7.6,6.7-15,8.1-18,abaxially,acuminate,acute,adaxially,anther,apex,attenuate,base,berry,branched,brown,brownish,bud,cm,corolla,cuneate,dark,decurrent,deltoid,diameter,elliptic,elongate,entire,filament,fleshy,fruit,glabrescent,granular-tomentose,gray,green,leaf,less,long,many,margin,mm,oblong-lanceolate,obtuse,orangish-tan,orbicular,pale,pedicel,peduncle,petiole,pseudoterminal,purple,rachi,reticulate-punctate,ripe,scabridulous,shrub,simple,stem,stigma,style,sublenticular,surface,time,tomentose,tree,velutinous,violet,x,yellow	-2/3,.5-4,0-250,0.1,0.2,0.2-0.5,0.3,0.4,0.5,0.8,0.9,0.9-1.2,1,1-2.5,1.1-3.1,1.4-2.6,1.9,1.9-4.2,1.9-5.8,1/2-3/4,10-24,11-15,2-3.8,2.5-7.8,2.6-5.9,2.9-4.7,3.7-6.3,4-13,5-7.5,6-16,8.5-22,abaxial,accrescent,ag,age,along,alyx,anthesi,apart,apparently,appressed,around,articulated,axillary,bark,becoming,blade,blunt-tippe,blunt-tipped,branch,c.,calyx,closely,cylindrical,dendritic-echinoid,directed,distally,drying,eaf,early,echinoi,echinoid,edge,eed,ength,exserted,farinose,flower,free,fruiting,glabrous,globose,grayish,hair,high,inserted,lacking,lanceolate,lateral,lengthening,lobe,lobed,lon,longitudinal,lower,m.,main,midrib,midvein,mostly,multangulate,nflorescence,oblong,obscured,occasionally,often,older,orolla,ovate-lanceolate,ovate-orbicula,overlapping,perfec,plurifoliate,pore,poricidal,porrect-stellate,present,prominent,pubescence,pubescent,quarter,relatively,rounded,ruit,runk,sessile,side,slightly,slit,somewhat,spaced,sparsely,stalk,stamen,stellate,stout,subcampanulate,subspherical,sulcate,suture,tamen,thick,thicker,thin,tip,tomentu,touching,tube,ud,unarme,unit,upper,usually,vary,vein,way,well,wide,yellowish,ympodial,young	arrangement,characteristic,colour,form,growth,height,inflorescence,length,ovary,plant,seed,shape,staman,subspheical,texture,type,unarmed,ye
208	wfo-0001028228	success	143	86	69	74	17	0.483	.5,0.1-1.7,0.75,1-1.5,1.1-1.2,1.1-2.5,1.2-1.8,1.5-2,1.8-3.4,10-30-flowered,2-8,2.1-4.2,6-7,abruptly,acute,anther,apex,bark,base,berry,brown,calyx,clavate,cm,coriaceous,corolla,dark,deflexed,deltoid,dia,dry,elliptic,fragrant,fruiting,glabrous,globose,green,greenish-yellow,leaf,lobe,long,material,minor,minutely,mm,narrowing,obovate,occasionally,ovary,ovoid-reniform,papillose,pedicel,petiole,reticulate,rounded,shining,shrub,simple,slender,small,stem,straight,style,surface,sweetly,tapering,tree,tube,white	2,2-5,2.8-6.5,3/4,6-8,7.5-12.5,age,anthesi,area,ba,becoming,beginning,beneath,caly,campanulate,closely,difoliate,distal,eaf,edicel,eed,erect,exserted,filament,free,geminat,impressed,inflorescenc,lateral,lobed,lon,lower,main,major,margin,middle,minute,nflorescence,older,opposite,overlapping,ovoid,pair,pale,planar,pore,poricidal,portion,prominent,ruit,scar,shaped,shinin,slightly,spaced,stigma,styl,tall,tear-drop,terminal,thick-margined,thickened,tip,ud,unit,usually,vein,way,weight,widest,woody,x,ympodial,young	characteristic,colour,diameter,flower,form,fragrance,fruit,growth,height,inflorescence,length,plant,seed,shape,texture,type,width
209	wfo-0001028263	success	156	104	82	74	22	0.526	0.25,1-2,1-3,11-23,2,2.6,3,3.4,4,6,9,abaxially,acumen,adaxially,apical,apically,atenuate,base,branched,broadly,calyx,cell,cm,conical,cordate,corolla,covering,cuneate,cyme,darker,deep,dehiscent,diameter,dichasial,dichasially,ebracteate,elliptical,exceeding,green,hair-like,herbaceous,introrse,lateral,leaf,light,lobe,long,make,maturing,medium,mm,monochasial,mucilaginous,oblique,odd-pinnate,often,ovate,ovoid,pedicel,peduncle,perennial,petiole,plant,poricidally,puberulent,pubescent,rotate,seed,sessile,short,slit,stamen,stigma,straight,strigose,style,testal,thick,throughout,tuber-bearing,violet,wall	1-4,11-13,14-44,2-3,2-4,3-6-foliat,3.5-4.2,4-5,5-7,5-7.5,6-8,8-1.,8-14,abaxiall,acuminate,acute,apex,articulate,connate,digestion,diminishing,distal,dorsally,eaf,edge,eed,emoval,enzyme,equal,filament,first,flat,flower,folded,forked,generally,globo,gradually,green-white,half,honeycomb,interjected,leaflet,living,lon,lower,lunat,nflorescence,nther,orolla,pair,pattern,perfect,plan,proximal,reveal,ruit,seudostipule,size,specimen,tal,tem,terminal,throughou,toward,truncate,two,typically,unit,vary,wide,yellow,ympodial,Â¼	anther,arrangement,characteristic,colour,dehiscence,form,fruit,globose,growth,height,history,inflorescence,length,life,margin,ovary,shape,stem,surface,texture,wet,ye
210	wfo-0001028280	success	87	74	37	50	37	0.425	.5,1-2,1-2-flowered,2-3,7-8,acuminate,apex,arching,attenuate,base,berry,ciliate,decurrent,elliptic,flattened,glabrous,globose,green,lanceolate,leaf,long,margin,minutely,mm,narrowly,pair,pedicel,petiole,rounded,shrub,simple,stem,surface,tip,ultimate,vein,winged	0.7-1,1.5-2.7,2-2.5,6-9,almost,anthesi,ape,axil,bark,branch,brow,closely,cm,completely,dark,dia,eaf,eed,fruiting,immature,know,known,lateral,lon,lower,main,middle,new,nflorescence,older,onto,opposite,papillae,pendant,present,ruit,scar,sessil,small,somewhat,spaced,tall,ud,unifoliat,unit,widest,woody,x,ympodial,young	abaxial,adaxial,anther,arrangement,branching,calyx,characteristic,colour,corolla,diameter,filament,form,fruit,growth,height,history,inflorescence,length,life,lobe,midvein,na,ovary,peduncle,plant,primary,pseudostipule,rachi,seed,shape,staman,style,tertiary,texture,unarmed,unifoliate,venation
211	wfo-0001028281	success	267	125	110	157	15	0.412	-0.9,-1,-3,-5,0.1-0.15,0.2-0.5,0.2-0.7,0.3-1,0.5-1,0.7-1.2,0.75-1,1-3,1.1-1.4,1.5-2,2-4,2-locular,2.1-3.0,20-30,6,6-15,abaxial,acuminate,acute,adaxial,almost,anther,apex,base,basiscopically,branching,brown,calyx,cell,cm,conical,corolla,dark,deep,densely,diameter,distal,doubly,elliptic,elongate-triangular,entire,extended,filament,flower,form,fruit,glabrous,glandular,globose,golden,green,hair-like,half,head,imparipinnate,inflorescence,interrupted,lateral,leaf,leaflet,like,lobe,long,margin,midvein,mm,multi-cellular,narrowly,oblique,obovate,occasionally,once-branched,orbicular,outgrowth,ovary,ovate,pale,paler,patent,pedicel,peduncle,petiole,primary,proximal,pseudostipule,pubescent,rachi,regularly,serrate,shrub,silky,sometimes,sparsely,stem,stripe,style,surface,terminal,tertiary,testa,trichome,uniseriate,vein,vine,wall,yellow	+,-10,-20,-36,-45,-7,-8,.2,.4,.5,0.05-0.4,0.15-0.2,0.2-0.3,0.3-0.5,0.5-,0.5-0.6,0.5-0.7,0.5-1.1,0.5-1.2,0.7-,0.7-2.5,0.8-1,1,1-,1-1.5,1-5,1.0-1.6,1.1-2.4,1.2-1.5,1.2-1.6,1.4-4,1.5-6,1.7-2.5,10-18,10-30,2-13,2-4-celled,2-6.5,2.5-,3-16,3-5,3-8.5,3-foliate,5-8-celled,7-30,abaxially,absent,alternate,anthesi,apical,appearance,appendage,appressed,arising,articulation,autogamous,axi,bent,berr,blade,bract,bracteate,broadly,capitate,column,composed,covering,darker,decreasing,decurrent,developed,dry,eaf,edicel,eed,eglandular,either,elongate,enclosing,exerted,exserted,fragile,free,fruiting,generally,giving,gland,gree,hal,halfway,included,interjected,internode,large,largest,less,lon,longest,lower,material,medial,minute,mixture,multi-celled,multicellular,nflorescence,node,opposite,other,pair,petiolule,point,population,portion,present,primarily,probably,rest,rotate,ruit,secondary,serrat,sessile,set,shorter,size,small,smaller,smooth,sparser,sprawling,staminal,sterile,stiff,stigma,straight,strongly,subopposite,tem,thick,thin,three,tip,toward,transparent,tube,type,ud,unicellular,unit,usually,weak,weak-walled,well,wide,winged,ympodial	0.7-1.5,arrangement,characteristic,colour,growth,height,length,na,plant,seed,shape,staman,texture,unarmed,venation
212	wfo-0001028317	success	204	121	99	105	22	0.485	-1.5,-5,0,0.3-1,0.6-1.2,0.6-1.5,0.8-1.1,1-1.3,1-3,1.4-2,1/5,2-2.8,2-4.5,2.8-3.3,3-4,4-6,5-8,absent,acute,anther,apex,apically,apparently,articulated,base,berry,branched,bright,brown,calyx,chartaceous,cm,cream,cuneate,dark,deltate,densely,diameter,dull,erect,eye,filament,flattened-reniform,fruit,glabrous,gray,green,herb,lanceolate,lateral,leaf,length,lobe,lobed,long,lower,margin,marking,maturity,mauve,midvein,mm,moderately,naked,obtuse,orange-brown,ovate,pair,pale,pedicel,peduncle,per,petiole,primary,purple,red,shrub,simple,smooth,sometimes,sparsely,spherical,stellate-pubescent,stem,style,surface,terminal,tertiary,truncate,unarmed,upper,vein,venation,visible,white,wide,yellow,yellow-green,young	/5,0-1,0-5,0.1,0.1-0.25,0.1-0.3,0.1-0.4,0.3-0.4,0.5-3.5,0.6-0.8,0.8-2.5,1-4,1.1-1.9,1.8-2.5,1/,1/3-1/4,1/4-2/3,2-4,2.5-6.5,2/3,3-10,3-5,4-5-merous,4-8,6-10,abaxially,acuminat,almost,alyx,apar,apart,bark,blade,broad-deltate,brow,concolorous,curved,difoliate,distance,drying,eaf,eed,elongating,equal,extending,filiform,flower,free,fruiting,geminat,hair,herbaceous,infructescence,longer,mature,midpoint,minute,nflorescence,oblong,older,one,open,orolla,oung,pendulous,perfec,pericarp,poricidal,porrect,portion,prickl,prickle,prickly,ray,reduced,reflexed,rounded,ruit,scandent,scar,sessile,shorter,side,spaced,spreading,stalk,stalked,stellate,straight,subsessile,tamen,tapering,terete,time,tip,toward,translucent,trichome,tube,unarme,unit,variously,vary,way,ympodial	1/2,abaxial,acuminate,adaxial,arrangement,branching,characteristic,colour,corolla,form,growth,height,inflorescence,mentioned,ovary,plant,seed,shape,staman,texture,type,ye
213	wfo-0001028323	success	164	103	78	86	25	0.476	0.2-0.5,0.2-1,0.6-1,0.9-1.2,1-1.2,1-1.5,1-2,1.5-2.5,2-3,3,3-5,3.5-4,5-6,7.5-9,acute,anther,apex,attenuate,base,berry,blue-green,brown,calyx,cm,conical,corolla,dark,densely,diameter,ellipsoid,elliptic,entire,fading,filament,fleshy,glabrescent,glabrous,grey,growth,inflorescence,internodal,lanceolate,leaf-opposed,less,lobe,margin,maturity,minutely,mm,ovary,ovoid,pair,pale,pedicel,peduncle,petiole,pitted,primary,pubescent,reddish,revolute,rounded,shiny,shoot,short,shrub,simple,sometimes,somewhat,sparely,sparsely,stem,style,surface,vein,violet,white,x	-2,0.4-1.3,0.5,0.5-1,0.8,1,1.1-4.5,1.5,2-9,3-6,abaxially,abscissio,absent,along,anthesi,apart,apparently,appressed,articulated,ba,bark,c.,capiatate,cell,coriaceous,cup-shaped,deltate,dendritic,drying,eaf,eed,erect,flower,free,fruiting,glabrescen,globose,included,lengthening,like,lobed,longer,lower,main,minute,new,nflorescence,occasionally,ovate,papillat,papillose,peg,perfect,pericarp,planar,plurifoliat,pore,poricidal,portion,proceed,remaining,ruit,scar,scattered,sinus,small,soft,soon,splitting,stigma,straight,tearing,testal,thick,thin,tip,trichome,tube,tuft,ud,uniseriate,unit,wall,way,woody,ympodial	abaxial,adaxial,arrangement,branching,characteristic,colour,form,fruit,height,history,leaf,length,life,midvein,na,plant,pseudostipule,rachi,seed,shape,staman,tertiary,texture,unarmed,venation
214	wfo-0001028329	success	215	144	120	95	24	0.558	.5-3,.75-5.75,0.2-0.3,0.8-1.1,0.8-1.4,0.9-1.3,1-6,1.1-2.5,1.3-1.8,1.3-2,1.5-2.3,1.5-8,12,2-3,2.2-3.9,2.6-5,3-8,4-15,5-10,6-11,6-8,6-9,abaxially,acuminate,acute,adaxially,anther,apart,apex,articulated,asperous,base,becoming,berry,branched,brown,calyx,closely,cm,conical,continued,corolla,cylindrical,deltoid,diameter,dichotomously,due,echinoid,entire,filament,finely,fleshy,flower,fruit,glabrous,granular,granular-tomentose,gray,green,growth,hair,honeycombed,lateral,leaf,length,lobe,long-attenuate,margin,midvein,minutely,mm,moderately,mostly,multangulate,obovate,obtuse,occasional,ovate,ovate-elliptic,pale,pedicel,peduncle,petiole,plurifoliate,porrect-stellate,pubescent,rachi,reniform,reticulate-punctate,ripe,sessile,several,short-,short-stalked,shrub,side,simple,small,sometimes,spaced,sparsely,stellate,stellate-pubescent,stem,style,subglobose,suborbicular,testa,time,tomentose,tree,turning,unarmed,vein,velutinous,white,whitish,x,yellow,yellowish	.75-2,/10-3/10,0-100,1.0-1.4,1.5-2.75,1.5-3.5,10-34,2-4,2.75-4.5,3-14,3.75-7,3/4,4-5,7-19,absen,ag,angled,anthesi,apical-lateral,apparently,axe,axillary,ba,bark,blade,blunt-tipped,branch,bud,chartaceous,dehiscing,dendritic-echinoi,dendritic-echinoid,distantly,distinct,eaf,eed,free,glabrescen,grooved,high,inserted,introrse,large,lengthening,lobed,long,longitudinally,lower,main,multangulat,nflorescence,obelliptic,oblong,obscured,older,orbicular,orolla,perfect,pore,present,pseudo-terminal,rather,receptacle,relatively,ruit,runk,sessil,slightly,slit,sparse,stalked,stellat,stellate-rotate,stelliform,stigma,subcapitat,suture,swollen,tamen,thick,thickened,thin,tomentu,touching,toward,tube,unarme,unit,usually,vary,vestigial,way,wide,ympodial,young	abaxial,adaxial,arrangement,branching,characteristic,colour,form,glabrescent,height,history,inflorescence,life,na,ovary,plant,primary,pseud-terminal,pseudostipule,seed,shape,staman,surface,texture,true
215	wfo-0001028337	success	195	116	95	100	21	0.487	-2.5,-6,.5,0,0.3-0.5,0.4-0.8,0.7-1,1-1.8,1-2,1-3,1.5-3,1.8-2,2-2.2,2-4,4-5,5-25,5-6,abaxial,adaxial,anther,apex,apically,apparently,articulated,base,berry,branched,calyx,chartaceous,cm,color,cuneate,dark,deltate,densely,diameter,entire,erect,evenly,eye,filament,flattened-reniform,flower,fruit,glabrescent,glabrous,glaucous,gray-brown,green,green-brown,hair,inflorescence,known,lateral,leaf,length,lobe,long,margin,marking,mature,mauve,minutely,mm,moderately,naked,narrow-oblong,one,open,orange-brown,pedicel,peduncle,per,petiole,pitted,primary,rounded,shallowly,shrub,simple,smooth,sparse,stellate-pubescent,stem,style,surface,terminal,time,toward,unarmed,vein,visible,white,wide,young	-2,-4,.8,/3,0.05-0.15,0.05-1,0.1-0.3,0.4-0.7,0.7-0.9,1,1.5-4,1/2,1/3-2/3,1/4-1/3,1/8-1/4,11-16,15-50,3-4,5-8,5-merous,6-7,8-10,8-14,abaxially,acut,alyx,apar,apart,ape,bark,blade,conical,connivent,curved,discolorous,drying,eaf,eed,elongating,equal,free,fruiting,fused,gently,glabrou,gray,infructescence,juvenil,juvenile,lobed,long-styled,longer,lower,midpoint,nflorescence,occasionally,older,orolla,oung,pale,perfect,pericarp,plurifoliat,poricidal,porrect,porrect-lepidote,portion,prickle,prickly,ray,reddish,reflexed,ruit,scar,sessile,shoot,short,short-styled,shorter,slender,small,spaced,spherical,staminate,stellate,stout,straight,strongly,tamen,tapering,terete,tip,trichome,tube,unarme,unit,usually,vary,way,ympodial	acute,arrangement,branching,characteristic,colour,corolla,form,growth,height,history,life,midvein,na,ovary,plant,seed,shape,staman,texture,type,ye
216	wfo-0001028339	success	195	103	88	107	15	0.451	.5,1-1.2,1-2,1-5,1.1-1.4,1.2-1.5,1.5,1.5-2,1.7-3.2,10-30-flowered,3.5-4,5-7,8182,acuminate,acute,anther,bark,base,beneath,berry,blue,broadly,brown,bud,calyx,capitate,cm,corolla,covered,cuneate,cup-shaped,dark,decurrent,deflexed,densely,dia,dried,filiform,flattened,glabrate,glabrous,globose,grainy,greyish-brown,growth,later,leaf,lobed,long,margin,minutely,mm,mustard,nearly,oblique,ovary,ovate,ovoid-reniform,papillate,pedicel,petiole,pitted,red-brown,schwarz,shining,shrub,simple,slender,slightly,small,somewhat,specimen,stem,stigma,strongly,style,surface,tapering,texture,tree,trichome,tube,urceolate,vein,white,winged,x,yellow	0.05-0.1,0.8-1.2,1-1.5,10.2-18.5,2.5-5,3.4-5.5,43191,5-angled,5.8-7.9,7-11,8-10,across,almost,anthesi,apex,appearance,appearing,appressed,attenuate,becoming,carinate,carpel,closely,connate,crystalline,differing,difoliate,distinctly,dry,eaf,edicel,eed,enclosed,epidermi,erect,evenly,exserted,fide,filament,first,floccose,flower,free,frui,fruiting,geminat,irregular,large-celled,lateral,leave,like,little,lobe,lon,long-triangular,lower,main,major,middle,minor,nee,nflorescence,obscure,occasionally,older,one,opposite,overlappin,ovoid,papery,papillose,planar,pore,poricidal,portion,proximal,pulp,reflexed,ruit,scar,secondary,septum,shaped,size,spaced,sparsely,speckled,straight,strong,tall,tear-drop,tightly,tip,tub,ud,uniseriate,unit,venation,white-lenticellat,white-papillo,white-speckled,wide,widest,woody,yellowish,ympodial,young	abaxial,characteristic,colour,diameter,form,fruit,height,inflorescence,length,plant,seed,shape,type,white-lenticellate,white-papillose
217	wfo-0001028351	success	175	121	95	80	26	0.543	.2,.8,0,0.1,0.2,0.5,1.0â2.0,1.0â2.5,1.4â1.5,2.0â2.5,2.1â3.5,2/3,3,3.4â5.0,3â4,40,5.0,5.0â5.5,5.5â10.5,5â7,6.5â8.5,6â12,8â15,abaxially,absent,acute,adaxially,along,annual,anther,anthesi,apart,apex,articulated,base,becoming,blue,branching,brown,calyx,cm,colour,densely,diameter,filament,flattened,fruit,glabrous,globose,green,hair,herb,lanceolate,leaf,lobe,lobed,long,lower,margin,midvein,mm,moderately,multicellular,narrowly,occasionally,opposed,ovate,pale,pedicel,peduncle,perennial,petiole,pitted,pubescent,regularly,shallowly,shiny,simple,slender,smaller,spaced,stem,style,surface,truncate,unbranched,unicellular,uniseriate,unknown,velutinous,white,winged,woody,x,â3.0	.8â1.0,0.6,0â,1.0â,1.0â1.6,1.5â4.0,1.6â,10,2,2.0â5.0,2â2.5,2â4,4,5,adaxiall,ag,apical,axe,ba,basal,blade,capitate,cell,chartaceous,clavate,connivent,convex,cylindrical,directed,distally,eaf,eed,equal,erect,fleshy,flower,geminat,glandular,indumentum,lamin,like,lon,longitudinal,m.,nfloresence,number,oblong,obtuse,opening,orolla,pair,pentagonal,perfect,plurifoliate,pore,present,probably,ruit,serrate,shaped,side,slit,sparsely,stigma,stone,straight,tal,tamen,tardily,teardrop,tem,time,tube,unit,vary,wide,wing,ympodial,young,â	abaxial,adaxial,arrangement,characteristic,corolla,form,growth,height,history,inflorescence,length,life,na,ovary,plant,primary,pseudostipule,rachi,seed,shape,staman,tertiary,texture,unarmed,vein,venation
218	wfo-0001028353	success	177	116	101	76	15	0.571	/3,0.2-0.4,0.5,0.9-1.2,1,1-2,1.4-2,2,2-3,2-4,3,3-5,6-8,7,8-10,acute,anther,apex,base,beneath,berry,bluntly,bright,calyx,campanulate,cell,centre,ciliate,clasping,cm,coarsely,conical,cordate,corolla,curved,dark,deep,deeply,densely,diameter,distally,elliptic,erect,fleshy,flower,glabrous,globose,green,greenish,growing,herb,hollow,honey-comb,internodal,leaf,less,like,lobe,long,margin,midrib,mm,nodding,ovary,ovoid,pale,papery,pedicel,peduncle,petiole,pitted,plant,plump,point,pubescent,purple,rhomboid,ripe,scattered,sessile,simple,slender,somewhat,sparsely,stem,straight,style,surface,tan,testal,tip,toothed,toward,trichome,truncate,uniseriate,vein,wall,way,x,yellow	.5,0.5-,1-4,1.5-2,1.5-5,4-7,abaxially,accrescent,age,along,anthesi,apart,area,becoming,capitate,cup-shaped,decreasing,decumben,difoliate,dry,drying,eaf,edicel,eed,ellipsoid,emarginated,exerted,filament,fracturing,free,frui,fruiting,geminat,gree,heteromorphic,horn,horned,inserted,lengthening,lon,lower,m.,material,minute,minutely,nflorescence,often,open,outline,pair,papillate,papillose,pericarp,pore,poricidal,portion,primary,principal,reddish,ruit,scar,sessil,shallow,short,size,sleeve,slightly,slit,stigma,strongly,thin,tube,ud,unit,wrinkled,ympodial	0.5-2,abaxial,arrangement,characteristic,colour,form,fruit,growth,height,inflorescence,length,pubescence,seed,shape,texture
219	wfo-0001028390	success	147	98	67	80	31	0.456	0.5,0.5-1,0.5-1.5,0.5-2.5,1-2.5,1-3,1.5-2,10-15,3-4,3-5,4-5,5-7,7-8,9,acute,angled,apex,apiculate,articulated,base,branched,calyx,chartaceous,cm,cuneate,deltate,dendritically,densely,diameter,divided,elliptic,entire,felty-pubescent,forked,glabrous,globose,lobe,margin,midvein,mm,moderately,near,obtuse,often,orange,ovate,pedicel,peduncle,petiole,pseudohair,pubescent,rachi,rarely,shrub,simple,slightly,sparsely,style,subcordate,subcoriaceous,unbranched,unequally,violet,white,white-pubescent,x,yellow	-10,.5-3.3,0,1,1-5,1.5-3.5,1.5-5.5,2,2.5,4-11,6-many-foliat,7,abaxially,absen,adaxiall,adaxially,aggregate,apart,axe,blade,cell,connivent,curled,cylindrical,dendritically-branched,dense,directed,distall,eaf,eed,eglandular,flower,gland,hair,lanceolate,leaving,less,like,lon,long,lower,mixed,mostly,narrowly,nflorescence,nther,occasionally,orolla,peg,perfect,pore,presen,puberulent,pubescen,radiu,ripe,ruit,scar,short,small,spaced,stalked,ste,stellate,stigma,stone,subcapitat,subclavate,tal,tem,time,tip,triangular,truncate,tube,unit,usually,vary,wide,ympodial	abaxial,adaxial,anther,arrangement,branching,characteristic,colour,corolla,filament,form,fruit,growth,height,inflorescence,leaf,length,na,ovary,plant,primary,pseudostipule,seed,shape,staman,stem,surface,tertiary,texture,unarmed,vein,venation
220	wfo-0001028405	success	149	68	49	100	19	0.329	0.4-0.5,1-9,1.5-6.5,10-11,2,2-2.5,2-4,3-4,4-6,6-7,8-15,branched,calyx,cm,conical,corolla,cyme,diameter,dichasial,dichasially,ebracteate,elliptic,elliptic-lanceolate,green,herbaceous,lanceolate,leaf,lobe,mm,monochasial,mucilaginous,oblong,odd-pinnate,ovate-elliptic,ovoid,pedicel,peduncle,perennial,petiole,plant,puberulent,seed,size,stellate,straight,style,throughout,tuber-bearing,yellow	0.5-3,1-4,1.3-8,2-3,3-20,3-6-foliat,3.5-10,3.5-6.5,4-11.5,7-14.5,9-15,abaxially,absen,acumen,acute,adaxially,apex,apical,apically,apiculate,articulate,attenuate,base,cell,connate,covering,decurrent,dehiscent,digestion,diminishing,distal,dorsally,eaf,edge,eed,emoval,enzyme,exceeding,filament,flat,flower,folded,forked,generally,globo,gradually,green-white,hair-like,half,honeycomb,interjected,introrse,lateral,leaflet,living,lon,long,lower,lunat,make,maturing,nflorescence,nther,oblique,often,orolla,pair,pattern,perfect,plan,poricidally,proximal,rachi,reveal,ruit,seudostipule,short,short-acuminate,short-petiolate,slit,specimen,stamen,stigma,subsessile,tal,tem,terminal,testal,thick,throughou,toward,typically,unit,vary,wall,whit,wide,without,ympodial,Â¼	anther,arrangement,characteristic,colour,form,fruit,growth,height,history,inflorescence,length,life,ovary,shape,stem,surface,texture,white,ye
221	wfo-0001028429	success	162	111	80	82	31	0.494	0.2-0.4,0.8-1.2,1-4,1.5-3,10-11,10-27,2.5-12,2.5-7.5,2.7-3.6,3-6,4-14,6-28,abaxially,acuminate,acute,adaxially,apex,articulate,base,branched,broadly,calyx,cell,cm,cordate,corolla,covering,cuneate,cyme,darker,diameter,dichasial,dichasially,distal,ebracteate,elliptical,filament,glabrescent,glabrous,globose,green,greenish,hair,hair-like,herbaceous,lateral,leaf,light,lobe,long,long-attenuate,make,medium,mm,monochasial,mucilaginous,narrowly,oblique,odd-pinnate,ovate,ovoid,pedicel,peduncle,perennial,petiole,plant,proximal,scattered,seed,slightly,spot,style,testal,thick,throughout,vein,violet,wall,white,Â¼	0.9-2.3,1-2.5,1.5-4,10.5-21,2-1.,2-3,2-4,2-8,2.5-4,3-6-foliat,5-12,6-18,7-7,abaxiall,acumen,apical,apically,connate,dehiscent,digestion,diminishing,dorsally,eaf,edge,eed,emoval,enzyme,especially,exceeding,flat,flower,folded,forked,generally,globo,gradually,green-white,half,honeycomb,interjected,introrse,leaflet,living,lon,lower,lunat,maturing,nflorescence,nther,obovate,often,orolla,pair,pattern,pentagonal,perfect,petiolule,plan,poricidally,reveal,rotate,ruit,seudostipule,short,size,slit,specimen,stamen,stigma,straight,tal,tem,terminal,throughou,toward,tuber-bearing,typically,unit,vary,wide,yellow,ympodial	abaxial,adaxial,anther,arrangement,branching,characteristic,colour,form,fruit,growth,height,history,inflorescence,length,life,margin,midvein,na,ovary,primary,pseudostipule,rachi,shape,staman,stem,surface,tertiary,texture,unarmed,venation,wet
222	wfo-0001028436	success	150	100	72	78	28	0.48	.5,0.2-0.4,0.5-1,1-3,1.5,1.5-2,1.5-2.5,10-20,2-3,2-4,2.5-3,4,5-10,5-15,5-8,7,8-12,absent,acute,anther,apex,base,berry,brown,calyx,center,ciliate,decurrent,diameter,dm,dried,edge,elliptic,entire,filament,fine,flower,fruit,glabrous,globose,hair,leaf,linear,linear-lancolate,lobe,margin,mm,moderately,much-branched,nearly,often,parallel,pedicel,peduncle,per,petiole,pubescent,rachi,radiating,raised,ridge,running,shallow,shrub,sparsely,stem,style,surface,unbranched,unifoliate,white,x	0.5,0.8-1.5,1-2,1-2-celled,1st,2nd,5-12,abaxially,abundant,adaxiall,adaxially,along,apically,appearance,appearing,axe,beyond,blade,cell,chartaceous,cm,connected,cordat,deflated,dehiscent,difficult,due,eaf,eed,evaluat,explosively,exserted,flat,frui,fruiting,geniculate,glabrescen,interpetalar,lengt,like,long,lower,lying,membranaceous,nflorescence,notch,oblong,older,orolla,oung,placenta,pointing,presence,pubescen,reaching,rhizomatous,rotate,ruit,small,stamen,stigma,structure,swollen,tal,tamen,taproot,tear,thick,tissue,triangular,tube,two-celled,unit,vary,wid,woody,wrinkled,ympodial	abaxial,adaxial,arrangement,branching,characteristic,colour,corolla,form,growth,height,history,inflorescence,length,life,midvein,na,ovary,plant,primary,pseudostipule,seed,shape,staman,tertiary,texture,unarmed,vein,venation
223	wfo-0001028465	success	159	82	63	96	19	0.396	0.75,10,11-23,2,2-6,2-9.3,2.4-2.8,3-5,4.5-5.5,5-7,8-10,acumen,acuminate,acute,base,branched,broadly,calyx,cell,cm,corolla,covering,cuneate,cyme,diameter,dichasial,dichasially,ebracteate,elliptical,globose,green,hair-like,herbaceous,interpetalar,lateral,leaf,long,medium,mm,monochasial,oblique,odd-pinnate,ovoid,pedicel,peduncle,perennial,petiole,petiolule,plant,puberulent,pubescent,purple,rotate,seed,sessile,spot,strigose,style,testal,thick,throughout,wall,white	1-2,1-4,1.2-2,1.5-2.9,10-24,2-3,2-4,2.5-4,3-4,3-6-foliat,3-8,3.8-7,4-1.,4-8,7-15,9-19,abaxially,adaxially,apex,apical,apically,articulate,attenuate,connate,decurrent,dehiscent,digestion,diminishing,distal,dorsally,eaf,edge,eed,emoval,enzyme,equal,exceeding,filament,first,flat,flower,folded,forked,generally,globo,gradually,green-white,half,honeycomb,interjected,introrse,leaflet,living,lobe,lon,lower,lunat,make,maturing,mucilaginous,nflorescence,nther,often,orolla,pair,pattern,perfect,plan,poricidally,proximal,rachi,rarely,reveal,ruit,seudostipule,short,size,slit,specimen,stamen,stigma,straight,tal,tem,terminal,tissu,toward,tuber-bearing,two,typically,unit,vary,wide,yellow,ympodial,Â¼	anther,arrangement,characteristic,colour,form,fruit,growth,height,history,inflorescence,length,life,margin,ovary,shape,stem,surface,texture,tissue
224	wfo-0001028468	success	255	139	116	139	23	0.455	-10,-3,.5,.6-1,0.2-0.3,0.4-4,0.5-2,0.5-3,0.6-1.2,0.7-2.5,1,1.2-1.5,1.3-2,16,2.2-3,2.5-4,2.8-4.1,2/3-3/4,5-9,6-10,6-9,abaxially,acute,anther,apex,armed,articulated,attenuate,base,becoming,berry,beyond,blue,broadly,brown,calyx,campanulate,chartaceous,clavate,cm,commonly,corolla,dark,densely,diameter,distally,exserted,extra-axillary,filament,flattened,flower,foveate,fruit,glabrescent,glabrous,gradually,gray,green,greenish,hair,increasing,length,light,lobe,lobed,margin,mm,moderately,narrowly,oblique,oblong-conical,obtuse,orange,pair,pale,pedicel,peduncle,petiole,porrect-stellate,proximal,pubescence,purple,rachi,recurved,reticulate,rhombic,shallowly,short,short-stalked,shrub,simple,somewhat,sparsely,stamen,stellate-pubescent,stelliform,stem,style,subchartaceous,subcuneate,subelliptic,subglobose,sublenticular,subreniform,subshrub,surface,terete,testa,thick,thicknes,triangular,tube,unarmed,unbranched,x,yellowish	-1.3,-4,-5.5,-7,.1-0.2,.1-0.3,.1-0.4,.2,.2-0.4,.3,.3-0.4,.5-1.5,.5-1.6,/10-1/5,/4-1/3,0.05,0.1,0.2-0.6,0.2-1.5,0.4-1,0.5-3.3,0.5-3.5,0.5-8,0.6-2,0.8-3.5,1.5-2.2,1.5-3.1,1.6,1/3-1/2,1/5-1/2,2,2-9,20,3-4,4-6,4-9,5-21,accrescent,acuminate,adaxially,along,apart,appressed,ark,axe,blade,broad-based,bu,bud,c.,cauline,central,compresse,compressed,connivent,d.,decreasing,density,directed,distal,distantly,dry,eaf,eed,ellipsoid,equal,fruiting,geminat,half,inserted,interpetalar,introrsel,lamin,lateral,laterally,long,longer,lower,m.,main,midpoint,midvein,minutely,mixed,mostly,multangulat,multangulate,nflorescence,oblong-lanceolate,occasionally,older,orangish,orolla,ovate,overlapping,ovoid,papillo,per,perfect,pore,prickle,pubescent,ray,reduced,relatively,rotate-stellate,ruit,sessile,short-,side,similar,similarly,slightly,spaced,specimen,stalk,stigma,straight,subacuminate,subcapitate,subsessile,tal,tamen,thick-stalked,time,tissue,touching,toward,unifoliate,unit,upper,usually,vary,vein,way,wide,yellow,ympodial,young	0-1.3,0.3-0.4,0.5-1.5,0.5-1.6,4-5.5,abaxial,adaxial,arrangement,branching,characteristic,colour,form,growth,height,inflorescence,leaf,na,ovary,plant,seed,shape,staman,texture
225	wfo-0001028470	success	185	130	97	88	33	0.524	0.25-0.75,0.9-2.2,0.9-2.3,1-12.3,1-2,1-3,12-44,2-10,2-7,2-8,2.1-3.9,3-10,3-5,4-7,6-33,anther,apart,apex,articulated,attenuate,axillary,base,berry,brownish,bud,cell,chartaceous,cm,condition,corolla,covering,dark,deep,diameter,distal,dot,drying,elliptic,filament,flower,forked,fresh,fruit,generally,glabrescent,glabrous,green,green-white,greenish,hair,hair-like,half,herb,high,lateral,leaf,light,lobe,long,make,medium,mm,mottled,mucilaginous,odd-pinnate,ovate,ovoid,pedicel,peduncle,petiole,petiolulate,plant,plurifoliate,pubescent,purple,ripe,rounded,seed,short,sometimes,spaced,style,subtending,terminal,testal,thick,throughout,tri-,unit,unwinged,usually,wall,wet,white,whitish,wide,wing	0-18,1.5-2.8,1.6-3.2,11.8-21,2-5,3.2-5.5,3.5-16,3.5-7,4-6,5-merou,5.5-11.6,abaxially,acumen,acute,adaxiall,adaxially,ag,alyx,apparently,asymmetric,axe,basiscopic,blade,capitat,clavate,connivent,decreasing,digestion,dorsally,eaf,edge,eed,end,enzyme,erec,exceeding,flat,folded,geminat,glabrou,hal,homostylous,honeycomb-shaped,interjected,lanceolate,leaflet,lengthening,living,lower,nflorescence,one,orbicular,orolla,pair,pentagonal,perfect,placed,pore,poricidal,removed,ruit,scarce,sessile,seudostipule,side,size,slit,specimen,stamen,stigma,stolo,straight,subequal,subglabrou,substellate,tall,tamen,tem,tip,tissue,toward,tube,tuber,typically,vary,x,yellow,ympodial	abaxial,adaxial,arrangement,branching,calyx,characteristic,colour,form,growth,height,history,inflorescence,length,life,margin,midvein,na,ovary,perennial,primary,pseudostipule,rachi,shape,staman,stem,subglabrous,surface,sympodial,tertiary,texture,unarmed,vein,venation
226	wfo-0001028476	success	246	94	75	171	19	0.305	-6,0.2-0.5,0.25-0.5,0.3-0.4,0.4-0.6,0.5,0.8-1.2,0.8-1.6,1-4,1.8-2.5,2.4-3,5-15,7-10,acuminate,acute,anther,apex,articulated,base,branched,bright,brown,calyx,cm,conical,corolla,dark,deeply,diameter,distal,elliptic,filament,fruit,globose,green,hair-like,half,herb,imparipinnate,inflorescence,interrupted,irregularly,lanceolate,leaf,less,lobe,lobed,margin,midvein,minutely,mm,narrowly,obovate,outgrowth,ovary,pale,pedicel,peduncle,perennial,petiole,primary,pseudostipule,puberulent,pubescent,purple,rachi,sparsely,stem,stripe,style,surface,tertiary,truncate,vein,yellow	-1,-16,-20,-8,.05-0.1,.5,0-,0-0.5,0.1-0.15,0.1-0.4,0.15-0.2,0.15-0.4,0.2-0.3,0.2-0.6,0.25-0.4,0.3-0.5,0.3-0.7,0.3-1.2,0.4-0.5,0.4-1.5,0.5-0.6,0.5-1.7,0.7-2.5,1,1-1.2,1-1.4,1-1.5,1-2,1-2-celled,1-6,1-celled,1.1-1.5,1.1-1.6,1.2-2.5,12-30,2,2-6,2-foliate,2-locular,3-12,3-7,3-foliate,3.5-13,4-celled,6-,8-30,abaxially,absent,abundant,acroscopically,age,almost,along,also,alternate,anthesi,ape,apical,appearance,appendage,axi,basal,basiscopically,becoming,bifurcate,bifurcation,bract,bracteate,capitate,cell,column,curved,decurrent,diamete,eaf,ebracteate,edicel,eed,elongate,entire,especially,exserted,first,flower,fortaleza,fruiting,give,glabrescent,glandular,gradually,gree,hal,head,hyaline,incurved,interjected,internode,largest,lateral,leaflet,like,lon,long,lower,main,maturity,minute,mixed,nflorescence,node,numerous,oblique,occasionally,often,pair,petiolule,population,present,prominent,pubescence,rarely,recurve,reflexed,regularly,rest,rounded,ruit,rÃ­o,scattered,secondary,sessile,set,short,silky,simple,sinus,slightly,smaller,sprawling,spreading,staminal,stellate,sterile,stiff,stigma,straight,subopposite,tall,tem,terminal,testa,thick,tip,toward,trichome,tube,ud,unicellular,uniformly,uniseriate,unit,unpaired,usually,wall,weak-walled,white,wid,wide,winged,woody,ympodial	0.05-0.1,abaxial,adaxial,arrangement,branching,characteristic,colour,form,growth,history,length,life,na,seed,shape,staman,texture,unarmed,venation
227	wfo-0001028481	success	194	105	90	104	15	0.464	.5,0.6-1,1-2,1.5,1.8-2.5,1/2-2/3,3,3-4,3-4.5,3-6,8,abaxially,acuminate,acute,adaxially,almost,anther,anthesi,apex,apically,attenuate,base,branch,branched,brown,chartaceous,cm,colour,conical,corolla,cuneate,deltoid,dendritic,dendritic-pubescent,diameter,distributed,drying,elliptic,entire,equal,evenly,flat,flower,glabrous,green,known,leaf,length,liana,like,lobe,long,long-acuminate,main,margin,midvein,mm,narrowly,oblique,occasional,orange-brown,pair,pedicel,peduncle,petiole,primary,pubescent,rachi,raised,reddish,shortly,shrub,slender,sparsely,stem,style,surface,terminal,tertiary,thickly,trichome,unarmed,unknown,vein,venation,visible,white,x,yellowish,young	.1,.3,0-2,0.1-0.2,0.15,0.5-1,0Â°,1-1.4,1-3,1-4,1.5-2,2-3,2.5-3,3-3.5,5.5-7.5,absent,age,along,alyx,apar,apparently,articulated,bark,canaliculate,clavate,clearly,close,cupular,deeply,delineated,density,different,dilated,discolorous,divided,domatia,dorsifixed,dry,eaf,eed,ellipsoi,erect,except,extending,extent,eye,faint,filament,flaking,flexuous,free,increasing,know,lamina,lengthening,less,linear,lobed,lon,longer,longitudinally,lower,m.,mostly,naked,nflorescence,nther,oblong,often,orolla,ovate,perfec,plurifoliat,pore,poricidal,portion,protruding,ray,ribbed,ridged,ruit,scar,see,side,simple,sinus,size,small,smoot,smoothly,spreading,stigma,stump,tearing,tip,together,toward,tube,ud,uneven,unit,vary,wide,ympodial	abaxial,adaxial,arrangement,branching,calyx,characteristic,form,fruit,growth,inflorescence,ovary,seed,shape,texture,ye
228	wfo-0001028482	success	224	140	121	103	19	0.54	.1,.5,0,0.5-1,0.5-5,1-1.5,1-11,1-2,1-4,1.1-5,1.2-1.6,1.5-2,10,2-3,3-4,4-5,7-14,acuminate,acute,adaxially,alternate,angled,anther,anthesi,apex,ascending,asymmetric,base,berry,bifurcate,branched,bright,broadly,brochiodromous,brownish,calyx,channeled,chartaceous,cm,corky,corolla,corrugated,creamy,curved,cymose,deltate,diameter,diffusely,difoliate,dry,drying,elliptic,emarginate,entire,filament,flattened-reniform,fleshy,fresh,fruit,glabrous,globose,golden,green,growth,hard,impressed,internodal,keeled,leaf-opposed,lobe,long,margin,material,maturity,midvein,minutely,mm,nodding,obovate,occasionally,olive,ovary,pair,pale,pedicel,peduncle,per,petiole,pitted,primary,pubescent,revolute,short,simple,slightly,somewhat,stem,stout,straight,style,subcoriaceous,subglobose,subpyramidal,surface,tan,transversely,tree,trichome,truncate,tuberculate,tuft,unifoliate,uniseriate,usually,vein,venation,white,x,yellow,yellowish,young	/3,0.2,0.5,0.7-1.1,00,1.5-3,2-celled,3-12,5-25,6-50,abaxially,age,apiculae,bark,basal,becoming,berr,bifid,bilobed,bud,campanulate,capitate,circinate,closely,constriction,coriaceous,cucullate,deciduous,deflexed,densely,discolorous,distally,distinct,eaf,eed,ellipsoid,embryo,enlarged,exerted,exfoliating,expanding,flower,free,fruiting,geminat,glabrou,glandular,grayish,halfway,heterostylous,incrassate,individual,investing,irregular,lengthening,less,lobed,lower,markedly,materia,midrib,minute,new,nflorescence,overlappin,papillat,pentamerous,pericarp,petal,pore,poricidal,portion,reddish,row,ruit,scandent,scar,shaped,shiny,size,slit,small,sometimes,soon,spaced,sparsely,stigma,tear-drop,tightly,tiny,tip,transparent,tub,tube,twice,two,ud,unit,vegetative,way,woody,ympodial,Âµm	abaxial,adaxial,arrangement,branching,characteristic,colour,form,height,inflorescence,leaf,length,na,plant,seed,shape,staman,tertiary,texture,unarmed
229	wfo-0001028487	invalid_json	195	139	102	93	37	0.523	0.3-0.7,0.9-3,1-2,1-3,1.1-1.5,1.4-1.7,10-4.3,10-41,15-28,2-4,2-6,2.5-3.5,3-10,3-5,4-7,5-6,abaxially,acumen,acuminate,acute,adaxially,anther,apart,apex,articulated,asymmetric,attenuate,axillary,base,basiscopic,berry,brownish,bud,cell,central,cm,condition,coriaceous,corolla,covering,dark,deep,diameter,distal,drying,elliptic,filament,flower,forked,fresh,fruit,generally,glabrescent,glabrous,green,green-white,greenish,hair,hair-like,half,herb,high,lateral,leaf,light,lobe,long,make,medium,mm,mucilaginous,odd-pinnate,ovate,ovoid,pedicel,peduncle,petiole,petiolulate,plant,purple,ripe,rounded,scabrous,scarce,seed,short,side,spaced,star,style,subtending,terminal,testal,thick,throughout,tissue,usually,wall,wet,white,whitish,wide	0-9,0.4-1.5,1-3.2,1.7-7,2-4.8,3-19,3-4,3.4-7.8,4.6-13.6,5-merou,7.8-16.4,adaxiall,ag,along,alyx,apparently,arranged,axe,bead,blade,capitat,clavate,connivent,considerably,decreasing,digestion,dorsally,eaf,edge,eed,enzyme,erec,exceeding,flat,folded,geminat,glabrou,hal,homostylous,honeycomb-shaped,interjected,lanceolate,leaflet,lengthening,like,living,lower,moniliform,multiple,narrow,necklace,nflorescence,orbicular,orolla,pair,pentagonal,perfect,plurifoliate,pore,poricidal,removed,ruit,second,sessile,seudostipule,size,slit,smaller,sometimes,specimen,stamen,stigma,stolon,straight,subequal,subglabrou,substellate,tall,tamen,tem,tip,toward,tri-,tube,tuber,typically,unit,unwinged,vary,wing,x,yellow,ympodial	'',[,``,abaxial,adaxial,arrangement,branching,calyx,characteristic,colour,form,growth,height,history,inflorescence,length,life,margin,midvein,na,ovary,primary,pseudostipule,rachi,shape,staman,stem,subglabrous,surface,tertiary,texture,unarmed,value,vein,venation,{,}
230	wfo-0001028489	success	224	145	121	103	24	0.54	-10,-2.5,-5,0-10,0-15,0-20,0-3,0.3-0.5,0.3-1,0.3-1.2,0.5-1.1,0.5-1.5,0.6-1.2,1-3,1-4,1.5-4,1.8-2.2,1/3,2-3,2-4,2.1-3,3-7,3.5-6,5-25,acute,anther,apex,apically,apparently,articulated,base,berry,branched,calyx,cell,chartaceous,cm,concolorous,cordate,cream,cuneate,curved,dark,deltate,diameter,drying,dull,elliptic,erect,eye,filament,flattened-reniform,fruit,glabrous,gray,green,infructescence,lateral,leaf,length,lobe,lobed,long,margin,marking,maturity,mauve,membranous,midvein,mm,moderately,naked,obtuse,occasionally,orange,orange-brown,outline,ovate,pair,pale,pedicel,peduncle,per,petiole,prickle,prickly,primary,purple,raised,red-brown,rounded,shiny,shrub,side,simple,slender,smooth,sometimes,sparsely,spherical,stellate,stellate-pubescent,stem,style,surface,tertiary,toward,trichome,truncate,unarmed,upper,vein,venation,visible,weakly,white,wide,yellow,yellow-green,yellow-orange,young	-0.6,-4,-6,/4,0-50,0.1,0.1-0.6,0.2,0.2-,0.2-0.4,0.2-0.5,0.2-0.6,0.2-0.7,0.3-0.7,0.4-0.8,0.5-0.8,0.5-1,0.7-3,1-6,1-7,1.5-3,1.8-4,1.8-5.5,1/3-1/2,1/4-1/2,2-6,4-10,4-13,4-8,5-8,5-merous,7.5,abaxially,acicular,alyx,apar,apart,ba,bark,beyond,blade,broad-deltate,caudat,connivent,densely,difoliate,distance,eaf,eed,elongating,equal,extending,flower,free,fruiting,geminat,hair,herbaceous,less,lon,longer,lower,mature,midpoint,minute,nflorescence,often,older,one,open,orange-green,orolla,oung,pendulous,perfec,pericarp,perpendicular,poricidal,porrect,portion,protruding,ray,ruit,scar,sessile,spaced,spreading,stalk,straight,subsessile,tamen,tapering,terete,time,tip,tube,unarme,unit,vary,way,white-gra,woody,ympodial	abaxial,adaxial,arrangement,branching,caudate,characteristic,colour,corolla,form,growth,height,history,inflorescence,life,na,ovary,perennial,plant,pseudostipule,rachi,seed,shape,staman,texture
231	wfo-0001028492	invalid_json	130	104	71	59	33	0.546	0.2-2,0.5-1,1-2.5,1-4,1-5,1.5-2.5,1.5-3,15-20,2-2.5,2-5,3,3-6,4,5-15,5-8,6-11,8-15,angled,apart,apex,articulated,base,calyx,chartaceous,cm,colored,connivent,cylindrical,dark,deltate,diameter,directed,elliptic-ovate,entire,forked,fruit,glabrous,globose,herb,lobe,margin,mm,narrowly,obtuse,pedicel,peduncle,petiole,pore,pubescent,punctate,purple,rachi,radiu,rarely,reticulate,ripe,rounded,sand-punctate,shrub,simple,stellate,stigma,style,subcordate,triangular,unbranched,veiny,white,white-punctate,whitish,x	-5-foliat,1.5-6,1.75-3.5,2-3,2-4,2.5-9,5-25-flower,6-12,abaxially,absen,acute,adaxially,aggregate,apiculate,axe,axi,blade,cell,ciliolate,color,containing,crystal,distall,eaf,eed,except,glabrou,hair,irregularly,leaving,long,lower,nflorescence,nther,orolla,ruit,san,scar,somewhat,spaced,sparse,splitting,stone,subcoriaceous,succulent,tal,tem,time,tip,triangular-ovate,truncat,tube,unevenly,unit,unknown,vary,wide,x1-3,ympodial	'',[,``,abaxial,adaxial,anther,arrangement,articulation,characteristic,colour,connivence,corolla,direction,distally,form,growth,height,inflorescence,leaf,length,ovary,plant,seed,shape,spacing,stem,surface,texture,truncate,value,width,{,}
232	wfo-0001028501	success	195	128	104	91	24	0.533	0-3.2,0.3-0.7,0.8-1.6,0.8-1.7,1,1-2,1-8,1.8-10.7,13-41,2-4,2.8-4.9,3-10,3-5,4-8,8-10,8-34,abaxially,acumen,acuminate,acute,adaxially,anther,apex,articulated,axillary,base,berry,brownish,bud,cell,cm,condition,coriaceous,corolla,covering,dark,decurrent,diameter,distal,drying,elliptic,filament,flower,forked,fresh,fruit,generally,glabrescent,glabrous,green,green-white,greenish,hair,hair-like,half,herb,high,lateral,leaf,light,linear,lobe,long,make,medium,mm,mottled,mucilaginous,narrow,narrowly,odd-pinnate,onto,ovate,ovoid,pedicel,peduncle,petiole,plant,purple,pyriform,rachi,ripe,scarce,seed,sessile,short,simple,sometimes,spot,style,subtending,terminal,testal,thick,throughout,typically,unwinged,usually,wall,wet,white,whitish,wide,wing	0-3,0-4,0.3-3.3,0.6-5.8,1-3,2-5,2.8-18,3-7,3.1-10.4,3.1-12,4.8-18,5-merou,6.6-21.1,adaxiall,ag,along,alyx,apart,apparently,arranged,attenuate,axe,bead,blade,broadly,capitat,clavate,connivent,considerably,decreasing,digestion,dorsally,eaf,edge,eed,enzyme,erec,exceeding,flat,folded,geminat,glabrou,hal,homostylous,honeycomb-shaped,interjected,lanceolate,larger,leaflet,lengthening,like,living,lower,moniliform,multiple,necklace,nflorescence,orbicular,orolla,pair,perfect,plurifoliate,pore,poricidal,present,removed,rotate,ruit,seudostipule,size,slit,spaced,specimen,stamen,stigma,stolon,straight,subglabrou,tall,tamen,tem,tip,toward,tri-,tube,tuber,unit,vary,x,yellow,ympodial	2,abaxial,adaxial,arrangement,branching,calyx,characteristic,colour,form,growth,height,inflorescence,length,margin,mentioned,ovary,pseudostipule,shape,staman,stem,subglabrous,surface,texture,unarmed
233	wfo-0001028502	success	158	96	70	88	26	0.443	0.5-1,1-2,1.5-2,1.5-2.5,1.5-3,1.6-2.4,2-4,2-5,2-7,2-8,3.5-4,5-15,6-8,abaxial,abaxially,acute,adaxially,anther,apex,base,beige,branched,calyx,cm,corolla,deltate,densely,elliptic,fawn,filament,flattened-reniform,flower,glabrous,globose,incrassate,inflorescence,later,lateral,leaf,light,lobe,long,margin,minutely,mm,ovary,pair,pedicel,petiole,pitted,prominent,pubescent,reddish-brown,scattered,seed,shining,shrub,small,stem,style,surface,terminal,time,tree,tree-like,trichome,vein,warty,white,wide	.5,/2,1.5-6,2-2.5,3.5-15,5-6,?,age,along,anthesi,apar,ba,bark,blade,body,branch,brown,campanulate,cazalet,christmas-tree-like,clavate,closely,cone,congested,constricted,dark,dendritic,denser,dia,eaf,edicel,eed,erect,exserted,fide,flat,fleshy,free,fruiting,glabrat,heteromorphic,impressed,included,inflorescenc,lengthening,like,lobed,lon,long-styled,lower,main,matted,middle,narrower,nflorescence,obovate,often,older,packed,papillo,papillose,planar,plurifoliat,pore,poricidal,portion,rest,ruit,scar,short-styled,slit,spaced,stigma,structure,tall,thick,tip,tub,tube,ud,unclear,unevenly,way,widest,within,woody,ympodia,young	4-6,adaxial,arrangement,branching,characteristic,colour,diameter,form,fruit,growth,height,length,midvein,na,peduncle,plant,plurifoliate,primary,pseudostipule,rachi,shape,staman,tertiary,texture,unarmed,venation
234	wfo-0001028505	invalid_json	168	91	72	96	19	0.429	.01,.1,.3,.5,0.8-1,0.8-1.5,1,1-3,1.2-2.5,10-15,2,2.5-4.5,3.5-5,anther,apex,beneath,berry,broadly,calyx,characteristic,cm,conical,corolla,darker,deflexed,elliptic,erect,filament,fruiting,glabrous,globose,incrassate,lateral,leaf,lobed,main,margin,minor,minutely,mm,narrowly,ovary,ovate,ovoid-reniform,pedicel,petiole,pitted,plant,poricidal,prominent,pubescent,seed,shape,shrub,simple,size,somewhat,stem,stigma,straight,style,surface,tip,trichome,tube,unicellular,uniseriate,unit,vein,white,x,yellowish	/3,0.25-0.5,1/3,10-14-flowered,3-5,7-8,acuminate,acute,anthesi,aspect,ba,barely,bark,basal,base,black,blade,body,branch,bright,bud,deciduous,decurrent,delicate,deltoid,dia,differentiated,differing,difoliate,distance,distinct,dried,dry,drying,eaf,edicel,eed,expanded,exserted,exsertion,f,flattened,free,geminat,gently,greatly,green,grey,live,lobe,lon,long,lower,m.,major,materia,material,member,minute,nflorescence,obovoid,obvious,older,opposite,overlapping,pair,pale,papillose,pore,portion,proximal,purple,reflexed,rounded,ruit,scar,shaped,short,slightly,soon,specimen,strongly,tall,tan,tapering,tear-drop,touching,truncate,ud,usually,way,whit,widest,woody,ympodial,young	'',[,``,branching,colour,diameter,form,fruit,growth,height,inflorescence,length,pubescence,sympodial,texture,type,value,{,}
235	wfo-0001028524	success	236	148	128	108	20	0.542	0-150,0.3,0.3-0.8,0.5-3.5,0.6-1.4,1-5,1.1-1.2,1.2-1.3,1.5-1.6,1.8-2.5,11,2-3.8,2-6,2.8-3.5,3-15,3-4.3,3.4-3.6,4-6,4-8,4.3-6,6-7,7-10,8-13,abaxially,acuminate,acute,adaxially,anther,apart,apex,articulated,base,becoming,berry,branched,brown,bud,calyx,chartaceous,closely,cm,conical,continued,corolla,cream,dark,deltoid,densely,diameter,dm,due,echinoid,entire,exserted,ferrugineous,filament,fleshy,flower,fruit,glabrescent,granular-tomentose,gray,green,greenish,growth,hair,honeycombed,lanceolate,large,lateral,leaf,length,lobe,long,margin,mixed,mm,multangulate,nearly,obtuse,ovate,pale,partly,pedicel,peduncle,persistent,petiole,plurifoliate,porrect-stellate,probably,pubescent,rachi,rather,relatively,reniform,reticulate-punctate,ripe,rounded,scabridulous,sessile,short,simple,slightly,somewhat,spaced,sparingly,stamen,stelliform,stem,stigma,style,subcoriaceous,suborbicular,sulcate,terete,testa,thick-stalked,thin,time,tomentose,translucent,tree,unarmed,velutinous,x,yellow,yellowish,yellowish-green	-2.7,-3,.5-1,/10-3/10,1.5-3,1/3-2/3,10-20,2.5-3.4,2.5-3.8,2.5-4,3-10,3.3-4,6-9,7-11,9-14,accrescent,ag,along,anthesi,apical-lateral,apparently,ascending,axe,axillary,ba,bark,blade,blunt-tipped,branch,capitat,dehiscing,distal,eaf,echinoi,eed,elliptic,extend,few-,few-rayed,first,free,fruiting,glabrescen,glabrous,half,high,indument,inserted,interpetalar,introrse,lacking,lanceolat,late,later,lobed,longitudinal,lower,m.,main,many-rayed,matted,midvei,midvein,nflorescence,oblong,obscured,often,older,orbicular,orolla,ovate-lanceolate,overlapping,perfect,pore,present,prominent,pseudo-terminal,ray,ruit,runk,short-stalked,side,slit,small,sparsely,stalked,stellate,stout-stalked,strongly,subglobose,suture,tamen,thick,thin-stalked,tissue,tomentu,touching,tube,unarme,unit,usually,vary,vein,warty,way,wide,ympodial,young	arrangement,branching,characteristic,colour,form,height,history,inflorescence,life,ovary,perennial,plant,pseud-terminal,seed,shape,staman,surface,texture,true,type
236	wfo-0001028525	success	257	115	102	155	13	0.397	0.5-1.5,0.5-2.5,1.1-1.7,1.2-1.6,1.5-3,1/3-3/4,10,10-13,2,2-2.5,3,3-7,4,4-5,4-7,6,7-13,7.5,acuminate,acute,anther,anthesi,apex,attenuate,base,berry,black,branch,branched,branching,brown,calyx,chartaceous,cm,conical,cordate,corolla,deltoid,dendritic,dendritic-pubescent,densely,developed,diameter,drying,elongated,entire,fine,flat,flower,form,frequently,fruit,glabrous,green-brown,grey,lateral,leaf,liana,light,like,linear,lobe,long,lumpy,margin,mature,mauve,membranous,midvein,mm,orange-brown,ovate,pair,partly,pedicel,peduncle,petiole,primary,pubescent,pyriform,rachi,red-brown,shrub,side,simple,slender,sometimes,spheroidal,stem,style,surface,terminal,tertiary,trichome,truncate,unarmed,vein,venation,weakly,whitish,x,young	.25,.4,0.2-0.3,0.2-0.6,0.5,0Â°,1-1.5,1-2,1-2.5,1-4,1.5,1mm,2-3,2.5-5,3-5,4-15,7,accrescent,age,almost,along,alternate,alyx,apar,apart,apically,apice,apparently,around,articulated,axil,bark,becoming,brachyblast,broadly,capitate,centre,clavate,clearly,clum,clustered,cup,curved,dark,deeply,delineated,density,detaching,developing,dilated,discolorous,divided,domatia-like,dorsal,dorsifixed,eaf,eed,ellipsoi,equal,erect,eye,fertilisation,fewer,filament,flattened,flexible,flexuous,formed,forming,free,frui,fruiting,glabrescent,increasing,inside,known,lamina,laterally,leave,lengthening,less,lobed,longer,longitudinally,loop,loose,lower,m.,main,minute,much,multicellular-dendritic,naked,narrowly,nflorescence,nther,obconical,oblong,obscuring,often,one,orolla,outside,overlapping,ovoid,pendulous,perfec,pericarp,plurifoliat,pore,poricidal,portion,prominent,protruding,puberulous,ray,ridged,rounded,ruit,scar,scattered,sessile,sinus,size,slightly,small,smaller,smoot,smooth,somewhat,soon,sparsely,spreading,stigma,stripe,structure,stump,tangling,tearing,terete,thick,thin,tip,toward,tube,ud,uneven,unit,vary,visible,well-developed,white,wide,wider,ympodial	abaxial,adaxial,arrangement,characteristic,colour,growth,inflorescence,length,ovary,shape,texture,true,type
237	wfo-0001028528	success	155	92	73	82	19	0.471	.5,0.9-1.2,1.1-1.2,2-4,2.5-3,4-5,4-6,8-9,abaxial,acuminate,acute,along,anther,anthesi,apex,attenuate,base,berry,bi-lobed,blackish,branch,branching,calyx,cm,corolla,decurrent,dendritic,densely,diameter,elliptic,erect,filament,flattened,fork,glabrous,globose,growth,later,leaf,lobe,long,margin,minutely,mm,mucronate,narrowly,nodding,obovate,occasionally,outline,ovary,pedicel,petiole,pitted,pubescent,reddish-brown,revolute,round,shiny,shrub,somewhat,sparsely,stem,stigma,strongly,style,surface,terminal,triangular,trichome,tube,violet,white	1-2,1.5,1.8-2,2-3,3.5-4,3.5-6,3/4,6-10,6-7,?,absent,adaxial,adaxially,age,apical,ba,bark,basal,becoming,conical,coriaceous,denser,dichasia,eaf,edicel,eed,ew,except,exserted,flower,free,fruiting,glabrat,glandular,immature,impressed,inserted,leave,like,lobed,lower,m.,midvein,minute,nflorescence,older,pair,papillo,per,pericarp,petal,planar,plurifoliate,pore,poricidal,portion,prominent,pyramidal,ruit,scar,secondary,short,sleeve,slit-like,stamen,ste,tall,tapering,thin,time,tip,tub,ud,unit,vein,way,wide,winged,woody,x,ympodial,young	.5-4,characteristic,colour,dichasial,form,fruit,glabrate,height,inflorescence,length,papillose,plant,pubescence,seed,shape,staman,texture,type,unknown
238	wfo-0001028529	success	164	103	73	91	30	0.445	0.1,0.5,0.5-2,0.8-1.3,1,1-1.2,1-1.5,1.5,2.5-3,3-40-flowered,5-6,6-9,acuminate,anther,apex,apiculate,attenuate,base,berry,bluish,brown,calyx,cast,cm,corolla,dark,decurrent,deltoid,dia,erect,filament,furcate,glabrous,globose,green,lanceolate,leaf,less,lobe,long,metallic,minutely,mm,narrowly,nearly,oblanceolate,occasionally,ovary,ovoid-reniform,pair,papillose,pedicel,petiole,pitted,shape,short,shrub,simple,slender,slightly,smooth,stem,style,subshrub,surface,tapering,tip,tube,vein,white,winged,x,yellowish	.2,0.8-3,0.8-3.2,2/3,3-5,7-8,8-14,across,acute,age,anthesi,apart,bark,becoming,beginning,beneath,bud,capitate,close,cork,course,deflexe,distal,eaf,edicel,eed,ellipsoi,elliptic,evenly,exfoliating,exserted,flower,free,fruiting,growing,heterostylous,hrub,hyaline,immature,indistinct,inflorescenc,internodal,lateral,lenticellat,linear,lobed,lon,lower,main,major,middle,minor,minute,much,nflorescence,older,one,opposite,paler,papillae,papillo,planar,pore,poricidal,portion,present,prominent,range,reflexed,river,ruit,scar,scattered,shaped,size,small,somewhat,soon,spaced,species,stigma,straight,tall,tear-drop,ud,umbonate,variable,way,widest,woody,young	abaxial,adaxial,arrangement,branching,characteristic,colour,deflexed,diameter,form,fruit,growth,height,history,inflorescence,length,life,margin,midvein,na,peduncle,plant,primary,pseudostipule,rachi,seed,staman,tertiary,texture,unarmed,venation
239	wfo-0001028532	success	186	103	74	112	29	0.398	0.2-1,1-2,1-3,1.3-8.7,17-42,2-3,2-8,2.2-4.2,3-10,3-7,4-7,5-9,acuminate,acute,anther,apex,attenuate,base,berry,brownish,cell,chartaceous,cm,condition,corolla,covering,dark,deep,diameter,drying,filament,fresh,fruit,glabrous,globose,green,green-white,greenish,hair-like,herb,lanceolate,lateral,leaf,lobe,long,make,medium,mm,mottled,mucilaginous,odd-pinnate,ovate,ovate-lanceolate,ovoid,pedicel,peduncle,petiole,petiolulate,plant,purple,ripe,rounded,seed,sometimes,spot,style,testal,thick,throughout,unwinged,wall,wet,white,whitish	0-19,1-1.6,1-1.7,1-5,1.4-1.6,15-36,2-6,3-5,3.3-4.4,3.9-5,5-merou,5.5-15,6.5-9.2,7.5-15.2,abaxiall,abaxially,acumen,adaxially,ag,along,alyx,apart,apparently,arranged,articulated,asymmetric,axe,axillary,basiscopic,bead,blade,bud,capitat,clavate,connivent,decreasing,digestion,distal,dorsally,eaf,edge,eed,enzyme,erec,exceeding,flat,flower,folded,forked,geminat,generally,glabrou,half,homostylous,honeycomb-shaped,interjected,larger,leaflet,lengthening,like,linear,living,lower,middl,moniliform,multiple,necklace,nflorescence,orbicular,orolla,pair,pentagonal,perfect,plurifoliate,pore,poricidal,removed,rotate,ruit,second,sessile,seudostipule,side,size,slightly,slit,spaced,specimen,stamen,stigma,stolon,straight,subequal,subtending,symmetric,tall,tamen,tem,terminal,tip,tissue,toward,tri-,tube,tuber,typically,unit,usually,vary,x,yellow,ympodial	2,abaxial,adaxial,arrangement,branching,calyx,characteristic,colour,form,growth,height,inflorescence,length,margin,midvein,na,ovary,primary,pseudostipule,rachi,shape,staman,stem,surface,tertiary,texture,unarmed,vein,venation
240	wfo-0001028547	success	224	120	100	124	20	0.446	.2,.5,.8,0-10,0-30,0-5,1-2,1-2.5,1.2-1.4,1.7-2,2-6,2.5-2.8,2.8-3.2,3-5,4-5,4-6,7-9,abaxial,absent,acute,adaxial,anther,apex,apically,apparently,articulated,base,berry,branched,branching,bright,calyx,cell,cm,cuneate,densely,diameter,dull,elongate,entire,erect,faint,filament,flattened-reniform,flower,fruit,glabrous,inflorescence,infructescence,lateral,leaf,length,lobe,lobed,long,long-acuminate,margin,maturity,mauve,midvein,mm,moderately,narrow-deltate,often,orange,orange-brown,outline,ovate,pair,pedicel,peduncle,per,petiole,pit,prickle,prickly,primary,purple,raised,red,shallowly,shrub,simple,small,smooth,somewhat,spherical,stellate-pubescent,stem,style,surface,terminal,tertiary,truncate,vein,venation,wide,yellow,yellow-green,young	-1/2,-13,-3,-6,.7,/2,/5,0,0-1,0-15,0-2,0.05-0.15,0.1-0.2,0.15,0.2-0.35,0.3-0.4,0.5-,0.7-1,0.8-1,1-4,1-5,1.5-2.5,1/3,1/5-1/4,10-12,2-1.5,2-2.5,2-4,3.5-4.5,5-merous,6-8,7-10,abaxially,alyx,apar,apart,ape,appearing,bark,blade,bulbous,chartaceous,conical,connivent,cream,curved,dark,deltate,discolorous,distance,drying,eaf,eed,elongating,equal,extending,flattened,free,fruiting,gently,glabrescent,glabrou,gray-brow,green,lon,long-styled,longer,lower,marking,mature,midpoint,nflorescence,oblong,occasionally,older,one,open,orolla,oung,pale,pendulous,perfect,pericarp,plurifoliat,poricidal,porrect,portion,prickl,ray,reddish,reflexed,rounded,ruit,scandent,scar,sessile,short-styled,side,slender,sometimes,spaced,spreading,stalk,stalked,staminate,stellate,straight,subsessile,tamen,tapering,terete,thin-acuminat,time,tip,trichome,tube,unit,usually,vary,villous,way,woody,yellow-orange,ympodial	arrangement,characteristic,colour,corolla,form,growth,height,history,life,na,ovary,plant,pseudostipule,rachi,seed,shape,staman,texture,thin-acuminate,unarmed
241	wfo-0001028587	success	178	90	58	120	32	0.326	0.3-1,0.8-1.8,1-1.3,1-2,1-4,2-5,2.5,6-8,8-10,abruptly,acuminate,acute,anther,apex,base,berry,brown,calyx,cm,corolla,densely,filament,fruit,glabrous,globose,green,greenish-white,keeled,leaf,length,lobe,minutely,mm,narrowing,obovate,ovary,ovate,ovoid-reniform,pair,pedicel,petiole,pitted,puberulent,pubescent,pubesent,seed,shrub,simple,slender,sparsely,stem,stiff,style,subumbellate,surface,vein,white,x	.4,.5,.75,0,0.3,0.5,0.5-1,0.7-1.2,0.8-1.6,0.8-2.9,1-1.5,1.3-5.1,1/4,2.1-6.9,3-8,6.5-17.7,8-10-flowered,accrescent,across,anthesi,bark,baseflower,becoming,ca,chartaceou,closely,coat,cracking,cup,deflexed,degree,dia,different,difoliate,distal,drying,eaf,edicel,eed,ellipsoid,erect,flower,forming,free,fruiting,geminat,geminate,impressed,lamina,lateral,layer,like,lobed,lon,long,long-styled,lower,main,major,middle,midrib,minor,minute,nearly,nflorescence,obe,obovoid,occasionally,often,older,open,opposite,outer,overlappin,paler,papillo,papillose,peeling,per,persistent,pore,poricidal,portion,pubescence,reflexed,ruit,scar,scattered,short,slightly,slit-like,spaced,stigma,straight,straw-colored,tall,terminal,thickened,thin,tip,transversel,triangular,trichome,tube,two,type,ud,umbonate,unicellular,uniseriate,unit,upon,upper,usually,variable,wide,widest,woody,ympodial,young	0.4,1,3.5,6,abaxial,adaxial,arrangement,branching,characteristic,chartaceous,colour,diameter,form,growth,height,history,inflorescence,life,margin,midvein,na,peduncle,plant,primary,pseudostipule,rachi,shape,staman,tertiary,texture,unarmed,venation
242	wfo-0001028594	success	142	77	60	82	17	0.423	.5,0-100,0.8-1.8,1-1.2,1-1.3,1-2,1-3,1.5-9,12,12-14,2,3-4,acuminate,acute,anther,apex,axil,axillary,base,berry,black,bottle-shaped,calyx,cm,corolla,densely,diameter,drying,elliptic,flattened-reniform,fruit,glabrous,globose,green,herb,inflorescence,leaf,length,lobe,maturity,minutely,mm,obtuse,orange-brown,ovary,ovate,pedicel,per,petiole,pubescent,purple,reddish,slightly,somewhat,sparsely,spreading,style,surface,violet,x	0.3-1.0,1-1.5,3-6,3-9,5-6,6-20,6-7,abaxially,adaxially,along,anthesi,bearing,becoming,capitat,cell,climbing,conical,denser,eaf,edicel,eed,ellipsoid,epidermal,especially,exserted,filament,floo,flower,forest,free,fruiting,glabrat,hair-like,immature,inflorescenc,lax,like,lon,long,lower,margin,minute,nflorescence,noddin,often,open,pair,papillate,pendent,planar,portion,primary,projection,quit,rectangular,reflexed,regular,rest,rounded,ruit,scar,scattered,side,simple,smooth,soft,stigma,strait,strongly,tem,time,tip,trailing,trichome,tub,tube,ud,unifoliat,uniseriate,unit,vein,ympodial	arrangement,characteristic,colour,form,growth,height,history,life,peduncle,perennial,plant,seed,shape,stem,texture,type,unifoliate
243	wfo-0001028660	success	204	118	95	109	23	0.466	0.5-2.8,0.5-5.5,0.8-1,0.9-2.5,1-2,1.5-2.8,1.5-4,2-11,2-9,3-30,3-7,3-9,4-6,5-8,7-10,abaxially,acute,adaxially,anther,articulated,attenuate,axillary,berry,blue,brownish,bud,cell,chartaceous,ciliate,cm,condition,corolla,covering,densely,diameter,distal,dot,drying,elliptic,entirely,filament,flower,forked,fresh,fruit,generally,glabrous,globose,green,green-white,greenish,hair,hair-like,half,herb,lateral,like,linear,lobe,long,make,margin,membranous,mm,mucilaginous,narrowly,odd-pinnate,often,ovoid,pedicel,peduncle,petiole,plant,pubescent,purple,ripe,scabrous,scattered,seed,short,sparsely,stem,style,subtending,terminal,testal,thick,throughout,tinged,unwinged,usually,wall,wet,white,whitish	0-5,0.1-0.3,0.2-1.1,0.3-1.1,0.7-4.2,1-10,1.5-7.6,2-5,2-6,20,3-5,3.8-13,5-merou,6,absent,acumen,ag,along,alyx,apart,apex,apparently,axe,base,blade,borne,broadly,capitat,clavate,connivent,decumbent,decurrent,digestion,dorsally,eaf,edge,eed,end,enzyme,erec,especially,exceeding,except,flat,folded,geminat,glabrou,greatly,homostylous,honeycomb-shaped,interjected,lanceolate,leaflet,lengthening,less,living,lower,middl,midrib,minutely,nflorescence,oblique,obtuse,orbicular,orolla,ovate,pair,pentagonal,perfect,petiolulate,petiolule,plurifoliate,pore,poricidal,proximal,puberulent,rarely,reduced,removed,rotate,ruit,sessile,seudostipule,singly,size,slit,spaced,specimen,stamen,ste,stigma,stolo,straight,subequal,substellate,sunny,tall,tamen,tem,tip,tri-,tube,tuber,typically,unit,vary,x,yellow,ympodial	2,abaxial,adaxial,arrangement,branching,calyx,characteristic,colour,form,growth,height,inflorescence,leaf,length,middle,na,ovary,pseudostipule,shape,staman,surface,texture,unarmed
244	wfo-0001028667	success	129	106	87	42	19	0.674	-2.6,0.4-0.7,0.7-4,1-1.5,1-6,1.3-2,5,5-20,acute,aid,apex,appearing,around,articulated,axillary,base,berry,branch,branched,calyx,cell,climbing,clustered,cm,completely,corolla,creamy,curling,deciduous,diameter,dry,ellipsoid,elliptic,entire,exfoliating,flattened,flower,fragrant,glabrous,growth,inflorescence,irregularly,leaf,like,lobe,margin,minutely,mm,narrowly,new,occasionally,other,outer,pale,pedicel,peduncle,per,perfect,petiole,pitted,reniform,revolute,scar,shiny,shoot,short,simple,sleeve,small,soon,spaced,stem,straw-colored,strongly,support,surface,terminal,tip,triangular,tube,twice,twining,vine,white,woody,wrinkling,yellow	.5,1-2-1.5,1-4.5,3,3-11,5-merou,8-10,alyx,anthesi,apar,ark,climbin,conical,coriaceous,discolorous,eaf,eed,exfoliatin,exserted,fide,fruiting,long,lower,mentz,midrib,nflorescence,older,orolla,papilla,papillat,pendan,plurifoliat,primary,slender,slightly,tem,ud,unit,vein,visible,x,ympodial	5-merous,apart,arrangement,bark,branching,bud,characteristic,colour,form,fragrance,fruit,length,number,papillae,papillate,seed,shape,texture,type
245	wfo-0001028688	success	137	74	49	88	25	0.358	.5,0.4-1,0.5,0.5-1,0.9-1,1-1.5,1-5,1.1-1.2,2-3,5-6,acuminate,acute,anther,anthesi,apex,base,calyx,clavate,cm,corolla,deflexed,deltoid,dia,filament,glabrous,golden,lanceolate,leaf,lobe,mm,near,opposite,ovary,overtopping,pedicel,petiole,pilose,pubescent,shoot,shrub,slender,sparsely,stem,straight,style,tapering,tip,tube,white	0.5-0.75,0.5-1.5,1-1.8,1-3,1.4-2.8,2.2-4.8,5-11,across,along,apar,area,bark,beneath,bi-cellular,branch,curl-tipped,deciduous,decreasing,densely,densest,differing,difoliate,eaf,edicel,eed,elliptic,exfoliatin,exserted,free,furcate,geminat,globose,interpetalar,irregularly,know,known,like,lobed,lon,long,lower,major,markedly,membraneous,middle,minor,minutely,nearly,nflorescence,occasionally,often,older,paler,papillose,planar,pore,poricidal,portion,proximal,reddish-brown,ruit,scar,shaped,shiny,sinus,size,slightly,soon,spaced,stigma,styl,tall,tear-drop,terminal,thickened,thin,trichome,tub,ud,uniseriate,unit,usually,vein,wide,widest,x,ympodial,young	abaxial,arrangement,branching,characteristic,colour,diameter,form,fruit,growth,hair,height,inflorescence,length,margin,na,peduncle,plant,pseudostipule,rachi,seed,shape,staman,surface,sympodial,texture
246	wfo-0001028698	success	166	111	80	86	31	0.482	0.3-0.75,1-2,1-4,1-9.8,1.9-4,13-25,2-10,3-5,5-15,5-6,5-8,6,8-10,acuminate,acute,apex,articulate,base,branched,broadly,calyx,cell,cm,conical,corolla,covering,cyme,dark,diameter,dichasial,dichasially,distal,dot,ebracteate,ellipsoid,elliptical,filament,green,green-white,hair-like,herbaceous,lateral,leaf,light,lobe,long,long-attenuate,make,medium,mm,monochasial,mucilaginous,oblique,odd-pinnate,often,ovate,ovoid,pedicel,peduncle,perennial,petiole,petiolule,plant,proximal,puberulent,pubescent,rachi,raised,seed,sessile,smooth,strigose,style,testal,thick,throughout,violet,wall,white,Â¼	0-1.,1.8-5,2-3,2-4,3-17,3-6-foliat,3.5,4-14,6-13,6-27,9-35,abaxiall,abaxially,acumen,adaxially,apical,apically,commonly,connate,cuneate,darker,decurrent,dehiscent,digestion,diminishing,dorsally,eaf,edge,eed,emoval,enzyme,equal,exceeding,first,flat,flower,folded,forked,generally,globo,gradually,half,honeycomb,interjected,introrse,leaflet,living,lon,lower,lunat,maturing,minute,nflorescence,nther,orolla,pair,pattern,pentagonal,perfect,plan,poricidally,rarely,reveal,rotate,ruit,seudostipule,short,size,slit,specimen,stamen,stigma,straight,tal,tem,terminal,toward,tuber-bearing,two,typically,unit,usually,vary,wide,yellow,ympodial	abaxial,adaxial,anther,arrangement,branching,characteristic,colour,form,fruit,growth,height,history,inflorescence,length,life,margin,midvein,na,ovary,primary,pseudostipule,shape,staman,stem,surface,tertiary,texture,unarmed,vein,venation,wet
247	wfo-0001028716	success	145	85	56	89	29	0.386	.2,.5,0.5,0.6-1.9,0.75,1-2,10-40-flowered,2.5-8,7-8,8-9,9-10,acuminate,anther,apex,base,branched,calyx,cm,corolla,cuneate,decurrent,dia,filament,filiform,fruit,glabrous,glandular,hirsute,leaf,less,lobe,long,minutely,mm,much,ovary,ovate,pair,pedicel,petiole,puberulent,pubescent,shape,shrub,simple,slightly,sparsely,stem,straight,style,triangular,truncate,vein,white,widening,x	1.9-5.5,11-16.4,2-4,2.2-7.9,3.6-8.8,5-6,across,anisophyllou,anthesi,apart,appearing,asymmetric,ba,bark,becoming,beginning,beneath,bi-cellular,brown,dark,deflexed,differing,difoliate,eaf,edicel,eed,ellipsoid,elliptic,evenly,except,fertilization,fifth,free,geminate,inflorescenc,intermediate,know,known,lateral,lengthening,lenticellat,like,lobed,lon,long-triangular,lower,main,major,markedly,middle,minor,nearly,nflorescence,node,often,older,one,opposite,orbicular,papillose,pointed,pore,poricidal,portion,prominent,proximal,raised,reflexed,remaining,rounded,ruit,scar,shaped,size,spaced,stigm,strongly,tall,tear-drop,tip,trichome,tube,two,ud,uniseriate,unit,widest,ympodial,young	abaxial,adaxial,arrangement,branching,characteristic,colour,diameter,form,growth,height,history,inflorescence,length,life,margin,midvein,na,peduncle,plant,primary,pseudostipule,rachi,seed,staman,surface,tertiary,texture,unarmed,venation
248	wfo-0001028723	success	211	124	112	99	12	0.531	-1.5,0.2,0.8-1,0.8-2,1-1.5,1-1.8,1-2.2,1-2.5,1/5-1/3,10-16,2-2.7,2-4,3.5-4,4,4-5,5,5-6,abaxially,acute,adaxially,almost,anther,anthesi,apex,apically,bark,base,brachyblast,branch,branching,broadly,brown,calyx,capitate,clustered,cm,concolorous,corolla,curved,dark,decurrent,deltoid,dendritic,diameter,drying,elliptic,entire,except,faint,fine,flat,flexuous,flower,glabrous,green,leaf,length,liana,lobe,lobed,long,long-attenuate,longitudinally,main,margin,membranous,midvein,minutely,mm,mostly,obconical,oblong,obovate,obtuse,occasional,orange-brown,overlapping,pair,pedicel,peduncle,petiole,primary,pubescent,raised,ridged,scar,short,shrub,side,simple,slender,small,smooth,sparsely,stem,stigma,stump,style,surface,terminal,tertiary,tip,trichome,unarmed,unevenly,vein,venation,white,widely,wrinkled,x,youngest	.3,.5,0-0.5,0Â°,1,1/3-1/2,10-15,2-2.5,2.5,3-4,5-7,abaxial,age,alternate,alyx,another,apar,apice,apparently,articulated,becoming,branched,clearly,common,conical,delineated,densely,density,developed,dilated,divided,domatia,dorsifixed,eaf,eed,ellipsoi,equal,ey,filament,formed,free,frequent,gradual,increasing,inner,junction,know,known,lengthening,less,like,lower,m.,middle,much,multiply,naked,narrowly,nflorescence,nther,one,orolla,outer,ovate,pale,papillo,perfec,plurifoliat,poorly,pore,poricidal,portion,prominent,protruding,rachi,ray,region,regular,ruit,separated,sinus,smaller,spreading,surrounding,tearing,tissu,toward,transition,tube,tuft,ud,uneven,unit,vary,visible,wide,yellow,ympodial,young	apart,arrangement,characteristic,colour,form,growth,inflorescence,papillose,shape,texture,width,ye
249	wfo-0001028736	success	180	140	115	65	25	0.639	0.2-0.4,0.5,0.5-1,0.5-1.5,1,1-1.5,1-2,1-3,1.5,10-15,2-5,2-7,3-5,3-6,3.5-5,4-12,4-6,40-70,5-10,5-15,abaxially,absent,acute,adaxially,anther,apex,apparently,armed,base,berry,brown,calyx,chartaceous,cm,contiguous,created,cylindrical,dark,decurrent,densely,diameter,discolorous,either,extra-axillary,filament,filiform,flattened,flower,fruit,geminate,glabrous,glandular,globose,green,hair,immature,leaf,length,light,like,lobe,long,many,mature,midvein,mm,moderately,mottled,multicellular,narrowly,nearly,netlike,obtuse,occasionally,onto,orange,pedicel,peduncle,per,perfect,petiole,pit,porrect-stellate,prickle,pubescent,rachi,raised,recurved,red,reniform,rhombic,ridge,roselike,shrub,side,slightly,small,spaced,sparsely,stalk,stellate,stem,style,surface,thin-skinned,triangular,unarmed,unbranched,uniseriate,unlobed,vein,white,x,yellow,yellow-white	0.5-1mm,0.5-2,1.5-3,1/6,2-4,3-8,4-9,5-merou,6-13x3-8,6-8,accrescent,adaxiall,alyx,apar,apical,attenuate,axe,beyond,blade,connivent,cordate,cut,difoliate,directed,eaf,eed,exserted,frui,fruiting,glabrou,gree,introsel,less,lobed,lower,m.,major,midpoint,midrib,multiseriate,nflorescence,occasional,orolla,pair,pore,purple,ray,ruit,scanden,simple,sinus,stamen,ste,stigma,tamen,tapering,tem,tube,unequa,unicellular,unit,vary,way,wide,ympodial	abaxial,adaxial,apart,arrangement,branching,characteristic,colour,corolla,form,growth,height,inflorescence,margin,na,ovary,plant,primary,pseudostipule,scandent,seed,shape,staman,tertiary,texture,venation
250	wfo-0001028737	invalid_json	151	108	69	82	39	0.457	0.2-0.5,1,1-2.5,1-4,1-6,1.5-3.5,10,12-14,16-30,2-5,2.8-3.5,6,acumen,acuminate,acute,apex,apiculate,articulate,base,branched,calyx,caudate,cell,cm,corolla,covering,cyme,diameter,dichasial,dichasially,distal,ebracteate,elliptic-lanceolate,filament,glabrescent,glandular,globose,green,green-white,hair-like,herbaceous,lanceolate,lateral,leaf,lobe,long,mm,monochasial,mucilaginous,oblique,oblong,odd-pinnate,ovoid,pedicel,peduncle,perennial,petiole,plant,proximal,rachi,seed,stigma,straight,style,testal,thick,throughout,wall,Â¼	0.7-2,2-3,3-4,3-5,3-6-foliat,4-10,4-6.5,4-9,5-6,7-15,abaxially,absen,adaxially,apical,apically,attenuate,connate,decurrent,dehiscent,digestion,diminishing,dorsally,eaf,edge,eed,emoval,enzyme,exceeding,flat,flower,folded,forked,generally,globo,gradually,half,honeycomb,interjected,introrse,larger,leaflet,living,lon,lower,make,maturing,nflorescence,nther,often,orolla,pair,pattern,perfect,pinnatifi,plan,poricidally,reveal,ruit,second,sessile,seudostipule,short,size,slit,specimen,stamen,stellate,strongly,tal,tem,terminal,throughou,toward,tuber-bearing,typically,unit,vary,whit,wide,without,yellow,ympodial	'',[,``,abaxial,adaxial,anther,arrangement,branching,characteristic,colour,form,fruit,growth,height,history,inflorescence,length,life,margin,midvein,na,ovary,pinnatifid,primary,pseudostipule,shape,staman,stem,surface,tertiary,texture,unarmed,value,vein,venation,wet,white,{,}
251	wfo-0001028777	success	205	119	101	104	18	0.493	-4,.5,.9,0-2,0-30,0.4-0.8,0.5-1.3,0.6-1,0.7-1.2,1-2,1-2.5,1.5-3,1.8-2.5,2-,2.5,2.5-5,3,4.5-8,acute,anther,apex,apically,articulated,attenuate,base,berry,branched,calyx,chartaceous,cm,concolorous,curved,dark,deltate,diameter,discolorous,drying,entire,erect,faint,filament,flattened-reniform,fruit,glabrescent,glabrous,green,green-brown,inflorescence,infructescence,leaf,length,lobe,long,margin,marking,maturity,mauve,minute,mm,moderately,obovate,orange,orange-brown,ovate,pair,pale,pedicel,peduncle,per,petiole,primary,retuse,rounded,shoot,short,shrub,simple,small,sometimes,sparsely,spherical,stellate-pubescent,stem,stout,style,surface,terete,terminal,tertiary,tree,trichome,truncate,unarmed,vein,venation,visible,white,whole,wide,yellow-green,young	-10,-12,-2.5,-3,.8,0.1-0.2,0.1-0.3,0.2,0.7-1.3,0.8-1,0.8-2.2,1,1-3,1.5,1.5-4,1/4,1/4-1/2,2.5-3,3.5-5,3/4-4/5,4-5-merous,6-10,7-11,8,8-15,abaxially,acuminat,alyx,ame,apar,ape,bark,blade,briefly,c.,connivent,deciduou,eaf,eed,elongating,equal,flower,free,fruiting,glabrescen,lengt,less,lobed,long-styled,longer,lower,mature,midpoint,multangulate,narrow-deltate,nflorescence,occasionally,older,one,open,orolla,oung,perfect,pericarp,plurifoliat,poricidal,porrect,portion,present,ray,recurved,red-brown,reflexe,reflexed,ruit,scar,sessile,short-styled,shorte,shorter,smooth,somewhat,soon,spaced,spreading,stalk,stalked,staminate,stellate,strongly,tamen,tapering,time,tip,tube,unarme,unit,usually,variously,vary,way,wider,woody,ympodial	abaxial,acuminate,adaxial,arrangement,branching,characteristic,colour,corolla,form,growth,midvein,na,ovary,seed,shape,staman,texture,ye
252	wfo-0001028791	success	257	97	77	180	20	0.3	0.05-0.2,0.3-0.4,0.3-0.6,0.4-0.65,0.45-0.55,0.8-1.3,1-1.5,1.8-3.3,10,2-7,2-locular,2.8-3.0,5-15,50-80,acuminate,acute,anther,apex,base,branched,broadly,brown,calyx,cm,conical,corolla,dark,deltate,densely,diameter,dichotomously,elliptic,entire,filament,fruit,glabrous,globose,green,hair-like,imparipinnate,interrupted,leaf,liana,lobe,long,margin,midvein,mm,oblique,obovate,occasionally,outgrowth,ovary,pale,paler,pedicel,peduncle,petiole,plant,primary,pseudostipule,pubescent,rachi,seed,slightly,somewhat,sparsely,stem,style,surface,tertiary,truncate,vein,vine,white,woody,yellow	+,-0.6,-1.5,-9,.5,0-6,0.05,0.2-0.3,0.2-0.4,0.2-0.8,0.25-0.3,0.3-0.5,0.3-0.8,0.4-0.5,0.4-0.6,0.4-1.1,0.5,0.6-0.8,0.6-0.9,0.7-1.5,0.8-1,1-2,1-2-celled,1-3,1-3-celled,1-celled,1.5-,1.5-2,1.6-4.5,1.7-2.1,100,2-3,2-3.5,2-7-celled,2.5-4.5,20-to,3-,3-4,4-11.5,4-15,4-5+,4-celled,5-,5-10,5-22,5-plurifoliate,8-10-celled,9-30,9-35,abaxially,absen,absent,abundant,adaxially,addition,ag,along,anthesi,apical,appearance,appendage,articulated,articulation,basal,basiscopically,beneath,berr,border,breaking,bullate,capitate,cell,clambering,colo.,column,consistently,darker,deciduous,densest,developed,eaf,ebracteate,edicel,eed,eglandular,elongating,enlarged,even,exserted,extended,flower,free,fruiting,give,glabrescent,glandular,gree,grow,growing,half,halfway,head,interjected,internode,lamina,large,lateral,leaflet,leaving,less,like,lon,lower,many,middle,minutely,mixture,much,multicellular,near,nflorescence,often,pair,papillate,per,petiolule,poorly,present,protuberance,pubescence,reflexed,rest,rough,round,ruit,sandpapery,scandent,secondary,sessile,short,shorter,silky,simple,single,small,smaller,sometimes,sparse,spreading,stamen,staminal,stellate,sterile,stiff,stigma,straight,tal,tem,terminal,testa,thick,thickened,time,tip,touch,transparent,trichome,tube,ud,unicellular,uniseriate,unit,upper,usually,vegetation,wall,wide,winged,ympodial,â1-2-celled	abaxial,adaxial,arrangement,branching,characteristic,colour,form,growth,height,history,inflorescence,length,life,na,perennial,shape,staman,texture,unarmed,venation
253	wfo-0001028798	success	214	120	98	116	22	0.458	0-1,0.2-0.4,0.5-2,0.9-1.2,1-4.5,1-6,1.1-2,1.5-1.8,10,15-19,2-3,2/3,3-5,3.3-5.6,5-8,7-8,8.5-13,acuminate,acute,anther,apart,apex,articulated,attenuate,base,becoming,berry,branched,chartaceous,cm,conical,continued,corolla,cylindrical,decurrent,densely,diameter,dm,due,entire,exserted,filament,fleshy,flower,fruit,granular,granular-tomentose,green,greenish,growth,hair,lanceolate,lateral,leaf,length,long,margin,midvein,mixed,mm,multangulate,nearly,oblanceolate,pale,pedicel,peduncle,petiole,plurifoliate,porrect-stellate,probably,pseudo-terminal,rachi,rather,ripe,rough,sessile,short,shrub,side,simple,spaced,sparingly,stalked,stamen,stellate-pubescent,stem,style,subcoriaceous,subglobose,time,tomentose,unarmed,vein,velutinous,way,x,yellow,yellowish	.5-5,0-60,1-3,1/2-2/3,1/20,2-3.75,2-6,2-7,2.4-4.4,2.5-3.5,2.6-4,3-4,3.8-4.2,4-5.4,5.25-7.5,6-10,6-8,8-18,abaxially,accrescent,adaxially,ag,anthesi,apical-lateral,apparently,axe,axillary,ba,blade,blunt-tipped,boat-shaped,branch,bud,calyx,capitat,curved,dehiscing,distal,downward,eaf,echinoi,echinoid,eed,extend,free,fruiting,glabrous,hal,high,included,inserted,introrse,irregularly,lacking,large,less,lined,lobe,lobed,longitudinal,lower,m.,main,many,minutely,multangulat,nflorescence,oblanceolat,oblong,obovate,obscured,obtuse,often,orbicular,orolla,oung,ovate-lanceolate,overlapping,perfect,persistent,persistently,pore,present,prominent,pubescent,quite,ray,rotate-stellate,rough-granular,ruit,semi-ovate,short-stalked,slightly,slit,small,somewhat,splitting,stigma,strongly,subcampanulate,sulcate,suture,tamen,thick,tip,tomentu,tomentum,toward,translucent,tube,unarme,unit,unknow,vary,wide,ympodial	abaxial,adaxial,arrangement,branching,characteristic,colour,form,height,history,inflorescence,life,na,ovary,plant,primary,seed,shape,staman,surface,texture,true,unknown
254	wfo-0001028815	success	196	110	80	116	30	0.408	0.4-0.8,0.5-1,1-2,1-5,10-15,2-4,2-9,22-35,3-4,3-5,4-10,6-8,7-16,abaxially,acute,adaxially,anther,apex,base,berry,broadly,brownish,cell,cm,condition,corolla,covering,cuneate,dark,diameter,distal,drying,elliptic,elliptic-lanceolate,filament,fresh,fruit,glabrous,globose,green,greenish,hair,hair-like,half,herb,lateral,like,lilac-purple,lobe,long,margin,medium,mm,obtuse,odd-pinnate,ovate,ovoid,papillose,pedicel,peduncle,petiole,plant,pubescent,purple,rachi,red-purple,ripe,rounded,rugose,seed,sparsely,splotched,stem,style,testal,thick,tinged,triangular-lanceolate,wall,whitish	1-10,1-3.5,1-4,14-28,2-4.5,2.5-6.5,3-7,5-6,5-7,5-merou,6-10,acumen,ag,along,alyx,apart,apparently,articulated,articulation,auriculate,axe,axillary,basiscopic,blade,bud,capitat,chartaceous,ciliate,connivent,decreasing,decurrent,developing,digestion,distinct,dorsally,eaf,edge,eed,enzyme,especially,exceeding,flat,flower,folded,forked,geminat,generally,glabrou,green-white,hal,high,homostylous,honeycomb-shaped,indistinct,interjected,lanceolate,leaflet,lengthening,living,lower,make,membranous,midrib,minutely,mucilaginous,narrowly,nflorescence,onto,orolla,pair,perfect,petiolulate,plurifoliate,pointed,pore,poricidal,puberulent,purpl,removed,rotate,ruit,semi-erec,semi-rosette,sessile,seudostipule,short,side,size,slightly,slit,spaced,specimen,stamen,ste,stigma,straight,subtending,tall,tamen,tem,terminal,terminated,throughout,tip,tri-,tube,unit,unwinged,usually,vary,wet,winged,x,yellow,ympodial,young	2,abaxial,adaxial,arrangement,branching,calyx,characteristic,colour,form,growth,height,history,inflorescence,leaf,length,life,midvein,na,ovary,perennial,primary,pseudostipule,shape,staman,surface,tertiary,texture,unarmed,vein,venation
255	wfo-0001028876	success	127	82	63	64	19	0.496	.5,/4,0.4-1,1-2,1.5-2,2-2.3,3-5,4-5,5-6,abaxial,anther,apex,bark,base,brown,calyx,capitate,cm,conical,corolla,dark,dendritic,densely,elliptic,filament,flower,glabrous,golden,internodal,leaf,lobe,lobed,long,long-triangular,minutely,mm,opposite,ovary,papillose,pedicel,petiole,pubescent,reddish,rounded,sagittate,shining,shrub,simple,small,sparsely,speciman,stem,stigma,style,subshrub,surface,trichome,tube,type,uniseriate,way,white,x	0.5-2,1.5-3,3-8,4-8,abaxially,acute,adaxially,along,anthesi,attenuate,branched,closely,dia,difoliate,drying,eaf,edicel,eed,ellipsoid,free,geminat,glabrat,hroughout,included,inflorescenc,know,known,lamina,lateral,leave,like,lower,main,middle,midrib,nflorescence,nodding,occasionally,older,overlappin,pair,papillae,papillo,planar,pore,poricidal,portion,rest,ruti,scar,shaped,slender,spaced,straight,tall,tear-drop,tip,tub,ud,unit,vein,widest,ympodial,young	alternate,arrangement,characteristic,colour,diameter,form,fruit,growth,height,inflorescence,length,lobing,midvein,na,plant,pubescence,seed,shape,texture
256	wfo-0001028883	success	207	129	101	106	28	0.488	2,4,5,50,6,abaxially,absent,acute,adaxially,anther,apex,arched,articulated,ascending,attenuate,base,becoming,berry,blade,brochidodromous,calyx,capitate,chartaceous,ciliate,cm,concolorous,coriaceous,cylindrical,cyme,dark,decurrent,deltate,densely,diameter,drying,dull,elliptic,entire,erect,filament,flattened,flower,fruit,glabrescent,glabrous,glandular,globose,green,growth,herb,hilum,hollow,impressed,lateral,leaf,length,lobe,long,margin,mm,moderately,narrowly,normally,onto,pedicel,peduncle,per,petiole,primarily,prominent,pubescence,pubescent,rachi,rarely,region,reniform,ripe,seed,sessile,shrub,similar,simple,slightly,small,spaced,sparsely,stem,straight,style,subopposite,subsessile,surface,swollen,trichome,unbranched,undulate,vein,venation,white,woody,Ã	0.3â0.6,0.4â1.2,0.5â2,0.6,1,1.5â7,1â2,1â6,2â3,2â5,3â5,4â6,5-merou,6â10,6â12,accrescent,acuminate,adaxiall,almost,along,alyx,antrorse,antrorsely,apar,ark,axi,branch,brow,capitat,cell,circular,common,completely,connivent,curved,differing,directed,eaf,eed,elliptic-ovate,emarginate,equal,exfoliating,eye,frui,geminate,geniculat,glabrou,greenish,head,introrsely,less,light,like,longitudinal,lower,lying,membranaceous,midrib,minor,multicellular,naked,new,nflorescence,notably,oblong,obtuse,often,older,opening,orolla,ovate-lanceolate,parallel,pendan,perfect,plurifoliate,pore,poricidal,present,rounded,ruit,secondary,shap,shiny,single,single-celled,size,slit,sometimes,sparse,spreading,stalk,stellate,stigma,subapical,tall,tamen,tem,uniseriate,unit,vary,visible,whitish,wide,yellow,ympodial	1-2,1-6,2-3,2-5,3-5,4-6,6-10,6-12,abaxial,adaxial,apart,arrangement,branching,characteristic,colour,corolla,form,height,inflorescence,mentioned,midvein,ovary,pendant,plant,primary,shape,staman,texture
257	wfo-0001028885	success	214	100	81	133	19	0.379	.5,0.7-2,1-1.2,1-2,1.5-3.5,2,2-2.5,2.3-2.5,2.5-3.5,3-5,3.5-4.5,7-8,7-9,9-11,?,abaxial,acute,adaxial,adaxially,anther,apex,apiculate,attenuate,base,berry,black,branched,broadly,calyx,cm,corolla,deltate,densely,diameter,distal,elliptic,entire,erect,filament,glabrous,globose,growth,height,immature,inflorescence,lanceolate,lateral,leaf,lobe,long,margin,midvein,mm,narrowly,nodding,pair,part,pedicel,peduncle,petiole,plant,primary,pubescent,purple,revolute,ripe,scandent,shrub,simple,slender,sometimes,sparsely,stem,style,surface,terminal,time,tip,vein,vine,woody	-1,0.3-0.5,0.5-1,0.5-5,1-1.5,1-3,1.5-1.7,10-20,2-,2/3,3.5-8.5,4-5,5-merou,9-12,ag,along,alyx,anthesi,apart,apparently,archin,ark,articulated,basal,blackish,branch,brown,capitate,cell,collapsing,connivent,cup-shaped,dark,dark-pigmented,decurrent,dendriti,dried,drying,eaf,eed,ellipsoid,exserted,extending,fleshy,flower,free,fruiting,furcate,glabrescent,glabrou,glandular,golden,gradually,groove,groupe,ilament,inserted,irregularly,known,lamina,leaving,lengthening,less,like,live,lobed,loosely,lower,material,minute,minutely,mostly,multicellular,narrowing,new,nflorescence,noddin,occasionally,often,older,orolla,papillo,peg,perfect,pericarp,pigmentation,plurifoliat,pore,poricidal,portion,quarter,recorded,reddish,retaining,rhachi,ruit,scar,scattered,shin,shiny,short,sleeve,slightly,slit,small,smaller,spaced,spheroidal,spreading,stellate,stigma,strongly,tangled,tem,thin,third,trichome,tube,twinin,ud,uniseriate,unit,upper,usually,vary,wall,way,weak,weak-walled,wide,winged,ympodial,Â¾	arching,arrangement,branching,characteristic,colour,form,fruit,length,na,ovary,pseudostipule,rachi,seed,shape,staman,tertiary,texture,unarmed,venation
258	wfo-0001028888	invalid_json	207	123	87	120	36	0.42	0-3.5,0.15-0.5,1-2,10-25,2-6,2.3-7,2.5-3.3,3-4,4-7,5-7,6-11,8-11,abaxially,acuminate,acute,adaxially,anther,apex,apiculate,base,berry,broadly,brownish,cell,center,chartaceous,cm,condition,corolla,covered,covering,diameter,dot,drying,elliptic,filament,fresh,fruit,glabrous,globose,green,green-white,greenish,hair,hair-like,herb,lateral,like,lobe,long,make,margin,membranous,mm,mottled,mucilaginous,oblique,odd-pinnate,often,ovate,ovoid,pedicel,peduncle,petiole,plant,pubescent,purple,ripe,rounded,scattered,seed,short,slightly,sparsely,stem,streak,style,subglabrous,testal,thick,throughout,typically,violet,wall,wet,white,whitish	0-5,0-7,1,1-1.5,1-10,1-3,1.5-4,12.5-25,2-5,2.3-5,3-5,3.6-12.5,3.8-8.3,4-25,5-10,5-merou,8-13.5,acumen,ag,along,alyx,apart,apparently,articulated,axe,axillary,blade,bud,capitat,central,ciliate,clavate,connivent,cuneate,digestion,distal,dorsally,eaf,edge,eed,end,enzyme,erec,especially,exceeding,except,flat,flower,folded,forked,geminat,generally,glabrou,glaucous,greatly,hal,half,homostylous,honeycomb-shaped,interjected,lanceolate,leaflet,lengthening,less,living,low,lower,middle,midrib,minutely,nflorescence,one,orbicular,orolla,pair,pentagonal,perfect,petiolulate,petiolule,placed,plurifoliate,pore,poricidal,proximal,puberulent,reduced,removed,ruit,sessile,seudostipule,size,slit,sometimes,spaced,specimen,stamen,ste,stigma,stolo,straight,subequal,substellate,subtending,tall,tamen,tem,terminal,tip,tri-,truncate,tube,tuber,unit,unwinged,usually,vary,wing,x,yellow,ympodial	'',2,[,``,abaxial,adaxial,arrangement,branching,calyx,characteristic,colour,form,growth,height,history,inflorescence,leaf,length,life,midvein,na,ovary,primary,pseudostipule,rachi,shape,staman,surface,tertiary,texture,unarmed,value,vein,venation,{,}
259	wfo-0001028920	success	152	97	82	70	15	0.539	.25,.5,0.2-1,0.5-1,0.8-1.1,1-1.2,1-1.5,1-2.4,1-3,2-2.5,3-15-flowered,3-3.5,6-6.5,abaxially,acuminate,acute,adaxially,anther,apex,arachnoid,arachnoid-pubescent,area,attenuate,base,berry,broadly,brownish,calyx,cm,congested,conical,corolla,cucullate,deltate,dendritic,dense,densely,elliptic,filament,fruiting,glabrate,glabrous,globose,leaf,lightly,lobe,lobed,long,long-styled,minutely,mm,nearly,obovate,occasionally,ovary,ovoid-reniform,papillose,pedicel,petiole,pitted,pubescence,pubescent,shape,shaped,short-styled,shrub,simple,small,sparsely,stem,stigma,strongly,style,surface,tear-drop,tip,tree,trichome,tube,uniseriate,winged,x	1.5-2,2-7,3-4,5-9,6-15,anthesi,axil,ba,bark,brown,closely,dark,decurrent,deflexed,dia,differing,difoliate,eaf,edicel,eed,ellipsoid,erect,exserted,felty,fleshy,flower,free,geminat,gray-brow,green,later,lateral,lon,lower,main,major,middle,minor,nflorescence,obovoid,older,opposite,overlappin,pair,planar,pore,poricidal,portion,present,ruit,scar,size,somewhat,soon,spaced,styl,tall,tapering,thick,tub,tuft,ud,unifoliate,unit,vein,white,widest,woody,ympodial,young	abaxial,characteristic,colour,diameter,form,fruit,gray-brown,growth,height,inflorescence,length,plant,seed,texture,type
260	wfo-0001028929	success	210	101	82	128	19	0.39	.7,.9,0-3,0.4-0.8,0.5-2,0.7-2,0.8-1,2-3,2.7-3,4-6,5-25,5-6,abaxial,acute,adaxial,anther,apex,apically,apparently,articulated,base,berry,calyx,cell,chartaceous,cm,cuneate,densely,diameter,dull,elliptic,erect,filament,fruit,glabrescent,glabrous,hair,inflorescence,lateral,leaf,length,lobe,lobed,margin,maturity,midvein,minutely,mm,oblong,obovate,obtuse,orange-brown,outline,pair,pale,pedicel,peduncle,per,petiole,pit,prickly,primary,raised,red,red-green,reticulate,shrub,simple,small,smooth,spherical,stellate-pubescent,stem,style,surface,tertiary,unarmed,vein,venation,visible,white,yellow	-2,-2/3,.5,/5,0,0-1,0-10,0-20,0.1,0.15-0.3,0.2-0.3,0.2-0.4,0.2-0.8,0.3-0.6,0.5-1.5,0.7-1,1,1-1.1,1-3,1.5-2.4,1/2,1/4-1/3,2-4,2-6,2-9,2.2-2.3,2.5-4,2/3-3/4,3-20,3-4,5-7.5,5-merous,6-8,7-9,8-10,abaxially,acicular,alyx,apar,apart,ape,bark,blade,branched,concolorous,connivent,curved,difoliate,discolorous,distance,drying,eaf,eed,elongating,equal,extending,flattened-reniform,flower,foliaceous,free,fruiting,geminat,gently,glabrou,gra,infructescence,lon,long,long-styled,longer,lower,mature,midpoint,minute,narrow-deltate,narrow-ovate,nflorescence,obtu,occasionally,older,one,open,orolla,oung,patch,pendulous,perfect,pericarp,perpendicular,poricidal,porrect,portion,prickl,prickle,ray,red-brown,rounded,ruit,scar,sessile,short-styled,side,slender,sometimes,spaced,spreading,stalk,stalked,staminate,stellate,straight,subsessile,tamen,tapering,terete,time,tip,trichome,tube,unit,usually,variously,vary,way,wide,woody,yellow-green,ympodial	arrangement,branching,characteristic,colour,corolla,form,growth,height,history,life,na,ovary,plant,pseudostipule,rachi,seed,shape,staman,texture
261	wfo-0001028963	success	197	103	83	114	20	0.421	.5,0-0.4,0-2,0.3-0.6,0.3-1,0.45-0.6,0.6-1,0.9-1.5,1.5-2,1/5,2-2.3,2-4,2.4-2.8,3.5-4.2,acute,anther,apex,apically,apparently,articulated,attenuate,base,berry,bright,broad-deltate,calyx,cell,chartaceous,cm,concolorous,densely,diameter,discolorous,drying,entire,erect,evenly,filament,green,herb,inflorescence,lanceolate,lateral,leaf,length,lobe,long,lower,margin,maturity,mauve,mm,moderately,narrow-cuneate,narrow-elliptic,narrowly,obtuse,orange,outline,pale,pedicel,peduncle,petiole,pit,purple,raised,red,shrub,simple,small,smooth,spherical,stellate-pubescent,stem,style,surface,terete,terminal,unarmed,unbranched,upper,winged,young	/2,0.1,0.1-0.2,0.1-0.25,0.15-0.3,0.3-0.7,0.3-1.5,0.6-0.9,0.8-1.8,1-4,1/,1/4-1/3,1/6,2-3,2-5,2-9,3-4.5,4-10,4-8,5-25,5-merous,6-10,7-8,abaxially,alyx,apar,ape,bark,becoming,blade,brown,connivent,curved,cuspidat,deltate,difoliate,dull,eaf,eed,elongating,equal,eye,flattened-reniform,flower,free,frui,fruiting,geminat,glabrescent,glabrous,gra,gray-green,herbaceous,infructescence,less,light,lobed,long-styled,longer,mature,midpoint,naked,nflorescence,occasionally,older,one,open,orolla,oung,pair,pendulous,per,perfect,pericarp,poricidal,porrect,portion,primary,ray,ruit,scar,sessile,short-styled,shorter,slender,slightly,spaced,spreading,stalk,stalked,staminate,stellate,straight,subsessile,tamen,tapering,tertiary,time,tip,trichome,tube,unarme,unit,usually,variously,vary,vein,venation,visible,way,wide,woody,yellow-orange,ympodial	1/2,arrangement,characteristic,colour,corolla,cuspidate,form,fruit,growth,height,na,ovary,plant,seed,shape,staman,texture,true,type,width
262	wfo-0001028971	success	225	137	112	113	25	0.498	0.1-0.4,0.25-0.6,0.3-0.6,0.4-0.9,1-2,1-5,1.5-2.2,1.75-2.5,10-15,2.2-3.5,2.5-3.5,2.5-5,3-14,3-5,3-6,4-5,4-9,5-10,6-16,6-8.5,6-9,7-16,abaxially,acute,acute-,adaxially,anther,apex,appearance,articulated,base,branched,broadly,calyx,close,cm,coarsely,deltoid,densely,dentate,diameter,erect,essentially,extra-axillary,farinaceous,felty,felty-pubescent,filament,flower,form,frequently,fruit,glabrous,globose,hair,inflorescence,invested,leaf,length,lenticular,like,lobe,margin,minutely,mixture,mm,narrowly,numerous,obtuse,occasionally,often,orange,outline,ovate,ovate-apiculate,pair,pedicel,peduncle,per,perennial,petiole,pitted,prickly,pubescent,rachi,reniform-ovate,ripe,round-tipped,sericeous,sessile,short,short-stalked,side,simple,spreading-hirsute,spreadingly,stellae,stellate,stellate-pubescent,stem,stipitate,style,surface,tan,thin-textured,trichome,truncate,unbranched,usually,vein,white,x	-0.8,-1.4,.1-0.2,0.1-0.5,0.2-0.5,0.25-1.25,0.4-1.5,0.8-2.5,05-2.5,1.5-4,1/5-1/2,15-30,2-5,2-foliate,2.5-4.5,20-35,5-15,5-8,adaxiall,along,also,apart,appearing,armed,ascending,attenuate,axe,ba,bearing,becoming,blade,broad-based,campanulate,capitat,cauline,compressed,connivent,cylindrical,delicate,directed,distal,distall,eaf,eed,elongate,elongate-deltoid,entire,female-sterile,geminat,grading,growt,inserted,interlobal,lanceolate,largest,later,lateral,laterally,least,lignescent,linear-lanceolate,lon,long,longer,longest,lower,major,manifestly,maturit,midpoint,midrib,minute,much,multiseriate,nflorescence,one,orolla,other,ovate-lanceolate,persistent,pore,prickle,principal,ray,reduced,ruit,scattered,shorter,similar,sinus,smaller,sometimes,spaced,sparse,stalk,ste,stigma,tal,tamen,tem,termination,time,tooth-like,tube,underdeveloped,unit,variable,variously,vary,well-developed,wide,yellow,ympodial	0.1-0.2,abaxial,adaxial,arrangement,branching,characteristic,colour,corolla,false,growth,height,history,life,midvein,na,ovary,plant,primary,pseudostipule,seed,shape,staman,texture,unarmed,ye
263	wfo-0001028975	success	163	90	73	90	17	0.448	.5,0.1-1,1,1-3,1-5,1.2-1.5,1.5-1.8,1.5-2,2.2-6,3-10-flowered,3-3.5,5.5-10,6-6.5,8-9,?,acuminate,acute,anther,apex,bark,base,beneath,berry,brown,calyx,cm,conical,conically,corolla,cup-shaped,dark,densely,dia,elliptic,fruit,fruiting,glabrous,globose,golden,immature,leaf,length,long,minor,minutely,mm,once-furcate,ovary,ovoid-reniform,pedicel,petiole,pitted,pubescent,shiny,shrub,simple,size,slender,small,sparsely,stem,straight,style,surface,tapering,tree,trichome,tube,uniseriate,varying,white,wide,x	.2,0.5-1,3-6.5,5-ribbed,7.5-15,along,anthesi,apart,appearing,area,broad,closely,corky,decurrent,deflexed,denser,differing,difoliate,eaf,edicel,eed,entire,epidermi,equal,erect,exserted,extension,filament,free,geminat,green,hyaline,large-celled,late,lateral,like,lobe,lobed,lon,lower,main,mainly,major,margin,member,mere,middle,narrowly,nearly,nflorescence,obscured,occasionally,older,one,opposite,pair,papillo,pore,poricidal,portion,prominent,pubescenc,raised,reddi,reflexed,remaining,rib,ruit,scar,shaped,short,sinus,slightly,somewhat,spaced,stigma,strongly,tall,tear-drop,tip,triangular,tub,ud,unit,upper,vein,widest,woody,ympodial,young	abaxial,bud,characteristic,colour,diameter,form,growth,height,inflorescence,plant,pubescence,reddish,seed,shape,texture,type,width
264	wfo-0001028980	invalid_json	168	139	116	52	23	0.69	.1,.5,/3,0.5-1.5,1-1.2,1.2-1.8,1.2-3,1.5-1.8,1.5-2,1.5-6,2.5,2.5-5,20-25-flowered,3-4,4-5,5-6,6,6-8,7-12,along,anther,anthesi,apart,axil,bark,base,beginning,black,calyx,capitate,clearly,cm,coarsely,corky,corolla,densely,dia,differentiated,dry,drying,elliptic,expanded,exserted,filament,flattened-reniform,fleshy,fruiting,furcate,glabrate,glabrous,glandular,globose,incrassate,lateral,leaf,like,lobe,long,main,major,margin,material,member,middle,minor,minutely,mm,occasionally,opposite,ovary,ovate,ovoid,pair,paler,pedicel,peduncle,petiole,pit,pitted,planar,pore,poricidal,pubescent,reddish,reflexed,scar,seed,shaped,shining,shrub,simple,size,slightly,small,soon,speciman,stem,stigma,style,surface,tall,tear-drop,thick,tip,tree,trichome,tube,type,uniseriate,usually,vein,way,white,widest,woody,x	.75,3/4,5-8,acuminate,acute,apex,basal,beneath,berry,broadly,conical,cucullate,deflexed,deltoid,differing,difoliate,eaf,edicel,eed,extending,f,free,frui,geminat,green,impressed,inflorescenc,lamina,lenticellat,lobed,lon,lower,m.,nflorescence,older,one,pale,papillose,portion,prominent,ruit,scarious,sharply,sparsely,strongly,tapering,ti,ud,unit,yellowish,ympodial,young	'',[,``,bud,characteristic,colour,diameter,exsertion,form,fruit,growth,height,inflorescence,length,lenticellate,plant,pubescence,shape,texture,value,width,{,}
265	wfo-0001028984	success	180	120	89	91	31	0.494	-14,-3,-6,-65,0.5-,1,1-,1-1.7,1-6,1-9,1.2-4,1.5,10-20,12-20,15-35,2,2-,2-2.5,2-3,2-4,20-40,3-10,3-26,3-6,4-30,4-5,4-6,4-6.3,5-10,7-14,acuminate,acute,age,also,apart,apex,articulated,basal,base,broadly,calyx,chartaceous,cm,cordate,densely,diameter,ellipsoid-fusiform,entire,flower,forked,fruit,glabrous,greenish,leaving,lobe,long,margin,mm,moderately,often,ovate,pale,pedicel,pedicellar,peduncle,petiole,pilose,puberulent,puberulent-pubescent,pubescent-pilose,purple,rachi,rarely,remnant,shrub,simple,small,spaced,sparsely,style,subcoriaceous,tip,tree,truncate,turning,unbranched,unknown,x,yellow	-2,-2.5,-9,1-2,1-2.5,2-16,3-28,4-7,4-foliat,5,8-15,abaxially,abruptly,absen,adaxially,adpressed,aggregate,almost,ape,apical,axe,blade,broad,campanulate,cell,color,concave,connective,dilated,directed,distally,eaf,eed,eglandular,equalling,especially,exceeding,fleshy,gland,glandular-puberulent,globose,hair,lanceolate,laterally,lon,longer,lower,minutely,narrowed,near,nflorescence,nther,obconical,obtuse,orolla,ovoid,papillose,perfect,pilo,pore,possibly,presence,present,pubescent-pilo,radiu,ripe,ruit,shorter,slightly,stamen,stigma,stone,strongly,swelling,tal,tem,thecae,time,tomento,tomentose,toward,triangular,tube,two,ud,unit,unknow,vary,violet,wide,ympodial	abaxial,adaxial,anther,arrangement,branching,characteristic,colour,corolla,filament,form,growth,height,inflorescence,leaf,length,midvein,na,ovary,plant,primary,pseudostipule,seed,shape,staman,stem,surface,tertiary,texture,unarmed,vein,venation
266	wfo-0001028997	success	136	106	76	60	30	0.559	.5,0.5-0.7,0.5-1,0.8-1.1,1-1.2,1-1.5,20-50-flowered,3-4,3.3.5,4-10,4-4.5,5-6,6-7,abaxially,acute,adaxially,anther,apex,appearing,attenuate,base,berry,branched,calyx,cm,corolla,deflexed,dia,difoliate,dry,drying,elliptic-obovate,erect,filament,filiform,flattened-reniform,glabrous,globose,golden,green,height,incrassate,leaf,lobe,long,many,margin,matte,minutely,mm,mustard,opposite,ovary,pair,pale,pedicel,pericarp,petiole,pitted,quadrate,revolute,shiny,shrub,stem,style,surface,tan,terminal,thick,time,trifoliate,unknown,vein,white,x,yellow	0.5-1.5,2-2.5,2-3.5,4-angled,6-10,anthesi,apar,area,ba,bark,broadened,conical,coriaceous,cucullate,eaf,edicel,eed,elliptic,exserted,fragrant,free,fruiting,geminat,glabrou,greenish-brow,later,lateral,lobed,lon,lower,main,merely,middle,nearly,nflorescence,older,papillose,partially,pore,poricidal,portion,ruit,scar,shaped,spaced,specimen,stigma,strongly,styl,tear-drop,thickened,tip,tub,tube,ud,unevenly,widest,woody,ympodia,young	abaxial,adaxial,arrangement,branching,characteristic,colour,diameter,form,fruit,greenish-brown,growth,history,inflorescence,length,life,midvein,na,peduncle,plant,primary,pseudostipule,rachi,seed,shape,staman,sympodia,tertiary,texture,unarmed,venation
267	wfo-0001029003	invalid_json	207	117	84	123	33	0.406	0.5,1-2,1.2-1.9,1.2-2.5,1.5-2.3,11-32,2.5-10,3,3-20,4-8,5,5-12.5,7-9,9-14,abaxially,acuminate,adaxially,anther,apex,articulated,attenuate,base,berry,blue-violet,brownish,cell,chartaceous,cm,condition,conical,corolla,covering,diameter,drying,filament,fourth,fresh,fruit,glabrous,green,greenish,hair,hair-like,herb,highly,lateral,leaf,light,like,lobe,long,margin,medium,membranous,middle,minute,mm,mottled,obtuse,odd-pinnate,ovoid,pale,pedicel,peduncle,petiole,pigmentation,plant,proximal,pubescent,purple,ripe,rounded,seed,sometimes,sparsely,stem,style,subglabrous,testal,thick,usually,violet,wall,whitish	0-6,0.3-0.5,0.4-3,1,1-10,1-2.5,1-3,1-5,12.2-30,13-36,2-6,2.5-7.5,3-5,3.5-7.5,5-10.5,5-merou,7-15.5,absent,acumen,ag,alyx,apart,apparently,axe,axillary,blade,bud,capitat,ciliate,connivent,decreasing,digestion,distal,dorsally,eaf,edge,eed,elliptic,elongated,end,enzyme,equal,erec,especially,exceeding,flat,flower,folded,forked,geminat,generally,glabrou,gradually,green-white,hal,half,homostylous,honeycomb-shaped,interjected,lanceolate,larger,leaflet,lengthening,living,lower,make,mucilaginous,nflorescence,one,orbicular,orolla,ovate,pair,pentagonal,perfect,petiolule,placed,plurifoliate,pore,poricidal,prostrate,rarely,ray,removed,rotate,ruit,secondary,sessile,seudostipule,size,slightly,slit,spaced,specimen,stamen,ste,stigma,stolo,straight,subcapitate,subequal,subtending,symmetrical,tall,tamen,tem,terminal,throughout,tip,toward,tri-,tube,tuber,typically,unit,vary,wet,white,wide,wing,x,yellow,ympodial	'',[,``,abaxial,adaxial,arrangement,branching,calyx,characteristic,colour,form,growth,height,inflorescence,length,midvein,na,ovary,primary,pseudostipule,rachi,shape,staman,surface,tertiary,texture,unarmed,value,vein,venation,width,{,}
268	wfo-0001029006	success	217	146	128	89	18	0.59	-+,0.2,0.4-2.5,0.5-4,1,1-1.5,1.8-2.2,10,10-20,2-3,2.5,3.5-4,4-6,5,7-8,<,>,acuminate,acute,adaxial,age,along,anther,anthesi,apex,articulated,asymmetrical,axi,axil,base,berry,beyond,blackish,branched,c.,calyx,cell,chartaceous,cm,corolla,deltate,dense,depending,diameter,elliptic,elongate,entire,exserted,extending,filament,filiform,flattened,glabrous,globose,groove,growth,inflorescence,keeled,lamina,later,lateral,leaving,lobe,lobed,long,many,margin,membranous,midrib,minute,minutely,mm,narrowly,nearly,nodding,oblique,occasionally,often,pair,pale,pedicel,peduncle,peg,pentagonal,per,petiole,pitted,primary,puberulent,pubescent,purple,reaching,reniform,ripe,rotate-stellate,simple,size,sleeve,small,sometimes,sparsely,spreading,stem,style,surface,tan,terminal,testal,time,tip,trichome,truncate,tube,tuft,twining,uniseriate,usually,variable,variously,vein,vine,violet,way,white,within,woody,x,young	.5,0.5,0.5-2,1-4,1-5,1.2-1.5,1/3,2-6,5-6,5-merou,50,7-9,abaxially,adaxiall,ag,alyx,apar,area,ark,basal,bilobed,black,bright,broadest,clavat,conical,connivent,deeply,drying,eaf,eed,ellipsoid,flower,free,fruiting,green,growing,ilament,inflated,intramarginal,irregular,irregularly,lengthening,loosely,lower,markedly,new,nflorescence,obvious,older,one,orolla,papillate,part,pendan,perfect,pericarp,pinnatifid,planar,plurifoliat,pore,poricidal,portion,puberulen,purplish,reddish,ruit,sagittate,scar,shiny,slit,smaller,somewhat,spaced,stigma,strong,strongly,sunligh,tem,thin,tiny,twinin,ud,unit,upper,vary,widest,ympodial,zig-zag	abaxial,arrangement,branching,characteristic,colour,form,fruit,hair,leaf,length,midvein,na,ovary,seed,shape,staman,texture,type
269	wfo-0001029031	success	213	96	80	133	16	0.376	-11.4,-8,.5-1.2,0.1-0.5,0.5-1.5,0.5-4,0.6-1.2,0.7-1.1,1-1.5,1-5,1-9.4,1.8-2.7,13.5,2-3,2-3.3,2-5,2.5-5.5,3-10,4-7.5,5-17,acuminate,acute,angle,anther,apex,base,becoming,berry,black,bluish,brown,calyx,chartaceous,cm,corolla,cuneate,densely,diameter,elliptic,elliptic-ovate,entire,erect,filament,fleshy,flower,fruit,glabrescent,glabrous,green,held,lateral,leaf,length,light,margin,mm,occasionally,pedicel,peduncle,peltate-stellate,petiole,possibly,pseudoterminal,pubescent,rachi,ripening,rounded,rugulose,shrub,simple,small,sparsely,stellate-pubescent,stem,style,surface,tree,white,x,yellow	-12.3,-3.6,.1-0.3,0-5,0.5,1-2,1-2.5,1-2.6,1-3,1.3-3.3,1.5-2.8,1.5-3.5,1.8-4,1/3,10,2-10.7,2.5-5.6,20-150,4-5-,6-12,6-21,abaxially,absent,accrescent,adaxiall,adaxially,ag,apart,apexacute,apparently,around,articulated,axe,ba,bilobe,blade,branched,capitate,center,connivent,covering,curved,cylindrical,deltate,denser,directed,distally,eaf,edge,eed,eglandula,eglandular,equal,farinose,flattened,forked,frui,fruiting,fused,geminate,globose,hair,immature,impressed,inserted,lanceolate,large,leaf-opposed,least,like,lobe,long,longitudinal,lower,major,many-foliate,midpoint,midvein,nearly,nflorescence,oblong,obtuse,opening,orange,orolla,outline,paired,peltate,perfect,pore,porrect-stellate,prominent,pubescen,pubescence,rarely,ray,reniform,ruit,sessile,short,short-stalked,side,silvery,slightly,slit,smaller,sometimes,somewhat,spaced,ste,stellate,stigma,straight,strongly,suborbicular,subtending,tall,tamen,tem,time,tip,trichome,tube,unarme,unbranched,unit,usually,vary,vein,whitish,wide,yellowish,ympodial	abaxial,adaxial,arrangement,characteristic,colour,form,growth,height,inflorescence,ovary,plant,seed,shape,staman,texture,unarmed
270	wfo-0001029048	success	162	100	75	87	25	0.463	.5,0.5,0.5-1,0.5-1.7,0.8-1,1,1-2,1-8,1.5-2,11,2,3-4,5-8,8-10,acuminate,angle,another,anther,apex,arching,attenuate,base,berry,calyx,cm,corolla,decurrent,elliptic,filament,filiform,glabrous,globose,greenish-white,greenish-yellow,hanging,hispidulous,leaf,less,lobe,long,margin,matte,midrib,minutely,mm,obtuse,one,ovary,ovoid-reniform,pair,pale,papillose,parallel,pedicel,petiole,pitted,planar,puberulent,right,rounded,sharply,shrub,slender,slightly,stem,straight,style,surface,tan,thread-like,tip,unifoliate,vein,winged,x	.01,.2,/3,14,25,26,3-7,3.5-4,4-6,9-15,anthesi,apar,apparent,basal,bearing,becoming,beneath,bicellular,blade,branch,bright,broadly,conical,dia,eaf,edicel,eed,elongated,except,expanded,f,flower,free,fruiting,geminate,glabrate,golden,greatly,green,greenish-yello,incrassate,lateral,like,live,lobed,lower,main,middle,minute,much,nflorescence,node,non-reproductive,obovoid,older,opposite,papillo,pore,poricidal,portion,reflexed,ripe,ruit,scar,shaped,small-capitate,somewhat,spaced,specimen,stigma,tall,tapering,tear-drop,time,translucent,trichome,tube,ud,unevenly,uni-,unit,way,widely,widest,ympodial,young,zig-zag	abaxial,adaxial,arrangement,branching,characteristic,colour,diameter,form,fruit,growth,height,inflorescence,length,midvein,na,peduncle,plant,primary,pseudostipule,rachi,seed,shape,staman,texture,unarmed
271	wfo-0001029055	invalid_json	169	107	77	92	30	0.456	0.4-1.5,1-5,1.6-3.5,1.8-3.5,14-50,2-4,2.2-3,4-10,4-6,4-7,5.5-9,8-9,apical,apically,base,branched,calyx,cell,cm,corolla,covering,cyme,dark,dehiscent,diameter,dichasial,dichasially,diminishing,ebracteate,elliptical,exceeding,gland,green,herbaceous,introrse,lateral,leaf,leaflet,long,longitudional,maturing,mm,monochasial,odd-pinnate,often,outline,ovate,ovoid,pedicel,peduncle,pentagonal,perennial,petiole,pilose,plant,poricidally,pubescent,purple,rotate,seed,short,short-stalked,size,slit,sometimes,stamen,stigma,straight,stripe,style,terminal,testal,thick,toward,triangular,wall,wide	1-2.6,1-4,1.7-2.2,2-1.,2-3,2.5-8,3,3-10,3-6,3-6-foliat,5-24,6-14,9-22,abaxially,acumen,acuminate,acute,adaxially,apex,articulate,attenuate,connate,cordate,covered,cuneate,decurrent,densely,digestion,distal,dorsally,eaf,edge,eed,elliptcal,emoval,enzyme,filament,first,flat,flower,folded,forked,generally,globo,green-white,hair,hair-like,half,honeycomb,interjected,living,lobe,lon,long-attenuate,longer,lower,lunat,make,mucilaginous,near,nflorescence,nther,oblique,orolla,pair,pattern,perfect,plan,proximal,rarely,reveal,ruit,second,sessile,seudostipule,short-petiolate,specimen,spreading,tal,tem,throughout,time,tuber-bearing,type,typically,unit,vary,whit,widest,yellow,ympodial,Â¼	'','hair-like,'type,[,],``,abaxial,adaxial,anther,arrangement,characteristic,colour,dehiscence,form,fruit,globose,growth,height,history,inflorescence,length,life,ovary,shape,stem,surface,texture,value,{,}
272	wfo-0001029059	success	199	118	89	110	29	0.447	.5,0.1-0.5,0.1-1,0.5-1,1-1.5,1-3,1-4,1-6,1.2-3,1.3-1.7,1.5-2,1.5-2.8,3-3.5,3.5-6,5-15-flowered,6-10,7-9,acute,along,anther,apex,base,berry,branched,calyx,cm,corolla,cuneate,deltoid,dense,densely,dia,dirty,elliptic,extremely,filament,flattened-reniform,glabrate,glabrous,globose,hispidulous,incrassate,inflorescence,leaf,lobe,long,major,margin,minute,minutely,mm,oblique,occasionally,often,ovary,pair,pale,partially,pedicel,petiole,pitted,pubescence,pubescent,purplish,ripe,shallowly,shape,shrub,simple,slender,small,sparse,stem,straight,style,surface,tapering,tinge,tree,trichome,tube,uniseriate,variable,vein,waxy,white,x,yellowish-green,yellowish-tan	0.2,0.2-0.5,0.5,1-1.2,10-19,2.5,3-6.5,3.5-8,4-10.5,5,anisophyllou,anthesi,apar,ape,apiculae,apiculate,arising,bark,beneath,bout,bud,clavate,closely,coiba,connivent,cordate,covered,de,deep,deflexed,differing,difoliate,eaf,edicel,eed,ellipsoid,expanded,exserted,extending,foetid,free,fruiting,geminate,greatly,impressed,interpetalar,isla,lamina,lateral,lobed,lon,longest,lower,main,member,membranous,middle,minor,narrowly,nearly,nflorescence,older,one,opposite,orange,orangish-yellow,orbiculate,paler,panama,papillo,papillose,planar,pointed,population,pore,poricidal,portion,prominent,reddish-gre,rest,rounded,ruit,scar,shaped,sinus,size,somewhat,soon,spaced,specimen,stigma,tall,tear-drop,terminal,thickened,ti,tightly,tip,triangular,ud,underside,unicellular,unit,usually,wide,widest,woody,yellowish,ympodial,young	abaxial,adaxial,arrangement,branching,characteristic,colour,diameter,form,fruit,growth,height,history,length,life,midvein,na,peduncle,perennial,plant,primary,pseudostipule,rachi,reddish-grey,seed,staman,tertiary,texture,unarmed,venation
273	wfo-0001029072	success	235	119	102	133	17	0.434	.5,0-4,0.4-0.9,0.5-2,0.8-1.5,00-200,1-1.2,1-25,1.5-2.6,1/3,2-10,2-5,2-7,2.2-2.5,2.2-3.2,2.5-3.5,3-8,3.5-6,4.2-6.5,4.5-9,5-7,7-15,abaxial,abaxially,acute,adaxial,adaxially,anther,apex,apically,apparently,articulated,base,berry,branched,bright,calyx,clearly,cm,cordate,cuneate,deltate,densely,diameter,dirty,dull,erect,filament,flattened-reniform,fruit,glabrous,green-brown,herb,lateral,leaf,length,lobe,lobed,long,long-styled,lower,margin,maturity,mauve,midvein,mm,moderately,narrow-deltate,orange-brown,ovate,pair,pale,pedicel,peduncle,pendent,per,petiole,plant,prickle,prickly,primary,rounded,short-styled,shrub,simple,sometimes,spherical,stellate-pubescent,stem,style,surface,terminal,tertiary,unarmed,upper,vein,venation,visible,white,whitish,wide,yellow	-1/2,-15,-2.5,/6,0,0-2,0-20,0-8,0.1-0.4,0.2-0.3,0.2-0.4,0.3,0.5-3,0.7,0.8,1,1-1.5,1-3,1.5-2.5,1.5-3.2,1/4-1/2,1/4-1/3,12-19,2-8,2.5-3.8,2.5-4.5,20-50,3-10,3-20,3-5,3-50,3/,4-,4-10,5-10,5-50,5-9,5-merous,7-10,8-20,8-27,alyx,ame,andromonoecious,angled,apar,apart,bark,blade,broad-deltate,broadly,c.,chartaceous,conical,connivent,cream,curved,dark,discolorous,distal,distance,drying,eaf,eed,elongated,elongating,equal,extending,flattened,flower,free,fruiting,gently,gra,green,hermaphrodite,heterostylous,infructescence,least,longer,longitudinal,lowermost,marking,mature,midpoint,multangulate,nflorescence,obtu,older,one,open,orolla,oung,pendulous,pericarp,plurifoliat,poricidal,porrect,portion,prickl,raised,ray,reflexed,ridge,ruit,scar,sessile,side,smooth,spaced,sparsely,spreading,stalk,stalked,staminat,stellate,stout,straight,strongly,tamen,tapering,time,tip,trichome,tube,unit,variously,vary,way,weakly,woody,ympodial,young	3/4,arrangement,characteristic,colour,corolla,form,growth,height,inflorescence,na,obtuse,ovary,seed,shape,staman,texture,type
274	wfo-0001029073	success	211	126	109	102	17	0.517	.5,.7,0.3-1,0.6-2,1-1.5,1.1-1.5,1.5-2,10-16,2,2-3,2-4,4-5,4-6,5-6,5-8,6-9,7-10,8-14,acuminate,acute,anther,anthesi,apex,awn-like,base,berry,brown,calyx,cell,cm,corolla,cream,dark,dense,densely,diameter,elliptic,entire,erect,filament,flattened,flower,glabrous,globose,golden,growth,inflorescence,internodal,lamina,lanceolate,leaf,length,like,linear,lobe,lobed,long,margin,maturity,midvein,minutely,mm,narrowly,oblique,occasionally,opposite,orange,pair,pale,pedicel,peduncle,per,pericarp,petiole,porrect,prickly,primary,pubescence,pubescent,purple,rectangular,reniform,reticulate,sessile,shallowly,shiny,short-stalked,shrub,simple,sinuate,slightly,sparsely,stellate,stem,style,surface,tan,tapering,testal,thin,trichome,truncate,unarmed,vein,visible,wall,whitish,x,yellowish	0.5,0.5-1,0.6-0.7,1-1.2,1-2.5,1-3,1.2-1.6,10-15,2/3,3.5-9,5-merous,abaxially,adaxially,along,another,apart,armed,articulated,away,ba,bark,basal,beneath,broad-based,chartaceous,conical,curved,darker,difoliate,dimorphic,discolorous,drying,eaf,eed,enlarged,equal,except,exserted,four,free,frui,fruiting,geminat,gre,hooked,interpetalar,lengthening,long-styled,lower,midpoint,mixture,multangulate,new,nflorescence,nodding,older,one,paler,papillose,perfect,planar,plurifoliate,pore,poricidal,portion,prickle,ray,ruit,scar,short,shorter,slit,sometimes,somewhat,spaced,splitting,stigma,straight,strongly,styled,three,ti,tip,tissue,triangular,tube,two,ud,underside,unequal,unequally,unisexual,unit,upper,upward,way,wide,woody,yellow,ympodial,zygomorphic,Â½	abaxial,adaxial,arrangement,characteristic,colour,form,fruit,height,history,life,na,ovary,plant,seed,shape,staman,texture
275	wfo-0001029074	success	174	95	73	101	22	0.42	0,0.2-1,0.3-0.8,0.5-1,0.7-0.8,1,1-1.5,1.4-1.8,1.5-2,2-4,3.5-5,5-7,acute,anther,apex,base,berry,black,broadly,calyx,cm,conical,corolla,cuneate,densely,diameter,entire,filament,flattened,glabrous,globose,green,grey,growth,herb,immature,leaf,less,lobe,margin,midvein,minutely,mm,ovary,ovate,pair,pale,pedicel,peduncle,per,petiole,pitted,primary,pubescent,purplish,reniform,ripening,rounded,simple,sparsely,stellate,stellate-pubescent,stem,style,subshrub,surface,triangular,truncate,uniformly,vein,white,x,yellowish	.1,.5,0.3-0.4,0.5-1.2,0.7-0.95,1-,1-1.2,1-2,1.5-4,11,2-2.3,2-5,2-7,3-,3-6,5-6,abaxially,absent,adaxially,age,almost,along,anthesi,apart,apparently,appearing,articulation,bark,basa,capitate,deflexed,denser,eaf,eed,ellipsoid,exerted,expanding,flower,free,frui,fruiting,glabrescen,internodal,lacking,lengthening,lignescent,like,lobed,longest,lower,markedly,midpoint,mixture,new,nflorescence,obscuring,often,older,opposite,papillat,perfect,pericarp,petal,planar,plurifoliat,pore,poricidal,portion,prominent,pulp,ray,reflexed,ruit,sagittate,scar,scattered,sessile,slit,small,somewhat,stalk,stalked,stigma,strongly,swollen,thin,tip,trichome,tub,tube,ud,underside,uniseriate,unit,usually,watery,way,woody,yellow,ympodial,Â¾	abaxial,adaxial,arrangement,branching,characteristic,colour,form,fruit,height,history,inflorescence,length,life,na,plant,pseudostipule,rachi,seed,shape,staman,texture,unarmed
276	wfo-0001029075	success	217	100	80	137	20	0.369	.5,0.8-1.5,1-2,10-20,2-5,2.5-3,30-60,4-7,4.5-6.5,5-8,6-12,7-9,8-9,abaxially,abruptly,adaxially,anther,apex,attenuate-acuminate,base,berry,broadly,brown,brownish,canescent,cm,condition,corolla,cuneate,dark,densely,diameter,dot,drying,elliptic-lanceolate,filament,flecked,fresh,fruit,glabrescent,glabrous,glandular-pilose,glandular-puberulent,gray-green,green,greenish,hair,herb,lanceolate,leaf,like,lobe,long-spatulate,margin,mm,narrowed,narrowly,odd-pinnate,ovoid,pedicel,peduncle,petiole,plant,pointed,pubescent,rachi,rounded,seed,short,small,stem,style,subobtuse,subquadrate,white,whitish,whitish-gray,yellow,yellow-green,yellowish-white	.3,0-3,0-8,0.5-0.8,0.8-1.2,1-10,1-2.5,1-3,2-4,2.7-4.2,4-10,4-14,4-5,5-10,5-8.5,5-merou,7-17,acumen,ag,along,alyx,apart,apparently,articulated,atypically,axe,axillary,blade,bud,cell,ciliate,clavifor,connivent,covering,decreasing,decurrent,digestion,distal,dorsally,eaf,edge,eed,end,enzyme,erect,erect-ascendin,especially,etota,exceeding,flat,flower,folded,forked,geminat,generally,glabrou,gradually,greatly,green-white,hair-like,half,homostylous,honeycomb-shaped,interjected,larger,lateral,leaflet,lengthening,light,living,long,lower,make,middl,midrib,minutely,mucilaginous,nflorescence,orbicular,orne,orolla,ovate,pair,pentagonal,perfect,petal,petiolulate,petiolule,plurifoliate,pore,poricidal,puberulent,purple,removed,ruit,sec,sessile,seudostipule,singly,size,slightly,slit,sometimes,spaced,specimen,stamen,ste,stigma,stolo,straight,subequal,substellate,subtending,tall,tamen,tem,terminal,testal,thick,throughout,tip,toward,tri-,tube,tuber,typically,unit,unwinged,upper,usually,vary,wall,wet,wide,woody,x,ympodial	abaxial,adaxial,arrangement,branching,calyx,characteristic,colour,form,growth,height,inflorescence,length,na,ovary,pseudostipule,shape,staman,surface,texture,unarmed
277	wfo-0001029084	invalid_json	192	128	93	99	35	0.484	.5,1-2,1.1-2.2,10-50,2-3.5,3-6,3.5-7.5,4-17,4-7,4.5-10,5,5-7,7-9,8-23,acuminate,anther,apex,apparently,articulated,axillary,base,berry,brownish,bud,cell,chartaceous,cm,condition,conical,corolla,covering,diameter,distal,drying,filament,flower,forked,fresh,fruit,generally,glabrous,green,green-white,greenish,hair-like,half,herb,lateral,leaf,light,lilac,lobe,long,make,margin,middle,minute,mm,mottled,mucilaginous,narrow,odd-pinnate,ovate-lanceolate,ovoid,pedicel,peduncle,perfect,petiole,petiolule,pilose,plant,proximal,pubescent,purple,ripe,seed,sparsely,style,subglabrous,subsessile,subtending,symmetrical,terminal,testal,thick,throughout,unwinged,usually,wall,wet,whitish,wing,x	0.8-2,0.8-2.1,1-10,1-3,1-4,1.5-2.5,2-4,2-5,3.5-8,4.5-6.5,5-merou,6-13,abaxially,absent,acumen,adaxially,ag,along,alyx,apart,arranged,axe,bead,blade,capitat,ciliate,connivent,darker,decreasing,digestion,dorsally,eaf,edge,eed,enzyme,especially,exceeding,flat,folded,geminat,glabrou,gradually,homostylous,honeycomb-shaped,interjected,interpetalar,lanceolate,larger,leaflet,lengthening,like,living,lon,lower,midrib,minutely,moniliform,multiple,necklace,nflorescence,obtuse,orolla,pair,plurifoliate,pore,poricidal,puberulent,ray,removed,rotate,ruit,secondary,semierec,seudostipule,size,slit,spaced,specimen,stamen,stigma,stolon,subequal,subglabrou,tall,tamen,tem,thir,tip,tissue,toward,tri-,tube,tuber,typically,unit,vary,wide,yellow,ympodial	'',2,[,``,abaxial,adaxial,arrangement,branching,calyx,characteristic,colour,form,growth,height,inflorescence,length,midvein,na,ovary,primary,pseudostipule,semierect,shape,staman,stem,surface,tertiary,texture,third,unarmed,value,vein,venation,{,}
278	wfo-0001029088	success	149	97	80	69	17	0.537	.2,.3,0.1,0.9â1.5,1.3â4.5,1.5â2,15â25,1â1.6,2.5â4.2,25â30,2â2.5,2â3,3â16,5â8,<,abaxially,acuminate,adaxially,anther,apex,base,berry,bronze-brown,calyx,cm,cordate,cylindrical,densely,diameter,entire,extra-axillary,filament,flattened,flower,fruit,glabrous,greenish-brown,hair,half,herbaceous,immature,leaf,lenticular,light,lobe,lower,margin,mature,minutely,mm,moderately,near,obtuse,ovoid-rhomboid,papillose,pedicel,peduncle,petiole,pubescent,purplish,rachi,reddish-brown,revolute,rounded,rugose,sand-punctate,shortly,simple,slender,slightly,sparsely,stout,straight,style,surface,tip,unbranched,vine,white,x	0.6â3.2,1.5â3,1â1.2,1â1.5,1â3,2-lobe,2.5â20,3.5â7,3.5â8,4â8,5,5-merous,6-10,accrescent,acute,alyx,apar,apicall,axe,blade,c.,capitate,ciliate,climbing,eaf,eed,emarginate,flavor,fleshy,fragrant,fruiting,glabrou,groun,heavy,juicy,lanceolate,long,m.,membranous,narrowly,nflorescence,nternode,orolla,palmate,perfec,plurifoliat,primary,ruit,scent,somewhat,spaced,stellate,stigma,strongly,swee,sweet,tamen,tem,terrestrial,truncate,truncate-acuminat,tube,unit,vary,vein,venation,wider,ympodial,â7	arrangement,characteristic,colour,corolla,form,growth,height,inflorescence,length,ovary,plant,seed,shape,staman,stem,texture,type
279	wfo-0001029089	success	177	94	76	101	18	0.429	.75,0.8-1,1,1-1.5,1.5-2,1.5-6,4.5-5,5-20-flowered,5-9,6-7,abrupt,acute,anther,bark,base,beneath,berry,bilobed,branched,calyx,campanulate,caniculate,cm,corolla,dark,decurrent,deflexed,densely,dia,drying,elliptic,flattened-reniform,furcate,glabrous,globose,golden,green,leaf,lobe,long,margin,minutely,mm,occasionally,ovary,pedicel,petiole,pinkish,pitted,pubescent,purplish,reddish-grey,resinous,rounded,rounded-deltoid,secretion,shiny,shrub,simple,slightly,small,smooth,somewhat,stem,stigma,straight,style,surface,tan,tapering,tree,tube,uniseriate,white,widening,x	.5,/4,0.1-0.25,0.5-0.6,0.5-1,0.8-1.2,1/2,10-25,2.5-3.5,5-10,5-6,8-9,along,anthesi,apart,apex,apiculate,axil,ba,beginning,bud,closely,completely,covered,covering,cracking,differing,difoliate,eaf,edicel,eed,either,enclosed,entire,erect,expand,exserted,filament,free,fruiting,geminat,glabrou,impressed,incrassate,inflorescenc,lamina,later,lateral,like,lobed,lon,lower,main,major,material,member,middle,minor,nflorescence,obovoid,older,one,opposite,otherwise,overlapping,pair,papillo,papillose,part,peeling,persistent,planar,pore,poricidal,portion,primary,prominent,resinou,ruit,scar,shaped,size,spaced,still,tall,tear-drop,tip,trichome,tub,ud,underside,unit,usually,varnish,varnished,vein,way,widest,woody,ympodial,young	abaxial,characteristic,colour,diameter,form,fruit,growth,hair,height,inflorescence,length,peduncle,plant,seed,shape,texture,type,unknown
280	wfo-0001029091	success	212	109	77	135	32	0.363	-4,-4.5,1-2,1.5-,1.5-2,10,170-210,2-2.5,2-3,2.5-,3-4,4,7-8,acuminate,acute,anther,apex,articulation,base,berry,blunt,bluntly,broadly,buff,calyx,cm,colour,corolla,cuneate,cyme,downward,elliptic,filament,flower,flushed,grey,intense,irregular,larger,leaf,light,line,lobe,long,may,minutely,mm,ochre-yellow,ovate,overlain,pale,pattern,pedicel,peduncle,petiolate,petiole,pubescent,rachi,raised,reddish-purple,relatively,reticulate-concentric,ridge,ridged,shortly,shrub,sigmoid,slender,slightly,soft-wooded,speckled,stem,style,surface,transverse,triangular,violet-purple	-1,-15,0.3-,0.5-0.8,0.5-1,1,1-10,10-20,10-toothed,15-40,2-12,20-30,3,3-,3-11-lobed,46/1,5,5-7,635/1,age,appearing,aromatic,articulated,aspect,axil,ba,becoming,brownish,campanulate,capitate,cell,clonal,close,common,conspicuous,cut,dark,deeply,develop,developed,dia,discoidal,eed,effect,ellipsoid,emarginated,erect,exceeding,exerted,flattened,floral,fork,forked,fresh,fruiting,general,giving,glandular,globose,globular,gree,growing,hair,half,interacuminal,irregularly,juvenile,lacking,lasting,later,lateral,lavende,lavender,lengthening,linear,linear-lanceolate,long-triangular,lower,mid-vein,mineral,narrowly,nflorescence,oblong,obovate,obscure,occasionally,ovoid,ower,pedicellate,pentagonal,petiol,plurifoliat,point,pore,poricidal,readily,rh,ripe,rounded,ruit,scarcely,separate,several,shallowly,shed,simple,sinus,slit,soft,soon,sparsely,stellate-rotate,stigma,stone,straggly,subulate,succulent,swollen,tall,tip,tissue,toward,tub,ud,unit,upper,usually,violet,well,winged,without,woody,x,year,ympodial	abaxial,adaxial,arrangement,branching,characteristic,diameter,form,fruit,green,growth,height,history,inflorescence,length,life,margin,midvein,na,ovary,perennial,plant,plurifoliate,primary,pseudostipule,seed,shape,staman,tertiary,texture,unarmed,vein,venation
281	wfo-0001029101	success	233	136	119	114	17	0.511	-3,.5,/3,0-2,0-20,0-5,0-8,0.4-1.5,0.5-1,00-200,1,1-1.5,1-3,1.3-2,1.5-2.5,1.8-3,10-14,10-20,2-6,2.5-3.5,2.5-6,2.8-3.3,3-4,30-100,5-6,5-7,5.5-8,abaxial,adaxial,anther,apex,apparently,articulated,base,berry,branched,brown-green,calyx,cell,chartaceous,cm,concolorous,cream,cuneate,dark,deltate,diameter,discolorous,drying,dull,elliptic,erect,filament,flattened-reniform,fruit,glabrescent,glabrous,green,infructescence,lateral,leaf,length,lobe,lobed,long,long-styled,margin,marking,maturity,mauve,midvein,mm,moderately,multangulate,obovate,obtuse,orange-brown,outline,ovate,pair,pale,pedicel,peduncle,per,petiole,pit,plant,porrect,prickle,prickly,primary,raised,rarely,rounded,sessile,short-styled,shrub,simple,small,smooth,sometimes,sparsely,spherical,stellate,stellate-pubescent,stem,straight,style,surface,tertiary,vein,venation,visible,way,wide,yellow,yellow-green,yellow-orange,young	-15,/4,0-100,0.1,0.1-0.4,0.1-0.5,0.1-0.7,0.1-1,0.2,0.7-,0.8-3.5,1-4,1-8,1.3-2.6,1.4-2.2,1.5-2,1.7,1/5-1/4,2-,2-20,2/3-3/4,3-,3-10,3-7,4-12,4-7,5-,5-20,5-8,5-9,5-merous,6-8,7-13,8-15,abaxially,acute,almost,always,alyx,andromonoecious,apar,apart,apically,bark,blade,broad-deltate,connivent,darker,distal,distance,eaf,eed,elongating,equal,extending,flattened,flower,free,fruiting,green-brow,hermaphrodite,heterostylous,lengt,like,lon,longer,lower,lowermost,mature,midpoint,narrow-deltate,nflorescence,oblong,often,older,one,open,orolla,oung,pendulous,pericarp,plurifoliat,poricidal,portion,present,prickl,ray,reduced,reflexed,rounde,ruit,scar,secondary,side,spaced,spreading,stalk,stalked,staminat,suborbicular,tamen,tapering,terete,thick,time,tip,trichome,tube,unit,variously,vary,well-developed,woody,ympodial	arrangement,branching,characteristic,colour,corolla,form,growth,hair,height,inflorescence,ovary,plurifoliate,seed,shape,staman,texture,unarmed
282	wfo-0001029106	success	200	127	102	98	25	0.51	.5,0-10,0-2,0-20,0-5,0-6,0.2-1,0.25-0.7,0.5-0.9,0.9-1.2,1.5-2,2-4,2-8,2.2-3,3-3.5,3-4,4-6,5-14,acute,anther,apex,apically,apparently,articulated,base,berry,branched,calyx,cell,cm,concolorous,cuneate,deltate,densely,diameter,discolorous,drying,elliptic,erect,eye,filament,flattened-reniform,flower,fruit,glabrescent,glabrous,infructescence,lateral,leaf,length,lobe,lobed,long,lower,margin,maturity,mauve,membranous,midvein,mm,naked,obtuse,orange,orange-brown,orbicular,outline,ovate,pair,pale,pedicel,peduncle,per,petiole,pit,prickle,prickly,primary,raised,red,rounded,shiny,shrub,simple,small,smooth,sometimes,sparsely,spherical,stellate-pubescent,stem,style,subentire,surface,tertiary,vein,venation,visible,weakly,white,wide,yellow-orange,yellowish-green	-6,.1,/3,0,0-0.3,0.1,0.2-0.4,0.5,0.5-0.8,0.5-1,0.5-2.5,1-1.6,1-2,1-5,1.5-1.8,1.5-3.5,1/4,1/5-1/4,2-3.5,2-5.5,2-6,2/,3-25,4-8,5-8,5-merous,6-8,abaxially,acuminat,alyx,ame,apar,apart,appearing,bark,blade,c.,curved,distance,eaf,eed,elongating,equal,extending,flattened,free,fruiting,gently,light,lon,longer,mature,midpoint,nflorescence,older,one,open,orange-brow,orolla,oung,pendulous,perfec,pericarp,plurifoliat,poricidal,porrect,portion,prickl,ray,reflexed,scandent,scar,sessile,shallow,shorter,side,size,slender,spaced,spreading,stalk,stalked,stellate,straight,tamen,tapering,terete,time,tip,trichome,tube,uit,unit,variously,vary,way,woody,ympodial	2/3,abaxial,acuminate,adaxial,arrangement,branching,characteristic,colour,corolla,form,growth,height,history,inflorescence,life,na,ovary,plant,pseudostipule,rachi,seed,shape,staman,texture,unarmed
283	wfo-0001029112	success	190	88	60	130	28	0.316	0.9-1.7,1-2,1.4-2.5,10-21,2-3.5,2.6-3,2.7-5.7,20,3-7,3.5-4.5,3.5-7,5,5-8,acuminate,anther,apex,base,berry,brownish,cm,condition,conical,corolla,densely,diameter,drying,elliptic-lanceolate,filament,fresh,fruit,glabrous,green,greenish,herb,leaf,light,lobe,margin,minute,mm,mottled,mucilaginous,obtuse,odd-pinnate,ovate,ovoid,pale,pedicel,peduncle,petiole,plant,pubescent,purple,ripe,seed,slightly,style,violet,wet,whitish	0-2,0.5,1-10,1-3,1-4,1.5-1.8,1.5-2,10-17,2.5-4.5,2.7-3.5,2.7-4.2,3-4,3-5,3-6,5-merou,6.5-5.5,9.5-13,abaxially,acumen,adaxially,ag,along,alyx,apart,apparently,arranged,articulated,axe,axillary,bead,blade,bud,capitat,cell,chartaceous,ciliate,connivent,covering,decreasing,digestion,distal,dorsally,eaf,edge,eed,enzyme,equal,especially,exceeding,flat,flower,folded,forked,geminat,generally,glabrou,gradually,green-white,hair,hair-like,half,homostylous,honeycomb-shaped,interjected,lanceolate,larger,lateral,leaflet,lengthening,like,living,long,lower,make,middle,moniliform,multiple,narrow,necklace,nflorescence,orolla,pair,perfect,petiolule,plurifoliate,pore,poricidal,present,pubescen,ray,removed,rotate,ruit,secondary,semierec,seudostipule,size,slit,spaced,specimen,stamen,ste,stigma,stolon,subequal,subtending,symmetrical,tall,tamen,tem,terminal,testal,thick,thir,throughout,tip,toward,tri-,tube,tuber,typically,unit,usually,vary,wall,wide,wing,x,yellow,ympodial	abaxial,adaxial,arrangement,branching,calyx,characteristic,colour,form,growth,height,inflorescence,length,midvein,na,ovary,primary,pseudostipule,rachi,shape,staman,stem,surface,tertiary,texture,unarmed,vein,venation,width
284	wfo-0001029120	success	168	101	75	93	26	0.446	.5,0.1-0.5,0.7-1,1-1.5,1.1-1.5,1.1-2,2.5-3.5,3-3.5,5-10-flowered,5-8,6-8,abrupt,acute,anther,basal,base,beneath,bud,calyx,cm,corolla,decurrent,deflexed,densely,dia,erose,especially,f,filament,fleshy,glabrous,golden,hirsute,infloresence,larger,later,leaf,lobe,long,long-triangular,margin,mm,narrowly,ovary,ovate,pair,pale,pedicel,peduncle,petaloid,petiole,prominently,pubescent,raised,rest,shrub,simple,slightly,sparsely,stem,straight,style,surface,tapering,trichome,tube,unbranched,unifoliate,uniseriate,vein,venation,white,widening,yellow,yellow-green	.05,.75,/2,0.5-1.5,2.6-7,6.5-16.5,8511,acuminate,anthesi,apart,apex,bark,beginning,black,bullate,cell,dark,difoliate,dry,drying,eaf,edicel,eed,epidermi,evenly,fide,free,geminat,globose,greenish-brown,inflorescenc,internodal,know,known,lanceolate,large,lateral,lehmann,like,lobed,lon,lower,main,middle,midrib,minor,minutely,narrow,narrower,nearly,nflorescence,occasionally,often,older,opposite,outer,paler,papillose,peduncl,point,pore,poricidal,portion,present,proximal,reproductive,ruit,scar,scattered,shaped,slender,spaced,specimen,speckle,stigma,sympodial,tall,tear-drop,terminal,thickened,tip,tub,ud,unit,upper,urceolate,way,white-papillo,wide,widest,x,ympodial,young	abaxial,adaxial,arrangement,branching,characteristic,colour,diameter,form,fruit,growth,height,history,inflorescence,length,life,midvein,na,plant,primary,rachi,seed,shape,staman,tertiary,texture,unarmed
285	wfo-0001029121	success	161	81	63	98	18	0.391	0-2,0.2-2,1-4,1-5,1.1-3.9,15-30,2-10,2-13,2-3,2-3-celled,3.8-11,4-10,4-5.5,5-8,acute,blue,branched,calyx,cell,cm,conical,corolla,covering,cyme,deep,diameter,dichasial,dichasially,ebracteate,elliptical,glabrous,green,hair,hair-like,herbaceous,lateral,leaf,lobe,long,medium,mm,monochasial,mucilaginous,narrowly,odd-pinnate,ovate,ovoid,pedicel,peduncle,perennial,petiole,plant,purple,scattered,seed,short,short-attenuate,straight,style,testal,thick,tuber-bearing,wall	-6,0,1.2-2.5,1.2-3.3,10,2-,3-5,3-6-foliat,3.6-9,4.5-10.0,5-20,8-16,9-33,abaxiall,abaxially,acumen,acuminate,adaxially,apex,apical,apically,articulate,attenuate,base,commonly,connate,cuneate,dehiscent,digestion,diminishing,distal,dorsally,eaf,edge,eed,emoval,enzyme,exceeding,filament,flat,flower,folded,forked,generally,globo,gradually,green-white,half,honeycomb,interjected,introrse,leaflet,living,lon,lower,lunat,make,maturing,nflorescence,nther,oblique,obtuse,often,orolla,pair,pattern,perfect,petiolule,plan,poricidally,proximal,rarely,reveal,rotate,rounded,ruit,sessile,seudostipule,size,slit,specimen,stamen,stigma,subequal,tal,tem,terminal,throughou,throughout,tip,toward,typically,unit,vary,wide,yellow,ympodial,Â¼	anther,arrangement,characteristic,colour,form,fruit,growth,height,inflorescence,length,lunate,ovary,pseudostipule,shape,stem,surface,texture,wet
286	wfo-0001029125	success	197	120	86	111	34	0.437	.1,.2,6,abaxial,abaxially,acuminate,acute,adaxially,anther,anthesi,apex,appressed,articulated,attenuate,base,berry,black,branching,brownish,calyx,central,cm,concave-reniform,corolla,cuneate,deltate,densely,diameter,end,entire,filament,flower,fruit,glabrous,globose,green,herb,internodal,lateral,leaf,lobe,long,lower,margin,maturity,mm,narrower,oblique,occasionally,one,orange,ovary,ovate-lanceolate,pair,pedicel,peduncle,per,petiole,plant,primary,pubescent,purple,purple-tinged,purplish,ripe,seed,simple,slightly,small,sparsely,spreading,star,stem,straight,style,subshrub,surface,trichome,turning,unequal,uniseriate,vein,white,wide,yellow,Â¼	.0â3.5,.1â1.4,.4,.5â2.0,.6,0.5,0.5â0.6,0.5â1.0,0.8â0.9,0.9,1,1.0â1.2,1.0â1.5,1.0â4.0,1.5â2.0,1.5â3.0,1.7-,1.8â3.5,1â2-celled,2.5â12.0,2/3,20â100,2â3-celled,2â4,3.0â3.4,3.5â4,35â45,3â5,3â5-celled,4â8,5-merous,5â6,6â7,adaxial,age,along,apar,apparently,arising,ba,beyond,cell,closely,cone,conical,delicate,difoliate,eaf,eed,ellipsoid,especially,exerted,free,fruiting,geminat,growt,hilum,later,lengthening,like,live,lobed,lon,maximum,minutely,nearly,nflorescence,often,outline,pale,papillate,pentagonal,perfect,place,pore,poricidal,portion,positioned,reflexe,reflexed,ridged,ruit,scar,scattered,shiny,shorter,single,slit,spaced,stellate,stemmed,stigma,stone,strongly,sub-lateral,tall,tem,terete,testal,tinged,tip,toward,traingular,tube,ud,unit,usually,whitewith,woody,ympodial,young	0.5-0.6,0.5-1.0,1-2-celled,1.0-1.2,1.0-1.5,1.5-2.0,1.7-3.4,2-3-celled,2-4,20-100,3-5,3.5-4,35-45,4-8,5-6,arrangement,characteristic,colour,form,growth,height,history,inflorescence,length,life,midvein,na,pseudostipule,rachi,shape,staman,texture,triangular,unarmed
287	wfo-0001029150	success	177	100	79	98	21	0.446	.5,0.3,0.3â0.5,0.5â1.1,0.8-1,0.8â1,1.2â1.5,1.5,1.5â2.2,15,1â1.5,1â5,2.5â3,2.5â5,2â10,3-5,3â10,3â4,6,9â12,acute,adaxially,anther,apex,apiculate,base,branched,calyx,cm,conical,diameter,ellipsoidal,elliptical,entire,filament,flattened,flower,fruit,glabrous,larger,leaf,light,lobe,margin,midvein,minutely,mm,moderately,oblique,ovate,pair,pedicel,peduncle,petiole,pinnate,pubescent,rachi,rarely,rounded,rounded-deltoid,rugose,sand-punctate,shortly,simple,slender,sparsely,stem,style,surface,tan,teardrop-shaped,thick,tip,truncate,vein,vine,white,woody,x	0.3-0.5,0.8â1.5,0.8â3.5,1.5â2,1â11,1â2,1â6,2.5â8,2â2.5,2â3,3â50,5-merous,7â8,8-shaped,abaxially,accrescent,across,adaxiall,alyx,apar,apicall,apically,attenuate,axe,berry,blade,c.,canopy,capitat,ciliate,climbing,color,cros,cylindrical,delicate,distant,dried,eaf,eed,enlarged,except,extra-axillary,fleshy,flush,fruiting,glabrou,inconspicuous,lamina,lanceolate,living,lon,long,lower,m.,material,membranaceous,mor,nearly,nflorescence,nternode,older,opposed,orolla,pale,perfec,pinkish-white,plurifoliat,pointed,reaching,ruit,scar,secondary,section,side,slightly,small,somewhat,spaced,specimen,stellate,stigma,strong,tamen,tem,thickened,time,translucent,tree,trichome,tube,understory,unit,vary,vegetation,venation,wide,wiry,ympodial	3,abaxial,arrangement,characteristic,colour,corolla,form,growth,height,history,inflorescence,internode,length,life,ovary,plant,primary,seed,shape,staman,texture
288	wfo-0001029152	success	197	99	75	122	24	0.381	0.5-1,0.8-1,0.9-1.3,1,1-1.5,1-4,1.1-1.3,1.5-2,2-2.5,2-5,2.5-3,3-8-flowered,6-8,acuminate,acute,anther,apex,appressed,attenuate,base,berry,brown,calyx,cm,corolla,cuneate,dark,deltoid,densely,elliptic,filament,floccose,fruit,glabrous,globose,green,inflorescence,keeled,leaf,lightly,lobe,long,margin,minutely,mm,obovate,ovary,ovoid-reniform,pair,pale,pedicel,petiole,pitted,plane,plant,prominently,red,red-floccose,reddish-floccose,shape,shrub,simple,single,slender,small,stem,style,surface,tapering,tree,tube,vein,white,winged,x	.1,.5,0.25-0.5,0.75-1,1-2,1-3,1.5-1.7,2-3,2-4,3-5,4-6,61-25,8.5-16,anthesi,appearanc,appearing,area,ba,bark,beginning,beneath,blade,branch,broadened,broadly,bud,citronella,closely,completely,conical,corky,deciduous,decurrent,deep,deflexed,dia,differing,difoliate,distal,dry,eaf,edicel,eed,ellipsoi,enclosing,erect,et,exsertion,fide,flattened,flower,fragrance,free,fruiting,geminat,giving,greyish-red,held,hyaline,inflorescenc,large-lenticellate,late,lateral,live,lobed,lon,long-styled,longer,lower,main,major,material,middle,midrib,minor,nearly,nflorescence,often,older,one,opposite,overlapping,papillose,per,planar,pore,poricidal,portion,prominent,quite,reddish,reflexed,reminiscent,rounded,ruit,scar,shaped,shiny,short-styled,size,slightly,somewhat,soon,spaced,stigma,straight,styl,tall,tear-drop,terminal,third,tillett,tip,trichome,ud,unit,usually,weak,widest,woody,ympodial,young	1.5-4-6,abaxial,adaxial,arrangement,branching,characteristic,colour,diameter,form,growth,height,length,midvein,na,peduncle,primary,pseudostipule,rachi,seed,staman,tertiary,texture,unarmed,venation
289	wfo-0001029156	success	65	61	43	22	18	0.662	0.5,1.5-2,10-12,4-6,6-8,<,almost,bark,cell,center,cm,completely,deeply,diameter,exfoliating,flattened,glabrous,golden,growth,liana,margin,minutely,mm,multiseriate,new,pale,pedicel,per,pitted,rectangular,reniform,rib-like,seed,shiny,sinuate,stem,surface,tan,testal,thickening,trichome,vine,woody	-3,1,2,6,apex,apparently,berry,eed,epiphytic,fide,fruiting,lateral,long,markedly,minute,nee,noddin,occasionally,older,shreddy,wall,wide	2-3,branching,characteristic,colour,form,fruit,inflorescence,length,na,nodding,number,peduncle,rachi,shape,texture,type,unarmed,width
290	wfo-0001029156	success	65	60	45	20	15	0.692	-3,0.5,1.5-2,10-12,<,almost,berry,cell,center,cm,completely,deeply,diameter,exfoliating,flattened,fruiting,glabrous,golden,growth,lateral,liana,margin,minutely,mm,multiseriate,new,pale,pedicel,per,pitted,rectangular,reniform,rib-like,seed,shiny,sinuate,stem,surface,tan,testal,thickening,trichome,vine,wall,woody	1,2,4-6,6-8,apex,apparently,ark,eed,em,epiphytic,fide,lon,markedly,minute,nee,noddin,occasionally,older,shreddy,x	6,bark,colour,form,height,history,length,life,na,nodding,number,plant,shape,texture,type
291	wfo-0001029163	success	149	107	86	63	21	0.577	0.3-2.5,0.5-1,1,1-2,10-,13-18,2,2-18,2-6,2.5-3,20-30,3-14,3-4,4-6,5-8,7-9,abaxial,acuminate,acute,apart,apex,articulated,base,calyx,chartaceous,cm,connivent,cuneate,cylindrical,decurrent,deltate,densely,diameter,distally,eglandular,elliptic,elliptic-ovate,entire,free,fruit,glabrous,glandular,globose,hair,herb,lanceolate,leaving,lenticular,lobe,long,margin,mm,moderately,narrowed,nearly,obtuse,pedicel,pedicellar,peduncle,perennial,petiole,pseudohair,puberulent,puberulent-pubescent,purple,rachi,radiu,remnant,shrub,simple,slightly,spaced,sparsely,stalked,stem,stigma,style,surface,thickened,tip,unbranched,unknown,white,whitish,x,yellow	-25,-4,-9,1.5-2,1.5-2.5,1.5-3,2-3,2-7,3-5,4-20,4-5-foliat,4.5-23,5-12,9-15,abaxially,absen,adaxiall,adaxially,aggregate,axe,band,blade,cell,color,denser,directed,distall,eaf,eed,flower,like,lon,lower,narrowly,nflorescence,nther,orolla,papillose,pore,projection,puberulent-pubescen,pubescence,ripe,roughened,ruit,scale-like,small,sometimes,stellate,stone,subapical,subcoriaceous,tal,tem,time,triangular,truncat,tube,unit,vary,vein,wide,ympodial	adaxial,anther,arrangement,characteristic,colour,corolla,form,growth,height,history,inflorescence,leaf,length,life,ovary,plant,seed,shape,texture,truncate,type
292	wfo-0001029171	success	137	95	64	73	31	0.467	-10,0.5,1-3,1-4.5,1-5,1.5-2,10-25,11-20,2-3,3-4,3.5-6.5,4-5,5-6,5-8,7-9,acuminate,acute,angled,apex,articulated,base,branched,calyx,chartaceous,cm,cuneate,decurrent,deltate,densely,diameter,elliptic,entire,forked,fruit,glabrous,globose,hair,lobe,margin,mm,moderately,obtuse,orange,ovate-elliptic,pedicel,peduncle,petiole,puberulent,pubescent,purple,rachi,rarely,red,ripe,rugose,shrub,simple,slightly,smooth,sometimes,style,unbranched,white,x	-,-15,1.5-7.5,10-35,3.5-18,4-10,6-,8-17,abaxially,abruptly,absen,adaxially,aggregate,also,and/or,apart,axe,ba,blade,cell,connivent,cylindrical,dendritically,dense,directed,distall,eaf,eed,eglandular,except,flower,gland,glandula,glandular,lanceolate,like,long,lower,many-foliat,midrib,narrowed,narrowly,near,nearly,nflorescence,nther,often,orolla,perfect,pore,radiu,ruit,shoot,short-stalked,spaced,sparsely,ste,stellate,stigma,stone,tal,tem,time,tip,triangular,truncat,tube,unit,usually,vary,wide,yellow,ympodial	abaxial,adaxial,anther,arrangement,branching,characteristic,colour,corolla,filament,form,growth,height,inflorescence,leaf,length,midvein,na,ovary,plant,primary,pseudostipule,seed,shape,staman,stem,surface,tertiary,texture,unarmed,vein,venation
293	wfo-0001029215	success	49	43	27	22	16	0.551	0.3-0.5,0.5-0.7,0.5-2.5,1,2.3-2.9,border,brown,calyx,cm,diameter,elongating,entire,hair-like,herb,lobe,markedly,mm,narrowly,obovate,outgrowth,pubescent,round,shrub,smelling,strong,surface,winged	-1.8-2.3,.2,appearance,cell,coarse,eed,fide,fruit,give,lateral,long,silky,small,spreadin,tall,testa,thick,wall,weigend,wide,woody,xyledecor	0.2,1.8-2.3,colour,form,growth,height,length,odour,plant,seed,shape,spreading,texture,thicknes,width,wing
294	wfo-0001029216	success	243	117	96	147	21	0.395	+,0.4-0.5,0.5,0.6-1,1-1.2,1-2,1.2-6,10-14,2,2-locular,2.5-3.3,3,absent,acute,and/or,annual,anther,apex,articulated,attenuate,base,basiscopically,biennial,branch,bright,brown,calyx,cell,cm,conical,corolla,crenate,decurrent,deep,dentate,diameter,distal,elliptic,filament,fruit,glandular,globose,green,hair-like,herb,imparipinnate,inflorescence,interrupted,lateral,length,less,like,linear,lobe,long,mainly,margin,maturity,minute,minutely,mm,multilocular,near,oblique,obovate,often,orange,outgrowth,ovary,ovate,pale,pedicel,peduncle,perennial,petiole,primary,pseudostipule,pubescent,rarely,red,shape,short,simple,sparsely,stem,style,surface,tertiary,testa,trichome,uniseriate,usually,varying,villous,wall,yellow	-0.5,-10,-5,.5,.8-1,0.1-0.3,0.1-0.5,0.1-0.6,0.1-0.8,0.2-0.25,0.2-0.3,0.2-0.4,0.2-0.8,0.3-0.4,0.3-0.5,0.3-2,0.4,0.5-0.8,0.5-1.5,0.5-2,0.6-0.8,0.8-2.5,1-3,1-4,1-6,1.5-2.3,1.5-2.5,1.5-3,1/,10,10-,2-4.5,20-35,3-,3-4,3-5,3-7,3-foliate,4,5,5-15-flower,6-10,7-10,<,absen,accrescent,acroscopically,adpressed,allogamous,always,angeld,anthesi,apical,appearance,appendage,articulation,axi,basal,becoming,capitate,cente,column,composed,cone,cordate,cultivar,deeply,eaf,edicel,eed,entire,erect,exserted,extending,facultatively,fasciated,fruited,fruiting,giving,glabrescent,gland-tipped,gree,half,halfway,included,initially,interjected,internode,lanceolate,large,larger,later,leaflet,lobulate,lon,longer,lower,mixture,multicellular,narrowly,nflorescence,numerous,one,pair,particularly,pentagonal,petiolule,plant,population,present,procumbent,reflexe,ruit,scen,secondary,sessile,shaggy,shaped,silky,sometimes,somewhat,sparse,spreading,staminal,sterile,stigma,straight,strong,strongly,tangled,tem,terminal,thick,thickening,tip,total,toward,truncate,tube,ud,unicellular,unit,variety,viny,wide,winged,ympodial	1/3,abaxial,adaxial,arrangement,branching,characteristic,colour,form,growth,history,leaf,life,midvein,na,rachi,seed,staman,texture,unarmed,vein,venation
295	wfo-0001029226	success	206	91	73	133	18	0.354	.5,0-1,1-1.5,1-3,2-6,3-3.5,5-7,7-11,8-13,acuminate,acute,anther,apex,base,berry,branched,bright,calyx,cm,cordate,corolla,deltate,diameter,enation,entire,filament,flattened,glabrous,globose,growth,herbaceous,lateral,lavender,leaf,lobe,lobed,lyrate,many,margin,mere,minutely,mm,occasionally,open,pair,pale,papillate,pedicel,peduncle,petiole,pinnatifid,pitted,primary,pubescent,red,reniform,rim,seed,short-glandular,shrub,simple,stem,style,surface,tan,terminal,time,tip,truncate,vein,vine,white,yellowish	-7,-9,.75,0.5,0.5-5,1-2,1-celled,10-40+,2,2-3,2-9,2.5-10,3-6,30,4,4-6,5-merou,>,ag,alyx,anthesi,apart,apparently,ark,articulated,ba,basal,black,blue,breaking,capitate,cell,completely,congested,conical,connivent,dark,decurrent,densely,distall,divided,dry,eaf,eed,ellipsoid,elongate,exserted,flexuous,flower,free,fruiting,glabrescent,gland,glandular,green,hairy,ilament,irregularly,juice,lengthening,like,long,longer,loosely,lower,material,mature,membranous,minute,new,nflorescence,often,older,one,orolla,overtopping,papillat,papillo,per,perfect,pinnate,plurifoliat,pore,poricidal,portion,reflexed,remainin,ripe,ruit,sagittate,scar,scarlet,shiny,shorter,sleeve,slender,slit,small,sometimes,spaced,sparsely,spot,sprawling,spreadin,spreading,staining,stellate,stigma,strongly,tangled,tem,testal,thin,third,translucent,trichome,tube,twinin,ud,uniformly,uniseriate,unit,usually,vary,wall,way,weak,wide,widest,winged,woody,ympodial,Â¾	abaxial,adaxial,arrangement,branching,characteristic,colour,form,fruit,inflorescence,length,midvein,na,ovary,rachi,shape,staman,texture,unarmed
296	wfo-0001029236	success	159	89	75	84	14	0.472	.5,0.2-1,0.45-0.5,1-1.5,1-2,1.4-1.7,3,adaxial,anther,anthesi,apex,apically,appearing,berry,broadly,calyx,cm,completely,corolla,deflexed,deltate,dendritic,densely,diameter,elliptic,filament,flattened,fleshy,fruit,glabrous,globose,grey-brown,growth,lateral,leaf,lenticular,less,lobe,margin,middle,minutely,mm,narrowly,near,nodding,occasionally,ovary,overtopping,pale,pedicel,per,pericarp,petiole,pitted,pointed,pubescent,purplish-black,reddish-brown,revolute,scattered,shiny,shoot,shrub,simple,slightly,sparsely,stem,strongly,style,surface,terminal,thin,trichome,violet,x	0.2-0.7,0.5,0.5-1.5,0.9-2.3,1/2,2-4,2-5,6-9,abaxially,absent,age,apical,apparently,axi,ba,bark,basal,base,becoming,bi-lobe,branch,branching,branchlet,compact,conical,coriaceous,cupulate,decurrent,dichasial,eaf,edicel,eed,erect,ew,except,exserted,flower,free,fruiting,inserted,later,lobed,long,lower,m.,many,midvein,nflorescence,obscure,obscurely,older,packe,persistent,plurifoliate,pore,poricidal,portion,prominent,purplish,ruit,scar,secondary,short,sleeve,slit-like,stamen,stigma,tall,tapering,time,tip,trongly,tub,tube,ud,unit,usually,venation,way,wide,winged,woody,ympodial,young	abaxial,characteristic,colour,form,height,inflorescence,length,na,peduncle,plant,seed,shape,staman,texture
297	wfo-0001029246	success	209	110	89	120	21	0.426	-1,-1.5,-4,0,0-15,0-5,0.1-0.4,0.7-1.3,0.7-2,0.8-1.1,1-1.5,1.5-2.3,1/3,2,2-3,2.8-4,3.5-5,4-6,5-20,7-12,abaxial,acuminate,acute,adaxial,anther,apex,apically,apparently,base,berry,calyx,chartaceous,cm,cuneate,deltate,diameter,dull,elliptic,entire,eye,filament,fruit,glabrous,lateral,leaf,length,less,lobe,lobed,lower,margin,maturity,mauve,midvein,mm,moderately,naked,obtuse,orange-brown,orange-red,pair,pale,pedicel,peduncle,per,petiole,prickle,primary,pubescent,purple,shrub,simple,sometimes,sparsely,stellate-pubescent,stem,style,surface,tertiary,unarmed,unbranched,upper,usually,vein,venation,visible,white,yellow,yellow-orange	/5,0.1-0.3,0.15-0.3,0.2-1.5,0.3-0.5,0.3-0.8,0.5,0.5-1.5,0.7-1.5,0.8-3,0.9-1.3,1-1.8,1-10,1-3,1-4,1-5,1-8,1.2-2,1.5-2.5,1.5-6,1.7-6,1.8-3,1/10-1/5,2-3.5,2-5,2.5-3.2,2/3,2/3-3/,3-20,3-5,5-,5-merous,6-10,6-8,8-16,abaxially,acuminat,almost,alyx,apar,apart,articulated,bark,blade,broad-deltate,c.,concolorous,connivent,curved,densely,discolorous,distance,drying,eaf,eed,elongating,equal,erect,extending,flattened,flattened-reniform,flower,free,fruiting,glabrescent,infructescence,lon,long,longer,mature,midpoint,narrow-deltate,narrow-ovate,nflorescence,oblong,older,one,open,orange-brow,orolla,oung,pendulous,perfec,pericarp,plurifoliat,poricidal,porrect,portion,prickl,prickly,procumbent,ray,recurved,rounded,ruit,scar,sessile,side,smooth,spaced,spherical,spreading,stellate,stout,straight,strongly,tamen,tapering,terete,time,tip,trichome,tube,unit,vary,way,wide,woody,ympodial,Â¼	2/3-3/4,arrangement,branching,characteristic,colour,corolla,form,growth,hair,height,inflorescence,na,ovary,plant,rachi,seed,shape,staman,texture,type,ye
298	wfo-0001029286	success	224	95	81	143	14	0.362	.5,1-2,1.5-2,1.5-4,1/8,2-3,2.5-3,4-5,4-6,4.5-7,5-6,6-9,7-10,abaxial,abaxially,acute,adaxially,anther,anthesi,apex,apically,apiculate,attenuate,bark,base,branching,broadly,brown,canaliculate,chartaceous,clustered,cm,conical,corolla,cuspidate,deltoid,diameter,dilated,drying,entire,faint,flat,glabrous,green,grey,known,leaf,length,less,liana,light,lilac,lobe,margin,mauve,membranous,midvein,mm,oblong,obovate,pair,pedicel,peduncle,petiole,primary,rachi,raised,rounded,slender,sparsely,stem,style,surface,terminal,tertiary,time,unarmed,vein,venation,x,yellowish	.4,0-0.5,0.1,0.15-0.4,0.4-1.2,0.6-1.2,0.8,0Â°,1-1.5,1.5-8,15-50,3-4,4.5,5,6-8,abscising,age,almost,along,altered,alyx,another,apar,apart,apice,apparently,arising,around,articulated,articulation,axil,becoming,branch,branched,capitate,clearly,closer,concave,concolorous,crenulate,curved,delineated,dendritic,density,distributed,domatia,eaf,eed,equal,except,extending,fertilization,filament,flexuous,flower,formed,forming,free,fresh,glabrescent,globo,hair,increasing,inflorescenc,inside,isolated,junction,know,lamina,lengthening,lobed,long,lower,m.,main,margi,mas,meeting,middle,minutely,much,multicellular,narrowly,nflorescence,nther,obconical,occasional,often,one,orolla,outside,ovate,papillo,perfec,plurifoliat,pore,poricidal,portion,prominent,protruding,rarely,regular,ruit,scar,separated,shallowly,side,simple,smaller,smooth,sometimes,somewhat,soon,specimen,spreading,stigma,stretchy,stump,tangled,tearing,terete,textur,thick,thickened,thinner,tip,tissue,together,toward,translucent,translucent-violet,trichome,tube,tuft,ud,uneven,unit,vary,visible,wide,widely,ympodial,young	adaxial,arrangement,calyx,characteristic,colour,form,fruit,growth,inflorescence,ovary,seed,shape,texture,ye
299	wfo-0001029310	success	216	118	96	120	22	0.444	.5,/4,0-20,0-5,0.6-1.1,00,1-1.5,1.2-1.5,1.8-3,10-15,2-3.5,20-40,3-4,3.5,5-12,5-20,5-30,5-6,5-7,7-12,8,acute,anther,apex,apically,apparently,articulated,base,berry,branched,brown,calyx,cm,cordate,dark,diameter,difoliate,dull,elliptic,erect,filament,flattened-reniform,fruit,glabrescent,glabrous,hair,herb,lateral,leaf,length,lobe,lobed,long,long-styled,lower,margin,maturity,mauve,membranous,midvein,mm,moderately,narrow-deltate,orange-green,ornately,pair,pedicel,peduncle,pendent,per,petiole,pinnatifid,plant,prickle,prickly,primary,short-styled,shrub,simple,sparsely,spherical,stellate,stellate-pubescent,stem,style,surface,tertiary,toward,truncate,unit,vein,venation,visible,way,wide,yellow	-16,-25,.1,.6,/6,0.1-0.2,0.2-0.3,0.2-0.8,0.5,0.5-3,1,1-2,1-4,1/,10,10-13,10-20,15-20,2-4,2.5-6,2/3-3/4,20-60,200-500,3-5,4-10,4-8,45-60,5,5-10,5-8,5-merous,6-8,7-13,abaxially,accrescent,alyx,ame,andromonoecious,apar,apart,bark,beyond,blade,c.,concolorous,conical,connivent,deltate,distal,distance,drying,eaf,eed,elongating,enclosing,equal,extending,filifor,flower,free,fruiting,geminat,gently,gray,hermaphrodite,heterostylous,inflated,infructescence,lobing,lon,longer,lowermost,mature,midpoint,minute,nflorescence,older,one,open,orolla,oung,pendulous,pericarp,perpendicular,poricidal,porrect,portion,prickl,ray,recurved,red-brow,retrorse,ruit,scar,secondary,sessile,shorter,side,smooth,sometimes,spaced,spreading,stalk,stalked,staminat,stout,straight,strongly,tamen,tapering,terete,time,tip,tissue,trichome,tube,variously,vary,woody,ympodial	1/3,abaxial,adaxial,arrangement,branching,characteristic,colour,corolla,filiform,form,growth,height,inflorescence,na,ovary,rachi,seed,shape,staman,sympodial,texture,unarmed
300	wfo-0001029317	success	151	92	63	88	29	0.417	0.5,0.5-1,0.8-1,1,1-1.5,10-30-flowered,11-14,2-3,7-8,8-9,acuminate,along,anther,apex,attenuate,base,beneath,broadly,ca,calyx,channeled,cm,corolla,deflexed,deltoid,densely,filament,glabrous,grayish,inflorescence,leaf,lobe,long,margin,mm,narrowly,opposite,ovary,ovate,pair,pedicel,petiole,prominent,pubescent,rachi,raised,rounded,shrub,simple,slender,sparsely,stem,straight,style,tapering,tip,trichome,tube,uniseriate,vein,white,x,yellowish	.5,0.25,0.5-0.75,1.5-3.5,10-16,2.5-5,6-8,6.5-11,anthesi,apar,area,barely,brow,bud,closely,cup-like,deciduou,denser,dia,differing,difoliate,dry,eaf,edicel,eed,ellipsoi,epidermi,erect,exserted,extreme,free,frui,fruiting,geminate,glabrate,globose,immature,known,lateral,like,lobed,lon,lower,main,major,middle,minor,minutely,nearly,nflorescence,occasionally,often,older,one,otherwise,overlapping,ovoid,paler,papillose,pore,poricidal,portion,probably,proximal,reflexed,remaining,rest,ruit,scar,shaped,size,slightly,soft,soon,spaced,specimen,stigma,styl,tall,tear-drop,thickened,tuft,ud,unit,visible,widest,ympodial,young	2,5,abaxial,adaxial,arrangement,branching,brown,characteristic,colour,diameter,form,fruit,growth,height,length,midvein,na,peduncle,plant,primary,pseudostipule,seed,shape,staman,surface,tertiary,texture,unarmed,venation
301	wfo-0001029332	success	197	140	119	78	21	0.604	/3,0,0-0.5,0-100,0-2,0-20,0-4,0-5,0.15-0.25,0.5-1,0.8-1,1-2,1-4,1.3-1.5,1.5-2,1/2,1/4,2,2-2.5,2-4,2.5-3.5,2.8-3.7,2/3-3/4,3-4,3.5-5,4-10,5-8,8.5-9.5,abaxial,abaxially,adaxial,anther,apart,apex,apically,apparently,articulated,base,berry,broad-deltate,calyx,chartaceous,cm,concolorous,cordate,curved,densely,diameter,difoliate,distance,drying,erect,extending,filament,flattened-reniform,flower,fruit,fruiting,glabrescent,glabrous,lateral,leaf,length,lobe,lobed,long,lower,margin,mature,maturity,mauve,midpoint,midvein,mm,moderately,narrow-deltate,one,open,orange-brown,ovate,pedicel,peduncle,per,petiole,plant,porrect,prickle,prickly,ray,rounded,scandent,scar,shorter,shrub,side,simple,slender,spaced,spherical,spreading,stellate,stellate-pubescent,stem,style,subsessile,surface,terete,terminal,time,trichome,unbranched,unit,upper,way,weakly,wide,yellow,yellow-green,yellow-orange	-5,.5,0.1,0.1-0.2,0.15-0.2,1-1.5,1-3,1/3,1/4-1/3,10-30,2/,3-6,4-15,5-6,5-merous,6-8,alyx,andromonoecious,apar,bark,becoming,blade,conical,connivent,distal,eaf,eed,elongating,equal,flattened,free,geminat,gland,globular,grayi,herbaceous,hermaphrodite,heterostylous,infructescence,less,long-acuminat,long-styled,longer,lowermost,nflorescence,often,older,orolla,oung,pair,pale,pendulous,pericarp,poricidal,portion,prickl,primary,pubescent,reduced,ruit,sessile,short-styled,smooth,stalk,stalked,staminat,tamen,tapering,tertiary,tip,tube,variously,vary,vein,venation,visible,woody,ympodial	2/3,arrangement,branching,characteristic,colour,corolla,form,geminate,growth,height,inflorescence,long-acuminate,na,ovary,seed,shape,staman,sympodial,texture,type,unarmed
302	wfo-0001029333	success	155	104	82	73	22	0.529	.5,0.5,0.7-1,1-1.2,1-1.5,1-15,1-3,1-7,1.5-2,1.5-2.5,1.5-3,10-15-flowered,17-26,2-2.5,3-7,3-7.5,5-6,8-15,abaxial,anther,apex,auriculate,bark,base,beige,berry,broadly,calyx,clavate,cm,conical,corolla,dendritic,dia,dry,elliptic-obovate,flattened-reniform,fresh,glabrous,globose,golden,green,incrassate,leaf,lobe,long,long-styled,margin,minor,minutely,mm,obovate,occasionally,orbicular,ovary,pale,paler,pedicel,petiole,pitted,pubescence,pubescent,reddish-brown,sessile,shape,shining,short-styled,shrub,simple,size,somewhat,stem,stigma,style,surface,time,triangular,trichome,truncate,tube,type,wide	.25,/4,0.5-1,1-2,100,9-13,abaxially,acuminate,acute,adaxially,along,anisophyllou,anthesi,ba,beneath,contracted,deflexed,dendritic-pubescent,densely,denser,differing,difoliate,eaf,edicel,eed,erect,exserted,filament,flower,free,fruiting,geminate,heteromorphic,inflorescenc,lateral,like,lobed,lon,lower,main,major,nflorescence,older,opposite,overlappin,pair,papillo,planar,pore,poricidal,portion,present,rest,rounded,ruit,scar,shaped,slender,small,spaced,sparsely,strongly,tall,tear-drop,tip,tree,ud,unit,vein,way,woody,ympodial,young	1,adaxial,alternate,arrangement,characteristic,colour,diameter,form,fruit,growth,height,history,inflorescence,length,life,papillose,perennial,plant,seed,texture,unknown,width
303	wfo-0001029334	invalid_json	211	111	73	138	38	0.346	0.15-0.3,1,1-2,1-3,1-6,1.3-4.5,1.5-6,1.8-2.9,2,2-2.5,2.5-3,3-7,4-5.5,8-30,9-12,acute,almost,anther,apex,articulated,attenuate,base,berry,brownish,cell,chartaceous,cm,condition,cordate,corolla,covering,densely,diameter,drying,filament,fresh,fruit,glabrous,globose,green,greenish,hair-like,herb,lateral,lobe,long,margin,membranous,mm,oblique,odd-pinnate,orbicular,ovate,ovoid,pedicel,peduncle,petiole,plant,puberulent,pubescent,pure,ripe,rounded,seed,stem,style,testal,thick,tinged,violet,wall,white,whitish	.2,0-4,1-10,1.5-3.9,2-4,2-5,2-8,3-5,3.2-5.8,3.3-6.5,4-8.5,5-10,5-merou,7.5-15.5,abaxially,absent,acumen,adaxially,ag,along,alyx,among,apart,apparently,axe,axillary,blade,borne,broadly,bud,capitat,ciliate,clavate,connivent,cuneate,decreasing,decurrent,digestion,distal,dorsally,eaf,edge,eed,elliptic,end,enzyme,erect,especially,exceeding,except,flat,flower,folded,forked,geminat,generally,glabrou,gradually,grassland,greatly,green-white,hair,half,homostylous,honeycomb-shaped,interjected,lanceolate,leaflet,lengthening,like,living,low-growin,lower,make,middl,midrib,minutely,mucilaginous,narrowly,nflorescence,obtuse,often,orolla,pair,perfect,petiolulate,petiolule,plurifoliate,pore,poricidal,proximal,rarely,reduced,removed,ruit,semi-rosette,sessile,seudostipule,shady,short,singly,situation,size,slightly,slit,spaced,specimen,stamen,ste,stellate,stigma,stolo,straight,subequal,subsessile,subtending,sunny,tall,tamen,tem,terminal,throughout,tip,toward,tri-,tube,tuber,typically,unit,unwinged,usually,vary,wet,wide,woodland,x,yellow,ympodial	'',[,``,abaxial,adaxial,arrangement,branching,calyx,characteristic,colour,form,growth,height,history,inflorescence,leaf,length,life,middle,midvein,na,ovary,perennial,primary,pseudostipule,rachi,shape,staman,surface,tertiary,texture,unarmed,value,vein,venation,width,{,}
304	wfo-0001029344	success	147	102	80	67	22	0.544	.5,0.4-1,0.5-1,0.5-1.5,1,1-2,1-3,1-5,1.5,1.5-3,1.5-4,10-20,10-35,2-3,2-7,3-10,4-6,5-12,5-15,absent,acute,anther,apex,base,berry,brown,calyx,center,chartaceous,ciliate,cm,densely,diameter,dm,drying,edge,elliptic,elliptic-ovoid,entire,filament,fine,flower,fruit,glabrous,globose,herb,immature,linear-lanceolate,lobe,margin,maturing,membranaceous,mm,moderately,nearly,obtuse,parallel,pedicel,peduncle,per,petiole,pubescent,rachi,radiating,raised,ridge,rotate,rounded,running,semitransparent,shallow,sparsely,style,surface,triangular,tube,white,woody,x,yellow	0.5-3,1-6,2-3-celled,2-4,abaxially,abundant,adaxiall,adaxially,along,axe,beyond,blade,connected,cordate,decurrent,dehiscing,denser,difoliate,eaf,eed,emarginat,equal,explosively,exserted,flat,frui,geminat,hair,held,interpetalar,lacking,long,lower,lying,maturit,mesocarp,nflorescence,notch,oblong,obvious,often,one-,orolla,placenta,pressure,pubescen,rhizomatous,ruit,short,slightly,sometimes,stamen,stigma,straight,swollen,tal,tamen,tem,tissue,two-celled,unbranched,unit,vary,vein,watery,wid,ympodial	abaxial,adaxial,arrangement,characteristic,colour,corolla,form,geminate,growth,height,inflorescence,leaf,length,ovary,plant,pubescence,seed,shape,staman,stem,texture,type
305	wfo-0001029363	success	152	76	59	93	17	0.388	.25,.75,0.1-0.5,0.2-1.1,1,1-1.2,1.5-1.7,2-6,3-7,5-7-flowered,6-7,acuminate,acute,anther,bark,base,becoming,beneath,berry,bud,calyx,cm,corolla,deep,deflexed,densely,elliptic,fruit,fruiting,glabrous,globose,green,greyish,leaf,long,margin,maroon,minutely,mm,narrowly,obtuse,ovary,pedicel,petiole,pubescent,shiny,shrub,simple,small,sparsely,stem,straight,style,surface,tapering,tree,tube,white,white-papillose	/4,0-0.1,0.5,0.5-1,1.5-3.5,4-11,6-8,7-10,anthesi,apex,axil,ba,beginning,bi-lobed,capitate,closely,coroll,cup-shaped,deltoid,dia,drying,eaf,edge,edicel,eed,erect,except,exsertion,filament,free,immature,inflorescenc,internodal,known,lamina,larger,later,lateral,lobe,lobed,lon,lower,main,mature,meeting,middle,minute,much,near,nflorescence,occasionally,often,older,opposite,overlapping,pair,pale,paler,papillo,papillose,pore,poricidal,portion,prominent,reflexed,ruit,scar,slender,slit-like,somewhat,spaced,sparse,stigma,tall,terminal,thickened,tip,trichome,tuft,ud,unifoliat,uniseriate,unit,upon,usually,vein,way,wide,widest,woody,yellowish,ympodial,young	abaxial,characteristic,colour,diameter,form,growth,hair,height,inflorescence,length,na,plant,seed,shape,texture,type,width
306	wfo-0001029364	success	153	93	69	84	24	0.451	-2,-6,0.2-0.5,1-,1-3,1-4,1-5,1.5-2,2,2-6,4-9,5-9,7-9,8-10,8-15,?,acuminate,anther,apart,apex,articulated,base,calyx,chartaceous,cm,corolla,cream,cuneate,cylindrical,diameter,elliptic,entire,extra-axillary,filament,finger,flower,fruit,glabrous,gland-tipped,globose,green,greenish,hair,herb,immature,lobe,margin,minutely,mm,nearly,obtuse,pedicel,peduncle,petiole,puberulent,pubescent,rachi,radiu,shallow,shrub,simple,sparsely,spot,stigma,style,unbranched,unknown,white,x	-3,.5,1,10-27,191.,2-,2-foliat,3-4,4-12,5-,5-11,6-8,abaxially,according,acute,adaxially,aggregate,around,axe,ba,bitter,blade,blue,cell,center,color,connivent,curled,darker,deep,directed,distall,distally,eaf,ed,fide,free,glandular-puberulen,inserted,long,lower,major,membranaceous,mesocarp,moderately,narrowly,nflorescence,orolla,ovate,part,perfect,pore,presence,present,puberulen,ripe,ruit,rusby,sagittate,short-tomentose,shorter,side,small,spaced,stellate,stone,strongly,tal,tamen,tapered,tem,thecae,tightly,time,tomento,triangular,truncat,tube,unit,vary,vein,wide,yellow,ympodial	abaxial,adaxial,arrangement,articulation,characteristic,colour,form,growth,height,inflorescence,leaf,length,ovary,plant,seed,shape,size,spacing,staman,stem,surface,texture,truncate,type
307	wfo-0001029368	success	139	70	53	86	17	0.381	.5,0.5-2,0.9-1,1.5-1.6,1.5-2,1.5-3,1.5-4,11-13,16-25,2-5,2.5-4,5-6,acuminate,acute,anther,apex,base,berry,broadly,calyx,capitate,cm,corolla,densely,elliptic,fruit,fruiting,glabrous,globose,golden,green,herb,inflorescence,lanceolate,leaf,lobe,long,minutely,mm,obtuse,ovary,pedicel,petiole,puberulent,shrub,simple,stem,stigma,straight,style,tube,white,x	.2,.25,0,?,abaxially,adaxially,along,anthesi,apparently,bark,bearing,bitter,borne,breaking,brow,closely,coarse,conical,crumpled,cup,deflexed,dia,distal,eaf,edicel,eed,erect,exserted,few-branched,fide,filament,flattened,flower,free,half,indistinct,inflorescenc,internodal,known,lamina,lateral,leaving,like,lower,main,margi,margin,middle,midrib,minute,nflorescence,non-flower,older,one,opposite,overlappin,pair,papillo,papillose,parallel,pore,poricidal,portion,reflexed,rest,ruit,scar,shaped,somewhat,spaced,strongly,tall,tear-drop,tip,trichome,ud,unifoliat,uniseriate,unit,upper,vein,widest,winged,woody,ympodial,young	abaxial,characteristic,colour,diameter,form,growth,height,length,na,peduncle,plant,seed,shape,surface,texture,type,width
308	wfo-0001029370	success	224	113	92	132	21	0.411	.3,0-35,0.5-1,0.5-2.2,1-2,1.5-6,1.8-2.5,12-17,2.5-3.5,3-4,4-7,5.5-7,7-11,abaxial,adaxial,anther,apex,apically,articulated,basal,base,berry,branched,broad-deltate,calyx,chartaceous,clearly,cm,cordate,cream,dark,densely,diameter,erect,filament,fine,flattened-reniform,flower,fruit,green,greenish,herb,lateral,leaf,length,lobe,lobed,long-styled,lower,margin,marking,maturity,mauve,midvein,mm,moderately,obtuse,orange,orange-brown,ornate,ovate,overlapping,pair,pale,pattern,pedicel,peduncle,petiole,plant,primary,red-brown,reticulate,rounded,shiny,short-styled,shrub,simple,smooth,spherical,stellate-pubescent,stem,style,surface,tertiary,unarmed,vein,venation,visible,white,whitish,yellow,young	-20,-32,.1,.5,/4,0-10,0-100,0-3,0.1,0.1-0.15,0.2,0.3,1,1-3,1-4,1.8-2.8,1/3-1/2,1/4-1/3,10-17,10-40,10-50,15-30,2-10,2-20,2-3,2-6,3.5-4,3.5-8,3/,4-6,4-9,5-10,5-12,5-merous,6-15,7-13,8-14,8-20,8-23,abaxially,acut,almost,alyx,ame,andromonoecious,apar,apart,apparently,bark,blade,c.,conical,connivent,curved,discolorous,distal,distance,drying,eaf,eed,elongate,elongating,equal,extending,fewer,flattened,free,fruiting,fully,gently,glabrescent,glabrous,hermaphrodite,heterostylous,infructescence,long,longer,lowermost,mature,midpoint,mixture,multangulate,nflorescence,often,older,one,open,opening,orolla,oung,pendulous,per,pericarp,perpendicular,plurifoliat,poricidal,porrect,portion,prickl,prickle,prickly,ray,rotate,ruit,scar,sessile,side,slightly,sometimes,spaced,spreading,stalk,stalked,staminat,stout,straight,strongly,tamen,tapering,terete,time,tip,trichome,tube,unit,variously,vary,way,white-gra,wide,woody,ympodial	3/4,4,acute,arrangement,branching,characteristic,colour,corolla,form,growth,height,inflorescence,na,ovary,plurifoliate,pseudostipule,rachi,seed,shape,staman,texture
309	wfo-0001029373	success	199	82	53	146	29	0.266	5,abaxial,acute,adaxial,anther,apex,articulated,base,berry,broadly,calyx,cm,conical,corolla,curved,deltate,densely,diameter,ellipsoid,entire,filament,flattened-reniform,fruit,glabrous,green,growth,herb,leaf,lobe,margin,minutely,mm,moderately,obtuse,ovary,ovate-lanceolate,pair,pedicel,peduncle,petiole,pitted,primary,pubescent,rounded,shape,simple,straight,style,surface,tip,vein,white,yellowish	.0â1.2,.2,.3,.5,.5â2.0,0.3â0.5,0.4â1.6,0.5â1.2,0.5â1.8,0.6â0.7,1.0â1.2,1.0â1.6,1.2â1.5,1.3â2.2,1.4â3.5,1.5â2.0,1.5â2.5,1.5â2.7,1.8â2.0,1.8â2.3,180Â°,2-celled,2.0â2.5,2.7â3.0,20â30,2â4-celled,3,3.5â4.0,30â40,3â5,4â5,4â6,5-merous,5â6,6.8,8â9,abaxially,accrescent,acuminate,adaxially,age,anthesi,apar,appearanc,appressed,arising,bark,basal,bayonet,beyond,bud,capped,cell,clavate,cone,developing,distal,eaf,eed,elongate,enclosed,enclosing,exerted,finger,flower,free,fruiting,fully,geminat,glandular-tipped,globose,grey-brown,hair,half,halfway,hilum,immature,individual,internodal,lateral,laterally,lengthening,less,like,live,lobed,lon,long,lower,mature,mesocarp,middle,minute,mouth,new,nflorescence,node,older,outline,papillate,pentagonal,per,perfect,plant,plurifoliate,pore,poricidal,portion,positioned,reflexed,resembling,root,ruit,scar,seen,seudostipule,shallowly,short,slightly,slit,smoot,spaced,spreading,stellate,stem,stigma,still,tall,tem,terete,testal,thicker-walled,trailing,trichome,tub,tube,ud,uniseriate,unit,upper,wide,woody,yellow,yellow-green,ympodial,â5	0.4-1.6,0.5-1.2,0.6-0.7,1.0-1.2,1.2-1.5,1.5-2.0,2.0-2.5,2.7-3.0,4-6,5-6,8-9,arrangement,branching,characteristic,colour,form,history,inflorescence,length,life,midvein,na,perennial,pseudostipule,rachi,seed,staman,texture,unarmed
310	wfo-0001029402	success	113	63	44	69	19	0.389	0.5-1,0.5-2,11-17,2,2-3,3-5,4-6,4-7,5-25,7-8,7-9,acute,apex,base,branched,calyx,ciliolate,cm,deltate,diameter,elliptic,glabrate,glabrous,lanceolate,lobe,margin,mm,narrowly,pedicel,peduncle,petiole,pubescent,rachi,radiu,shrub,simple,sparsely,stigma,style,surface,tapered,unknown,violet,x	1-2.5,15-30,2-10,3-4,3-6,4-8,6-16,7-11,8-15,abaxial,abaxially,acuminate,adaxially,apart,articulated,axe,band,blade,chartaceous,color,connivent,cylindrical,denser,directed,distall,eaf,eed,fleshy,flower,forked,free,glabrou,hair,inrolled,leaving,long,lower,many-foliat,moderately,narrowed,nearly,nflorescence,nther,often,orolla,papillose,pore,pubescence,rachise,roughened,ruit,scale-like,scar,somewhat,spaced,stellate,tal,tem,thickened,time,tip,triangular,truncat,tube,unit,unknow,vary,wide,ympodial	anther,arrangement,characteristic,colour,corolla,form,fruit,growth,height,inflorescence,leaf,length,ovary,plant,seed,shape,stem,texture,truncate
311	wfo-0001029404	success	154	93	67	87	26	0.435	-3,0.5-1,1-4,15-25,2-3,2-8,2.5-22,2.5-3,3-4,3-8.5,5-20,5-6,6-8,6-9,acuminate,acute,anther,apex,apiculate,articulated,auriculate,base,branched,calyx,center,chartaceous,cm,cordate,dark,darker,deltate,densely,diameter,ellipsoidal,entire,flattened,fleshy,fruit,glabrous,green,lobe,longitudinal,margin,mm,moderately,mottling,orange,ovate,pedicel,peduncle,petiole,pink,puberulent,pubescent,purple,rachi,shrub,simple,sparsely,star,style,toward,tree,unbranched,white,x,yellow	-1.5,-10,-5,0-60-flower,1,1.5-2,2,2-4,2-5,20-35,3-5,4-foliat,5-10,5-24,6.5-34,8-12,abaxially,absent,adaxially,aggregate,apart,ape,axe,basal,beyond,blade,cell,connective,connivent,cream,cylindrical,directed,distally,eaf,eed,eglandular,exserted,flower,glandular,glandular-puberulen,hair,lanceolate,leaving,lemon,less,light,lon,long,lower,narrowly,nflorescence,nther,obtuse,orang,orolla,ovoid,pedicellar,perfect,pore,presen,radiu,remnant,ripe,ruit,shorter,slightly,small,somewhat,spaced,stellate,stigma,stone,subcoriaceous,tal,tem,thecae,time,tomento,triangular,truncat,tube,ud,unit,vary,vein,wide,ympodial	abaxial,adaxial,arrangement,branching,characteristic,colour,corolla,filament,form,glandular-puberulent,growth,height,inflorescence,leaf,length,na,ovary,plant,pseudostipule,seed,shape,staman,stem,surface,texture,unarmed
312	wfo-0001029406	success	136	106	85	51	21	0.625	0.5-1,0.6-1,0.7-1.5,1-1.5,1-10,1-2,1.5-2.2,1.5-2.5,1.5-5,2,2-11,2-3,2.5-3.5,28,3-9,30,4-18,4-6,7-12,acute,anther,apex,arachnoid,arachnoid-pubescent,bark,base,broadly,calyx,clavate,cm,corolla,dark,deltate,densely,dry,elliptic,filament,free,fruiting,glabrous,globose,grayish-brown,grayish-green,green,greenish-white,large,lateral,leaf,lenticel,lobe,main,major,matted,maturity,minor,minutely,mm,occasionally,ovary,ovoid,ovoid-reniform,pair,papillose,pedicel,petiole,pitted,pointed,poricidal,portion,pubescent,shiny,shrub,slightly,small,stem,stigma,style,surface,tip,tree,trichome,tube,vein,waxy,white	.5,0.3-1,abaxially,adaxially,along,anthesi,ba,berry,brown,brownish,bullate,conical,conspicuously,deciduous,deflexed,dia,differing,difoliate,eaf,eed,felt-like,geminat,impressed,lilac,lobed,lon,long,lower,margin,middle,nearly,often,older,pale,papillo,planar,population,pore,ruit,shaped,size,soon,tall,tear-drop,tinge,unit,wide,widest,woody,ympodial,young	0.5,1.5,abaxial,adaxial,alternate,arrangement,colour,diameter,flower,form,fruit,growth,hair,height,length,plant,pubescence,seed,shape,texture,width
313	wfo-0001029407	success	208	126	104	104	22	0.5	-6,.5,0-15,0-2,0-4,0-5,0.4-0.7,0.5-0.7,0.5-1.5,0.5-2,0.6-0.9,1-1.4,1-2,1-4,1.8-2.5,1/5,2.5-3,3-4,3-6,5-7,6-13,6-20,abaxial,acute,adaxial,almost,anther,apex,apically,apparently,articulated,base,berry,bright-red,calyx,cm,cuneate,dark,deltate,densely,diameter,dull,elliptic,entire,erect,evenly,filament,flattened-reniform,flower,fruit,glabrous,green,green-brown,infructescence,lateral,leaf,length,lobe,lobed,long,margin,mature,maturity,mauve,mm,moderately,obtuse,orange,orange-brown,ovate,pair,pale,pedicel,peduncle,per,petiole,prickle,prickly,primary,pubescent,rarely,rounded,shrub,side,simple,sometimes,sparsely,spherical,stellate-pubescent,stem,straw-yellow,style,surface,tertiary,unbranched,upper,vein,venation,visible,white,wide,yellow,yellow-green,young	-10,-2,-25,-4,-7,/3,0,0.1-0.2,0.1-0.25,0.15-0.4,0.2-0.3,0.4-1,0.6,0.7-1.2,1,1-3,1-4.5,1.5,1/3,1/3-1/2,1/8-1/5,2-3,2-4,2-5,3.5-4.5,4-15,4-9,4.5-6,5-merous,7-8,abaxially,acut,alyx,apar,apart,bark,blade,brow,chartaceous,connivent,curved,difoliate,discolorous,drying,eaf,eed,elongating,equal,flattened,free,fruiting,geminat,geminate,glabrescent,gray-greenish,lengt,longer,lower,midpoint,nflorescence,occasionally,older,one,open,orolla,oung,pendulous,perfec,pericarp,poricidal,porrect,portion,prickl,ray,recurved,reflexed,ruit,scar,sessile,shorter,slender,smooth,spaced,spreading,stalk,stalked,stellate,stout,straight,strongly,tamen,tapering,terete,thick,time,tip,trichome,tube,unit,vary,way,weakly,woody,ympodial	arrangement,branching,characteristic,colour,corolla,form,growth,height,history,inflorescence,life,midvein,na,ovary,plant,pseudostipule,rachi,seed,shape,staman,texture,unarmed
314	wfo-0001029408	success	244	108	87	157	21	0.357	-10.5,0,0.2-0.3,0.5-2.5,0.7-1.2,0.9-1.3,0.9-1.6,1-8,1.1-1.5,1.4-1.9,1.7-2.4,2-12,2-5,2.2-3.7,3-5,4-20,5-6.5,abaxially,acute,adaxially,anther,apex,base,berry,branched,broadly,brown,clavate,cm,conical,corolla,cuneate,deltoid,diameter,elliptic,entire,filament,fleshy,flower,fruit,glabrous,globose,gray,growth,honeycombed,lanate,leaf,length,lilac,long-attenuate,margin,mm,moderately,mostly,oblong,orbicular,ovate,pale,pedicel,peduncle,petiole,plurifoliate,pubescent,purplish,rachi,rarely,reniform,reticulate-punctate,ripe,short-attenuate,shrub,small,stem,stigma,style,suborbicular,time,tomentose,tree,turbinate,unarmed,velutinous,white,whitish,x,yellow,yellowish	-1.5,-4.5,.2-3.5,/10,0-100,0.3-5,1.5-3,1.6-2.8,1.8-3.5,1/2,1/2-3/4,1/4,11-31,2-3.5,2-4,2.5-7,2/3,3.5-5,4-14,4-7.5,5-24,5-6,5-8,5-merou,7-12,accrescent,acuminate,adaxiall,ag,alyx,anthesi,apart,apical-lateral,articulated,axe,axillary,ba,barely,bark,becoming,blade,blunt-tipped,branch,bud,calyx,capitat,chartaceous,continued,dark,decurrent,dehiscing,dendritic-echinoi,dendritic-multangulate,densely,develope,directed,distal,distall,due,eaf,echinoi,echinoid,eed,exserted,extend,faintly,few-rayed,free,fruiting,green,hair,high,homostylous,indument,inserted,interpetalar,introrse,lacking,lanceolate,large,lateral,lobe,lobed,long,long-,long-stalked,longitudinal,lower,m.,main,many,midvein,mixed,multangulate,near,nearly,nflorescence,obscured,obtuse,often,older,orolla,ovate-lanceolate,overlapping,part,partly,perfect,persistent,pore,porrect-stellate,present,pseudo-terminal,rather,ray,relatively,ribbed,rotate-stellate,ruit,runk,sessile,short-,short-stalked,side,simple,slightly,slit,sometimes,spaced,stamen,stelliform,subcampanulate,subovate,suture,tamen,terete,testa,thick,thick-stalked,thick-textured,thin-stalked,tissue,tomentu,tomentum,top,touching,toward,tube,unarme,unit,usually,vary,vein,way,well,wide,ympodial,young	abaxial,arrangement,capitate,characteristic,colour,form,height,history,inflorescence,life,ovary,perennial,plant,pseudoterminally,seed,shape,staman,surface,texture,true,type
315	wfo-0001029417	success	213	159	129	84	30	0.606	.5,0.2-0.6,0.7-3,1,1-10,1-2,1.3-8,1.5-1.8,1.5-8,12,2.5-10,2.8-3.5,3-5,4-7,5-15,6-11,8-9,abaxially,acuminate,acute,adaxially,anther,apart,apex,apiculate,articulated,attenuate,axillary,base,basiscopic,berry,blue,broadly,brownish,bud,cell,central,chartaceous,cm,coarsely,condition,corolla,covering,dark,decurrent,deep,diameter,distal,dot,drying,erect,filament,flower,forked,fresh,fruit,generally,glabrous,globose,green,green-white,greenish,hair,hair-like,half,herb,lateral,like,linear,lobe,long,make,margin,medium,membranous,minute,mm,moderately,mucilaginous,narrowly,non-glandular,odd-pinnate,often,orbicular,ovate,ovoid,pedicel,peduncle,petiole,pilose,plant,plurifoliate,pubescent,purple,rarely,ripe,rounded,scattered,seed,sessile,short,side,slightly,sometimes,spaced,star,stem,style,subtending,terminal,testal,thick,throughout,tinged,tri-,trichome,typically,unit,unwinged,usually,violet,wall,wet,white,whitish,wide,widely,wing,x	0-7,0.4-8,1-1.5,1-4,1-8,1.5-10,2-4,3-14,5-merou,8-15,acumen,ag,along,alyx,apparently,axe,blade,borne,capitat,ciliate,clavate,connivent,decreasing,digestion,dorsally,eaf,edge,eed,end,enzyme,erec,especially,exceeding,flat,folded,geminat,glabrou,greatly,hal,homostylous,honeycomb-shaped,interjected,lanceolate,leaflet,lengthening,living,lower,lunate,midrib,minutely,nflorescence,orolla,pair,pentagonal,perfect,petiolulate,pore,poricidal,puberulent,rapidly,removed,rotate,ruit,seudostipule,short-petiolulate,singly,size,slit,specimen,stamen,ste,stigma,stolo,straight,subequal,tall,tamen,tem,tip,tube,tuber,vary,yellow,ympodial	2,abaxial,adaxial,arrangement,branching,calyx,characteristic,colour,form,geminate,growth,height,inflorescence,leaf,length,midvein,na,ovary,primary,pseudostipule,rachi,shape,staman,surface,sympodial,tertiary,texture,unarmed,vein,venation
316	wfo-0001029461	success	217	109	90	127	19	0.415	-1.5,-2,-3,-4.5,.5,0,0.6-1,1-,1-1.6,1-3,1/3,2-2.8,2-3,2.5-3,3-6,4-6.5,4.5-7,5-25,almost,anther,apex,attenuate,base,becoming,berry,black,broad-deltate,brown,calyx,cell,cm,cuneate,densely,diameter,dull,elliptic,evenly,faint,filament,fine,fruit,glabrous,green,infructescence,leaf,length,lobe,lobed,margin,maturity,mauve,midvein,mm,moderately,orange,outline,ovate,pair,pedicel,per,petiole,pit,plant,prickle,prickly,primary,raised,reddish,rounded,shrub,simple,small,smooth,sometimes,sparsely,spherical,staman,stellate-pubescent,stem,style,subentire,surface,tertiary,unarmed,upper,vein,venation,visible,yellow,young	-14,-3.2,-3/4,-4,-5,0.1,0.1-0.25,0.15-0.25,0.7-1,0.8,0.8-1.5,1-2,1-4,1-6,1.2-1.7,1.2-1.8,1.3-2.2,1.5-,1.5-2,1/3-2/3,1/4,1/4-1/2,2-2.4,2-4,3-20,4-10,4-7,4.7-7.2,5-10,5-merous,7-10,7-12,8-9,abaxially,acuminat,alyx,ame,andromonoecious,apart,apically,bark,blade,breaking,brittle,c.,chartaceous,concolorous,curved,dark,discolorous,distal,distance,drying,eaf,eed,elongating,erect,extending,fifth,flattened,flattened-reniform,flower,four,free,fruiting,glabrescent,gra,hermaphrodite,heterostylous,lengt,long,long-styled,longer,lower,lowermost,mature,midpoint,oblong,obovate,obtuse,older,orolla,oung,pendulous,pericarp,plurifoliat,poricidal,porrect,portion,prickl,ray,reduced,reflexed,ruit,sessile,shallow,shiny,short-styled,shorter,side,slender,slightly,spaced,spreading,stalk,stalked,staminat,stellate,straight,strongly,tamen,terete,time,tip,trichome,tube,unarme,unequal,unit,variously,vary,way,weakly,wide,woody,ympodial,zygomorphic	abaxial,adaxial,arrangement,branching,characteristic,colour,corolla,form,growth,height,inflorescence,na,ovary,peduncle,pseudostipule,rachi,seed,shape,texture
317	wfo-0001029462	success	166	111	83	83	28	0.5	-2,-30,-4,-5,0.5-1,0.5-2,1,1-3,1-6,1.5,1.5-2,10-,10-22,15-25,2-6.5,2.5-3.5,2.5-5.5,20-35,3,3-27,3-6,3-7,4-20,6-9,7-8,acuminate,acute,apex,articulated,base,calyx,chartaceous,cm,cuneate,dark,densely,dentate,diameter,ellipsoidal,elliptic,entire,flattened,flower,fruit,glabrous,green,laterally,leaving,light,lobe,long,longitudinal,margin,membranaceous,mm,moderately,near,obtuse,often,oval,ovate,pedicel,pedicellar,peduncle,petiole,pubescent-pilose,purplish,rachi,remnant,reticulate,rounded,simple,smooth,somewhat,stripe,style,tip,tree,triangular,truncate,unbranched,white,x	1-,1-2,1.5-3,1.5-7,2-3,3-18,3-4,3-5,4-15,4-foliat,5-30,7-19,8-9,abaxially,abruptly,absent,adaxially,aggregate,apart,ape,axe,basal,beyond,blade,broad,campanulate,cell,ciliate,connective,connivent,constricted,curled,cylindrical,directed,eaf,eed,eglandular,equal,exceeding,exserted,hair,lanceolate,lon,lower,m.,minutely,narrowly,nflorescence,nther,occasionally,orolla,ovoid,perfect,pore,puberulent,pubescent,pubescent-pilo,purpl,radiu,ruit,shorter,slightly,small,spaced,sparsely,stamen,stellate-,stigma,stone,tal,tem,thecae,time,tomentose,truncat,tube,ud,unit,vary,wide,without,yellow,ympodial	abaxial,adaxial,anther,arrangement,branching,characteristic,colour,corolla,filament,form,growth,height,history,inflorescence,leaf,length,life,na,ovary,plant,pseudostipule,seed,shape,staman,stem,surface,texture,unarmed
318	wfo-0001029464	success	235	124	104	131	20	0.443	.9,0-80,0.2-0.5,0.8-2,00-200,1-10,1/4,10-40,2-3,2-3.5,2.2-2.5,2.4-4,2.5-5,2.9-3.2,3-20,3.5-5,4-7,5-17,5.5-6,5.5-7.5,6-15,7-10,abaxial,acute,adaxial,annual,anther,apex,apparently,articulated,base,berry,black,branched,calyx,chartaceous,cm,cordate,curved,deltate,diameter,ellipsoid,erect,filament,flattened-reniform,fruit,glabrescent,glaucous,globular,green,herb,lateral,leaf,length,lobe,lobed,long,long-styled,lower,margin,maroon,maturity,mauve,midvein,mm,moderately,mottled,narrow-deltate,oblong,obtuse,orange-brown,ovate,ovoid,pair,pedicel,peduncle,pendent,per,petiole,pink,plant,primary,purple,red-brown,short-styled,simple,sometimes,stellate-pubescent,striped,style,surface,terminal,tertiary,unarmed,upper,usually,variously,vein,venation,visible,white,wide,yellow-green,young	-2/3,-3,-30,-5,0,0-2,0.2,0.2-0.7,0.3-0.7,0.3-1,0.5,0.5-2,1,1-3,1-8,1.2-3,1.5-2,1/,1/4-1/2,1/4-1/3,10-15,10-23,10-50,12-50,2,2-4,2.5-8,3-5,3-7,4-8,4-8-merous,5-8,8-13,8-15,9-15,abaxially,acicular,alyx,ame,andromonoecious,apar,apart,apically,around,bark,blade,broad,broad-deltate,brow,brown,c.,connivent,cultivar,cup-shaped,dark,difoliate,discolorous,distal,distance,drying,eaf,eed,elongated,elongating,equal,extending,flower,free,fruiting,fully,geminat,glabrous,green-brown,hair,hermaphrodite,heterostylous,infructescence,less,long-acuminat,longer,lowermost,mature,midpoint,minute,nflorescence,occasionally,often,older,one,open,opening,orolla,oung,pendulous,pericarp,poricidal,porrect,portion,prickl,prickle,prickly,ray,rounded,ruit,scar,sessile,side,smooth,spaced,sparsely,spreading,stalk,stalked,staminat,stellate,stem,straight,tamen,tapering,terete,time,tip,translucent,trichome,tube,unit,vary,way,woody,yellow-orange,ympodial	/,1/2,arrangement,branching,characteristic,colour,corolla,form,growth,height,history,inflorescence,life,na,ovary,rachi,seed,shape,staman,texture
319	wfo-0001029546	success	203	139	110	93	29	0.542	0.3-1,1-2,1-4.5,1.5-6.2,2.2-2.8,3-8,3.5-5,4-10,4.5-7,5-10,5-18,5-8,7-10,8-17,abaxially,acuminate,acute,adaxially,anther,apex,apiculate,articulated,attenuate,axillary,base,berry,blue,broadly,brownish,bud,cell,cm,condition,cordate,corolla,covered,covering,densely,diameter,distal,dot,drying,elliptic,elliptical,filament,flower,forked,frequently,fresh,fruit,generally,glabrous,glandular,globose,green,green-white,greenish,hair,hair-like,half,herb,lateral,leaf,like,lobe,long,longer,lunate,make,mm,mucilaginous,nearly,non-glandular,oblique,odd-pinnate,often,orbicular,ovate,ovoid,pedicel,peduncle,petiole,plant,pubescent,purple,rachi,rarely,regular,ripe,seed,short,simple,slightly,soft,sometimes,stem,style,subtending,terminal,testal,thick,throughout,tinged,trichome,usually,wall,wet,white,whitish,x	0-2,1-10,1-3.2,1-5,1.5-2,1.6-6.5,2-4,2-9,4.5-12.5,5,5-merou,6.3-19.5,8,8-19.5,absent,acumen,adaxiall,ag,alyx,apart,apparently,axe,blade,capitat,chartaceous,clavate,connivent,curved,decreasing,decumben,decurrent,digestion,dorsally,eaf,edge,eed,enzyme,erect,exceeding,flat,folded,geminat,glabrou,greatly,homostylous,honeycomb-shaped,interjected,lanceolate,leaflet,lengthening,living,lower,membranous,middl,minutely,mottle,nflorescence,pair,pentagonal,perfect,petiolule,plurifoliate,pore,poricidal,removed,rotate-pentagonal,ruit,sessile,seudostipule,size,slit,spaced,specimen,stamen,ste,stigma,straight,subequal,tall,tamen,tem,tip,tri-,truncate,tube,typically,unit,unwinged,vary,wide,wing,yellow,ympodial	2,abaxial,adaxial,arrangement,branching,calyx,characteristic,colour,form,growth,height,inflorescence,length,margin,middle,midvein,mottled,na,ovary,primary,pseudostipule,shape,staman,surface,tertiary,texture,unarmed,vein,venation
320	wfo-0001029552	success	161	102	77	84	25	0.478	.5,0.1-0.5,0.6-1,1-1.3,1-1.5,1-3,1-5,1.5-2,12,2-2.5,2.5-3,5-10-flowered,6-9,abaxial,abaxially,acuminate,acute,adaxially,along,anther,apex,base,berry,branched,broadly,calyx,cm,corolla,decurrent,deltate,dendritic,densely,dia,elliptic,erect,filament,flattened-reniform,glabrous,globose,green,incrassate,inflorescence,lateral,leaf,lobe,long,long-styled,main,margin,minutely,mm,occasionally,ovary,pair,paler,pedicel,petiole,pitted,pubescent,shape,shining,short-styled,shrub,simple,small,somewhat,sparsely,stem,style,surface,tan,tree,tree-like,trichome,vein,white,wide	.25,0.5,1-2,1.5-6.5,10-20,2-9,5.5-8,abruptly,anthesi,area,bark,broadened,clavate,closely,conical,contracted,deflexed,denser,differing,difoliate,drying,eaf,edicel,eed,exserted,flower,free,fruiting,geminat,greyish-brow,heteromorphic,inflorescenc,lamina,later,like,lobed,lon,lower,major,middle,minor,minute,nearly,nflorescence,older,onto,opposite,orbicular,overlappin,pale,papillo,persistent,planar,pore,poricidal,portion,present,reflexed,rest,rounded,ruit,scar,scattered,shaped,size,slender,slightly,spaced,stigma,strongly,swollen,tall,tear-drop,tip,tub,tube,ud,unit,widest,woody,x,yellowish,ympodial,young	adaxial,alternate,arrangement,branching,characteristic,colour,diameter,form,fruit,growth,height,length,midvein,na,peduncle,plant,primary,pseudostipule,rachi,seed,staman,tertiary,texture,unarmed,venation
321	wfo-0001029584	invalid_json	180	135	99	81	36	0.55	1,1-2,1-6,1.5-6.5,2-3,2-4,3-10,3-7,4-14,4-15,6-7,7-14,8-15,abaxially,acumen,acuminate,acute,adaxially,anther,apex,articulated,asymmetric,axillary,base,basiscopic,brownish,bud,cell,clavate,cm,condition,connivent,coriaceous,corolla,covering,dark,densely,diameter,distal,drying,elliptic,filament,flower,forked,fresh,fruit,generally,glabrescent,glabrous,green,green-white,greenish,hair,hair-like,half,herb,lateral,leaf,light,linear,lobe,long,make,margin,middle,mm,mucilaginous,oblong-lanceolate,odd-pinnate,ovate,ovoid,pedicel,peduncle,petiole,petiolulate,plant,poricidal,proximal,pubescent,purple,seed,short,side,simple,stigma,style,subtending,terminal,testal,thick,throughout,tip,tissue,usually,wall,wet,white,whitish,yellow	0-30,1-3,16.2-33,2.4-6.3,3-5,4-5,4.5-11.5,5-merou,5.3-13.3,6.1-9.4,9.7-23.4,9.8-17,ag,alyx,apart,apparently,attenuate,axe,blade,borne,capitat,considerably,decreasing,dense,digestion,dorsally,eaf,edge,eed,end,enzyme,erry,finer,flat,folded,geminat,hal,homostylous,honeycomb-shaped,interjected,larger,leaflet,lengthening,living,lower,nflorescence,orbicular,orolla,pair,pentagonal,perfect,plurifoliate,pore,present,removed,second,semi-erec,sessile,seudostipule,singly,size,slit,spaced,specimen,stolo,straight,substellate,tall,tamen,tem,toward,tri-,tube,tuber,typically,unit,unknow,unwinged,vary,x,ympodial	'',2,[,``,abaxial,adaxial,arrangement,branching,calyx,capitate,characteristic,colour,form,growth,height,inflorescence,length,midvein,na,ovary,primary,pseudostipule,rachi,shape,staman,stem,surface,tertiary,texture,unarmed,unknown,value,vein,venation,{,}
322	wfo-0001029593	success	181	121	95	86	26	0.525	0.5-1,0.5-5,0.8-1.2,1,1-1.2,1-1.5,1-8,1.6-2.3,100,2-14,2.3-3.0,3-4,35-60,4-6,5-10,5-15,abaxially,acuminate,acute,anther,anthesi,anticlinal,apex,apically,arising,attenuate,axil,axillary,base,basiscopically,bearing,berry,brown,calyx,cm,conical,deltate,densely,diameter,elliptic,enlarged,filament,filiform,flower,fruit,glabrous,globose,green,half,irregular,leaf,lobe,long,lower,markedly,minutely,mm,oblique,obovate,occasionally,once-branched,ovary,ovoid-reniform,pair,papillose,pedicel,per,petiole,pinnate,plant,pointed,primary,projection,pubescence,pubescent,rachi,rest,scar,seed,shape,shrub,simple,sinuous,smooth,somewhat,sparsely,style,surface,thickening,trichome,uniseriate,vein,without,woody,x	-10,0.05,0.8-1,1-2,10-50,2,2-3,2-5,2.3,3.5-8,7-25,7.5-15,9-15,abruptly,adaxially,age,always,basal,broadly,capitate,cateniform,cell,clavat,colony,cone,decurrent,dry,drying,eaf,edicel,eed,entire,epidermal,exserted,extremely,free,fruiting,glabrescent,growing,hollow,included,lamina,large,lateral,leaflet,much,narrowing,nflorescence,noddin,often,onto,open,opposite,perfectly,petiolule,place,poricidal,portion,pubescen,purple,rarely,reflecting,ruit,short-styled,similar,single-stemmed,slightly,small,smaller,stigma,tall,tem,terminal,tip,tub,tube,ud,unifoliat,unit,usually,variable,white,white-lenticellate,wider,winged,ympodial	abaxial,adaxial,arrangement,branching,characteristic,colour,corolla,form,growth,height,history,inflorescence,length,life,margin,midvein,na,nodding,peduncle,pseudostipule,staman,stem,tertiary,texture,unarmed,venation
323	wfo-0001029601	invalid_json	187	134	95	92	39	0.508	0.2-0.8,0.5-5.8,1-2,1-3,1-4,1-53,2,2-12,2-9,2.3-5.9,3-10,3-7,5-41,6-10,abaxially,acuminate,acute,adaxially,anther,apex,articulated,asymmetric,attenuate,axillary,base,basiscopic,berry,brownish,bud,cell,cm,condition,coriaceous,corolla,covering,dark,diameter,distal,dot,drying,elliptic,filament,flower,forked,fresh,fruit,generally,glabrescent,glabrous,globose,green,green-white,greenish,hair,hair-like,half,herb,lanceolate,lateral,leaf,light,lobe,long,make,middle,mm,mucilaginous,odd-pinnate,ovate,ovoid,pedicel,peduncle,petiole,petiolulate,plant,puberulent,ripe,rounded,seed,short,side,slightly,small,style,subtending,terminal,testal,thick,throughout,tissue,usually,wall,wet,white,whitish	0-37,0.5-8,1.1-2.7,1.2-2.3,1.7-6.5,2-3,2-7,2.2-4.5,2.8-10.5,3-5,4-13.5,5-merou,6.6-22,6.8-14.5,abaxiall,acumen,ag,alyx,apart,apparently,axe,blade,borne,capitat,clavate,connivent,decreasing,digestion,dorsally,eaf,edge,eed,end,enzyme,erec,exceeding,flat,folded,geminat,glabrou,homostylous,honeycomb-shaped,interjected,larger,leaflet,lengthening,linear,living,lower,middl,narrow,nflorescence,orbicular,orolla,pair,pentagonal,perfect,plurifoliate,pore,poricidal,removed,rotate,ruit,sessile,seudostipule,singly,size,slit,spaced,specimen,stamen,stigma,stolo,straight,subequal,subglabrou,tall,tamen,tem,tip,toward,tri-,tube,tuber,typically,unit,unwinged,vary,wing,x,yellow,ympodial	'',[,``,abaxial,adaxial,arrangement,branching,calyx,characteristic,colour,form,growth,height,history,inflorescence,length,life,margin,midvein,na,ovary,perennial,primary,pseudostipule,rachi,shape,staman,stem,subglabrous,surface,tertiary,texture,true,unarmed,value,vein,venation,{,}
324	wfo-0001029621	success	165	103	75	90	28	0.455	0.5-0.75,0.7-1.1,0.8-1,1-1.5,1.5-2,1.5-2.5,1.5-5,2.5-3,3-3.5,3.5-4.5,6-8,7-9,acute,anther,apex,appearing,attenuate,base,becoming,berry,branched,brown,calyx,cm,corolla,dark,decurrent,deltoid,dry,erect,filament,fleshy,fruit,glabrous,globose,green,irregularly,lanceolate,later,lateral,leaf,live,lobe,many,margin,material,minutely,mm,oblanceolate,often,ovary,ovoid-reniform,pair,pale,pedicel,pitted,plant,puberulent,ripe,sessile,shrub,stem,straight,style,surface,tan,terminal,thick,time,vein,white,whorl-like,woody,x,yellowish	.1,0.5-1,0.5-1.2,0.5-1.5,0.8-4.5,1-2,1/3,2/3,5-20-flowered,6-20,accrescent,along,anthesi,apar,appressed,area,bark,beneath,borne,caudate,cluster,completely,constricted,course,cup-shaped,densely,dia,distal,eaf,edicel,eed,ellipsoid,elongate,enclosed,exsertio,free,fruiting,geminate,glabrate,late,like,lobed,lon,long,lower,main,merely,middle,nflorescence,occasionally,older,onto,papillate,papillo,papillose,planar,plurifoliat,pore,poricidal,portion,prominent,quite,rarely,reddish,reddish-gre,river,ruit,scar,shaped,shiny,small,somewhat,spaced,ste,stigma,tall,tapering,tear-drop,tip,trichome,tube,ud,uniseriate,unit,way,widened,widest,yellow,ympodial,young	abaxial,adaxial,arrangement,branching,characteristic,colour,diameter,form,growth,height,history,inflorescence,length,life,midvein,na,peduncle,petiole,primary,pseudostipule,rachi,seed,shape,staman,tertiary,texture,unarmed,venation
325	wfo-0001029622	success	182	84	61	121	23	0.335	.1,.5,0.5-1,0.6-0.9,0.8-1,1-1.2,1.5,2.5-3,3-4,3-5,30-35,4-6.5,5-6,acute,anther,apex,attenuate,base,brown,calyx,chartaceous,cm,corolla,deflexed,diameter,elliptic,entire,filament,flower,fruit,glabrous,globose,green,inflorescence,leaf,lobe,long-acuminate,long-triangular,margin,mm,narrowly,ovate,pair,pedicel,peduncle,petiole,rachi,raised,reddish,rounded,shiny,shrub,simple,single,slightly,stem,style,tapering,vein,white,x	.2,/3,0.3,0.5,0.5-0.7,1-1.5,1-2.7,1-4,2-11,2-4,2-5,40,45-50,7-11,abaxially,absent,accrescent,adaxially,ag,alyx,anthesi,apparently,appearing,arising,axe,axil,bark,beneath,blade,bud,capitat,connivent,consisting,cylindrical,deciduous,differing,difoliate,dimorphic,eaf,eed,elongate,except,free,fruiting,geminate,glabrou,ilament,immature,included,interlaced,internodal,jointed,known,lamina,lateral,less,lobed,long,longitudinal,m.,main,major,mature,measured,midrib,minor,minute,minutely,nflorescence,obconic,oblong,occasionally,often,older,one,onto,opening,opposite,orolla,oung,ovate-lanceolate,papillose,pendent,pore,portion,present,probably,reflexed,remaining,ruit,sagittate,scar,second,shaped,size,slende,slender,slit,somewhat,stellate,stigma,straight,tal,tear-drop,thin,thus,tip,trichome,tube,tuft,ud,unarme,unifoliat,uniseriate,unit,vary,way,within,yellow,ympodial,young	0,abaxial,adaxial,arrangement,characteristic,colour,form,growth,hair,height,length,midvein,na,ovary,plant,primary,seed,shape,staman,surface,texture,unarmed,ye
326	wfo-0001029625	success	168	88	75	93	13	0.446	..,.1-0.2,0.5-1,0.5-1.3,0.8-1.4,1-1.5,1-2,1-3,1.2-1.6,2,3,3-,3-3.5,4-4,4-7-celled,4-9,5,5-6,5-8,abaxial,anther,bark,beneath,branch,branched,calyx,cm,corolla,darker,deltate,densely,diameter,elliptic,filament,flattened,four,fruit,glabrescent,globose,green,greenish,growth,herb,inflorescence,later,lobe,long,mm,occasionally,ovate-reniform,pale,papillate,pedicel,peduncle,point,pubescent,purplish,reddish,shrub,single,small,smooth,sparsely,stem,stripe,style,surface,tan,time,tinged,trichome,tube,uniseriate,white,young	-15,.5,0.5-2,0.5-2mm,0.8-1.8,100,2.5-.,3-3,4-10,4-5-celled,5-10,6-9,8-13,9-25,along,anthesi,apical,base,branc,brittle,brow,capitat,cel,cell,conical,cucullate,deflexe,deflexed,denser,distinct,dry,eaf,edicel,eed,erect,flower,frui,fruiting,glabrous,gland,gland-tipped,glandular,hyaline,lamina,lighter,like,lobed,lower,margin,markedly,middle,midline,minute,mixed,narrowly,nearly,new,nflorescence,open,outer,outline,ovary,pair,per,pericarp,planar,plurifoliat,pointed,primary,rarely,regularly,ruit,scar,scattered,single-stemmed,sinuate,slightly,stigma,striate,strongly,testa,thin,tip,triangular,tuft,ud,unit,vein,wall,weight,without,x,ympodial	arrangement,brown,characteristic,colour,form,height,leaf,length,plant,plurifoliate,seed,shape,texture
327	wfo-0001029645	success	160	111	92	68	19	0.575	0.2-0.5,0.3-0.5,0.5-7,1-1.5,1-2,1-4,1.5,2.5-4,3-10,3-15,3-7,3.5-4,337,5-8,6-12,7-12,750,?,abaxially,abundantly,acuminate,adaxially,along,anther,apart,apex,articulated,base,blue,brown,calyx,chartaceous,cm,corolla,cuneate,cylindrical,decurrent,deltate,diameter,entire,et,extra-axillary,fide,filament,finger,flattened,flower,fruit,glabrous,gland-tipped,globose,green,greenish,hair,herb,immature,kayap,line,lobe,margin,membranaceous,minutely,mm,moderately,ovate,ovate-elliptic,pedicel,peduncle,perfect,petiole,puberulent,purple,rachi,rarely,red,rugose-verrucate,sand-punctate,simple,smith,spaced,sparsely,stigma,style,subcordate,triangular,truncate,unbranched,veiny,white,wide,x,Â±	-1,.5-1,0.5-2.5,1,1.3-7,1.5-2,2-3-foliat,2-4,2.5-17,4-5,4-8,5,acute,aggregate,around,axe,ba,blade,cell,connivent,directed,distall,distally,eaf,eed,except,free,glabrou,inserted,knapp,long,lower,major,mesocarp,nearly,nflorescence,obtuse,orolla,part,pore,puberulen,radiu,rotate-stellate,ruit,sagittate,short,short-tomentose,shorter,shru,side,small,stone,strongly,tal,tamen,tapered,tem,thecae,tightly,time,tomento,truncat,tube,unit,vary,vein,yellow,ympodial	0.5-1,arrangement,characteristic,colour,form,growth,height,inflorescence,leaf,length,ovary,plant,seed,shape,shrub,staman,stem,surface,texture
328	wfo-0001029646	invalid_json	141	104	65	76	39	0.461	0.1-0.6,0.5,0.7-2.2,1-4,1.5-2,10-15,2-3,4-5.5,5-15,6-8,acuminate,acute,apex,articulate,attenuate,base,branched,calyx,cell,cm,corolla,covering,cyme,diameter,dichasial,dichasially,distal,ebracteate,elliptic,filament,finely,globose,green,green-white,hair-like,herbaceous,lateral,leaf,lobe,long,mm,monochasial,mucilaginous,mucronate,narrowly,ovate,ovoid,pedicel,peduncle,perennial,petiole,plant,proximal,pubescent,seed,simple,style,testal,thick,throughout,tone,wall,white,yellow-green,Â¼	0.5-0.8,1.5-4.9,3-14,3-6-foliat,7-15,abaxially,acumen,adaxially,apical,apically,commonly,dehiscent,digestion,dorsally,eaf,edge,eed,emoval,enzyme,epiphytic,equaling,flat,flower,folded,forked,free,generally,globo,ground,growing,half,honeycomb,introrse,linear,living,lon,lower,make,maturing,mos,mould,nflorescence,nther,oak,often,orolla,ovat,pattern,perfect,pine,plan,poricidally,rarely,reveal,ruit,seudostipule,short,slit,specimen,stamen,stellate,stigma,straight,tall,tem,throughou,tree,tuber-bearing,typically,unit,vary,viole,wide,without,yellow,ympodial	'',[,``,abaxial,adaxial,anther,arrangement,branching,characteristic,colour,form,fruit,growth,height,history,inflorescence,length,life,margin,midvein,na,ovary,primary,pseudostipule,rachi,shape,staman,stem,surface,tertiary,texture,unarmed,value,vein,venation,violet,wet,{,}
329	wfo-0001029652	success	160	102	72	88	30	0.45	.5,0.5-1,0.5-4,0.75-1,0.8-1,1-3,1.5-2,2-2.5,2.5-3,3.5-4,4-4.5,7-9,abaxially,adaxially,anther,apex,apical,attenuate,base,berry,broadly,calyx,cm,corolla,curling,deflexed,deltate,elliptic-ovate,filament,filiform,glabrous,globose,golden,green,greenish-white,hispid,leaf,lobe,long-acuminate,long-styled,margin,minute,minutely,mm,narrowly,near,occasionally,ovary,ovoid-reniform,pair,pale,pedicel,petiole,pitted,projection,pubescent,short-styled,shrub,simple,slender,stem,style,surface,swollen,tan,tip,trichome,undulate,uniseriate,vein,white,x	.25,.3,1,1-2,2,2-4,25,3/4,6-15,along,anthesi,apar,ape,arch,arching,ba,bark,bearing,cone,conical,deciduous,denser,dia,differing,difoliate,drying,eaf,edicel,eed,evenly,exserted,flower,free,fruiting,geminat,golden-red,hard,heteromorphic,included,joining,lamina,lateral,like,lobed,lon,long,lower,main,major,maturity,middle,midrib,minor,nflorescence,older,opposite,papillo,papillose,pericarp,pore,poricidal,portion,reddish-brown,reflexed,ruit,scar,series,shaped,size,slende,slightly,soon,spaced,sparsely,stigma,tall,tear-drop,thickened,time,tub,tube,ud,unit,way,widest,within,ympodial,young	0.5,abaxial,adaxial,arrangement,branching,characteristic,colour,diameter,form,fruit,growth,height,history,inflorescence,length,life,midvein,na,peduncle,plant,primary,pseudostipule,rachi,seed,shape,staman,tertiary,texture,unarmed,venation
330	wfo-0001029673	success	159	99	76	83	23	0.478	0.5-1,0.7-1.1,0.8-1,1-10,1-2,1-5,1.5-2,10-20,2-2.5,2.5,4-6,abaxial,acuminate,acute,adaxial,anther,apex,appearing,base,berry,black,branch,branching,calyx,cm,corolla,deep,deltoid,dendritic,densely,diameter,elliptic,filament,fork,fruit,glabrous,globose,greyish,greyish-yellow,growth,later,lateral,leaf,length,lenticular,lobe,long,minutely,mm,monochasial,narrowly,occasionally,ovary,overtopping,pair,pedicel,petiole,pitted,pubescent,purple,reddish-brown,shoot,shrub,small,sparsely,stem,style,surface,terminal,tree,triangular,trichome,vein,violet,winged,x	.5,0.75-1,1.2-3.5,1.5-1.8,2-3,2-4,3-5,3/4,5-25,5.5-15,abaxially,absent,accrescent,adaxially,age,along,anthesi,apical,bark,basal,becoming,blade,broadly,clavate,conical,decurrent,deflexed,denser,dichasia,eaf,edicel,eed,ew,exserted,flower,free,fruiting,greyish-yello,individual,inserted,lamina,like,lon,longer,lower,m.,nflorescence,nodding,older,papillo,pericarp,petal,planar,plurifoliate,pore,poricidal,portion,prominent,pyramidal,reflexed,ruit,scar,secondary,sleeve,slightly,slit-like,somewhat,stamen,stigma,strongly,tall,tapering,thin,time,tip,tub,tube,ud,unit,wide,woody,ympodial,young	3.5,arrangement,characteristic,colour,dichasial,form,height,inflorescence,margin,midvein,na,peduncle,plant,primary,pseudostipule,rachi,seed,shape,staman,tertiary,texture,unarmed,venation
331	wfo-0001029680	success	212	122	103	109	19	0.486	0.1,0.5â1.5,0.6â1.2,1.0â1.1,1.0â1.5,1.0â1.8,1.1â1.2,1.7â7,1.8â3.8,11â16,11â25,12,1â2,2.2â4.2,3.0â4.2,3.3â5.5,3â6,4.0â6.5,4.5â20,4.5â7.0,4â10,50,5â11,abaxially,acute,adaxially,annual,anther,anthesi,apart,apex,articulated,axillary,base,becoming,bipinnate,blue,borne,branched,brown,calyx,cm,cylindrical,decurrent,diameter,divided,filament,flattened,fleshy,fruit,glabrous,globose,green,herb,leaf,length,light,lobe,long,margin,mm,moderately,oblong,obovate,obtuse,ovate,pair,pale,pedicel,peduncle,pendant,petiole,pinnae,pinnate,pitted,primary,pubescent,purple,rarely,red,ripe,shallowly,shoot,sometimes,spaced,sparsely,stem,straight,style,subglabrous,surface,terminal,time,tripinnate,turning,violet,white,winged,woody,x,â10,â12.5,â3	.0,0.4,0.6,0.6â2.0,0.9â1.0,1,1.0,1.4â2.5,1.4â7.5,1.5,1.6â2.7,10,1â3,1â6,1â8,2â20,3â22,4.0â16,4â30,5,5.5â8.5,7â10,8â32,absen,adaxiall,ag,along,appressed,arequipa,arranged,asymmetrically,axe,ba,beyond,blade,cell,clavate,connivent,decreasing,densely,difoliate,eaf,eed,entire,equal,erect,extending,flange,flower,forming,geminat,hair,indistinct,irregularly,lon,longitudinal,lower,m.,midrib,multicellular,narrow,nflorescence,node,occasionally,often,opening,orolla,parallel,pentagonal,perfect,plurifoliate,pore,poricidal,prostrate,rapidly,rotate,ruit,running,secondary,shaped,side,simple,size,specimen,split,stigma,stone,tacna,tal,tamen,tear-drop,tem,tertiary,tip,tube,unicellular,uniseriate,unit,usually,vary,wide,wing,winge,yellow,ympodial,â19,â3.2,â46,â48	arrangement,branching,characteristic,colour,corolla,form,growth,height,history,inflorescence,life,na,ovary,plant,seed,shape,staman,texture,unarmed
332	wfo-0001029704	success	146	96	78	68	18	0.534	0-1.5,1.5,1.5-2.5,1.5-3,1000-1200,2-2.5,2-3,2-5,3-5,4,5,7-10,acuman,acuminate,acute,anther,anthesi,apex,base,berry,blue,branch,broadly,brown,calyx,cm,composed,conical,corolla,cuneate,dark,deeply,ellipsoid,extra-axillary,few-flowered,filament,flower,fork,fruiting,glabrous,globose,green,halfway,leaf,less,lobe,lobed,long,minutely,mm,mottled,obovate,occasionally,one,ovary,pedicel,peduncle,petiole,pinnatisect,pubescent,purple,record,reddish,reticulate,rounded,short,shrub,simple,single,stellate,stigma,striped,style,subdiscoidal,surface,trichome,variously,white	-17,-3,.5,0.5,1,1-2,1-4,10-14,140-185,15-25,3-4-celled,4-7,7-,9-20,along,also,apparently,aspect,axi,c.,cell,cunate,cut,deflexed,dia,diam,eaf,eed,enlarged,erect,especially,exerted,flowering,gradually,lanceolate,lengthening,lower,midrib,minute,moderately,nflorescence,obovoid,plurifoliat,pore,poricidal,ruit,shoot,sinus,slit,sombre,sprawling,stone,stout,straight,subglobo,swollen,tip,tub,tube,twig,ud,unit,variable,vein,within,x,ympodial,young	arrangement,characteristic,colour,diameter,form,fruit,growth,height,inflorescence,length,plant,plurifoliate,seed,shape,stem,subglobose,texture,type
333	wfo-0001029727	success	260	98	80	180	18	0.308	-3,0-30,0-4,0.4-1,0.7-0.9,1-1.2,1-4,1.6-3,1/3-1/2,1/4,2.8-4,3-6,3-7,4.5,5.5-7,abaxial,acuminate,acute,adaxial,anther,anthesi,apex,apically,articulated,base,berry,calyx,chartaceous,climber,cm,cordate,corolla,densely,diameter,erect,filament,filiform,finely,glabrous,lateral,leaf,length,lobe,lobed,long,lower,margin,mauve,midvein,mm,moderately,orange-brown,ovate,pair,pedicel,peduncle,per,petiole,pitted,primary,raised,red-brown,rounded,seed,shallowly,shape,shrub,simple,stellate-pubescent,stem,style,subentire,surface,terminal,tertiary,unarmed,upper,vein,venation,visible	-1/3,-10,.5,/3,0-15,0-2,0-20,0-40,0-5,0-8,0.1-5,0.15-0.2,0.15-0.3,0.2,0.2-0.5,0.2-2.5,0.3,0.4,0.5,0.5-1.2,0.5-3,0.7-1,1,1-,1-2,1.2-2,1.5-2.3,1.5-2.5,1.5-3,1.5-5.5,1/2-2/3,1/8-1/5,2-5,2.5,2.5-3.2,2.5-5.5,3-11,3/,4-7,4-merou,4-merous,4.5-,5-12,5-8,5-9,6-11,7-10,abaxially,acicular,age,almost,along,alternate,alyx,ame,apar,apart,apparently,bark,blade,branched,bristle,brown,c.,clavate,colourles,connivent,covered,cupular,curved,darker,deltate,deltoid,developing,different,dimorphic,discolorous,divided,drying,eaf,edge,eed,elongating,equal,except,extending,ferrugineous,filiform-acuminat,fissure,flattened-reniform,flower,free,geminate,increasing,inside,lengthening,less,like,lon,longer,m.,mature,middle,midpoint,minor,minutely,mixture,narrow-deltate,nflorescence,nther,obconical,oblong,occasional,older,one,open,orolla,oung,outside,papillo,papillose,perfec,perfect,pit,plurifoliat,pore,poricidal,porrect,portion,prickl,prickle,prickly,protruding,pubescent,rarely,ray,red-brow,reddish,reduced,regular,scandent,scar,series,sessile,short,sinus,size,smooth,sometimes,spaced,spreading,stalk,stalked,stellate,stigma,straight,strongly,tamen,tapering,tearing,terete,time,tip,toward,translucent,transverse,trichome,tube,uneven,unit,variable,variously,vary,violet,way,wide,x,yellowish,ympodial,young	3/4,arrangement,branching,characteristic,colour,false,form,fruit,growth,height,inflorescence,na,ovary,plant,pseudostipule,rachi,staman,texture
334	wfo-0001029731	success	246	116	100	146	16	0.407	.5,1,1-2,1-2.5,1.5,1.5-2.5,2.5,3-4,4-5,4-9,6-7,7-11,8-9,acquiring,acuminate,acute,along,anther,apex,apically,base,berry,black,branch,branched,branching,broadly,brown,calyx,cm,conical,coriaceous,corolla,crinkled,cuneate,deltoid,diameter,dilated,distributed,drying,elliptic,entire,epiphyte,erect,evenly,faint,filament,filiform,flattened,fleshy,fruit,glabrous,lateral,leaf,less,liana,linear,lobe,long,long-ellipsoid,margin,mauve,midvein,mm,obovate,obtuse,often,orange-brown,pair,papillae,pedicel,peduncle,pendulous,petiole,primary,pyriform,rachi,rarely,revolute,ridged,rounded,slender,sometimes,sparsely,stem,straight,style,succulent,surface,terminal,thick,tuft,usually,vein,visible,white,wide,woody,x,yellow-green	.6,0.05,0.1-0.8,0.25-0.3,1-1.5,1.5-3,1/3,10-20,1994,2,2-3,2-6,2.5-4.5,3,3-10,31,4,6,abaxially,accrescent,adaxially,age,almost,alyx,anthesi,apar,apparently,arcy,articulated,bark,basal,basally,beak,becoming,boundary,bumpy,clavate,clearly,concolorous,connate,darker,delimited,delineated,dense,development,different,domatia,dorsal,dorsifixed,dry,dull,eaf,early,elongating,enlarge,equal,even,exserted,fine,finely,flaring,flower,free,fruiting,ground,hair,iscoid,lamina,large,later,lengthening,like,lobed,lon,longitudinal,longitudinally,lower,main,mature,maturity,much,narrowly,nflorescence,nther,obconical,oblong,occasionally,orolla,papillose,part,perfec,pericarp,persisting,plurifoliat,pore,poricidal,portion,prominent,protruding,raised,rakotozafy,reflexed,reported,ribbed,ridge,ruit,scar,see,several,shallowly,shorter,simple,sinus,slightly,small,smaller,smoot,stigma,stretched,stump,sunk,tearing,thickened,thinner,though,time,tip,toward,trichome,tub,tube,ud,unit,vary,venation,ventral,visibl,well-developed,widely,wing,winged,wrinkling,yellow,ympodial,young,â	abaxial,adaxial,arrangement,characteristic,colour,form,growth,inflorescence,length,na,ovary,seed,shape,staman,texture,unarmed
335	wfo-0001029741	success	137	92	64	73	28	0.467	.4,.5,0.9-1.2,1-1.5,1-3.5,1.1-1.3,1.5-4,1.5-6,10-50-flowered,?,acute,age,anther,apex,apiculate,attenuate,base,becoming,berry,black,calyx,cm,completely,corolla,dark,deltoid,dia,drying,elliptic,filament,fruit,furcate,glabrous,globose,green,growth,immature,inflorescence,leaf,lenticellate,lighter,lobe,long,minutely,mm,opposite,ovary,ovate,papillose,pedicel,petiole,shrub,slender,stem,straight,style,tapering,tree,tube,usually,vein,weak,white,x	0.5-1.5,0.8-3.5,1.5,2-2.5,2.2-9,2.5-7.8,3,9.5-22.5,accrescent,anthesi,branched,ca,caly,capitate,closely,deflexed,differing,difoliate,divisio,dry,eaf,early,edicel,eed,erect,exserted,flower,free,fruiting,geminat,glabrou,known,lateral,lobed,lon,lower,main,major,middle,minor,nearly,new,nflorescence,overlapping,pair,papillo,planar,pore,poricidal,portion,produced,prominent,proximal,quite,raised,reddish-brown,ruit,scar,shaped,size,slightly,spaced,stigma,tall,tear-drop,tip,ud,unit,variable,widest,wood,woody,ympodial	abaxial,adaxial,arrangement,branching,characteristic,colour,diameter,form,height,history,length,life,margin,midvein,na,peduncle,plant,primary,pseudostipule,rachi,seed,shape,staman,surface,tertiary,texture,unarmed,venation
336	wfo-0001029744	success	113	84	69	44	15	0.611	0.3-0.6,0.5-1,1.5,2-4,5-8,50,8-10-flowered,acute,apart,apex,bark,base,beginning,blunt,branch,calyx,cm,deltate,dendritic,densely,difoliate,elliptic,entire,extreme,flattened,flexuous,form,geminate,glabrescent,glabrous,golden,incrassate,lanceolate,leaf,lobe,long-acuminate,margin,minutely,mm,narrowly,node,non-reproductive,oblanceolate,oblique,occasionally,older,ovoid-reniform,pale,pedicel,petiole,pitted,pubescence,pubescent,revolute,scar,shape,shrub,simple,single-celled,slightly,sometimes,somewhat,stem,surface,thin,tip,trichome,unifoliate,uniseriate	1,1.5-3.2,2,7-15,8-11,abaxially,adaxially,along,brow,denser,distinct,eaf,eed,examined,fide,fruit,inflorescenc,lamina,leave,looping,lower,major,marginal,mature,minor,nflorescence,opposite,pair,primary,see,similar,small,smaller,smith,spaced,thee,ud,unicellular,unit,vein,white,x,ympodial,young	abaxial,adaxial,arrangement,brown,characteristic,colour,growth,height,inflorescence,length,plant,seed,spacing,texture,width
337	wfo-0001029746	success	179	89	71	108	18	0.397	0.3-2,0.7-1,1,1-1.3,1-1.5,2-2.5,2-8,3,3-4,8-10,8-11,acuminate,acute,anther,apex,base,berry,brown,calyx,centre,cm,conical,cordate,corolla,dark,darker,densely,diameter,elliptic,entire,filament,flattened,fleshy,fruit,glabrous,glandular,globose,greenish,herb,hollow,inflorescence,internodal,leaf,lobe,margin,mm,narrowly,orange,ovary,ovate,ovoid,pale,pedicel,peduncle,petiole,pitted,principal,pubescent,purple,rachi,red,reddish,shallowly,simple,sparsely,stem,style,subshrub,surface,vein,x	.5,0.5-1,1.2-1.5,1.5,2,2-4,2-7,3-4-pluri-foliate,3-4.5,3-6,4-9,6,6-7,abaxially,adaxially,age,anthesi,apart,bearing,becoming,blackish,broadly,c.,capitate,cell,ciliate,color,crenate,crowded,cup-shaped,curved,eaf,edicel,eed,ellipsoid,enlarged,erect,exerted,flower,flush,free,fruiting,gland-tipped,growing,heteromorphic,horn,irregularly,lamina,lengthening,less,lon,long,longer,longest,lower,markedly,mature,maturit,mid-length,minutely,mixed,near,nflorescence,nodding,occasionally,pair,papillo,papillose,pericarp,plan,pore,poricidal,portion,primary,pubescen,reflexed,ruit,scar,shortest,single,slender,slightly,slit,somewhat,spaced,sparse,spreading,stigma,straight,strongly,testal,thin,third,tip,triangular,trichome,tube,ud,uniseriate,unit,upper,upward,wall,widely,widest,woody,ympodial,â3	1.5-3,abaxial,adaxial,arrangement,branching,characteristic,colour,form,growth,height,length,na,plant,seed,shape,staman,texture,unarmed
338	wfo-0001029769	success	142	112	90	52	22	0.634	.25,.5,0.5-1.5,1-1.2,1-3,1.5-2,1.5-2.5,30-60-flowered,4,5-8,6-17,7-8,abaxially,acuminate,acute,adaxially,along,anther,apex,bark,base,bearing,berry,brown,calyx,capitate,cm,conical,corolla,curl-tipped,cyathiform,dark,deflexed,deltoid,densely,dia,elliptic,filament,filiform,flower,fresh,fruiting,glabrous,globose,golden,green,horizontally,leaf,like,lobe,long,main,margin,midrib,minutely,mm,onto,ovary,ovoid-reniform,papillose,pedicel,petiole,pitted,pore,poricidal,puberulent,pubescent,scattered,shaped,shrub,simple,smooth,somewhat,sparsely,stem,stigma,style,surface,swollen,tear-drop,three,time,tip,trichome,tube,two,uniseriate,vein,white,winged	2.5-3,2.5-8,3.5-4,4-5,8-9,8.5-17,anthesi,apar,ape,archin,ba,branch,brochidodromu,cerro,eaf,edicel,eed,exserted,free,hen,inglÃ©,internodal,lateral,less,lobed,lon,lower,nearly,nflorescence,older,opposite,pair,papillo,portion,reflexed,ried,ruit,scar,spaced,straight,tall,tub,ud,unevenly,unifoliat,unit,wide,widely,woody,x,ympodial,young	arching,arrangement,branching,characteristic,colour,diameter,dried,form,fruit,growth,height,inflorescence,length,peduncle,plant,pubescence,seed,shape,specified,texture,type,unifoliate
339	wfo-0001029780	invalid_json	204	121	88	116	33	0.431	1-2,15-22,15-45,2-2.8,2-3.5,2-5.5,4-6,4.5-6,5-7,8-12,absent,acute,anther,apex,articulated,attenuate,axillary,base,berry,brownish,bud,cell,chartaceous,cm,condition,cordate,corolla,covering,cuneate,dark,densely,diameter,distal,drying,filament,flower,forked,fresh,fruit,generally,glabrous,globose,green,greenish,hair,hair-like,half,herb,high,invested,lateral,length,like,lobe,long,margin,membranous,minute,mm,non-glandular,obtuse,odd-pinnate,ovate,ovoid,pale,pedicel,peduncle,petiole,pinkish,plant,pubescent,seed,short,stem,streak,stripe,style,subtending,terminal,testal,thick,trichome,truncate,usually,wall,white,whitish,yellow	1-1.2,1-10,1.4-1.9,1.5-2,11-24,120-210,2-12,2-2.5,2.4-4.2,20-60,3,3-6,3.5-7.3,5-merou,5.5,5.5-13,50-70,600-950,?,abaxially,acumen,adaxially,ag,along,alyx,apart,apparently,axe,blade,borne,capitat,ciliate,connivent,decumbent,digestion,dorsally,eaf,edge,eed,end,enzyme,erec,especially,exceeding,except,flat,folded,geminat,glabrou,gland,glandular,greatly,green-white,hal,head,homostylous,honeycomb-shaped,interjected,lanceolate,leaflet,lengthening,living,longer,lower,make,midrib,minutely,mucilaginous,nflorescence,often,orbicular,orolla,pair,perfect,petiolulate,petiolule,plurifoliate,pore,poricidal,proximal,puberulent,rarely,reduced,removed,ripe,rotate,ruit,sessile,seudostipule,singly,size,slit,spaced,specimen,stamen,ste,stigma,stolo,straight,subequal,tall,tamen,tem,tetralobulate,throughout,tip,tri-,tube,tuber,typically,unit,unwinged,vary,wet,x,ympodial	'',2,[,``,abaxial,adaxial,arrangement,branching,calyx,characteristic,colour,form,growth,height,inflorescence,leaf,midvein,na,ovary,primary,pseudostipule,rachi,shape,staman,surface,tertiary,texture,unarmed,value,vein,venation,{,}
340	wfo-0001029784	success	237	136	115	122	21	0.485	-12,-5,.2,.5,0.2,0.25-0.3,0.4-0.45,0.5,0.5-1.5,0.6-1,1-1.1,1-1.2,1-4,1.7-2.6,2,2-2.5,2-3-celled,2-locular,2/3,5-10,abaxial,abaxially,acuminate,acute,adaxially,adpressed,along,anther,apex,appearance,arising,articulated,axi,base,brown,calyx,cell,cm,column,corolla,crenate-serrate,dark,densely,diameter,distal,due,eglandular,elliptic,exserted,filament,flower,fruit,giving,glabrescent,glabrous,glandular,globose,golden,green,hair-like,half,head,imparipinnate,included,inflorescence,interrupted,lanceolate,lateral,like,lobe,long,margin,maturing,mm,multicellular,narrowly,obovate,outgrowth,ovary,pale,paler,patent,pedicel,peduncle,perennial,petiole,plant,proximal,pseudostipule,pubescence,pubescent,rarely,ripe,scattered,silky,simple,soft,sparsely,staminal,stem,stout,stripe,style,surface,testa,trailing,trichome,truncate,uniseriate,unseriate,velvety,wall,white,winged,yellow	.1,0-4,0.1-,0.1-0.15,0.1-0.5,0.2-,0.2-0.3,0.2-0.5,0.3-0.35,0.3-0.4,0.3-0.5,0.3-1,0.4-,0.4-0.5,0.4-0.6,0.5-,0.7-1.2,0.9-1.2,1,1-,1-1.5,1-2,1-2-celled,1.0-1.3,1.2-2.5,1.5-,1/3,2-,2-4,2-4.5,2-foliate,2.5-3.5,3-,3-5,5-14,5-8,absent,abundant,angled,anthesi,apical,appendage,articulation,basal,basicopically,beneath,berry,bract,broadly,capitate,conical,crenation,decurrent,deeper,developed,distributed,eaf,edicel,eed,enclosing,entire,evenly,fruiting,gree,hal,halfway,herb,interjected,internode,interspersed,irregularly,lamina,larger,leaflet,live,lon,long-acuminate,loosely,lower,markedly,mostly,nflorescence,node,northern,occasionally,often,orbicular,pair,pentagonal,petiolule,population,present,primary,reflexed,robust,ruit,secondary,sessile,smaller,sometimes,somewhat,sparse,spreadin,sterile,stigma,straight,strongly,tem,terminal,tertiary,thick,tube,ud,undulate,unicellular,unit,usually,vein,wide,woody,x,ympodial	0.1,0.1-0.3,adaxial,arrangement,branching,characteristic,colour,form,growth,height,history,leaf,length,life,na,rachi,seed,shape,staman,texture,unarmed
341	wfo-0001029785	invalid_json	223	151	119	104	32	0.534	0.1-0.5,0.8-1,1-1.2,1-10,1-2,1-5,1.2-3.2,1.5-3.6,1.8-3.5,10-26,2-4,3-6,3-8,3.5-5,3.8-7.2,5-16,5-9,6,8-11,abaxially,absent,acute,adaxially,along,anther,apart,apex,articulation,attenuate,axillary,base,berry,brownish,bud,cell,chartaceous,cm,commonly,condition,corolla,covering,cuneate,dark,darker,denser,diameter,distal,drying,filament,flower,forked,fresh,fruit,generally,glabrous,globose,green,green-white,greenish,hair,hair-like,half,herb,invested,lateral,leaf,like,lobe,long,make,margin,membranous,middle,minute,mm,mottled,mucilaginous,multiple-celled,non-glandular,oblique,odd-pinnate,outer,ovoid,pedicel,peduncle,petiole,plant,point,pubescent,purple,purple-tinged,quite,ripe,rounded,scale-like,seed,short,slightly,spaced,sparsely,stem,style,subglabrous,subtending,terminal,testal,thick,throughout,typically,unbranched,usually,variable,vein,violet,wall,wet,whitish,wide,x	0-2,0-3,0.3-2.2,0.4-4.9,1.8-7,3-4,4-10.5,5-merou,acumen,ag,alyx,apparently,axe,blade,borne,broadly,capitat,clavate,connivent,cordate,decreasing,decumbent,digestion,dorsally,eaf,edge,eed,elliptic,end,enzyme,erec,especially,exceeding,flat,folded,geminat,glabrou,greatly,homostylous,honeycomb-shaped,interjected,lanceolate,larger,leaflet,lengthening,living,lower,markedly,medium,midrib,minutely,much,nflorescence,obovate,obtuse,one-quarte,orbicular,orolla,ovate,pair,pale,pentagonal,perfect,petiolulate,petiolule,plurifoliate,pore,poricidal,present,puberulent,rarely,removed,rotate,ruit,sessile,seudostipule,shallowly,singly,size,slit,sometimes,specimen,stamen,ste,stigma,stolo,straight,stripe,tall,tamen,tem,tip,toward,tri-,truncate,tube,tuber,unequal,unit,unwinged,vary,white,yellow,ympodial	'',[,``,abaxial,adaxial,arrangement,branching,calyx,characteristic,colour,form,growth,height,inflorescence,length,midvein,na,one-quarter,ovary,primary,pseudostipule,rachi,shape,staman,surface,tertiary,texture,unarmed,value,venation,{,}
342	wfo-0001029789	success	167	108	80	87	28	0.479	0.2-0.5,1-2,1-3,12,2-25,2-6,2-6.5,2.7-4.7,3-8.5,4-13,5-7,6,6-7,8-9,acuminate,acute,anther,apex,articulated,axillary,base,basiscopic,blue,broadly,bud,chartaceous,cm,corolla,dark,decurrent,diameter,distal,filament,flower,forked,fruit,generally,glabrous,green,hair,half,herb,leaf,light,like,lilac,linear,lobe,long-attenuate,lunate,membranous,minute,mm,mottled,narrowly,odd-pinnate,ovary,ovate,pedicel,peduncle,petiole,petiolulate,plant,pubescent,rachi,rarely,sessile,short,side,sparsely,star,style,subglabrous,subtending,terminal,tinged,typically,usually,white,x	0-2,0.5-2.8,0.8-3.5,1-10,1.5-2,1.7-8.5,1.8-6.5,2-3,3-5,4-10,5-merou,7-16.6,7-21,abaxially,acumen,adaxiall,adaxially,ag,alyx,apart,apparently,attenuate,axe,blade,capitat,clavate,connivent,decreasing,dorsally,eaf,edge,eed,erec,exceeding,flat,folded,formed,geminat,greatly,hal,homostylous,interjected,lanceolate,lant,lateral,leaflet,lengthening,long,lower,maturing,minutely,never,nflorescence,orbicular,orolla,pair,pentagonal,perfect,plurifoliate,pore,poricidal,pubescen,purpl,rotate,seudostipule,simple,size,slightly,slit,spaced,stamen,ste,sterile,stigma,straight,subequal,tall,tamen,tem,tip,toward,tri-,tube,unit,vary,yellow,ympodial	abaxial,adaxial,arrangement,branching,calyx,characteristic,colour,form,growth,height,inflorescence,length,margin,midvein,na,primary,pseudostipule,purple,seed,shape,staman,stem,surface,tertiary,texture,unarmed,vein,venation
343	wfo-0001029810	success	149	102	88	61	14	0.591	0.5-3,1-1.3,1-1.5,1-10,1-3,1.1-2.3,1.5-3,2-5,2.5-3,3-3.5,3-4,4-10,5-15-flowered,5-6,acuminate,acute,adaxially,along,anther,apex,apically,arachnoid,attenuate,bark,base,berry,brown,calyx,capitate,cm,compact,compressed,congested,conical,corolla,dark,dendritic,densely,dia,elliptic,fleshy,fruiting,glabrous,globose,green,inflorescence,internodal,leaf,like,lobed,long,margin,minor,minutely,mm,narrowly,nearly,occasionally,opposite,ovary,ovoid-reniform,pale,papillose,pedicel,petiole,pitted,pointed,pubescent,reddish-brown,rest,shining,shrub,simple,size,small,sparsely,stem,stigma,style,surface,tan,tip,tree,trichome,tube,vein,white,wide	.25,.5,0.5-1,1-2,2-3,3-6,5-16,8-12,abaxially,anthesi,ape,closely,deflexed,deltate,differing,difoliate,drying,eaf,edicel,eed,ellipsoid,exserted,filament,free,geminat,glabrou,large,later,lateral,lenticel,less,lobe,lon,lower,main,major,middle,nflorescence,older,overlappin,papillo,planar,pore,poricidal,portion,ruit,scar,shaped,slender,spaced,tall,tapering,tear-drop,tub,ud,unit,widest,woody,yellowish,ympodial,young	characteristic,colour,form,fruit,growth,height,length,plant,pubescence,seed,shape,texture,type,width
344	wfo-0001029811	success	225	119	100	125	19	0.444	-3,0,0-30,0-35,0.3-1,0.5-2,0.8-1.5,1.3-1.7,1.5-6,1/3,13-20,2-2.5,2-5,2.8-3.2,3-5,3-5.5,3.5-4.5,4.5-5,5-17,5-40,7-18,7-9,abaxial,abaxially,adaxial,anther,apex,apically,apparently,articulated,base,berry,brown,calyx,cell,cm,cordate,cuneate,dark,diameter,erect,faint,filament,flattened-reniform,fruit,glabrous,glandular,hair,herb,lateral,leaf,length,lobe,lobed,long,long-styled,lower,margin,maturity,mauve,midvein,minute,mm,moderately,narrow-deltate,obtuse,orange-brown,outline,ovate,pair,pedicel,peduncle,per,petiole,pit,plant,prickle,primary,raised,short-styled,shrub,simple,small,smooth,sometimes,sparsely,spherical,stellate,stellate-pubescent,stem,style,surface,tertiary,unbranched,upper,vein,venation,wide,yellow,yellow-green	-6,-merous,.5,/3,0.1-0.3,0.1-0.4,0.2,0.2-0.6,0.3-1.5,1,1-1.5,1-2.5,1-3,1.5-2.5,1/,1/2-2/3,1/3-2/3,10-22,15-23,15-50,2-5.5,2.5-3,20-100,3-7,4-8,5,5-11,5-9,6-12,8-12,8-18,acicular,alyx,andromonoecious,apar,apart,bark,blade,broad-deltate,chartaceous,connivent,cream,densely,discolorous,distal,distance,drying,eaf,eed,elongate,elongating,equal,extending,eye,fewer,flattened,flower,free,fruiting,green,green-brow,hermaphrodite,heterostylous,inflated,infructescence,less,lobing,long-acuminat,longer,lowermost,marking,mature,midpoint,multangulate,naked,nflorescence,often,older,one,open,orolla,oung,pale,pendulous,pericarp,perpendicular,plurifoliat,poricidal,porrect,portion,prickl,prickly,ray,ruit,scandent,scar,secondary,sessile,short,shorter,side,slightly,spaced,spreading,stalk,stalked,staminat,stout,straight,tamen,tapering,terete,time,tip,trichome,tube,unarmed,unit,usually,vary,visible,way,woody,ympodial,young	1/2,arrangement,branching,characteristic,colour,corolla,form,growth,height,inflorescence,long-acuminate,na,ovary,rachi,seed,shape,staman,texture,type
345	wfo-0001029978	success	208	130	101	107	29	0.486	0.5-0.6,1-2,1.3-1.5,1.4-1.5,1.5-3.1,11-19,15-27,3-5,3-7,3.2-2.5,3.7-8.1,4-11,4.2-5.2,5,8-10,abaxially,acuminate,adaxially,anther,apex,articulated,asymmetrical,attenuate,axillary,base,basiscopic,berry,brownish,bud,cell,chartaceous,cm,coarsely,commonly,condition,conical,corolla,covering,dark,diameter,distal,drying,elliptic,filament,finely,flower,forked,fresh,fruit,generally,glabrous,green,green-white,greenish,hair,hair-like,half,herb,lateral,leaf,light,like,lobe,long,make,margin,medium,membranous,middle,minute,mm,mottled,mucilaginous,odd-pinnate,ovate,ovoid,pedicel,peduncle,petiole,plant,pubescent,purple,ripe,seed,side,simple,sparsely,stem,style,subsessile,subtending,symmetrical,terminal,testal,thick,throughout,tissue,usually,wall,wet,whitish	0.3-0.4,0.3-0.7,0.7-1.9,0.8,0.9-2.3,1-10,1.8-5,2-4,3.1-6.3,3.5-9.5,4-7,5-16.5,5-merou,acumen,ag,along,alyx,apart,apparently,arranged,axe,bead,blade,capitat,ciliate,clavate,connivent,darker,decreasing,digestion,dorsally,eaf,edge,eed,enzyme,erec,especially,exceeding,flat,folded,fourt,geminat,glabrou,gradually,homostylous,honeycomb-shaped,interjected,lanceolate,larger,leaflet,lengthening,less,living,lower,midrib,minutely,moniliform,multiple,narrow,necklace,nflorescence,orbicular,orolla,pair,pentagonal,perfect,petiolule,plurifoliate,pore,poricidal,puberulent,pubescen,ray,removed,rotate,ruit,secondary,semierect,sessile,seudostipule,size,slightly,slit,spaced,specimen,stamen,ste,stigma,stolon,straight,subequal,tall,tamen,tem,tip,toward,tri-,tube,tuber,typically,unit,vary,wide,wing,x,yellow,ympodial	2,abaxial,adaxial,arrangement,branching,calyx,characteristic,colour,form,fourth,growth,height,inflorescence,length,midvein,na,ovary,primary,pseudostipule,rachi,shape,staman,surface,tertiary,texture,unarmed,vein,venation,width
346	wfo-0001029980	success	173	98	71	102	27	0.41	0.1-0.25,0.25-1,0.5-1.2,0.5-2.5,0.5-5,0.7-1.3,1-1.5,1.2-2.5,1.5-2,2-5,3-4,5-10,abaxially,acute,anther,apex,base,berry,calyx,cm,corolla,curved,decurrent,deflexed,deltoid,elliptic,filament,flattened-reniform,glabrous,globose,green,greenish-white,leaf,lobe,margin,minutely,mm,one,onto,ovary,ovate,pair,pale,pedicel,petiole,pitted,plant,puberulent,rounded,shape,shiny,shrub,side,simple,slender,slightly,somewhat,stem,straight,style,surface,tan,tapering,trichome,tube,tuft,uniseriate,vein,white,winged,x	.1,.5,0.25-0.5,0.5-1,0.8-1.2,0.9-4.5,1-1.7,1.5-6,2-6,2/3,3-9,5-50-flowered,6.4-17,adaxially,anthesi,apar,appearing,appressed,axil,ba,bark,black,bright,brown,bud,closely,conical,dark,density,dia,differing,difoliate,dried,drying,eaf,edicel,eed,elevation,especially,exserted,five,free,fruiting,geminat,gray,greatly,high,impressed,incrassate,knob,lateral,live,lobed,lon,long,lower,main,major,material,middle,minor,near,nflorescence,node,often,older,opposite,orbicular,overlapping,paler,papillose,pore,poricidal,portion,prominent,proximal,race,reflexed,ruit,scar,shaped,size,small-capitate,soon,spaced,specimen,stigma,tall,tear-drop,tip,ud,unicellular,unit,varying,venezuelan,way,whit,widest,woody,yellowish,ympodial,young	abaxial,adaxial,arrangement,branching,characteristic,colour,diameter,form,fruit,growth,height,history,inflorescence,length,life,midvein,na,peduncle,primary,pseudostipule,rachi,seed,staman,tertiary,texture,unarmed,venation
347	wfo-0001029989	success	161	99	82	79	17	0.509	.2,.5,/2,0.25-0.5,0.5-1,0.5-1.5,1-2,1-2.5,1-4,1.3-2.3,1.5-2.5,10-14,2.5-3,3-5,3-8,3.5-8,4-4.5,5-6,7-20,abaxial,anther,apex,base,broadly,calyx,capitate,cm,conical,corolla,deltoid,dendritic,densely,elliptic,filament,flattened,fruiting,glabrous,globose,golden,green,greenish-black,heteromorphic,incrassate,inflorescence,lateral,leaf,lenticular,lobe,lobed,long,main,margin,minutely,mm,nearly,occasionally,ovary,pair,pedicel,petiole,pitted,poricidal,pubescence,pubescent,shining,short-style,shrub,simple,small,sparsely,stem,stigma,style,surface,tip,tree,tree-like,trichome,tube,vein,way,white	1-1.5,5-10-flowered,abaxially,acute,adaxially,anthesi,bark,berry,branch,branched,brownish-re,central,closely,collection,congested,deflexed,dense,described,dia,difoliate,dimaeter,discussion,drying,due,eaf,edicel,eed,erect,exserted,fleshy,free,geminat,gray,inflorescenc,internodal,lamina,like,lon,lower,middle,nflorescence,nodding,northern,older,opposite,overlappin,papillo,peru,peruvian,perÃº,petal,petaloid,planar,population,pore,portion,probably,reddish,reddish-brown,rest,ruit,scar,scattered,see,shaped,somewhat,spaced,tall,tear-drop,ud,unifoliate,unit,wide,widest,woody,x,yellow,ympodial,young	1,adaxial,bud,colour,diameter,exsertion,form,fruit,growth,height,length,papillose,plant,seed,shape,type,width
348	wfo-0001030000	success	155	125	103	52	22	0.665	-5,-50,0.5-,0.5-1,0.5-14,0.5-3,1,1-,1-10,1-2,1.5-2,10-,10-20,15-25,2-2.5,2-5,2.5-3,25-30,3-4,3.5-5,30-50,4,4-5,abaxially,absent,acute,adaxially,also,apex,apiculate,articulated,base,calyx,cm,connective,connivent,conspicuous,deltate,densely,dia,diameter,dilated,distally,eglandular,ellipsoidal,equal,exceeding,flattened,flower,fruit,glabrous,globose,green,hair,immature,leaving,lobe,long,mature,mm,moderately,oblong,obtuse,occasionally,orange,ovoid,pedicel,pedicellar,peduncle,perfect,pilose,produced,puberulent,pubescent,purplish,rachi,radiu,remnant,scar,shorter,shrub,slightly,small,sparsely,spotted,stigma,strongly,style,subcoriaceous,swelling,thecae,tinge,tip,tree,truncate,umbrella-shaped,unbranched,white,wide,x,yellow,yellow-brown,yellowish	-4,-7,-pilose,1.5-,2-3,2-4,2.5-,2.5-3.5,3-,3-16,4-4.5,4-foliat,7-15,aggregate,apart,ape,axe,biglandula,cell,chartaceous,ciliat,coriaceous,creamy-whit,cucullate,directed,eed,laterally,lon,lower,margin,narrowly,nflorescence,nther,orolla,pore,pubescen,rarely,ruit,smal,spaced,stamen,stellate,stone,tal,tem,tomentose,triangular,tube,ud,unit,vary,ympodial	4-foliate,anther,arrangement,biglandular,bud,characteristic,colour,corolla,creamy-white,form,growth,height,inflorescence,leaf,length,ovary,plant,seed,shape,stem,texture,theca
349	wfo-0001030000	success	178	125	103	75	22	0.579	-50,-pilose,0.5-,0.5-13,0.5-14,0.5-3,1,1-10,1-5,10-,10-20,15-25,2-2.5,2-5,25-30,30-50,abaxially,acuminate,acute,adaxially,also,apex,apiculate,articulated,basal,base,calyx,chartaceous,cm,connective,conspicuous,cordate,coriaceous,deltate,densely,diameter,dilated,directed,distally,ellipsoidal,elliptic,entire,flattened,flower,fruit,glabrescent,glabrous,globose,green,immature,laterally,leaving,lobe,long,margin,mature,mm,moderately,oblique,oblong,obtuse,occasionally,often,orange,ovate,ovoid,pedicel,pedicellar,peduncle,perfect,petiole,pilose,pore,puberulent,pubescent,purplish,rachi,radiu,rarely,remnant,scar,shrub,simple,small,sparsely,spotted,stellate,stigma,strongly,style,subcoriaceous,thecae,tinge,tip,tree,truncate,umbrella-shaped,unbranched,vein,white,yellow,yellow-brown,yellowish	-2,-4,-5,-7,0.5-1,1-,1-1.5,1-2,1.5-,1.5-2,2-,2-3,2-4,2.5-,2.5-3,2.5-3.5,3-,3-16,3-4,3.5-5,4,4-25,4-4.5,4-5,4-foliat,5-25,7-15,absent,aggregate,apart,ape,axe,biglandula,blade,cell,ciliat,connivent,creamy-whit,cucullate,dia,eaf,eed,eglandular,equal,exceeding,hair,lon,lower,narrowly,nflorescence,nther,orolla,pilo,produced,pubescen,ruit,shorter,slightly,smal,spaced,stamen,stone,swelling,tal,tem,time,tomentose,triangular,tube,ud,unit,vary,wide,x,ympodial	anther,arrangement,biglandular,bud,characteristic,colour,corolla,creamy-white,direction,form,growth,height,inflorescence,leaf,length,ovary,plant,seed,shape,stem,surface,texture
350	wfo-0001030004	success	177	87	69	108	18	0.39	0-0.5,0-1.5,0.2-1,0.3-1,1.2-2,1.5-2.5,2-20,3-4,3.5-5,5-25,abaxial,acuminate,acute,adaxially,anther,apex,axillary,base,branched,branching,broadly,calyx,cm,corolla,deltate,densely,elliptic,filament,flattened-reniform,glabrous,globose,green,inflorescence,later,lateral,leaf,lobe,many,margin,minutely,mm,much,obovate,occasionally,ovary,pale,pedicel,petiole,pitted,plant,plurifoliate,pubescent,seed,sessile,shrub,small,sparsely,stem,stout,style,surface,tan,terminal,thick,time,tree,white,winged,yellowish-green	.3,0.8-1.1,1-1.5,1-2,15,15-20,20-200-flowered,3-3.5,4-15,9-30,abaxially,across,along,always,anthesi,apar,appearanc,barely,bark,basal,berry,blade,body,bushy,capitate,collection,cone,conical,crotaloid,decurrent,dendritic,dense,denser,dia,diamete,distal,drying,eaf,edicel,eed,erect,especially,exserted,flat,fleshy,free,fruiting,giving,greenish-yello,hard,incrassate,juvenile,knob,lamina,large,like,lobed,long,loose,lower,main,middle,nearly,nflorescence,obovoid,often,older,onto,pair,papillate,papillo,pericarp,planar,pore,poricidal,portion,possessing,prominent,pubescence,rest,ruit,scar,shaped,simple,spaced,stigma,strongly,surpassing,tall,tear-drop,thin,tip,translucent,trichome,tub,tube,tuft,ud,unevenly,variously,vein,wide,widest,woody,x,yellowish,ympodia,young	arrangement,characteristic,colour,diameter,form,fruit,greenish-yellow,growth,height,length,na,peduncle,pseudostipule,rachi,shape,staman,texture,unarmed
351	wfo-0001030007	success	168	77	63	105	14	0.375	0.2-1,0.8-1,1-1.5,1-15,1-2,1.6-2.2,2-4,3/4,4.5-5,6-10-flowered,7-9,acute,along,anther,base,beneath,berry,brown,calyx,cm,corolla,densely,dia,dry,elliptic,flattened,glabrous,globose,golden,golden-pubescent,green,leaf,live,lobed,long,material,midrib,mm,oblique,onto,ovary,pale,pedicel,petiole,plant,pubescent,reniform,shrub,simple,slightly,small,soft,sparsely,stem,style,surface,tree,trichome,uniseriate,way,white,winged,x	.05,.4,.5,0.1-0.5,0.5-1,1.5-5,15-20,2-7,3-5,7-10,abrupt,acuminate,anthesi,apart,apex,ba,bark,becoming,branched,broadly,bud,campanulate,clavate,closely,cork,dark,decurrent,deltoid,difoliate,edicel,eed,erect,exserted,filament,fleshy,free,fruiting,geminateleaf,glabrate,gre,hooded,impressed,incrassate,inflorescenc,lateral,like,lobe,lon,longer,lower,main,major,margin,middle,minor,minutely,nflorescence,obovoid,occasionally,older,one,opposite,outline,pair,papillo,papillose,pitted,planar,pore,poricidal,portion,prominent,raised,rest,rounded,ruit,scar,shaped,short,shorter,slender,soon,spaced,specimen,stigma,straight,tall,tapering,tear-drop,thick,thickened,tip,trunk,tub,tube,two,type,ud,unit,vein,widening,widest,woody,ympodial,young	alternate,arrangement,characteristic,colour,diameter,form,fruit,growth,height,inflorescence,length,seed,shape,texture
352	wfo-0001030010	success	156	110	93	63	17	0.596	.5,.75,/4,0.5-5,0.9-1.1,1-1.3,1-1.5,1-2,1.2-1.5,1.5-2,10-50-flowered,2-2.2,2-7,2.5,4-4.5,5-7,acuminate,acute,anther,apex,area,attenuate,bark,basal,base,berry,calyx,cm,corolla,cyathiform,deciduous,decurrent,deflexed,deltate,dia,f,filament,fleshy,fruit,fruiting,furcate,glabrate,glabrous,globose,grey,hooded,leaf,lobe,lobed,long,margin,minutely,mm,nearly,obovate,often,opposite,ovary,ovoid-reniform,papillose,pedicel,persistent,petiole,pitted,pore,poricidal,puberulent,rather,reddish,shaped,shrub,simple,slightly,small,smooth,soon,stem,stigma,straight,style,surface,tapering,tear-drop,tiny,tip,tree,trichome,tube,way,white,winged,woody,x	0.7-1,10-15,11-12,20-40,3-5,7-10,anthesi,appearing,beneath,brown,bud,closely,dark,differing,difoliate,distal,dry,eaf,edicel,eed,ellipsoid,exserted,free,geminat,green,lateral,lon,lower,m.,main,major,materia,material,middle,midrib,minor,minute,near,nflorescence,occasionally,older,one,orange,overlappin,pair,planar,portion,prominent,ruit,scar,shin,size,spaced,styl,tall,trunk,ud,uniseriate,unit,vein,widest,ympodial,young	characteristic,diameter,flower,form,growth,height,inflorescence,length,number,persistence,plant,pubescence,seed,shape,shiny,texture,type
353	wfo-0001030023	success	171	117	94	77	23	0.55	0-100+,0.5-1,1,1-,1-8,1.5-7,10-25,11-40+,13-20,2,2-3,2.5-3.5,20-30,3-4.5,3-5,4,4-10,4-12,5,5-,5-6,6-7,7-9,abaxially,acute,adaxially,apart,apex,apiculate,articulated,basal,base,branched,calyx,cm,cordate,cuneate,cylindrical,deeply,densely,diameter,dilated,distally,ellipsoidal,elliptic,entire,finely,flattened,fleshy,flower,fruit,glabrous,glandular-puberulent,globose,greenish-white,highly,leaving,lobe,long,margin,mm,moderately,narrowly,near,oblique,oblong,occasionally,often,ovate,pedicel,pedicellar,peduncle,peltiform,petiole,probably,puberulent,pubescent,purplish-,rachi,remnant,short-acuminate,simple,somewhat,spaced,sparsely,stigma,style,tip,tree,triangular,truncate,unknown,x,yellowish	-,1-2,1.5-2,10-,12-18,30-50+,4-foliat,5-16,6-26,aggregate,ape,axe,beyond,blade,capitat,cell,ciliate,color,connective,connivent,denser,directed,eaf,eed,especially,exceeding,except,exserted,forked,glandular-puberulen,hair,lanceolate,lon,loosely,lower,main,membranaceous,narrow,nflorescence,nther,obtuse,orolla,perfect,pore,presen,present,prominent,pubescen,pubescence,pubescent-pilo,radiu,ripe,ruit,shorter,slightly,small,stamen,stellate,stone,subcoriaceous,swelling,tal,tem,thecae,time,tube,ud,unbranched,unit,unknow,usually,vary,vein,villous,wide,ympodial,young	anther,arrangement,capitate,characteristic,colour,corolla,form,growth,height,history,inflorescence,leaf,length,life,ovary,perennial,plant,pubescent-pilose,seed,shape,stem,surface,texture
354	wfo-0001030032	success	250	125	106	144	19	0.424	0.2-0.5,0.25-0.4,0.5-0.6,0.5-1.5,0.8-1.0,0.8-1.1,1-1.3,1-1.5,1-2-celled,1.5-2,2-3-locular,2-4,2-5,2.4-3.5,3.0-3.5,3.5-12,30,4-5,4.3-5.0,60-80,8-10,8-10-celled,8-20,acuminate,acute,adaxial,anther,apex,articulated,articulation,base,branched,bright,brown,calyx,cm,completely,conical,corolla,decurrent,deltate,densely,diameter,elliptic,entire,filament,fruit,glabrous,golden,green,greenish-brown,hair-like,imparipinnate,interrupted,irregularly,leaf,length,like,lobe,long,many,margin,middle,midvein,mm,oblanceolate,obovate,often,orbicular,outgrowth,ovary,pale,paler,pedicel,peduncle,petiole,pithy,primary,pseudostipule,pubescent,rachi,seed,simple,soft,splitting,stem,style,surface,swollen,tangled,tertiary,thick,time,trichome,truncate,uniseriate,vein,venation,vine,wall,weaker-walled,white,wide,woody,yellow,Â½-3/4	+,.05,.5,0.1-0.4,0.1-0.5,0.2,0.2-0.3,0.4-1.5,0.5,0.5-0.7,0.5-1,0.5-2,0.6-1.1,0.7-0.8,1-3,1-celled,1.5-2.5,11-20,13-35,2,2-10,2-3.5,2-60,2-lobed,3,3-5,4-6-celled,4-celled,5-plurifoliate,6-11,7-16,7.5-10,abaxially,absent,abundant,adaxially,along,also,anthesi,apical,appearance,appendage,basal,basally,basiscopically,bent,border,branche,breaking,capitate,cell,clambering,column,conspicuou,dark,densest,desne,dry,eaf,ebracteate,edicel,eed,exserted,flower,free,fruiting,give,glandular,gree,halfway,hea,head,herbarium,interjected,internode,lamina,large,larger,lateral,leaflet,leave,longest,lower,markedly,mixed,moderately,much,multicellular,nflorescence,node,oblique,occasionally,older,onto,opposite,pair,patent,petiolule,present,pubescence,reflexed,rest,rotate,rotate-stellate,rough,round,ruit,secondary,set,shorter,silky,slightly,smaller,sometimes,somewhat,sparsely,sparser,specimen,spreading,stamen,staminal,sterile,stigma,straight,subopposite,tall,tem,terminal,testa,thickened,tiny,tip,touch,transparent,tube,ud,unicellular,unit,usually,vegetatio,well-developed,winged,ympodial,younger	abaxial,arrangement,branching,characteristic,colour,conspicuous,dense,form,growth,height,history,inflorescence,life,na,plant,shape,staman,texture,unarmed
355	wfo-0001030048	success	156	102	82	74	20	0.526	0.5-1.5,1-2,1.2-2,1.3-1.6,1.5-3.5,10-16,2-3,2-5,3-3.5,3-5,4-4.5,5-10-flowered,5-8,abaxially,acute,adaxially,anther,apex,apically,arachnoid,bark,base,berry,bi-colored,bi-lobed,blue,broadly,brown,calyx,clavate,cm,conical,corolla,decurrent,deltate,densely,difoliate,elliptic,felt-like,fruiting,glabrate,glabrous,globose,golden,green,greyish,lateral,leaf,lobe,long,main,margin,matted,mm,onto,ovary,ovoid-reniform,pair,pale,pedicel,petiole,pointed,pubescent,reddish-brown,shiny,shrub,simple,small,somewhat,stem,stigma,strongly,style,tan,thickened,tree,trichome,trifoliate,tube,unit,vein,white	.5,1-1.5,1.5-7,4-15,5973,abaxial,along,anthesi,ape,apparently,becoming,closely,completely,covered,deflexed,dia,drying,eaf,edicel,eed,ellipsoid,exserted,fide,filament,fleshy,four-angle,free,geminat,impressed,inflorescenc,internodal,lamina,lightly,like,lobed,lon,lower,middle,minutely,nearly,nflorescence,occasionally,older,opposite,overlappin,papillo,papillose,pitted,planar,pore,poricidal,portion,prominent,rather,rest,ruit,scar,shaped,solomon,spaced,sparsely,surface,tall,tear-drop,thick,tip,tub,ud,wide,widest,woody,yellowish,ympodial,young	1,arrangement,characteristic,colour,dense,diameter,form,fruit,growth,height,inflorescence,length,plant,pubescence,seed,shape,sympodial,texture,type,width
356	wfo-0001030053	success	141	106	91	50	15	0.645	0.5,0.5-1,1-1.3,1.3-3.5,1.8-2,10-20,2-2.5,2.5-3,3.5-4,7-9,<,abruptly,abscission,acuminate,acute,anthesi,apex,apiculae,articulated,base,berry,branched,brown,calyx,cell,cm,corolla,cyathiform,decurrent,diameter,elliptic,entire,filiform,fine,flattened,fragrant,glabrous,greenish,growth,hyaline,inflorescence,irregularly,leaving,lobe,lobed,long,many,margin,minutely,mm,new,pair,pale,parallel,pedicel,peduncle,peg,pendant,per,petiole,pitted,primary,rectangular,reniform,rim,shallowly,shining,shiny,simple,sleeve,slightly,small,spreading,stem,strongly,surface,terminal,testal,time,tiny,truncate,tube,twining,usually,vein,venation,vine,white,woody,x,yellowish	1-13,1.5-5.5,100,4-,5,5-merou,7-11,aiding,alyx,apart,apical,ark,around,bfeore,branch,climbin,completely,coriaceous,eaf,eed,exserted,far,fide,flower,frui,fruiting,lower,mentz,near,nflorescence,nipple,older,orolla,papilla,papillo,perfect,plurifoliat,revolute,scar,secondary,shin,spaced,spreadin,support,tem,tip,turbinate,ud,unit,ympodial	arrangement,bark,characteristic,colour,form,fragrance,fruit,leaf,length,number,papillose,seed,shape,tertiary,texture
357	wfo-0001030057	success	141	115	82	59	33	0.582	-2,2-3-celled,2-4,2-4.5,2-6,20-30,20-80,8,abaxially,absent,acuminate,acute,adaxially,apex,articulated,axillary,base,berry,brownish,bud,cell,chartaceous,cm,condition,cordate,covering,cuneate,diameter,distal,drying,elliptic,extremely,flower,forked,fresh,fruit,generally,globose,green,green-white,greenish,hair,hair-like,half,herb,high,lateral,leaf,like,long,lunate,make,membranous,mm,mucilaginous,narrow,odd-pinnate,ovate,ovoid,pedicel,peduncle,petiole,plant,pubescent,scale-like,seed,short,small,stem,subglabrous,subtending,terminal,testal,thick,throughout,truncate,unwinged,usually,wall,wet,whitish,wing	1-10,1-2,2.1-4.1,3-5,3.5-8,4-10,4.3-8.2,5.5-12,7-14,8-19,apart,apparently,axe,blade,borne,broadly,decreasing,digestion,eaf,eed,end,enzyme,erec,geminat,glabrou,greatly,honeycomb-shaped,interjected,larger,leaflet,living,mottled,nflorescence,pair,perfect,petiolule,plurifoliate,purple,removed,ruit,seudostipule,singly,size,sometimes,spaced,specimen,ste,stolo,suborbicular,tall,tem,thir,toward,tri-,tuber,typically,unit,x,ympodial	abaxial,adaxial,anther,arrangement,calyx,characteristic,colour,corolla,filament,form,glabrous,growth,height,inflorescence,length,lobe,margin,midvein,na,ovary,primary,pseudostipule,rachi,shape,staman,style,surface,tertiary,texture,third,unarmed,vein,venation
358	wfo-0001030057	success	197	112	84	113	28	0.426	-10,-2,.5-3.5,1-2,2-3-celled,2-4,2-4.5,2-6,20-30,20-80,5-10,5-6,8,abaxially,acuminate,acute,adaxially,anther,apex,articulated,axillary,base,berry,brownish,bud,chartaceous,cm,condition,cordate,corolla,cuneate,diameter,distal,drying,elliptic,filament,flower,forked,fresh,fruit,generally,glabrous,globose,green,greenish,hair,half,herb,high,leaf,like,linear,lobe,long,margin,membranous,mm,narrow,odd-pinnate,ovate,ovate-lanceolate,ovoid,pedicel,peduncle,petiole,plant,plurifoliate,pubescent,seed,short,stem,style,subglabrous,subtending,terminal,tri-,truncate,unit,unwinged,usually,white,whitish,wing,x	1-10,2-3,2-5,2.1-4.1,3-5,3.5-8,4-10,4.3-8.2,5-merou,5.5-12,7-14,8-19,absent,acumen,ag,along,alyx,apart,apparently,axe,blade,borne,broadly,cell,ciliate,connivent,covering,decreasing,digestion,dorsally,eaf,edge,eed,end,enzyme,erec,especially,exceeding,extremely,flat,folded,geminat,glabrou,globo,greatly,green-white,greenish-yellow,hair-like,homostylous,honeycomb-shaped,interjected,lanceolate,larger,lateral,leaflet,lengthening,living,lower,lunate,make,middle,midrib,minutely,mottled,mucilaginous,nflorescence,orolla,pair,pentagonal,perfect,petal,petiolule,pore,poricidal,puberulent,purple,removed,rotate,ruit,scale-like,seudostipule,singly,size,slit,small,sometimes,spaced,specimen,stamen,star,ste,stigma,stolo,straight,striped,suborbicular,tall,tamen,tem,testal,thick,thir,throughout,tip,toward,tube,tuber,typically,vary,wall,wet,yellow,ympodial	abaxial,adaxial,arrangement,branching,calyx,characteristic,colour,form,growth,height,inflorescence,length,midvein,na,ovary,primary,pseudostipule,rachi,shape,staman,surface,sympodial,tertiary,texture,third,unarmed,vein,venation
359	wfo-0001030080	success	186	117	93	93	24	0.5	0.3-7,0.4-1.5,0.5-4,1-2,1.5-2,1.5-2.5,2-3,2.1-7.1,3-10,3-5,4-12,4-7,5-7,8-16,8-23,acuminate,anther,apart,apex,articulated,axillary,base,berry,brownish,bud,cell,cm,condition,coriaceous,corolla,covering,cuneate,dark,decurrent,diameter,distal,dot,drying,elliptic,filament,flower,forked,fresh,fruit,generally,glabrescent,glabrous,green,green-white,greenish,hair,hair-like,half,herb,high,lanceolate,lateral,leaf,light,lobe,long,make,medium,mm,mottled,mucilaginous,odd-pinnate,onto,ovate,ovoid,pedicel,peduncle,petiole,plant,purple,pyriform,rachi,seed,sometimes,spaced,style,subtending,terminal,testal,thick,throughout,tiny,usually,wall,wet,white,whitish,winged	1-3,1.8-4.5,1999,2-4,3.3-7.7,5-13.5,5-merou,5.5-9.9,6.5-18.6,9.9-33,abaxiall,abaxially,absent,acumen,adaxially,ag,along,alyx,apparently,arranged,axe,bead,blade,capitat,ccording,clavate,connivent,decreasing,digestion,dorsally,eaf,edge,eed,enzyme,erec,exceeding,flat,folded,geminat,glabrou,hal,homostylous,honeycomb-shaped,inconspicuous,interjected,larger,leaflet,lengthening,like,linear,living,lower,moniliform,multiple,necklace,nflorescence,ochoa,orolla,pair,perfect,plurifoliate,pore,poricidal,removed,second,seudostipule,size,slightly,slit,specimen,stamen,stellate,stigma,stolon,straight,strongly,subequal,tall,tamen,tem,tip,toward,tri-,tube,tuber,typically,unit,unknown,vary,width,x,yellow,ympodial	2,abaxial,adaxial,arrangement,calyx,characteristic,colour,form,growth,height,history,inflorescence,length,life,margin,mentioned,ovary,perennial,pseudostipule,shape,staman,stem,surface,texture
360	wfo-0001030081	success	157	128	103	54	25	0.656	.5,0.5-1,0.5-1.5,0.5-2.5,1,1-2-celled,1-4,1-5,1.5,1.5-3,10-20,10-35,1st,2-7,2-foliate,2nd,3-10,3-6,4-6,5-12,5-15,absent,acute,along,anther,apex,apically,axe,base,berry,beyond,blade,brown,calyx,cell,center,chartaceous,ciliate,cm,decurrent,densely,denser,diameter,dm,drying,edge,elliptic,elliptic-ovoid,entire,equal,exserted,few-branched,filament,fine,flat,flower,fruit,geniculate,glabrous,globose,hair,herb,immature,linear-lanceolate,lobe,long,lying,margin,maturing,membranaceous,mm,moderately,nearly,obtuse,often,parallel,pedicel,peduncle,per,petiole,pointing,pubescent,rachi,radiating,raised,ridge,rounded,running,semitransparent,shallow,single-,sparsely,stamen,style,surface,two-celled,unbranched,unit,usually,vein,white,x,yellow	0.25-0.5,1-2,1-3,1.5-7,2-4,abaxially,abundant,adaxiall,adaxially,connected,cordate,dehiscing,eaf,eed,emarginat,explosively,frui,geminat,held,interpetalar,longer,lower,maturit,mesocarp,nfloresence,notch,oblong,one,orolla,other,placenta,pressure,pubescen,rarely,rotate,ruit,short,slightly,small,sometimes,stigma,straight,swollen,tal,tamen,tem,tissue,triangular,tube,vary,watery,wid,woody,ympodial	adaxial,arrangement,branching,characteristic,colour,corolla,form,geminate,growth,height,inflorescence,leaf,length,na,orientation,ovary,plant,seed,shape,staman,stem,sympodial,texture,type,unarmed
361	wfo-0001030083	success	146	104	73	73	31	0.5	.5,0.25-0.5,0.5-1,0.5-2,0.8-1,0.8-3,1-1.5,1-2,1.5-3,2,2-5-flowered,4-6,9-11,anther,apex,base,berry,broadly,calyx,cm,corolla,decurrent,deeply,deltoid,dia,dry,elliptic,flower,fruit,glabrous,globose,green,greenish-white,hyaline,leaf,lobe,long,long-acuminate,long-styled,minutely,mm,narrowly,onto,ovary,ovate,ovoid-reniform,pair,pale,papillose,pedicel,petiole,pitted,prominent,raised,red-papillose,reddish-gold,short-styled,shrub,simple,slender,specimen,stem,strongly,style,surface,tan,tapering,translucent,tube,vein,white,winged,x	.75,0.1,10-30,2-3,3-4,3/4,4-15,accrescent,acute,anthesi,bark,beginning,closely,cup-shaped,dar,deciduous,deflexed,drying,eaf,edicel,eed,elongate,exserted,fleshy,fruiting,greyish-re,inflorescenc,internodal,lateral,lobed,lon,lower,main,membranous,middle,near,nflorescence,older,opposite,overlapping,paler,papillae,pore,poricidal,proximal,reflexed,ruit,scar,shallowly,shaped,single-stemmed,slightly,small-capitate,somewhat,soon,spaced,stigma,straight,tall,tear-drop,terminal,thickened,thin,tip,tub,ud,unifoliat,unit,way,widest,woody,ympodial,young	abaxial,adaxial,arrangement,branching,characteristic,colour,diameter,filament,form,growth,height,history,inflorescence,length,life,margin,midvein,na,peduncle,plant,primary,pseudostipule,rachi,seed,shape,staman,tertiary,texture,unarmed,unifoliate,venation
362	wfo-0001030093	success	181	110	81	100	29	0.448	0.1-0.3,0.2-1,0.5-1.1,0.75-1,1-1.5,1-12,1-5,2-2.5,3-4,4-6,7-9,8-9,acuminate,acute,anther,apex,attenuate,base,becoming,beneath,berry,branched,brownish-tan,calyx,case,cm,continues,corolla,cuneate,deltoid,densely,elliptic,erect,especially,filament,glabrous,globose,golden,green,greenish-white,growth,hirsutulous,hyaline,lateral,leaf,lobe,margin,minutely,mm,obovate,occasionally,often,opposite,ovary,ovoid-reniform,pair,pale,paler,pedicel,petiole,pitted,plant,population,pubescent,shiny,shoot,shrub,simple,small,southern,stem,style,surface,terminal,tiny,tree,trichome,uniseriate,vein,white,x	.2,.5,0,0.2,0.2-0.5,0.6-1.5,1.3-4.5,2.5-11,3.5-12,5-50-flowered,5-8,7-30,anthesi,apar,bark,campanulate,clavate,closely,collection,commonly,deflexed,dia,differing,difoliate,eaf,edicel,eed,ellipsoid,evenly,except,expanded,exserted,flower,forest,free,fruiting,furcate,geminat,greyish-brow,guyanese,impressed,inundated,like,lobed,lon,long,long-styled,lower,main,major,many,member,middle,minor,narrowly,nearly,new,nflorescence,older,one,onto,open,orbicular,papillo,persisting,pore,poricidal,portion,present,puberulent,quite,reflexed,remaining,ruit,scar,shaped,short-styled,size,slender,slightly,soon,spaced,stigma,straight,tall,tapering,tear-drop,thickened,time,tip,tub,tube,ud,underside,unit,widest,woody,yellowish,ympodial,young	1.5-4,abaxial,adaxial,arrangement,branching,characteristic,colour,diameter,form,fruit,height,history,inflorescence,length,life,midvein,na,peduncle,perennial,primary,pseudostipule,rachi,seed,shape,staman,tertiary,texture,unarmed,venation
363	wfo-0001030145	success	153	109	92	61	17	0.601	-3,0.2-2,0.3-,0.5,0.5-1,1,1-1.5,1-2,1-2.5,1-3,1-5,1.5,1.5-2,1.5-4.5,10-12,2-3,3-10,3-4,3-5,6-40,8-11,abaxially,acute,adaxially,adpressed,also,apart,apex,articulated,basal,base,calyx,chartaceous,cm,compound,cuneate,cylindrical,deltate,densely,diameter,dunal,ellipsoidal,elliptic-ovate,entire,fide,flower,forked,fruit,glabrous,glandular,globose,hair,herb,leaf,leaving,less,lobe,long,margin,mm,moderately,narrowly,near,obtuse,ovate-elliptic,pedicel,pedicellar,peduncle,petiole,pilose,puberulent,rachi,remnant,shrub,simple,sinuate,slender,slightly,spaced,sparsely,stigma,style,subcordate,subcoriaceous,ternately,triangular,truncate,unbranched,unknown,violet,x,yellow	-2,0.5-4,1.5-7,2-4,2.5-6.5,3,4-5,4-8,4-foliat,absent,aggregate,ape,axe,beyond,blade,campanulate,cell,color,connective,directed,distally,eaf,eed,elliptic,exceeding,exserted,fleshy,lanceolate,larger,lateral,leaflet,lon,lower,nflorescence,nther,orolla,pore,presen,puberulen,radiu,reddish,ripe,ruit,shorter,somewhat,stamen,stone,tal,tem,terminal,thecae,time,tomento,toward,truncat,tube,ud,unit,vary,wide,ympodial	anther,arrangement,characteristic,colour,corolla,form,growth,height,inflorescence,length,ovary,plant,seed,shape,stem,surface,texture
364	wfo-0001030146	success	210	93	74	136	19	0.352	0.6â2,0.9â1,1.2â1.5,1.5â2,16â20,1â1.5,2.5â9,3â4,3â6,40â50,5â8,9â9.5,abaxial,acuminate,acute,adaxial,anther,anthesi,apex,base,berry,branched,branching,brown,calyx,cm,coriaceous,corolla,dark,deltate,densely,diameter,elliptic,entire,filament,glabrous,globose,golden,green,growth,inflorescence,leaf,length,lobe,many,margin,minutely,mm,narrowly,nodding,pair,pedicel,peduncle,per,petiole,pitted,plant,primary,pubescent,reddish,revolute,simple,small,stem,stout,style,surface,terminal,time,tree,treelet,vein,white,â18	.1,.2,.5,0.2â0.4,0.5,0.5â1,0.6â0.7,1â1.1,20,20â30,2â5,4â30,4â4.5,5-merou,6.5â16,60+,6â7,8â15,>,abaxially,absent,ag,almost,along,alyx,apar,appearing,ark,articulated,axe,beig,beneath,bright,brownish,c.,capitate,cell,center,closely,connivent,covered,cup-shaped,deeply,dense,dichasia,discolorous,drying,eaf,echinoid,edge,eed,ellipsoidal,elongate,erec,exserted,flattened-reniform,flower,free,fresh,fruiting,fused,gradually,halfway,ilament,impressed,lamina,layer,lengthening,less,like,lobed,long,loosely,lower,midpoint,multangulate,narrowing,new,nflorescence,older,olive,orolla,pale,papillose,part,peltate,perfect,pericarp,persistent,plurifoliate,pore,poricidal,portion,projection,pubescence,ray,reflexed,regularly,rhachi,ripe,ruit,scar,scurfy,sessile,shiny,short-stalked,slit,spaced,sparsely,stellate,stigma,strongly,subtended,tall,tan,tangled,tem,testal,thin,tiny,tip,trichome,tube,ud,undersurface,unevenly,unit,upper,vary,varying,visible,way,wide,woody,yellow,ympodial	arrangement,characteristic,colour,form,fruit,height,history,life,midvein,na,ovary,pseudostipule,rachi,seed,shape,staman,texture,unarmed,ye
365	wfo-0001030147	invalid_json	158	109	71	87	38	0.449	0.5-2,1-4,1-5,15-30,2-10,2-10.5,2-13,2-3,2-5,4-5.5,4.5-10,5-8,acuminate,acute,apex,articulate,base,blue,branched,calyx,cell,cm,conical,corolla,covering,cuneate,cyme,deep,diameter,dichasial,dichasially,distal,ebracteate,elliptical,filament,finely,green,green-white,hair-like,herbaceous,lateral,leaf,lobe,long,long-attenuate,medium,mm,monochasial,mucilaginous,narrowly,oblique,obtuse,odd-pinnate,ovate,ovoid,pedicel,peduncle,perennial,petiole,plant,proximal,pubescent,purple,rounded,seed,style,testal,thick,tip,wall,Â¼	-8,0-5,1.0-2.0,1.0-2.2,10-19,14-35,2,2.5-7.5,3-,3-6-foliat,4-3.,4.2-7.5,5-7,8-38,abaxiall,abaxially,acumen,adaxially,apical,apically,attenuate,connate,dehiscent,digestion,diminishing,dorsally,eaf,edge,eed,emoval,enzyme,exceeding,flat,flower,folded,forked,generally,globo,gradually,half,honeycomb,interjected,introrse,leaflet,living,lon,lower,lunat,make,maturing,nflorescence,nther,often,orolla,pair,pattern,perfect,petiolule,plan,poricidally,reveal,rotate,ruit,sessile,seudostipule,short,size,slit,specimen,stamen,stigma,straight,subequal,subsessile,tal,tem,terminal,throughou,throughout,toward,tuber-bearing,typically,unit,vary,wide,yellow,ympodial	'',[,``,abaxial,adaxial,anther,arrangement,branching,characteristic,colour,form,fruit,growth,height,history,inflorescence,length,life,margin,midvein,na,ovary,primary,pseudostipule,rachi,shape,staman,stem,surface,tertiary,texture,unarmed,value,vein,venation,wet,{,}
366	wfo-0001030151	success	175	132	113	62	19	0.646	-50,0.2-0.5,0.3-0.5,0.5,0.5-1,1-1.5,1-17,1-3,1-5,1.5-2.5,10-20,10-25,15-35,2-11,2-3,2-6,2-7-compound,20-30,3-5,4-5,5-6,6-9,abaxially,abundantly,acuminate,acute,adaxial,adaxially,apart,apex,apiculate,articulated,base,blade,blotch,calyx,chartaceous,cm,connective,cordate,cuneate,cylindrical,decurrent,deltate,diameter,eglandular,elliptic,entire,except,flower,fruit,glabrate,glabrous,glandular,glandular-puberulent,globose,hair,lanceolate,leaf,leaving,lilac-tinged,line,lobe,long,longitudinal,margin,membranaceous,mm,narrowly,near,oblique,oblong,obovate,often,pedicel,pedicellar,peduncle,petiole,pinnately,probably,puberulent,pyriform,rachi,radiu,remnant,ripe,sand-punctate,scattered,shallowly,simple,slender,slightly,sometimes,spaced,sparsely,stellate,stigma,stripe,style,surface,thecae,tip,toward,tree,truncate,unbranched,vein,veiny,white,white-puberulent,x,yellow,yellow-green	-3,1,1-2,1.5-2,2-25,3-14,3.5-32,4-foliat,?,absent,aggregate,ape,around,axe,basal,beyond,cell,channe,ciliat,compound,connate,directed,distally,eaf,eed,exceeding,exserted,leaflet,less,lon,lower,nflorescence,nther,obtuse,orolla,perfect,pore,presence,purplish,ring,ruit,sand-punctat,short,shorter,small,somewhat,stalked,stamen,stone,tal,tem,time,triangular,truncat,tube,ud,unit,unknow,vary,whitish,wide,ympodial	abaxial,anther,arrangement,bud,channel,characteristic,colour,corolla,form,growth,height,inflorescence,length,ovary,plant,seed,shape,stem,texture
367	wfo-0001030153	success	147	102	79	68	23	0.537	.1,.2,0.2-1,0.8-0.9,1-1.2,1-1.5,1-2,1.3-1.5,1.3-1.9,1.5-2,2-8,2.5-4,3-4,3-5,3-50,5-6,6-8,acuminate,acute,anther,anthesi,apex,apiculate,apparently,attenuate,base,berry,branched,brittle,calyx,cm,conical,corolla,deltate,diameter,dry,elliptic,entire,filament,flower,glabrous,globose,green,growth,impressed,internodal,lanceolate,less,lobe,margin,membranous,mm,narrowly,nodding,ovary,pair,paler,pedicel,peduncle,petiole,primary,rachi,revolute,ripe,simple,slightly,small,specimen,stem,style,surface,terminal,thin,time,tree,treelet,vein,white,x	/3,0.8-1.3,1-10,1-2.5,2-lobed,3.5-10.5,abaxially,absent,adaxially,age,apart,ape,axil,bark,broadly,caly,campanulate,clavate,dark,densely,distinct,domatia,dot,eaf,ellipsoid,enlarged,erect,exerted,free,fruiting,glabrou,irregularly,known,lengthening,lobed,lower,markedly,minutely,new,nflorescence,occasionally,older,ot,papillat,papillate,perfect,pit-like,plane,plurifoliat,pore,poricidal,portion,resinous,ruit,scar,slit,spaced,stigma,straight,strongly,tip,tube,ud,unit,way,yellowish,ympodial,young	abaxial,adaxial,arrangement,branching,characteristic,colour,form,fruit,height,inflorescence,leaf,length,midvein,na,plant,pseudostipule,seed,shape,staman,tertiary,texture,unarmed,venation
368	wfo-0001030167	success	141	93	60	81	33	0.426	.8,.9,0.6,12,acuminate,along,anther,apex,base,calyx,chartaceous,ciliate,clavate,cm,contiguously,densely,diameter,entire,extra-axillary,filament,flattened,flower,fruit,glabrous,green,herbaceous,lanceolate,lobe,margin,membranaceous,minutely,mm,near,nearly,obtuse,ovate,ovoid,pedicel,peduncle,petal,petiole,pointed,rachi,rounded,sand-punctate,simple,slender,slightly,somewhat,spaced,sparsely,style,thinly,tip,unbranched,unknown,vine,weakly,white,x	0.1â0.2,0.5â0.6,0.5â0.7,0.6â0.8,0.7â1.2,0.8â1,1.2â2.5,1.5â2,1.5â7,14â19,15â20,17â58,1â1.2,1â1.5,2â3,2â4.5,4.5â8,4â10,4â4.5,4â5,4â7,5-merous,8â10,abaxially,accrescent,acute,adaxially,alyx,apar,apically,axe,berry,blade,branch,c.,ciliat,climbing,eaf,eed,enlarged,fertile,fruiting,gap,glabrou,immature,less,long,lower,m.,maturity,membranous,moderately,nflorescence,nternode,orolla,pair,penden,perfec,pinnate,plurifoliat,reflexed,ruit,scar,secondary,seen,stellate,stigma,subequal,symmetrical,tamen,tem,time,truncat,tube,unit,vary,vegetation,vein,venation,wide,ympodial	0.1-0.2,0.5-0.6,0.7-1.2,0.8-1,1-1.2,1-1.5,1.5-2,15-20,2-4.5,4-4.5,8-10,abaxial,adaxial,apart,arrangement,branching,characteristic,colour,corolla,form,growth,inflorescence,leaf,length,na,ovary,plurifoliate,seed,shape,staman,stem,surface,texture
369	wfo-0001030176	success	171	92	74	97	18	0.433	-6.25,.2,.7,.75-1.5,0.4-1.5,0.5-2,0.6-0.9,0.7-1.4,0.7â0.8,1.2,1.6,2.25-3.25,2â3,3-5,3-lobed,3.75-5,6-8,6â8,acute,anther,apex,attenuate,base,bilobed,broadly,calyx,chartaceous,ciliate,cm,depressed-globose,diameter,especially,extra-axillary,few-branched,filament,flattened-reniform,flower,fruit,glabrous,herb,lanceolate-oblong,light,lobe,long,margin,midrib,mm,near,nearly,node,numerous,often,ovate,pale,pedicel,peduncle,petiole,plant,pubescent,rachi,rarely,ripe,slightly,sometimes,sparsely,style,unbranched,violet,white,winged,x,yellow,yellow-orange,young	-1.4,-4.25,0.5,1,1-2,1-5,1.2-2.5,1.5-2,1.5-2.5,1/3,1/6,2-3,2-foliate,2.5,2.5â7.5,2.5â9,4-9,5-merou,abaxially,accrescent,adaxiall,adaxially,alyx,angulate,apart,apparently,articulated,asymmetrically,axe,ba,basal,berry,bi-lobed,blade,branch,broad,capitat,connivent,contact,covering,cylindrical,decumbent,dehiscent,downward,eaf,eed,erec,forming,fruiting,geminat,hair,hermaphroditic,hold,interlobal,juic,lance-ovate,lateral,line,lon,longitudinall,lower,major,mesocarp,minutely,nflorescence,oblong,orolla,partially,patch,perfect,pore,prostrate,recurve,recurved,rooting,rotate-stellate,round,ruit,simple,sinus,soil,somewhat,spaced,stigma,tamen,tem,terminal,time,tip,triangular,tube,unit,vary,vein,white-puberulent,wide,ympodial	abaxial,adaxial,characteristic,colour,corolla,form,growth,height,inflorescence,leaf,length,ovary,seed,shape,staman,stem,surface,texture
370	wfo-0001030180	success	135	111	85	50	26	0.63	.1,.5,0.05-1,0.5-1,0.8-2,0.9-1.8,1-1.5,1.1-1.2,3-4,3-8,4.5-5,6,8-10,8.5-23,?,abruptly,anther,anthesi,apart,apex,apiculate,appearing,attenuate,bark,base,calyx,clavate,cm,corolla,dark,decurrent,deltoid,ellipsoid,exserted,filament,fruit,fruiting,furcate,glabrous,globose,green,height,lateral,leaf,linear,lobe,lobed,long-acuminate,main,minutely,mm,narrowing,nearly,occasionally,opposite,ovary,pair,papillate,papillose,pedicel,petiole,planar,poricidal,puberulent,raised,scar,shrub,slightly,soon,sparsely,stem,stigma,straight,style,surface,terminal,tip,trichome,tube,uniseriate,unknown,vein,widely,winged,x	.75,10-30-flowered,accrescent,becoming,berry,clu,deflexe,dia,eaf,edicel,eed,erect,free,glabrate,immature,inflorescenc,interpetalar,known,lenticellat,lon,long,lower,middle,minute,nflorescence,older,overlapping,peduncl,plurifoliat,pore,portion,prominent,proximal,rounded,ruit,shaped,sinus,slender,spaced,tear-drop,thin,ud,unevenly,unit,white,widest,woody,yellowish,ympodial,young	arrangement,bud,characteristic,club,colour,diameter,elevation,exsertion,form,growth,inflorescence,length,lenticellate,lobing,na,peduncle,plant,plurifoliate,pubescence,seed,shape,spacing,texture,type,venation,width
371	wfo-0001030189	success	188	113	89	99	24	0.473	0-1,0-30,0.5-1.6,0.9-1.1,1,1-1.5,1-2,1.3-4.2,1/3,2-5.5,2.5-4,3-4,3.2-4.5,4-5.5,5-10,5-6,6-12,anther,apex,apparently,articulated,base,berry,branched,calyx,chartaceous,cm,concolorous,cordate,densely,diameter,drying,dull,elliptic,entire,erect,evenly,faint,filament,flattened-reniform,fruit,glabrescent,green,infructescence,lateral,leaf,length,lobe,long,lower,margin,maturity,mauve,mm,moderately,oblong,obtuse,orange,ovate,pair,pedicel,peduncle,per,petiole,primary,purple,red,rounded,shrub,simple,sometimes,sparsely,spherical,stellate-pubescent,stem,style,surface,terete,terminal,tertiary,unarmed,upper,vein,venation,visible,wide,yellow,yellow-green,young	-1/2,-4,.2,/3,0-15,0.1,0.1-0.2,0.2-0.3,0.2-0.5,1-3-cellular,1-4-cellula,1-4-cellular,1.1-2.7,1.5-2,1.5-4.5,1.5-5,1/,1/6-1/3,2,2-3,4-13,5-,5-merous,6-10,8,8-10,8-18,abaxially,acut,alyx,apar,apically,appressed,bark,blade,connivent,curved,deltate,eaf,eed,elongating,equal,flower,foliaceous,free,frui,fruiting,glabrescen,glabrous,gland-tipped,gray,lobed,longer,mature,midpoint,nflorescence,often,older,one,open,orolla,oung,perfec,pericarp,plurifoliat,poricidal,porrect,portion,ray,recurved,red-brow,reflexed,ruit,scandent,scar,sessile,shorter,slender,smooth,somewhat,spaced,spreading,stalk,stalked,stellate,strongly,tamen,tapering,time,tip,trichome,tube,unarme,unit,variously,vary,way,woody,ympodial	1/4,abaxial,adaxial,arrangement,branching,characteristic,colour,corolla,form,growth,height,history,inflorescence,life,midvein,na,ovary,plant,rachi,seed,shape,staman,texture,ye
372	wfo-0001030219	success	191	104	57	134	47	0.298	1.5,60,abaxially,acute,adaxially,anther,anthesi,apex,articulated,base,black,blue,branched,brown,calyx,cm,decurrent,deeply,densely,diameter,elliptic,filament,flattened,fruit,glabrous,globose,green,incised,lanceolate,leaf,lilac,lobe,margin,marking,mm,moderately,oblong,olive,ovate,pale,paler,pedicel,peduncle,perennial,petiole,pitted,pubescent,purple,shallowly,shrub,sparsely,style,surface,velutinous,winged,woody,x	0.1â0.3,0.2â2.3,0.4â1.0,0.5,0.5â,0.7â1.1,0.8â3.0,0â,1.0â1.2,1.0â1.5,1.0â2.0,1.0â2.2,1.3â2.9,1.4â2.8,1.6â,10,15,1â2.5,2.0â2.5,2.0â3.2,2.0â5.5,2.4â6.0,2â,2â2.5,2â3,2â4.5,3,4.5â5.5,4.8â11.5,4â5,4â7,5,5â,5â8,6â,6â10,6â8,7â11,8â18,9â10,9â12,abaxiall,acut,adaxiall,adnate,ag,along,anisophyllous,apart,apical,apparently,appearing,arising,arranged,axe,ba,basal,blade,bractâlike,cell,chartaceous,clavat,concave,connivent,convex,cylindrical,decreasing,diamete,difoliate,directed,distally,eaf,eed,equal,erect,flower,geminat,glabrescent,hair,indistinct,internode,long,longitudinal,lower,multicellular,nflorescence,number,opening,opposed,oppositely,orolla,pair,pentagonal,perfect,pore,present,procumbent,rapidly,redâpurple,regularly,rounded,ruit,serrate,sessile,sid,side,simple,size,smaller,spaced,split,stigma,stone,straight,stripe,strongly,tal,tamen,tem,time,tube,two,unicellular,uniseriate,unit,vary,white,wide,wing,yellow,ympodial,â3.0,â7.0,â9.5	0.1-0.3,0.2-2.3,0.5-,1.0-1.2,1.0-2.2,1.3-2.9,1.6-3.2,2-2.5,2.0-2.5,2.0-5.5,4-7,4.5-5.5,5-8,7.0,9-10,9.5,abaxial,adaxial,arrangement,branching,characteristic,colour,corolla,form,growth,height,history,inflorescence,length,life,midvein,na,opposite,ovary,plant,primary,pseudostipule,rachi,seed,shape,staman,stem,tertiary,texture,unarmed,vein,venation
373	wfo-0001030225	success	155	124	102	53	22	0.658	-11,-30,-4,-45,-7,.5,.5-2.5,0,0-20,0-5,1,1-4,1-6,1.5,1.5-2.5,10-15,10-30,2,2-2.5,2-3,3-11-compound,3-4,3-5,4-5,abaxially,absent,acuminate,acute,adaxially,apart,apex,apical,apically,articulated,basal,base,bilobed,calyx,campanulate,cm,conivent,connective,cordate,coriaceous,cuneate,cylindrical,deltate,densely,diameter,dilated,elliptic-ovate,entire,equal,exceeding,expanded,fleshy,flower,forked,fruit,glabrate,glabrous,gland,globose,leaf,leaving,less,lobe,long,margin,mm,moderately,oblong,obtuse,pedicel,peduncle,petiole,pinnately,possibly,prominent,puberulent,purple,rachi,radiu,scar,shallowly,shrub,simple,small,sparsely,stellate,stigma,strongly,style,succulent,thecae,tip,tree,truncate,two,unbranched,unknown,x	-1.5,2-18,2-6,3-20,3-foliat,8-15,ape,ature,axe,beyond,blade,color,compound,directed,distally,eaf,eed,especially,exserted,immature,laterally,leaflet,lower,minutely,narrowly,nflorescence,nther,one,orolla,papillose,perfect,pore,puberulen,see,seen,slightly,somewhat,spaced,stalked,stamen,tal,tem,time,tomento,toward,triangular,tube,ud,unit,unknow,vary,wide,ympodial	anther,arrangement,articulation,bud,characteristic,colour,corolla,form,growth,height,inflorescence,length,ovary,plant,pubescence,seed,shape,spacing,stem,surface,texture,theca
374	wfo-0001030250	success	169	75	49	120	26	0.29	0.5-1,1-3,1.1-1.2,1.4-1.5,1.7-7,2.5-3.25,3.5-4,5-6,anther,apex,base,berry,brown,calyx,cm,corolla,dark,decurrent,elliptic-ovate,filament,glabrous,globose,green,greenish-white,greenish-yellow,inflorescence,leaf,lobe,long-acuminate,minutely,mm,orbiculate,ovary,ovoid-reniform,pale,pedicel,petiole,pitted,sea-green,seed,shape,shrub,simple,stem,style,surface,tan,translucent-green,white-lenticellate	.5,/4,0-seeded,1-1.5,1.1-3.5,1.25-1.5,1.9-2.6,11.2-22,11.3,2-2.5,2.1-6,25,3-5,3.4-6.6,4-7,5-50-flowered,6-8,across,anthesi,apart,appearing,arching,attenuate,bark,beginning,beneath,broadly,bullate,capitate,carinate-hooded,conical,consisting,cuneate,cup-shaped,curved,deflexed,dia,differing,difoliate,dry,eaf,edicel,eed,elliptic,exerted,five,free,fresh,fruiting,geminat,glabrou,horizontally,inflorescenc,irregularly,lateral,lobed,lon,long,lower,main,major,maturity,middle,minor,n,nflorescence,node,occasionally,older,one,opposite,orbicular,pair,paler,papillo,papillose,pendulous,pit,pore,poricidal,portion,projection,prominent,proximal,raised,reflexed,rim,ruit,scar,shallow,shaped,size,slender,slightly,smooth,soon,spaced,specimen,spreading,stigma,straight,tall,tapering,tear-drop,tip,translucent,tube,two,ud,unit,usually,vein,way,white-lenticellat,wide,widest,winged,woody,x,ympodial	0.5,1.5,abaxial,adaxial,arrangement,branching,characteristic,colour,diameter,form,fruit,growth,height,history,length,life,margin,na,peduncle,perennial,plant,pseudostipule,rachi,staman,texture,unarmed
375	wfo-0001030271	success	195	123	90	105	33	0.462	0.15-0.75,0.7-9.5,1-2,1-2.5,1-3,1-7,1.4-2.1,15-61,2-6,2.4-5.6,3-10,4-22,4-7,5-8,acute,anther,apex,articulated,attenuate,axillary,base,berry,blue,brownish,bud,cell,cm,coloration,completely,condition,coriaceous,corolla,covering,dark,deep,diameter,distal,drying,elliptic,filament,flower,forked,fresh,fruit,generally,glabrous,green,green-white,greenish,hair-like,half,herb,lanceolate,lateral,leaf,light,lilac,lobe,long,make,medium,mm,mottled,mucilaginous,odd-pinnate,ovate,ovoid,pedicel,peduncle,petiole,petiolulate,plant,purple,ripe,rounded,seed,slightly,spot,style,subtending,terminal,testal,thick,throughout,usually,vein,wall,wet,white,whitish	0-2,0.5-1.2,0.9-2.5,0.9-3.6,1-4,1-6,1.9-6.6,2-2.7,2-3,2-4,3-5,3.4-7.5,5-merou,5.6-12.3,6-15,abaxially,acumen,adaxiall,adaxially,ag,along,alyx,apart,apparently,arranged,asymmetric,axe,basiscopic,bead,blade,capitat,clavate,connivent,considerably,decreasing,digestion,dorsally,eaf,edge,eed,enzyme,erect,exceeding,flat,folded,geminat,glabrou,habi,homostylous,honeycomb-shaped,interjected,larger,leaflet,lengthening,like,linear,living,lower,middl,moniliform,multiple,necklace,nflorescence,orbicular,orolla,pair,pentagonal,perfect,plurifoliate,pore,poricidal,removed,rosette,rotate,ruit,sessile,seudostipule,side,size,slit,sometimes,spaced,specimen,stamen,stigma,stolon,straight,symmetric,tall,tamen,tem,tip,tissue,toward,tri-,tube,tuber,typically,unit,unwinged,vary,wide,x,yellow,ympodial	2,abaxial,adaxial,arrangement,branching,calyx,characteristic,colour,form,growth,height,history,inflorescence,length,life,margin,middle,midvein,na,ovary,perennial,primary,pseudostipule,rachi,shape,staman,stem,surface,tertiary,texture,true,unarmed,venation
376	wfo-0001030272	success	179	111	89	90	22	0.497	-6,/4,0.5-1,0.5-1.5,0.5-2,0.65-1,0.7-2.5,0.8-1.5,1,1.2-1.8,1/3,2.5-3,2.8-3.5,3.5-5,4-6,acute,almost,anther,apex,apically,articulated,base,berry,bright,calyx,cm,deltate,diameter,elliptic,entire,erect,evenly,filament,flattened-reniform,fruit,glabrescent,glabrous,glandular,green,hair,lateral,leaf,length,less,lobe,lobed,long-attenuate,margin,maturity,mauve,membranous,minute,mm,moderately,near,obtuse,orange-brown,pair,pedicel,peduncle,petiole,primary,red,red-brown,rounded,shallowly,shrub,simple,slender,sometimes,spherical,stellate,stellate-pubescent,stem,straight,style,surface,terminal,tertiary,trichome,unarmed,unbranched,undulate,upper,vein,venation,visible,way,young	.3,.5,0-20,0.05-0.1,0.05-1.5,0.6-0.9,1-1.5,1-2.8,1.5-2.5,1.5-3,1/3-2/3,10-20,2-2.5,2-6.5,2.5-3.5,3-8,4-10,4-15,4-8,5-7,5-merous,abaxially,acut,alyx,ame,apar,apparently,ba,bark,blade,c.,concolorous,connivent,densely,difoliate,drying,eaf,eed,elongating,equal,flower,free,fruiting,geminat,glabrescen,gland,gra,infructescence,long,longer,lower,mature,midpoint,multangulate,narrow-deltate,nflorescence,older,one,open,orolla,oung,per,perfec,pericarp,poricidal,porrect,portion,ray,reduced,reflexe,ruit,scar,sessile,shorte,smooth,spaced,sparsely,spreading,tamen,tapering,terete,time,tip,tube,unarme,unit,vary,wide,woody,ympodial	abaxial,adaxial,arrangement,branching,characteristic,colour,corolla,form,growth,height,inflorescence,midvein,na,ovary,plant,pseudostipule,rachi,seed,shape,staman,texture,true
377	wfo-0001030287	success	150	108	83	67	25	0.553	-11,0-15,0.5-1,1,1-10,1-15,1-2,1-2.5,1-4,1-5.5,1.5-2.5,1966,2,2-,2-5,3-9,4-5,4.5-6,8-13,acute,apart,apex,articulated,base,bluish,branched,calyx,chartaceous,cm,compound,cylindrical,deltate,dendritically,densely,diameter,down,eglandular,ellipsoidal,elliptic-ovate,entire,fide,flattened,forked,glabrous,hair,herb,lanceolate,leaf,lilac,lobe,long,margin,mm,moderately,narrowly,oblong,ovoid,pedicel,peduncle,petiole,pinnately,puberulent,pubescent,purple,rachi,radiu,rugulose,scar,shrub,simple,slightly,smith,stigma,strongly,style,subcordate,subcoriaceous,tip,truncate,unbranched,unknown,x,yellow	-40,-foliat,-many,.5-2.5,1-3,1.5-10,2-10,2-12,2.5-4,3,4-6,5-10,?,abaxially,adaxiall,adaxially,aggregate,axe,basiscopically,blade,cell,color,connivent,decurrent,dendritic,dendritic-pubescen,directed,distall,eaf,eed,flower,gland,glandular,lateral,leaflet,leaving,lon,long-stalked,lower,membranaceous,nflorescence,nther,obtuse,often,orolla,pedicellar,pore,presen,ruit,scattered,spaced,sparsely,sparser,stalked,stellate,stone,subcapitat,tal,tem,time,triangular,tube,unit,upper,vary,wide,ympodial	abaxial,adaxial,anther,arrangement,articulation,characteristic,colour,corolla,dendritic-pubescent,form,fruit,growth,height,inflorescence,length,ovary,plant,seed,shape,spacing,stem,subcapitate,surface,texture,type
378	wfo-0001030300	success	235	101	81	154	20	0.345	-1,-7,0.4-0.5,0.5,0.5-1,0.5-4,0.6-0.8,0.7-0.8,0.9-1,1,1-2,1-4,1.4-2.4,2-2.1,2-locular,3/4,adaxial,almost,anther,apex,articulated,basal,base,broadly,brown,calyx,cm,cordate,corolla,crenate,densely,diameter,elliptical,entire,filament,finely,fruit,glabrous,globose,golden,green,herb,imparipinnate,inflorescence,interrupted,irregularly,less,like,lobe,margin,midvein,mm,obovate,occasionally,once-branched,orbicular,ovary,pale,pedicel,peduncle,perennial,petiole,plant,primary,pseudostipule,pubescent,rest,rounded,silky,simple,sparsely,spathulate,stem,style,surface,tertiary,triangular,vein,yellow,yellowish,yellowish-green	-0.9,.5,0.1,0.1-0.15,0.15-1,0.2,0.2-0.5,0.2-1.5,0.4-1.5,0.4-4.5,0.5-0.6,0.5-5,0.6-0.7,0.7-1.2,0.7-1.5,0.8-1,0.8-3,0.8-4,1-1.3,1-2-celled,1-6,1-celled,1.2-,1.5-,1.5-2.5,2-2.5,2-3,2-4,2-foliate,2.2-7.5,3.5-13,4-11,4-celled,6-15,6-8-celled,9-12,abaxially,absent,abundant,acute,adaxially,although,always,anthesi,apical,appearance,appendage,articulation,ba,bent,beyond,bifid,bract,bracteate,brittle,capitate,cell,coherent,column,crenat,curved,deltate,developed,diamete,distal,eaf,edicel,eed,eglandular,ellipsoidal,elongate,even,exserted,face,flower,frequently,fruiting,give,glandular,glutinous-viscose,gree,hair-like,halfway,head,interjected,internode,introrse,lamina,large,larger,lateral,leaflet,leave,lon,long,longer,markedly,minute,moderately,multicellular,narrowly,nflorescence,node,oblique,outgrowth,pair,papillae,partially,pentagonal,petal,petiolule,pith,population,pore,present,pubescence,reflexed,ruit,secondary,slightly,spreadin,spreading,staminal,sterile,stigma,straight,strongly,tall,tem,terminal,testa,thick,tip,trichome,tube,two,ud,underlying,unicellular,uniseriate,unit,united,upper,usually,velvety,wall,weak,well,wide,wider,winged,woody,ympodial,zygomorphic	abaxial,arrangement,branching,characteristic,colour,form,growth,height,history,leaf,length,life,na,rachi,seed,shape,staman,texture,unarmed,venation
379	wfo-0001030311	success	182	112	69	113	43	0.379	.2,.5,0.1,5-pinnate,<,acuminate,acute,adaxial,anther,apex,base,brown,calyx,chartaceous,clavate,cm,color,deltoid,densely,diameter,entire,extra-axillary,filament,flattened,flower,fruit,glabrous,granular,green,half,herbaceous,lenticular,lobe,lower,margin,membranaceous,midvein,minutely,mm,oblique,obtuse,orangish,ovoid-rhomboid,papillose,pedicel,peduncle,petiole,pubescent,purplish,rachi,rounded,sand-punctate,short,slender,slightly,sparsely,stem,style,surface,tan,terrestrial,thickened,tip,trichome,unbranched,vein,vine,white,x	.5â1.8,0.1â0.2,0.3â1.5,0.4â2,0.5â0.8,0.5â1,0.5â2,0.5â2.5,0.6â1,0.6â2.4,0.8â1.2,0.8â4,0.8â4.5,1.2â7,1.5â2,1.5â3,1.5â5.5,1.5â6,1.5â8,1.8â2,15â22,1â1.2,1â1.5,1â2,1â2.5,1â3,2.2â2.5,2.2â3,2.5â9,2â10,2â2.5,2â6,3â5,3â7,5â10,abaxially,accrescent,adaxially,along,alyx,apar,apical,appearance,axe,basal,berry,blade,c.,capitat,ciliat,ciliate,cordate,cuneate,dense,distal,eaf,eed,elliptical,especially,falcate,fallen,fruiting,giving,glabrou,groov,groove,ground,hair,lanceolate,lateral,leaflet,like,log,lon,long,m.,membranous,nflorescence,nternode,obovate,occasionally,orolla,pair,petiolulate,petiolule,plurifoliat,present,proximal,pubescence,rhomboid,ruit,scattered,sessile,shortly,side,smaller,spaced,stellate,stigma,strongly,tamen,tem,thick,thinner,trailing,tube,unit,upper,vary,wide,wide-diameter,widely,ympodial	0.5-0.8,0.5-1,0.6-1,0.8-1.2,1-1.2,1-1.5,1-2.5,1-3,1.5-2,1.5-5.5,1.8-2,15-22,2-2.5,2-6,2.2-2.5,2.2-3,3-5,5-10,abaxial,arrangement,branching,characteristic,colour,corolla,form,growth,habit,inflorescence,leaf,length,na,ovary,plant,plurifoliate,primary,pseudostipule,seed,shape,staman,tertiary,texture,unarmed,venation
380	wfo-0001030311	success	203	114	90	113	24	0.443	.2,.5,0.1,0.5-0.8,0.5-1,0.6-1,0.8-1.2,1-1.2,1-1.5,1-2.5,1-3,1.5-2,1.5-5.5,1.8-2,15-22,2-10,2-2.5,2-6,2.2-2.5,2.2-3,3-5,5-10,<,abaxially,acuminate,acute,adaxial,adaxially,anther,apart,apex,articulated,base,brown,chartaceous,clavate,cm,color,cordate,deltoid,densely,diameter,entire,especially,filament,flattened,flower,fruit,glabrous,granular,green,groove,hair,half,herb,lenticular,lobe,lower,margin,membranaceous,midvein,minutely,mm,oblique,obtuse,orangish,ovoid-rhomboid,papillose,pedicel,peduncle,petiole,pubescent,purplish,rachi,rounded,short,simple,slender,slightly,spaced,sparsely,style,surface,tan,thickened,tip,unbranched,vein,white,x	.5-1.8,0-2.5,0.4-2,0.5-2,0.6-2.4,0.8-4,0.8-4.5,1.2-7,1.5-3,1.5-6,1.5-8,2224,3-7,5-merou,5-pinnate,8031,[,],absen,absent,accrescent,ag,aggregate,along,alyx,apical,apparently,appearance,axe,ba,basal,basally,blade,capitat,cell,ciliat,ciliate,connivent,cuneate,dense,dig,directed,distal,distally,eaf,eed,elliptical,equal,falcate,fallen,formation,g,geminat,gh,giving,groov,ground,interjected,large,lateral,leaflet,like,log,lon,long,longitudinal,m.,nflorescence,node,oblong,obovate,occasionally,opening,orolla,pair,perfect,petiolulate,petiolule,pittier,plurifoliate,pore,present,proximal,rhomboid,rooting,ruit,scattered,sessile,shortly,side,sinple,slit,smaller,stellate,stem,stigma,stone,strongly,tamayo,tamen,tem,thick,thinner,trailing,tube,uniseriate,unit,upper,vary,wide,widely,yellow,ympodial	abaxial,arrangement,branching,calyx,characteristic,colour,corolla,form,growth,inflorescence,leaf,length,na,ovary,pinnate,primary,pseudostipule,seed,shape,staman,tertiary,texture,unarmed,venation
381	wfo-0001030335	success	153	124	106	47	18	0.693	.1,.25,.5,0-5,0.05-0.2,0.25-0.5,0.5-1,0.7-1,1-1.5,1-2,1-3-flowered,1.1-1.4,1.1.5,2-2.2,2-2.5,2-5,2.5-3,3/4,5-6,acute,along,anther,anthesi,apex,bark,base,beneath,berry,bi-lobed,bud,calyx,cm,corolla,dark,deciduous,decurrent,deltoid,densely,dia,dry,elliptic,erect,exserted,filament,filiform,flattened,fruiting,gently,giving,glabrous,globose,green,greyish-red,horizontally,leaf,lightly,like,lobe,lobed,long,material,minute,minutely,mm,narrowly,obovoid,often,older,onto,ovary,ovoid-reniform,pale,papillose,pedicel,petiole,pitted,pore,poricidal,puberulent,pubescent,reflexed,ripe,shaped,shrub,simple,soon,sparsely,spreading,stem,stigma,strongly,style,surface,tan,tapering,tear-drop,tip,trichome,tube,uniseriate,vein,way,winged,x,yellowish-green,young	.75,0.1-0.5,2-4.5,5-7,7-13,acuminate,aspec,ba,branch,conical,deflexed,eaf,edicel,eed,except,expanded,free,geminate,lamina,lateral,lenticellate,lon,lower,main,middle,nflorescence,occasionally,opposite,pair,papillo,portion,prominent,puberulen,raised,ruit,slightly,straight,tall,ud,underside,unifoliat,unit,white,widest,woody,yellow,ympodial	arrangement,aspect,branching,characteristic,colour,diameter,form,fruit,growth,height,inflorescence,length,plant,pubescence,seed,shape,texture,unifoliate
382	wfo-0001030336	success	266	115	93	173	22	0.35	0.2-1,0.5,0.5-0.7,0.6-0.8,0.8-1.3,1-1.5,1-3,1.7-2.3,1.8-3.0,2/3,3-5,4-10,acute,almost,anther,apex,articulated,basal,base,basiscopically,bifurcate,bluntly,bright,brown,calyx,cell,cm,conical,corolla,crenate,dark,decurrent,deeply,densely,diameter,elliptic,entire,filament,flushed,fruit,globose,grayish,green,greenish,hair-like,half,herb,imparipinnate,inflorescence,interrupted,lanceolate,lateral,leaf,less,lobe,lobed,margin,markedly,midvein,minutely,mm,oblique,obovate,occasionally,once-branched,orbicular,outgrowth,ovary,pale,pedicel,peduncle,perennial,petiole,primary,proximal,pseudostipule,puberulent,pubescent,purple,rachi,rounded,stem,style,surface,ten,tertiary,testa,truncate,uniformly,velvety,wall,white,yellow	-1.5,-10,-19,-2,.5,0-,0.1-0.3,0.1-0.5,0.1-0.7,0.1-1,0.15-0.2,0.15-0.9,0.2,0.2-0.25,0.2-0.8,0.2-1.5,0.3-0.4,0.3-1.1,0.5-1,0.5-1.5,0.6-1.5,0.8-0.9,0.8-1.2,0.8-3,1,1-1.4,1-celled,1.0-1.4,1.5-,1.5-2,1.5-3.5,1.5-5,1.6-7,1/4-1/3,10,2-4,2-9,2-foliate,2-locular,4,4-,4-celled,6,8-16,8-20,8-celled,absent,adpressed,amongst,anthesi,apical,appearance,appearing,appendage,articulation,bent,berry,bract,bracteate,branch,capitate,clavat,coat,column,completely,cordate,curved,darker,developed,diamete,distal,divided,eaf,edicel,eed,eglandular,elongate,entir,erect,essentially,exserted,extremely,first,flower,fruiting,giving,glandula,glandular,halfway,head,interjected,internode,investing,large,larger,largest,leaflet,leave,like,lon,long,longer,loosely,lower,maturity,mere,middl,minute,mixed,mostly,narrowing,narrowly,nflorescence,node,often,pair,papillate,part,petiolule,population,present,range,reflexed,rest,rotate,ruit,scattered,secondary,sessile,shaggy,shorter,shrub,silky,simple,sinus,slightly,small,soft,sometimes,southern,sparse,spreadin,spreading,staminal,stellate,sterile,stigma,straight,stripe,strongly,surrounding,tall,tem,terminal,thick,tip,trichome,tube,two,ud,unicellular,uniseriate,unit,united,upper,usually,way,weak-walled,wide,winged,woody,ympodial,young	abaxial,adaxial,arrangement,branching,characteristic,colour,form,growth,height,history,length,life,middle,na,plant,seed,shape,staman,texture,unarmed,vein,venation
383	wfo-0001030342	success	155	67	44	111	23	0.284	1-6.5,1.5,3-pinnate,5-merous,acuminate,apex,berry,brown,chartaceous,cm,dense,diameter,entire,flower,fruit,glabrous,greenish,herbaceous,leaf,lenticular,light,margin,membranous,mm,obtuse,ovoid-rhomboid,pedicel,peduncle,petiole,pubescent,rachi,rarely,scattered,slender,smooth,stem,surface,trichome,unbranched,undulate,vine,widely,x,yellowish	.2,.5,0.1â0.2,0.3â1.2,0.5â1,0.5â3,0.5â5,0.8â1.5,0.8â4,1-5,1.2â3,1.5â13,1.5â2,1.5â5,1.5â7.5,10â25,1â1.2,1â1.5,1â2.5,1â3,1â5.5,1â6,1â7,2â,2â2.5,2â4,3,3â12,4â5,4â8,6â7,abaxially,abundant,accrescent,acute,adaxially,along,alyx,anther,apar,apical,apiculate,axe,base,blade,broadly,c.,calyx,capitat,ciliat,cordate,cuneate,cylindrical,deltoid,eaf,eed,elliptical,extra-axillary,filament,flattened,fruiting,glabrou,lanceolate,lateral,leaflet,like,lobe,lon,long,lower,m.,minutely,mottled,nflorescence,nternode,oblique,often,orolla,perfec,petiolule,plurifoliat,pointed,proximal,pubescen,revolute,rhomboid,rounded,ruit,sand-punctate,side,slightly,spaced,sparsely,stellate,stigma,style,tamen,tem,terrestria,tip,truncate,truncate-acuminat,tube,unit,vary,vein,white,wide,wide-diameter,ympodial,â7	1.5-13,1.5-5,10-25,3-12,abaxial,adaxial,arrangement,branching,colour,form,growth,habit,inflorescence,internode,length,merosity,plant,seed,shape,size,terrestrial,texture,type
384	wfo-0001030342	success	153	77	61	92	16	0.399	-7,.2,.5,1-1.5,1-6.5,1.5-13,1.5-2,1.5-5,10-25,2-,2-2.5,3,3-pinnate,4-5,4-8,anther,apart,articulated,base,brown,calyx,chartaceous,cm,cylindrical,diameter,entire,extra-axillary,filament,flower,fruit,glabrous,hair,herb,leaf,light,margin,membraceous,minutely,mm,pedicel,peduncle,petiole,pubescent,rachi,rarely,revolute,scattered,simple,slender,smooth,spaced,style,surface,terrestrial,trailing,unbranched,undulate,uniseriate,white,widely,x	0.5-1,0.5-3,0.5-5,0.8-4,1-1.2,1-3,1-5,1-5.5,1-6,1-7,1.2-3,1.5-7.5,2-3,3-12,5-merou,6-7,abaxially,absent,abundant,accrescent,acuminate,acute,adaxially,ag,along,alyx,apex,apical,apiculate,apparently,axe,ba,basally,blade,broadly,capitat,ciliat,connivent,cordate,cuneate,deltoid,directed,distally,eaf,eed,elliptical,equal,fruiting,geminat,interjected,lanceolate,lateral,leaflet,lenticular,lobe,long,longitudinal,lower,nflorescence,node,oblique,oblong,obtuse,opening,orolla,perfect,petiolule,plurifoliate,pore,proximal,pubescen,rhomboid,rooting,rounded,sagittate,side,slightly,slit,stellate,stigma,tamen,tem,tip,truncate,truncate-acuminat,tube,unit,vary,vein,wide,yellow,ympodial	abaxial,adaxial,arrangement,characteristic,colour,corolla,form,growth,inflorescence,length,ovary,seed,shape,staman,stem,texture
385	wfo-0001030353	success	227	126	106	121	20	0.467	.7,0,0-15,0-2,0-6,0.5-0.9,0.8-1.2,1-6,1.8-3,1/2-2/3,1/3,1/5,2.8-3.7,3-4,3.5-4,4-4.5,5,7-10,abaxial,acute,adaxial,anther,apex,apically,apparently,articulated,base,berry,brown,c.,calyx,chartaceous,cm,cuneate,densely,diameter,discolorous,drying,ellipsoid,elliptic,erect,evenly,filament,flattened-reniform,fruit,glabrescent,glabrous,green,lateral,leaf,length,lobe,lobed,long,long-styled,longer,lower,margin,maturity,mauve,midvein,mm,moderately,narrow-deltate,orange-brown,pair,pedicel,peduncle,per,petiole,plant,pointed,prickle,prickly,primary,reddish-green,shape,short-styled,shrub,simple,small,sparsely,stellate,stellate-pubescent,stem,strongly,style,subentire,surface,terminal,tertiary,time,tree,unarmed,unbranched,upper,vein,venation,visible,way,weakly,white-gray,wide,wo,yellow,young	-0.2,-1.5,-1/2,-2,-3,-5,-6,-merous,.1,.2,.5,0.1-0.2,0.1-0.3,0.15-0.3,0.5,0.8,1,1-2,1-3,1-7,1.2-1.8,1.8-2.2,1/,1/6,1/6-1/4,10-15,11-16,2-10,2-7,2.5-4,20-200,3-5.5,4-,4-5,5-6,6,6-15,6-8,8-15,abaxially,almost,alyx,andromonoecious,apar,apart,apiculat,bark,blade,broad-deltate,conical,connivent,curved,deltate,development,distal,distance,eaf,eed,elongating,equal,extending,flattened,flower,free,fruiting,half,hermaphrodite,heterostylous,infructescence,less,lowermost,mature,midpoint,multangulate,nflorescence,older,one,open,orolla,oung,patch,pendulous,pericarp,plurifoliat,poricidal,porrect,portion,ray,red-brown,reflexed,retaining,rounded,ruit,scar,sessile,shorter,side,smooth,sometimes,somewhat,spaced,spreading,stalk,stalked,staminat,stout,straight,tamen,tapering,terete,throughout,tip,trichome,tube,unarme,unit,vary,warty,whit,woody,ympodial	4-6,apiculate,arrangement,branching,characteristic,colour,corolla,form,growth,height,history,inflorescence,life,na,ovary,pseudostipule,rachi,seed,staman,texture
386	wfo-0001030407	success	182	93	65	117	28	0.357	.5,1-2,12-14,2-5,2-7,3-6.5,3-9,30-60,4-5,5,6-7,7-8,acuminate,anther,apex,base,berry,brownish,cell,chartaceous,cm,condition,conical,corolla,covering,densely,diameter,drying,elliptic-lanceolate,filament,fresh,fruit,glabrous,green,greenish,hair-like,herb,lateral,leaf,light,lobe,long,margin,minute,mm,mottled,obtuse,odd-pinnate,ovate,ovoid,pedicel,peduncle,petiole,plant,pubescent,purple,ripe,round,seed,style,testal,thick,unwinged,wall,whitish	.2,0.7-3.2,1-10,1-3,1-4,1.5-5,12-15,2-2.5,2-6.7,3-10.5,3-4,3.5-9.5,5-merou,6.5-18.5,abaxially,absent,acumen,adaxially,ag,alyx,apart,apparently,articulated,axe,axillary,blade,bud,capitat,ciliate,connivent,decreasing,digestion,distal,dorsally,eaf,edge,eed,end,enzyme,especially,exceeding,flat,flower,folded,forked,geminat,generally,glabrou,gradually,green-white,hair,half,homostylous,honeycomb-shaped,interjected,lanceolate,larger,leaflet,lengthening,like,living,lower,make,middle,mucilaginous,nflorescence,one,orolla,pair,pentagonal,perfect,petiolule,placed,plurifoliate,pore,poricidal,proximal,pubescen,ray,removed,ruit,secondary,semierec,seudostipule,size,slit,spaced,specimen,stamen,ste,stigma,stolo,subequal,subsessile,subtending,symmetrical,tall,tamen,tem,terminal,thir,throughout,tip,toward,tri-,tube,tuber,typically,unit,usually,vary,wet,white,wide,x,yellow,ympodial	abaxial,adaxial,arrangement,branching,calyx,characteristic,colour,form,growth,height,inflorescence,length,midvein,na,ovary,primary,pseudostipule,rachi,shape,staman,stem,surface,tertiary,texture,true,unarmed,vein,venation
387	wfo-0001030420	success	170	98	78	92	20	0.459	-2,-20,-30,-pubescent,0.5-,0.5-1,0.5-4,0.5-8,1,1-1.5,1-2,1-3,1-4,1-6,1.5-3,1.5-5,10-,15-25,2-5,4-7,5-,5-15,6-7,7-22,acuminate,acute,also,apex,basal,base,calyx,chartaceous,cm,cordate,deltate,densely,diameter,eglandular,elliptic-ovate,entire,flower,forked,fruit,glabrate,glabrous,glandular-,glandular-puberulent,leaf,lobe,lobed,long,margin,mm,moderately,often,ovate,pedicel,peduncle,petiole,pinnately,puberulent,pubescent,pubescent-pilose,purple,rachi,rarely,shrub,simple,small,sparsely,style,subcoriaceous,tip,tree,truncate,unbranched,unknown,x	-35,-4,-9,1-,1-7.5,1/2,10-25,2-,2-14.5,2-3,2-6,2-9,3-7,3-lobed,4-foliat,5-6,7-19,7/8,abaxially,absent,adaxially,aggregate,apart,ape,articulated,axe,beyond,blade,cell,color,connective,connivent,cylindrical,dark,directed,distally,divided,eaf,eed,eglandular-pilo,eglandular-puberulent,ellipsoidal,elongated,equal,exserted,hair,lanceolate,leaving,lon,lower,midrib,narrowly,nearly,nflorescence,nther,obtuse,orolla,pedicellar,perfect,pilose,pore,presen,puberulent-pubescent,pubescent-pilo,radiu,remnant,ripe,ruit,shorter,sinus,spaced,stamen,stellate,stigma,stone,tal,tem,thecae,time,tomento,triangular,truncat,tube,ud,unit,unlobed,vary,vein,wide,yello,yellow,ympodial	abaxial,adaxial,anther,arrangement,characteristic,colour,corolla,eglandular-pilose,form,growth,height,inflorescence,length,ovary,plant,seed,shape,stem,surface,texture
388	wfo-0001030426	success	158	70	52	106	18	0.329	-30,0.4-0.7,1-4.2,15-25,2.5-4,2.5-6,3-6,4-10,6-8,9,branched,calyx,cell,cm,corolla,covering,cyme,diameter,dichasial,dichasially,ebracteate,elliptic-lanceolate,glandular,globose,green,hair-like,heart-shaped,herbaceous,lanceolate,lateral,leaf,linear,long,mm,monochasial,odd-pinnate,ovoid,pedicel,peduncle,perennial,petiole,pilose,plant,seed,spot,stripe,style,testal,thick,tuber-bearing,wall,white	0.3-7,0.3-8,1-4,1.5-3,1.5-6.5,1.7-3.2,10,2,2-3,3-12,3-4,3-6-foliat,4-6.5,6-11.5,abaxially,absen,acumen,acute,adaxially,apex,apical,apically,apiculate,articulate,base,caudate,connate,decurrent,dehiscent,digestion,diminishing,distal,dorsally,eaf,edge,eed,emoval,enzyme,exceeding,filament,flat,flower,folded,forked,generally,globo,gradually,green-white,half,honeycomb,interjected,introrse,larger,leaflet,linear-lanceolate,linear-oblong,living,lobe,lon,lower,make,maturing,mucilaginous,nflorescence,nther,oblique,oblong,obtuse,often,orolla,pair,pattern,perfect,pinnatifi,plan,poricidally,proximal,rachi,reveal,rounded,ruit,second,sessile,seudostipule,short,size,slit,specimen,stamen,stellate,stigma,straight,tal,tem,terminal,throughout,toward,typically,unit,vary,whit,wide,without,yellow,ympodial,Â¼	anther,arrangement,characteristic,colour,form,fruit,growth,height,history,inflorescence,length,life,ovary,shape,stem,surface,texture,ye
389	wfo-0001030430	success	171	110	92	79	18	0.538	.2,.5,0.5â12,0.6â1.0,0â20,1.0â1.5,1.0â2.0,1.4â1.5,1.5â1.7,1.6â1.8,12â20,1â3,2.0â3.0,2.0â4.2,2â3,3.0â4.5,30â200,3â17,3â4,3â5,3â8,5â10,5â6,abundant,acute,anther,anthesi,apart,apex,articulated,axillary,base,blue,borne,branched,brittle,brown,calyx,cell,cm,cylindrical,decurrent,densely,diameter,elliptic,erect,few-seeded,filament,flattened,fleshy,fruit,glabrous,globose,green,leaf,lobe,lobed,long,margin,mm,moderately,occasionally,ovate,pair,pale,pedicel,peduncle,perennial,petiole,pitted,present,pubescent,purple,regularly,rounded,shallowly,shoot,shrub,simple,spaced,stone,straight,style,subglabrous,surface,terminal,time,unifoliate,violet,white,woody,x	0.25,0.3,0.4,0.5,0.6,0.6â0.8,0.8â3.0,0.8â5.6,0.9â1.0,1.0â1.2,1.2â2.0,1.3â8.0,1.8â5.0,12â30,1â9,3â24,5,5.5â12,6â10,abaxially,adaxiall,adaxially,ag,apical,appressed,axe,ba,basal,blade,bud,capitate,chartaceous,clavate,connivent,convex,dentate,diamete,eaf,eed,equal,especially,flower,geminat,hair,indumentum,lon,longitudinal,lower,m.,multicellular,nflorescence,oblong,opening,orolla,pentagonal,perfect,pore,poricidal,ruit,serrate,shaped,side,slit,stigma,tal,tamen,tear-drop,tem,tip,toward,tube,uniseriate,unit,vary,wide,yellow,ympodial,â2.7,â40	arrangement,characteristic,colour,corolla,form,growth,height,history,inflorescence,length,life,ovary,plant,seed,shape,staman,stem,texture
390	wfo-0001030441	success	178	135	111	67	24	0.624	+,.5,0.5,0.5-0.75,0.5-3,1,1-1.4,1-1.5,1-2-celled,1.5-2,10-40,2,2-10,2-5.5,2.5,3-4,30,5-7.5,6-11,<,>,acuminate,acute,along,anther,apart,apex,articulated,attenuate,base,berry,branched,bright,c.,capitate,cell,closely,cm,corolla,decurrent,diameter,ellipsoid,elliptic,entire,eye,filament,flattened,flexuous,flower,glabrous,glandular,globose,green,growth,hair,irregularly,lateral,leaving,lobe,lobed,long,making,many,margin,membranous,midvein,minutely,mm,narrowly,new,occasionally,onto,open,pale,pedicel,peduncle,peg,per,petiole,plant,pubescent,red,reniform,ridged,ripe,scar,short,shrub,simple,slightly,spaced,spot,stellate,stem,stigma,style,surface,terminal,thin,time,trichome,tube,undulate,uniseriate,usually,vine,violet,wall,way,white,yellow	0.5-1,1.2-1.4,2-3,4-5,5-14,5-6,5-7,5-merou,ag,alyx,anthesi,ark,brow,calyx,deltate,distall,eaf,eed,exerted,free,fruiting,glabrou,glandula,ilament,impressed,juicy,lengthening,lon,lower,markedly,nflorescence,older,orolla,otherwise,pair,papillat,papillose,perfect,pericarp,plurifoliat,pore,poricidal,portion,primary,reflexed,ruit,scandent,shiny,shrubby,slit,small,somewhat,spreadin,spreading,strongly,tem,tip,trailing,triangular,ud,unit,upper,vary,vein,wide,woody,ympodial	abaxial,adaxial,arrangement,articulation,bark,brown,bud,characteristic,colour,distally,form,fruit,height,inflorescence,leaf,length,number,ovary,papillate,ridging,seed,shape,texture,width
391	wfo-0001030444	success	196	78	53	143	25	0.27	0.15-0.8,0.8-2,1-10,1-2,11-45,2-8,2.4-3.8,3-10,3-5,4-17,4-7,anther,articulated,berry,blue,ciliate,cm,coriaceous,corolla,dark,deep,diameter,distal,elliptic,filament,forked,fruit,glabrous,green,greenish,half,herb,high,lanceolate,leaf,light,lilac,lobe,margin,medium,mm,odd-pinnate,ovate,ovoid,pedicel,peduncle,petiole,plant,purple,seed,style,terminal,whitish	0-24,1,1-4,1-5,1.1-2.7,1.2-1.8,2-3,2-6,2.3-3.6,3.7-6.8,4-39,5-merou,5.3-9,6.1-12.8,7.1-17.5,9.4-20.1,abaxiall,abaxially,acumen,acuminate,acute,adaxially,ag,along,alyx,apart,apex,apparently,arranged,asymmetric,attenuate,axe,axillary,base,basiscopic,bead,blade,brownish,bud,capitat,cell,clavate,condition,connivent,covering,decreasing,digestion,dorsally,dot,drying,eaf,edge,eed,enzyme,erec,exceeding,flat,flower,folded,fresh,geminat,general,generally,glabrou,green-white,hair-like,hal,homostylous,honeycomb-shaped,interjected,larger,lateral,leaflet,lengthening,like,linear,living,long,lower,make,moniliform,mucilaginous,multiple,narrow,necklace,nflorescence,orbicular,orolla,pair,pentagonal,perfect,petiolulate,plurifoliate,pore,poricidal,removed,ripe,rotate,rough,rounded,ruit,sessile,seudostipule,shortly,side,size,slit,sometimes,spaced,specimen,stamen,stigma,stolon,straight,subequal,subtending,symmetric,tall,tamen,tem,testal,thick,throughout,tip,tissue,touch,toward,tri-,tube,tuber,typically,unit,unwinged,usually,vary,wall,wet,white,wide,wing,x,yellow,ympodial	2,abaxial,adaxial,arrangement,branching,calyx,characteristic,colour,form,growth,height,history,inflorescence,length,life,ovary,perennial,pseudostipule,shape,staman,stem,surface,texture,unarmed,ye
392	wfo-0001030445	success	226	111	92	134	19	0.407	0.2-0.4,0.2-0.5,0.6-2.2,0.6-3.5,1-1.3,1-7,1.3,1.3-2,1.5-2.1,1.6-2,1.7-2.4,10-14,10-16,14,2.2-2.9,3.5-4.2,4.1-8.7,4.2-10,5-125,6.1-9.1,7.5-16,abaxial,abaxially,acuminate,along,anther,apex,around,base,berry,black,blade,branched,bud,capitate,cm,corolla,decurrent,deltoid-reniform,diameter,drying,elliptic,elliptical,elongated,entire,ferruginous,ferruginous-tomentose,filament,flower,fruit,glabrous,green,greyish-tan,hair,leaf,long,many,margin,midrib,midvein,mm,oblong-lanceolate,obovate,orangish-tan,orbicular,pedicel,peduncle,petiole,porrect-stellate,pseudoterminal,pubescent,rachi,reniform,reticulate-punctate,semi-spherical,sessile,shrub,side,simple,small,stem,stigma,style,surface,time,tomentose,tree,vein,white,x,yellowish,yellowish-tan	.1,.5,/5-2/3,0.1-0.7,0.2,0.2-0.7,0.3,0.4,0.5,0.7,0.8,1,1.1-4.3,1.3-1.8,1.8-3.5,15-35,2.1-5.2,2.2-3.5,2.4-4.7,3-5.4,3.1-5,3.4-5.6,5-merou,5.2-7.1,5.9-15,5.9-8.3,8.1-10,8.2-18,accrescent,acute,adaxially,ag,alyx,apart,appressed,articulated,axillary,bark,blunt-tippe,blunt-tipped,branch,brown,brownish-yellow,bulbous-based,calyx,concentrated,cylindrical,directed,distally,eaf,earl,edge,eed,erect,exserted,ferruginous-granular,free,fruiting,geminate,glabrate,glabrescen,globose,high,homostylous,inserted,intermediate,lackin,lateral,lengthening,lobe,lobed,lon,longitudinal,lower,m.,main,mostly,multangulat,multangulate,nflorescence,oblong,obscured,obtuse,older,open,orange,orolla,ovate,ovate-lanceolate,plurifoliate,pore,poricidal,porrect-stellat,pubescence,ray,relatively,resorption,rounded,ruit,runk,slightly,slit,somewhat,soon,spaced,sparse,sparsely,splitting,stalk,stamen,stellate,stout,subcampanulate,sulcate,suture,tamen,thick,thick-textured,thicknes,thin,thin-,tip,tissue,tomentum,tube,unarme,unit,vary,vestigial-rayed,way,wide,yellow,ympodial,young	adaxial,arrangement,characteristic,colour,form,growth,height,inflorescence,length,ovary,plant,primary,seed,shape,staman,texture,type,unarmed,ye
393	wfo-0001030447	success	276	143	125	151	18	0.453	.2,.3,.5,/5,0,0.5,0.5-0.65,0.5-10,0.5-3,0.7-1,0.8-3.5,1-1.5,1-2,1-5,1.8-2.5,1/3-2/3,2-4,2.2-2.8,3,3-4.5,3-5,4-8,6.5-9,7-8,8,abaxially,acute,adaxially,anther,apex,apically,apparently,armed,articulated,base,berry,calyx,cell,chartaceous,cm,corolla,cuneate,curved,deltate,development,diameter,discolorous,drying,filament,fine,flat,flattened-reniform,flower,fruit,gently,glabrescent,glabrous,globose,infructescence,lateral,leaf,length,less,lobe,lobed,long,long-styled,lower,margin,maturity,midvein,mm,moderately,oblique,oblong,often,opening,orange,orange-brown,orange-red,outline,ovate,pair,pale,pedicel,peduncle,per,petiole,pit,prickle,primary,purple,rachi,raised,red-brown,rounded,shallowly,shrub,side,simple,slender,small,sometimes,sparsely,spherical,stellate,stellate-pubescent,stem,straight,straw-yellow,style,surface,tertiary,throughout,unarmed,unbranched,usually,vein,venation,visible,weakly,white,x,yellow,Ã	0.1,0.1-0.3,0.15-0.3,0.2,0.2-0.4,0.4-0.7,0.4-0.9,0.8-1.7,1,1-10,1-2.5,1-3,1-6,1.5,1.5-2.5,1.5-7,1/3,1/3-1/2,1/4-1/3,2.5-10,2.5-6.5,30-45Â°,5,5-15,5-merou,6,6-10,6-16,6-7,6-8,6-9,accrescent,age,always,alyx,apar,apart,apical,axe,bark,beyond,blade,branche,broad-deltate,c.,characteristically,clavate,covering,cupular,dark,densely,difoliate,distance,divided,eaf,eed,elongating,equal,erect,exserted,extending,filiform,finely,finger-hair,flattened,free,fruiting,geminat,herbaceous,irregula,irregular,lengthening,long-ovoi,longer,longitudinal,mature,midpoint,minute,mostly,narrow-deltate,nflorescence,obconical,obtuse,older,one,open,orange-translucent,orolla,oung,papillo,pendulous,perfect,pericarp,persisting,point,pore,poricidal,porrect,portion,pronounced,prostrate,pubescent,ray,reduced,rest,ri,ridge,ridged,ruit,scar,sessile,shallow,shiny,short-styled,shorter,shortly,sinus,slit,smooth,somewhat,spaced,sparse,spreading,stalk,stalked,stigma,stout,stump,subsessile,tamen,tapering,terete,terminal,thick,thin,time,tip,toward,translucent,trichome,tube,ud,unequal,unit,variously,vary,wide,widest,woody,yellow-orange,ympodial	.2-2.8,abaxial,adaxial,arrangement,branched,branching,characteristic,colour,form,growth,height,inflorescence,ovary,plant,seed,shape,staman,texture
394	wfo-0001030453	success	127	84	54	73	30	0.425	.25,0.25-0.5,0.8-1.5,1-1.3,1-1.5,1.5-1.6,1.5-2.5,3-3.5,9-12,abaxially,acuminate,acute,adaxially,along,anther,apex,arachnoid,arachnoid-pubescent,attenuate,axi,base,broadly,calyx,cm,corolla,deltate,elliptic,filament,floccose,glabrous,leaf,lobe,long,margin,mm,narrowly,occasionally,ovary,pair,pedicel,petiole,pubescent,reddish,shiny,shrub,simple,sparsely,stem,straight,style,surface,trichome,vein,white	.5,/4,4-5,9-14,anthesi,bark,clavate,closely,cup-shaped,dark,deflexed,delicate,dendritic,densely,dia,divided,eaf,edicel,eed,ellipsoid,especially,exserted,fine,flat,free,glabrate,know,known,later,lateral,less,lon,lower,main,middle,midrib,minute,minutely,near,nearly,nflorescence,older,opposite,overlappin,papillat,papillose,planar,pore,poricidal,portion,reddish-brow,rounded,ruit,scar,shaped,slender,soon,spaced,stigma,strongly,tall,tear-drop,tip,tub,tube,ud,unifoliat,unit,way,wide,widest,ympodial,young	abaxial,adaxial,arrangement,branching,characteristic,colour,diameter,form,fruit,growth,height,history,inflorescence,length,life,midvein,na,peduncle,plant,primary,pseudostipule,rachi,seed,shape,staman,tertiary,texture,unarmed,unifoliate,venation
395	wfo-0001030486	success	141	70	53	88	17	0.376	.5,1-1.5,1-5,1.1-1.4,1.5-2,1.7-2,2-3,3-3.5,4-4.5,4.5-5,6-7,acute,anther,apex,base,brown,calyx,cm,corolla,dark,deltate,dry,drying,elliptic,filament,fleshy,fresh,glabrous,globose,green,leaf,lobe,margin,material,minutely,mm,ovary,ovoid-reniform,pedicel,petiole,pitted,shrub,simple,small,stem,style,surface,tan,tapering,treelet,white,x,yellow-green	0.8-2.2,1/2,1/4,10-12,10-14.5,2-5.5,3-5,3/4,4-6.5,5-8-flowered,abaxially,adaxially,anthesi,ba,bark,basal,beneath,berry,clavate,closely,clustered,completely,conical,deflexed,dia,differing,difoliate,distal,eaf,edicel,eed,ellipsoid,erect,exserted,f,free,fruiting,geminat,inflorescenc,internodal,later,lateral,lobed,lon,long,lower,m.,main,major,middle,minor,nflorescence,older,opposite,overlapping,pair,pale,papillo,papillose,planar,pore,poricidal,portion,reddish,ruit,scar,shaped,shin,size,slightly,spaced,stigma,stout,tall,tear-drop,thickened,tip,tub,tube,ud,unit,usually,vein,way,widest,woody,ympodial,young	characteristic,colour,diameter,form,fruit,growth,height,inflorescence,length,na,peduncle,plant,rachi,seed,shape,staman,texture
396	wfo-0001030489	success	196	138	117	79	21	0.597	-6.5,.5-2.8,0.25-0.4,0.5-3,0.6-0.9,0.75-0.9,0.9-1.1,1-3,1.1-1.3,1.2-1.5,1.2-1.6,1.6-2.1,2.1-2.9,3-6,3-8,4-8,4.5-9,5,7-15,abaxially,abruptly,acute,anther,apart,apex,appressed-pubescent,attenuate,bark,base,becoming,berry,blunt-tipped,branch,branched,broadly,brown,bud,calyx,chartaceous,cinereous,cm,conical,continued,corolla,deltoid,densely,diameter,dichotomously,due,echinoid,elliptic,elongate,entire,filament,fleshy,flower,fruit,glabrate,globose,greenish,growth,hair,honeycombed,lateral,leaf,length,lobe,long,long-acuminate,margin,minute,minutely,mm,mostly,multangulate,narrowly,oblong,obtuse,ovate,ovate-lanceolate,pale,pedicel,peduncle,petiole,porrect-stellate,probably,pseudo-terminal,pubescent,pulverulent,rachi,reniform,reticulate-punctate,ripe,sessile,several,short,short-stalked,shrub,simple,small,smooth,somewhat,stellate-pubescent,stem,stigma,style,subglobose,suborbicular,time,tomentose,tree,unarmed,white,x,yellow,yellowish,young	.5-3,.75-5.25,1-1.3,1-3.75,1.7-2,1.75-2,1.9-2.6,1/3-1/2,1/5-1/2,100,12-24,5-6,6-8,absen,acuminate,adaxiall,adaxially,ag,anthesi,apical-lateral,apparently,appressed,articulated,axe,axillary,ba,blade,closely,cylindrical,dehiscing,eaf,echinoi,eed,free,glabrous,high,inserted,introrse,large,lobed,long-exserted,longitudinal,lower,main,midvein,nflorescence,older,orolla,perfect,plurifoliate,pore,puberulent,pulverulen,ruit,runk,side,slender,slit,spaced,sparingly,sparse,stellate-rotate,subcampanulate,subcapitat,tamen,terete,testa,thick,toward,tube,turn,unarme,unit,usually,vary,vein,way,wide,ympodial	abaxial,adaxial,arrangement,characteristic,colour,form,height,inflorescence,ovary,plant,seed,shape,spacing,staman,subcapitate,surface,texture,thicknes,trunk,type,ye
397	wfo-0001030509	success	220	114	95	125	19	0.432	-10,-2,0,0-100,0-3,0-5,0.3-2.5,0.8-1.2,1-1.5,1-2,1.3-2,1/4,2-2.5,2-4.2,2-4.5,2-6,2.8-3,4.5-12,4.5-8,8-16,anther,apex,apically,apparently,articulated,base,berry,calyx,cm,cordate,cream,cuneate,dark,densely,diameter,entire,erect,filament,flattened-reniform,flower,fruit,glabrous,green,half,herb,inflated,lateral,leaf,length,lobe,lobed,long,lower,margin,marking,maturity,mauve,mm,moderately,narrow-deltate,narrow-oblong,obtuse,occasional,orange,orange-brown,ovate,pale,pedicel,peduncle,per,petiole,plant,prickle,prickly,purple,rounded,shrub,simple,smooth,sometimes,spherical,stellate-pubescent,stem,style,surface,terminal,trichome,unarmed,unbranched,upper,weakly,wide,yellow,yellow-green,young	-6,/3,0-0.3,0-15,0.1,0.1-0.2,0.1-0.25,0.1-0.3,0.2,0.5-1.5,0.6-1,0.8-4,1,1-3,1-4,1-6,1.5-2,1.7-2,1/,1/3-2/3,2-3,2/3-3/4,3-10,3-4,4.5-10,5-10,5-merous,7-15,7-9,abaxially,alyx,andromonoecious,apar,apart,apical,bark,becoming,blade,broad-deltate,brow,chartaceous,connivent,curved,difoliate,discolorous,distal,distance,drying,eaf,eed,elongating,equal,extending,eye,free,fruiting,geminat,glabrescent,gland,globular,gray,herbaceous,hermaphrodite,heterostylous,infructescence,long-acuminat,long-styled,longer,lowermost,mature,midpoint,midvein,naked,nflorescence,occasionally,often,older,one,open,orolla,oung,pair,pendulous,pericarp,perpendicular,poricidal,porrect,portion,primary,ray,reduced,ruit,scar,short-styled,shorte,shorter,side,slender,spaced,sparsely,spreading,stalk,stalked,staminat,stellate,straight,subsessile,tamen,tapering,terete,tertiary,time,tip,tube,unarme,unit,usually,variously,vary,vein,venation,visible,way,woody,ympodial	abaxial,adaxial,arrangement,branching,characteristic,colour,corolla,form,growth,height,inflorescence,long-acuminate,na,ovary,seed,shape,staman,texture,type
398	wfo-0001030516	invalid_json	172	96	68	104	28	0.395	0.4-1.5,1-7,1.1-4.1,1.5-2,1.8-2.4,3-6,3-8,4-22,4-6,4-7,4.2-10.7,8-9,acute,branched,calyx,cell,cm,corolla,covered,covering,cyme,darker,densely,diameter,dichasial,dichasially,ebracteate,elliptical,gland,green,hair,herbaceous,interjected,lateral,leaf,leaflet,light,lobe,long,long-attenuate,mm,monochasial,odd-pinnate,ovate,ovoid,pair,pedicel,peduncle,pentagonal,perennial,petiole,pilose,plant,puberulent,pubescent,rotate,seed,short-stalked,sometimes,spreading,stripe,style,terminal,testal,thick,tuber-bearing,wall,yellow	1-2.5,1-4,1.1-3.5,1.7,2-12,2-2.,2-3,2-4,3-6-foliat,3-9.8,4-4,6-15,9-22,9-32,abaxially,acumen,acuminate,adaxially,apex,apical,apically,articulate,base,connate,cordate,cuneate,decurrent,dehiscent,digestion,diminished,distal,dorsally,eaf,edge,eed,emoval,enzyme,exceeding,filament,first,flat,flower,folded,forked,generally,globo,globose,gradually,green-white,hair-like,half,honeycomb,introrse,less,living,lon,longer,lower,lunat,make,maturing,mucilaginous,nflorescence,nther,oblique,often,orolla,outline,pattern,perfect,plan,poricidally,proximal,rarely,reveal,ruit,second,sessile,seudostipule,short,short-petiolate,size,slightly,slit,specimen,stamen,stigma,straight,tal,tem,throughout,time,toward,triangular,triangulat,type,typically,unit,vary,whit,wide,ympodial,Â¼,â	'','hair-like,'type,2-21,[,],``,abaxial,adaxial,anther,arrangement,characteristic,colour,form,fruit,growth,height,inflorescence,length,ovary,shape,stem,surface,texture,value,width,{,}
399	wfo-0001030551	success	167	103	75	92	28	0.449	-30,0-2,0.5-1,0.6-1.5,1-10,1-2,1-2.5,1-3.5,1-4,1-5,1.5-2.5,10-20,10-40,2,2-3,2.5-5,20-25,4-,4-5,9-20,acuminate,acute,also,apex,articulated,basal,base,blue,calyx,chartaceous,cm,cordate,densely,diameter,entire,fading,flower,fruit,glandular-puberulent,globose,leaving,lobe,long,margin,mm,moderately,oblong-fusiform,obtuse,often,ovate,ovate-elliptic,pedicel,pedicellar,peduncle,perfect,petiole,pilose,puberulent,puberulent-pubescent,pubescent-pilose,rachi,remnant,shrub,simple,sparsely,style,subcoriaceous,tip,triangular-elliptic,truncate,unbranched,unknown,violet,x,yellowish	-12,-5,1,1-,1.5-,13.,2-6,2.5-4,3-,3-12,3-5,3-8,4-7,4-foliat,5-17,5-6,abaxially,abruptly,absent,adaxially,adpressed,aggregate,apart,ape,axe,beyond,bilobe,blade,broad,campanulate,cell,clavate,color,concave,connective,dia,dilated,directed,distally,eaf,ed,ellipsoidal,equal,et,exceeding,exserted,fleshy,glabrous,hair,lanceolate,laterally,lon,lower,martinelli,narrow,narrowed,narrowly,nflorescence,nther,orolla,ovoid,papillose,pore,puberulen,pubescent-pilo,radiu,ripe,round,ruit,seen,shorter,slightly,small,spaced,stamen,stellate,stigma,stone,tal,tem,thecae,time,tomento,triangular,tube,ud,unit,unknow,vary,wide,widening,ympodial	3-7,4-6,abaxial,adaxial,anther,arrangement,branching,characteristic,colour,corolla,filament,form,growth,height,inflorescence,leaf,length,na,ovary,plant,pseudostipule,seed,shape,staman,stem,surface,texture,unarmed
400	wfo-0001030570	success	173	134	109	64	25	0.63	-1,.3-0.5,0.3-0.5,0.5-1,1,1-1.5,1-2,1-3,1-4,1-5,1-8,1.5,10-25,15-35,2-3,2-5,2-7,2-7-lobed,2-8,2.5-22,20-30,3-5,3-6,3.5-5,4-25,4-5,4-7,abaxially,acuminate,acute,adaxially,apart,apex,apiculate,basal,base,calyx,campanulate,cm,connective,connivent,cordate,cylindrical,diameter,dilated,distally,eglandular,ellipsoidal,entire,exceeding,flattened,fleshy,flower,forked,fruit,glabrous,glandular-puberulent,globose,green,hair,lanceolate,leaf,lobe,lobed,long,margin,mm,narrowly,obtuse,occasionally,often,ovoid,pedicel,peduncle,petiole,pilose,pinnately,pubescent,punctate,purplish,rachi,radiu,rarely,remnant,rounded,rugose,shorter,simple,slightly,sometimes,somewhat,sparsely,stellate,stigma,style,subcoriaceous,submarginally,thecae,tip,tree,triangular,truncate,unbranched,unequal,unlobed,vein,white,x,yellow	0-,0.5-,1-,1.5-2.5,1/2,10-17,15-20,2-2.5,2-4,3-10,4-foliat,4/5,5-,8-,absent,aggregate,ape,articulated,axe,beyond,blade,cell,color,directed,divided,eaf,eed,elliptic-oblong,exserted,glabrat,leaving,lon,lower,midrib,near,nflorescence,nther,orolla,ovate,pedicellar,perfect,pilo,pore,presen,purpl,ripe,ruit,sinus,small,spaced,stamen,stone,tal,tem,time,tomento,truncat,tube,ud,unit,unknown,vary,wide,ympodial	anther,arrangement,bud,characteristic,colour,corolla,form,glabrate,growth,height,history,inflorescence,length,life,ovary,perennial,pilosity,plant,seed,shape,size,spacing,stem,texture,theca
401	wfo-0001030581	success	187	99	70	117	29	0.374	.5,abaxial,acute,adaxial,anther,apex,articulated,base,berry,black,calyx,central,cm,conical,corolla,decurrent,densely,diameter,elliptic,entire,filament,flattened-reniform,fruit,glabrous,globose,green,growth,herb,inflorescence,intermodal,lateral,leaf,lobe,long,margin,maturity,minutely,mm,occasionally,once-branched,ovary,ovate,pair,pedicel,peduncle,per,petiole,pitted,plant,portion,primary,pubescent,purplish,rachi,ripe,rounded,shallow,simple,sparsely,spreading,stem,straight,style,surface,turning,vein,white,wide,yellow,yellowish	.3,0.2â0.8,0.4â0.6,0.4â1.6,0.5,0.5â0.7,0.5â2.5,0.6â0.7,0.7â0.8,0.9â1,1,1-4-celled,1.2â1.5,1.8â8,1â2,1â2-celled,1â2.5,1â4-celled,2,20â50,2â3-celled,35â45,3â4,3â5,4.5â12,4â7,4â9,5-merous,5â6,5â8,9,abaxially,adaxially,aggregate,along,angle,angled,anthesi,apar,appressed,basal,becoming,beyond,branched,bright,capitate,cell,clustered,cone,denser,difoliate,drop,eaf,eed,ellipsoid,exserted,florescence,flower,free,fruiting,geminat,halfway,individual,lacking,later,leave,less,like,live,lobed,lon,lower,markedly,minute,narrowly,near,new,often,outline,papillate,pentagonal,perfect,reflexe,reflexed,remaining,ridge,ruit,scar,shiny,shorter,slightly,somewhat,spaced,sprawlin,stellate,stigma,stone,strongly,tall,tangled,tem,terete,testal,third,translucent,trichome,tube,ud,uniseriate,unit,upper,usually,winged,woody,ympodial,â15,â5	0.4-1.6,0.5-0.7,0.5-2.5,0.6-0.7,0.9-1,1.2-1.5,20-50,3-4,35-45,5,5-6,5-8,arrangement,branching,characteristic,colour,form,height,history,length,life,midvein,na,pseudostipule,seed,shape,staman,texture,unarmed
402	wfo-0001030583	success	166	90	66	100	24	0.398	0.2-1,0.3-1,0.5-1,1,1-1.5,1-2,1.5-4,2.5,2.5-3,3-4,5-6,abaxial,acute,anther,apex,base,berry,calyx,cm,corolla,crisped,cultivar,deep,densely,elliptic,filament,flattened-reniform,form,fruit,glabrous,globose,green,immature,incrassate,irregular,leaf,lobe,long,long-triangular,margin,midvein,minutely,mm,narrowly,occasionally,orange-red,ovary,pale,pedicel,petiole,pitted,plant,pubescent,ripe,rounded,shrub,simple,spathulate,stem,style,surface,tan,vein,white,x,yellow	.2,.5,0.1-0.5,0.4-2.7,0.7-4.5,0.8-1,0.9-3.5,1-8,1/2,2.5-9,3/4,4-6,5-7,6-7,abaxially,adaxially,along,anthesi,ba,bark,brow,cell,closely,conical,corky,cultivated,dark,deflexed,dendritic,dia,differing,difoliate,dry,eaf,edicel,eed,ellipsoid,enlarged,erect,especially,flower,free,frui,fruiting,geminat,golden,included,lateral,leave,like,live,lobed,lon,long-rectangular,lower,main,major,minor,nflorescence,often,older,opposite,outline,overlapping,pair,papery,papillo,papillose,pericarp,planar,pore,poricidal,portion,prostrate,rest,ruit,scar,shaped,size,small,small-capitate,soon,spaced,specimen,stigma,stout,tall,tear-drop,testal,thin,tip,trichome,tube,ud,uniseriate,unit,way,woody,ympodial,young	adaxial,arrangement,branching,characteristic,colour,diameter,growth,height,history,inflorescence,length,life,na,peduncle,primary,pseudostipule,rachi,seed,shape,staman,tertiary,texture,unarmed,venation
403	wfo-0001030605	success	144	105	78	66	27	0.542	.5,0.1,0.3-0.5,1,1-4,1.5-2,1.7,12-19-flowered,2,2-3,2.5,7,abaxially,acute,adaxially,almost,anther,apex,attenuate,base,berry,branched,brown,calyx,cinereous,cm,commonly,coriaceous,corolla,dark,dendritic-echinoid,dia,difoliate,dry,entire,filament,glabrate,glabrous,globose,green,growth,inflorescence,leaf,less,lobe,long,margin,material,minutely,mm,nearly,obovate,obtuse,olive,ovary,ovate,ovoid-reniform,pedicel,peduncle,petiole,pitted,pubescent,rarely,revolute,rounded,shiny,shrub,simple,slightly,smooth,sparsely,style,surface,trichome,unifoliate,vein,white,x	.4,1.5-5.5,1/3-1/2,5-12.5,along,anthesi,apart,ape,apical,area,beginning,beneath,branch,conical,covered,cylindrical,deflexed,densely,drying,eaf,edicel,eed,ellipsoid,exerted,free,fruiting,geminat,gold,inflorescenc,internodal,light,lobed,lower,midrib,new,nflorescence,occasionally,opposite,otherwise,overlapping,papillate,papillosefruit,pore,poricidal,portion,reflexed,scar,scattered,shaped,slender,somewhat,soon,sparesly,stigma,tear-drop,thickened,tinged,tip,tub,tube,ud,unit,way,woody,yellow,ympodial	abaxial,adaxial,arrangement,branching,characteristic,colour,diameter,form,fruit,geminate,hair,height,length,midvein,na,plant,primary,pseudostipule,rachi,seed,shape,staman,stem,tertiary,texture,unarmed,venation
404	wfo-0001030624	success	170	94	74	96	20	0.435	.5,0.5,0.5-1,0.5-1.5,1-3,1.2-1.8,1.2-2,1.5-2,2-10,2-3,2.5-5.5,25-40-flowered,3-3.5,3.5-4,4.5-8,6-13,anther,apart,axil,bark,calyx,clavate,cm,corolla,ellipsoid,elliptic,falcate,filament,flattened-reniform,furcate,glabrate,glabrous,glandular,globose,green,later,lateral,leaf,long,longitudinally,main,major,minor,minutely,mm,narrowly,occasionally,ovary,pedicel,petiole,pitted,pore,puberulent,scar,shining,shrub,simple,size,small,soon,stem,stigma,style,surface,tree,trichome,tube,tuft,uniseriate,vein,white,x,yellowish-green,yellowish-grey	.25,0.9-1,2,3,7-9,acute,anthesi,apex,apiculate,appearing,attenuate,ba,base,beginning,berry,branch,caly,cell,decurrent,deflexed,dia,differing,difoliate,dimorphic,distal,dry,eaf,edicel,eed,end,erect,except,expanded,exserted,extreme,free,fruiting,geminat,greyish,hyaline,incrassate,inflorescenc,large,like,lobe,lobed,lon,lower,margin,material,middle,midrib,near,nearly,nflorescence,older,one,opposite,outer,pair,pale,papillose,planar,poricidal,portion,prominent,raised,remaining,round,rugo,ruit,short,slender,slightly,somewhat,spaced,square,straight,tall,tapering,thickened,three,ti,tip,trunk,two,ud,unevenly,unit,wall,widest,woody,yellow,yellowish,ympodial,young	bud,colour,diameter,flower,form,fruit,growth,height,inflorescence,length,number,plant,presence,pubescence,rugose,seed,shape,spacing,texture,type
405	wfo-0001030638	success	177	85	61	116	24	0.345	0.5-1,0.5-1.5,0.5-2,0.7-1.5,1-1.2,1-2,1.5-2,1.6-2.2,2-7-flowered,3-10,4-6,8,8-11,8-9,acute,anther,apex,base,berry,broadly,calyx,cm,corolla,deltoid,elliptic,exfoliating,filament,fruit,glabrous,glandular,globose,green,inflorescence,leaf,like,lobe,long,margin,mm,obovate,ovary,pair,pale,papillose,pedicel,petiole,red,rugose,seed,shape,shrub,simple,stem,style,surface,thick,transversely,tree,vein,white,x	0.1,0.5,0.5-0.7,1-1.5,1.4-1.7,2-3,2-5,2.5-4,3-13,along,anthesi,apically,appear,appearing,axi,axil,ba,bark,beginning,beneath,blade,branched,bud,closely,conspicuously,corky,cucullate,cup-shaped,deflexed,densely,dia,differing,difoliate,dry,eaf,eed,entire,erect,extending,flattened,fleshy,free,fruiting,geminat,geminate,glabrate,gre,impressed,irregular,known,lamina,large,later,lateral,less,lobed,lon,lower,main,major,material,middle,minor,minutely,near,nearly,nflorescence,occasionally,often,older,one,open,opposite,overlapping,ovoi,paler,papillae,papillo,persistent,planar,pore,poricidal,portion,present,prominent,rather,red-glandular,reddish,rest,roundish,ruit,scar,shaped,size,soon,spaced,speciman,stigma,straight,tall,tapering,tear-drop,terminal,thickened,thickening,tip,trichome,tube,uniseriate,unit,usually,wall,widest,woody,ympodial,young	abaxial,adaxial,arrangement,branching,characteristic,colour,diameter,form,grey,growth,height,length,midvein,na,peduncle,plant,primary,pseudostipule,rachi,staman,tertiary,texture,unarmed,venation
406	wfo-0001030661	success	183	110	88	95	22	0.481	-24,.5,0,0.5-0.6,0.5-0.75,0.5-2,0.7-0.8,1-1.3,1-1.4,1-1.5,1.5-2,1.5-7,12-16,2-2.5,3-3.5,4-15,5-5.5,acute,anther,anthesi,apex,articulated,attenuate,base,berry,branched,brown,calyx,cm,corolla,deltate,densely,diameter,elliptic,entire,filament,flattened,glabrous,globose,growth,inflorescence,lateral,leaf,lobe,long,many,margin,mature,membranous,minutely,mm,narrowly,nodding,occasionally,onto,pair,pedicel,peduncle,per,petiole,pitted,primary,pubescent,red,reddish,reniform,scattered,shrub,simple,sleeve,slender,small,sparsely,stem,strongly,style,surface,terminal,time,tinged,tree,trichome,uniseriate,vein,violet,white,winged,x	.2,1-,1-.,1-1.2,1.2-7,2-,3-20,3-4,4-6,5-10,5-merou,50-100+,ag,along,alyx,ark,branch,brow,capitate,cell,clustered,conical,connivent,dar,denser,drying,eaf,eed,ellipsoid,em,erec,erect,exserted,extending,flower,free,fruiting,glabrescent,glabrou,group,ilament,insertion,lamina,lengthening,lobed,lon,loosely,lower,midrib,minute,near,never,new,nflorescence,older,orolla,otherwise,pale,papillo,perfect,pericarp,planar,platform,plurifoliat,point,pore,poricidal,portion,rectangular,ruit,scar,shiny,slightly,slit,spreading,stellate,stigma,tangled,testal,thin,tip,tube,twinin,ud,unit,upper,usually,vary,way,woody,yellow,yellowish,ympodial,Â½,Â¾	1-5,abaxial,adaxial,arrangement,branching,characteristic,colour,form,fruit,height,length,midvein,na,ovary,plant,pseudostipule,rachi,seed,shape,staman,texture,unarmed
407	wfo-0001030676	success	220	153	131	89	22	0.595	-1.6,-3.9,0-100,0.4,0.6-1.2,1,1-1.2,1-3,1.1-1.4,1.1-1.9,1.2-1.3,1.7-2,11-14,14-17,16,2.1-2.3,2.1-2.6,2.2-5.7,2.4-3.1,3-6,4-6,4-6.5,7-10,7-8,7-9,8-10,abaxially,abruptly,acute,adaxially,angled,anther,apart,apex,appressed-tomentose,articulated,base,becoming,berry,branch,branched,brown,calyx,closely,cm,conical,continued,corolla,cylindrical,deltoid,densely,diameter,dichotomously,due,echinoid,entire,except,filament,finely,fleshy,flower,fruit,glabrescent,glabrous,granular-tomentose,green,greenish,grooved,growth,hair,honeycombed,initially,lateral,leaf,length,lobe,longitudinally,margin,midvein,minute,minutely,mm,moderately,mostly,multangulate,nearly,oblique,oblong-elliptic,obtuse,often,openly,ovate,pedicel,peduncle,petiole,probably,pseudo-terminal,pubescent,pulverulent,rachi,reniform,reticulate-punctate,ripe,scabrous,scattered,sessile,short-attenuate,short-stalked,shrub,side,simple,small,spaced,stellate,stellate-pubescent,stem,style,subglobose,suborbicular,terete,testa,tip,tree,tuft,vein,velutinous,white,whitish,x,yellow,yellowish	-2.5,-8.5,/10-1/5,1.3-1.5,1/4,19-35,2.5-5.5,2.75-3.25,3-3.5,3-5,8-12,along,anthesi,apical-lateral,apparently,appearing,axillary,ba,bark,blade,blunt-tipped,bud,chartaceous,crown,dehiscing,eaf,echinoi,eed,elongate,exserted,flat-topped,forming,free,glabrescen,globose,high,horizontal,inserted,introrse,lackin,lamina,large,lengthen,lined,lobed,long,longitudinal,lower,main,midvei,nflorescence,oblong,occasional,older,opening,orolla,ovate-lanceolate,parallel,perfect,plurifoliate,pore,rather,ray,ridged,ruit,runk,slit,somewhat,sparsely,spreading,stigma,strongly,subcampanulate,subcapitat,tamen,tending,thick,thin,time,tomentose,tube,unarme,unit,usually,vary,way,wide,ympodial,young	abaxial,adaxial,arrangement,branching,characteristic,colour,form,height,history,inflorescence,life,na,ovary,plant,primary,seed,shape,staman,surface,texture,unarmed,ye
408	wfo-0001030686	success	182	96	81	101	15	0.445	1-1.1,1-1.2,1-1.5,1-2,1.2-1.5,1.5-4.5,1.6-3,15,2-2.5,2-3,2.5-4,2.5-8,3-3.5,5-25,5-30,5-6,8-9,abruptly,acuminate,acute,anther,apex,base,berry,branched,brown,calyx,cm,conical,corolla,dark,densely,diameter,elliptic,entire,filament,flattened,flower,form,fruit,globose,height,internodal,leaf,leaf-opposed,lepidote,lilac,lobe,margin,maturity,midvein,mm,oblique,orange,ovary,pair,pale,pedicel,peduncle,petiole,pitted,plant,primary,pubescent,purple,rachi,scarious,seed,shallowly,shiny,simple,sparsely,stem,style,surface,time,tree,usually,vein,x,yellow	.2,.5,.5-1,0.5-1,1.5-2,1972,2-6.5,5-12,?,abaxially,aborted,adam,adaxially,age,anthesi,apart,bark,basal,beneath,bifid,black,breast,brittle,bu,c.,centre,closely,cup-shaped,darker,deeply,denser,different,difoliate,discolorous,dry,drying,eaf,edicel,eed,empty,erect,exerted,fide,fragrant,free,fruiting,geminat,glabrescen,glabrous,golden,half,heteromorphic,lamina,lengthening,less,lobed,long,lower,many,midrib,minutely,nflorescence,noddin,older,overlapping,paler,papillae,papillose,pericarp,planar,pore,poricidal,portion,pubescen,ruit,scar,shallow,short,slightly,slit,somewhat,space,spaced,spreading,stellate,stigma,strongly,styl,thin,tip,tissue,trichome,tube,ud,uniformly,unit,visible,way,woody,ympodial,â	abaxial,adaxial,arrangement,branching,characteristic,colour,growth,inflorescence,length,na,pseudostipule,shape,staman,texture,unarmed
409	wfo-0001030709	success	217	121	101	116	20	0.465	-2,0,0-,0-20,0-30,0.7-1,1-1.2,1-1.6,1-4.5,1.3-1.4,1.6-2.1,1.9-2.8,1/4,2-5,2-8,2.3-3,5-10,5-20,5-6,6-7,7-9,8-11,abaxially,acuminate,acute,adaxially,almost,anther,apex,apically,apparently,articulated,base,berry,branched,calyx,cm,cordate,diameter,dull,edge,elliptic,erect,filament,finely,flattened-reniform,flower,fruit,increasing,inflorescence,infructescence,lateral,leaf,length,lobe,lobed,long,margin,maturity,mauve,middle,midvein,mm,moderately,narrow-deltate,orange-brown,pair,pedicel,peduncle,per,petiole,pit,pitted,prickle,prickly,primary,purple,red-green,seed,shrub,simple,size,smooth,sparsely,spherical,stellate-pubescent,stem,style,surface,terminal,tertiary,toward,truncate,unarmed,upper,vein,venation,visible,wide,yellow,yellow-green	-5,-9,0.1-0.2,0.15-0.5,0.2-0.5,0.3-1.5,0.4,0.8-4,0.9-1.5,1-6,1.4-2,1/2-2/3,1/3-1/2,1/4-1/3,10-14,10-50,2-4,2-6,2/3-3/4,3-,4-5-merous,5-7,5-9,6-10,6-21,6-8,7-8,8-15,alyx,ame,apar,apart,ape,bark,blade,bright,broad-deltate,brow,c.,chartaceous,conical,connivent,cuspidate,deltate,discolorous,distance,drying,eaf,eed,elongating,equal,extending,free,fruiting,glabrescent,glabrous,lanceolate,lengt,lobing,lon,long-acuminat,longer,lower,mature,midpoint,nflorescence,occasionally,often,older,one,open,orolla,oung,pendulous,perfect,pericarp,perpendicular,plurifoliat,poricidal,porrect,portion,prickl,ray,red-orange,reflexed,retrorse,rounded,ruit,scar,secondary,short-styled,shorter,side,slender,sometimes,spaced,spreading,stalk,stalked,stellate,straight,tamen,tapering,terete,time,tip,trichome,tube,unit,usually,variously,vary,way,weakly,woody,ympodial	abaxial,adaxial,arrangement,branching,characteristic,colour,corolla,form,growth,height,history,life,long-acuminate,na,ovary,plant,rachi,shape,staman,texture
410	wfo-0001030714	success	178	142	129	49	13	0.725	-3,.2,.5,/3,0.1-0.3,0.5,0.5-0.8,0.5-1.9,0.7-0.8,1-1.2,1-1.3,1-2.5,1.2-1.5,1.2-4,1/3,2-2.5,2-2.6,3-3.5,5-100,5-6,7-17,abaxial,acuminate,acute,adaxially,age,aid,along,anther,apex,articulating,bark,basal,base,becoming,beneath,berry,blue,blue-black,branching,clavate,cm,conical,cordate,corolla,dark,densely,diameter,ellipsoid,elliptic,entire,especially,except,filament,flattened,flower,fruit,glabrous,globose,greyish,growth,herbaceous,joined,leaf-opposed,leaving,lengthening,liana,like,lobed,long,many,margin,membranous,midrib,minute,minutely,mm,narrowly,new,ob-ellipsoid,ob-elliptic,oblique,occasionally,ovary,overall,pair,pale,papillate,pedicel,peduncle,peg,petiole,pitted,pore,poricidal,primary,prominent,pubescent,reniform,ripe,scar,shape,simple,slightly,slit,spaced,sparsely,stellate,stem,stigma,style,submarginal,surface,terminal,time,tip,trichome,truncate,tube,twining,uniseriate,vein,vine,violet,way,widely,woody,x,yellow	0.3-0.4,0.8-1,1-1.5,1.4-3.5,1.5-2,20,3-7,>,abaxially,anthesi,apar,calyx,campanulate,climbin,cup,denser,eaf,eed,exserted,fide,free,grading,gradually,gree,howard,lobe,lower,narrow,nflorescence,nodding,node,older,paler,papillat,pedice,per,perfect,planar,plurifoliat,portion,quadrate,ruit,strongly,tapering,thickened,tub,ud,unit,ympodial	apart,arrangement,bud,characteristic,climbing,colour,form,green,inflorescence,leaf,length,seed,texture
411	wfo-0001030733	success	130	87	57	73	30	0.438	1-1.2,1-1.5,1-2,2-2.5,3-4,3-5,4.5-5,5-8-flowered,6-7,6-9,abaxially,acuminate,acute,adaxially,anther,apex,base,berry,brown,calyx,cm,corolla,dark,decurrent,deltate,densely,elliptic,filament,glabrous,globose,green,leaf,lobe,long,margin,mm,moderately,narrowly,onto,ovary,ovoid-reniform,pair,pedicel,petiole,pubescent,shrub,simple,smooth,somewhat,sparsely,stem,style,surface,treelet,vein,white,x	.5,/4,0.5-1,1.5-5,1.7-2.7,4-15,?,along,anthesi,ape,bark,bi-lobed,broadly,capitate,clearly,closely,conical,coriaceous,denser,dia,eaf,eed,ellipsoid,elongate,embryo,erect,exserted,free,fruiting,grayish-brow,lamina,later,lateral,like,lobed,lon,lower,main,middle,minutely,nflorescence,older,opposite,overlappin,papillo,planar,pore,poricidal,portion,rounded,ruit,scar,shaped,spaced,stigma,strongly,tall,tear-drop,testa,thick,tip,trichome,tube,ud,unifoliat,uniseriate,unit,visible,way,widest,woody,ympodial,young	0.5,abaxial,adaxial,arrangement,branching,characteristic,colour,diameter,form,fruit,grayish-brown,growth,height,inflorescence,length,midvein,na,peduncle,plant,primary,pseudostipule,rachi,seed,shape,staman,tertiary,texture,unarmed,unifoliate,venation
412	wfo-0001030772	success	155	82	61	94	21	0.394	-2,0.2-0.8,0.25-0.5,0.5-1,0.75-1,0.9-1,1-2,1-2.5,1.5-2,3-3.5,3-5,5-6,acuminate,anther,attenuate,bark,base,berry,bud,calyx,cm,corolla,dark,deflexed,elliptic,filament,fruit,gently,glabrous,globose,green,grey,large,leaf,lobe,long-acuminate,long-triangular,margin,minutely,mm,occasionally,ovary,ovoid-reniform,pale,paler,papillose,pedicel,petiole,pitted,shape,shining,shrub,simple,stem,straight,style,surface,tan,tapering,white,x	.05,.2,.25,.5,0.9-3.1,1.2-5,1.4-1.6,2-7,4.2-6.5,5-10-flowered,8-10,9-15,acute,anthesi,apex,archin,ba,becoming,beginning,beneath,branch,capitate,closely,dia,differing,difoliate,eaf,edicel,eed,ellipsoid,erect,extreme,free,fruiting,geminat,impressed,inflorescenc,later,lateral,lenticellate,lobed,lon,long,lower,main,major,methyl,middle,minor,nearly,nflorescence,node,older,one,opposite,overlapping,pair,papillo,per,pore,poricidal,portion,prominent,reflexed,ripe,rounded,ruit,salicylate,scar,shaped,size,slender,slightly,smelling,soon,spaced,stigma,strongly,swollen,tall,tear-drop,tip,trichome,tube,ud,uniseriate,unit,usually,vein,widest,wintergreen,woody,ympodial,young	abaxial,adaxial,alternate,arching,arrangement,branching,characteristic,colour,diameter,form,growth,height,inflorescence,length,na,peduncle,plant,rachi,seed,staman,texture
413	wfo-0001030781	invalid_json	213	135	103	110	32	0.484	0.5-6,1-2,1-4,1.6-2.2,10-40,15-35,2.5-14,2.5-3.5,3-4,5-6,5-7,5-8,6-7,7.5-9,abaxially,adaxially,anther,apex,apiculate,articulated,base,berry,brown,brownish,cell,chartaceous,cm,condition,corolla,covering,dark,decurrent,deep,densely,diameter,distal,dot,drying,filament,finely,fresh,fruit,glabrous,glandular,globose,gray-green,green,green-white,greenish,hair,hair-like,half,herb,high,lateral,leaf,light,like,lobe,long,make,margin,membranous,mm,mucilaginous,obovate,odd-pinnate,ovate,ovate-lanceolate,ovoid,papillose,pedicel,peduncle,petiole,pilose,plant,pointed,pubescent,purple,rachi,rarely,rounded,scattered,seed,simple,slightly,small,sometimes,somewhat,sparsely,stem,style,subovoid,testal,thick,throughout,typically,unwinged,violet,wall,wet,white,whitish	0-5,0.2-4,0.5-8,1-1.5,1-10,1-12,1-8,1.5-12,1.5-2,1.5-9,2-20,2-3,3-6,4-15,5-merou,abruptly,acumen,ag,along,alyx,apart,apparently,axe,axillary,blade,borne,broadly,bud,caly,capitat,ciliate,connivent,cuneate,decreasing,digestion,dorsally,eaf,edge,eed,elliptic,end,enzyme,erect,especially,exceeding,flat,flower,folded,forked,geminat,generally,glabrou,gradually,homostylous,honeycomb-shaped,interjected,lanceolate,larger,leaflet,lengthening,living,low-growin,lower,midrib,minutely,narrowed,nflorescence,orbicular,orolla,pair,pentagonal,perfect,petiolulate,plurifoliate,pore,poricidal,puberulent,removed,rotate-pentagonal,ruit,sessile,seudostipule,short,singly,size,slit,spaced,specimen,stamen,ste,stigma,stolo,straight,subtending,tall,tamen,tem,terminal,tip,toward,tri-,tube,tuber,unit,usually,vary,wide,x,yellow,ympodial	'',2,[,``,abaxial,adaxial,arrangement,branching,calyx,characteristic,colour,form,growth,height,inflorescence,length,midvein,na,ovary,primary,pseudostipule,shape,staman,surface,tertiary,texture,unarmed,value,vein,venation,{,}
414	wfo-0001030782	success	198	118	100	98	18	0.505	0-1,0-7,0.4-1.5,1-2,1-3,1-6,1.3-1.6,1.5-2,1.5-7.5,13-22,15,2,2.2-4,3-10,4-6,5-20,6-8,abaxially,acumen,adaxially,anther,attenuate,axillary,base,berry,broadly,brownish,bud,cell,cm,condition,coriaceous,corolla,covering,deep,diameter,distal,drying,elliptic,filament,flower,forked,fresh,fruit,generally,glabrescent,glabrous,globose,green,green-white,greenish,hair,hair-like,half,herb,homostylous,interjected,lateral,leaf,leaflet,lilac,lobe,long,make,medium,mm,moniliform,mottled,mucilaginous,odd-pinnate,ovate,ovoid,pair,pedicel,peduncle,petiole,petiolulate,plant,prominently,purple,rachi,ripe,rounded,scarce,seed,sessile,short,style,subtending,terminal,testal,thick,throughout,tuber,usually,wall,wet,white,whitish,winged	1-5,1.2-3.9,1.6-4.6,11-47,12-30,2-3,2.4-11.5,3-5,4-11.6,4.6-26,5-merou,7-15.6,abaxiall,acuminate,acute,ag,along,alyx,apart,apex,apparently,arranged,articulated,asymmetric,axe,basiscopic,bead,blade,capitat,clavate,connivent,cuneate,dark,decreasing,digestion,dorsally,eaf,edge,eed,enzyme,exceeding,flat,folded,geminat,glabrou,hal,high,honeycomb-shaped,inconspicuous,lanceolate,lengthening,light,like,living,lower,multiple,necklace,nflorescence,orbicular,orolla,pentagonal,perfect,plurifoliate,pore,poricidal,removed,rotate,ruit,second,seudostipule,side,size,slit,smaller,sometimes,spaced,specimen,stamen,stigma,stolon,straight,subequal,tal,tamen,tem,tip,tissue,totally,toward,tri-,tube,typically,unit,vary,wide,x,yellow,ympodial	5-merous,arrangement,calyx,characteristic,colour,form,growth,height,inflorescence,length,ovary,pseudostipule,shape,staman,stem,surface,texture,width
415	wfo-0001030802	success	171	103	87	84	16	0.509	.5,.5mm,0,0.5-0.75,0.5-1,0.7-1cm,0.75-1,0.9-1,1,1-1.1,1-1.2,1-1.5,2-2.5,2-3,3-3.5x,4-5mm,5-10-flowered,abrupt,anther,anthesi,bark,base,berry,brown,calyx,campanulate,cm,corolla,deflexed,densely,dia,difoliate,evenly,filament,filiform,flattened-reniform,fruit,fruiting,glabrous,glandular,globose,halfway,heart-shaped,incrassate,internodal,leaf,length,lobe,lobed,long,long-triangular,margin,markedly,minutely,mm,ovary,ovoid,pale,papillate,pedicel,per,persistently,petiole,pitted,plant,pore,poricidal,pubescent,red,shaped,shrub,simple,slender,somewhat,stem,stigma,straight,style,subshrub,surface,tapering,tear-drop,tip,tube,unifoliate,white,yellowish	.3,0.25-0.4,0.5-1.5,2-5,2.5-3,3-4,3-6,4-6,abaxially,acuminate,acute,adaxially,along,apex,appearing,basal,becoming,beginning,beneath,bud,cordate,cucullate,deeply,denser,dry,eaf,edicel,eed,ellipsoid,except,exerted,exudate,free,geminat,gland,glandurla,hanging,inflorescenc,invest,irregularly,lamina,later,lateral,line,live,lower,m.,main,material,midvein,near,nflorescence,obconic,older,pair,palmate,papillose,portion,prominent,pubescen,raised,reddish,ruit,scar,single-celled,soon,spaced,specimen,stigm,strongly,tipped,trichoem,trichome,ud,uniseriate,unit,variable,vein,widely,woody,x,yellow,ympodial,young	abaxial,arrangement,characteristic,colour,diameter,form,growth,height,inflorescence,number,persistence,pubescence,seed,shape,texture,type
416	wfo-0001030809	success	154	77	44	110	33	0.286	0.5-1,1-1.5,1.2-1.4,1.4-1.5,1.5-3.5,4.5-5,6-8,8,acute,anther,apex,base,berry,branched,broadly,calyx,cm,corolla,deltoid,densely,elliptic,filament,fruit,glabrous,globose,green,leaf,lobe,mm,ovary,ovate,pedicel,petiole,pubescent,several,simple,stem,style,time,tomentose,tree,triangular,vein,white	.5,0.2,1-1.25,1.5-2.4,2-2.5,2.3-5.5,20-60-flowered,5-8,9.9-12,across,along,also,anthesi,apar,appearing,bark,beneath,caly,campanulate,clavate,curl-tipped,curved,dark-papillo,deciduous,deflexed,dense,dia,difoliate,distally,eaf,edicel,eed,ellipsoid,erect,especially,evenly,exserted,falcate,free,fruiting,geminat,golden,hair,hidden,interpetalar,known,large,lateral,leave,like,lobed,lon,long,long-papillose,lower,main,major,markedly,mature,membranous,middle,midrib,minor,minutely,nearly,nflorescence,older,one,opposite,overtopping,planar,pore,poricidal,portion,present,round,ruit,scar,scattered,shinin,shining,shoot,sinus,size,slender,slightly,small,soon,spaced,stigma,straight,tall,tapering,terminal,three,tip,trichome,tube,two,ud,underside,unequal,uniseriate,unit,wide,widest,x,yellow-brown,ympodial,young	1,2,abaxial,adaxial,arrangement,branching,characteristic,colour,diameter,form,growth,height,history,inflorescence,length,life,margin,midvein,na,peduncle,perennial,plant,primary,pseudostipule,rachi,seed,shape,staman,surface,tertiary,texture,unarmed,venation
417	wfo-0001030810	success	191	129	76	115	53	0.398	0.2,0.4,abaxially,accrescent,adaxially,anther,anthesi,apart,apex,articulated,axillary,base,bipinnate,blue,borne,branched,brown,calyx,cell,cm,colour,dark,densely,diameter,elliptic,filament,flattened,fleshy,flower,fruit,glabrous,globose,green,greyish,hair,indumentum,leaf,leafy,lobe,long,margin,midvein,mm,moderately,multicellular,oblong,older,opposed,pale,pedicel,peduncle,petiole,pinnate,pitted,primary,pubescent,shallowly,shiny,shoot,shrub,simple,spaced,sparsely,stem,stone,style,subglabrous,surface,time,tomentose,uniseriate,unknown,violet,white,woody,x	0.2â0.3,0.3,0.5â,0.5â0.8,0.6â1.0,0.7â1.4,0.8â5.5,0.95â2.0,0â,1,1.0â1.5,1.0â2.0,1.0â3.0,1.1â2.0,1.1â2.2,1.2â1.5,1.5â1.9,1â2,1â3,1â5,2.9â4.5,20â100,2â3,2â4,3.0â5.0,3.3â5.5,3.3â8.5,3.5â4.6,3â19,4â14,4â5,4â7,5,5â15,5â30,5â32,6â10,6â22,7â10,7â11,8â10,absen,acute,adaxiall,ag,along,axe,ba,blade,chartaceous,clavate,connivent,cylindrical,decreasing,denser,divided,eaf,eed,elliptical,equal,erect,especially,geminat,half,hig,irregular,lon,longitudinal,lower,m.,midrib,narrow,nflorescence,obtu,occasionally,opening,orolla,oung,pair,pentagonal,perfect,pinnae,plurifoliate,pore,poricidal,rarely,reflexed,rounded,ruit,secondary,shaped,side,size,slit,sometimes,stigma,straight,tamen,tardily,tear-drop,tip,tube,unicellular,unit,vary,wide,wing,yellow,ympodial,â2.5,â3,â3.4,â4.5,â5.0,â8	0.2-0.3,0.6-1.0,0.7-1.4,1-2,1.0-1.5,1.0-3.0,1.1-2.0,1.1-2.2,1.2-1.5,1.5-1.9,2.9-4.5,20-100,3,3.0-5.0,3.3-5.5,3.4,3.5-4.6,4-14,4-7,5-15,5-32,5.0,6-22,7-10,8-10,abaxial,absent,adaxial,arrangement,branching,characteristic,corolla,form,growth,height,history,inflorescence,length,life,na,ovary,plant,pseudostipule,rachi,seed,shape,staman,tertiary,texture,unarmed,vein,venation,young
418	wfo-0001030822	success	146	85	57	89	28	0.39	.2,0-0.5,0.5-1.5,0.8-1,0.9-1,1-1.5,1.5-2,2-2.5,2-5,3-3.5,5-6,8-9,acute,anther,apex,attenuate,base,berry,broadly,calyx,cm,completely,corolla,decurrent,deltate,elliptic-obovate,filament,filiform,flattened-reniform,glabrous,globose,green,inflorescence,leaf,lobe,margin,minutely,mm,ovary,pair,pale,pedicel,petiole,pitted,revolute,shiny,shrub,simple,stem,style,surface,tan,tapering,vein,white,x,yellowish-brown	0.1-0.2,0.4,0.4-1,1-1.2,11-15.5,2-3.8,3-5,3.5-7,5-7,abaxially,adaxially,anthesi,ba,beneath,clavate,closely,clustered,cucullat,cucullate,cup,deflexed,dia,differing,difoliate,eaf,edicel,eed,erect,exserted,fleshy,flower,free,fruiting,geminat,incrassate,inflorescenc,internodal,later,lateral,lobed,lon,long,long-ellipsoid,lower,main,major,middle,minor,minute,near,nearly,nflorescence,occasionally,older,onto,open,opposite,papillo,papillose,perhaps,planar,pore,poricidal,portion,present,red-papillose,ruit,scar,shaped,size,slightly,somewhat,spaced,sparsely,stigma,strongly,tall,tear-drop,tip,tube,ud,unit,usually,widest,winged,woody,yellowish,ympodial,young	abaxial,adaxial,arrangement,branching,characteristic,colour,diameter,form,fruit,growth,height,history,length,life,midvein,na,peduncle,plant,primary,pseudostipule,rachi,seed,shape,staman,tertiary,texture,unarmed,venation
419	wfo-0001030871	success	248	130	114	134	16	0.46	0-120,0.2-0.4,0.3-4,0.4-1.8,0.6-1.5,0.7-1.3,1-1.3,1-18,1.3-2,1.8-2.6,1/2-3/4,2-8,3-32,3-4.4,3-6,30,4.5-6.5,5-7,7-12,abaxially,abruptly,acuminate,acute,adaxially,anther,apex,appressed,attenuate,base,becoming,berry,branched,brown,bud,chartaceous,cm,conical,continued,corolla,dark,deltoid,dendritic-echinoid,densely,diameter,due,echinoid,entire,equal,filament,fleshy,flower,fruit,glabrescent,granular-tomentose,green,greenish,growth,hair,honeycombed,lateral,leaf,length,long,long-stalked,longer,margin,mixed,mm,mostly,multangulate,narrowly,orbicular,ovate,pale,partly,pedicel,peduncle,petiole,plurifoliate,probably,pubescent,purple,rachi,reniform,reticulate-punctate,ripe,scabridulous,sessile,short,short-stalked,shrub,sometimes,sparingly,stamen,stem,stigma,style,suborbicular,sulcate,terete,terminal,testa,time,tomentose,tree,unarmed,usually,velutinous,violet,way,white,x,yellow,yellowish	.2-3,.8-3.5,.9-1.2,/30-1/5,0.7-2.5,1.3-3,1.4-2.7,1.5-3,1.5-6,1.8-3.5,1/2,1/4,1/4-1/3,11,2-3,2.8-4.5,3-5,3.5-14,4.8-9.5,5-33,6-40,9-13,accrescent,adaxial,ag,along,anthesi,apart,apical-lateral,apparently,appressed-tomentose,articulated,axe,axillary,ba,bark,blade,blunt-tipped,branch,calyx,campanulate,capitat,closely,decurrent,dehiscing,dendritic-echinoi,dendritic-multangulate,directed,distal,eaf,earl,early,echinoi,eed,elliptic,elongate,erect,evident,exserted,extend,free,fruiting,glabrescen,glabrous,grayish,held,high,inserted,introrse,large,lobe,lobed,long-,longitudinal,lower,m.,main,midvein,minute,multangulat,nearly,nflorescence,nodding,oblong,obtuse,occasionally,often,older,open,orbicula,orolla,ovate-lanceolate,overlapping,perfect,plait,pore,porrect-stellate,present,prominent,rather,ray,reflexed,relatively,rotate-stellate,ruit,runk,short-,side,simple,slit,small,somewhat,soon,spaced,sparsely,splitting,stellate-tomentose,striate,strongly,subglobose,suture,tamen,thick,thick-stalked,thin-stalked,toward,tube,unarme,unit,vary,vein,wide,ympodial,young	arrangement,capitate,characteristic,colour,form,height,inflorescence,ovary,plant,seed,shape,staman,surface,texture,true,type
420	wfo-0001030872	success	166	95	79	87	16	0.476	.5,0.5-1,0.8-1,1-1.2,1-1.5,1-2,1.2-1.5,1.5-5,2-5,3-7,4-6,4-6-flowered,5.5-7,acuminate,acute,anther,area,bark,base,berry,black,brown,calyx,cm,consisting,corky,corolla,dark,deflexed,dia,dry,elliptic,erect,fleshy,glabrate,glabrous,globose,green,known,large,leaf,lenticel,long,major,margin,minutely,mm,oblique,opposite,ovary,ovate,paler,papillose,pedicel,petiole,puberulent,red-glandular-puberulent,reddish-glandular,relative,shining,shorter,simple,size,slightly,small,soon,specimen,stem,stigma,straight,strongly,style,tapering,tip,tree,treelet,tube,white,x	0.5,0.8-2,1.2-3,1.5-2,12-18,5-6,6-12.5,adaxial,age,along,anthesi,apex,appearing,beginning,broadly,caly,center,closed,closely,completely,crateriform,cucullate,darker,deltoid,densely,difoliate,eaf,edicel,eed,ellipsoid-ovoid,exserted,filament,free,fruiting,full,geminat,hooded,incurved,inflorescenc,lenticellate,less,like,live,lobe,lobed,lon,lower,material,middle,minor,nearly,nerve,nflorescence,older,one,overlapping,pair,pale,petal,planar,pore,poricidal,portion,primary,prominent,proximal,raised,rather,reddish-glandular-puberulent,rest,ridge,rounded,ruit,scar,shaped,side,spaced,styl,tall,tear-drop,thickened,ud,unit,widest,woody,ympodial,young	abaxial,characteristic,colour,diameter,form,fruit,growth,height,inflorescence,length,plant,seed,shape,surface,texture,type
421	wfo-0001030882	success	144	72	56	88	16	0.389	.5,0.5-1,0.5-1.1,0.8-2.4,0.9-1.1,1-1.3,1-1.5,1-4,1.6-2,2-5.4,3-3.5,acuminate,anther,apex,attenuate,bark,base,berry,calyx,cm,corolla,crenulate,elliptic,fruit,fruiting,glabrous,globose,green,leaf,lightly,margin,minor,minutely,mm,narrowly,occasionally,ovary,ovoid-reniform,pale,papillose,pedicel,petiole,pitted,shrub,simple,size,small,stem,style,surface,tan,transversely,tree,tube,white,x	.1,0.5-0.75,0.75-1,0.8-1.1,2,2-6,2.2-4.6,3/4,6.5-15.6,8-12,?,accrescent,anthesi,beginning,beneath,capitate,closely,conical,deflexed,deltoid,dia,differing,difoliate,eaf,edicel,eed,erect,exserted,extreme,filament,free,geminat,inflorescenc,lateral,lobe,lobed,lon,long,lower,main,major,middle,nearly,nflorescence,older,one,opposite,overlapping,ovoid,pair,paler,papillo,peelin,planar,pore,poricidal,portion,prominent,raised,ruguse,ruit,scar,shaped,short,slender,slightly,soon,spaced,stigma,straight,tall,tapering,tear-drop,terminal,thick,thickened,tip,truncate,tub,ud,unit,vein,way,widest,woody,yellowish,ympodial,young	characteristic,colour,diameter,form,growth,height,inflorescence,length,peduncle,peeling,plant,rugose,seed,shape,texture,type
422	wfo-0001030883	success	179	88	60	119	28	0.335	0.5-3,0.5-5,1-1.2,1-1.3,1-1.5,1.5-3.5,10-18,2-5,3-3.5,5-6,acuminate,acute,anther,apex,base,berry,brown,calyx,cm,corolla,deflexed,elliptic,filament,finely,fruit,glabrous,globose,green,inflorescence,leaf,lobe,massive,minutely,mm,narrowly,oblique,occasionally,ovary,ovate,ovoid-reniform,pair,pale,pedicel,petiole,pitted,plant,puberulent,russet,seed,shrub,stem,stout,straight,strongly,style,surface,tan,triangular,vein,white	-3,.05,.1,.5,1-1.1,1-4,1.5-2,18-44.5,20-50-flowered,3-4,3/4,9.5-27.5,accrescent,across,anthesi,apart,appearing,approximatately,arching,bark,becoming,branched,bu,cell,clavate,collapsed,collection,dark,dia,differing,difoliate,dry,eaf,edicel,eed,epidermal,erect,evenly,fleshy,free,fruiting,furcate,geminat,geminate,glandular,hard,hollow,imbedded,laminar,large,later,lateral,lenticellat,less,like,little,live,living,lobed,lon,long,long-acuminate,lower,main,malodorous,markedly,material,middle,midrib,minute,nflorescence,older,opposite,papillate,papillo,papillose,perpendicular,petaloid,placenta,pore,poricidal,portion,present,proximal,pulp,quite,rather,reflexed,reticulate,ruit,scar,shaped,size,slender,slightly,sometimes,soon,spaced,stigma,tall,tapering,tear-drop,thick,time,tip,trichome,tube,two,ud,uniseriate,unit,upper,wall,way,widest,woody,x,ympodial,young	0.1,2-3,abaxial,adaxial,arrangement,branching,characteristic,colour,diameter,form,growth,height,history,length,life,margin,midvein,na,peduncle,primary,pseudostipule,rachi,shape,staman,tertiary,texture,unarmed,venation
423	wfo-0001030884	success	218	93	71	147	22	0.326	0.4-3,0.5-1.2,0.8-1,1-1.5,1.5-2,1.5-2.5,2-5,4-5,4.5-5,5-6,5.5-7,9-11,abaxial,abruptly,acute,adaxial,anther,apex,base,berry,brown,calyx,cm,conical,dark,decurrent,densely,diameter,elliptic,filament,gray-tinged,green,greenish,growth,inflorescence,lateral,leaf,length,lobe,lobed,long-triangular,margin,mature,mm,moderately,occasionally,ovary,ovoid-reniform,pair,pedicel,peduncle,petiole,plant,prickly,primary,pubescent,reddish,shallowly,shrub,simple,slender,sparsely,spherical,spreading,stem,style,surface,unarmed,vein,white,winged	.2,.5,.7,0.3,0.3-0.5,0.5,0.9-5,1,1-1.2,1-3,1.5,10,100,2,4-13,5,5-30,5-merous,6-10,6-25,6-8,7-8,>,abaxially,adaxiall,along,also,alyx,andromonoeciou,anthesi,apar,arme,articulated,bark,basal,blade,broad-based,c.,capitate,connivent,curved,di-,differing,directed,discolorous,distal,eaf,eed,equal,extend,extending,flower,flowering,free,fruiting,geminate,glabrous,glandular,gree,half,herbaceous,heterostylous,infructescence,leafy,like,long,long-stalked,long-styled,lower,magnification,midpoint,midrib,minute,minutely,mixture,new,nflorescence,node,older,one,onto,open,orolla,oung,outlin,pale,papillat,per,pore,poricidal,porrect,portion,present,prickle,principal,ray,red,reflexe,reflexed,regularly,rest,ruit,sagittate,scar,scattered,sessile,shap,short,short-stalked,short-styled,similar,size,spaced,stellate,stellate-pubescent,stiff,stigma,still,strongly,tall,tamen,tannish,tapering,time,tip,treelet,trichome,trifoliate,tube,unicellular,uniformly,uniseriate,unit,upward,usually,vary,varying,visible,way,weakly,wide,wing,without,woody,yellow,ympodial,young	armed,arrangement,branching,characteristic,colour,corolla,form,fruit,height,history,life,midvein,na,perennial,pseudostipule,rachi,seed,shape,staman,tertiary,texture,venation
424	wfo-0001030899	success	146	125	100	46	25	0.685	-45,.5-2,0.3-0.5,0.5-1,1,1-2,1-3,1.5-2,10-13,10-20,2,2-3,2-3.5,20-25,3-12,3-4,3-5,3.5-4,4-5,5-10,5-6.5,8-11,?,abaxially,acuminate,acute,adaxially,apart,apex,basal,base,bronze,calyx,cm,connective,connivent,cordate,coriaceous,deeply,densely,desc,diameter,dilated,directed,distally,ellipsoidal,end,entire,ex,extrorse,flattened,flower,fruit,glabrous,glandular-puberulent,globose,green,inside,less,light,lobe,long,margin,mm,mucronate,narrowly,obconical,oblong,obtuse,outside,ovate,ovoid,pedicel,peduncle,petiole,pore,puberulent,pubescent,purple,rachi,radiu,remnant,shorter,shrub,simple,slightly,splotch,stellate,stigma,stripe,strongly,style,thecae,triangular,tube,unbranched,upward,white,x,yellow	0.5,1-1.5,1-6,2.5-3.5,3-foliate,6.5-31,7-27,absent,aggregate,ape,articulated,axe,beyond,blade,cell,chartaceous,eaf,eed,exceeding,exserted,leaving,lon,lower,nflorescence,nther,orang,orolla,pedicellar,peltifor,perfect,presen,puberulen,ruit,spaced,stamen,stone,tal,tem,time,tomento,ud,unit,vary,vein,wide,ympodial	anther,arrangement,bud,characteristic,colour,corolla,direction,form,growth,height,inflorescence,leaf,length,orange,ovary,peltiform,plant,seed,shape,spacing,stem,surface,texture,theca,tomentose
425	wfo-0001030902	success	159	109	87	72	22	0.547	-2,0-15,0.6-1.5,1-2,1-6,1.5-13,1.5-2,1.5-2.5,10-15,2,2-3,2-5,2.5,3-20,3.5-4,4,4-6,4-7,5-7,5-9,abaxially,acuminate,angled,apex,apically,apiculate,articulated,basal,base,branched,brown-pilose,calyx,cm,connective,connivent,cordate,cylindrical,dark,deltate,densely,diameter,dilated,eglandular,ellipsoidal,entire,exceeding,flattened,forked,fruit,glabrescent,glabrous,globose,hair,leaving,lobe,long,margin,mature,mm,oblong,occasionally,orange,ovate,pedicel,pedicellar,peduncle,petiole,pinkish,purple,purplish,rachi,rarely,reddish,remnant,shorter,simple,slightly,somewhat,stigma,style,thecae,tip,tree,truncate,unbranched,x,yellow	-20,-5,1.5-,15-50,2.5-4,3-13,3-4,30-50,4-22,4-foliat,6-24,8-14,absent,acute,adaxially,aggregate,along,apart,ape,axe,beyond,blade,brow,cell,directed,distally,eaf,eed,equalling,except,exserted,fleshy,flower,glabrat,glandular,glandular-puberulen,laterally,lon,lower,narrowly,nflorescence,nther,obtuse,orolla,perfect,pore,presen,present,puberulence,radiu,ruit,small,spaced,sparse,sparsely,stamen,stellate,stone,subcapitat,subcoriaceous,tal,tem,time,tomento,triangular,tube,ud,unit,vary,vein,wide,ympodial	abaxial,anther,arrangement,brown,characteristic,colour,corolla,form,glabrate,growth,height,inflorescence,leaf,length,ovary,plant,seed,shape,stem,subcapitate,surface,texture
426	wfo-0001030914	success	186	96	80	106	16	0.43	/4,0.1-0.5,0.7-1,0.8-1.3,1-1.5,1-2,1.2-1.5,1.5-3,1.5-8,2-10,2-2.5,2.5-3,3-4,7-8,anther,bark,base,beneath,berry,calyx,campanulate,capitate,cm,constriction,corolla,dark,decurrent,deflexed,densely,elliptic,fruiting,furcate,glabrous,globose,golden,green,inflorescence,leaf,lemon-yellow,length,long-styled,many,minutely,mm,obovate,ovary,ovoid-reniform,pale,papillose,pedicel,petiole,pitted,plant,puberulent,pubescent,reddish-brown,ripe,shape,shaped,short-styled,shrub,simple,small,sparsely,stem,stigma,style,surface,tapering,tear-drop,time,tree,trichome,trunk,tube,uniseriate,way,white,winged,x	.1,.5,0-0.25,0.5-1,0.8-1,1.5-2,2.5-11,3.5-17,5-17,5-25-flowered,7-10,9-35,acute,along,anthesi,apex,attenuate,blade,bud,closely,deltoid,dia,differing,difoliate,distal,dry,eaf,edicel,eed,ellipsoid,equal,erect,even,evenly,exserted,filament,flower,free,geminat,glabrate,greyish-brow,individual,later,lateral,like,live,lobe,lobed,lon,long,lower,main,major,margin,middle,minor,narowly,nflorescence,occasionally,often,older,one,onto,opposite,otherwise,overlappin,pair,papillo,planar,pore,poricidal,portion,prominent,quite,raised,rest,rounded,ruit,scar,size,slender,slightly,sometimes,soon,spaced,specimen,straight,tall,tan,thick,third,ti,tip,tub,ud,unit,usually,variable,vein,weight,widest,within,woody,yellow,ympodial,young	0.1,characteristic,colour,diameter,form,fruit,greyish-brown,growth,height,lobing,narrowly,pubescence,seed,texture,type,unripe
427	wfo-0001030918	success	230	111	88	142	23	0.383	-3.2,-40,-5,0-25,0.3-1.5,0.6-2.5,0.7-1.7,1,1-1.5,1.5-2.5,1/3,2-25,2.8-3,3-4,3.5-6,5-8,5.5-7,abaxial,acute,adaxial,anther,apex,apically,articulated,base,berry,calyx,cell,chartaceous,cm,cuneate,curved,densely,diameter,dull,elliptic,erect,faint,filament,fruit,glabrous,green-brown,lateral,leaf,length,lobe,lobed,lower,margin,mauve,midvein,mm,moderately,narrow-deltate,obtuse,orange,orange-brown,outline,pair,pale,pedicel,peduncle,per,petiole,pit,prickly,primary,purple,raised,red,scandent,seed,shrub,simple,slender,small,smooth,spherical,stellate-pubescent,stem,style,surface,terminal,upper,vein,visible,weakly,yellow	-12,-2.3,-4,-4.5,-6,-9,.5,.7,0-10,0-20,0-4,0-6,0.1,0.1-0.25,0.2-0.4,0.25-0.45,0.5-0.7,0.5-2,0.5-2.5,0.6,0.7-1.2,1-1.8,1-2,1-4,1.5-2,1.5-5.5,1/2-2/3,1/2-3/4,1/3-,1/3-1/2,1/4-1/3,2-10,2-2.5,2-3,2-4,2-7,2-8,2/,3-15,3-6.5,3-7,4-7,5-7,5-merous,6-8,7-10,abaxially,acicular,alyx,ame,apar,apart,apparently,bark,blade,branched,brow,c.,caudat,connivent,dark,deltate,difoliate,discolorous,distance,drying,eaf,elongated,elongating,equal,evenly,extending,flattened,flattened-reniform,flower,free,fruiting,geminat,glabrescent,green,infructescence,lobing,long,longer,mature,maturity,midpoint,mixture,nflorescence,oblong,occasionally,older,one,open,orolla,oung,pendulous,perfec,pericarp,perpendicular,poricidal,porrect,portion,prickl,prickle,pubescent,ray,red-brown,reduced,reflexed,ruit,scar,secondary,sessile,side,sometimes,somewhat,spaced,sparsely,spreading,stalk,stalked,stellate,straight,strongly,tamen,tapering,terete,tertiary,time,tip,trichome,tube,unit,usually,vary,venation,way,wide,woody,ympodial,young	2/3,arrangement,branching,caudate,characteristic,colour,corolla,form,growth,height,history,inflorescence,life,na,ovary,perennial,plant,pseudostipule,rachi,shape,staman,texture,unarmed
428	wfo-0001030943	success	167	95	79	88	16	0.473	.5,0,1-1.2,1-1.5,1.1,1.8-2.2,2-6,3,4-4.5,4-5,4-6,abaxial,abaxially,acuminate,acute,adaxial,adaxially,anther,anthesi,apex,base,becoming,berry,black,calyx,cm,corolla,decurrent,deflexed,dendritic,densely,diameter,drying,echinoid,elliptic,fide,filament,flattened,glabrous,globose,golden,golden-yellow,growth,horizontal,im,large,lateral,leaf,lenticular,lobe,minutely,mm,narrowly,outline,ovary,overtopping,pearce,pedicel,per,petiole,pitted,pubescent,purplish-black,reddish-brown,scattered,shoot,shrub,small,sparsely,stem,style,surface,terminal,tree,tree-like,triangular,trichome,violet,x	0.5-1,0.5-3,1.5-2,1/2,10-25,12-15,3-4,3/4,7-13.5,7-8,8-10,absent,age,along,apical,bark,basal,belo,bi-lobed,branch,branching,conical,cupulate,dark,denser,eaf,edicel,eed,elongate,erect,ew,exserted,flower,free,fruiting,glabrat,inserted,lobed,lon,long,lower,m.,main,minute,monochasia,nflorescence,nodding,often,older,pair,pale,papillo,pericarp,planar,plurifoliate,pore,poricidal,portion,raised,ruit,scar,secondary,showy,sleeve,slightly,slit-like,somewhat,stamen,stigma,strongly,tall,tapering,thin,time,tip,tub,tube,ud,unit,upper,vein,way,wide,woody,yellow,yellowish-white,ympodial,young	characteristic,colour,form,fruit,height,inflorescence,length,margin,mentioned,peduncle,plant,rachi,seed,shape,staman,texture
429	wfo-0001030959	success	164	86	66	98	20	0.402	.8,0.5-1.5,0.7-1.2,1.2-1.8,1.5-3.5,10-15,2.5-5,5-6,6-8,anther,apex,apically,armed,articulated,base,branched,brown,brown-green,cm,color,cuneate,deltate,densely,diameter,elliptic,erect,filament,fresh,glabrous,glandular,hair,inflorescence,known,lateral,leaf,length,lobe,long-acuminate,margin,membranous,minute,mm,pair,pedicel,peduncle,petiole,prickle,prickly,primary,scrambling,several,shrub,simple,stem,straw,style,subentire,surface,tertiary,toward,unarmed,usually,vein,venation,visible,yellow	.05,.2,/5,0.5,1-10,1-2,1-7,1.5-2,1/5-1/10,2-4,2.5-4,2.5-4.5,4-6,4-8,5-9,5-merous,9-12,abaxially,almost,alyx,ame,apar,apart,apparently,bark,blade,c.,concolorous,connivent,curved,difoliate,distributed,drying,eaf,eed,equal,evenly,flower,free,geminat,gently,glabrescent,glabrou,green-brow,know,less,like,lobed,long,long-acuminat,longer,lower,midpoint,narrow-deltate,nflorescence,numerous,older,one,open,orolla,oung,part,perfec,perpendicular,poricidal,porrect,portion,present,prickl,prominent,ray,ruit,scar,secondary,sessile,short,side,slender,spaced,sparsely,spreading,stellate,stellate-pubescent,straight,tamen,tapering,terete,time,tip,trichome,tube,unit,vary,way,whole,wide,ympodial,youngest	abaxial,adaxial,arrangement,branching,calyx,characteristic,colour,corolla,form,fruit,growth,height,midvein,na,ovary,plant,seed,shape,staman,texture
430	wfo-0001030982	success	215	104	81	134	23	0.377	-2-2.5,0.05-0.5,0.1-0.15,0.2-3,0.5-1,1,1-1.5,1.5,1.5-2,1.5-3,4-12,4-5,6-8,acuminate,acute,anther,apex,base,berry,broadly,brown,brownish,calyx,cm,conical,corolla,cuneate,dark,deltate,diameter,dry,drying,elliptic,entire,filament,flattened-reniform,form,fresh,fruit,glabrous,globose,green,growth,leaf,lobe,margin,material,maturity,midvein,minutely,mm,ovary,ovate,pair,pale,papillose,pedicel,peduncle,petiole,pitted,plant,primary,pubescent,reddish,reflexed,rhizomatous,seed,simple,sinuate,slightly,sparsely,stem,strongly,style,subshrub,surface,vein,weakly,white,x,yellowish	.1,.2,.5,0.05,0.1,0.3-2,0.5,0.5-0.9,0.5-3,1-8,2/3,3-21,3-8,abaxially,adaxially,age,angular,anisophyllous,anthesi,ape,appressed,ba,beneath,bud,caducous,capitate,central,channelled,chartaceous,ciliate,closely,conic,cream,cucullate,curved,deflexed,differing,difoliate,distall,distally,distichou,eaf,edicel,eed,ellipsoid,enlarged,exerted,extension,external,fleshy,flower,foliage,free,fruiting,geminate,glabrescent,glandular,glandular-papillose,golden-green,greenish,hilum,impressed,inconspicuously,internal,isostylous,larger,later,lengthening,less,like,live,lobed,long,lower,major,materia,minor,mostly,near,new,nflorescence,oblique,obovate,occasionally,often,olive,one,opposite,overlappin,packed,papillae,papillat,papillate,planar,pore,poricidal,portion,projection,prominent,prominently,puberulent,rest,revolute,ruit,sagittate,scar,separated,shoot,sigmoidally,situated,size,slit,somewhat,stamen,stigma,straight,stripe,testa,tetramerous,tightly,time,tip,transverse,trichome,tub,tube,ud,uniseriate,unit,vegetative,veined,way,ympodial,young	.5-2,abaxial,adaxial,arrangement,branching,characteristic,colour,distichous,hair,height,history,inflorescence,length,life,na,pseudostipule,rachi,shape,staman,tertiary,texture,unarmed,venation
431	wfo-0001030989	success	177	115	87	90	28	0.492	.5,0.5-1,1-1.5,1-2,12-15,3-20,3-4,3-7.5,4-5,5,6-6.5,9-10,abaxially,acuminate,adaxially,anther,apex,articulated,axillary,base,berry,brownish,bud,cell,chartaceous,cm,condition,conical,corolla,covering,densely,diameter,distal,drying,filament,flower,forked,fresh,fruit,generally,glabrous,green,green-white,greenish,hair,hair-like,half,herb,lateral,leaf,light,like,lobe,long,make,margin,minute,mm,mucilaginous,obtuse,odd-pinnate,ovate-lanceolate,ovoid,pedicel,peduncle,petiole,plant,proximal,pubescent,ripe,seed,sparsely,stem,style,subtending,terminal,testal,thick,throughout,triangular,unwinged,usually,violet,wall,wet,whitish,wide	1-10,15-27.5,2-3.5,3-5.5,4-7,4-8,5-merou,5.5-7.9,6-13,ag,alyx,apart,apparently,axe,blade,capitat,ciliate,connivent,decreasing,digestion,dorsally,eaf,edge,eed,end,enzyme,erec,especially,flat,folded,geminat,glabrou,gradually,homostylous,honeycomb-shaped,interjected,lanceolate,larger,leaflet,lengthening,living,lower,nflorescence,occurring,orbicular,orolla,ovate,pair,pale,perfect,petiolule,plurifoliate,pore,poricidal,present,pubescen,ray,removed,rotate,ruit,secondary,semierect,seudostipule,singly,size,slit,spaced,specimen,ste,stigma,stolo,subequal,subsessile,symmetrical,tall,tamen,tem,thir,tip,toward,tri-,tube,tuber,typically,unit,vary,wider,x,yellow,ympodial	abaxial,adaxial,arrangement,branching,calyx,capitate,characteristic,colour,form,growth,height,inflorescence,length,midvein,na,ovary,primary,pseudostipule,rachi,shape,staman,surface,tertiary,texture,third,unarmed,vein,venation
432	wfo-0001030991	success	204	113	91	113	22	0.446	.5,0,0.5-1,0.5-1.5,0.7-1.2,1-1.5,1-1.6,1-2.2,1.5,10-20,2.5-3,2/3,3-,3-5-lobed,5-5.5,9-11,absent,acuminate,acute,along,anther,anthesi,apex,apparently,appressed,ascending,attenuate,basal,base,berry,brown,calyx,cm,corolla,diameter,elliptic,entire,filament,filiform,flattened,glabrous,globose,grey,growth,herb,inflorescence,lanceolate,lateral,leaf,leaf-opposed,like,lobe,long-triangular,margin,minutely,mm,narrowly,nodding,occasionally,pair,pedicel,peduncle,per,petiole,pitted,primary,pubescent,red,reniform,rest,ripe,scattered,short,shrub,simple,small,sparsely,stem,style,surface,terminal,trichome,uniformly,uniseriate,vein,violet,weak,white,winged,x,yellowish	0.1,0.2,0.2-0.7,0.3-0.4,0.5,0.5-0.7,0.5-3.5,0.6-0.8,1-2.5,1-7,2-plurifoliat,2.5-10,4-10,5-merou,<,abaxially,adaxiall,adaxially,ag,alyx,angled,arising,ark,articulated,bulbous,capitate,cell,color,conical,connivent,densely,different,distally,drying,eaf,eed,ellipsoid,ellipsoidal,elongate,enlarged,exerted,eye,flower,free,frui,fruiting,furcate,fusiform,glabrescen,ilament,incised,leave,lengthening,less,lobed,loosely,lower,midrib,minute,nearly,new,nflorescence,often,older,orolla,outline,packed,papillo,part,particularly,pendant,perfect,pericarp,pinnatifid,platfor,pointing,pore,poricidal,portion,pseudoumbel,rectangular,reflexed,rootstoc,ruit,scar,shallowly,shiny,sleeve,slightly,slit,somewhat,spreading,stellate,stigma,strongly,suffrutescent,tangled,tem,testal,thin,tightly,tip,tube,twinin,ud,unit,upper,variably,vary,weight,woody,ympodial,young	abaxial,adaxial,arrangement,branching,characteristic,colour,form,fruit,glabrescent,height,length,midvein,na,ovary,plant,pseudostipule,rachi,seed,shape,staman,texture,unarmed
433	wfo-0001031005	success	231	110	99	132	11	0.429	.5,/3-1/2,0.8,0.9,1-1.5,1-2,1-2.5,1-3,2-3.2,2.5,3-4,3-6.5,4-6,5-7,abaxial,abaxially,acuminate,acute,adaxially,almost,anther,anthesi,apex,apically,attenuate,base,berry,black,blue,branch,branching,brown,calyx,chartaceous,clustered,cm,conical,corolla,curved,deltoid,dendritic,diameter,dilated,drying,elliptic,elongated,entire,evenly,filament,fine,flat,form,fruit,glabrous,greenish,known,lateral,leaf,length,liana,lobe,margin,membranous,midvein,mm,network,obovate,occasional,orange-brown,ovoid,pair,pedicel,peduncle,petiole,primary,prominent,pubescent,purple,rachi,raised,ridged,seed,short,slender,sometimes,somewhat,sparsely,stem,style,surface,terminal,tertiary,trichome,unarmed,usually,vein,venation,white,x	.4,0-0.5,0.1,0.3-0.5,0.5-1.5,1,1.5-2.5,1.5-4,10,2.3-3,2.5-4,3-10,5,5-8,5Â°,6-12,accrescent,age,along,alyx,apar,apparently,articulated,bark,brachyblast,branched,capitate,clearly,clum,common,concolorous,cupular,dark,datum,deeply,delineated,dendritic-pubescent,denser,density,detaching,developing,discolorous,divided,domatia,eaf,ellipsoi,equal,extending,eye,fertilisation,flattened,flexuous,flower,forming,free,fruiting,immature,increasing,inside,junction,leave,lengthening,like,linear,lobed,long,longitudinally,loop,lower,m.,main,minute,much,naked,nflorescence,nther,oblong,obscure,occasionally,often,older,onl,orolla,ou,outside,ovate,pendulous,perfec,pericarp,plurifoliat,pointed,pore,poricidal,portion,protruding,ray,region,rest,ruit,scar,secondary,side,simple,smaller,smoot,smooth,soon,spread,spreading,standing,stigma,strongly,stump,surrounding,tangling,tearing,terete,thick-chartaceous,thin,tip,toward,tube,ud,uneven,unit,vary,visible,weakly,well-developed,wide,ympodial,young	adaxial,arrangement,characteristic,colour,growth,inflorescence,ovary,shape,staman,texture,ye
434	wfo-0001031007	success	207	132	115	92	17	0.556	.5,0.5,0.5-1,0.75-1.5,1,1-1.2,1-1.5,1-3.5,1.2-1.5,1.5-2,1.9-3,15,3-4,4-6,4.5-5,5.5-6,50-100,6,7-10,acute,alfway,along,anther,anthesi,apex,articulated,base,beginning,berry,black,branched,broad,broadly,brown,c.,calyx,cell,cm,corolla,cuneate,dark,deltate,dendritic,diameter,drying,elliptic,entire,extending,filament,flattened-reniform,flower,fruit,glabrous,globose,growth,herbarium,inflorescence,irregularly,lamina,lax,leaving,lilac,lobe,lobed,long,loose,lower,many,margin,minutely,mm,narrowly,near,occasionally,often,outline,pedicel,peduncle,peg,per,petiole,pitted,prominent,pubescent,reddish,revolute,round-rectangular,shiny,shrub,simple,sleeve,slender,sparsely,specimen,splitting,spreading,stellate,stellate-pentagonal,stem,stout,style,surface,tangled,terminal,testal,time,tiny,tip,trichome,twining,usually,vein,vine,woody,x	0.2,0.5-10,1.3-,1.6-2,1/3,11-14,2.5-,2.5-5,4-7,5,5-12,5-merou,8-10,<,abaxiall,abruptly,ag,almost,alyx,apar,apparently,ark,becoming,bifid,branching,campanulate,capitate,chartaceous,clustered,completely,connivent,cup-shaped,densely,dilated,dull,eaf,eed,ellipsoid,exserted,fleshy,free,fruiting,geminat,glabrescen,glabrou,ilament,impressed,intramarginal,junction,lengthening,looping,loosely,m.,markedly,matte,midvein,multi-celled,narrowing,new,nflorescence,nodding,older,orolla,pale,papillat,papillate,perfect,pericarp,planar,plurifoliate,pore,poricidal,portion,primary,rat,ruit,sagittate,scar,slightly,slit,spaced,stigma,strongly,thin,tube,ud,unit,upper,vary,way,yellow,ympodial	abaxial,adaxial,arrangement,characteristic,colour,form,height,leaf,length,na,ovary,plant,rachi,seed,shape,texture,type
435	wfo-0001031007	success	206	126	109	97	17	0.529	.5,0.5-1,0.5-10,0.75-1.5,1,1-1.2,1-1.5,1-3.5,1.2-1.5,1.9-3,15,3-4,4.5-5,5.5-6,50-100,6,7-10,acute,alfway,along,anther,anthesi,apex,articulated,bark,base,becoming,beginning,berry,bifid,black,branched,broad,brown,c.,capitate,clustered,cm,corolla,cuneate,dark,dendritic,diameter,drying,ellipsoid,elliptic,entire,extending,filament,flattened,flower,fruit,glabrous,globose,growth,herbarium,inflorescence,irregularly,lamina,lax,leaving,lilac,lobed,long,loose,lower,many,margin,minutely,mm,narrowly,near,occasionally,often,papillate,pedicel,peduncle,peg,petiole,prominent,pubescent,reddish,reniform,revolute,scar,shrub,simple,sleeve,slender,spaced,sparsely,specimen,spreading,stellate,stellate-rotate,stem,stigma,style,surface,tall,tangled,terminal,time,trichome,usually,vein,vine,wide,woody	0.2,0.5,1.3-,1.5-2,1.6-2,1/3,11-14,2.5-,2.5-5,4-6,4-7,5,5-12,5-merou,8-10,<,abaxially,abruptly,adaxial,ag,almost,alyx,apar,apparently,branching,broadly,calyx,campanulate,cell,chartaceous,completely,cup-shaped,deltate,densely,dilated,dull,eaf,eed,exserted,fleshy,free,fruiting,glabrescen,glabrou,ilament,impressed,intramarginal,junction,lengthening,lobe,looping,m.,markedly,matte,midvein,multi-celled,narrowing,new,nflorescence,nodding,older,orolla,outline,pale,papillat,per,perfect,pericarp,pitted,planar,plurifoliat,pore,poricidal,portion,primary,rat,round-rectangular,ruit,sagittate,shiny,slightly,slit,splitting,stout,strongly,testal,thin,tiny,tip,tube,twinin,ud,unit,upper,vary,way,ympodial	apart,arrangement,bud,characteristic,colour,form,glabrescent,height,leaf,length,ovary,plant,seed,shape,texture,twining,width
436	wfo-0001031036	success	150	101	72	78	29	0.48	.2,.25,.5,0.5-1,0.8-1,0.8-1.2,1-1.3,1-2.5,1.2-1.5,1.5-3,10-20-flowered,2-2.5,3-4,5-6,7-8,acuminate,acute,anther,apex,base,berry,broadly,brown,calyx,cm,corolla,crisped,dark,decurrent,dia,dry,elliptic,enlarged,erect,filament,filiform,flattened-reniform,fleshy,fresh,glabrous,globose,green,greenish-white,knob-like,leaf,lobe,long,margin,material,minutely,mm,oblique,ovary,pair,pedicel,perhaps,petiole,pitted,shiny,shrub,simple,slightly,spathulate,stem,style,surface,tapering,thickened,tube,vein,winged,x	12-15,2.2-3.7,3-5,3.5-5.5,4.5-6.5,abaxially,adaxially,along,angle,anthesi,arising,axil,ba,becoming,bi-lobed,closely,conical,deflexed,differing,difoliate,drying,eaf,edicel,eed,ellipsoid,exserted,free,fruiting,geminat,lamina,lateral,lobed,lon,lower,main,major,middle,minor,nearly,nflorescence,older,onto,opposite,overlappin,papillo,papillose,planar,pointed,pore,poricidal,portion,rounded,ruit,sagittate,scar,shaped,short,sinus,size,soon,spaced,stigma,strongly,tall,tear-drop,tip,trichome,tub,ud,uniseriate,unit,usually,white,widest,woody,yellowish,ympodial,young	abaxial,adaxial,arrangement,branching,characteristic,colour,diameter,form,fruit,growth,height,history,inflorescence,length,life,midvein,na,peduncle,plant,primary,pseudostipule,rachi,seed,shape,staman,tertiary,texture,unarmed,venation
437	wfo-0001031064	success	179	106	80	99	26	0.447	.0-2.5,.5,.5-1,0.5,0.5-0.7,1-2,1-3,1.2,1.5-2,10-12,2.5-3,3,3.5-4,5-6,abaxially,acuminate,anther,anticlinal,apex,arising,attenuate,axil,base,berry,bright,calyx,cm,completely,conical,corolla,deltate,densely,diameter,elongate,filament,fleshy,fruit,glabrous,green,half,highly,inflorescence,irregular,leaf,like,lobe,lower,margin,minutely,mm,obovate,occasionally,ovary,ovoid-reniform,pedicel,petiole,pinnate,projection,pubescent,purple,rachi,scattered,short-pubescent,shrub,simple,single,sinuous,somewhat,sparsely,stem,style,surface,thickening,translucent,trichome,uniseriate,vein,white,without,x	.05,0,0-15,0.5-0.8,1,1-1.2,1.7-4.2,10-12.5,10-17,2,3-5.5,3-7,4-5-celled,5-10.5,6-16,7-16,8-10-celled,acroscopic,adaxially,along,anthesi,basal,bearing,blade,broader,cell,clavat,commentary,conspicuous,dark,denser,distal,dr.,eaf,edicel,eed,epidermal,erec,exserted,flower,free,fruiting,globose,irregularly,lamina,lateral,leaflet,leave,lenticel,lightly,lobed,lon,long,lost,minute,narrower,near,nearly,nflorescence,nodding,node,often,open,ovate,pair,papillate,per,petiolule,planar,poricidal,portion,prominent,pubescen,rugose,ruit,scar,see,side,sinus,slender,smaller,splitting,stigma,strongly,swollen,tal,tem,terminal,time,tip,tub,tube,ud,unifoliat,unit,usually,wand-like,winged,ympodial	abaxial,adaxial,arrangement,branching,characteristic,colour,form,growth,height,history,length,life,midvein,na,peduncle,perennial,plant,primary,pseudostipule,seed,shape,staman,tertiary,texture,unarmed,venation
438	wfo-0001031071	success	186	91	69	117	22	0.371	0.2-0.8,1-1.5,1-2,2-8,2.1-3,2.4-3.4,3-10,3-6,4-25,4-6,6-8,7-8,8-28,anther,axillary,berry,blue,brownish,bud,cm,color,condition,coriaceous,corolla,dark,deep,diameter,distal,drying,elliptic,filament,flower,forked,fresh,fruit,generally,glabrous,globose,green,greenish,half,herb,lanceolate,leaf,lilac,lobe,long,medium,mm,mottled,narrowly,odd-pinnate,ovate,ovoid,pedicel,peduncle,plant,purple,ripe,seed,spot,star,style,subtending,terminal,usually,white,whitish,winged	0-10,0.4-2,1-3,1-7,1.5-2.2,2-3,2-5,3-5,3.8-5.4,5-9.4,5-merou,5.7-8.8,7-16.5,abaxiall,abaxially,acumen,acute,adaxially,ag,along,alyx,apart,apex,apparently,arranged,articulated,asymmetric,attenuate,axe,base,basiscopic,bead,blade,capitat,cell,clavate,connivent,covering,decreasing,digestion,dorsally,eaf,edge,eed,enzyme,erec,exceeding,flat,folded,geminat,glabrou,green-white,hair-like,homostylous,honeycomb-shaped,interjected,lateral,leaflet,lengthening,like,living,lower,make,middl,moniliform,mucilaginous,multiple,necklace,nflorescence,orbicular,orolla,pair,pentagonal,perfect,petiole,petiolulate,plurifoliate,pore,poricidal,removed,rotate,round,ruit,sessile,seudostipule,short,side,size,slightly,slit,spaced,specimen,stamen,stigma,stolon,straight,subequal,tall,tamen,tem,testal,thick,throughout,tip,tissue,toward,tri-,tube,tuber,typically,unit,vary,wall,wet,x,yellow,ympodial	2,abaxial,adaxial,arrangement,calyx,characteristic,colour,form,growth,height,history,inflorescence,length,life,ovary,perennial,pseudostipule,shape,staman,stem,surface,texture
439	wfo-0001031097	success	174	80	63	111	17	0.362	0.45,1-4,1-4.5,1.6-5.5,1.8-2.5,13-30,2-3.3,2-4,3-5,3.7-8.4,4-6,5-12,8-11,abaxially,adaxially,branched,calyx,cm,corolla,cyme,darker,deep,diameter,dichasial,dichasially,ebracteate,elliptical,green,green-white,herbaceous,lateral,leaf,leaflet,light,long,medium,mm,monochasial,mucilaginous,obovate,odd-pinnate,ovate,ovoid,pair,pedicel,peduncle,pentagonal,perennial,petiole,plant,puberulent,pubescent,purple,rotate,seed,strigose,style,terminal,throughout,tuber-bearing,violet,violet-blue,wide	0.5,1,1-3,1.5,1.8-2.6,2-3,3-6-foliat,3.5-6,4-7,5-11,5-9,9-21,abaxial,acumen,acuminate,acute,along,apex,apical,apically,articulate,base,cell,connate,covering,cuneate,decurrent,dehiscent,digestion,diminishing,distal,dorsally,dotted,eaf,edge,eed,emoval,enzyme,exceeding,filament,flat,flower,folded,forked,frequently,generally,globo,gree,hair-like,half,highly,honeycomb,interjected,interpetalar,introrse,lighter,living,lobe,lon,lower,lunat,make,margin,maturing,mottled,narrow,nflorescence,noticeably,nther,oblique,often,orolla,pattern,perfect,petal,petiolulate,petiolule,plan,poricidally,proximal,rachi,rapidly,rarely,reveal,ruit,sessile,seudostipule,short,side,size,slit,sometimes,specimen,stamen,stigma,straight,tal,tem,testal,thick,tissu,toward,typically,unit,vary,vbase,wall,without,yellow,ympodial,Â¼	anther,arrangement,characteristic,colour,form,fruit,growth,height,inflorescence,length,ovary,shape,stem,surface,texture,wet,width
440	wfo-0001031101	success	197	124	104	93	20	0.528	-20,-5,-8,0.5-0.8,0.5-3,0.8-,1-2,1-2.3,1.3-2,1.4-1.7,1/4-1/2,2-2.8,2-4,2-6,2.5-3.8,3-15,3-8,3.5-4.5,5-6,abaxial,acuminate,adaxial,almost,anther,apex,apical,apically,apparently,articulated,base,berry,branched,bright,calyx,cm,concolorous,diameter,drying,dull,entire,erect,evenly,filament,filiform,flattened-reniform,glabrescent,glabrous,glandular,green,green-brown,hair,lateral,leaf,length,lobe,long,long-acute,margin,maturity,mauve,membranous,minute,mm,moderately,narrow-deltate,near,obtuse,often,orange-brown,orange-red,ovate,pair,pedicel,peduncle,per,petiole,primary,red,resembling,rounded,scandent,shrub,simple,sparsely,spherical,stellate-pubescent,stem,straight,style,surface,terete,terminal,tertiary,trichome,umbel,unarmed,vein,venation,visible,white,wide,yellow,yellow-green,young	-1,-16,-30,/2,/2-equal,0.05-0.2,0.1-0.2,0.1-0.3,0.3-0.5,0.6-0.8,0.7-0.8,1-,1-3,1.3-2.5,1.5-3,1/3-1/2,10-30,2-5,2.5-,2.5-3.5,3-10,4-10,4-5-merous,4-7,4.5-9,5-20,6-10,8-15,abaxially,alyx,ame,apar,ba,bark,blade,c.,connivent,deltate,difoliate,eaf,eed,elongating,equal,flower,free,frui,fruiting,geminat,herbaceous,infructescence,lobed,long-acuminat,longer,lower,mature,midpoint,multangulate,nflorescence,older,one,open,orolla,oung,pale,pendulous,perfec,pericarp,poricidal,porrect,portion,ray,red-brow,ruit,scar,sessile,smooth,spaced,spreading,stalk,stalked,stellate,stellate-pubescen,tamen,tapering,time,tip,tube,unarme,unit,variously,vary,way,ympodial	arrangement,branching,characteristic,colour,corolla,form,fruit,growth,height,inflorescence,long-acuminate,midvein,na,ovary,plant,rachi,seed,shape,staman,texture
441	wfo-0001031114	success	208	106	87	121	19	0.418	.2,.5,0.5,0.5-1,0.7-1.5,0.8-1.2,1-10,1-7,1.5-4,10-15,2-3,2/3,25-50,3-4,4-10,4.5-6,6-7,acuminate,acute,anther,apex,base,becoming,berry,branched,brown,chartaceous,cm,dark,densely,diameter,distal,echinoid,elliptic-ovate,entire,erect,especially,filament,first,flattened,fleshy,flower,fruit,glabrous,globose,green,hair,leaf,leaf-opposed,light,long,margin,mm,nodding,obtuse,outline,ovate,pedicel,peduncle,petiole,pubescent,purple,rachi,reniform,ripe,rounded,rugulose,shrub,simple,small,sparsely,stellate,stellate-pubescent,stem,strongly,style,subcoriaceous,subcuneate,surface,thickened,toward,tree,truncate,white,white-pubescent,x,yellowish	.1,0-0.3,0.3-0.5,1-1.5,1-2,1-4.5,1-8,1.5-2.5,2-17,2-4,2-7,2.5-3,3-10,3-5,3-7,4-5,4-8,5-10,5-8,5-merou,7-15,abaxially,absen,accrescent,adaxiall,adaxially,ag,alyx,apart,apparently,articulated,axe,ba,blade,calyx,capitat,connivent,covering,cylindrical,deltate,differentiated,directed,discolorous,distally,dried,eaf,eed,equal,free,frui,fruiting,geminate,highly,homostylous,impressed,interpetalar,introrsely,juic,lacking,large,like,lobe,long-stalked,longitudinal,lower,major,membanaceous,midpoint,minor,multangulate,nearly,nflorescence,oblong,often,one,opening,orolla,paired,part,perfect,pericarp,plurifoliate,pore,porrect,prominent,ray,ruit,sessile,short,short-,short-stalked,side,slightly,slit,somewhat,spaced,stalk,ste,stigma,straight,subcucullate,subtending,tall,tamen,tem,thin,time,tip,tissue,triangular,tube,unarme,unit,vary,vein,white-stellate,whitish,wide,without,yellow,ympodial	abaxial,adaxial,arrangement,characteristic,colour,corolla,form,growth,height,inflorescence,length,ovary,plant,seed,shape,staman,texture,true,unarmed
442	wfo-0001031116	success	191	110	95	96	15	0.497	-10,.5,.8,0,0.3-0.5,0.7-1,1-5,1/2,2-5,2.7-3.2,3.5-4,30-100,4-7,8-11,abaxial,acuminate,adaxial,almost,anther,apex,apparently,attenuate,base,berry,branching,bristle,calyx,caudate,cm,collapsed,diameter,dirty-white,discolorous,drying,dull,elliptic,evenly,filament,flower,fragile,fruit,glabrescent,glabrous,glaucous-green,green,lateral,leaf,length,long,lower,margin,maturity,mauve,membranous,mm,moderately,multangulate,obovate,obtuse,one,open,orange-brown,orange-red,pedicel,peduncle,petiole,primary,red-brown,rounded,secondary,sessile,sharply,shortly,shrub,slender,small,soft,sometimes,sparsely,spherical,stalked,stellate-pubescent,stem,straight,style,subentire,surface,time,tree,trichome,unarmed,upper,weakly,yellow,young	.2,/4,0.05-0.15,0.1,0.4-0.7,0.7-0.9,1,1/3-2/,1/6-1/4,10-14,15-25,30-50,4-10,5,5-15,5-merous,9-13,abaxially,alyx,ame,apar,apart,apically,arachnoid,articulated,bark,blade,broad-deltate,brow,c.,clearly,connivent,densely,eaf,eed,elongated,elongating,epidermi,equal,erect,flat,flattened-reniform,flexuous,free,fruiting,hair,infructescence,less,lobe,lobed,longer,mature,midpoint,minute,narrow-deltate,nflorescence,obtu,often,older,orolla,oung,pair,per,perfec,pericarp,perpendicular,plurifoliat,poricidal,portion,ray,recurved,reflexed,ruit,scar,simple,single,smooth,spaced,stalk,stellate,tamen,tapering,terete,tertiary,tip,tube,unarme,unit,vary,vein,venation,visible,way,wide,woody,ympodial	1/3-2/3,characteristic,colour,corolla,form,growth,height,inflorescence,ovary,plant,seed,shape,staman,texture,type
443	wfo-0001031128	success	213	132	111	102	21	0.521	-10,-100,-4.5,-6.5,0,0-30,0.5-0.7,0.5-0.8,0.5-1.5,0.6-1,0.8-1.7,1-,1.5-3,1.5-3.5,2-5,2.3-,20-60,3-4,3.5-4.5,8-12,abaxial,acute,almost,anther,apex,apically,apparently,articulated,base,berry,branched,branching,bristle,calyx,cm,concolorous,cuneate,deltate,diameter,drying,dull,elliptic,entire,erect,evenly,eye,filament,filiform,flattened-reniform,fruit,glabrescent,glabrous,glandular,green,hair,inflorescence,lateral,leaf,length,lobe,lobed,long,long-acuminate,lower,margin,maturity,mauve,membranous,minute,mm,moderately,naked,near,often,orange-brown,pair,pale,pedicel,peduncle,per,petiole,primary,purple-black,recurved,red,red-brown,shallowly,short-attenuate,shrub,simple,spherical,stellate,stellate-pubescent,stem,straight,style,surface,terminal,tertiary,trichome,unarmed,undulate,vein,venation,visible,weakly,white,wide,yellow,yellow-green,young	/4,0.05-0.2,0.05-0.25,0.2,0.2-0.4,0.3-0.8,0.5-5,1,1-1.6,1.2-2,1/,1/6-1/3,10-20,10-35,2-9.5,2.5-10,2.5-3.5,20-50,4-5-merous,4-7,5-,5-15,5-19,5-30,8-23,abaxially,alyx,apar,apart,ape,bark,blade,brown,connivent,densely,eaf,eed,elongated,elongating,equal,flexuous,flower,free,fruiting,gland,gra,infructescence,less,lon,long-acuminat,longer,mature,midpoint,multangualte,multangulate,narrow-deltate,nflorescence,occasionally,older,one,open,orolla,oung,perfect,pericarp,perpendicular,plurifoliat,poricidal,portion,ray,reduced,reflexed,ruit,scar,secondary,sessile,short-styled,side,single,smooth,soft,spaced,spreading,stalk,stalked,staminate,tamen,tapering,terete,time,tip,tube,unarme,unit,usually,variously,vary,way,whitish,woody,yellow-brown,ympodial	1/3,adaxial,arrangement,characteristic,colour,corolla,form,growth,height,history,life,midvein,na,ovary,plant,pseudostipule,rachi,seed,shape,staman,texture
444	wfo-0001031135	invalid_json	189	143	107	82	36	0.566	0-2,0.7-2,1-,1-1.5,1-10,1-3,1-4,1.5-2,1.5-3,1.5-9,10-20,2,2-,2-2.5,2-3,2-3.5,2-4,3-10,3-4,3-5,4-5,5-30,5-9-pinnate,7-15,abaxially,acuminate,acute,adaxially,also,apart,apex,articulated,basal,base,basiscopically,calyx,chartaceous,cm,compound,cordate,cuneate,darker,decurrent,deflexed,deltate,densely,diameter,eglandular-pubescent,ellipsoidal,elliptic,entire,fading,flattened,flower,frequently,fruit,fusiform,glandular-,green,lateral,leaf,leaflet,leaving,light,lobe,lobed,long,longitudinal,margin,mm,moderately,oblique,often,ovate,ovoid,pedicel,pedicellar,peduncle,perfect,petiole,pilose,pink,pinnately,pinnatifid,puberulent,pubescent,purple,rachi,remnant,ripe,shrub,simple,spaced,sparsely,stripe,style,tip,tree,truncate,unbranched,unlobed,upper,white,whitish,x,yellow-green,yellowish	-7,0.5-2,1-2.5,2-23,2-5,2.5-28,3.5-12,4-foliat,5-11,absent,adpressed,aggregate,along,ape,axe,beyond,biglandula,blade,broad,campanulate,cell,color,connective,coriaceous,cylindrical,dilated,directed,distally,eaf,eed,ellipsoida,equal,especially,exceeding,exserted,glabrous,hair,interstitial,irregularly,laterally,lon,lower,midrib,narrowed,nflorescence,nther,obconical,oblong,obtuse,occasionally,orolla,papillose,peltiform,pilo,pore,present,radiu,ruit,shorter,slightly,small,smaller,stamen,stigma,stone,strongly,subcoriaceous,tal,tem,thecae,time,tomento,toward,triangular,tube,ud,unit,unknow,vary,violet,wide,ympodial	'',[,``,abaxial,adaxial,anther,arrangement,branching,characteristic,colour,corolla,filament,form,growth,height,inflorescence,length,midvein,na,ovary,plant,primary,pseudostipule,seed,shape,staman,stem,surface,tertiary,texture,unarmed,value,vein,venation,{,}
445	wfo-0001031144	success	231	103	93	138	10	0.403	.5,0.2,0.8-1.4,1-1.5,1-4,1.1-2.5,2-3,2.5-3,2/3,25,3-7,4-4.5,6,7-10,<,acuminate,acute,adaxially,anther,apex,apiculae,articulated,asymmetric,base,berry,bright,broadly,brown,calyx,cm,commonly,cordate,corolla,diameter,elliptic,entire,filament,form,glabrous,globose,groove,growth,inflorescence,later,lateral,leaf,less,lobe,lobed,long,margin,mere,minutely,mm,oblique,occasionally,pale,pedicel,peduncle,petiole,pinnately,pinnatifid,pitted,pubescent,red,reddish,rim,seed,shiny,simple,slightly,sparsely,stellate-rotate,stem,style,surface,tan,terete,terminal,tiny,triangular,trichome,truncate,uniseriate,usually,vine,violet,way,white,woody,x,yellowish,Â½	-11,-13,.2,0.5,1-,100,2,2-,2-6,2-9,3-4.5,3.5-10,4,4-20,4-6,5,5-9,5-merou,ag,alyx,anthesi,apart,apicula,appearing,ark,around,away,axi,basal,basiscopically,blac,branch,branche,brow,capitate,cell,closer,connivent,corresponding,cupped,curved,densely,divaricate,drying,eaf,eed,ellipsoid,elongate,elongating,exserted,extending,flattened,flattened-reniform,flower,four,free,fruiting,geminat,ilament,inflated,irregularly,lamina,larger,leaflet,leaving,lengthening,like,longer,longest,loosely,lower,many,markedly,membranous,minute,near,new,nflorescence,number,often,older,one,open,orolla,outline,pair,papillo,peg,pendant,pentagonal,per,perfect,pericarp,plurifoliate,pore,poricidal,portion,primary,progress,quite,ripe,ruit,scar,sleeve,slit,small,smaller,sometimes,spaced,spreading,stigma,strongly,tangle,tem,testal,thin,third,tip,together,tube,tuft,twinin,twining,two,ud,unequal,unit,upper,variable,vary,vein,wall,weight,widest,wing,wood,yellow,ympodial	arrangement,bark,characteristic,colour,fruit,length,ovary,shape,texture,type
446	wfo-0001031152	success	232	141	126	106	15	0.543	-10,.4,0-100,0.2-0.3,0.2-1.5,0.3-1.3,0.3-3,1-1.5,1-3,1-6,1.1-2.2,1.2-1.8,1.4-2.6,1/2-3/4,11,2.7-3.7,4-19,4-6,4-8,5-6,6.5-10,abaxially,acuminate,acute,adaxially,anther,anthesi,apart,apex,articulated,attenuate,basal,base,becoming,berry,branched,brown,bud,bullate,closely,cm,conical,continued,corolla,decurrent,deltoid,densely,diameter,directed,due,entire,exserted,filament,fleshy,flower,fruit,granular-tomentose,greenish,growth,hair,honeycombed,lanceolate,lateral,lavender,leaf,length,lilac,long,long-,longer,margin,mixed,mm,mostly,multangulate,narrowly,nearly,oblanceolate,openly,pale,pedicel,peduncle,persistently,petiole,pitted,porrect-stellate,probably,pubescent,rachi,rather,ray,reddish,reddish-brown,reniform,reticulate-punctate,ripe,scabrous,sessile,short-,shrub,simple,spaced,sparingly,sparsely,stamen,stellate-pubescent,stem,stigma,style,suborbicular,surface,terete,terminal,thick-stalked,thin-,time,tomentose,toward,tree,unarmed,variously,violet,x,yellow,yellowish,young	-1.5,-5.5,/100-1/16,1.1-3,1.3-4,1.5-3,1.5-3.5,1/2-2/3,13-27,2-5,2.5-7.5,2.7-4.5,2.7-6,2.8-4,3.7-7,4-7,8-20,9-13,accrescent,ag,along,apical-lateral,apparently,axe,axillary,ba,blade,blister,blunt-tipped,branch,calyx,capitat,chartaceous,dehiscing,eaf,earl,eed,evident,extend,few-rayed,free,fruiting,glabrescen,glabrous,globose,green,high,inserted,introrse,lackin,large,less,lobe,lobed,longitudinal,lower,m.,main,midvein,moderately,multangulat,nflorescence,oblong,obtuse,occasionally,one,open,orbicular,orolla,ovate,partly,perfect,plurifoliate,pore,relatively,rotate-stellate,ruit,runk,short-stalked,side,slightly,slit,somewhat,soon,splitting,stelliform,stipitate-glandular,stout-stalked,strongly,suture,swelling,tamen,testa,thick,thin,thin-stalked,touching,tube,unarme,unit,usually,vary,vein,way,wide,ympodial	arrangement,capitate,characteristic,colour,form,glabrescent,height,inflorescence,ovary,plant,seed,shape,staman,texture,type
447	wfo-0001031202	success	198	121	92	106	29	0.465	0-0.5,0-1,0.6-1.1,0.8-1,1-1.5,1.5-2.5,2-3,2-8,2.5-3.5,2.5-4,3.5-4,6-25,9-11,abrupt,acute,along,anther,apex,apiculate,base,beneath,berry,broadly,calyx,cm,cordate,corolla,decurrent,deflexed,deltoid,densely,erect,filament,fleshy,flower,fruit,glabrous,globose,golden,green,inflorescence,later,lateral,leaf,lobe,long-styled,margin,minute,minutely,mm,narrowing,obovate,occasionally,opposite,ovary,overtopping,ovoid-reniform,pair,pale,pedicel,petiole,pitted,plant,puberulent,pubescent,reddish-brown,sessile,shape,shoot,short-styled,shrub,slender,slightly,small,sparsely,stem,straight,style,surface,tan,tapering,terminal,tip,tree,trichome,tube,uniseriate,variable,vein,white,winged,x	.1,.5,0.1-0.3,0.5,0.5-1,1-1.7,1-5,1.5-2,1.5-9,15-40,2.5-13,2/3,20-100-flowered,9-20,accrescent,anthesi,apart,axi,bark,bud,capitate,completely,complex,condition,corky,cup-shaped,dia,differing,difoliate,distal,dry,due,eaf,edicel,eed,enclosed,exserted,extremely,free,frui,fruiting,furcate,geminat,glabrate,greenish-white,greyi,hard,irregularly,large,like,live,lobed,lon,long,long-ellipsoid,longer,lower,main,major,many,material,middle,minor,nflorescence,occasional,often,older,one,orbicular,paler,papillo,papillose,planar,pore,poricidal,portion,prominent,quite,raised,rounded,ruit,scar,scattered,shaped,size,spaced,specimen,stigma,tall,tear-drop,thick,thickened,thicker,third,time,tub,ud,unit,usually,way,weight,whitish,widest,woody,ympodial,young	abaxial,adaxial,arrangement,branching,characteristic,colour,diameter,form,greyish,growth,hair,height,hirsute,history,length,life,midvein,na,peduncle,perennial,primary,pseudostipule,rachi,seed,staman,tertiary,texture,unarmed,venation
448	wfo-0001031207	success	219	107	85	134	22	0.388	0-20,0.25-0.5,0.5-1,0.6-1.2,0.85-1.4,1.4-2,1/4-1/3,2.8-3,3-5,3.5-7,5-8,anther,apex,apparently,articulated,base,berry,calyx,cell,cm,cordate,densely,diameter,dull,erect,evenly,eye,filament,fruit,glabrous,gray,green,herb,lateral,leaf,length,lobe,lobed,lower,margin,maturity,mauve,midvein,mm,moderately,naked,narrow-deltate,oblong,obtuse,orange-brown,outline,ovate,pair,pale,pedicel,peduncle,per,petiole,pit,prickly,primary,raised,red,shrub,simple,small,smooth,sometimes,spherical,stellate-pubescent,stem,style,subentire,surface,terminal,tertiary,unarmed,upper,vein,venation,visible,white,yellow,yellow-green,young	-0.4,-1/2,-11,-4,-5,-7,-8,.1,/5,0,0-0.5,0-10,0.1-0.2,0.1-0.3,0.1-0.5,0.2,0.2-0.3,0.3-0.5,0.6-0.9,0.7-2,0.8,0.9-1.6,1,1-3,1-4,1-5,1.5-5,1/,1/3,1/3-equal,2-3,2-4,2.1-2.3,2.5-,5-merous,6-8,6.5-8,9,abaxially,acuminat,acute,alyx,ame,apar,apart,apically,bark,blade,branched,bristle,bristly,broad-deltate,brow,c.,chartaceous,concolorous,curved,dark,difoliate,discolorous,distance,drying,eaf,eed,elongated,elongating,equal,extending,filiform,flattened-reniform,flower,free,fruiting,geminat,gently,glabrescent,herbaceous,infructescence,lanceolate,less,like,long,longer,mature,midpoint,multangulate,nflorescence,occasionally,older,one,open,orolla,oung,pendulous,perfec,pericarp,perpendicular,persistent,poricidal,porrect,portion,prickl,prickle,ray,reflexed,rounded,ruit,scandent,scar,sessile,shorter,side,spaced,spreading,stalk,stalked,stellate,straight,tamen,tapering,terete,time,tip,toward,trichome,tube,unit,usually,variously,vary,way,weakly,wide,ympodial	0-8,1/4,abaxial,adaxial,arrangement,branching,characteristic,colour,corolla,form,growth,height,inflorescence,na,ovary,plant,pseudostipule,rachi,seed,shape,staman,texture
449	wfo-0001031218	success	154	115	94	60	21	0.61	-5,0.5-1,1-2,1-3,1-4,10-19,15-25,2-2.5,2-22,2-3,3,3-14,3-5,4-5,4-7,4-8,40,40-100+,5-7,6-7,6-9,abaxially,acuminate,adaxially,apart,apex,apiculate,articulated,basal,base,branched,calyx,cm,connective,connivent,cordate,cylindrical,dark,densely,diameter,eglandular-pilose,ellipsoidal,entire,equal,exceeding,flattened,flower,fruit,glabrous,glandular-puberulent,globose,greenish-purple,lanceolate,lavender,leaving,lobe,long,margin,minutely,mm,mottled,oblique,obtuse,orange,ovate,ovate-elliptic,ovoid,pedicel,pedicellar,peduncle,perfect,petiole,puberulent,pubescent,purple,rachi,radiu,remnant,ripe,shorter,simple,slightly,sometimes,spaced,sparsely,stigma,style,succulent,thecae,tip,tree,violet,x,yellow	0.5,2.5-3,4-28,4-foliat,5-37,5.5-7,6-10,8-17,8-20,acute,aggregate,ape,axe,beyond,blade,cell,coriaceous,directed,distally,eaf,eed,eglandular,especially,exserted,glabrou,glandular,hair,introrse,less,lon,lower,moderately,narrowly,nflorescence,nther,orolla,papillo,pore,presen,present,purpl,ruit,small,stamen,stellate,stone,subcoriaceous,tal,tem,time,tomento,toward,triangular,truncat,tube,ud,unit,vary,wide,ympodial	anther,arrangement,bud,characteristic,colour,corolla,form,growth,height,inflorescence,leaf,length,ovary,papillose,plant,seed,shape,stem,surface,texture,truncate
450	wfo-0001031225	success	163	76	62	101	14	0.38	.5,0.7-6,0.75-1,0.8-1,1-1.5,1-5,2,2.5-3,5-6,7-9,acute,along,anther,apex,base,berry,calyx,characteristic,cm,corolla,decurrent,deltoid,elliptic,filament,furcate,glabrate,glabrous,globose,green,growth,inflorescence,leaf,lobe,margin,minutely,mm,often,ovary,ovate,ovoid-reniform,pale,pedicel,petiole,pitted,plant,pubescent,shape,shrub,slender,slightly,small,stem,straight,style,surface,tan,tapering,tree,tube,vein,white,x	.25,/3,0.1-0.75,0.2,0.2-0.75,0.5,0.5-1,1-1.7,1-3,1.5-5,3-9,3/4,5-50-flowered,6-8,9-16,anthesi,apart,bark,beginning,broadly,bud,closely,conspicuous,cup-shaped,darker,dia,differentiated,differing,difoliate,dry,eaf,edicel,eed,ellipsoid,erect,exserted,flattene,fragrant,free,fruiting,geminat,greyish-brow,inflorescenc,lateral,less,like,live,lobed,lon,long,lower,main,major,middle,minor,minute,much,narrowly,nflorescence,older,one,opposite,outline,pair,papillo,papillose,pore,poricidal,portion,prominent,proximal,raised,red-papillose,reflexed,rest,rhomboidal,rounded,ruit,scar,shaped,size,soon,spaced,specimen,stigma,strongly,sweetly,swelling,tall,tear-drop,tip,trichome,ud,unevenly,uniseriate,unit,way,widest,woody,ympodial,young	abaxial,colour,diameter,form,fruit,greyish-brown,height,length,na,peduncle,rachi,seed,staman,texture
451	wfo-0001031231	success	175	83	64	111	19	0.366	-2,.5,0.5-1.5,1-1.5,1.5-2,2-3,2.5-3,25-35,3-4,37/2,37/3,5-7,8-10,anther,axillary,berry,branch,branched,brown,calyx,campanula,cm,colour,corolla,dark,discoidal,except,filament,fork,glabrous,green,greyish,hair,juvenile,leaf,len,less,long,marbled,mature,minute,mm,occasionally,ovary,pedicel,peduncle,petal,pinnatisect,plant,purple,rh,ripening,rugose-ruminate,seed,shrub,simple,soft,sometimes,style,surface,tinged,tip,violet,wooded	1-2,1-3,1-4,13,2-4,4-8,80-110,absent,acumen,acuminate,acute,adherent,almost,along,anthesi,apex,aromatic,aspect,axi,basal,base,becoming,beyond,blunt,bluntly,campanulate,cell,clonal,cluster,declinate,developed,dia,eaf,eed,ellipsoid,elliptic,entire,equal,erect,exceeding,exerted,expanded,facetted,fleshy,flower,flowering,folded,general,glandular,globose,gree,habit,herbarium,interacuminal,lanceolate,lasting,lengthening,lobe,lon,loosely,lower,margin,mauve,midrib,nflorescence,oblong,often,pedice,pedicellate,pentagonal,plurifoliat,pore,poricidal,projecting,rarely,readily,recurve,ripe,rotate,rounded,ruit,sessile,several,shallow,shed,short,sinus,slightly,slit,small,specimen,stigma,stone,stonrgly,stout,succulent,tissue,toward,translucent,triangular,tub,ud,unit,usually,variable,vigorous,well,without,x,year,ympodial	abaxial,adaxial,arrangement,characteristic,diameter,form,fruit,growth,height,history,inflorescence,length,life,perennial,plurifoliate,shape,stem,texture,type
452	wfo-0001031252	success	170	95	71	99	24	0.418	0.2-1.5,0.3-1.1,1-2,1.75-5.2,16-33,2-3,2.8-3.6,3-10,3-6,5-8,5.5-6.5,7-18,acute,anther,apex,attenuate,base,berry,brownish,cell,ciliate,cm,condition,coriaceous,corolla,covering,cuneate,dark,deep,diameter,drying,elliptic,entire,filament,fresh,fruit,glabrous,globose,green,greenish,hair-like,herb,lanceolate,lateral,light,lobe,long,margin,medium,mm,mottled,ovate,ovoid,pedicel,peduncle,petiole,plant,purple,rounded,seed,serrate,simple,sometimes,stripe,style,testal,thick,unwinged,wall,white,whitish	0.4-3,1-3,1.3-1.9,12-20,2.5-7,3-5,5-17,5-9,5-merou,abaxially,absent,acumen,adaxiall,adaxially,ag,along,alyx,apart,apparently,arranged,articulated,axe,axillary,bead,blade,bud,capitat,clavate,connivent,digestion,distal,dorsally,eaf,edge,eed,enzyme,erec,exceeding,flat,flower,folded,forked,geminat,generally,glabrou,green-white,hal,half,high,homostylous,honeycomb-shaped,interjected,leaflet,lengthening,like,linear,living,lower,make,moniliform,mucilaginous,multiple,necklace,nflorescence,orolla,perfect,plurifoliate,pore,poricidal,removed,ripe,rotate,ruit,seudostipule,slit,spaced,specimen,stamen,stigma,stolon,straight,subtending,tall,tamen,tem,terminal,throughout,tip,tri-,tube,tuber,typically,unit,usually,vary,wet,x,yellow,ympodial	2,abaxial,adaxial,arrangement,branching,calyx,characteristic,colour,form,growth,height,inflorescence,leaf,length,na,ovary,pseudostipule,rachi,shape,staman,stem,surface,texture,unarmed
453	wfo-0001031257	success	206	103	76	130	27	0.369	-12,-5,-6,0.7-1,0.75-2.5,1-1.2,1-1.3,1.1-1.2,1.5-1.7,11.5-15,2-4.5,3.5-,3.5-5.7,4-4.5,5-8.5,7.5-9,acuminate,anther,anthesi,apex,ascending,attenuate,basal,base,berry,blue-violet,bud,calyx,cm,coarsely,corolla,cuneate,dark,dentate,diameter,filament,glabrous,globose,half,herb,honey-combed,leaf,length,light,little,lobe,long,longer,margin,midvein,mm,narrowly,non-glandular,ovate,petiole,pubescent,purple,ring,robust,seed,serrate,shrub,simple,stem,striate,style,subglobose,trans-ovoidal,triangular,trichome,tube,vein,white,within,x,yellow	-22.5,0,0.4,0.5,0.5-0.8,1.5,1.5-2,1/10,10-16,2-,3,4-10,4.5-,5,5-,6-12,6-celled,7-,8,8-celled,abaxially,abundant,accrescen,adaxially,ag,aggregate,antrorse,bicellular,branch,broad,campanulate,cell,coat,connectival,cotyledon,curved,cuticle,deep,densely,diamete,difoliate,directed,dorsally,eaf,edentate,eed,ellipsoidal,elliptical,embryo,endosperm,epidermal,erect,finely,flexuous,foliage,free,fruiting,geminat,glandular,hair-like,head,herbaceous,high,hollow,inconspicuous,inserted,lamina,lateral,like,lon,long-stalked,longitudinal,longitudinally,lower,many-seeded,odorles,opening,orolla,outward,pair,papillate,patent,pericarp,pore,poricidal,portion,prolongation,rarely,reduced,ree,rest,ridged,ruit,saddle-shape,scarce,scarcely,secondary,separated,short-stalked,shorter,single-celled,sinus,slightly,slit,small,smooth,solitary,somewhat,spur-like,stalk,stigma,stone,strand,tem,thecae,thickened,thickening,time,tip,tooth,unequal,unit,upward,vary,ventrifixed,verrucate,viscid,viscid-pubescen,wall,ympodial	abaxial,adaxial,arrangement,branching,characteristic,colour,form,fruit,growth,height,inflorescence,na,ovary,pedicel,peduncle,plant,primary,pseudostipule,rachi,shape,staman,surface,tertiary,texture,unarmed,venation,viscid-pubescent
454	wfo-0001031270	success	234	109	88	146	21	0.376	+,0.4-1.5,0.5-1,1-1.2,1-4,10-12,2-3,2-4,2.5-3,5-15,5-6,6-17,6-50,9-10,abaxial,acute,adaxial,anther,apex,base,berry,bipinnatifid,bright,brown,calyx,cm,conical,deeply,densely,depressed-spherical,diameter,elliptic,filament,flower,glabrous,glandular-pubescent,growth,heavily,herb,inflorescence,lateral,leaf,leaf-opposed,length,lobe,lobed,long-styled,margin,membranous,midvein,minutely,mm,narrowly,obovate,ovoid,pair,pale,pedicel,peduncle,petiole,pinnatifid,pitted,plant,prickly,primary,pubescent,rachi,red,reddish,reniform,rounded,shallowly,short-styled,shrub,simple,small,sparsely,spherical,stem,straw-colored,style,surface,tan,terete,truncate,vein,white,yellowish	.5,1,1-3,1.2-1.6,1.5,1.5-2,1/3,10,100,2-2.5,2-20,2-7,3-10,3-20,3-5,4-5,5,5-10,5-merous,7-12,8,>,abaxially,accrescent,adaxiall,along,alyx,anthesi,apart,arme,articulated,associated,bark,basal,beginning,blade,brow,c.,capitate,cell,celled,clavate,colored,connivent,consistently,curved,differentiated,difoliate,directed,distal,eed,ellipti,entire,equal,erect,few-rayed,free,frui,fruiting,geminat,gland,glandular,green,heterostylous,infructescence,investing,later,leafy,like,live,lon,long,longer,loosely,lower,midpoint,minute,mixture,multangulate,multiseriate,new,nflorescence,occasionally,often,older,orolla,oung,outline,papillo,per,pericarp,pore,poricidal,portion,prickle,ray,reflexed,rest,ripe,ruit,scar,scattered,secondary,sessile,shallow,shining,short-stalked,single,sinuate,size,slender,slightly,spreading,stalk,staminat,stellate,stigma,straight,strongly,tall,tamen,tapering,testal,thin,thus,tightly,tip,tissue,trichome,tube,uniseriate,unit,upward,usually,vary,varying,way,well,wice,wid,wide,wing,woody,yellow,ympodial,Â½	armed,arrangement,branching,characteristic,colour,corolla,form,fruit,height,history,life,na,ovary,pseudostipule,seed,shape,staman,tertiary,texture,unarmed,venation
455	wfo-0001031283	success	52	69	27	25	42	0.519	-0.25,0.1-0.15,0.4-0.5,0.5-0.7,0.7,2.2-2.8,30-40,apex,base,brown,calyx,cell,cm,diameter,fruit,hair-like,lateral,lobe,mm,obovate,outgrowth,pale,pubescent,shrub,surface,testa,wall	.7-2.3,acute,appearance,eed,elongating,erect,fide,give,lo,long,markedly,moore,narrowly,pleasant,silky,small,smelling,somewhat,sprawling,spreadin,tall,thick,wide,winged,woody	1.7-2.3,abaxial,adaxial,anther,arrangement,branching,characteristic,colour,corolla,filament,form,growth,height,history,inflorescence,leaf,length,life,margin,midvein,na,ovary,pedicel,peduncle,petiole,plant,primary,pseudostipule,rachi,seed,shape,spreading,staman,stem,style,tertiary,texture,thicknes,unarmed,vein,venation,width
456	wfo-0001031287	success	147	94	73	74	21	0.497	.5,0.5-1.5,0.9-1,1,1-1.2,1-5,1.5-2,2-2.5,3-4,4-5,4.5-5,6-10-flowered,6-7,abaxially,acute,adaxially,anther,apex,attenuate,bark,base,berry,bi-lobed,calyx,cm,corolla,dark,deltate,dendritic,densely,dia,divergently,elliptic,erect,fleshy,glabrous,globose,green,greenish-white,knob,leaf,lobe,long,margin,minutely,mm,onto,ovary,ovoid-reniform,pale,papillose,pedicel,petiole,pitted,pubescent,red-papillose,rounded,shrub,simple,small,stem,stigma,strongly,style,surface,tan,thick,trichome,tube,tuft,white,winged,x	1-1.3,1-1.5,1.5-5.5,3-5,4-6,5-14,anthesi,apar,ape,axil,bearing,branch,conical,connective,coriaceous,deflexed,difoliate,eaf,edicel,eed,ellipsoid,elongate,enlarged,exserted,filament,free,frui,fruiting,geminate,internodal,lamina,later,lateral,lobed,lon,lower,main,many,membranous,middle,nearly,nflorescence,occasionally,older,pair,papillo,planar,plurifoliate,pointed,pore,poricidal,portion,reddish-brow,reflexed,ruit,scar,shaped,shoot,short,sinus,somewhat,spaced,tear-drop,thin,tip,tub,ud,unevenly,unit,vein,widest,woody,ympodial,young	abaxial,arrangement,branching,characteristic,colour,diameter,form,fruit,greyish,growth,hair,height,inflorescence,length,peduncle,plant,reddish-brown,seed,shape,texture,type
457	wfo-0001031300	success	219	120	97	122	23	0.443	0-20,0.2-0.4,0.2-0.5,0.3,0.5-0.9,0.5-18,0.5-2,0.7-0.9,0.8-1.5,1-2,2-4,2.2-2.7,2.5-3.2,3-4,5-15,acute,anther,apex,apically,articulated,attenuate,base,berry,branched,brown-green,calyx,cell,chartaceous,cm,curved,deltate,densely,diameter,difoliate,dull,erect,eye,filament,filiform,fruit,glabrous,gray-green,lateral,leaf,length,lobe,lobed,margin,maturity,membranous,midvein,mm,moderately,naked,near,oblanceolate,orange,orange-brown,outline,pair,pale,pedicel,peduncle,per,petiole,pit,prickle,prickly,primary,pubescent,raised,rarely,red,rounded,shrub,simple,small,smooth,sparsely,spherical,stellate,stellate-pubescent,stem,style,surface,tertiary,trichome,unit,vein,venation,visible,weakly,white,winged,yellow,yellow-green,yellow-orange	-2.2,-4,-5,-6,.5,/4,0-15,0-3,0-8,0.1,0.1-0.5,0.1-0.6,0.15-0.7,0.2-0.7,0.2-1,0.3-0.6,0.3-1.3,0.5-1.5,0.6-0.8,0.6-1,0.6-1.2,0.7-1.2,1-4,1-5,1.2-1.7,1.3-2,1.5-3.5,1/2-3/4,1/3-1/2,1/6-1/4,10-30,2-,2-3,2-5.5,2-6,2.2-2.3,3-,4,4.5-6,5-merous,6-8,abaxially,absent,also,alyx,apar,apart,apparently,ba,bark,blade,brow,bulbous,caudat,concolorous,connivent,creeping,distance,drying,eaf,eed,elongating,equal,extending,flattened,flattened-reniform,flower,free,fruiting,geminat,geniculate,glabrescent,hair,herbaceous,highly,infructescence,lon,long,longer,lower,mature,midpoint,minute,nflorescence,oblong,obtuse,older,one,open,orange-green,orolla,oung,pendulous,perfec,pericarp,poricidal,porrect,portion,prickl,ray,reduced,ruit,scar,sessile,side,spaced,spreading,stalk,stalked,tamen,tapering,terete,thin,time,tip,tube,uniradiate,vary,way,wide,wider,ympodial	abaxial,adaxial,arrangement,branching,caudate,characteristic,colour,corolla,form,growth,height,inflorescence,na,ovary,plant,pseudostipule,rachi,seed,shape,staman,sympodial,texture,unarmed
458	wfo-0001031310	success	203	133	107	96	26	0.527	.5,0-3,1-10,1-3,1-6,1.5-4,15-40,2-3,4-10,4.5-4.8,5-6,5-7,6-7,abaxially,acuminate,adaxially,anther,apart,apex,articulated,axillary,base,berry,blue,blue-purple,brown,brownish,bud,cell,chartaceous,cm,condition,conspicuously,corolla,covering,decurrent,diameter,distal,drying,filament,flower,forked,fresh,fruit,generally,glabrous,globose,green,green-white,greenish,hair,hair-like,half,high,lateral,leaf,less,light,like,lobe,long,make,margin,membranous,mm,mottled,mucilaginous,multicellular,obtuse,odd-pinnate,ovate,ovate-elliptic,ovate-lanceolate,ovoid,pale,pedicel,peduncle,petiole,pilose,plant,pubescent,purple,rachi,rosette-forming,seed,shortly,simple,slightly,sometimes,somewhat,spaced,sparsely,stem,streak,style,subrosette-forming,subtending,terminal,testal,thick,throughout,unwinged,usually,wall,wet,white,whitish	0-4,0.5-3,1-2,1-5.5,2.5-5.5,2.5-8.5,3-10,4-12,5-merou,5.5-21,absent,acumen,ag,along,alyx,apparently,attenuate,axe,blade,borne,broadly,caly,ciliate,connivent,cuneate,decreasing,digestion,dorsally,eaf,edge,eed,elliptic,end,enzyme,erect-decumben,especially,exceeding,extremely,flat,folded,geminat,glabrou,gradually,herb,homostylous,honeycomb-shaped,interjected,lanceolate,larger,leaflet,lengthening,living,lower,midrib,minutely,narrowly,nflorescence,orolla,pair,perfect,petiolule,plurifoliate,pointed,pore,poricidal,puberulent,removed,rotate,ruit,seudostipule,singly,size,slit,small,specimen,stamen,ste,stigma,stolo,straight,subellipsoi,tall,tamen,tem,tip,tissue,toward,tri-,tube,tuber,typically,unit,vary,x,yellow,ympodial	abaxial,adaxial,arrangement,branching,calyx,characteristic,colour,erect-decumbent,form,growth,height,inflorescence,length,midvein,na,ovary,primary,pseudostipule,shape,staman,surface,tertiary,texture,unarmed,vein,venation
459	wfo-0001031316	success	207	138	116	91	22	0.56	-2,/3,0.3-1,0.5-2,0.8-1.8,0.9-1.3,1-5,1.5-2,1.5-3.5,2-20,2-3,3-8,3.5-3.8,3.8-5,4-7,5-10,5-6,5-8,6-20,abaxial,acuminate,acute,adaxial,anther,apex,apically,apparently,articulated,base,berry,blue-mauve,branched,bright,calyx,cm,colored,concolorous,contrast,cream,curved,dark,densely,diameter,difoliate,discolorous,drying,dull,entire,erect,eye,filament,flattened-reniform,flower,fruit,glabrescent,glabrous,green,hair,lateral,leaf,length,lobe,lobed,long,margin,marking,maturity,membranous,mm,moderately,naked,narrow-deltate,obtuse,one,open,orange,orange-brown,ovate,pair,pale,pedicel,peduncle,per,petiole,primary,purple,red-brown,shrub,simple,slender,smooth,sometimes,spherical,stellate,stellate-pubescent,stem,strongly,style,surface,terete,terminal,tertiary,time,unarmed,unit,usually,vein,venation,visible,way,white-green,whitish,wide,yellow,yellow-green,young	.1,0.05-0.1,0.05-0.15,0.1-0.2,0.4-0.6,0.4-0.8,0.6-1,0.8-1.2,1.2-2.1,1.3-3.5,1.5-,1.5-5,1/3-1/2,1/3-2/3,2-4,2.5-8,3-10,4,4-9,5-15,5-merous,8-11,8-12,8-25,abaxially,almost,alyx,ame,apar,bark,becoming,blade,broad,c.,connivent,eaf,eed,elongating,fifth,foliaceou,four,free,fruiting,geminat,glabrou,gray,held,herbaceous,infructescence,inward,long-acuminat,longer,lower,lowermost,mature,midpoint,minute,multangulate,nflorescence,older,orolla,oung,pendulous,perfec,pericarp,poricidal,porrect,portion,ray,red-brow,reflexed,ruit,scar,sessile,spaced,sparsely,spreading,stalk,stalked,stellate-pubescen,tamen,tapering,tip,trichome,tube,unarme,unequal,variously,vary,white,ympodial	arrangement,branching,characteristic,colour,corolla,form,geminate,growth,height,inflorescence,long-acuminate,midvein,na,ovary,plant,seed,shape,staman,sympodial,texture,type,ye
460	wfo-0001031333	success	194	79	64	130	15	0.33	.5,0.5,1-1.5,1-4,1.2-2,1.5-2,2,2.5-3,3-4,7-9,<,?,acuminate,acute,anther,apex,base,berry,branched,broadly,brown,calyx,cm,densely,diameter,elliptic,entire,filament,flattened,glabrous,globose,golden,green,greenish,growth,immature,inflorescence,lobe,many,margin,mere,mm,narrowly,ovate,pale,pedicel,peduncle,petiole,pubescent,reniform,sparsely,stem,style,surface,terminal,time,truncate,twining,undulation,unevenly,vine,white,woody,x	+,0.1-0.5,1-5,1.5,1.5-1.7,1/2,2-3,2.7-7,3/4,30-40,5-7,5-8,5-merou,50,7-10,>,abaxially,adaxiall,adaxially,adjacent,ag,almost,alyx,anthesi,apart,appearing,ark,articulated,bilobed,branche,capitate,cell,clustered,collection,composed,conical,crea,cupped,denser,eaf,eed,ellipsoidal,exserted,flower,free,fruting,glabrescen,glabrescent,half,high,ilament,lamina,leaving,lengthening,less,like,lobed,long,lower,m.,matte,membranous,minute,minutely,near,new,nflorescence,nodding,occasionally,older,orolla,outline,pair,papillat,peg,penden,pentagonal,per,perfect,pericarp,pitted,planar,plurifoliat,pore,poricidal,portion,primary,pubescent-papillate,quadrate,rest,rhachi,ruit,scar,simple,sinus,slightly,slit,small,somewhat,soon,splitting,ste,stellate,stigma,striped,strongly,tangled,tem,testal,thickened,thin,tip,trailing,triangular,trichome,tube,ud,undersurface,unequal,uniseriate,unit,upper,vary,vein,venation,way,whitish,yellow,yellowish,ympodial	abaxial,characteristic,colour,corolla,form,fruit,leaf,length,ovary,seed,shape,staman,texture,type,unknown
461	wfo-0001031333	success	194	75	62	132	13	0.32	.5,0.5,1-1.5,1-4,1.5-2,2.5-3,3-4,5-7,7-9,<,?,acuminate,acute,anther,apex,base,berry,branched,broadly,brown,calyx,cm,corolla,densely,diameter,elliptic,entire,filament,glabrous,globose,golden,green,greenish,growth,immature,inflorescence,lobe,many,margin,minutely,mm,narrowly,ovate,pair,pale,pedicel,peduncle,petiole,pitted,primary,pubescent,sparsely,stem,style,surface,terminal,time,truncate,vein,vine,white,woody	+,0.1-0.5,1-5,1-5-2,1.5,1.5-1.7,1/2,2,2-3,2.7-7,3,3/4,30-40,5-8,5-merou,50,7-10,>,abaxially,adaxiall,adaxially,adjacent,ag,almost,alyx,anthesi,apart,appearing,articulated,bark,bilobed,branche,capitate,cell,clustered,composed,conical,cream,cupped,denser,eaf,eed,ellipsoid,exserted,flattened,flower,free,fruiting,glabrescen,glabrescent,half,high,ilament,lamina,leaving,lengthening,less,like,lobed,long,lower,m.,matte,membranous,mere,minute,near,new,nflorescence,nodding,occasionally,older,orolla,outline,papillat,peg,penden,per,perfect,pericarp,planar,plurifoliat,pore,poricidal,portion,pubescent-papillate,quadrate,reniform,rest,rhachi,rotate-stellate,ruit,scar,simple,sinus,slightly,slit,small,somewhat,soon,spaced,splitting,stellate,stigma,striped,strongly,tangled,testal,thickened,thin,tip,trailing,triangular,trichome,tub,tube,twinin,ud,undersurface,undulation,unequal,unevenly,uniseriate,unit,upper,vary,venation,way,whitish,wide,yellowish,ympodial	abaxial,characteristic,colour,form,fruit,leaf,length,ovary,seed,shape,texture,type,unknown
462	wfo-0001031359	success	166	111	95	71	16	0.572	.02,.25,/4,0.5-1,0.5-6,0.75-1,1-4,1.1-1.6,1.2-2.5,1.3-1.6,1.5-2,1.6-2.8,1.9-2.3,12-21,2.5-3,3-3.5,3.6-8.8,5-30-flowered,5-angled,5.3-7.5,6-7,anther,apart,bark,base,beginning,berry,bi-lobed,brown,calyx,cm,corolla,dark,dull,elliptic,evenly,filament,flattened-reniform,fruiting,glabrous,globose,green,incrassate,lamina,leaf,live,lobed,long,major,margin,minor,minutely,mm,narrowly,near,nearly,obovoid,originating,outline,ovary,paler,papillae,papillose,pedicel,petiole,pit,pitted,plant,pore,poricidal,ripe,round,rusty,scar,shaped,shiny,shrub,simple,size,spaced,stem,stigma,style,surface,tear-drop,tip,trichome,tube,tuft,uniseriate,vein,way,white,x,yellow-orange	.5,1.2-1.6,5-7,acuminate,angle,anthesi,apex,apiculate,appearing,attenuate,axil,ba,beneath,broadly,curled,deflexed,dia,differing,difoliate,distal,dried,eaf,edicel,eed,extending,free,geminat,inflorescenc,internodal,interpetalar,lateral,lobe,lon,lower,main,membraneous,middle,nflorescence,occasionally,often,older,one,opposite,pair,papillo,planar,portion,reflexed,ridged,ruit,sinus,slender,slightly,somewhat,specimen,straight,strongly,tall,tan,tapering,triangular,tub,ud,undulate,unit,white-lenticellat,widest,woody,yellow,ympodial,young	abaxial,bud,characteristic,colour,diameter,form,fruit,growth,height,inflorescence,length,origin,seed,shape,texture,white-lenticellate
463	wfo-0001031362	success	138	95	76	62	19	0.551	.2,.3,.5,0.5-1,0.7-1,1-1.1,1-1.5,1-3-flowered,1-4,1.5-2,2-2.5,3-6,?,anther,apex,bark,brown,calyx,cell,closely,cm,corolla,dendritic,densely,dia,ellipsoid,filament,flattened,flattened-reniform,fruiting,glabrous,globose,golden,incrassate,lanceolate,leaf,like,lobe,long,long-triangular,margin,minutely,mm,orange-red,outline,ovary,packed,pale,papillose,pedicel,petiole,pitted,pore,poricidal,pubescent,pubesent,rectangular,red,rounded,shaped,shrub,simple,small-capitate,sparsely,stem,stigma,style,subshrub,surface,tan,tear-drop,tip,trichome,tube,white,x	0.4-0.5,1-3,3-4,abaxially,acute,adaxially,along,anthesi,appearance,attenuate,base,berry,branch,bushy,conical,denser,eaf,edicel,eed,erect,exceeding,exserted,free,giving,golden-brow,inflorescenc,internodal,lamina,lateral,lobed,lon,lower,main,middle,nearly,nflorescence,nodding,older,opposite,overlappin,pair,papillo,pericarp,planar,plurifoliat,portion,rest,ruit,scar,shiny,slender,somewhat,spaced,straight,thin,ud,unit,vein,widest,woody,ympodial,young	abaxial,adaxial,arrangement,branching,bud,characteristic,colour,diameter,form,fruit,golden-brown,growth,inflorescence,length,plurifoliate,pubescence,seed,shape,texture
464	wfo-0001031400	success	161	104	83	78	21	0.516	0.25-0.8,0.7-6,1,1-4,1.2-2,1.5-5,10-11,2,2-5,4-6.5,4-7,7-28,abaxial,acumen,acute,apex,apiculate,articulate,base,branched,calyx,cell,cm,corolla,covering,cyme,dark,decurrent,deeply,diameter,dichasial,dichasially,distal,ebracteate,exceeding,filament,generally,globose,green,green-white,hair-like,half,herbaceous,lateral,leaf,linear,linear-lanceolate,lobe,long,make,mm,monochasial,mucilaginous,oblique,oblong,odd-pinnate,ovoid,pedicel,peduncle,perennial,petiole,plant,proximal,puberulent,rachi,seed,sessile,side,stamen,stigma,straight,stripe,style,subglabrous,testal,thick,throughout,tip,tone,violet,wall,white,Â¼	-3,0.4-1.7,0.6-1.8,0.8-1.1,1-,2-3,2-9,3-6-foliat,4-,4-13,4-17,5-12.5,6-23,7-25,abaxially,abruptly,absen,adaxially,apical,apically,connate,cuneate,dehiscent,digestion,diminishing,dorsally,eaf,edge,eed,emoval,enzyme,flat,flower,folded,forked,forming,globo,honeycomb,interjected,introrse,leaflet,living,lon,lower,lunat,maturing,nflorescence,nther,occasionally,often,orolla,pair,pattern,perfect,plan,poricidally,reveal,ruit,seudostipule,short,size,slit,specimen,stellate,structure,tal,tem,terminal,toward,trilobe,tuber-bearing,typically,unit,vary,wide,without,yellow,ympodial	anther,arrangement,characteristic,colour,form,fruit,growth,height,history,inflorescence,length,life,margin,na,ovary,shape,staman,stem,surface,texture,wet
465	wfo-0001031401	success	182	136	117	65	19	0.643	0.5,0.6-1.2,0.8-1.2,1,1-1.4,1-1.5,1-6,1.1-3,1/2,2-2.4,2-5,2.5-4,3,3.5-4,3/4,5-7,5-9,7-9,abaxial,abaxially,adaxial,anther,apical,appearing,attenuate,bark,basal,base,berry,bi-lobed,black,branch,branching,brown,calyx,cm,corolla,dark,deflexed,dendritic,densely,diameter,drying,ecuadorian,elliptic,exserted,finely,flattened,fork,fruit,fruiting,glabrous,globose,golden,golden-yellow,growth,lateral,leaf,lenticular,long,matted,minutely,mm,narrowly,near,new,nodding,occasionally,often,outline,ovary,overtopping,pair,pedicel,petiole,pitted,poricidal,prominently,puberulent,pubescent,purplish-black,pyramidal,raised,reddish-brown,roundish,scar,secondary,shiny,shoot,short,shrub,small,sometimes,somewhat,sparsely,specimen,stem,stigma,strongly,style,surface,tapering,terminal,time,tip,tree,tree-like,trichome,tube,vein,violet,way,white,wide,winged,x,yellow	1.5-2,5,8-10,acute,adaxially,age,along,anthesi,apex,axi,becoming,blade,clearly,conical,deciduous,deltoid,denser,dichasial,differentiated,eaf,ecuador,edicel,eed,ew,filament,flower,free,impressed,inserted,less,lobe,lobed,long-triangular,lower,m.,mesophyll,monochasia,nflorescence,noddin,node,older,papillo,per,pericarp,planar,plurifoliate,pore,portion,pubescen,rounded,ruit,sleev,slit-like,stamen,ste,tall,thin,tub,ud,unit,usually,visible,woody,ympodial,young	arrangement,bud,characteristic,colour,exsertion,form,height,inflorescence,length,lobing,papillose,plant,pubescence,seed,shape,size,staman,texture,type
466	wfo-0001031480	success	237	128	112	125	16	0.473	0-1,0-2,0-30,0.5-2,0.8-1,1-1.3,1-1.5,1-2,1-3,1.8-3,1/3,2-2.7,2-3,4-5,4-6,6-8,abaxial,acute,adaxial,anther,apex,apically,apparently,articulated,base,berry,branched,branching,bright,calyx,cell,cm,cream,cuneate,dark,deltate,densely,diameter,dull,ellipsoid,entire,erect,eye,faint,filament,fruit,glabrescent,glabrous,glandular,green,hair,lateral,leaf,length,lobe,lobed,margin,marking,maturity,mauve,midvein,minutely,mm,moderately,naked,near,obtuse,orange-brown,outline,ovate,pair,pale,pedicel,peduncle,per,petiole,pit,plant,prickle,prickly,primary,pubescent,purple,raised,red,red-brown,red-green,red-yellow-green,reticulate,shallowly,shrub,simple,small,smooth,sparsely,spherical,stellate-pubescent,stem,style,surface,terminal,tertiary,thick-chartaceous,trichome,truncate,unarmed,upper,vein,venation,visible,yellow,young	-0.25,-2,/3,0,0-0.5,0-5,0.1,0.1-0.3,0.1-0.4,0.15-0.3,0.2-0.35,0.4,0.4-0.8,0.5-,0.6-0.8,0.7,0.8,1-4,1.5-2.2,1.7-2.2,1/2,1/4,1/6-1/5,2-,2-5,2-6,3,3-10,3-6,3-7,3.5-7,5-8,5-merous,6-13,6-30,7-8,8-12,abaxially,acuminat,alyx,andromonoecious,apar,apart,ba,bark,blade,broad-deltate,curved,difoliate,discolorous,distal,distance,drying,eaf,eed,elongate,elongating,equal,extending,flattened,flattened-reniform,flower,free,fruiting,geminat,hermaphrodite,heterostylous,inconspicuous,infructescence,long,long-styled,longer,lower,lowermost,mature,midpoint,nflorescence,often,older,one,open,orolla,oung,pendulous,pericarp,persistent,poricidal,porrect,portion,ray,red-brow,reduced,rounded,ruit,scandent,scar,sessile,short-styled,shorter,side,slender,slightly,somewhat,spaced,spreading,stalk,stalked,staminat,stellate,straight,tamen,tapering,terete,time,tip,tube,unarme,unit,variously,vary,way,weakly,wide,woody,ympodial	2-30,acuminate,arrangement,characteristic,colour,corolla,form,growth,height,inflorescence,na,ovary,seed,shape,staman,texture
467	wfo-0001031483	success	154	109	90	64	19	0.584	.5,/2,0.5,0.5-2,1,1-2,1.1-2.5,1.2-1.4,1.7-5.5,11-20.5,2-2.5,2.5-3.2,3-4,3-8-flowered,6-10,7-10,across,acuminate,acute,almost,anther,apex,attenuate,base,berry,ca,calyx,clavate,cm,corky,corolla,deltoid,dia,difoliate,dry,filament,filiform,fresh,fruiting,glabrous,green,internode,larger,leaf,lenticellate,less,linear,lobe,lobed,long,major,markedly,minor,minutely,mm,oblanceolate,oblong,obovate,orbiculate,ovary,ovoid-reniform,pair,pale,papillose,pedicel,pore,poricidal,shape,shaped,short-triangular,shrub,simple,slender,slightly,stem,stigma,straight,style,subshrub,tan,tapering,tear-drop,tip,tube,turbinate,unit,vein,way,white,x	0,1/3,2-3,anew,anthesi,apart,ba,bearing,beginning,beneath,blade,caly,continuous,cork,decurrent,deflexed,distal,eaf,edicel,eed,end,evenly,exserted,flower,free,fusiform,geminat,indistinc,indistinct,lateral,lea,lower,main,nflorescence,obovoid,often,opposite,paler,papillo,per,petiole,planar,pointed,portion,prominent,quite,raised,rounded,ruit,scar,short,somewhat,soon,spaced,strongly,tall,third,ud,variable,widest,wing,winged,woody,ympodial	arrangement,characteristic,colour,diameter,form,fruit,geminate,growth,height,inflorescence,length,lobing,plant,seed,surface,sympodial,texture,type,width
468	wfo-0001031492	success	175	99	74	101	25	0.423	0.5,0.7-1.3,0.9-1.1,1-1.3,1-1.5,1.3-2,1.5-1.8,2-10,2-3,20,3-4,3-5,4-10,4-4.5,6-8,8-11,abaxially,acuminate,acute,anther,apex,attenuate,base,berry,branching,calyx,cm,corolla,dark,decurrent,deltoid,densely,diameter,drying,elliptic,filament,flattened,fruit,glabrous,globose,grey,growth,leaf,lenticular,lightly,lobe,long,medium,minutely,mm,narrowly,ovary,pair,pedicel,petiole,pitted,predominantly,pubescent,purplish-black,pyramidal,reddish-brown,shiny,shrub,size,sparsely,stem,style,surface,terminal,tree,vein,violet,winged,x	.5,/4,08,1.5-2.5,10-15,2-5,8-9,absent,adaxially,age,anthesi,apical,appearing,axe,ba,bark,basal,becoming,beneath,bi-lobed,bitter,conical,dbh,deciduous,dendritic,denser,distinguishable,dull,eaf,echinoid,edicel,eed,erect,ew,exserted,flower,free,fruiting,golden,inserted,juice,lamina,lateral,lobed,lower,m.,monochasia,nflorescence,nodding,occasionally,older,overtopping,papillo,per,pericarp,planar,plurifoliate,pore,poricidal,portion,prominent,rather,remaining,ruit,scar,scarcely,scattered,secondary,shoot,short,sleeve,slightly,slit-like,sometimes,somewhat,stamen,ste,sticky,stigma,strongly,sunken,tall,tapering,thin,time,tip,tree-like,trichome,tub,tube,ud,undersurface,unit,upper,upturned,way,wide,woody,ympodial,young,younger	abaxial,adaxial,arrangement,characteristic,colour,form,height,inflorescence,length,margin,midvein,monochasial,na,peduncle,plant,primary,pseudostipule,rachi,seed,shape,staman,tertiary,texture,unarmed,venation
469	wfo-0001031503	success	142	111	78	64	33	0.549	-10,-15,-7,0.3-3,0.5-1,0.5-4,1-2.5,1-3,1-5,1.5-2,1.5-3,1.5-8,10-19,2-3,3-4,3-5,3-6,6-7,7-10,abruptly,acuminate,acute,angled,apex,articulated,base,branched,calyx,chartaceous,cm,cuneate,decurrent,deltate,densely,diameter,distally,eglandular,elliptic,entire,forked,glabrous,gland,globose,hair,lobe,margin,mm,moderately,narrowed,obtuse,occasionally,often,orange,ovate,pedicel,peduncle,petiole,puberulent,pubescent,rachi,rarely,reddish,ripe,rounded,rugose-pubescent,shrub,simple,slightly,sparsely,stalked,style,tip,truncate,unbranched,unequal,vein,white,x	-25,-30,-6,1-,1-7,1.5-7,1.7-3.5,2.5-10,3-15,5613,6-many-foliat,7-15,abaxially,absen,adaxially,aggregate,apart,axe,ba,blade,cell,connivent,curled,cylindrical,directed,distall,eaf,eed,except,fide,flower,lanceolate,long,lower,mostly,narrowly,nflorescence,nther,orolla,perfect,pore,present,radiu,ruit,spaced,stellate,stigma,stone,subcapitat,subclavate,tal,tem,time,toward,triangular,tube,uniseriate,unit,usually,vary,venturi,wide,yellow,ympodial	abaxial,adaxial,anther,arrangement,branching,characteristic,colour,corolla,filament,form,fruit,growth,height,history,inflorescence,leaf,length,life,midvein,na,ovary,plant,primary,pseudostipule,seed,shape,staman,stem,surface,tertiary,texture,unarmed,venation
470	wfo-0001031586	success	167	108	86	81	22	0.515	-2,0.1-1,0.5-1,1-1.2,1-1.5,1-2,1.4-2.5,1.5-2,2,5-6,7-10-flowered,abrupt,anther,anthesi,apart,bark,base,bright,bud,calyx,campanulate,capitate,cm,completely,corolla,cream-colored,deltate,drying,elliptic,exerted,filament,fleshy,flower,fresh,glabrous,globose,green,greenish,inflorescence,leaf,lobe,lobed,long,margin,material,may,minutely,mm,mucro,nearly,notched,occasionally,older,olive,ovary,pale,pedicel,petiole,planar,poricidal,prominent,remaining,ridged,rounded,scar,shiny,shrub,simple,slender,somewhat,soon,sparsely,stem,stigma,straight,style,swollen,tapering,thick,thickened,tip,tube,white,x,yellow,yellowish	.25,0.5-0.8,1,1.3-5,2-2.5,3-11,5-10,absent,acute,apex,apparently,appearing,attenuate,becoming,beneath,borne,branch,broadly,closer,conical,cucullate,deflexed,dia,differing,difoliate,distance,eaf,edicel,eed,ellipsoid,exfoliatin,free,geminate,gree,inflorescenc,know,known,later,lateral,leave,lower,main,major,minor,near,new,nflorescence,one,onto,open,opposite,overtopping,pair,paler,papillate,papillose,pore,portion,present,raised,ruit,shap,shaped,shin,size,small,sometimes,spaced,surface,tall,tear-drop,trichome,truncate,trunk,ud,uniseriate,unit,vein,widely,ympodial,young	colour,diameter,exertion,exfoliating,form,fruit,glabrousnes,growth,height,length,lobing,na,number,papillation,plant,ridging,seed,shape,spacing,texture,type,unknown
471	wfo-0001031587	success	142	71	42	100	29	0.296	0.8-1,1.5-2,1.7-2,2,2-2.5,3-4,5,6-7,7-9,acute,anther,apex,attenuate,base,calyx,clavate,cm,corolla,densely,elliptic-ovoid,filament,glabrous,inflorescence,irregular,leaf,lobe,mm,ovary,pair,parallel,pedicel,petiole,pubescent,shape,stem,style,surface,tree,vein,white,winged,x	.5,1-1.5,10-15,12-16,17-30,2-9-celled,2/3,6-8,abaxially,adaxially,along,anthesi,apart,axi,bark,bi-lobed,broadly,closely,cone,conical,decurrent,deflexed,deltate,dendritic,denser,dia,differing,drying,eaf,edicel,eed,elliptic,erect,evenly,exserted,fide,fleshy,free,furcate,globose,golden-red,included,know,known,lamina,later,lateral,like,lobed,long,loose,lower,lowered,main,major,middle,minor,minutely,mostly,oblique,ocasionally,occasional,older,overlappin,pale,papillate,papillo,perpendicular,persisten,pore,poricidal,portion,rarely,rect,reddish-grey,rest,ruit,scar,shaped,simple,size,soft,somewhat,spaced,steinbach,stigma,tall,tear-drop,thick,thickened,tip,trichome,tub,tube,ud,uniseriate,verrucose,way,widest,young	1,abaxial,adaxial,arrangement,branching,characteristic,colour,diameter,form,fruit,growth,height,history,length,life,margin,midvein,na,peduncle,plant,primary,pseudostipule,rachi,seed,staman,tertiary,texture,unarmed,venation
472	wfo-0001031589	success	222	140	117	105	23	0.527	0-10,0-3,0-30,0.1-0.5,0.2-0.5,0.4,0.5-1,0.55-0.7,0.9-1.3,1-1.8,1.2-1.5,1.7-2.5,1.8-2.9,1/3,2-3.5,2.8-4,3-5,3/4,4-6.5,8-30,acute,anther,apex,apically,apparently,articulated,attenuate,base,berry,bright,brown-green,calyx,cell,chartaceous,cm,concolorous,cream,dark,deltate,densely,diameter,difoliate,discolorous,drying,dull,elliptic,erect,eye,filament,flattened-reniform,flower,fruit,glabrescent,glabrous,gray-green,green,lateral,leaf,length,lobe,lobed,long,long-obovate,lower,margin,marking,maturity,mauve,membranous,midvein,mm,moderately,naked,narrow-cuneate,occasionally,often,orange-brown,outline,pair,pale,pedicel,per,petiole,pit,plant,prickle,prickly,primary,raised,rounded,shiny,shrub,simple,small,smooth,solitary,sparsely,spherical,stellate-pubescent,stem,style,subentire,surface,tertiary,unit,upper,vein,venation,visible,weakly,white,whole,wide,yellow,yellow-green,yellow-orange,young	-0.5,-15,-6,-6.5,.5,/6,0,0-1,0.1,0.15-0.3,0.2-0.4,0.2-3,0.6-1.2,0.7,0.8-2.3,0.9-1.6,1,1-5,1.5-5,1/3-1/2,1/3-1/4,10-30,2-,2-10,2.5-4.5,2.5-6,3-4,4/5,5-8,5-merous,6-8,8-14,abaxially,alyx,ame,apart,bark,blade,broadly,brow,c.,caudat,connivent,density,distance,eed,elongating,equal,extending,free,fruiting,geminat,higher,infructescence,lengt,lon,longer,mature,midpoint,multangulate,narrow,nflorescence,oblong,obovate,older,orange-green,orolla,oung,part,pendulous,perfec,pericarp,poricidal,porrect,portion,prickl,ray,reflexed,ruit,scandent,sessile,shorter,side,sometimes,somewhat,spaced,spreading,stalk,stalked,stellate,stout,straight,subsessile,tamen,tapering,terete,time,tip,trichome,tube,vary,way,winged,woody,ympodial	abaxial,adaxial,arrangement,branching,caudate,characteristic,colour,corolla,form,geminate,growth,height,inflorescence,mentioned,ovary,peduncle,seed,shape,staman,sympodial,texture,type,unarmed
473	wfo-0001031609	success	154	108	79	75	29	0.513	0.4-3,0.5-3,1-10,1-6,1.3-3,1.5-2,1.5-3,10-25,2-,2-3,2.5-4,3-5,3-9-lobed,4,4-5,4-6,5-25,abaxially,acute,adaxially,apex,around,articulated,base,branch,brownish,calyx,cm,conspicuous,contiguous,cuneate,deltate,dia,diameter,emerging,entire,flattened,fleshy,forked,fruit,glabrous,globose,green,inflorescence,leaf,leaving,lobe,lobed,margin,mm,nearly,obovate,obtuse,occasionally,orange,pedicel,pedicellar,peduncle,petiole,pinnately,point,puberulent,rachi,reticulate,ripe,scar,shallowly,shrub,simple,small,style,succulent,tree,triangular,two,unbranched,unlobed,x,yellow	.5,/4,0-30,0.5-1,2,20-25,3-24,3-foliat,4.5-60,5/6,8-20,absen,absent,aggregate,ape,apiculate,axe,barely,beyond,bilobe,blade,brow,campanulate,cell,connective,connivent,dark,dilated,directed,distally,divided,eaf,eed,ellipsoidal,elliptic,elliptic-ovate,equal,exceeding,exserted,flower,glabrou,laterally,long,lower,midrib,minutely,nflorescence,nther,obconical,orolla,papillose,pore,radiu,rounded,ruit,sinus,stamen,stellate,stigma,stone,strongly,succulen,tal,tem,thecae,time,tip,tomento,truncate,tube,ud,unit,vary,wide,ympodial	abaxial,adaxial,anther,arrangement,branching,characteristic,colour,corolla,filament,form,growth,height,length,midvein,na,ovary,plant,primary,pseudostipule,seed,shape,staman,stem,surface,tertiary,texture,unarmed,vein,venation
474	wfo-0001031615	success	154	98	81	73	17	0.526	.5,0.5-1,0.8-1,0.9-1.1,1-1.6,1.3-1.8,1.5,1.5-5,11-15.5,2-4.2,3.8-6.1,4-6.5,5-6,6-8,8-10,acuminate,acute,anther,apex,attenuate,bark,base,berry,bilobed,brown,calyx,capitate,cm,corolla,deep,deflexed,deltoid,elliptic,filament,flattened-reniform,fruit,fruiting,furcate,glabrous,glandular,globose,inflorescence,leaf,lobe,major,minor,minutely,mm,occasionally,older,ovary,pair,pedicel,petiole,pitted,shaped,shrub,simple,size,small,somewhat,stem,stigma,straight,style,subumbellate,surface,tapering,tear-drop,tip,tree,trichome,tube,uniseriate,urceolate,vein,white,winged,woody,x,young	0,0.5,2-3,5-20-flowered,anthesi,arising,axil,ba,becoming,caly,closely,dark,dark-papillo,decurrent,dia,differing,difoliate,distal,eaf,edicel,eed,expanded,exserted,free,geminat,green,impressed,incrassate,interpetalar,lamina,lateral,less,lobed,lon,long,lower,main,margin,maroo,middle,minute,nearly,nflorescence,one,opposite,overlappin,packed,paler,papillae,papillose,per,pore,poricidal,portion,prominent,reflexed,ruit,scar,scarcely,shiny,sinus,slender,slightly,tall,terminal,thickened,thin,tuft,ud,unicellular,unit,widest,ympodial	5-20,characteristic,colour,dark-papillose,diameter,flower,form,growth,height,hirsute,length,maroon,plant,seed,shape,texture,type
475	wfo-0001031618	success	184	90	72	112	18	0.391	-2,0-3,1-1.5,1.5-2,2-2.5,2-3,3-4,4-5,90-110,acute,anther,apex,axil,base,berry,branch,broadly,calyx,cm,corolla,cuneate,cyme,darker,discoidal,equal,filament,finely,glabrous,glandular,green,greyish,growing,hair,lavender-purple,leaf,less,lobe,lobed,long,marbled,maturity,mauve,minute,mm,obovoid,ovary,ovoid,pale,pedicel,peduncle,petiole,pinatisect,point,purple,reddish-brown,reticulate,rounded,rugose,scorpioid,shrub,simple,somewhat,stem,stripe,surface,tapering,terete,tinged,triangular,unequal,variable,young	0.5-1.5,1-7,1.5-3.5,10-18,10-lobed,13,3,3-8,40-60,5,5-12,acuman,almost,also,anthesi,appearance,appearing,aspect,becoming,beyond,blunt,bluntly,c.,capitate,cell,clonal,cluster,column,conical,covering,cut,developed,dia,eaf,eed,ellipsoid,elliptic,emarginate,enlarged,erect,except,exerted,extending,facetted,fleshy,floral,flower,fork,forked,frui,general,giving,greatly,gree,habit,half,interacuminal,lanceolate,lasting,lengthening,lon,loosely,lower,may,mid-vein,midrib,narrowly,nflorescence,oblong,occasional,occur,often,ovate-lanceolate,pal,pedicellate,petal,plurifoliat,pore,poricidal,rarely,rhachi,ripe,rotate,ruit,sessile,several,shallowly,side,single,sinus,slit,soft-wooded,sometimes,specimen,stigma,stone,stout,strongly,styl,succulent,tip,tissue,tub,ud,unit,vigorous,way,well,x,year,ympodial,younger	characteristic,colour,diameter,form,fruit,growth,height,inflorescence,length,margin,mentioned,plant,seed,shape,style,texture,type,width
476	wfo-0001031646	success	171	103	85	86	18	0.497	-7,-pinnate,.2,.5,0.2-0.8,0.5-2,0.8-1.5,1-1.8,1-10,1-6,1.2-2.5,15-25,2-10,2-3,2.5-10,3.5-4,4-5,5,5-6,5-7,7-8,8-15,acuminate,acute,anther,apart,apex,articulated,base,berry,blue,branched,brown,calyx,chartaceous,cm,cuneate,cylindrical,densely,diameter,ellipsoidal,elliptic-lanceolate,entire,filament,flattened,flower,fruit,glabrous,globose,green,highly,hyaline,immature,leaf,light,lobe,long,margin,mature,mm,oblique,obliquely,ovate-lanceolate,pedicel,peduncle,petiole,pubescent,rachi,red,rounded,rugulose,scandent,shortly,shrub,smooth,spaced,stem,stout,style,surface,tawny,tip,vine,violet,x	1.5-3.5,1.5-4,18-38,1962,2-2.5,20,4-18,4-20,4-8,4-foliate,5-7.5,5-merou,abaxially,absen,absent,accrescent,acut,adaxially,aggregate,alyx,apical,apparently,axe,ba,basally,blade,cell,ciliat,climbing,connivent,correll,covered,darker,decreasing,directed,distall,eaf,eed,elliptic,equal,fide,fruiting,geminat,glandular,hair,high,homostylous,interjected,lateral,leaflet,lower,maroon,multicellular,nflorescence,oblong,obtuse,orolla,ovate-lanceolat,part,perfect,petiolule,pore,present,pubescen,pubescence,rotate-pentagonal,ruit,seudostipule,simple,size,slightly,small,spreading,stigma,stone,tamen,tem,toward,tree,truncat,tube,uniseriate,unit,vary,yellow,ympodial	abaxial,adaxial,arrangement,characteristic,colour,corolla,form,growth,inflorescence,length,na,ovary,pseudostipule,seed,shape,staman,texture,type
477	wfo-0001031651	success	201	91	74	127	17	0.368	.7,0.3-0.8,0.3-1.5,0.6-1,0.7-1,1-1.7,1/5,2-3.5,4-5,4-6,abaxial,absent,acute,anther,apex,apically,apparently,articulated,base,berry,branched,brown,calyx,cell,cm,cordate,deltate,densely,diameter,dull,elliptic,entire,erect,filament,fruit,glabrous,gray,herb,lateral,leaf,length,lobe,lower,margin,maturity,mm,obtuse,orange-brown,outline,ovate,pedicel,peduncle,petiole,pit,prickly,purple,raised,red,rounded,shrub,small,smooth,sometimes,stellate-pubescent,stem,style,subentire,surface,terminal,unarmed,upper,weakly,white,yellow	-2,-3,-3.5,.1,.6,/3,/5,0-20,0.1,0.1-0.15,0.1-0.2,0.1-0.25,0.15-0.2,0.2-0.5,0.3-0.5,0.6-1.3,1,1-2,1-4,1.2-2,1.2-3,1.3-1.6,1.5-2,1/6-1/4,2-10,2-3,2/3-3/,3-5,4.5-7,5-merous,abaxially,acuminat,adaxial,alyx,ame,apar,apart,bark,blade,c.,chartaceous,concolorous,curved,dark,difoliate,discolorous,drying,eaf,eed,elongating,equal,eye,faint,filiform,flattened-reniform,flower,free,fruiting,geminat,glabrescent,gra,herbaceous,infructescence,lanceolate,lobed,long,longer,mature,midpoint,naked,nflorescence,oblong,older,one,open,orolla,oung,pair,pendulous,per,perfec,pericarp,persistent,poricidal,porrect,portion,prickl,prickle,primary,ray,red-green,reflexed,ruit,scandent,scar,shorter,simple,spaced,spherical,spreading,stalk,stalked,stellate,straight,subsessile,tamen,tapering,terete,tertiary,thick,thick-stalked,time,tip,toward,trichome,tube,unarme,unit,variously,vary,vein,venation,visible,way,wide,yellow-green,ympodial	2/3-3/4,acuminate,characteristic,colour,corolla,form,growth,height,inflorescence,na,ovary,plant,seed,shape,staman,texture,type
478	wfo-0001031656	success	154	68	48	106	20	0.312	0.5,0.5-1,1-1.5,1-2.5,1.2-1.5,1.5-2,1.5-5,3-3.5,5-ribbed,6-8,anther,berry,calyx,cm,corolla,ellipsoid,elliptic,filament,fleshy,fruit,glabrous,globose,green,greyish,leaf,lobe,long-acuminate,matte,mm,opposite,ovary,ovate,pedicel,petiole,plant,rather,reddish,sessile,shiny,shrub,stem,straight,strongly,style,surface,thick,transversely,white	.5,/4,1-2,10-20,2.5-3.5,3-5,4-9,5-7,acuminate,acute,also,anthesi,apex,arising,ba,bark,base,bright,capitate,closely,cork,densely,dia,differing,difoliate,directly,drying,eaf,edicel,eed,enclosing,erect,extremely,flower,free,fruiting,geminat,hooded,known,lateral,live,lobed,lon,long,lower,main,major,margin,mature,middle,minor,minute,minutely,nflorescence,node,oblique,often,older,one,pair,pale,paler,papillo,papillose,peelin,persistent,planar,pore,poricidal,portion,prominent,proximal,red-papillose,reflexed,rib,ridged,rounded,ruit,scar,shaped,size,slightly,somewhat,spaced,specimen,stigma,swollen,tall,tear-drop,terminal,thickened,tip,top,tube,ud,unit,upper,vein,visible,way,wide,widest,woody,x,ympodial,young	abaxial,adaxial,alternate,arrangement,characteristic,colour,diameter,form,growth,height,inflorescence,length,na,peduncle,peeling,rachi,seed,shape,staman,texture
479	wfo-0001031667	success	153	71	52	101	19	0.34	0.6-1,1-1.5,1.4-3,10-13,12-35,2.5-5,3-13,5-9,8-13,branched,calyx,cell,cm,corolla,covering,cyme,dark,diameter,dichasial,dichasially,ebracteate,elliptic-lanceolate,globose,green,hair-like,herbaceous,lanceolate,lateral,leaf,lobe,long,mm,monochasial,mucilaginous,oblong,odd-pinnate,ovoid,pedicel,peduncle,perennial,petiole,pilose,plant,seed,spot,stripe,style,testal,thick,tuber-bearing,wall,white	0.6-1.5,1-4,1.5-2,2-3,2-5,2-6,3-5,3-6-foliat,3-8,4-1.,5-15,6-10,8-15,abaxially,abruptly,acumen,acuminate,acute,adaxially,apex,apical,apically,apiculate,articulate,base,caudate,connate,cordate,cuneate,dehiscent,digestion,diminishing,distal,dorsally,eaf,edge,eed,emoval,enzyme,exceeding,filament,flat,flower,folded,forked,generally,globo,green-white,half,honeycomb,interjected,introrse,irregularly,leaflet,living,lobed,lon,lower,lunat,make,maturing,nflorescence,nther,oblique,often,orolla,pair,pattern,perfect,petiolate,petiolule,plan,poricidally,proximal,reveal,rounded,ruit,sessile,seudostipule,short,size,slit,specimen,stamen,stellate,stigma,straight,tal,tem,terminal,throughout,toward,typically,unit,vary,whit,wide,without,yellow,ympodial,Â¼	anther,arrangement,characteristic,colour,form,fruit,growth,height,history,inflorescence,length,life,ovary,shape,stem,surface,texture,wet,ye
480	wfo-0001031672	success	157	108	75	82	33	0.478	0,0-2,0.3-0.5,0.5-1.5,1,1-1.5,1-10,1-5,1.5-2,1.5-2.5,1.5-3.5,1.5-5,10-20,15-50,4,4.5-5,6,9-lobed,acuminate,acute,apex,apiculate,articulated,basal,base,calyx,chartaceous,cm,cordate,densely,diameter,entire,flattened,fleshy,flower,fruit,glabrous,glandular-puberulent,globose,green,greenish-brown,leaf,leaving,lobe,lobed,long,margin,mature,mm,near,obtuse,occasionally,ovate,ovoid,pedicel,pedicellar,peduncle,petiole,pilose,pinnately,puberulent,rachi,remant,rounded,simple,sparsely,style,subcoriaceous,tip,tree,truncate,unbranched,whitish,x,yellow	0.5,0.5-1,1-,1-2,15-20,2-12,2-28,3-4-foliat,3/4,4-34,4/5,5-6,abaxially,absent,adaxially,aggregate,apart,ape,aublet,axe,beyond,blade,cell,ciliat,connective,cylindrical,directed,distally,divided,eaf,eed,exceeding,exserted,fide,hair,lanceolate,lon,lower,membranaceous,midrib,moderately,narrowly,nflorescence,nther,often,one,orolla,perfect,pilo,pore,presen,present,pubescent,purple,radiu,represented,ruit,shorter,sinus,slightly,small,spaced,stamen,stellate,stigma,stone,tal,tem,thecae,time,toward,triangular,truncat,tube,ud,unit,unlobed,vary,white,wide,yello,ympodial	abaxial,adaxial,anther,arrangement,branching,characteristic,colour,corolla,filament,form,growth,height,history,inflorescence,length,life,midvein,na,ovary,perennial,plant,primary,pseudostipule,seed,shape,staman,stem,surface,tertiary,texture,unarmed,vein,venation
481	wfo-0001031684	success	161	90	74	87	16	0.46	.25,0.4-1.5,0.5-0.8,0.5-1,0.7-1,0.75-1,1-1.2,1-5,2,3-30,along,anther,bark,base,beneath,berry,black,branched,calyx,clavate,cm,corolla,curly,decurrent,deflexed,densely,dia,difoliate,drying,elliptic,filiform,geminate,glabrous,globose,inflorescence,internodal,irregularly,leaf,lobe,long,long-triangular,minutely,mm,occasionally,opposite,ovary,ovoid-reniform,pale,papillose,pedicel,petiole,pitted,pubescent,shrub,slender,slightly,small,sparsely,stem,stigma,style,surface,tan,tapering,tipped,tree,trichome,tube,unifoliate,uniseriate,vein,white,winged,x	.5,.75,/4,0.1,0.5-0.7,10-100,2-9,3-3.5,4-17,5-7,acuminate,acute,anthesi,apar,apex,bearing,borne,causing,denser,differing,eaf,edicel,eed,elongated,except,expanded,exserted,extremely,filament,flower,free,fruiting,gre,greatly,green,lateral,less,like,lobed,lon,lower,main,major,middle,midrib,minor,nflorescence,obconic,older,one,pair,papillo,persistently,planar,pore,poricidal,portion,present,previously,pulled,raised,reflexe,reflexed,rest,ruit,scar,shaped,short,single,siz,size,soon,spaced,straight,tall,tear-drop,time,tip,ud,unevenly,unit,varying,way,widely,widest,ympodial,young	arrangement,characteristic,colour,diameter,form,fruit,grey,growth,height,length,plant,pubescence,seed,shape,texture,type
482	wfo-0001031695	success	185	118	87	98	31	0.47	0.5-1,1-2,1-9,1.5-8,10-35,2-3,2-4,2-5,2.5-5,20-30,3-17,3-7,4-10,4-5,4-6,5-7,6-10,abruptly,acuminate,acute,also,apex,articulated,basal,base,branched,calyx,chartaceous,cm,color,cordate,dark,deep,densely,diameter,eglandular-pilose,ellipsoidal,entire,flattened,flower,fruit,glabrate,glabrescent,glabrous,glandular-puberulent,green,greenish,immature,lavender,leaf,leaving,lobe,lobed,long,margin,mm,moderately,mottled,oblique,oblong,obtuse,occasionally,ovate,pedicel,pedicellar,peduncle,petiole,pilose,pilose-hirsute,puberulent,puberulent-pubescent,pubescent,purple,rachi,remnant,ripe,shrub,simple,sometimes,sparsely,stripe,style,subcoriaceous,tree,unbranched,unknown,x	0.5-2,1,1-3,1.5-2,1/2,1/3,10-,10-15,15-20,3-,3-10,3-19,30-40,4-foliat,5,5-20,6-20,6-8,7-,?,abaxially,adaxially,aggregate,apart,ape,apically,apiculate,axe,beyond,blade,broadened,campanulate,capitat,cell,connective,connivent,cylindrical,d,dilated,directed,divided,eaf,eed,eglandular,exceeding,exserted,fleshy,hair,hard,lanceolate,lateral,laterally,lilac,lon,lower,midrib,narrowly,nflorescence,nther,often,orolla,ovoid,perfect,pilo,pilose-hirsut,pore,presen,present,purplish,radiu,rounded,ruit,shorter,sinus,slight,slightly,small,somewhat,spaced,stamen,stigma,stone,swelling,tal,tem,thecae,time,tip,tomento,triangular,tube,unequal,unit,unlobed,vary,wide,yellow,ympodial	10-20,abaxial,adaxial,anther,arrangement,branching,characteristic,colour,corolla,filament,form,growth,height,inflorescence,length,midvein,na,ovary,plant,primary,pseudostipule,seed,shape,staman,stem,surface,tertiary,texture,unarmed,vein,venation
483	wfo-0001031698	success	58	48	31	27	17	0.534	2-2.5,2.5,2.5-3,4-4.5,base,cm,deflexed,elliptic,flattened,fruiting,glabrous,incrassate,leaf,margin,minutely,mm,paler,papillae,pedicel,pitted,reddish-brown,reniform,repandly,rugose,shrub,stem,strongly,surface,winged,woody,yellowish	'',``,ape,bark,branch,decurrent,dia,difoliate,dull,eaf,eed,fide,geminat,green,long,maguire,older,otherwise,pale,persistin,stout,tall,unit,wing,x,ympodial,young	1,apex,arrangement,branching,characteristic,colour,diameter,form,geminate,growth,height,length,plant,seed,shape,texture,width
484	wfo-0001031707	success	178	115	87	91	28	0.489	1-1.3,1-1.5,1.2-1.8,1.2-2,1.5-2,1.5-6,1/3,16-20,2,2-6,4-5,4-6,6-7,80-140,abaxially,acuminate,acute,adaxially,almost,along,anther,apex,apical,apically,attenuate,axillary,base,basiscopically,bearing,berry,brown,calyx,cm,conical,corolla,dense,densely,diameter,distal,distinct,elliptic,enlarged,erect,filament,flattened,flower,glabrous,globose,green,greenish,lanceolate,leaf,lobe,long,margin,mm,narrowly,oblique,obovate,occasionally,ovary,pair,pedicel,per,petiole,pink,pinnate,plant,pointed,primary,pubescent,quadrate,reddish,round,scattered,simple,slightly,sparsely,style,surface,trichome,uniseriate,vein,vine,white,woody,x	-3,.5,/4,0.5-1,1-1.2,1-3,1.5-1.7,2-10,2-3,2-4,24,3,5-10-celled,8-12,9-15,absent,anthesi,axil,basal,c.,capitate,cateniform,cell,clavat,climbing,conspicuously,cucullate,drying,eaf,edicel,eed,endrophilum,epidermal,exserted,flap-like,flat,fleshy,four-lobed,free,fruiting,high,horizonta,inflorescenc,lateral,leaflet,less,like,lobed,lon,lower,minutely,narrower,nflorescence,open,papillate,penden,petiolule,planar,poricidal,portion,quite,raised,regular,rest,ruit,sagittate,scar,smaller,smooth,somewhat,spaced,stigma,stout,strongly,tem,terminal,ternate,thickening,time,tip,tub,tube,type,ud,unifoliat,unit,usually,way,white-lenticellate,widely,ympodial	0.5,8,abaxial,adaxial,arrangement,branching,characteristic,colour,form,fruit,growth,height,history,horizontal,inflorescence,length,life,midvein,na,peduncle,pseudostipule,rachi,seed,shape,staman,stem,texture,unarmed
485	wfo-0001031723	success	228	143	123	105	20	0.539	-1.5,-15,-2,-5,-8,0,0.4,0.4-,0.4-1,0.55-0.9,0.6-1,0.7-1,1-,1-2,1-2.5,1-3,1.2-2,15-45,2-,2-3.5,2.5-4.5,2.5-5,4-11,4-6,5-40,abaxial,abaxially,acuminate,acute,adaxial,anther,apex,apically,apparently,articulated,base,berry,branched,branching,brown,calyx,chartaceous,cm,cuneate,curved,dark,deltate,diameter,drying,dull,elongated,entire,erect,evenly,eye,filament,filiform,flattened-reniform,fruit,gently,glabrescent,glabrous,glandular,green,hair,infructescence,lateral,leaf,length,lobe,long,margin,marking,maturity,mauve,midpoint,minute,mm,moderately,naked,near,obtuse,orange,orange-brown,ovate,pair,pale,pedicel,peduncle,per,petiole,prickle,prickly,primary,recurved,red,rounded,secondary,shrub,simple,sometimes,sparsely,spherical,stellate-pubescent,stem,straight,style,subentire,surface,terminal,tertiary,trichome,unarmed,vein,venation,visible,weakly,white,whitish,wide,yellow,yellow-green,young	-1/2,-16,-6,-6.5,-merous,0.05-0.2,0.1-0.2,0.1-0.3,0.1-0.5,0.15,0.2-1,0.4-0.9,0.8-1.5,1-5,1.5-,1.5-10,1.5-2.5,1/3-1/2,1/4-1/3,1/6-,10-30,2-5.5,2-7,2/3,2/3-3/4,3-10,3-15,4-,4-10,4-20,4-5,5-9,8-20,acut,alyx,ame,apar,apart,ba,bark,blade,brow,c.,conical,connivent,densely,discolorous,eaf,eed,elongating,equal,finely,flower,free,fruiting,gland,gland-tipped,gray,herbaceous,inflated,lobed,longer,lower,mature,multangulate,narrow-deltate,nflorescence,older,one,open,orolla,oung,perfec,pericarp,perpendicular,plurifoliat,poricidal,porrect,portion,ray,reflexed,ruit,scar,sessile,smooth,spaced,spreading,stalk,stalked,stellate,strongly,tamen,tapering,terete,time,tip,tube,unarme,unit,usually,variously,vary,way,woody,ympodial	arrangement,characteristic,colour,corolla,form,growth,height,history,inflorescence,life,midvein,na,ovary,plant,pseudostipule,rachi,seed,shape,staman,texture
486	wfo-0001031729	success	161	97	69	92	28	0.429	-2,0.5-1,0.6-,1-1.5,1-2,1-2.5,1.5-2,12-13,2-2.5,2-3,2.5-5,3-4,5-6,5-7,abruptly,acuminate,anther,apex,apiculate-deltate,attenuate,base,branched,calyx,cm,conical,corolla,dark,darker,deltate,diameter,elliptic,filament,flattened,fruit,glabrous,globose,green,greenish,lobe,long,minutely,mm,mottling,obovate,occasionally,ovary,ovate-reniform,pair,pale,papillate,papillose,pedicel,peduncle,petiole,pink,primary,purplish,quadrate,reddish,shrub,somewhat,stem,stripe,surface,tan,time,vein,white,x	-0.5,-45,..,0.5,0.5-4,1.0-1.3,1.5,10-20,11-30,2.5-,3-celled,3.5-4,4.1-16,5-,50,8-9,along,anthesi,apicula,beneath,branc,branch,brittle,brow,c.,cell,cucullate,curve,dry,drying,eaf,edicel,eed,elongate,erec,flattened-capitat,flower,fruiting,glandular,gradually,later,less,lobed,lower,markedly,membranous,middle,minute,narrowly,nearly,never,nflorescence,noddin,open,outer,outline,papillae,per,pericarp,planar,plurifoliat,point,pointed,regularly,ruit,scar,scattered,short,single,single-stemmed,sinuate,small,smooth,stigma,striate,testa,thin,thing,tip,toward,triangular,trichome,tube,tuft,ud,unit,usually,wall,wand-like,widening,ympodial,young	abaxial,adaxial,arrangement,branching,characteristic,colour,form,growth,height,inflorescence,leaf,length,margin,midvein,na,nodding,plant,plurifoliate,pseudostipule,rachi,seed,shape,staman,style,tertiary,texture,unarmed,venation
487	wfo-0001031738	success	231	85	70	161	15	0.303	0.7-1,0.7-1.1,1-1.5,1.5-4,1/3,10-15,15-40,2.3-3,3.5-4.5,4-6,5-8,abaxial,acute,adaxial,anther,apex,apically,articulated,auriculate,base,berry,branched,calyx,chartaceous,cm,cordate,dark,densely,diameter,dull,erect,filament,frequently,fruit,glabrous,gray,lateral,leaf,length,lobe,lobed,lower,margin,mm,narrow-deltate,orange,orange-brown,ovate,pale,pedicel,peduncle,petiole,prickly,pubescent,shrub,small,sparsely,stellate-pubescent,stem,style,surface,terminal,tree,unarmed,upper,weakly,white,yellow,yellow-green,yellowish	-15,-5,-6,-merous,.5,0,0-2,0-3,0.1-0.25,0.2-0.3,0.25-0.8,0.3-1,0.9-2.1,1-1.8,1-3,1-4,1.4-1.7,1.5-,1/,1/2-2/3,1/3-2/3,1/4-1/3,1/6-1/4,2-,2-4,20-200,3-4,3-6,3-7,3.5-3.8,4,4-10,4-5,4-8,5,6-15,7-12,7-12.5,8-10,8-18,abaxially,acuminat,adaxially,almost,always,alyx,andromonoecious,apar,apart,apparently,bark,blade,cell,connivent,curved,deltate,discolorous,distal,distance,drying,eaf,eed,elongating,equal,evenly,extending,flattened,flattened-reniform,flower,free,fruiting,glabrescent,green,held,hermaphrodite,heterostylous,infructescence,inside,lobing,long,long-styled,longer,lowermost,mature,maturity,midpoint,midvein,multangulate,nflorescence,oblong,obovate,often,older,one,open,orolla,oung,outline,pair,per,pericarp,pit,plant,plurifoliat,poorly,poricidal,porrect,portion,prickl,prickle,primary,prominent,raised,ray,reflexed,resin,rounded,ruit,scar,secondary,sessile,short-styled,shorter,side,simple,smooth,sometimes,spaced,spherical,spreading,stalk,stalked,staminat,stellate,sticky,stout,straight,strongly,tamen,tapering,terete,tertiary,time,tip,trichome,truncate,tube,unit,usually,variously,vary,vein,venation,visible,way,white-brow,wide,woody,yellow-orange,ympodial,young	1/4,acuminate,characteristic,colour,corolla,form,growth,inflorescence,ovary,seed,shape,staman,texture,type,unknown
488	wfo-0001031752	success	172	134	103	69	31	0.599	-10,-100,-44,-6,0.5-1,0.5-1.5,1,1-1.5,1-3,1-4,1.5-10.5,1.5-2,1.5-3,1.5-3.5,15-25,15-40,2-2.5,2-3,2-5,20-35,3-4,3-7,3.5-5,5-6,5-8,9-16,acuminate,acute,apart,apex,apiculate,articulated,basal,base,calyx,chartaceous,cm,cuneate,darker,deltate,densely,diameter,ellipsoidal,elliptic,entire,flattened,fleshy,flower,fruit,fusiform,glabrate,glabrescent,glabrous,gland,glandular-puberulent,green,immature,leaving,less,light,lobe,long,margin,mm,moderately,near,oblong,often,older,ovate,pedicel,pedicellar,peduncle,perfect,petiole,pink,puberulent,pubescent,purplish,rachi,remnant,ripe,rounded,rugose,shrub,simple,small,spaced,sparsely,stalked,stripe,style,subcordate,subcoriaceous,tip,tree,truncate,unbranched,white,wide,x,yellow,young	-3,-47,-pubescent,1-,1-2,1.5-2.5,3-11.5,3-4-foliat,3.5-15,5-23,8-15,abaxially,adaxially,aggregate,ape,axe,beyond,blade,cell,ciliat,ciliate,connective,connivent,cylindrical,directed,distally,eaf,eed,equal,exceeding,exserted,glandular-puberulen,lanceolate,linear,lon,lower,membranaceous,narrowly,nearly,nflorescence,nther,obtuse,olde,orolla,ovoid,pore,presen,present,purpl,radiu,ruit,slightly,stamen,stellate,stigma,stone,swelling,tal,tem,thecae,time,tomentose,triangular,truncat,tube,ud,unit,vary,ympodial	abaxial,adaxial,anther,arrangement,branching,characteristic,colour,corolla,filament,form,growth,height,inflorescence,leaf,length,midvein,na,ovary,plant,primary,pseudostipule,seed,shape,staman,stem,surface,tertiary,texture,unarmed,vein,venation
489	wfo-0001031756	success	186	92	69	117	23	0.371	-1,.5,0,0-2,0.4-1.6,0.5-1,0.8-1,1-1.8,1-4,1.5-2,1.8-2.5,4-5,anther,apex,apically,articulated,base,berry,calyx,cm,color,cordate,curved,deltate,densely,diameter,entire,erect,evenly,filament,finely,fruit,glabrous,gray,green,known,leaf,lobe,margin,mature,mauve,mm,ovate,pale,pedicel,peduncle,petiole,pitted,prickly,red-brown,rounded,scandent,shoot,short,shrub,simple,slender,smooth,spherical,stellate-pubescent,stem,style,surface,terminal,truncate,unarmed,white,yellow-green,young	-5,.1,.8,/2,0-5,0.02-0.2,0.1,0.15-0.25,0.2,0.5-1.3,0.6-1.2,0.6-1.6,0.7-1.7,00,1-2,1-3,1.5-3.5,1/2,1/3,10,2-6,3-15,3-5,3-7,4.5,5-merous,6-9,7-10,9-14,abaxially,accrescent,acut,alyx,apar,apart,apparently,bark,blade,branched,broad-deltate,chartaceous,concolorous,conical,connivent,drying,eaf,eed,elongating,enclosing,equal,eye,flattened-reniform,flower,free,fruiting,fully,glabrescent,glabrou,herbaceous,inflated,infructescence,invested,lobed,long,longer,lower,midpoint,moderately,naked,nflorescence,older,one,open,orange-brown,orolla,oung,pair,pendulous,per,perfec,pericarp,perpendicular,plurifoliat,poricidal,porrect,portion,prickl,prickle,primary,ray,ruit,scar,sessile,shorter,small,spaced,sparsely,spreading,stalk,stalked,stellate,straight,tamen,tapering,terete,time,tip,trichome,tube,unit,variously,vary,vein,visible,way,wide,ympodial	abaxial,acute,adaxial,arrangement,branching,characteristic,colour,corolla,form,growth,height,inflorescence,length,mentioned,ovary,plant,pseudostipule,seed,shape,staman,texture,type,width
490	wfo-0001031786	success	209	114	94	115	20	0.45	0-20,0.2-2.5,0.5-1.5,0.7-1,0.7-1.6,1.2-1.6,1.5-2.5,2-3,2.5-3.5,3-4,4-5,6-8,acute,anther,apex,apically,apparently,articulated,base,becoming,berry,calyx,cell,chartaceous,cm,cuneate,curved,dark,deep,deltate,diameter,elliptic,erect,evenly,eye,filament,filiform,fruit,glabrous,gray,green,herb,lateral,leaf,length,lobe,lobed,margin,maturity,mauve,membranous,midvein,minute,mm,naked,orange,orange-brown,outline,ovate,pair,pale,pedicel,peduncle,per,petiole,pit,prickly,primary,raised,red,red-brown,shiny,shrub,simple,small,smooth,sometimes,sparsely,spherical,stellate-pubescent,stem,style,surface,tertiary,trichome,truncate,unarmed,vein,venation,visible,weakly,white,yellow-orange,young	-5,.4,.5,/2,/3,0,0-2,0-3,0-5,0.1,0.1-0.4,0.2-0.3,0.25-0.5,0.7-4,0.8,0.8-1.2,1,1-2,1-3,1-4,1-6,1.5-1.9,1/3-1/2,2-13,2-7,2-8,3-5.5,5-7,5-merous,8-12,abaxially,acut,almost,alyx,ame,apar,apart,bark,blade,branched,c.,clavat,concolorous,connivent,densely,distance,drying,eaf,eed,elongating,equal,extending,flattened,flattened-reniform,flower,free,fruiting,glabrescent,gray-brow,herbaceous,inconspicuous,infructescence,lon,long,longer,lower,mature,midpoint,nflorescence,obtuse,older,one,open,orolla,oung,pendulous,perfec,pericarp,plurifoliat,poricidal,porrect,portion,prickl,prickle,ray,reflexed,rounded,ruit,scandent,scar,sessile,shorter,side,slightly,spaced,spreading,stalk,stalked,stellate,stigma,straight,tamen,tapering,terete,thick,time,tip,tube,unit,variously,vary,way,wide,woody,ympodial	abaxial,adaxial,arrangement,branching,characteristic,colour,corolla,form,growth,height,inflorescence,na,ovary,plant,pseudostipule,rachi,seed,shape,staman,texture
491	wfo-0001031793	success	188	110	89	99	21	0.473	-4,.5,1-1.5,1-2,1-8,1.5-4,10-15,15-20,2-3,2-5,acumen,acuminate,aging,almost,anther,apex,armed,articulated,base,berry,black,branched,broadly,brown,brownish,calyx,cm,cuneate,densely,diameter,elliptic,erect,evident,extra-axillary,filament,flattened,flower,forked,fruit,glandular,globose,hair,inflorescence,leaf,linear,lobe,long,many,margin,mm,mucilaginous,often,orange-yellow,orbicular-ovate,pedicel,peduncle,per,petiole,prickle,pubescent,rachi,reddish,reduced,reticulation,rounded,rusty,scarcely,scattered,shallow,shrub,simple,small,sparsely,stellate,stellate-pubescent,stem,style,surface,testa,tip,tree,triangular,trichome,unarmed,unbranched,well-developed,white,yellow,yellow-brown	0,1,1-3,1.5-2,1/3,1/4,1/5,13-20,20,26,3-4,3-8,3/4,4,40,5-merous,7,8-11,absent,abundant,accrescent,acute,adult,alyx,apparently,aspect,axe,ba,bilobe,blade,branche,broad,capitate,central,chartaceous,cut,difoliate,distal,eaf,eed,elongatin,erec,extreme,ferrugineous,fruiting,geminat,general,homostylou,interpetalar,larger,lobing,lon,lower,main,maturing,midpoint,midrib,minutely,mostly,nflorescence,oblique,oblong-lanceolate,obtuse,older,orolla,ovate,perfect,pore,porocidal,porrect,principal,ruit,sessile,side,similar,single,sinus,size,smaller,stellate-pubescen,stigma,stipitate,stout,tall,tamen,tem,thickened,tissue,triangular-acuminat,tube,unit,upward,usually,uvenile,vary,way,woody,x,ympodial	abaxial,adaxial,arrangement,branching,characteristic,colour,corolla,form,growth,height,history,length,life,na,ovary,plant,pseudostipule,seed,shape,staman,texture
492	wfo-0001031829	success	138	60	46	92	14	0.333	.5,0.7-1,1-2,1.3-1.5,1.5-2,1.5-2.5,2-4,4-4.5,acute,anther,apex,base,berry,calyx,cm,corolla,densely,elliptic,fruiting,globose,green,growth,inflorescence,leaf,leathery,lobe,margin,mm,ovary,pedicel,petiole,poricidal,pubescent,quadrate,revolute,shrub,simple,somewhat,sparsely,stem,style,surface,thick,tube,white,x	.25,0.5-2.1,1,1.5-3.5,1.5-4.5,3-5-flowered,3/4,4-8.5,7-10,abaxially,absent,adaxial,adaxially,along,anthesi,ape,apiculae,bae,bark,branched,broadly,capitate,conical,crystalline,deflexed,denser,dia,differing,difoliate,drying,eaf,edicel,eed,epidermi,erect,exserted,filament,free,geminat,glabrat,glabrous,greenish-brown,immature,known,large-celled,lateral,like,lobed,lon,long,lower,main,major,minor,minute,minutely,nflorescence,occasionally,often,older,opposite,overlappin,packed,pair,papillo,papillose,planar,pore,portion,ruit,scar,shaped,size,soft,stigma,tall,tapering,tear-drop,tip,trichome,tub,tuft,ud,uniseriate,unit,vein,waxy,way,woody,yellowish,ympodial,young	characteristic,colour,diameter,form,fruit,height,length,na,plant,pubescence,seed,shape,texture,type
493	wfo-0001031832	success	232	135	114	118	21	0.491	0.1-0.3,0.2-1.5,0.3-0.8,0.3-3,0.7-1.5,0.7-1.6,0.7-2,0.8-1.2,1-12,1.1-2.4,1.2-1.6,1.2-2,1.3-4.2,14,2-3.6,2-6,2.5-6.5,3-6.5,3-7,4-20,5.5-10,7-10,9,abaxially,acuminate,acute,adaxially,anther,apart,apex,articulated,attenuate,basal,base,becoming,berry,branched,brown,brownish,bullate,calyx,closely,cm,conical,continued,corolla,dark,deltoid,diameter,due,entire,exserted,ferrugineous,filament,fleshy,flower,fruit,glabrous,globose,granular-tomentose,green,greenish,growth,hair,half,honeycombed,lanceolate,lateral,leaf,length,lobe,margin,midvein,mm,mostly,oblanceolate,obtuse,pale,pedicel,peduncle,petiole,pitted,probably,pubescent,rachi,reniform,reticulate-punctate,ripe,rough,scabrous,shrub,side,simple,smooth,spaced,sparingly,stamen,stem,stipitate-glandular,style,suborbicular,surface,terete,terminal,testa,time,tree,unarmed,vein,violet,white,x,yellow,yellowish	-8,.5-1,/50-1/10,0-150,0.2-0.6,1.2-2.5,1.5-4,1.7-4,1.8-4,1/2-3/4,2-4,2.8-4.8,3.5-7,4-7,5-21,8-25,accrescent,ag,anthesi,apical-lateral,apice,apparently,axe,axillary,ba,bark,blade,blister,blunt-tipped,branch,bud,capitat,chartaceous,connate,decurrent,dehiscing,directed,eaf,eed,evident,extend,few-rayed,forming,free,fruiting,glabrescen,glabrescent,high,indument,inserted,introrse,lackin,large,line,lobed,long,long-,longer,longitudinal,lower,m.,main,minute,mixed,multangulate,nearly,nflorescence,oblong,obovoid,occasionally,older,orbicular,orolla,ovate,partly,perfect,persistent,plurifoliate,pore,porrect-stellat,porrect-stellate,pubescence,rather,ray,relatively,rotate-stellate,ruit,runk,sessile,short-,short-stalked,slit,sometimes,somewhat,soon,sparse,splitting,stellate-pubescent,stigma,subcampanulate,suture,swelling,tamen,thick,thick-stalked,toward,translucent,tube,unarme,unit,usually,vary,way,weakly,whitish,wide,ympodial,young	abaxial,adaxial,arrangement,branching,characteristic,colour,form,height,history,inflorescence,life,na,ovary,plant,primary,pseudostipule,seed,shape,staman,texture,ye
494	wfo-0001031834	success	150	84	58	92	26	0.387	0.5,0.5-3,0.5-3.5,0.6-1.4,0.8-1,0.8-1.3,1,1.5,1.6-2,6-7,acuminate,acute,anther,apex,base,calyx,cm,corolla,decurrent,deltoid,few-flowered,filament,flattened-reniform,fruit,glabrous,globose,green,greenish-yellow,leaf,less,lobe,margin,minutely,mm,ovary,ovate,pale,pedicel,petiole,pitted,pubescent,scabrous,short,shrub,simple,slender,sparsely,stem,straight,style,surface,tan,tapering,tufted,vein,white,x,yellow	.5,0.5-1,0.9-1.4,1.5-4,1.9-6.5,2.9-7,2/3,6.5-14,accrescent,across,anthesi,apar,apically,apiculate,appear,attenuate,berry,bi-cellular,borne,campanulate,covered,deciduou,deciduous,deflexed,depression,dia,difoliate,eaf,edicel,eed,expanded,eye,free,fruiting,geminat,glabrou,hook,hooked,incrassate,lamina,larger,leaving,like,lobed,lon,long,lower,major,markedly,middle,minor,minute,mound-like,multicellular,naked,nflorescence,often,opposite,papillo,papillose,persistent,planar,pore,poricidal,portion,proximal,ruit,scar,shaped,slightly,small,soon,spaced,speck,stigma,tall,tear-drop,tip,trichome,tube,ud,unevenly,uni-,uniseriate,unit,upper,usually,way,widest,woody,ympodial,young	abaxial,adaxial,arrangement,branching,characteristic,colour,diameter,form,growth,height,inflorescence,length,midvein,na,peduncle,plant,primary,pseudostipule,rachi,seed,shape,staman,tertiary,texture,unarmed,venation
495	wfo-0001031842	success	161	106	77	84	29	0.478	.4,.5,0.1-0.5,0.6-1,0.7-1,1,1-1.5,1-1.8,10-12,10-20,10-30-flowered,2-10,2-3,2.5-3,3-8,4.5-6,7-9,acute,anther,apex,attenuate,base,bearing,beneath,berry,brown,calyx,cm,corolla,cusp,dark,deeply,dia,dry,elliptic,filament,flattened-reniform,glabrous,globose,green,incrassate,leaf,lobe,long,margin,mm,ovary,pair,pale,paler,pedicel,petiole,pitted,pubescent,quadrate,shiny,shrub,simple,slender,sparsely,specimen,stem,straight,style,surface,tapering,terminal,time,tree,trichome,tube,tuft,uniseriate,vein,white,woody,x	.1,.75,0.5-1,0.5-2,1-3.5,1.5-2,2.5-6,3/4,9-15,anthesi,apart,axil,ba,bark,beginning,bi-lobed,capitate,cup-shaped,decurrent,deflexed,densely,differing,difoliate,eaf,edicel,eed,ellipsoid,exserte,exsertion,free,fruiting,geminat,inflorescenc,irregularly,later,lateral,leaf-opposed,lobed,lon,lower,main,major,middle,minor,minutely,near,new,nflorescence,often,older,one,onto,opposite,overtopping,papillo,papillose,pore,poricidal,portion,prominent,reddish,reddish-resinous,reflexed,ruit,scar,shaped,shoot,size,somewhat,soon,spaced,stigma,strongly,tall,tear-drop,tip,ud,unit,way,widest,yellowish,yellowish-whit,ympodial,young	abaxial,adaxial,alternate,arrangement,branching,characteristic,colour,diameter,form,fruit,growth,height,inflorescence,length,midvein,na,peduncle,plant,primary,pseudostipule,rachi,seed,shape,staman,tertiary,texture,unarmed,venation,yellowish-white
496	wfo-0001031843	success	245	126	110	135	16	0.449	.5,0.6-1.2,1-2,1-7,1.2-2,1.2-2.2,1.5,1.5-2,1mm,2.5,3-4,3-7,4-12,5-12,6-9,abaxially,acuminate,adaxially,along,anther,apex,apically,attenuate,basal,base,berry,black,branch,branched,branching,broadly,brown,calyx,canaliculate,caudate,cm,completely,conical,corolla,cuspidate,dark,deltoid,diameter,dilated,discoid,distributed,drying,dull,equal,evenly,filament,fine,flat,flower,glabrous,green,leaf,length,liana,like,lobe,long,main,midvein,mm,network,oblique,oblong,obovate,orange,orange-brown,orange-yellow,pair,part,partly,pedicel,peduncle,petiole,primary,pubescent,raised,rarely,red,reddish,rounded,seed,shiny,shortly,shrub,side,slender,slightly,sometimes,sparsely,spheroidal,stem,style,surface,terminal,tertiary,thick-chartaceous,trichome,twice,unarmed,vein,venation,violet,visible,x,young	.2,.3,.6,0-4,0.2-2,0.4-0.5,0.5-1,0.5-1.5,0.7-1.2,0.7-2,0.8-2,1.8-2.5,1/6-1/4,2-3,2-4,45-60Â°,5-10,accrescent,age,almost,always,alyx,anthesi,apar,apice,apparently,appressed,around,articulated,bark,becoming,capitate,clearly,collapsing,cupular,curved,deeply,delineated,dendritic,density,detaching,discolorous,domatia,eaf,eed,ellipsoi,entire,erect,even,eye,fertilisation,finely,flexuous,forming,free,fruiting,hand,honeycomb,inner,largely,leave,len,lengthening,lignified,lobed,longitudinally,loop,looping,lower,m.,margin,much,multiseriate,naked,never,nflorescence,nther,obscure,older,opening,orolla,outline,ovate,papillo,pattern,pendulous,perfec,pericarp,pit,pitted,plurifoliat,pore,poricidal,portion,present,prominent,pronounced,protruding,rachi,recurve,reveal,ribbed,ridged,ruit,scar,see,shallowly,simple,sinus,small,smaller,smooth,soon,spreading,stigma,straight,strongly,stump,surfac,tearing,thickened,thin,tip,tube,tuft,ud,unit,variable,vary,weakly,white,wide,wider,without,ympodial	abaxial,adaxial,arrangement,characteristic,colour,form,fruit,growth,inflorescence,ovary,shape,specified,staman,texture,type,ye
497	wfo-0001031852	success	155	97	65	90	32	0.419	-8,0.1-1,1-4,1-4.2,1-9,1.4-3,12-35,4-,4-10,4-5,4-6,7-,9-11,acuminate,acute,apex,articulate,base,branched,calyx,cell,cm,conical,corolla,covering,cyme,diameter,dichasial,dichasially,ebracteate,elliptic,elliptic-lanceolate,filament,green,green-white,hair-like,herbaceous,lanceolate,lateral,leaf,light,lobe,long,mm,monochasial,mucilaginous,oblique,oblong,odd-pinnate,ovate-elliptic,ovoid,pedicel,peduncle,perennial,petiole,plant,pubescent,rachi,seed,style,testal,thick,throughout,wall,white	0.5-1.3,0.5-3,1-,1.3-2.5,1.5-3,2-3,2-5.5,2.6-9.5,3-4,3-6-foliat,3-9,3.5-10,5-15,abaxially,abruptly,absen,acumen,adaxially,apical,apically,apiculate,attenuate,connate,decurrent,dehiscent,digestion,diminishing,distal,dorsally,eaf,edge,eed,emoval,enzyme,exceeding,flat,flower,folded,forked,generally,globo,half,honeycomb,interjected,introrse,leaflet,living,lon,lower,lunat,make,maturing,nflorescence,nther,often,orolla,pair,pattern,perfect,plan,poricidally,proximal,reveal,ruit,sessile,seudostipule,short,shortly,size,slit,specimen,stamen,stellate,stigma,straight,tal,tem,terminal,throughou,toward,tuber-bearing,typically,unit,vary,white-crea,wide,without,yellow,ympodial,Â¼	abaxial,adaxial,anther,arrangement,branching,characteristic,colour,form,fruit,growth,height,history,inflorescence,length,life,margin,midvein,na,ovary,primary,pseudostipule,shape,staman,stem,surface,tertiary,texture,unarmed,vein,venation,wet,white-cream
498	wfo-0001031864	success	140	95	73	67	22	0.521	.2,.25,.5,0.2-0.5,0.5-13.5,0.5-4,0.7-0.8,0.8-1,1-1.2,1-1.8,1-2,1.2-1.5,1.5-10,1.5-2.5,15-60,2-3,2.5-6,3-3.5,3-pinnate,7.5-8,abaxially,acute,adaxially,anther,apex,calyx,chartaceous,clavate,cm,deltoid,dense,diameter,emarginate,entire,filament,fleshy,flower,fruit,glabrous,herbaceous,lenticular,lobe,margin,middle,mm,moderately,ovoid-deltoid,papillose,pedicel,peduncle,petiole,pubescence,pubescent,rachi,rounded,sand-punctate,short,slender,slightly,sparsely,stem,stigma,style,surface,tip,trichome,truncate,tube,unbranched,unknown,vine,violet,x	0.4-3,0.6-3.5,0.6-4,1-3,1-5,1-6.5,1.5,2,5-15,5-9,5-merous,accrescent,acuminate,alyx,apar,apical,apiculate,axe,base,berry,blade,c.,capitat,ciliate,color,cuneate,densely,eaf,eed,extra-axillary,fine,flattened,fruiting,glabrou,hair,lateral,leaflet,like,lon,long,lower,m.,minutely,near,nflorescence,nternode,oblique,orolla,perfec,petiolule,plurifoliat,pointed,pubescenc,rotate,ruit,scattered,spaced,tamen,tem,terrestria,typical,unit,vary,vein,wide-diameter,widely,ympodial	abaxial,adaxial,arrangement,branching,capitate,colour,corolla,form,growth,history,inflorescence,internode,leaf,length,life,number,ovary,seed,shape,staman,terrestrial,texture
499	wfo-0001031864	success	148	90	71	77	19	0.48	.2,.25,.5,0.5-13.5,0.5-4,1-1.2,1-1.8,1-2,1.5-2.5,15-60,2-3,3-3.5,3-5-celled,3-pinnate,5-15,7.5-8,abaxially,adaxially,anther,apart,apparently,articulated,base,blue-purple,calyx,center,ciliate,clavate,cm,color,dense,densely,diameter,entire,extra-axillary,filament,fine,fleshy,flower,glabrous,hair,herb,lenticular,long,margin,mm,papillose,pedicel,peduncle,perfect,pubescence,pubescent,rachi,scattered,short,simple,slender,somewhat,spaced,sparsely,style,surface,terrestrial,thick,trailing,unbranched,uniseriate,unknown,widely,woody,x	0.4-3,0.6-3.5,0.6-4,1-3,1-5,1-6.5,1.2-1.5,1.5,2,2.5-6,5-9,5-merou,absent,accrescent,acuminate,acute,ag,alyx,apex,apical,apiculate,axe,ba,basally,blade,capitat,connivent,cordate,cuneate,deltoid,directed,distally,eaf,eed,emarginate,equal,etiole,fruit,fruiting,geminat,interjected,large,lateral,leaflet,lobe,longitudinal,lower,m.,minutely,near,nflorescence,node,oblique,oblong,opening,orolla,petiolule,plurifoliate,pore,pubescenc,rooting,rotate,rounded,slightly,slit,stigma,tamen,tem,tip,truncate,tube,unit,vary,weakly,wiry,yellow,ympodial	5-merous,abaxial,adaxial,arrangement,characteristic,colour,corolla,form,growth,inflorescence,leaf,length,ovary,petiole,seed,shape,staman,stem,texture
500	wfo-0001031871	success	185	129	99	86	30	0.535	0.4-2,0.6-1.2,1-2,1.5-11,1.5-2.1,14-22,2-4,3-10,3-4,3-5,3.5-4,33-40,4-6,6-12,6-7,7-9,abaxially,acumen,acute,adaxially,anther,apart,apex,articulated,attenuate,axillary,base,berry,brownish,bud,cell,chartaceous,cm,condition,corolla,covering,dark,deep,diameter,distal,dot,drying,elliptic,filament,flower,forked,fresh,fruit,generally,glabrous,globose,green,green-white,greenish,hair,hair-like,half,herb,high,lanceolate,lateral,linear,lobe,long,make,medium,mm,mottled,mucilaginous,narrowly,odd-pinnate,ovate,ovoid,pedicel,peduncle,petiole,petiolulate,plant,pubescent,purple,ripe,rounded,seed,short,spaced,style,subglabrous,subtending,terminal,testal,thick,throughout,tiny,usually,wall,wet,white,whitish,winged	1.4-2.1,1.5-2,1.6-2.7,2-3,2.9-6,36-44,4-7,5-merou,5.4-12.3,6.5-20.5,7.5-23,adaxiall,ag,alyx,apparently,asymmetric,axe,basiscopic,blade,capitat,clavate,connivent,digestion,dorsally,eaf,edge,eed,end,enzyme,erec,exceeding,flat,folded,geminat,glabrou,hal,homostylous,honeycomb-shaped,interjected,leaflet,lengthening,living,lower,nflorescence,one,orbicular,orolla,pair,perfect,placed,plurifoliate,pore,poricidal,removed,rotate,round,ruit,sessile,seudostipule,side,size,slit,sometimes,specimen,stamen,stigma,stolo,straight,subequal,subglabrou,symmetric,tall,tamen,tem,tip,tissue,tri-,tube,tuber,typically,unit,vary,wide,x,yellow,ympodial	2,abaxial,adaxial,arrangement,branching,calyx,characteristic,colour,form,growth,height,inflorescence,leaf,length,margin,midvein,na,ovary,primary,pseudostipule,rachi,shape,staman,stem,surface,tertiary,texture,unarmed,vein,venation
501	wfo-0001031876	success	140	74	48	92	26	0.343	.1,.5,0-flowered,0.5,0.8-1,1,1-1.5,1.5-2.2,acute,anther,bark,base,berry,calyx,cm,corolla,decurrent,elliptic,filament,glabrous,green,irregularity,leaf,less,lightly,lobe,long,margin,minute,mm,oblanceolate,oblique,often,ovary,pedicel,petiole,present,shrub,simple,slender,slightly,stem,straight,style,tapering,tube,white,winged	1-1.6,1-4,27-35,3,5,9-15,?,across,anthesi,apex,apiculate,arc,arising,ba,bearing,beneath,bright,closely,convergence,corky,cup-like,dia,differing,eaf,edicel,eed,erect,family,flower,free,fruiting,glabrou,globose,granular,greenish-yellow,immature,known,lateral,lenticellat,lobed,long-acuminate,lower,main,major,melastomataceae,member,middle,minutely,nearly,nflorescence,opposite,otherwise,overlappin,pair,papillose,parallel,perpendicular,persistent,point,pore,poricidal,portion,primary,prominent,raised,recurved,reflexed,resemble,ruit,running,scar,secondary,shaped,spaced,stigma,styl,tall,tear-drop,time,tip,ud,unifoliat,unit,vein,venation,wide,widest,woody,x,yellow,ympodial,young	-1.6,arrangement,characteristic,colour,diameter,form,fruit,growth,height,history,inflorescence,length,lenticellate,life,na,peduncle,plant,rachi,seed,shape,staman,surface,texture,type,unifoliate,width
502	wfo-0001031877	success	216	99	88	128	11	0.407	+,.5,0.3-,0.3-1,0.3-1.2,0.5,0.6-1.2,1-1.5,1-3,1-3.5,1.1-,1.5,1.5-1.9,1.5-2,1.8-5,2.5,3.5-4,6-8,abaxially,acuminate,acute,adaxially,anther,apex,basally,base,bright,brown,calyx,cm,corolla,densely,diameter,ellipsoid,entire,filament,flattened,fruit,furcate,glabrous,globose,greenish,growth,hastate,lateral,line,lobe,lobed,long-acuminate,margin,minutely,mm,occasionally,often,pale,papillate,pedicel,peduncle,petiole,pitted,plump,pubescence,pubescent,purple,red,reddish,reniform,ripe,scrambler,seed,simple,slightly,sparsely,stem,style,surface,terminal,tinged,tip,triangular,trichome,tube,uniseriate,usually,vine,weak,white,x	.3,0.2,0.5-1,0.8-0.9,1,1-4,2,2-,3-5,3-6,5-merou,6-10,abruptly,adaxiall,ag,along,alyx,angled,anthesi,apar,apparently,ark,articulated,ascending,basal,berry,capitate,cell,clavate,conical,connivent,deep,deflexed,deltate,distal,dried,eaf,eed,ellipsoidal,enlarged,erect,especially,exposed,exserted,eye,fleshy,flower,free,fruiting,green,ilament,impressed,internal,irregularly,lamina,later,lengthening,like,linear,long,loosely,lower,material,mature,midvein,minute,nearly,new,nflorescence,older,orolla,outline,pair,papillo,parallel,part,per,perfect,pericarp,plant,plurifoliat,pointing,pore,poricidal,portion,primary,prominently,purplish,rectangular,reflexed,rest,rounded,ruit,scar,semi-woody,shiny,short,shorte,silky,sinuate,sleeve,slender,slit,sometimes,somewhat,spaced,spreadin,stellate,stigma,strongly,subshru,tem,testal,thin,truncate,twinin,ud,uniformly,unit,upper,vary,vein,visible,wall,woody,yello,ympodial,young	characteristic,colour,form,inflorescence,leaf,length,ovary,shape,size,texture,yellow
503	wfo-0001031880	invalid_json	180	116	89	91	27	0.494	0.5-2,0.7-0.8,1,1-1.3,1-1.5,1.5,2,2-3,2.5-8,3-3.5,3-foliate,3-lobed,4,5-6,6-9,7-9,abaxially,acuminate,acute,adaxially,anther,apex,base,berry,brown,calyx,cell,cm,conical,cordate,corolla,crenate,dark,densely,diameter,elliptic,entire,filament,flattened,fleshy,flower,fruit,glabrous,glandular,globose,green,herb,inflorescence,internodal,irregularly,leaf,lobe,long,margin,mature,mm,narrowly,orange,ovary,ovoid,pair,pale,pedicel,peduncle,petiole,pitted,primary,pubescent,purple,rachi,red,reddish,shallowly,simple,sparsely,stem,straight,style,subshrub,surface,testal,toothed,trichome,truncate,uniseriate,vein,wall,x,â5	.5,0.5-1,1-2,2-4,2-9,3-4-pluri-foliate,4-8,5,age,anthesi,apart,basal,bearing,becoming,broadly,c.,capitate,ciliate,color,crowded,cup-shaped,curved,eaf,edicel,eed,ellipsoid,enlarged,erect,exerted,flush,free,fruiting,gland,gland-tipped,growing,heteromorphic,hollow,horn,lamina,lengthening,less,lon,longest,lower,markedly,maturit,mid-length,middle,minutely,near,nflorescence,nodding,ovate,papillo,papillose,pericarp,plan,pore,poricidal,portion,pubescen,reflexed,ruit,scar,shortest,single,slender,slightly,slit,sometimes,spaced,sparse,spreading,stigma,strongly,terminal,thin,tip,triangular,tube,ud,unicellula,unit,unlobed,upper,upward,widely,widest,woody,yellow,ympodial	'',[,``,abaxial,adaxial,arrangement,branching,characteristic,colour,form,growth,height,length,midvein,na,plant,pseudostipule,seed,shape,staman,tertiary,texture,unarmed,value,venation,{,}
504	wfo-0001031881	success	168	77	64	104	13	0.381	.5,0.5-1,1-1.3,1-1.5,1-7,1.2-6,1.5-2.5,1/3,2,3.5-4,5-6,anther,base,beneath,branched,broadly,brown,calyx,cm,corolla,dark,decurrent,deflexed,deltoid,densely,distal,elliptic,fruit,glabrous,globose,golden,golden-pubescent,green,inflorescence,leaf,lightly,lobe,long,minutely,mm,obovate,opposite,ovary,ovoid-reniform,pedicel,petiole,pitted,puberulent,pubescent,rounded,shape,shrub,small,sparsely,stem,style,surface,tip,tree,tube,usually,white,winged,x	0.1-0.5,0.2,0.2-0.6,0.4-1,0.5-0.7,10-12,10-30,2-9,3-19,3/4,7-14,absent,acute,along,anthesi,apar,apex,apparent,attenuate,axil,ba,bark,branch,bud,campanulate,capitate,constriction,dia,differing,difoliate,dry,drying,eaf,edicel,eed,either,ellipsoid,erect,evenly,exserted,filament,fleshy,free,fruiting,geminat,golden-puberulent,greyish-brow,incrassate,inflorescenc,junction,lateral,like,lobed,lon,lower,main,major,margin,material,maturity,middle,midrib,minor,minute,nflorescence,occasionally,older,one,orbicular,pair,papillo,papillose,planar,pore,poricidal,portion,puberulen,rest,ruit,scar,shaped,simple,size,slender,slightly,somewhat,soon,spaced,stigma,straight,strong,tall,tapering,tear-drop,trichome,ud,uniseriate,unit,vein,way,widest,woody,ympodial,young	abaxial,characteristic,colour,diameter,form,greyish-brown,growth,hair,height,length,plant,seed,texture
505	wfo-0001031886	success	169	102	76	93	26	0.45	-4,-9,0.5-1,1-1.5,1-4,1.2-2.5,2,2-2.5,2-5,2.0-2.5,3.0,5-6,6-8,9-10,acuminate,along,anther,apex,arising,attenuate,axil,axillary,base,berry,bright,broadly,brown,calyx,cm,completely,conical,corolla,deltate,diameter,elliptic,filament,fleshy,fruit,glabrous,green,greenish,half,lobe,lower,margin,minutely,mm,occasionally,ovary,ovoid-reniform,pair,papillate,papillose,pedicel,petiole,pinnate,portion,primary,purple,rachi,raised,rugose,seed,shape,shrub,simple,single,style,surface,tip,triangular,trichome,uniseriate,vein,white,x	-1.2,-25,.5,0,0.1,1.5-2,10-40,2-3,2-4,20-30,3-6,4,4-15,5-10,5-ridged,6-20,abaxially,abruptly,absent,adaxially,anthesi,anticlinal,basal,beak,bearing,bud,capitate,cell,clavat,commonly,distinctly,dry,eaf,earl,edicel,eed,either,em,epidermal,equal,erec,exserted,flower,free,fruiting,irregular,lanceolate,lateral,le,leaflet,lobed,long,narrowed,near,nearly,nflorescence,noddin,node,oblique,open-conical,papillae,per,petiolule,poricidal,projection,reddish,reflexed,ripe,ruit,scar,scattered,similar,sinuous,smaller,smelling,somewhat,sparse,specimen,stigma,strongly,terminal,thickening,time,tub,tube,ud,unifoliat,unit,usually,wintergreen,without,woody,ympodial	1,abaxial,adaxial,arrangement,branching,characteristic,colour,form,growth,height,inflorescence,leaf,length,midvein,na,nodding,peduncle,plant,pseudostipule,staman,stem,tertiary,texture,unarmed,unifoliate,venation
506	wfo-0001031895	success	160	89	73	87	16	0.456	-1.5,1-1.5,1.5-3,2-2.5,2.5-3,3-4,3.5-6,4,4-5,5,5-6,6-7,6-9,acute,anther,apex,attenuate,bark,base,beneath,berry,bluish,calyx,cm,completely,conical,corolla,dark,deltate,densely,diameter,elliptic,entire,exfoliating,filament,fleshy,glabrous,globose,green,growth,less,lobe,margin,matte,minutely,mm,occasionally,once-branched,ovary,overlapping,pair,pale,papillate,pedicel,peduncle,peeling,petiole,pitted,primary,revolute,shiny,shrub,simple,slightly,stem,stout,style,surface,tan,vein,violet,white,x	0.5,0.5-1,0.5-2,1.5-2,1.5-6,3-10,3-8,4.5-16.5,5-8,age,anthesi,apparently,articulating,blac,broadly,campanulate,capitate,cell,cup-shaped,drying,eaf,eed,ellipsoid,emarginated,enlarging,erec,erect,exerted,expand,flower,fragrant,free,fruiting,glabrou,immature,inflorescenc,intensely,irregular,leaf-opposed,leafy,leaving,lengthening,lobed,lower,new,nflorescence,older,ovoid,papillat,part,patch,peg,perfect,pericarp,planar,plurifoliat,pore,poricidal,portion,reddish,reniform,ruit,scar,shoot,short,sinuate,slender,slit,small,somewhat,stigma,straight,strongly,terminal,testal,thick,thin,tip,tree,tub,tube,ud,unit,way,woody,ympodial,Â¼-1/2	abaxial,arrangement,characteristic,colour,form,fruit,height,inflorescence,leaf,length,plant,seed,shape,texture,type,unknown
507	wfo-0001031897	success	264	149	133	131	16	0.504	.5,0.1-0.5,0.15,0.4-1.1,0Â°,1.1,1.3-2,1.7-3,2/3,4-5,5-6,6-9,abaxial,abaxially,absent,acute,adaxial,adaxially,along,anther,anthesi,apex,apically,appearing,attenuate,axillary,base,bendy,berry,black,brachyblast,branch,brown,calyx,chartaceous,clustered,cm,condensed,conical,coriaceous,corolla,cuneate,dark,densely,developed,diameter,dilated,distributed,dry,drying,dull,elliptic,entire,epiphyte,erect,evenly,except,extending,faint,filament,filiform,foliaceous,fruit,glabrous,green,grey,hair,known,lamina,lanceolate,lateral,leaf,least,light,linear,lobe,long,longitudinal,margin,mauve,membranous,midvein,mm,multicellular,oblong,obtuse,occasionally,one,orange,orange-brown,ovate,ovoid,pair,partly,pedicel,peduncle,pericarp,petiole,pointed,primary,pubescent,raised,rarely,reddish,revolute,ridge,ridged,shoot,short,shrub,simple,slender,slightly,sometimes,sparse,sparsely,stem,style,sunk,surface,terminal,tertiary,thick,thin,unarmed,usually,vein,venation,visible,weakly,white,x,young	.1,.8,0-1,0.2-0.4,0.5-1,0.5-3,0.6,0.8-1.5,1,1-1.5,1-2,1-2.5,1.5,1.5-8,13,2-4,462.,8,accrescent,age,almost,alyx,apar,apparently,appendage,arising,aristate,articulated,bark,boiteau,branched,cell,clavate,clearly,concolorous,connate,covering,curved,datum,dehiscing,delineated,dendritic,dense,developing,development,divided,domatia,dorsal,dorsifixed,eaf,earliest,ed,enlarged,equal,even,eye,fine,flower,free,fruiting,immature,indistinc,inner,inside,larger,lengthening,like,lobed,longitudinally,looped,lower,m.,main,margi,minute,minutely,multiseriate,naked,never,nflorescence,nther,obconical,oblon,occasional,orolla,outside,overlapping,papillose,part,pendulous,perfec,persisting,plant,plurifoliat,pore,poricidal,portion,prominent,pronounced,protruding,reach,ribbed,ruit,scar,secondary,see,seen,side,sinus,smaller,smoot,smooth,stigma,stump,subulate,tearing,terete,tip,toward,trichome,tube,ud,unbranched,unicellular,unit,vary,well-developed,wide,winged,wrinkle,ympodial	arrangement,branching,characteristic,colour,form,growth,inflorescence,length,mentioned,ovary,seed,shape,staman,texture,true,type
508	wfo-0001032157	success	136	92	75	61	17	0.551	.5,.75,0.5-1,0.6-1,0.75-1,1-3,1.9-2.2,2-3,2.2,5-15-flowered,7-9,acute,anther,bark,base,beneath,berry,bi-lobed,calyx,cm,completely,corolla,crystalline,decurrent,deflexed,deltoid,dia,dry,elliptic,filament,fruiting,glabrous,globose,golden,green,incrassate,leaf,live,lobe,long,longitudinal,margin,minutely,mm,ovary,ovoid-reniform,paler,papillose,pedicel,peeling,petiole,pitted,plant,pore,poricidal,reddish,rounded,shaped,shiny,shrub,simple,slender,slightly,stem,stigma,straight,strip,style,surface,tapering,tear-drop,tip,tube,white,x	0.25,2-5,3-6,5-8,5-9,9-17,anthesi,apart,apex,becoming,beginning,caly,differing,difoliate,eaf,edicel,eed,evenly,exserted,free,frui,geminat,glabrou,inflorescenc,lateral,less,living,lobed,lon,lower,main,major,middle,minor,nearly,nflorescence,obscure,older,one,opposite,pair,papillo,persistent,portion,raised,reflexed,ruit,scar,size,soon,spaced,tall,translucen,ud,unit,vein,widest,woody,yellowish,ympodial,young	abaxial,adaxial,characteristic,colour,diameter,form,fruit,growth,height,inflorescence,length,mentioned,peduncle,seed,shape,texture,type
509	wfo-0001032161	success	146	91	62	84	29	0.425	0.4-1.2,0.5-1,0.75-1,0.8-1,1-3,1.2-1.3,2-7,2-8-flowered,2.5-3,3.5-4,acute,adaxially,anther,apex,base,berry,calyx,cm,corolla,deltate,dendritic,densely,drying,elliptic,filament,filiform,glabrous,globose,golden,green,inflorescence,internodal,leaf,lobe,margin,minutely,mm,mustard,opposite,ovary,ovoid-reniform,pale,pedicel,petiole,pitted,plant,pubescent,quadrate,revolute,shrub,simple,sparsely,stem,style,sulcate,surface,tan,trichome,vein,white,yellow,yellowish	.5,0.7-4,1-1.5,1-11,1.4-2,?,abaxially,adaxiall,anthesi,apical,area,ba,bark,beneath,branched,brownish-blac,closely,color,conical,coriaceous,dark,deflexed,delicate,dia,difoliate,eaf,edicel,eed,ellipsoid,exserted,free,fruiting,giving,hanging,lamina,later,like,lobed,long,lower,many,merely,middle,minute,nearly,nflorescence,obovate,occasionally,older,overlappin,papillose,pericarp,persistent,plurifoliate,pore,poricidal,portion,projection,reflexed,rest,ruit,scar,shaped,shiny,shoot,short,spaced,stigma,strongly,styl,tall,tear-drop,thin,tip,tub,tube,ud,uniseriate,unit,usually,widest,x,ympodial,young	0.5,6,abaxial,adaxial,arrangement,branching,characteristic,colour,diameter,form,fruit,growth,height,history,length,life,midvein,na,peduncle,primary,pseudostipule,rachi,seed,shape,staman,tertiary,texture,unarmed,venation
510	wfo-0001032165	success	197	110	95	102	15	0.482	0.1,0.25-0.5,0.3-1,0.75-1,1-1.2,1-1.5,1-2,1.5-4,10-25,2-2.5,2.5-3.5,3-6,3.5-8.5,4-6,5-15,5-30-flowered,5-6,5-7,5-9.5,8-9,abaxial,acute,anther,apex,bark,base,berry,broadly,calyx,capitate,cm,continued,corolla,cup-shaped,deltoid,densely,due,dull,edged,elliptic,erect,filament,fruiting,glabrous,globose,golden,golden-pubescent,green,greyish-brown,inflorescence,leaf,less,lobe,lobed,major,minor,minute,minutely,mm,nearly,obovate,occasionally,once-furcate,orbicular,ovary,ovoid-reniform,pale,pedicel,petiole,pitted,plant,poricidal,presence,purplish,ripe,rounded,shape,simple,size,stem,stigma,straight,style,surface,tapering,tinged,tip,tree,trichome,tube,uniseriate,white,winged,x,young	.25,.5,0.1-0.3,3-4,adaxial,along,anthesi,apparent,appearing,ba,beginning,beneath,brown,bud,center,closely,cucullate,dark,deciduous,decurrent,denser,dia,differing,difoliate,distal,dry,eaf,edicel,eed,ellipsoid,end,entire,even,expansion,exserted,exsertion,free,geminat,golden-puberulent,immature,inflorescenc,later,lateral,like,live,lon,long,lower,main,margin,markedly,medial,middle,midrib,near,nflorescence,node,older,one,onto,opposite,overlapping,pair,paler,papillo,papillose,planar,pore,portion,prominent,puberulent,rather,rest,ridge,ruit,scar,shaepd,single,slender,slightly,slow,small,smoot,spaced,specimen,stout,stripe,strongly,swollen,tall,tear-drop,terminal,thickened,time,tub,ud,unit,vein,widest,woody,yellowish,ympodial	characteristic,colour,diameter,edge,form,fruit,growth,hair,height,length,seed,smooth,texture,type,width
511	wfo-0001032167	success	163	111	91	72	20	0.558	.5,0.5-1,0.5-1.5,0.5-2.5,1-2,1-2-celled,1-2.5,1-5,1.5,10-20,10-35,12-20,2-4,2-7,2-foliate,3-6,3-7,4-10,4-6,5-15,7-10,absent,acute,anther,apex,base,berry,brown,calyx,cell,chartaceous,ciliate,cm,decurrent,densely,diameter,dm,drying,elliptic,elliptic-ovoid,entire,few-,filament,flower,forming,fruit,geniculate,glabrous,globose,growth,hair,herb,immature,linear-lanceolate,lobe,lowermost,many-branched,margin,maturing,membranaceous,mm,moderately,nearly,netlike,obtuse,often,one-celled,pedicel,peduncle,per,petiole,projection,pubescent,purple,rachi,raised,rounded,seed,semitransparent,staman,style,surface,two-celled,unbranched,unit,upper,usually,wall,white,x,yellow	0.75-3,1,1-3,1-7,abaxially,abundant,adaxiall,adaxially,along,appressed,axe,blade,closely,common,connected,cordate,curved,dehiscing,dense,denser,eaf,eed,emarginat,explosively,flat,flattened,frui,geminat,growt,held,interpetalar,larger,long,longer,lower,lying,maturit,mesocarp,near,new,nfloresence,notch,oblong,older,orolla,placenta,pressure,pubescen,rotate,ruit,shorter,slightly,small,smaller,sometimes,sparsely,stamen,stigma,straight,tal,tamen,tem,tissue,triangular,tube,twisted,vary,vein,watery,wid,woody,ympodial	abaxial,adaxial,arrangement,branching,characteristic,colour,corolla,form,geminate,height,inflorescence,leaf,length,ovary,plant,shape,stem,sympodial,texture,type
512	wfo-0001032176	success	177	96	68	109	28	0.384	.5,0.5,0.5-0.7,0.5-0.75,0.8-6,1-1.2,1-10,1.5-1.6,1.5-2.5,1/2,3-3.5,3-4,6,6-10,7,anther,apex,apical,attenuate,axillary,base,berry,branched,calyx,cm,conical,corolla,densely,diameter,elliptic,filament,glabrous,green,greenish,grey-brown,greyish,herb,leaf,lobe,long-papillose,lower,margin,mm,obtuse,occasionally,onto,ovary,ovoid-reniform,pale,pedicel,petiole,pinnate,projection,pubescent,quadrate,rachi,rounded,seed,sinuous,sparsely,stem,style,thickening,vein,white,winged,without,x	0,0.42,0.5-1,0.8-1,1.5-6,100,2-3,2.5-10,3-15,3-7,5-6-celled,adaxially,adhering,along,anthesi,apart,arising,attaining,axil,basal,beak,becoming,capitat,cateniform,cell,containing,copiously,creeping,cucullate,denser,drying,eaf,edicel,eed,ellipsoid,epidermal,equal,especially,exserted,fallen,filiform,flower,free,fruiting,globose,hangin,inflorescenc,lateral,leaflet,lengt,lengthening,like,lobed,log,long,minute,minutely,nearly,nflorescence,nodding,node,obovate,often,open,pair,papillose,per,petiolule,pore,poricidal,portion,reflexed,rest,rooting,ruit,scar,separate,simple,single,size,slightly,slit,smaller,somewhat,soon,spaced,stigma,strait,strongly,tem,terminal,tightly,time,tip,tree,trichome,truncate,trunk,tub,tube,ud,ultimate,unevenly,unifoliat,uniseriate,unit,wall,whit,ympodial	abaxial,adaxial,arrangement,branching,characteristic,colour,form,fruit,growth,height,history,inflorescence,length,life,midvein,na,peduncle,perennial,plant,primary,pseudostipule,shape,staman,surface,tertiary,texture,unarmed,venation
513	wfo-0001032187	success	139	105	84	55	21	0.604	-4,-4.2,-5,-9,0.1â1.4,0.5,0.5-,0.5â1,0.6â1.3,1.1â3.2,1.3â1.8,1.6â2.1,1.8â2,1.8â2.8,100,22,3.1â3.5,3â3.2,3â4,5â7,7â11,9,acuminate,acute,adherent,anther,apex,appressed,aromatic,base,berry,blade,broadly,brown,brownish,cm,corolla,dark,dull,eglandular,elliptic,entire,equal,erect,filament,glabrescent,globose,green,hair,herb,hooked,leaf,light,lobe,long,margin,mature,mm,numerous,obovate,occasionally,ovate,pedicel,peduncle,per,persistent,petiole,plant,purple,simple,soft,sometimes,spreading,stem,straight,style,sub-glabrous,texture,tinged,triangular,truncate,yellowish,Â±,Â±1	-11,-2.1,1â1.7,24.6â26.3,2â9,5-merous,alyx,angular,ape,branch,changing,consisting,cyme,di-foliate,dia,eaf,eed,flowered,forked,fully,geminat,granule,hite,hydrated,lower,many,marked,nflorescence,penden,pentagonal,perfec,petiolate,pollen,predominantly,presen,protruding,rarely,ridge,ruit,running,sclerotic,short,small,sparse,stage,stellate,tooth,unit,well,widest,wing,yellow,ympodial,Âµm,Ã	arrangement,branching,calyx,characteristic,colour,diameter,form,fruit,glabrous,growth,height,inflorescence,length,pendent,seed,shape,surface,type,white,width,â
514	wfo-0001032206	success	216	118	97	119	21	0.449	0.8â1.2,1.1â1.2,1.5â2.5,11â22,1â2.3,1â3,2.5â3.3,2.7â3.5,2â2.5,3.5â9,3â4,4.5â5.8,4â6,5â6,5â9,7â10,abaxially,acute,adaxially,anther,apex,apparently,approximately,armed,articulated,base,berry,branched,calyx,clearly,cm,cream,cuneate,dark,deltate,diameter,elliptic,erect,filament,flattened-reniform,foliaceous,fruit,glabrescent,glabrous,green,green-brown,lateral,leaf,length,lobe,lobed,long,long-styled,margin,marking,maturity,mauve,midvein,mm,moderately,obtuse,orange-brown,ovate,pair,pale,pedicel,peduncle,pendent,petiole,plant,primary,purple,rarely,ray,short-styled,shrub,sometimes,spherical,stellate,stellate-pubescent,stem,style,surface,tertiary,toward,trichome,truncate,unarmed,usually,vein,venation,visible,weakly,white,yellow,yellow-orange,young	-0.8,-2,-20,-5,..,.2,.5,0,0.2,0.2â0.4,0.2â0.5,0.5â1,00â200,0â20,0â30,0â5,1,1.2â2.2,1.5â2,1/3,1/4â1/2,1/4â1/3,1/6,10â80,1â2,1â4,2â3,2â8,30â80,5-merous,5â15,5â20,5â8,6â10,6â15,6â8,8â20,accrescent,alyx,andromonoecious,apar,apart,apically,bark,blade,bluntly,broad-deltate,brow,chartaceous,concolorous,connivent,covering,curved,discolorous,distal,distance,drying,eaf,eed,equal,extending,flattened,flower,free,fruiting,functionally,gently,hermaphroditic,heterostylous,infructescence,lengt,lobing,longer,lowermost,mal,mature,midpoint,nflorescence,often,older,one,open,orolla,ower,pendulous,per,pericarp,plurifoliat,poricidal,porrect,portion,prickle,reflexed,scar,secondary,sessile,side,slender,smooth,spaced,sparsely,spreading,stalk,stalked,stout,straight,tamen,tapering,time,tip,tube,uit,ung,unit,variously,vary,wide,woody,ympodial	0.5â1.5,abaxial,adaxial,arrangement,branching,characteristic,colour,corolla,form,growth,height,inflorescence,ovary,plurifoliate,seed,shape,specified,staman,texture,type,width
515	wfo-0001032209	success	257	112	97	160	15	0.377	-30+,0.5-1,1-1.5,1-6,1.5-6,10-13,2-3,2-5,2/3,20-30,3-7,4-20,5-8,6-8,acute,adaxial,along,anther,apex,appearing,arching,basal,base,berry,blue,branched,broadly,calyx,cell,cm,colour,conical,conspicuously,cordate,corolla,dendritic,densely,diameter,ecuador,elliptic,entire,evenly,filament,flattened-reniform,glabrous,globose,growth,hairy,inflorescence,lamina,lateral,leaf,length,like,lobe,margin,metallic,midvein,minutely,mm,narrowly,ovate,pair,pedicel,peduncle,per,petiole,pinnatifid,primary,puberulent,pubescent,purple,red,rest,several,shiny,simple,sometimes,somewhat,stem,style,surface,terminal,testa,time,tiny,trichome,truncate,uniseriate,vein,vine,violet,w,wall,white,woody,x	-11,-20,.5,0.3,0.5,1,1-2,1-2-celled,1.5,1.5-,1.5-2,1.5-2.5,100,12-16,2,2-3-lobed,2.5-,3-9,4,5-merou,6-15,absent,ag,alyx,anthesi,apart,apiculae,apparently,ark,articulated,axi,berr,bilobed,branch,brown,bu,canopy,capitate,cast,chartaceous,climbing,connivent,coriaceous,cucullat,dark,deeply,deltate,denser,distally,distinct,dried,eaf,early,eed,ellipsoid,enlarged,equal,erect,especially,exerted,finely,fleshy,flower,flowering,free,fruiting,geminat,giving,glabrescen,groove,hanging,hastate,held,hollow,ilament,keeled,large,leathery,leaving,lengthening,less,lobed,long,longer,longest,lower,markedly,material,mean,mere,middle,midrib,minute,mixture,near,nearly,new,nflorescence,nipple,occasionally,often,older,one,orolla,papillae,papillat,papillate,part,particularly,peg,pentagonal,perfect,pericarp,pinnately,planar,plurifoliate,pointed,pore,poricidal,portion,probably,pubescence,reddish,rhachi,rim,ripe,ruit,sagittate,scar,sleeve,slit,small,spaced,sparser,spreading,stellate,stigma,stout,tapering,tem,testal,thin,third,tightly,tip,tube,twinin,twining,ud,unequal,unit,upper,usually,variable,vary,weight,widest,within,yellow,ympodial	abaxial,arrangement,branching,characteristic,form,fruit,na,ovary,pseudostipule,rachi,seed,shape,staman,texture,unarmed
516	wfo-0001032232	success	137	107	85	52	22	0.62	.5,0.25,0.5,0.5-1,0.6-3,0.8-1,1-3,1.8-2,18.8-27.5,2,2-2.6,20-100-flowered,4.8-7.3,5-6,abruptly,age,anther,attenuate,bark,base,becoming,berry,calyx,clavate,cm,corolla,dark-papillose,decurrent,deflexed,dia,distally,elliptic,erose,filiform,fruiting,glabrous,globose,green,greenish-brown,irregular,leaf,lenticellate,less,light,lightly,lobe,long,margin,minute,minutely,mm,narrowly,node,occasionally,onto,ovary,ovoid-reniform,pair,pale,paler,papillose,pedicel,petiole,pitted,prominent,raised,revolute,rounded,shrub,simple,slightly,somewhat,sparsely,stem,stigma,straight,style,subshrub,surface,tip,tube,undulate,vein,widening,winged	0.1,3/4,?,anthesi,apex,ba,closely,cup-shaped,eaf,edicel,eed,erect,evenly,exfoliatin,filament,flower,free,immature,lateral,lobed,long-acuminate,lower,main,middle,midrib,nflorescence,opposite,overlappin,packed,papillo,pore,poricidal,portion,reflexed,ruit,scar,shaped,short-styled,tall,tear-drop,ti,translucent,tub,ud,umbonate,unifoliat,unit,way,wide,widest,woody,ympodial	arrangement,characteristic,colour,diameter,exfoliating,form,fruit,growth,height,inflorescence,length,midvein,peduncle,plant,primary,seed,shape,sparingly,texture,type,unifoliate,width
517	wfo-0001032233	success	160	122	100	60	22	0.625	0.3-2,1-1.5,1-2,1-3,1.5-2.5,10-15,157,2-15,2-3,2-5.5,2-6,2.5-4,20-100+,3-15,3-4,3-4.5,3-5,3.5-4,4-5,4-7,5-6,abaxially,acuminate,acute,adaxial,almost,apex,articulated,basal,base,bent,branched,calyx,chartaceous,cm,connective,connivent,convex,cordate,cylindrical,dark,densely,diameter,dilated,distally,ellipsoidal,entire,exceeding,flattened,fleischmann,fleshy,flower,fruit,glabrate,glabrescent,glabrous,glandular-puberulent,globose,green,leaving,lobe,long,longitudinal,margin,mm,moderately,oblong,obtuse,orange,ovate,ovoid,pedicel,pedicellar,peduncle,petiole,projection,puberulent,pubescent,purple,radiu,remnant,shallowly,simple,slightly,sparsely,stigma,stripe,style,subcoriaceous,subpeltiform,thecae,tip,tree,triangular,truncate,unbranched,white,x,yellow,yellow-green	0-2,2-4,25-40,4-18,4-foliat,5-16,6-25,8-12,absen,absent,adaxially,aggregate,apart,ape,axe,beyond,biglandula,blade,brow,cell,coriaceous,directed,eaf,eed,equal,especially,exserted,laterally,lon,lower,narrowly,nflorescence,nther,orolla,perfect,pore,present,puberulen,rachise,ruit,shorter,small,somewhat,spaced,stamen,stellate,stone,tal,tem,time,tomento,toward,tube,ud,unit,vary,vein,wide,yellow-orange,ympodial	abaxial,anther,arrangement,biglandular,bud,characteristic,colour,corolla,form,growth,height,inflorescence,leaf,length,ovary,plant,rachi,seed,shape,stem,surface,texture
518	wfo-0001032259	success	202	109	91	111	18	0.45	.5,0-2,0-20,0-4,0.45-0.6,0.5-1.5,0.7-1.1,0.9-1.2,1-2.5,1.5-4.5,10-30,2-2.5,2.2-3,20-60,3-4,5.5-8,abaxial,acute,adaxial,almost,anther,apex,apically,apparently,articulated,base,becoming,berry,branched,brown,brownish,calyx,cm,cordate,cuneate,dark,deltate,densely,diameter,difoliate,dull,evenly,filament,flattened-reniform,flower,fruit,geminate,glabrous,green,hair,lateral,leaf,length,lobe,lobed,long,lower,margin,maturity,mauve,mm,orange,orange-brown,ovate,pedicel,peduncle,per,petiole,prickle,prickly,pubescent,recurved,red,shrub,smooth,sparsely,stellate,stellate-pubescent,stem,style,surface,terminal,toward,trichome,unarmed,unit,white,wide,yellow,yellow-green,young	-4,/3,/4,0,0-10,0-5,0.1-0.2,0.1-0.3,0.15-0.3,0.5-0.8,0.8-1.3,1-1.8,1-2,1/2,1/3,1/4-1/3,1/6-1/5,15-40,2-4,2-5,3/,4,4-5,4-6,4-9,5,5-30,5-merous,7-16,7-8,9-22,abaxially,acut,alyx,apar,apart,bark,blade,broad-deltate,chartaceous,conical,connivent,discolorous,distance,drying,eaf,eed,elongating,equal,erect,extending,flattened,free,fruiting,fully,glabrescent,gland,green-brow,infructescence,longer,mature,midpoint,midvein,minute,moderately,nflorescence,older,one,open,opening,orolla,oung,pair,pendulous,perfec,pericarp,poricidal,porrect,portion,prickl,primary,ray,reduced,rounded,ruit,scar,sessile,shorter,side,simple,slender,sometimes,spaced,spherical,spreading,straight,strongly,tamen,tapering,terete,tertiary,time,tip,tube,vary,vein,venation,visible,way,woody,ympodial	3/4,branching,characteristic,colour,corolla,form,growth,height,inflorescence,na,ovary,plant,seed,shape,staman,sympodial,texture,type
519	wfo-0001032260	success	216	123	102	114	21	0.472	-1.5,-10,-8,0-,0-10,0-20,0-5,0-8,0.5-2,0.6-0.8,0.7-1.5,0.8-1.1,1-1.7,1-5,1-6,10-30,2,2-20,2.5-3,2.5-3.5,3-5,3-9,6-10,abaxial,acuminate,acute,adaxial,anther,apex,apically,apparently,articulated,base,berry,branched,calyx,cell,cm,cuneate,deltate,densely,diameter,dull,elliptic,erect,eye,filament,flattened-reniform,fruit,glabrous,glaucous,green-brown,infructescence,lateral,leaf,length,lobe,lobed,long,margin,maturity,mauve,midvein,mm,naked,orange-brown,outline,ovate,pair,pale,pedicel,peduncle,per,petiole,pit,prickle,prickly,primary,pubescent,purple,raised,red,rounded,shallowly,shrub,simple,small,sparsely,spherical,stellate-pubescent,stem,style,subentire,surface,terminal,tertiary,vein,venation,visible,wide,yellow,yellow-green	-0.5,-3,.1,/5,0-0.5,0.1,0.1-0.3,0.1-0.4,0.15-0.3,0.2,0.2-0.5,0.4,0.5-0.8,0.5-5,0.7,1-3,1.2-1.7,1.5-4,1/2,1/3,1/3-1/2,1/3-1/5,2-4,2-5,2.5,3-10,3-8,4-,5-,5-20,5-merous,6-8,7-15,abaxially,acuminat,alyx,apar,apart,bark,blade,broad-deltate,chartaceous,connivent,curved,difoliate,discolorous,distance,drying,eaf,eed,elongating,equal,extending,flattened,flower,free,fruiting,geminat,glabrescent,glabrou,gland,globular,gray-brow,lon,long-styled,longer,lower,mature,midpoint,moderately,narrow-ovate,nflorescence,older,one,open,orolla,oung,pendulous,perfec,pericarp,poricidal,porrect,portion,prickl,ray,reduced,reflexed,ruit,scandent,scar,sessile,shorter,side,slender,smooth,spaced,spreading,stalk,stalked,stellate,strongly,tamen,tapering,terete,time,tip,trichome,tube,unit,variously,vary,way,woody,ympodial	arrangement,branching,characteristic,colour,corolla,form,growth,height,history,inflorescence,life,na,ovary,plant,pseudostipule,rachi,seed,shape,staman,texture,unarmed
520	wfo-0001032264	success	183	98	68	115	30	0.372	0.5-1,0.6-2.2,0.8-10,1-1.5,1.2-2,1.5-1.8,10-22,3,3-15,4.5-5,acuminate,acute,anther,apex,apiculate,base,branched,broadly,calyx,cm,corolla,deflexed,densely,elliptic,filament,flattened-reniform,glabrous,globose,green,inflorescence,leaf,lobe,margin,minutely,mm,narrowly,occasionally,ovary,pair,pale,pedicel,petiole,pitted,plant,pubescent,red-papillose,reddish-tan,revolute,rounded-deltoid,several,shrub,simple,slender,sparsely,stem,straight,style,surface,tapering,time,tree,trichome,tube,uniseriate,vein,white,x,yellowish-brown	.2,.5,0.25-0.5,0.25-0.75,0.8-4,1.8-3,2-50-flowered,2-6,3-9,5-9,6-17,along,anthesi,apar,appearing,ba,bark,berry,bud,bullate,cell,cell-layer,closely,cup-like,curling,deciduous,dia,differing,difoliate,dry,eaf,edicel,eed,epidermal,exserted,fleshy,flower,free,fruiting,geminat,gnarled,greyi,habitat,hair,incrassate,lamina,large,larger,lateral,layer,like,live,lobed,lon,long,lower,main,major,material,middle,minor,minute,multiseriate,nearly,nflorescence,often,older,one,opposite,overlapping,ovoid,papillo,papillose,parallel,peeling,planar,pointed,pore,poricidal,portion,primarily,prominent,quite,raised,reddish,ruit,scar,scattered,shaped,sheet,sheltered,short,size,small-capitate,small-celled,somewhat,soon,spaced,stigma,tall,tear-drop,thick,tip,transversely,trunk,ud,unit,upper,weak,whitish,wide,widest,woody,ympodial,young	0.5,4,4-8,abaxial,adaxial,arrangement,branching,characteristic,colour,diameter,form,fruit,growth,height,history,length,life,midvein,na,peduncle,primary,pseudostipule,rachi,seed,shape,staman,tertiary,texture,unarmed,venation
521	wfo-0001032274	success	192	108	84	108	24	0.438	0,0.15-0.2,0.5-0.7,0.5-1,0.5-1.5,0.7-1.8,1-1.2,1-1.5,1-3,2,2-7,3-4,5-7,acuminate,acute,anther,anthesi,apex,arching,axillary,base,berry,brown,calyx,cm,corolla,deltate,densely,diameter,elliptic,entire,filament,filiform,flattened-reniform,glabrous,globose,green,grey,growth,inflorescence,lanceolate,leaf,lobe,long,margin,minutely,mm,nodding,occasionally,often,once-branched,pair,pedicel,peduncle,per,petiole,pitted,plurifoliate,primary,pubescent,purple,quadrate,red,reddish,ripe,rounded,shape,shiny,shoot,short,shrub,simple,sometimes,sparsely,stem,style,surface,terminal,tinged,truncate,vein,violet,white,x	.5,0.5,0.9-1,1.5-2,2-3.5,3-10,3-5,3-6,3/4,5-merou,<,ag,alyx,apiculate,apparently,appearance,ark,articulated,ba,basal,borne,branch,capitate,cell,clustered,conical,connivent,dendritic,distal,eaf,eed,ellipsoid,exserted,fleshy,flower,free,fruiting,geminat,glabrou,group,highly,ilament,irregular,lax,lengthening,less,like,lobed,loosely,lower,markedly,membranous,minute,new,nflorescence,non-reproductive,obtusely,older,one,orolla,pale,papillo,peg,pendan,perfect,pericarp,platfor,platform,pore,poricidal,portion,puberulent,reflexed,reproductive,ridge,ridged,ruit,scar,size,sleeve,slit,small,somewhat,square,stellate,stigma,strongly,suckering,tem,testal,thin,tip,trichome,tube,twinin,two,ud,uniseriate,unit,upper,usually,variable,vary,visible,way,woody,yellow,ympodial	abaxial,adaxial,arrangement,branching,characteristic,colour,form,fruit,height,history,length,life,midvein,na,ovary,plant,pseudostipule,rachi,seed,staman,tertiary,texture,unarmed,venation
522	wfo-0001032276	success	152	95	61	91	34	0.401	-,0.25-1.5,0.3-1,0.8-1,1,1-1.5,1-2,2-2.5,3-3.5,3-6-flowered,5-7,7-8,acute,anther,apex,attenuate,base,brown,calyx,cm,corolla,dark,deltoid,dia,elliptic,filament,filiform,glabrous,globose,green,leaf,lobe,long,long-pubescent,margin,minutely,mm,narrowly,ovary,ovoid-reniform,pair,pale,pedicel,petiole,pitted,plant,pubescent,shrub,simple,sparsely,stem,style,surface,tapering,triangular,unifoliate,vein,white,winged,x,yellow	.25,.5,0.5-0.75,0.5-1,1.8-2,2.5-4,9-18,along,anthesi,apart,ba,bark,beneath,blade,broadly,capitat,converging,cup-shaped,curly-tipped,decurrent,deflexed,densely,dry,eaf,edicel,eed,ellipsoid,evenly,except,exserted,free,fruiting,geminate,greyish-gree,lamina,later,lateral,like,lobed,lower,main,material,middle,minute,nearly,nflorescence,node,non-reproductive,obovoid,occasionally,older,onto,opposite,papillose,perhaps,pore,poricidal,portion,prominent,raise,raised,reflexed,remaining,rest,ruit,scar,shaped,short,slender,slightly,somewhat,soon,spaced,stigma,straight,straw-colored,strongly,tall,tear-drop,tip,trichome,tub,tube,ud,uniseriate,unit,widely,widest,woody,ympodial,young	0.25,0.5,2,3,8,abaxial,adaxial,arrangement,branching,characteristic,colour,diameter,form,fruit,greyish-green,growth,height,history,inflorescence,length,life,midvein,na,peduncle,primary,pseudostipule,rachi,seed,shape,staman,tertiary,texture,unarmed,venation
523	wfo-0001032277	success	163	83	62	101	21	0.38	0.2-0.6,0.8-3,1-1.1,1-1.5,1-2,1.5-1.8,2-4,2-6-flowered,3-3.5,5-6,8-9,acute,anther,base,berry,bright,calyx,cm,coriaceous,corolla,cup-shaped,deltoid,densely,elliptic,flattened-reniform,fruit,glabrous,globose,green,immature,inflorescence,lax,leaf,lobe,long,margin,minutely,mm,ovary,pale,pedicel,petiole,pitted,pubescent,revolute,ripe,shrub,simple,slender,sparsely,stem,straight,style,surface,translucent,trichome,tube,uniseriate,white,x,yellow,yellowish-tan	.5,0.1-0.5,0.75-1,1-1.2,1-5,1/2,10-14,2-2.5,3-9,along,anthesi,apex,apiculate,appear,appearing,area,auriculate,ba,bark,beneath,blade,blunt,branched,closely,dia,drooping,dry,eaf,edicel,eed,ellipsoid,erect,exserted,filament,free,fruiting,geminat,gre,impressed,incrassate,indentation,internodal,lateral,like,lobed,lower,main,mature,middle,nflorescence,number,obscured,occasionally,older,opposite,overlapping,pair,paler,papillae,papillose,partially,pore,poricidal,portion,prominent,puberulent,pubescenc,raised,reddish,remaining,rest,round,rounded,ruit,scar,slende,small,spaced,specimen,spicy-fragrant,stigma,strict,strongly,styl,tall,tapering,tip,truncate,trunk,tub,two,ud,unit,varying,vein,virgately,way,widest,woody,ympodial,young	abaxial,adaxial,characteristic,colour,dense,diameter,form,growth,hair,height,history,length,life,peduncle,perennial,plant,pubescence,seed,shape,texture,type
524	wfo-0001032304	success	249	171	149	100	22	0.598	.9-1.4,0-120,0.2-0.3,0.3-1.5,0.5-3,0.5-4.5,0.9-1.3,1.1-2,1.2-2.3,1.2-3,1.3-2.1,1.5-3.2,1.6-1.9,1/2,1/8,10,18,2-5,2.5-19.5,2/3-3/4,3-15,3-20,3-6,3.2-3.8,3.2-5.5,4-7.5,7.5-12,9-13,abaxially,acuminate,acute,adaxially,anther,apart,apex,articulated,base,becoming,berry,blackish,branched,broadly,brown,brownish,calyx,closely,cm,conical,continued,corolla,dark,deltoid,dendritic,dendritic-echinoid,densely,diameter,directed,distal,due,echinoid,elliptic,entire,exserted,filament,fleshy,flower,fruit,glabrescent,granular-tomentose,green,greenish,growth,hair,honeycombed,lateral,leaf,length,lobe,long,long-,long-attenuate,long-stalked,many,many-rayed,margin,midvein,mixed,mm,mostly,multangulate,obtuse,occasionally,ovate,pale,partly,pedicel,peduncle,petiole,plant,plurifoliate,porrect-stellate,probably,pseudo-terminal,pubescent,rachi,rarely,rather,ray,reniform,reticulate-punctate,ripe,scabridulous,seed,sessile,short-,short-stalked,shrub,side,simple,small,spaced,sparingly,stamen,stellate-tomentose,stem,style,subglobose,suborbicular,terete,testa,thick-stalked,thin-,time,tomentose,toward,tree,triangular-ovate,tube,unarmed,vein,velutinous,violet,way,white,whitish,x,yellow,yellowish,young	-3,.6-1.2,/20,1,1-3.5,1.8-4,1/3-1/2,1/5,2-4,2-4.2,21,3-10,3-4.5,44,5-6,5.5-9,7-27,accrescent,ag,along,anthesi,apical-lateral,apparently,appressed-tomentose,ascending,axe,axillary,ba,bark,blade,blunt-tipped,branch,bud,campanulate,capitat,chartaceous,decurrent,dehiscing,dendritic-echinoi,eaf,echinoi,especially,extend,few-,few-rayed,free,fruiting,glabrescen,glabrous,high,inserted,introrse,juvenile,large,least,lobed,longitudinal,lower,m.,main,multangulat,nflorescence,oblong,obscured,often,older,opaque,orbicular,orolla,ovat,ovate-lanceolate,overlapping,perfect,pore,present,relatively,rotate-stellate,ruit,runk,short,slit,somewhat,spreading,stigma,strongly,sulcate,suture,tamen,thick,thin,thin-stalked,tomentu,touching,unarme,unit,usually,vary,wide,within,ympodial	abaxial,adaxial,arrangement,branching,characteristic,colour,form,height,history,inflorescence,life,na,ovary,primary,pseudostipule,shape,staman,surface,tertiary,texture,venation,ye
525	wfo-0001032307	success	153	95	74	79	21	0.484	0.2-0.5,0.4-1.3,1-1.5,1-2,1.5-2,1.5-5,10-20,2-5,2.5-12,2.5-3,2.5-3.5,3.5-4,4-8,5-25-flowered,abaxial,acute,adaxial,anther,apex,base,berry,branched,calyx,cm,corolla,deltate,dendritic,densely,dia,elliptic,erect,filament,flattened-reniform,glabrous,globose,green,growth,incrassate,inflorescence,later,lateral,leaf,lobe,long,many,margin,minutely,mm,ovary,pair,pale,pedicel,petiole,pitted,plant,prominent,pubescent,reddish,reddish-brown,shrub,small,sparsely,stem,style,surface,tan,terminal,time,tree,trichome,truncate,vein,white,wide	.5,/3,30,5-12,7-18,?,along,anthesi,apar,bark,blade,body,branch,brow,campanulate,capitate,christmas-tree-like,congested,dark,eaf,edicel,eed,either,ellipsoid,elongate,exserted,flat,fleshy,free,fruiting,glabrate,immature,inflorescenc,like,lobed,lon,loose,lower,main,middle,minute,new,nflorescence,older,papillae,papillo,petal,planar,plurifoliat,pore,poricidal,portion,rest,ruit,scar,shaped,spaced,stigma,stout,strongly,tall,tear-drop,thick,thickened,tip,tree-like,tub,tube,type,ud,unevenly,upper,variable,way,widest,within,woody,ympodia,young	arrangement,branching,characteristic,colour,diameter,form,fruit,height,length,midvein,na,peduncle,plurifoliate,primary,pseudostipule,rachi,seed,shape,staman,texture,unarmed
526	wfo-0001032308	success	190	110	90	100	20	0.474	0.7-1,0.7-1.2,1-10,1-2,1.5-2.5,1.8-2.5,1.9-3,2,2-4,3-10,3-6,4-7,5-7,6,8-9,acumen,anther,apart,axillary,base,berry,broadly,brownish,bud,clavate,cm,condition,connivent,cordate,corolla,cuneate,deep,diameter,distal,drying,elliptic,filament,flower,forked,fresh,fruit,generally,glabrous,globose,green,green-white,greenish,hair,half,homostylous,irregular,lanceolate,leaflet,lobe,lobed,long,margin,medium,mm,mucilaginous,orbicular,ovate,ovoid,pedicel,peduncle,pentagonal,petiolule,plant,pubescent,pure,ripe,rounded,seed,sessile,shape,slightly,stigma,straight,style,substellate,subtending,sympodial,terminal,throughout,truncate,usually,wet,white,whitish,yellow	0-3,0.2-2.1,0.3-5,12-16,2-3,2-6,3.8-5,4-8,4.8-7.7,5-merou,6-11,abaxially,absent,acute,adaxially,ag,along,alyx,apex,apparently,articulated,axe,blade,capitat,cell,chartaceous,ciliate,covering,digestion,dorsally,dot,eaf,edge,eed,enzyme,especially,exceeding,flat,folded,geminat,glabrou,greatly,hair-like,hal,honeycomb-shaped,interjected,invested,larger,lateral,leave,lengthening,like,living,lower,make,membranous,midrib,minute,minutely,much,narrowly,nflorescence,non-glandular,obtuse,odd-pinnate,often,orolla,pair,perfect,petiole,petiolulate,plurifoliate,pore,poricidal,puberulent,removed,ruit,scattered,seudostipule,short,slit,spaced,specimen,stamen,ste,stem,tamen,testal,thick,tip,tri-,trichome,tube,typically,unit,vary,varying,wall,wide,x	abaxial,arrangement,calyx,capitate,characteristic,colour,form,growth,inflorescence,leaf,length,ovary,pinnate,pseudostipule,spacing,staman,surface,texture,type,width
527	wfo-0001032335	success	215	94	71	144	23	0.33	12â15,1â1.2,1â1.5,1â3,2.5â3,2â5,4â14,5â6,6â6.5,abaxial,abaxially,acuminate,acute,adaxial,anther,anthesi,apex,attenuate,base,berry,branched,branching,bright,calyx,chartaceous,cm,corolla,deltate,densely,diameter,elliptic,entire,filament,flattened-reniform,globose,golden-yellow,growth,inflorescence,length,lobe,many,margin,membranous,minutely,mm,narrowly,nodding,orange,pair,pale,pedicel,peduncle,petiole,pitted,plane,primary,pubescent,shrub,simple,small,somewhat,stem,stout,style,surface,terminal,time,tree,vein,white,â4	'',.2,.5,0,0.05,0.2,0.2â0.3,0.4,0.5,0.5â1,0.9â1,1.5â2,100,100+,10â12,15,16,2â10,2â2.5,3361,4â5,4â6-rayed,5-merou,6â19,7â10,>,ag,along,alyx,apar,appearing,ark,articulated,axe,beneath,boh,c.,capitate,cell,center,closely,connivent,covered,cup-shaped,dichasia,discolorous,drying,eaf,eed,ellipsoidal,elongate,equal,erec,evenly,exserted,fide,flower,free,fruiting,fused,glabrous,gold,golden-brow,gradually,half,ilament,impressed,lamina,lengthening,less,like,lobed,long,loosely,lower,markedly,midpoint,minute,moderately,multangulate,narrowing,near,new,nflorescence,older,onto,orolla,papillo,part,peltate,per,perfect,pericarp,persistent,plurifoliate,pore,poricidal,porrect,porrect-stellate,portion,pubescence,ray,reddish,reflexed,regularly,ripe,ruit,scar,scurfy,sessile,shiny,short,short-stalked,silvery,slightly,slit,sometimes,spaced,sparsely,square,stellate,stigma,strongly,stub,tal,tem,testal,thin,tip,trichome,tube,ud,unevenly,unit,upper,vary,varying,visible,way,wide,woody,yellow,ympodial,âstellate	arrangement,characteristic,colour,dichasial,form,fruit,height,history,leaf,life,midvein,na,ovary,plant,pseudostipule,rachi,seed,shape,staman,tertiary,texture,unarmed,venation
528	wfo-0001032337	success	225	131	106	119	25	0.471	0.4-1.5,0.5-3.5,1-2,1.2-2.8,1.5,1.6-4,2,2-3.5,2.3-11.5,3-8,3.6-5,4-17,4-6,8-10,abaxially,acuminate,acute,adaxially,anther,apex,apiculate,attenuate,base,basiscopic,berry,broadly,brownish,canescent,cell,chartaceous,cm,condition,corolla,covering,cuneate,darker,decurrent,deep,densely,diameter,dot,drying,elliptic,filament,fresh,fruit,glabrous,globose,green,green-white,greenish,hair,hair-like,herb,lateral,leaf,light,like,lobe,long,make,margin,membranous,mm,mottled,mucilaginous,oblique,obtuse,odd-pinnate,often,ovate,ovoid,pedicel,peduncle,petiole,plant,pubescent,purple,rarely,ray,ripe,rounded,scattered,seed,short,side,sometimes,sparsely,stem,style,subglabrous,tertiary,testal,thick,throughout,tissue,typically,unwinged,violet,violet-purple,wall,wet,white,whitish,wide,wing	0,1,1-10,1-4,1.4-2,10,2-14,2-4,2-4.5,2-7,2.3-4.8,3-4,4-9,4.5-14.5,5-11,5-merou,8-17,9-21,9-29,acumen,ag,along,alyx,apart,apparently,articulated,axe,axillary,blade,borne,bud,capitat,ciliate,clavate,connivent,cordate,digestion,distal,dorsally,eaf,edge,eed,end,enzyme,erec,especially,exceeding,except,flat,flower,folded,forked,frequently,geminat,generally,glabrou,greatly,half,homostylous,honeycomb-shaped,interjected,lanceolate,leaflet,lengthening,living,lower,middl,midrib,minutely,nflorescence,orbicular,orolla,pair,paired,pentagonal,perfect,petiolulate,petiolule,plurifoliate,pore,poricidal,proximal,puberulent,reduced,removed,rotate,ruit,sessile,seudostipule,singly,size,slightly,slit,small,spaced,specimen,stamen,ste,stigma,stolo,straight,subequal,subsessile,subtending,tall,tamen,tem,terminal,tip,tri-,tube,tuber,unit,unpaired,usually,vary,x,yellow,ympodial	abaxial,adaxial,arrangement,branching,calyx,characteristic,colour,form,growth,height,inflorescence,length,midvein,na,ovary,primary,pseudostipule,rachi,shape,staman,surface,texture,unarmed,vein,venation
529	wfo-0001032344	success	157	84	68	89	16	0.433	0.2-0.5,1-4,1.5-4.5,1.5-6,10-29,2-2.8,3-5,3-8.5,3-9,3.5-6.5,4-8,5-10,acute,bluish,branched,broadly,calyx,cell,cm,corolla,covering,cyme,dark,diameter,dichasial,dichasially,dot,ebracteate,elliptical,globose,green,hair-like,herbaceous,lateral,leaf,leaflet,lobe,long,long-attenuate,medium,mm,monochasial,odd-pinnate,often,ovate,ovoid,pair,pedicel,peduncle,perennial,petiole,plant,puberulent,pubescent,purple,rotate,rotate-pentagonal,seed,smooth,style,terminal,testal,thick,tuber-bearing,violet,wall,white,yellow	1-1.3,1-3,1.6-2.4,2-3,2.2-4,2.8,3-6-foliat,3-7,4-11,6-15,9.5-21,abaxially,abruptly,absent,acumen,acuminate,adaxially,apex,apical,apically,articulate,base,belo,connate,cuneate,decurrent,dehiscent,digestion,diminishing,distal,dorsally,eaf,edge,eed,emoval,enzyme,exceeding,filament,flower,forked,generally,globo,green-white,half,honeycomb,inrolled,interjected,introrse,layeral,living,lon,lower,lunat,make,maturing,mucilaginous,nflorescence,nther,oblique,orolla,pattern,perfect,petiolule,plan,poricidally,proximal,reveal,ruit,scarce,sessile,seudostipule,short,size,slit,sometimes,specimen,stamen,stigma,straight,tal,tem,throughout,toward,typically,unit,vary,wide,ympodial,Â¼	anther,arrangement,characteristic,colour,form,fruit,growth,height,inflorescence,length,ovary,shape,stem,surface,texture,width
530	wfo-0001032354	success	171	88	63	108	25	0.368	0,0-5,1-2,1-5,2-2.5,2.5-3,3-4,38/2,acute,anther,apex,aster,axillary,base,becoming,branch,branched,broadly,brown,calyx,cm,coarsely,colour,corolla,cuneate,decurrent,deep,discoidal,filament,fork,glabrous,globose,green,greenish-ivory,greyish,leaf,lobe,maturity,minutely,mm,obovate,occasionally,ovary,ovoid,pedicel,peduncle,pinnatisect,puberulent,pubescent,rh,rounded,rugose-reticulate,shape,shrub,simple,soft,somewhat,stem,straight,style,surface,violet,wooded	0.3,0.5-1,0.8-1,0.8-1.2,1-10,1-3,10-lobed,2,25,250-400,29,4-6,40-75,5-10,5-15,acuminate,almost,angular,anthesi,aspect,axi,berry,bilobed,c.,campanulate,capitate,cell,creating,cut,deeply,dia,distal,eaf,eed,effect,ellipsoid,except,exerted,facetted,fleshy,flower,general,glandular,gre,gree,hair,halfway,lanceolat,large,lasting,lengthening,linear,lobed,lower,midrib,minute,narrow,nflorescence,obovoid,oval,ovate,pair,pale,pebble-shaped,pedicellate,plurifoliat,pore,poricidal,rather,rotate,ruit,secondary,seedling,several,shoot,single,sinus,size,slightly,slit,small,smaller,smel,sparse,spreading,stellate,stigma,stone,strongly,tall,tip,trichome,tub,ud,uniseriate,unit,unpleasant,usually,variable,vein,wide,wing,within,woody,x,year,ympodial,young	apcuminate,arrangement,branching,characteristic,diameter,form,fruit,growth,height,history,inflorescence,length,life,margin,na,perennial,petiole,plant,plurifoliate,pseudostipule,rachi,seed,staman,texture,unarmed
531	wfo-0001032358	success	216	92	72	144	20	0.333	0,0.2-4,0.5-3,0.7-1,1-2,13-20,2-3,2-5,3-4,4-4.5,4-7,4-8,4.5-5,acute,anther,apex,armed,base,berry,branched,calyx,cm,cordate,corolla,diameter,entire,filament,fruit,furcate,glabrous,globose,green,growth,inflorescence,leaf,linear,lobe,margin,membranous,midvein,minutely,mm,occasionally,orangish,ovate,pair,pale,pedicel,peduncle,per,petiole,pitted,prickly,primary,pubescent,purple,red,ripening,shrub,simple,sinuate,slightly,staman,stellate,stem,style,surface,tan,time,vein,x,yellowish	.1,.2,.3,.4,.5,/2,0.6-0.8,0.6-1,1-1.6,1.3-1.7,1.5-2,1.5-2.5,1/4-1/2,12-20,15-40,2,2-10,2-4,2.2-7.5,3-10,3.5-13,4-merous,abaxially,abscissio,adaxially,along,another,anthesi,apart,appearing,away,bark,basal,based,broad,brown,bulbous,capitate,cell,center,cupuliform,curved,densely,difoliate,dorsal,drying,eaf,eed,equal,erect,expanding,exserted,flattened,flower,free,frui,fruiting,geminate,glabrescen,glabrescent,heteromorphic,internodal,interpetalar,irregular,irregularly,lamina,left,lengthening,like,lobed,long,longer,lower,lowermost,margined,markedly,maturity,midpoint,midrib,new,nflorescence,nodding,often,older,one,ovoid,paler,papillat,papillate,part,peg,perfect,pericarp,persistent,planar,pore,poricidal,porrect,portion,present,prickle,ray,reniform,rhachi,rotate-stellate,ruffly,ruit,scar,sessile,shiny,short,short-stalked,sinus,slit,small,sometimes,somewhat,space,spaced,sparsely,spreading,stigma,strongly,thick,thin,three,tip,trichome,tub,tube,tuberculate,two,type,ud,unevenly,unisexual,unit,upper,usually,way,whitish,widely,ympodial,zygomorphic	abaxial,adaxial,arrangement,branching,characteristic,colour,form,height,history,length,life,na,ovary,plant,pseudostipule,rachi,seed,shape,texture,unarmed
532	wfo-0001032367	success	231	102	73	158	29	0.316	0-0.3,0.7-1.1,100-300,2-4,abaxial,acute,adaxial,anther,apex,axi,base,berry,calyx,cm,congested,conical,cordate,dark,densely,diameter,filament,flattened-reniform,glabrous,glandular-puberulent,globose,green,greenish,immature,inflorescence,lateral,leaf,length,light,lobe,lobed,margin,maturity,membranous,minute,mm,mottled,nearly,obtuse,ovary,ovate,pale,pedicel,peduncle,per,petiole,prickle,puberulent,pubescence,pubescent,red-brown,sessile,shrub,similar,simple,spreading,stem,style,suborbicular,surface,tightly,tip,triangular,truncate,unarmed,unbranched,vein,white,yellow	-3,.2,.4,0.2â0.35,0.4-0.5,0.4â0.5,0.4â0.6,0.4â1,0.5â0.8,0.5â2,0.6,0.6â0.8,0.8,0.8â2,1-2,1-2.1,1.2,1â1.5,1â1.8,2,2-3-celled,2.2â2.5,2.2â2.8,2.5â3,2â2.5,3-5,3-celled,3.2â4,3â10,3â5,3â6,4,4â6.5,5-merous,5.5â6.9,5â18,6-8,6.8â8.2,7â10,8,abaxially,accrescent,acicular,adaxiall,adaxially,also,alyx,anthesi,arme,around,ba,blade,branch,broad-based,capitate,connivent,copious,cream,curved,deciduous,difoliate,directed,distall,eaf,eed,enlarged,entire,equal,erect,expand,fertile,flower,free,fruiting,geminat,geminate,gland-tipped,grading,hair,herbarium,heterostylous,hyaline,infructescence,lanceolate,largest,layer,least,long,long-styled,longer,lower,lowermost,major,many,mesocarp,midpoint,minutely,mixed,mixture,moderately,narrowly,nflorescence,often,one,orolla,oung,pair,papillat,pore,poricidal,portion,prickly,rarely,ray,recurved,rest,ruit,scarcely,scattered,secondary,shallow,short-styled,shorter,size,slender,small,smaller,somewhat,sparsely,specimen,spongy,spreadin,staminat,ste,stellate,stigma,straight,tall,tamen,tapering,terete,thick,time,tooth,trichome,tube,twice,uniformly,uniseriate,unit,usually,variable,vary,whitish,wide,ympodial,â15,â5	0.5-2,0.8-2,1-1.8,2.2-2.8,3-6,5.5-6.9,6.8-8.2,armed,arrangement,branching,characteristic,colour,corolla,form,fruit,growth,height,midvein,na,plant,primary,pseudostipule,rachi,seed,shape,staman,tertiary,texture,venation
533	wfo-0001032407	invalid_json	216	142	115	101	27	0.532	0.3-0.6,0.5-3,0.8,1-2,1-2.4,1.4-2.7,1.5-2.2,10-27,2-10.5,2.5-9,3-15,4-11,4-48,4-7,5,7-9,8-10,abaxially,acuminate,adaxially,anther,apex,articulated,asymmetrical,attenuate,axillary,base,basiscopic,berry,brownish,bud,cell,chartaceous,cm,coarsely,commonly,condition,conical,corolla,covering,dark,densely,diameter,distal,drying,elliptic,elongated,filament,finely,flower,forked,fresh,fruit,generally,glabrous,green,green-white,greenish,hair,hair-like,half,herb,lateral,leaf,less,light,like,lobe,long,make,margin,membranous,middle,minute,mm,mottled,mucilaginous,narrow,obtuse,odd-pinnate,ovate,ovoid,pedicel,peduncle,petiole,plant,proximal,puberulent,pubescent,purple,rarely,ripe,round,seed,semierect,side,simple,sparsely,stem,style,subtending,symmetrical,terminal,testal,thick,throughout,tissue,usually,wall,wet,white,whitish,wide,wing,x	0-4,0.3-8,0.4-4,0.8-0.3,1-10,1-5,1.2-7,10-19.5,12,2-4,2.5-10.5,3.1-13.5,30,38,5-23,5-30,5-merou,6,absent,acumen,ag,along,alyx,apart,apparently,arranged,axe,bead,blade,capitat,ciliate,clavate,connivent,decreasing,digestion,eaf,edge,eed,enzyme,erec,especially,exceeding,folded,geminat,glabrou,gradually,homostylous,honeycomb-shaped,interjected,lanceolate,larger,leaflet,lengthening,living,lower,medium,minutely,moniliform,multiple,necklace,nflorescence,orbicular,orolla,pair,pentagonal,perfect,petiolule,plurifoliate,pore,poricidal,pubescen,ray,removed,rotate,ruit,secondary,sessile,seudostipule,size,slit,spaced,specimen,stamen,ste,stigma,stolon,straight,subequal,tall,tamen,tem,tip,tri-,tube,tuber,typically,unit,unwinged,vary,yellow,ympodial	'',2,[,``,arrangement,branching,calyx,characteristic,colour,erect,form,growth,height,inflorescence,length,ovary,pseudostipule,shape,staman,surface,texture,unarmed,value,width,{,},Â¼
534	wfo-0001032465	success	233	93	77	156	16	0.33	1-1.5,1.2-1.5,1.5-1.8,1.5-2,2-2.5,3-3.5,3-4,4,5-8,abaxial,acuminate,acute,anther,apex,base,berry,black,branched,brown,calyx,cm,cordate,corolla,deeply,deltate,densely,diameter,elliptic,entire,filament,glabrous,glandular,globose,greenish,growth,inflorescence,later,lateral,leaf,length,lobe,lobed,margin,minutely,mm,narrowly,ovate,pedicel,peduncle,petiole,pinnate,pinnatifid,puberulent,pubescent,purplish,reddish,reticulate,revolute,seed,shape,simple,sparsely,stem,style,surface,terminal,time,trichome,truncate,tube,twining,variously,vine,violet,white,woody,x	+,-10,-11,-14,-9,.2,.5,0,0.2,0.5-,0.5-2,1-,1-1.7,1-celled,1.5,1.5-5,1/3,2,2.5-5.5,25,3-5,3-8,3-9,5,5-7,5-merou,9,ag,alyx,angled,anthesi,apar,apically,appearing,ark,articulated,axi,basal,capitate,cell,ciliate,clasping,commonly,conical,connivent,coriaceous,de,decreasing,deep,deeper,distal,drying,eaf,edge,eed,ellipsoid,elongate,erect,exserte,filiform,flattened,flower,free,fringe,fruiting,glabrescen,gland,glandular-tipped,green,growing,half,ilament,included,irregular,irregularly,janeiro,larger,leaving,lengthening,like,long,loosely,lower,mature,membranous,minute,new,nflorescence,nodding,occasionally,often,older,orolla,outline,pair,paired,papillate,papillo,peg,pendan,pentagonal,per,perfect,pericarp,planar,plurifoliat,pore,poricidal,portion,primary,reniform,rio,ripe,ruit,scar,scattered,shallow,shiny,similar,sinus,size,sleeve,slit,somewhat,spaced,splitting,stellate-rotate,stigma,strongly,subshrub,tem,testal,thicker,thin,tiny,tip,toward,transparent,tuft,twinin,ud,unicellular,uniseriate,unit,upper,usually,vary,varying,vein,wall,way,widest,yellowish,ympodial,young,Â½	0.2-5,0.5,0.5-11,arrangement,bark,characteristic,colour,form,fruit,glabrescent,habit,ovary,present,texture,type,unknown
535	wfo-0001032494	invalid_json	163	101	69	94	32	0.423	.4,.5,0.8-1,0.9-1.2,1.45-1.5,1.5,1.5-8,2.5,2.5-8,8-11,acuminate,anther,apex,attenuate,base,berry,brown,calyx,cm,corolla,decurrent,filament,flattened-reniform,fruit,furcate,glabrous,globose,greenish-yellow,leaf,light,lobe,margin,minutely,mm,narrowly,occasionally,opposite,ovary,ovate,pair,pale,papillose,pedicel,petiole,pitted,prominent,raised,revolute,shrub,simple,slender,small,stem,straight,style,surface,tapering,tree,triangular,trichome,tube,uniseriate,vein,venation,white,whitish-green,winged,x,yellow	.1,0.6-1,0.75-1,1-1.5,1.1-1.2,1.6-2,1.8-4.5,16.5-20.5,2.3-2.5,3-4,3.4-14.5,3/4,4-8,5-40,5-6.4,accrescent,anthesi,apart,appearing,axil,ba,bark,beginning,beneath,bullate,clavate,deflexed,dia,differing,difoliate,dry,eaf,edicel,eed,equal,evenly,except,expanded,exserted,flowered,free,fruiting,geminat,geminate,incrassate,inflorescenc,lateral,lax,lenticellat,lobed,lon,long,lower,main,major,material,middle,minor,nearly,nflorescence,node,orange,ovoid,papillae,papillo,planar,pore,poricidal,portion,proximal,pubescent,quite,ridge,ruit,scar,shaped,size,slightly,somewhat,spaced,stigma,tall,tan,tear-drop,tip,two-winged,ud,unit,upper,way,widest,woody,ympodial,zig-zag	'',[,],``,abaxial,adaxial,arrangement,branching,characteristic,colour,diameter,form,growth,height,inflorescence,length,midvein,na,peduncle,plant,primary,pseudostipule,rachi,seed,shape,staman,tertiary,texture,unarmed,value,{,}
536	wfo-0001032507	success	206	118	83	123	35	0.403	0.5,2,6,abaxial,abaxially,acuminate,acute,adaxially,anther,anthesi,apex,apiculate,armed,articulated,base,berry,blue,branched,brown,calyx,cell,chartaceous,cm,compound,corolla,curved,diameter,distinct,elliptic,entire,fertile,filament,flattened-reniform,flower,glabrous,globose,green,hair,leaflet,light,lobe,margin,minutely,mm,occasionally,often,ovate,pedicel,peduncle,pentagonal,perennial,petiole,pinnate,pinnately,pinnatifid,pitted,present,prickle,puberulent,pulp,purple,quadrate,rachi,rarely,reddish,rounded,shape,side,simple,slender,stem,strongly,style,surface,terminal,testal,tip,unbranched,variously,vein,vine,white,Ã	.2,.5,/4,0.25,0.3,0.7-1.2,0.8,1,1.2-1.7,1.3,1.5â2,1.5â7,10â20,15â20,1â1.5,1â10,2.5â4,2.5â6,20â30,2â9,3â5,3â7,4â10,5â10,5â20,5â8,8â15,absent,abundant,adaxiall,adjacent,ag,alyx,becoming,blade,broadly,bud,campanulate,collection,confluent,connivent,cream,deep,deltate,distally,dr.,eaf,eed,either,ellipsoid,elongating,equal,exserted,fifth,flowering,four,fruiting,herbaceous,herbarium,highly,individual,internode,interpetalar,larger,lateral,lengthening,lobed,long,longer,lower,major,material,midrib,narrowly,nearly,nflorescence,oblong,observe,one,orolla,pale,papery,pericarp,pistillate,plant,plurifoliat,pore,poricidal,purplish,ranging,recurve,regularly,rotate-pentagonal,rugose,ruit,single,sinus,slightly,slit,sometimes,spreading,staminate,stigma,stout,straight,tamen,tear,time,tissue,tube,unequal,unit,unlobed,usually,variable,vary,way,wide,widest,wood,woody,yellowish,ympodial	0.25-0.8,1.5-2,1.5-7,15-20,2-9,2.5-6,3-7,4,4-10,5-10,5-20,5-8,arrangement,branching,characteristic,colour,form,fruit,greyish,growth,history,inflorescence,leaf,length,life,midvein,na,ovary,plurifoliate,primary,pseudostipule,seed,staman,texture,unarmed
537	wfo-0001032523	success	200	112	94	106	18	0.47	-5,.2,.5,/4,0-3,0.3-0.5,0.6-0.7,1-1.5,1-3,1-8,1.3-1.6,1.5-3,1/3-1/2,10-50,15-30,2-2.4,2.7-3,3.5-4,4-7,5-20,abaxial,acuminate,adaxial,anther,apart,apex,apparently,base,berry,branching,calyx,cm,cuneate,curved,diameter,dull,elliptic,elongating,entire,evenly,filament,filiform,flattened-reniform,flower,fruit,fruiting,gently,glabrescent,glabrous,green,lateral,leaf,length,lobe,lobed,margin,mature,maturity,mauve,membranous,mm,moderately,orange,orange-brown,ovate,pale,pedicel,peduncle,per,petiole,prickle,prickly,red,reflexed,scandent,scar,shrub,sometimes,spaced,spherical,stellate,stellate-pubescent,stem,straight,style,subentire,surface,terminal,unarmed,unit,way,weakly,yellow,young	-2,0-0.15,0-10,0-12,0-15,0.1-0.2,0.2,0.2-0.4,0.4-1,0.4-1.5,0.5-1,0.6-0.8,1-2,1/4-1/3,2,2-2.5,2-4,2-5.5,2.5-6,3-15,3-4,4-5-merous,5-12,6-10,6-20,6-8,abaxially,acuminat,acute,alyx,ame,apar,apically,articulated,bark,blade,brow,c.,conical,connivent,deltate,discolorous,drying,eaf,eed,equal,erect,free,glabrou,hair,herbaceous,inflated,infructescence,lon,long,longer,lower,midpoint,minute,multangulate,narrow-deltate,nflorescence,older,one,open,orolla,oung,pair,perfec,pericarp,perpendicular,plurifoliat,poricidal,porrect,portion,primary,ray,recurved,red-brown,ruit,secondary,sessile,simple,smooth,sparsely,spreading,stalk,stalked,strongly,tamen,tapering,terete,tertiary,time,tip,trichome,tube,unarme,variously,vary,vein,venation,visible,wide,woody,ympodial	characteristic,colour,corolla,form,growth,height,inflorescence,number,ovary,plant,plurifoliate,seed,shape,staman,sympodial,texture,type,width
538	wfo-0001032524	success	205	103	75	130	28	0.366	1-2,1-2.5,1.5-4,12-13,2-5,25-90,3-5,3.5-4.5,4.5-8,5-6,7-35,7-8,acute,anther,apex,articulated,attenuate,axillary,base,berry,brownish,bud,cm,condition,corolla,cuneate,densely,diameter,distal,drying,elliptic,filament,flower,forked,fresh,fruit,generally,glabrous,globose,grayish-green,green,greenish,hair,half,herb,length,light,like,lilac,lobe,long,margin,middle,mm,narrowly,obtuse,odd-pinnate,ovate,ovoid,pedicel,peduncle,petiole,plant,pubescent,purple,ripe,rounded,seed,stem,style,subtending,terminal,usually,violet,whitish	1-10,1.5-2,10-35,120-210,14-50,2-3,2.5-8,3-4,3-8.5,4,4-5,4.5-5,5-9,5-merou,50-70,6-13,6-16.5,?,abaxially,acumen,adaxially,ag,along,alyx,apart,apparently,arranged,ascending,axe,bead,blade,capitat,cell,chartaceous,ciliate,clavate,connivent,covering,different,digestion,dorsally,eaf,edge,eed,enzyme,erec,especially,exceeding,except,flat,folded,geminat,glabrou,greatly,green-white,hair-like,hal,head,homostylous,honeycomb-shaped,interjected,lanceolate,lateral,leaflet,lengthening,living,lower,make,membranous,midrib,minutely,moniliform,mucilaginous,multicellular,multiple,necklace,nflorescence,non-glandular,often,orolla,pair,pentagonal,perfect,petiolulate,petiolule,plurifoliate,pore,poricidal,proximal,puberulent,reduced,removed,rotate,ruit,sessile,seudostipule,short,silky,silvery-white,size,slit,spaced,specimen,stamen,ste,stigma,stolon,straight,subequal,tall,tamen,tem,testal,tetralobulate,thick,throughout,tip,tri-,trichome,tube,tuber,typically,unit,unwinged,vary,wall,wet,x,yellow,ympodial	2,abaxial,adaxial,arrangement,branching,calyx,characteristic,colour,form,growth,height,inflorescence,leaf,midvein,na,ovary,primary,pseudostipule,rachi,shape,staman,surface,tertiary,texture,true,unarmed,vein,venation
539	wfo-0001032532	success	161	98	75	86	23	0.466	0.3-2.5,1.5-2.6,15-30,2,2-13,2-3,2.8-3.6,2.8-9.5,3-10,4-5.5,4.5,6,acuminate,acute,apex,apical,apically,base,branched,calyx,cm,conical,corolla,cuneate,cyme,dehiscent,diameter,dichasial,dichasially,ebracteate,elliptical,exceeding,finely,green-white,herbaceous,honeycomb,introrse,lateral,leaf,leaflet,light,long,maturing,mm,monochasial,mucilaginous,narrowly,oblique,obtuse,odd-pinnate,often,ovate,pair,pattern,pedicel,peduncle,perennial,petiole,petiolule,plant,poricidally,pubescent,purple,rounded,seed,short,slit,stamen,stigma,straight,style,terminal,throughout,tip,tuber-bearing	0-.,1-1.5,1-4,1.5-3.2,1.5-4.3,13-52,2-,2-10,3-5,3-6-foliat,3.4-12.2,3.7-10,6-22,8-38,abaxiall,abaxially,absent,acumen,adaxially,articulate,attenuate,cell,coarsel,connate,covering,deep,digestion,diminishing,distal,dorsally,eaf,edge,eed,emoval,enzyme,filament,flat,flower,folded,forked,generally,globo,gradually,green,hair-like,half,interjected,living,lobe,lon,long-attenuate,lower,lunat,make,medium,minute,nflorescence,nther,orolla,ovoid,perfect,plan,proximal,reveal,rotate,ruit,sessile,seudostipule,size,specimen,subequal,subsessile,tal,tem,testal,thick,throughou,toward,typically,unit,vary,wall,wide,yellow,ympodial,Â¼	2-5,anther,arrangement,characteristic,coarsely,colour,dehiscence,form,fruit,globose,growth,height,history,inflorescence,length,life,ovary,shape,stem,surface,texture,wet,ye
540	wfo-0001032536	success	254	113	96	158	17	0.378	1-2.5,1.3-2.2,10,10-20,13-24,14-16,2-3,20-22,3-3.5,4-6,4-9,5.5-8,7-10,abaxial,acute,adaxial,age,almost,anther,apex,armed,base,berry,bright,bristle,bristly,brown,calyx,chartaceous,cm,conical,dark,deeply,densely,depressed,diameter,difoliate,elliptic,entire,fading,filament,flattened,fruit,glabrous,glandular,globose,grayish,growth,inflorescence,leaf,length,lobe,lobed,margin,maturity,membranous,midvein,minute,minutely,mixture,mm,multiseriate,narrowly,oblique,olive-green,once-branched,ovary,papillae,papillate,pedicel,peduncle,petiole,plant,porrect,primary,pubescent,purple,reddish,reniform,rough,simple,somewhat,sparsely,stellate,stem,style,surface,tree,triangular,trichome,truncate,unarmed,unit,vein,white,yellow-green	-3,/3,0.5,1,1-2,1.5,10-30,10-50,100,2.5-3,20-25,20-50,3,3-6,4-8,5,5-6,5-8,5-merous,<,>,abaxially,abruptly,adaxiall,adaxially,along,alyx,angle,anthesi,apar,appressed,around,articulated,axi,bark,basal-most,berr,blade,broad-based,broadly,capitate,caudat,caudate,cell,clavate,clearly,coriaceous,cu,curved,dbh,deltate,denser,directed,diverging,eaf,eed,enlarged,equal,evenly,flower,free,fruiting,geminate,glabrescent,glandular-puberulent,halfway,hanging,heterostylous,inflorescenc,infructesecnce,interpetalar,irregularly,juvenile,lamina,lateral,leaf-opposed,leaving,like,long,long-stalked,long-styled,lower,mature,midpoint,midrib,mixed,multangulate,narrowing,near,new,nflorescence,number,occasionally,occurring,odor,older,open,orolla,oung,papillat,part,pentagonal,per,pericarp,pore,poricidal,portion,potato,prickl,prickle,prickly,prominent,protuberance,rarely,ray,reproductive,ruit,scar,scattered,shallowly,short-,short-styled,slender,slightly,small,smooth,soft,spaced,spreading,stalk,staminate,stellate-pubescent,stigma,strongly,tall,tamen,tapering,terete,terminal,thick,time,tip,tissue,trunk,tube,unequal,upward,urceolate,usually,vary,visible,way,wide,wood,woody,yellowish,ympodial,younger	arrangement,branching,characteristic,colour,corolla,form,height,history,life,na,perennial,rachi,seed,shape,staman,sympodial,texture
541	wfo-0001032542	success	161	94	70	91	24	0.435	0.5-1,0.7-1,1-1.5,1-2,1-5,10-15-flowered,2-3,2-3.5,3-4,4-7,4.5-5,5-8,abaxial,abaxially,acuminate,acute,adaxially,anther,apex,attenuate,base,berry,bluish-green,bright,calyx,cm,corolla,deltate,dendritic,densely,elliptic-obovate,filament,flattened-reniform,glabrous,globose,golden,green,growth,incrassate,inflorescence,lamina,lateral,leaf,lobe,main,margin,minutely,mm,narrowly,ovary,pair,pedicel,petiole,pitted,pubescent,reddish-brown,shape,shining,shrub,simple,small,sparsely,stem,style,surface,treelet,triangular,trichome,vein,yellow-green	.25,.25-0.5,.5,.5-1,/4,1-1.3,1.5-3.5,10-28,2.5-5,3-5,4-9.5,along,anthesi,apical,axi,ba,bark,basal,beginning,brown,capitate,closely,compact,conical,dark,deflexed,di,dia,differing,difoliate,distal,dry,eaf,edicel,eed,either,elliptic,erect,exserted,free,fruiting,geminat,inflorescenc,later,less,like,lobed,lon,long,loose,lower,major,minor,minute,near,new,nflorescence,older,opposite,overlapping,papillo,persisten,planar,pore,poricidal,portion,rounded,ruit,scar,shaped,size,slender,slightly,somewhat,spaced,stigma,strongly,swollen,tear-drop,tip,tub,tube,ud,unit,way,wide,woody,x,yellowish,ympodial,young	adaxial,alternate,arrangement,branching,characteristic,colour,diameter,form,fruit,height,length,midvein,na,peduncle,plant,primary,pseudostipule,rachi,seed,staman,tertiary,texture,unarmed,venation
542	wfo-0001032564	success	160	114	84	76	30	0.525	.1,.5,0.3-1,0.75-1,1-1.2,1-1.3,1-1.5,1-2,1.5,2-2.5,4-5,4-6-flowered,6-7,8-9,along,anther,apex,arched,base,becoming,beneath,berry,broadly,brown,calyx,cm,corolla,dark,deflexed,deltoid,densely,dia,dry,elliptic,extreme,filiform,flattened,fresh,glabrous,globose,golden,green,greenish-white,leaf,lobe,long,long-acuminate,margin,material,minutely,mm,narrowly,ovary,ovate,ovoid-reniform,pair,pedicel,petiole,pitted,prominent,puberulent,raised,ripe,rounded,shiny,shrub,simple,slightly,stem,straight,style,surface,tan,tapering,thread-like,tip,trichome,truncate,unifoliate,uniseriate,vein,winged,x,yellowish-green	.05,.05-0.1,0.25-0.5,1.3-2.5,5.5-9,anthesi,apar,apart,aspec,ba,bark,branch,bud,clavate,conical,converging,eaf,edicel,eed,except,expanded,exserted,flower,fruiting,geminate,giving,glabrate,greyish-red,halfway,lamina,later,lateral,like,lobed,lower,main,member,middle,minute,nearly,nflorescence,node,non-reproductive,obovoi,often,older,one,open,opposite,papillo,papillose,planar,point,pore,poricidal,projection,proximal,reflexed,ruit,scar,shaped,small,soon,stigma,strongly,tall,tear-drop,time,tiny,tube,ud,unit,widest,woody,ympodial,young	abaxial,adaxial,arrangement,branching,characteristic,colour,diameter,filament,form,fruit,growth,height,history,inflorescence,length,life,midvein,na,peduncle,plant,primary,pseudostipule,rachi,seed,shape,staman,tertiary,texture,unarmed,venation
543	wfo-0001032569	success	164	100	72	92	28	0.439	0.5-10,0.8-1,1-1.2,1-1.5,1-2,1-4,1.2-5,1.5-2,1.7-2,2-3,5-6,7-9,acute,anther,apex,base,berry,branched,brown,bullate,calyx,cm,corolla,corrugated,dark,decurrent,dendritic,densely,dry,elliptic,erect,filament,flattened,glabrous,globose,green,inflorescence,irregularly,lateral,leaf,lobe,main,margin,minutely,mm,moderately,occasionally,onto,opposite,ovary,ovate,pair,papillose,pedicel,petiole,pitted,pubescent,reniform,shrub,simple,sparsely,splitting,stem,strongly,style,surface,thick,triangular,trichome,vein,white,x	.5,/3,1.5,2-4,4-18,4-8,5-60-flowered,7-27,abaxially,adaxially,along,anthesi,apparently,appearing,axi,bark,bearing,bilobed,broadly,cell,closely,conical,deflexed,dense,denser,dia,differing,difoliate,drying,eaf,edicel,eed,ellipsoid,exserted,fleshy,free,fruiting,geminate,golden,gra,incrassate,later,lea,like,lobed,lon,long,los,lower,major,matted,mature,middle,minor,nflorescence,obscured,open,otherwise,paler,papillo,pericar,planar,pore,poricidal,portion,present,pubecsence,rich,ruit,scar,shaped,size,somewhat,spaced,stigma,stone,tall,tear-drop,time,tip,tub,tube,tuft,ud,unifoliate,unit,waxy,way,widest,woody,ympodial,young	0.5,abaxial,adaxial,arrangement,branching,characteristic,colour,diameter,form,fruit,gray,growth,height,length,midvein,na,peduncle,plant,primary,pseudostipule,rachi,seed,shape,staman,tertiary,texture,unarmed,venation
544	wfo-0001032576	success	229	144	123	106	21	0.537	-10,-2,0,0-3,0-5,0.3-0.7,0.5-1.5,0.5-2,0.5-4,0.8-1.2,1-4,1.5-2,1.5-2.3,1.8-2.5,1/3,2-4,2-5,4,4-6,4-6.5,5-30,acute,anther,apex,apically,apparently,articulated,base,berry,branched,branching,bright,brown,brown-green,calyx,cell,chartaceous,cm,concolorous,cuneate,deltate,densely,diameter,difoliate,drying,dull,entire,erect,evenly,eye,faint,filament,flattened-reniform,fruit,glabrescent,glabrous,glandular,gray,green,hair,herb,lanceolate,lateral,leaf,length,lobe,lobed,long,margin,maturity,membranous,midvein,minutely,mm,moderately,naked,near,obtuse,often,orange-brown,outline,ovate,pair,pale,pedicel,peduncle,per,petiole,pit,prickle,prickly,primary,purple,raised,red,red-green,reticulate,shiny,shrub,simple,small,sparsely,spherical,stellate-pubescent,stem,style,surface,terminal,tertiary,trichome,unarmed,unit,upper,usually,vein,venation,visible,white,wide,yellow,yellow-green,yellow-orange,young	-12,-2/3,/4,/5,0-1.5,0-30,0.1,0.1-0.15,0.1-0.2,0.1-0.25,0.3-0.5,0.5-1,0.8-1.4,0.8-2,1-3,1.2-1.8,1.5-7.5,1/2,1/3-1/6,2-10,2-3,2.5-3,2.5-4,3-14,4-,4-5-merous,6-8,7-8,abaxially,acuminat,alyx,apar,apart,ascendant,ba,bark,blade,brow,conical,curved,distance,eaf,eed,ellipsoid,elongating,equal,extending,flattened,flower,free,fruiting,geminat,gland,globular,herbaceous,infructescence,longer,lower,mature,midpoint,narrow-deltate,narrow-ovate,nflorescence,obovate,older,one,open,orolla,oung,perfec,pericarp,poricidal,porrect,portion,prickl,ray,reduced,reflexed,rounded,ruit,scandent,scar,sessile,short,shorter,side,slender,slightly,smooth,sometimes,spaced,spreading,stalk,stalked,stellate,straight,tamen,tapering,time,tip,tube,variously,vary,way,woody,ympodial	abaxial,acuminate,adaxial,arrangement,characteristic,colour,corolla,form,geminate,growth,height,inflorescence,na,ovary,plant,seed,shape,staman,sympodial,texture,type
545	wfo-0001032595	success	200	133	113	87	20	0.565	-20,-25,0-,0.5-1,0.5-3.5,1-3,1-6,1-6.5,1.5-2,1.5-2.5,1.5-5,12-16,15-25,15-40,2-4,25-40,3-10,3-12,3-4,3-5,4-5,4-7,5-6,abaxially,acuminate,acute,adaxially,along,also,anther,apart,apex,apical,apiculate,articulated,basal,base,branch,branched,brownish-purple,calyx,cm,cordate,coriaceous,deeply,densely,denser,diameter,dull,eglandular,ellipsoidal,entire,filament,finely,flattened,flower,fork,forked,fruit,fusiform,glabrous,gland,glandular,greenish,hair,homostylous,leaf-opposed,leaving,lobe,long,margin,mature,mm,moderately,near,oblique,often,ovate,ovoid,pale,pedicel,pedicellar,peduncle,petiole,pilose,prominent,pseudohair,puberulent,pubescent,rachi,rarely,remnant,reniform,rugulose,shrub,simple,small,spaced,sparsely,stellate,stigma,style,subcoriaceous,tip,toward,tree,truncate,two,unbranched,violet,white,x,yellow	-pilose,1,1-2,1-2.5,1.5-4.5,2-3,2.3-24,3-4-foliate,4-25,5-merou,6-7,9-14,accrescen,aggregate,alyx,ape,axe,blade,brownish,cell,ciliat,connective,connivent,cream,crow,cucullate,deltate,dense,dilated,directed,distally,eaf,eed,equal,exceeding,free,fruiting,geminate,lanceolate,larg,lon,longitudinal,loosely,lower,m.,major,midrib,narrowly,nflorescence,opening,orolla,part,per,perfect,pilo,pore,produced,purple,purplish,ruit,shallow,shorter,side,single,slightly,slit,spreading,stamen,stone,strongly,swelling,tall,tamen,tem,thecae,time,tomentose,triangular,trunk,tube,ud,umbrella-shaped,unit,vary,vein,wide,ympodial	5-merous,arrangement,bud,characteristic,colour,corolla,form,growth,height,inflorescence,leaf,length,ovary,plant,seed,shape,staman,stem,surface,texture
