	coreid	status	nwords_original	nwords_result	nwords_recovered	nwords_omitted	nwords_created	prop_recovered	common_words	original_only	result_only
0	wfo-0001025652	success	156	106	81	75	25	0.519	.3,.5,0.5-1,1.5-2,10-20,15-17,2-3,2-6,20-50,4,4-7,abruptly,acuminate,acute,anther,anthesi,apex,bark,base,bilobed,calyx,closed,cm,completely,corolla,decurrent,dia,elliptic,envelope,filament,fleshy,fruit,furcate,glabrous,green,greyish,growth,lateral,leaf,main,margin,matte,minutely,mm,narrowing,nearly,new,occasionally,onto,opposite,ovary,ovoid,ovoid-reniform,pair,pale,parallel,pedicel,petiole,pitted,plant,shape,shaped,shiny,shrub,simple,size,small,stem,stigma,strongly,style,surface,tan,tapering,tear-drop,tree,tube,vein,white,winged,x	1,1-1.5,15-19,2-5,3-3.5,3-5,3-5-flowered,4-6,9-11,appearing,blade,broad,campanulate,closely,connate,densely,differing,difoliate,dry,eaf,edicel,eed,emerge,flower,free,geminat,glabrate,greyi,growing,irregular,like,live,lobe,lobed,lon,long,lower,major,middle,minor,minute,nflorescence,older,one,overlappin,paler,papillae,papillo,papillose,pinkish-grey,planar,pore,poricidal,portion,rather,red-papillose,ry,scar,soon,spaced,specimen,straight,tall,tear,thick,thicker,tightly,tip,ud,unit,wider,widest,wing,ympodial,young	arrangement,branch,bud,characteristic,colour,corrugation,diameter,exertion,form,fruiting,glabrousnes,height,history,inflorescence,length,life,lobing,na,number,peduncle,per,primary,seed,texture,type
1	wfo-0001025657	success	239	123	99	140	24	0.414	0.1-0.4,0.2-0.4,1-1.1,1-3,1.3-2,1.5-1.8,2-10,2/3,25-60,3-6,4-4.4,5-14,5-16,6-12,6-8,7-27,8.3-12,abaxially,acute,adaxially,also,anther,anthesi,apex,base,berry,bluish,blunt-tipped,branch,branched,brown,bud,calyx,chartaceous,cm,conical,cordate,corolla,dark,deltoid,diameter,dried,elliptic,entire,exserted,filament,fleshy,flower,fruit,granular,green,hair,leaf,length,light,margin,midrib,mm,narrowly,nearly,oblong,orbicular,ovate,pale,parted,pedicel,peduncle,persistently,petiole,pseudo-terminal,reportedly,reticulate-punctate,ripe,scented,shrub,side,simple,soft,stellate,stem,stigma,strongly,style,suborbicular,surface,tan,terete,tomentose,tomentose-pubescent,tree,unarmed,vein,velutinous-pubescent,way,weakly,white,x,yellow,yellowish	-2,/3,0.5-2.5,1-1.3,1-1.6,1.2-1.5,1.7-1.9,12x,2-3.5,2.2-5.5,2.5-9.3,2.7-4.3,3-4,3-4.8,3.2-6,4-4.5,4-7,6.5-10,7-9,7-9.5,8-10.5,accrescent,ag,apart,apparently,appearing,ark,around,articulated,ascending,axe,axillary,ba,blade,broadly,capitat,central,closely,cylindrical,dendritic-multangulat,dendritic-multangulate,dense,densely,directed,distally,due,eaf,earl,edge,eed,especially,evident,exerted,expanded,farinose,few-rayed,free,fruiting,glabrous,glandula,glandular,half,inserted,lanate-pubescent,lanceolate,lateral,lengthening,lobe,lobed,long,long-stalked,longitudinal,lower,m.,magnification,main,minutely,mixed,multangulate,nflorescence,obtuse,occasional,often,older,open,orolla,ovat,ovate-lanceolate,overlapping,part,partly,perfect,persistent,plurifoliate,pore,poricidal,porrect-stellate,present,pubescence,pubescent,rachi,ray,ruit,semi-ovate,sessile,short,short-,short-stalked,slightly,slit,somewhat,spaced,splitting,stamen,stellate-pubescent,stipitate-glandular,stipitate-multangulate,subcampanulate,subcoriaceous,suture,tall,tamen,thick-stalked,thickened,thin-stalked,time,tip,tomentum,transparent,tube,two-third,ud,unarme,unit,upper,usually,vary,wide,ympodial,young	arrangement,bark,capitate,characteristic,colour,exertion,form,glabrousnes,growth,height,history,inflorescence,life,lobing,new,ovary,perennial,plant,primary,seed,shape,size,texture,type
2	wfo-0001025669	invalid_json	216	151	118	98	33	0.546	'',.5,0-1,0.1-0.3,0.8-2.4,1,1-10,1-2,1-2.2,1-4,1.3-4.2,1.4-2.5,1.6-4.4,13-35,2-3,2-4,2.2-6,2.2-6.5,2.4-7,3-5,3-7,9-24.5,``,abaxially,absent,acumen,acuminate,acute,adaxially,anther,apart,apex,base,berry,blade,blue,brownish,cell,chartaceous,clavate,cm,condition,connivent,corolla,covering,cuneate,diameter,dorsally,drying,edge,end,filament,flat,flower,folded,forming,fresh,fruit,glabrous,globose,green,greenish,herb,homostylous,lanceolate,lateral,leaflet,lobe,long,membranous,minute,minutely,mm,moderately,monochasium,mottled,oblique,obtuse,odd-pinnate,one,ovoid,pedicel,peduncle,petiole,placed,plant,puberulent,pubescent,purple,rarely,ripe,rosette,rotate,scale-like,seed,size,slightly,sometimes,stem,stigma,straight,streaked,style,subglabrous,terminal,testal,thick,tinged,tube,tuber,typically,unwinged,wall,white,whitish,wide,x,yellow	0-5,0-7,1-3,2,4-6,5-merou,absen,ag,along,alyx,apparently,articulation,axe,broadly,capitat,ciliate,clearly,contracted,decurrent,digestion,discussion,distal,distinct,eaf,eed,elliptic,enzyme,erec,especially,exceeding,except,extra,flowered,geminat,glabrou,greatly,green-white,hair,hair-like,half,highly,honeycomb-shaped,interjected,larger,lengthening,like,living,lower,make,margin,midrib,mucilaginous,multicellular,near,nflorescence,obovate,often,orbicular,orolla,ovate,pair,perfect,petiolulate,petiolule,plurifoliate,pore,poricidal,proximal,reduced,removed,rounded,ruit,see,sessile,seudostipule,short,single,slit,spaced,species,specimen,stamen,ste,stolo,subequal,tall,tamen,tem,throughout,tip,tri-,truncate,unbranched,unequal,unit,vary,wet,ympodial	'extra,'hair-like,5-merous,[,],abaxial,adaxial,arrangement,calyx,capitate,characteristic,colour,erect,form,growth,height,history,inflorescence,leaf,length,life,ovary,placement,pseudostipule,shape,spacing,stolon,surface,texture,type,value,{,}
3	wfo-0001025697	success	181	119	92	89	27	0.508	0-14,0.15-0.75,0.8-2,1-2,1.5-1.8,1.7-8.6,10-26,2-2.6,2-6,25-35,3-10,3-4,3-5,3-6,4-7.5,5.5-11.5,acumen,acuminate,acute,anther,apex,asymmetric,attenuate,base,basiscopic,berry,blue,brownish,clavate,cm,condition,coriaceous,corolla,dark,deep,diameter,distal,drying,elliptic,filament,flower,forked,fresh,fruit,glabrescent,glabrous,globose,green,green-white,greenish,hair,half,herb,high,interjected,lanceolate,leaf,leaflet,light,lilac,medium,mm,mucilaginous,odd-pinnate,ovate,ovoid,pedicel,peduncle,pentagonal,perfect,petiolulate,plant,purple,rotate,seed,sessile,short,side,size,stigma,straight,stripe,style,terminal,throughout,tissue,tube,unwinged,wet,whitish,x,yellow	-9,0.6-3.5,1-1.7,1-3,2-10.5,2-4,3.3-11,5-merou,6.5-13.5,abaxially,adaxiall,adaxially,ag,alyx,apart,apparently,articulated,axe,axillary,blade,bud,capitat,cell,connivent,covering,decreasing,decurrent,digestion,dorsally,eaf,edge,eed,enzyme,erec,exceeding,flat,folded,geminat,generally,glabrou,hair-like,hal,homostylous,honeycomb-shaped,lateral,lengthening,linear,living,lobe,long,lower,make,nflorescence,orbicular,orolla,pair,petiole,plurifoliate,pore,poricidal,rachi,removed,ripe,rounded,ruit,seudostipule,slightly,slit,spaced,specimen,stamen,subequal,subglabrou,subtending,tall,tamen,tem,testal,thick,tip,toward,tri-,typically,unit,usually,vary,wall,wood,ympodial	abaxial,adaxial,arrangement,articulation,calyx,capitate,characteristic,colour,form,growth,height,history,inflorescence,length,life,number,ovary,pseudostipule,shape,spacing,staman,stem,subglabrous,surface,texture,type,woody
4	wfo-0001025699	success	181	122	99	82	23	0.547	.2,.5,0.5,1,1-2.5,1.5-2,1/3,10,15-20,2,2-2.5,2cm,3-5.5,5-8,5-winged,5.5-14,8-9,absent,acute,adaxially,almost,anther,apex,attenuate,bark,base,becoming,berry,brown,c.,calyx,capitate,cm,completely,conical,corolla,dark,darker,diameter,drying,ellipsoid,elliptic,entire,erect,exerted,filament,fruiting,glabrous,globose,green,grey-brown,growth,immature,inflorescence,leaf,leaf-opposed,leafy,less,lobe,margin,markedly,midrib,minutely,mm,new,older,ovary,pair,pale,pedicel,peduncle,petiole,poricidal,primary,red,reddish,reniform,reticulate-pitted,rounded,rounded-sagittate,shoot,short,simple,slightly,somewhat,stem,stigma,style,surface,tip,tree,tube,vein,way,white,x,yellow,young,Â½	1-1.5,1-2,1-3,1.5,2-6,3-15,3-3.5,3-8,4-5,499,abaxially,age,anthesi,apart,apparently,appearing,articulating,branching,campanulate,conspicuously,continuing,corrugate,crystal,cup-shaped,deltate,densely,difoliate,dorsal,dry,eaf,eed,face,fide,flower,free,glabrou,included,inclusion,inflorescenc,irregularly,lanceolate,leaving,lengthening,lobed,lower,narrowly,nflorescence,nodding,one,onto,oxalate,papillat,papillose,peg,penden,per,perfect,plurifoliate,pore,portion,ruit,sand,scar,slit,small,spaced,stearn,straight,strongly,tangled,thickened,time,triangular,trichome,ud,unit,white-spotted,wide,wing,winged,woody,ympodial	arrangement,bud,characteristic,colour,corrugated,corrugation,exertion,form,fruit,glabrousnes,height,history,length,life,lobing,na,papillate,plant,seed,shape,size,texture,type
5	wfo-0001025700	success	189	88	65	124	23	0.344	0-16,0.30-2.0,0.5-2,0.7-2.7,0.8-2.6,1.1-2.3,1.5-2,10.5-12,15-40,2-12,2.5-4,3-8,3.5-10.5,3.7-8.6,5-15,5-20,5.3-17.5,5.5-18,5.5-8,9-31,anther,berry,blade,chartaceous,clavate,cm,corolla,diameter,dot,filament,flower,fruit,glabrescent,glabrous,globose,green,greenish,herb,homostylous,interjected,lateral,leaf,leaflet,light,lilac,medium,mm,mucilaginous,narrowly,odd-pinnate,ovoid,pedicel,peduncle,petiole,plant,purple,seed,size,stigma,style,terminal,unwinged,whitish,winged,x	0.8-4,1-2,1-3,10-40,2-7,3-4,4-5,5-merou,abaxially,acuman,acumen,acuminate,acute,adaxially,ag,alyx,apex,apiculate,apparently,articulated,asymmetric,attenuate,axe,axillary,basal,base,basiscopic,brownish,bud,capitat,cell,condition,connivent,considerably,covering,decrease,decreasing,digestion,distal,dorsally,drying,eaf,edge,eed,elliptic,enzyme,erec,exceeding,except,flat,folded,forked,fresh,geminat,generally,glabrou,green-white,hair,hair-like,hal,half,high,honeycomb-shaped,lanceolate,larger,lengthening,linear,living,lobe,long,lower,make,nflorescence,orbicular,orolla,ovate,pair,par,pentagonal,perfect,petiolulate,plurifoliate,pore,poricidal,proximal,removed,ripe,rotate-pentagonal,rounded,ruit,sessile,seudostipule,short,side,slightly,slit,sometimes,specimen,stamen,straight,subequal,subglabrou,subtending,tall,tamen,tem,testal,thick,throughout,tip,tissue,toward,tri-,tube,typically,unit,usually,vary,wall,wet,white,whose,yellow,ympodial	5-merous,abaxial,adaxial,arrangement,calyx,capitate,characteristic,colour,form,growth,height,history,inflorescence,length,life,ovary,pseudostipule,shape,staman,stem,surface,texture,type
6	wfo-0001025704	success	248	150	128	120	22	0.516	0-100,0-3.5,0.3-0.8,0.5-1.5,0.7-1,1-3.5,1-6,1.2-3,1.5-3.2,1.5-4.5,1.8-3.5,1/2-4/5,2-10,2-3,2-4.5,2.5-4.5,2.7-4,3-15,3-5,3-6,4-5,6-12,8-15,abaxial,acute,adaxial,almost,anther,apex,apparently,articulated,auriculate,bark,base,berry,branched,calyx,cell,chartaceous,cm,connivent,cordate,densely,diameter,discolorous,drying,ellipsoid,elliptic,erect,evenly,filament,flattened-reniform,flower,fruit,fruiting,glabrescent,gray,green,green-yellow,irregular,lateral,leaf,length,lobe,lobed,lobing,long,long-styled,margin,maturity,mauve,mm,near,often,orange-brown,outline,ovate,pair,pale,pedicel,peduncle,per,petiole,pit,plant,poricidal,prickle,prickly,primary,raised,rarely,red-brown,red-green,round,shape,short-styled,shrub,side,small,smooth,sometimes,somewhat,sparsely,spherical,stellate-pubescent,stem,strongly,style,surface,tapering,terete,terminal,tip,tree,truncate,tube,unarmed,unbranched,vein,way,white,white-gray,wide,yellow,yellow-green,yellowish,young,Ã	-10,-2,-3,-5,/6,0,0-2,0-5,0.1,0.1-0.3,0.1-0.5,0.15-0.8,1,1-4,1.5-2,1/4-3/4,1/5,2,2-5,2-7,3-10,4-12,4.5-6.5,5-20,5-merous,6-15,8-12,8-17,abaxially,age,alyx,andromonoecious,apar,apart,apically,apiculate,axe,ba,blade,broad-deltate,brow,covering,curved,deltate,development,distal,distance,eaf,eed,elongating,end,equal,extending,flattened,free,glabrous,half,hermaphrodite,heterostylous,infructescence,less,longer,lower,lowermost,mature,midpoint,midvein,moderately,multangulate,nflorescence,obtuse,occasionally,older,one,open,orange,orolla,oung,pendulous,pericarp,plurifoliat,porrect,portion,prickl,prominent,ray,recurved,reflexed,retaining,rounded,ruit,scar,secondary,sessile,shorter,slender,spaced,spreading,stalk,stalked,staminat,stellate,stellate-pubescen,stout,straight,tamen,tertiary,throughout,time,trichome,unit,upper,variously,vary,venation,visible,warty,widening,woody,ympodial	arrangement,branch,brown,bud,characteristic,colour,corolla,exertion,form,glabrousnes,growth,height,inflorescence,na,new,number,ovary,seed,size,stigma,texture,type
7	wfo-0001025729	success	177	143	122	55	21	0.689	.5,/4,0.25-0.5,0.7-1.2,1-1.5,1-5,1.1-1.5,1.2-1.8,1.75,2,2-3.5,20,3-6,4-5,4-8,5-50-flowered,9-17,abaxial,abrupt,anther,anthesi,apical,apiculate,appearing,axil,bark,basal,base,berry,black,blackish,bright,bristly,bud,calyx,cm,corolla,covering,densely,dia,diam,difoliate,dirty,drying,elliptic,enclosed,expanded,f,filament,flattened-reniform,fleshy,fruiting,furcate,gently,glabrous,globose,green,greenish-yellow,greyish-brown,growing,lamina,lateral,leaf,like,live,lobe,lobed,long,main,minor,minutely,mm,occasionally,often,opposite,ovary,overtopping,pale,papillose,partially,pedicel,petiole,pit,pitted,plant,pore,poricidal,portion,pubescent,quite,reflexed,ripening,shaped,shiny,short,simple,size,sparsely,stem,stigma,stout,style,surface,tapering,tear-drop,terminal,tip,tree,treelet,trichome,tube,tuft,uniseriate,unit,usually,vein,way,white,widening,woody,x,yellow	-20,1.5-2,6-8,7-8,abaxially,acute,adaxially,along,apar,apex,branched,covered,cyathiform,dark,deflexed,deltoid,denser,differing,eaf,edicel,eed,free,geminat,glabrou,incrassate,lat,lon,lower,m.,mainly,major,margin,member,middle,minute,nflorescence,oblique,older,one,overlapping,pair,papillo,prominent,raised,rounded,ruit,scar,straight,tall,touching,tub,ud,widest,ympodial,young	4-20,adaxial,arrangement,characteristic,colour,diameter,exertion,form,fruit,geminate,growth,height,inflorescence,late,length,lobing,seed,shape,sympodial,texture,type
8	wfo-0001025749	success	217	110	88	129	22	0.406	-12,/5,0.2-1.5,0.3-1.5,0.4-0.7,0.5-0.8,0.5-0.9,0.5-1.3,0.5-3,0.8-0.9,1-10,1-2,1.5-2.5,2-2.5,5-10,abaxial,acute,adaxial,anther,apex,apparently,bark,base,berry,calyx,chartaceous,cm,cuneate,curved,dark,densely,diameter,dull,flattened,flattened-reniform,fruit,fruiting,gently,glabrescent,glabrous,gray,green-brown,lateral,leaf,length,light,lobed,long,long-ovate,lower,margin,maturity,mauve,mm,moderately,narrow-deltate,orange-brown,orange-red,orbicular,ovate,pale,pedicel,peduncle,petiole,poricidal,prickle,red-brown,rounded,shrub,sometimes,sparsely,spherical,spreading,stellate,stellate-pubescent,straight,straw-yellow,style,surface,tapering,tip,way,white,wide,yellow,yellow-green,yellow-orange,yellowish	-1,.5,0-10,0-3,0-5,0-6,0-8,0.1,0.1-0.2,0.1-0.3,0.1-0.4,0.2,0.5,0.6-4.5,1,1-13,1-3,1-6,1-8.5,1-9,1.5,1.5-2,1/4-1/3,1/5-1/2,2-10,2.5-6,2/3,3-20,3-5,4-8,5-,5-20,5-merous,6-8,abaxially,acuminat,adaxially,adnate,almost,alyx,apar,apart,apically,articulated,blade,branched,broad-deltate,concolorous,difoliate,discolorous,distance,drying,eaf,eed,elongating,equal,erect,extending,filament,filiform,flower,free,geminat,herbaceous,indistinct,infructescence,lobe,lon,longer,magnification,markedly,mature,midpoint,midvein,narrow-ovate,nflorescence,oblong,obtuse,occasionally,older,one,open,orange-brow,orolla,oung,pair,pendulous,per,perfec,pericarp,porrect,portion,prickl,prickly,primary,procumbent,purple,rarely,ray,recurved,reduced,ruit,scar,sessile,shorter,side,smooth,spaced,stalk,stalked,stem,strongly,tamen,terete,tertiary,time,toward,trichome,tube,unit,usually,variously,vary,vein,venation,visible,without,ympodial,Â½-2/	arrangement,characteristic,colour,corolla,form,growth,height,history,inflorescence,life,lobing,ovary,perennial,plant,seed,shape,size,staman,texture,type,width,Â½-2/3
9	wfo-0001025754	success	164	102	78	86	24	0.476	.5,0.5-1,0.5-1.5,1,1-3,1.5,10-20,2-4,2-foliate,3-10,4-6,5-12,5-15,absent,acuminate,acute,anther,apex,asymmetrical,base,berry,brown,calyx,center,chartaceous,ciliate,cm,cordate,cordiform,decurrent,densely,diameter,dm,drying,edge,entire,filament,fine,flower,fruit,glabrous,globose,hair,herb,immature,leaf,linear-lanceolate,margin,maturing,membranaceous,mm,moderately,nearly,oblong,often,parallel,pedicel,peduncle,petiole,pubescent,radiating,raised,ridge,rotate,running,semitransparent,shallow,slightly,sparsely,stem,stigma,style,surface,truncate,unbranched,white,x,yellow	-celled,0.1-0.2,1-2,1-3.5,1.5-3,1.5-4,10-35,2-5-celled,2-7,3-5,3-6,4,abaxially,abundant,adaxiall,adaxially,along,axe,barely,beyond,blade,branch,connected,decumbent,dehiscing,denser,dried,eaf,eed,eglandular,emarginat,equal,erect,explosively,exserted,flat,geminat,glandular,held,interpetalar,leaving,like,lobe,long,lower,lying,main,material,maturit,mesocarp,mixed,much-branched,nfloresence,notch,orolla,palmately,penden,per,placenta,pressure,probably,pubescen,rachi,ruit,short,small,solitary,sometimes,stamen,straight,swollen,tal,tamen,tem,tissue,triangular,tube,unit,upright,vary,vein,visible,watery,wid,woody,ympodial	abaxial,adaxial,arrangement,characteristic,colour,corolla,form,glabrousnes,growth,height,inflorescence,length,na,new,ovary,pendent,plant,seed,shape,size,staman,texture,type,wide
10	wfo-0001025760	success	210	135	110	100	25	0.524	-5,.5,/3,0-0.5,0.3-1,0.4-0.8,0.45-0.9,0.5-1.5,0.5-2,0.7-2.5,0.8-1.8,1-,1-1.8,1-4,1.5,1.5-2.5,1/5,2-2.5,2.1-3.5,2.5-10,2/3,3,3-6,5-18,acute,almost,annual,anther,apex,apically,apparently,articulated,bark,base,berry,black,broad-deltate,calyx,chartaceous,cm,cream,cultivar,cuneate,curved,dark,diameter,dull,elliptic,filament,flattened-reniform,fruit,fruiting,gently,glabrous,green,herb,infructescence,lateral,leaf,length,lobe,lobed,long,margin,marking,maturity,membranous,mm,moderately,orange,orange-brown,ovate,pair,pale,pedicel,peduncle,per,perennial,petiole,poricidal,primary,red-brown,rounded,shape,shrub,side,sometimes,spherical,stellate-pubescent,stem,style,subentire,surface,tapering,terete,tip,tube,unarmed,unbranched,upper,usually,various,vein,way,weakly,white,wide,yellow,yellow-green,young	-10,-12,-3,-6,0-100,0.1,0.1-0.2,0.15-0.3,0.2-0.35,1,1-2,1.5-4.5,1.5-5,1/4,1/4-1/2,1/4-1/3,2-3,2.3-4,2.5-8,3.5-17,3.5-9,5-10-merous,8-10,abaxial,abaxially,acut,adaxial,alyx,apar,blade,brow,concolorous,connivent,deltate,difoliate,discolorous,distance,drying,eaf,eed,elongating,equal,erect,extending,flower,free,geminat,geminate,glabrescent,hair,lengt,longer,lower,mature,midpoint,midvein,minute,nflorescence,often,older,one,open,orolla,oung,pendulous,perfec,pericarp,porrect,portion,ray,recurved,reflexe,ruit,scar,sessile,shorter,simple,slender,smooth,spaced,spreading,stalk,stalked,stellate,stellate-pubescen,stout,straight,tamen,tertiary,thick-stalked,time,trichome,unarme,unit,variously,vary,venation,visible,woody,ympodial	arrangement,branch,brown,bud,characteristic,colour,corolla,exertion,form,glabrousnes,growth,height,history,inflorescence,life,lobing,na,new,ovary,plant,seed,size,stigma,texture,type
11	wfo-0001025782	success	200	150	112	88	38	0.56	.5,0-10,0-5,0.1-0.2,0.4-0.6,0.55-0.75,0.9-1.3,1-2.5,1-4,1.2-6,1.3-1.6,1.5-3,10-13,2-10,2-2.5,2-3,2-5,2.5-3.5,2/3-3/4,3-4,3-5,4,4-4.5,4.5-9,5-20,5.5-6,6-14,abaxially,acuminate,anther,apart,apex,apparently,articulated,bark,base,berry,brown,calyx,chartaceous,cm,concolorous,conical,cuneate,curved,densely,diameter,discolorous,distal,drying,dull,elliptic,evenly,filament,flattened,flattened-reniform,flower,fruit,fruiting,gently,glabrous,green,green-brown,lateral,leaf,length,lobe,lobed,long,long-styled,margin,maturity,membranous,midpoint,mm,moderately,orange-brown,pair,pedicel,peduncle,per,petiole,plant,poricidal,prickle,prickly,primary,ray,shrub,spaced,sparsely,spherical,stellate,stellate-pubescent,stem,style,surface,tapering,terete,tip,toward,trichome,tube,unbranched,vein,way,weakly,white,wide,yellow,yellow-green,young	-2,0.1-0.15,0.1-0.25,0.3-1,0.5-1,1,1-1.7,1-2,1/4-1/2,1/4-1/3,1/6,2-7,20,5-6.5,5-8,5-merous,6-8,abaxial,acuminat,adaxial,also,alyx,andromonoecious,apar,apically,blade,climbing,connivent,deltate,difoliate,distance,eaf,eed,elongated,elongating,equal,extending,free,geminat,geminate,glabrescent,hair,hermaphrodite,heterostylous,infructescence,lengt,less,longer,lower,lowermost,mature,midvein,minute,nflorescence,occasionally,older,one,open,orolla,oung,pendulous,pericarp,porrect,portion,prickl,red-brow,reduced,ruit,scar,sessile,short-styled,shorter,side,simple,smooth,spreading,staminat,stout,straight,tamen,tertiary,time,unit,vary,venation,visible,woody,ympodial	appearance,arrangement,border,branch,bud,characteristic,colour,corolla,corrugation,exertion,form,giving,glabrousnes,growth,height,history,inflorescence,interjected,leaflet,life,lobing,na,new,number,ovary,perennial,pseudostipule,red-brown,seed,shape,size,stigma,terminal,texture,thicknes,type,variation,width
12	wfo-0001025783	success	179	124	97	82	27	0.542	.5,0.5-1.5,1-1.2,1-3,1.8-2,2-3+,2-5,5,7-10,abaxially,acute,anther,anthesi,apex,articulated,base,berry,branched,branching,brown,bud,c.,calyx,cm,coriaceous,corolla,dendritic,diameter,ellipsoid,elliptic,entire,erect,expanded,exserted,filiform,flattened,fleshy,flexuous,flower,fruiting,glabrous,globose,greyish,growth,inserted,lateral,lax,less,lobed,long,margin,minutely,mm,narrowly,new,nodding,obtuse,pale,pedicel,peduncle,petiole,pitted,point,pubescent,purple,reniform,revolute,ripe,sagittate,shiny,shoot,short,shrub,simple,sleeve,slightly,sometimes,somewhat,sparsely,stem,stigma,strongly,style,surface,terminal,thin,time,trichome,truncate,tube,type,uniseriate,vine,violet,way,wide,woody	0.5,0.5-1,0.8-3.5,1-1.5,2,2-6.5,3-4,5-merou,<,abaxiall,adaxiall,adaxially,along,alyx,apart,ape,ark,axil,cell,cluster,completely,confined,conical,densely,eaf,eed,exposed,free,glabrou,green,groove,hromosome,ilament,keeled,known,lobe,long/tall,lower,mature,midrib,midvein,minute,mmm,near,nflorescence,number,obscured,occasionally,older,orolla,outlin,pair,penden,pentagonal,perfect,pericarp,plurifoliat,portion,possibly,primary,ruit,scar,scarious,see,spaced,sparse,stellate,suture,testal,transparent,triangular,tuft,twinin,ud,unit,upper,vary,vein,weak,within,yellowish,ympodial	abaxial,adaxial,arrangement,bark,characteristic,colour,exertion,filament,form,fruit,glabrousnes,hair,height,history,inflorescence,leaf,length,life,lobing,ovary,plant,seed,seen,shape,size,texture,white
13	wfo-0001025788	success	158	69	48	110	21	0.304	0.5-2,1-4,1-5,10-24,14-48,15-30,2-10,2-13,2-3,2-5,2.8-9.5,4-5.5,4.5-10.1,4.5-12.5,5-8,6.2-12.5,blue,calyx,cm,corolla,deep,diameter,filament,finely,forked,green,green-white,herbaceous,interjected,lateral,leaf,leaflet,medium,mm,mucilaginous,odd-pinnate,ovoid,pedicel,peduncle,perennial,petiole,plant,pubescent,purple,seed,size,style,terminal	-8,0-6,1.8-2.7,1.8-3.9,2m,3-,3-6-foliat,4-3.,6-7,8-38,abaxiall,abaxially,acumen,acuminate,acute,adaxially,apex,apical,apically,articulate,attenuate,base,branched,cell,conical,connate,covering,cuneate,cyme,dehiscent,dichasial,dichasially,digestion,diminishing,distal,dorsally,eaf,ebracteate,edge,eed,elliptical,emoval,enzyme,exceeding,flat,flower,folded,generally,globo,gradually,hair-like,half,honeycomb,introrse,living,lobe,lon,long,long-attenuate,lower,lunat,make,maturing,monochasial,narrowly,nflorescence,nther,oblique,obtuse,often,orolla,ovate,pair,pattern,perfect,petiolule,plan,poricidally,proximal,reveal,rotate,rounded,ruit,sessile,seudostipule,short,slit,specimen,stamen,stigma,straight,subequal,subsessile,tal,tem,testal,thick,throughou,throughout,tip,toward,tuber-bearing,typically,unit,vary,wall,wide,yellow,ympodial,Â¼	4-31,abaxial,adaxial,anther,arrangement,colour,form,fruit,growth,height,history,inflorescence,length,life,ovary,pseudostipule,shape,stem,surface,texture,width
14	wfo-0001025792	success	203	113	91	112	22	0.448	0.4-0.7,1-2,1-3,10-15,2-3,2-3.5,2.5-3.5,2.5-4,21-28,3-5,3.5-6,4-12,4-6,4.5-7,5,5-10,5-9,7-10,7.5-8,8-10,9-12,abaxially,acuminate,adaxially,anther,auriculate,berry,blade,blue-mauve,blue-purple,brownish,cell,chartaceous,cm,condition,corolla,covering,dark,densely,diameter,drying,elliptic,filament,flower,forked,fresh,fruit,glabrous,globose,green,greenish,hair-like,herb,interjected,lateral,leaflet,lobe,long,mauve,membranous,minute,mm,narrow,narrowly,odd-pinnate,ovoid,pedicel,peduncle,petiole,plant,pubescent,purple,ripe,rotate-pentagonal,seed,semi-rosette,shortly,size,stem,stigma,streak,style,terminal,testal,thick,tinged,wall,white,whitish,wing,x	1-10,1-4,2-11,3-4,5-6,5-merou,acumen,acute,ag,along,alyx,apart,apex,apparently,articulated,articulation,axe,axillary,base,basiscopic,broadly,bud,capitat,ciliate,connivent,decurrent,developing,digestion,distal,distinct,distinctly,dorsally,eaf,edge,eed,enzyme,especially,exceeding,except,flat,folded,geminat,generally,glabrou,greatly,green-white,hair,hal,half,high,homostylous,honeycomb-shaped,indistinct,lanceolate,lengthening,like,living,lower,make,margin,midrib,minutely,mottle,mucilaginous,nflorescence,oblique,often,onto,orolla,pair,papillose,perfect,petiolulate,plurifoliate,pore,poricidal,proximal,puberulent,rachi,reduced,removed,rounded,ruit,semi-erec,sessile,seudostipule,short,side,slightly,slit,spaced,specimen,stamen,ste,straight,sub-rosette,subequal,subtending,tall,tamen,tem,throughout,tip,tri-,tube,unit,usually,vary,wet,yellow,ympodial,young	arrangement,calyx,capitate,characteristic,colour,form,growth,height,history,inflorescence,leaf,length,life,mottled,number,ovary,pseudostipule,shape,staman,surface,texture,type
15	wfo-0001025804	success	155	116	92	63	24	0.594	.25,.5,0.5-1,1-3,1.2-1.5,1.4-1.7,1.5-2,16-35,3.5-12,4-10,6-8,7-10,abaxially,acute,adaxially,anther,apex,attenuate,bark,base,berry,bilobed,branched,calyx,clavate,cm,corolla,cream,dark,decurrent,deflexed,dia,difoliate,drying,ellipsoid,elliptic,erect,exserted,filament,flattened,fleshy,fruiting,glabrous,globose,green,incrassate,internodal,lateral,leaf,light,lobed,long,main,many,margin,minutely,mm,near,nearly,obovate,occasionally,often,onto,opposite,ovary,pair,paler,pedicel,pitted,plurifoliate,poricidal,red-papillose,reddish-brown,reniform,sessile,shrub,size,somewhat,stem,stigma,strongly,style,surface,thick,time,tip,tube,vein,white,whitish-green,winged,x	1-1.5,10-20,11-20,2-2.5,2.5-4,3-4.5,5,?,age,anthesi,apar,ape,apiculate,ba,c.,conical,covered,cucullate,densely,differing,eaf,edicel,eed,flower,free,geminat,glandular,later,lengthening,lobe,lower,major,mere,middle,minor,minute,nflorescence,older,papillae,papillat,papillate,papillose,planar,pore,portion,projection,red,reddish-brow,regularly,rim,ruit,scar,slit,spaced,tall,tub,ud,unit,widest,wing,woody,ympodial,young	arrangement,bud,characteristic,colour,diameter,exertion,form,fruit,geminate,growth,height,history,inflorescence,length,life,lobing,na,peduncle,plant,primary,seed,shape,texture,type
16	wfo-0001025813	invalid_json	197	112	83	114	29	0.421	'',0-2,0.7-1.7,1-1.5,1-10,1-2,1-4,1.2-4.5,1.3-7,1.5-1.8,1.5-6.5,15-30,2-4,3-3.5,3-4,3-5,3-6,3-7,5-18.5,5-6,6-7,``,abaxially,absent,adaxially,anther,base,berry,blade,blue,borne,brownish,chartaceous,cm,condition,corolla,dark,densely,diameter,drying,end,filament,flower,fresh,fruit,glabrous,globose,green,greenish,hair,herb,homostylous,interjected,lateral,leaflet,light,lobe,long,membranous,minute,mm,monochasium,odd-pinnate,ovoid,pedicel,peduncle,pilose,pubescent,rarely,seed,singly,size,stem,stigma,style,terminal,tube,tuber,typically,violet,white,whitish,x	1.5-2,2-3,2-5,5-merou,acumen,acuminate,acute,ag,along,alyx,apart,apex,apparently,articulated,axe,broadly,cell,ciliate,connivent,contracted,covering,cuneate,decreasing,decurrent,digestion,discussion,distal,distinct,dorsally,eaf,edge,eed,elliptic,enzyme,especially,exceeding,extra,flat,folded,geminat,glabrou,green-white,hair-like,half,highly,honeycomb-shaped,lanceolate,larger,lengthening,like,living,longer,lower,make,margin,midrib,minutely,mucilaginous,near,nflorescence,obtuse,often,orbicular,orolla,ovate,ovoi,pair,perfect,petiole,petiolulate,plant,plurifoliate,pore,poricidal,puberulent,rachi,removed,rosette-formin,rotate,ruit,see,sessile,seudostipule,short,single-flowered,slit,sometimes,spaced,species,specimen,stamen,ste,stolo,straight,strongly,suborbicular,tamen,tem,testal,thick,thir,throughout,tip,toward,tri-,unforked,unit,unwinged,vary,vein,wall,wet,yellow,ympodial	'extra,[,],arrangement,calyx,characteristic,colour,form,glabrousnes,growth,history,inflorescence,leaf,length,life,ovary,presence,pseudostipule,pubescence,rosette-forming,shape,spacing,staman,stolon,texture,type,value,{,}
17	wfo-0001025825	success	187	139	111	76	28	0.594	0-0.21,0.4-1,0.5-0.8,0.5-10.4,0.9-2,1-2,1-3,1.1-1.4,10-24,10.5-26,14-85,2-3.7,2-5,3-10,3-5,3.7-6.5,4-8,4-9,5-10,5-7,6-10,6.6-14,abaxially,acuminate,acute,adaxially,anther,apex,axillary,back,base,berry,blade,brownish,bud,cell,clavate,cm,condition,connivent,coriaceous,corolla,covering,cuneate,dark,diameter,distal,drying,elliptic,filament,flower,forked,fresh,fruit,generally,glabrescent,glabrous,green,green-white,greenish,hair,hair-like,half,herb,homostylous,interjected,lanceolate,lateral,leaf,leaflet,light,lilac,lobe,long,make,medium,mm,mucilaginous,odd-pinnate,ovate,ovoid,pair,pedicel,peduncle,pentagonal,plant,rotate-pentagonal,seed,shiny,short,size,stigma,straight,streak,style,subtending,terminal,testal,thick,throughout,tube,unwinged,usually,wall,wet,white,whitish,wing,winged,x,yellow	0.4-3,0.7-2.2,0.9-4,1-5.5,22-86,3-8.5,5-merou,acumen,adaxiall,ag,alyx,apart,apparently,articulated,asymmetric,attenuate,axe,basiscopic,capitat,decreasing,decurrent,digestion,dorsally,eaf,edge,eed,enzyme,erec,exceeding,flat,folded,geminat,glabrou,hal,high,honeycomb-shaped,increasing,lengthening,living,lower,middle,nflorescence,orbicular,orolla,perfect,petiole,petiolulate,plurifoliate,pore,poricidal,rachi,removed,rounded,ruit,sessile,seudostipule,side,slightly,slit,smaller,spaced,specimen,stamen,subequal,subglabrou,tall,tamen,tem,tip,tissue,toward,tri-,unit,vary,wide,ympodial	abaxial,adaxial,arrangement,calyx,capitate,characteristic,colour,connivence,erect,form,glabrousnes,growth,height,history,inflorescence,length,life,ovary,pseudostipule,shape,spacing,staman,stem,subglabrous,surface,texture,type,width
18	wfo-0001025838	success	217	120	102	115	18	0.47	0.5-1,0.7-2,1-1.2,1.5-1.7,1.5-3.5,1.5-5,1.8-2,2-2.5,2.5-3,2/3,20-40,4-15,6.5-7,acuminate,adaxial,anther,anthesi,apex,attenuate,base,berry,black,brown,calyx,capitate,clavate,cm,corolla,dendritic,dense,densely,diameter,ellipsoidal,elliptic,entire,erect,exserted,filament,flattened,fleshy,fruit,fruiting,glabrous,globose,greenish,growth,inflorescence,lanceolate,lateral,leaf,like,lobed,long,margin,membranous,minute,minutely,mm,narrowly,new,nodding,often,onto,ovoid,pale,pedicel,peduncle,per,petiole,pitted,pointed,pubescent,purple,reddish,reniform,revolute,ripe,seed,shrub,simple,slender,slightly,sometimes,sparsely,stem,stigma,strongly,style,surface,terminal,tinged,tree,trichome,tube,tuft,turbinate,way,white,winged,x,yellow,Â¾	-20,.5,0.5,1-1.5,1.2-5,1.5-2,1.5-2.5,10-15,10-60,2-5,3.5-,4.5-5.5,5,5-merou,6-15,abruptly,adaxially,ag,along,alyx,apart,apiculate,appearing,archin,ark,articulated,axil,basall,branch,branched,broad,cell,clustered,connivent,cucullate,cup-shaped,dark,decurrent,denser,disintegrating,drying,eaf,eed,extending,flower,free,glabrescent,hairy,ilament,inserted,insertion,irregularly,keeled,lamina,lengthening,less,lobe,loosely,lower,m.,many,midrib,mostly,narrowing,never,nflorescence,occasionally,older,orolla,pair,papillat,papillo,perfect,pericarp,platform,plurifoliat,point,pore,poricidal,portion,primary,quadrate,ruit,scar,shin,shiny,short,sinus,sleeve,slit,small,spaced,spreading,square,stellate,tall,tem,testal,thi,thin,time,tip,twinin,ud,uniseriate,unit,upper,vary,vein,wall,weight,wing,woody,yellowish,ympodial	abaxial,arrangement,bud,characteristic,colour,exertion,form,glabrousnes,height,length,lobing,number,ovary,plant,shape,size,texture,type
19	wfo-0001025845	success	180	100	83	97	17	0.461	0.3-0.5,0.4-1.5,0.5-11,0.5-2.5,1-1.8,1-4.5,1.5,1.5-13,1.5-2,1.5-2.5,2,2-15,2-5-lobed,2.5-4,3-13,4-5,4-6,6-6.5,6-9,acuminate,acute,anther,apart,apex,apiculate,base,branch,brown,calyx,cm,compressed,corolla,cuneate,deltate,diameter,distally,ellipsoidal,entire,extra-axillary,filament,flattened,fork,fruit,glabrous,greenish,herb,laterally,leaf,light,lobed,located,margin,minutely,mm,narrowly,obtuse,orange,ovoid,pedicel,peduncle,petiole,pinnately,puberulent,rachi,rotate-stellate,rugose-verrucate,sagittate,shrub,simple,sparsely,stigma,strongly,style,subcordate,tapered,tip,triangular,truncate,unbranched,unlobed,white,x,yellow	.5,1,1-2,1.5-7,2-3,3,3-4,3-6,3-foliat,5-6,7-10,abaxially,abundantly,adaxial,adaxially,aggregate,along,around,articulated,ascending,axe,ba,blade,cell,channe,chartaceous,connivent,cylindrical,dark,decurrent,diamete,directed,distall,divided,eaf,eed,eglandular,elliptic,especially,flower,free,glabrou,green,inserted,lateral,lobe,long,longitudinal,lower,major,membranaceous,mesocarp,midrib,near,nearly,nflorescence,obovate,often,orolla,ovate,part,patch,perfect,pore,pubescent,purple,radiu,rarely,rounded,ruit,sand-punctate,shorter,side,sinus,small,spaced,stone,stripe,tal,tamen,tem,terminal,thecae,thick,tightly,time,tomento,truncat,tube,unit,vary,vein,veiny,wide,yellowish,ympodial,youn	arrangement,characteristic,colour,form,growth,height,inflorescence,length,ovary,plant,seed,shape,size,spacing,stem,texture,thicknes
20	wfo-0001025850	success	197	133	110	87	23	0.558	-5,.5,.8,0.5,0.5-,0.5-1,0.5-3,0.6-1,1,1-1.5,1-3,1.5-5,15-20,2,2-6.5,30,6-7,acute,anther,anthesi,apex,articulated,axi,basal,base,berry,branched,brown,calyx,capitate,cm,corolla,cyathiform,deflexed,diameter,divaricate,ellipsoid,elliptic,entire,erect,exserted,filament,flattened,flower,fruiting,glabrous,glandular,globose,green,growth,half,inflorescence,irregularly,lamina,later,lateral,lax,leaving,lobed,long,many,margin,minute,minutely,mm,narrowly,nearly,new,nodding,often,openly,orange,pale,pedicel,peduncle,peg,per,petiole,pinnatifid,pitted,pubescent,reddish,reniform,rhomboid,ripe,rounded,scattered,shallowly,shrub,simple,sleeve,slender,small,spreading,stem,stigma,strongly,style,surface,tan,terminal,time,tiny,trichome,tube,uniseriate,vine,white,woody,x	-7,1-celled,1.5,2-12,3-4,4-5,5-7,5-merou,abaxial,ag,along,alyx,apar,apparently,ark,broadly,cell,connivent,cupped,deciduous,deltate,densely,denser,divided,drying,eaf,eed,elongate,em,extending,fleshy,free,geminat,glabrou,gland,halfway,ilament,lengthening,less,lobe,loosely,lower,membranous,midrib,nflorescence,node,occasionally,older,orolla,outline,pair,papillate-puberulent,papillo,perfect,planar,plurifoliate,pore,poricidal,portion,primary,puberulen,ruit,scar,shiny,sinuate,sinus,slightly,slit,sometimes,soon,spaced,splitting,spreadin,stellate,surfac,testal,thin,tip,truncate,twinin,ud,unit,vary,vein,yellow,ympodial,young	arrangement,bark,characteristic,colour,exertion,form,fruit,glabrousnes,height,history,leaf,length,life,lobing,number,ovary,plant,puberulent,seed,shape,size,texture,type
21	wfo-0001025872	success	160	99	81	79	18	0.506	0.6-1,1,1-1.3,1-2,1.2-1.5,1.2-1.6,1.7-3,2-2.5,2-5,2/3,3.5-4,4.5-13,6-10,6-8,acute,anther,apex,bark,base,becoming,berry,broadly,brownish,calyx,capitate,cm,corolla,crinkled,cup-shaped,dark,decurrent,deeply,densely,dia,dry,elliptic,flattened-reniform,fleshy,fruiting,glabrous,globose,green,greenish-tan,later,lateral,leaf,live,main,margin,mm,narrowly,occasionally,older,onto,opposite,ovary,pair,pedicel,petiole,pitted,plant,pubescent,red-papillose,revolute,rounded,shaped,shrub,stem,stigma,style,surface,tapering,tear-drop,terminal,thick,tube,vein,way,white,x,young	.1,.5,0.25-0.5,0.5,0.5-1,1-1.5,10-25-flowered,4-4.5,along,anthesi,apart,apically,auriculate,ba,beginning,beneath,blade,branched,bright,coriaceous,crowded,deflexed,dense,eaf,edicel,eed,exserted,filament,flattened,flower,free,glandular-resinous,grayish-brow,incrassate,inflorescenc,irregularly,junction,lobe,lobed,lon,long,lower,material,midrib,minutely,nflorescence,often,paler,papillae,papillo,papillose,planar,plurifoliat,pore,poricidal,portion,prominent,rounded-triangular,ruit,scar,several,simple,somewhat,soon,spaced,specimen,straight,tall,thickened,time,tip,trichome,tub,ud,uniseriate,unit,visible,woody,ympodial	arrangement,characteristic,colour,diameter,form,fruit,grayish-brown,growth,height,inflorescence,length,lobing,primary,seed,shape,size,texture,type
22	wfo-0001025893	success	157	99	76	81	23	0.484	.25,.4,.5,0.5-1.5,0.8-1,1-1.2,1-4,1.5-1.7,1.5-2,11-20,2-3,5-6,anther,bark,base,berry,bi-lobed,branched,brownish-green,calyx,capitate,cm,corolla,densely,dia,early,ellipsoid,elliptic,even,exserted,faintly,filament,fruit,fruiting,glabrate,glabrous,globose,golden-puberulent,green,greyish,internodal,leaf,long,longitudinally,minutely,mm,narrowly,obovate,occasionally,older,opposite,ovary,ovoid-reniform,pale,papillose,pedicel,petiole,pitted,pore,poricidal,red-papillose,shaped,shrub,slender,sometimes,stem,stigma,style,surface,tapering,tear-drop,tip,tube,white,x,young	1-1.5,1-2.5,2-2.5,3-5,6-10,accrescent,along,anthesi,apex,attenuate,bank,barely,bearing,beginning,beneath,blade,broadly,closely,cup-shaped,decurrent,deflexed,deltoid,difoliate,dry,eaf,eed,erect,flower,free,geminate,gravelly,growing,impressed,inflorescenc,lateral,lobe,lobed,lon,long-acuminate,lower,main,many,margin,material,middle,nearly,nflorescence,overlapping,pair,papillo,planar,plurifoliat,portion,puberulent,reflexed,river,rocky,ruit,sandy,scar,slightly,spaced,specimen,straight,stream,striat,tall,thickened,time,trichome,ud,unicellular,unit,usually,vein,visible,widest,winged,woody,yellowish,ympodial	abaxial,adaxial,alternate,arrangement,bud,characteristic,colour,diameter,exertion,form,growth,height,history,inflorescence,length,life,plant,seed,shape,size,striate,texture,type
23	wfo-0001025896	success	146	122	71	75	51	0.486	-3,-30,0.5,0.5-2,1-6.5,1-8,1.5-2,2-14,4,4-23,4-5,5-15,6-10,7743,acosta,acuminate,adaxially,also,angled,apex,base,brownish,calyx,chartaceous,cm,cuneate,densely,diameter,eglandular,elliptic-ovate,entire,flower,forked,fruit,glabrous,gland,globose,hair,lobe,margin,mm,moderately,nearly,obtuse,often,orange,ovate,pale,pedicel,peduncle,petiole,pubescent,purple,red,ripe,rugose,short-stalked,shrub,simple,smooth,solÃ­,stem,stigma,style,subcordate,surface,tube,unbranched,vein,white,x	.5-2.5,1-1.5,1-25,1-3,1.5-9,10-15,10-25,2-2.5,2.5-14,2.5-5,4-12,4-6,5-7,6-13,7-,abaxial,abaxially,absen,acute,adaxiall,aggregate,apart,articulated,axe,ba,blade,branched,cell,connivent,constricted,cylindrical,deltate,dendritically,directed,distall,eaf,eed,especially,greenish,inflated,like,long,lower,many-foliat,membranaceous,near,nflorescence,nther,occasionally,orolla,perfect,pore,present,puberulent,pubescen,rachi,radiu,rotate-stellate,ruit,spaced,sparsely,stalked,stone,tal,tem,time,tip,triangular-ovate,triangular-subulate,truncat,unit,vary,wide,yellow,ympodial	anther,appearance,arrangement,bark,border,branch,bud,characteristic,colour,corolla,corrugation,distal,drying,exertion,filament,form,fruiting,giving,glabrousnes,growth,height,history,inflorescence,interjected,lateral,leaf,leaflet,length,life,lobing,midpoint,na,new,number,ovary,per,plant,prickle,primary,pseudostipule,ray,seed,shape,size,terminal,texture,thicknes,truncate,type,variation,width
24	wfo-0001025902	success	211	136	114	97	22	0.54	.2,.5,/2,0.1-0.5,0.5-2.5,1-1.2,1-1.5,1.2-1.5,1.5,1.5-2,1/3,11-15,1983,2.5-4,4,4-13,5-6,abaxially,acute,adaxially,along,anther,anthesi,apex,articulated,attenuate,axi,bark,base,becoming,berry,black,c.,cabrera,calyx,clavate,cm,completely,corolla,densely,diameter,dull,ellipsoid,entire,exserted,fide,filament,flattened-reniform,flower,fruiting,glabrous,globose,green,growth,inflorescence,lanceolate,lateral,leaf,leaf-opposed,leaving,length,linear,lobed,long,lower,margin,mature,minute,minutely,mm,new,occasionally,ovary,pale,papillose,pedicel,peduncle,peg,perfect,petiole,pitted,pubescent,ridged,rotate-stellate,rounded,scattered,scrambling,simple,sleeve,small,sometimes,sparsely,stem,stigma,strongly,style,surface,tangled,tapering,terminal,trichome,tube,uniseriate,vine,violet,way,weak,whitish,wing,woody,x,yellow,yellowish,Â½	0.5-2,1.5-3,2-6,3-10,4-5,4-6,40,5-merou,8-10,8-15,8-9,>,absent,accompanied,ag,aid,always,alyx,apar,ark,beginning,berr,branch,branched,branching,broadly,cell,chartaceous,circular,climbin,conical,connivent,deciduou,deltate,eaf,eed,either,except,exfoliatin,fleshy,free,geminat,ilament,lengthening,less,lobe,loosely,low,markedly,midvei,nflorescence,obscured,often,older,one,orolla,pair,papillat,pendant,per,pericarp,planar,plurifoliate,pore,poricidal,portion,primary,prominent,revolute,ruit,scar,semi-aquati,semi-circular,shallow,slender,slit,somewhat,soon,spaced,spreading,tem,testal,thin,time,tip,twining,ud,ultimate,unit,usually,vary,vegetation,vein,water,weight,widely,ympodial	5-merous,arrangement,articulation,bud,characteristic,colour,exertion,form,fruit,glabrousnes,height,history,life,midvein,na,plant,pubescence,seed,shape,size,texture,type
25	wfo-0001025906	success	188	116	91	97	25	0.484	0-14,0.1-2,0.15-0.6,0.2-0.6,0.20-0.60,1-2,1.1-2,1.6-12.4,1.8-4.8,16-51,2-4.4,2-6,2.6-5.2,3-10,4-5,4-7,5-6,5-7,5.2-9,8-16,8.5-12.5,abaxially,adaxially,anther,berry,blade,blue,brownish,cell,clavate,cm,condition,coriaceous,corolla,covering,dark,diameter,drying,filament,flower,fresh,fruit,glabrous,globose,green,green-white,greenish,hair,hair-like,herb,homostylous,interjected,lateral,leaf,leaflet,light,lilac,lobe,long,make,mm,mucilaginous,odd-pinnate,ovoid,pedicel,peduncle,petiole,plant,pubescent,purple,ripe,seed,shiny,short,size,stigma,stripe,style,sub-glabrous,subglabrous,terminal,testal,thick,throughout,tube,unwinged,wall,wet,white,whitish,x	1-3,1-6,3-5,4-10,4-12,5-merou,acumen,acute,adaxiall,ag,alyx,apart,apex,apparently,articulated,axe,axillary,base,bud,capitat,connivent,cuneate,decreasing,decurrency,decurrent,delimited,digestion,diminishing,distal,dorsally,eaf,edge,eed,enzyme,erec,exceeding,falcate,first,flat,folded,forked,geminat,generally,glabrou,hal,half,high,honeycomb-shaped,lanceolate,lengthening,linear,living,lower,next,nflorescence,obtuse,orolla,pair,pentagonal,perfect,plurifoliate,pore,poricidal,rachi,removed,rotate,ruit,second,sessile,seudostipule,slightly,slit,smaller,spaced,sparsely,specimen,stamen,straight,subequal,subglabrou,subtending,tall,tamen,tem,third,tip,toward,tri-,typically,unit,usually,vary,well,width,wood,yellow,ympodial	5-merous,abaxial,adaxial,arrangement,calyx,capitate,characteristic,colour,erect,form,growth,height,history,inflorescence,length,life,ovary,pseudostipule,shape,staman,stem,surface,texture,type,woody
26	wfo-0001025907	success	148	113	94	54	19	0.635	.05,.5,.5-1,0,0.8-1.8,1,1-1.2,1-2.3,1-3,1-5,1.5-2,1.5-2.2,12-45,2,2-3.5,2-8,2/3,3-,4-5,5-15,acuminate,acute,along,anther,anticlinal,apex,attenuate,axillary,base,beak,berry,brown,c,cell,cm,conical,densely,diameter,elliptic,epidermal,filament,fruit,fruiting,glabrous,globose,green,greenish,growth,highly,iquito,irregular,isolated,lobed,long,lower,margin,minutely,mm,near,nearly,new,obovate,ovary,ovoid-reniform,papillate,papillose,pedicel,per,petiole,plant,population,poricidal,projection,pubescent,red-papillate,round,rugose,scattered,seed,shrub,simple,sinuous,size,stigma,style,surface,thickening,tip,trichome,truncate,tube,uniseriate,without,x	-4,0-60,10-15,3-4,3/2,absent,anthesi,anthesis5-7,appearing,axil,bearing,breaking,calyx,clavat,conspicuously,deciduous,eaf,edicel,eed,erec,flattened,flower,free,included,lamina,lobe,lon,nflorescence,occasionally,open,pair,portion,primary,raised,reflexed,remaining,ruit,scar,single-stemmed,slender,soon,sparsely,tal,tem,time,tub,ud,unifoliat,unit,variable,vein,white,white-lenticellate,ympodial	5-7,arrangement,bud,clavate,colour,form,glabrousnes,height,history,inflorescence,leaf,length,life,number,perennial,shape,stem,texture,type
27	wfo-0001026203	success	197	128	105	92	23	0.533	0-39,0.06-0.86,0.3-11,0.38-11.3,0.4-3,0.5-2.3,0.7-2.6,1-13,1-2,1-4,1-9,1.2-5.5,2-10,2-4.9,2-43,2-5,2-8.5,3-10,3-11,3.2-23,7-47,anther,axillary,berry,blue,brownish,bud,cell,clavate,cm,condition,coriaceous,corolla,covering,dark,deep,diameter,distal,drying,elliptic,filament,flower,forked,fresh,fruit,generally,glabrescent,glabrous,globose,green,green-white,greenish,hair,hair-like,half,herb,homostylous,interjected,lanceolate,lateral,leaf,leaflet,light,lilac,lobe,long,make,medium,mm,moniliform,mucilaginous,odd-pinnate,ovate,ovoid,pair,pedicel,peduncle,pentagonal,petiole,plant,ripe,rotate,seed,short,size,sometimes,stigma,straight,stripe,style,subglabrous,subtending,terminal,testal,thick,throughout,tube,tuber,unwinged,usually,wall,wet,whitish,wide,x	0-7,0.3-6,0.5-3.2,1-5,1.1-7.9,2.2-13.3,3-5,3.2-22,5-merou,abaxially,acumen,acuminate,acute,adaxially,ag,along,alyx,apart,apex,apparently,arranged,articulated,asymmetric,attenuate,axe,base,basiscopic,bead,blade,capitat,connivent,decreasing,decurrent,digestion,dorsally,eaf,edge,eed,enzyme,erect,exceeding,flat,folded,geminat,glabrescen,glabrou,hal,high,honeycomb-shaped,lengthening,like,linear,living,lower,middle,multiple,necklace,nflorescence,orbicular,orolla,perfect,plurifoliate,pore,poricidal,rachi,removed,rosett,rounded,ruit,sessile,seudostipule,side,slightly,slit,spaced,specimen,stamen,stolon,subequal,tall,tamen,tem,tip,tissue,toward,tri-,typically,unit,vary,white,yellow,ympodial	5-merous,abaxial,adaxial,arrangement,calyx,capitate,characteristic,colour,form,growth,height,history,inflorescence,length,life,ovary,pseudostipule,shape,staman,stem,surface,texture,type
28	wfo-0001026208	success	214	110	88	126	22	0.411	/3,0.5-0.8,0.5-1.2,0.6-0.8,0.6-0.9,0.7-2,0.8-1.3,0.8-1.5,1-5,1.8-2.3,1.8-2.5,11-25,2.5-6,4-7,5-17,abaxially,acuminate,acute,anther,apex,apparently,bark,base,berry,bright,calyx,chartaceous,cm,connivent,cuneate,dark,densely,diameter,dull,elliptic,erect,evenly,filament,flattened-reniform,fruit,fruiting,glabrous,gray-greenish,green,green-brown,lateral,leaf,length,lobed,long,lower,margin,maturity,mauve,membranous,mm,moderately,orange,orange-brown,ovate,pair,pale,pedicel,peduncle,petiole,poricidal,prickly,primary,recurved,red,rounded,shrub,sometimes,spherical,stellate-pubescent,stem,style,surface,tapering,terminal,tip,unarmed,vein,way,white,wide,yellow,young	-1/2,-10,-3,-5,.5,0,0-20,0-4,0-5,0-8,0.1,0.1-0.2,0.1-0.25,0.1-0.3,1-2,1-4,1.5,1.5-2.5,1/3,1/4-1/3,1/4-1/6,2,2-20,2-3,2-4,2.5-5,3-30,3-5,3-6,3.5-5,3/,4-9,5,5-,5-22,5-merous,6-22,6-8,abaxial,acut,adaxial,alyx,apar,apart,apically,articulated,becoming,blade,branched,broad-deltate,brown,conical,curved,deltate,difoliate,discolorous,distance,drying,eaf,eed,elongated,elongating,equal,extending,flattened,flower,free,geminat,geminate,glabrescent,infructescence,lobe,longer,mature,midpoint,midvein,nflorescence,older,one,open,orolla,oung,pendulous,per,perfec,pericarp,porrect,portion,prickle,pubescent,ray,red-brow,ruit,scar,sessile,shorter,side,slender,smooth,somewhat,spaced,sparsely,spreading,stalk,stalked,stellate,stout,straight,straw-yellow,subentire,tamen,terete,tertiary,time,toward,trichome,tube,unarme,unit,usually,variously,vary,venation,visible,woody,ympodial	3/4,arrangement,branch,characteristic,colour,corolla,exertion,form,glabrousnes,growth,height,inflorescence,lobing,new,ovary,plant,red-brown,seed,shape,size,texture,type
29	wfo-0001026215	success	150	121	98	52	23	0.653	-3,.5,0,0.5-1,1-3,1.5-2,1.5-2.2,13-35,15-2,2-3,2-3.5,2-4,3/4,4-15,4-5,7-8,abruptly,absent,acuminate,anther,anticlinal,apex,base,beak,berry,broadly,brown,calyx,cell,clavate,cm,completely,conical,conspicuously,corolla,densely,diameter,elliptic,enlarged,epidermal,erect,filament,flattened-round,fruit,fruiting,glabrous,globose,green,greenish,herb,highly,horizontal,internode,irregular,kink,length,long,marked,markedly,mm,narrowing,nearly,occasionally,often,ovary,ovoid-reniform,papillae,papillate,pedicel,per,petiole,poricidal,portion,projection,purple,raised,red-papillose,rugose,seed,shrub,simple,sinuous,stem,stigma,strongly,style,surface,thickening,tip,tube,usually,way,white,white-lenticellate,white-pubescent,winged,without,x	.05,0.05,1,1.5,18-20,2,abaxially,along,anthesi,ape,axil,axillary,bifi,continually,deltate,eaf,edicel,eed,entire,exserted,flower,free,less,lobe,lobed,lower,minutely,nflorescence,noddin,nodding,onto,pair,papillat,primary,reflexed,rounded,ruit,scar,shortsympodial,single-stemmed,small,ste,tal,tem,time,tub,ud,unifoliat,unit,vein,wide,wing	abaxial,arrangement,bifid,bud,colour,form,glabrousnes,growth,height,inflorescence,leaf,lenticellate,lobing,number,plant,presence,shape,short,size,tall,texture,type,unifoliate
30	wfo-0001026229	success	299	118	86	213	32	0.288	1,35,5,acute,anther,apex,asymmetric,attenuate-caudate,base,beneath,berry,black,branch,brown,clavate,cm,corolla,cuneate,cyme,dark,densely,developed,diameter,elliptic,elongated,entire,even,flattened,flower,fruit,fully,glabrous,globose,golden,green,growth,hirsute,hispid,immature,included,inflorescence,irregular,leaf,lobed,long,margin,mature,membranaceous,mm,moderately,narrowly,nearly,new,oblong,ovate-elliptic,pale,papillose,pedicel,peduncle,per,petiole,pit,purple,reniform,revolute,rounded,shiny,shrub,simple,size,slightly,small,spreading,stellate,stem,stigma,style,surface,tree,tube,type,unbranched,white,wide,yellowish-white,Â¾	0.1â1.47,0.2â0.8,0.35,0.3â0.9,0.3â1.2,0.4,0.8â1.2,0.8â2,0.9,0.9â4.3,1-celled,1.2â4.8,1.3â1.5,1.3â1.7,1.4,1.7â11.8,1.7â2.3,1.8,1.8â5.5,1.9â2.5,1/3,13,1â1.4,1â2,1â4,2,2.3â3.4,2.8â4,2â3,2â3-celled,2â4-celled,3,3â4,3â5,4.5â6.5,4â6,5-merou,5â9,6â15,6â7,6â8,8.6â12,8â10,9â31,abaxial,abaxially,accrescent,acuminate,adaxial,adaxiall,adaxially,ag,almost,also,always,alyx,anthesi,ark,articulated,associated,axe,ba,barely,blade,branching,broadly,broken,calyx,camptodromous,capitate,celled,central,changing,commentary,commonly,completely,concentrated,connivent,cordate,covered,creating,cylindrical,deltoid,develope,differing,directed,discolorous,diÂ­,dried,drying,eaf,eed,eglandular,ellipsoidal,faces,few-rayed,found,free,frequently,fresh,geminate,glabrescent,gland,glandular,glandular-capitate,hair,head,hyaline,ilament,impressed,insertion,internodal,introrsely,involute,lamina,lanceolate,larger,lateral,less,like,lobe,long-stalked,longer,longitudinal,lower,mainly,material,maturit,midpoint,midri,midvein,minute,mixed,much,multangulate,multangulate-stellate,multiseriate,narrow-ovate,near,nflorescence,often,old,older,one,open,opening,orientation,orolla,other,oung,ovate,pair,paired,pedunculate,perfect,pink,plurifoliate,point,poorly,pore,poricidal,porrect-stellate,portion,primary,pubescent,purplish,ra,rachi,raised,rarely,ray,remnant,ruit,secondary,see,sessile,shin,short-,short-stalked,shorter,slit,smaller,solitary,sometimes,somewhat,sparsely,spread,spreadin,stalk,strongly,subopposite,subsessile,supported,surfac,terminal,three,trichome,trifoliate,tuft,ud,unequal,unit,upper,usually,vary,vein,venation,vestiture,visible,weakly,whitish-green,yellow,ympodial	0.3-1.2,0.35-4.3,1-1.4,1.2-4.8,1.3-1.7,1.7-11.8,1.7-2.3,1.8-5.5,1.9-2.5,2.3-3.4,6-7,9-31,arrangement,bark,characteristic,colour,exertion,filament,form,fruiting,glabrousnes,height,history,length,life,lobing,number,ovary,plant,seed,shape,texture
31	wfo-0001026230	success	144	126	86	58	40	0.597	.25,.5,.8,0.3-1.5,0.75-1,0.9-2,1-1.4,1.1-1.8,1.8-2.3,12.6-20.8,2-4,3-4,4.6-9.3,5-10,5-20-flowered,acuminate,acute,anisomorphic,anther,anthesi,apex,area,bark,base,berry,bud,calyx,cm,corolla,dia,distal,elliptic,erect,except,filament,fruit,fruiting,glabrous,globose,green,grey,immature,lateral,leaf,lobe,lobed,long,long-acuminate,main,margin,minutely,mm,nearly,older,ovary,ovoid,pair,papillose,pedicel,petiole,reflexed,rounded,rusty-papillose,shaped,shrub,simple,slender,slightly,small,stem,stigma,strongly,style,surface,tapering,tear-drop,tip,tree,tube,umbonate,vein,white,winged,woody,x,young	0.5-3,1-1.5,1-4,1.9-4.1,2-5,anisophyllou,apart,apiculate,appears,back,beginning,beneath,broadly,clavate,clu,completely,cordate,coroll,deflexed,deltoid,difoliate,eaf,edicel,eed,enclosing,evenly,free,geminate,inflorescenc,large,lon,long-triangular,lower,major,middle,minor,nflorescence,obtuse,opposite,orbicular,pointed,pore,poricidal,portion,raised,ruit,scar,sinus,spaced,straight,tall,thickened,ud,unit,unknown,white-lenticellat,widest,ympodial	appearance,arrangement,border,characteristic,club,colour,corrugation,diameter,drying,exertion,form,giving,growth,height,history,inflorescence,interjected,leaflet,length,life,lobing,midpoint,na,number,peduncle,per,plant,prickle,primary,pseudostipule,ray,seed,shape,size,terminal,texture,thicknes,type,variation,width
32	wfo-0001026233	success	165	104	75	90	29	0.455	-1,-1.9,-5.5,-50,.25,0.7-0.8,0.8-1.55,0.8-4,1-,1.1,1/2,2-,2.1,2.3-7,2.6,2/3,3.5-4.5,5-30,6,acute,annual,anther,apex,ascending,basal,bearing,berry,broadly,calyx,capitate,cm,conspicuous,densely,diameter,ellipsoidal,elliptic,entire,few-,filament,glabrous,globose,herb,herbaceous,leaf,less,lilac,longitudinally,margin,mm,moderately,narrowly,non-glandular,ovate,pale,petiole,pinnatisect,present,protuberance,pubescent,ridged,seed,simple,slender,sparsely,stigma,style,subglobose,surface,trans-ovoidal,trichome,tube,tuberculate,winged,x,yellow	-3.8,-8.1,.75,0.3,0.5,0.7-,0.8-1.3,1,1.2-2.7,1.5,2,2.4-3.5,3.2-3.7,3.2-4.7,4-,5-6.2,abundant,accrescent,ag,annular,antrorse,articulated,base,campanulate,coat,cuneate-attenuate,curved,cylindrical,difoliat,dimorphic,eaf,eed,embryo,evident,fruiting,hair,hig,interlobular,investing,lamina,larger,lobe,lobed,long,longitudinal,lower,membrane,minutely,multicellular,near,obtuse,occasionally,opening,orolla,other,outer,ovule,papery-scarious,partially,pinnatipartite,pore,poricidal,portion,pubescen,ree,reticulate,rounded,ruit,scarcely,seede,serrate,shorter,slightly,slit,small,smaller,striate,strongly,styl,tem,tip,unequal,unifoliate,uniseriate,unit,vary,venatio,verrucose,wider,ympodial	arrangement,bud,characteristic,colour,corolla,dimorphism,exertion,form,fruit,growth,height,history,inflorescence,length,life,lobing,na,number,ovary,pedicel,peduncle,per,plant,seeded,shape,size,stem,texture,type
33	wfo-0001026241	success	220	136	96	124	40	0.436	.5,10-20,109,2-flowered,abaxially,adaxially,anther,apex,appearing,appears,base,basiscopically,berry,black,branching,brown,calyx,capitate,cell,cm,conical,cordate,corolla,covered,cup,densely,depressed-globose,dia,dry,drying,entire,erect,erose,et,extended,filament,fruit,fruiting,galiano,glabrous,glandular-pubescent,globose,inflorescence,internodal,irregularly,leaf,lobed,margin,mm,near,oblique,open,orangish,outline,ovary,ovate,ovoid,papillate,pedicel,peduncle,per,perennial,petiole,pinnatifid,pitted,pubescent,pulp,rachi,remain,reniform,robust,seed,shallowly,sinuate,slightly,somewhat,stellate,stem,stigma,stout,style,subshrub,sulcate,surface,ternate,testa,thickened,triangular,truncate,tube,tuberculate,usually,vein,way,white,x	.2,.3,0.1â0.15,0.2â,0.3â,0.3â0.4,0.3â0.6,0.3â1,0.5,0.5â0.7,0.5â0.8,0.5â1,0.7â1.1,1-,1-celled,1.2â1.5,1.2â2,1.5â1.7,1.5â2.5,1.5â3.5,1.9â2.1,1/3â1/2,1â,1â1.1,1â1.4,1â1.5,1â2,2.5â3,2â2.1,2â3,3,3-,30â50,3â3.1,4-,4.5â5,5,5-celled,5-merous,6,always,anthesi,apical,articulated,attenuate,ba,basal,beak,brittle,broader,campanulate,center,connecting,curved,curving,darker,decurrent,deflexe,dehiscing,deltate,denser,difoliate,discrete,dwarf,eaf,eglandular,elliptic,enclosed,equal,flower,foliat,foliose,free,geminate,gland,glandular,herb,intially,larger,lateral,leaflet,like,lobe,lon,long,longitudinal,main,midvein,mixture,much,nflorescence,one,onto,papillat,perfect,pericarp,pore,portion,prolonged,pubescen,ruit,shiny,simple,slit,small,smaller,sometimes,spatulate,stamen,strongly,succulent,taproot,terminal,thick,tip,tissue,trichome,ud,uniseriate,unit,wide,wing,woody,ympodial	0.1-0.15,0.5-0.7,1-1.1,1-1.4,1-2,1-2.5,1-3.5,1.2-1.5,1.5-1.7,1.9-2.1,1/3-1/2,3-3.1,30-50,4.5-5,arrangement,branch,bud,characteristic,colour,corrugation,decurren,diameter,exertion,form,glabrousnes,growth,height,history,length,life,lobing,na,new,number,plant,primary,shape,size,texture,type
34	wfo-0001026242	success	210	144	119	91	25	0.567	-0.9,-1.5,-2,-6,/4,0,0-2,0.3-0.5,0.4-0.5,0.4-2,0.5-0.7,0.5-1,0.55-0.9,0.7-1.3,1-1.5,1-2.5,1-3,1.2-2,1.5-3,1.5-4,1/5-1/3,10-20,2-2.5,2.5-2.8,3-6.5,4.5-5.5,5-7,6.5-8,7-17,abaxially,acute,anther,apex,apically,apparently,articulated,bark,base,berry,branched,bright,broad-deltate,calyx,cm,concolorous,cuneate,deltate,densely,diameter,distance,drying,dull,elliptic,erect,evenly,extending,filament,flattened-reniform,flower,fruit,fruiting,glabrescent,glabrous,green,irregularly,lateral,leaf,length,lobe,lobed,long,margin,maturity,membranous,midvein,mm,moderately,narrow-deltate,obtuse,one,open,orange-brown,pair,pedicel,peduncle,petiole,poricidal,prickle,prickly,primary,recurved,red,red-brown,reflexed,rounded,shrub,side,sometimes,sparsely,spherical,spreading,stellate-pubescent,stem,style,subentire,surface,tapering,terete,time,tip,tube,unarmed,vein,way,weakly,white,wide,yellow,young	-5,0.05-0.2,0.1,0.35-,0.4-0.55,0.5,0.7,1/2,1/6-1/4,10-,2-5,2.5-4.5,30-80,4-10,4-13,4-5-merous,5-,5-18,8-20,abaxial,acut,almost,alyx,ame,apar,apart,blade,c.,connivent,curved,difoliate,eaf,eed,elongating,equal,eye,filiform,flattened,free,geminat,glabrou,glandular,green-gra,hair,infructescence,largely,longer,lower,mature,midpoint,minute,multangulate,naked,nflorescence,occasionally,older,orolla,oung,pale,pale-brown,per,perfec,pericarp,porrect,portion,prickl,ray,ruit,scar,sessile,shorte,shorter,simple,smooth,spaced,stalk,stalked,stellate,straight,tamen,tertiary,trichome,unarme,unit,upper,variously,vary,venation,visible,woody,ympodial	0.35-0.55,arrangement,branch,bud,characteristic,colour,corolla,exertion,form,glabrousnes,green-gray,growth,height,inflorescence,lobing,na,new,ovary,plant,seed,shape,size,stigma,texture,type
35	wfo-0001026259	success	233	127	107	126	20	0.459	.1,.7,0.3â1.2,0.4â0.6,1.0â1.2,1.0â3.3,1.2â8.4,1.4â4.0,1.5,11â22,12â24,1m,2-ridged,2â17,35â45,6,7â10,8â11,acuminate,acute,anther,anthesi,apex,base,becoming,berry,branch,broadly,brown,calyx,central,cm,concave-reniform,conical-ellipsoid,corolla,cream-coloured,cylindrical,decurrent,densely,diameter,ellipsoid,entire,exerted,filament,fruit,fruiting,glabrous,globose,green,green-orange,halfway,herb,inflorescence,internodal,lateral,leaf,length,less,lilac,long,margin,minutely,mm,nearly,often,ovary,ovate-lanceolate,pair,papillate,pedicel,peduncle,per,petiole,plant,primary,pubescent,purple,purple-coloured,rarely,recurving,ripe,rounded,shiny,simple,slightly,smooth,sparsely,spreading,star,stem,stigma,straight,strongly,style,surface,tinged,translucent,tube,turning,vein,white,wide,winged,woody,yellow,yellow-green,young	.8,0.1â0.2,0.2â0.4,0.5,0.5â0.6,0.7â0.9,0404,0â2,1,1-celled,1.5â2.0,1â2,1â2-celled,1â3-celled,2/3,2â3-celled,3.0â3.4,4â5,5-merous,5â14,5â7-celled,?,abaxial,abaxially,adaxial,adaxially,affected,age,apar,appressed,arising,beyond,branched,branching,cell,close,coloured,cone,congested,dehiscing,deltate,difoliate,drop,eaf,eed,elongating,end,especially,et,fleshy,flower,free,geminat,gradually,growt,hilum,individual,knapp,larger,leave,lengthening,like,live,lobe,lobed,lon,longer,lower,lowermost,membranous,much,narrower,narrowly,near,nflorescence,node,occasionally,once-branched,one,outline,pale,pathogen,pentagonal,perfect,pericarp,pore,poricidal,portion,positioned,purple-black,rachi,reduced,reflexed,relatively,remaining,ruit,scar,short,shorter,shrub,similar,slit,sometimes,somewhat,spaced,splitting,stellate,stone,stout,sub-laterally,tall,tapering,tem,testal,thick,tightly,tip,together,toward,trichome,two,ud,uniseriate,unit,ympodial,â15	arrangement,bud,characteristic,colour,exertion,form,glabrousnes,growth,height,history,life,lobing,new,number,perennial,seed,shape,size,texture,type
36	wfo-0001026267	success	162	109	82	80	27	0.506	.5,0.6-1.7,0.7-1.1,1-1.2,1-2.6,1.5-2,1.5-2.3,2.5-3,20-30-flowered,3-15,3-6.1,5-7,8.5-15,acuminate,acute,anther,apex,attenuate,bark,base,berry,blackish,bright,calyx,cm,corolla,cuneate,dia,distally,drying,exerted,flattened-reniform,fruiting,glabrous,globose,green,greenish-white,greyish-green,lavender,leaf,lobed,long,minutely,mm,narrowly,nearly,occasionally,often,ovary,ovate,pale,papillose,pedicel,petiole,pitted,ripening,rough,scattered,shaped,shrub,simple,size,slender,slightly,small,soon,stem,stigma,straight,style,surface,tan,tapering,tear-drop,tinge,tree,trichome,tube,uniseriate,white,x,yellow-green	.25,0.1-1,0.5-1,1-1.5,1-4,3.2-8.6,4-8,8-10,anthesi,axil,ba,beginning,beneath,body,broadly,closely,crateriform,decurrent,deflexed,densely,depressed,differing,difoliate,distinct,eaf,edicel,eed,except,filament,free,geminat,hard,incrassate,inflorescenc,larger,lateral,lobe,lon,longinflorescence,lower,main,major,margin,maturity,middle,minor,older,one,opposite,overlapping,pair,papillo,pitting,pore,poricidal,portion,pubescent,quickly,raised,reflexed,remaining,ruit,scar,scarious,softening,spaced,sparsely,tall,tip,triangular,tuft,ud,unit,vein,widest,wing,winged,woody,ympodial,young	abaxial,adaxial,alternate,arrangement,bud,characteristic,colour,diameter,exertion,form,fruit,growth,hair,height,history,inflorescence,length,life,lobing,na,number,per,plant,seed,shape,texture,type
37	wfo-0001026279	success	248	117	98	150	19	0.395	-2.9,-34.3,-5.9,0.2-0.4,0.8-2.3,0.9-1.8,1-10,1-3.5,1.1-1.9,11.5-19.7,2.6-4.8,3-4,3.4-5.2,4-7.5,8,abaxially,acuminate,adaxially,anther,anthesi,apex,attenuate,base,berry,black,blunt-tipped,branched,brown,bud,calyx,capitate,cm,conical,corolla,cuneate,dark,deltoid,diameter,drying,elliptic,elongated,entire,exerted,filament,fleshy,flower,fruit,glabrescent,globose,granular,grayish,grayish-green,green,hair,immature,lanceolate,lavender,leaf,length,lilac,long,margin,mature,mm,narrowly,oblong,obovate,occasionally,orbicular,ovate-lanceolate,pale,pedicel,peduncle,petiole,plant,rachi,reticulate-punctate,rounded,scabridulous,scabrous,short,shrub,simple,slowly,stem,stigma,style,suborbicular,surface,tomentose-pubescent,tree,unarmed,white,whitish,x,yellow,yellowish,yellowish-tan	-11.4,-4,/14-1/8,0.25-0.4,0.9-1,1-1.4,1.1-1.6,1.5-1.8,1.5-3,1.7-2.3,1.9-3,1.9-3.2,1/2,14-27,2.4-3.2,2.5-3.2,2/3,3.1-3.6,3.1-4.2,3.5-7.8,3.8-5.1,5-200,5-8,8-11,8.5-10.5,9-22,accrescent,acute,adaxiall,ag,apart,apparently,appearing,appressed,ark,around,articulated,axe,axillary,ba,blade,branch,chartaceous,closely,completely,covering,cylindrical,dendritic-echinoi,dendritic-echinoid,dense,directed,distally,due,eaf,earl,echinoi,echinoid,edge,eed,enveloping,equal,evident,expanded,farinose,few-rayed,free,fruiting,glabrescen,glabrous,half,inserted,lateral,lengthening,lobe,lobed,long-stalked,longer,longitudinal,longitudinall,lower,m.,main,many,midrib,minute,mixed,multangulate,multangulate-pubescent,multiseriate,nflorescence,occasional,often,older,open,orolla,overlapping,partly,perfect,plurifoliate,pore,poricidal,porrect-stellate,present,prominent,pseudo-terminal,pubescence,ruit,scattered,secondary,semi-ovate,sessile,short-,short-decurrent,short-stalked,side,slightly,slit,somewhat,spaced,splitting,stalk,stamen,stellate,subcampanulate,subcoriaceous,subsessile,sulcate,suture,tall,tamen,tertiary,thickened,thin,thin-stalked,time,tip,tomentose,tube,ud,unarme,unit,unwinged,upper,usually,vary,vein,way,wide,ympodial,young	abaxial,adaxial,arrangement,bark,characteristic,colour,exertion,form,growth,height,inflorescence,lobing,longitudinally,ovary,pseudoterminally,seed,shape,texture,type
38	wfo-0001026299	success	239	152	115	124	37	0.481	0-8,0.2-0.25,0.25-0.5,0.4-0.5,0.5-0.6,0.5-1,0.5-2.5,0.8-1,0.9-1,1,1-1.4,1.1-1.7,1.2-1.6,1.5-2.3,1.8-2,2.2-3.2,3.5-10,5-20,acute,almost,anther,anthesi,apex,appearance,approximately,articulated,basal,base,basiscopically,beneath,broadly,brown,calyx,capitate,cell,cm,conical,corolla,crenate-serrate,dark,decurrent,densely,diameter,distal,elliptic,entire,exserted,filament,flower,fruit,fruiting,glabrous,glandular,globose,green,hair-like,half,herb,imparipinnate,inflorescence,interjected,interrupted,irregularly,lanceolate,lateral,leaf,leaflet,lobe,lobed,long,margin,middle,minute,minutely,mm,oblique,obovate,outgrowth,ovary,pale,pedicel,peduncle,pentagonal,perennial,petiole,primary,pseudostipule,pubescent,regularly,short,silky,simple,size,sparsely,stem,stigma,straight,stripe,style,surface,terminal,testa,thick,tip,trichome,truncate,tube,variously,vein,velvety,wall,way,white,wide,yellow	--,-0.8,-1,-10,-2.5,-3.5,-5,.5,0.1-0.2,0.1-0.25,0.1-0.4,0.1-0.5,0.15-0.2,0.2-1,0.3-0.4,0.4-2,0.5,0.5-0.7,0.6-2,0.7-3.5,0.8-0.9,1-celled,1.2-5,1.5-,2-4,2-6,2-foliate,2-locular,2.5,2.5-7,25,3-,5,5-15,6-20,7-12,abaxially,absent,abundant,acroscopically,adaxially,along,angled,apical,appendage,axi,berr,bract,bracteate,change,chota,column,could,crenat,developed,diamete,eaf,ebracteate,edicel,eed,eglandular,erect,give,gree,hal,head,intermixed,internode,investing,jequetepeque,lacking,larger,less,like,lon,long-acuminate,longer,loosely,lower,maraÃ±Ã³n,maturity,mixture,multicellular,narrowly,nearly,nflorescence,node,occasionally,often,pair,patent,petiolule,population,present,prostrate,pubescence,purple,rachi,reflexed,rest,ruit,scarcely,scattered,secondary,sessile,sparse,spreading,staminal,sterile,stout,tall,tem,tertiary,toward,ud,unicellular,uniseriate,unit,usually,valley,weak-walled,winged,woody,ympodial	1-7,2-15,arrangement,bark,berry,border,branch,bud,characteristic,colour,corrugation,drying,exertion,form,giving,glabrousnes,growth,height,history,length,life,lobing,midpoint,na,new,number,per,plant,prickle,ray,seed,shape,texture,thicknes,type,variation,width
39	wfo-0001026305	success	135	102	80	55	22	0.593	.25,/4,0.2-1,0.25-0.5,0.5-2,0.6-1,0.7-1,1-1.5,1.3-1.5,2-6-flowered,3-8.5,5-7,6-9,7-16,abaxially,acute,adaxially,anther,apex,area,attenuate,base,beige-tan,berry,calyx,cm,congested,corolla,dendritic,densely,dia,difoliate,elliptic,exserted,filament,fruiting,glabrate,glabrous,globose,green,greenish-white,leaf,leaf-opposed,like,lobed,long,minute,minutely,mm,occasionally,older,ovary,ovoid-reniform,pale,papillose,pedicel,petiole,pitted,pore,poricidal,pubescent,rounded,shaped,shining,shrub,simple,stem,stigma,strongly,style,surface,tan,tear-drop,tip,trichome,tube,unifoliate,way,x,young	2-2.5,2.5-3,4-4.5,7-9,abaxial,along,anthesi,apical,ba,bark,closely,conical,dark,deflexed,deltate,drying,eaf,edicel,eed,free,geminat,interlocking,knob-like,lamina,lateral,lobe,lon,lower,main,margin,middle,midrib,nflorescence,overlappin,pair,planar,portion,projection,reddish-brow,ruit,scar,scattered,slender,spaced,sparsely,styl,tall,tub,ud,unit,vein,visible,widest,woody,ympodial	arrangement,bud,characteristic,colour,diameter,exertion,form,fruit,geminate,growth,height,history,inflorescence,length,life,lobing,plant,seed,shape,size,texture,type
40	wfo-0001026307	success	193	154	119	74	35	0.617	.6,0.2â0.5,0.2â1.5,0.5â0.7,0.5â5.0,0.8â2,1.0â1.2,1.0â2.0,1.0â2.4,1â3-celled,1â6-celled,2.0,2.0â3.5,2/3,3.5â7.0,35â45,3â8,3â8-celled,4â5.7,8â12,9,abaxial,acute,acute-acuminate,adaxial,angled,anther,anthesi,apex,appressed,articulated,base,berry,black,broadly,calyx,central,clavate,cm,corolla,cuneate,cylindrical,decurrent,densely,diameter,ellipsoid,entire,exerted,eye,facing,filament,flattened-reniform,flower,fruit,fruiting,glabrous,glandular,globose,green,growth,herb,internodal,lateral,length,like,lobe,lobed,long,margin,membranous,minutely,mm,narrowing,new,ovary,ovate,paler,pedicel,peduncle,per,petiole,pubescent,purple,purple-yellow,reflexed,restricted,ripe,shallow,shallowly,shape,shrub,side,simple,sparsely,spreading,stem,stigma,straight,strongly,style,surface,tinged,tip,toward,translucent,triangular,trichome,tube,turning,undulate,uniseriate,variable,vein,vigorous,weak-stemmed,white,wide,yellow,yellow-green	.0â1.2,.3,.5,.5â4.0,.8,0.4,0.5â0.6,0.6,0.8â0.9,0.8â5,1.0â1.5,1.0â2.5,2.0â3.0,2.6â13,3.0â4.0,5-merous,5â7,abaxially,adaxially,age,apar,becoming,beyond,cell,cone,difoliate,eaf,eed,end,free,geminat,gradually,hilum,later,lengthening,longer,lower,middle,narrower,nflorescence,one,outline,pair,papillat,pentagonal,perfect,pore,poricidal,portion,positioned,primary,recurved,reflexe,ruit,scar,shorter,slightly,slit,spaced,ste,stellate,stone,sub-laterally,tal,tem,testal,three,two,ud,unequal,unevenly,unit,upper,ympodial	0.8,appearance,arrangement,bark,border,branch,bud,characteristic,colour,distal,exertion,form,giving,glabrousnes,height,history,inflorescence,interjected,leaf,leaflet,life,lobing,na,number,papillate,plant,prickle,pseudostipule,seed,size,terminal,texture,type,variation,width
41	wfo-0001026317	success	169	109	87	82	22	0.515	/4,0.3-1.2,0.5,0.5-0.6,0.7-0.9,0.8-1,1-1.2,10-12,2-2.5,2-4,2.5-10,3-3.5,4-5,6x,absent,acuminate,acute,anther,anthesi,apex,approximately,attenuate,bark,base,berry,branched,bright,brown,capitate,clonal,cm,conical,corolla,dark,dendritic,densely,diameter,drying,elliptic,entire,essentially,filament,flattened,fruiting,glabrous,globose,growth,inflorescence,less,many,margin,minutely,mm,narrowly,new,nodding,orange,ovary,pair,pale,pedicel,peduncle,petiole,pitted,plant,poricidal,primary,pubescence,pubescent,red,reniform,shiny,shrub,simple,sparsely,stem,stigma,style,surface,time,tip,tube,vein,way,white,x,yellowish	.5,0.25-1,0.5-0.8,0.5-1,0.6-,1-1.5,1-5.7,2-,3,3-foliate,3.5-15,50-200,6-8,?,abaxially,adaxially,age,apart,apically,calyx,closely,correlated,deltate,dense,distally,eaf,eed,em,erec,erect,exerted,extremely,flower,found,free,geminat,halfwa,internodal,lamina,lengthening,like,lobe,lobed,longer,lower,maturity,nflorescence,occasionally,often,packed,papillat,papillate,per,perfect,pericarp,planar,plane,population,pore,portion,pubescen,pulp,rachi,reflexed,ruit,scar,slightly,slit,sticky,straight,swollen,terminal,thin,toward,triangular,trichome,ud,uniseriate,unit,variable,woody,ympodial	2,abaxial,adaxial,arrangement,branching,bud,colour,exertion,form,fruit,halfway,height,history,leaf,length,life,lobing,seed,shape,size,texture,type
42	wfo-0001026335	success	157	100	77	80	23	0.49	.5,0.25-0.5,0.5-1,0.6-1,1-2,1.5-2,10-20,2,2-3,2-4,2-7.5,3-18,3-5,4-5,5-15,5-7,acuminate,adaxially,anther,apex,base,branched,calyx,cm,connivent,cuneate,curved,dense,densely,diameter,elliptic,elliptic-ovate,entire,filament,flattened,flower,forked,fruit,glabrescent,glabrous,globose,green,hair,lanceolate,leaf,leaf-opposed,like,long,margin,mm,moderately,oblong,pedicel,peduncle,petiole,probably,pubescence,pubescent,rachi,reticulate,ripe,rounded,scattered,shrub,simple,stellate,stem,stigma,straight,style,surface,unripe,usually,white,x,yellow,yellowish	.5-3.5,0.1-0.3,0.8-1.3,1,1-1.5,1-3,1-4,1.5-4,10-30,5-,7-8,abaxially,accrescent,acute,adaxiall,ag,apart,apparently,articulated,axe,ba,blade,capitat,chartaceous,covering,cylindrical,deltate,directed,distally,eaf,eed,equal,erect,especially,frui,fruiting,geminate,glandula,glandular,held,large,lobe,longitudinal,lower,many-foliate,midpoint,much,multangulate,nflorescence,often,opening,orolla,paired,perfect,pore,ray,ruit,sessile,slightly,slit,smaller,sometimes,spaced,ste,stellate-pubescent,subtending,tal,tamen,tem,time,tip,toward,tube,unit,uprigh,vary,vein,whitish,wide,ympodial	arrangement,capitate,characteristic,colour,corolla,form,glabrousnes,growth,height,history,inflorescence,length,life,lobing,new,ovary,perennial,plant,seed,shape,size,texture,type
43	wfo-0001026343	success	221	135	103	118	32	0.466	-3.5,-4,-7,.5,/5,0-4,0-40,0.05-0.5,0.45-1,0.5-1.5,0.8-1.5,1.3-1.7,1.5-2,1.5-2.5,1.8-2.2,1.8-3,1/3,2-3,2-3.2,2-4,2-6,2.2-3.2,3-5,5-10,5.5-9,acute,anther,apex,apparently,articulated,bark,base,berry,branched,broadly,calyx,chartaceous,cm,cream,cuneate,curved,dark,densely,diameter,distal,dull,elliptic,erect,filament,flattened,flattened-reniform,fruit,fruiting,green,green-brown,lateral,leaf,length,lobe,lobed,lobing,long,lower,margin,marking,maturity,mauve,mm,orange,orange-brown,pair,pale,pedicel,peduncle,per,petiole,plant,poricidal,prickle,prickly,primary,purple,reddish,rounded,shrub,small,sparsely,spherical,stellate-pubescent,stem,style,surface,tapering,terete,tip,tree,tube,vein,way,weakly,wide,yellow,young	-1,-1.5,-15,/2,0,0-10,0-2,0-5,0.05-0.2,0.1-0.2,0.15,0.2,0.2-0.3,0.2-0.7,0.3,0.5,1-2,1-3,1-4,1/,1/4-2/3,1/5,10-30,2-5,2-8,2.5-8,3-4,3.5-4.5,5-merous,6-9,7-12,7-14,7-8,7-9,abaxial,abaxially,acuminat,adaxial,alyx,andromonoecious,apar,apart,apically,blade,brow,concolorous,connivent,deltate,distance,drying,eed,elongating,equal,extending,faint,flower,free,glabrescent,glabrous,hermaphrodite,heterostylous,infructescence,less,lon,long-styled,longer,lowermost,mature,midpoint,midvein,moderately,multangulate,narrow-deltate,nflorescence,obtuse,older,one,open,orolla,oung,ovate,pendulous,pericarp,plurifoliat,porrect,portion,prickl,ray,reduced,reflexed,ruit,scar,secondary,sessile,short-styled,side,smooth,sometimes,spaced,spreading,stalk,stalked,staminat,stellate,stout,tamen,tertiary,time,trichome,unarmed,unit,upper,variously,vary,venation,visible,woody,ympodial	appearance,arrangement,border,branch,brown,bud,characteristic,colour,corolla,exertion,form,giving,glabrousnes,growth,height,inflorescence,interjected,leaflet,na,new,number,ovary,pseudostipule,seed,shape,size,stigma,terminal,texture,type,variation,width
44	wfo-0001026352	success	209	117	95	114	22	0.455	.3,.5,0.5,0.5-0.8,0.5-3,0.7-2,0.9-1,1-1.5,1-2-celled,1.2-1.7,10+,5-6,<,acuminate,acute,anther,anthesi,antrorsely,apex,articulated,bark,base,berry,blue,branching,brown,calyx,capitate-truncate,chartaceous,cm,conical,cordate,corolla,curved,densely,diameter,discolorous,ellipsoid,entire,evenly,exserted,filament,flattened,fruiting,glabrous,globose,green,greenish,growth,inflorescence,leafy,length,many,margin,membranous,mm,narrowly,near,nearly,new,outline,ovate,pale,pedicel,peduncle,per,petiole,pink,pubescent,reniform,revolute,shallowly,shoot,short,simple,sleeve,small,spreading,stem,stigma,strongly,style,surface,terminal,time,trichome,truncate,tube,uniseriate,unspecified,vine,weak,white,woody,yellowish	0.5-1,0.5-1.5,0.6-,1-,1-10,1.5,1.5-2,1.5-4.6,12-60,2,2-3-celled,3-15,3.5-9,4-4.5,5-merou,6-7,7-9,?,abaxially,adaxiall,ag,almost,alyx,angle,apart,apparently,appearance,arising,articulation,axi,basal,bending,branch,broadly,cell,deciduous,deltate,denser,eaf,eed,eventually,expanded,few-celled,flower,free,giving,half,heigh,herbarium,ilament,immature,impressed,inflorescenc,irregularly,junction,lamina,large,largest,leave,leaving,lengthening,like,lobe,lobed,long,lower,mature,minutely,nflorescence,older,orolla,pair,papillate,papillo,peg,perfect,pericarp,plurifoliat,point,pore,poricidal,portion,primary,principal,rachi,reflexed,rest,right,ruit,scar,seen,shiny,slit,spaced,sparser,specimen,spreadin,stellate,straw-colored,tem,thin,third,tip,tub,tuberculate,ud,unit,upper,vary,vein,violet,wide,widest,ympodial	arrangement,bud,characteristic,colour,exertion,form,fruit,glabrousnes,height,history,leaf,life,lobing,na,number,ovary,plant,seed,shape,size,texture,type
45	wfo-0001026352	success	214	130	109	105	21	0.509	.3,.5,0.5,0.5-0.8,0.5-1,0.5-3,0.7-2,0.9-1,1-1.5,1-2-celled,1.2-1.7,1.5,10+,3-15,5-6,<,?,acuminate,acute,anther,anthesi,antrorsely,apex,articulated,base,berry,blue,branching,broadly,brown,calyx,capitate-truncate,chartaceous,cm,conical,connivent,cordate,corolla,curved,deltate,densely,diameter,ellipsoid,entire,evenly,exserted,filament,flattened-reniform,form,fruiting,glabrous,globose,green,greenish,growth,immature,inflorescence,lamina,leaf,leafy,length,lobe,long,many,margin,membranous,minutely,mm,narrowly,near,nearly,new,outline,ovate,pale,pedicel,peduncle,per,petiole,pink,pubescent,revolute,shallowly,shiny,shoot,short,simple,sleeve,small,spreading,stem,stigma,strongly,style,surface,terminal,time,trichome,truncate,tube,tuberculate,uniseriate,vein,vine,violet,weak,white,woody,yellowish	0.5-1.5,0.6-,1-,1-10,1.5-2,1.5-4.6,12-60,2,2-3-celled,3.5-9,4-4.5,5-merou,6-7,7-9,abaxially,adaxially,ag,almost,alyx,angle,apart,apparently,appearance,arising,ark,articulation,axi,basal,bending,branch,cell,deciduous,denser,discolorous,eaf,eed,eventually,expanded,few-celled,flower,free,geminat,giving,half,heigh,herbarium,ilament,impressed,inflorescenc,irregularly,junction,large,largest,leaving,lengthening,like,lobed,lower,mature,nflorescence,older,orolla,pair,papillate,papillo,peg,perfect,pericarp,plurifoliate,point,pore,poricidal,portion,primary,principal,rachi,reflexed,rest,right,ruit,scar,seen,slit,spaced,sparser,speciman,specimen,spreadin,stellate,straw-colored,tem,thin,third,tip,tub,twining,ud,unit,unspecified,upper,vary,widest,x,yellow,ympodial	abaxial,adaxial,arrangement,bark,bud,characteristic,colour,exertion,fruit,glabrousnes,history,life,lobing,number,ovary,papillose,seed,shape,size,texture,type
46	wfo-0001026379	invalid_json	219	142	111	108	31	0.507	-4.5,0.2-0.38,0.2-0.4,0.7-1,0.7-2.5,0.8-1.2,0.9-1.2,1-1.7,1-10,1-2,1.3-2.1,1.5-2.3,1.8-2.6,1.9-3.4,1/2,13,2-7,2.6-3.7,2.9-4,2/3,3/4,4.1-7,5.3-10.2,50-450,6-10.6,8-13,8.3-10,acute,along,anther,anthesi,apart,apex,articulated,attenuate,bark,basal,base,berry,blunt-tipped,branch,branched,brown,calyx,closely,cm,conical,corolla,dark,densely,diameter,dried,echinoid-pubescent,ellipsoid,entire,filament,finely,fleshy,flower,fruit,fruiting,glabrous,globose,granular,gray-brown,grayish,growth,included,leaf,length,long-attenuate,many,margin,minutely,mm,multangulate,nearly,oblong,obovate,obtuse,ovate,pale,pedicel,peduncle,petiole,plant,rachi,reniform,rich,scabrous,shrub,simple,size,small,spaced,stellate-tomentose,stelliform,stem,stigma,style,terete,time,tomentose-pubescent,tree,tube,velutinous-pubescent,violet,way,whitish,x,yellow	1-3.7,1.7-4.9,1.8-3.2,1.8-5,2-2.8,2.4-5.1,3-11,4-5,8-15,8-29,9-14,abaxially,accrescent,adaxiall,adaxially,ag,apparently,around,axillary,ba,blade,capitat,chartaceous,completely,covering,cylindrical,dendritic-echinoid,directed,distal,distally,eaf,echinoi,echinoid,edge,eed,enveloping,evident,farinose,few-rayed,free,hair,hig,inserted,lacking,large,lateral,lengthening,line,lobe,lobed,long,lower,m.,main,mature,midrib,minute,mostly,multangulat,multangulate-pubescent,nflorescence,often,older,orolla,ovate-lanceolate,partly,perfect,persistently,pitted,plurifoliate,pore,poricidal,porrect-stellate,present,pubescen,rather,recent,ruit,runk,scattered,semi-ovate,sessile,short-stalked,side,slit,sometimes,somewhat,sparse,stellate,stellate-,stellate-pubescent,suture,tamen,testa,thin,tip,translucent,ud,uneven,unit,upper,usually,vary,vein,vestigial,whitish-brown,ympodial,young	'',[,],``,abaxial,adaxial,arrangement,bud,capitate,characteristic,colour,exertion,form,glabrousnes,height,history,inflorescence,life,lobing,na,new,ovary,perennial,seed,shape,surface,texture,type,value,{,}
47	wfo-0001026400	success	187	132	109	78	23	0.583	0.2-0.8,0.4-1,0.5-1,1-2,1.3-2.6,1.7-2.2,10-18,10-28,12-27,13-30,2-6,2-8,3.4-4.8,3.5-5.9,30-55,4-7,5-7,6-13,6-15,6.5-20,8-12,9-13,abaxially,adaxially,anther,axillary,berry,blade,blue,brownish,bud,cell,clavate,cm,condition,connivent,coriaceous,corolla,covering,dark,deep,diameter,distal,drying,filament,finely,flower,forked,fresh,fruit,generally,glabrescent,glabrous,globose,green,green-white,greenish,hair,hair-like,half,herb,homostylous,interjected,lanceolate,lateral,leaf,leaflet,light,lilac,lobe,long,make,mm,moderately,mucilaginous,odd-pinnate,ovoid,pedicel,peduncle,pentagonal,plant,poricidal,puberulent,pubescent,purple,ripe,seed,semi-stellate,short,simple,size,stigma,stripe,style,subtending,terminal,testal,thick,throughout,tip,tube,unwinged,usually,wall,wet,white,whitish,x,yellow	0.5-1.2,0.7-1.1,1-10,2.4-5.9,3-6,5-merou,acumen,acuminate,acute,adaxiall,ag,alyx,apart,apex,apparently,articulated,asymmetric,attenuate,axe,base,basiscopic,capitat,decreasing,decurrent,digestion,dorsally,eaf,edge,eed,elliptic,enzyme,erec,exceeding,flat,folded,geminat,glabrou,gree,hal,high,honeycomb-shaped,lengthening,linear,living,lower,nflorescence,orbicular,orolla,ovate,pair,perfect,petiole,petiolulate,plurifoliate,pore,removed,rounded,ruit,sessile,seudostipule,side,slightly,slit,spaced,specimen,stamen,straight,subequal,tall,tamen,tem,tissue,toward,tri-,typically,unit,vary,ympodial	5-merous,arrangement,calyx,capitate,characteristic,colour,erect,form,growth,height,history,inflorescence,length,life,number,ovary,pseudostipule,shape,staman,stem,surface,texture,type
48	wfo-0001026406	success	219	130	95	124	35	0.434	0.4-0.9,0.5-1.5,1-2,1.3-1.5,1.8-2.4,1/3,1/4-1/2,2-2.7,2-3,2.5-8,2.9-3.2,3.2-3.8,5-25,5-6,6-12,9-15,acute,anther,apex,apparently,bark,base,berry,calyx,chartaceous,cm,connivent,cordate,cream,dark,deltate,densely,diameter,discolorous,drying,erect,filament,flattened-reniform,foliaceous,fruit,fruiting,glabrous,green,herb,lateral,leaf,length,lobed,long,long-styled,lower,margin,marking,maturity,mauve,midvein,mm,moderately,oblong,obtuse,orange-brown,ovate,pair,pale,pedicel,peduncle,pendent,per,petiole,plant,poricidal,prickly,primary,purple,red-brown,short-styled,shrub,spherical,stellate-pubescent,stem,style,surface,tapering,terete,terminal,tip,tube,vein,velvety,way,weakly,white,wide,yellow,young	-1,.2,.5,0,0-3,0-30,0-5,0.3,0.3-0.5,0.3-0.7,0.4-0.8,0.5,0.5-2.5,0.8,00-200,1,1.5-2,1.5-5,1/,1/4,1/4-1/3,10-30,12-19,2-6,20-60,3-10.5,3-4,30-60,5,5-50,5-7,5-8,5-merous,6-15,6.5-7,7-10,7-8,7-9,abaxial,abaxially,adaxial,adaxially,alyx,ame,andromonoecious,apar,apart,apically,articulated,blade,branched,broad-deltate,c.,conical,curved,dirty-whitish,distal,distance,eaf,eed,elongated,elongating,equal,extending,flattened,flower,free,fully,gently,hermaphrodite,heterostylous,infructescence,least,lobe,lon,longer,lowermost,mature,midpoint,nflorescence,older,one,open,opening,orolla,oung,pendulous,pericarp,plurifoliat,porrect,portion,prickl,prickle,ray,reflexed,rounded,ruit,scar,sessile,side,smooth,sometimes,spaced,sparsely,spreading,stalk,stalked,staminat,stellate,stout,straight,tamen,tertiary,time,trichome,unit,upper,variously,vary,venation,visible,woody,yellow-brow,ympodial	1.5,100-200,2.5,3.5,arrangement,branch,bud,characteristic,colour,corolla,corrugation,exertion,form,glabrousnes,growth,height,history,inflorescence,life,lobing,na,new,number,ovary,perennial,plurifoliate,seed,shape,size,stelate,stigma,texture,type,ye,yellow-brown
49	wfo-0001026407	success	221	132	111	110	21	0.502	.5,/3,0.5-0.6,0.5-2,1,1-1.2,1.3,1.5-1.7,2.5-3,20-30,3.5,5,5-10,7-8,acute,anther,anthesi,apex,appearing,basal,base,becoming,berry,black,branched,broadly,brown,brownish,calyx,capitate,chartaceous,cm,congested,connivent,corolla,deep,dendritic,dense,densely,diameter,discolorous,ellipsoid,elliptic,entire,exserted,filament,flattened-reniform,fleshy,fruiting,glabrous,globose,golden,golden-pubescent,growth,inflorescence,internodal,lateral,lax,like,lobed,long,loosely,many,margin,markedly,membranous,minutely,mm,narrowly,new,oblique,occasionally,outline,pale,papillate,pedicel,peduncle,per,petiole,pitted,pubescence,pubescent,purple,purplish,reddish,revolute,ripe,shiny,short,shrub,simple,slightly,stellate,stem,stiff,stigma,stout,strongly,style,surface,terminal,time,trichome,truncate,tube,vine,violet,way,woody,x,yellow	+,-11,-6,0.5,0.5-1,0.9-3,1-10,1.2-1.5,1.5-2,1.5-7,2-2.5,20-40,3.5-5.5,4-5,5-7,5-merou,7-10,abaxially,adaxially,ag,aid,along,always,alyx,apart,area,ark,around,articulated,axi,beneath,berr,blunt,branch,cell,clear,climbin,conical,deltate,denser,eaf,eed,erect,evenly,flower,free,geminat,glabrescen,glabrou,ilament,interpetalar,irregularly,lamina,leafy,leaving,lengthening,lobe,lower,midvein,mixture,near,nflorescence,numerous,obscured,often,older,open,orolla,pair,paler,papillat,pedice,peg,pentagonal,perfect,pericarp,persistent,planar,plurifoliate,pore,poricidal,portion,primary,pubescenc,ruit,scar,sinus,sleeve,slit,small,spaced,sparsely,sparser,spreading,tangled,tem,testal,thin,tip,transition,twining,ud,undulate,unit,upper,usually,vary,vein,weak,ympodial	arrangement,bark,bud,characteristic,colour,exertion,form,fruit,glabrousnes,height,leaf,length,lobing,number,ovary,plant,seed,shape,size,texture,type
50	wfo-0001026424	success	138	97	78	60	19	0.565	0.75-1.5,1-1.5,1-10,1-2,1.5-2,10,10-15,12-60,15,15-30,3-4,637/1,acuminate,acute,age,apex,aspect,base,becoming,blush-violet,broadly,calyx,campanulate,cell,clonal,close,cm,conspicuous,corolla,cuneate,cyme,distinct,ellipsoid,elliptic,erect,facetted,flower,general,glabrous,glandular,growing,hair,lanceolate,lasting,lavender,leaf,lobed,long,minute,mm,oblique,obovate,pedicel,petiole,pinnatisect,point,rarely,rh,rotate-stellate,rounded,scorpioid,several,shrub,simple,soft-wooded,stem,stone,straggly,tip,toward,triangular,unwinged,usually,violet,woody,x,year,young	-25,-3.5,-4,1,1-,2,3-11,8-,acuman,acumen,angular,anthesi,axil,ba,blunt,bluntly,broad,common,cut,dia,downard,eaf,exceeding,except,exerted,facing,floral,fork,forked,gree,interacuminal,lacking,lanceolate-elliptic,larger,line,lobe,lon,lower,midvein,nflorescence,often,part,pedicellate,peduncle,plurifoliat,rachi,raised,second,shallowly,short,sinus,slightly,soon,time,tissue,tub,ud,unit,within,ympodial	1-4,arrangement,bud,characteristic,colour,diameter,form,green,growth,height,history,inflorescence,length,life,plant,shape,size,texture,type
51	wfo-0001026440	success	181	120	96	85	24	0.53	1-5,1.1-1.5,1.5-2.1,1/2-2/3,3-7,3-8,3/4,7-14,9,abaxially,acute,adaxially,along,anther,anthesi,apex,bark,basal,base,berry,blunt-tipped,bract-like,branch,branched,broadly,brown,calyx,chartaceous,cm,conical,corolla,diameter,dichotomy,elliptic,entire,filament,first,fleshy,flower,free,globose,granular,green,greenish-yellow,hair,included,leaf,length,lobed,long-attenuate,many,margin,minutely,mm,multangulate,multangulate-pubescent,nearly,oblong,obovate,obovoid-oblong,obtuse,ovate,pair,pale,pedicel,peduncle,petiole,pitted,poricidal,porrect-stellate,reniform,ripe,scabrous,sessile,short-acuminate,short-stalked,shrub,simple,small,sometimes,sparse,stellate,stem,stigma,style,terete,time,tip,tomentose,tomentose-pubescent,tree,truncate,turning,way,white,yellow	0-15,1.1-1.4,1.3-1.7,1.8-4.5,1.9-3.7,1/2,14-30,2-2.8,2-4,2.9-4.4,3-5,3.9-6.5,4-12,5-7,accrescent,adaxiall,ag,always,apparently,appressed,articulated,axillary,ba,blade,branche,capitat,closely,dendritic-echinoid,dense,developed,directed,distal,distally,eaf,echinoi,echinoid,eed,fruiting,high,inserted,large,lengthening,lobe,long,lower,m.,minute,mostly,multangulat,nflorescence,obscure,often,older,openly,orolla,perfect,persistently,plurifoliate,pore,pubescen,rather,ruit,runk,semi-ovate,size,slit,somewhat,spaced,stellate-pubescent,suture,tamen,testa,thick,thin,tomentum,translucent,tube,ud,uneven,unit,usually,vary,x,ympodial,young	arrangement,bud,capitate,characteristic,colour,exertion,form,fruit,glabrousnes,growth,height,history,inflorescence,life,lobing,na,new,ovary,plant,seed,shape,surface,texture,type
52	wfo-0001026441	success	197	113	92	105	21	0.467	0.3-0.7,0.5-1.5,1-2,1.5-2.5,10,15-20,2-2.5,2-5.5,2-8,4-6,4-8,4-8.5,4.5-6.5,5,5-10.5,7-20,7-8,9-14,abaxially,adaxially,anther,berry,blade,brownish,cell,chartaceous,ciliate,cm,condition,conical,connivent,corolla,covering,diameter,drying,end,filament,flower,fresh,fruit,glabrous,green,greenish,hair,hair-like,herb,homostylous,lanceolate,lateral,leaf,leaflet,light,like,lobe,long,margin,minute,minutely,mm,mottled,odd-pinnate,one,ovoid,pale,pedicel,peduncle,petiole,placed,plant,puberulent,pubescent,purple,ripe,seed,semierect,size,sparsely,stem,stigma,style,terminal,testal,thick,tube,tuber,typically,usually,violet,wall,whitish,x,yellow	.5,0-2,0.4-3,0.8,1-1.5,1-10,1.5-2,10-14,3-5,5-merou,6-15,absent,acumen,acuminate,ag,alyx,apart,apex,apparently,articulated,attenuate,axe,axillary,base,bud,capitat,decreasing,digestion,distal,dorsally,eaf,edge,eed,elliptic-lanceolate,enzyme,equal,erec,especially,exceeding,flat,folded,forked,fourt,geminat,generally,glabrou,gradually,green-white,half,honeycomb-shaped,interjected,internal,larger,lengthening,living,lower,make,middle,mucilaginous,narrow,nflorescence,obtuse,orbicular,orolla,ovate,pair,perfect,petiolule,plurifoliate,pore,poricidal,removed,rotate,rounded,ruit,secondary,seudostipule,short,slightly,slit,spaced,specimen,stamen,star,ste,stolo,straight,subequal,subsessile,subtending,symmetrical,tall,tamen,tem,throughout,tip,toward,tri-,unit,vary,wet,white,wide,wing,ympodial	5-merous,arrangement,calyx,capitate,colour,erect,form,growth,height,history,inflorescence,length,life,ovary,placement,pseudostipule,shape,stolon,surface,texture,type
53	wfo-0001026460	success	131	98	74	57	24	0.565	.1,.5,0.5-1.5,1-1.5,10-15,13.5-21,2-2.5,2.5-3,4.5-5,6-7,6-9,7-9,abaxially,acute-acuminate,adaxially,anther,apex,base,becoming,berry,branched,brown,calyx,capitate,cm,completely,corolla,dark,dia,drying,elliptic,erect,filament,filiform,floccose,flower,fruiting,glabrous,globose,green,greenish,inflorescence,leaf,long,long-exserted,minutely,mm,nearly,older,ovary,ovoid-reniform,pale,pedicel,pitted,puberulent,reddish,shaped,shrub,simple,soon,stem,stigma,style,subshrub,surface,tapering,tear-drop,tiny,trichome,tube,vein,white,x,yellow	1.5-2,1/2,5,513,8-10,acut,anthesi,axi,closely,conical,deflexed,deltate,distal,do,eaf,edicel,eed,fide,free,frui,inflorescenc,internodal,less,like,lobe,lobed,lower,major,membraneous,middle,nflorescence,often,opposite,pair,papillo,papillose,pore,poricidal,portion,reddish-brow,reflexed,ruit,santo,scar,slightly,somewhat,spaced,tall,tip,tub,ud,unifoliat,unit,widest,woody,ympodial,young	acute,arrangement,bud,characteristic,colour,diameter,exertion,form,fruit,growth,height,length,lobing,na,peduncle,plant,reddish-brown,seed,shape,size,texture,type,unifoliate,variation
54	wfo-0001026489	success	153	122	95	58	27	0.621	.3,0.05-0.1,0.25-0.5,0.5,0.5-0.75,0.5-2,0.8-1.2,0.8-1.3,0.8-3.7,1-1.5,1.5-5,2-3,2-4,2-5,2-8-flowered,2.5-13,2/3,5-6,acute,along,anther,apex,area,axil,bark,base,beneath,berry,branched,broadly,brown,calyx,cm,corolla,cup-shaped,dark,densely,dia,difoliate,elliptic,exserted,filament,flattened,flattened-reniform,fruiting,glabrous,globose,green,later,leaf,lobed,long,margin,minutely,mm,occasionally,opposite,ovary,paler,papillose,pedicel,perpendicular,petiole,pitted,poricidal,pubescent,red-papillose,rhachi,shiny,shrub,simple,size,slender,soon,stem,stigma,straight,style,surface,tapering,terminal,thickened,tip,trichome,tube,uniseriate,unit,usually,vein,way,white,whitish,widened,x,young	0.5-1,0.6-1.4,1.3-3,2.5-4,8-13,anthesi,appearing,ba,closely,deflexed,deltoid,differing,dry,eaf,edicel,eed,erect,extending,fleshy,free,geminat,gra,incrassate,lamina,lateral,lobe,lon,lower,main,major,middle,minor,nflorescence,often,older,one,overlappin,pair,papillo,parallel,planar,pore,portion,prominent,ruit,scar,shaped,somewhat,spaced,specimen,strongly,tall,tear-drop,tub,ud,widest,woody,ympodial	arrangement,branch,bud,characteristic,colour,diameter,exertion,form,fruit,geminate,glabrousnes,gray,growth,height,history,inflorescence,length,life,lobing,new,peduncle,plant,seed,shape,sympodial,texture,type
55	wfo-0001026490	success	272	177	142	130	35	0.522	0.1â0.2,0.1â2.5,0.4â0.8,0.5â1,0.5â1.5,0.5â8,0.8â1.5,0.8â12,1.5â2,1.5â3.5,1.5â5,10â20,1â1.2,1â3,2â2.5,2â4,3,3â4.2,3â4.5,3â5,3â5-pinnate,4â4.5,5â7,7-pinnate,7â15,abaxially,absent,acute,adaxially,along,anther,anthesi,apex,axillary,base,brown,calyx,chartaceous,cm,commonly,connivent,corolla,covered,crisped,darker,densely,diameter,distal,distally,ellipsoidal,entire,expanded,extra-axillary,filament,flat,flattened,flower,fruit,fruiting,glabrous,green,immature,incurved,inflorescence,interjected,irregularly,lateral,leaf,leaflet,length,lenticular,light,lobe,long,lower,main,margin,mature,medium,middle,midvein,mm,moderately,mottled,nearly,oblique,oblong,obtuse,obtusely,orange,ovate-lanceolate,papillose,pedicel,peduncle,per,petiole,plurifoliate,pointed,pseudostipule,pubescence,pubescent,punctate,reflexed,revolute,rounded,sand,seed,shape,shoot,short,simple,size,slender,slightly,smooth,sometimes,somewhat,sparsely,spur,stem,stigma,striping,strongly,style,surface,tawny,teardrop-shaped,terminal,tip,trailing,transparent,trichome,truncate,tube,vine,violet,white,woody,yellow,Â½,Ã,â4.5	.5,0.2â1,0.2â1.5,0.3â3.5,0.5â3.5,0.7â3,1.2â8,1.5,1.8â2.2,1.9,1â15,1â2.5,1â8,2,2.5â3.5,2â6,2â8,3â8,4.6,4â5,5-merous,6,7,=,[,],accrescent,acuminate,ag,alyx,apart,apical,apicall,apparently,around,articulated,axe,ba,becoming,blade,bract,bracteate,branched,broadly,capitat,cauline,ciliate,climbing,completely,contiguously,cordate,cylindrical,decreasing,directed,eaf,eed,eglandular,elliptic,equal,exceeding,free,fused,geminat,ground,lacking,large,latrorse-introrse,lobed,longitudinal,lowermost,lunate,markedly,match,mean,mean=,minute,multicellular,near,nflorescence,node,obliqu,obliquely,oblon,occasionally,one,opening,orolla,ovate,pair,part,pentagonal,perfec,perfect,petiolule,pore,present,pubescen,pur,rachi,radial,reniform,resulting,rooting,ruit,seudostipule,shorter,similar,slit,smaller,spaced,stamen,striation,tamen,tem,thickened,toward,trichomessympodial,typically,unbranched,undulate,unit,vary,vegetation,wide,wing,yellowish-tan,youn,â4,â8,â9.5	appearance,arrangement,border,branch,bud,capitate,characteristic,colour,corrugation,drying,exertion,form,geminate,giving,glabrousnes,growth,height,history,life,lobing,midpoint,na,new,number,ovary,plant,prickle,primary,ray,texture,thicknes,type,variation,vein,width
56	wfo-0001026491	success	165	115	88	77	27	0.533	.5,1,1.5-2,1.5-2.5,1.5-3.5,1.7,10-50,3,3-pinnate,5-6,5-8,6-8,abaxially,absent,acuminate,acute,adaxially,anther,apex,appressed,articulated,averaging,base,bent,berry,branched,broadly,cellular-papillose,cellular-pilose,central,cm,conspicuously,cuneate,deciduous,diameter,elliptic-lanceolate,entire,filament,flower,glistening,globose,hair,highly,inflorescence,interjected,lanceolate,leaf,leaflet,less,margin,middle,minutely,mm,near,oblong-elliptic,ovate-elliptic,ovoid,pale,pedicel,peduncle,petiole,pilose,porrect-incurved,pubescent,purple,readily,rotate-pentagonal,rotate-substellate,rounded,row,sharp,shortly,shrub,simple,slender,stigma,strigose,strong,strongly,suborbicular-ovate,surface,tawny,usually,ventral,white,whitish,x,yellow	1-2,1977,2-3,2-4,2-celled,2.5-3.5,5-merou,7-8,abaxiall,alyx,anderson,apparently,axe,ba,bayonet,blade,bract,branching,capitat,connivent,crinkly,deep,deltoid,densely,directed,distall,eaf,eed,equal,first,geminat,greatly,green,growing,homostylous,lateral,light,lobe,long,lower,lunulat,mean,nflorescence,obtuse,often,orolla,ovate,perfect,plurifoliate,point,pore,poricidal,present,rachi,rarely,reduced,ruit,scandent,seudostipule,similar,small,spotted,straight,strigo,subacute,tal,tamen,tem,terminal,tightly,tip,tube,tyle,uniseriate,unit,upright,ympodial	abaxial,adaxial,arrangement,articulation,capitate,characteristic,colour,corolla,direction,form,fruit,growth,height,history,length,life,lunulate,perennial,plant,pseudostipule,seed,shape,size,stem,style,texture,type
57	wfo-0001026501	success	195	118	94	101	24	0.482	.35,.5,.6,.7,/3,0-1,0.27-0.7,0.5-0.6,0.5-0.9,0.5-1,0.6-1,0.9-2.2,1-2.5,1.8-2.2,1/4,2.5-4,2.8-3,?,abaxially,acute,anther,apex,apically,articulated,bark,base,berry,branched,brown,brown-green,calyx,chartaceous,cm,cuneate,deltate,densely,diameter,dull,elliptic,entire,erect,filament,flattened-reniform,fruit,fruiting,glabrous,gray,green,known,leaf,length,light,long,margin,mauve,mm,moderately,orange-brown,orbicular,ovate,pale,pedicel,peduncle,petiole,poricidal,porrect,prickly,rounded,scandent,shoot,short,shrub,simple,sparsely,spherical,spreading,stalked,stellate-pubescent,stem,style,surface,tapering,terete,terminal,tip,trichome,tube,unarmed,upper,way,white,wide,yellow,yellow-green	-1.7,-3,.1,0,0-2,0.05-0.3,0.1,0.2-1.8,0.5,0.6-1.1,0.6-2,1,1-2,1/2-2/3,1/6-1/2,2-10,3-4,3-5,3-9,3.5-4,4-5,4-7,5-merous,6-9,7-9,acicular,almost,alyx,apar,apart,apparently,becoming,blade,borne,color,concolorous,curved,discolorous,drying,eaf,eed,elongated,elongating,equal,eye,filiform,filiform-acuminat,flattened,flower,free,glabrou,infructescence,lobe,lobed,longer,lower,mature,midpoint,naked,nflorescence,often,older,one,open,orolla,oung,pair,pendulous,per,perfec,pericarp,plurifoliat,portion,prickl,prickle,primary,ray,reddish,ruit,scar,sessile,shorter,slender,small,smooth,sometimes,somewhat,spaced,stalk,stellate,straight,subsessile,tamen,time,unarme,unit,variously,vary,vein,visible,ympodial	arrangement,branch,characteristic,colour,corolla,exertion,filiform-acuminate,form,glabrousnes,growth,height,history,inflorescence,life,lobing,new,ovary,plant,seed,shape,size,stigma,texture,type
58	wfo-0001026513	success	138	91	64	74	27	0.464	.1,0.8-2,1-1.5,1-3,2-2.2,3-5,3-6-flowered,4-5,6-8,acute,anther,apex,area,bark,base,berry,calyx,cm,completely,corolla,decurrent,dia,elliptic,exserted,filament,flower,fruit,fruiting,glabrous,globose,green,hirsute,lanceolate,leaf,less,long,long-styled,minute,minutely,mm,pale,papillose,pedicel,petiole,plant,shaped,shiny,short-styled,shrub,simple,slender,small,soon,stem,stigma,style,surface,tear-drop,tip,treelet,trichome,tube,uniseriate,white	.25,.3,.75,/3,2-5,7-9,8-16,anthesi,apiculate,ba,broadly,caly,closely,darkish,deflexed,delicate,deltoid,differentiated,dry,eaf,edicel,eed,erect,except,free,gre,immature,known,lateral,leave,live,lobe,lobed,longer,lower,main,mature,middle,much,nflorescence,obscure,older,opposite,ovary,overlappin,pair,pore,poricidal,portion,prominent,raised,reflexed,rest,ruit,scar,somewhat,spaced,specimen,straight,styl,tall,ud,undersurface,unifoliat,unit,vein,venation,way,wide,widest,woody,x,ympodial,young	0.25,0.3,0.75,1,3,arrangement,bud,characteristic,colour,diameter,exertion,form,grey,growth,height,inflorescence,length,na,number,per,seed,shape,size,texture,type,unifoliate,width
59	wfo-0001026529	success	219	167	147	72	20	0.671	0-25,0.3-1,1,1-10,1-2,1-3,1-4.5,1.1-2.5,1.5-2.5,1.5-4,11-14,12-22,120-210,2-7.5,20-60,3-12,3-5,3-6,3-9.5,5-15,5-17,50-70,600-950,?,abaxially,acumen,adaxially,along,anther,apart,articulated,attenuate,axillary,berry,blue,brownish,bud,cell,chartaceous,ciliate,clavate,cm,condition,connivent,corolla,covering,creamy,dark,deep,densely,diameter,distal,dot,drying,especially,faintly,filament,flower,forked,fresh,fruit,generally,glabrous,gland,glandular,globose,greatly,green,green-white,greenish,hair,hair-like,half,head,herb,homostylous,interjected,lanceolate,lateral,leaflet,length,lengthening,light,like,lilac,lobe,long,longer,lunate,make,margin,medium,membranous,midrib,minutely,mm,moderately,mucilaginous,non-glandular,odd-pinnate,often,ovoid,pair,pedicel,peduncle,pentagonal,plant,pore,poricidal,puberulent,pubescent,pure,rarely,ripe,scattered,seed,shape,short,size,slightly,slit,spaced,stem,stigma,style,substellate,subtending,terminal,testal,tetralobulate,thick,throughout,tip,trichome,typically,unwinged,usually,varying,wall,wet,white,whitish,wide,wing,x,yellow,yellowish	0.5-4.5,10,10-28,2,2-5,4-8,5-9,5-merou,6-20,acuminate,acute,ag,alyx,apex,apparently,axe,base,blade,broadly,capitat,cordate,digestion,dorsally,eaf,edge,eed,elliptic,enzyme,erec,exceeding,except,flat,folded,geminat,glabrou,gree,hal,honeycomb-shaped,living,lower,narrowly,nflorescence,oblique,orbicular,orolla,ovate,perfect,petiole,petiolulate,petiolule,plurifoliate,proximal,reduced,removed,rounded,ruit,sessile,seudostipule,specimen,stamen,ste,straight,subequal,subsessile,tall,tamen,tem,tri-,tube,unit,vary,ympodial	5-merous,age,arrangement,calyx,capitate,characteristic,colour,erect,form,growth,height,history,inflorescence,leaf,life,ovary,pseudostipule,surface,texture,type
60	wfo-0001026534	success	150	96	71	79	25	0.473	0.5-1,1.5-6,1.5-9,10-20,10-50,15-50,2-2.5,2-7,2-8,2.5-15,3-25,3-4,3.5-4,5-6,acuminate,acute,apex,apiculate,auriculate,basal,base,branched,calyx,chartaceous,cm,connivent,cordate,deltate,densely,diameter,eglandular,ellipsoidal,entire,flattened,fleshy,flower,fruit,glabrous,glandular,hair,lanceolate,lobe,margin,mm,moderately,obtuse,orange,ovate,ovoid,pale,pedicel,peduncle,petiole,pinkish,puberulent,pubescent,purple,rachi,red,simple,stellate,stigma,style,subcoriaceous,tip,tree,truncate,unbranched,white,x,yellow	-1.5,1-2,1-2.5,1-3,10-15,2-3,2.5-4,3-,3-10,3-5,4-10,4-foliat,4.5-5,6-35,7-12,7-40,abaxially,absent,adaxially,aggregate,apart,ape,articulated,axe,beyond,blade,bright,cell,connective,cylindrical,darker,directed,distally,eaf,eed,equal,exserted,leaving,lemon-yello,lon,long,longitudinal,lower,m.,narrowly,nflorescence,nther,often,orolla,pedicellar,perfect,pore,presen,puberulen,radiu,remnant,ruit,shorter,slightly,small,spaced,sparsely,stamen,stone,stripe,tal,tem,thecae,time,tomento,triangular,truncat,tube,ud,unit,vary,vein,wide,ympodial	abaxial,adaxial,anther,arrangement,bud,characteristic,colour,corolla,form,growth,height,history,inflorescence,leaf,length,life,ovary,perennial,plant,seed,shape,size,stem,surface,texture
61	wfo-0001026535	success	248	133	112	136	21	0.452	.5,.8,0.7-1.5,1,1-2,1-3,1.2-2,1.3,1.5-3,1/2-2/3,1/3,2-5,2.5,7-8,acute,age,almost,along,anther,anthesi,apex,apically,bark,base,becoming,berry,black,brachyblast,branch,branched,branching,broadly,brown,calyx,chartaceous,clavate,clustered,cm,condensed,conical,corolla,cuneate,cupular,curved,dark,dendritic,dendritic-pubescent,dense,developed,diameter,dilated,distributed,dry,drying,elliptic,elongated,entire,evenly,filament,flower,fruit,fruiting,glabrous,green-brown,leaf,length,liana,like,lobed,long,lower,margin,membranous,minutely,mm,number,oblong,obovate,older,orange-brown,ovate,ovoid,partly,pedicel,peduncle,petiole,plant,pointed,pubescent,rachi,rarely,ridged,rounded,short,shrub,slender,sparsely,stem,stigma,style,surface,terminal,trichome,truncate,tube,unarmed,violet,white,widely,x,yellowish,young	.1,.2,.4,0-0.5,0.1-0.2,0.15,0.2,0.2-0.3,0.2-1.5,0.5-1,1-5,1.5-2,2-3,3,3-4.5,3-5,3.5-4,4-15,5-10,5-7,5Â°,abaxial,abaxially,absent,accrescent,adaxially,alternate,alyx,apar,apparently,area,around,articulated,clearly,concolorous,cup,deeply,delineate,delineated,deltoid,detaching,developing,discolorous,divided,domatia,dorsal,eaf,eed,ellipsoi,equal,except,eye,fertilisation,fine,flat,flexuous,forming,free,frui,increasing,inside,known,leave,lengthening,linear,lobe,lon,loop,loose,m.,main,marginal,midvein,minute,mostly,much,naked,network,nflorescence,nther,obscure,orolla,outside,pair,papillo,pendulous,perfec,pericarp,plurifoliat,pore,poricidal,portion,primary,prominent,protruding,raised,ray,reaching,ruit,scar,secondary,see,side,simple,sinus,slightly,smaller,smooth,soon,spaced,spreading,stump,tearing,terete,tertiary,thin,tip,tissue,toward,translucent,tufted,two,ud,uneven,unevenly,unit,unlignified,vary,vein,venation,visible,weakly,wide,wider,ympodial,youngest	arrangement,bud,characteristic,colour,ellipsoid,exertion,form,glabrousnes,growth,inflorescence,lobing,na,new,ovary,papillose,per,seed,shape,size,texture,type
62	wfo-0001026604	success	192	110	92	100	18	0.479	0,0.8-0.9,1-1.2,1.1-1.3,1.2-1.7,1.5-2,1.5-9,2-2.3,2.3-3.5,3-3.5,5,50-100,acuminate,along,anther,apex,bark,base,berry,branching,brown,c.,calyx,capitate,cm,conical,cordate,corolla,dark,diameter,ellipsoid,entire,exserted,flattened,flexuous,flower,fruit,fruiting,glabrous,globose,growth,inflated,later,leaf-opposed,liana,margin,midrib,minute,minutely,mm,narrowly,new,oblique,ovary,ovate,overall,ovoid,pale,pedicel,peduncle,per,petiole,pitted,poricidal,purple,red,reddish,reniform,ripe,shape,shrub,simple,slender,somewhat,stem,stigma,stout,strongly,style,surface,terminal,time,tip,trichome,truncate,tube,uniseriate,vining,violet,way,woody,x	.4,.5,.75,0.1,0.4-0.6,0.8-1,10-30,2-2.5,3-5,3.5-4,4-4.5,4.5-7,5-7,<,?,absent,age,aid,always,anthesi,apart,appearing,articulated,articulation,atop,basal,brow,cell,clearly,climbing,comical,cucullate,cupped,deflexed,densely,differentiated,distal,distinct,drying,due,eaf,eed,elongate,expanding,filament,free,leaving,lengthening,lobe,lobed,lower,mere,nflorescence,nodding,occasionally,older,outline,pair,papillo,papillose,part,particularly,peg,perfect,pericarp,planar,plurifoliat,poin,point,pore,portion,primary,pubescent,quarter,receptacle-like,rim,ruit,scar,series,shiny,sinuate,slightly,slit,spaced,stellate,structure,support,swolle,testal,thin,tub,twisting,ud,undulation,unit,upper,vein,widely,ympodial,Â½	arrangement,bud,characteristic,colour,exertion,form,glabrousnes,history,inflorescence,leaf,length,life,lobing,number,seed,size,texture,type
63	wfo-0001026607	success	204	123	99	105	24	0.485	0-3,0.1-0.3,0.3-1.8,0.5-5.8,0.8-3.4,0.8-4.5,0.8-5,1-2,1-3.8,1-8,1.5-4,10-30,2-2.5,2.4-5.8,2.5-3.8,2.7-19,3-8,4-10,4-6,5.8-19.8,6-10,abaxially,adaxially,anther,berry,brownish,cell,chartaceous,clavate,cm,coarse,condition,connivent,corolla,covering,deep,diameter,drying,filament,finely,flower,forming,fresh,fruit,glabrous,globose,green,green-white,greenish,hair,hair-like,herb,homostylous,interjected,lanceolate,lateral,leaf,leaflet,like,lobe,long,make,medium,membranous,minutely,mm,moderately,mucilaginous,odd-pinnate,ovoid,pedicel,peduncle,petiole,petiolulate,plant,puberulent,pubescent,rachi,ripe,rosette,seed,sessile,short,simple,size,stem,stigma,style,terminal,testal,thick,throughout,tube,unwinged,violet,wall,wet,whitish,x	0-4,1-10,1-5,2-10,2-3,5,5-merou,absent,acumen,acute,ag,along,alyx,apart,apex,apparently,articulated,attenuate,axe,axillary,base,basiscopic,blade,bud,capitat,ciliate,clearly,decreasing,decurrent,digestion,distal,dorsally,dot,eaf,edge,eed,elliptic,enzyme,especially,exceeding,flat,folded,forked,geminat,generally,glabrou,greatly,gree,hal,half,high,honeycomb,larger,lengthening,living,lower,margin,marked,midrib,minute,much,nflorescence,obtuse,often,orbicular,orolla,ovate,pair,pentagonal,perfect,plurifoliate,pore,poricidal,present,rarely,removed,rounded,ruit,scattered,semierec,seudostipule,shaped,side,slit,sometimes,spaced,specimen,stamen,ste,straight,subtending,tall,tamen,tem,tip,toward,tri-,typically,unit,usually,vary,white,without,yellow,ympodial	0-5,5-merous,abaxial,adaxial,arrangement,calyx,capitate,characteristic,colour,form,growth,height,history,inflorescence,length,life,ovary,pseudostipule,semierect,shape,staman,surface,texture,type
64	wfo-0001026613	success	159	128	107	52	21	0.673	1-10,1-2,1.5-4,11-19.5,2-7.5,2.3-8,2.5-2.8,3-10,3-5,4-5,4.5-8.5,5,5-6,5-7,5.5-7,6-8,6.2-9.5,8-18,8.5-10,8.5-9,9.5-13.5,abaxially,acuminate,adaxially,along,anther,apart,apex,axillary,base,berry,blade,borne,bud,chartaceous,ciliate,cm,conical,connivent,cordate,corolla,densely,diameter,distal,dorsally,edge,end,especially,filament,flat,flower,folded,forked,fruit,generally,glabrous,green,hair,half,herb,homostylous,immature,lanceolate,lateral,leaf,leaflet,lengthening,like,lobe,margin,mature,membranous,midrib,minute,minutely,mm,mottled,odd-pinnate,ovate,pedicel,peduncle,petiole,petiolule,plant,pore,poricidal,puberulent,pubescent,purple,rotate-pentagonal,singly,size,slit,stem,stigma,style,subtending,terminal,tip,tube,tuber,typically,unknown,unwinged,usually,x,yellow	0.5-1,0.6,5-merou,6-12,absent,acumen,ag,alyx,apparently,articulated,attenuate,axe,capitat,decreasing,eaf,eed,erec,geminat,greatly,hal,interjected,larger,long,lower,m-1.2,middle,nflorescence,orolla,pair,perfect,plurifoliate,proximal,pubescen,ruit,secondary,semierect,seudostipule,spaced,sparsely,ste,stolo,subequal,symmetrical,tall,tamen,tem,toward,tri-,unit,unknow,vary,ympodial	0.6-1.2,5-merous,age,arrangement,calyx,capitate,colour,form,growth,height,inflorescence,length,ovary,presence,pseudostipule,seed,shape,spacing,stolon,texture,type
65	wfo-0001026614	success	200	143	118	82	25	0.59	0.2â0.3,0.4-0.7,0.5,0.5â2,1-,15â30,1â2,1â3,1â5,2.5,2.5â3,20â25,2â4-branched,3â10,5.3-8.2,8â10,9â16,abaxially,acuminate,acute,adaxially,anther,apex,armed,articulated,base,berry,black,blunt-tipped,broad-based,brown,calyx,campanulate,clavate,cm,commonly,cylindrical,dark,developed,diameter,dried,entire,erect,especially,evenly,expanded,extra-axillary,filament,flattened-reniform,fleshy,flower,foveolate,fruit,fruiting,glabrescent,glabrous,gland-tipped,globose,golden,hair,interpetalar,irregularly,leaf,linear,lobe,lobed,long,margin,minute,minutely,mm,mottled,nearly,oblique,orange,orange-red,ovate,ovoid,pair,pedicel,peduncle,petiole,prickle,pubescent,rarely,reflexed,repand,ripe,rotate-pentagonal,rounded,sessile,shallowly,shrub,simple,slightly,smaller,sometimes,somewhat,soon,sparsely,spreading,stellate-pubescent,stem,stigma,style,surface,tapering,tissue,tube,unarmed,usually,weakly,well,white,x,yellow,yellowish,young	.8,0.2,1.3-1.8,1.5â2,11-15,2.2,2.2-5.5,2â4,2â6.5,3-foliate,3.2-5.2,4-7,4.5â11,4.5â5.5,5,5-merou,50,6.4-8.4,6â8,7.2-9.8,>,absent,across,adaxiall,alyx,apart,apparently,axe,ba,blade,capitat,chartaceous,closely,concentrated,densely,denser,directed,distally,eaf,eed,geminate,globo,homostylous,internode,lanceolate-attenuate,lateral,less,lon,lower,midpoint,midvein,nflorescence,obtuse,often,orolla,ovate-lanceolate,per,perfect,pore,pubescence,rachi,ray,ruit,scattered,shin,side,similar,spaced,stellae,stellate,tall,tamen,tem,time,tissu,ud,unarme,vary,vein,wide,ympodia,â5	arrangement,branch,bud,capitate,characteristic,colour,corolla,exertion,form,glabrousnes,growth,height,history,inflorescence,length,life,lobing,new,ovary,plant,seed,shape,size,texture,type
66	wfo-0001026642	success	193	94	60	133	34	0.311	5,6,abaxial,annual,anther,anthesi,apex,axillary,base,bipinnate,black,blue,borne,branched,brown,calyx,clavate,cm,dark,diameter,elliptic,filament,flattened,fruit,glabrous,globose,green-purple,hair,herb,lavender,leaf,length,lilac,long,mm,number,oblong,obtuse,ovate,pale,pedicel,peduncle,perennial,petiole,pinnate,pitted,pubescent,shallowly,shoot,sparsely,stigma,style,subglabrous,surface,time,violet,white,woody,x,yellow	.05,.1,.8,0.1,0.1â0.3,0.2,0.25,0.4,0.4â2.2,0.5,0.5â,0.5â0.7,0.5â1.7,0.5â2.0,0.5â3.5,0.6,0.6â1.0,0.75â1.0,0.75â2.0,0.7â1.6,0.8â1.2,1.0,1.0â2.0,1.2â1.7,1.2â2.0,1.2â3.5,1.2â6.2,1.6â8.0,1.9â3.0,12â30,1â10,1â3,2.0â4.0,2.5â3.5,2.5â4.0,2.8â3.0,3.0â5.1,3â5,4.0â6.0,4â7,5.0â7.0,50â100,<,abaxially,acute,adaxiall,adaxially,ag,along,apart,appressed,articulated,axe,ba,blade,cell,chartaceous,circular,connivent,cylindrical,decreasing,decumbent,densely,denser,divided,eaf,eed,either,equal,erect,fleshy,flower,geminat,glabrescen,gland,glandular,half,indumentum,lobe,lon,longitudinal,lower,m.,moderately,multicellular,narrow,nflorescence,occasionally,often,opening,orolla,pair,pentagonal,perfect,pinnae,pore,poricidal,present,primary,probably,rapidly,rounded,ruit,secondary,sessile,side,simple,slit,sometimes,spaced,stone,straight,tal,tamen,tem,tip,tube,unicellular,unifoliate,uniseriate,unit,usually,vary,vein,wide,wing,ympodial,â1.2,â11.0,â2.0,â4.5,â6,â7	0.4-2.2,0.5-3.5,0.5-6.2,0.5-8.0,0.8-1.2,1-3,1.2-1.7,1.2-3.5,2.8-3.0,3.0-5.1,4-7,4.0-6.0,5.0-7.0,50-100,adaxial,arrangement,characteristic,colour,corolla,form,growth,height,history,inflorescence,life,ovary,plant,seed,shape,size,staman,stem,texture,type
67	wfo-0001026651	success	222	104	75	147	29	0.338	1.8,acuminate,acute,anther,apex,articulated,attenuate,base,beneath,berry,beyond,brochidodromous,calyx,capitate,chartaceous,ciliate,dark,densely,diameter,drying,dull,entire,exserted,filament,flattened,flower,fruit,glabrescent,glabrous,globose,green,herb,lanceolate,lateral,leaf,length,light,long,margin,mm,moderate,narrowly-elliptic,new,oblong-ellipsoid,ovate-deltate,ovate-reniform,pedicel,peduncle,pedunculate,per,petiole,plant,pubescent,revolute,ripe,rounded,seed,shape,shrub,simple,size,slightly,sometimes,stamen,stem,stigma,style,sub-opposite,surface,terminal,translucent,undulate,vein,white,Ã	-celled,0.2â1.3,0.35â2.6,0.9â3,1,1â2,2.2â10,2.8,2â11.5,2â13,2â3,2â3.3,2â4,2â4.5,2â8,3,3-plurifoliate,3â5,3â7,4,4â6,4â7.8,5-merou,6â10,6â14,8,abaxially,absent,accrescent,adaxiall,adaxially,along,alyx,anisophyllous,antror,antrorse,antrorsely,apar,appressed,arcuate,ark,asymmetric,axi,branch,broadly,brown,brownish-green,capitat,cell,circular,cm,connivent,cordate,cylindrical,cyme,decumbent,decurrent,differing,directed,discolorous,eaf,eed,elliptic,emarginate,equal,erect,exfoliating,eye,flexuous,frui,geminate,geniculate,glabrou,glandular,growt,hair,head,highly,hilum,hollow,impressed,introrsely,less,like,lobe,longitudinal,lower,lying,major,markedly,matte,membranaceous,midrib,minor,moderately,mostly,much-branched,multicellular,naked,nflorescence,normally,obtuse,older,one,onto,opening,orolla,ovate-lanceolate,parallel,perfect,pore,poricidal,prominent,pubescence,reduce,region,ruit,secondary,shiny,similar,single-celled,slit,small,smaller,spaced,stalk,stellate,straight,subapical,tall,tamen,tem,trichome,turning,unbranched,uniseriate,unit,upper,usually,vary,venation,visible,wide,woody,yellow,ympodial,young	2-13,2-3,2-3.3,2-4,2-4.5,2-8,2.2-10,3-5,4-6,4-7.8,6-10,6-14,arrangement,characteristic,colour,corolla,exertion,form,glabrousnes,growth,height,history,inflorescence,life,lobing,number,ovary,texture,type
68	wfo-0001026656	success	211	106	79	132	27	0.374	0.3-4.2,0.4-6.5,0.7-10.5,0.9-13,1-1.8,1-10,1-2,1-3.8,1.1-8.1,2-6,2.5-17,20-60,4-10,4-13,4-8,5-35,5.5-27,9-11,acute,anther,attenuate,blade,blue,brownish,chartaceous,cm,condition,corolla,dark,densely,diameter,distal,dot,drying,filament,flower,fresh,fruit,glabrous,glaucous,globose,green,greenish,herb,homostylous,lateral,leaflet,light,long,lunate,membranous,mm,moderately,mottled,odd-pinnate,ovoid,pair,pedicel,peduncle,pentagonal,petiolule,plant,pubescent,purple,rotate-pentagonal,scale-like,scattered,seed,stem,style,subglabrous,terminal,tinged,tuber,unwinged,violet,white,whitish,wide	0-4,0.3-3,1,1-4,1-5,1.5-7,10,2-8,5,5-18,5-merou,abaxially,absent,acumen,acuminate,adaxially,ag,along,alyx,apart,apex,articulated,base,bearing,borne,broadly,bud,capitate,cell,ciliate,clavat,connate,connivent,covering,cuneate,curved,decurrent,digestion,dorsally,eaf,edge,eed,elliptic,end,enzyme,erec,especially,exceeding,flat,folded,forked,geminat,generally,greatly,green-white,greenish-yellow,hair,hair-like,half,honeycomb-shaped,interjected,lanceolate,larger,lengthening,like,living,lobe,lower,make,margin,middl,midvein,minutely,mucilaginous,narrowly,nflorescence,non-glandular,oblique,occasionally,often,orolla,ovate,petiole,petiolulate,plurifoliate,pore,poricidal,puberulent,pubescen,rachi,ranging,removed,ruit,seudostipule,short,singly,slightly,slit,sometimes,somewhat,spaced,specimen,stamen,star,ste,stigma,stolo,straight,subequal,subtending,symmetrical,tall,tamen,tem,tertiary,testal,therefore,thick,throughout,tip,tri-,truncate,tube,typically,unit,vary,wall,wet,wing,without,yellow,ympodial	0-5,5-merous,abaxial,adaxial,arrangement,calyx,characteristic,colour,form,glabrousnes,growth,height,inflorescence,leaf,length,ovary,presence,present,pseudostipule,pubescence,shape,size,staman,texture,type,width,winged
69	wfo-0001026663	success	251	148	121	130	27	0.482	-2.9,-9.7,/3,0-160,1,1-3.2,1-5,1.1,1.1-2.1,1.2-2,1.6-2.3,1.9-2.6,10-26,12-14,2-12,2.1-2.6,2.8-5.3,24-45,31,4.7-25.9,5.5-8.8,abaxially,acuminate,adaxially,along,angled,anther,anthesi,apex,attenuate,bark,base,becoming,berry,blunt-tipped,branch,branched,brown,bud,calyx,cm,conical,corolla,dark,densely,diameter,distributed,drying,echinoid,echinoid-pubescent,elongated,entire,exserted,filament,fleshy,flower,free,fruit,glabrescent,glabrous,globose,granular,green,greenish-brown,grooved,hair,immature,lanceolate,leaf,length,less,light,long,long-stalked,longitudinally,many,margin,midrib,mm,multangulate,obtuse,ovate-lanceolate,pale,pedicel,peduncle,petiole,poricidal,porrect-stellate,pubescent,rich,scabrous,sessile,short,short-stalked,shrub,side,simple,small,soon,spaced,sparsely,stem,stigma,strongly,style,subglobose,terete,time,tip,tomentose,touching,tree,tube,unarmed,vein,violet,way,white,whitish,x,yellow	-15,-8,.5-2.5,/25-1/15,0.2-0.6,0.3-0.8,0.4-2.2,0.9-1.5,1-2.5,1.4-2.6,1.4-3.1,1/2,1/3,1/4-1/2,10.3-13.2,2.5-3.7,2.9-5,2/3,3-5,3.5-5,3.8-5.7,4.5-5.7,5-8,5.5-,7.5-9,8-17,accrescent,acute,adaxiall,ag,apart,apparently,appressed,around,articulated,ascending,axe,axillary,blade,broadly,capitat,chartaceous,closely,completely,constricted,covering,cylindrical,directed,distally,eaf,echinoi,edge,eed,enveloping,especially,evident,farinose,flared,fruiting,glabrescen,granular-tomentose,inserted,lateral,lengthening,line,lined,lobe,lobed,long-stalke,longer,longitudinal,lower,m.,main,matur,midvein,minute,multangulate-pubescent,nearly,nflorescence,occasional,occuring,older,opening,openly,orolla,ovate,ovate-lanceolat,perfect,persistent,plurifoliate,pore,present,pseudo-terminal,pubescence,rachi,rather,ray,ridged,robust,ruit,runk,slightly,slit,sometimes,somewhat,stalk,stalked,stamen,stellate,subcampanulate,subcoriaceous,subglabrous,suture,tall,tamen,tangled,thick,thin,tomentose-pubescent,tomentum,ud,unarme,unit,upper,usually,vary,wide,ympodial,young	5.5-9,arrangement,capitate,characteristic,colour,exertion,form,glabrousnes,growth,height,history,inflorescence,life,lobing,na,new,ovary,perennial,plant,primary,pseud-terminal,seed,shape,size,surface,texture,type
70	wfo-0001026686	success	196	111	88	108	23	0.449	.4,0.6-0.9,1-2,1-2.5,1.2-3.4,1.5-7,1.7-2.5,10-28,2-10,2.4-3.6,2.5-8,3-4,3.7-8,4-6,5,5-16.5,5-8,6.5-12.7,7-9,8-10,8-27,abaxially,adaxially,anther,berry,blade,borne,brownish,chartaceous,cm,condition,conical,connivent,corolla,densely,diameter,drying,end,filament,flower,fresh,fruit,glabrous,green,green-white,greenish,herb,homostylous,interjected,lanceolate,lateral,leaf,leaflet,light,lobe,long,minute,minutely,mm,mottled,mucilaginous,odd-pinnate,ovoid,pedicel,peduncle,petiole,plant,puberulent,pubescent,purple,purple-violet,ripe,rotate-stellate,seed,semierect,singly,size,sparsely,stigma,style,terminal,throughout,tube,tuber,typically,wet,whitish,x	0.2-0.5,1,1-10,1.2-3.6,2-9,3-5,5-merou,8-14,absent,acumen,acuminate,ag,along,alyx,apart,apex,apparently,articulated,axe,axillary,base,bud,capitat,cell,ciliate,covering,decreasing,digestion,distal,dorsally,eaf,edge,eed,elliptic-lanceolate,enzyme,equal,erec,especially,exceeding,flat,folded,forked,geminat,generally,glabrou,gradually,hair,hair-like,half,honeycomb-shaped,larger,lengthening,like,living,lower,make,margin,middle,midrib,nflorescence,obtuse,often,orbicular,orolla,ovate,pair,perfect,petiolule,plurifoliate,pore,poricidal,pubescen,removed,round,ruit,secondary,seudostipule,slightly,slit,spaced,specimen,stamen,star,ste,stolo,straight,stripe,subequal,subsessile,subtending,symmetrical,tall,tamen,tem,testal,thick,tip,toward,tri-,unit,usually,vary,wall,white,wide,wing,yellow,ympodial	5-merous,arrangement,calyx,capitate,colour,erect,form,growth,height,history,inflorescence,length,life,ovary,presence,pseudostipule,shape,stem,stolon,surface,texture,type,width
71	wfo-0001026696	success	139	117	66	73	51	0.475	0.3-4.5,0.8-7,0.9-7.2,1,1-1.3,1-4,1.3-2.1,2-17,3-17,3-3.5,3-6,4-16,9,acute,apex,articulate,base,branched,broadly,calyx,cm,corolla,cuneate,cyme,decurrent,densely,diameter,dichasial,dichasially,distal,ebracteate,entire,filament,globose,green,green-white,lanceolate,lateral,light,linear,lobe,long,margin,mm,monochasial,mucilaginous,oblong,obtuse,odd-pinnate,often,ovate,ovoid,pedicel,peduncle,perennial,petiole,plant,pubescent,rounded,seed,sinuate,stigma,style,throughout,white-cream,wide	1.5-3,2-3,3-6-foliat,3-8.5,5-35,abaxially,acumen,adaxially,apical,apically,apiculate,cell,connate,covering,dehiscent,digestion,dorsally,eaf,edge,eed,emoval,enzyme,exceeding,flat,flower,folded,forked,generally,globo,hair-like,half,herbaceous,honeycomb,introrse,light-yello,living,lon,lower,lunat,make,maturing,nflorescence,nther,orolla,pattern,perfect,plan,poricidally,proximal,reveal,ruit,seudostipule,short,simple,slit,specimen,stamen,stellate,straight,tal,tem,testal,thick,throughou,tuber-bearing,typically,unit,vary,wall,without,yellow,ympodial,Â¼	anther,appearance,arrangement,bark,border,branch,bud,characteristic,colour,corrugation,drying,exertion,form,fruit,fruiting,giving,glabrousnes,growth,height,herb,history,inflorescence,interjected,leaf,leaflet,length,life,light-yellow,lobing,midpoint,na,new,number,ovary,per,prickle,primary,pseudostipule,ray,shape,size,stem,surface,terminal,texture,thicknes,tube,type,variation,vein,width
72	wfo-0001026706	success	232	114	92	140	22	0.397	0-240,0.8-1.2,0.9-2,1-2.2,1-5,1.5-3,12,2.7-4,4,4.5-5.5,5.3-6.4,6-10,abaxially,acute,adaxially,anther,apex,appearing,attenuate,bark,base,berry,blunt-tipped,branch,branched,brown,bud,calyx,cm,corolla,crisped,cuneate,dark,diameter,entire,exserted,filament,fleshy,flower,fruit,glabrate,globose,golden,grayish,green,herbarium,lanceolate,leaf,length,many,margin,mm,oblong,obtuse,occasionally,ovate,ovate-elliptic,ovate-lanceolate,pale,pedicel,peduncle,petiole,reddish,reticulate-punctate,shrub,simple,slightly,small,softly,soon,specimen,stem,stigma,strongly,style,subconical,subglobose,suborbicular,sulcate,surface,tall,time,tomentose-pubescent,tree,unarmed,velutinous,wavy,white,whitish,x,yellow,yellowish-tan	-3.1,-4.4,-5.5,-6.1,.5,/14-1/6,0.2-0.3,0.2-0.5,0.6-2.2,0.8-1.5,0.8-2.8,0.9-1.9,1.1-4,1/2-2/3,10-15,14-32,2.2-3.3,2.3-3.8,2.5-3,2.9-6,2/3-3/4,3-4.6,3.1-3.8,3.6-5.7,4.2-12,5-6.5,6-8,6.1-,7-16,8-14,9.8-15.4,accrescent,adaxiall,ag,anthesi,apart,apparently,around,articulated,axe,axillary,ba,becoming,blade,capitat,chartaceous,closely,completely,coriaceous,covering,cylindrical,dendritic-echinoid,dendritic-multangulate,densely,directed,distally,eaf,edge,eed,enveloping,farinose,fourth,free,fruiting,furfuraceou,glabrous,hair,indument,inserted,lackin,lacking,lateral,lengthening,lobe,lobed,long,long-stalked,longitudinal,lower,m.,main,matted,midrib,minute,mixed,multangulat,multangulate,nearly,nflorescence,obscured,often,older,orolla,perfect,persistent,plurifoliate,pore,poricidal,porrect-stellate,pseudo-terminal,pubescence,pubescent,rachi,rather,ruit,runk,semi-ovate,sessile,short-,short-stalked,side,slit,somewhat,spaced,sparsely,splitting,stalked,stamen,stellate,subcampanulate,suture,tamen,thin-walled,tip,tomentu,touching,translucent,transparent,tube,ud,unarme,unevenly,unit,upper,vary,vein,way,wide,ympodial,young	6.1-15.4,arrangement,capitate,characteristic,colour,exertion,form,glabrousnes,growth,height,inflorescence,lobing,new,ovary,plant,pseudoterminally,seed,shape,size,texture,trunk,type
73	wfo-0001026707	success	196	116	91	105	25	0.464	-5,.5,.8,/3,0,0.5-1,0.6-0.7,0.6-0.8,0.7-1,0.7-1.4,1-1.7,1.5-1.8,1.6-2,1/3,2-2.3,3-4.5,4,5-25,8-15,?,abaxially,acute,anther,apex,apically,apparently,articulated,attenuate,bark,base,berry,branched,broad-deltate,calyx,chartaceous,clustered,cm,densely,diameter,entire,erect,filament,flattened-reniform,fruit,fruiting,glabrous,gray,green,lateral,leaf,length,long,margin,mauve,mm,moderately,narrow-oblong,obtuse,orange-brown,pedicel,peduncle,per,petiole,poricidal,porrect,prickle,prickly,red-brown,rounded,shrub,small,sometimes,spherical,stalked,stellate-pubescent,stem,style,surface,tapering,terete,terminal,tip,tree,trichome,tube,unarmed,upper,way,white,wide,yellow-green	-1/3,-3,0-20,0.05,0.05-0.15,0.1-0.2,0.3-0.8,0.5-3,0.7-1.5,1-3,1-5,1/3-1/2,1/3-3/4,1/4-1/3,1/8-1/4,11-16,2-10,2-6,2.5-3,2.5-4,2.5-6,3-4,3-7,3-8,5-10,5-7,5-8,5-merous,alyx,apar,apart,blade,branche,broadly,color,concolorous,connivent,curved,cuspidat,decurrent,discolorous,drying,eaf,eed,elongating,equal,eye,flower,foliaceous,free,fused,gently,glabrescent,glabrou,inflated,infructescence,juvenil,known,less,lobe,lobed,longer,lower,mature,midpoint,naked,narrow-deltate,nflorescence,older,one,open,orolla,oung,perfec,pericarp,plurifoliat,porrect-lepidote,portion,pubescent,ray,reflexed,ruit,scar,sessile,shorter,simple,slender,smooth,spaced,sparsely,spreading,stalk,stellate,stout,straight,tamen,time,unit,variously,vary,venation,visible,weakly,ympodial,Â¼	arrangement,branch,characteristic,colour,corolla,cuspidate,exertion,form,glabrousnes,growth,height,inflorescence,juvenile,lobing,na,new,number,ovary,plant,seed,shape,size,stigma,texture,type
74	wfo-0001026711	success	210	162	141	69	21	0.671	-5,-6,-7,.8,0,0-0.2,0-25,0-4,0-6,0.15,0.2-0.3,0.3-1,0.5-1.5,0.7-,0.7-0.9,0.7-1.4,0.75-1,0.9-1.1,0.9-1.5,1-,1-2,1.5-2.2,1/2-2/3,1/3,1/4,2-2.2,2-3.5,2-4,2-6,2.1-2.5,3-4,3-4.5,3-5,4-8,4.5-7,7-8,abaxially,acute,ame,anther,apex,apically,apparently,articulated,bark,base,berry,branched,c.,calyx,cell,cm,connivent,cuneate,curved,deltate,densely,diameter,distance,dull,elliptic,erect,evenly,extending,filament,flattened-reniform,flower,fruit,fruiting,glabrous,green,infructescence,lateral,leaf,length,lobe,lobed,long,lower,margin,maturity,mauve,midpoint,midvein,mm,narrow-deltate,obtuse,occasionally,one,open,orange,orange-brown,outline,pale,pedicel,peduncle,per,petiole,pit,poricidal,porrect,prickle,prickly,purple,raised,ray,red,reduced,rounded,shallowly,shrub,side,slender,small,smooth,sometimes,spherical,spreading,stalk,stalked,stellate,stellate-pubescent,stem,style,surface,tapering,terminal,time,tip,trichome,tube,unarmed,uniform,upper,variously,way,weakly,wide,yellow,yellow-green,young	-15,-2,.2,.5,0.1,0.8,0.8-2.2,1-30,1.5-,1.7-4,1/,1/4-1/3,2-2.5,3-7,3.5-5.2,5-merous,acicular,acuminat,alyx,apar,apart,blade,brow,concolorous,difoliate,discolorous,drying,eaf,eed,elongating,equal,faint,free,geminat,less,longer,mature,moderately,nflorescence,older,orolla,oung,pair,pendulous,perfec,pericarp,perpendicular,portion,prickl,primary,reflexed,ruit,scar,sessile,shorter,somewhat,spaced,straight,tamen,terete,tertiary,thick-chartaceous,unit,vary,vein,venation,visible,woody,ympodial	acuminate,arrangement,branch,brown,characteristic,colour,corolla,exertion,form,glabrousnes,growth,height,inflorescence,lobing,new,ovary,plant,seed,shape,texture,type
75	wfo-0001026717	success	207	141	115	92	26	0.556	0.3-0.6,0.6-1.5,1-10,1-2,1-2.5,1.3-2.5,1.4-2.2,1.8-3,13-28,14-22,15-34,2.5-4.5,2.5-5.5,3-4,3-6,3.3-11,4-6,4-9,5,5-11,5-13.5,5-6,5.3-9,7-11,acuminate,anther,apart,apex,attenuate,axillary,base,berry,blade,borne,brownish,bud,cell,chartaceous,cm,condition,conical,corolla,covering,dark,diameter,distal,drying,end,filament,flower,forked,fresh,fruit,generally,glabrous,green,green-white,greenish,hair,hair-like,half,herb,homostylous,lanceolate,lateral,leaf,leaflet,light,like,lobe,long,make,medium,membranous,minute,mm,mottled,mucilaginous,obtuse,odd-pinnate,ovoid,pedicel,peduncle,pentagonal,petiole,plant,pubescent,purple,ripe,rotate,round,seed,semierect,singly,size,sparsely,stigma,straight,style,subtending,terminal,testal,thick,throughout,tube,tuber,typically,usually,violet,wall,wet,whitish,wide,x,yellow	0.3-2.5,0.3-5,0.8,1-3,2.2-5,3-5,4-8,5-merou,abaxially,acumen,adaxially,ag,along,alyx,apparently,articulated,axe,capitat,ciliate,connivent,darker,decreasing,decurrent,digestion,dorsally,eaf,edge,eed,elliptic,enzyme,equal,erec,especially,exceeding,flat,folded,geminat,glabrou,gradually,honeycomb-shaped,interjected,larger,lengthening,living,lower,margin,middle,midrib,minutely,narrow,nflorescence,often,one-quarte,orbicular,orolla,ovate,pair,perfect,petiolule,plurifoliate,pore,poricidal,present,puberulent,pubescen,removed,ruit,secondary,sessile,seudostipule,slightly,slit,spaced,specimen,stamen,ste,stolo,stripe,subequal,subglabrous,subsessile,symmetrical,tall,tamen,tem,tip,toward,tri-,unit,vary,wing,ympodial	5-merous,abaxial,adaxial,arrangement,calyx,capitate,colour,erect,form,growth,height,history,inflorescence,length,life,number,ovary,presence,pseudostipule,shape,spacing,stem,stolon,surface,texture,type
76	wfo-0001026725	success	166	86	68	98	18	0.41	/4,0.7-1.2,1-1.2,1-1.5,1-4.5,1-5,1.2-1.7,1.6-2,5-20-flowered,acute,anther,apex,bark,base,beneath,berry,broadly,calyx,capitate,cm,corolla,cup-shaped,dark,dia,drying,ellipsoid,elliptic,flattened-reniform,fruit,fruiting,glabrous,glandular-papillose,globose,green,greenish-white,large,leaf,lobed,long,minutely,mm,onto,ovary,ovate,ovoid,paler,papillose,pedicel,petiole,pitted,pubescent,reddish-brown,rounded,shaped,shrub,simple,size,slender,stem,stigma,stretching,style,subshrub,surface,tear-drop,way,white,winged	.3,.5,0.2,1.5,1.5-2,1/2,2,2.2-4,3.5-4,3.6-7.7,5-5.5,5-6,8-18.6,8-9,accrescent,anthesi,apart,attenuate,axil,becoming,black,bluish,brownish-papillose,character,crackin,deflexed,differing,difoliate,dry,eaf,edicel,eed,evenly,extremely,filament,free,geminat,geographically,incrassate,inflorescenc,interpetalar,lateral,less,lobe,lon,lower,main,major,margin,margine,material,middle,minor,nflorescence,occasionally,often,older,one,open,opposite,pair,pale,papillo,planar,pore,poricidal,portion,prominent,proximal,reflexed,ruit,scar,scarious,short,sinus,slightly,spaced,split,straight,tall,tan,tapering,tip,triangular,trichome,tube,tuft,ud,uniseriate,unit,upper,varying,vein,widest,woody,x,ympodial,young	bud,characteristic,colour,cracking,diameter,exertion,form,growth,height,history,inflorescence,length,life,plant,seed,shape,texture,type
77	wfo-0001026733	success	188	152	97	91	55	0.516	0.3-2,0.5-2,1-3,1-7,1.5-14,10-20,15-,2-2.5,2.5-7.5,20-50,25-40,3-15,3-3.5,4,4-23,4-5,5-8,abaxially,acuminate,acute,acute-acuminate,adaxially,apex,axe,basal,base,calyx,chartaceous,cm,color,connivent,cordate,curled,deltate,dense,densely,diameter,eglandular-pubescent,ellipsoidal,elliptic-ovate,entire,flattened,flower,forked,fruit,fusiform,glabrate,glabrous,gland-tipped,glandular-,glandular-puberulent,green,greyish,hair,hirsute,immature,lanceolate,lobe,long,longitudinal,margin,mm,moderately,narrowly,oblique,ovate,ovoid,pedicel,peduncle,perfect,petiole,pilose,pubescent-pilose,ripe,round,shining,simple,smooth,sometimes,stigma,stripe,style,submarginally,tree,triangular,truncate,tube,unbranched,unknown,vein,villous,white,white-puberulent,wide,x,yellow,yellowish	-1,-11,-13,-14,-15,-2,-4,-7,-8,.5-3,0.3-0.5,0.5,0.5-1,0.5-4,1,1-1.5,1-2,1.5-2,1.5-2.5,2-3,2-4,2-6,3-4-foliat,3-7,4.5-5,7-10,8-12,aggregate,apart,ape,articulated,beyond,blade,capitat,cell,ciliat,connective,cylindrical,dia,directed,distally,eaf,eed,eglandular-pilose,eglandular-villous,equal,especially,exceeding,exserted,glandula,glandular-tomentose,leaving,linear-triangular,lon,lower,membranaceous,midrib,near,nflorescence,nther,orolla,ovum,pedicellar,pore,present,pubescent,pubescent-pilo,rachi,radiu,remnant,ruit,shorter,slightly,small,spaced,sparsely,stamen,stellate,stone,swelling,tal,tem,thecae,time,toward,ud,unit,unknow,usually,vary,ympodial	anther,appearance,arrangement,bark,border,branch,bud,capitate,characteristic,colour,corolla,corrugation,distal,drying,exertion,filament,form,fruiting,giving,glabrousnes,glandular,growth,height,history,inflorescence,interjected,lateral,leaf,leaflet,length,life,lobing,midpoint,na,new,number,oval,ovary,per,plant,prickle,primary,pseudostipule,ray,seed,shape,size,stem,surface,terminal,texture,thicknes,type,variation,width
78	wfo-0001026734	success	266	121	95	171	26	0.357	0.5,0.6,1,3,abaxial,absent,acuminate,anther,anthesi,apex,base,becoming,berry,bright,broadly,brown,calyx,chartaceous,clavate,cm,congested,corolla,cuneate,cylindrical,cyme,densely,diameter,discolorous,distally,elliptic,emergent,entire,flattened,flower,fruit,glabrescent,glabrous,globose,green,growth,immature,internodal,irregular,lanceolate,lateral,leaf,length,less,lobe,lobed,long-attenuate,margin,maturity,membranaceous,mm,moderately,narrow,new,oblong,obtuse,ovary,pale,pedicel,peduncle,petiole,pit,plane,porrect-stellate,pubescent,purple,purplish,reniform,scandent,sessile,shape,short-stalked,shrub,simple,size,slightly,sometimes,sparsely,spreading,stem,stigma,style,subopposite,subsessile,surface,trichome,tube,unbranched,white,yellowish,Â¾	0.1,0.2,0.3,0.7â0.9,0.7â1,0.8â1,1.6â2,1.6â2.5,1.8â2.2,1.8â3,1/4,1â1.2,1â3,2.2â7,2.3â5,2.5â3,2â2.4,2â3,3.2â3.8,3â4,3â4-celled,3â8,4â6,4â7,4â8,4â9,5-merou,5â9,8,abaxially,accrescent,acute,adaxial,adaxiall,adaxially,ag,also,always,alyx,apical,apice,archin,ark,articulated,associated,asymmetric,axi,barely,beneat,beneath,blade,branch,branched,caly,camptodromous,capitate,celled,central,closely,commonly,connivent,covered,covering,dark,dense,denser,differing,directed,downward,dried,drying,due,eaf,eed,eglandular,erect,f.,fewer,flat,foliate,forked,found,free,frequently,geminate,glabrescen,glandular,gray,hair,held,ilament,initially,introrsely,j,lamina,large,long,longer,longitudinal,lower,lying,material,mature,maturit,midpoint,midri,minute,mostly,much,multiseriate,near,nflorescence,normally,obovate,observed,often,old,older,one,one-celled,opening,orolla,other,oung,ovate,pair,paired,papillose,perfect,pointing,pore,poricidal,porrect,portion,pubescence,rachi,raised,rarely,ray,rayed,reaching,rounded,ruit,secondary,shiny,shorter,slit,smaller,spaced,sparse,spread,stalk,stellate,still,surfac,terminal,tuft,ud,unequal,uniseriate,unit,upward,vary,vein,venation,vestiture,visible,whole,wide,yellow,ympodial	0.7-0.9,0.8-1,1.8-3,2.3-5,3-8,5-9,arrangement,bark,bud,characteristic,colour,exertion,filament,form,fruiting,glabrousnes,height,history,inflorescence,life,lobing,midrib,plant,seed,texture,type
79	wfo-0001026740	success	171	107	83	88	24	0.485	0-10,0.5-1,1-12,1-5,10-20,10-30,2-3,2.5-27,2.5-6,20-50,3-15,3-3.5,4-5,6-10,abaxially,acuminate,acute,adaxially,also,apex,apiculate,basal,base,branched,calyx,cm,connivent,cordate,corky,curled,darker,deltate,densely,diameter,eglandular,ellipsoidal,elliptic,entire,flattened,fleshy,flower,fruit,glabrate,glabrous,glandular-puberulent,greenish,hair,immature,lanceolate,lobe,long,margin,mature,mm,moderately,oblong,obtuse,often,ovate,ovoid,pedicel,peduncle,petiole,pilose,present,puberulent,purple,rachi,reticulate,simple,sparsely,stigma,stripe,style,tree,truncate,unbranched,violet,white-puberulent,whitish,woody,x,yellow	-17,-2,1-10,1-2,1-3,1-4,2-4,2.5-3,2.5-4.5,3-5,3-foliat,3.5-40,4.5-10,5-40,5-8,8-19,absen,absent,acute-acuminate,aggregate,apart,ape,articulated,axe,beyond,blade,browni,cell,ciliate,connective,cylindrical,directed,distally,eaf,eed,equal,especially,exceeding,exserted,leaving,lon,lower,narrowly,near,nearly,nflorescence,nther,orange,orolla,pedicellar,perfect,pilo,pore,pubescent,radiu,rarely,remnant,ruit,scar,sessile,shorter,slightly,small,sometimes,spaced,stamen,stellate,stone,subcoriaceous,swelling,tal,tems,thecae,time,tomentose,toward,triangular,truncat,tube,ud,unit,unlobed,vary,vein,villous,wide,ympodial,young	anther,arrangement,bud,characteristic,colour,corolla,form,growth,height,history,inflorescence,leaf,length,life,ovary,perennial,plant,seed,shape,size,stem,surface,texture,type
80	wfo-0001026752	success	169	134	80	89	54	0.473	-25,-4,1,1-12,1-5,1-6,1.5-2.5,10-20,2-2.5,2.5-20,2.5-5,3.5-4,4-45,4-5,abaxially,abruptly,acute,adaxially,apex,apiculate,basal,base,black,branched,calyx,chartaceous,cm,cordate,cuneate,darker,deltate,densely,diameter,ellipsoidal,elliptic-oblong,elliptic-ovate,entire,flattened,fleshy,forked,fruit,glabrous,globose,green,greenish-brown,immature,lanceolate,lobe,margin,mm,narrowly,obtuse,ovoid,pedicel,peduncle,petiole,pilose,possibly,pubescent,pubescent-pilose,purplish,rarely,rather,ripe,short-acuminate,simple,stigma,stripe,style,tree,triangular,truncate,tube,unbranched,vein,violet,white,whitish,x,yellow	-3,-50,0-,1-1.5,1-2,1-3,1.5-12,1.5-2,15-35,2,2-3,2-4,20-30,3,3-18,3-4,3-5,3-foliat,7-15,8-16,absent,aggregate,also,apart,ape,articulated,axe,beyond,blade,campanulate,capitat,cell,connective,connivent,coriaceous,cylindrical,dilated,directed,distally,eaf,eed,equal,exceeding,exserted,finely,flower,hair,laterally,leaving,less,lon,long,lower,moderately,near,nearly,nflorescence,nther,orolla,papillose,pedicellar,perfect,pilo,pore,presence,present,rachi,radiu,remnant,ruit,slightly,small,somewhat,spaced,stamen,stellate,stone,tal,tem,thecae,time,tomento,ud,unit,unknow,vary,wide,yello,ympodial	anther,appearance,arrangement,bark,border,branch,bud,capitate,characteristic,colour,corolla,corrugation,distal,drying,exertion,filament,form,fruiting,giving,glabrousnes,growth,height,history,inflorescence,interjected,lateral,leaf,leaflet,length,life,lobing,midpoint,na,new,number,ovary,per,perennial,plant,prickle,primary,pseudostipule,ray,seed,shape,size,stem,surface,terminal,texture,thicknes,type,variation,width
81	wfo-0001026754	success	176	87	63	113	24	0.358	0.5-1,0.9-1.1,1/2,10,2-2.5,2/3,5,5-lobed,acute,anther,apex,asymmetric,base,berry,broadly,clavate,cm,corolla,deeply,densely,diameter,ellipsoid,elliptic,entire,exerted,filament,glabrous,globose,growth,halfway,inflorescence,later,lateral,leaf,lobed,margin,membranous,minute,minutely,mm,narrowly,new,oblique,pedicel,peduncle,petiole,pubescent,scandent,simple,slender,sparsely,spreading,stem,stigma,style,surface,terminal,truncate,tube,vine,way,white,yellowish	-6+,.5,0.5,1,1-,1.5-3,198.,2,2-3,2-4,2.5-3.5,3-4-celled,30+,4-5,5-merou,5.5-9,7-9,9,9-11,abaxially,adaxially,ag,along,alyx,anthesi,apar,apparently,ark,articulated,axi,basal,branched,brow,cabrera,calyx,complete,conical,connivent,cucullat,dendritic,denser,distal,divided,eaf,ed,especially,extending,fide,flower,free,half,ilament,irregularly,lamina,leaving,lengthening,like,lobe,long,loosely,lower,many,mature,midvein,mixture,mostly,nflorescence,older,orolla,outline,pair,papillo,peg,perfect,pinnate,planar,plurifoliat,pore,poricidal,portion,primary,puberulent,ruit,scar,seen,sleeve,slit,small,sometimes,spaced,splitting,stellate-rotate,tangled,tem,time,tip,transparent,trichome,tub,twinin,twining,ud,uniseriate,unit,upper,vary,vein,weak,within,woody,x,yellow,ympodial	1-6,abaxial,adaxial,arrangement,bark,brown,bud,characteristic,colour,exertion,form,fruit,glabrousnes,length,lobing,na,number,ovary,per,seed,shape,size,texture,type
82	wfo-0001026756	success	147	77	55	92	22	0.374	0-7-1.2,0.5-3,1.5-1.7,1.5-10,1.5-2,1.8-3,5-10,5-10-flowered,abaxial,anther,bark,berry,bilobed,brown,cm,corolla,dark,densely,dia,difoliate,elliptic,erect,exserted,fruiting,glabrous,globose,green,leaf,long,minutely,mm,ovary,ovate,ovoid-reniform,pale,pedicel,petiole,pinkish-white,pitted,pubescent,shape,shaped,shrub,simple,sparsely,stem,stigma,strongly,style,surface,tear-drop,thick,tree,unifoliate,white	.25,.5,0.25-0.5,0.5-1,1-1.5,1-2,1.5-3,3-4,3.5-8.5,5-5.5,6-10,6-16,abaxially,acute,adaxially,along,anthesi,apex,apiculate,attenuate,ba,base,broadly,calyx,closely,conical,corresponding,deflexed,deltate,dendritic,denser,differing,distal,eaf,edicel,eed,filament,fleshy,free,geminat,glabrescent,grayish-brow,hard,inflorescenc,irregular,lamina,lateral,lax,like,lobe,lobed,lower,main,major,middle,minor,nearly,nflorescence,occasionally,older,opposite,overlappin,pair,papillo,perhaps,pericarp,planar,pore,poricidal,portion,present,pubescence,rest,ruit,scar,somewhat,soon,spaced,tall,tip,trichome,tub,tube,ud,uniseriate,unit,vein,wide,widest,woody,ympodial,young	adaxial,arrangement,bud,characteristic,colour,diameter,exertion,form,fruit,grayish-brown,growth,height,history,inflorescence,length,life,perennial,plant,seed,size,texture,type
83	wfo-0001026777	success	168	117	94	74	23	0.56	.5,0.25-0.5,0.5-1,0.5-1.5,1-1.3,1-10,1-2,1-4,1.2-1.8,1.5-3,2-4,5-50-flowered,5-7,acuminate,acute,anther,apex,axil,base,beneath,berry,blue,branching,brown,calyx,capitate,cm,corolla,decurrent,deflexed,dense,dia,distal,elliptic,end,exserted,fide,filament,filiform,flattened-reniform,flexuous,fruiting,glabrate,glabrous,globose,green,growth,lateral,leaf,lobed,long,main,minutely,mm,narrowly,near,nearly,new,occasionally,often,older,onto,opposite,ovary,overtopping,papillose,pedicel,petiole,pubescent,russet,seed,shaped,shiny,shrub,size,slightly,smooth,soon,sparsely,stem,stigma,straight,style,surface,tear-drop,trichome,tube,tuft,uniseriate,vein,vellozo,white,x,young	.25,/3,0.5-5,0.9-3,1-1.5,1.5-5,2-4.5,2-5,3-3.5,4-8,5-14,anthesi,apart,apiculate,ba,beginning,body,campanulate,cell,cup,differing,difoliate,eaf,edicel,eed,flattened,free,geminat,greyi,hyaline,incrassate,inflorescenc,irregularly,like,lobe,lon,lower,major,margin,matted,middle,minor,nflorescence,one,outline,pair,papillo,pitted,planar,pore,poricidal,portion,prominent,quadrate-deltoid,quite,rest,ruit,scar,sinuate,somewhat,spaced,tall,tapering,testa,thread-like,tip,ud,unit,wall,way,widest,woody,yellowish,ympodial	bud,characteristic,colour,diameter,exertion,form,fruit,glabrousnes,greyish,height,history,inflorescence,length,life,lobing,na,number,peduncle,per,plant,shape,texture,type
84	wfo-0001026819	success	218	145	118	100	27	0.541	0-27,0.3-4.7,1-10,1-2,1.2-36,1.5-10,1.5-12,1.5-3.0,1.5-3.3,1.6-3.5,10-26,2-6,2.5-5,3-120,3-18,3-35,3-38,4,4-10,4-7,5-30,6-11,abaxially,acute,anther,apart,attenuate,blade,blue,borne,brownish,capitate,cell,chartaceous,cm,condition,connate,connivent,corolla,covering,curved,dark,densely,diameter,distal,dot,drying,end,especially,filament,flower,fresh,fruit,glabrous,glaucous,globose,green,green-white,greenish,greenish-yellow,hair,hair-like,herb,homostylous,interjected,lanceolate,lateral,leaflet,light,long,lunate,make,membranous,mm,moderately,mottled,mucilaginous,non-glandular,odd-pinnate,often,ovoid,pair,pedicel,peduncle,pentagonal,plant,pubescent,purple,rotate-pentagonal,scale-like,scattered,seed,short,singly,slightly,sometimes,star,stem,stigma,straight,stripe,style,subglabrous,terminal,testal,thick,throughout,tinged,tuber,typically,unwinged,violet,wall,wet,white,whitish,wide,wing	0.5-1.5,1-2.3,1-5,1.5-3.5,10,2-5,3-20,5-merou,7,absent,acumen,acuminate,adaxially,ag,along,alyx,apex,articulated,ascending,base,bearing,broadly,bud,ciliate,clavat,cuneate,decurrent,digestion,dorsally,eaf,edge,eed,elliptic,enzyme,erec,exceeding,flat,folded,forked,geminat,generally,glabrou,greatly,half,honeycomb-shaped,larger,lengthening,like,living,lobe,lower,margin,middle,midvein,minutely,narrowly,nflorescence,oblique,orolla,ovate,pedice,petiole,petiolule,plurifoliate,pore,poricidal,puberulent,rachi,ranging,removed,ruit,seudostipule,slit,somewhat,spaced,specimen,stamen,ste,stolo,subequal,suborbicular,subrosette,subtending,symmetrical,tall,tamen,tem,tertiary,therefore,tip,tri-,truncate,tube,unit,usually,vary,within,without,yellow,ympodial	5-merous,arrangement,calyx,characteristic,clavate,colour,form,glabrousnes,growth,height,history,inflorescence,leaf,length,life,ovary,presence,pseudostipule,shape,size,spacing,staman,stolon,surface,texture,type,width
85	wfo-0001026821	success	204	108	88	116	20	0.431	.2,0.3-1.2,0.3-2.5,0.4-1.5,0.7-1.8,1-2,1-3,1-5,1.5-2.5,10-15,2-celled,2.5-18,3-11,3-18,3-branched,4-4.5,5-12,5-20,5-34,angular,anther,apically,appressed,auriculate,base,bayonet,berry,blade,broadly,brown,cm,cordate,dark,diameter,due,ellipsoidal,flattened,flower,forked,fruit,gglobose,glabrous,green,hair,herb,incurved,lateral,leaflet,length,light,long,mature,membranous,mm,narrowly,obliquely,oblong,odd-pinnate,pale,pedicel,peduncle,petiole,pilose,puberulent,pubescent,rachi,rarely,remnant,reniform,slender,small,somewhat,sparsely,stellate,stigma,stripe,style,subglabrous,substellate,surface,terminal,thickening,unbranched,wall,white,winged,x,yellow	/3,0-20,0.2-1.5,0.5-1.2,0.5-3.5,0.8-1,1-1.5,1-20,1.2-1.5,17,1977,2-15,2-3.5,2-6,3-6,3-7,3-celled,5-10,5-merou,abaxially,acuminate,acut,adaxial,adaxially,ag,alyx,anderson,apart,apex,apical,apiculate,articulated,axe,ba,basal,bract,cell,chartaceous,ciliat,cuneate,deltate,directed,distal,distally,eaf,eed,elliptic,equal,especially,exceeding,filament,frequent,fused,geminat,glabrou,gland-tipped,greatly,homostylous,interjected,interstaminal,lanceolate,large,leaf-opposed,lobe,long-attenuate,longitudinal,lower,lowermost,many,margin,mean,membrane,minute,minutely,moderately,much,nflorescence,oblique,obtuse,occasional,occasionally,one-celled,opening,orolla,pair,paired,per,perfect,petiolule,plurifoliate,pore,present,pseudostipular,pubescen,reduced,rounded,ruit,scandent,seudostipule,short,slightly,slit,smaller,spaced,stamen,subtended,tamen,tem,time,tri-,truncat,tube,unit,vary,wide,ympodial	10-20,arrangement,characteristic,colour,corolla,form,glabrousnes,growth,inflorescence,leaf,number,ovary,pseudostipule,seed,shape,size,stem,texture,truncate,type
86	wfo-0001026827	success	143	115	91	52	24	0.636	/3,0.2-0.5,0.4-0.6,0.5-2,0.6-1,1-1.1,1-1.5,1-2.1,1.3-1.6,2-2.2,2-4,3-9,7-9,acute,age,and/or,anther,anthesi,apex,appearing,arachnoid,attenuate,bark,base,branched,calyx,clavate,cm,conical,corolla,dendritic,densely,diameter,drying,ellipsoid,erect,exerted,filament,flower,glabrescent,glabrous,growth,inflorescence,internodal,lamina,lanceolate,leaf,lengthening,less,like,margin,minutely,mm,narrowly,new,nodding,oblanceolate,ovary,pair,paler,papillate,pedicel,peduncle,petiole,pore,poricidal,primary,pubescent,reddish,revolute,shrub,simple,slender,slit,soon,sparsely,stem,stigma,stout,strongly,style,surface,terminal,tip,trichome,tube,uniseriate,vein,way,white,x	.5,1-,1-2,1.5-2,2-2.5,5-6,?,abaxially,adaxiall,apart,branch,broadly,crowded,deciduou,deltate,dense,distally,dry,eaf,especially,fleshy,free,irregularly,know,known,lobe,lobed,lower,near,nflorescence,ot,papillat,perfect,planar,plane,plurifoliat,portion,rachi,scar,sinus,small,straight,surfac,thick,thickened,third,tub,ud,unit,upper,widest,ympodial	adaxially,arrangement,bud,characteristic,colour,deciduous,exertion,form,fruit,glabrousnes,height,history,length,life,lobing,na,number,per,plant,seed,shape,size,texture,type
87	wfo-0001026830	success	198	121	98	100	23	0.495	0-10,0.3-1.3,0.4-1,0.9-1.9,1-10,1-11,1-2,1.1-2.7,1.4-4,1.5-4,10-57,2.5-5,2.7-8,3.5-8.5,4-10,4-14.5,4-7,4.4-14.5,4.5-17.5,5-11,6-13,7-18,abaxially,adaxially,anther,berry,blade,brown,brownish,ciliate,clavate,cm,condition,coriaceous,corolla,deep,diameter,distal,drying,filament,finely,flower,fresh,fruit,glabrescent,glabrous,globose,green,green-white,greenish,hair,half,herb,high,interjected,lanceolate,lateral,leaf,leaflet,light,linear,lobe,long,margin,medium,mm,moderately,moniliform,mucilaginous,odd-pinnate,ovoid,pedicel,peduncle,pentagonal,plant,puberulent,pubescent,purple,ripe,rotate,seed,short,size,stigma,straight,stripe,style,subglabrous,terminal,throughout,tube,tuber,wet,white,whitish,x,yellow,yellowish	0.5-1.0,0.5-1.2,2-4,2-6,2.5-4.4,5-merou,acumen,acuminate,acute,adaxiall,ag,along,alyx,apart,apex,apparently,arranged,articulated,asymmetric,attenuate,axe,axillary,base,basiscopic,bead,bud,capitat,cell,connivent,covering,decreasing,digestion,dorsally,eaf,edge,eed,elliptic,enzyme,erec,exceeding,flat,folded,forked,geminat,generally,glabrou,hair-like,hal,homostylous,honeycomb,lengthening,like,living,lower,make,multiple,necklace,nflorescence,orbicular,orolla,ovate,pair,perfect,petiole,petiolulate,plurifoliate,pore,poricidal,removed,rounded,ruit,sessile,seudostipule,shaped,side,simple,slit,spaced,specimen,stamen,stolon,subequal,subglabrou,subtending,tall,tamen,tem,testal,thick,tip,tissue,toward,tri-,typically,unit,unwinged,usually,vary,wall,ympodial	arrangement,articulation,calyx,capitate,colour,erect,form,growth,height,history,inflorescence,length,life,number,ovary,pseudostipule,shape,spacing,staman,stem,surface,texture,type
88	wfo-0001026831	success	207	131	109	98	22	0.527	-6.5,-9,.5,/4,0-10,0-3,0-6,0.2-1,0.3-0.6,0.3-0.65,0.5-1.2,0.6,0.6-2,0.65-1,0.7-1.1,1-2.2,1-2.5,1-4,1.5-2.5,1/3,2-2.5,2-4,2.3-2.9,2.5-4.5,3-6,abaxially,acute,anther,apex,apparently,articulated,attenuate,bark,base,berry,branched,bright,calyx,cell,chartaceous,cm,connivent,cream,curved,dark,densely,diameter,dull,elliptic,erect,filament,flattened-reniform,flower,fruit,fruiting,glabrous,green,lateral,leaf,length,lobed,long,lower,margin,marking,maturity,mauve,membranous,mm,moderately,narrow-cuneate,orange,orange-brown,outline,pair,pale,pedicel,peduncle,petiole,poricidal,prickle,prickly,primary,raised,red-brown,rounded,shiny,shrub,slender,smooth,sparsely,spherical,stellate-pubescent,stem,style,surface,tapering,tip,tube,upper,usually,vein,way,white,white-gray,wide,yellow,yellow-green,young	-0.25,-5,0-20,0.1,0.1-0.2,0.1-0.25,0.15-0.25,0.2-0.4,0.7-2,1-10,1-2,1-3,1-6,1.2-2,1/3-1/,1/3-2/3,1/5-1/4,2-3,3-5,3.5-10,5-merous,7-10,7-8,alyx,apar,apart,apically,blade,broad-deltate,brow,caudat,concolorous,deltate,difoliate,distance,drying,eaf,eed,elongating,equal,extending,eye,free,fully,geminat,glabrescent,gray-brown,herbaceous,infructescence,less,lobe,longer,mature,midpoint,midvein,multangulate,naked,nflorescence,oblong,occasionally,older,one,open,opening,orolla,oung,ovate,pendulous,per,perfec,pericarp,porrect,portion,prickl,ray,reduced,ruit,scandent,scar,sessile,shorter,side,sometimes,spaced,spreading,stalk,stellate,subsessile,tamen,terete,tertiary,time,trichome,unit,vary,venation,visible,ympodial	1/3-1/2,arrangement,branch,brown,characteristic,colour,corolla,exertion,form,glabrousnes,growth,height,inflorescence,lobing,new,ovary,plant,seed,shape,size,texture,type
89	wfo-0001026841	success	139	87	59	80	28	0.424	/4,0.25-0.3,0.5-0.75,0.6-1,0.8-1,0.8-3,1.5,2-2.5,3.5-5,4-8,5-8-flowered,6-8,acute,anther,apex,bark,base,berry,bi-lobed,clavate,cm,corolla,curly-tipped,decurrent,dia,ellipsoid,elliptic,filament,filiform,fruiting,glabrate,glabrous,globose,green,inflorescence,later,leaf,long,mm,ovary,pedicel,petiole,poricidal,pubescent,shining,shrub,simple,slightly,sparsely,stem,stigma,style,tip,trichome,tube,uniseriate,way,white,young	.25,.5,0.05,0.25-0.5,0.5-1,0.5-2,0.75-1,1.5-2,3-6.5,7-9,9.2-18,along,anthesi,apart,arch,axi,ba,beneath,broadly,calyx,conical,coroll,deflexed,deltoid,eaf,edicel,eed,exsertion,free,greyish-gree,hyaline,immature,joined,known,lateral,like,lobe,lobed,lon,lower,main,margin,middle,minutely,nflorescence,older,opposite,pair,paler,papillo,papillose,pore,portion,prominent,raised,reddish,reflexed,rest,ruit,scar,series,shaped,slender,spaced,straight,tall,tapering,tear-drop,terminal,thickened,ud,unevenly,unifoliat,unit,vein,widest,winged,woody,x,ympodial	abaxial,arrangement,bud,characteristic,colour,diameter,exertion,form,fruit,greyish-green,growth,height,history,length,life,lobing,na,number,per,plant,seed,shape,size,surface,texture,type,unifoliate,ye
90	wfo-0001026849	success	180	91	66	114	25	0.367	0-10,0.5-1,1,1-2,1-6,1.5-2.5,1.75-2,11,2,5,5-10,acute,adult,apex,base,berry,brown,cm,colour,conical,cut,cyme,discoidal,distinctly,entire,floral,flowered,fruiting,glabrous,glandular,green,grey-brown,growth,hair,half,inflorescence,leaf,linear-lanceolate,lobe,long-cuneate,margin,mid-vein,minute,minutely,mm,oblong-lanceolate,pedicel,peduncle,petiole,rarely,reticulate,rhachi,rounded,seed,shallow,short-lived,shrub,simple,sinus,soft-wooded,stem,surface,unarmed,undulate,way,x	-50,1-1.5,100-130,2-3,30-,38/2,40,637/2,7-8,80-,adherent,amongst,anther,appearing,aspect,aster,australian,axil,calyx,capitate,cell,composed,conspicuous,corolla,curved,deflexed,developed,dia,distinct,eed,ellipsoid,emarginate,enlarge,erect,exceeding,except,exerted,expanded,facetted,filament,filled,flesh,flower,fork,free,general,globose,globular,granule,greater,gree,interacuminal,large,lavender,leave,lengthening,less,little,lon,long,loosely,lower,mature,maturity,native,nflorescence,oblong,occasionally,often,ovary,pal,pale,pedicellate,petal,plurifoliat,pore,poricidal,preparation,pruinose,purple,relatively,reproducing,rh,rotate,ruit,ruiting,sea,shed,slende,slightly,slit,solanum,solitary,sometimes,somewhat,soon,stigma,stone,stony,stout,style,thus,tip,tissue,tub,tube,ud,unit,uvenile,vegetatively,violet,well,ympodial,young	8,80-100-130,arrangement,branch,characteristic,depth,form,fruit,glabrousnes,height,history,juvenile,length,life,na,new,number,per,plant,plurifoliate,shape,size,slender,texture,type
91	wfo-0001026858	success	153	116	92	61	24	0.601	-30,0.5,0.8,0.8-1,1-10,1-11.5,1-4,1-5,1.3-1.5,1.5-4,2-2.5,2-3,2-4,2.5-3,3-,3-4,4.5-10.5,5-15,6-10,6-18,6-7,acumen,apical,apically,branched,calyx,cell,cm,connate,corolla,covering,cyme,dehiscent,diameter,dichasial,dichasially,distal,ebracteate,exceeding,filament,forked,glabrescent,glabrous,globose,green,hair-like,herbaceous,interjected,introrse,lateral,leaf,leaflet,light,lobe,long,make,maturing,minute,mm,monochasial,mucilaginous,mucronate,oblong,odd-pinnate,often,ovate,ovate-lanceolate,ovoid,pedicel,peduncle,perennial,petiole,plant,poricidally,seed,shiny,short,size,slit,stamen,stellate,stigma,straight,style,testal,thick,throughout,triangular,tuber-bearing,wall,wide,yellow	-4,0-.,1-,3-6-foliat,4-24,abaxially,abruptly,acute,adaxially,apex,articulate,base,cordate,cuneate,digestion,diminishing,dorsally,eaf,edge,eed,emoval,enzyme,flat,flower,folded,generally,globo,green-white,half,honeycomb,living,lon,lower,lunat,nflorescence,nther,oblique,obtuse,orolla,pair,pattern,perfect,plan,proximal,reveal,rounded,ruit,seudostipule,slightly,specimen,tal,tem,throughou,toward,typically,unit,vary,white-crea,without,ympodial,Â¼	0-2,abaxial,adaxial,anther,arrangement,colour,form,fruit,growth,height,history,inflorescence,length,life,lunate,ovary,pseudostipule,shape,stem,surface,texture,wet,white-cream,width
92	wfo-0001026895	success	166	134	113	53	21	0.681	0-0.5,0.5-1,0.5-1.2,0.5-1.5,0.5-2,0.8-1,1-1.5,1-5,1.4-2.1,2-2.3,2-2.5,2-3,2.5-3.2,2/3,3-12,5-8-flowered,abaxial,acute,adaxial,along,anther,apex,apically,appearing,attenuate,bark,base,berry,borne,brown,calyx,capitate,cm,contracted,corolla,dark,deflexed,dendritic,denser,dia,drying,ellipsoid,elliptic,erect,filament,filiform,flattened,fruiting,glabrate,glabrous,globose,green,incrassate,internodal,lamina,leaf,like,lobed,long,long-exserted,margin,minute,minutely,mm,mustard,narrowly,obovate,often,ovary,pale,pedicel,petiole,pitted,pointed,pore,poricidal,pubescent,reddish,reniform,scattered,shape,shaped,shoot,short,shrub,shrublet,side,simple,size,small,somewhat,soon,sparsely,stem,stigma,style,surface,swollen,swollen-based,tan,tear-drop,tip,toothed,trichome,tube,type,uniseriate,vein,way,white,x,yellow,young	.5,1.5-2,4.5-5,5-6,anthesi,apical,ba,broad,broadly,campanulate,closely,conical,deltoid,differing,difoliate,eaf,edicel,eed,elongate,free,geminat,hard,lateral,lobe,lon,lower,main,major,middle,minor,nflorescence,older,overlappin,pair,papillo,pericarp,portion,present,projection,reddish-brow,ruit,scar,spaced,tall,thin,tub,tuft,ud,unit,usually,widest,woody,ympodial	arrangement,bud,characteristic,colour,diameter,exertion,form,fruit,geminate,growth,height,history,inflorescence,length,life,lobing,papillose,plant,reddish-brown,seed,texture
93	wfo-0001026905	success	204	127	101	103	26	0.495	.5,0-2,0-25,0.4-0.9,0.4-1,0.5-0.7,0.5-1.5,0.6-0.7,0.7-1.4,0.75-1.1,0.9-1.3,1-2.5,1-3.7,1.9-2.5,1/2-3/4,2.5-2.9,3-5,3-8,5-6,acute,anther,apex,articulated,attenuate,bark,base,berry,branched,calyx,cell,chartaceous,cm,cream,dark,densely,diameter,dull,erect,filament,flattened-reniform,fruit,fruiting,gray-green,green,inflorescence,lateral,leaf,length,lobed,long,lower,margin,marking,maturity,mauve,mm,moderately,oblong,orange,orange-brown,outline,ovate,pair,pale,pedicel,peduncle,per,petiole,pit,poricidal,prickly,primary,raised,red,rounded,shallowly,shrub,small,smooth,sometimes,sparsely,spherical,stellate,stellate-pubescent,stem,style,surface,tapering,terete,tip,tube,unarmed,usually,vein,way,weakly,white,wide,yellow,yellow-green,young	-1.5,-10,-2,-2/3,-3,-4,.2,0,0-20,0.1,0.15,0.2-0.3,0.2-0.5,0.3-0.4,0.4,1,1-2,1-20,1-4,1-6,1/3,1/4,1/5-1/3,2-3,2.5-3.5,2/3-3/,5-merous,6-8,7-8,abaxially,acuminat,alyx,ame,apar,apart,apically,apparently,blade,brow,c.,connivent,curved,deltate,difoliate,discolorous,distance,drying,eaf,eed,elongating,equal,extending,eye,flower,free,geminat,glabrous,infructescence,lobe,longer,mature,midpoint,midvein,naked,older,one,open,orolla,oung,pendulous,perfec,pericarp,porrect,portion,prickl,prickle,ray,reduced,ruit,scar,sessile,shorter,side,slender,somewhat,spaced,spreading,stalk,stalked,straight,subentire,tamen,tertiary,time,trichome,unit,upper,variously,vary,venation,visible,woody,ympodial	2/3-3/4,alternate,arrangement,branch,brown,bud,characteristic,colour,corolla,exertion,form,glabrousnes,growth,height,lobing,na,new,number,ovary,plant,seed,shape,size,stigma,texture,type
94	wfo-0001026923	success	177	144	99	78	45	0.559	.5,0.25-0.5,0.5-1,0.6-0.8,0.8-1,1,1-1.5,1-7,1.5-2,2,2-2.5,2-6,20-50,3-4,3-5,4-18,5-10,5-15,abaxially,acuminate,acute,adaxially,anther,apex,articulated,base,black,branched,brown,calyx,chartaceous,cm,connivent,cuneate,curved,deltate,densely,diameter,elliptic,elliptic-ovate,entire,erect,filament,flattened,flower,forked,fruit,fruiting,glabrescent,glabrous,globose,green,hair,intermediate,lanceolate,lateral,leaf,light,like,lobe,long,margin,midpoint,mm,oblong,orange,pedicel,peduncle,peltate,petiole,possibly,pubescent,purple,ray,red,ripening,rounded,rugulose,scale,sessile,shrub,simple,small,sparsely,stellate,stem,stigma,straight,strongly,style,surface,tip,tree,trichome,tube,white,x,yellow,yellowish	-5,.1-0.3,0-5,0.5,1-3,1-4,1.5-4,10,2-3,4-5-,5-6,5-9,absent,accrescent,adaxiall,ag,apart,apparently,axe,ba,blade,capitat,center,covering,cylindrical,denser,directed,distally,eaf,eed,eglandular,equal,frui,fused,geminate,gland-tippe,glandular,held,large,leaf-opposed,longitudinal,lower,many-foliate,midvein,moderately,much,multangulate,nearly,nflorescence,opening,orolla,paired,perfect,pore,pubescence,rachi,relatively,ruit,short,slightly,slit,smaller,sometimes,somewhat,spaced,ste,subtending,tal,tamen,tem,time,unit,uprigh,usually,vary,whitish,wide,ympodial	appearance,arrangement,bark,border,branch,bud,capitate,characteristic,colour,corolla,corrugation,distal,drying,exertion,form,giving,glabrousnes,growth,height,history,inflorescence,interjected,leaflet,length,life,lobing,na,new,number,ovary,per,plant,prickle,primary,pseudostipule,seed,shape,size,terminal,texture,thicknes,type,variation,vein,width
95	wfo-0001026925	success	215	118	93	122	25	0.433	.5,0-7,0.5-1.5,0.9-1.8,00-200,1-1.3,1-1.4,1-25,1-3.5,1.5-2,1.8-2,1/3,1/3-1/2,2.4-2.6,2.4-3,4-14,4-5,6-17,acute,anther,apex,apparently,attenuate,bark,base,berry,calyx,chartaceous,cm,concolorous,connivent,cream,dark,deltate,diameter,drying,elliptic,erect,filament,flattened-reniform,fruit,fruiting,glabrescent,glabrous,green,green-brown,lateral,leaf,length,lobed,lobing,long,lower,margin,marking,maturity,mauve,membranous,mm,moderately,narrow-deltate,orange-brown,ovate,pair,pale,pedicel,peduncle,pendent,per,petiole,plant,poricidal,prickle,prickly,primary,red-brown,shrub,spherical,stellate-pubescent,stem,style,surface,tapering,terminal,tip,tube,upper,vein,way,white,wide,yellow,young	-2,/6,0,0-10,0-20,0-5,0.1,0.1-0.2,0.1-0.3,0.2,0.5-4,0.7-1.8,1-3,1-4,1.5-2.5,1.5-4.5,1.8-2.5,1/4-2/3,1/6-1/3,2-4,2-5,2.5-6,2/,3-20,3-7,4-10,4-7,5-6,5-8,5-merous,5.5-10,6-10,6-8,7-12,abaxially,acuminat,alyx,ame,andromonoecious,apar,apart,apically,articulated,blade,branched,broad-deltate,brow,c.,curved,distal,distance,eaf,eed,elongating,equal,extending,flattened,flower,free,gently,hair,hermaphrodite,heterostylous,infructescence,lobe,long-styled,longer,lowermost,mature,midpoint,midvein,minute,nflorescence,oblong,older,one,open,orolla,oung,pendulous,pericarp,plurifoliat,porrect,portion,prickl,rarely,ray,reduced,reflexed,rounded,ruit,scar,secondary,sessile,short-styled,side,simple,smooth,sometimes,spaced,sparsely,spreading,stalk,stalked,staminat,stellate,stout,straight,tamen,terete,tertiary,time,translucent,trichome,unarmed,unit,vary,venation,visible,woody,yellow-orange,ympodial	2/3,arrangement,branch,brown,bud,characteristic,colour,corolla,corrugation,exertion,form,glabrousnes,growth,height,inflorescence,na,new,number,ovary,seed,shape,size,stigma,texture,type
96	wfo-0001026946	success	205	141	115	90	26	0.561	0-20,0.5-2,0.9-3.5,0.9-4.3,1-2,1-4,1.5-2,1.6-3.7,10-39,12-23,2-15,2-5,2.5-10.5,2.7-9,3-20,3-5,3.5-10,4.1-9.4,5-7,6-24,8-15,8-25,acumen,anther,axillary,berry,blade,borne,brownish,bud,cell,chartaceous,clavate,cm,condition,connivent,corolla,covering,creamy,deeply,densely,diameter,distal,dot,drying,end,filament,flower,forked,fresh,fruit,generally,glabrous,globose,green,green-white,greenish,hair,hair-like,half,herb,homostylous,interjected,lanceolate,lateral,leaflet,like,lobe,long,make,membranous,mm,mottled,mucilaginous,odd-pinnate,often,ovoid,pedicel,peduncle,pentagonal,petiole,plant,pubescent,pure,purple,ripe,scattered,seed,short,short-pubescent,singly,size,slightly,stellate,stem,stigma,straight,streak,style,subtending,terminal,testal,thick,throughout,tube,tuber,typically,usually,wall,wet,white,whitish,x,yellow,yellow-white	0-5,1,1-10,2,3-6,4-7,5-merou,abaxially,acuminate,acute,adaxially,ag,along,alyx,apart,apex,apparently,articulation,attenuate,axe,base,broadly,capitat,ciliate,digestion,dorsally,eaf,edge,eed,elliptic,enzyme,erec,especially,exceeding,except,extremely,flat,folded,geminat,glabrou,greatly,honeycomb-shaped,lengthening,living,lower,margin,midrib,minutely,narrowly,nflorescence,oblique,orbicular,orolla,ovate,pair,perfect,petiolulate,petiolule,plurifoliate,pore,poricidal,proximal,puberulent,pubescen,reduced,removed,rounded,ruit,sessile,seudostipule,slit,spaced,specimen,stamen,ste,stolo,subequal,tall,tamen,tem,thir,tip,tri-,truncate,unit,unwinged,variable,vary,wing,ympodial	5-merous,abaxial,adaxial,arrangement,calyx,capitate,colour,erect,form,growth,height,history,inflorescence,leaf,length,life,number,ovary,presence,pseudostipule,shape,staman,stolon,surface,texture,type
97	wfo-0001026962	success	205	87	71	134	16	0.346	.05,0.3-0.7,0.8-1,1-1.2,1-3,1-4.5,1-6,1.5-17,1.5-2,10-12,10-20,2-2.5,2-6,3-3.5,6-7,acute,anther,apex,base,bud,calyx,cm,corolla,densely,diameter,dry,elliptic,entire,evenly,filament,flattened-reniform,flower,fruit,glabrous,globose,green,inflorescence,leaf,lobed,margin,material,mm,narrowly,obconic,oblong,pale,pedicel,peduncle,petiole,pubescent,purplish,rachi,rounded,sagittate,shrub,simple,size,slightly,small,sometimes,stellate,stem,stigma,style,tinged,tip,tree,unbranched,white,x,yellow	.5,0,0.5,0.5-0.8,0.5-1,0.5-1.5,1,1-1.5,1-2,1.5-3,1.5-5,15-22,2-5,2/3-3/4,3-6,4-5,9-12,9-17,abaxially,abrupt,abruptly,accrescent,adaxially,ag,alyx,anthesi,apparently,appearing,arising,articulated,axe,bark,basebud,becoming,beneath,blade,brittle,broadly,capitat,cell,chartaceous,closely,composed,connivent,constricted,cucullat,cylindrical,darker,deflexed,deltate,denser,differing,difoliate,dimorphic,eaf,eed,elongate,except,exerted,free,fruiting,geminat,glabrate,glabrou,ilament,incrassate,internodal,later,lateral,like,lobe,long,longitudinal,main,major,minor,minutely,nflorescence,obovoid,occasionally,often,older,one,opening,opposite,orolla,oung,outline,ovate-lanceolate,overlapping,packed,pair,papillose,paten,pendent,perfect,pitted,pore,portion,prominent,pubescen,raised,reflexed,remaining,rest,rounder,ruit,shaped,slender,slit,somewhat,soon,straight,surface,tal,tapering,tear-drop,tooth,triangular,trichome,trunk,tube,unarmed,unifoliate,uniseriate,unit,vary,vein,way,whit,woody,yellowish,ympodial,young	abaxial,adaxial,arrangement,capitate,characteristic,colour,form,growth,height,length,ovary,plant,seed,shape,texture,type
98	wfo-0001026964	success	128	108	81	47	27	0.633	.2,.5,0,0.5-1,1-1.2,1-2.5,10,10-30,2-2.5,2-4,3-5,3.5-7,4.5-8.5,7-8,acuminate,acute,along,anther,apex,attenuate,axillary,basal,base,berry,cm,conical,corolla,diameter,elliptic,equal,filament,filiform,fleshy,fruiting,glabrous,green,greenish,herb,horizontal,lateral,leaflet,lightly,lobed,long,long-attenuate,margin,minutely,mm,nearly,obovate,onto,ovary,pair,papillate,pedicel,petiole,petiolule,pinnate,poricidal,primary,pubescent,purple,rachi,shape,simple,size,slender,small,sparsely,stigma,style,surface,terminal,tip,trichome,tube,uniseriate,vein,winged,x,yellow	0.5,?,anthesi,beak,bearing,calyx,capitat,conspicuously,differentiated,distinct,eaf,edicel,erec,exserted,flower,free,glabrou,globose,immature,known,lenticellate,line,lobe,lower,nflorescence,noddin,often,one,open,ot,portion,purpli,reflexed,rugose,ruit,scar,side,smooth,somewhat,tal,tem,time,tub,ud,unifoliat,unit,ympodial	arrangement,capitate,characteristic,colour,form,fruit,glabrousnes,growth,height,history,inflorescence,leaf,length,life,lobing,na,nodding,number,peduncle,per,plant,purplish,seed,stem,texture,type,variation
99	wfo-0001026981	success	252	113	92	160	21	0.365	-0.8,-2.5,0.05-0.1,0.1-0.2,0.1-0.3,0.2-2,0.3-0.5,0.4-0.5,0.4-0.7,0.4-2,0.45-1.3,0.6-1.4,0.6-2,0.8-1.2,0.8-6,0.9-1.5,1-2,1-3,1-3.3,1-4,1.5-2.0,1.5-8.5,1.8-2.8,3.5-14,4,6-10,7.5,absent,anther,brown,calyx,capitate,cm,coastal,column,conical,corolla,dark,densely,diameter,exserted,filament,fruit,fruiting,glabrescent,glandular,globose,green,hair-like,halfway,herb,imparipinnate,interjected,interrupted,lateral,leaf,leaflet,lime,lobe,minutely,mm,narrowly,obovate,orange,orbicular,outgrowth,ovate,pale,pedicel,peduncle,pentagonal,perennial,petiolule,plant,population,primary,pseudostipule,pubescence,pubescent,secondary,sparsely,staminal,stem,stigma,style,surface,terminal,tube,type,variously,velvety,yellow	-0.4,-14,-2,-35,-4,-8,.2,.2-0.2,0-5,0.15-0.2,0.2,0.2-0.4,0.25-0.4,0.3.6,0.5,0.5-0.3,0.5-30,0.7-0.8,0.9-1.4,1,1-2-cellular,1-3-celled,1.5-5,1/3,11,196.,2-3,2-3-branched,2-locular,3-foliate,4-8,4-celled,<,abaxially,absen,abundant,academy,accrescent,acute,adaxially,adpressed,along,amongst,angled,anthesi,apex,apical,appearance,appendage,appressed,articulated,articulation,asymmetric,axi,base,basiscopically,bay,beak,becoming,bract,bracteole-like,cell,citrus-like,composed,cone,cordate,d,deltate,distal,eaf,ebracteate,edicel,eed,entire,erect,flower,giving,gree,half,head,included,initially,internode,irregularly,jointles,larger,later,less,like,linear,lobed,lon,long,lower,mainly,margin,maturity,mixed,much,multicellular,nflorescence,occasionally,ovary,pair,patent,per,petiole,present,procumbent,pronounced,proximal,rachi,reflexed,rick,robust,rounded,ruit,scen,see,sessile,several,shaggy,shaped,short,shorter,silky,simple,slender,smaller,sometimes,sparser,specimen,spreadin,sterile,straight,strong,tangled,tem,tertiary,testa,thick,tightly,transparent,trichome,tub,uni-,unicellular,uniseriate,unit,upto,usually,villous,viny,wall,wide,winged,without,ympodial,â,â	0.2-0.2,0.3-0.6,abaxial,adaxial,arrangement,bud,colour,exertion,form,glandularity,growth,height,history,inflorescence,length,life,seed,shape,texture,thicknes,width
100	wfo-0001026992	success	243	117	95	148	22	0.391	0.2-0.5,1-4,1.2-1.4,1.2-1.7,1.4-1.6,1.7-4.3,2-10,2.8-4.6,3-4,4-8,5.3-12.1,6-10,8,abaxially,abruptly,acuminate,acute,adaxially,angled,anther,anthesi,apex,attenuate,bark,base,berry,blunt-tipped,branch,branched,broadly,brown,calyx,cm,corolla,cylindrical,deltoid,diameter,elliptic,entire,exserted,filament,fleshy,flower,fruit,globose,granular-tomentose,greenish,grooved,lance-ovate,lanceolate,leaf,length,longitudinally,many,margin,mm,oblong,orange-tan,ovate,ovate-lanceolate,pedicel,peduncle,petiole,plant,pubescent,reniform,reticulate-punctate,ripe,scabridulous-,short,shrub,simple,size,small,sometimes,stem,stigma,style,subcampanulate,subglobose,surface,terete,terminal,time,tomentose,tree,unarmed,velutinous,violet,weakly,white,whitish,x,yellow,yellowish	-2.5,/7,0.25-0.45,0.5-1.2,0.6-1.5,0.8-3.4,00-170,1.3-2.6,1.3-4.3,1.4-1.9,1.5-3.4,1.7-1.9,1.7-2.4,1/2,10-12,12-33,2-5.6,2.3-3.3,2.6-4.6,2.8-4.7,3.3-5.5,3.3-5.6,5-15,5-merou,8-11,8-14,abaxial,accrescent,adaxiall,ag,along,alyx,apart,apparently,appressed,approximately,around,articulated,axe,axillary,ba,blade,capitat,chartaceous,completely,coriaceous,covering,crown,dark,densely,directed,distally,drying,eaf,echinoi,echinoid,edge,eed,enveloping,equal,evident,farinose,flat-topped,forming,free,fruiting,geminate,glabrescen,glabrous,hair,high,homostylous,immature,inserted,lacking,lateral,lengthening,less,line,lobe,lobed,long,long-stalked,longitudinal,lower,m.,main,mature,maturity,midrib,minute,moderately,mostly,multangulate,nearly,nflorescence,obtuse,occasional,occasionally,often,older,orolla,overlapping,perfect,plurifoliate,pore,poricidal,porrect-stellate,pubescence,rachi,rare,rather,ruit,runk,semi-ovate,sessile,short-,short-stalked,shorter,side,slit,somewhat,spaced,sparingly,split,spreading,stalked,stamen,stellate,stout-stalked,suture,tamen,tan,thin-textured,tip,tube,ud,unarme,unequal,unit,usually,vary,vein,way,wide,ympodial,young,Â½	arrangement,bud,capitate,characteristic,colour,exertion,form,glabrousnes,growth,height,history,inflorescence,life,lobing,new,ovary,perennial,seed,shape,texture,trunk,type
101	wfo-0001026994	success	266	187	150	116	37	0.564	-0.7,-10,-20,-30,-foliate,0.15-0.2,0.25,0.4-0.5,0.5,0.5-0.7,0.5-0.8,0.5-0.9,0.5-1.3,0.5-2,0.7-2.5,1,1-1.4,1-1.5,1-1.6,1.2-1.6,1.2-3.5,1.4-2.1,10-20,2,2-2.6,2-4,2-5-locular,2.2-3.2,2.5-6.5,3,4,4-15,6-20,abaxially,acuminate,acute,adpressed,anther,anthesi,apex,appearance,articulate,basal,base,bent,bifurcate,branched,bright,broadly,brown,calyx,capitate,cell,cm,conical,corolla,crenate,dark,darker,decreasing,deeply,densely,diameter,distal,eglandular,elliptic,exserted,filament,fruit,fruiting,giving,glabrous,globose,grayish,green,greenish,hair-like,half,halfway,herb,imparipinnate,inflorescence,interjected,interrupted,irregularly,lanceolate,lateral,leaf,leaflet,less,lobe,lobed,locule,long,margin,markedly,medial,midvein,minutely,mm,narrowly,obovate,often,outgrowth,ovary,pair,pedicel,peduncle,perennial,petiole,primary,pseudostipule,puberulent,pubescent,purple,rachi,rarely,regularly,ripe,set,shaggy,silky,simple,size,slightly,sometimes,sparsely,stem,stigma,straight,stripe,style,surface,terminal,testa,thick,tip,toward,trichome,tube,unicellular,uniseriate,unit,usually,velvety,wall,white,wide,woody,yellow	.2,.5,0.05-0.1,0.05-0.2,0.1,0.1-0.2,0.1-0.3,0.2-0.4,0.2-0.5,0.3-0.4,0.4-1.2,0.5-0.6,0.5-1.2,0.9-1.2,0.9-1.3,1-1.2,1-2,12-,2-,20-50,3-branched,4-celled,5,5-,5-7,7-13,8,8-12,absent,abundant,acroscopically,additional,along,also,amongst,andscattered,apical,apically,appendage,articulation,basally,basiscopically,becoming,beneath,berry,bifurcation,bract,bracteate,broader,celled,column,crenat,crowded,decumbent,decurrent,developed,eaf,ebracteate,edicel,eed,erect,especially,essentially,fewer,flower,glandular,gree,habitat,hal,head,internode,investing,lamina,large,larger,largest,leave,like,lon,loosely,lower,moderately,much,narrower,narrowing,nearly,nflorescence,node,oblique,occasionally,paler,papillate,petiolule,present,reflexed,robust,rocky,rotate-stellate,secondary,sessile,short,sinus,specimen,spreadin,spreading,staminal,sterile,tall,tem,tertiary,ud,weak-walled,well,winged,ympodial,young	5-13,arrangement,bark,border,branch,bud,characteristic,colour,corrugation,decurred,drying,exertion,form,glabrousnes,growth,height,history,length,life,lobing,midpoint,na,new,number,per,plant,prickle,ray,seed,shape,sympodial,texture,thicknes,type,variation,vein,width
102	wfo-0001026996	success	188	117	94	94	23	0.5	0-6,0.6-1,0.9-2.7,1-2,1-3,1.2-1.8,1.3-7.7,1.8-4.4,15-28,2-3,3-10,3-7,3.3-6,3.8-14.1,4-4.4,4-8,4.5-10.5,5-8,6-8,6.9-10.9,8.7-18.6,acumen,anther,berry,blade,blue,brownish,cell,clavate,cm,condition,connivent,coriaceous,corolla,covering,dark,deep,diameter,drying,filament,flower,fresh,fruit,glabrous,globose,green,green-white,greenish,hair-like,herb,homostylous,interjected,lanceolate,lateral,leaf,leaflet,lilac,lobe,long,make,medium,mm,moniliform,mottled,mucilaginous,odd-pinnate,ovoid,pedicel,peduncle,pentagonal,petiole,plant,purple,ripe,rotate,seed,size,stigma,straight,stripe,style,terminal,testal,thick,throughout,tube,tuber,unwinged,wall,wet,white,whitish,x,yellow	1-4,1-5,14-33,3-5,5-merou,abaxiall,abaxially,acuminate,acute,adaxially,ag,along,alyx,apart,apex,apparently,arranged,articulated,asymmetric,attenuate,axe,axillary,base,basiscopic,bead,bud,capitat,considerably,decreasing,digestion,distal,dorsally,eaf,edge,eed,elliptic,enzyme,erec,exceeding,flat,folded,forked,geminat,generally,glabrou,half,honeycomb-shaped,larger,lengthening,like,linear,living,lower,middl,multiple,necklace,nflorescence,orbicular,orolla,ovate,pair,perfect,petiolulate,plurifoliate,pore,poricidal,removed,rounded,ruit,sessile,seudostipule,side,slightly,slit,sometimes,spaced,specimen,stamen,stolon,subglabrou,subtending,symmetric,tall,tamen,tem,tip,tissue,toward,tri-,typically,unit,usually,vary,ympodial	5-merous,abaxial,adaxial,arrangement,calyx,capitate,colour,erect,form,growth,height,history,inflorescence,length,life,ovary,pseudostipule,shape,staman,stem,subglabrous,surface,texture
103	wfo-0001027010	success	198	118	96	102	22	0.485	0-2,0-2.5,0.4-5.1,0.5-1.5,1-10,1-2,1.2-1.7,1.2-1.9,1.4-6.9,14-46,2-9.4,2.1-15.3,2.1-4.3,2.2-12.9,3-10,3-5,3-6,3-8,3.5-13.6,4-12,4-8,4.4-29,4.9-31,5-13,5-14,acuminate,acute,anther,apex,attenuate,axillary,base,blade,brownish,bud,clavate,cm,condition,coriaceous,corolla,deep,diameter,drying,filament,flower,fresh,fruit,glabrescent,glabrous,green,greenish,herb,homostylous,interjected,lanceolate,lateral,leaf,leaflet,light,lobe,long,mm,moniliform,mucilaginous,odd-pinnate,ovate,ovoid,pedicel,peduncle,pentagonal,petiole,petiolulate,plant,purple,ripe,rotate,rounded,scabrous,seed,sessile,size,sometimes,stigma,stripe,style,subtending,terminal,tube,tuber,wet,white,whitish,wide,wing,winged,x	0-3,1-4,1-7,10-60,2-6,5-merou,abaxially,acumen,adaxiall,adaxially,ag,along,alyx,apart,apparently,arranged,articulated,asymmetric,axe,basiscopic,bead,capitat,cell,coloration,connivent,covering,decreasing,digestion,distal,dorsally,eaf,edge,eed,elliptic,enzyme,erec,exceeding,flat,folded,forked,geminat,generally,glabrescen,glabrou,green-white,hair,hair-like,hal,half,high,honeycomb-shaped,larger,lengthening,like,living,lower,make,multiple,narrow,necklace,nflorescence,occasionally,orbicular,orolla,pair,perfect,plurifoliate,pore,poricidal,present,removed,ruit,scabrou,seudostipule,short,side,slightly,slit,spaced,specimen,spot,stamen,stolon,straight,subequal,tall,tamen,tem,testal,thick,throughout,tip,tissue,toward,tri-,typically,unit,usually,vary,wall,yellow,ympodial	5-merous,abaxial,adaxial,arrangement,calyx,capitate,colour,form,growth,height,history,inflorescence,length,life,ovary,presence,pseudostipule,shape,spacing,stem,surface,texture
104	wfo-0001027019	success	142	113	94	48	19	0.662	.5,/4,0-0.5,0.5-1,1-1.5,1.5-2,1.5-3,10,10-40-flowered,12-30,2-3,2-5,2-8,4-8.5,7-14,abaxially,acute,adaxially,along,anther,apex,apparent,attenuate,bark,base,berry,branched,bright,calyx,capitate,cm,corolla,deflexed,densely,dia,ellipsoid,elliptic,erect,even,exserted,filament,flattened,fruiting,glabrate,glabrous,globose,golden,green,inflorescence,later,leaf,like,live,lobed,long,midrib,minor,minutely,mm,obovate,older,onto,opposite,ovary,ovoid-reniform,pale,papillose,pedicel,petiole,pitted,plant,pubescent,shaped,shrub,small,somewhat,sparsely,stem,stigma,straight,strongly,style,surface,tan,tear-drop,tree,trichome,tube,way,white,wing,winged,x,young	1-2,1/2,4-5,abaxial,abruptly,anthesi,ba,constriction,cyathiform,deltoid,difoliate,distal,eaf,edicel,eed,fleshy,free,geminat,inflorescenc,largely,lobe,lon,lower,major,narrowed,nflorescence,overlapping,papillo,planar,pore,poricidal,portion,reddish-brow,rest,ruit,scar,spaced,tall,tapering,third,tip,tub,ud,unit,waxy,widest,woody,ympodial	bud,characteristic,colour,diameter,exertion,form,fruit,growth,height,history,length,life,lobing,reddish-brown,seed,shape,size,texture,type
105	wfo-0001027030	success	234	168	141	93	27	0.603	-11,-15,.5,0.2,0.6-0.8,0.7-1,0.8-0.9,1,1-,1-1.3,1-3,1.2-1.6,1.6-2,2-4,2-6,2-7,2-foliate,2.2-3.2,3-4-celled,3-8,4-celled,5-12,8-celled,abaxial,abaxially,abundant,acute,adpressed,anther,anthesi,apex,appearance,basal,base,basiscopically,beneath,berry,bract,branched,bright,brown,calyx,capitate,cell,cm,conical,corolla,crenate,crenation,dark,darker,decurrent,deeper,deeply,densely,denser,diameter,due,eglandular,elliptic,entire,evenly,exserted,filament,flower,fruit,fruiting,giving,gland,glandular,globose,grayish,green,hair-like,half,halfway,herb,imparipinnate,inflorescence,internode,interrupted,interspersed,lamina,lateral,leaflet,less,like,lobe,long,longer,margin,minutely,mm,multicellular,narrowly,near,node,oblique,obovate,occasionally,often,outgrowth,ovary,pale,paler,papillate,pedicel,peduncle,perennial,petiole,primary,pubescence,pubescent,robust,silky,similar,simple,size,soft,sometimes,spread,stem,stigma,style,surface,testa,thick,tiny,trichome,truncate,tube,unicellular,uniseriate,unit,vein,velvety,wall,white,wide,woody,yellow	.2,0-4,0.05-0.1,0.1-0.7,0.1-0.9,0.15-0.2,0.2-0.3,0.2-1,0.3-,0.3-0.5,0.3-0.7,0.4-0.5,0.4-0.8,0.4-1.5,0.5,0.5-,0.5-0.7,0.5-0.8,0.5-1,0.6-0.7,0.6-1.8,0.8-1,0.9-1.1,1-1.2,1-3.4,1.5-,2-,2-3,2-4.8,2-locular,3-9,absent,acuminate,adaxially,angled,apical,appendage,articulated,articulation,axi,beyond,column,crenat,diamete,distal,eaf,edicel,eed,extremely,gree,growt,hal,interjected,investing,irregularly,lanceolate,larger,lon,loosely,lower,nflorescence,pair,petiolule,present,pseudostipule,reflexed,rotate-stellate,ruit,secondary,sessile,slender,slightly,small,smaller,somewhat,sparsely,spreadin,spreading,staminal,sterile,straight,stripe,tall,tem,terminal,tertiary,trailing,ud,usually,weak,winged,ympodial,young	arrangement,branch,bud,characteristic,colour,corrugation,drying,exertion,form,glabrousnes,growth,height,history,leaf,length,life,lobing,mentioned,new,number,per,plant,seed,shape,sympodial,texture,type
106	wfo-0001027035	success	199	139	116	83	23	0.583	0-36,0.1-0.9,0.3-2.3,0.4-12.8,0.5-3.4,0.5-7,0.8-3,0.8-4.2,0.9-3.1,1-2,1-3,1-3.4,1-8,1.5-5.9,1.7-8,1.8-5.2,10-80,2.8-10.3,3-10,3-5,4-18,4-18.5,4.9-23.5,acuminate,acute,anther,apart,apex,attenuate,axillary,base,blade,blue,brownish,bud,cell,clavate,cm,completely,condition,corolla,covering,deep,diameter,distal,drying,elliptic,filament,flower,forked,fresh,fruit,generally,glabrescent,glabrous,globose,green,green-white,greenish,hair,hair-like,half,herb,homostylous,interjected,lanceolate,lateral,leaf,leaflet,light,lilac,lobe,long,make,medium,mm,moniliform,mucilaginous,odd-pinnate,ovate,ovoid,pedicel,peduncle,pentagonal,petiole,petiolulate,plant,purple,ripe,rotate,rounded,seed,sessile,shape,short,size,sometimes,stigma,straight,stripe,style,subtending,terminal,testal,thick,throughout,tube,tuber,usually,wall,wet,white,whitish,wide,x,yellow	0-7,0.5-5,2-38,2-7,5-merou,abaxially,acumen,adaxiall,adaxially,ag,along,alyx,apparently,arranged,articulated,asymmetric,axe,basiscopic,bead,capitat,coloration,connivent,decreasing,digestion,dorsally,eaf,edge,eed,enzyme,erec,exceeding,flat,folded,geminat,glabrescen,glabrou,hal,high,honeycomb,larger,lengthening,like,living,lower,multiple,necklace,nflorescence,orbicular,orolla,pair,perfect,plurifoliate,pore,poricidal,present,removed,ruit,second,seudostipule,shaped,side,slightly,slit,smaller,spaced,specimen,stamen,stolon,subequal,subglabrous,tall,tamen,tem,tip,tissue,toward,tri-,typically,unit,unwinged,variable,vary,ympodial	5-merous,abaxial,adaxial,arrangement,calyx,capitate,colour,erect,form,glabrousnes,growth,height,history,inflorescence,length,life,ovary,pseudostipule,spacing,staman,stem,surface,texture
107	wfo-0001027050	success	244	136	114	130	22	0.467	-12,-9,/3,0.3-1.5,0.5-3,0.9-2.1,1-1.5,1-2,1.5-6,10-13.5,2-5,2-8,3-5,abaxial,acuminate,acute,adaxial,anther,apex,bark,base,berry,branch,branched,broadly,brown,calyx,capitate,chartaceous,cm,coarsely,conical,cordate,cuneate,densely,diameter,distally,drying,elliptic,entire,erect,ferruginous,filament,flattened-reniform,fruit,fruiting,glabrous,glandular-puberulent,green,growth,hair,inflorescence,lanceolate,lateral,leaf,leaf-opposed,length,like,lobe,lobed,margin,markedly,minute,minutely,mm,moderately,narrowly,near,oblique,obtuse,often,ovate,pale,pedicel,peduncle,petiole,plant,present,pubescent,rest,ripe,rounded,several,shallowly,shiny,short-stalked,shrub,side,small,sparsely,spherical,stellate,stellate-pubescent,stem,stigma,style,surface,terete,thicker,time,toothed,tree,triangular,trichome,truncate,tube,unbranched,usually,way,white,whitish,woody,yellow,yellowish-green	.2,.5,0-0.2,0-3,0.1-0.3,0.1-3,0.2-0.5,0.2-1,0.8,1,1.5-2,12-15,15-50+,2-2.5,2-3,2-4,2.5-3,4-20,4-8,5,5-10,5-6,5-7,5-9,5-merous,50,6-8,7-30+,8-26,abaxially,absen,absent,abundant,adaxiall,adult,alyx,andromonoeciou,apar,arme,articulated,axe,basal,blade,broad,broad-based,brow,closely,connivent,curved,deeply,difoliate,directed,distal,distall,eaf,eed,eglandular,equal,erec,except,flattened,flower,free,geminat,half,heterostylous,infructescence,inside,interpetalar,juicy,juvenile,larger,least,less,long,long-styled,longer,lower,mature,mid-way,midpoint,midrib,midvein,moist,mucilaginous,multiseriate,nflorescence,numerous,occasionally,older,orolla,oung,ovate-lanceolate,papillat,per,pericarp,pore,poricidal,porrect,portion,prickle,pricklier,prickly,ray,ruit,scar,scattered,secondary,sessile,short-styled,shorter,slightly,somewhat,spaced,stalk,stalked,straight,tall,tamen,tip,tissue,touching,unarmed,unit,vary,weakly,wide,ympodial,young,younger	alternate,armed,arrangement,characteristic,colour,corolla,exertion,form,glabrousnes,height,history,life,lobing,new,ovary,papillate,perennial,seed,shape,size,texture,type
108	wfo-0001027050	success	234	108	90	144	18	0.385	0.5-1,0.5-3,1-1.5,1-2,1.5-6,10-13.5,11-21,14-20,2-10,2-5,2-8,3-15,acuminate,acute,anther,apex,base,branched,broadly,brown,chartaceous,cm,coarsely,connivent,cordate,cuneate,densely,diameter,drying,elliptic,entire,extra-axillary,ferruginous,filament,flattened,flower,forked,fruit,fruiting,glabrous,glandular-puberulent,globose,green,growth,hair,inflorescence,lanceolate,leaf,leaf-opposed,length,like,lobed,margin,minutely,mm,moderately,oblique,obtuse,often,ovate,ovate-lanceolate,pale,pedicel,peduncle,petiole,pitted,plant,present,rounded,shallowly,shrub,simple,small,somewhat,sparsely,stellate-pubescent,stem,stigma,style,surface,toothed,tree,truncate,unbranched,usually,white,whitish,x,yellow,yellowish-green	.2,0-0.2,0-0.5,0-1,0-3,0.1-3,0.2-0.6,0.2-1,0.3-0.6,0.4-1,0.5-0.8,0.8,1-5,1.5-2,10-30,12-15,15-50+,16-40,2-2.5,2-3,2-3-locular,2-4,2-6,2-foliate,2.5-3,23-40+,3-5,4-19,4-40,4-8,5,5-10,5-6,5-7,5-9,5-merous,6-8,7-30+,8-26,8-40+,abaxially,absen,absent,abundant,accrescent,across,adaxiall,adaxially,adult,andromonoecious,anvil-shape,apart,armed,articulated,axe,ba,blade,branche,broad-based,calyx,capitat,contiguous,cross-section,curved,cylindrical,deeply,directed,distall,distally,distributed,eaf,eed,eglandular,erect,except,exocarp,functional,geminat,half,held,interpetalar,juicy,juvenile,lateral,less,lobe,long,longer,lower,markedly,mature,mesocarp,midpoint,midvein,minute,moist,mucilaginous,multiseriate,narrowly,nearly,nflorescence,orolla,pair,per,pinnatifid,placenta,pore,porrect,prickle,rachi,ray,ruit,scattered,sessile,shorter,side,slightly,spaced,stalk,stalked,stellae,stellate,straight,tal,tamen,tem,thick,thicker,throughout,time,tip,tissue,triangular,tube,unarme,unarmed,unit,upper,upright,vary,weakly,wide,ympodial,younger	abaxial,adaxial,arrangement,capitate,characteristic,colour,corolla,form,glabrousnes,height,lobing,new,ovary,seed,shape,size,texture,type
109	wfo-0001027091	success	142	132	98	44	34	0.69	.3,0.7,0.8,1-1.6,1.1-1.6,1.8-2.6,1/2-2/3,2.3-2.9,2.5-3.5,3-8,3-9,4-10,5-11,6-10,8.5-11.5,9-13,acute-tipped,along,annual,anther,arcuate,armed,base,beneath,berry,blade,blue,bristly,broadly,brown,calyx,capitate-glandular,cm,dark,deltoid,densely,dia,dm,extended,few-rayed,fully,glabrous,gland,glandular,green,hair,herb,internodal,lenticular,linear-lanceolate,lobe,long,longer,low,main,mm,mostly,narrowly,near,obtuse,occasionally,oriented,ovate,pedicel,petiole,pinnatifid,pinnatisect,prickly,radially,reticulately,ridge,rounded,scattered,sessile,short-stipitate,simple,sometimes,sparsely,spherical,stellae,stellate-pentagonal,stem,strait,suffused,surface,tapering,terete,terminally,tube,twice,undulate,uniseriate,usually,variously,vein,vestiture,violet,wrinkled	30-60,6-10-flowere,accrescent,across,alyx,anthesi,branched,campanulate,cauline,developing,difoliate,divided,dry,eaf,eed,enveloped,geminat,high,invested,lon,maturity,nflorescence,orolla,per,ruit,short,slende,somewhat,splitting,spreadingly,ste,tamen,taprooted,tightly,tigma,tub,tyle,unexpande,unit,vary,wholly,yello,ympodial,younger	6-10-flowered,armament,characteristic,colour,corolla,diameter,form,fruit,fruiting,glabrousnes,glandularity,growth,height,history,inflorescence,leaf,length,life,lobing,na,ovary,plant,pricklines,seed,shape,slender,staman,stigma,style,texture,type,unexpanded,variation,yellow
110	wfo-0001027102	success	167	104	85	82	19	0.509	.5,0.2-2,0.5,0.5-1,0.5-2,0.5-3,1-1.5,1-2.5,1-4,10-20,15-35,3,3-12,4-5,4-7,absent,acuman,acuminate,acute,adaxial,almost,anther,apex,base,broad,broadly,calyx,chartaceous,ciliate,cm,connivent,cuneate,cylindrical,deltate,densely,diameter,elliptic,entire,filament,flattened,flower,forked,fruit,glabrous,globose,hair,lanceolate,leaf,leaf-opposed,long-tapered,margin,mm,moderately,multiseriate,narrowly,oblong,orange,pedicel,peduncle,petiole,pubescent,rachi,rarely,ripe,rugulose,shrub,simple,size,small,somewhat,stellate,stem,stigma,straight,style,surface,tip,tomentose,truncate,tube,unbranched,white,x,yellow,yellow-brown	.5-6,1-2,1-3,1-6,1.5-2,15,2-2.5,2-3,3-4,3-5,5-12,<,abaxially,absen,accrescent,adaxiall,adaxially,ag,aggregate,alyx,apart,appearance,articulated,axe,ba,blade,cell,channe,congested,corky,curved,differing,difoliate,dimorphic,directed,distally,eaf,eed,few-,free,fruiting,geminat,giving,ilament,lobe,long,longitudinal,m.,major,minor,nflorescence,obtuse,often,one,opening,orolla,ovate,per,perfect,pore,portion,roughened,ruit,short,slender,slit,spaced,sparsely,stone,subcoriaceous,tal,tem,time,triangular,truncat,unarme,unit,usually,vary,wide,ympodial,young	abaxial,arrangement,characteristic,colour,corolla,form,growth,height,history,inflorescence,length,life,ovary,perennial,plant,seed,shape,texture,type
111	wfo-0001027104	success	141	122	69	72	53	0.489	0.15-0.35,0.5-0.8,1-3,1-4,1.2-6,1.5-2.3,1.5-4.2,10-15,2-6,2.2-5,3-5.5,5-15,6-7.5,acuminate,acute,apex,apical,articulate,attenuate,base,branched,calyx,cm,cordate,corolla,cyme,dehiscent,diameter,dichasial,dichasially,distal,ebracteate,filament,finely,globose,green,green-white,herbaceous,introrse,lateral,lobe,long,maturing,mm,monochasial,mucilaginous,mucronate,odd-pinnate,often,ovate,ovoid,pedicel,peduncle,perennial,petiole,plant,poricidally,pubescent,seed,short,slit,stigma,style,throughout,tone,truncate,white,wide,yellow-green	1-1.5,2-3,3-6-foliat,4-15,abaxially,acumen,adaxially,apically,cell,condition,connate,covering,digestion,dorsally,eaf,edge,eed,emoval,enzyme,epiphyti,epiphytic-like,exceeding,flat,flower,folded,forked,generally,globo,growing,hair-like,half,honeycomb,linear,living,lon,lower,make,mos,narrowly,nflorescence,nther,orolla,ovat,pattern,perfect,plan,proximal,rarely,reveal,ruit,seudostipule,simple,specimen,stamen,stellate,straight,tall,tem,terrestrial,testal,thick,throughou,tuber-bearing,typically,unit,vary,viole,wall,without,yellow,ympodial,Â¼	2,anther,appearance,arrangement,bark,border,branch,bud,characteristic,colour,corrugation,drying,exertion,form,fruit,fruiting,giving,glabrousnes,growth,height,history,inflorescence,interjected,leaf,leaflet,length,life,lobing,margin,midpoint,na,new,number,ovary,per,prickle,primary,pseudostipule,ray,shape,size,stem,surface,terminal,texture,thicknes,tube,type,variation,vein,violet,wet,width
112	wfo-0001027114	success	154	91	71	83	20	0.461	-17,-2,-30,.5,1-1.1,1-1.2,1.5-1.7,1/2,13-21,2-2.5,2-3,20-40,3-4,3-7,6-8,6-9,abaxial,anther,appearing,bark,base,berry,branched,calyx,capitate,cm,conical,corolla,dark,dendritic,densely,dia,elliptic,flattened-reniform,flowered,fruiting,glabrous,globose,green,inflorescence,leaf,lobed,long,many,margin,minutely,mm,opposite,ovary,pedicel,petiole,pitted,poricidal,pubescent,reddish,reddish-brown,shoot-terminal,shrub,size,soft,stem,stigma,style,surface,thickened,time,tip,trichome,way,white,wide	0.5-1,1-1.5,1-2,1.5-2,5,7-10,7-9,abaxially,acute,adaxially,along,alternating,anthesi,apar,apex,axillary,ba,bushy,closely,commonly,deltate,differing,difoliate,drying,due,eaf,edicel,eed,erect,exserted,filament,free,geminate,glabrou,growt,halfway,inflorescenc,investing,lamina,lateral,like,lobe,lon,lower,main,major,minor,minute,nflorescence,occasionally,older,opening,pair,papillo,planar,plurifoliate,pore,portion,projection,rapid,rest,ruit,scar,scattered,several,shoot,simple,slit,spaced,tall,tapering,triangular,tub,tube,ud,unevenly,uniseriate,unit,vein,woody,yellowish,ympodial,young	adaxial,characteristic,colour,diameter,form,fruit,growth,height,history,length,life,lobing,na,perennial,plant,seed,shape,texture,type,variation
113	wfo-0001027117	success	235	131	102	133	29	0.434	-1.5,-12,-2.8,.5,/3,0-10,0-20,0-5,0.1-0.7,0.5-1.5,0.6-0.9,0.7-0.9,0.7-1.3,0.7-1.5,1-2,1.5-2.3,1.7-2.5,1/3,2-3,2.3-2.8,4-7,4-8,4.5-8,5-11,abaxially,acute,almost,anther,apex,apparently,articulated,attenuate,bark,base,berry,black,branched,brown,calyx,cell,chartaceous,cm,concolorous,cordate,dark,densely,diameter,discolorous,drying,erect,evenly,filament,fine,flattened-reniform,fruit,fruiting,green,herb,lateral,leaf,length,lobed,long,lower,margin,maturity,mauve,mm,moderately,narrow-deltate,narrow-lanceolate,oblong,outline,ovate,pair,pedicel,peduncle,petiole,pit,prickle,prickly,primary,raised,red-brown,rounded,shallowly,small,smooth,spherical,stellate-pubescent,stem,style,surface,tapering,tube,vein,way,weakly,wide,yellow,yellow-green,young	-11,-3/4,0-15,0-25,0-40,0.1,0.1-,0.15-0.25,0.15-0.35,0.2,0.2-0.45,0.5,0.8-,1-4,1-6,1.2,1.5-,1.5-6.5,1.8-2.5,1/,1/4,1/8-1/2,10-20,2-6,2-8,25-100,3-10,3-15,3-6,4-6.5,4.5-6.5,5-14,5-merous,6-10,6-9,7-,8,accrescent,acicular,alyx,ame,apar,apart,apically,beyond,blade,brittle,c.,connivent,curved,deltate,distance,eaf,eed,elongating,enclosing,extending,fifth,flower,four,free,gently,glabrescent,glabrous,gra,herbarium,infructescence,irregularly,less,lobe,lon,long-acuminat,longer,mature,membranous,midpoint,midvein,narrow-elliptic,nflorescence,obovate,older,one,open,orolla,oung,pale,pendulous,per,perfec,pericarp,perpendicular,plurifoliat,poricidal,porrect,portion,prickl,ray,reduced,reflexed,ruit,scar,sessile,shiny,shorter,side,sometimes,spaced,sparsely,specimen,spreading,stalk,stalked,staman,stellate,straight,tamen,tearing,terete,tertiary,time,tip,tissue,translucent,trichome,unequal,unit,upper,variously,vary,venation,visible,woody,ympodial	0.8-6.5,1.5-14,arrangement,branch,bud,characteristic,colour,corolla,exertion,form,glabrousnes,gray,growth,height,history,inflorescence,life,lobing,na,new,ovary,perennial,plant,seed,shape,size,stigma,texture,type
114	wfo-0001027123	success	181	137	110	71	27	0.608	-10,-20,.3,0.5,0.8-1.3,1,1-1.2,1.5-2,2-2.6,2-5.5,2-lobed,2.5-6,3-15,3-4,4-5,4-6,5-10,5-6,abaxial,acute,adaxially,along,anther,apex,attenuate,axe,axi,base,branched,bright,brown,calyx,clavate,cm,commonly,completely,conical,constricted,coriaceous,corolla,cup-shaped,dark,darker,diameter,drying,elliptic,exerted,filament,flattened,flower,glabrous,glandular,globose,green,inflorescence,lamina,leaf,less,like,long,loose,loosely,margin,mauve-purple,minutely,mm,narrowly,nodding,ovary,pair,papillate,pedicel,peduncle,perhaps,petiole,pitted,primary,pubescent,reddish,reniform,revolute,scattered,shining,shiny,simple,sometimes,soon,sparsely,stellate,stem,stigma,stoutish,strongly,style,subshrub,surface,terminal,thick,time,trichome,tube,turned,vein,violet,warty,way,white,x,young,Â¾	.5,0.3-1.6cm,0.5-0.8,0.7-3.5,0.9-1.3,1-1.5,2-2.2,2-2.5,2-3,2.5-10.4,2.5-4,adaxial,anthesi,appearing,bark,broadly,campanulate,cell,deltate,dendritic,densely,denser,eaf,edge,eed,enlarged,erect,fide,free,fruiting,inserted,lax,lewi,lobe,lobed,lon,lower,midvein,minute,monopodia,nflorescence,older,outline,papillae,perfect,petal,planar,plurifoliate,portion,prominent,scar,scatted,shin,shinin,short,sinuate,sleeve,slightly,spaced,straight,testal,tip,trailing,tub,ud,unit,upper,usually,widely,wood,ympodial	0.3-1.6,appearance,arrangement,berry,border,bud,characteristic,colour,form,fruit,giving,glabrousnes,growth,hair,height,history,length,life,lobing,new,plant,seed,shape,size,texture,type,ye
115	wfo-0001027146	success	213	133	115	98	18	0.54	0-11,0.3-2.2,0.5-3.2,0.7-2.4,0.8,0.8-5.8,1-2,1-2.5,1-9.5,1.9-10,10,13-36,2-12.2,2-13,2-4.2,3.3-6.1,3.5-22,4-11,4-12.5,4-8,6-10,6-17.5,6.5-52,abaxially,adaxially,along,anther,berry,blade,brownish,cell,chartaceous,ciliate,clavate,cm,coarsely,condition,conical,connivent,corolla,covering,dark,deep,diameter,drying,especially,filament,finely,flower,fresh,fruit,glabrous,green,green-white,greenish,hair,hair-like,herb,homostylous,interjected,lanceolate,lateral,leaf,leaflet,like,lobe,long,make,margin,medium,membranous,midrib,minute,minutely,mm,moniliform,mottled,mucilaginous,odd-pinnate,ovoid,pedicel,peduncle,petiole,plant,puberulent,pubescent,purple,ripe,seed,semierect,simple,size,stem,stigma,straight,style,subglabrous,terminal,testal,thick,throughout,tinged,tip,tube,tuber,unwinged,violet,wall,wet,white,whitish,wide,wing,x,yellow	0.6-3.3,0.8-3.1,1-10,2-5,4-38,5-merou,6,acumen,acuminate,ag,alyx,apart,apex,apparently,arranged,articulated,asymmetrical,attenuate,axe,axillary,base,basiscopic,bead,bud,capitat,commonly,darker,decreasing,digestion,distal,dorsally,eaf,edge,eed,elliptic,enzyme,erec,exceeding,flat,folded,forked,fourt,fourth,geminat,generally,glabrou,gradually,half,honeycomb-shaped,lengthening,living,lower,multiple,necklace,nflorescence,orbicular,orolla,ovate,pair,pentagonal,perfect,petiolule,plurifoliate,pore,poricidal,proximal,rarely,ray,removed,rotate,ruit,secondary,sessile,seudostipule,side,slit,sometimes,spaced,specimen,stamen,ste,stolon,subequal,subglabrou,subsessile,subtending,symmetrical,tall,tamen,tem,tissue,toward,tri-,typically,unit,usually,vary,ympodial	5-merous,arrangement,calyx,capitate,colour,erect,form,growth,height,history,inflorescence,length,life,ovary,pseudostipule,shape,surface,texture
116	wfo-0001027157	success	207	117	93	114	24	0.449	0-3,0.15-0.3,1,1-10,1-2,1-3,1-6,1.5-6.5,10-30,2-15,2-2.5,2-3,2-5,2.3-4,2.5-3,3-7,3.8-8.3,4-5,9-12,absent,anther,apart,berry,broadly,brownish,cell,chartaceous,clavate,cm,condition,conical,corolla,covering,deeply,densely,diameter,drying,elliptic,end,filament,flower,forked,fresh,fruit,generally,glabrous,green,greenish,hair,hair-like,herb,homostylous,interjected,lanceolate,lateral,leaf,leaflet,like,lobe,membranous,mm,odd-pinnate,one,ovate,ovoid,pair,pedicel,peduncle,placed,plant,puberulent,pubescent,ripe,seed,size,sometimes,stellate,stem,stigma,straight,style,terminal,testal,thick,tinged,tube,tuber,typically,violet,wall,white,whitish,x	0.7-2,0.9-2.8,1-3.8,2,3-12,3.3-7.8,5-merou,6.5-14.5,abaxially,acumen,acuminate,acute,adaxially,ag,along,alyx,among,apex,apparently,articulated,attenuate,axe,axillary,base,blade,bud,capitat,ciliate,connivent,cordate,cuneate,decreasing,decurrent,digestion,distal,dorsally,eaf,edge,eed,enzyme,erec,especially,exceeding,flat,folded,geminat,glabrou,grassland,greatly,green-white,half,honeycomb-shaped,lengthening,living,long,low-growing,lower,make,margin,markedly,middl,midrib,minutely,mucilaginous,narrowly,nflorescence,oblique,obtuse,orbicular,orolla,perfect,petiole,petiolulate,petiolule,plurifoliate,pore,poricidal,rarely,removed,rounded,ruit,semi-rosette,sessile,seudostipule,shady,short,situation,slightly,slit,spaced,specimen,stamen,ste,stolo,subsessile,subtending,sunny,tall,tamen,tem,throughout,tip,toward,tri-,unequal,unit,unwinged,usually,vary,wet,wide,woodland,yellow,ympodial	abaxial,adaxial,arrangement,calyx,capitate,colour,form,growth,height,history,inflorescence,length,life,ovary,placement,pseudostipule,shape,spacing,stolon,surface,texture,type,variation,width
117	wfo-0001027184	success	219	184	142	77	42	0.648	.3,.5,.7,.8,0.2-0.4,0.4-2,0.8,0.8â1.6,1.5-5,1.8â3.5,13â18,19,1â2,1â2.5,1â4,2,2.8â4.1,2â4-celled,3-foliolate,3.5â8,3â,4â12,5,5-7,7,abaxially,absent,acute,adaxially,along,anther,apex,axi,axillary,base,blue,borne,bract-like,branch,broad,brown,calyx,cm,connivent,covered,densely,diameter,directed,entire,epidermal,especially,extension,filament,flattened,fleshy,flower,foliaceous,fruit,fruiting,generally,glabrescent,glabrous,globose,grading,hair,hairlike,half,herbaceous,imparipinnate,introrsely,lanceolate,lateral,leaf,leaflet,leafy,light,lobe,long,longitudinal,lower,margin,membranous,meter,midrib,minutely,mm,mostly,nearly,oblong,obtuse,often,older,opening,orange,pedicel,peduncle,per,petiole,pilose,pore,prominently,pseudostipule,puberulent,pubescent,raised,rarely,red,reticulate,revolute,ripe,several,shape,shoot,short,simple,size,slightly,slit,small,soft-woody,somewhat,sparsely,stem,stigma,style,sulcate,surface,terminal,tertiary,tip,truncate,tube,unbranched,unequal,vein,vine,wall,white,x,yellow,young,â9	0-,0-0.2,0.4â0.9,0.5-2,0â3,1-2,1.5,3-4-,3â4-celled,4,9,accrescent,adaxiall,adventitious,ag,always,alyx,apart,appressed,articulated,axe,ba,basal,blade,broadly,cell,chartaceous,clavat,cluster,cordat,cylindrical,eaf,eed,elliptic,fasciculate,free,geminat,glabrou,ilament,larger,largest,least,less,like,m.,much,narrowly,nflorescence,node,opposite,orolla,ovate,ower,petiolule,plurifoliate,portion,prominent,rachi,root,ruit,scarcely,secondary,spaced,stellate,straight,subopposite,tightly,tree,trunk,unarme,uniform,unit,usually,vary,visible,weak,ympodial	age,appearance,arrangement,border,bud,characteristic,clavate,colour,cordate,corolla,distal,drying,exertion,form,geminate,giving,glabrousnes,green,growth,height,history,inflorescence,interjected,length,life,lobing,midpoint,na,new,number,ovary,plant,prickle,primary,ray,seed,texture,thicknes,type,unarmed,variation,width
118	wfo-0001027186	success	168	116	93	75	23	0.554	.4,.5,1-1.5,1-2.5,1.4-1.6,1.5,1.5-2,15,2-6,2-lobed,2.5-3,5-10,6-7,9-10,?,abaxial,acute,anther,apex,attenuate,bark,base,berry,broadly,brown,calyx,clavate,cm,conical,corolla,dark,dendritic,diameter,ellipsoid,elliptic,entire,exerted,filament,filiform,fruit,fruiting,glabrescent,glabrous,globose,green,growth,immature,less,longer,margin,maturity,minutely,mm,much,narrowly,new,ovary,ovoid,pair,pale,pedicel,peduncle,petiole,pitted,pointed,poridical,primary,pubescent,reddish,reniform,seed,shiny,simple,slightly,soon,sparsely,spreading,stem,stigma,strongly,style,surface,terminal,tip,tree,treelet,tube,variably,vein,way,white,x,yellow	-6,0.5-1,1.5-2.5,1.6-5,3-4,3.5-4,30-40,4-15,4-9,abaxially,adaxially,age,always,anthesi,apart,apparently,axil,branch,branched,dbh,deflexed,deltate,denditic,densely,denser,dry,eaf,enlarging,flower,free,golden,incrassat,irregularly,keeled,lamina,lengthening,like,lobe,lobed,loose,lower,m.,midrib,nflorescence,occasionally,papillat,papillate,pendent,perfect,pericarp,planar,plane,plurifoliat,pore,portion,pubescen,rachi,rough,ruit,scar,scattered,short,slit,small,spaced,stalk,straight,time,trichome,tub,ud,uniseriate,unit,woody,ympodial	arrangement,bud,characteristic,colour,drying,exertion,form,glabrousnes,height,history,inflorescence,leaf,length,life,lobing,na,number,per,plant,shape,size,texture,type
119	wfo-0001027198	success	191	132	97	94	35	0.508	0.8-1,1-1.5,1-10,1.5-10,10-11,11-20,3/4,5-6,7.5-9,acuminate,acute,anther,apex,attenuate,axil,base,beneath,berry,calyx,channeled,clavate,cm,complex,corolla,cyathiform,decurrent,dendritic,dia,elliptic,entire,exserted,extremely,filament,flower,fruiting,furcate,glabrate,glabrous,globose,golden,green,inflorescence,large,lateral,leaf,lobed,long,main,many,margin,minute,minutely,mm,obovate,often,opposite,ovary,ovoid,ovoid-reniform,pale,paler,pedicel,petiole,pitted,plant,puberulent,pubescent,set,shaped,shining,short,shrub,simple,size,slender,slightly,soon,speciman,stem,stigma,straight,style,styled,surface,tannish-yellow,tear-drop,time,trichome,tube,two,type,vein,way,white,x,yellowish,young	.4,.5,0.05-1.0,0.5-0.75,0.5-1,0.7-1,1-5,1.5-2,2-5.5,4-9,5-120-flowered,abruptly,always,anthesi,apart,ba,beginning,broadening,bushy,caly,closely,constriction,corky,corresponding,deltoid,densely,differing,difoliate,dry,eaf,edge,edicel,eed,erect,evenly,eye,female,found,free,geminat,impressed,inflorescenc,invisible,like,live,lobe,lon,lower,major,male,medium,meet,middle,minor,naked,nearly,nflorescence,older,overlapping,papillo,papillose,pendan,planar,pore,poricidal,portion,pubescence,rather,reddi,reflexed,rest,rounded,ruit,scar,sessile,small,spaced,specimen,strong,tall,testae,thickened,thin,tip,top,tree,ud,undersurface,uniseriate,unit,usually,widest,woody,ympodial	0.4,2.5,3.5,5,alternate,arrangement,branch,bud,characteristic,colour,corrugation,dense,diameter,drying,exertion,form,fruit,glabrousnes,growth,height,history,length,life,lobing,na,new,number,peduncle,per,perennial,primary,reddish,seed,shape,texture
120	wfo-0001027200	success	139	110	87	52	23	0.626	0.05-0.25,0.25-0.5,0.5-0.75,0.6-1,0.7-2.5,1-1.4,1.2-1.5,1.5-5,1.6-6,2-3,3.5-6,6-8,8-15,acute,anther,apex,bark,base,beneath,berry,branch,broadly,brown,calyx,capitate,cm,conical,corolla,dark,decurrent,deeply,densely,dia,elliptic,except,filament,flattened,fruiting,giving,glabrous,globose,golden,green,grey-brown,horizontally,impressed,inflorescence,leaf,lobed,long,major,margin,minor,minute,mm,nearly,non-reproductive,onto,ovary,ovoid-reniform,pedicel,petiole,pitted,prominent,puberulent,shaped,shrub,size,slightly,small,sparsely,spreading,stem,stigma,style,surface,tear-drop,tree,trichome,tube,unicellular,unifoliate,uniseriate,vein,white,x,yellowish	0.5-1,1-1.5,1.5-2,2.5-3,3-3.5,9-11,across,anthesi,aspec,ba,branche,converging,deflexed,deltoid,differing,eaf,eed,free,geminate,lateral,lightly,like,lobe,lon,lower,main,middle,minutely,near,node,occasionally,older,papillo,papillose,planar,pore,poricidal,portion,reflexed,rest,ruit,sparse,straight,tall,tip,unit,widened,widest,winged,woody,ympodial,young	arrangement,aspect,bud,characteristic,colour,diameter,exertion,form,fruit,growth,height,history,length,life,lobing,na,peduncle,plant,primary,seed,shape,texture,type
121	wfo-0001027213	invalid_json	231	119	87	144	32	0.377	-19,-3.3,0-2.5,0.2-0.4,1-2,1-5,1.1-1.7,1.2-2.5,12.3-16.3,2-5,2.5-5.1,4-9.5,5-7.5,5.7-6.2,abaxially,acute,adaxially,anther,anthesi,apex,attenuate,base,blunt-tipped,branch,branched,broadly,brown,cm,conical,corolla,cuneate,dark,deltoid,diameter,early,elliptic,entire,exserted,filament,flower,fruit,glabrescent,globose,granular,grayish-brown,green,lanceolate,leaf,length,many,margin,mm,moderately,oblanceolate,obovate,orbicular,ovate,ovate-lanceolate,pale,pedicel,peduncle,petiole,pubescent,relatively,reniform,reticulate-punctate,scabrous,short-attenuate,shrub,simple,stem,stigma,style,surface,terete,time,tomentose,tree,unarmed,violet,white,whitish,whitish-green,x,yellow-green,yellow-tan,yellowish	-230,-4.5,/10,0-160,0.2-0.5,0.7-2.3,0.8-1.8,1.2-1.6,1.2-1.7,1.3-2.2,1.7-3.6,1.7-3.9,1.8-2.8,1.8-3.2,1/2-2/3,10-24,2.4-4.7,2.9-3.8,2.9-4.8,2/3,3.5-5,3.5-8,4.2-5.9,5-8,5-merou,8-24,8.2-10.5,9-13,accrescent,acuminate,ag,along,alyx,apart,apparently,ark,around,articulated,axe,axillary,ba,basal,blade,calyx,capitat,cell,completely,covering,cylindrical,decurrent,directed,distally,drying,eaf,edge,eed,enveloping,epidermal,eventually,farinose,few-rayed,free,fruiting,glabrescen,glabrous,group,hair,high,homostylous,immature,inserted,lackin,lateral,lengthening,lobe,lobed,long,long-,long-stalked,longitudinal,lower,m.,main,midrib,mixed,mostly,multangulat,multangulate,nearly,nflorescence,obscured,obtuse,often,older,orolla,partly,perfect,plurifoliate,pore,poricidal,porrect-stellat,porrect-stellate,prominent,pseudo-terminal,pubescence,rachi,rather,ruit,sessile,short,short-,short-stalked,side,slit,sometimes,somewhat,spaced,sparsely,stamen,stellate,subcampanulate,suture,tamen,thick,thick-stalked,thin-stalked,ti,tip,tomentose-pubescent,tomentu,touching,tube,ud,unarme,unit,unwinged,vary,vein,vestigial-rayed,way,wide,yellow,ympodial,young	'',[,],``,arrangement,bark,bud,capitate,characteristic,colour,exertion,form,glabrousnes,growth,height,history,inflorescence,life,lobing,new,ovary,perennial,plant,pseud-terminal,seed,shape,size,texture,type,value,{,}
122	wfo-0001027214	success	181	119	93	88	26	0.514	-9,.5,0,0.5-0.8,0.7-2,0.7-2.5,0.8-1,1-2.8,1.2-3,1.5,1.5-1.8,1.5-6,10-13,2,2-9,3-,4-5,6-12,7-12,absent,anther,anticlinal,basal,base,berry,cell,climbing,cm,conical,corolla,densely,diameter,elliptic,epidermal,erect,filament,finely,flattened-round,fruit,fruiting,glabrous,globose,green,greenish,height,herb,horizontal,inflorescence,irregular,lanceolate,lateral,leaflet,length,lobed,long-conical,minutely,mm,narrowly,nearly,nodding,obovate,occasionally,often,once-branched,opposite,ovary,paired,pedicel,per,perfectly,petiole,pinnate,pointed,poricidal,projection,pubescent,rachi,rugose,rugosity,seed,sharply,simple,sinuous,stigma,style,terminal,thickening,tip,tube,unevenly,white,without,x	-20,-38,..,.25,0-16,0.25,0.3-1.5,0.3-1.7,0.5-1,1-1.5,10-,12-17,15-25,3-6,5-6,6-,8-9,abaxially,acuminate,acute,adaxially,along,anthesi,apex,apical,broadly,calyx,capitat,composed,conspicuously,decurrent,deltate,dr.,drying,eaf,edicel,eed,exserted,extending,flower,free,groove,grown,inflorescenc,lamina,less,like,lobe,lon,long,long-acuminate,lower,margin,markedly,midrib,nflorescence,noddin,oblique,onto,open,pair,papilla,papillate,petiolule,portion,reflexed,rest,ruit,scar,scattered,scrambling,smaller,somewhat,surface,tem,time,triangular,trichome,truncate,tub,ud,unifoliat,uniseriate,unit,vein,white-lenticellate,whitish,ympodial	.0,2.0,abaxial,adaxial,arrangement,branching,bud,capitate,colour,form,glabrousnes,growth,history,leaf,lenticellate,life,lobing,number,pairing,plant,pubescence,shape,size,stem,texture,type
123	wfo-0001027219	success	143	127	100	43	27	0.699	.5,/4,0.3,0.4-0.6,0.5,0.5-0.8,1-15,1-3,1.5-2,2,2-3,2-3.5,2-4,3-5,6-8,7-8,absent,acuminate,acute,age,anther,anthesi,apex,axillary,bark,base,berry,bright,broadly,brown,c.,capitate,cm,completely,conical,corolla,densely,diameter,drying,edge,elliptic,entire,erect,filament,flower,fruiting,glabrescent,glabrous,globose,green,greyish,growth,hard,leaf-opposed,lengthening,less,long-conical,long-styled,margin,maturity,minutely,mm,new,ovary,pair,pale,pedicel,peduncle,petiole,pore,poricidal,primary,pubescent,purple,shoot,short,short-styled,shrub,simple,slightly,slit,soon,stem,stigma,stout,style,surface,terminal,thickened,tip,trichome,tube,uniseriate,vein,violet,way,white,x,yellowish,â1/3	1,1-2,1.5-2.5,2-2.5,3-6,berr,calyx,closely,cup-shaped,deltate,eaf,eed,exerte,exfoliatin,free,glabrou,heterostylous,known,lobe,lobed,lower,nflorescence,overlappin,papillo,papillose-pubescent,pendent,pericarp,planar,plurifoliat,pointed,portion,ruit,scar,sharply,sometimes,somewhat,spaced,tuft,ud,unit,weight,woody,ympodial	arrangement,bud,characteristic,colour,exerted,exertion,exfoliating,form,fruit,glabrousnes,height,history,inflorescence,leaf,length,life,lobing,na,number,papillose,per,plant,seed,shape,size,texture,type
124	wfo-0001027223	success	189	139	112	77	27	0.593	.5,0.19-0.75,0.3-1.2,1-2,1-3,1.3-2,1.5-3.5,1.8-3.5,16-41,3-10,3-11,3-5.2,3.5-4,3.5-6,3.5-7,3.7-9.3,4-6,5-21,5-8,5.9-12.2,9-15,9-22,abaxially,adaxially,anther,axillary,berry,blade,brownish,bud,cell,clavate,cm,condition,conical,connivent,corolla,covering,deep,densely,diameter,distal,dot,drying,end,filament,flower,forked,fresh,fruit,generally,glabrous,green,green-white,greenish,hair,hair-like,half,herb,homostylous,hyaline,interjected,lanceolate,lateral,leaf,leaflet,light,like,lobe,long,make,mm,mucilaginous,odd-pinnate,one,ovoid,pedicel,peduncle,pentagonal,petiole,placed,plant,poricidal,pubescent,purple,ripe,rotate,seed,size,sometimes,stigma,straight,stripe,style,subtending,terminal,testal,thick,throughout,tip,tube,tuber,typically,unwinged,usually,wall,wet,white,whitish,wide,x,yellow	2-4,2-7,3-5,5-10,5-merou,9-35,acumen,acuminate,adaxiall,ag,alyx,apart,apex,apparently,articulated,asymmetric,attenuate,axe,base,basiscopic,capitat,decreasing,digestion,dorsally,eaf,edge,eed,elliptic,enzyme,erec,exceeding,flat,folded,geminat,glabrou,hal,honeycomb-shaped,larger,lengthening,living,lower,middle,nflorescence,orbicular,orolla,ovate,pair,perfect,petiolulate,plurifoliate,pore,present,removed,rounded,ruit,sessile,seudostipule,short,shortly,side,slightly,slit,spaced,specimen,stamen,ste,stolo,subequal,tall,tamen,tem,tissue,toward,tri-,unit,vary,ympodial	5-merous,abaxial,adaxial,arrangement,calyx,capitate,characteristic,colour,erect,form,glabrousnes,growth,height,history,inflorescence,length,life,ovary,placement,pseudostipule,shape,staman,stem,stolon,surface,texture,type
125	wfo-0001027237	success	122	94	66	56	28	0.541	.5,/4,1-1.2,1.5-2,3-3.5,30-100-flowered,6-11,6-8,8,anther,bark,base,berry,black,branched,brown,calyx,clavate,cm,completely,corolla,cup-shaped,dark,deflexed,dia,drying,ellipsoid,exsertion,filament,flattened,fruiting,glabrous,globose,green,greenish-white,inflorescence,internodal,later,leaf,long,many,margin,minutely,mm,ovary,paler,pedicel,pitted,regularly,reniform,shaped,shining,shrub,slender,small,stem,stigma,style,surface,tapering,tear-drop,time,tree,tube,way,white	0.5-1,1.5-2.5,2-3,3-4,5,anthesi,apart,apiculae,apiculate,appearing,ba,blac,branc,broadly,cucullate,deltoid,difoliate,edicel,eed,erect,free,geminate,greyi,lobe,lobed,lower,nflorescence,occasionally,older,papillate,papillo,papillose,part,plurifoliat,pore,poricidal,portion,reflexed,regulary,ruit,scar,spaced,straight,tall,terminal,tip,ud,unit,upper,usually,widely,woody,x,x.,ympodial,young	apex,arrangement,bud,characteristic,colour,corrugation,diameter,exertion,form,fruit,greyish,growth,height,history,length,life,lobing,na,peduncle,petiole,plant,primary,seed,shape,size,texture,type,vein
126	wfo-0001027238	success	204	119	98	106	21	0.48	-25,.3,0-1,0-1.5,0.3-0.8,0.3-5,0.5-1,0.5-16,1-1.5,1-2,1.5-4,10,15-30,2-4,3-4,3-6,4-5,5-15,6-15,acuminate,acute,anther,apex,base,berry,black,branch,brown,chartaceous,cm,connivent,cuneate,dark,densely,diameter,elliptic,elliptic-ovate,entire,extra-axillary,filament,flattened,fleshy,flower,fruit,glabrous,globose,green,greenish,hair,lavender,leaf,light,lighter,long,margin,membranaceous,minutely,mm,multangulate,narrowly,oblique,oblong,obtuse,outline,pale,pedicel,peduncle,petiole,pitted,porrect-stellate,pubescent,purple,reniform,ripe,rounded,scandent,shiny,shrub,simple,small,sometimes,sparsely,sprawling,stellate-pubescent,stem,stigma,strongly,style,surface,tip,tree,triangular,unbranched,white,whitish,x,yellow,yellowish	-5,.5,0-0.7,0.3-0.5,0.3-1,0.5-2,1.5-3,1.5-7,2-3,3-5,4-,4-10,4-16,4-8,5-7,5-merou,6-8,abaxially,accrescent,adaxiall,adaxially,ag,alyx,apparently,articulated,axe,ba,blade,calyx,capitat,contiguous,covering,cylindrical,deltate,differentiated,directed,discolorous,distally,eaf,eed,equal,foliaceous,fork,free,frui,fruiting,geminate,glabrescent,gland,gland-tipped,growt,homostylous,interpetalar,introrsely,juic,large,like,lobe,longitudinal,lower,major,midpoint,minor,mixed,near,nearly,new,nflorescence,often,one,opening,orolla,paired,part,perfect,pericarp,plurifoliate,pore,rachi,ray,ruit,sessile,short-stalked,side,similar,slit,somewhat,sparse,ste,stellate,straight,subtending,tamen,tem,time,tissue,toward,tube,unarme,unequal,unit,vary,vein,wide,without,ympodial	abaxial,adaxial,arrangement,capitate,characteristic,colour,corolla,form,growth,height,inflorescence,length,lobing,ovary,plant,seed,shape,size,texture,type,unarmed
127	wfo-0001027244	success	294	156	124	170	32	0.422	-12,-2,-3.2,0.05,0.07-0.15,0.15-0.2,0.2-1,0.3-0.6,0.4-1,0.45-0.6,0.5,0.5-0.8,0.7-1.5,0.9-1.3,0.9-1.7,1,1.1-1.3,1.2-1.6,1.5-2.1,1.5-2.4,1.5-6.5,1.7-3.0,1/2,2.1-8,3.5-13,3/4,4-12,5-10,acute,anther,anthesi,apex,appearance,articulated,base,berry,bifurcate,branched,broadly,brown,calyx,capitate,cell,cm,conical,cordate,corolla,crenate,curved,dark,decurrent,densely,dentate,diameter,distal,elliptic,exserted,filament,fruit,fruiting,giving,globose,green,greenish,hair-like,half,halfway,herb,imparipinnate,inflorescence,interjected,interrupted,irregularly,lateral,leaflet,length,lobe,lobed,lobing,long,margin,middle,minute,mm,oblique,obovate,often,orbicular,outgrowth,ovary,pedicel,peduncle,perennial,petiole,primary,pseudostipule,pubescent,purple,rotate-stellate,rounded,shaggy,silky,simple,size,somewhat,stem,stigma,stripe,strongly,style,surface,terminal,testa,thick,truncate,tube,vein,velvety,vivid,wall,white,wide,woody,yellow	-1.2,.5,0-,0.02-,0.04-,0.05-1,0.1-,0.1-0.3,0.1-0.5,0.1-0.6,0.2,0.2-,0.25-0.4,0.3,0.3-0.4,0.3-0.5,0.3-0.8,0.4-,0.4-0.6,0.5-1,0.6-0.9,0.6-09,0.7-1,0.7-2,0.7-3,0.8-1.2,1-2-celled,1-2.5,1-3.5,1-celled,1.5-2,2-,2-4,2-4-celled,2-9,2-foliate,2-locular,3-5,4-celled,5-,5-9-celled,7-12,8-16,8-celled,abaxially,absent,abundance,abundant,acroscopically,acuminate,adaxially,adpressed,alfway,along,also,always,amongst,angled,apical,apparently,appendage,arequipa,around,articulatio,articulation,axi,basal,berr,bract,bracteate,c.,cage,column,common,deciduous,decumbent,deeper,deltate,dense,density,developed,diamete,eaf,edicel,eed,eglandular,either,elliptical,erect,extremely,flower,flushed,forming,general,glabrescent,glabrous,gland,glandular,gree,head,hyaline,internode,investing,lamina,lanceolate,larger,largest,leave,like,lon,longer,lower,midvein,mixed,mixture,multicellular,narrowly,near,node,occasionally,onto,pair,papillate-pubescent,patent,petiolule,population,present,rachi,reflexed,rest,ripe,ruit,scattered,secondary,sessile,short,shorter,sinus,slender,small,sometimes,sparse,sparsely,sparser,spreading,staminal,sterile,stout,straight,tall,tem,tertiary,tiny,tip,tipped,toward,trichome,two,ud,undulate,unicellular,uniseriate,unit,united,upper,usually,variable,variety,winged,ympodial	arrangement,bark,border,branch,bud,characteristic,colour,corrugation,drying,exertion,form,glabrousnes,growth,height,history,leaf,life,midpoint,na,new,number,per,plant,prickle,ray,seed,shape,texture,thicknes,type,variation,width
128	wfo-0001027248	success	158	136	107	51	29	0.677	.5,0,0.5-1,0.5-2.5,0.7-1.2,1-1.5,1-2,1-5,2-2.5,3-7,3-7-flowered,3.5-4,5-5.5,6-13,6.5-8,7-9,abaxially,acute,adaxially,anther,apex,appearing,arachnoid,arachnoid-pubescent,area,bark,base,beige,beneath,berry,broadened,broadly,brown,brownish,calyx,cm,conical,corolla,dark,deflexed,densely,dia,difoliate,dirty,ellipsoid,elliptic,erect,exserted,felty,filament,fruit,fruiting,geminate,glabrescent,glabrous,globose,grayish-green,green,later,lateral,leaf,lightly,lobed,long,main,margin,merely,minutely,mm,nearly,node,occasionally,ovary,ovoid-reniform,pair,pale,patch,pedicel,per,petiole,pitted,pubescence,pubescent,scattered,shaped,shrub,simple,size,small,somewhat,soon,sparsely,stem,stigma,strongly,style,surface,tear-drop,top,tree,trichome,tube,unifoliate,vein,white,wide,winged	1-3,2-4.5,3-4,4-8,abaxial,along,anthesi,ape,arachnoid-pubescen,brownish-gra,closely,deltate,denser,differing,eaf,edicel,eed,fleshy,free,impressed,lamina,lobe,lower,major,minor,nflorescence,older,opposite,overlappin,papillo,papillose,planar,pore,poricidal,portion,present,ruit,scar,shoot,spaced,specimen,tall,thick,tip,tub,ud,unit,wid,woody,ympodial,young	arrangement,branch,brownish-gray,bud,characteristic,colour,corrugation,diameter,drying,exertion,form,glabrousnes,growth,height,history,inflorescence,length,life,lobing,na,new,number,peduncle,plant,primary,seed,shape,texture,type
129	wfo-0001027258	success	178	135	107	71	28	0.601	/4,0.5-1,0.6-2,0.9-1.3,1-1.5,1-2.3,1.2-2,1.5-1.6,2-2.5,3-6,3.5-4,4-5,4.5-5,5-10-flowered,6-8,7-13,7-9,abaxially,abruptly,acuminate,acute,adaxially,age,along,anther,apex,attenuate,bark,base,berry,broadly,calyx,capitate,cm,corolla,decurrent,densely,dia,drying,ellipsoid,elliptic,entire,exserted,filament,flattened-reniform,fruit,fruiting,glabrous,globose,green,greenish-yellow,large,lateral,leaf,length,lengthening,lenticel,lobed,long,main,margin,minutely,mm,onto,ovary,ovate,pair,pale,papillose,pedicel,petiole,pitted,pore,poricidal,pubescent,reddish,scattered,shrub,simple,size,slender,slightly,slit,small,sparsely,stem,stigma,straight,strongly,style,surface,swollen,tip,treelet,trichome,tube,tuft,uniseriate,urceolate,vein,way,white,widening,winged,x,yellowish,yellowish-tan	.25,.5,0.25-0.5,1-4,2.5-8,3-4,anthesi,apar,apical,apiculae,axil,ba,beneath,crystal,darker,deflexed,deltate,dense,deposit,differing,difoliate,dissecting,eaf,edicel,eed,enlarge,evenly,extending,fide,fragrant,free,geminat,glabrou,incrassate,internodal,lamina,lobe,lower,major,microscope,middle,minor,minute,nee,nflorescence,occasionally,often,older,opposite,papillo,planar,portion,projection,prominent,red-papillose,ruit,sand,scar,spaced,speck,sweetly,tall,tiny,tub,ud,unit,visible,widest,woody,ympodial,young	alternate,arrangement,branch,bud,characteristic,colour,corrugation,diameter,exertion,form,glabrousnes,growth,height,history,inflorescence,life,lobing,na,new,number,peduncle,per,plant,primary,seed,shape,texture,type
130	wfo-0001027260	success	176	146	92	84	54	0.523	-60,0.25-1,0.5-3,0.5-6.5,0.8-2,1-,1-2,1-3,1-4,1.5-13,2-18,2-2.5,2.5-14,2.5-3.5,3-4.5,3-6,3.5-25,4-25,4-32,5-40,abaxially,acuminate,acute-,adaxially,age,also,apex,basal,base,berry,beyond,branched,clavate,cm,cordate,cylindrical,darker,densely,diameter,eglandular,ellipsoidal,elliptic,elliptic-ovate,entire,exserted,fading,flattened,flower,fruit,glabrous,globose,greenish,hair,lanceolate,lavender,lobe,long,longitudinal,margin,mm,moderately,obtuse,often,ovate,pedicel,peduncle,petiole,pilose,pink,puberulent,puberulent-pubescent,pubescent,pubescent-pilose,purple,shrub,simple,small,sparsely,stamen,stigma,stripe,style,tree,truncate,tube,unbranched,usually,vein,white,x,yellow-green,yellowish	-17,-2,-7,0.5-1,0.75-1,1-6,1-7,1.5-2,10-25,15-30,2-,2-10,3-,3-10,3-11,4-5-foliat,4-6,4.5-14,5-,5-25,5-merous,6-20,absent,acute,aggregate,alyx,apart,ape,articulated,axe,blade,cell,chartaceous,connective,connivent,diamete,directed,distally,eaf,eed,equal,exceeding,glabrate,leaving,lon,lower,membranaceous,narrowly,nearly,nflorescence,nther,orolla,pedicellar,perfec,perfect,pilo,pore,presen,puberulent-pubescen,rachi,radiu,remnant,ruit,shorter,slightly,spaced,stellate,stone,strongly,subcoriaceous,tal,tapered,tem,thecae,time,tomento,triangular,ud,unit,vary,wide,yellow,yellow-orang,ympodial	5-10-25,anther,appearance,arrangement,bark,border,branch,bud,calyx,characteristic,colour,corolla,corrugation,distal,drying,exertion,filament,form,fruiting,giving,glabrousnes,growth,height,history,inflorescence,interjected,lateral,leaf,leaflet,length,life,lobing,midpoint,na,new,number,ovary,per,plant,prickle,primary,pseudostipule,ray,seed,shape,size,stem,surface,terminal,texture,thicknes,type,variation,width
131	wfo-0001027265	success	159	116	85	74	31	0.535	.2,0.1â2,0.2-0.4,0.5,0.5-1,0.5â0.6,1-3,1.2-1.3,1.2-2,1.2â1.4,1.5â1.8,1.5â2,2,2-3,2-4,2/3,2â2.5,2â3,4-5,4â6,4â7-branched,acute,anther,apart,apex,articulated,base,berry,broad,calyx,chartaceous,cm,diameter,entire,extra-axillary,filament,flattened-reniform,flower,fruit,glabrous,globose,herb,hermaphroditic,leaf-opposed,light,lobe,long,long-attenuate,lower,margin,minutely,mm,nearly,numerous,oblong,obtuse,orange,ovate-lanceolate,partially,pedicel,peduncle,petiole,pitted,pore,puberulent,pubescent,purple,rachi,recurved,red,ripe,rotate-stellate,seed,simple,sparsely,stigma,style,subcoriaceous,surface,tip,triangular,tube,white,x,yellow	-2.5,.3,.5,1-1.3,1-2.5,1.5-2.5,1.5â4,2-,20-30,3-,3-lobed,30â50,4.5â8,5-merou,58409,abaxially,accrescent,adaxiall,adaxially,alyx,apparently,axe,ba,blade,capitat,ciliate,connivent,covering,croat,cylindrical,dehiscent,eaf,eed,erect,foliate,frui,fruiting,geminat,granule,hair,juic,larger,lon,longitudinall,low,mesocarp,near,nflorescence,node,orolla,paired,present,prominent,rarely,rooting,ruit,scarcely,sclerotic,slightly,sometimes,somewhat,spaced,tall,tamen,tem,time,unit,usually,vary,weak,white-puberulent,wide,winged,ympodial	30-50,abaxial,adaxial,arrangement,articulation,capitate,characteristic,colour,corolla,dehiscence,form,glabrousnes,growth,height,history,inflorescence,leaf,length,life,longitudinally,new,number,ovary,per,plant,shape,size,spacing,stem,texture,type
132	wfo-0001027265	success	156	112	83	73	29	0.532	.2,0.1â2,0.2-0.4,0.5,0.5-1,1-3,1.2-2,1.2â1.4,1.5â1.8,1.5â2,2,2-3,2/3,20-30,2â2.5,2â3,4-5,4â6,4â7-branched,acute,anther,apart,apex,articulated,base,broad,chartaceous,cm,diameter,entire,extra-axillary,filament,flattened-reniform,flower,fruit,glabrous,globose,granule,herb,hermaphroditic,larger,leaf-opposed,light,long,long-attenuate,lower,margin,minutely,mm,near,nearly,oblong,orange,ovate-lanceolate,paired,partially,pedicel,peduncle,petiole,pitted,pore,prominent,puberulent,pubescent,purple,rachi,recurved,red,ripe,rotate-stellate,sclerotic,seed,simple,sometimes,sparsely,stigma,style,subcoriaceous,surface,tip,white,x,yellow	-2.5,.3,.5,0.5â0.6,1-1.3,1-2.5,1.2-1.3,1.5-2.5,1.5â4,2-,2-4,3-,3-lobed,30â50,4.5â8,5-merou,58409,abaxially,accrescent,adaxiall,adaxially,alyx,apparently,axe,ba,blade,calyx,capitat,ciliate,connivent,covering,croat,cylindrical,dehiscent,eaf,eed,erect,foliate,frui,fruiting,geminat,hair,juic,lobe,lon,longitudinall,low,mesocarp,nflorescence,node,numerous,obtuse,orolla,rarely,rooting,ruit,scarcely,slightly,somewhat,spaced,tall,tamen,tem,time,triangular,tube,unit,vary,weak,white-puberulent,wide,winged,ympodial	30-50,abaxial,adaxial,arrangement,articulation,capitate,characteristic,colour,corolla,dehiscence,form,glabrousnes,growth,height,history,inflorescence,leaf,length,life,longitudinally,new,ovary,plant,shape,size,spacing,stem,texture,type
133	wfo-0001027284	success	172	118	95	77	23	0.552	.3,0.1â0.5,0.1â2,0.7â0.9,0.7â1,1.2â1.5,1.5â2,1â1.5,2â16,3â4,4,4â12,4â6,5-merous,5â8,9â18,abaxially,acuminate,acute,adaxially,anther,anthesi,apex,axillary,base,berry,branched,brownish,calyx,cm,cordate,deltoid,densely,diameter,elliptic,entire,extra-axillary,filament,fine,flattened-reniform,fleshy,flower,fruit,glabrous,globose,green,herbaceous,inflorescence,margin,maturity,midvein,minutely,mm,nearly,oblique,orangish,ovate,ovoid,pale,pedicel,peduncle,petiole,pink,planar,pubescence,pubescent,rachi,rarely,reticulate-rugulose,rounded,sand-punctate,scandent,scar,shortly,shrub,simple,size,sometimes,somewhat,soon,sparsely,stem-terminal,stigma,style,surface,tan,thickly,tip,truncate,unbranched,vine,weakly,white,woody,x	0.2â,1.5â2.5,1.5â5.5,1.5â8,1.8â2,1â2,1â3,2.5â3,2.5â3.5,2â2.2,3.5â14,5â7,accrescent,alyx,axe,blade,branch,c.,capitat,ciliat,climbing,conspicuous,contiguousl,cylindrical,deflected,distally,eaf,eed,enlarged,flattened,fruiting,glabrescen,glabrou,gradually,immature,leafy,lobe,long,lower,m.,near,nflorescence,nternode,one,orolla,pair,pendulou,perfec,pinnate,plurifoliate,pointed,prominent,reduced,ruit,sand-punctat,secondary,seen,side,slightly,spaced,spreading,stellate,tamen,tem,thickened,time,toward,tree,tube,understory,unifoliat,unit,vary,vein,venation,wide,ympodial	0.2â1.5,arrangement,capitate,characteristic,colour,corolla,form,glabrescent,growth,height,history,leaf,length,life,lobing,ovary,perfect,plant,seed,shape,stem,texture,type
134	wfo-0001027302	invalid_json	188	162	130	58	32	0.691	.5,0.5,0.5-1,0.6-1,0.8-1,1,1-1.3,1-1.5,1-2,1-3,1.2-1.6,1.2-2.5,1.5-2,10,10-20,2-3,2-6,2.2,2.7-7.5,3.5-5,3/4,5-7,7,7/8,abaxial,acuminate,acute,adaxial,age,along,anther,apex,apical,appearing,bark,basal,base,becoming,berry,branching,bright,brownish-yellow,calyx,capitate,clavate,cm,cordate,corolla,crispate,dendritic,densely,denser,diameter,elliptic,entire,especially,exserted,filament,fine,flat-topped,flattened,flower,free,fruiting,glabrous,globose,growth,later,lateral,leaf,length,lenticular,less,like,long,main,margin,minutely,mm,monochasial,narrowly,occasionally,otherwise,ovary,ovate,overtopping,pale,per,petiole,plant,plurifoliate,pore,poridical,portion,prominent,puberulent,pubescent,pyramidal,red,scar,shoot,shrub,simple,slit-like,small,somewhat,sparsely,stem,stigma,strongly,style,surface,tapering,terminal,time,tiny,tip,tree,trichome,truncate,tube,undulate,usually,vein,violet,way,wide,winged,x,young	0.4-5,2,6-12,abaxially,adaxially,anthesi,ba,blade,broader,conical,cultivation,decurrent,deflexed,deltoid,dichasia,discussion,eaf,edicel,eed,ew,growing,inserted,juvenile,larger,lax,lobe,lobed,lon,long-triangular,lower,m.,nflorescence,nodding,older,pair,papillo,pedicle,pericarp,pitted,planar,reddish-brown,reflexed,ruit,scattered,scrambling,secondary,see,shade,shin,sleeve,stamen,tall,thin,tub,ud,unit,woody,ympodial	'',[,],``,arrangement,bud,characteristic,colour,dichasial,exertion,form,fruit,glabrousnes,history,inflorescence,life,lobing,new,number,papillose,pedicel,perennial,seed,shape,shiny,size,staman,texture,type,value,{,}
135	wfo-0001027310	success	215	119	96	119	23	0.447	.8,/3,0.6-1,0.7-2,1-1.2,1-1.7,1-6,1.1-1.5,1.5-2.2,2-3.1,2.2-2.5,2.8-3,20-60,4.5-7,5-10,5-7,abaxially,acute,anther,apex,apparently,articulated,bark,base,berry,calyx,chartaceous,cm,connivent,cuneate,dark,deltate,densely,diameter,entire,erect,evenly,filament,flattened-reniform,fruit,fruiting,glabrous,gray,green,green-brown,hair,lanceolate,lateral,leaf,length,lobed,long,margin,maturity,mauve,minutely,mm,moderately,orange-brown,pale,pedicel,peduncle,petiole,pitted,plant,poricidal,porrect-lepidote,prickly,purple,reflexed,rounded,sessile,shallowly,shrub,simple,sometimes,sparse,spherical,spreading,stellate-pubescent,stem,style,surface,tapering,terminal,tip,toward,tree,trichome,truncate,tube,unarmed,way,wide,yellow,young	-2.2,-20,0,0-20,0-5,0.05,0.05-0.15,0.1,0.1-0.2,0.15-0.3,0.9-0.17,1.5-5,1/10-1/6,1/3-1/2,1/3-3/4,11-16,2-10,2-4,2-5,2/3,22-30,3-15,4-10,4-9,4.5-5.5,5-20,5-merous,6-8,7-10,8-10,9-13,abaxial,acut,adaxial,alyx,andromonoecious,apar,apart,apically,blade,branched,branching,broadly,curved,discolorous,distal,drying,eaf,eed,elongating,equal,faint,flattened,flower,foliaceous,free,fused,gently,glabrescent,glabrou,glaucous,hermaphrodite,heterostylous,inflated,infructescence,less,lobe,long-styled,longer,lower,lowermost,mature,midpoint,nflorescence,older,one,open,orolla,oung,pair,pendulous,per,pericarp,plurifoliat,porrect,portion,prickle,primary,pubescent,ray,red,reddi,ruit,scar,secondary,short-styled,shorter,smooth,spaced,sparsely,stalk,stalked,staminat,stellate,stout,straight,strongly,tamen,terete,tertiary,time,unarme,unit,vary,vein,venation,visible,woody,ympodial	arrangement,branch,characteristic,colour,corolla,exertion,form,glabrousnes,growth,height,inflorescence,lobing,na,new,ovary,plurifoliate,reddish,seed,shape,size,stigma,texture,type
136	wfo-0001027317	success	144	94	75	69	19	0.521	.5,0.1-0.2,0.3-1,0.4-1.5,0.5-3,1,1-1.5,1-2,1-5,1.5-2,2-3-flowered,4.5-5,?,acuminate,acute,adaxially,along,anther,apex,apically,bark,base,beneath,berry,bilobed,calyx,cm,corolla,deciduous,densely,dia,difoliate,drying,ellipsoid,elliptic,erect,fruit,fruiting,glabrous,globose,golden,green,leaf,like,lobed,long,long-exserted,minor,mm,nearly,offset,opposite,ovary,pale,pedicel,petiole,pointed,pubescent,shaped,shrub,simple,size,slightly,soon,stem,stigma,style,surface,tear-drop,trichome,tube,uniseriate,vein,white,x	.25,0.5-1,0.8-3.5,1.4-1.6,2-9,3-3.5,7-9,abaxial,anthesi,apical,arch,ba,broadly,closely,conical,cucullate,deflexed,deltoid,differing,eaf,edicel,eed,elongated,expanded,filament,filiform,free,geminat,greyish-whit,immature,inflorescenc,joined,known,lateral,lobe,lon,lower,main,major,margin,mature,minute,minutely,nflorescence,older,overlappin,pair,papillo,papillose,pore,poricidal,portion,projection,prominent,reflexed,rest,ruit,scar,series,spaced,sparsely,strongly,tall,tip,tub,ud,woody,ympodia,young	arrangement,bud,characteristic,colour,diameter,exertion,form,geminate,greyish-white,growth,height,inflorescence,length,lobing,plant,shape,sympodia,texture,type
137	wfo-0001027323	success	175	108	89	86	19	0.509	.75,/3,0.5-1,1-1.5,1.2-1.5,14-21,2-3,2-6,2.5-3,20-45,5-20-flowered,5-7,adaxial,along,anther,appearing,area,asymmetric,bark,base,berry,broadened,bud,calyx,campanulate,closed,cm,corolla,decurrent,densely,dia,difoliate,elliptic,elongate,filament,fleshy,flopping,flower,fruit,fruiting,furcate,glabrate,glabrous,globose,grey,held,higher,hooded,immature,leaf,lobed,long,minutely,mm,occasionally,older,opposite,ovary,ovoid,ovoid-reniform,papillose,partially,pedicel,petiole,pinkish-grey,pitted,plant,red-papillose,reddish-grey,rest,size,slightly,small,stem,stigma,style,surface,tan,tip,treelet,tube,two,unit,vein,way,white,winged,x,young	1-2,10-15,3-5,6-11,7-9,acute,anthesi,apex,apparent,arising,attenuate,ba,character,closely,cork,deflexed,differing,dried,dry,eaf,edicel,eed,entire,erect,erose,exserted,five-pointed,free,geminat,growing,hood,interpetalar,lateral,like,live,lobe,lon,long-triangular-deltoid,lower,main,major,margin,matte,mature,measured,middle,minor,nflorescence,one,onto,overlapping,pair,papillae,papillo,persistent,planar,pore,poricidal,portion,prominent,proximal,rather,ridge,ruit,scar,secondary,seen,shaped,sinus,smoot,soon,spaced,specimen,straight,tall,tear-drop,thickened,thin,tiny,trunk,ud,upper,visible,widest,woody,ympodial	arrangement,characteristic,colour,diameter,form,geminate,growth,height,history,inflorescence,length,life,lobing,seed,shape,smooth,sympodial,texture,type
138	wfo-0001027340	success	189	124	103	86	21	0.545	0.5-0.9,1-2,1.5-2.7,10-16,16-22,2-3,2-4,2.5-4.5,2.7-4.5,3.5-5,3.5-9,4-6,4-7.5,5-11,5-6,6-8.5,7-18,7-8,8-14,8-9.5,abaxially,absent,adaxially,anther,auriculate,axillary,berry,blade,brownish,bud,cell,chartaceous,cm,condition,corolla,covering,dark,diameter,distal,drying,elliptic,filament,flower,forked,fresh,fruit,generally,glabrous,globose,green,green-white,greenish,hair,hair-like,half,herb,homostylous,interjected,lateral,leaflet,like,lilac-purple,lobe,long,make,membranous,minute,mm,mucilaginous,narrow,odd-pinnate,ovate,ovoid,pedicel,peduncle,petiole,petiolulate,plant,pubescent,purple,ripe,seed,sessile,short,size,sparsely,splotched,stem,stigma,style,subtending,terminal,testal,thick,throughout,tinged,tube,usually,wall,wet,whitish,wing,x	1-10,1-3,2-3.5,3-4,5-merou,abruptly,acumen,acuminate,ag,along,alyx,apart,apex,apparently,articulated,articulation,axe,base,capitat,ciliate,connivent,cordate,decreasing,developing,digestion,distinct,dorsally,eaf,edge,eed,enzyme,especially,exceeding,flat,folded,geminat,glabrou,hal,high,honeycomb-shaped,indistinct,lanceolate,lengthening,living,lower,margin,midrib,minutely,narrowed,nflorescence,orolla,pair,papillose,perfect,plurifoliate,pointed,pore,poricidal,puberulent,purpl,removed,rotate,rounded,ruit,semi-erec,semi-rosette,seudostipule,shortly,slightly,slit,spaced,specimen,stamen,ste,straight,tall,tamen,tem,tip,tri-,truncate,unit,vary,yellow,ympodial,young	5-merous,arrangement,calyx,capitate,characteristic,colour,form,growth,height,history,inflorescence,leaf,length,life,ovary,pseudostipule,shape,staman,surface,texture,type
139	wfo-0001027354	success	166	137	114	52	23	0.687	0,0.5,0.5-2,0.7-1.3,1,1-1.2,1-1.5,1-7,1.5-1.8,1.7-5,10,10-20,2.5-3.5,3-4,3.4-4,3/4,4-10,5-7,6.5-13,8-12,absent,acute,age,along,anther,apex,apical,appearing,basal,base,becoming,berry,bi-lobed,branch,branching,calyx,cm,conical,corolla,covered,dark,dendritic,densely,diameter,drying,elliptic,entire,exserted,filament,flattened,flower,fork,fruit,fruiting,glabrate,glabrous,globose,golden,growth,later,lateral,leaf,length,lenticular,like,long,loose,loosely,minutely,mm,mostly,narrowly,near,occasionally,ovary,pair,pedicel,per,petiole,pitted,plurifoliate,pore,poricidal,pubescent,purplish-black,pyramidal,reddish-brown,secondary,shrub,slightly,slit-like,small,sparsely,stem,stigma,strongly,style,surface,tapering,terminal,time,tip,tree,tree-like,trichome,tube,type,vein,violet,way,white,wide,x,young	.5,1.5-2,abaxial,abaxially,adaxial,anthesi,ba,bark,belo,blade,deltoid,denser,dichasia,eaf,edicel,eed,erect,ew,free,inserted,less,lobe,lobed,lower,m.,monochasial,nflorescence,nodding,older,papillo,pericarp,planar,portion,pubescen,raised,ruit,scar,side,simple,sleeve,somewhat,stamen,tall,thecalyx,thin,tiny,tub,ud,unit,winged,woody,ympodial	arrangement,bud,characteristic,colour,exertion,form,glabrousnes,height,history,inflorescence,life,lobing,margin,na,new,number,papillose,peduncle,plant,seed,shape,size,texture
140	wfo-0001027359	success	224	127	99	125	28	0.442	-2,.5,/3,0-9,0.3-0.5,0.3-1.2,0.5-2,0.6-1,1-1.2,1.2-1.5,1.2-2,1.8-3.2,2.5-3.5,6-8,acute,anther,apex,apparently,bark,base,berry,bright,calyx,cell,chartaceous,cm,cream,cuneate,dark,densely,diameter,dull,entire,filament,filiform,flattened-reniform,fruit,fruiting,glabrous,gray,green,lateral,leaf,length,lobed,long,margin,marking,maturity,membranous,minutely,mm,moderately,near,obtuse,occasional,orange-brown,outline,ovate,ovoid,pale,pedicel,peduncle,petiole,pit,poricidal,prickly,purple,raised,red,reflexed,reticulate,shallowly,shrub,simple,small,smooth,sometimes,sparsely,spherical,spreading,stellate,stellate-pubescent,stem,style,surface,tapering,terminal,tip,trichome,tube,unarmed,undulate,way,white,wide,yellow,yellow-brown,young	-0.25,-20,-3,-4,-7,-9,.1,.2,/4,0,0-2,0-3,0-5,0.1,0.1-0.2,0.1-1.5,0.5,0.5-1,0.6-0.8,1-2,1-3,1-4,1-5,1.5-2,1.5-2.5,1/5-1/4,2-10,2-3,2-4,2.5-5.5,3-10,4-,4-5,5-,5-6.5,5-merous,7-8,abaxially,acut,alyx,apar,apart,apically,articulated,ba,blade,branched,brow,concolorous,coroll,curved,deltate,difoliate,distinctive,drying,eaf,eed,elongate,elongating,equal,erect,eye,flattened,flower,free,geminat,glabrescent,herbaceous,infructescence,less,like,lobe,longer,lower,mature,midpoint,naked,narrow-deltate,narrow-ovate,nflorescence,often,older,one,open,orolla,oung,pair,per,perfec,pericarp,porrect,portion,prickle,primary,rachi,rarely,ray,ruit,scandent,scar,sessile,shorter,slender,slightly,spaced,stalk,stalked,stump,tamen,terete,tertiary,time,tinge,ud,unarme,unit,usually,variously,vary,vein,venation,visible,weakly,woody,ympodial	alternate,arrangement,branch,brown,bud,characteristic,colour,corolla,exertion,form,glabrousnes,growth,height,history,inflorescence,life,lobing,na,new,ovary,perennial,plant,seed,shape,size,stigma,texture,type
141	wfo-0001027366	success	136	95	68	68	27	0.5	/4,0.7-1,1-1.5,1-2,1-3,1.5-2,11-21,2-2.5,3-10-flowered,3-9,4-4.5,4-5,5-7,6-19,acute,anther,apex,bark,base,berry,bright,broadly,brown,calyx,capitate,cm,conical,corolla,dark,dia,drying,elliptic,fruiting,glabrous,globose,golden,green,greenish-white,lateral,leaf,long,main,minutely,mm,orbicular,ovary,ovoid,ovoid-reniform,pair,pale,pedicel,petiole,pitted,pointed,rounded,shaped,shrub,simple,somewhat,stem,stigma,style,surface,tear-drop,tip,vein,way,wide	.5,/2,0.25-0.5,0.5-1,603,abaxially,adaxially,anthesi,ape,axe,ba,closely,conspicuously,deflexed,deltate,eaf,edicel,eed,erect,et,except,exserted,fide,filament,free,internodal,lamina,less,lobe,lobed,lon,long-triangular,lower,margin,middle,nflorescence,older,opposite,overlappin,packed,papillo,papillose,parallel,planar,pore,poridical,portion,ramo,reddish,ruit,scar,secondary,shining,sometimes,straight,tall,trichome,tub,tube,ud,unifoliat,unit,venation,widest,woody,yellowish-gre,ympodial,young	0.5,abaxial,adaxial,arrangement,bud,characteristic,colour,diameter,form,fruit,growth,height,history,inflorescence,length,life,lobing,na,peduncle,plant,seed,shape,size,texture,type,unifoliate,yellowish-grey
142	wfo-0001027368	success	145	131	79	66	52	0.545	-20,-5,.5,0.3-2.5,0.5-3.5,0.5-5,0.8-2,1-15-flower,1-2,1.5-2,1.5-2.5,2,2-2.5,3-12.5,5-15,5-6,abruptly,acuminate,acute,apex,base,calyx,chartaceous,cm,cuneate,darker,decurrent,deltate,densely,diameter,distally,ellipsiodal,elliptic,elliptic-ovate,entire,forked,glabrous,globose,lanceolate,lenticular,lighter,lobe,margin,mm,moderately,narrowed,narrowly,nearly,oblong,obtuse,occasionally,often,otherwise,ovoid-fusiform,pedicel,peduncle,petiole,puberulent,pubescent,purple,ray,shrub,simple,small,sparsely,star,stigma,style,subcoriaceous,subhastate,terminal,triangular,truncate,tube,unbranched,unknown,vein,white,x	-10,-15,-2,1-6,2-3,2-4,2-9,3,4-6,4-many-foliat,5-10,8-13,abaxially,absen,adaxiall,adaxially,aggregate,also,apart,articulated,axe,ba,blade,branched,cell,color,connivent,contiguous,cylindrical,dendritically,denser,directed,eaf,eed,except,gland,hair,long,long-stalked,lower,midvein,nflorescence,nther,orolla,pore,pubescen,rachi,radiu,ruit,sometimes,spaced,stalked,stellate,stone,subcapitat,tal,tem,three,time,tip,unit,usually,vary,wide,yellow,ympodial	anther,appearance,arrangement,bark,border,branch,bud,characteristic,colour,corolla,corrugation,distal,drying,exertion,filament,form,fruit,fruiting,giving,glabrousnes,growth,height,history,inflorescence,interjected,lateral,leaf,leaflet,length,life,lobing,midpoint,na,new,number,ovary,per,plant,prickle,primary,pseudostipule,seed,shape,size,stem,subcapitate,surface,texture,thicknes,type,variation,width
143	wfo-0001027369	success	191	96	70	121	26	0.366	.4,.5,.7,/4,0-1,0.5-0.8,0.6-0.8,1-2.5,1.2-2.5,1.2-3,1.5-2,2-3,anther,apex,apically,apparently,articulated,bark,base,berry,calyx,cm,cordate,densely,diameter,erect,eye,filament,fruit,fruiting,glabrous,glaucous,green,known,lanceolate,lateral,leaf,length,lobed,long,margin,mauve,membranous,mm,moderately,naked,orbicular,pedicel,peduncle,per,petiole,poricidal,prickly,reniform,rounded,shrub,simple,sparsely,spherical,spreading,stellate-pubescent,stem,style,surface,tapering,terminal,tip,visible,way,wide	-1,-10,-11,-2,.1,0,0-15,0-3,0-5,0-6,0.05-0.15,0.1,0.1-0.2,0.1-0.3,0.2-0.5,0.25-0.4,0.3-1.5,0.5,0.5-1.5,1-,1-2,1-3,1-4,1/3,2-4,2-5,3,3-10,3-4,4-5,4-8,5,5-merous,7-15,abaxially,acut,almost,alyx,ame,apar,apart,blade,branched,broad-deltate,c.,color,concolorous,curved,deltate,difoliate,distance,drying,eaf,eed,elongating,equal,extending,filiform,flower,free,geminat,glabrou,gra,hair,herbaceous,infructescence,know,less,lobe,lon,lower,mature,midpoint,midvein,multangulate,narrowly,nflorescence,older,one,open,orolla,oung,pale,pendulous,perfec,pericarp,perpendicular,porrect,portion,prickl,prickle,ray,reflexed,ruit,scandent,scar,sessile,side,slender,slightly,smooth,spaced,stalk,stalked,stellate,straight,strongly,tamen,terete,time,trichome,tube,unarmed,unequal,unit,vary,venation,wider,winged,yellow,ympodial	acute,arrangement,branch,characteristic,colour,corolla,exertion,form,glabrousnes,gray,growth,height,inflorescence,lobing,na,new,number,ovary,plant,primary,seed,shape,size,texture,type,vein
144	wfo-0001027378	success	149	144	96	53	48	0.644	.2,0.5â1,0.7â1,1.2â1.8,1.5â1.8,1.5â8,15â35,2.3â5,2.5â7,2â11,2â2.2,2â2.5,3â5,3â6,4â6,5-8,5â13,5â7,6â7,abaxially,acuminate,acute,adaxially,anther,apex,base,berry,blue,broadly,calyx,chartaceous,cm,cordate,deeply,deltoid,diameter,extra-axillary,filament,flattened,fleshy,flower,fruit,fruiting,glabrous,hair-tipped,half,herbaceous,lanceolate,leaf,light,lobe,long,lower,margin,markedly,minutely,mm,narrowly,obscure,often,ovate,ovoid,palmate,papillose,pedicel,peduncle,pentagonal,petiole,pointed,primary,pubescent,revolute,rotate-stellate,rounded,sand-punctate,simple,slender,slightly,small,somewhat,spaced,sparsely,stem,stigma,style,tip,tooth,trichome,tube,unbranched,unknown,vein,vine,white,widely,x	0.8â2.5,1.2â1.5,1â1.5,1â3,3â4.5,4â9,5-merous,5â10,6â10,adaxial,alyx,apar,apicall,axe,blade,c.,capitat,ciliate,clavate,climbin,color,cylindrical,densely,eaf,eed,glabrou,hair,like,lon,longer,m.,membranous,moderately,nflorescence,nternode,orolla,perfec,plurifoliat,rachi,ruit,sand-punctat,scattered,short,side,tamen,tem,terrestrial,unit,unknow,vary,venation,wide,ympodial	apart,appearance,arrangement,bark,border,branch,bud,capitate,characteristic,colour,corolla,corrugation,distal,drying,exertion,form,giving,glabrousnes,growth,height,history,inflorescence,interjected,lateral,leaflet,length,life,lobing,midpoint,na,new,number,ovary,per,plant,prickle,pseudostipule,ray,seed,shape,size,surface,terminal,texture,thicknes,type,variation,width
145	wfo-0001027378	success	141	118	98	43	20	0.695	.2,0.7-1,0.8-2.5,1-1.5,1-3,1.2-1.5,1.5-1.8,1.5-8,15-35,2-11,2-2.2,2-4,2.5-7,3-4.5,3-5,3-6,4-6,5-13,6-10,abaxially,acuminate,acute,adaxially,anther,apex,apparently,basally,base,blue,broadly,calyx,chartaceous,ciliate,clavate,climbing,cm,connivent,cordate,cylindrical,deeply,densely,diameter,equal,extra-axillary,filament,fleshy,flower,fruit,glabrous,hair,hair-tipped,herb,lanceolate,leaf,light,lobe,long,margin,minutely,mm,multicellular,node,oblong,obscure,often,ovate,pedicel,peduncle,perfect,petiole,pubescent,rachi,revolute,rooting,rotate-pentagonal,rounded,scattered,short,simple,slender,small,somewhat,spaced,sparsely,stigma,style,terrestrial,tip,tooth,trailing,tube,unbranched,unknown,weakly,white,widely,x,yellow	2.3-5,4-9,5-8,5-merou,6-7,ag,alyx,apart,apicall,articulated,axe,ba,blade,capitat,deltoid,directed,distally,eaf,eed,fruiting,geminat,large,longer,longitudinal,lower,moderately,narrowly,nflorescence,opening,orolla,plurifoliate,pore,pubescen,slightly,slit,tamen,tem,unit,unknow,vary,vein,wide,ympodial	5-merous,apically,arrangement,capitate,characteristic,corolla,form,growth,habit,history,inflorescence,length,life,ovary,seed,shape,size,staman,stem,texture
146	wfo-0001027384	success	155	107	87	68	20	0.561	.5,0.4-1.1,0.5-1,0.9-1,1-1.3,1-1.5,1-3,1-4,1.5-2,2.5-6.5,3-3.5,3-4,3/4,4-7,5-15-flowered,7-14,7.5-8,acute,anther,apex,bark,base,berry,broadly,brown,bud,calyx,capitate,clavate,cm,corolla,cuneate,deep,dia,drying,ellipsoid,filament,flattened-reniform,fruiting,glabrous,globose,green,hard,later,lateral,leaf,long,long-exserted,main,minutely,mm,mustard,narrowly,obovate,opposite,ovary,pair,pale,papillose,pedicel,petiole,pitted,pseudo-terminal,reddish-purple,rounded,shaped,shining,shrub,simple,slender,small,stem,stigma,style,sulcate,surface,tapering,tear-drop,tree,triangular,tube,vein,way,white,x,yellow,young	.25,.75,/3,5-5.5,abov,anothe,anthesi,apart,ba,beginning,beneath,breaking,closely,difoliate,distal,eaf,edicel,eed,equal,erect,free,geminate,herbarium,incrassate,inflorescenc,lobe,lobed,lower,margin,member,middle,nflorescence,occasionally,older,overlapping,paler,papillo,peeling,planar,pore,poricidal,portion,prominent,rarely,ruit,scar,section,siz,spaced,specimen,straight,subcoriaceous-fleshy,tall,thick,tip,transverse,trichome,tub,tuft,ud,uniseriate,unit,widely,widest,without,woody,yellowish,ympodial	arrangement,characteristic,colour,diameter,form,fruit,growth,height,history,inflorescence,length,life,lobing,plant,primary,seed,shape,size,texture,type
147	wfo-0001027389	success	154	84	62	92	22	0.403	.1,.25,.5,0.5-1.5,0.6-1,1-1.5,1.8-1.9,11-14,2-2.5,3-3.5,3-4.5,4-5-flowered,acuminate,acute,apex,bark,base,berry,brown,calyx,cm,dark,dia,dry,elliptic,erect,except,filiform,fruiting,geminate,glabrous,globose,green,hispidulous,inflorescence,leaf,like,long,margin,material,minutely,mm,node,non-reproductive,ovate,ovoid-reniform,pedicel,petiole,puberulent,reddish-golden,shrub,simple,slender,sparsely,stem,surface,tapering,thread-like,trichome,truncate,uniseriate,x	0.25-0.3,0.25-0.5,0.5-0.75,1,1-2,5-7,7-8,along,anther,anthesi,apart,ba,beneath,broadening,broadly,bud,conical,corolla,decurrent,deflexed,deltoid,eaf,edicel,eed,ellipsoid,evenly,expanded,exserted,filament,foetid,foliage,free,lateral,lobe,lobed,lon,lower,main,making,middle,nearly,nflorescence,obovoi,occasionally,often,older,one,opposite,ovary,pair,paler,papillo,papillose,pitted,pore,poricidal,portion,prominent,prominently,proximal,raise,raised,reflexed,rest,ruit,scar,shaped,shin,side,slight,slightly,soon,spaced,stigma,straight,style,tall,tear-drop,tip,top,tube,ud,unifoliat,unit,vein,white,widest,winged,woody,yellowish,ympodial,young	arrangement,characteristic,colour,form,fruit,glabrousnes,growth,height,history,length,life,new,peduncle,perennial,plant,seed,shape,shiny,size,texture,type,unifoliate
148	wfo-0001027395	success	153	122	100	53	22	0.654	.5,0.25-0.5,0.75-1,1-1.5,1-2,1-5,1.1-1.5,1.5-1.9,10-20-flowered,12.5-17.3,2-3,5-6.5,8,acute,anther,anthesi,apex,apically,apiculate,attenuate,bark,base,beneath,berry,black,calyx,capitate,cm,conical,constricted,corolla,cucullate,decurrent,deflexed,deltoid,densely,dia,drying,erect,exfoliating,exserted,fleshy,fruit,fruiting,glabrous,globose,green,immature,imperceptibly,large,leaf,lobe,lobed,long,margin,minutely,mm,narrowly,nearly,obovate,occasionally,once-furcate,ovary,ovoid,papillose,partially,pedicel,petiole,piece,planar,pointed,primary,pubescent,robust,rusty-papillate,secondary,shaped,shining,shiny,shrub,simple,size,small,somewhat,stem,stigma,straight,style,tapering,tear-drop,tip,transverse,trichome,uniseriate,vein,white,within,without,woody,x	.25,0.6-1.1,1.5-2.5,1.6-2.9,11-15,2.2-7,3.5-4,4-6,becoming,beginning,caly,closely,depressed,differing,difoliate,eaf,edicel,eed,enlarging,filament,free,geminat,inflorescenc,known,lateral,lon,lower,main,major,midrib,minor,nflorescence,older,opposite,overlapping,pair,papillo,pore,poricidal,portion,raised,restricted,ruit,scar,spaced,tall,thick,thickened,tube,ud,unit,ympodial,young	bud,characteristic,colour,diameter,form,growth,height,history,inflorescence,length,life,lobing,na,number,per,perennial,plant,seed,shape,surface,texture,type
149	wfo-0001027396	success	244	148	120	124	28	0.492	0-100,0-3,0-4,0.5-1,0.5-1.5,0.7-2.5,0.8-1.3,1.5-3,1.5-3.5,1.8-3,1/3,1/4-1/3,10-35,2-3,2-3.5,2.5-4,2.8-4.5,20-100,3.5-6,4-7,5-8,6-20,abaxially,acute,almost,anther,apex,apparently,articulated,attenuate,bark,base,berry,black,brown,calyx,chartaceous,cm,concolorous,connivent,cream,cuneate,dark,densely,diameter,discolorous,drying,elliptic,elongate,erect,filament,flattened-reniform,flower,fruit,fruiting,glabrous,glandular,green,hair,herb,lateral,leaf,length,lobed,lobing,long,long-styled,margin,marking,maturity,mauve,mm,moderately,near,obtuse,often,orange,pair,pale,pedicel,peduncle,per,petiole,plant,poricidal,porrect,prickle,prickly,primary,pubescent,purple,red-brown,rotate,short-styled,shrub,simple,sometimes,somewhat,sparsely,spherical,stalked,stellate-pubescent,stem,style,surface,tapering,tearing,tip,trichome,tube,unbranched,upper,variously,vein,way,white,wide,yellow,yellow-green,young	-2,-5,-6,/3,0-30,0-5,0.1-0.5,0.1-1,0.4-0.7,0.5-2,0.5-2.5,0.8,1,1-4,1.2-2,1/2-2/3,1/6,10-15,10-25,10-30,12-25,15-40,2-7,3-,3-9,4,4-5,4-6,5-10,5-20,5-30,5-50,5-merous,5.5-7.5,6.5-7.5,7-10,7-15,8-20,abaxial,adaxial,alyx,ame,andromonoecious,apar,apart,apically,ba,blade,broad,broad-deltate,bulbous,c.,curved,decurrent,deltate,difoliate,distal,distance,eaf,eed,elongating,equal,extending,extensive,fewer,flattened,free,fully,geminat,glabrescent,gray-brow,hermaphrodite,heterostylous,infructescence,less,lignified,lobe,lon,long-acuminat,longer,lower,lowermost,mature,midpoint,midvein,nflorescence,older,one,open,opening,orolla,oung,pendulous,pericarp,perpendicular,portion,prickl,ray,reflexed,ruit,scar,secondary,sessile,side,smooth,spaced,spreading,stalk,staminat,stout,straight,tamen,terete,tertiary,time,unarmed,unit,usually,vary,venation,visible,woody,yellowish,ympodial	arrangement,branch,bud,characteristic,colour,corolla,corrugation,decurren,exertion,form,glabrousnes,gray-brown,growth,height,history,inflorescence,life,na,new,number,ovary,perennial,seed,shape,size,stigma,texture,type
150	wfo-0001027449	success	160	105	80	80	25	0.5	/3,0.5-1,0.5-1.5,0.8-1.5,0.9-1.1,1.4-1.5,1.5-2.5,10-15-flowered,2-4,3,3-7,5-6,8-15,acute,anther,apex,area,bark,base,berry,brown,bud,calyx,cm,corolla,dark,dia,difoliate,elliptic,exserted,fruit,fruiting,glabrate,glabrous,globose,green,inflorescence,leaf,lobe,lobed,long,long-acuminate,minutely,mm,narrowly,oblique,often,ovary,ovoid-reniform,pale,papillose,pedicel,petiole,pitted,pointed,pubescent,red-papillose,shaped,shrub,simple,size,slender,small,soon,stem,stigma,straight,style,surface,tapering,tear-drop,tip,tree,trichome,tube,uniseriate,unit,way,white,x	.4,.5,.75,1.2-1.5,2-3,3-3.5,4-6,acuminate,anthesi,appearing,arising,around,axil,becoming,beginning,beneath,closely,cup,deciduous,deflexed,dense,densely,density,differing,dry,eaf,edicel,eed,ellipsoid,erect,extreme,filament,forming,free,frui,geminat,inflorescenc,lamina,later,lateral,like,lon,long-triangular,lower,main,major,material,minor,nflorescence,obconic,older,one,opposite,orangish,overlapping,packed,pair,persistent,pore,poricidal,portion,prominent,raised,reddish-brow,reflexed,rest,ruit,scar,sparse,sparsely,styl,tall,trunk,tuft,ud,varying,vein,woody,ympodial,young	abaxial,adaxial,arrangement,characteristic,colour,diameter,exertion,form,geminate,growth,hair,height,history,length,life,lobing,na,plant,reddish-brown,seed,shape,sympodial,texture,type,variation
151	wfo-0001027452	success	152	108	83	69	25	0.546	.5,0.5-1,0.5-2,1,1-3,1-5,1.5,10-20,2-4,2-foliate,3-9,4,4-6,5-12,absent,acute,anther,apex,base,berry,branched,brown,calyx,cell,center,chartaceous,ciliate,cm,connected,densely,denser,diameter,dm,drying,elliptic,elliptic-ovoid,entire,filament,flower,fruit,glabrous,globose,herb,immature,large,linear-lanceolate,margin,maturing,membranaceous,mm,moderately,nearly,new,notched,oblong,obtuse,outer,parallel,pedicel,peduncle,perpendicular,petiole,placenta,pubescent,raised,ridge,rotate,rounded,running,seed,semitransparent,significantly,single,smaller,smoother,sparsely,stigma,style,swollen,wall,white,x,yellow	0.5-1.5,0.5-2.5,1-2,1-4.5,1.5-3,2-6,3-6,5-20,abaxially,abundant,adaxiall,adaxially,along,axe,beyond,blade,celled,cordate,decurrent,dehiscing,eaf,eed,emarginat,equal,explosively,exserted,flat,frui,geminat,growt,hair,held,interpetalar,lobe,long,lower,lying,maturit,mesocarp,nfloresence,often,one-,orolla,per,pressure,pubescen,rachi,ruit,short,slightly,sometimes,stamen,straight,tal,tamen,tem,tissue,triangular,tube,two-celled,unbranched,unit,usually,vary,vein,watery,wid,woody,ympodial	abaxial,adaxial,arrangement,branch,characteristic,colour,corolla,form,glabrousnes,growth,height,inflorescence,leaf,length,mentioned,ovary,plant,shape,size,staman,stem,surface,texture,type,wide
152	wfo-0001027471	success	165	102	82	83	20	0.497	.5,/4,0.1-0.2,0.2-0.5,0.4-1,0.5,0.5-0.6,0.5-0.7,0.5-1.5,0.9-1,1-1.2,2-3,2-lobed,3-4,4-5,acute,anther,anthesi,apex,bark,base,berry,bifid,branched,calyx,cm,conical,corolla,dendritic,densely,diameter,elliptic,entire,erect,filament,flattened,fruiting,glabrous,globose,growth,herb,included,inflorescence,leaf,less,lobe,margin,maturity,minutely,mm,new,nodding,ovary,ovate,pale,pedicel,peduncle,petiole,pitted,poridical,pubescent,red-orange,reniform,shape,simple,size,slender,sparsely,stem,stigma,style,subshrub,surface,tan,tip,trichome,tube,uniseriate,way,white,x,yellowish	0.2-0.4,0.7-0.9,1-1.5,1-1.6,1.4-3,1.5-2,2-2.5,3-7,6-7,abaxially,adaxially,age,along,appressed,ascending,brittle,c.,closely,deltate,desnsely,differing,difoliate,distant,drying,eaf,eed,erec,especially,flower,free,furcate-dendritic,geminate,internodal,lamina,leaf-opposed,lengthening,like,lobed,long-triangular,lower,major,midvein,minor,mixture,nflorescence,node,occasionally,open-conical,orbicular,overlapping,pair,papillat,perfect,pericarp,petal,planar,plane,pore,portion,primary,pubscent,rachi,reflexed,ruit,scar,scattered,shrub,similar,slightly,slit,small,somewhat,spaced,straight,thickened,thin,trifoliat,ud,unit,usually,vein,woody,ympodial	abaxial,adaxial,arrangement,bud,characteristic,colour,exertion,form,fruit,glabrousnes,height,history,length,life,lobing,plant,pubescence,seed,texture,type
153	wfo-0001027473	success	138	90	68	70	22	0.493	/2,0.25-0.5,0.5-1,0.8-1,1.3-2,1.5-2,1.8-2,2-2.5,2.5-3,?,acute,anther,apex,bark,base,berry,brown,calyx,clavate,cm,conical,corolla,decurrent,dendritic,densely,di-,dia,erect,filament,flattened-reniform,fruiting,glabrous,globose,green,incrassate,leaf,lobe,long,long-triangular,margin,mm,near,obovate,occasionally,ovary,pale,pedicel,petiole,pointed,pubescent,rusty,sessile,shape,shrub,somewhat,sparsely,stem,stigma,style,subshrub,surface,thick,trichome,trifoliate,tube,way,white,wide	.25,1-1.5,1-2,1/3,3.5-5,4.5-13,5,6-9,8.5-37,abaxially,absen,adaxially,along,anthesi,ape,apparently,deccurent,deep,deflexed,denser,differing,drying,eaf,eed,empty,free,geminat,giving,later,lateral,less,like,lobed,lower,main,major,middle,minor,minute,minutely,older,overall,pair,papillo,pitted,planar,pore,poricidal,portion,pubesent,rootstock,ruit,sac,shaped,sterile,strongly,tall,tear-drop,tip,unit,usually,vein,widest,wing,winged,woody,yellowish,yellowish-brow,ympodial,young	abaxial,absent,adaxial,arrangement,characteristic,colour,diameter,flower,form,fruit,growth,height,history,length,life,lobing,plant,seed,size,texture,type,yellowish-brown
154	wfo-0001027483	success	164	82	59	105	23	0.36	0.2-1.9,0.6,1-2.5,1-4,1-5,1.2-2.5,1.5-10,1.5-2.6,1.5-3,2-3,2-4,2-4.5,3-15,3-6,3.5-20,4.5-8,5-6,branched,calyx,cm,coarsely,corolla,cyme,diameter,dichasial,dichasially,ebracteate,filament,finely,forked,globose,green,herbaceous,interjected,lateral,leaf,leaflet,light,long,medium,mm,monochasial,mucilaginous,odd-pinnate,ovoid,pedicel,peduncle,perennial,petiole,plant,pubescent,seed,size,style,terminal,tuber-bearing,violet,violet-purple,wide	0-1.,1,1-2,2,3-6-foliat,5-10,abaxially,acumen,acute,adaxially,apex,apical,apically,articulate,basal,base,cell,connate,covering,cuneate,decurrent,dehiscent,digestion,diminishing,distal,dorsally,dot,eaf,edge,eed,elliptical,emoval,enzyme,erec,exceeding,flat,flower,folded,generally,globo,gradually,green-white,hair-like,half,honeycomb,interpetiolar,introrse,lighter,living,lobe,lon,lower,lunat,make,maturing,minute,nflorescence,nther,obtuse,often,orolla,ovate,pair,pattern,perfect,petiolule,plan,poricidally,proximal,purple,rachi,ray,reveal,rosette,rotate,rounded,ruit,sessile,seudostipule,short,slit,smooth,sometimes,specimen,stamen,stigma,straight,subsessile,tall,tem,testal,thick,throughout,tissu,toward,typically,uniform,unit,vary,varying,wall,white,yellow,ympodial,Â¼	0-10,abaxial,adaxial,anther,arrangement,colour,form,fruit,growth,height,history,inflorescence,length,life,ovary,pseudostipule,shape,stem,surface,texture,type,wet,width
155	wfo-0001027506	success	215	107	88	127	19	0.409	/6,0-10,0.5-1.5,0.5-6,0.7-1.3,0.8-1.5,1-2,1.2-1.5,1.5-2.2,1/3,2-3.2,2.2-3.5,acuminate,acute,anther,apex,apically,apparently,articulated,bark,base,berry,brown,calyx,cell,chartaceous,cm,connivent,cordate,cream,cuneate,dark,densely,diameter,entire,erect,filament,fine,flattened-reniform,fruit,fruiting,green,lateral,leaf,length,lobed,margin,marking,maturity,mauve,mm,narrow-deltate,occasionally,orange-brown,outline,ovate,pale,pedicel,peduncle,petiole,pit,plant,poricidal,prickly,purple,raised,reddish,shrub,simple,small,smooth,sometimes,spherical,stellate-pubescent,stem,style,subentire,surface,tapering,terminal,tip,tree,truncate,upper,way,yellow,yellow-green,young	-0.35,-1,-20,-3,-7,-7.5,.2,.5,/2,0,0-2,0-6,0-60,0.1-,0.1-0.3,0.2,0.2-0.3,0.25,1-3,1-4,1.8,1/6-1/4,10-40,2.5-5,2.5-8,3-10,3-5,3-6,3.5-5,5-10,5-7,5-merous,6-13,6.5-10,7-8,7-9,8-10,9-13,abaxially,acuminat,alyx,ame,andromonoecious,apar,apart,becoming,blade,branched,brow,c.,concolorous,curved,distal,dry,drying,eaf,eed,elongating,equal,flattened,flower,free,glabrescent,glabrous,hard,hermaphrodite,heterostylous,infructescence,lengt,lobe,long,long-styled,longer,lower,lowermost,mature,midpoint,moderately,multangulate,nflorescence,older,one,open,orange,orolla,oung,pair,pendulous,per,pericarp,plurifoliat,porrect,portion,prickl,prickle,primary,ray,reduced,reflexed,ruit,scar,sessile,short-styled,spaced,spreading,stalk,stalked,staminat,stellate,stout,tamen,terete,tertiary,time,trichome,tube,twice,unarmed,unit,variously,vary,vein,venation,visible,wide,woody,ympodial	arrangement,branch,characteristic,colour,corolla,exertion,form,glabrousnes,growth,height,inflorescence,lobing,new,ovary,seed,shape,size,texture,type
156	wfo-0001027548	success	216	104	82	134	22	0.38	0.3-1.2,0.5-2,1-1.5,1.5-2,10-12,4.5,6-9,acuminate,acute,almost,anther,apex,attenuate,base,berry,black,branch,brown,c.,calyx,capitate,cm,corolla,dark,densely,depressed-elliptic,diameter,ellipsoid,elliptic,entire,exserted,filament,flattened-reniform,flexuous,fruiting,glabrous,globose,green,growth,immature,inflorescence,leaf,like,lilac,long,loosely,margin,membranous,minute,minutely,mm,narrowly,new,pale,pedicel,peduncle,per,petiole,pitted,puberulent,pubescent,reddish,revolute,ripe,simple,size,slender,stem,stigma,strongly,style,surface,terminal,tinged,tube,type,vine,warty,way,white,woody,x	-11.5,.3,0.2,0.5,1,1-10,1-2.5,1-3.5,1.2,1.5,1.5-2.5,10-50,3-7,4-6,4-8,5-merou,7-10,8-9,abaxiall,adaxially,ag,along,also,although,alyx,anthesi,apart,apical,apparently,appearing,area,ark,articulated,articulation,axi,basal,beneath,bent,branched,branching,bu,cell,conical,connivent,darker,deflexe,deltate,dendritic,denser,drying,dull,eaf,early,eed,elongate,em,extending,flower,free,geminat,glabrescen,glandular,half,herbarium,ilament,irregularly,lamina,leaving,lengthening,less,lobe,lobed,lon,long-styled,loose,lower,many,matte,mixed,near,nflorescence,occasionally,older,orolla,outline,pair,papillae,papillate,papillo,perfect,pericarp,planar,plurifoliate,point,pore,poricidal,portion,primary,prominent,rachi,rectangular,ruit,scar,scattered,slit,small,sometimes,somewhat,spaced,sparse,sparsely,specimen,spreading,stellate,swollen,tapering,testal,thickened,thin,time,tiny,tip,transparent,trichome,twinin,ud,uniseriate,unit,upper,usually,vary,vein,yellow,ympodial	1.2-2.5,8,arrangement,bark,bud,characteristic,colour,exertion,form,fruit,glabrousnes,height,history,length,life,lobing,number,ovary,plant,seed,shape,texture
157	wfo-0001027581	success	200	135	97	103	38	0.485	100+,200,>,acute,along,anther,anthesi,apex,axe,base,berry,branched,branching,broadly,brown,c.,calyx,clavate,cm,corolla,cup-shaped,dark,densely,diameter,drying,echinoid,ellipsoidal,elliptic,entire,evenly,exserted,filament,flattened-reniform,flower,fruiting,glabrous,globose,golden,gradually,green,growth,inflorescence,leaf,length,like,lobed,long,many,margin,minute,minutely,mm,moderately,multangulate,multiseriate,narrowing,new,nodding,pair,part,pedicel,peduncle,per,petiole,pitted,plane,primary,pubescent,purple,ray,reddish,ripe,scarcely,sessile,shrub,simple,size,small,sparsely,stalk,stellate,stem,stigma,stout,style,surface,terminal,time,tree,trichome,tube,undersurface,upper,vein,way,wide,yellowish	0.2â0.3,0.3,0.3â1,0.5â1,0.5â1.5,1,1.2â1.5,1.3â1.5,1.5,1.5â2,1.5â3,10,10â16,12,12â30,15â20,1â1.5,1â3-rayed,2.5â3,3.5â4.5,3â3.5,4.5â16,4â8,5-merou,6â7,7â10,7â9,8,8â10,9â11,9â9.5,abaxial,abaxially,adaxial,ag,alyx,apar,ark,articulated,beneath,brow,bulbous,clearly,closely,connivent,deltate,dichasia,discolorous,distally,eaf,eed,erec,free,glabrescent,greyish,ilament,lamina,largest,lengthening,less,lobe,longest,loosely,lower,midvei,mixed,near,nflorescence,older,orolla,papillo,perfect,pericarp,plurifoliate,pore,poricidal,porrect-stellate,portion,reflexed,rhachi,ruit,scar,shiny,short-stalked,slit,smaller,spaced,spreading,tall,tem,thin,tip,ud,unevenly,unit,vary,varying,visible,weak,whit,woody,yellow,ympodial	0.5-1,1-1.5,1-3-rayed,1.2-1.5,1.3-1.5,1.5-2,1.5-3,12-30,15-20,2.5-3,4-8,4.5-16,7-10,7-9,9-11,9-9.5,arrangement,bark,branch,bud,characteristic,colour,exertion,form,fruit,glabrousnes,height,history,life,lobing,na,number,ovary,plant,seed,shape,texture,type
158	wfo-0001027584	success	144	99	78	66	21	0.542	-2,0.5-1.5,0.9-1,0.9-2.5,1-1.2,1.2-1.4,1.5-2,1.6-1.9,11.5-45,2,2-10,3,3-.,4-6,4-7,4.5-20,abruptly,acuminate,anther,anthesi,apex,attenuate,bark,base,becoming,branched,calyx,cell,cm,conical,corolla,darker,diameter,ellipsoid,elliptic,filament,flattened,four,fruit,fruiting,glabrous,green,herb,lamina,long,minutely,mm,nearly,outer,ovary,ovate,pale,papillate,pedicel,peduncle,petiole,pointed,reddish,regularly,reniform,scattered,shrub,smooth,sparsely,stem,striate,stripe,style,suffruticose,surface,tan,time,trichome,uniseriate,wall,white,without,x	-16,..,.5,0.5-1,1.5-8,10-15,100,2.5-3,7-10,8-9,absent,apical,beginning,beneath,branch,brittle,broadly,brow,c.,capitat,cucullate,deflexe,deltate,densely,dry,eaf,edicel,eed,erec,flower,irregular,lobe,lobed,lower,margin,markedly,narrowly,nflorescence,open,outline,pair,per,pericarp,planar,plurifoliat,present,primary,ruit,scar,single,single-stemmed,sinuate,small,sparse,stigma,testal,thickening,thin,tip,triangular,tube,tuft,ud,unit,vein,ympdoial	arrangement,brown,bud,characteristic,colour,form,growth,height,history,inflorescence,leaf,length,life,lobing,plant,plurifoliate,seed,shape,size,texture,type
159	wfo-0001027600	success	185	104	82	103	22	0.443	0.5-1.5,1,1-14,1-4,1-5,1.5-2,10-,10-20,15-25,2-11,2-18,2-3,2-4,2-4.5,2-6,2.5-21,20-30,3-5-lobed,acuminate,acute,adpressed,apex,apical,apiculate,basal,base,calyx,cm,concave,cordate,cuneate,deltate,densely,diameter,ellipsoidal,entire,fading,flattened,flower,forked,fruit,glabrous,gland,greenish-white,leaf,lobe,lobed,margin,mature,minutely,mm,moderately,oblong,obtuse,occasionally,orange,ovoid,pedicel,peduncle,petiole,pilose,pinnately,puberulent,purple,purplish,rachi,rarely,rounded,simple,stigma,style,surface,tip,tree,truncate,two,unbranched,unlobed,white,x,yellow,yellow-green	-10,-3,0.5-1,1-2,1.5-2.5,1/2-3/4,2-3.5,2-5,2.5-6,3-15,3-5,3-6,4-6,4-foliat,5-13,8-17,abaxially,abruptly,absen,absent,adaxial,adaxially,aggregate,along,apart,ape,articulated,axe,beyond,blade,brow,campanulate,cell,channe,collection,connective,coriaceous,cream,dilated,directed,distally,divided,eaf,eed,elliptic,especially,exceeding,except,exserted,fleshy,glabrescent,glandular-puberulent,laterally,leaving,lon,long,lower,main,midrib,narrowed,nflorescence,nther,obconical,older,orolla,ovate,papillose,pedicellar,perfect,pilo,pore,puberulen,puberulence,pubescent,radiu,remnant,ruit,shorter,sinus,slightly,small,somewhat,spaced,sparsely,stamen,stone,strongly,subcoriaceous,tal,tem,thecae,time,tomento,triangular,tube,ud,unit,vary,vein,wide,yellowish,ympodial,young	anther,arrangement,bud,characteristic,colour,corolla,form,growth,height,history,inflorescence,length,life,ovary,perennial,plant,seed,shape,size,stem,texture,type
160	wfo-0001027607	success	167	98	82	85	16	0.491	.1,0.25-0.5,0.8-1,1-4,1.2-1.5,1.5-3,2-2.5,2-3,2-4,2.5-3,3-3.5,3/4,4-10-flowered,5-10,8-9,acuminate,acute,anther,apex,arching,area,aspect,bark,base,berry,branch,calyx,cm,corolla,curling,decurrent,deltoid,densely,dia,elliptic,erect,filiform,flattened,fruiting,giving,glabrous,globose,golden,green,leaf,like,long,minute,minutely,mm,narrowly,occasionally,older,ovary,ovoid-reniform,pagoda-like,papillose,pedicel,petiole,pitted,plant,pubescent,reddish-brown,shaped,shrub,simple,slender,stem,stigma,style,surface,tear-drop,tip,trichome,unifoliate,uniseriate,way,white,widened,winged,x,zig-zag	.25,.5,0.5,0.5-1,1,5-7,age,anthesi,apar,ba,basal,becoming,branche,brown,corky,dark,deflexed,dry,eaf,edicel,eed,ellipsoid,elongate,evenly,except,exserted,f,filament,free,geminate,gently,glabrate,lamina,lateral,lenticellat,less,lobe,lobed,lon,lower,m.,main,material,middle,midrib,narrow,nflorescence,non-reproductive,obovoid,opposite,pair,pore,poricidal,portion,present,prominent,raised,rarely,reflexed,ruit,scar,short,slight,slightly,small,soon,spaced,straight,strongly,styl,tall,tan,tapering,treelet,tub,tube,ud,unit,vein,widening,widest,woody,yellowish,ympodial,young	arrangement,characteristic,colour,diameter,form,fruit,growth,height,inflorescence,length,lobing,seed,shape,size,texture,type
161	wfo-0001027618	success	202	139	113	89	26	0.559	-10,0.5,0.5-1,1,1-1.5,1-14,1-23,1-3,1-5,1-9,1.4-4,1.5-3,11-pinnate,15-35,2-11,2-5,2.5-6,3-30,3-5,3-7,3-7-pinnate,3.5-6,4,4-8,5-7.5,5-merous,6-40,8-35,abaxially,acute,adaxially,apex,articulated,basal,base,branched,campanulate,capitate,chartaceous,cm,compound,connective,cordate,cuneate,cylindrical,deltate,densely,dia,diameter,dilated,distally,ellipsoidal,elliptic-ovate,entire,fleshy,flower,fruit,fusiform,glabrous,globose,greenish,leaf,leaving,length,less,lobe,long,margin,membranaceous,minutely,mm,moderately,near,oblong,obtuse,orange,ovate,papillose,pedicel,pedicellar,peduncle,per,perfect,pinnately,puberulent,puberulent-pubescent,pubescent,pubescent-pilose,purple,rachi,radiu,remnant,reticulate,ripe,shallowly,shrub,simple,slightly,stigma,style,sympodial,tomentose,triangular,truncate,tube,unbranched,unit,urceolate,white,wide,width,x,yellow	-pubescent,0-10,0.5-6,1-,1-13,1.5-13,1.5-7,1.5-8.5,11-16,11-22,12-27,15-30,2-11.5,2-12,2-27,2-8.5,2-9,3-18,5-18,5-20,5-30,5.5-12,6-25,7-25,8-16,acuminat,acut,aggregate,also,alyx,apart,ape,ascending,axe,beyond,blade,bud,cell,darker,diamete,directed,eaf,eed,elliptic,exceeding,exserted,lateral,laterally,leaflet,lon,longitudinal,lower,mesocarp,nflorescence,nther,obovate,obtu,often,orolla,perfec,petiole,petiolule,pilo,pilose,pore,presen,puberulent-pilo,ranch,ratio,rown,ruit,runk,shorter,small,sometimes,somewhat,spaced,sparsely,spreading,stamen,stone,stripe,tal,terminal,thecae,tree,uni,vary,without	1-8.5,acuminate,anther,arrangement,calyx,characteristic,colour,corolla,crown,form,glabrousnes,growth,height,history,inflorescence,life,ovary,perennial,plant,puberulent-pilose,seed,shape,stem,surface,texture,trunk
162	wfo-0001027622	success	203	142	120	83	22	0.591	.5,0-14,0-16,0.3-10,1,1-2,1.5-3.5,1.5-4.2,1.6-4.5,12-23,2-25,2-6,2.5-3.5,3-4.5,3.5-11,4-9.5,5-11,6-17,6-7,8-16,abaxially,acuminate,adaxially,anther,axillary,berry,blade,blue,blue-purple,borne,brownish,bud,cell,chartaceous,clavate,cm,condition,connivent,corolla,covering,diameter,distal,drying,end,erect,filament,flower,forked,fresh,fruit,generally,glabrescent,glabrous,globose,green,green-white,greenish,hair,hair-like,half,herb,homostylous,interjected,lanceolate,lateral,leaflet,light,like,lobe,long,make,membranous,middle,mm,mottled,mucilaginous,odd-pinnate,ovate-lanceolate,ovoid,pale,pedicel,peduncle,pentagonal,petal,petiole,plant,poricidal,pubescent,purple,seed,shortly,singly,size,slightly,star,stellate,stem,stigma,straight,striped,style,subglabrous,subtending,terminal,testal,thick,throughout,tip,tube,tuber,typically,unwinged,usually,wall,wet,whitish,wide,wing,x,yellow	1-10,1/,2-3,3-16,3-4,4-5,5-merou,8-20,acumen,acute,ag,along,alyx,apart,apex,apparently,articulated,axe,base,broadly,capitat,ciliate,decumben,different,digestion,dorsally,eaf,edge,eed,elliptic,elliptical,enzyme,especially,exceeding,except,flat,folded,geminat,glabrou,greatly,honeycomb-shaped,lengthening,living,lower,margin,midrib,minutely,narrowly,nflorescence,oblique,often,orolla,ovate,pair,perfect,petiolule,plurifoliate,population,pore,proximal,puberulent,reduced,removed,rounded,ruit,seudostipule,slit,sometimes,spaced,specimen,stamen,ste,stolo,subequal,tall,tamen,tem,tri-,truncate,unit,vary,varying,ympodial	5-merous,arrangement,calyx,capitate,colour,decumbent,form,growth,height,history,inflorescence,leaf,length,life,ovary,presence,pseudostipule,shape,stolon,surface,texture,type
163	wfo-0001027624	success	189	116	95	94	21	0.503	0-7,0.1-0.9,0.3-1,0.4-3,0.5-1.5,0.8-5.6,1-2,1.1-8.4,1.2-2.6,1.3-2.9,1.5-6.6,2.4-4.8,2.9-12,3-10,3-11,4-15.2,4-7,5-9,6-18.5,9-41,anther,berry,blade,brownish,cell,clavate,cm,condition,connivent,corolla,covering,deep,densely,diameter,drying,entirely,erect,filament,flower,fresh,fruit,glabrous,globose,green,green-white,greenish,hair,hair-like,herb,homostylous,interjected,lanceolate,lateral,leaf,leaflet,light,like,long,make,mm,moniliform,mottled,mucilaginous,odd-pinnate,ovate,ovoid,pedicel,peduncle,pentagonal,petiole,plant,pubescent,purple,rotate,seed,short,size,slightly,sometimes,stigma,style,terminal,testal,thick,throughout,tuber,unwinged,usually,wall,wet,white,whitish,wide,x,yellow	0-3,1-3,1-5,2-20,2-5,2-7,3-4,3-5,4-8,5-merou,abaxially,acuman,acumen,acuminate,acute,adaxially,ag,along,alyx,apart,apex,apparently,arranged,articulated,axe,axillary,base,bead,bud,capitat,considerably,cuneate,decreasing,decumben,decurrent,digestion,distal,dorsally,eaf,edge,eed,elliptic,enzyme,exceeding,flat,folded,forked,geminat,glabrou,half,honeycomb-shaped,larger,leave,lengthening,living,lobe,lower,middl,multiple,necklace,nflorescence,onto,orbicular,orolla,pair,perfect,plurifoliate,pore,poricidal,present,rachi,removed,ruit,sessile,seudostipule,slit,spaced,specimen,stamen,stolon,straight,subtending,tall,tamen,tem,tip,toward,tri-,tube,typically,unit,vary,widely,ympodial	5-merous,abaxial,adaxial,arrangement,calyx,capitate,colour,decumbent,form,growth,height,history,inflorescence,length,life,ovary,pseudostipule,shape,stem,surface,texture
164	wfo-0001027626	success	152	117	86	66	31	0.566	.3,.5,0.2â0.6,0.5-1,0.7â1,1,1.5â2,13â14,2â49,2â5,3â4,3â4.5,3â5,4â6,5-merous,5â6,8,9â18,abaxially,acuminate,acute,adaxially,along,anther,apex,arrangement,base,berry,calyx,center,chartaceous,clavate,cm,cordate,coriaceous,diameter,distichous,elliptical,entire,extra-axillary,filament,fleshy,flower,fruit,glabrous,greenish-white,lanceolate,leaf-opposed,liana,long,margin,maturity,membranous,minutely,mm,moderately,nearly,oblique,ovate,pedicel,peduncle,petal,petiole,pinnate,possibly,pubescent,rachi,reflexed,sand-punctate,scandent,shrub,slender,somewhat,sparsely,spindle-shaped,stellate,stigma,style,terminal,tip,unbranched,unknown,venation,white,wiry-woody,x	0.1â0.2,0.5â1,0.7â2.8,1.3â4.5,1.5â8,14â116,2â3,3â55,4.4â11,accrescen,alyx,apar,axe,blade,broadly,c.,capitat,ciliat,climbing,color,densely,distant,distinct,eaf,eed,frequently,fruiting,glabrou,immature,lamina,line,lobe,lower,m.,midvein,mor,nflorescence,nternode,orolla,pair,perfec,plurifoliat,pointed,rounded,ruit,sand-punctat,scar,secondary,seen,shortly,side,simple,spaced,ste,tamen,tem,time,trichome,truncate,tube,two,unit,vary,vein,wide,ympodial	abaxial,adaxial,branch,capitate,characteristic,ciliate,colour,corolla,form,glabrousnes,growth,height,history,inflorescence,leaf,length,life,lobing,new,ovary,perfect,plant,plurifoliate,seed,shape,size,staman,stem,surface,texture,type
165	wfo-0001027630	success	149	108	77	72	31	0.517	.1,0.5-1.2,0.5-2,1-1.5,1-5,1.4-1.7,1.5-2,2-3,3/4,4-6,5.5-11.2,6-10,8-9,acute,anther,anthesi,apart,apex,bark,base,berry,calyx,climbing,cm,corolla,deflexed,densely,erose,filament,fruit,fruiting,glabrate,glabrous,globose,golden,green,hirsute,lanceolate,lateral,leaf,linear,long-acuminate,main,margin,midrib,minutely,mm,near,ovary,pair,papillose,partially,pedicel,petiole,prominent,puberulent,pubescent,reflexed,scar,shaped,shrub,simple,slender,sparsely,stem,stigma,style,tapering,tear-drop,tip,trichome,tube,vein,way,white,winged,yellowish	.2,.5,0.05-0.1,0.5-1,2-6-flowered,also,arising,beginning,blunt,branchlet,broadly,ciliate,de,decurrent,deltoid,dia,distinguishable,eaf,edicel,eed,elongat,except,extreme,free,globo,immature,indistinct,inflorescenc,internodal,irregularly,knob-like,known,lobe,lobed,lon,long,lower,middle,nflorescence,novo,occasionally,older,opposite,paler,pore,poricidal,portion,proximal,raised,rest,rounded,ruit,seen,spaced,straight,strongly,swollen,tall,terminal,thickened,ti,ud,ultimate,unifoliat,uniseriate,unit,wide,widest,wing,x,ympodial,young	arrangement,bud,characteristic,ciliation,colour,density,diameter,distance,elongate,form,glabrousnes,growth,height,inflorescence,length,lobing,na,new,number,per,plant,prominence,seed,shape,size,spacing,surface,texture,type,unifoliate,width
166	wfo-0001027661	success	222	123	101	121	22	0.455	+,0.5,0.5-,0.5-2,0.6-1.1,0.6-1.5,1-7,1.2-6,1.3,1.5-2,2.5-7,4.5-6,5-9,6-12,8-10,acuminate,acute,anther,anthesi,apex,base,berry,bright,calyx,capitate,cm,column,connivent,corolla,creeping,deeply,densely,diameter,ellipsoid,entire,extremely,filament,flattened,fruiting,fused,glabrous,globose,grey,growth,herbaceous,lateral,leaf,leaf-opposed,like,lobed,long,long-exserted,margin,minute,minutely,mm,moderately,new,pale,pedicel,peduncle,petiole,pinnatifid,pitted,pubescent,purple,red,reniform,ripe,shape,simple,single,size,slender,sparsely,spreading,stellate,stem,stigma,style,surface,tan,terminal,ternately,tightly,trailing,tube,turbinate,type,underground,usually,variable,vine,violet,way,white,wide,woody,yellow,yellowish,Â¾	-10,1-,1-1.5,1-5,1.5,2,2.5-3,30,4-15,4-8-celled,40,5-merou,6-8,6-9,<,>,abaxially,adaxiall,ag,along,alyx,apart,ark,articulate,axi,basal,branch,branched,broadly,cell,commonly,conical,cordate,dendritic,denser,density,eaf,eed,elliptic,even,flower,free,gre,green,ground,hue,ilament,irregularly,lamina,leaving,lengthening,lobe,lower,many,markedly,membraneous,mixture,narrowing,near,nflorescence,occasionally,often,older,open,orolla,outline,ovate,pair,papillat,papillate,papillo,peg,pentagonal,per,perfect,pericarp,plurifoliat,pointed,pore,poricidal,portion,primary,prominent,pubescen,pubescence,purplish,rachi,rarely,reflexed,ruit,scar,shiny,short,sinus,sleeve,slit,small,spaced,spot,spreadin,strongly,swollen,tangled,tem,testa,thin,time,tip,triangular,trichome,truncate,two,ud,unieriate,uniseriate,unit,upper,vary,vein,ympodial,zig-za	abaxial,adaxial,arrangement,bark,bud,characteristic,colour,exertion,form,fruit,glabrousnes,height,history,inflorescence,length,life,lobing,ovary,papillose,plant,seed,texture
167	wfo-0001027714	success	251	124	101	150	23	0.402	+,.5,/3,0,1-1.5,1-1.6,1-2,1.5-2.5,1.5-3,1.5-5,14-16,2-2.5,4-5,5,5-6,6-7,7-20,acuminate,acute,almost,anther,apex,basal,base,berry,bright,brown,calyx,capitate,cm,conical,cordate,corky,corolla,deep,densely,diameter,drying,ellipsoid,elliptic,entire,exserted,filament,flattened,fruit,fruiting,glabrate,glabrous,globose,growth,immature,inflated,inflorescence,juicy,lateral,leaf,lobe,margin,mature,minutely,mm,new,obovate,occasionally,ovary,pair,pale,pedicel,peduncle,per,petiole,pitted,primary,pubescent,purple,red,reddish,reniform,ripe,seed,shiny,simple,slender,small,somewhat,sparsely,stem,stigma,strongly,style,surface,terminal,truncate,tube,vein,vine,violet,way,woody,x,yellowish	0.4,0.5,0.5-0.7,0.6-0.7,0.9-1.5,1,1-,1.5-2,2-,2-8,2.5-,2.5-4,2373.,3-3.5,4-10,4.5-5,5-10,5-merou,80,<,abaxial,abaxially,adaxial,adaxially,age,aid,along,alyx,angle,anthesi,apar,apice,appearance,ark,around,articulated,axi,branched,canop,cell,channelled,climbin,confined,connected,connivent,creating,cucullate,cupped,deflexed,dendritic,denser,eaf,eed,elongate,enlarged,especially,fide,fleshy,flower,free,furcate,giving,glabrou,groove,hairy,hanging,ilament,individual,irregularly,lamina,large,leaving,lengthening,like,lobed,lon,long,longer,loosely,lower,many,marginal,mere,minute,mpodial,nee,nflorescence,nodding,often,older,orolla,otherwise,outline,papillate,papillo,peg,perfect,pericarp,petal,petiolule,pinnatifid,plat,plurifoliat,pore,poricidal,portion,prominent,pubescence,reaching,rectangular,rim,ruit,scar,showy,similar,sleeve,slightly,slit,spaced,spreading,stellate-rotate,tangled,tem,testa,testal,thecae,thick,thickened,thin,third,time,tiny,tip,tooth,trichome,twining,ud,uniformly,uniseriate,unit,upper,usually,visible,wall,weak,weight,widest,wing,yellow,younger	1-8,2-4,2.5-10,arrangement,bark,branch,bud,characteristic,colour,exertion,form,glabrousnes,history,length,life,lobing,na,number,papillose,shape,size,texture,type
168	wfo-0001027720	success	184	116	89	95	27	0.484	0,0-15,0.25-0.35,0.3-5,0.5-0.8,0.8-1,1-1.5,1-2,1-3.5,1.5-2,15-25,2-3,2-4,2-7,2-branched,2-foliate,4-7,7-8,8-16,acute,anther,apex,articulated,base,berry,brown,calyx,chartaceous,cm,confined,connivent,cuneate,deltate,densely,diameter,distally,elliptic,entire,extra-axillary,filament,flattened,flower,fruit,glabrous,globose,green,hair,inflorescence,lanceolate,leaf,length,lilac,lobe,long,loosely,margin,markedly,midrib,mm,narrowly,notched,oblique,ovate,pale,part,pedicel,peduncle,per,perennial,petiole,pubescent,red,sessile,shrub,simple,slightly,sparsely,stellae,stellate,stellate-pubescent,stigma,style,subreniform,surface,thicker,triangular,tube,unit,yellow	%,.25-0.3,0.15-0.25,0.4-0.7,0.4-0.8,0.5-1,0.6-1.2,1-locular,13-23,13-35,2.8-3.1,23-35,3-13,4-,4-5.5,4.3-15,4.3-7.5,5-merous,6,7-10,7-9,8-11,9-15,abaxially,absen,absent,adaxiall,adaxially,adult,alyx,apparently,axe,ba,blade,capitat,cylindrical,directed,distall,eaf,eed,eglandular,erect,finger,fruiting,geminat,gland-tipped,half,hig,homostylous,incomplete,intepetalar,juicy,juvenile,lamina,lateral,less,lower,mature,mesocarp,mid-point,midpoint,minute,nflorescence,orolla,perfec,perfect,pore,porrect,present,prickle,rachi,ray,rhizomatous,ruit,scarce,septum,short,straight,succulen,tamen,tem,thick,time,tissue,toward,unarme,unarmed,upper,vary,white,wide,without,x,yellowi,ympodial	abaxial,adaxial,arrangement,branch,capitate,characteristic,colour,corolla,form,geminate,glabrousnes,growth,height,history,life,lobing,new,number,ovary,plant,seed,shape,size,stem,sympodial,texture,type
169	wfo-0001027720	success	272	158	133	139	25	0.489	.2,0,1.5â3.3,1.5â9.0,1.7â2.5,1.8â2.0,1/3,2.0,2.5â2.8,2â3,3.2,3.6,4.0â12.6,5.1â18.6,6.5â9.5,6â8,8.0â11.9,acuminate,acute,aequilateral,anther,apex,apical,apparently,appearing,attachment,attenuate,base,berry,bilobed,branch,broad,broad-based,calyx,cancellate,capitate,channel,cm,concave,conical,connivent,corolla,cream,crisped,curved,deciduous,developed,diameter,dry,elliptic,entire,erect,especially,extra-axillary,fertile,flattened-irregular,flattened-orbicular,flattened-reniform,flower,fruit,glabrous,glandular,globose,growth,hair,heavily,internode,interpetalar,juvenile,lateral,lavender,leaf,long,margin,mature,midpoint,minute,mm,narrowly,notched,oblique,often,orange,ovate,pedicel,peduncle,per,petiole,point,poorly,pore,porrect,portion,potentially,prickle,ray,red,scattered,sessile,short,shorter,shrub,side,simple,slightly,small,soon,stellae,stellate,stem,stigma,straight,style,subacute,subcoriaceous,surface,tissue,tree,triangular,twice-branched,unarmed,upper,violet,wavy,white,wide,yellow,yellow-ferruginous,yellow-tan,young,Â±equal,Ã,â4	.0,.04,.3,.5,.9,0.1â0.6,0.2â0.4,0.3â0.4,0.7â0.9,0.7â1.1,0.7â1.2,0.8â1.3,0.8â1.9,0.8â2.0,0.9,1.4â1.9,1.5â1.7,1.5â2.0,1.5â2.5,1.7â1.8,1.7â2.0,1.9â2.2,1/2,1/3â1/2,10.0,10.8â18.2,12â16,13.0,19.7â30.0,2.5,2.5â2.9,3.7â5.7,3.9,4.0â18.0,4â5-merou,8.0,8.2â10.5,8.5â9.4,9.5â16.0,abaxially,adaxially,adnate,alyx,anthesi,apiculate,armed,articulated,axe,ba,becoming,blade,brochidodromous,bud,channeled,colore,congested,dehiscence,densely,dentate,difoliate,distally,dorsally,eaf,eed,either,emerging,endocarp,exocarp,filament,filiform,free,geminat,glossy,gradually,homostylous,hooked,inclined,increasing,intersepalar,juic,lamina,large,least,like,line,lobe,lon,longer,lower,m.,major,midrib,midvein,minor,moderately,nearly,nflorescence,oblong,occasionally,orolla,part,perforate,porrect-stellate,presumably,proximal,pubescent,raised,reflexed,rigid,rip,row,ruit,sinus,sparsely,splitting,spread,stamen,stellate-pubescen,stellate-pubescent,suture,tall,tamen,tem,thin,time,tip,toward,translucent,truncate,tube,two,ud,vary,vein,way,weakly,yellow-ferruginou,ympodia,youngest	abaxial,adaxial,arrangement,characteristic,colored,colour,exertion,form,green,greyish,height,hirsute,history,inflorescence,length,life,number,ovary,perennial,plant,seed,shape,size,texture,type
170	wfo-0001027757	success	186	109	86	100	23	0.462	0.2â0.3,0.3â2.0,0.5,0â1.4,1.2â4.0,1.5â2.5,2.5,2.5â4,2â10,3â12,4â9,60â100,6â9,8â16,abaxially,anther,anthesi,apart,articulated,axillary,base,blue,borne,brown,calyx,campanulate,clavate,cm,colour,dark,deeply,diameter,elliptic,erect,filament,flattened,fruit,glabrous,globose,hair,irregularly,lanceolate,leaf,leafy,lilac,lobed,long,margin,mm,moderately,multicellular,narrowly,oblong,occasionally,often,ovate,pale,pedicel,peduncle,perennial,petiole,pitted,pubescent,regularly,rotate,shoot,shrub,simple,spaced,sparsely,stigma,style,surface,tube,unicellular,uniseriate,unknown,violet,white,woody,x,â19,â2.7,â3.2,â5.5,â6	0.2,0.6,0.6â1.0,0.7,1.0â1.1,1.0â2.5,1.5â1.6,1.6â2.4,1.9â2.7,12,1â1.5,1â11,1â2,1â3,2,2.5â5.5,2.5â7,2â,3â5,5,5â,7â8,absen,accrescent,acute,adaxiall,adaxially,ag,along,apex,apical,arising,axe,ba,basal,blade,branching,cell,chartaceous,concave,connivent,convex,cylindrical,decurrent,densely,directed,distally,eaf,eed,entire,equal,erose,fleshy,flower,geminat,glabrescen,glabrou,lobe,lon,longitudinal,lower,m.,nflorescence,obtuse,opening,opposed,orolla,pair,perfect,plurifoliate,pore,poricidal,primary,probably,rootstock,ruit,secondary,serrate,side,slit,smaller,sometimes,stone,straight,tall,tamen,tem,thic,thickened,time,tip,toward,unbranched,unit,vary,wide,yellow,ympodial,â4.0,â9	arrangement,characteristic,corolla,decurred,exertion,form,glabrousnes,growth,height,history,inflorescence,length,life,lobing,new,ovary,plant,seed,shape,size,stem,texture,type
171	wfo-0001027765	success	167	117	95	72	22	0.569	-30,-44,0.8,1,1-10,1-11.5,1-2,1-4,1-5,1.5-6,10-13,2-2.5,2-3,2-4,2.5-4,2.5-4.2,20-30,3-,3-12,5-15,5-6,5-8,7-20,abaxial,acumen,apical,apically,apiculate,branched,calyx,cell,cm,connate,corolla,covering,cyme,dehiscent,diameter,dichasial,dichasially,ebracteate,elliptic,exceeding,filament,forked,glandular,globose,green,hair,hair-like,herbaceous,interjected,introrse,lateral,leaf,leaflet,light,lobe,long,make,maturing,mm,monochasial,mucilaginous,odd-pinnate,often,ovoid,pedicel,peduncle,perennial,petiole,pilose,plant,poricidally,seed,short,simple,size,slit,stamen,stellate,stigma,straight,style,terminal,testal,thick,throughout,tone,tuber-bearing,violet,wall,white,wide,yellow	-4,0-.,1-,3-20,3-6-foliat,5,abaxially,abruptly,acuminate,acute,apex,articulate,base,cordate,cuneate,digestion,diminishing,distal,dorsally,eaf,edge,eed,elliptic-lanceolate,emoval,enzyme,flat,flower,folded,generally,globo,green-white,half,honeycomb,living,lon,lower,lunat,nflorescence,nther,oblique,obtuse,orolla,ovate,ovate-elliptic,ovate-lanceolate,pair,pattern,perfect,petiolate,petiolule,plan,proximal,reveal,rounded,ruit,sessile,seudostipule,side,slightly,specimen,tal,tem,throughou,tip,toward,truncate,typically,unit,vary,without,ympodial,Â¼	0-2,anther,arrangement,colour,form,fruit,growth,height,history,inflorescence,length,life,lunate,ovary,pseudostipule,shape,stem,surface,texture,type,wet,width
172	wfo-0001027807	success	116	95	78	38	17	0.672	.5,0-0.2,0.1-1,0.2-0.9,0.9-1,1-1.5,15-30,2-5,2-6,acuminate,acute,apex,attenuate,bark,base,berry,brittle,brown,bud,closely,cm,decurrent,deflexed,diameter,dry,drying,elliptic,flattened,flower,fruiting,glabrous,globose,gray,grayish,green,growth,internodal,known,lanceolate,leaf,leaf-opposed,margin,material,maturity,minutely,mm,narrowly,new,occasionally,pair,pale,papillae,papillate,parallel,pedicel,peduncle,petiole,pitted,primary,reddish,reniform,revolute,seemingly,shrub,simple,slender,slightly,small,somewhat,spaced,sparsely,stem,surface,tree,vein,white,winged,yellowish	0.2-0.3,0.3-0.4,0.9-2.5,3.5-9,abaxially,adaxially,almost,barely,deflexe,difoliate,eaf,eed,ellipti,geminat,know,midrib,nflorescence,older,ot,overlapping,paler,plane,prominent,rachi,reddi,reproductive,ruit,scar,shoot,thickened,ud,unifoliate,unit,usually,visible,x,ympodial,young	arrangement,characteristic,colour,form,fruit,glabrousnes,height,history,inflorescence,length,life,plant,seed,shape,size,texture,type
173	wfo-0001027816	success	187	136	112	75	24	0.599	.5,0.5-1,0.5-2,0.6-0.8,0.7-1,1-1.5,1-3,1.2-2,1.8-6,12-14,2-4,2/3,3-3.5,3.5-4,4-5,5-30,6-9,acuminate,acute,anther,anthesi,apex,attenuate,base,becoming,berry,bluish,branched,brown,calyx,capitate,cm,conical,corolla,dark,dense,densely,diameter,drying,ellipsoid,entire,erect,exserted,filament,filiform,flattened,flower,fruiting,glabrous,gland-tipped,glandular,globose,growth,half,inflorescence,lanceolate,lateral,leaf,less,like,linear,lobed,lower,margin,minute,minutely,mm,new,occasionally,often,orange,pair,patent,pedicel,peduncle,per,petiole,pitted,plant,primary,pubescent,purple,red,reddish,reniform,ripe,rounded,several,shrub,simple,slightly,sometimes,sparse,sparsely,stem,stigma,style,surface,terminal,time,tip,trichome,tube,ultimate,uniformly,uniseriate,vein,viscous,way,x,yellowish,Â½	..,0.2,0.5,1,1-1,1-4,1.5-2,2-2.5,5-merou,<,ag,almost,along,alyx,apar,ark,articulated,axi,cell,confined,connivent,cupped,eaf,eed,em,fleshy,free,ilament,irregularly,leaving,lengthening,lobe,loosely,m.,markedly,nflorescence,nodding,older,orolla,papillo,peg,perfect,perhaps,pericarp,plurifoliat,pore,poricidal,portion,prominen,pubescen,rectangular,ruit,scar,shiny,sleeve,slit,small,somewhat,spaced,spreadin,spreading,square,stellate,testal,thin,triangular,twinin,ud,unit,upper,usually,variable,vary,woody,ympodial	arrangement,bark,branch,bud,characteristic,colour,exertion,form,fruit,glabrousnes,height,history,length,life,lobing,na,number,ovary,papillose,seed,shape,size,texture,type
174	wfo-0001027819	success	199	118	93	106	25	0.467	10-20,10-50,12-21,16-25,2-,2-15,20-35,22-35,3-40,3-5,3-5-lobed,4,4-10,4-15,4-25,4-5,5,5-6,9-12,abaxially,acute,adaxially,apex,apical,basal,base,branched,cm,concave,cordate,cuneate,deeply,densely,diameter,ellipsoidal,entire,especially,fading,finely,fleshy,forked,fruit,glabrous,globose,green,leaf,length,lobe,lobed,long,margin,mm,narrowly,oblique,oblong,obtuse,occasionally,often,pedicel,peduncle,per,petiole,pilose,pinnately,probably,protuberance,puberulent,purple,rachi,rarely,rugose,simple,sometimes,sparsely,stellate,stigma,style,sympodial,tree,triangular,truncate,two,umbrella-shaped,unbranched,unit,unknown,unlobed,usually,whitish,wide,without,x,yellow	-100,0.5-1,1,1-,1-2,1-5,1.5-2,15-22,2,2-3,20-25,20-40,25-35,5-merous,8-10,aggregate,also,alyx,apart,ape,apiculat,articulated,axe,ba,beyond,blade,cell,ciliate,color,connective,cylindrical,denser,dia,diamete,dilated,directed,distally,divided,eaf,eed,eglandular,eglandular-pilose,elliptic,elliptic-ovate,equal,exceeding,except,exserted,flower,hair,halfway,leaving,lon,lower,main,mesocarp,midrib,moderately,narrow,near,nflorescence,nther,obtu,orolla,ovate,pedicellar,perfec,perfect,pore,present,prominent,puberulen,puberulence,purplish,radiu,ranch,ratio,remnant,ripe,rounded,rown,ruit,runk,shallowly,short-acuminat,shorter,sinus,slightly,small,spaced,stamen,stone,strongly,subcoriaceous,swelling,tal,thecae,toward,tube,ud,uni,vary,vein,villous,width,young	anther,arrangement,branch,bud,calyx,characteristic,colour,corolla,crown,form,growth,height,history,inflorescence,life,ovary,perennial,plant,seed,shape,short-acuminate,size,surface,texture,trunk
175	wfo-0001027834	success	236	132	108	128	24	0.458	-6.1,0-110,0.2-0.3,0.2-0.6,0.5-2,0.9-1.8,1-1.9,1-10,1.1-1.6,1.1-1.8,1.4-2,10-25,2-8,25,3-15,4-5.2,5-merous,6.9-18.1,9-13,abaxial,accrescent,acuminate,acute,adaxial,angled,anther,anthesi,apex,attenuate,bark,base,berry,blunt-tipped,branch,branched,brown,bud,calyx,cm,completely,corolla,covering,deltoid,diameter,drying,ellipsoid,entire,enveloping,filament,finely,fleshy,flower,fruit,fruiting,globose,granular-tomentose,gray,grooved,hair,included,leaf,lenticular,light,longitudinally,margin,mm,multangulate,obovate,obtuse,orbicular,ovate,ovate-elliptic,pair,pedicel,peduncle,petiole,porrect-stellate,primary,rachi,rarely,reticulate-punctate,ripe,rounded,scabridulous,semi-spherical,short,shrub,simple,small,soft,sometimes,stalked,stem,stigma,style,subcampanulate,surface,tree,turbinoid,vein,velutinous-tomentose,white,whitish,whitish-tomentose,x,yellow,yellowish,yellowish-tan	.5-3,0.2-0.4,0.4-1.1,1-1.6,1-2.5,1.6-2.7,1.8-4.9,1/2,2-3.8,2.2-4.3,2.3-3.4,2.4-6.2,2.7-7.3,2.9-4.2,3-4.3,4-6,4.8-6.9,5-20,5.1-8,9-11.9,abaxially,absent,adaxially,ag,alyx,apar,apical,around,articulated,axillary,ba,becoming,blade,branching,capitat,closely,concentrated,connivent,coriaceous,crown,cylindrical,dendritic-echinoi,dendritic-echinoid,densely,dichasia,directed,discolorous,distally,eaf,echinoi,echinoid,edge,eed,enclosing,equal,erec,exserted,farinose,flat-topped,forming,glabrescent,glabrous,high,inserted,lengthening,less,lobe,lobed,long,long-stalked,longitudinal,lower,many,mostly,multangulat,near,nflorescence,numerous,obscured,older,orolla,ovate-lanceolate,perfec,persistent,plurifoliate,pore,poricidal,pseudo-terminal,pubescence,pubescent,ray,ruit,runk,scar,semi-ovate,sessile,short-stalked,slit,somewhat,spaced,sparsely,spreading,stamen,stellate,stellate-pubescent,subcoriaceous,suture,tamen,though,time,tip,tomentose,tomentu,tomentum,toward,trichome,tube,ud,unarme,unit,usually,vary,villous,way,wide,yellowish-tomentose,ympodial,young	arrangement,capitate,characteristic,colour,exertion,form,growth,height,history,inflorescence,length,life,lobing,ovary,perennial,plant,pseudoterminally,seed,shape,size,texture,trunk,type,unarmed
176	wfo-0001027843	success	154	147	103	51	44	0.669	.5,.75,0.5-0.75,0.5-1,0.8-3.5,1-1.2,1-1.3,1-1.5,1.2-1.5,3-15-flowered,3-6,5-6,6-13,6-9,acute,along,anther,anthesi,apex,bark,base,bearing,becoming,beneath,berry,broadly,calyx,clavate,cm,conical,corolla,curly,densely,dia,distally,ellipsoid,erose,exsertion,filament,flower,fruiting,glabrate,glabrous,globose,green,hairy,lamina,later,lateral,leaf,like,lobe,lobed,long,long-acuminate,main,margin,minutely,mm,near,nearly,older,one,ovary,ovate,pair,papillose,pedicel,petiole,pleated,pubescent,reflexed,shape,shaped,shrub,simple,sinus,size,slender,slightly,somewhat,sparsely,sparser,stem,stiff,stigma,straight,strongly,style,surface,tapering,tear-drop,time,tipped,trichome,tube,two,uniseriate,vein,white,winged,x,young	/3,1.2-2.5,2-2.5,2-4,apart,apiculate,ba,beginning,coroll,deflexed,deltoid,denser,differing,difoliate,eaf,edicel,eed,free,geminat,impressed,irregularly,known,larger,lon,lower,major,middle,minor,nflorescence,occasionally,opposite,orbicular,papillo,pore,poricidal,portion,prominent,proximal,reddish-gre,rounded,ruit,scar,spaced,tall,tip,ud,unit,way,widest,woody,ympodial	appearance,arrangement,border,branch,bud,characteristic,colour,corrugation,diameter,distal,drying,exertion,form,fruit,giving,glabrousnes,growth,height,history,inflorescence,interjected,leaflet,length,life,lobing,midpoint,na,new,number,peduncle,per,plant,prickle,primary,pseudostipule,ray,reddish-grey,seed,terminal,texture,thicknes,type,variation,width
177	wfo-0001027847	success	219	127	105	114	22	0.479	-2.5,-4,-6,.35,/3,0-2,0.4-1,0.8-0.9,0.8-1.2,1-2.5,1.5-2,1.5-2.5,1.5-5,1/4,2-2.8,2-3,2-4,2-5,3-6,acute,almost,anther,apex,apparently,articulated,bark,base,berry,calyx,chartaceous,cm,connivent,cordate,curved,deltate,densely,diameter,discolorous,drying,dull,elliptic,erect,evenly,filiform,finely,flattened,flattened-reniform,fruit,fruiting,glabrescent,glabrous,gray,green,lateral,leaf,length,lobe,lobed,long,margin,maturity,mauve,middle,mm,narrow-deltate,orange,orange-brown,ovate,pedicel,peduncle,perpendicular,petiole,pitted,poricidal,prickle,purple,red,red-brown,retrorse,rounded,seed,shrub,side,simple,size,smooth,sometimes,sparsely,spherical,stellate-pubescent,stem,straight,strongly,style,surface,tapering,terminal,tip,upper,way,weakly,white,wide,yellow,young	-0.8,-2,-3,-5,.7,/2,0,0-7,0.1-0.4,0.15-0.2,0.2,0.5,0.5-1,0.8,1,1-2,1.9-2.3,1/2,1/6-1/3,2.2-3,2.5-3.5,2/,3-15,3-5,3.5-6,4-5-merous,5-25,5-6,5.5-8,6-11,6-8,7-10,abaxially,alyx,ame,apar,apart,apically,blade,branched,broadly,brow,c.,dimorphic,distance,eaf,edge,eed,elongating,equal,extending,faint,filament,filiform-acuminat,flower,free,geminate,increasing,infructescence,lon,longer,lower,mature,midpoint,midvein,minor,moderately,nflorescence,older,one,open,orbicular,orolla,oung,pair,pendulous,per,perfec,pericarp,pit,plurifoliat,porrect,portion,prickl,prickly,primary,ray,reddish,ruit,scandent,scar,sessile,slender,spaced,spreading,stalk,stalked,stellate,tamen,terete,tertiary,time,toward,trichome,tube,unarmed,unit,usually,variously,vary,vein,venation,visible,ympodial	abaxial,adaxial,arrangement,brown,characteristic,colour,corolla,form,growth,height,history,inflorescence,life,lobing,ovary,perennial,plant,shape,staman,texture,type,width
178	wfo-0001027872	success	190	118	93	97	25	0.489	1,1-4,1-8,1.0-1.3,15,2,2-3,2.2-3.5,20,35,5-7,5-8,5-lobed,6-20,8-11,angular,apical,apically,articulate,base,branched,ca,calyx,cell,clasping,cm,connate,covering,cyme,deep,dehiscent,diameter,dichasial,dichasially,ebracteate,elliptic,filament,forked,glandular-pubescent,globose,gray-green,green,hair-like,herbaceous,homogeneously,introrse,lanceolate,lateral,light,long,make,maturing,middle,mm,monochasial,mottled,mucilaginous,narrowly,odd-pinnate,often,ovate,ovoid,pedicel,peduncle,perennial,plant,poricidally,purple,rarely,rhizomatous,rotate,seed,semi-lunate,shape,short,size,slightly,slit,sometimes,stigma,straight,style,symmetrically,terete,testal,thick,tinged,type,usually,wall,wide,yellow,yellowish-green	0.5,1-1.2,1.5-4,10,12-35,2.8,3-6-foliat,4-6,5-10,abaxially,acumen,acuminate,acute,adaxially,apex,apiculate,b,ba,basal,becoming,caudate,celled,commonly,cordate,cuneate,decreasing,densely,digestion,distal,eaf,eed,emoval,enzyme,erect,exceeding,externally,flower,four-celled,generally,glabrescent,gland,glandular,globo,green-white,half,honeycomb,interjected,leaflet,living,lobe,lon,longer,lower,moderately,nearly,nflorescence,nther,obliquely,oblong,orolla,pair,pattern,pentagonal,perfect,petiolate,petiolulate,petiolule,puberulent,pubescent,purpl,reduced,reveal,rhizome,rotate-,rounded,ruit,sessile,seudostipule,single,somewhat,specimen,stamen,ste,subequal,tem,terminal,tip,trailing,typically,unbranched,uniformly,unit,vary,viole,wid,wider,ympodial	abaxial,adaxial,anther,arrangement,characteristic,colour,corolla,form,fruit,growth,height,history,inflorescence,leaf,length,life,ovary,pseudostipule,rotate-pentagonal,stem,surface,texture,violet,wet,width
179	wfo-0001027880	success	185	111	92	93	19	0.497	-3.5,.25,0.3-3,0.5-1.5,0.5-5,0.6-1,0.6-1.5,1-14,1-2,1.5-2,10-15,2-80,4-10,4-6,5-8,acuminate,acute,along,anther,apex,apiculate,base,calyx,clavate,cm,conical,cordate,coriaceous,cylindrical,densely,diameter,discolorous,distichous,entire,epiphytic,filament,flattened,flower,fruit,glabrous,globose,green,greenish,hair,inflorescence,internode,leaf,lower,margin,minutely,mm,oblique,oblong,oblong-ovate,often,ovate,ovoid,pale,papillose,pedicel,peduncle,perfect,petiole,pink,pubescent,purple,rachi,red-brown,revolute,ripe,rounded,rugulose,scar,shrub,size,slender,slightly,sometimes,somewhat,sparsely,stellate,stigma,style,surface,tan,truncate,unbranched,undulate,vine,white,x,yellow	-3,0.8-1.5,1-15,1-2.5,1-3,1.5-3,2-3,2/,3-4,5-11,5-merou,8,abaxially,absen,accrescen,adaxially,ag,aggregate,alyx,apart,apparently,articulated,axe,ba,blade,branch,branching,cell,chartaceous,ciliat,connivent,contiguously,curled,deltate,dense,diminishing,directed,distally,distinct,distinctly,eaf,eed,equal,extra-axillary,fruiting,geminat,growing,increasing,leaf-opposed,line,lobe,long,longer,longitudinal,midvein,multicellular,nearly,nflorescence,node,occasionally,opening,orolla,pair,plurifoliate,point,pore,pubescen,reddish,rooting,ruit,secondary,simple,slit,spaced,ste,stone,tamen,tem,thickened,time,tip,trailing,tree,trunk,tube,typically,uniseriate,unit,usually,vary,vein,wide,ympodial	2/3,abaxial,arrangement,characteristic,colour,corolla,form,glabrousnes,growth,history,length,life,new,ovary,seed,shape,stem,texture,type
180	wfo-0001027880	success	170	109	87	83	22	0.512	.25,0.5,0.6â1,0.6â1.5,0.8â1.5,1.5â2,1.5â3,10â15,1â14,1â2,2/3,2â3,4â10,4â6,5â8,absent,acuminate,acute,along,anther,apex,apiculate,arrangement,base,berry,bluish-purple,calyx,chartaceous,clavate,cm,conical,cordate,coriaceous,cylindrical,densely,diameter,distichous,entire,extra-axillary,flattened,flower,fruit,glabrous,globose,greenish,leaf,leaf-opposed,lower,margin,membranous,minutely,mm,nearly,oblique,oblong-ovate,often,ovate,ovoid,papillose,pedicel,peduncle,petiole,pink,pubescent,rachi,revolute,rounded,rugulose,sand-punctate,shrubby,slender,slightly,sometimes,somewhat,sparsely,stellate,stigma,style,surface,tan,truncate,unbranched,undulate,vine,white,woody,x	0.2-0.5,0.3â3,0.5â1.5,0.5â5,1â15,1â2.5,1â3,2-80,3â4,5-merous,5â11,8,abaxially,accrescen,adaxially,alyx,apar,axe,blade,c.,capitat,ciliat,climbing,contiguously,curled,deltate,dense,discolored,distinct,distinctly,eaf,eed,filament,fruiting,green,hair,lanceolate,line,lobe,long,longer,m.,midvein,mottled,nflorescence,nternode,occasionally,orolla,pair,pale,perfec,pinnate,plurifoliat,red,reddish,reddish-brown,rip,ruit,sand-punctat,scar,secondary,simple,spaced,ste,tamen,tem,thickened,time,tip,tree,trichome,trunk,tube,typically,uniseriate,unit,vary,vegetatio,vein,venation,wide,ympodial,â3.5	abaxial,adaxial,capitate,characteristic,colour,corolla,form,glabrousnes,growth,history,inflorescence,length,life,new,ovary,perfect,seed,shape,size,stem,texture,type
181	wfo-0001027881	success	215	130	76	139	54	0.353	-3,acute,almost,anther,apex,articulated,attenuate,base,berry,blackish,calyx,camptodromous,chartaceous,ciliate,cm,connivent,contiguous,cordate,cordiform,densely,diameter,drying,entire,extra-axillary,few-,filament,flattened,flower,fruit,giving,glabrous,globose,greenish,groove,herb,immature,impression,lateral,leaf,light-brown,lobe,many-branched,margin,maturity,membranaceous,mm,moderately,netlike,ovate-elliptic,parallel,pedicel,peduncle,per,petiole,primary,projection,pubescent,raised,reniform,rotate,seed,sessile,simple,size,stem,stigma,style,subopposite,surface,translucent,triangular,tube,vein,white,yellow,Ã	.3â0.5,0.5â2.2,0.8â1.5,1-celled,1.3â2,1.8â2.9,10â25,1â2,1â2-celled,1â2.5,1â2.6,1â3,1â3-celled,1â4,2.5â3.6,20â40,2â4,2â6,2â7,4â6,4â9.5,5,5-merous,6â10,7â14,7â9,8,abaxially,absent,abundant,accrescent,acuminate,adaxiall,adaxially,alyx,appressed,asymmetric,axe,ba,barely,blade,bulge,capitat,case,central,closely,commonly,connected,curved,cylindrical,decurrent,dehiscing,denser,difoliate,directed,dorsally,eaf,ed,eglandular,emarginate,emerging,equal,erect,exceeding,exclusively,explosively,eye,fewer,forming,frequent,geminate,glandular,hair,half,held,hollow,interpetalar,introrsely,larger,less,like,long,longer,longitudinal,lower,mainly,maturit,mesocarp,mixed,much,multicelled,multicellular,naked,near,nflorescence,normally,one,opening,orolla,other,pair,part,perfec,placenta,pore,pressure,prominent,pubescence,rachi,ruit,secondary,short,side,similar,slightly,slit,small,smaller,solitary,sometimes,sparsely,stalk,staman,stamen,subapically,tal,tamen,tem,tissue,two,unbranched,unit,vary,venation,visible,watery,winged,woody,ympodial	0.5-2.2,0.8-1.5,1-2,1-2.5,1-3,1-4,1.8-2.9,10-25,2.5-3.6,20-40,6-10,7-14,7-9,appearance,arrangement,bark,border,branch,bud,capitate,characteristic,colour,corolla,corrugation,distal,exertion,form,fruiting,glabrousnes,growth,height,history,inflorescence,interjected,leaflet,length,life,lobing,midpoint,na,new,number,ovary,plant,prickle,pseudostipule,ray,shape,terminal,texture,thicknes,type,variation,width
182	wfo-0001027882	success	184	147	126	58	21	0.685	.25,.5,0.1,0.5-1,1,1-5,1.5-,1.5-2.2,1.5-6,10-40,2-3,2-lobed,2.1-2.6,2.5-3,3-4,6-9,9-13,abaxially,acuminate,adaxially,age,along,anther,anthesi,apex,apparently,appearing,attenuate,axil,bark,base,berry,branch,branched,broadly,brown,c.,calyx,clavate,cm,completely,conical,corolla,dark,diameter,dry,drying,elliptic,entire,erect,exerted,filament,flattened,flower,fork,fruiting,fusiform,glabrous,globose,green,growth,hairy,hollow,inflorescence,junction,lamina,leaf-opposed,lengthening,less,lobed,margin,maturity,midrib,minutely,mm,new,nodding,occasionally,ovary,ovoid,pair,pale,paulo,pedicel,peduncle,petiole,pitted,pointed,population,pore,poricidal,primary,rarely,reddish,reniform,shattering,shiny,shrub,simple,slender,slit,small,sometimes,sparse,sparsely,specimen,stem,stigma,stout,strongly,structurally,style,surface,sÃ£o,time,tip,tree,trichome,tube,uniseriate,usually,vein,way,white,yellow,yellowish	06a,1-1.5,1.5-2,1.6-2.2,10-25,2-6,3.2-6,3.5-4,3.5-5,4-5,7-,absent,apart,branching,caly,cucullate,deltate,dense,densely,difoliate,eaf,eed,et,fide,free,geminat,glabrou,hooked,irregularly,kallunki,lobe,lower,markedly,nflorescence,papillat,papillate,penden,perfect,planar,plane,portion,pulp,rachi,red-papillat,ruit,scar,spaced,sticky,straight,sweet-scented,swollen,thickened,tuft,ud,unit,woody,x,ympodial	arrangement,bud,characteristic,colour,exertion,form,fruit,glabrousnes,height,history,leaf,length,life,lobing,plant,red-papillate,seed,shape,size,texture,type
183	wfo-0001027889	success	151	126	100	51	26	0.662	-pubescent,.5,0.5-1,0.5-11,0.7-2,1,1-3,1-3.5,1.5,10-12,10-20,10-30,2-3,3-4,3-8,abaxially,acuminate,acute,acute-acuminate,adaxially,apart,apex,apiculate,basal,base,calyx,chartaceous,cm,connective,connivent,cylindrical,darker,deltate,densely,diameter,dilated,directed,distally,eglandular-puberulent,eglandular-pubescent,elliptic,entire,equal,exceeding,finely,flower,fruit,glabrous,glandular-,green,greenish,immature,introrse,laterally,length,light,lobe,long,longitudinal,margin,mm,moderately,oblong,ovate,ovoid,pedicel,peduncle,petiole,pore,probably,puberulent,puberulent-pubescent,rachi,radiu,remnant,ripe,shrub,simple,slightly,somewhat,sparsely,stellate,stigma,stripe,style,subcordate,subcoriaceous,thecae,tip,tomentose,tree,triangular,truncate,tube,unbranched,unknown,violet,white,x,yellowish	-2.5,.5-2,0,1-10,1.5-2,2-20,3-9,4-foliat,5-10,aggregate,ape,articulated,axe,beyond,blade,capitat,cell,color,eaf,eed,exserted,extending,leaving,lon,lower,narrow,nflorescence,nther,orolla,pedicellar,perfect,presen,present,puberulen,puberulent-pubescen,ruit,small,spaced,stamen,stone,swelling,tal,tem,time,tomento,ud,unit,vary,wide,yello,ympodial	1-2.5,abaxial,adaxial,anther,arrangement,bud,capitate,characteristic,colour,corolla,direction,form,growth,height,inflorescence,leaf,ovary,plant,seed,shape,size,spacing,stem,surface,texture,yellow
184	wfo-0001027901	success	156	112	91	65	21	0.583	.5,0.3-1.2,0.8-1,0.8-2,0.9-2.3,1-1.5,1-2,1-2.5,1.5-1.8,1.8-4.5,3-5,4-5,4.7-12,abaxial,abaxially,acuminate,acute,adaxially,anther,apex,area,attenuate,bark,base,berry,bright,broadened,brown,calyx,cm,corolla,curled,dark,densely,dia,dry,drying,ellipsoid,elliptic,exserted,fresh,fruiting,glabrous,globose,green,immature,inflorescence,later,leaf,like,lobed,long,material,minor,minutely,mm,nearly,orbicular,ovary,ovoid-reniform,papillose,pedicel,petiole,pitted,pubescent,reddish,ripe,rounded,shape,shaped,shiny,shrub,simple,size,slender,sparsely,stem,stigma,strongly,style,surface,tear-drop,tip,translucent,trichome,tube,uniseriate,white,x,yellow,young	.25,0.5-1,2.5-3,4-10-flowered,6-7,?,anthesi,ba,beneath,brow,closely,conical,deflexed,differing,difoliate,direction,eaf,edicel,eed,filament,firm,fleshy,free,geminat,imbedded,keeled,lateral,lobe,lon,lower,main,major,matrix,middle,midrib,nflorescence,older,opposite,oriented,overlappin,pair,papillo,planar,pore,poricidal,portion,prominently,reflexed,rest,ruit,scar,single,spaced,straight,swollen,tall,triangular,tub,ud,unit,usually,vein,widest,woody,ympodial	adaxial,alternate,arrangement,bud,characteristic,colour,diameter,form,fruit,growth,hair,height,history,length,life,lobing,peduncle,plant,seed,texture,type
185	wfo-0001027902	success	128	129	76	52	53	0.594	-2.5,0.5-1,1-1.5,1.5-3,10-20,15-30,2,2-15,2-8,20-50,3-4,3-5,4-25,4-5,5-20,6-37,7-9,8-13,abaxially,acuminate,acute,adaxially,angled,apex,base,branched,calyx,chartaceous,cm,cordate,deeply,densely,diameter,distally,eglandular,entire,flower,forked,fruit,glabrous,glandular,globose,hair,inflated,like,lobe,margin,mm,moderately,narrowly,nearly,obtuse,ovate,pedicel,peduncle,petiole,puberulent,pubescent,purple,reticulate,shrub,simple,small,sparsely,stigma,style,tip,tree,triangular,truncate,tube,unbranched,unknown,usually,whitish,x	1-2,1-6,10-15,2-12,2-3,2-9,3-foliat,absen,adaxiall,aggregate,apart,articulated,axe,blade,cell,color,connivent,cylindrical,directed,distall,eaf,eed,leaving,lon,long,lower,nflorescence,nther,orolla,pedicellar,pore,pubescen,purplish,rachi,radiu,remnant,ripe,ruit,spaced,ste,stellate,stone,subcoriaceous,tal,tem,time,truncat,unit,vary,wide,yellow,ympodial	anther,appearance,arrangement,bark,border,branch,bud,characteristic,colour,corolla,corrugation,distal,drying,exertion,filament,form,fruiting,giving,glabrousnes,growth,height,history,inflorescence,interjected,lateral,leaf,leaflet,length,life,lobing,midpoint,na,new,number,ovary,per,plant,prickle,primary,pseudostipule,ray,seed,shape,size,stem,surface,terminal,texture,thicknes,type,variation,vein,width
186	wfo-0001027929	success	193	118	93	100	25	0.482	1,1-10,1-4,1.5-4,10,15,2,2-3,2.0-3.0,20,3.5-5,35,4-5,5-10,5-6,5-lobed,6-15,acuminate,acute,angular,apex,apical,apically,articulate,base,branched,calyx,cell,clasping,cm,connate,cordate,corolla,covering,cuneate,cyme,deep,dehiscent,diameter,dichasial,dichasially,ebracteate,elliptic,filament,forked,glabrous,globose,green,hair-like,herbaceous,introrse,lanceolate,lateral,leaflet,maturing,middle,mm,monochasial,narrowly,obliquely,odd-pinnate,often,ovate,ovoid,pedicel,peduncle,perennial,petiolule,plant,poricidally,puberulent,purple,rhizome,rotate,rounded,seed,semi-lunate,shape,short,slit,sometimes,stigma,straight,style,symmetrically,terete,testal,thick,tinged,unbranched,violet,violet-blue,wall	0.2-0.9,1-8,1.0-1.3,3-6-foliat,4-30,4-6,abaxially,acumen,adaxially,along,apiculate,ba,basal,becoming,beyond,caudate,cente,center,coat,color,dark,darker-violet-blue,decreasing,digestion,distal,eaf,eed,embryo,emoval,enzyme,erect,exceeding,except,flower,formed,generally,globo,green-white,hair,half,honeycomb,included,interjected,light,living,lobe,lon,long,lower,make,mostly,mucilaginous,nearly,nflorescence,nther,oblong,occasional,orolla,pair,pattern,pentagonal,perfect,petiolate,petiolulate,purpl,radiating,rarely,reduced,reveal,rhizomatous,rotate-,ruit,sessile,seudostipule,size,slightly,somewhat,specimen,spot,stamen,star,ste,subequal,tem,terminal,tip,trailing,typically,unit,usually,vary,vein,visible,white,wid,wide,wider,without,yellow,ympodial	abaxial,adaxial,anther,arrangement,articulation,characteristic,colour,dehiscence,form,fruit,growth,history,inflorescence,leaf,length,life,occasionally,ovary,pseudostipule,rotate-pentagonal,stem,surface,texture,type,width
187	wfo-0001027948	success	186	106	80	106	26	0.43	-15,-16,-6,.5,0-,0.5-2,1-2,1.3-1.8,1.5-4.5,10-14,13,5,7,7-15,7.5-10,acuminate,anther,apex,basal,berry,branch,calyx,cm,corolla,diameter,directed,dorsally,edentate,ellipsoidal,elliptical,erect,filament,glabrous,globose,herb,herbaceous,hollow,ill-smelling,inconspicuous,leaf,length,light,longer,longitudinally,margin,mm,narrowly,occasionally,ovate,ovoid,pair,papillate,petiole,pubescent,purple,reduced,ridged,seed,serrulate,shorter,simple,slightly,small,stem,stigma,straight,style,sub-shrub,thickened,tip,tooth,triangular,tube,unequal,upward,violet,viscid-pubescent,x,Â¼,Â½	0.4,0.5-0.7,0.6,0.8-,1-1.2,1.2-2.2,1.6,1/10,14,2-,2.2-,2.5-,3-8.2,3.2-5.2,3.5,3.7-4,5-,6-celled,8-celled,abaxially,abundant,accrescen,adaxially,ag,aggregate,antrorse,ape,articulate,attenuate,ature,base,bicellular,c.,campanulate,cell,connectival,crushed,cuticle,dark,delicate,diamete,difoliate,eaf,finely,flexuous,fragrance,free,fruiting,generally,glandular,head,hig,inserted,lamina,lobe,long,long-stalked,longitudinal,lower,many-,midvein,narrow,near,non-glandular,odorles,opening,orolla,patent,pericarp,pore,poricidal,portion,prolongation,pubescence,ree,ruit,saddle-shape,scarce,scarcely,secondary,seeded,seen,separated,short-stalked,single-celled,sinus,slit,smooth,solitary,spur-like,stalk,stone,striat,striate,sub-opposite,tem,thecae,time,trichome,twice,unit,vary,vein,ventrifixed,verrucate,ympodial	2.2-8.2,2.5-5.2,abaxial,adaxial,arrangement,characteristic,colour,form,fruit,growth,height,history,life,lobing,na,number,ovary,per,perennial,plant,saddle-shaped,shape,size,surface,texture,type
188	wfo-0001027961	success	177	97	73	104	24	0.412	0.9-1,1-1.5,1-5,2-2.5,2.3-2.5,3-3.5,8-10,?,acute,anther,anthesi,apex,asymmetric,base,berry,c.,calyx,clavate,cm,cordate,corolla,densely,diameter,ellipsoid,elliptic,entire,exserted,fading,filament,fruiting,fusiform,glabrous,globose,green,growth,immature,inflorescence,lateral,lobed,margin,membranous,minute,mm,new,obovate,occasionally,often,pedicel,peduncle,petiole,pinnatifid,pubescent,purple,simple,slender,slightly,sparsely,stem,stigma,style,surface,terminal,triangular,trichome,truncate,tube,uniseriate,vine,violet,way,white,white-pubescent,woody	.5,0.25,0.25-0.5,0.5-1,1,1-3,1-4,1-9,10-50,2.5-9,4.5-5,5-8,5-merou,6-9,7-9,<,abaxially,adaxiall,adaxially,age,always,alyx,apar,ark,articulated,axil,branched,broadly,brow,clear,conical,connivent,curling,deltate,distributed,eaf,early,eed,equalling,flower,free,geminat,ilament,irregularly,lamina,lengthening,lobe,lon,long,loosely,lower,many,mature,maturity,midrib,minutely,nflorescence,observed,older,one,orolla,other,pair,papillo,pendan,perfect,pericarp,pinched,planar,plurifoliate,pore,poricidal,portion,present,primary,probably,pubescen,reddish,rotate-stellate,ruit,scar,shiny,sleeve,slit,small,spaced,spreading,tem,thin,time,tip,transition,tuft,twinin,twining,ud,unequal,unit,upper,vary,vein,x,yellow,ympodial	abaxial,adaxial,arrangement,bud,characteristic,colour,exertion,form,fruit,glabrousnes,history,leaf,length,life,lobing,na,number,ovary,per,seed,shape,size,texture,type
189	wfo-0001027966	success	207	155	129	78	26	0.623	0.8-2.5,1-1.8,1-10,1-2,1-3,1-4.2,1-5,1.2-4.5,1.3-2.2,1.5-5.2,10,10-30,2.2-2.9,2.5-10.5,2.8-9,3-5,3-7,4,40-80,5-10,5-6,5-9.5,5.5-14,6-11,abaxially,absent,acuminate,adaxially,anther,apart,apex,attenuate,axillary,base,berry,blade,blue-violet,brownish,bud,cell,chartaceous,ciliate,cm,condition,conical,corolla,covering,densely,diameter,distal,dorsally,drying,edge,elliptic,filament,flat,flower,folded,forked,fresh,fruit,generally,glabrous,green,green-white,greenish,hair-like,half,herb,homostylous,interjected,lanceolate,lateral,leaf,leaflet,lengthening,light,lobe,long,make,margin,medium,membranous,minute,mm,moniliform,mottled,mucilaginous,odd-pinnate,ovate,ovoid,pedicel,peduncle,pentagonal,petiole,plant,pore,poricidal,pubescent,purple,rarely,ripe,rotate,seed,semierect,sessile,size,slightly,slit,sparsely,stem,stigma,straight,subsessile,subtending,terminal,testal,thick,throughout,tip,tube,tuber,usually,wall,wet,whitish,wide,x,yellow	0.4-0.5,0.7-3,0.8,1.5-3,3-4,5-merou,acumen,ag,along,alyx,apparently,arranged,articulated,asymmetrical,axe,basiscopic,bead,capitat,commonly,connivent,decreasing,digestion,eaf,eed,enzyme,erec,especially,exceeding,geminat,glabrou,gradually,hair,honeycomb-shaped,larger,less,like,living,lower,middle,multiple,narrow,necklace,nflorescence,orbicular,orolla,pair,pale,perfect,petiolule,plurifoliate,proximal,ray,removed,ruit,secondary,seudostipule,shorter,side,somewhat,spaced,specimen,stamen,ste,stolon,subequal,symmetrical,tall,tamen,tem,tissue,tri-,tyle,typically,unit,violet,white,wing,ympodial	5-merous,abaxial,adaxial,age,arrangement,calyx,capitate,colour,erect,form,growth,height,history,inflorescence,length,life,number,poricity,pseudostipule,pubescence,shape,spacing,style,surface,texture,type
190	wfo-0001028014	success	222	109	86	136	23	0.387	-15,-2.5,-4,-6,/5,0.2-1,0.2-1.6,0.3-0.4,0.5-1,0.5-3,0.6-0.9,0.7-1,0.7-1.6,0.9-1.2,1-4,1.3-2.4,2-3,almost,anther,apex,apparently,articulated,bark,base,berry,black,brown,brown-green,cell,chartaceous,cm,cordate,densely,diameter,erect,flattened-reniform,fruit,fruiting,glabrous,gray,gray-green,lateral,leaf,length,lobed,long,margin,maturity,mauve,membranous,mm,obtuse,orange,outline,ovate,pair,pedicel,peduncle,petiole,pit,poricidal,prickly,primary,purple,raised,red,rough,rounded,seed,shiny,shrub,simple,spherical,stellate-pubescent,stem,style,surface,tapering,terminal,tip,vein,visibly,way,weakly,wide,yellow-green	-0.5,-1,-1/2,-10,-3,-5,.5,0,0.1-0.2,0.15,0.15-0.3,0.2,0.2-0.4,0.25,0.5,0.5-1.5,0.5-2,1-,1-10,1-2,1-3,1.5,1.5-2,1.8-3,1/4,1/4-2/3,2,2-20,2-4.5,2-6.5,2.5-4,3-10,4-10,4.5-7,5-merous,6-10,6-11,abaxially,acuminat,alyx,ame,apar,apart,apically,around,blade,branched,broad-deltate,c.,calyx,concolorous,connivent,curved,decurrent,deltate,difoliate,discolorous,distance,drying,eaf,edge,eed,elongating,equal,extending,eye,filament,flattened,flower,free,geminat,glabrescent,glabrou,gland,globular,herbaceous,infructescence,lobe,lon,longer,lower,mature,midpoint,midvein,moderately,naked,nflorescence,occasionally,older,one,open,orange-gra,orolla,oung,outer,pale,pendulous,per,perfec,pericarp,porrect,portion,prickl,prickle,ray,reduced,reflexed,ruit,scandent,scar,sessile,shorter,side,slender,smooth,sometimes,spaced,spreading,stalk,stalked,stellate,straight,strongly,tamen,terete,tertiary,time,trichome,tube,unit,vary,venation,visible,winged,yellow,ympodial	arrangement,branch,characteristic,colour,corolla,form,glabrousnes,growth,height,history,inflorescence,life,lobing,new,orange-gray,ovary,perennial,plant,shape,size,staman,texture,type
191	wfo-0001028017	success	158	129	76	82	53	0.481	-2.5,0.3-1,10-22,13-40,15-35,2,2-3,2-4,2.5-5,3,3-12,3-4,5-9,6-8,9-11,acute,apex,apiculate,base,beyond,brown,calyx,clavate,cm,connivent,cuneate,densely,diameter,eglandular-pubescent,ellipsoidal,elliptic,entire,exserted,flattened,forked,fruit,fusiform,glabrous,glandular-puberulent,green,greenish,immature,lanceolate,lobe,margin,mm,moderately,narrowly,oblique,obtuse,ovate,ovoid,pedicel,peduncle,petiole,pointed,pubescent,rarely,ripe,short-acuminate,simple,sometimes,sparsely,stamen,stigma,style,tip,tree,triangular,truncate,tube,unbranched,vein,white,x,yellow	1,1-10,1-2,1-3,1.5-2,15-50-flower,3-14,3-foliat,40-50,5,5-7,6-7,abaxially,absen,absent,acuminate,adaxially,aggregate,apart,ape,articulated,axe,basal,blade,cell,chartaceous,ciliat,connective,cream,cylindrical,directed,distally,eaf,eed,eglandular,eglandular-puberulent,exceeding,fleshy,flower,glandular,glandular-,hair,introrse,leaving,lon,long,lower,near,nflorescence,nther,orolla,pedicellar,perfect,pore,puberulen,purple,purplish,rachi,radiu,remnant,ruit,shorter,slightly,small,spaced,stellate,stellate-campanulate,stone,subcoriaceous,tal,tan,tem,thecae,time,tomentose,truncat,ud,unit,vary,wide,without,ympodial	anther,appearance,arrangement,bark,border,branch,bud,characteristic,colour,corolla,corrugation,distal,drying,exertion,filament,form,fruiting,giving,glabrousnes,growth,height,history,inflorescence,interjected,lateral,leaf,leaflet,length,life,lobing,midpoint,na,new,number,ovary,per,plant,prickle,primary,pseudostipule,puberulent,ray,seed,shape,size,stem,surface,terminal,texture,thicknes,type,variation,width
192	wfo-0001028033	success	157	83	64	93	19	0.408	1.4â1.8,3â5,4â12,4â5,50,6â12,acuminate,acute,anther,apex,ascending,attenuate,base,becoming,brochidodromous,brown,calyx,chartaceous,ciliate,cm,connivent,cyme,decurrent,deeply,densely,diameter,elliptic,entire,few-branched,glabrescent,glabrous,greenish,growth,herb,hispid-pubescent,lateral,length,light,like,lobed,long,margin,mm,new,oblong,pedicel,petiole,pubescence,rhizomatous,sessile,shiny,shrub,simple,slightly,solitary,stellate,stem,stigma,style,surface,unbranched,venation,white,woody	.6,1.5,1â4,1â5,2â3,2â4,2âfoliate,3,3â11,3â4,5-merou,5â7,abaxially,adaxiall,adaxially,along,alyx,anthesi,ark,blade,branch,capitat,cell,contiguou,cordate,cylindrical,darker,denser,directed,discolorous,drying,eaf,eed,emarginate,equal,eye,filament,florescence,flower,fruit,geminat,green,high,introrsely,know,known,linear-lanceolate,lobe,longitudinal,lower,mainly,membranaceous,midrib,naked,nearly,older,onto,opening,order,orolla,ovate-lanceolate,perfect,pore,poricidal,prominent,prostrat,pubescent,recurved,ruit,secondary,shin,shorter,slit,sparsely,spreading,straight,strongly,subapical,tamen,tem,trichome,tube,uniseriate,unit,unknown,upright,vary,vein,visible,wide,yellow,ympodial,Ã	arrangement,bark,capitate,characteristic,colour,corolla,form,glabrousnes,height,history,inflorescence,leaf,life,ovary,plant,prostrate,shape,staman,texture
193	wfo-0001028067	success	139	83	64	75	19	0.46	-30,0.5-1,0.5-1.5,0.5-2,1-10,1-11,1-2,1-3,1-7,1.5-2.5,10-25,2,2-2.5,2.5-3,3-5,3-7,5-7,6-18,7-11-compound,7-9,acuminate,acute,apart,apex,base,calyx,cm,cuneate,dark,diameter,elliptic-fusiform,elliptic-ovate,entire,flattened,fruit,glabrous,leaf,margin,mm,moderately,narrowly,pedicel,peduncle,petiole,pink,pinnately,puberulent,purple,rachi,rarely,shrub,simple,sparsely,stellate,stigma,strongly,style,tomentulose,triangular,triangular-deltate,truncate,unbranched,x,yellow	1,2-3,3-17,3-4,4-foliat,6-12,7-20,8-13,abaxially,adaxiall,adaxially,aggregate,along,articulated,axe,basiscopically,blade,cell,chartaceous,color,compound,connivent,cylindrical,decurrent,directed,distall,eaf,eed,especially,flower,glabrou,hair,lateral,leaflet,leaving,lobe,lon,long,lower,midrib,nearly,nflorescence,nther,obtuse,often,orolla,pedicellar,per,pore,puberulen,radiu,remnant,ripe,ruit,several,slightly,smal,spaced,stone,subcoriaceous,tal,tem,time,tip,truncat,tube,unequal,unit,unknown,upper,usually,vary,wide,ympodial,zigzag	anther,arrangement,characteristic,colour,corolla,form,growth,height,inflorescence,length,ovary,plant,seed,shape,size,spacing,stem,surface,texture
194	wfo-0001028069	success	253	132	100	153	32	0.395	0.1-0.3,0.4-0.5,0.4-0.8,0.5-1.8,0.6-1.1,0.6-4,0.7-1.5,0.8-1.2,1-2.7,1-3.5,1.4,1.5-2.0,1.6-3.2,10,10-12,2-17,2-3-branched,2-locular,3,5-25,acute,along,anther,anthesi,apex,appearance,articulated,base,basioscopically,bright,brown,calyx,cm,conical,corolla,decurrent,deep,deeply,densely,diameter,exserted,filament,fruit,fruiting,giving,glandular-villous,globose,green,hair-like,halfway,herb,imparipinnate,interjected,interrupted,lateral,leaf,leaflet,length,linear,lobe,lobed,long,margin,midvein,minute,minutely,mm,oblique,obovate,occasionally,orange,outgrowth,ovary,ovate,pale,pedicel,peduncle,per,perennial,petiole,plant,present,primary,pseudostipule,pubescent,rounded,shaggy,silky,simple,size,stem,stigma,straight,style,surface,terminal,thick,tube,wide,yellow	-0.4,-30,-6,.1,.1-0.2,.2,.5,0.05-0.1,0.1-0.15,0.1-0.2,0.1-0.5,0.1-0.6,0.2-0.3,0.2-0.5,0.3,0.3-0.4,0.3-0.45,0.3-0.6,0.3-0.7,0.3-1,0.4,0.4-1,0.5,0.5-0.7,0.5-2,0.7-1,0.7-1.3,1-2-celled,1-4.5,1.5-3.5,10-30,12,2-4,2-7,3-,3-foliate,4-celled,5-22,6-,<,abaxially,absen,abundant,accrescent,adjacent,adpressed,alternate,always,among,apical,appendage,appressed,axi,ba,basal,becoming,berry,bilaterally,bract,bracteole-like,cell,citru,column,composed,cone-shaped,cordate,cuneate,curving,dense,due,eaf,ebracteate,edicel,eed,eglandular,erect,flower,forming,fusion,glabrescent,gland,gland-tippe,gland-tipped,glandular,gree,half,head,included,initially,internode,larger,later,less,like,lime,lon,longer,longest,lower,maturity,middl,multicellular,narrowly,nflorescence,often,one,pair,patent,pentagonal,petiolule,population,procumbent,pubescence,quaternary,rarely,reflexed,robust,ruit,scarcely,scent,secondary,sessile,several,short,shorter,single-celled,slender,smaller,somewhat,staminal,sterile,strong,subopposite,symmetric,tangled,tem,tertiary,testa,tightly,toward,transparent,trichome,ud,unicellular,uniseriate,unit,usually,varying,viny,wall,weak,winged,ympodial	arrangement,border,bud,characteristic,colour,corrugation,distal,drying,exertion,form,glabrousnes,growth,height,history,inflorescence,life,lobing,middle,midpoint,na,new,number,prickle,ray,seed,shape,texture,thicknes,type,variation,vein,width
195	wfo-0001028075	success	196	100	80	116	20	0.408	1.5-2.5,1.6-2.7,10-35,2-4.5,2-6,2.5-10,5-14,5-17,5-7,5-8,5-9,7-13,7-30,8-12,abaxially,acuminate,acute,adaxially,anther,apex,base,berry,brownish,chartaceous,ciliate,cm,condition,corolla,cuneate,dark,diameter,drying,elliptic-lanceolate,filament,flower,forked,fresh,fruit,glabrescent,glabrous,globose,green,greenish,herb,homostylous,lanceolate,leaf,leaflet,light,long,margin,membranous,minutely,mm,mucilaginous,obtuse,odd-pinnate,ovate,ovate-elliptic,ovoid,pale,pedicel,peduncle,pentagonal,petiole,plant,puberulent,rotate,rounded,seed,size,slightly,stigma,style,terminal,wet,white,whitish,wide,x	.5,1-10,1-2,1-2.7,1-3,1.5-7,2-3,3-11,3-23.5,4-12,4-7,5-12,5-merou,absent,acuman,acumen,ag,along,alyx,apart,apparently,articulated,axe,axillary,blade,borne,broadly,bud,capitat,cell,connivent,covering,decreasing,differentiated,digestion,distal,distally,distinctively,dorsally,dot,eaf,edge,eed,end,enzyme,erec,especially,exceeding,flat,folded,geminat,generally,glabrescen,green-white,hair-like,half,honeycomb-shaped,interjected,larger,lateral,lengthening,ligulate,living,lobe,lower,make,middl,midrib,much,narrow,nflorescence,oblique,often,orolla,pair,perfect,petiolule,plurifoliate,pore,poricidal,purple,reflexed,removed,ruit,scattered,seudostipule,singly,slit,sometimes,spaced,specimen,stamen,star,stolo,straight,subcordate,subtending,tall,tamen,tem,testal,thick,throughout,tip,toward,tri-,tube,tuber,typically,unit,usually,vary,wall,wing,yellow,ympodial	abaxial,adaxial,arrangement,calyx,capitate,colour,form,growth,height,history,inflorescence,length,life,ovary,pseudostipule,shape,stem,surface,texture,type
196	wfo-0001028076	success	195	156	128	67	28	0.656	.5,0.4-0.5,0.5,1-1.3,1-10,1-2,1.2-2.2,1.8-2.2,110,12-22,13-14,2-12,2-5.4,2.2-2.6,2.2-3.7,2.5-4,2.6-3.8,4-5,4.5-7,5,5-20,5-6,5-6.5,7-8,absent,acuminate,anther,apart,apex,articulated,attenuate,axillary,base,berry,blade,borne,brownish,bud,cell,chartaceous,ciliate,cm,condition,conical,connivent,corolla,covering,densely,diameter,distal,dorsally,drying,edge,end,especially,filament,flat,flower,folded,forked,fresh,fruit,generally,glabrous,green,green-white,greenish,hair-like,half,herb,homostylous,interjected,lanceolate,lateral,leaf,leaflet,less,light,lobe,long,make,margin,medium,membranous,minute,mm,mucilaginous,odd-pinnate,ovoid,pedicel,peduncle,pentagonal,petiole,plant,proximal,pubescent,purple,rarely,ripe,rotate,seed,sessile,singly,size,slightly,stem,stigma,straight,style,subsessile,subtending,tall,terminal,testal,thick,throughout,tip,tube,tuber,typically,usually,wall,wet,whitish,wide,wing,x,yellow	1-3,2-3,2.5-3,5-merou,?,abaxially,acumen,adaxially,ag,alyx,apparently,axe,capitat,decreasing,digestion,eaf,eed,elliptic,enzyme,erec,exceeding,geminat,glabrou,gradually,hair,honeycomb-shaped,larger,lengthening,like,living,lower,nflorescence,obtuse,orolla,ovate,pair,perfect,petiolule,plurifoliate,pore,poricidal,pubescen,ray,removed,round,ruit,secondary,semierect,seudostipule,slit,spaced,specimen,stamen,ste,stolo,subequal,symmetrical,tamen,tem,thir,toward,tri-,unit,unwinged,vary,white,ympodial	5-merous,abaxial,adaxial,arrangement,articulation,calyx,capitate,colour,form,growth,height,history,inflorescence,length,life,number,ovary,presence,pseudostipule,shape,spacing,stolon,surface,texture,third,type,variation,width
197	wfo-0001028105	success	150	106	80	70	26	0.533	.5,0.3-1.5,0.5-2,0.6-1,1-1.2,1-1.5,1.5,1.5-1.8,2,2-2.2,3-5-celled,3-6,5-7-flowered,9.5-15,acuminate,anther,apex,attenuate,axil,bark,base,berry,bilobed,calyx,clavate,cm,conical,corolla,dark,dense,dia,difoliate,ellipsoid,elliptic,exserted,filiform,flattened-reniform,fruiting,glabrous,glandular,globose,green,incrassate,lamina,leaf,lobed,long,margin,mm,nearly,occasionally,ovary,pale,pedicel,petiole,pubescent,reddish-brown,scattered,shaped,shrub,simple,size,slightly,small,spreading,stem,stigma,strongly,style,tear-drop,tip,tree,trichome,tube,tuft,uniseriate,unit,vein,white,x	.1,.4,0.5,0.5-1,1-2.5,1.5-2,1.5-4.5,2-5,3.5-4,6-7,abaxially,acute,adaxially,anthesi,apar,apical,axi,ba,deflexed,differing,distinct,drying,eaf,edicel,eed,erect,evenly,filament,free,geminat,greenish-yello,lateral,like,lobe,lon,lower,main,major,middle,minor,minutely,nflorescence,older,olive-green,opposite,pair,papillo,papillose,pitted,planar,pore,poricidal,portion,projection,quadrate,reflexed,ruit,scar,spaced,sparsely,straight,surface,tall,tub,ud,widest,woody,yellowish,ympodial,young	abaxial,adaxial,arrangement,bud,characteristic,colour,diameter,exertion,form,fruit,geminate,greenish-yellow,growth,height,history,inflorescence,length,life,lobing,peduncle,plant,seed,shape,sympodial,texture,type
198	wfo-0001028109	success	205	105	88	117	17	0.429	-20,-7,0.4-0.8,0.4-1.5,0.45-0.65,0.5-1.2,0.6-0.8,0.8-1.5,0.8-1.6,1.5-2.5,1.5-5.5,12-40,2-4,2.3-2.9,2.5-5,2/3-3/4,20-60,3-,3-7,4-13,5-13,abaxial,acuminate,acute,adaxial,almost,anther,apex,apparently,bark,base,berry,bright,calyx,cm,cuneate,deltate,densely,diameter,dull,elliptic,entire,erect,evenly,flattened-reniform,fruit,fruiting,glabrescent,glabrous,green,green-brown,lateral,leaf,length,light,lobed,long,margin,maturity,mauve,mm,moderately,orange-brown,pedicel,peduncle,petiole,poricidal,prickle,recurved,red,red-brown,shrub,small,sometimes,spherical,stellate,stellate-pubescent,style,tapering,terminal,tip,tree,way,weakly,white,wide,yellow,young	-4,.5,/3,0.05-0.15,0.05-0.2,0.1,0.1-0.2,0.3,0.5-2.5,0.7,1.5-10,1/8-1/4,10-25,10-30,15-100,2-15,2.5-3,3.5-6,3/4,30-150,4-5-merous,5-30,8-12,8-15,8-25,abaxially,acut,alyx,ame,apar,apart,apically,articulated,blade,branching,brow,c.,chartaceous,connivent,curved,dimorphic,discolorous,drying,eaf,eed,elongating,equal,filament,flower,free,fully,geminate,gently,glabrou,gray-green,infructescence,lobe,long-styled,longer,lower,mature,midpoint,minor,multangulate,nflorescence,obtuse,occasionally,older,one,open,opening,orolla,oung,pair,per,perfec,pericarp,perpendicular,plurifoliat,porrect,portion,prickl,prickly,primary,ray,reflexed,ruit,scar,secondary,sessile,simple,slender,smooth,spaced,spreading,stalk,stalked,stem,straight,strongly,surface,tamen,terete,tertiary,time,trichome,tube,unarme,unarmed,unit,usually,vary,vein,venation,visible,woody,ympodial	brown,characteristic,colour,corolla,form,growth,height,inflorescence,ovary,plant,seed,shape,size,staman,texture,type,width
199	wfo-0001028115	success	165	119	96	69	23	0.582	-1.1,-5.2,.6,0.42,0.7-0.8,1-3,1.1-1.8,1.4-1.7,1.7-2.2,2-3.2,2.5-,3-4.5,3-5,4.7-,5-15,5-8.5,6-10,9-17,abaxially,abundant,acute,adaxially,alternate,anther,antrorse,apex,attenuate,basal,base,berry,blue,calyx,capitate,cm,diameter,ellipsoidal,elliptical,entire,especially,filament,glabrescent,glandular,globose,half,herb,herbaceous,length,light,linear,lobe,long,longitudinally,margin,mixed,mm,moderately,narrowly,nerve,non-glandular,oblong,one,opposite,ovate,pair,pale,petiole,pinnatifid,pinnatipartite,pinnatisect,prostrate,pubescent,rarely,ridged,scarce,seed,segment,similar,simple,slender,small,stem,stigma,style,trans-ovoidal,triangular,trichome,tube,tuberculate,unequal,unifoliate,uniseriate,violet,wide,winged,x,yellow	-2.5,.2,0.2-0.3,0.5,0.6-0.7,0.8-,1-2.4,1.3-1.8,1.8-3.5,12-13.5,2-,3-6.5,7-7.5,accrescent,acuminat,ag,amply,annular,articulate,blade,campanulate,coat,connectival,curved,difoliat,dorsal,eaf,eed,embryo,evident,exceeding,fruiting,glabrous,growing,hig,inflated,longer,longitudinal,lower,much,multi-seeded,near,opening,orolla,papery-scarious,papillo,pore,poricidal,portion,prolongation,ree,reticulate,ruit,slightly,slit,smooth,sometimes,strongly,styl,subsessil,tem,time,tip,unit,vary,venation,wider,width,ympodial	acuminate,arrangement,characteristic,colour,corolla,difoliate,form,fruit,growth,height,history,inflorescence,leaf,life,number,ovary,per,plant,shape,size,surface,texture,type
200	wfo-0001028131	success	208	127	103	105	24	0.495	.5,/5,0.1-0.3,0.2-1.5,0.3-0.7,0.4-0.8,0.5-1.1,0.7-1.1,0.8-1,0.8-1.1,1.5-3,1.8-2.2,1/5,2-2.8,2-6.5,3-6,4-6,5-6.5,absent,anther,apex,apparently,articulated,attenuate,bark,base,berry,branched,calyx,cell,chartaceous,cm,concolorous,connivent,cream,dark,densely,diameter,drying,dull,erect,filament,flattened-reniform,fruit,fruiting,glabrescent,green,herb,lateral,leaf,length,like,lobed,long,margin,marking,maturity,mauve,membranous,mm,narrow-obovate,narrow-ovate,obtuse,orange,orange-brown,outline,pair,pale,pale-brown,pedicel,peduncle,petiole,pit,poricidal,prickly,primary,purple,raised,red,rounded,shiny,simple,small,smooth,sparsely,spherical,spreading,stellate-pubescent,stem,style,surface,tapering,tip,tube,unarmed,upper,vein,visible,way,wide,yellow,yellow-green,young	-1.2,.1,0-0.6,0-2,0-3,0-30,0-4,0.05-0.2,0.1-0.15,1-10,1-3,1-4,1-5,1.5-5,1.8-2,1/4-2/3,2-4,2-5,2/3,5-8,5-merous,6-7,7-8,abaxial,abaxially,acuminat,adaxial,alyx,apar,apart,apically,blade,broad-deltate,curved,deltate,difoliate,distance,eaf,eed,elongating,epidermi,equal,extending,eye,filiform,flattened,flower,free,geminat,glabrous,gland,infructescence,lanceolate,lengt,lobe,longer,lower,mature,midpoint,midvein,moderately,naked,nflorescence,oblong,often,older,one,open,orolla,oung,pale-gra,pendulous,per,perfec,pericarp,porrect,portion,prickl,prickle,ray,reduced,reflexed,ruit,scar,sessil,sessile,shorter,side,sometimes,spaced,stellate,straight,strongly,sunk,tamen,terete,tertiary,time,trichome,unarme,unit,vary,venation,woody,ympodial	arrangement,branch,characteristic,colour,corolla,exertion,form,glabrousnes,growth,height,history,inflorescence,life,lobing,new,ovary,pale-gray,perennial,plant,seed,shape,size,texture,type
201	wfo-0001028148	success	157	109	78	79	31	0.497	-6,0.25-0.5,1-15,1-3.5,1.5,12-15,2-7,2.5-4,3.5-4,5-20,5-7,5-8,abaxially,acute,angled,apart,apex,apiculate,articulated,base,blue-black,branched,broadly,calyx,chartaceous,cm,dark,decurrent,deltate,densely,diameter,elliptic,entire,except,fruit,glaucous,globose,less,light-colored,lobe,margin,mature,minute,mm,moderately,narrowly,obtuse,orange,ovate,pedicel,peduncle,petiole,pink,plicate,puberulence,puberulent,purple,rachi,rhizomatous,ridge,ripe,rotate-stellate,scalloped,shrub,simple,smooth,sparse,stigma,style,surface,tapered,treelet,triangular,tube,violet,whitish,x,yellow	.5-4,0.5-1.5,0.6-3.5,0.75-2,1.5-2.5,10-30,15,2,2-3,20-50,3.5-9,4-10,4.5-10,5,5-10,6-18,absen,adaxially,aggregate,axe,ba,blade,cell,central,connivent,cylindrical,directed,distal,distall,eaf,eed,especially,fleshy,flower,fresh,glabrous,hair,highly,long,lower,many-foliat,margi,material,midrib,nflorescence,nther,often,orolla,part,perfect,plicae,pore,puberulent-pubescent,radiu,rarely,ruit,slender,slightly,smoot,sometimes,spaced,star,stone,succulent,tal,tem,thickened,time,tip,truncat,unbranched,unit,usually,vary,white,wide,winge,ympodial,young	0.5-4,abaxial,adaxial,anther,arrangement,articulation,branch,characteristic,colour,corolla,form,glabrousnes,growth,height,history,inflorescence,leaf,length,life,many-foliate,new,ovary,plant,seed,shape,size,spacing,stem,texture,truncate,type
202	wfo-0001028161	success	124	86	71	53	15	0.573	.5,0.1-0.25,0.25-0.5,0.7-1.7,1-1.5,1-2,1-2.3,2-5-flowered,2-9,2.5-3,3-4,3-7,4-5,6-9,abaxially,acuminate,acute,adaxially,along,apex,attenuate,bark,base,berry,branched,brown,cell,closely,cm,dendritic,densely,denser,dia,elliptic,fruiting,globose,green,incrassate,lanceolate,leaf,like,long,main,margin,minor,minutely,mm,narrowly,orbicular,outline,ovoid-reniform,pale,pedicel,petiole,pitted,pubescent,reddish-brown,rounded,shape,shrub,simple,sinuate,size,somewhat,sparsely,stem,surface,tan,trichome,vein,x	1-1.3,1.5-4.5,1/3,7.5-12,9-11,anthesi,arising,ba,branch,calyx,congested,consisting,corolla,deflexed,differing,difoliate,distal,eaf,edicel,eed,exserted,geminat,glabrescen,inflorescenc,later,lateral,lon,major,middle,nflorescence,obovoid,often,older,opposite,overlappin,pair,probably,pubescence,rest,ruit,scar,short,spaced,strongly,tall,tapering,thin,tub,ud,unit,widest,ympodial,young	characteristic,colour,diameter,form,fruit,growth,height,history,inflorescence,length,life,plant,seed,texture,type
203	wfo-0001028164	success	197	128	104	93	24	0.528	-1,/4,0.3-0.8,0.4-0.8,0.5-0.8,0.5-1,0.7-1.1,0.8-1.5,0.9-1.6,1-1.5,1-4.5,1/3,2.5-4.5,2.8-4,3-17,3.6-4.8,abaxially,acuminate,acute,anther,apex,apically,apparently,articulated,attenuate,bark,base,berry,branched,bright,calyx,cm,concolorous,dark,deltate,densely,diameter,drying,dull,elliptic,entire,erect,evenly,filament,flattened-reniform,fruit,fruiting,glabrescent,glabrous,glandular,gray,green,hair,lateral,leaf,length,long,margin,maturity,mauve,membranous,midvein,minute,mm,moderately,multangulate,obtuse,orange-brown,pale,pedicel,peduncle,petiole,poricidal,recurved,red,red-brown,sessile,shallowly,shrub,simple,sometimes,sparsely,spherical,stalked,stellate-pubescent,stem,style,surface,tapering,terete,terminal,tip,trichome,tube,unarmed,undulate,upper,variously,way,white,wide,yellow,yellow-green,young	-14,-6,-8,0-20,0.05-0.2,0.05-1.5,0.1,1,1.5-2.5,1.8-2.5,1/6-1/4,12-20,2-2.5,2.5-4,3-7,4-13,4-5-merous,4-7,4-8,6-8,8-15,8-17,abaxial,almost,alyx,ame,apar,blade,c.,connivent,curved,difoliate,eaf,eed,elongating,equal,eye,filiform,flower,free,geminat,glabrescen,glabrou,infructescence,less,lobe,lobed,long-acuminat,longer,lower,mature,midpoint,naked,narrow-deltate,nflorescence,often,older,one,open,orolla,oung,pair,per,perfec,pericarp,porrect,portion,primary,ray,reflexe,ruit,scar,shorte,shorter,side,smooth,spaced,spreading,stalk,stellate,straight,tamen,tertiary,time,unarme,unit,vary,vein,venation,visible,woody,yellow-gra,ympodial	arrangement,branch,characteristic,colour,corolla,exertion,form,glabrousnes,growth,height,inflorescence,lobing,long-acuminate,na,new,ovary,plant,seed,shape,size,stigma,texture,type,yellow-gray
204	wfo-0001028180	success	147	115	95	52	20	0.646	.5,1-1.2,1-1.5,1-1.8,1-3,15-28,2-2.2,2-3,2.5-3,20-30-flowered,3-4,5-6,5-8,7,abaxially,acute,adaxially,along,anther,anthesi,apex,attenuate,bark,base,berry,calyx,capitate,cm,conical,corolla,cucullate,dark,darker,densely,dia,distinctly,drying,elliptic,elongate,erect,falcate,fleshy,four-angled,fruiting,glabrous,globose,golden,green,larger,lateral,leaf,lobe,lobed,long,main,margin,midrib,minutely,mm,nearly,onto,opposite,ovary,ovoid-reniform,pale,papillose,pedicel,petiole,pinkish-white,pitted,planar,puberulent,pubescent,shaped,shiny,simple,size,small,somewhat,sparsely,stem,stigma,style,surface,tan,tear-drop,tip,tree,trichome,uniseriate,vein,white,winged,x,yellow-gray	.05,/2,0.7-1,1.5-5,3-10,4.5-5,8-10,ba,beginning,c.,closely,deflexed,deltate,differing,difoliate,eaf,eed,filament,free,geminat,glabrat,gold,irregularly,know,leathery,lon,lower,major,minor,nflorescence,obscure,older,overlappin,pair,pore,poricidal,portion,ruit,scar,spaced,straight,styl,tall,thick,tube,ud,underside,unit,way,woody,ympodial,young	bud,characteristic,colour,diameter,exertion,form,fruit,glabrate,growth,height,history,inflorescence,known,length,life,plant,seed,shape,texture,type
205	wfo-0001028182	success	150	95	65	85	30	0.433	0.1-0.2,0.5-0.6,0.8-1,0.9-1,1-1.5,2-2.5,2-6.5,3-5,4-6,6-9,anther,apex,arching,bark,base,beneath,branch,calyx,capitate,ciliate,cm,conical,cordate,corolla,ellipsoid,filament,filiform,glabrous,globose,inflorescence,later,lateral,leaf,lobed,long-acuminate,main,margin,mm,narrowly,nearly,obovoid,ovary,ovate,pair,pedicel,petiole,poricidal,pubescent,shiny,shrub,simple,slender,somewhat,sparsely,stem,stigma,style,surface,tip,truncate,tube,vein,white,x,young	.5,0-90,0.5,0.5-1,2,3,5-15-flowered,5-ribbed,along,anthesi,apart,apiculae,apiculate,axi,bending,black,blade,brown,deflexed,deltoid,densely,dia,dry,eaf,edicel,eed,evenly,except,extreme,flower,free,gre,hemiepiphyte,internodal,keeled,know,known,lax,less,like,lobe,long,lower,material,midrib,minute,minutely,nflorescence,older,opposite,papillo,papillose,planar,pore,portion,present,prominent,proximal,purplish,reflexed,rib,rounded,ruit,sca,scar,shaped,slightly,spaced,sparser,specimen,spindly,still,strongly,tapering,tear-drop,third,time,trichome,ud,unifoliat,uniseriate,unit,widest,ympodial,zig-zag	arrangement,bud,characteristic,colour,diameter,exertion,form,fruit,glabrousnes,grey,growth,height,hemiautotrophic,history,length,life,lobing,na,new,number,peduncle,per,plant,primary,seed,shape,size,texture,type,unifoliate
206	wfo-0001028183	success	237	107	81	156	26	0.342	-10,0.2-0.5,0.5-2.5,0.7-1.2,0.7-2,1.1-1.8,10-15,11-30,2-4.2,2-5,4.5-9,5.2-6.2,6.6-20,9-13,abaxially,adaxially,anther,apex,attenuate,bark,base,berry,blunt-tipped,branch,branched,bud,calyx,cm,corolla,cuneate,deltoid,diameter,dull,elliptic,entire,exserted,filament,flower,fruit,glabrous,globose,granular-punctate,lanceolate,leaf,many,margin,midrib,mm,narrowly,oblong,obovoid,orangish-tan,ovate-lanceolate,pedicel,peduncle,petiole,pseudoterminal,pubescent,purple,reticulate-punctate,ripe,scabrous,shrub,side,simple,soon,spherical,stem,streak,style,sub-lenticular,surface,tan,terete,time,tree,vein,violet,white,x,yellowish	-5.3,.5-3,0.1,0.1-0.2,0.1-0.4,0.1-0.9,0.2-0.3,0.2-0.4,0.5,0.6,0.8-1.4,0.8-3.1,1.2-1.4,1.3-1.4,1.3-1.7,1.4-2.8,1.5-3.4,1.6-2.3,1.7-2.7,1.9-3.7,1/3-1/2,2.2-5.7,2.5-4.1,2.6-4.4,2.8-4.2,3.2-,3.5-6.6,4.6-6.4,5-8,5-8.5,50-400,7.5-23,8-9.1,abaxial,accrescent,acute,ag,along,alyx,anthesi,apart,apparently,around,articulated,axi,axillary,blade,brown,capitate,cell,central,chartaceous,closely,cylindrical,dark,dendritic-multangulate,directed,distally,distantly,drying,eaf,earl,edge,eed,elongated,epidermal,especially,evident,except,farinose,few-rayed,free,fruiting,glabrescen,glabrescent,group,hair,half,high,inserted,lackin,lateral,lengthening,lobe,lobed,lon,long,long-decurrent,longitudinal,lower,m.,main,multangulate,nearly,nflorescence,older,open,orolla,overlapping,perfec,plurifoliate,pore,poricidal,porrect-stellat,porrect-stellate,present,prominent,pubescence,rachi,rarely,relatively,reportedly,ruit,runk,sessile,short,short-,slit,small,somewhat,spaced,sparingly,sparse,splitting,stage,stalk,stamen,stellate,stigma,stipitate-glandular,stout,strongly,subcampanulate,suture,tamen,thick,thin,thin-textured,tip,tomentose,touching,translucent,tube,ud,unarme,unit,upper,usually,vary,way,whitish,wide,yellow,yellowish-tomentose,ympodial,young	3.2-6.4,arrangement,characteristic,colour,exertion,form,glabrousnes,growth,height,history,inflorescence,length,life,lobing,new,ovary,perennial,plant,primary,seed,shape,size,sparely,texture,type,unarmed
207	wfo-0001028227	success	236	122	98	138	24	0.415	-6.2,0.2-0.3,0.2-0.4,0.8-1.4,1-1.7,1-4.2,1.2-2,1.3-4,1/2,10,10-24,11-15,2-12,2.5-7.8,3.7-7,4.8-7.6,6.7-15,abaxially,acuminate,acute,adaxially,anther,anthesi,apex,attenuate,bark,base,berry,blunt-tipped,branch,branched,brown,brownish,bud,c.,calyx,cm,corolla,cuneate,dark,decurrent,deltoid,diameter,early,elliptic,ength,entire,exserted,filament,fleshy,fruit,globose,granular-tomentose,gray,green,leaf,less,lobe,long,many,margin,midrib,mm,oblong,oblong-lanceolate,obtuse,orangish-tan,orbicular,ovate-lanceolate,pale,pedicel,peduncle,petiole,pseudoterminal,purple,reticulate-punctate,ripe,scabridulous,shrub,side,simple,slightly,stem,style,subcampanulate,sublenticular,subspherical,sulcate,surface,time,tomentose,tree,vein,velutinous,violet,x,yellow,yellowish	-2/3,.5-4,0-250,0.1,0.2,0.2-0.5,0.3,0.4,0.5,0.7-2.1,0.8,0.9,0.9-1.2,0.9-1.4,1,1-2.5,1.1-3.1,1.4,1.4-2.6,1.5-2.3,1.7-2.8,1.9,1.9-4.2,1.9-5.8,1/2-3/4,2-3.8,2.6-5.9,2.9-4.7,3-4.9,3.7-6.3,4-13,5-7.5,6-16,8.1-18,8.5-22,abaxial,accrescent,ag,age,along,alyx,apart,apparently,appressed,around,articulated,axillary,becoming,blade,blunt-tippe,closely,cylindrical,dendritic-echinoid,directed,distally,drying,eaf,echinoi,echinoid,edge,eed,elongate,farinose,flower,free,fruiting,glabrescent,glabrous,grayish,hair,high,inserted,lacking,lanceolate,lateral,lengthening,lobed,lon,longitudinal,lower,m.,main,midvein,mostly,multangulate,nflorescence,obscured,occasionally,often,older,orolla,ovate-orbicula,overlapping,perfec,plurifoliate,pore,poricidal,porrect-stellate,present,prominent,pubescence,pubescent,quarter,rachi,relatively,rounded,ruit,runk,sessile,slit,somewhat,spaced,sparsely,stalk,stamen,stellate,stigma,stout,suture,tamen,thick,thicker,thin,tip,tomentu,touching,tube,ud,unarme,unit,upper,usually,vary,way,well,wide,ympodial,young	arrangement,characteristic,colour,exertion,form,glabrousnes,growth,height,history,inflorescence,length,life,lobing,new,ovary,perennial,plant,primary,seed,shape,size,texture,type,unarmed
208	wfo-0001028228	success	143	109	86	57	23	0.601	.5,0.1-1.7,0.75,1-1.5,1.1-1.2,1.1-2.5,1.2-1.8,1.5-2,1.8-3.4,10-30-flowered,2-5,2-8,2.1-4.2,2.8-6.5,6-7,7.5-12.5,abruptly,age,anther,area,bark,base,becoming,berry,brown,calyx,clavate,cm,corolla,dark,deflexed,dia,difoliate,dry,elliptic,exserted,filament,fruiting,glabrous,globose,green,greenish-yellow,leaf,long,material,minor,minute,minutely,mm,narrowing,obovate,occasionally,ovary,ovoid,ovoid-reniform,pale,papillose,pedicel,petiole,pore,poricidal,portion,reticulate,shaped,shining,shrub,simple,slender,small,stem,stigma,straight,style,surface,tapering,tear-drop,terminal,thickened,tip,tree,tube,unit,usually,white,x,young	2,3/4,6-8,acute,anthesi,apex,ba,beginning,beneath,caly,campanulate,closely,coriaceous,deltoid,distal,eaf,edicel,eed,erect,fragrant,free,geminat,impressed,inflorescenc,lateral,lobe,lobed,lon,lower,main,major,margin,middle,nflorescence,older,opposite,overlapping,pair,planar,prominent,rounded,ruit,scar,shinin,slightly,spaced,styl,sweetly,tall,thick-margined,ud,vein,way,weight,widest,woody,ympodial	arrangement,bud,characteristic,colour,diameter,exertion,form,fruit,geminate,growth,height,history,inflorescence,length,life,perennial,plant,seed,shape,size,sympodial,texture,type
209	wfo-0001028263	success	156	126	79	77	47	0.506	0.25,1-2,1-3,1-4,11-13,11-23,14-44,2-4,2.6,3,3.4,3.5-4.2,4,5-7,5-7.5,6,6-8,9,abaxially,acumen,acuminate,acute,adaxially,apex,articulate,atenuate,base,branched,broadly,calyx,cm,conical,cordate,corolla,cuneate,cyme,darker,deep,diameter,dichasial,dichasially,distal,ebracteate,elliptical,filament,green,green-white,herbaceous,interjected,lateral,leaf,leaflet,light,lobe,long,medium,mm,monochasial,mucilaginous,oblique,odd-pinnate,ovate,ovoid,pedicel,peduncle,perennial,petiole,plant,puberulent,pubescent,rotate,seed,size,stigma,strigose,style,terminal,violet,wide	2,2-3,3-6-foliat,4-5,8-1.,8-14,abaxiall,apical,apically,cell,connate,covering,dehiscent,digestion,diminishing,dorsally,eaf,edge,eed,emoval,enzyme,equal,exceeding,first,flat,flower,folded,forked,generally,globo,gradually,hair-like,half,honeycomb,introrse,living,lon,lower,lunat,make,maturing,nflorescence,nther,often,orolla,pair,pattern,perfect,plan,poricidally,proximal,reveal,ruit,sessile,seudostipule,short,slit,specimen,stamen,straight,tal,tem,testal,thick,throughou,throughout,toward,truncate,tuber-bearing,two,typically,unit,vary,wall,yellow,ympodial,Â¼	8-19,anther,appearance,arrangement,bark,border,branch,bud,characteristic,colour,corrugation,drying,exertion,form,fruit,fruiting,giving,glabrousnes,globose,growth,height,history,inflorescence,length,life,lobing,margin,midpoint,na,new,number,ovary,per,prickle,primary,pseudostipule,ray,shape,stem,surface,texture,thicknes,tube,type,variation,vein,width
210	wfo-0001028280	success	87	56	39	48	17	0.448	.5,1-2,1-2-flowered,2-2.5,2-3,acuminate,apex,arching,attenuate,bark,base,berry,ciliate,cm,completely,dark,decurrent,elliptic,flattened,fruiting,glabrous,globose,green,lanceolate,leaf,long,margin,minutely,mm,narrowly,new,onto,pedicel,petiole,shrub,simple,stem,surface,winged	0.7-1,1.5-2.7,6-9,7-8,almost,anthesi,ape,axil,branch,brow,closely,dia,eaf,eed,immature,know,known,lateral,lon,lower,main,middle,nflorescence,older,opposite,pair,papillae,pendant,present,rounded,ruit,scar,sessil,small,somewhat,spaced,tall,tip,ud,ultimate,unifoliat,unit,vein,widest,woody,x,ympodial,young	arrangement,brown,characteristic,colour,diameter,form,fruit,glabrousnes,growth,height,inflorescence,length,plant,shape,texture,type,unifoliate
211	wfo-0001028281	success	267	161	140	127	21	0.524	-0.9,-1,-10,-20,-3,-36,-45,-5,-7,-8,.5,0.2-0.3,0.2-0.5,0.2-0.7,0.3-0.5,0.3-1,0.5-0.6,0.5-0.7,0.5-1,0.5-1.1,0.5-1.2,0.7-2.5,0.75-1,0.8-1,1,1-1.5,1-3,1-5,1.0-1.6,1.1-1.4,1.1-2.4,1.2-1.6,1.4-4,1.5-6,1.7-2.5,10-30,2-4,2-6.5,2.1-3.0,20-30,3-16,3-8.5,6,7-30,abaxial,acuminate,acute,adaxial,almost,anther,apex,apical,appendage,articulation,axi,base,basiscopically,bent,bract,branching,broadly,brown,calyx,capitate,cell,cm,column,conical,corolla,dark,deep,densely,diameter,distal,doubly,elongate,entire,extended,flower,form,fruit,fruiting,glabrous,glandular,globose,golden,green,hair-like,half,head,imparipinnate,inflorescence,interjected,interrupted,lateral,leaf,leaflet,like,lobe,margin,mm,multi-cellular,oblique,obovate,occasionally,once-branched,orbicular,outgrowth,ovary,pale,paler,pedicel,peduncle,petiole,petiolule,point,proximal,pseudostipule,pubescent,regularly,rotate,serrate,shrub,small,sparsely,staminal,stem,sterile,stigma,stripe,strongly,style,terminal,testa,toward,trichome,tube,vine,wall,yellow	+,.2,.4,0.05-0.4,0.1-0.15,0.15-0.2,0.5-,0.7-,0.7-1.2,1-,1.2-1.5,1.5-2,10-18,2-13,2-4-celled,2-locular,2.5-,3-5,3-foliate,5-8-celled,6-15,abaxially,absent,alternate,anthesi,appearance,appressed,arising,autogamous,berr,blade,bracteate,composed,covering,darker,decreasing,decurrent,developed,dry,eaf,edicel,eed,eglandular,either,elliptic,elongate-triangular,enclosing,exerted,exserted,filament,fragile,free,generally,giving,gland,gree,hal,halfway,included,internode,large,largest,less,lon,long,longest,lower,material,medial,midvein,minute,mixture,multi-celled,multicellular,narrowly,nflorescence,node,opposite,other,ovate,pair,patent,population,portion,present,primarily,primary,probably,rachi,rest,ruit,secondary,serrat,sessile,set,shorter,silky,size,smaller,smooth,sometimes,sparser,sprawling,stiff,straight,subopposite,surface,tem,tertiary,thick,thin,three,tip,transparent,type,ud,unicellular,uniseriate,unit,usually,vein,weak,weak-walled,well,wide,winged,ympodial	0.5-1.5,0.7-1.5,1-2,2.5-6-15,arrangement,bend,bud,colour,growth,height,history,length,life,perennial,plant,pubescence,seed,shape,staman,thicknes,width
212	wfo-0001028317	success	204	121	98	106	23	0.48	-1.5,-5,/5,0.3-0.4,0.3-1,0.6-0.8,0.6-1.2,0.6-1.5,0.8-1.1,0.8-2.5,1-1.3,1-3,1.1-1.9,1.4-2,1/5,2-2.8,2.5-6.5,2.8-3.3,3-4,4-6,absent,acute,anther,apex,apparently,articulated,bark,base,berry,branched,bright,brown,calyx,chartaceous,cm,cream,cuneate,dark,densely,diameter,dull,erect,filament,flattened-reniform,fruit,fruiting,gray,green,herb,lanceolate,lateral,leaf,length,lobed,long,margin,marking,maturity,mauve,mm,moderately,obtuse,orange-brown,ovate,pair,pale,pedicel,peduncle,petiole,poricidal,prickly,primary,purple,red,reflexed,shrub,simple,sometimes,sparsely,spherical,spreading,stellate-pubescent,stem,style,surface,tapering,terminal,tip,truncate,unarmed,upper,vein,way,white,wide,yellow,yellow-green,young	0,0-1,0-5,0.1,0.1-0.25,0.1-0.3,0.1-0.4,0.5-3.5,1-4,1.8-2.5,1/,1/3-1/4,1/4-2/3,2-4,2-4.5,2/3,3-10,3-5,4-5-merous,4-8,5-8,6-10,abaxially,acuminat,almost,alyx,apar,apart,apically,blade,broad-deltate,brow,concolorous,curved,deltate,difoliate,distance,drying,eaf,eed,elongating,equal,extending,eye,filiform,flower,free,geminat,glabrous,hair,herbaceous,infructescence,lobe,longer,lower,mature,midpoint,midvein,minute,naked,nflorescence,oblong,older,one,open,orolla,oung,pendulous,per,perfec,pericarp,porrect,portion,prickl,prickle,ray,reduced,rounded,ruit,scandent,scar,sessile,shorter,side,smooth,spaced,stalk,stalked,stellate,straight,subsessile,tamen,terete,tertiary,time,toward,translucent,trichome,tube,unarme,unit,variously,vary,venation,visible,ympodial	arrangement,branch,characteristic,colour,corolla,exertion,form,glabrousnes,growth,height,history,inflorescence,life,lobing,new,ovary,perennial,plant,seed,shape,size,texture,type
213	wfo-0001028323	success	164	119	96	68	23	0.585	0.2-1,0.4-1.3,0.5,0.6-1,0.8,0.9-1.2,1-1.2,1-1.5,1.1-4.5,1.5,2-3,2-9,3,5-6,7.5-9,abaxially,absent,acute,anther,anthesi,apex,attenuate,bark,base,berry,blue-green,brown,c.,calyx,cm,conical,corolla,cup-shaped,dark,densely,diameter,drying,ellipsoid,elliptic,entire,erect,fading,filament,fleshy,fruiting,glabrescent,glabrous,globose,grey,growth,included,inflorescence,internodal,leaf-opposed,less,like,margin,maturity,minutely,mm,new,ovary,ovoid,pair,pale,pedicel,peduncle,petiole,pitted,poricidal,primary,pubescent,reddish,revolute,rounded,shiny,shoot,short,shrub,simple,sometimes,somewhat,sparsely,stem,stigma,style,surface,tip,trichome,tube,uniseriate,vein,violet,way,white,x	-2,0.2-0.5,0.5-1,1,1-2,1.5-2.5,3-5,3-6,3.5-4,abscissio,along,apart,apparently,appressed,articulated,ba,capiatate,cell,coriaceous,deltate,dendritic,eaf,eed,flower,free,glabrescen,lanceolate,lengthening,lobe,lobed,longer,lower,main,minute,nflorescence,occasionally,ovate,papillat,papillose,peg,perfect,pericarp,planar,plurifoliat,pore,portion,proceed,remaining,ruit,scar,scattered,sinus,small,soft,soon,sparely,splitting,straight,tearing,testal,thick,thin,tuft,ud,unit,wall,woody,ympodial	arrangement,branch,bud,capitate,characteristic,colour,exertion,form,fruit,glabrousnes,height,history,leaf,length,life,lobing,na,plant,seed,shape,size,texture,type
214	wfo-0001028329	success	215	143	122	93	21	0.567	.5-3,0-100,0.2-0.3,0.8-1.4,0.9-1.3,1-6,1.0-1.4,1.3-1.8,1.5-2.3,1.5-3.5,12,3-8,4-15,5-10,6-8,abaxially,acuminate,acute,adaxially,angled,anther,anthesi,apart,apex,articulated,asperous,base,becoming,berry,blunt-tipped,branch,branched,brown,calyx,chartaceous,closely,cm,conical,continued,corolla,deltoid,dendritic-echinoid,diameter,dichotomously,distantly,due,echinoid,entire,filament,finely,fleshy,flower,fruit,glabrous,granular,granular-tomentose,green,grooved,growth,hair,honeycombed,inserted,lateral,leaf,length,long-attenuate,longitudinally,margin,minutely,mm,moderately,mostly,multangulate,obelliptic,oblong,obovate,obtuse,ovate,ovate-elliptic,pedicel,peduncle,petiole,porrect-stellate,pubescent,rather,reniform,reticulate-punctate,ripe,sessile,several,short-,short-stalked,shrub,simple,slightly,small,sometimes,spaced,sparse,sparsely,stellate-pubescent,stellate-rotate,stelliform,stem,stigma,style,subglobose,suborbicular,time,tomentose,touching,tree,tube,turning,unarmed,velutinous,vestigial,white,whitish,x,yellow,yellowish	.75-2,.75-5.75,/10-3/10,0.8-1.1,1.1-2.5,1.3-2,1.5-2.75,1.5-8,10-34,2-3,2-4,2.2-3.9,2.6-5,2.75-4.5,3-14,3.75-7,3/4,4-5,6-11,6-9,7-19,absen,ag,apical-lateral,apparently,axe,axillary,ba,bark,blade,bud,cylindrical,dehiscing,dendritic-echinoi,distinct,eaf,eed,free,glabrescen,gray,high,introrse,large,lengthening,lobe,lobed,long,lower,main,midvein,multangulat,nflorescence,obscured,occasional,older,orbicular,orolla,pale,perfect,plurifoliate,pore,present,pseudo-terminal,rachi,receptacle,relatively,ruit,runk,sessil,side,slit,stalked,stellat,stellate,subcapitat,suture,swollen,tamen,testa,thick,thickened,thin,tomentu,toward,unarme,unit,usually,vary,vein,way,wide,ympodial,young	arrangement,characteristic,colour,exertion,form,fruiting,glabrousnes,height,inflorescence,lobing,new,ovary,plant,pseud-terminal,seed,shape,size,subcapitate,surface,texture,type
215	wfo-0001028337	success	195	125	106	89	19	0.544	-2.5,-6,.5,.8,/3,0,0.3-0.5,0.4-0.8,0.7-0.9,0.7-1,1-1.8,1-2,1-3,1.5-3,1.8-2,2-2.2,2-4,5-6,abaxial,abaxially,adaxial,anther,apex,apically,apparently,articulated,bark,base,berry,branched,calyx,chartaceous,cm,color,connivent,cuneate,dark,deltate,densely,diameter,discolorous,drying,entire,erect,evenly,filament,flattened-reniform,flower,fruit,fruiting,glabrescent,glabrous,glaucous,gray,green,green-brown,hair,inflorescence,juvenile,known,lateral,leaf,length,lobe,lobed,long,margin,marking,mature,mauve,minutely,mm,moderately,narrow-oblong,orange-brown,pale,pedicel,peduncle,petiole,pitted,poricidal,prickly,reddish,rounded,shallowly,shrub,simple,smooth,sparse,spherical,stellate-pubescent,stem,strongly,style,surface,tapering,terete,terminal,tip,toward,tube,unarmed,way,white,wide,young	-2,-4,0.05-0.15,0.05-1,0.1-0.3,0.4-0.7,1,1.5-4,1/2,1/3-2/3,1/4-1/3,1/8-1/4,11-16,15-50,3-4,4-5,5-25,5-8,5-merous,6-7,8-10,8-14,acut,alyx,apar,apart,ape,blade,conical,curved,eaf,eed,elongating,equal,eye,free,fused,gently,glabrou,gray-brown,infructescence,juvenil,long-styled,longer,lower,midpoint,naked,nflorescence,occasionally,older,one,open,orolla,oung,per,perfect,pericarp,plurifoliat,porrect,porrect-lepidote,portion,prickle,primary,ray,reflexed,ruit,scar,sessile,shoot,short,short-styled,shorter,slender,small,spaced,staminate,stellate,stout,straight,tamen,time,trichome,unarme,unit,usually,vary,vein,visible,ympodial	acute,arrangement,characteristic,colour,corolla,exertion,form,glabrousnes,growth,height,lobing,new,ovary,plant,seed,shape,size,texture,type
216	wfo-0001028339	success	195	118	95	100	23	0.487	.5,0.05-0.1,1-1.2,1-2,1-5,1.1-1.4,1.2-1.5,1.7-3.2,10-30-flowered,5-7,anther,appearance,appressed,bark,base,beneath,berry,brown,bud,calyx,capitate,cm,corolla,covered,cup-shaped,dark,decurrent,densely,dia,dried,dry,enclosed,exserted,filiform,flattened,floccose,fruiting,glabrate,glabrous,globose,grainy,greyish-brown,growth,irregular,later,leaf,like,little,lobed,long,minutely,mm,mustard,nearly,ovary,ovate,ovoid,ovoid-reniform,papillate,pedicel,petiole,pitted,pulp,red-brown,shaped,shining,shrub,simple,size,slender,slightly,small,somewhat,sparsely,specimen,stem,stigma,style,surface,tapering,tear-drop,texture,tree,trichome,tube,uniseriate,urceolate,vein,white,white-speckled,winged,woody,yellow,yellowish,young	0.8-1.2,1-1.5,1.5,1.5-2,10.2-18.5,2.5-5,3.4-5.5,3.5-4,43191,5-angled,5.8-7.9,7-11,8-10,8182,across,acuminate,acute,almost,anthesi,apex,appearing,attenuate,becoming,blue,broadly,carinate,carpel,closely,connate,crystalline,cuneate,deflexed,differing,difoliate,distinctly,eaf,edicel,eed,epidermi,erect,evenly,fide,filament,first,flower,free,frui,geminat,large-celled,lateral,leave,lobe,lon,long-triangular,lower,main,major,margin,middle,minor,nee,nflorescence,oblique,obscure,occasionally,older,one,opposite,overlappin,papery,papillose,planar,pore,poricidal,portion,proximal,reflexed,ruit,scar,schwarz,secondary,septum,spaced,speckled,straight,strong,strongly,tall,tightly,tip,tub,ud,unit,venation,white-lenticellat,white-papillo,wide,widest,x,ympodial	abaxial,adaxial,alternate,arrangement,characteristic,colour,diameter,exertion,form,fruit,hair,height,history,inflorescence,length,life,lobing,plant,seed,shape,type,white-lenticellate,white-papillose
217	wfo-0001028351	success	175	131	80	95	51	0.457	.2,.8,0,0.2,1.0â2.0,2,2.0â2.5,3,3â4,40,5.0,5.0â5.5,6â12,8â15,abaxially,acute,adaxially,along,annual,anther,anthesi,apex,base,becoming,blue,branching,brown,calyx,capitate,clavate,cm,colour,densely,diameter,filament,flattened,fruit,glabrous,globose,green,herb,lanceolate,leaf,lobe,lobed,long,margin,midvein,mm,moderately,number,oblong,opposed,ovate,pale,pedicel,peduncle,perennial,petiole,pitted,pubescent,regularly,shallowly,shiny,simple,slender,sparsely,stem,stigma,style,surface,truncate,tube,unbranched,unknown,velutinous,woody,x,young,â3.0	.8â1.0,0.1,0.5,0.6,0â,1.0â,1.0â1.6,1.0â2.5,1.4â1.5,1.5â4.0,1.6â,10,2.0â5.0,2.1â3.5,2/3,2â2.5,2â4,3.4â5.0,4,5,5.5â10.5,5â7,6.5â8.5,absent,adaxiall,ag,apart,apical,articulated,axe,ba,basal,blade,cell,chartaceous,connivent,convex,cylindrical,directed,distally,eaf,eed,equal,erect,fleshy,flower,geminat,glandular,hair,indumentum,lamin,like,lon,longitudinal,lower,m.,multicellular,narrowly,nfloresence,obtuse,occasionally,opening,orolla,pair,pentagonal,perfect,plurifoliate,pore,present,probably,ruit,serrate,shaped,side,slit,smaller,spaced,stone,straight,tal,tamen,tardily,teardrop,tem,time,unicellular,uniseriate,unit,vary,white,wide,wing,winged,ympodial,â	0â2.5,1.0â4.0,1.5,1.6â5.0,appearance,arrangement,bark,border,branch,bud,characteristic,corolla,corrugation,distal,drying,exertion,form,fruiting,giving,glabrousnes,growth,height,history,inflorescence,interjected,lateral,leaflet,length,life,lobing,mentioned,midpoint,na,new,ovary,per,plant,prickle,primary,pseudostipule,ray,seed,shape,size,terminal,texture,thicknes,type,variation,vein,width
218	wfo-0001028353	invalid_json	177	138	112	65	26	0.633	/3,0.2-0.4,0.5,0.9-1.2,1,1-4,1.4-2,1.5-2,1.5-5,2,2-3,2-4,3,3-5,4-7,6-8,7,acute,along,anther,apex,base,beneath,berry,bluntly,bright,calyx,capitate,cell,centre,ciliate,clasping,cm,coarsely,conical,cordate,corolla,cup-shaped,dark,deep,deeply,densely,diameter,ellipsoid,elliptic,emarginated,erect,filament,fleshy,flower,fruiting,glabrous,globose,green,greenish,herb,heteromorphic,hollow,honey-comb,internodal,leaf,less,like,lobe,long,margin,midrib,minute,minutely,mm,nodding,often,open,ovary,ovoid,pale,papery,papillate,papillose,pedicel,petiole,pitted,plant,plump,pubescent,purple,rhomboid,ripe,sessile,shallow,short,simple,size,slender,somewhat,sparsely,stem,stigma,style,surface,tan,testal,tip,toothed,trichome,truncate,tube,uniseriate,vein,way,x,yellow	.5,0.5-,1-2,8-10,abaxially,accrescent,age,anthesi,apart,area,becoming,campanulate,curved,decreasing,decumben,difoliate,distally,dry,drying,eaf,edicel,eed,exerted,fracturing,free,frui,geminat,gree,growing,horn,horned,inserted,lengthening,lon,lower,m.,material,nflorescence,outline,pair,peduncle,pericarp,point,pore,poricidal,portion,primary,principal,reddish,ruit,scar,scattered,sessil,sleeve,slightly,slit,straight,strongly,thin,toward,ud,unit,wall,wrinkled,ympodial	'',[,``,abaxial,adaxial,arrangement,bud,characteristic,colour,form,fruit,growth,height,history,inflorescence,length,life,lobing,pubescence,seed,shape,texture,type,value,{,}
219	wfo-0001028390	success	147	113	81	66	32	0.551	-10,0.5,0.5-1,0.5-1.5,0.5-2.5,1-2.5,1-5,10-15,2,2.5,3-4,4-5,7,7-8,abaxially,acute,adaxially,angled,apart,apex,apiculate,base,calyx,chartaceous,cm,connivent,cuneate,cylindrical,deltate,densely,diameter,directed,divided,elliptic,entire,felty-pubescent,forked,glabrous,globose,lanceolate,lobe,margin,mm,moderately,narrowly,obtuse,often,orange,ovate,pedicel,peduncle,petiole,pore,pseudohair,puberulent,pubescent,rachi,rarely,ripe,shrub,simple,slightly,small,sparsely,stellate,stigma,style,subclavate,subcordate,subcoriaceous,triangular,truncate,tube,unbranched,unequally,usually,violet,white,white-pubescent,x,yellow	.5-3.3,0,1,1-3,1.5-2,1.5-3.5,1.5-5.5,3-5,4-11,5-7,6-many-foliat,9,absen,adaxiall,aggregate,articulated,axe,blade,branched,cell,curled,dendritically,dendritically-branched,dense,distall,eaf,eed,eglandular,flower,gland,hair,leaving,less,like,lon,long,lower,midvein,mixed,mostly,near,nflorescence,nther,occasionally,orolla,peg,perfect,presen,pubescen,radiu,ruit,scar,short,spaced,stalked,ste,stone,subcapitat,tal,tem,time,tip,unit,vary,wide,ympodial	abaxial,adaxial,anther,arrangement,characteristic,colour,corolla,direction,distally,form,fruit,glabrousnes,growth,height,history,inflorescence,leaf,length,life,na,new,ovary,plant,seed,shape,size,spacing,stem,subcapitate,surface,texture,type
220	wfo-0001028405	success	149	74	53	96	21	0.356	0.4-0.5,0.5-3,1-9,1.3-8,1.5-6.5,10-11,2,2-2.5,3-4,3.5-10,3.5-6.5,4-11.5,4-6,6-7,7-14.5,8-15,branched,calyx,cm,conical,corolla,cyme,diameter,dichasial,dichasially,ebracteate,green,green-white,herbaceous,interjected,lateral,leaf,leaflet,long,mm,monochasial,odd-pinnate,ovoid,pedicel,peduncle,perennial,petiole,plant,puberulent,seed,size,stellate,style,terminal,throughout,tuber-bearing,wide,yellow	1-4,2-3,2-4,3-20,3-6-foliat,9-15,abaxially,absen,acumen,acute,adaxially,apex,apical,apically,apiculate,articulate,attenuate,base,cell,connate,covering,decurrent,dehiscent,digestion,diminishing,distal,dorsally,eaf,edge,eed,elliptic,elliptic-lanceolate,emoval,enzyme,exceeding,filament,flat,flower,folded,forked,generally,globo,gradually,hair-like,half,honeycomb,introrse,lanceolate,living,lobe,lon,lower,lunat,make,maturing,mucilaginous,nflorescence,nther,oblique,oblong,often,orolla,ovate-elliptic,pair,pattern,perfect,plan,poricidally,proximal,rachi,reveal,ruit,seudostipule,short,short-acuminate,short-petiolate,slit,specimen,stamen,stigma,straight,subsessile,tal,tem,testal,thick,throughou,toward,typically,unit,vary,wall,whit,without,ympodial,Â¼	abaxial,absent,adaxial,anther,arrangement,characteristic,colour,form,fruit,growth,height,history,inflorescence,length,life,ovary,shape,stem,texture,white,width
221	wfo-0001028429	success	162	78	56	106	22	0.346	0.2-0.4,0.8-1.2,0.9-2.3,1-2.5,1.5-3,10-11,10-27,10.5-21,2-3,2-4,2.5-12,2.5-4,2.5-7.5,2.7-3.6,3-6,4-14,5-12,6-28,calyx,cm,corolla,diameter,distal,especially,forked,generally,glabrescent,glabrous,globose,hair,half,herbaceous,interjected,lateral,leaf,leaflet,long,mm,mucilaginous,odd-pinnate,ovoid,pedicel,peduncle,pentagonal,perennial,petiole,plant,rotate,scattered,seed,size,slightly,style,terminal,vein,wide	1-4,1.5-4,2-1.,2-8,3-6-foliat,6-18,7-7,abaxiall,abaxially,acumen,acuminate,acute,adaxially,apex,apical,apically,articulate,base,branched,broadly,cell,connate,cordate,covering,cuneate,cyme,darker,dehiscent,dichasial,dichasially,digestion,diminishing,dorsally,eaf,ebracteate,edge,eed,elliptical,emoval,enzyme,exceeding,filament,flat,flower,folded,globo,gradually,green,green-white,greenish,hair-like,honeycomb,introrse,light,living,lobe,lon,long-attenuate,lower,lunat,make,maturing,medium,monochasial,narrowly,nflorescence,nther,oblique,obovate,often,orolla,ovate,pair,pattern,perfect,petiolule,plan,poricidally,proximal,reveal,ruit,seudostipule,short,slit,specimen,spot,stamen,stigma,straight,tal,tem,testal,thick,throughou,throughout,toward,tuber-bearing,typically,unit,vary,violet,wall,white,yellow,ympodial,Â¼	2-19,abaxial,adaxial,anther,arrangement,colour,form,fruit,growth,height,history,inflorescence,length,life,ovary,pseudostipule,shape,stem,surface,texture,wet,width
222	wfo-0001028436	success	150	94	69	81	25	0.46	.5,0.2-0.4,0.5,1-3,1.5,1.5-2,10-20,2-4,2.5-3,4,5-10,5-12,5-15,5-8,8-12,absent,acute,anther,apex,base,berry,brown,calyx,center,chartaceous,ciliate,decurrent,diameter,dm,dried,edge,elliptic,entire,filament,fine,flower,fruit,glabrous,globose,leaf,linear,linear-lancolate,margin,membranaceous,mm,moderately,nearly,oblong,often,parallel,pedicel,peduncle,per,petiole,pubescent,radiating,raised,ridge,rotate,running,shallow,shrub,stem,stigma,style,surface,unifoliate,white,x	0.5-1,0.8-1.5,1-2,1-2-celled,1.5-2.5,1st,2-3,2nd,7,abaxially,abundant,adaxiall,adaxially,along,apically,appearance,appearing,axe,beyond,blade,cell,cm,connected,cordat,deflated,dehiscent,difficult,due,eaf,eed,evaluat,explosively,exserted,flat,frui,fruiting,geniculate,glabrescen,hair,interpetalar,lengt,like,lobe,long,lower,lying,much-branched,nflorescence,notch,older,orolla,oung,placenta,pointing,presence,pubescen,rachi,reaching,rhizomatous,ruit,small,sparsely,stamen,structure,swollen,tal,tamen,taproot,tear,thick,tissue,triangular,tube,two-celled,unbranched,unit,vary,wid,woody,wrinkled,ympodial	abaxial,adaxial,arrangement,characteristic,colour,corolla,form,glabrousnes,growth,height,history,inflorescence,length,life,new,number,ovary,perennial,plant,seed,shape,staman,texture,type,wide
223	wfo-0001028465	success	159	117	93	66	24	0.585	0.75,1-2,1-4,1.2-2,10-24,11-23,2-3,2-6,2-9.3,2.4-2.8,2.5-4,3-4,3-5,3-8,3.8-7,4-8,4.5-5.5,5-7,7-15,8-10,acumen,apical,apically,attenuate,branched,broadly,calyx,cell,cm,connate,corolla,covering,cyme,dehiscent,diameter,dichasial,dichasially,distal,ebracteate,elliptical,exceeding,filament,forked,globose,green,hair-like,herbaceous,interjected,interpetalar,introrse,lateral,leaf,leaflet,lobe,long,make,maturing,medium,mm,monochasial,mucilaginous,odd-pinnate,often,ovoid,pair,pedicel,peduncle,perennial,petiole,plant,poricidally,puberulent,pubescent,purple,rotate,seed,short,size,slit,spot,stamen,stigma,straight,strigose,style,terminal,testal,thick,throughout,tuber-bearing,wall,white,yellow	1.5-2.9,10,2,2-4,3-6-foliat,4-1.,9-19,abaxially,acuminate,acute,adaxially,apex,articulate,base,cuneate,decurrent,digestion,diminishing,dorsally,eaf,edge,eed,emoval,enzyme,equal,first,flat,flower,folded,generally,globo,gradually,green-white,half,honeycomb,living,lon,lower,lunat,nflorescence,nther,oblique,orolla,pattern,perfect,petiolule,plan,proximal,rachi,rarely,reveal,ruit,sessile,seudostipule,specimen,tal,tem,tissu,toward,two,typically,unit,vary,wide,ympodial,Â¼	4-18,abaxial,adaxial,anther,arrangement,colour,form,fruit,growth,height,history,inflorescence,length,life,lunate,ovary,pseudostipule,shape,stem,surface,texture,tissue,wet,width
224	wfo-0001028468	success	255	118	93	162	25	0.365	-10,-3,.3-0.4,.6-1,0.2-0.3,0.4-4,0.7-2.5,1.2-1.5,1.6,16,2-9,5-21,5-9,6-9,acute,anther,apex,armed,attenuate,base,berry,blue,broadly,brown,calyx,chartaceous,cm,commonly,corolla,dark,densely,diameter,exserted,extra-axillary,filament,flattened,flower,foveate,fruit,fruiting,glabrescent,gray,green,greenish,interpetalar,length,light,lobe,lobed,long,margin,mm,moderately,narrowly,oblique,oblong-conical,oblong-lanceolate,obtuse,orange,ovate,pair,pale,pedicel,peduncle,petiole,purple,reticulate,rhombic,shallowly,short,shrub,simple,somewhat,sparsely,stellate-pubescent,stem,stigma,style,subcapitate,subcuneate,subelliptic,subglobose,sublenticular,subreniform,subshrub,surface,terete,tissue,triangular,unarmed,unbranched,x,yellowish	-1.3,-4,-5.5,-7,.1-0.2,.1-0.3,.1-0.4,.2,.2-0.4,.3,.5,.5-1.5,.5-1.6,/10-1/5,/4-1/3,0.05,0.1,0.2-0.6,0.2-1.5,0.4-1,0.5-2,0.5-3,0.5-3.3,0.5-3.5,0.5-8,0.6-1.2,0.6-2,0.8-3.5,1,1.3-2,1.5-2.2,1.5-3.1,1/3-1/2,1/5-1/2,2,2.2-3,2.5-4,2.8-4.1,2/3-3/4,20,3-4,4-6,4-9,6-10,abaxially,accrescent,acuminate,adaxially,along,apart,appressed,ark,articulated,axe,becoming,beyond,blade,broad-based,bu,bud,c.,campanulate,cauline,central,clavate,compresse,compressed,connivent,d.,decreasing,density,directed,distal,distally,distantly,dry,eaf,eed,ellipsoid,equal,geminat,glabrous,gradually,hair,half,increasing,inserted,introrsel,lamin,lateral,laterally,longer,lower,m.,main,midpoint,midvein,minutely,mixed,mostly,multangulat,multangulate,nflorescence,occasionally,older,orangish,orolla,overlapping,ovoid,papillo,per,perfect,pore,porrect-stellate,prickle,proximal,pubescence,pubescent,rachi,ray,recurved,reduced,relatively,rotate-stellate,ruit,sessile,short-,short-stalked,side,similar,similarly,slightly,spaced,specimen,stalk,stamen,stelliform,straight,subacuminate,subchartaceous,subsessile,tal,tamen,testa,thick,thick-stalked,thicknes,time,touching,toward,tube,unifoliate,unit,upper,usually,vary,vein,way,wide,yellow,ympodial,young	0-1.3,0.5-1.5,arrangement,bark,branch,characteristic,colour,exertion,form,glabrousnes,growth,height,history,inflorescence,leaf,life,lobing,new,ovary,plant,seed,shape,size,texture,type
225	wfo-0001028470	success	185	147	121	64	26	0.654	0-18,0.25-0.75,0.9-2.2,0.9-2.3,1-12.3,1-2,1-3,1.5-2.8,1.6-3.2,11.8-21,12-44,2-10,2-7,2-8,2.1-3.9,3-10,3-5,3.2-5.5,3.5-16,3.5-7,4-7,5.5-11.6,abaxially,acumen,adaxially,anther,apart,axillary,berry,blade,brownish,bud,cell,chartaceous,clavate,cm,condition,connivent,corolla,covering,dark,deep,diameter,distal,dorsally,dot,drying,edge,end,filament,flat,flower,folded,forked,fresh,fruit,generally,glabrous,green,green-white,greenish,hair,hair-like,half,herb,homostylous,interjected,lanceolate,lateral,leaf,leaflet,light,lobe,long,make,medium,mm,mottled,mucilaginous,odd-pinnate,one,ovate,ovoid,pedicel,peduncle,pentagonal,petiole,placed,plant,poricidal,pubescent,purple,ripe,scarce,seed,short,size,sometimes,stigma,straight,style,substellate,subtending,terminal,testal,thick,throughout,tip,tube,tuber,typically,unwinged,usually,wall,wet,white,whitish,wide,wing,x,yellow	2-5,4-6,5-merou,6-33,acute,adaxiall,ag,alyx,apex,apparently,articulated,asymmetric,attenuate,axe,base,basiscopic,capitat,decreasing,digestion,eaf,eed,elliptic,enzyme,erec,exceeding,geminat,glabrescent,glabrou,hal,high,honeycomb-shaped,lengthening,living,lower,nflorescence,orbicular,orolla,pair,perfect,petiolulate,plurifoliate,pore,removed,rounded,ruit,sessile,seudostipule,side,slit,spaced,specimen,stamen,stolo,subequal,subglabrou,tall,tamen,tem,tissue,toward,tri-,unit,vary,ympodial	5-merous,abaxial,adaxial,arrangement,calyx,capitate,colour,erect,form,growth,height,history,inflorescence,length,life,ovary,presence,pseudostipule,shape,spacing,stem,stolon,subglabrous,surface,texture,type
226	wfo-0001028476	success	246	166	141	105	25	0.573	-16,-6,-8,.05-0.1,0.2-0.5,0.4-0.6,0.5,0.5-0.6,0.8-1.2,0.8-1.6,1,1-1.4,1-2,1-2-celled,1-4,1-6,1.1-1.5,1.8-2.5,2-6,2-foliate,2-locular,2.4-3,3-foliate,3.5-13,4-celled,5-15,8-30,abaxially,abundant,acuminate,acute,age,almost,along,anther,anthesi,apex,appearance,articulated,basal,base,basiscopically,bifurcate,bracteate,branched,bright,brown,calyx,capitate,cell,cm,conical,corolla,curved,dark,deeply,diameter,distal,ebracteate,elliptic,entire,especially,exserted,filament,flower,fruit,fruiting,give,glabrescent,glandular,globose,green,hair-like,half,head,herb,imparipinnate,inflorescence,internode,interrupted,irregularly,lateral,leaf,leaflet,less,like,lobed,long,margin,maturity,minute,minutely,mixed,mm,narrowly,node,oblique,obovate,occasionally,outgrowth,ovary,pale,pedicel,peduncle,perennial,petiole,present,primary,puberulent,pubescence,pubescent,purple,rarely,regularly,scattered,silky,simple,sparsely,stellate,stem,stiff,stigma,straight,stripe,style,surface,testa,thick,tip,trichome,truncate,tube,unicellular,uniseriate,unit,usually,vein,wall,wide,woody,yellow	-1,-20,.5,0-,0-0.5,0.1-0.15,0.1-0.4,0.15-0.2,0.15-0.4,0.2-0.3,0.2-0.6,0.25-0.4,0.25-0.5,0.3-0.4,0.3-0.5,0.3-0.7,0.3-1.2,0.4-0.5,0.4-1.5,0.5-1.7,0.7-2.5,1-1.2,1-1.5,1-celled,1.1-1.6,1.2-2.5,12-30,2,3-12,3-7,6-,7-10,absent,acroscopically,also,alternate,ape,apical,appendage,axi,becoming,bifurcation,bract,column,decurrent,diamete,eaf,edicel,eed,elongate,first,fortaleza,gradually,gree,hal,hyaline,incurved,interjected,lanceolate,largest,lobe,lon,lower,main,midvein,nflorescence,numerous,often,pair,petiolule,population,prominent,pseudostipule,rachi,recurve,reflexed,rest,rounded,ruit,rÃ­o,secondary,sessile,set,short,sinus,slightly,smaller,sprawling,spreading,staminal,sterile,subopposite,tall,tem,terminal,tertiary,toward,ud,uniformly,unpaired,weak-walled,white,wid,winged,ympodial	arrangement,branch,bud,characteristic,colour,corrugation,drying,exertion,form,glabrousnes,growth,height,history,length,life,lobing,na,new,plant,seed,shape,size,sympodial,texture,type
227	wfo-0001028481	success	194	108	94	100	14	0.485	.1,.5,0.5-1,0.6-1,1-2,1-3,1-4,1.5,1.8-2.5,1/2-2/3,2.5-3,3,3-4,5.5-7.5,8,acuminate,almost,along,anther,anthesi,apex,attenuate,bark,base,branch,branched,chartaceous,clavate,cm,colour,conical,corolla,cuneate,cupular,deeply,dendritic,dendritic-pubescent,diameter,discolorous,distributed,divided,drying,elliptic,entire,equal,evenly,filament,flaking,flower,glabrous,leaf,length,less,liana,like,long,longitudinally,main,margin,midvein,mm,oblique,oblong,occasional,often,orange-brown,pedicel,peduncle,petiole,pubescent,ray,ridged,scar,shortly,shrub,side,size,slender,small,sparsely,stem,stigma,stump,style,surface,terminal,thickly,trichome,tube,unarmed,unknown,white,x,young	.3,0-2,0.1-0.2,0.15,0Â°,1-1.4,1.5-2,2-3,3-3.5,3-4.5,3-6,abaxially,absent,acute,adaxially,age,alyx,apar,apically,apparently,articulated,brown,canaliculate,clearly,close,delineated,deltoid,density,different,dilated,domatia,dorsifixed,dry,eaf,eed,ellipsoi,erect,except,extending,extent,eye,faint,flat,flexuous,free,green,increasing,know,known,lamina,lengthening,linear,lobe,lobed,lon,long-acuminate,longer,lower,m.,mostly,naked,narrowly,nflorescence,nther,orolla,ovate,pair,perfec,plurifoliat,pore,poricidal,portion,primary,protruding,rachi,raised,reddish,ribbed,ruit,see,simple,sinus,smoot,smoothly,spreading,tearing,tertiary,tip,together,toward,ud,uneven,unit,vary,vein,venation,visible,wide,yellowish,ympodial	apart,arrangement,bud,calyx,characteristic,ellipsoid,form,growth,inflorescence,lobing,ovary,shape,smooth,texture
228	wfo-0001028482	success	224	177	159	65	18	0.71	.1,.5,/3,0,0.2,0.5,0.5-1,0.5-5,00,1-1.5,1-11,1-2,1-4,1.2-1.6,1.5-2,1.5-3,10,2-3,2-celled,3-4,4-5,6-50,7-14,abaxially,acuminate,acute,adaxially,age,alternate,angled,anther,anthesi,apex,ascending,asymmetric,bark,base,becoming,berry,bifid,bifurcate,bilobed,bright,broadly,brochiodromous,brownish,bud,calyx,campanulate,capitate,channeled,chartaceous,cm,corky,corolla,corrugated,creamy,cymose,deciduous,deltate,diameter,dry,drying,ellipsoid,elliptic,emarginate,entire,exerted,exfoliating,filament,flattened-reniform,fleshy,flower,fresh,fruit,fruiting,glabrous,glandular,globose,golden,green,growth,halfway,hard,impressed,internodal,irregular,keeled,leaf-opposed,lengthening,less,lobe,long,margin,material,maturity,midrib,minutely,mm,new,nodding,obovate,occasionally,olive,ovary,pair,pale,pedicel,peduncle,per,petiole,pitted,pore,poricidal,primary,pubescent,reddish,revolute,scandent,shaped,shiny,short,simple,size,slightly,slit,sometimes,somewhat,soon,sparsely,stem,stigma,style,subcoriaceous,subglobose,subpyramidal,surface,tan,tear-drop,tip,transparent,transversely,tree,trichome,truncate,tube,tuberculate,tuft,uniseriate,usually,vein,venation,way,white,x,yellow,yellowish,young,Âµm	0.7-1.1,1.1-5,3-12,5-25,apiculae,basal,berr,branched,circinate,closely,constriction,coriaceous,cucullate,curved,deflexed,densely,diffusely,difoliate,discolorous,distally,distinct,eaf,eed,embryo,enlarged,expanding,free,geminat,glabrou,grayish,heterostylous,incrassate,individual,investing,lobed,lower,markedly,materia,midvein,minute,nflorescence,overlappin,papillat,pentamerous,pericarp,petal,portion,row,ruit,scar,small,spaced,stout,straight,tightly,tiny,tub,twice,two,ud,unifoliate,unit,vegetative,woody,ympodial	arrangement,characteristic,colour,exertion,form,glabrousnes,height,inflorescence,leaf,length,lobing,number,papillate,plant,seed,shape,texture,type
229	wfo-0001028487	success	195	132	108	87	24	0.554	0-9,0.3-0.7,0.4-1.5,0.9-3,1-2,1-3,1.1-1.5,1.4-1.7,10-4.3,15-28,2-4,2-4.8,2-6,2.5-3.5,3-10,3-19,3-5,3.4-7.8,4-7,4.6-13.6,5-6,7.8-16.4,anther,axillary,berry,blade,brownish,bud,cell,central,clavate,cm,condition,connivent,coriaceous,corolla,covering,dark,deep,diameter,distal,drying,elliptic,filament,flower,forked,fresh,fruit,generally,glabrescent,glabrous,green,green-white,greenish,hair-like,half,herb,homostylous,interjected,lanceolate,lateral,leaf,leaflet,light,lobe,long,make,medium,mm,moniliform,mucilaginous,narrow,odd-pinnate,ovate,ovoid,pair,pedicel,peduncle,pentagonal,petiole,plant,purple,ripe,seed,size,sometimes,star,stigma,straight,style,substellate,subtending,terminal,testal,thick,throughout,tube,tuber,unwinged,usually,wall,wet,white,whitish,wide,wing,x,yellow	1-3.2,1.7-7,10-41,3-4,5-merou,abaxially,acumen,acuminate,acute,adaxiall,adaxially,ag,along,alyx,apart,apex,apparently,arranged,articulated,asymmetric,attenuate,axe,base,basiscopic,bead,capitat,considerably,decreasing,digestion,dorsally,eaf,edge,eed,enzyme,erec,exceeding,flat,folded,geminat,glabrou,hair,hal,high,honeycomb-shaped,lengthening,like,living,lower,multiple,necklace,nflorescence,orbicular,orolla,perfect,petiolulate,plurifoliate,pore,poricidal,removed,rounded,ruit,scabrous,scarce,second,sessile,seudostipule,short,side,slit,smaller,spaced,specimen,stamen,stolon,subequal,subglabrou,tall,tamen,tem,tip,tissue,toward,tri-,typically,unit,vary,ympodial	5-merous,abaxial,adaxial,arrangement,calyx,capitate,colour,erect,form,growth,height,history,inflorescence,length,life,ovary,presence,pseudostipule,shape,spacing,stem,subglabrous,surface,texture
230	wfo-0001028489	success	224	128	107	117	21	0.478	-10,-2.5,-5,-6,/4,0-3,0.3-1,0.3-1.2,0.4-0.8,0.5-0.8,0.5-1.1,0.5-1.5,0.6-1.2,0.7-3,1-3,1.5-4,1.8-2.2,1.8-4,1/3,2-3,2-4,2.1-3,3-7,7.5,acute,anther,apex,apparently,articulated,bark,base,berry,calyx,cell,chartaceous,cm,connivent,cordate,cream,cuneate,dark,diameter,dull,elliptic,erect,filament,flattened-reniform,fruit,fruiting,glabrous,green,lateral,leaf,length,lobe,lobed,long,margin,marking,maturity,mauve,membranous,mm,moderately,obtuse,occasionally,orange,orange-brown,orange-green,outline,ovate,pair,pale,pedicel,peduncle,petiole,poricidal,prickly,primary,purple,raised,red-brown,rounded,shiny,shrub,side,simple,smooth,sometimes,sparsely,spherical,stellate-pubescent,stem,style,surface,tapering,tip,truncate,unarmed,upper,vein,way,white,wide,yellow,yellow-green,young	-0.6,-4,0-10,0-15,0-20,0-50,0.1,0.1-0.6,0.2,0.2-,0.2-0.4,0.2-0.5,0.2-0.6,0.2-0.7,0.3-0.5,0.3-0.7,0.5-1,1-4,1-6,1-7,1.5-3,1.8-5.5,1/3-1/2,1/4-1/2,2-6,3.5-6,4-10,4-13,4-8,5-25,5-8,5-merous,abaxially,acicular,alyx,apar,apart,apically,ba,beyond,blade,branched,broad-deltate,caudat,concolorous,curved,deltate,densely,difoliate,distance,drying,eaf,eed,elongating,equal,extending,eye,flower,free,geminat,gray,hair,herbaceous,infructescence,less,lon,longer,lower,mature,midpoint,midvein,minute,naked,nflorescence,often,older,one,open,orolla,oung,pendulous,per,perfec,pericarp,perpendicular,porrect,portion,prickle,protruding,ray,ruit,scar,sessile,slender,spaced,spreading,stalk,stellate,straight,subsessile,tamen,terete,tertiary,time,toward,trichome,tube,unarme,unit,vary,venation,visible,weakly,white-gra,woody,yellow-orange,ympodial	arrangement,branch,characteristic,colour,corolla,exertion,form,glabrousnes,growth,height,inflorescence,lobing,new,ovary,plant,seed,shape,size,texture,type,white-gray
231	wfo-0001028492	success	130	96	73	57	23	0.562	0.2-2,0.5-1,1-2.5,1-4,1-5,1.5-2.5,1.5-3,1.5-6,15-20,2-2.5,2-3,2-5,3,3-6,4,5-15,5-25-flower,5-8,6-11,8-15,acute,angled,apart,apex,base,calyx,cell,chartaceous,cm,colored,containing,crystal,dark,deltate,diameter,elliptic-ovate,entire,forked,fruit,glabrous,globose,herb,lobe,margin,mm,narrowly,pedicel,peduncle,petiole,pubescent,punctate,purple,rachi,radiu,rarely,reticulate,ripe,rounded,shrub,simple,stellate,stigma,style,subcordate,triangular,triangular-ovate,tube,unbranched,white,white-punctate,whitish,wide,x	-5-foliat,1.75-3.5,2-4,2.5-9,6-12,abaxially,absen,adaxially,aggregate,apiculate,articulated,axe,axi,blade,ciliolate,color,connivent,cylindrical,directed,distall,eaf,eed,except,glabrou,hair,irregularly,leaving,long,lower,nflorescence,nther,obtuse,orolla,pore,ruit,san,sand-punctate,scar,somewhat,spaced,sparse,splitting,stone,subcoriaceous,succulent,tal,tem,time,tip,truncat,unevenly,unit,unknown,vary,veiny,x1-3,ympodial	anther,arrangement,characteristic,colour,corolla,form,glabrousnes,growth,height,inflorescence,leaf,length,ovary,plant,sand,seed,shape,size,spacing,stem,surface,texture,truncate
232	wfo-0001028501	success	195	110	88	107	22	0.451	0-3,0-3.2,0-4,0.3-0.7,0.8-1.6,0.8-1.7,1-2,1-8,1.8-10.7,13-41,2-4,2.8-18,2.8-4.9,3-10,3-5,3-7,3.1-10.4,3.1-12,4-8,4.8-18,6.6-21.1,8-10,anther,blade,broadly,brownish,clavate,cm,condition,coriaceous,corolla,dark,diameter,drying,filament,flower,forked,fresh,fruit,glabrescent,glabrous,green,green-white,greenish,herb,homostylous,interjected,lanceolate,lateral,leaf,leaflet,light,lobe,long,medium,mm,moniliform,mottled,mucilaginous,odd-pinnate,ovate,ovoid,pair,pedicel,peduncle,petiole,plant,purple,pyriform,ripe,rotate,seed,simple,size,sometimes,spot,stigma,straight,style,terminal,throughout,tube,tuber,wet,white,whitish,wide,x	0.3-3.3,0.6-5.8,1,1-3,2-5,5-merou,8-34,abaxially,acumen,acuminate,acute,adaxiall,adaxially,ag,along,alyx,apart,apex,apparently,arranged,articulated,attenuate,axe,axillary,base,bead,berry,bud,capitat,cell,connivent,considerably,covering,decreasing,decurrent,digestion,distal,dorsally,eaf,edge,eed,elliptic,enzyme,erec,exceeding,flat,folded,geminat,generally,glabrou,hair,hair-like,hal,half,high,honeycomb-shaped,larger,lengthening,like,linear,living,lower,make,multiple,narrow,narrowly,necklace,nflorescence,onto,orbicular,orolla,perfect,plurifoliate,pore,poricidal,present,rachi,removed,ruit,scarce,sessile,seudostipule,short,slit,spaced,specimen,stamen,stolon,subglabrou,subtending,tall,tamen,tem,testal,thick,tip,toward,tri-,typically,unit,unwinged,usually,vary,wall,wing,yellow,ympodial	5-merous,abaxial,adaxial,arrangement,calyx,capitate,colour,form,growth,height,history,inflorescence,length,life,ovary,pseudostipule,shape,spacing,stem,subglabrous,surface,texture
233	wfo-0001028502	success	158	103	77	81	26	0.487	.5,/2,0.5-1,1-2,1.5-2,1.5-2.5,1.5-6,1.6-2.4,2-5,2-7,2-8,3.5-15,5-15,6-8,abaxially,acute,adaxially,anther,apex,base,branched,calyx,campanulate,clavate,cm,congested,constricted,corolla,dendritic,densely,dia,elliptic,exserted,fawn,filament,flattened-reniform,flower,fruiting,glabrous,globose,inflorescence,later,lateral,leaf,lobed,long,main,minutely,mm,obovate,ovary,pair,pedicel,petiole,pitted,pubescent,reddish-brown,seed,shining,shrub,small,stem,stigma,style,surface,terminal,thick,time,tree,tree-like,trichome,tube,vein,warty,way,white,wide	1.5-3,2-2.5,2-4,3.5-4,5-6,?,abaxial,age,along,anthesi,apar,ba,bark,beige,blade,body,branch,brown,cazalet,christmas-tree-like,closely,cone,dark,deltate,denser,eaf,edicel,eed,erect,fide,flat,fleshy,free,glabrat,heteromorphic,impressed,included,incrassate,inflorescenc,lengthening,light,like,lobe,lon,long-styled,lower,margin,matted,middle,narrower,nflorescence,often,older,packed,papillo,papillose,planar,plurifoliat,pore,poricidal,portion,prominent,rest,ruit,scar,scattered,short-styled,slit,spaced,structure,tall,tip,tub,ud,unclear,unevenly,widest,within,woody,ympodia,young	4-6,arrangement,bud,characteristic,colour,diameter,drying,exertion,form,fruit,growth,height,history,length,life,lobing,na,peduncle,perennial,plant,plurifoliate,primary,shape,size,texture,type
234	wfo-0001028505	success	168	107	84	84	23	0.5	.1,.3,.5,/3,0.25-0.5,0.8-1,0.8-1.5,1-3,10-14-flowered,10-15,2,3.5-5,acuminate,acute,anther,apex,aspect,bark,basal,base,beneath,berry,branch,bud,calyx,characteristic,cm,corolla,dia,dry,drying,erect,exsertion,f,filament,flattened,fruiting,gently,glabrous,globose,green,grey,leaf,long,margin,minutely,mm,narrowly,obovoid,ovary,ovate,ovoid-reniform,pale,pedicel,petiole,pitted,plant,prominent,pubescent,rounded,seed,shape,shaped,shrub,simple,size,specimen,stem,stigma,style,surface,tan,tapering,tear-drop,trichome,truncate,tube,unicellular,uniseriate,vein,way,white,x,yellowish	.01,1,1.2-2.5,1/3,2.5-4.5,3-5,7-8,anthesi,ba,barely,black,blade,body,bright,broadly,conical,darker,deciduous,decurrent,deflexed,delicate,deltoid,differentiated,differing,difoliate,distance,distinct,dried,eaf,edicel,eed,elliptic,expanded,exserted,free,geminat,greatly,incrassate,lateral,live,lobe,lobed,lon,lower,m.,main,major,materia,material,member,minor,minute,nflorescence,obvious,older,opposite,overlapping,pair,papillose,pore,poricidal,portion,proximal,purple,reflexed,ruit,scar,short,slightly,somewhat,soon,straight,strongly,tall,tip,touching,ud,unit,usually,whit,widest,woody,ympodial,young	alternate,arrangement,colour,decurred,diameter,exertion,form,fruit,growth,height,history,inflorescence,length,life,lobing,na,number,peduncle,per,perennial,primary,texture,type
235	wfo-0001028524	success	236	162	131	105	31	0.555	-3,0.3,0.5-3.5,0.6-1.4,1-5,1.1-1.2,1.5-1.6,10-20,11,2-6,2.5-3.8,2.8-3.5,3-10,3-15,3.4-3.6,4-6,4-8,6-9,7-11,8-13,acuminate,acute,adaxially,anther,anthesi,apart,apex,apical-lateral,articulated,bark,base,becoming,berry,blunt-tipped,branch,branched,brown,bud,calyx,chartaceous,closely,cm,conical,continued,corolla,cream,dark,dehiscing,deltoid,densely,diameter,dm,due,echinoid,entire,exserted,extend,ferrugineous,filament,flower,free,fruit,fruiting,glabrescent,glabrous,granular-tomentose,gray,green,greenish,growth,honeycombed,introrse,lanceolate,large,late,lateral,leaf,length,longitudinal,margin,midvein,mm,multangulate,nearly,oblong,obtuse,orbicular,ovate,ovate-lanceolate,pale,pedicel,peduncle,persistent,petiole,pore,probably,pubescent,rather,reniform,reticulate-punctate,ripe,rounded,scabridulous,side,simple,slightly,slit,somewhat,spaced,stelliform,stem,stigma,strongly,style,subcoriaceous,subglobose,suborbicular,sulcate,terete,thin,time,tomentose,translucent,tree,tube,unarmed,vein,velutinous,x,yellow,yellowish	-2.7,.5-1,/10-3/10,0-150,0.3-0.8,1.2-1.3,1.5-3,1.8-2.5,1/3-2/3,2-3.8,2.5-3.4,2.5-4,3-4.3,3.3-4,4.3-6,6-7,7-10,9-14,abaxially,accrescent,ag,along,apparently,ascending,axe,axillary,ba,blade,capitat,distal,eaf,echinoi,eed,elliptic,few-,few-rayed,first,fleshy,glabrescen,hair,half,high,indument,inserted,interpetalar,lacking,lanceolat,later,lobe,lobed,long,lower,m.,main,many-rayed,matted,midvei,mixed,nflorescence,obscured,often,older,orolla,overlapping,partly,perfect,plurifoliate,porrect-stellate,present,prominent,pseudo-terminal,rachi,ray,relatively,ruit,runk,sessile,short,short-stalked,small,sparingly,sparsely,stalked,stamen,stellate,stout-stalked,suture,tamen,testa,thick,thick-stalked,thin-stalked,tissue,tomentu,touching,unarme,unit,usually,vary,warty,way,wide,yellowish-green,ympodial,young	age,arrangement,capitate,characteristic,colour,corrugation,drying,exertion,form,glabrousnes,height,history,inflorescence,life,lobing,na,new,number,ovary,per,perennial,plant,primary,pseud-terminal,seed,shape,size,sparing,surface,texture,type
236	wfo-0001028525	success	257	133	115	142	18	0.447	.25,0.2-0.3,0.5,0.5-1.5,0.5-2.5,1-2.5,1.1-1.7,1.2-1.6,1.5,1.5-3,10,10-13,2,2-2.5,2.5-5,3,3-5,3-7,4,4-5,4-7,6,7,acuminate,acute,almost,anther,apex,apically,attenuate,bark,base,berry,black,branch,branched,branching,broadly,brown,calyx,capitate,chartaceous,clavate,cm,conical,cordate,corolla,dendritic,dendritic-pubescent,density,developed,diameter,dilated,drying,elongated,entire,fine,flat,form,frequently,fruit,fruiting,green-brown,grey,leaf,liana,light,longitudinally,lumpy,main,margin,mature,mauve,membranous,midvein,mm,multicellular-dendritic,obconical,oblong,obscuring,orange-brown,ovate,ovoid,pair,partly,pedicel,peduncle,petiole,primary,pubescent,pyriform,red-brown,ridged,scattered,shrub,side,simple,size,sometimes,sparsely,spheroidal,stem,stigma,style,surface,tertiary,trichome,truncate,unarmed,vein,venation,weakly,whitish,x,young	.4,0.2-0.6,0Â°,1-1.5,1-2,1-4,1/3-3/4,1mm,2-3,4-15,7-13,7.5,accrescent,age,along,alternate,alyx,anthesi,apar,apart,apice,apparently,around,articulated,axil,becoming,brachyblast,centre,clearly,clum,clustered,cup,curved,dark,deeply,delineated,deltoid,densely,detaching,developing,discolorous,divided,domatia-like,dorsal,dorsifixed,eaf,eed,ellipsoi,equal,erect,eye,fertilisation,fewer,filament,flattened,flexible,flexuous,flower,formed,forming,free,frui,glabrescent,glabrous,increasing,inside,known,lamina,lateral,laterally,leave,lengthening,less,like,linear,lobe,lobed,long,longer,loop,loose,lower,m.,minute,much,naked,narrowly,nflorescence,nther,often,one,orolla,outside,overlapping,pendulous,perfec,pericarp,plurifoliat,pore,poricidal,portion,prominent,protruding,puberulous,rachi,ray,rounded,ruit,scar,sessile,sinus,slender,slightly,small,smaller,smoot,smooth,somewhat,soon,spreading,stripe,structure,stump,tangling,tearing,terete,terminal,thick,thin,tip,toward,tube,ud,uneven,unit,vary,visible,well-developed,white,wide,wider,ympodial	arrangement,bud,characteristic,colour,ellipsoid,growth,inflorescence,length,lobing,na,number,ovary,per,seed,shape,texture,type,width
237	wfo-0001028528	success	155	111	87	68	24	0.561	.5,0.9-1.2,1.1-1.2,1.8-2,2-4,2.5-3,3.5-4,3/4,4-6,8-9,?,abaxial,absent,acute,age,anther,anthesi,apex,apical,attenuate,bark,basal,base,becoming,berry,bi-lobed,blackish,branch,calyx,cm,corolla,decurrent,dendritic,diameter,elliptic,except,exserted,filament,flattened,fork,fruiting,glabrous,globose,growth,immature,later,leaf,margin,minutely,mm,mucronate,narrowly,nodding,obovate,occasionally,outline,ovary,pedicel,per,petiole,pitted,plurifoliate,pore,poricidal,pubescent,reddish-brown,revolute,round,shiny,shrub,slit-like,somewhat,sparsely,stem,stigma,strongly,style,surface,tapering,terminal,tip,trichome,tube,violet,way,white,x	1-2,1.5,2-3,3.5-6,4-5,6-10,6-7,acuminate,adaxial,adaxially,along,ba,branching,conical,coriaceous,densely,denser,dichasia,eaf,edicel,eed,erect,ew,flower,free,glabrat,glandular,impressed,inserted,leave,like,lobe,lobed,long,lower,m.,midvein,minute,nflorescence,older,pair,papillo,pericarp,petal,planar,portion,prominent,pyramidal,ruit,scar,secondary,short,sleeve,stamen,ste,tall,thin,time,triangular,tub,ud,unit,vein,wide,winged,woody,ympodial,young	arrangement,bud,characteristic,colour,dichasial,exertion,form,fruit,glabrousnes,height,history,inflorescence,length,life,lobing,new,papillose,peduncle,plant,seed,shape,size,texture,type
238	wfo-0001028529	success	164	98	74	90	24	0.451	0.5,0.5-2,0.8-1.3,1-1.2,1-1.5,2/3,5-6,anther,attenuate,bark,base,berry,bluish,brown,bud,calyx,capitate,cast,cm,corolla,dark,decurrent,dia,erect,exfoliating,fruiting,furcate,glabrous,globose,green,hyaline,internodal,lanceolate,leaf,less,lobed,metallic,minutely,mm,narrowly,nearly,oblanceolate,occasionally,older,opposite,ovary,ovoid-reniform,paler,papillose,pedicel,petiole,pitted,shape,shaped,shrub,simple,size,slender,slightly,smooth,somewhat,stem,stigma,straight,style,surface,tapering,tear-drop,tube,way,white,winged,woody,yellowish	.2,0.1,0.8-3,0.8-3.2,1,1.5,2.5-3,3-40-flowered,3-5,6-9,7-8,8-14,across,acuminate,acute,age,anthesi,apart,apex,apiculate,becoming,beginning,beneath,close,cork,course,deflexe,deltoid,distal,eaf,edicel,eed,ellipsoi,elliptic,evenly,exserted,filament,flower,free,growing,heterostylous,hrub,immature,indistinct,inflorescenc,lateral,lenticellat,linear,lobe,lon,long,lower,main,major,middle,minor,minute,much,nflorescence,one,pair,papillae,papillo,planar,pore,poricidal,portion,present,prominent,range,reflexed,river,ruit,scar,scattered,short,small,soon,spaced,species,subshrub,tall,tip,ud,umbonate,variable,vein,widest,x,young	2,abaxial,adaxial,alternate,arrangement,characteristic,colour,deflexed,diameter,form,fruit,growth,height,history,inflorescence,length,lenticellate,life,lobing,perennial,plant,seed,texture,type
239	wfo-0001028532	success	186	133	108	78	25	0.581	0-19,0.2-1,1-1.7,1-2,1-3,1.3-8.7,1.4-1.6,17-42,2-3,2-8,2.2-4.2,3-10,3-5,3-7,3.9-5,4-7,5-9,5.5-15,6.5-9.2,7.5-15.2,acumen,acuminate,acute,anther,apex,attenuate,axillary,base,blade,brownish,bud,cell,chartaceous,clavate,cm,condition,connivent,corolla,covering,dark,deep,diameter,distal,drying,filament,flower,forked,fresh,fruit,generally,glabrous,globose,green,green-white,greenish,hair-like,half,herb,homostylous,interjected,lanceolate,lateral,leaf,leaflet,lobe,long,make,medium,mm,moniliform,mottled,mucilaginous,odd-pinnate,ovate,ovate-lanceolate,ovoid,pair,pedicel,peduncle,pentagonal,petiole,petiolulate,plant,purple,ripe,rotate,rounded,seed,size,sometimes,spot,stigma,straight,style,subtending,terminal,testal,thick,throughout,tube,tuber,usually,wall,wet,white,whitish,x,yellow	1-1.6,1-5,15-36,2-6,3.3-4.4,5-merou,abaxiall,abaxially,adaxially,ag,along,alyx,apart,apparently,arranged,articulated,asymmetric,axe,basiscopic,bead,berry,capitat,decreasing,digestion,dorsally,eaf,edge,eed,enzyme,erec,exceeding,flat,folded,geminat,glabrou,honeycomb-shaped,larger,lengthening,like,linear,living,lower,middl,multiple,necklace,nflorescence,orbicular,orolla,perfect,plurifoliate,pore,poricidal,removed,ruit,second,sessile,seudostipule,side,slightly,slit,spaced,specimen,stamen,stolon,subequal,symmetric,tall,tamen,tem,tip,tissue,toward,tri-,typically,unit,unwinged,vary,ympodial	5-merous,abaxial,adaxial,arrangement,calyx,capitate,colour,connivence,erect,form,glabrousnes,growth,height,history,inflorescence,length,life,ovary,pseudostipule,shape,spacing,staman,stem,surface,texture
240	wfo-0001028547	success	224	131	110	114	21	0.491	-13,-6,.2,.5,.7,.8,/5,0,0-5,0.3-0.4,1-2.5,1.2-1.4,1.7-2,2-1.5,2-2.5,2.5-2.8,2.8-3.2,3-5,3.5-4.5,4-5,7-10,absent,acute,anther,apex,apically,apparently,appearing,articulated,bark,base,berry,branched,bright,calyx,cell,cm,cream,cuneate,dark,densely,diameter,dull,elongate,entire,erect,filament,flattened-reniform,fruit,fruiting,glabrous,green,inflorescence,lateral,leaf,length,lobed,long,long-acuminate,margin,marking,maturity,mauve,mm,moderately,narrow-deltate,oblong,often,orange,orange-brown,outline,ovate,pair,pale,pedicel,peduncle,petiole,pit,poricidal,prickle,prickly,primary,purple,raised,red,reddish,reflexed,shallowly,shrub,simple,small,smooth,somewhat,spherical,spreading,stellate-pubescent,stem,style,surface,tapering,terminal,tip,truncate,tube,vein,villous,way,wide,yellow,young	-1/2,-3,/2,0-1,0-10,0-15,0-2,0-30,0.05-0.15,0.1-0.2,0.15,0.2-0.35,0.5-,0.7-1,0.8-1,1-2,1-4,1-5,1.5-2.5,1/3,1/5-1/4,10-12,2-4,2-6,4-6,5-merous,6-8,7-9,abaxial,abaxially,adaxial,alyx,apar,apart,ape,blade,branching,bulbous,chartaceous,conical,connivent,curved,deltate,discolorous,distance,drying,eaf,eed,elongating,equal,extending,faint,flattened,flower,free,gently,glabrescent,glabrou,gray-brow,infructescence,lobe,lon,long-styled,longer,lower,mature,midpoint,midvein,nflorescence,occasionally,older,one,open,orolla,oung,pendulous,per,perfect,pericarp,plurifoliat,porrect,portion,prickl,ray,rounded,ruit,scandent,scar,sessile,short-styled,side,slender,sometimes,spaced,stalk,stalked,staminate,stellate,straight,subsessile,tamen,terete,tertiary,thin-acuminat,time,trichome,unit,usually,vary,venation,woody,yellow-green,yellow-orange,ympodial	arrangement,branch,characteristic,colour,corolla,exertion,form,glabrousnes,gray-brown,growth,height,lobing,new,ovary,plant,seed,shape,size,texture,thin-acuminate,type
241	wfo-0001028587	success	178	99	76	102	23	0.427	.5,.75,0,0.3-1,0.5-1,0.8-1.6,0.8-1.8,1-1.3,1-4,2.1-6.9,2.5,6-8,6.5-17.7,abruptly,acuminate,acute,anther,anthesi,apex,bark,base,berry,brown,calyx,cm,corolla,dia,ellipsoid,filament,fruit,fruiting,geminate,glabrous,globose,green,greenish-white,impressed,leaf,length,long,minutely,mm,narrowing,nearly,obe,obovate,obovoid,ovary,ovate,ovoid-reniform,papillose,pedicel,per,persistent,petiole,pitted,poricidal,puberulent,pubescent,reflexed,seed,shrub,simple,slender,stem,stigma,style,subumbellate,surface,tip,triangular,tube,type,umbonate,white,x	.4,0.3,0.5,0.7-1.2,0.8-2.9,1-1.5,1-2,1.3-5.1,1/4,2-5,3-8,8-10,8-10-flowered,accrescent,across,baseflower,becoming,ca,chartaceou,closely,coat,cracking,cup,deflexed,degree,densely,different,difoliate,distal,drying,eaf,edicel,eed,erect,flower,forming,free,geminat,keeled,lamina,lateral,layer,like,lobe,lobed,lon,long-styled,lower,main,major,middle,midrib,minor,minute,nflorescence,occasionally,often,older,open,opposite,outer,overlappin,pair,paler,papillo,peeling,pore,portion,pubescence,pubesent,ruit,scar,scattered,short,slightly,slit-like,spaced,sparsely,stiff,straight,straw-colored,tall,terminal,thickened,thin,transversel,trichome,two,ud,unicellular,uniseriate,unit,upon,upper,usually,variable,vein,wide,widest,woody,ympodial,young	arrangement,bud,characteristic,colour,diameter,exertion,form,glabrousnes,growth,height,history,inflorescence,life,lobing,margin,new,number,peduncle,perennial,plant,shape,size,texture
242	wfo-0001028594	success	142	99	79	63	20	0.556	.5,0-100,0.8-1.8,1-1.2,1-1.3,1-1.5,1-2,1.5-9,12,12-14,2,3-4,3-9,5-6,6-20,6-7,acuminate,acute,anther,apex,base,becoming,black,bottle-shaped,calyx,cm,conical,corolla,densely,diameter,drying,ellipsoid,elliptic,exserted,filament,flattened-reniform,fruit,fruiting,glabrous,globose,green,herb,immature,inflorescence,lax,leaf,length,lobe,maturity,minute,minutely,mm,obtuse,orange-brown,ovary,ovate,pair,pedicel,per,petiole,primary,pubescent,purple,quit,reddish,rounded,simple,slightly,soft,somewhat,sparsely,spreading,stigma,strongly,style,tube,vein,violet,x	0.3-1.0,1-3,3-6,abaxially,adaxially,along,anthesi,axil,axillary,bearing,berry,capitat,cell,climbing,denser,eaf,edicel,eed,epidermal,especially,floo,flower,forest,free,glabrat,hair-like,inflorescenc,like,lon,long,lower,margin,nflorescence,noddin,often,open,papillate,pendent,planar,portion,projection,rectangular,reflexed,regular,rest,ruit,scar,scattered,side,smooth,strait,surface,tem,time,tip,trailing,trichome,tub,ud,unifoliat,uniseriate,unit,ympodial	abaxial,adaxial,arrangement,bud,capitate,colour,exsertion,form,growth,history,life,number,perennial,plant,pubescence,seed,shape,size,stem,texture
243	wfo-0001028660	success	204	95	76	128	19	0.373	0.2-1.1,0.3-1.1,0.5-5.5,0.7-4.2,0.8-1,0.9-2.5,1-2,1.5-2.8,1.5-4,1.5-7.6,2-11,2-6,2-9,3-30,3.8-13,4-6,5-8,7-10,abaxially,absent,adaxially,anther,berry,blue,brownish,chartaceous,ciliate,clavate,cm,condition,corolla,diameter,drying,elliptic,entirely,filament,flower,fresh,fruit,glabrous,globose,green,greenish,herb,homostylous,interjected,lanceolate,lateral,leaflet,linear,long,margin,membranous,minutely,mm,narrowly,odd-pinnate,ovoid,pedicel,peduncle,plant,puberulent,pubescent,purple,ripe,seed,size,stem,stigma,style,terminal,tinged,typically,white,whitish,x	0-5,0.1-0.3,0.5-2.8,1-10,2-5,20,3-5,3-7,3-9,5-merou,6,acumen,acute,ag,along,alyx,apart,apex,apparently,articulated,attenuate,axe,axillary,base,blade,borne,broadly,bud,capitat,cell,connivent,covering,decumbent,decurrent,densely,digestion,distal,dorsally,dot,eaf,edge,eed,end,enzyme,erec,especially,exceeding,except,flat,folded,forked,geminat,generally,glabrou,greatly,green-white,hair,hair-like,half,honeycomb-shaped,lengthening,less,like,living,lobe,lower,make,middl,midrib,mucilaginous,nflorescence,oblique,obtuse,often,orbicular,orolla,ovate,pair,pentagonal,perfect,petiole,petiolulate,petiolule,plurifoliate,pore,poricidal,proximal,rarely,reduced,removed,rotate,ruit,scabrous,scattered,sessile,seudostipule,short,singly,slit,spaced,sparsely,specimen,stamen,ste,stolo,straight,subequal,substellate,subtending,sunny,tall,tamen,tem,testal,thick,throughout,tip,tri-,tube,tuber,unit,unwinged,usually,vary,wall,wet,yellow,ympodial	abaxial,adaxial,arrangement,calyx,capitate,colour,form,growth,height,history,inflorescence,leaf,length,life,ovary,pseudostipule,shape,texture,type
244	wfo-0001028667	success	129	132	103	26	29	0.798	-2.6,.5,0.4-0.7,0.7-4,1-1.5,1-2-1.5,1-4.5,1-6,1.3-2,3,3-11,5,5-20,8-10,acute,aid,anthesi,apex,appearing,around,articulated,axillary,base,berry,branch,branched,calyx,cell,climbing,clustered,cm,completely,corolla,creamy,curling,deciduous,diameter,dry,ellipsoid,elliptic,entire,exfoliating,exserted,fide,flattened,flower,fragrant,fruiting,glabrous,growth,inflorescence,irregularly,leaf,like,long,margin,mentz,midrib,minutely,mm,narrowly,new,occasionally,other,outer,pale,pedicel,peduncle,per,perfect,petiole,pitted,primary,reniform,revolute,scar,shiny,shoot,short,simple,sleeve,slender,slightly,small,soon,spaced,stem,straw-colored,strongly,support,surface,terminal,tip,twice,twining,vein,vine,visible,white,woody,wrinkling,x,yellow	5-merou,alyx,apar,ark,climbin,conical,coriaceous,discolorous,eaf,eed,exfoliatin,lobe,lower,nflorescence,older,orolla,papilla,papillat,pendan,plurifoliat,tem,triangular,tube,ud,unit,ympodial	5-merous,apart,arrangement,bark,bud,characteristic,colour,corrugation,drying,exertion,exfoliation,form,fragrance,fruit,glabrousnes,height,history,length,life,na,number,papillae,pendant,plant,seed,shape,size,texture,type
245	wfo-0001028688	success	137	88	56	81	32	0.409	0.4-1,0.5,0.5-1,0.9-1,1-5,1.1-1.2,1.4-2.8,2-3,5-11,5-6,acuminate,acute,anther,apex,bark,base,branch,calyx,clavate,cm,corolla,deciduous,elliptic,exserted,filament,glabrous,globose,lanceolate,leaf,lobed,mm,near,nearly,opposite,ovary,overtopping,papillose,pedicel,petiole,pilose,reddish-brown,shaped,shoot,shrub,size,soon,stem,stigma,style,tapering,tear-drop,tip,tube,vein,white,x	.5,0.5-0.75,0.5-1.5,1-1.5,1-1.8,1-3,2.2-4.8,across,along,anthesi,apar,area,beneath,bi-cellular,curl-tipped,decreasing,deflexed,deltoid,densely,densest,dia,differing,difoliate,eaf,edicel,eed,exfoliatin,free,furcate,geminat,golden,interpetalar,irregularly,know,known,like,lobe,lon,long,lower,major,markedly,membraneous,middle,minor,minutely,nflorescence,occasionally,often,older,paler,planar,pore,poricidal,portion,proximal,pubescent,ruit,scar,shiny,sinus,slender,slightly,spaced,sparsely,straight,styl,tall,terminal,thickened,thin,trichome,tub,ud,uniseriate,unit,usually,wide,widest,ympodial,young	arrangement,bud,characteristic,colour,corrugation,diameter,drying,exertion,form,fruit,fruiting,glabrousnes,growth,height,history,inflorescence,length,life,lobing,margin,na,new,number,peduncle,per,plant,primary,seed,shape,surface,texture,type
246	wfo-0001028698	success	166	89	67	99	22	0.404	0.3-0.75,1-2,1-9.8,1.9-4,13-25,2-10,2-3,2-4,3-5,4-14,5-15,5-6,5-8,6-13,6-27,8-10,9-35,branched,broadly,calyx,cm,conical,corolla,cyme,dark,diameter,dichasial,dichasially,distal,ebracteate,ellipsoid,elliptical,forked,green,green-white,herbaceous,interjected,lateral,leaf,leaflet,light,medium,mm,monochasial,mucilaginous,odd-pinnate,ovate,ovoid,pair,pedicel,peduncle,pentagonal,perennial,petiole,plant,puberulent,pubescent,rotate,seed,size,strigose,style,terminal,throughout,violet,white,yellow	0-1.,1-4,1.8-5,3-17,3-6-foliat,3.5,6,abaxiall,abaxially,acumen,acuminate,acute,adaxially,apex,apical,apically,articulate,base,cell,commonly,connate,covering,cuneate,darker,decurrent,dehiscent,digestion,diminishing,dorsally,dot,eaf,edge,eed,emoval,enzyme,equal,exceeding,filament,first,flat,flower,folded,generally,globo,gradually,hair-like,half,honeycomb,introrse,living,lobe,lon,long,long-attenuate,lower,lunat,make,maturing,minute,nflorescence,nther,oblique,often,orolla,pattern,perfect,petiolule,plan,poricidally,proximal,rachi,raised,rarely,reveal,ruit,sessile,seudostipule,short,slit,smooth,specimen,stamen,stigma,straight,tal,tem,testal,thick,toward,tuber-bearing,two,typically,unit,usually,vary,wall,wide,ympodial,Â¼	0-10,abaxial,adaxial,anther,arrangement,branching,colour,form,fruit,growth,height,history,inflorescence,length,life,ovary,pseudostipule,shape,stem,surface,texture,width
247	wfo-0001028716	success	145	92	70	75	22	0.483	.2,.5,0.6-1.9,1-2,10-40-flowered,11-16.4,2.5-8,3.6-8.8,7-8,8-9,acuminate,anther,anthesi,apex,appearing,bark,base,bi-cellular,brown,calyx,cm,corolla,cuneate,dark,decurrent,dia,ellipsoid,except,filiform,glabrous,glandular,hirsute,leaf,like,lobe,long,long-triangular,minutely,mm,nearly,node,often,ovary,ovate,papillose,pedicel,petiole,pointed,puberulent,pubescent,reflexed,shape,shaped,shrub,simple,size,slightly,sparsely,stem,straight,style,tear-drop,triangular,trichome,truncate,uniseriate,white,widening,x,young	0.5,0.75,1.9-5.5,2-4,2.2-7.9,5-6,9-10,across,anisophyllou,apart,asymmetric,ba,becoming,beginning,beneath,branched,deflexed,differing,difoliate,eaf,edicel,eed,elliptic,evenly,fertilization,fifth,filament,free,fruit,geminate,inflorescenc,intermediate,know,known,lateral,lengthening,lenticellat,less,lobed,lon,lower,main,major,markedly,middle,minor,much,nflorescence,older,one,opposite,orbicular,pair,pore,poricidal,portion,prominent,proximal,raised,remaining,rounded,ruit,scar,spaced,stigm,strongly,tall,tip,tube,two,ud,unit,vein,widest,ympodial	alternate,arrangement,bud,characteristic,colour,diameter,exertion,form,growth,height,history,inflorescence,length,lenticellate,life,lobing,peduncle,perennial,plant,stigma,surface,texture
248	wfo-0001028723	success	211	121	109	102	12	0.517	-1.5,0.2,0.8-1,0Â°,1-1.8,1-2.2,1-2.5,10-15,10-16,2-2.5,2-2.7,2-4,3.5-4,4-5,5,5-6,5-7,abaxial,abaxially,acute,adaxially,almost,anther,apex,bark,base,brachyblast,branch,branched,branching,broadly,brown,calyx,capitate,clustered,cm,common,corolla,dark,dendritic,developed,diameter,domatia,drying,elliptic,entire,except,faint,filament,fine,flat,flower,glabrous,green,junction,leaf,length,liana,like,long,long-attenuate,longitudinally,main,margin,membranous,midvein,minutely,mm,mostly,obconical,oblong,obovate,occasional,orange-brown,pair,pedicel,peduncle,petiole,poorly,primary,pubescent,raised,ray,ridged,short,shrub,side,simple,smooth,sparsely,spreading,stem,stigma,style,surface,terminal,tertiary,tip,trichome,tube,unarmed,unevenly,vein,venation,white,widely,wrinkled,x,youngest	.3,.5,0-0.5,0.8-2,1,1-1.5,1/3-1/2,1/5-1/3,2.5,3-4,4,age,alternate,alyx,another,anthesi,apar,apically,apice,apparently,articulated,becoming,clearly,concolorous,conical,curved,decurrent,delineated,deltoid,densely,density,dilated,divided,dorsifixed,eaf,eed,ellipsoi,equal,ey,flexuous,formed,free,frequent,gradual,increasing,inner,know,known,lengthening,less,lobe,lobed,lower,m.,middle,much,multiply,naked,narrowly,nflorescence,nther,obtuse,one,orolla,outer,ovate,overlapping,pale,papillo,perfec,plurifoliat,pore,poricidal,portion,prominent,protruding,rachi,region,regular,ruit,scar,separated,sinus,slender,small,smaller,stump,surrounding,tearing,tissu,toward,transition,tuft,ud,uneven,unit,vary,visible,wide,yellow,ympodial,young	arrangement,characteristic,colour,form,growth,inflorescence,lobing,papillose,presence,shape,size,texture
249	wfo-0001028736	success	180	121	101	79	20	0.561	0.2-0.4,0.5,0.5-1,0.5-1.5,1,1-1.5,1-2,1-3,10-15,2-5,3-6,4-12,4-6,5-10,5-15,6-13x3-8,absent,acute,anther,apex,armed,attenuate,base,berry,brown,chartaceous,cm,connivent,created,cylindrical,dark,decurrent,densely,diameter,discolorous,either,extra-axillary,filament,flower,fruit,glandular,green,hair,immature,leaf,length,light,like,lobe,long,major,many,mature,midvein,mm,moderately,mottled,multicellular,nearly,netlike,obtuse,occasionally,onto,orange,pedicel,peduncle,per,petiole,pit,porrect-stellate,prickle,pubescent,raised,recurved,red,reniform,rhombic,ridge,roselike,shrub,side,simple,slightly,small,sparsely,stellate,stem,stigma,style,surface,tapering,thin-skinned,unarmed,unbranched,uniseriate,unlobed,vein,white,x,yellow,yellow-white	0.5-1mm,0.5-2,1.5,1.5-3,1/6,2-4,2-7,3-5,3-8,3.5-5,4-9,40-70,5-merou,6-8,abaxially,accrescent,adaxiall,adaxially,alyx,apar,apical,apparently,axe,beyond,blade,calyx,contiguous,cordate,cut,difoliate,directed,eaf,eed,exserted,filiform,flattened,frui,fruiting,geminate,glabrou,glabrous,globose,gree,introsel,less,lobed,lower,m.,midpoint,midrib,multiseriate,narrowly,nflorescence,occasional,orolla,pair,perfect,pore,purple,rachi,ray,ruit,scanden,sinus,spaced,stalk,stamen,ste,tamen,tem,triangular,tube,unequa,unicellular,unit,vary,way,wide,ympodial	abaxial,adaxial,arrangement,characteristic,colour,corolla,form,growth,height,inflorescence,lobing,ovary,plant,pubescence,seed,shape,size,staman,texture,type
250	wfo-0001028737	success	151	115	67	84	48	0.444	0.2-0.5,0.7-2,1,1-2.5,1-4,1-6,1.5-3.5,10,12-14,16-30,2-5,2.8-3.5,3-5,4-6.5,4-9,6,7-15,acute,apex,apiculate,base,branched,calyx,caudate,cm,corolla,cyme,diameter,dichasial,dichasially,distal,ebracteate,elliptic-lanceolate,filament,glabrescent,glandular,globose,green,green-white,herbaceous,interjected,lanceolate,lateral,leaf,leaflet,lobe,long,mm,monochasial,mucilaginous,oblique,oblong,odd-pinnate,ovoid,pedicel,peduncle,perennial,petiole,plant,seed,size,stigma,style,terminal,throughout,tuber-bearing,wide	2-3,3-4,3-6-foliat,4-10,5-6,abaxially,absen,acumen,acuminate,adaxially,apical,apically,articulate,attenuate,cell,connate,covering,decurrent,dehiscent,digestion,diminishing,dorsally,eaf,edge,eed,emoval,enzyme,exceeding,flat,flower,folded,forked,generally,globo,gradually,hair-like,half,honeycomb,introrse,larger,living,lon,lower,make,maturing,nflorescence,nther,often,orolla,pair,pattern,perfect,pinnatifi,plan,poricidally,proximal,rachi,reveal,ruit,second,sessile,seudostipule,short,slit,specimen,stamen,stellate,straight,strongly,tal,tem,testal,thick,throughou,toward,typically,unit,vary,wall,whit,without,yellow,ympodial,Â¼	absent,anther,appearance,arrangement,bark,border,branch,bud,characteristic,colour,corrugation,drying,exertion,form,fruit,fruiting,giving,glabrousnes,growth,height,history,inflorescence,length,life,lobing,margin,midpoint,na,new,number,ovary,per,prickle,primary,pseudostipule,ray,shape,stem,surface,texture,thicknes,tube,type,variation,vein,wet,white,width
251	wfo-0001028777	success	205	129	105	100	24	0.512	-2.5,-4,.5,.9,0-2,0-30,0.4-0.8,0.5-1.3,0.6-1,0.7-1.2,0.7-1.3,0.8-1,0.8-2.2,1-2.5,1.5-3,1.5-4,1.8-2.5,2-,2.5,3,3/4-4/5,abaxially,acute,anther,apex,apically,articulated,attenuate,bark,base,berry,branched,calyx,chartaceous,cm,concolorous,dark,deltate,diameter,discolorous,drying,entire,erect,filament,flattened-reniform,fruit,fruiting,glabrescent,glabrous,green,green-brown,inflorescence,leaf,length,lobed,long,margin,marking,maturity,mauve,mm,moderately,obovate,orange,orange-brown,ovate,pair,pale,pedicel,peduncle,per,petiole,poricidal,primary,red-brown,reflexed,retuse,rounded,shoot,short,shrub,simple,small,sometimes,sparsely,spherical,stellate-pubescent,stem,style,surface,tapering,terete,terminal,tip,tree,truncate,tube,unarmed,vein,way,white,whole,wide,yellow-green,young	-10,-12,-3,.8,0.1-0.2,0.1-0.3,0.2,1,1-2,1-3,1.5,1/4,1/4-1/2,2.5-3,2.5-5,3.5-5,4-5-merous,4.5-8,6-10,7-11,8,8-15,acuminat,alyx,ame,apar,ape,blade,briefly,c.,connivent,curved,deciduou,eaf,eed,elongating,equal,faint,flower,free,glabrescen,infructescence,lengt,less,lobe,long-styled,longer,lower,mature,midpoint,minute,multangulate,narrow-deltate,nflorescence,occasionally,older,one,open,orolla,oung,perfect,pericarp,plurifoliat,porrect,portion,present,ray,recurved,reflexe,ruit,scar,sessile,short-styled,shorte,shorter,smooth,somewhat,soon,spaced,spreading,stalk,stalked,staminate,stellate,stout,strongly,tamen,tertiary,time,trichome,unarme,unit,usually,variously,vary,venation,visible,wider,woody,ympodial	acuminate,arrangement,branch,bud,characteristic,colour,corolla,exertion,form,glabrousnes,growth,height,lobing,na,new,number,ovary,plant,seed,shape,size,stigma,texture,type
252	wfo-0001028791	success	257	156	121	136	35	0.471	+,-9,0-6,0.05-0.2,0.2-0.3,0.3-0.6,0.4-0.6,0.4-0.65,0.6-0.8,0.8-1.3,1-1.5,1.5-2,1.7-2.1,1.8-3.3,10,2-3,2-7,2-locular,2.8-3.0,4-5+,5-15,5-22,9-30,9-35,absent,acuminate,acute,anther,anthesi,apex,articulated,basal,base,beneath,branched,breaking,broadly,brown,calyx,capitate,cell,clambering,cm,conical,corolla,dark,deciduous,deltate,densely,developed,diameter,dichotomously,elliptic,entire,exserted,filament,fruit,fruiting,glabrous,globose,green,hair-like,half,halfway,imparipinnate,interjected,interrupted,lateral,leaf,leaflet,less,liana,lobe,long,many,margin,middle,minutely,mm,near,oblique,obovate,occasionally,outgrowth,ovary,pale,paler,pedicel,peduncle,per,petiole,plant,poorly,present,primary,pseudostipule,pubescent,scandent,seed,slightly,somewhat,sparsely,stellate,stem,stigma,style,surface,terminal,testa,thick,thickened,time,truncate,tube,usually,vein,wall,white,wide,woody,yellow	-0.6,-1.5,.5,0.05,0.2-0.4,0.2-0.8,0.25-0.3,0.3-0.4,0.3-0.5,0.3-0.8,0.4-0.5,0.4-1.1,0.45-0.55,0.5,0.6-0.9,0.7-1.5,0.8-1,1-2,1-2-celled,1-3,1-3-celled,1-celled,1.5-,1.6-4.5,100,2-3.5,2-7-celled,2.5-4.5,20-to,3-,3-4,4-11.5,4-15,4-celled,5-,5-10,5-plurifoliate,50-80,8-10-celled,abaxially,absen,abundant,adaxially,addition,ag,along,apical,appearance,appendage,articulation,basiscopically,berr,border,bullate,colo.,column,consistently,darker,densest,eaf,ebracteate,edicel,eed,eglandular,elongating,enlarged,even,extended,flower,free,give,glabrescent,glandular,gree,grow,growing,head,internode,lamina,large,leaving,like,lon,lower,midvein,mixture,much,multicellular,nflorescence,often,pair,papillate,petiolule,protuberance,pubescence,rachi,reflexed,rest,rough,round,ruit,sandpapery,secondary,sessile,short,shorter,silky,simple,single,small,smaller,sometimes,sparse,spreading,stamen,staminal,sterile,stiff,straight,tal,tem,tertiary,tip,touch,transparent,trichome,ud,unicellular,uniseriate,unit,upper,vegetation,vine,winged,ympodial,â1-2-celled	2,arrangement,bark,branch,bud,characteristic,colour,corrugation,dense,distal,drying,exertion,form,glabrousnes,growth,height,history,inflorescence,length,life,lobing,midpoint,na,new,number,perennial,prickle,ray,shape,size,texture,thicknes,type,variation,width
253	wfo-0001028798	success	214	113	86	128	27	0.402	0-1,0.2-0.4,0.9-1.2,1-4.5,1.5-1.8,10,15-19,2-6,2-7,3-4,3-5,5-8,6-10,7-8,8-18,acuminate,acute,anther,apex,attenuate,base,becoming,berry,blunt-tipped,branch,bud,chartaceous,cm,conical,continued,corolla,decurrent,diameter,dm,due,entire,filament,flower,fruit,granular,green,greenish,growth,lanceolate,lateral,leaf,length,lined,long,margin,midvein,mm,nearly,oblanceolate,oblong,obovate,orbicular,ovate-lanceolate,pale,pedicel,peduncle,persistently,petiole,probably,pseudo-terminal,ripe,rotate-stellate,rough,rough-granular,short,shrub,side,simple,slightly,stem,stigma,style,subcoriaceous,subglobose,sulcate,tomentose,unarmed,vein,x,yellow,yellowish	.5-5,0-60,0.5-2,1-3,1-6,1.1-2,1/2-2/3,1/20,2-3,2-3.75,2.4-4.4,2.5-3.5,2.6-4,2/3,3.3-5.6,3.8-4.2,4-5.4,5.25-7.5,6-8,8.5-13,abaxially,accrescent,adaxially,ag,anthesi,apart,apical-lateral,apparently,articulated,axe,axillary,ba,blade,boat-shaped,branched,calyx,capitat,curved,cylindrical,dehiscing,densely,distal,downward,eaf,echinoi,echinoid,eed,exserted,extend,fleshy,free,fruiting,glabrous,granular-tomentose,hair,hal,high,included,inserted,introrse,irregularly,lacking,large,less,lobe,lobed,longitudinal,lower,m.,main,many,minutely,mixed,multangulat,multangulate,nflorescence,oblanceolat,obscured,obtuse,often,orolla,oung,overlapping,perfect,persistent,plurifoliate,pore,porrect-stellate,present,prominent,pubescent,quite,rachi,rather,ray,ruit,semi-ovate,sessile,short-stalked,slit,small,somewhat,spaced,sparingly,splitting,stalked,stamen,stellate-pubescent,strongly,subcampanulate,suture,tamen,thick,time,tip,tomentu,tomentum,toward,translucent,tube,unarme,unit,unknow,vary,velutinous,way,wide,ympodial	arrangement,bark,capitate,characteristic,colour,exertion,form,glabrousnes,height,history,inflorescence,life,lobing,na,new,number,ovary,per,perennial,plant,primary,seed,shape,size,surface,texture,type
254	wfo-0001028815	success	196	107	89	107	18	0.454	0.4-0.8,0.5-1,1-2,1-3.5,1-4,1-5,10-15,14-28,2-4,2.5-6.5,22-35,3-4,3-5,3-7,4-10,5-6,6-10,6-8,7-16,abaxially,acumen,adaxially,anther,auriculate,axillary,berry,blade,brownish,bud,chartaceous,cm,condition,corolla,dark,diameter,distal,drying,elliptic-lanceolate,filament,forked,fresh,fruit,generally,glabrous,globose,green,greenish,half,herb,interjected,lateral,leaflet,lilac-purple,lobe,long,medium,membranous,mm,narrowly,odd-pinnate,ovoid,pedicel,peduncle,petiole,plant,pointed,pubescent,purple,red-purple,ripe,rotate,rugose,seed,size,sparsely,splotched,stem,stigma,style,subtending,terminal,terminated,tinged,triangular-lanceolate,unwinged,usually,whitish,winged,x	1-10,2-4.5,2-9,5-7,5-merou,acute,ag,along,alyx,apart,apex,apparently,articulated,articulation,axe,base,basiscopic,broadly,capitat,cell,ciliate,connivent,covering,cuneate,decreasing,decurrent,developing,digestion,distinct,dorsally,eaf,edge,eed,elliptic,enzyme,especially,exceeding,flat,flower,folded,geminat,glabrou,green-white,hair,hair-like,hal,high,homostylous,honeycomb-shaped,indistinct,lanceolate,lengthening,like,living,lower,make,margin,midrib,minutely,mucilaginous,nflorescence,obtuse,onto,orolla,ovate,pair,papillose,perfect,petiolulate,plurifoliate,pore,poricidal,puberulent,purpl,rachi,removed,rounded,ruit,semi-erec,semi-rosette,sessile,seudostipule,short,side,slightly,slit,spaced,specimen,stamen,ste,straight,tall,tamen,tem,testal,thick,throughout,tip,tri-,tube,unit,vary,wall,wet,yellow,ympodial,young	arrangement,calyx,capitate,characteristic,colour,form,growth,height,history,inflorescence,leaf,length,life,ovary,pseudostipule,shape,texture,type
255	wfo-0001028876	success	127	89	70	57	19	0.551	.5,/4,0.4-1,0.5-2,1-2,1.5-2,2-2.3,3-5,4-5,5-6,abaxially,adaxially,along,anther,bark,base,brown,calyx,capitate,cm,conical,corolla,dark,dendritic,densely,dia,difoliate,drying,elliptic,filament,flower,glabrous,golden,hroughout,internodal,leaf,like,lobed,long,midrib,mm,occasionally,opposite,pedicel,petiole,pubescent,reddish,rest,sagittate,shining,shrub,simple,small,sparsely,speciman,stem,stigma,style,subshrub,surface,tall,trichome,tube,type,uniseriate,unit,way,white,x,young	1.5-3,3-8,4-8,abaxial,acute,anthesi,apex,attenuate,branched,closely,eaf,edicel,eed,ellipsoid,free,geminat,glabrat,included,inflorescenc,know,known,lamina,lateral,leave,lobe,long-triangular,lower,main,middle,minutely,nflorescence,nodding,older,ovary,overlappin,pair,papillae,papillo,papillose,planar,pore,poricidal,portion,rounded,ruti,scar,shaped,slender,spaced,straight,tear-drop,tip,tub,ud,vein,widest,ympodial	arrangement,characteristic,colour,diameter,form,fruit,geminate,growth,history,inflorescence,length,life,lobing,na,seed,shape,size,sympodial,texture
256	wfo-0001028883	success	207	102	78	129	24	0.377	5,50,abaxially,acute,adaxially,almost,anther,apex,articulated,base,berry,brochidodromous,calyx,capitate,chartaceous,cm,completely,concolorous,connivent,coriaceous,cylindrical,dark,deltate,densely,diameter,drying,dull,elliptic,exfoliating,flattened,flower,fruit,glabrescent,glabrous,glandular,globose,green,growth,herb,lateral,leaf,length,margin,mm,moderately,narrowly,oblong,pedicel,peduncle,per,petiole,pubescence,pubescent,reniform,ripe,seed,sessile,similar,simple,size,slightly,sparsely,stellate,stem,stigma,straight,style,subopposite,subsessile,surface,trichome,undulate,venation,white,whitish,woody,yellow,Ã	0.3â0.6,0.4â1.2,0.5â2,0.6,1,1.5â7,1â2,1â6,2,2â3,2â5,3â5,4,4â6,5-merou,6,6â10,6â12,absent,accrescent,acuminate,adaxiall,along,alyx,antrorse,antrorsely,apar,arched,ark,ascending,attenuate,axi,becoming,blade,branch,brow,capitat,cell,ciliate,circular,common,curved,cyme,decurrent,differing,directed,eaf,eed,elliptic-ovate,emarginate,entire,equal,erect,eye,filament,frui,geminate,geniculat,glabrou,greenish,head,hilum,hollow,impressed,introrsely,less,light,like,lobe,long,longitudinal,lower,lying,membranaceous,midrib,minor,multicellular,naked,new,nflorescence,normally,notably,obtuse,often,older,onto,opening,orolla,ovate-lanceolate,parallel,pendan,perfect,plurifoliate,pore,poricidal,present,primarily,prominent,rachi,rarely,region,rounded,ruit,secondary,shap,shiny,shrub,single,single-celled,slit,small,sometimes,spaced,sparse,spreading,stalk,subapical,swollen,tall,tamen,tem,unbranched,uniseriate,unit,vary,vein,visible,wide,ympodial	1-2,2-3,2-5,3-5,4-6,6-10,6-12,arrangement,bark,characteristic,colour,corolla,form,height,history,inflorescence,life,number,ovary,plant,shape,staman,texture,type
257	wfo-0001028885	success	214	130	109	105	21	0.509	-1,0.3-0.5,0.5-1,0.7-2,1-1.2,1-2,1.5-1.7,1.5-3.5,10-20,2.3-2.5,2/3,3-5,7-8,9-11,?,acute,adaxially,along,anther,anthesi,apex,attenuate,basal,base,berry,black,branched,brown,calyx,capitate,cm,corolla,cup-shaped,dark,decurrent,densely,diameter,ellipsoid,elliptic,entire,erect,exserted,extending,filament,flower,fruiting,furcate,glabrescent,glabrous,globose,golden,gradually,groove,growth,height,immature,inflorescence,lamina,lanceolate,lateral,leaf,like,lobed,long,margin,midvein,minute,mm,mostly,multicellular,narrowing,narrowly,new,nodding,occasionally,pedicel,peduncle,petiole,plant,pubescent,purple,quarter,reddish,revolute,rhachi,ripe,scandent,shrub,simple,slender,slightly,sometimes,sparsely,stem,stigma,strongly,style,surface,terminal,third,time,trichome,tube,uniseriate,vine,way,winged,woody,Â¾	.5,0.5-5,1-1.5,1-3,2,2-,2-2.5,2.5-3.5,3.5-4.5,3.5-8.5,4-5,5-merou,7-9,9-12,abaxial,adaxial,ag,alyx,apart,apiculate,apparently,archin,ark,articulated,blackish,branch,broadly,cell,collapsing,connivent,dark-pigmented,deltate,dendriti,distal,dried,drying,eaf,eed,fleshy,free,glabrou,glandular,groupe,ilament,inserted,irregularly,known,leaving,lengthening,less,live,lobe,loosely,lower,material,minutely,nflorescence,noddin,often,older,orolla,pair,papillo,part,peg,perfect,pericarp,pigmentation,plurifoliat,pore,poricidal,portion,primary,recorded,retaining,ruit,scar,scattered,shin,shiny,short,sleeve,slit,small,smaller,spaced,spheroidal,spreading,stellate,tangled,tem,thin,tip,twinin,ud,unit,upper,usually,vary,vein,wall,weak,weak-walled,wide,ympodial	arrangement,bark,bud,characteristic,colour,dendritic,exertion,form,fruit,glabrousnes,length,lobing,na,number,ovary,per,seed,shape,size,texture,type
258	wfo-0001028888	success	207	116	95	112	21	0.459	0-3.5,0-7,0.15-0.5,1-1.5,1-2,1.5-4,10-25,12.5-25,2-6,2.3-5,2.3-7,2.5-3.3,3-4,3.6-12.5,3.8-8.3,4-7,5-10,5-7,6-11,8-11,8-13.5,abaxially,acuminate,acute,adaxially,anther,apex,base,berry,blade,brownish,chartaceous,clavate,cm,condition,connivent,corolla,covered,diameter,drying,filament,flower,fresh,fruit,glabrous,globose,green,greenish,hair,herb,homostylous,interjected,lanceolate,lateral,leaflet,like,lobe,long,membranous,minutely,mm,mottled,oblique,odd-pinnate,ovoid,pedicel,peduncle,pentagonal,petiole,plant,puberulent,pubescent,purple,ripe,rounded,seed,short,size,slightly,sparsely,stem,stigma,straight,streak,style,subglabrous,substellate,terminal,tube,typically,violet,white,whitish,x,yellow	0-5,1,1-10,1-3,2-5,3-5,4-25,5-merou,acumen,ag,along,alyx,apart,apiculate,apparently,articulated,axe,axillary,broadly,bud,capitat,cell,center,central,ciliate,covering,cuneate,digestion,distal,dorsally,dot,eaf,edge,eed,elliptic,end,enzyme,erec,especially,exceeding,except,flat,folded,forked,geminat,generally,glabrou,glaucous,greatly,green-white,hair-like,hal,half,honeycomb-shaped,lengthening,less,living,low,lower,make,margin,middle,midrib,mucilaginous,nflorescence,often,one,orbicular,orolla,ovate,pair,perfect,petiolulate,petiolule,placed,plurifoliate,pore,poricidal,proximal,reduced,removed,ruit,scattered,sessile,seudostipule,slit,sometimes,spaced,specimen,stamen,ste,stolo,subequal,subtending,tall,tamen,tem,testal,thick,throughout,tip,tri-,truncate,tuber,unit,unwinged,usually,vary,wall,wet,wing,ympodial	5-merous,abaxial,adaxial,arrangement,calyx,capitate,colour,erect,form,growth,height,history,inflorescence,leaf,length,life,ovary,pseudostipule,shape,texture,type
259	wfo-0001028920	success	152	101	82	70	19	0.539	.25,.5,0.2-1,0.5-1,0.8-1.1,1-1.2,1-1.5,1-2.4,1-3,3-15-flowered,6-6.5,abaxially,acuminate,acute,adaxially,anther,apex,arachnoid,arachnoid-pubescent,area,attenuate,bark,base,berry,brown,calyx,cm,congested,corolla,dark,decurrent,dia,difoliate,ellipsoid,elliptic,erect,exserted,flower,fruiting,glabrous,globose,green,later,leaf,lightly,lobed,long,long-styled,minutely,mm,nearly,obovate,obovoid,occasionally,ovary,ovoid-reniform,papillose,pedicel,petiole,pitted,pubescent,shape,shaped,short-styled,shrub,simple,size,small,sparsely,stem,stigma,strongly,style,surface,tear-drop,tip,tree,trichome,tube,unifoliate,white,winged	1.5-2,2-2.5,2-7,3-3.5,3-4,5-9,6-15,anthesi,axil,ba,broadly,brownish,closely,conical,cucullate,deflexed,deltate,dendritic,dense,densely,differing,eaf,edicel,eed,felty,filament,fleshy,free,geminat,glabrate,gray-brow,lateral,lobe,lon,lower,main,major,middle,minor,nflorescence,older,opposite,overlappin,pair,planar,pore,poricidal,portion,present,pubescence,ruit,scar,somewhat,soon,spaced,styl,tall,tapering,thick,tub,tuft,ud,uniseriate,unit,vein,widest,woody,x,ympodial,young	arrangement,bud,characteristic,colour,diameter,exertion,form,fruit,geminate,gray-brown,growth,height,inflorescence,length,lobing,plant,seed,texture,type
260	wfo-0001028929	success	210	131	109	101	22	0.519	.5,.7,.9,/5,0-1,0-10,0-3,0.3-0.6,0.4-0.8,0.5-2,0.7-2,0.8-1,1-1.1,1.5-2.4,2-3,2.2-2.3,2.5-4,2.7-3,4-6,5-6,5-7.5,abaxial,abaxially,acute,adaxial,anther,apex,apparently,articulated,bark,base,berry,branched,calyx,cell,chartaceous,cm,concolorous,connivent,cuneate,curved,densely,diameter,discolorous,drying,dull,elliptic,erect,filament,flattened-reniform,fruit,fruiting,gently,glabrescent,glabrous,inflorescence,lateral,leaf,length,lobed,long,margin,maturity,minutely,mm,obovate,obtuse,orange-brown,outline,pair,pedicel,peduncle,petiole,pit,poricidal,porrect,prickle,prickly,primary,raised,red,red-brown,red-green,reticulate,sessile,shrub,simple,slender,small,smooth,sometimes,spherical,stalked,stellate-pubescent,stem,style,surface,tapering,terete,tip,trichome,tube,unarmed,vein,way,white,wide,yellow,yellow-green	-2,-2/3,0,0-20,0.1,0.15-0.3,0.2-0.3,0.2-0.4,0.2-0.8,0.5-1.5,0.7-1,1,1-3,1/2,1/4-1/3,2-4,2-6,2-9,2/3-3/4,3-20,3-4,5-25,5-merous,6-8,7-9,8-10,acicular,alyx,apar,apart,ape,apically,blade,difoliate,distance,eaf,eed,elongating,equal,extending,flower,foliaceous,free,geminat,glabrou,gra,hair,infructescence,lobe,lon,long-styled,longer,lower,mature,midpoint,midvein,minute,narrow-deltate,narrow-ovate,nflorescence,oblong,obtu,occasionally,older,one,open,orolla,oung,pale,patch,pendulous,per,perfect,pericarp,perpendicular,portion,prickl,ray,rounded,ruit,scar,short-styled,side,spaced,spreading,stalk,staminate,stellate,straight,subsessile,tamen,tertiary,time,unit,usually,variously,vary,venation,visible,woody,ympodial	arrangement,branch,characteristic,colour,corolla,exertion,form,glabrousnes,gray,growth,height,lobing,na,new,ovary,plant,seed,shape,size,stigma,texture,type
261	wfo-0001028963	success	197	132	104	93	28	0.528	/2,0-0.4,0-2,0.3-0.6,0.3-0.7,0.3-1,0.3-1.5,0.45-0.6,0.6-0.9,0.6-1,0.8-1.8,0.9-1.5,2-2.3,2-4,2-9,2.4-2.8,5-25,6-10,abaxially,acute,anther,apex,apically,apparently,articulated,attenuate,bark,base,berry,bright,broad-deltate,brown,calyx,cell,chartaceous,cm,concolorous,densely,diameter,discolorous,drying,dull,entire,erect,evenly,filament,flattened-reniform,fruiting,gray-green,green,herb,inflorescence,lanceolate,lateral,leaf,length,light,lobed,long,lower,margin,maturity,mauve,mm,moderately,narrow-cuneate,narrow-elliptic,obtuse,orange,outline,pair,pale,pedicel,peduncle,per,petiole,pit,poricidal,primary,purple,raised,red,shrub,simple,small,smooth,spherical,stellate,stellate-pubescent,stem,style,surface,tapering,terete,terminal,tip,tube,unarmed,unbranched,vein,way,wide,yellow-orange,young	.5,0.1,0.1-0.2,0.1-0.25,0.15-0.3,1-4,1.5-2,1/,1/4-1/3,1/5,1/6,2-3,2-5,3-4.5,3.5-4.2,4-10,4-8,5-merous,7-8,alyx,apar,ape,becoming,blade,connivent,curved,cuspidat,deltate,difoliate,eaf,eed,elongating,equal,eye,flower,free,frui,geminat,glabrescent,glabrous,gra,herbaceous,infructescence,less,lobe,long-styled,longer,mature,midpoint,naked,narrowly,nflorescence,occasionally,older,one,open,orolla,oung,pendulous,perfect,pericarp,porrect,portion,ray,ruit,scar,sessile,short-styled,shorter,slender,slightly,spaced,spreading,stalk,stalked,staminate,straight,subsessile,tamen,tertiary,time,trichome,unarme,unit,upper,usually,variously,vary,venation,visible,winged,woody,ympodial	1,1/2,arrangement,branch,bud,characteristic,colour,corolla,cuspidate,exertion,form,fruit,glabrousnes,gray,growth,height,lobing,na,new,number,ovary,plant,seed,shape,size,stigma,texture,type
262	wfo-0001028971	success	225	115	92	133	23	0.409	.1-0.2,0.1-0.4,0.25-0.6,0.4-0.9,1-2,1.75-2.5,10-15,15-30,2.2-3.5,2.5-3.5,20-35,3-6,4-5,4-9,5-10,6-16,acute,acute-,adaxially,anther,apex,appearance,articulated,attenuate,base,branched,broadly,calyx,campanulate,close,cm,coarsely,connivent,deltoid,dentate,diameter,erect,extra-axillary,farinaceous,filament,flower,form,fruit,globose,inflorescence,lanceolate,lateral,leaf,length,lenticular,lignescent,linear-lanceolate,lobe,margin,minutely,mm,narrowly,obtuse,often,orange,outline,ovate,ovate-lanceolate,pair,pedicel,peduncle,perennial,pitted,pubescent,reniform-ovate,ripe,round-tipped,sericeous,short,side,simple,spreadingly,stellate,stem,stigma,style,surface,tan,termination,thin-textured,truncate,unbranched,usually,vein,white,x,yellow	-0.8,-1.4,0.1-0.5,0.2-0.5,0.25-1.25,0.3-0.6,0.4-1.5,0.8-2.5,05-2.5,1-5,1.5-2.2,1.5-4,1/5-1/2,2-5,2-foliate,2.5-4.5,2.5-5,3-14,3-5,5-15,5-8,6-8.5,6-9,7-16,abaxially,adaxiall,along,also,apart,appearing,armed,ascending,axe,ba,bearing,becoming,blade,broad-based,capitat,cauline,compressed,cylindrical,delicate,densely,directed,distal,distall,eaf,eed,elongate,elongate-deltoid,entire,essentially,felty,felty-pubescent,female-sterile,frequently,geminat,glabrous,grading,growt,hair,inserted,interlobal,invested,largest,later,laterally,least,like,lon,long,longer,longest,lower,major,manifestly,maturit,midpoint,midrib,minute,mixture,much,multiseriate,nflorescence,numerous,occasionally,one,orolla,other,ovate-apiculate,per,persistent,petiole,pore,prickle,prickly,principal,rachi,ray,reduced,ruit,scattered,sessile,short-stalked,shorter,similar,sinus,smaller,sometimes,spaced,sparse,spreading-hirsute,stalk,ste,stellae,stellate-pubescent,stipitate,tal,tamen,tem,time,tooth-like,trichome,tube,underdeveloped,unit,variable,variously,vary,well-developed,wide,ympodial	arrangement,branch,capitate,characteristic,colour,corolla,exertion,glabrousnes,growth,height,herb,history,life,lobing,new,ovary,plant,primary,seed,shape,size,texture,type
263	wfo-0001028975	success	163	110	75	88	35	0.46	1,1-3,1-5,1.2-1.5,1.5-1.8,3-6.5,6-6.5,7.5-15,8-9,acuminate,acute,anther,apex,area,bark,base,berry,broad,brown,calyx,cm,conically,corolla,cup-shaped,dark,decurrent,densely,dia,elliptic,exserted,filament,fruit,fruiting,glabrous,globose,green,immature,late,lateral,leaf,length,lobed,long,main,margin,minutely,mm,nearly,once-furcate,ovary,ovoid-reniform,pair,pedicel,petiole,pitted,pubescent,shaped,shiny,shrub,simple,size,sparsely,stem,stigma,straight,style,surface,tapering,tear-drop,tip,tube,vein,white,wide,x	.2,.5,0.1-1,0.5-1,1.5-2,2.2-6,3-10-flowered,3-3.5,5-ribbed,5.5-10,?,along,anthesi,apart,appearing,beneath,closely,conical,corky,deflexed,denser,differing,difoliate,eaf,edicel,eed,entire,epidermi,equal,erect,extension,free,geminat,golden,hyaline,large-celled,like,lobe,lon,lower,mainly,major,member,mere,middle,minor,narrowly,nflorescence,obscured,occasionally,older,one,opposite,papillo,pore,poricidal,portion,prominent,pubescenc,raised,reddi,reflexed,remaining,rib,ruit,scar,short,sinus,slender,slightly,small,somewhat,spaced,strongly,tall,tree,triangular,trichome,tub,ud,uniseriate,unit,upper,varying,widest,woody,ympodial,young	0.5,9,abaxial,adaxial,alternate,arrangement,branch,bud,characteristic,colour,corrugation,diameter,drying,exertion,form,glabrousnes,growth,height,history,inflorescence,life,lobing,na,new,number,peduncle,per,perennial,plant,primary,reddish,seed,shape,texture,type
264	wfo-0001028980	success	168	122	102	66	20	0.607	.5,1-1.2,1.2-1.8,1.2-3,1.5-1.8,1.5-2,1.5-6,2.5,2.5-5,3-4,3/4,5-6,5-8,6,6-8,7-12,anther,anthesi,axil,bark,basal,base,beneath,berry,black,broadly,calyx,capitate,clearly,cm,coarsely,conical,corolla,deflexed,deltoid,densely,dia,differentiated,drying,elliptic,filament,flattened-reniform,fleshy,fruiting,furcate,glabrate,glabrous,glandular,globose,green,impressed,incrassate,lateral,leaf,lobe,long,main,margin,minor,minutely,mm,opposite,ovary,ovate,pair,paler,pedicel,petiole,pitted,planar,prominent,pubescent,reddish,reflexed,seed,shaped,shrub,simple,size,slightly,small,soon,speciman,stem,stigma,style,surface,tall,tapering,tear-drop,thick,tip,tree,tube,type,usually,vein,way,white,x,yellowish,young	.1,.75,/3,0.5-1.5,20-25-flowered,4-5,acuminate,acute,along,apart,apex,beginning,corky,cucullate,differing,difoliate,dry,eaf,edicel,eed,expanded,exserted,extending,f,free,frui,geminat,inflorescenc,lamina,lenticellat,like,lobed,lon,lower,m.,major,material,member,middle,nflorescence,occasionally,older,one,ovoid,pale,papillose,peduncle,pit,pore,poricidal,portion,ruit,scar,scarious,sharply,shining,sparsely,strongly,ti,trichome,ud,uniseriate,unit,widest,woody,ympodial	abaxial,adaxial,alternate,arrangement,characteristic,colour,diameter,form,fruit,growth,height,history,inflorescence,length,lenticellate,life,lobing,plant,shape,texture
265	wfo-0001028984	success	180	137	84	96	53	0.467	-3,-65,0.5-,1,1-1.7,1-6,1-9,1.2-4,1.5,10-20,15-35,2,2-16,2-2.5,2-3,4-6,4-6.3,acuminate,acute,age,almost,also,apex,apical,basal,base,broadly,calyx,chartaceous,cm,concave,cordate,densely,diameter,dilated,distally,ellipsoid-fusiform,entire,flower,forked,fruit,glabrous,gland,globose,greenish,lanceolate,lobe,long,margin,mm,moderately,obconical,obtuse,often,ovate,ovoid,pale,pedicel,peduncle,petiole,pilose,puberulent,pubescent-pilose,purple,rarely,shrub,simple,small,sparsely,stigma,strongly,style,subcoriaceous,tip,tree,triangular,truncate,tube,turning,two,unbranched,unknown,x,yellow	-14,-2,-2.5,-6,-9,1-,1-2,1-2.5,12-20,2-,2-4,20-40,3-10,3-26,3-28,3-6,4-30,4-5,4-7,4-foliat,5,5-10,7-14,8-15,abaxially,abruptly,absen,adaxially,adpressed,aggregate,apart,ape,articulated,axe,blade,broad,campanulate,cell,color,connective,directed,eaf,eed,eglandular,equalling,especially,exceeding,fleshy,glandular-puberulent,hair,laterally,leaving,lon,longer,lower,minutely,narrowed,near,nflorescence,nther,orolla,papillose,pedicellar,perfect,pilo,pore,possibly,presence,present,puberulent-pubescent,pubescent-pilo,rachi,radiu,remnant,ripe,ruit,shorter,slightly,spaced,stamen,stone,swelling,tal,tem,thecae,time,tomento,tomentose,toward,ud,unit,unknow,vary,violet,wide,ympodial	anther,appearance,arrangement,bark,border,branch,bud,characteristic,colour,corolla,corrugation,distal,drying,exertion,filament,form,fruiting,giving,glabrousnes,growth,height,history,inflorescence,interjected,lateral,leaf,leaflet,length,life,lobing,midpoint,na,new,number,ovary,per,plant,prickle,primary,pseudostipule,ray,seed,shape,size,stem,surface,terminal,texture,thicknes,type,variation,vein,width
266	wfo-0001028997	success	136	105	78	58	27	0.574	0.5-0.7,0.8-1.1,1-1.2,1-1.5,2-2.5,2-3.5,4-10,4-angled,5-6,6-10,6-7,acute,anther,apex,appearing,area,attenuate,bark,base,berry,broadened,calyx,cm,coriaceous,corolla,difoliate,dry,drying,elliptic,elliptic-obovate,erect,exserted,filiform,flattened-reniform,fruiting,glabrous,globose,golden,green,height,later,lateral,leaf,main,margin,matte,minutely,mm,mustard,nearly,opposite,ovary,pair,pale,papillose,pedicel,petiole,pitted,revolute,shaped,shiny,shrub,stem,stigma,strongly,style,surface,tan,tear-drop,terminal,trifoliate,tube,unknown,vein,white,x,yellow,young	.5,0.5-1,0.5-1.5,20-50-flowered,3-4,3.3.5,4-4.5,abaxially,adaxially,anthesi,apar,ba,branched,conical,cucullate,deflexed,dia,eaf,edicel,eed,filament,fragrant,free,geminat,glabrou,greenish-brow,incrassate,lobe,lobed,lon,long,lower,many,merely,middle,nflorescence,older,partially,pericarp,pore,poricidal,portion,quadrate,ruit,scar,spaced,specimen,styl,thick,thickened,time,tip,tub,ud,unevenly,widest,woody,ympodia	abaxial,adaxial,arrangement,bud,characteristic,colour,diameter,exertion,form,fruit,greenish-brown,growth,history,inflorescence,length,life,lobing,na,peduncle,plant,primary,seed,shape,size,sympodia,texture,type
267	wfo-0001029003	success	207	104	85	122	19	0.411	0-6,0.5,1-2,1-3,1.2-1.9,1.2-2.5,1.5-2.3,11-32,12.2-30,2.5-10,2.5-7.5,3,3-20,3.5-7.5,4-8,5,5-10.5,5-12.5,7-15.5,7-9,9-14,abaxially,adaxially,anther,berry,blade,blue-violet,brownish,chartaceous,cm,condition,conical,corolla,diameter,drying,flower,fresh,fruit,glabrous,green,green-white,greenish,hair,herb,homostylous,interjected,lateral,leaf,leaflet,light,long,medium,membranous,minute,mm,mottled,mucilaginous,odd-pinnate,ovoid,pale,pedicel,peduncle,petiole,plant,prostrate,pubescent,purple,ripe,seed,size,sparsely,stem,stigma,style,subcapitate,subglabrous,terminal,throughout,tube,usually,violet,wet,whitish,wide,x	0.3-0.5,0.4-3,1,1-10,1-2.5,1-5,13-36,2-6,3-5,5-merou,absent,acumen,acuminate,ag,alyx,apart,apex,apparently,articulated,attenuate,axe,axillary,base,bud,capitat,cell,ciliate,connivent,covering,decreasing,digestion,distal,dorsally,eaf,edge,eed,elliptic,elongated,end,enzyme,equal,erec,especially,exceeding,filament,flat,folded,forked,fourth,geminat,generally,glabrou,gradually,hair-like,hal,half,highly,honeycomb-shaped,lanceolate,larger,lengthening,like,living,lobe,lower,make,margin,middle,nflorescence,obtuse,one,orbicular,orolla,ovate,pair,pentagonal,perfect,petiolule,pigmentation,placed,plurifoliate,pore,poricidal,proximal,rarely,ray,removed,rotate,rounded,ruit,secondary,sessile,seudostipule,slightly,slit,sometimes,spaced,specimen,stamen,ste,stolo,straight,subequal,subtending,symmetrical,tall,tamen,tem,testal,thick,tip,toward,tri-,tuber,typically,unit,vary,wall,white,wing,yellow,ympodial	abaxial,arrangement,calyx,capitate,colour,erect,form,growth,height,history,inflorescence,length,life,ovary,pseudostipule,shape,surface,texture,type
268	wfo-0001029006	success	217	138	119	98	19	0.548	-+,0.4-2.5,0.5-2,0.5-4,1,1-1.5,1-5,1.2-1.5,1.8-2.2,10,10-20,2.5,4-6,5,7-8,>,acuminate,acute,adaxial,along,anther,anthesi,apex,area,articulated,asymmetrical,axil,base,berry,blackish,c.,calyx,cm,connivent,corolla,deeply,dense,diameter,ellipsoid,elliptic,entire,exserted,extending,filament,filiform,flattened,fruiting,glabrous,globose,green,groove,growth,inflorescence,lamina,later,lateral,lobe,lobed,long,loosely,margin,midrib,minute,minutely,mm,narrowly,nearly,new,nodding,oblique,occasionally,often,pair,pale,papillate,pedicel,peduncle,per,petiole,pinnatifid,pitted,primary,puberulent,purple,purplish,reaching,reddish,reniform,ripe,sagittate,simple,size,sleeve,small,sometimes,sparsely,spreading,stem,stigma,strongly,style,surface,tan,terminal,tip,trichome,truncate,tube,tuft,uniseriate,variously,vein,vine,violet,way,white,x,young,zig-zag	.5,0.2,0.5,1-4,1/3,2-3,2-6,3.5-4,5-6,5-merou,50,7-9,<,abaxially,adaxiall,ag,age,alyx,apar,ark,axi,basal,beyond,bilobed,black,branched,bright,broadest,cell,chartaceous,clavat,conical,deltate,depending,drying,eaf,eed,elongate,flower,free,growing,ilament,inflated,intramarginal,irregular,irregularly,keeled,leaving,lengthening,lower,many,markedly,membranous,nflorescence,obvious,older,one,orolla,part,peg,pendan,pentagonal,perfect,pericarp,planar,plurifoliat,pore,poricidal,portion,puberulen,pubescent,rotate-stellate,ruit,scar,shiny,slit,smaller,somewhat,spaced,strong,sunligh,tem,testal,thin,time,tiny,twinin,twining,ud,unit,upper,usually,variable,vary,widest,within,woody,ympodial	abaxial,arrangement,bark,characteristic,colour,exertion,form,fruit,glabrousnes,leaf,length,lobing,number,ovary,plant,seed,shape,texture,type
269	wfo-0001029031	success	213	132	117	96	15	0.549	-11.4,-12.3,-8,.5-1.2,0.1-0.5,0.5-1.5,0.5-4,0.6-1.2,0.7-1.1,1-1.5,1-2.5,1-5,1-9.4,1.8-2.7,13.5,2-10.7,2-3,2-3.3,2-5,2.5-5.5,3-10,4-7.5,5-17,6-21,abaxially,acuminate,acute,adaxially,angle,anther,apex,base,becoming,berry,black,bluish,brown,calyx,capitate,chartaceous,cm,connivent,corolla,cuneate,deltate,densely,diameter,elliptic,elliptic-ovate,entire,erect,filament,flattened,fleshy,flower,fruit,glabrescent,glabrous,globose,green,hair,held,immature,lateral,leaf,leaf-opposed,length,light,like,long,margin,mm,oblong,obtuse,occasionally,orange,outline,pedicel,peduncle,peltate,peltate-stellate,petiole,possibly,pseudoterminal,pubescence,pubescent,rachi,rarely,reniform,ripening,rounded,rugulose,sessile,short-stalked,shrub,silvery,simple,small,sparsely,stellate,stellate-pubescent,stem,stigma,strongly,style,suborbicular,surface,tall,tip,tree,trichome,usually,white,whitish,x,yellow,yellowish	-3.6,.1-0.3,0-5,0.5,1-2,1-2.6,1-3,1.3-3.3,1.5-2.8,1.5-3.5,1.8-4,1/3,10,2.5-5.6,20-150,4-5-,6-12,absent,accrescent,adaxiall,ag,apart,apexacute,apparently,around,articulated,axe,ba,bilobe,blade,branched,center,covering,curved,cylindrical,denser,directed,distally,eaf,edge,eed,eglandula,eglandular,equal,farinose,forked,frui,fruiting,fused,geminate,impressed,inserted,lanceolate,large,least,lobe,longitudinal,lower,major,many-foliate,midpoint,midvein,nearly,nflorescence,opening,orolla,paired,perfect,pore,porrect-stellate,prominent,pubescen,ray,ruit,short,side,slightly,slit,smaller,sometimes,somewhat,spaced,ste,straight,subtending,tamen,tem,time,tube,unarme,unbranched,unit,vary,vein,wide,ympodial	arrangement,bilobed,colour,form,growth,height,inflorescence,lobing,ovary,plant,seed,shape,size,texture,type
270	wfo-0001029048	success	162	125	97	65	28	0.599	.01,.2,/3,0.5-1.7,0.8-1,1-2,1-8,1.5-2,11,2,25,3-4,3.5-4,5-8,acuminate,anther,anthesi,apex,arching,attenuate,base,bearing,becoming,beneath,berry,bicellular,branch,broadly,calyx,cm,conical,corolla,decurrent,dia,elliptic,filiform,flower,fruiting,glabrate,glabrous,globose,golden,greenish-white,greenish-yellow,hanging,hispidulous,leaf,like,lobe,lobed,long,matte,minute,minutely,mm,obovoid,obtuse,older,ovary,ovoid-reniform,pale,papillose,pedicel,petiole,pitted,planar,puberulent,reflexed,ripe,scar,shaped,sharply,shrub,slender,slightly,small-capitate,stem,stigma,straight,style,surface,tan,tapering,tear-drop,thread-like,time,tip,translucent,trichome,tube,uni-,unifoliate,vein,way,winged,x,young	.5,0.5,0.5-1,1,14,26,3-7,4-6,8-10,9-15,angle,another,apar,apparent,basal,blade,bright,eaf,edicel,eed,elongated,except,expanded,f,filament,free,geminate,greatly,green,greenish-yello,incrassate,lateral,less,live,lower,main,margin,middle,midrib,much,nflorescence,node,non-reproductive,one,opposite,pair,papillo,parallel,pore,poricidal,portion,right,rounded,ruit,somewhat,spaced,specimen,tall,ud,unevenly,unit,widely,widest,ympodial,zig-zag	arrangement,bud,characteristic,colour,diameter,exertion,form,fruit,glabrousnes,growth,height,history,inflorescence,length,life,lobing,na,new,number,peduncle,per,perennial,plant,seed,shape,size,texture,type
271	wfo-0001029055	success	169	72	52	117	20	0.308	0.4-1.5,1-4,1-5,1.8-3.5,14-50,2.2-3,2.5-8,3-10,4-10,4-6,4-7,5.5-9,6-14,8-9,9-22,branched,calyx,cm,corolla,cyme,diameter,dichasial,dichasially,ebracteate,filament,green,herbaceous,interjected,lateral,leaf,leaflet,long,mm,monochasial,mucilaginous,odd-pinnate,ovoid,pedicel,peduncle,pentagonal,perennial,petiole,pilose,plant,pubescent,rotate,seed,size,style,terminal,triangular,tuber-bearing	1-2.6,1.6-3.5,1.7-2.2,2-1.,2-3,2-4,3,3-6,3-6-foliat,5-24,abaxially,acumen,acuminate,acute,adaxially,apex,apical,apically,articulate,attenuate,base,cell,connate,cordate,covered,covering,cuneate,dark,decurrent,dehiscent,densely,digestion,diminishing,distal,dorsally,eaf,edge,eed,elliptcal,elliptical,emoval,enzyme,exceeding,first,flat,flower,folded,forked,generally,gland,globo,green-white,hair,hair-like,half,honeycomb,introrse,living,lobe,lon,long-attenuate,longer,longitudional,lower,lunat,make,maturing,near,nflorescence,nther,oblique,often,orolla,outline,ovate,pair,pattern,perfect,plan,poricidally,proximal,purple,rarely,reveal,ruit,second,sessile,seudostipule,short,short-petiolate,short-stalked,slit,sometimes,specimen,spreading,stamen,stigma,straight,stripe,tal,tem,testal,thick,throughout,time,toward,type,typically,unit,vary,wall,whit,wide,widest,yellow,ympodial,Â¼	2-11,anther,arrangement,characteristic,colour,form,fruit,growth,height,history,inflorescence,length,life,ovary,pseudostipule,shape,stem,surface,texture,width
272	wfo-0001029059	invalid_json	199	108	80	119	28	0.402	.5,0.1-1,0.2,1-1.5,1-4,1-6,1.2-3,1.3-1.7,1.5-2,1.5-2.8,10-19,2.5,3-3.5,3-6.5,3.5-8,4-10.5,5-15-flowered,7-9,along,anther,apiculate,bark,base,berry,calyx,clavate,cm,corolla,deltoid,densely,dia,dirty,elliptic,flattened-reniform,fruiting,glabrous,globose,hispidulous,inflorescence,leaf,long,minor,minute,minutely,mm,nearly,occasionally,orbiculate,ovary,pale,papillose,pedicel,petiole,purplish,ripe,shallowly,shape,shaped,shrub,simple,size,slender,small,stem,stigma,style,tapering,tear-drop,tinge,tree,trichome,tube,unicellular,uniseriate,vein,waxy,white,x,yellowish-green,yellowish-tan	0.1-0.5,0.2-0.5,0.5,0.5-1,1-1.2,1-3,3.5-6,5,6-10,acute,anisophyllou,anthesi,apar,ape,apex,apiculae,arising,beneath,bout,branched,bud,closely,coiba,connivent,cordate,covered,cuneate,de,deep,deflexed,dense,differing,difoliate,eaf,edicel,eed,ellipsoid,expanded,exserted,extending,extremely,filament,foetid,free,geminate,glabrate,greatly,impressed,incrassate,interpetalar,isla,lamina,lateral,lobe,lobed,lon,longest,lower,main,major,margin,member,membranous,middle,narrowly,nflorescence,oblique,often,older,one,opposite,orange,orangish-yellow,pair,paler,panama,papillo,partially,pitted,planar,pointed,population,pore,poricidal,portion,prominent,pubescence,pubescent,reddish-gre,rest,rounded,ruit,scar,sinus,somewhat,soon,spaced,sparse,specimen,straight,surface,tall,terminal,thickened,ti,tightly,tip,triangular,ud,underside,unit,usually,variable,wide,widest,woody,yellowish,ympodial,young	'',[,],``,abaxial,adaxial,alternate,arrangement,characteristic,colour,diameter,form,fruit,growth,height,history,length,life,lobing,perennial,plant,reddish-grey,seed,texture,type,value,{,}
273	wfo-0001029072	success	235	134	105	130	29	0.447	.5,0-4,0.4-0.9,0.5-2,0.8-1.5,00-200,1-1.2,1-1.5,1-25,1.5-2.6,1.5-3.2,1/3,1/4-1/2,2-7,2.2-2.5,2.2-3.2,2.5-3.5,2.5-3.8,2.5-4.5,3-20,4.5-9,5-7,7-15,8-27,acute,anther,apex,apparently,bark,base,berry,bright,calyx,chartaceous,cm,connivent,cordate,cream,cuneate,dark,densely,diameter,dirty,discolorous,drying,dull,erect,filament,flattened-reniform,fruit,fruiting,glabrous,green,green-brown,herb,lateral,leaf,length,lobed,long,long-styled,lower,margin,marking,maturity,mauve,mm,moderately,orange-brown,ovate,pair,pale,pedicel,peduncle,pendent,per,petiole,plant,poricidal,prickle,prickly,primary,rounded,short-styled,shrub,simple,sometimes,spherical,stellate-pubescent,stem,strongly,style,surface,tapering,terminal,tip,tube,upper,vein,way,weakly,white,wide,yellow,young	-1/2,-15,-2.5,/6,0,0-2,0-20,0-8,0.1-0.4,0.2-0.3,0.2-0.4,0.3,0.5-3,0.7,0.8,1,1-3,1.5-2.5,1/4-1/3,12-19,2-10,2-5,2-8,20-50,3-10,3-5,3-50,3-8,3.5-6,3/,4-,4-10,4.2-6.5,5-10,5-50,5-9,5-merous,7-10,8-20,abaxial,abaxially,adaxial,adaxially,alyx,ame,andromonoecious,angled,apar,apart,apically,articulated,blade,branched,broad-deltate,broadly,c.,clearly,conical,curved,deltate,distal,distance,eaf,eed,elongated,elongating,equal,extending,flattened,flower,free,gently,gra,hermaphrodite,heterostylous,infructescence,least,lobe,longer,longitudinal,lowermost,mature,midpoint,midvein,multangulate,narrow-deltate,nflorescence,obtu,older,one,open,orolla,oung,pendulous,pericarp,plurifoliat,porrect,portion,prickl,raised,ray,reflexed,ridge,ruit,scar,sessile,side,smooth,spaced,sparsely,spreading,stalk,stalked,staminat,stellate,stout,straight,tamen,tertiary,time,trichome,unarmed,unit,variously,vary,venation,visible,whitish,woody,ympodial	3/4,arrangement,branch,bud,characteristic,colour,corolla,corrugation,exertion,form,glabrousnes,gray,growth,height,history,inflorescence,life,lobing,na,new,number,ovary,perennial,seed,shape,size,stigma,texture,type
274	wfo-0001029073	success	211	116	99	112	17	0.469	.5,0.3-1,0.5,0.6-2,1-1.2,1-1.5,1.1-1.5,1.5-2,10-16,2,2-3,2/3,4-5,4-6,5-6,5-8,acuminate,acute,anther,anthesi,apex,armed,base,berry,broad-based,brown,calyx,chartaceous,cm,corolla,curved,dark,densely,diameter,dimorphic,elliptic,entire,exserted,filament,flattened,fruiting,glabrous,globose,golden,growth,hooked,inflorescence,internodal,lanceolate,leaf,length,lobed,long,margin,maturity,minutely,mm,narrowly,oblique,occasionally,opposite,orange,pale,papillose,pedicel,peduncle,per,petiole,prickle,pubescence,pubescent,purple,reniform,reticulate,shallowly,shrub,simple,sinuate,slightly,somewhat,sparsely,stellate,stem,stigma,straight,strongly,style,surface,tan,tapering,tip,trichome,truncate,tube,unequally,way,x,yellowish,Â½	.7,0.5-1,0.6-0.7,1-2.5,1-3,1.2-1.6,10-15,2-4,3.5-9,5-merous,6-9,7-10,8-14,abaxially,adaxially,along,another,apart,articulated,away,awn-like,ba,bark,basal,beneath,cell,conical,cream,darker,dense,difoliate,discolorous,drying,eaf,eed,enlarged,equal,erect,except,flower,four,free,frui,geminat,gre,interpetalar,lamina,lengthening,like,linear,lobe,long-styled,lower,midpoint,midvein,mixture,multangulate,new,nflorescence,nodding,older,one,pair,paler,perfect,pericarp,planar,plurifoliate,pore,poricidal,porrect,portion,prickly,primary,ray,rectangular,ruit,scar,sessile,shiny,short,short-stalked,shorter,slit,sometimes,spaced,splitting,styled,testal,thin,three,ti,tissue,triangular,two,ud,unarmed,underside,unequal,unisexual,unit,upper,upward,vein,visible,wall,whitish,wide,woody,yellow,ympodial,zygomorphic	arrangement,bud,characteristic,colour,exertion,form,fruit,height,lobing,na,number,plant,seed,shape,size,texture,type
275	wfo-0001029074	success	174	111	88	86	23	0.506	.5,0,0.2-1,0.3-0.8,0.5-1,0.7-0.8,1,1-,1-1.2,1-2,1.4-1.8,11,2-2.3,3-6,acute,anther,apart,apex,base,berry,black,broadly,calyx,capitate,cm,conical,corolla,cuneate,densely,diameter,ellipsoid,entire,exerted,flattened,flower,fruiting,glabrous,globose,green,grey,growth,herb,immature,internodal,leaf,less,like,margin,mixture,mm,new,opposite,ovary,ovate,pale,pedicel,peduncle,per,petiole,poricidal,pubescent,purplish,reniform,ripening,rounded,sagittate,sessile,simple,sparsely,stalked,stellate,stem,stigma,strongly,style,subshrub,tip,trichome,truncate,tube,underside,uniformly,way,white,x,yellow,yellowish,Â¾	.1,0.3-0.4,0.5-1.2,0.7-0.95,1-1.5,1.5-2,1.5-4,2-4,2-5,2-7,3-,3.5-5,5-6,5-7,abaxially,absent,adaxially,age,almost,along,anthesi,apparently,appearing,articulation,bark,basa,deflexed,denser,eaf,eed,expanding,filament,free,frui,glabrescen,lacking,lengthening,lignescent,lobe,lobed,longest,lower,markedly,midpoint,midvein,minutely,nflorescence,obscuring,often,older,pair,papillat,perfect,pericarp,petal,pitted,planar,plurifoliat,pore,portion,primary,prominent,pulp,ray,reflexed,ruit,scar,scattered,slit,small,somewhat,stalk,stellate-pubescent,surface,swollen,thin,triangular,tub,ud,uniseriate,unit,usually,vein,watery,woody,ympodial	abaxial,adaxial,arrangement,bud,characteristic,colour,exertion,form,fruit,glabrousnes,height,history,inflorescence,length,life,lobing,number,plant,seed,shape,size,texture,type
276	wfo-0001029075	success	217	168	147	70	21	0.677	.3,.5,0.8-1.2,0.8-1.5,1-10,1-2,1-2.5,1-3,10-20,2-5,2.5-3,2.7-4.2,30-60,4-14,4-7,4.5-6.5,5-10,5-8,5-8.5,6-12,7-17,7-9,8-9,abaxially,abruptly,acumen,adaxially,along,anther,apart,apex,attenuate-acuminate,axillary,base,berry,broadly,brown,brownish,bud,canescent,cell,ciliate,cm,condition,connivent,corolla,covering,cuneate,dark,densely,diameter,distal,dorsally,dot,drying,edge,elliptic-lanceolate,end,especially,filament,flat,flecked,flower,folded,forked,fresh,fruit,generally,glabrescent,glabrous,glandular-pilose,glandular-puberulent,gray-green,green,green-white,greenish,hair,hair-like,half,herb,homostylous,lanceolate,lateral,leaf,leaflet,light,like,lobe,long,long-spatulate,make,margin,midrib,minutely,mm,mucilaginous,narrowed,narrowly,odd-pinnate,orne,ovoid,pedicel,peduncle,pentagonal,petal,petiole,plant,pointed,poricidal,puberulent,pubescent,purple,rounded,seed,short,singly,size,small,sometimes,stem,stigma,straight,style,subobtuse,subquadrate,substellate,subtending,terminal,testal,thick,throughout,tip,tube,tuber,unwinged,upper,usually,wall,wet,white,whitish,whitish-gray,wide,x,yellow,yellow-green,yellowish-white	0-3,0-8,0.5-0.8,2-4,4-10,4-5,5-merou,ag,alyx,apparently,articulated,atypically,axe,blade,clavifor,decreasing,decurrent,digestion,eaf,eed,enzyme,erect,erect-ascendin,etota,exceeding,geminat,glabrou,gradually,greatly,honeycomb-shaped,interjected,larger,lengthening,living,lower,middl,nflorescence,orbicular,orolla,ovate,pair,perfect,petiolulate,petiolule,plurifoliate,pore,rachi,removed,ruit,sec,sessile,seudostipule,slightly,slit,spaced,specimen,stamen,ste,stolo,subequal,tall,tamen,tem,toward,tri-,typically,unit,vary,woody,ympodial	5-merous,abaxial,adaxial,arrangement,calyx,claviform,colour,form,growth,height,history,inflorescence,length,life,ovary,pseudostipule,shape,spacing,stolon,surface,texture
277	wfo-0001029084	success	192	129	110	82	19	0.573	.5,0.8-2,0.8-2.1,1-2,1.1-2.2,1.5-2.5,10-50,2-3.5,2-5,3-6,3.5-7.5,3.5-8,4-7,4.5-10,4.5-6.5,5,5-7,6-13,7-9,8-23,abaxially,acuminate,adaxially,along,anther,apex,axillary,base,berry,blade,brownish,bud,cell,chartaceous,ciliate,cm,condition,conical,connivent,corolla,covering,diameter,distal,drying,especially,filament,flower,forked,fresh,fruit,generally,glabrous,green,green-white,greenish,hair-like,half,herb,homostylous,lanceolate,lateral,leaf,leaflet,light,lilac,lobe,long,make,margin,midrib,minute,minutely,mm,moniliform,mottled,mucilaginous,odd-pinnate,ovoid,pedicel,peduncle,petiole,petiolule,plant,puberulent,pubescent,purple,ripe,rotate,seed,size,sparsely,stigma,style,subglabrous,subsessile,subtending,terminal,testal,thick,throughout,tip,tube,tuber,usually,wall,wet,whitish,wide,x,yellow	1-10,1-3,1-4,2-4,4-17,5-merou,absent,acumen,ag,alyx,apart,apparently,arranged,articulated,axe,bead,capitat,darker,decreasing,digestion,dorsally,eaf,edge,eed,enzyme,exceeding,flat,folded,geminat,glabrou,gradually,honeycomb-shaped,interjected,interpetalar,larger,lengthening,like,living,lon,lower,middle,multiple,narrow,necklace,nflorescence,obtuse,orolla,ovate-lanceolate,pair,perfect,pilose,plurifoliate,pore,poricidal,proximal,ray,removed,ruit,secondary,semierec,seudostipule,slit,spaced,specimen,stamen,stolon,subequal,subglabrou,symmetrical,tall,tamen,tem,thir,tissue,toward,tri-,typically,unit,unwinged,vary,wing,ympodial	5-merous,arrangement,calyx,capitate,colour,form,growth,height,history,inflorescence,length,life,ovary,pseudostipule,semierect,shape,stem,surface,texture
278	wfo-0001029088	success	149	104	79	70	25	0.53	.3,0.1,0.6â3.2,1.3â4.5,15â25,1â1.6,1â3,25â30,2â2.5,2â3,3â16,4â8,5â8,<,acuminate,anther,apex,base,berry,bronze-brown,capitate,cm,cordate,cylindrical,diameter,entire,extra-axillary,filament,flattened,fleshy,flower,fruit,glabrous,greenish-brown,hair,half,herbaceous,immature,leaf,lenticular,light,long,lower,margin,mature,membranous,minutely,mm,moderately,near,obtuse,ovoid-rhomboid,papillose,pedicel,peduncle,petiole,pubescent,purplish,reddish-brown,revolute,rounded,rugose,sand-punctate,shortly,simple,slender,slightly,somewhat,sparsely,stellate,stigma,stout,straight,style,surface,unbranched,vine,white,x	.2,0.9â1.5,1.5â2,1.5â3,1â1.2,1â1.5,2-lobe,2.5â20,2.5â4.2,3.5â7,3.5â8,5,5-merous,6-10,abaxially,accrescent,acute,adaxially,alyx,apar,apicall,axe,blade,c.,calyx,ciliate,climbing,densely,eaf,eed,emarginate,flavor,fragrant,fruiting,glabrou,groun,heavy,juicy,lanceolate,lobe,m.,narrowly,nflorescence,nternode,orolla,palmate,perfec,plurifoliat,primary,rachi,ruit,scent,spaced,strongly,swee,sweet,tamen,tem,terrestrial,tip,truncate,truncate-acuminat,tube,unit,vary,vein,venation,wider,ympodial,â7	2-lobed,arrangement,branch,characteristic,colour,corolla,form,glabrousnes,growth,height,history,inflorescence,length,life,new,ovary,plant,plurifoliate,seed,shape,size,staman,stem,texture,type
279	wfo-0001029089	success	177	106	88	89	18	0.497	/4,0.1-0.25,0.5-0.6,0.5-1,0.8-1,1,1-1.5,1.5-2,1.5-6,10-25,2.5-3.5,5-10,5-6,5-9,6-7,acute,anther,apex,bark,base,berry,bilobed,branched,bud,calyx,campanulate,caniculate,cm,completely,corolla,dark,decurrent,densely,dia,drying,elliptic,enclosed,filament,flattened-reniform,fruiting,furcate,glabrous,globose,golden,green,incrassate,leaf,margin,minor,minutely,mm,occasionally,opposite,ovary,pedicel,petiole,pinkish,pitted,pubescent,purplish,reddish-grey,resinous,rounded,secretion,shaped,shiny,shrub,simple,size,slightly,small,smooth,somewhat,stem,stigma,style,surface,tan,tapering,tear-drop,tree,trichome,tube,uniseriate,way,white,x,young	.5,.75,0.8-1.2,1/2,4.5-5,5-20-flowered,8-9,abrupt,along,anthesi,apart,apiculate,axil,ba,beginning,beneath,closely,covered,covering,cracking,deflexed,differing,difoliate,eaf,edicel,eed,either,entire,erect,expand,exserted,free,geminat,glabrou,impressed,inflorescenc,lamina,later,lateral,like,lobe,lobed,lon,long,lower,main,major,material,member,middle,nflorescence,obovoid,older,one,otherwise,overlapping,pair,papillo,papillose,part,peeling,persistent,planar,pore,poricidal,portion,primary,prominent,resinou,rounded-deltoid,ruit,scar,spaced,still,straight,tall,tip,tub,ud,underside,unit,usually,varnish,varnished,vein,widening,widest,woody,ympodial	abaxial,characteristic,colour,diameter,form,fruit,growth,height,history,inflorescence,length,life,lobing,plant,seed,shape,texture,type
280	wfo-0001029091	success	212	103	78	134	25	0.368	-4,-4.5,1-2,1.5-,1.5-2,10,10-20,15-40,2-2.5,2-3,2.5-,3,3-11-lobed,3-4,4,7-8,acuminate,acute,anther,apex,base,berry,broadly,buff,calyx,campanulate,capitate,cm,colour,corolla,cuneate,cyme,dia,discoidal,ellipsoid,elliptic,filament,flattened,flower,flushed,fruiting,globose,globular,grey,intense,irregularly,leaf,light,long,minutely,mm,narrowly,oblong,obovate,ochre-yellow,ovate,ovoid,pale,pedicel,peduncle,petiolate,petiole,pubescent,raised,reddish-purple,scarcely,separate,shortly,shrub,slightly,soft-wooded,speckled,stem,stigma,style,violet-purple,winged,x	-1,-15,0.3-,0.5-0.8,0.5-1,1,1-10,10-toothed,170-210,2-12,20-30,3-,46/1,5,5-7,635/1,age,appearing,aromatic,articulated,articulation,aspect,axil,ba,becoming,blunt,bluntly,brownish,cell,clonal,close,common,conspicuous,cut,dark,deeply,develop,developed,downward,eed,effect,emarginated,erect,exceeding,exerted,floral,fork,forked,fresh,general,giving,glandular,gree,growing,hair,half,interacuminal,irregular,juvenile,lacking,larger,lasting,later,lateral,lavende,lavender,lengthening,line,linear,linear-lanceolate,lobe,long-triangular,lower,may,mid-vein,mineral,nflorescence,obscure,occasionally,overlain,ower,pattern,pedicellate,pentagonal,petiol,plurifoliat,point,pore,poricidal,rachi,readily,relatively,reticulate-concentric,rh,ridge,ridged,ripe,rounded,ruit,several,shallowly,shed,sigmoid,simple,sinus,slender,slit,soft,soon,sparsely,stellate-rotate,stone,straggly,subulate,succulent,surface,swollen,tall,tip,tissue,toward,transverse,triangular,tub,ud,unit,upper,usually,violet,well,without,woody,year,ympodial	arrangement,bud,characteristic,diameter,form,fruit,glabrousnes,growth,height,history,inflorescence,length,life,lobing,margin,new,ovary,perennial,plant,plurifoliate,seed,shape,size,type,vein
281	wfo-0001029101	success	233	117	95	138	22	0.408	.5,/3,0-2,0.4-1.5,0.5-1,1-1.5,1-3,1.3-2,1.3-2.6,1.4-2.2,1.5-2.5,1.8-3,2.5-3.5,2.5-6,2.8-3.3,abaxial,adaxial,anther,apex,apparently,articulated,bark,base,berry,brown-green,calyx,cell,chartaceous,cm,concolorous,connivent,cream,cuneate,dark,darker,diameter,discolorous,drying,dull,elliptic,erect,filament,flattened-reniform,fruit,fruiting,glabrescent,glabrous,green,lateral,leaf,length,lobed,long,long-styled,margin,marking,maturity,mauve,mm,moderately,obovate,obtuse,orange-brown,outline,ovate,pale,pedicel,peduncle,petiole,pit,plant,poricidal,prickly,raised,rounded,short-styled,shrub,simple,small,smooth,sometimes,sparsely,spherical,stellate-pubescent,stem,style,surface,tapering,tip,tube,way,wide,yellow,yellow-green,young	-15,-3,/4,0-100,0-20,0-5,0-8,0.1,0.1-0.4,0.1-0.5,0.1-0.7,0.1-1,0.2,0.7-,0.8-3.5,00-200,1,1-4,1-8,1.5-2,1.7,1/5-1/4,10-14,10-20,2-,2-20,2-6,2/3-3/4,3-,3-10,3-4,3-7,30-100,4-12,4-7,5-,5-20,5-6,5-7,5-8,5-9,5-merous,5.5-8,6-8,7-13,8-15,abaxially,acute,almost,always,alyx,andromonoecious,apar,apart,apically,blade,branched,broad-deltate,deltate,distal,distance,eaf,eed,elongating,equal,extending,flattened,flower,free,green-brow,hermaphrodite,heterostylous,infructescence,lengt,like,lobe,lon,longer,lower,lowermost,mature,midpoint,midvein,multangulate,narrow-deltate,nflorescence,oblong,often,older,one,open,orolla,oung,pair,pendulous,per,pericarp,plurifoliat,porrect,portion,present,prickl,prickle,primary,rarely,ray,reduced,reflexed,rounde,ruit,scar,secondary,sessile,side,spaced,spreading,stalk,stalked,staminat,stellate,straight,suborbicular,tamen,terete,tertiary,thick,time,trichome,unit,variously,vary,vein,venation,visible,well-developed,woody,yellow-orange,ympodial	arrangement,branch,characteristic,colour,corolla,exertion,form,glabrousnes,green-brown,growth,height,inflorescence,lobing,na,new,ovary,seed,shape,size,stigma,texture,type
282	wfo-0001029106	success	200	112	90	110	22	0.45	.5,/3,0.2-1,0.25-0.7,0.5-0.8,0.5-0.9,0.5-1,0.9-1.2,1-1.6,1.5-3.5,2-4,2-5.5,2-8,2.2-3,3-3.5,3-4,anther,apex,apparently,articulated,bark,base,berry,calyx,cell,cm,concolorous,cuneate,densely,diameter,discolorous,drying,elliptic,erect,filament,flattened-reniform,fruit,fruiting,glabrous,lateral,leaf,length,light,lobed,long,margin,maturity,mauve,membranous,mm,obtuse,orange,orange-brown,outline,ovate,pair,pale,pedicel,peduncle,petiole,pit,poricidal,prickly,primary,raised,red,rounded,shiny,shrub,simple,size,small,smooth,sparsely,spherical,spreading,stellate-pubescent,stem,style,subentire,surface,tapering,tip,vein,way,weakly,white,wide,yellow-orange,yellowish-green	-6,.1,0,0-0.3,0-10,0-2,0-20,0-5,0-6,0.1,0.2-0.4,0.5,0.5-2.5,1-2,1-5,1.5-1.8,1.5-2,1/4,1/5-1/4,2-3.5,2-6,2/,3-25,4-6,4-8,5-14,5-8,5-merous,6-8,abaxially,acuminat,acute,alyx,ame,apar,apart,apically,appearing,blade,branched,c.,curved,deltate,distance,eaf,eed,elongating,equal,extending,eye,flattened,flower,free,gently,glabrescent,infructescence,lobe,lon,longer,lower,mature,midpoint,midvein,naked,nflorescence,older,one,open,orange-brow,orbicular,orolla,oung,pendulous,per,perfec,pericarp,plurifoliat,porrect,portion,prickl,prickle,ray,reflexed,scandent,scar,sessile,shallow,shorter,side,slender,sometimes,spaced,stalk,stalked,stellate,straight,tamen,terete,tertiary,time,trichome,tube,uit,unit,variously,vary,venation,visible,woody,ympodial	arrangement,branch,characteristic,colour,corolla,exertion,form,glabrousnes,growth,height,history,inflorescence,life,lobing,new,ovary,perennial,plant,seed,shape,texture,type
283	wfo-0001029112	success	190	156	127	63	29	0.668	0.9-1.7,1-10,1-2,1-4,1.4-2.5,1.5-1.8,1.5-2,10-17,10-21,2-3.5,2.5-4.5,2.6-3,2.7-3.5,2.7-4.2,2.7-5.7,20,3-4,3-6,3-7,3.5-4.5,3.5-7,5,5-8,6.5-5.5,9.5-13,abaxially,acumen,acuminate,adaxially,anther,apart,apex,articulated,axillary,base,berry,blade,brownish,bud,cell,chartaceous,ciliate,cm,condition,conical,connivent,corolla,covering,densely,diameter,distal,dorsally,drying,edge,elliptic-lanceolate,filament,flat,flower,folded,forked,fresh,fruit,generally,glabrous,green,green-white,greenish,hair-like,half,herb,homostylous,interjected,lanceolate,lateral,leaf,leaflet,lengthening,light,lobe,long,make,margin,middle,minute,mm,moniliform,mottled,mucilaginous,obtuse,odd-pinnate,ovate,ovoid,pale,pedicel,peduncle,petiole,petiolule,plant,pore,poricidal,pubescent,purple,ripe,rotate,seed,size,slightly,slit,stigma,style,subtending,symmetrical,terminal,testal,thick,throughout,tip,tube,tuber,usually,violet,wall,wet,whitish,wide,x,yellow	0-2,0.5,1-3,3-5,5-merou,ag,along,alyx,apparently,arranged,axe,bead,capitat,decreasing,digestion,eaf,eed,enzyme,equal,especially,exceeding,geminat,glabrou,gradually,hair,honeycomb-shaped,larger,like,living,lower,multiple,narrow,necklace,nflorescence,orolla,pair,perfect,plurifoliate,present,pubescen,ray,removed,ruit,secondary,semierec,seudostipule,spaced,specimen,stamen,ste,stolon,subequal,tall,tamen,tem,thir,toward,tri-,typically,unit,vary,wing,ympodial	5-merous,age,arrangement,articulation,calyx,capitate,colour,connivence,form,growth,height,history,inflorescence,length,life,number,ovary,poricity,pseudostipule,pubescence,semierect,shape,spacing,stem,surface,symmetry,texture,third,type
284	wfo-0001029120	success	168	63	47	121	16	0.28	0.1-0.5,0.7-1,1.1-1.5,1.1-2,5-10-flowered,6-8,acuminate,acute,anther,apex,base,calyx,cm,corolla,decurrent,densely,erose,especially,glabrous,globose,golden,hirsute,larger,leaf,long,margin,minutely,mm,narrowly,ovary,ovate,pale,pedicel,petiole,shaped,shrub,simple,slightly,stem,stigma,style,tear-drop,trichome,uniseriate,white,yellow-green,young	.05,.5,.75,/2,0.5-1.5,1-1.5,2.5-3.5,2.6-7,3-3.5,5-8,6.5-16.5,8511,abrupt,anthesi,apart,bark,basal,beginning,beneath,black,bud,bullate,cell,dark,deflexed,dia,difoliate,dry,drying,eaf,edicel,eed,epidermi,evenly,f,fide,filament,fleshy,free,geminat,greenish-brown,inflorescenc,infloresence,internodal,know,known,lanceolate,large,later,lateral,lehmann,like,lobe,lobed,lon,long-triangular,lower,main,middle,midrib,minor,narrow,narrower,nearly,nflorescence,occasionally,often,older,opposite,outer,pair,paler,papillose,peduncl,peduncle,petaloid,point,pore,poricidal,portion,present,prominently,proximal,pubescent,raised,reproductive,rest,ruit,scar,scattered,slender,spaced,sparsely,specimen,speckle,straight,surface,sympodial,tall,tapering,terminal,thickened,tip,tub,tube,ud,unbranched,unifoliate,unit,upper,urceolate,vein,venation,way,white-papillo,wide,widening,widest,x,yellow,ympodial	characteristic,colour,decument,diameter,form,fruit,growth,height,inflorescence,length,na,plant,seed,shape,type,white-papillose
285	wfo-0001029121	success	161	77	55	106	22	0.342	0,0.2-2,1-4,1-5,1.1-3.9,1.2-2.5,1.2-3.3,15-30,2-10,2-13,2-3,3.6-9,3.8-11,4-10,4-5.5,4.5-10.0,5-20,5-8,9-33,blue,branched,calyx,cm,conical,corolla,deep,diameter,dichasially,filament,forked,glabrous,green,herbaceous,interjected,lateral,leaf,leaflet,long,medium,mm,mucilaginous,odd-pinnate,ovoid,pedicel,peduncle,perennial,petiole,plant,purple,rarely,seed,size,style,terminal,wide	-6,0-2,10,2-,2-3-celled,3-5,3-6-foliat,8-16,abaxiall,abaxially,acumen,acuminate,acute,adaxially,apex,apical,apically,articulate,attenuate,base,cell,commonly,connate,covering,cuneate,cyme,dehiscent,dichasial,digestion,diminishing,distal,dorsally,eaf,ebracteate,edge,eed,elliptical,emoval,enzyme,exceeding,flat,flower,folded,generally,globo,gradually,green-white,hair,hair-like,half,honeycomb,introrse,living,lobe,lon,lower,lunat,make,maturing,monochasial,narrowly,nflorescence,nther,oblique,obtuse,often,orolla,ovate,pair,pattern,perfect,petiolule,plan,poricidally,proximal,reveal,rotate,rounded,ruit,scattered,sessile,seudostipule,short,short-attenuate,slit,specimen,stamen,stigma,straight,subequal,tal,tem,testal,thick,throughou,throughout,tip,toward,tuber-bearing,typically,unit,vary,wall,yellow,ympodial,Â¼	6,abaxial,adaxial,anther,arrangement,branching,colour,form,fruit,growth,height,history,inflorescence,length,life,ovary,pseudostipule,shape,stem,surface,texture,width
286	wfo-0001029125	success	197	124	85	112	39	0.431	0.5,2/3,abaxial,acuminate,adaxial,anther,anthesi,apex,appressed,attenuate,base,berry,black,brownish,calyx,central,cm,concave-reniform,conical,corolla,cuneate,diameter,ellipsoid,end,entire,exerted,filament,fruit,fruiting,glabrous,globose,green,herb,internodal,lateral,leaf,lobe,long,margin,maturity,minutely,mm,narrower,nearly,oblique,often,one,orange,ovary,ovate-lanceolate,pale,papillate,pedicel,peduncle,per,petiole,plant,pubescent,purple,purple-tinged,purplish,ridged,ripe,seed,simple,slightly,small,sparsely,spreading,star,stem,stigma,strongly,style,subshrub,surface,terete,trichome,tube,turning,unequal,uniseriate,white,wide,yellow	.0â3.5,.1,.1â1.4,.2,.4,.5â2.0,.6,0.5â0.6,0.5â1.0,0.8â0.9,0.9,1,1.0â1.2,1.0â1.5,1.0â4.0,1.5â2.0,1.5â3.0,1.7-,1.8â3.5,1â2-celled,2.5â12.0,20â100,2â3-celled,2â4,3.0â3.4,3.5â4,35â45,3â5,3â5-celled,4â8,5-merous,5â6,6,6â7,abaxially,acute,adaxially,age,along,apar,apparently,arising,articulated,ba,beyond,branching,cell,closely,cone,delicate,deltate,densely,difoliate,eaf,eed,especially,flower,free,geminat,growt,hilum,later,lengthening,like,live,lobed,lon,lower,maximum,nflorescence,occasionally,outline,pair,pentagonal,perfect,place,pore,poricidal,portion,positioned,primary,reflexe,reflexed,ruit,scar,scattered,shiny,shorter,single,slit,spaced,stellate,stemmed,stone,straight,sub-lateral,tall,tem,testal,tinged,tip,toward,traingular,ud,unit,usually,vein,whitewith,woody,ympodial,young,Â¼	0.4,0.5-0.6,0.5-1.0,1-2-celled,1.0-1.2,1.0-1.5,1.0-4.0,1.1,1.1-1.4,1.2,1.5-3.0,1.8-3.5,2-4,2.5-12.0,20-100,3.5-4,35-45,5-6,6-7,bud,characteristic,colour,exertion,form,glabrousnes,growth,height,history,inflorescence,length,life,lobing,new,number,perennial,shape,size,texture,type
287	wfo-0001029150	success	177	126	101	76	25	0.571	.5,0.3,0.3â0.5,0.5â1.1,0.8-1,0.8â1,0.8â1.5,0.8â3.5,1.2â1.5,1.5,1.5â2.2,15,1â1.5,1â11,1â5,2.5â5,2.5â8,2â10,3-5,3â10,3â50,6,8-shaped,9â12,acute,adaxially,anther,apex,apically,apiculate,base,berry,branched,calyx,ciliate,cm,conical,cros,cylindrical,diameter,ellipsoidal,elliptical,enlarged,entire,except,extra-axillary,filament,flower,fruit,glabrous,larger,leaf,light,lobe,margin,membranaceous,midvein,minutely,mm,moderately,nearly,oblique,opposed,ovate,pale,pedicel,peduncle,petiole,pinkish-white,pinnate,pubescent,rachi,rarely,rounded,rounded-deltoid,rugose,sand-punctate,section,shortly,simple,slender,slightly,sparsely,stellate,stem,stigma,strong,style,surface,tan,teardrop-shaped,tip,trichome,truncate,tube,venation,vine,white,wiry,woody,x	0.3-0.5,1.5â2,1â2,1â6,2.5â3,2â2.5,2â3,3â4,5-merous,7â8,abaxially,accrescent,across,adaxiall,alyx,apar,apicall,attenuate,axe,blade,c.,canopy,capitat,climbing,color,delicate,distant,dried,eaf,eed,flattened,fleshy,flush,fruiting,glabrou,inconspicuous,lamina,lanceolate,living,lon,long,lower,m.,material,mor,nflorescence,nternode,older,orolla,pair,perfec,plurifoliat,pointed,reaching,ruit,scar,secondary,side,small,somewhat,spaced,specimen,tamen,tem,thick,thickened,time,translucent,tree,understory,unit,vary,vegetation,vein,wide,ympodial	abaxial,arrangement,branching,capitate,characteristic,colour,corolla,form,growth,height,history,inflorescence,internode,length,life,number,ovary,plant,position,seed,shape,size,texture,thicknes,type
288	wfo-0001029152	success	197	112	91	106	21	0.462	0.5-1,0.75-1,0.8-1,0.9-1.3,1-4,1.1-1.3,1.5-1.7,2-5,3-5,3-8-flowered,6-8,8.5-16,acuminate,acute,anther,apex,area,attenuate,bark,base,berry,branch,broadly,brown,bud,calyx,cm,conical,corolla,cuneate,dark,decurrent,deep,densely,dia,elliptic,filament,floccose,fruit,fruiting,glabrous,globose,green,greyish-red,inflorescence,late,lateral,leaf,lightly,long,main,margin,minutely,mm,nearly,obovate,ovary,ovoid-reniform,pair,pale,papillose,pedicel,petiole,pitted,plane,plant,quite,red,red-floccose,reddish-floccose,shape,shaped,shiny,shrub,simple,single,size,slender,small,stem,stigma,style,surface,tapering,tear-drop,tree,tube,vein,white,winged,x	.1,.5,0.25-0.5,1,1-1.5,1-2,1-3,1.5-2,2-2.5,2-3,2-4,2.5-3,4-6,61-25,anthesi,appearanc,appearing,appressed,ba,beginning,beneath,blade,broadened,citronella,closely,completely,corky,deciduous,deflexed,deltoid,differing,difoliate,distal,dry,eaf,edicel,eed,ellipsoi,enclosing,erect,et,exsertion,fide,flattened,flower,fragrance,free,geminat,giving,held,hyaline,inflorescenc,keeled,large-lenticellate,live,lobe,lobed,lon,long-styled,longer,lower,major,material,middle,midrib,minor,nflorescence,often,older,one,opposite,overlapping,per,planar,pore,poricidal,portion,prominent,prominently,reddish,reflexed,reminiscent,rounded,ruit,scar,short-styled,slightly,somewhat,soon,spaced,straight,styl,tall,terminal,third,tillett,tip,trichome,ud,unit,usually,weak,widest,woody,ympodial,young	1.5-6,arrangement,characteristic,colour,diameter,exertion,form,glabrousnes,growth,height,history,length,life,lobing,mentioned,new,peduncle,primary,seed,texture,type
289	wfo-0001029156	success	65	65	48	17	17	0.738	0.5,1.5-2,10-12,4-6,6,6-8,<,almost,bark,cell,center,cm,completely,deeply,diameter,exfoliating,flattened,fruiting,glabrous,golden,growth,lateral,liana,margin,markedly,minutely,mm,multiseriate,new,pale,pedicel,per,pitted,rectangular,reniform,rib-like,seed,shiny,sinuate,stem,surface,tan,testal,thickening,trichome,vine,wall,woody	-3,1,2,apex,apparently,berry,eed,epiphytic,fide,long,minute,nee,noddin,occasionally,older,shreddy,wide	2-3,characteristic,colour,exfoliation,form,fruit,glabrousnes,history,length,life,nodding,number,plant,shape,texture,type,width
290	wfo-0001029156	success	65	65	44	21	21	0.677	0.5,1.5-2,10-12,<,almost,cell,center,cm,completely,deeply,diameter,exfoliating,flattened,fruiting,glabrous,golden,growth,lateral,liana,margin,markedly,minutely,mm,multiseriate,new,pale,pedicel,per,pitted,rectangular,reniform,rib-like,seed,shiny,sinuate,stem,surface,tan,testal,thickening,trichome,vine,wall,woody	-3,1,2,4-6,6-8,apex,apparently,ark,berry,eed,em,epiphytic,fide,lon,minute,nee,noddin,occasionally,older,shreddy,x	2-3,6,bark,characteristic,colour,exfoliation,form,fruit,glabrousnes,height,history,length,life,na,nodding,number,plant,shape,texture,type,variation
291	wfo-0001029163	success	149	118	90	59	28	0.604	0.3-2.5,0.5-1,1,1-2,1.5-2,10-,2,2-18,2-3,2-6,2.5-3,20-30,3-14,3-4,3-5,4-6,5-8,7-9,9-15,abaxial,acuminate,acute,apart,apex,band,base,calyx,chartaceous,cm,connivent,cuneate,cylindrical,decurrent,deltate,densely,diameter,distally,elliptic,elliptic-ovate,entire,free,fruit,glabrous,globose,herb,lanceolate,lenticular,lobe,long,margin,mm,moderately,narrowed,narrowly,nearly,obtuse,papillose,pedicel,peduncle,perennial,petiole,pseudohair,puberulent,puberulent-pubescent,pubescence,purple,rachi,radiu,remnant,roughened,scale-like,shrub,simple,sparsely,stellate,stem,stigma,style,subcoriaceous,surface,thickened,tip,triangular,tube,unbranched,unknown,white,whitish,x,yellow	-25,-4,-9,1.5-2.5,1.5-3,13-18,2-7,4-20,4-5-foliat,4.5-23,5-12,abaxially,absen,adaxiall,adaxially,aggregate,articulated,axe,blade,cell,color,denser,directed,distall,eaf,eed,eglandular,flower,glandular,hair,leaving,like,lon,lower,nflorescence,nther,orolla,pedicellar,pore,projection,puberulent-pubescen,ripe,ruit,slightly,small,sometimes,spaced,stalked,stone,subapical,tal,tem,time,truncat,unit,vary,vein,wide,ympodial	adaxial,anther,arrangement,branch,characteristic,colour,corolla,form,glabrousnes,growth,height,history,inflorescence,leaf,length,life,new,ovary,plant,seed,shape,size,spacing,texture,thicknes,truncate,type,width
292	wfo-0001029171	success	137	119	83	54	36	0.606	-,-15,0.5,1-3,1-4.5,1.5-2,1.5-7.5,10-25,10-35,2-3,3.5-18,3.5-6.5,4-10,4-5,5-6,7-9,abaxially,abruptly,acuminate,acute,adaxially,also,angled,apex,base,branched,calyx,chartaceous,cm,connivent,cuneate,decurrent,deltate,dendritically,densely,diameter,eglandular,elliptic,entire,flower,forked,fruit,glabrous,gland,glandular,globose,hair,lanceolate,like,margin,mm,moderately,narrowed,obtuse,often,orange,ovate-elliptic,pedicel,peduncle,perfect,petiole,pubescent,purple,rarely,red,ripe,rugose,shoot,short-stalked,shrub,simple,slightly,smooth,sometimes,stellate,stigma,style,tip,tube,unbranched,usually,white,x	-10,1-5,11-20,3-4,5-8,6-,8-17,absen,aggregate,and/or,apart,articulated,axe,ba,blade,cell,cylindrical,dense,directed,distall,eaf,eed,except,glandula,lobe,long,lower,many-foliat,midrib,narrowly,near,nearly,nflorescence,nther,orolla,pore,puberulent,rachi,radiu,ruit,spaced,sparsely,ste,stone,tal,tem,time,triangular,truncat,unit,vary,wide,yellow,ympodial	anther,arrangement,bud,characteristic,colour,corolla,drying,exertion,filament,form,fruiting,glabrousnes,growth,height,history,inflorescence,leaf,length,life,lobing,na,new,number,ovary,per,plant,primary,seed,shape,size,stem,surface,texture,truncate,type,vein
293	wfo-0001029215	success	49	50	32	17	18	0.653	.2,0.3-0.5,0.5-0.7,0.5-2.5,1,2.3-2.9,appearance,border,brown,calyx,cm,coarse,diameter,elongating,fruit,hair-like,herb,lobe,long,markedly,mm,narrowly,obovate,outgrowth,pubescent,shrub,silky,smelling,strong,surface,wide,winged	-1.8-2.3,cell,eed,entire,fide,give,lateral,round,small,spreadin,tall,testa,thick,wall,weigend,woody,xyledecor	0.2,1.8-2.3,characteristic,colour,form,giving,growth,height,history,length,life,plant,seed,shape,stem,texture,thicknes,width
294	wfo-0001029216	success	243	145	126	117	19	0.519	+,-0.5,-10,.8-1,0.1-0.3,0.1-0.5,0.1-0.6,0.1-0.8,0.2-0.25,0.2-0.3,0.2-0.8,0.3-2,0.4-0.5,0.5,0.5-0.8,0.5-1.5,0.6-0.8,0.6-1,0.8-2.5,1-1.2,1-2,1-3,1-4,1.2-6,1.5-2.3,1.5-2.5,1.5-3,10,10-,10-14,2-4.5,2.5-3.3,20-35,3,3-,3-5,3-7,4,5,7-10,acute,annual,anther,apex,apical,appendage,attenuate,base,basiscopically,biennial,bright,brown,calyx,capitate,cell,cm,column,conical,corolla,cultivar,decurrent,deep,diameter,elliptic,filament,fruit,fruited,fruiting,glandular,globose,green,hair-like,herb,imparipinnate,inflorescence,interjected,interrupted,large,lateral,leaflet,length,less,lobe,long,minute,minutely,mm,oblique,obovate,orange,outgrowth,ovary,ovate,pale,pedicel,peduncle,pentagonal,perennial,petiole,petiolule,plant,primary,pseudostipule,pubescent,red,secondary,shape,sometimes,sparsely,staminal,stem,sterile,stigma,straight,style,surface,terminal,tertiary,testa,thickening,usually,variety,villous,wall,wide,yellow	-5,.5,0.2-0.4,0.3-0.4,0.3-0.5,0.4,0.5-2,1-6,1/,2,2-locular,3-4,3-foliate,5-15-flower,6-10,<,absen,absent,accrescent,acroscopically,adpressed,allogamous,always,and/or,angeld,anthesi,appearance,articulated,articulation,axi,basal,becoming,branch,cente,composed,cone,cordate,crenate,deeply,dentate,distal,eaf,edicel,eed,entire,erect,exserted,extending,facultatively,fasciated,giving,glabrescent,gland-tipped,gree,half,halfway,included,initially,internode,lanceolate,larger,later,like,linear,lobulate,lon,longer,lower,mainly,margin,maturity,mixture,multicellular,multilocular,narrowly,near,nflorescence,numerous,often,one,pair,particularly,population,present,procumbent,rarely,reflexe,ruit,scen,sessile,shaggy,shaped,short,silky,simple,somewhat,sparse,spreading,strong,strongly,tangled,tem,thick,tip,total,toward,trichome,truncate,tube,ud,unicellular,uniseriate,unit,varying,viny,winged,ympodial	0.1-0.4,arrangement,berry,bud,colour,form,growth,height,history,leaf,life,lobing,na,seed,size,texture,thicknes,type,width
295	wfo-0001029226	success	206	106	87	119	19	0.422	.5,1-1.5,1-3,2-6,2.5-10,4,5-7,7-11,8-13,acuminate,acute,anther,anthesi,apex,base,berry,branched,bright,calyx,capitate,cm,cordate,corolla,densely,diameter,ellipsoid,exserted,filament,flattened,flexuous,fruiting,glabrous,glandular,globose,growth,herbaceous,lateral,lavender,leaf,like,lobed,long,lyrate,many,minute,minutely,mm,new,open,pale,pedicel,peduncle,petiole,pinnatifid,pitted,pubescent,red,reniform,seed,short-glandular,shrub,simple,slender,sparsely,spreading,stem,stigma,strongly,style,surface,tan,terminal,time,translucent,trichome,tube,uniformly,uniseriate,vine,way,weak,white,wide,winged,woody,yellowish,Â¾	-7,-9,.75,0-1,0.5,0.5-5,1-2,1-celled,10-40+,2,2-3,2-9,3-3.5,3-6,30,4-6,5-merou,>,ag,alyx,apart,apparently,ark,articulated,ba,basal,black,blue,breaking,cell,completely,congested,conical,connivent,dark,decurrent,deltate,distall,divided,dry,eaf,eed,elongate,enation,entire,flower,free,glabrescent,gland,green,hairy,ilament,irregularly,juice,lengthening,lobe,longer,loosely,lower,margin,material,mature,membranous,mere,nflorescence,occasionally,often,older,one,orolla,overtopping,pair,papillat,papillate,papillo,per,perfect,pinnate,plurifoliat,pore,poricidal,portion,primary,reflexed,remainin,rim,ripe,ruit,sagittate,scar,scarlet,shiny,shorter,sleeve,slit,small,sometimes,spaced,spot,sprawling,spreadin,staining,stellate,tangled,tem,testal,thin,third,tip,truncate,twinin,ud,unit,usually,vary,vein,wall,widest,ympodial	arrangement,bark,bud,characteristic,colour,exertion,form,fruit,glabrousnes,history,inflorescence,length,life,lobing,ovary,shape,size,texture,type
296	wfo-0001029236	success	159	125	103	56	22	0.648	.5,0.2-0.7,0.2-1,0.45-0.5,0.5,0.5-1.5,0.9-2.3,1-1.5,1-2,1.4-1.7,1/2,3,6-9,absent,anther,anthesi,apex,apical,apically,appearing,bark,basal,base,berry,calyx,cm,coriaceous,corolla,decurrent,deflexed,dendritic,densely,diameter,elliptic,except,exserted,flattened,fleshy,fruit,fruiting,glabrous,globose,grey-brown,growth,later,lateral,leaf,lenticular,less,lobed,long,margin,middle,minutely,mm,narrowly,near,nodding,obscure,obscurely,occasionally,ovary,overtopping,pale,pedicel,per,persistent,petiole,pitted,pointed,poricidal,prominent,pubescent,purplish-black,reddish-brown,revolute,scar,scattered,secondary,shiny,shoot,short,shrub,slightly,sparsely,stem,stigma,strongly,style,surface,tapering,terminal,tip,trichome,trongly,tube,usually,venation,violet,way,wide,winged,x	2-4,2-5,abaxially,adaxial,age,apparently,axi,ba,becoming,bi-lobe,branch,branching,branchlet,broadly,compact,completely,conical,cupulate,deltate,dichasial,eaf,edicel,eed,erect,ew,filament,flower,free,inserted,lobe,lower,m.,many,midvein,nflorescence,older,packe,pericarp,plurifoliate,pore,portion,purplish,ruit,simple,sleeve,slit-like,stamen,tall,thin,time,tub,ud,unit,woody,ympodial,young	bi-lobed,bud,characteristic,colour,exertion,form,glabrousnes,height,history,inflorescence,length,life,lobing,new,number,perennial,plant,seed,shape,size,texture,type
297	wfo-0001029246	success	209	136	111	98	25	0.531	-1,-1.5,-4,/5,0,0-15,0-5,0.1-0.4,0.3-0.8,0.7-1.3,0.7-2,0.8-1.1,0.8-3,0.9-1.3,1-1.5,1-1.8,1.2-2,1.5-2.3,1.5-2.5,1.7-6,1/3,2,2-3,2.5-3.2,2.8-4,3-5,3.5-5,5-20,7-12,abaxial,acuminate,adaxial,anther,apparently,articulated,bark,base,berry,calyx,chartaceous,cm,concolorous,connivent,cuneate,densely,diameter,discolorous,drying,dull,elliptic,entire,erect,filament,flattened-reniform,flower,fruit,fruiting,glabrescent,glabrous,lateral,leaf,length,less,lobed,long,lower,margin,maturity,mauve,midvein,mm,moderately,orange-brown,orange-red,pair,pale,pedicel,peduncle,per,petiole,poricidal,porrect,prickle,prickly,primary,procumbent,purple,recurved,sessile,shrub,simple,sometimes,sparsely,spherical,stellate,stellate-pubescent,stem,style,surface,tapering,terete,tip,trichome,tube,unbranched,upper,vein,way,white,wide,yellow	0.1-0.3,0.15-0.3,0.2-1.5,0.3-0.5,0.5,0.5-1.5,0.7-1.5,1-10,1-3,1-4,1-5,1-8,1.5-6,1.8-3,1/10-1/5,2-3.5,2-5,2/3,2/3-3/,3-20,4-6,5-,5-merous,6-10,6-8,8-16,abaxially,acuminat,acute,almost,alyx,apar,apart,apex,apically,blade,broad-deltate,c.,curved,deltate,distance,eaf,eed,elongating,equal,extending,eye,flattened,free,infructescence,lobe,lon,longer,mature,midpoint,naked,narrow-deltate,narrow-ovate,nflorescence,oblong,obtuse,older,one,open,orange-brow,orolla,oung,pendulous,perfec,pericarp,plurifoliat,portion,prickl,pubescent,ray,rounded,ruit,scar,side,smooth,spaced,spreading,stout,straight,strongly,tamen,tertiary,time,unarmed,unit,usually,vary,venation,visible,woody,yellow-orange,ympodial,Â¼	2/3-3/4,arrangement,branch,bud,characteristic,colour,corolla,exertion,form,glabrousnes,growth,height,inflorescence,lobing,na,new,number,ovary,plant,seed,shape,size,stigma,texture,type
298	wfo-0001029286	success	224	116	99	125	17	0.442	0-0.5,0.4-1.2,0.8,1-2,1.5-2,1.5-4,2-3,2.5-3,4-5,4-6,4.5-7,5-6,6-9,7-10,abaxial,abaxially,acute,adaxially,almost,anther,apart,apex,apiculate,articulation,attenuate,bark,base,branch,branching,broadly,brown,capitate,chartaceous,clustered,cm,corolla,crenulate,dendritic,diameter,domatia,entire,except,faint,filament,flat,flexuous,formed,glabrous,green,grey,junction,leaf,length,liana,light,lilac,lobed,long,main,margin,mauve,membranous,midvein,minutely,mm,obconical,oblong,obovate,occasional,pair,pedicel,peduncle,petiole,primary,prominent,rachi,raised,scar,shallowly,side,simple,sometimes,sparsely,stem,stigma,stump,style,surface,terete,tertiary,time,tip,trichome,tube,unarmed,vein,venation,widely,x	.4,.5,0.1,0.15-0.4,0.6-1.2,0Â°,1-1.5,1.5-8,1/8,15-50,3-4,4.5,5,6-8,abscising,age,along,altered,alyx,another,anthesi,apar,apically,apice,apparently,arising,around,articulated,axil,becoming,branched,canaliculate,clearly,closer,concave,concolorous,conical,curved,cuspidate,delineated,deltoid,density,dilated,distributed,drying,eaf,eed,equal,extending,fertilization,flower,forming,free,fresh,glabrescent,globo,hair,increasing,inflorescenc,inside,isolated,know,known,lamina,lengthening,less,lobe,lower,m.,margi,mas,meeting,middle,much,multicellular,narrowly,nflorescence,nther,often,one,orolla,outside,ovate,papillo,perfec,plurifoliat,pore,poricidal,portion,protruding,rarely,regular,rounded,ruit,separated,slender,smaller,smooth,somewhat,soon,specimen,spreading,stretchy,tangled,tearing,terminal,textur,thick,thickened,thinner,tissue,together,toward,translucent,translucent-violet,tuft,ud,uneven,unit,vary,visible,wide,yellowish,ympodial,young	arrangement,bud,calyx,characteristic,colour,form,glabrousnes,globose,growth,history,inflorescence,life,lobing,papillose,prominence,shape,texture
299	wfo-0001029310	success	216	157	135	81	22	0.625	.5,.6,/4,0-20,0-5,0.2-0.8,0.5-3,0.6-1.1,1-1.5,1-2,1.2-1.5,1.8-3,10,10-15,2-3.5,2-4,2.5-6,2/3-3/4,20-40,3-4,3-5,3.5,4-10,5,5-10,5-12,5-20,5-30,5-7,5-8,5-merous,7-13,abaxially,acute,andromonoecious,anther,apart,apex,apically,apparently,articulated,bark,base,berry,branched,brown,calyx,cm,concolorous,conical,connivent,cordate,dark,deltate,diameter,distal,distance,drying,dull,elliptic,equal,erect,extending,filament,flattened-reniform,flower,free,fruit,fruiting,glabrescent,glabrous,gray,hair,herb,hermaphrodite,heterostylous,lateral,leaf,length,lobe,lobed,lobing,long,long-styled,lower,lowermost,margin,maturity,mauve,membranous,midvein,mm,moderately,narrow-deltate,one,open,orange-green,ornately,pedicel,peduncle,pendent,perpendicular,petiole,pinnatifid,plant,poricidal,portion,prickle,retrorse,secondary,short-styled,shrub,side,simple,sometimes,spaced,sparsely,spherical,spreading,stellate,stellate-pubescent,stem,straight,style,surface,tapering,tertiary,time,tip,toward,truncate,tube,way,wide,yellow	-16,-25,.1,/6,0.1-0.2,0.2-0.3,0.5,00,1,1-4,1/,10-13,10-20,15-20,20-60,200-500,4-8,45-60,5-6,6-8,7-12,8,accrescent,alyx,ame,apar,beyond,blade,c.,difoliate,eaf,eed,elongating,enclosing,filifor,geminat,gently,inflated,infructescence,lon,longer,mature,midpoint,minute,nflorescence,older,orolla,oung,pair,pendulous,per,pericarp,porrect,prickl,prickly,primary,ray,recurved,red-brow,ruit,scar,sessile,shorter,smooth,stalk,stalked,staminat,stout,strongly,tamen,terete,tissue,trichome,unit,variously,vary,vein,venation,visible,woody,ympodial	1/3,arrangement,characteristic,colour,corolla,filiform,form,growth,history,inflorescence,life,ovary,perennial,red-brown,seed,shape,size,staman,staminate,texture,type,width
300	wfo-0001029317	success	151	104	75	76	29	0.497	.5,0.5,0.8-1,1-1.5,10-16,10-30-flowered,11-14,2-3,2.5-5,7-8,8-9,acuminate,anther,apex,area,attenuate,barely,base,broadly,bud,ca,calyx,channeled,cm,corolla,cup-like,dry,erect,exserted,filament,fruiting,glabrate,glabrous,globose,grayish,immature,inflorescence,lateral,leaf,lobed,long,main,margin,minutely,mm,narrowly,nearly,ovary,ovate,pair,papillose,pedicel,petiole,poricidal,probably,pubescent,shrub,simple,size,slender,soon,specimen,stem,stigma,style,tapering,tip,trichome,tube,uniseriate,vein,visible,white,x,yellowish	0.25,0.5-0.75,0.5-1,1,1.5-3.5,6-8,6.5-11,along,anthesi,apar,beneath,brow,closely,deciduou,deflexed,deltoid,densely,denser,dia,differing,difoliate,eaf,edicel,eed,ellipsoi,epidermi,extreme,free,frui,geminate,known,like,lobe,lon,lower,major,middle,minor,nflorescence,occasionally,often,older,one,opposite,otherwise,overlapping,ovoid,paler,pore,portion,prominent,proximal,rachi,raised,reflexed,remaining,rest,rounded,ruit,scar,shaped,slightly,soft,spaced,sparsely,straight,styl,tall,tear-drop,thickened,tuft,ud,unit,widest,ympodial,young	.25,arrangement,bark,brown,characteristic,colour,diameter,drying,exertion,form,fruit,glabrousnes,growth,height,length,lobing,mentioned,na,new,number,peduncle,per,plant,primary,seed,shape,surface,texture,type
301	wfo-0001029332	success	197	135	99	98	36	0.503	0-2,0-20,0-4,0.5-1,0.8-1,1-2,1-3,1-4,1.3-1.5,1.5-2,1/2,1/3,2,2-2.5,2.5-3.5,2.8-3.7,2/3-3/4,3-6,4-15,5-6,5-8,6-8,abaxially,anther,apart,apex,apparently,articulated,bark,base,berry,calyx,chartaceous,cm,concolorous,conical,connivent,cordate,curved,densely,diameter,distal,drying,erect,filament,flattened,flattened-reniform,fruit,fruiting,glabrous,lateral,leaf,length,lobe,lobed,long,lower,margin,maturity,mauve,mm,moderately,orange-brown,ovate,pair,pale,pedicel,peduncle,per,petiole,plant,poricidal,prickle,prickly,primary,pubescent,rounded,shrub,simple,spaced,spherical,spreading,stellate,stellate-pubescent,stem,style,surface,tapering,terminal,tip,tube,upper,vein,way,weakly,wide,yellow,yellow-green,yellow-orange	-5,.5,/3,0,0-0.5,0-100,0-5,0.1,0.1-0.2,0.15-0.2,0.15-0.25,1-1.5,1/4,1/4-1/3,10-30,2-4,2/,3-4,3.5-5,4-10,5-merous,8.5-9.5,abaxial,adaxial,alyx,andromonoecious,apar,apically,becoming,blade,broad-deltate,difoliate,distance,eaf,eed,elongating,equal,extending,flower,free,geminat,glabrescent,gland,globular,grayi,herbaceous,hermaphrodite,heterostylous,infructescence,less,long-acuminat,long-styled,longer,lowermost,mature,midpoint,midvein,narrow-deltate,nflorescence,often,older,one,open,orolla,oung,pendulous,pericarp,porrect,portion,prickl,ray,reduced,ruit,scandent,scar,sessile,short-styled,shorter,side,slender,smooth,stalk,stalked,staminat,subsessile,tamen,terete,tertiary,time,trichome,unbranched,unit,variously,vary,venation,visible,woody,ympodial	1.5,2/3,50-100,appearance,arrangement,border,branch,bud,characteristic,colour,corolla,corrugation,exertion,form,giving,glabrousnes,grayish,growth,height,inflorescence,interjected,leaflet,lobing,na,new,number,ovary,pseudostipule,seed,shape,size,stigma,texture,type,variation,width
302	wfo-0001029333	success	155	101	82	73	19	0.529	.5,/4,0.5,0.7-1,1-1.2,1-1.5,1-15,1-2,1-3,1-7,1.5-2.5,10-15-flowered,17-26,3-7,3-7.5,5-6,8-15,abaxially,acuminate,acute,adaxially,anther,apex,auriculate,base,berry,calyx,clavate,cm,corolla,dendritic,densely,dia,elliptic-obovate,exserted,flattened-reniform,fruiting,glabrous,globose,green,incrassate,leaf,lobed,long,long-styled,margin,minor,minutely,mm,obovate,occasionally,orbicular,ovary,pale,paler,pedicel,petiole,pitted,pubescent,rounded,sessile,shape,shaped,shining,short-styled,shrub,simple,size,somewhat,stem,stigma,strongly,style,surface,tear-drop,time,trichome,truncate,tube,type,way,wide	.25,0.5-1,1.5-2,1.5-3,100,2-2.5,9-13,abaxial,along,anisophyllou,anthesi,ba,bark,beige,beneath,broadly,conical,contracted,deflexed,dendritic-pubescent,denser,differing,difoliate,dry,eaf,edicel,eed,erect,filament,flower,free,fresh,geminate,golden,heteromorphic,inflorescenc,lateral,like,lobe,lon,lower,main,major,nflorescence,older,opposite,overlappin,pair,papillo,planar,pore,poricidal,portion,present,pubescence,reddish-brown,rest,ruit,scar,slender,small,spaced,sparsely,tall,tip,tree,triangular,ud,unit,vein,woody,ympodial,young	1,bud,characteristic,colour,diameter,exertion,form,fruit,growth,height,history,inflorescence,length,life,lobing,perennial,plant,seed,texture
303	wfo-0001029334	success	211	147	121	90	26	0.573	0-4,0.15-0.3,1,1-10,1-2,1-3,1-6,1.5-3.9,1.5-6,1.8-2.9,2-2.5,2-4,2.5-3,3-7,3.2-5.8,3.3-6.5,4-5.5,4-8.5,5-10,7.5-15.5,8-30,9-12,abaxially,absent,acumen,adaxially,almost,along,anther,apart,axillary,berry,blade,borne,brownish,bud,cell,chartaceous,ciliate,clavate,cm,condition,connivent,corolla,covering,densely,diameter,distal,dorsally,drying,edge,end,especially,filament,flat,flower,folded,forked,fresh,fruit,generally,glabrous,globose,green,green-white,greenish,hair,hair-like,half,herb,homostylous,interjected,lanceolate,lateral,leaflet,like,lobe,long,make,margin,membranous,midrib,minutely,mm,mucilaginous,odd-pinnate,ovoid,pedicel,peduncle,plant,puberulent,pubescent,pure,ripe,seed,singly,size,stellate,stem,stigma,straight,style,subtending,terminal,testal,thick,throughout,tinged,tip,tube,tuber,typically,usually,violet,wall,wet,white,whitish,wide,x,yellow	.2,1.3-4.5,2,2-5,2-8,3-5,5-merou,acute,ag,alyx,among,apex,apparently,articulated,attenuate,axe,base,broadly,capitat,cordate,cuneate,decreasing,decurrent,digestion,eaf,eed,elliptic,enzyme,erect,exceeding,except,geminat,glabrou,gradually,grassland,greatly,honeycomb-shaped,lengthening,living,low-growin,lower,middl,narrowly,nflorescence,oblique,obtuse,often,orbicular,orolla,ovate,pair,perfect,petiole,petiolulate,petiolule,plurifoliate,pore,poricidal,proximal,rarely,reduced,removed,rounded,ruit,semi-rosette,sessile,seudostipule,shady,short,situation,slightly,slit,spaced,specimen,stamen,ste,stolo,subequal,subsessile,sunny,tall,tamen,tem,toward,tri-,unit,unwinged,vary,woodland,ympodial	0.2,5-merous,abaxial,adaxial,arrangement,calyx,capitate,colour,form,growth,height,history,inflorescence,leaf,length,life,ovary,presence,pseudostipule,shape,spacing,stolon,surface,texture,type,variation
304	wfo-0001029344	success	147	101	73	74	28	0.497	.5,0.4-1,0.5-1,1,1-5,1.5,1.5-4,10-20,10-35,2-4,3-10,4-6,5-12,5-15,absent,acute,anther,apex,base,berry,brown,calyx,center,chartaceous,ciliate,cm,densely,diameter,dm,drying,edge,elliptic,elliptic-ovoid,entire,filament,fine,flower,fruit,glabrous,globose,herb,immature,linear-lanceolate,margin,maturing,membranaceous,mm,moderately,nearly,oblong,obtuse,parallel,pedicel,peduncle,per,petiole,pubescent,radiating,raised,rhizomatous,ridge,rotate,rounded,running,semitransparent,shallow,sparsely,stigma,style,surface,white,x,yellow	0.5-1.5,0.5-3,1-2,1-3,1-6,1.5-3,2-3,2-3-celled,2-7,abaxially,abundant,adaxiall,adaxially,along,axe,beyond,blade,connected,cordate,decurrent,dehiscing,denser,difoliate,eaf,eed,emarginat,equal,explosively,exserted,flat,frui,geminat,hair,held,interpetalar,lacking,lobe,long,lower,lying,maturit,mesocarp,nflorescence,notch,obvious,often,one-,orolla,placenta,pressure,pubescen,rachi,ruit,short,slightly,sometimes,stamen,straight,swollen,tal,tamen,tem,tissue,triangular,tube,two-celled,unbranched,unit,vary,vein,watery,wid,woody,ympodial	abaxial,adaxial,arrangement,characteristic,colour,corolla,form,geminate,glabrousnes,growth,height,history,inflorescence,leaf,length,life,new,number,ovary,plant,seed,shape,size,staman,stem,texture,type,wide
305	wfo-0001029363	success	152	102	77	75	25	0.507	.75,/4,0.2-1.1,1-1.2,1.5-1.7,1.5-3.5,2-6,3-7,4-11,5-7-flowered,6-7,6-8,7-10,acuminate,acute,anther,anthesi,apex,bark,base,becoming,beneath,berry,bi-lobed,bud,calyx,capitate,cm,corolla,cup-shaped,deep,deflexed,densely,dia,elliptic,exsertion,fruit,fruiting,glabrous,globose,green,greyish,immature,lateral,leaf,lobed,long,main,maroon,minutely,mm,narrowly,obtuse,ovary,pair,pale,pedicel,petiole,poricidal,pubescent,shiny,shrub,simple,small,sparsely,stem,stigma,style,surface,tapering,tip,tree,vein,way,white,white-papillose,wide	.25,0-0.1,0.1-0.5,0.5,0.5-1,1,axil,ba,beginning,closely,coroll,deltoid,drying,eaf,edge,edicel,eed,erect,except,filament,free,inflorescenc,internodal,known,lamina,larger,later,lobe,lon,lower,margin,mature,meeting,middle,minute,much,near,nflorescence,occasionally,often,older,opposite,overlapping,paler,papillo,papillose,pore,portion,prominent,reflexed,ruit,scar,slender,slit-like,somewhat,spaced,sparse,straight,tall,terminal,thickened,trichome,tube,tuft,ud,unifoliat,uniseriate,unit,upon,usually,widest,woody,yellowish,ympodial,young	arrangement,characteristic,colour,diameter,exertion,form,growth,height,history,inflorescence,length,life,lobing,na,number,peduncle,per,plant,primary,seed,shape,size,texture,type,unifoliate
306	wfo-0001029364	success	153	105	80	73	25	0.523	-2,0.2-0.5,1-,1-3,1-4,1-5,1.5-2,10-27,2,2-6,4-9,5-11,5-9,7-9,8-15,?,acuminate,anther,apart,apex,articulated,base,calyx,cm,corolla,cream,cuneate,cylindrical,diameter,distally,elliptic,entire,extra-axillary,filament,finger,flower,fruit,glabrous,gland-tipped,globose,green,greenish,hair,herb,immature,lobe,major,margin,membranaceous,minutely,mm,moderately,narrowly,nearly,obtuse,pedicel,peduncle,petiole,puberulent,pubescent,rachi,radiu,sagittate,shallow,shrub,side,simple,sparsely,spot,stellate,stigma,strongly,style,tapered,triangular,unbranched,unknown,vein,white,x	-3,-6,.5,1,191.,2-,2-foliat,3-4,4-12,5-,6-8,8-10,abaxially,according,acute,adaxially,aggregate,around,axe,ba,bitter,blade,blue,cell,center,chartaceous,color,connivent,curled,darker,deep,directed,distall,eaf,ed,fide,free,glandular-puberulen,inserted,long,lower,mesocarp,nflorescence,orolla,ovate,part,perfect,pore,presence,present,puberulen,ripe,ruit,rusby,short-tomentose,shorter,small,spaced,stone,tal,tamen,tem,thecae,tightly,time,tomento,truncat,tube,unit,vary,wide,yellow,ympodial	2-12,abaxial,adaxial,arrangement,articulation,characteristic,colour,form,glandular-puberulent,growth,height,inflorescence,insertion,leaf,length,ovary,plant,seed,shape,size,spacing,staman,stem,texture,truncate
307	wfo-0001029368	success	139	83	59	80	24	0.424	.2,.5,0.5-2,1.5-3,1.5-4,11-13,16-25,2-5,2.5-4,5-6,acuminate,acute,anther,anthesi,apex,bark,base,berry,broadly,calyx,capitate,cm,corolla,crumpled,densely,dia,elliptic,erect,exserted,fruit,fruiting,glabrous,globose,golden,herb,inflorescence,leaf,lobe,long,minutely,mm,obtuse,ovary,pedicel,petiole,puberulent,shaped,shrub,simple,stem,stigma,strongly,style,tear-drop,trichome,tube,uniseriate,white,x	.25,0,0.9-1,1.5-1.6,1.5-2,?,abaxially,adaxially,along,apparently,bearing,bitter,borne,breaking,brow,closely,coarse,conical,cup,deflexed,distal,eaf,edicel,eed,few-branched,fide,filament,flattened,flower,free,green,half,indistinct,inflorescenc,internodal,known,lamina,lanceolate,lateral,leaving,like,lower,main,margi,margin,middle,midrib,minute,nflorescence,non-flower,older,one,opposite,overlappin,pair,papillo,papillose,parallel,pore,poricidal,portion,reflexed,rest,ruit,scar,somewhat,spaced,straight,tall,tip,ud,unifoliat,unit,upper,vein,widest,winged,woody,ympodial,young	abaxial,adaxial,arrangement,brown,bud,characteristic,colour,diameter,exertion,form,growth,height,length,na,number,per,plant,seed,shape,size,surface,texture,type,unifoliate
308	wfo-0001029370	success	224	133	111	113	22	0.496	.3,0-35,0.5-1,0.5-2.2,1-2,1.5-6,1.8-2.5,1/4-1/3,2-3,3-4,3.5-4,3.5-8,4-6,4-9,8-14,abaxial,adaxial,almost,anther,apex,apically,apparently,articulated,bark,basal,base,berry,branched,broad-deltate,calyx,chartaceous,cm,connivent,cordate,cream,dark,densely,diameter,discolorous,drying,elongate,erect,filament,fine,flattened-reniform,flower,fruit,fruiting,fully,glabrescent,green,greenish,herb,lateral,leaf,length,lobe,lobed,long,long-styled,lower,margin,marking,maturity,mauve,mm,moderately,multangulate,obtuse,often,opening,orange-brown,ornate,ovate,overlapping,pale,pattern,pedicel,peduncle,petiole,plant,poricidal,prickly,red-brown,reticulate,rotate,rounded,shiny,short-styled,shrub,simple,smooth,spherical,spreading,stalked,stellate-pubescent,stem,strongly,style,surface,tapering,tip,trichome,tube,variously,way,white,whitish,wide,yellow,young	-20,-32,.1,.5,/4,0-10,0-100,0-3,0.1,0.1-0.15,0.2,0.3,1,1-3,1-4,1.8-2.8,1/3-1/2,10-17,10-40,10-50,12-17,15-30,2-10,2-20,2-6,2.5-3.5,3/,4-7,5-10,5-12,5-merous,5.5-7,6-15,7-11,7-13,8-20,8-23,abaxially,acut,alyx,ame,andromonoecious,apar,apart,blade,c.,clearly,conical,curved,distal,distance,eaf,eed,elongating,equal,extending,fewer,flattened,free,gently,glabrous,hermaphrodite,heterostylous,infructescence,longer,lowermost,mature,midpoint,midvein,mixture,nflorescence,older,one,open,orange,orolla,oung,pair,pendulous,per,pericarp,perpendicular,plurifoliat,porrect,portion,prickl,prickle,primary,ray,ruit,scar,sessile,side,slightly,sometimes,spaced,stalk,staminat,stout,straight,tamen,terete,tertiary,time,unarmed,unit,vary,vein,venation,visible,white-gra,woody,ympodial	3/4,acute,arrangement,branch,characteristic,colour,corolla,exertion,form,glabrousnes,growth,height,inflorescence,lobing,new,ovary,seed,shape,size,texture,type,white-gray
309	wfo-0001029373	success	199	113	76	123	37	0.382	5,6.8,acute,anther,anthesi,apex,articulated,bark,base,berry,broadly,bud,calyx,clavate,cm,conical,corolla,curved,deltate,densely,diameter,ellipsoid,entire,filament,flattened-reniform,fruit,fruiting,globose,green,grey-brown,growth,halfway,herb,internodal,lateral,leaf,less,long,margin,minute,minutely,mm,moderately,new,node,obtuse,ovary,ovate-lanceolate,pair,papillate,pedicel,peduncle,per,petiole,pitted,plant,primary,pubescent,rounded,shape,simple,slightly,stem,stigma,straight,style,surface,terete,tip,trailing,tube,vein,white,wide,woody,yellowish	.0â1.2,.2,.3,.5,.5â2.0,0.3â0.5,0.4â1.6,0.5â1.2,0.5â1.8,0.6â0.7,1.0â1.2,1.0â1.6,1.2â1.5,1.3â2.2,1.4â3.5,1.5â2.0,1.5â2.5,1.5â2.7,1.8â2.0,1.8â2.3,180Â°,2-celled,2.0â2.5,2.7â3.0,20â30,2â4-celled,3,3.5â4.0,30â40,3â5,4â5,4â6,5-merous,5â6,8â9,abaxial,abaxially,accrescent,acuminate,adaxial,adaxially,age,apar,appearanc,appressed,arising,basal,bayonet,beyond,capped,cell,cone,developing,distal,eaf,eed,elongate,enclosed,enclosing,exerted,finger,flower,free,fully,geminat,glabrous,glandular-tipped,hair,half,hilum,immature,individual,laterally,lengthening,like,live,lobe,lobed,lon,lower,mature,mesocarp,middle,mouth,nflorescence,older,outline,pentagonal,perfect,plurifoliate,pore,poricidal,portion,positioned,reflexed,resembling,root,ruit,scar,seen,seudostipule,shallowly,short,slit,smoot,spaced,spreading,stellate,still,tall,tem,testal,thicker-walled,trichome,tub,ud,uniseriate,unit,upper,yellow,yellow-green,ympodial,â5	0.4-1.6,0.5-1.2,0.6-0.7,1.0-1.2,1.0-1.6,1.2-1.5,1.3-2.2,1.4-3.5,1.5-2.5,1.8-2.3,20-30,30-40,4-6,5-6,8-9,arrangement,branch,characteristic,colour,exertion,form,glabrousnes,height,history,inflorescence,length,life,lobing,na,number,pseudostipule,rooting,seed,size,smooth,texture,type
310	wfo-0001029402	success	113	83	61	52	22	0.54	0.5-1,0.5-2,11-17,15-30,2,2-3,3-5,4-6,4-7,5-25,7-8,acuminate,acute,apex,band,base,branched,calyx,chartaceous,ciliolate,cm,connivent,deltate,diameter,elliptic,flower,free,glabrate,glabrous,inrolled,lanceolate,lobe,margin,mm,narrowed,narrowly,often,papillose,pedicel,peduncle,petiole,pubescence,pubescent,rachi,radiu,roughened,scale-like,shrub,simple,somewhat,sparsely,stellate,stigma,style,surface,tapered,thickened,tip,unknown,violet,x	1-2.5,2-10,3-4,3-6,4-8,6-16,7-11,7-9,8-15,abaxial,abaxially,adaxially,apart,articulated,axe,blade,color,cylindrical,denser,directed,distall,eaf,eed,fleshy,forked,glabrou,hair,leaving,long,lower,many-foliat,moderately,nearly,nflorescence,nther,orolla,pore,rachise,ruit,scar,spaced,tal,tem,time,triangular,truncat,tube,unit,unknow,vary,wide,ympodial	anther,arrangement,characteristic,colour,corolla,form,fruit,growth,height,history,inflorescence,leaf,length,life,ovary,plant,seed,shape,stem,texture,truncate,type
311	wfo-0001029404	success	154	149	95	59	54	0.617	0-60-flower,0.5-1,1,1-4,2,2-3,2-5,2.5-22,2.5-3,20-35,3-4,3-8.5,5-10,5-20,5-24,6-8,6.5-34,abaxially,acuminate,acute,adaxially,anther,apex,apiculate,auriculate,basal,base,beyond,branched,calyx,center,chartaceous,cm,connivent,cordate,cream,dark,darker,deltate,densely,diameter,directed,distally,eglandular,ellipsoidal,entire,exserted,flattened,fleshy,flower,fruit,glabrous,glandular,green,hair,lanceolate,less,light,lobe,long,longitudinal,margin,mm,moderately,mottling,obtuse,orange,ovate,ovoid,pedicel,peduncle,perfect,petiole,pink,pore,puberulent,pubescent,purple,ripe,shrub,simple,somewhat,sparsely,star,stigma,style,toward,tree,triangular,tube,unbranched,vein,white,x,yellow	-1.5,-10,-3,-5,1.5-2,15-25,2-4,2-8,3-5,4-foliat,5-6,6-9,8-12,absent,aggregate,apart,ape,articulated,axe,blade,cell,connective,cylindrical,eaf,eed,glandular-puberulen,leaving,lemon,lon,lower,narrowly,nflorescence,nther,orang,orolla,pedicellar,presen,rachi,radiu,remnant,ruit,shorter,slightly,small,spaced,stellate,stone,subcoriaceous,tal,tem,thecae,time,tomento,truncat,ud,unit,vary,wide,ympodial	appearance,arrangement,bark,border,branch,bud,characteristic,colour,corolla,corrugation,distal,drying,exertion,filament,form,fruiting,giving,glabrousnes,glandular-puberulent,growth,height,history,inflorescence,interjected,lateral,leaf,leaflet,length,life,lobing,midpoint,na,new,number,ovary,per,plant,prickle,primary,pseudostipule,ray,seed,shape,size,stem,surface,terminal,texture,thicknes,tomentose,truncate,type,variation,width
312	wfo-0001029406	success	136	108	83	53	25	0.61	0.3-1,0.5-1,0.6-1,0.7-1.5,1-1.5,1-10,1.5-2.2,1.5-2.5,1.5-5,2,2-11,2-3,2.5-3.5,28,3-9,30,4-18,abaxially,acute,adaxially,anther,apex,arachnoid,arachnoid-pubescent,bark,base,berry,broadly,brown,calyx,clavate,cm,conical,corolla,dark,deciduous,densely,dia,difoliate,elliptic,filament,fruiting,glabrous,globose,grayish-brown,grayish-green,green,greenish-white,leaf,lilac,lobed,long,maturity,minor,minutely,mm,nearly,ovary,ovoid,ovoid-reniform,pale,pedicel,petiole,pitted,pubescent,shaped,shiny,shrub,size,slightly,small,stem,stigma,style,surface,tear-drop,tinge,tree,trichome,tube,unit,white,wide	.5,1-2,4-6,7-12,along,anthesi,ba,brownish,bullate,conspicuously,deflexed,deltate,differing,dry,eaf,eed,felt-like,free,geminat,impressed,large,lateral,lenticel,lobe,lon,lower,main,major,margin,matted,middle,occasionally,often,older,pair,papillo,papillose,planar,pointed,population,pore,poricidal,portion,ruit,soon,tall,tip,vein,waxy,widest,woody,ympodial,young	1.5,arrangement,bud,characteristic,colour,diameter,exertion,form,fruit,geminate,growth,height,history,inflorescence,length,life,lobing,na,peduncle,plant,seed,shape,sympodial,texture,type
313	wfo-0001029407	success	208	113	89	119	24	0.428	-6,.5,/3,0-4,0.4-0.7,0.4-1,0.5-0.7,0.5-1.5,0.5-2,0.6-0.9,0.7-1.2,1-1.4,1-4,1.8-2.5,1/5,2.5-3,3-4,3-6,acute,almost,anther,apex,apparently,articulated,bark,base,berry,bright-red,calyx,cm,cuneate,dark,densely,diameter,dull,elliptic,entire,erect,evenly,filament,flattened-reniform,fruit,fruiting,gray-greenish,green,green-brown,lateral,leaf,length,lobed,long,margin,mature,maturity,mauve,mm,moderately,obtuse,orange,orange-brown,ovate,pedicel,peduncle,petiole,poricidal,prickle,prickly,rarely,rounded,shrub,simple,sometimes,spherical,stellate,stellate-pubescent,stem,style,surface,tapering,tip,tube,unbranched,upper,way,white,wide,yellow,yellow-green,young	-10,-2,-25,-4,-7,0,0-15,0-2,0-5,0.1-0.2,0.1-0.25,0.15-0.4,0.2-0.3,0.6,1,1-2,1-3,1-4.5,1.5,1/3,1/3-1/2,1/8-1/5,2-3,2-4,2-5,3.5-4.5,4-15,4-9,4.5-6,5-7,5-merous,6-13,6-20,7-8,abaxial,abaxially,acut,adaxial,alyx,apar,apart,apically,blade,brow,chartaceous,connivent,curved,deltate,difoliate,discolorous,drying,eaf,eed,elongating,equal,flattened,flower,free,geminat,geminate,glabrescent,glabrous,infructescence,lengt,lobe,longer,lower,midpoint,nflorescence,occasionally,older,one,open,orolla,oung,pair,pale,pendulous,per,perfec,pericarp,porrect,portion,prickl,primary,pubescent,ray,recurved,reflexed,ruit,scar,sessile,shorter,side,slender,smooth,spaced,sparsely,spreading,stalk,stalked,stout,straight,straw-yellow,strongly,tamen,terete,tertiary,thick,time,trichome,unit,vary,vein,venation,visible,weakly,woody,ympodial	arrangement,branch,brown,bud,characteristic,colour,corolla,exertion,form,glabrousnes,growth,height,inflorescence,lobing,na,new,ovary,plant,seed,shape,size,stigma,texture,type
314	wfo-0001029408	success	244	146	116	128	30	0.475	0,0.2-0.3,0.9-1.3,0.9-1.6,1-8,1.1-1.5,1.4-1.9,1.5-3,1.7-2.4,1/2,11-31,2-12,2-5,2/3,3-5,4-14,4-20,5-6.5,7-12,abaxially,acute,adaxially,anther,anthesi,apex,barely,bark,base,becoming,berry,blade,blunt-tipped,branch,branched,broadly,brown,bud,calyx,clavate,cm,conical,continued,corolla,cuneate,dark,decurrent,deltoid,diameter,due,elliptic,entire,exserted,filament,fleshy,flower,fruit,fruiting,glabrous,globose,gray,green,growth,honeycombed,lanate,lateral,leaf,length,lilac,long,long-attenuate,margin,midvein,mm,moderately,mostly,oblong,orbicular,ovate,pale,pedicel,peduncle,petiole,pubescent,purplish,rarely,reniform,reticulate-punctate,ripe,short-attenuate,shrub,side,simple,slightly,small,stelliform,stem,stigma,style,subcampanulate,suborbicular,terete,time,tomentose,top,tree,tube,turbinate,unarmed,vein,velutinous,way,white,whitish,x,yellow,yellowish	-1.5,-10.5,-4.5,.2-3.5,/10,0-100,0.3-5,0.5-2.5,0.7-1.2,1.6-2.8,1.8-3.5,1/2-3/4,1/4,2-3.5,2-4,2.2-3.7,2.5-7,3.5-5,4-7.5,5-24,5-6,5-8,5-merou,accrescent,acuminate,adaxiall,ag,alyx,apart,apical-lateral,articulated,axe,axillary,ba,capitat,chartaceous,dehiscing,dendritic-echinoi,dendritic-multangulate,densely,develope,directed,distal,distall,eaf,echinoi,echinoid,eed,extend,faintly,few-rayed,free,hair,high,homostylous,indument,inserted,interpetalar,introrse,lacking,lanceolate,large,lobe,lobed,long-,long-stalked,longitudinal,lower,m.,main,many,mixed,multangulate,near,nearly,nflorescence,obscured,obtuse,often,older,orolla,ovate-lanceolate,overlapping,part,partly,perfect,persistent,plurifoliate,pore,porrect-stellate,present,pseudo-terminal,rachi,rather,ray,relatively,ribbed,rotate-stellate,ruit,runk,sessile,short-,short-stalked,slit,sometimes,spaced,stamen,subovate,suture,tamen,testa,thick,thick-stalked,thick-textured,thin-stalked,tissue,tomentu,tomentum,touching,toward,unarme,unit,usually,vary,well,wide,ympodial,young	5-merous,arrangement,capitate,characteristic,colour,corrugation,drying,exertion,form,glabrousnes,height,history,inflorescence,life,lobing,na,new,number,ovary,per,perennial,plant,primary,pseud-terminal,seed,shape,size,surface,texture,type
315	wfo-0001029417	success	213	140	117	96	23	0.549	.5,0-7,0.2-0.6,0.4-8,0.7-3,1-2,1-4,1-8,1.3-8,1.5-1.8,1.5-10,1.5-8,12,2.5-10,2.8-3.5,3-14,3-5,4-7,5-15,6-11,8-15,8-9,abaxially,adaxially,anther,berry,blade,blue,borne,brownish,cell,central,chartaceous,clavate,cm,coarsely,condition,connivent,corolla,covering,dark,deep,diameter,distal,dot,drying,end,erect,filament,flower,fresh,fruit,glabrous,globose,green,green-white,greenish,hair-like,herb,homostylous,interjected,lanceolate,lateral,leaflet,lobe,long,lunate,make,medium,membranous,minute,mm,moderately,mucilaginous,non-glandular,odd-pinnate,often,ovoid,pair,pedicel,peduncle,pentagonal,petiole,pilose,plant,pubescent,purple,ripe,rotate,scattered,seed,singly,size,slightly,sometimes,star,stem,stigma,straight,style,terminal,testal,thick,throughout,tinged,trichome,tube,tuber,typically,violet,wall,wet,white,whitish,wide,x,yellow	1,1-1.5,1-10,2-4,5-merou,acumen,acuminate,acute,ag,along,alyx,apart,apex,apiculate,apparently,articulated,attenuate,axe,axillary,base,basiscopic,broadly,bud,capitat,ciliate,decreasing,decurrent,digestion,dorsally,eaf,edge,eed,enzyme,erec,especially,exceeding,flat,folded,forked,geminat,generally,glabrou,greatly,hair,hal,half,honeycomb-shaped,lengthening,like,linear,living,lower,margin,midrib,minutely,narrowly,nflorescence,orbicular,orolla,ovate,perfect,petiolulate,plurifoliate,pore,poricidal,puberulent,rapidly,rarely,removed,rounded,ruit,sessile,seudostipule,short,short-petiolulate,side,slit,spaced,specimen,stamen,ste,stolo,subequal,subtending,tall,tamen,tem,tip,tri-,unit,unwinged,usually,vary,widely,wing,ympodial	5-merous,abaxial,adaxial,arrangement,calyx,capitate,colour,form,growth,height,history,inflorescence,leaf,length,life,ovary,presence,pseudostipule,shape,stolon,surface,texture,type
316	wfo-0001029461	success	217	124	95	122	29	0.438	-1.5,-3,-3.2,-5,.5,0.6-1,0.7-1,0.8-1.5,1-,1-1.6,1.2-1.7,1.2-1.8,1.3-2.2,1.5-,1/4-1/2,2-2.4,2-2.8,2-4,2.5-3,3-6,5-25,almost,anther,apex,attenuate,bark,base,berry,black,broad-deltate,calyx,cell,chartaceous,cm,concolorous,cuneate,dark,densely,diameter,discolorous,drying,dull,elliptic,evenly,filament,fine,flattened-reniform,fruit,fruiting,green,leaf,length,lobed,long,margin,maturity,mauve,mm,moderately,oblong,outline,ovate,pair,pedicel,per,petiole,pit,plant,poricidal,prickly,primary,raised,reddish,rounded,shiny,shrub,simple,small,smooth,sometimes,sparsely,spherical,stellate-pubescent,stem,style,subentire,surface,tip,tube,vein,way,weakly,wide,yellow,young	-14,-2,-3/4,-4,-4.5,0,0.1,0.1-0.25,0.15-0.25,0.8,1-2,1-3,1-4,1-6,1.5-2,1/3,1/3-2/3,1/4,2-3,3-20,4-10,4-6.5,4-7,4.5-7,4.7-7.2,5-10,5-merous,7-10,7-12,8-9,abaxially,acuminat,alyx,ame,andromonoecious,apart,apically,becoming,blade,breaking,brittle,brown,c.,curved,distal,distance,eaf,eed,elongating,erect,extending,faint,fifth,flattened,flower,four,free,glabrescent,glabrous,gra,hermaphrodite,heterostylous,infructescence,lengt,lobe,long-styled,longer,lower,lowermost,mature,midpoint,midvein,obovate,obtuse,older,orange,orolla,oung,pendulous,pericarp,plurifoliat,porrect,portion,prickl,prickle,ray,reduced,reflexed,ruit,sessile,shallow,short-styled,shorter,side,slender,slightly,spaced,spreading,stalk,stalked,staman,staminat,stellate,straight,strongly,tamen,terete,tertiary,time,trichome,unarme,unarmed,unequal,unit,upper,variously,vary,venation,visible,woody,ympodial,zygomorphic	1,arrangement,branch,bud,characteristic,colour,corolla,corrugation,exertion,form,glabrousnes,gray,growth,height,history,inflorescence,life,lobing,na,new,number,ovary,peduncle,seed,shape,size,stigma,texture,type
317	wfo-0001029462	success	166	106	67	99	39	0.404	-30,-4,0.5-1,0.5-2,1-3,1-6,1.5-7,10-,15-25,2-6.5,2.5-3.5,2.5-5.5,3-18,4-20,6-9,acuminate,acute,apex,base,calyx,chartaceous,cm,connivent,cuneate,dark,densely,diameter,ellipsoidal,elliptic,entire,flattened,flower,fruit,glabrous,green,lanceolate,laterally,light,longitudinal,margin,membranaceous,mm,narrowly,obtuse,ovate,ovoid,pedicel,peduncle,petiole,pubescent-pilose,purplish,reticulate,rounded,simple,smooth,somewhat,stigma,stripe,style,tip,tree,triangular,truncate,tube,unbranched,white,x	-2,-5,1,1-,1-2,1.5,1.5-2,1.5-3,10-22,2-3,20-35,3,3-27,3-4,3-5,3-6,3-7,4-15,4-foliat,5-30,7-19,7-8,8-9,abaxially,abruptly,absent,adaxially,aggregate,apart,ape,articulated,axe,basal,beyond,blade,broad,campanulate,cell,ciliate,connective,constricted,curled,cylindrical,dentate,directed,eaf,eed,eglandular,equal,exceeding,exserted,hair,leaving,lobe,lon,long,lower,m.,minutely,moderately,near,nflorescence,nther,occasionally,often,orolla,oval,pedicellar,perfect,pore,puberulent,pubescent,pubescent-pilo,purpl,rachi,radiu,remnant,ruit,shorter,slightly,small,spaced,sparsely,stamen,stellate-,stone,tal,tem,thecae,time,tomentose,truncat,ud,unit,vary,wide,without,yellow,ympodial	anther,arrangement,bark,branch,bud,characteristic,colour,corolla,corrugation,drying,exertion,filament,form,fruiting,glabrousnes,growth,height,history,inflorescence,leaf,length,life,lobing,na,new,number,ovary,per,plant,primary,seed,shape,size,stellate-campanulate,stem,surface,texture,type,vein
318	wfo-0001029464	success	235	161	125	110	36	0.532	.9,0-80,0.2-0.5,0.2-0.7,0.8-2,00-200,1-10,1-3,1.2-3,1/4-1/2,10-23,10-40,2-3,2-3.5,2-4,2.2-2.5,2.4-4,2.5-5,2.5-8,2.9-3.2,3-20,3-7,4-7,5.5-6,5.5-7.5,6-15,7-10,9-15,abaxially,acicular,acute,annual,anther,apex,apparently,bark,base,berry,black,branched,brown,calyx,chartaceous,cm,connivent,cordate,curved,dark,diameter,distal,drying,ellipsoid,erect,filament,flattened-reniform,flower,fruit,fruiting,glabrescent,glabrous,globular,green,green-brown,herb,lateral,leaf,length,lobe,lobed,long,long-styled,lower,margin,maroon,maturity,mauve,midpoint,mm,moderately,mottled,oblong,obtuse,occasionally,orange-brown,ovate,ovoid,pair,pedicel,peduncle,pendent,per,petiole,pink,plant,poricidal,prickle,prickly,primary,purple,ray,red-brown,short-styled,simple,sometimes,stellate-pubescent,stem,straight,striped,style,surface,tapering,terete,terminal,tip,tube,unarmed,usually,variously,vein,way,white,wide,yellow-green,yellow-orange,young	-2/3,-3,-30,-5,0,0-2,0.2,0.3-0.7,0.3-1,0.5,0.5-2,1,1-8,1.5-2,1/,1/4,1/4-1/3,10-15,10-50,12-50,2,3-5,3.5-5,4-8,4-8-merous,5-17,5-8,8-13,8-15,abaxial,adaxial,alyx,ame,andromonoecious,apar,apart,apically,around,articulated,blade,broad,broad-deltate,brow,c.,cultivar,cup-shaped,deltate,difoliate,discolorous,distance,eaf,eed,elongated,elongating,equal,extending,free,fully,geminat,glaucous,hair,hermaphrodite,heterostylous,infructescence,less,long-acuminat,longer,lowermost,mature,midvein,minute,narrow-deltate,nflorescence,often,older,one,open,opening,orolla,oung,pendulous,pericarp,porrect,portion,prickl,rounded,ruit,scar,sessile,side,smooth,spaced,sparsely,spreading,stalk,stalked,staminat,stellate,tamen,tertiary,time,translucent,trichome,unit,upper,vary,venation,visible,woody,ympodial	1/2,appearance,arrangement,border,branch,bud,characteristic,colour,corolla,corrugation,exertion,form,giving,glabrousnes,growth,height,history,inflorescence,interjected,leaflet,life,lobing,na,new,number,ovary,pseudostipule,seed,shape,size,stigma,texture,thicknes,type,variation,width
319	wfo-0001029546	success	203	138	119	84	19	0.586	0-2,0.3-1,1-2,1-4.5,1.5-2,1.5-6.2,2-9,2.2-2.8,3-8,4-10,4.5-12.5,5,5-10,5-18,6.3-19.5,7-10,8-17,8-19.5,abaxially,adaxially,anther,apparently,axillary,base,berry,blue,brownish,bud,cell,chartaceous,clavate,cm,condition,connivent,corolla,covered,covering,curved,decreasing,densely,diameter,distal,dot,drying,erect,filament,flower,forked,frequently,fresh,fruit,generally,glabrous,glandular,globose,greatly,green,green-white,greenish,hair-like,half,herb,lanceolate,lateral,leaf,leaflet,long,longer,lunate,make,membranous,mm,mucilaginous,non-glandular,odd-pinnate,often,ovoid,pair,pedicel,peduncle,pentagonal,perfect,petiole,plant,poricidal,pubescent,rachi,rarely,ripe,rotate-pentagonal,seed,short,simple,size,slightly,soft,stem,stigma,straight,style,subequal,subtending,terminal,testal,thick,throughout,tinged,tip,trichome,unwinged,usually,wall,wet,white,whitish,wide,wing,x,yellow	1-10,1-3.2,1-5,1.6-6.5,2-4,3.5-5,4.5-7,5-8,5-merou,8,absent,acumen,acuminate,acute,adaxiall,ag,alyx,apart,apex,apiculate,articulated,attenuate,axe,blade,broadly,capitat,cordate,decumben,decurrent,digestion,dorsally,eaf,edge,eed,elliptic,elliptical,enzyme,exceeding,flat,folded,geminat,glabrou,hair,homostylous,honeycomb-shaped,interjected,lengthening,like,living,lobe,lower,middl,minutely,mottle,nearly,nflorescence,oblique,orbicular,ovate,petiolule,plurifoliate,pore,purple,regular,removed,ruit,sessile,seudostipule,slit,sometimes,spaced,specimen,stamen,ste,tall,tamen,tem,tri-,truncate,tube,typically,unit,vary,ympodial	arrangement,capitate,characteristic,colour,decumbent,form,growth,height,history,inflorescence,length,life,ovary,pseudostipule,shape,staman,surface,texture,type
320	wfo-0001029552	success	161	114	93	68	21	0.578	.5,0.5,0.6-1,1-1.3,1-1.5,1-2,1-3,1-5,1.5-6.5,12,2-9,5-10-flowered,abaxial,acute,along,anther,apex,area,bark,base,berry,branched,broadened,calyx,cm,corolla,dendritic,densely,dia,difoliate,elliptic,erect,exserted,flattened-reniform,flower,fruiting,glabrous,globose,green,incrassate,inflorescence,later,leaf,like,lobed,long,long-styled,main,margin,minor,minutely,mm,nearly,occasionally,older,onto,opposite,orbicular,ovary,pale,paler,pedicel,persistent,petiole,pitted,pubescent,rounded,shape,shaped,shining,short-styled,shrub,simple,size,small,sparsely,stem,stigma,strongly,style,surface,tan,tear-drop,tip,tree,tree-like,trichome,tube,unit,vein,white,x,young	.25,0.1-0.5,1.5-2,10-20,2-2.5,2.5-3,5.5-8,6-9,abaxially,abruptly,acuminate,adaxially,anthesi,broadly,clavate,closely,conical,contracted,decurrent,deflexed,deltate,denser,differing,drying,eaf,edicel,eed,filament,free,geminat,greyish-brow,heteromorphic,inflorescenc,lamina,lateral,lobe,lon,lower,major,middle,minute,nflorescence,overlappin,pair,papillo,planar,pore,poricidal,portion,present,reflexed,rest,ruit,scar,scattered,slender,slightly,somewhat,spaced,swollen,tall,tub,ud,wide,widest,woody,yellowish,ympodial	adaxial,arrangement,bud,characteristic,colour,diameter,exertion,form,fruit,geminate,greyish-brown,growth,hair,height,length,lobing,plant,seed,sympodial,texture,type
321	wfo-0001029584	success	180	118	93	87	25	0.517	0-30,1,1-2,1-6,1.5-6.5,16.2-33,2-3,3-10,3-7,4-14,4.5-11.5,6-7,6.1-9.4,7-14,8-15,9.7-23.4,9.8-17,anther,axillary,borne,brownish,bud,cell,clavate,cm,condition,coriaceous,corolla,covering,dark,densely,diameter,distal,drying,end,filament,flower,forked,fresh,fruit,generally,glabrescent,glabrous,green,green-white,greenish,hair,hair-like,half,herb,homostylous,interjected,lateral,leaf,leaflet,light,make,mm,mucilaginous,oblong-lanceolate,odd-pinnate,ovate,ovoid,pair,pedicel,peduncle,pentagonal,petiole,plant,pubescent,purple,seed,short,simple,singly,size,stigma,straight,style,substellate,subtending,terminal,testal,thick,throughout,tuber,typically,usually,wall,wet,white,whitish,x	1-3,2-4,2.4-6.3,3-5,4-15,4-5,5-merou,5.3-13.3,abaxially,acumen,acuminate,acute,adaxially,ag,alyx,apart,apex,apparently,articulated,asymmetric,attenuate,axe,base,basiscopic,blade,capitat,connivent,considerably,decreasing,dense,digestion,dorsally,eaf,edge,eed,elliptic,enzyme,erry,finer,flat,folded,geminat,hal,honeycomb-shaped,larger,lengthening,linear,living,lobe,long,lower,margin,middle,nflorescence,orbicular,orolla,perfect,petiolulate,plurifoliate,pore,poricidal,present,proximal,removed,second,semi-erec,sessile,seudostipule,side,slit,spaced,specimen,stolo,tall,tamen,tem,tip,tissue,toward,tri-,tube,unit,unknow,unwinged,vary,yellow,ympodial	5-merous,abaxial,adaxial,arrangement,berry,calyx,capitate,colour,form,growth,height,history,inflorescence,length,life,ovary,presence,pseudostipule,semi-erect,shape,stem,stolon,surface,texture,type
322	wfo-0001029593	success	181	128	110	71	18	0.608	-10,0.05,0.5-1,0.5-5,0.8-1,0.8-1.2,1,1-1.2,1-1.5,1-8,1.6-2.3,10-50,2,2-3,2-5,2.3,2.3-3.0,3-4,3.5-8,35-60,4-6,5-15,7-25,7.5-15,9-15,abaxially,abruptly,acuminate,acute,anther,apex,apically,arising,attenuate,axil,basal,base,basiscopically,berry,broadly,brown,calyx,capitate,cm,conical,decurrent,deltate,densely,diameter,drying,elliptic,enlarged,extremely,filament,filiform,fruit,fruiting,glabrous,globose,green,half,hollow,lateral,leaf,leaflet,lobe,long,lower,markedly,minutely,mm,narrowing,oblique,obovate,occasionally,onto,ovary,ovoid-reniform,pair,papillose,pedicel,per,petiole,petiolule,pinnate,plant,pointed,poricidal,pubescence,pubescent,rachi,seed,shape,shrub,slightly,smaller,smooth,somewhat,stigma,style,surface,terminal,tip,tube,usually,variable,white-lenticellate,winged,woody,x	1-2,100,2-14,5-10,adaxially,age,always,anthesi,anticlinal,axillary,bearing,cateniform,cell,clavat,colony,cone,dry,eaf,edicel,eed,entire,epidermal,exserted,flower,free,glabrescent,growing,included,irregular,lamina,large,much,nflorescence,noddin,often,once-branched,open,opposite,perfectly,place,portion,primary,projection,pubescen,purple,rarely,reflecting,rest,ruit,scar,short-styled,similar,simple,single-stemmed,sinuous,small,sparsely,tall,tem,thickening,trichome,tub,ud,unifoliat,uniseriate,unit,vein,white,wider,without,ympodial	arrangement,bud,clavate,colour,form,growth,height,history,inflorescence,length,life,nodding,number,perennial,size,stem,texture,type
323	wfo-0001029601	success	187	110	87	100	23	0.465	0-37,0.2-0.8,0.5-5.8,1-2,1-3,1-4,1.1-2.7,1.2-2.3,1.7-6.5,2-12,2-9,2.2-4.5,2.3-5.9,2.8-10.5,3-10,3-7,4-13.5,5-41,6-10,6.6-22,6.8-14.5,abaxially,adaxially,anther,berry,blade,brownish,cell,clavate,cm,condition,coriaceous,corolla,covering,dark,diameter,dot,drying,filament,flower,fresh,fruit,glabrous,globose,green,green-white,greenish,hair-like,herb,homostylous,interjected,lanceolate,lateral,leaf,leaflet,light,lobe,long,make,mm,mucilaginous,odd-pinnate,ovoid,pedicel,peduncle,pentagonal,petiole,plant,puberulent,ripe,rotate,seed,size,small,stigma,straight,style,terminal,testal,thick,throughout,tube,wall,wet,white,whitish,x	0.5-8,1-53,2,2-3,2-7,3-5,5-merou,abaxiall,acumen,acuminate,acute,ag,alyx,apart,apex,apparently,articulated,asymmetric,attenuate,axe,axillary,base,basiscopic,borne,bud,capitat,connivent,decreasing,digestion,distal,dorsally,eaf,edge,eed,elliptic,end,enzyme,erec,exceeding,flat,folded,forked,geminat,generally,glabrescent,glabrou,hair,half,honeycomb-shaped,larger,lengthening,linear,living,lower,middl,middle,narrow,nflorescence,orbicular,orolla,ovate,pair,perfect,petiolulate,plurifoliate,pore,poricidal,removed,rounded,ruit,sessile,seudostipule,short,side,singly,slightly,slit,spaced,specimen,stamen,stolo,subequal,subglabrou,subtending,tall,tamen,tem,tip,tissue,toward,tri-,tuber,typically,unit,unwinged,usually,vary,wing,yellow,ympodial	5-merous,abaxial,adaxial,arrangement,calyx,capitate,colour,form,glabrousnes,growth,height,history,inflorescence,length,life,ovary,pseudostipule,shape,stem,subglabrous,surface,texture,type
324	wfo-0001029621	success	165	116	88	77	28	0.533	0.5-0.75,0.5-1.2,0.7-1.1,0.8-1,0.8-4.5,1-1.5,1-2,1.5-2,1.5-5,2/3,6-20,6-8,7-9,acute,anther,apex,area,attenuate,bark,base,becoming,berry,branched,brown,calyx,cm,constricted,corolla,cup-shaped,dark,decurrent,dia,dry,ellipsoid,erect,filament,fruit,fruiting,glabrate,glabrous,globose,green,lanceolate,later,lateral,leaf,live,lobed,main,many,margin,material,merely,minutely,mm,oblanceolate,often,ovary,ovoid-reniform,pair,pale,pedicel,pitted,plant,puberulent,ripe,sessile,shaped,shrub,stem,stigma,style,surface,tan,tear-drop,terminal,thick,time,tip,tube,vein,way,white,whorl-like,widened,x,yellow,yellowish	.1,0.5-1,0.5-1.5,1.5-2.5,1/3,2.5-3,3-3.5,3.5-4.5,5-20-flowered,accrescent,along,anthesi,apar,appearing,appressed,beneath,borne,caudate,cluster,completely,course,deltoid,densely,distal,eaf,edicel,eed,elongate,enclosed,exsertio,fleshy,free,geminate,irregularly,late,like,lobe,lon,long,lower,middle,nflorescence,occasionally,older,onto,papillate,papillo,papillose,planar,plurifoliat,pore,poricidal,portion,prominent,quite,rarely,reddish,reddish-gre,river,ruit,scar,shiny,small,somewhat,spaced,ste,straight,tall,tapering,trichome,ud,uniseriate,unit,widest,woody,ympodial,young	arrangement,branch,bud,characteristic,colour,diameter,drying,exertion,exsertion,form,glabrousnes,growth,height,history,inflorescence,length,life,lobing,new,peduncle,perennial,primary,reddish-grey,seed,shape,size,texture,type
325	wfo-0001029622	success	182	109	83	99	26	0.456	.1,.5,0.5-0.7,0.5-1,0.8-1,1-1.2,1-4,1.5,2-11,2.5-3,3-4,3-5,30-35,4-6.5,45-50,acute,anther,apex,apparently,attenuate,bark,base,brown,bud,calyx,cm,consisting,corolla,deflexed,diameter,elliptic,entire,filament,flower,fruit,glabrous,globose,green,inflorescence,leaf,lobe,lobed,long-acuminate,long-triangular,major,margin,minor,mm,narrowly,obconic,oblong,occasionally,older,onto,ovate,pedicel,peduncle,petiole,present,reddish,rounded,sagittate,scar,second,shiny,shrub,simple,single,size,slightly,somewhat,stellate,stem,stigma,style,tapering,tip,trichome,tube,uniseriate,white,x,young	.2,/3,0.3,0.5,0.6-0.9,1-1.5,1-2.7,2-4,2-5,40,5-6,7-11,abaxially,absent,accrescent,adaxially,ag,alyx,anthesi,appearing,arising,axe,axil,beneath,blade,capitat,chartaceous,connivent,cylindrical,deciduous,differing,difoliate,dimorphic,eaf,eed,elongate,except,free,fruiting,geminate,glabrou,ilament,immature,included,interlaced,internodal,jointed,known,lamina,lateral,less,long,longitudinal,m.,main,mature,measured,midrib,minute,minutely,nflorescence,often,one,opening,opposite,orolla,oung,ovate-lanceolate,pair,papillose,pendent,pore,portion,probably,rachi,raised,reflexed,remaining,ruit,shaped,slende,slender,slit,straight,tal,tear-drop,thin,thus,tuft,ud,unarme,unifoliat,unit,vary,vein,way,within,yellow,ympodial	abaxial,adaxial,arrangement,berry,capitate,characteristic,colour,form,growth,hair,height,history,length,life,na,number,ovary,per,plant,seed,shape,surface,texture,true,type,unarmed
326	wfo-0001029625	invalid_json	168	161	134	34	27	0.798	-15,..,.1-0.2,.5,0.5-1,0.5-1.3,0.5-2,0.5-2mm,0.8-1.4,0.8-1.8,1-1.5,1-2,1-3,1.2-1.6,2,2.5-.,3,3-,3-3,3-3.5,4-10,4-4,4-5-celled,4-7-celled,4-9,5,5-10,5-6,5-8,6-9,9-25,abaxial,along,anther,anthesi,bark,base,beneath,branch,branched,calyx,cell,cm,conical,corolla,cucullate,darker,deflexed,deltate,densely,denser,diameter,elliptic,erect,filament,flattened,four,fruit,fruiting,glabrescent,glabrous,gland,gland-tipped,globose,green,greenish,growth,herb,hyaline,inflorescence,lamina,later,lighter,like,lobe,lobed,long,margin,markedly,middle,midline,mixed,mm,narrowly,nearly,occasionally,outer,outline,ovary,ovate-reniform,pair,pale,papillate,pedicel,peduncle,per,planar,point,pointed,pubescent,purplish,rarely,reddish,regularly,scattered,shrub,single,sinuate,slightly,small,smooth,sparsely,stem,stigma,striate,stripe,strongly,style,surface,tan,testa,time,tinged,tip,triangular,trichome,tube,uniseriate,vein,wall,weight,white,x,young	100,8-13,apical,branc,brittle,brow,capitat,cel,deflexe,distinct,dry,eaf,edicel,eed,flower,frui,glandular,lower,minute,new,nflorescence,open,pericarp,plurifoliat,primary,ruit,scar,single-stemmed,thin,tuft,ud,unit,without,ympodial	'',[,``,adaxial,arrangement,brown,bud,capitate,characteristic,colour,form,hair,height,history,leaf,length,life,plant,plurifoliate,seed,shape,size,texture,type,value,{,}
327	wfo-0001029645	success	160	128	102	58	26	0.637	.5-1,0.2-0.5,0.5-7,1,1-2,1-4,1.3-7,1.5,1.5-2,2-4,2.5-17,3-10,3-15,3-7,3.5-4,337,5,5-8,6-12,7-12,750,?,abaxially,acuminate,acute,adaxially,anther,apart,apex,articulated,base,blue,brown,calyx,chartaceous,cm,corolla,cuneate,cylindrical,deltate,diameter,distally,entire,et,except,extra-axillary,fide,filament,finger,flattened,flower,fruit,glabrous,gland-tipped,globose,green,greenish,hair,herb,immature,kayap,line,lobe,margin,membranaceous,minutely,mm,moderately,nearly,obtuse,ovate,ovate-elliptic,pedicel,peduncle,petiole,puberulent,purple,rachi,radiu,rarely,red,rotate-stellate,rugose-verrucate,sagittate,short,short-tomentose,simple,smith,sparsely,stigma,strongly,style,subcordate,tapered,triangular,truncate,tube,unbranched,white,x,yellow,Â±	-1,0.3-0.5,0.5-2.5,1-1.5,2-3-foliat,2.5-4,4-5,4-8,abundantly,aggregate,along,around,axe,ba,blade,cell,connivent,decurrent,directed,distall,eaf,eed,free,glabrou,inserted,knapp,long,lower,major,mesocarp,nflorescence,orolla,part,perfect,pore,puberulen,ruit,sand-punctate,shorter,shru,side,small,spaced,stone,tal,tamen,tem,thecae,tightly,time,tomento,truncat,unit,vary,vein,veiny,wide,ympodial	0.5-1,abaxial,adaxial,arrangement,articulation,characteristic,colour,form,growth,height,history,inflorescence,leaf,length,life,ovary,plant,seed,shape,shrub,size,spacing,stem,surface,texture,type
328	wfo-0001029646	success	141	120	69	72	51	0.489	0.1-0.6,0.5-0.8,0.7-2.2,1-4,1.5-2,1.5-4.9,10-15,3-14,4-5.5,5-15,6-8,acuminate,acute,apex,apical,apically,articulate,attenuate,base,branched,calyx,cm,corolla,cyme,dehiscent,diameter,dichasial,dichasially,distal,ebracteate,elliptic,epiphytic,filament,finely,globose,green,green-white,herbaceous,introrse,lateral,leaf,lobe,long,maturing,mm,monochasial,mucilaginous,narrowly,often,ovate,ovoid,pedicel,peduncle,perennial,petiole,plant,poricidally,pubescent,seed,short,simple,slit,stigma,style,throughout,tone,white,wide,yellow-green	0.5,2-3,3-6-foliat,7-15,abaxially,acumen,adaxially,cell,commonly,covering,digestion,dorsally,eaf,edge,eed,emoval,enzyme,equaling,flat,flower,folded,forked,free,generally,globo,ground,growing,hair-like,half,honeycomb,linear,living,lon,lower,make,mos,mould,mucronate,nflorescence,nther,oak,orolla,ovat,pattern,perfect,pine,plan,proximal,rarely,reveal,ruit,seudostipule,specimen,stamen,stellate,straight,tall,tem,testal,thick,throughou,tree,tuber-bearing,typically,unit,vary,viole,wall,without,yellow,ympodial,Â¼	anther,appearance,arrangement,bark,border,branch,bud,characteristic,colour,corrugation,drying,exertion,form,fruit,fruiting,giving,glabrousnes,growth,height,history,inflorescence,interjected,leaflet,length,life,lobing,margin,midpoint,na,new,number,ovary,per,prickle,primary,pseudostipule,ray,shape,size,stem,surface,terminal,texture,thicknes,tube,type,variation,vein,violet,wet,width
329	wfo-0001029652	success	160	107	83	77	24	0.519	.5,0.5-4,0.8-1,1-3,1.5-2,2-2.5,2-4,3/4,4-4.5,6-15,7-9,abaxially,adaxially,along,anther,apex,attenuate,bark,base,berry,calyx,cm,conical,corolla,curling,deflexed,drying,elliptic-ovate,exserted,filament,filiform,fruiting,glabrous,globose,golden,golden-red,green,greenish-white,hispid,lateral,leaf,long,long-acuminate,long-styled,main,margin,minute,minutely,mm,narrowly,near,occasionally,ovary,ovoid-reniform,pair,pale,papillose,pedicel,petiole,pitted,pubescent,reddish-brown,shaped,short-styled,shrub,simple,size,slender,stem,stigma,style,surface,tan,tear-drop,tip,trichome,tube,undulate,uniseriate,vein,way,white,x	.25,.3,0.5-1,0.75-1,1,1-2,2,2.5-3,25,3.5-4,anthesi,apar,ape,apical,arch,arching,ba,bearing,broadly,cone,deciduous,deltate,denser,dia,differing,difoliate,eaf,edicel,eed,evenly,flower,free,geminat,hard,heteromorphic,included,joining,lamina,like,lobe,lobed,lon,lower,major,maturity,middle,midrib,minor,nflorescence,older,opposite,papillo,pericarp,pore,poricidal,portion,projection,reflexed,ruit,scar,series,slende,slightly,soon,spaced,sparsely,swollen,tall,thickened,time,tub,ud,unit,widest,within,ympodial,young	alternate,arrangement,bud,characteristic,colour,diameter,exertion,form,fruit,growth,height,history,inflorescence,length,life,lobing,na,peduncle,plant,primary,seed,shape,texture,type
330	wfo-0001029673	success	159	101	81	78	20	0.509	.5,0.5-1,0.7-1.1,0.8-1,1-10,1-2,1-5,1.2-3.5,1.5-1.8,1.5-2,4-6,5.5-15,absent,acuminate,acute,age,anther,anthesi,apex,appearing,base,becoming,berry,black,branch,calyx,clavate,cm,corolla,deep,dendritic,densely,diameter,elliptic,exserted,filament,fork,fruit,fruiting,glabrous,globose,greyish,greyish-yellow,growth,later,lateral,leaf,length,lenticular,minutely,mm,narrowly,occasionally,ovary,overtopping,pedicel,petiole,pitted,planar,pore,poricidal,pubescent,purple,reddish-brown,reflexed,shoot,shrub,slightly,slit-like,sparsely,stem,stigma,strongly,style,surface,terminal,tip,trichome,tube,violet,x	0.75-1,10-20,2-2.5,2-3,2-4,2.5,3-5,3/4,5-25,abaxial,abaxially,accrescent,adaxial,adaxially,along,apical,bark,basal,blade,branching,broadly,conical,decurrent,deflexed,deltoid,denser,dichasia,eaf,edicel,eed,ew,flower,free,greyish-yello,individual,inserted,lamina,like,lobe,lon,long,longer,lower,m.,monochasial,nflorescence,nodding,older,pair,papillo,pericarp,petal,plurifoliate,portion,prominent,pyramidal,ruit,scar,secondary,sleeve,small,somewhat,stamen,tall,tapering,thin,time,tree,triangular,tub,ud,unit,vein,wide,winged,woody,ympodial,young	bud,characteristic,colour,exertion,form,glabrousnes,height,history,inflorescence,life,lobing,new,peduncle,perennial,plant,seed,shape,size,texture,type
331	wfo-0001029680	success	212	110	93	119	17	0.439	0.1,1.0â1.1,1.1â1.2,1.4â7.5,1.7â7,11â16,11â25,12,1â2,3â6,4.0â16,4.0â6.5,4.5â20,4.5â7.0,5,50,5â11,8â32,acute,annual,anther,anthesi,apex,axillary,base,becoming,bipinnate,blue,borne,branched,brown,calyx,clavate,cm,connivent,decurrent,diameter,divided,flattened,fleshy,flower,fruit,glabrous,globose,green,herb,indistinct,leaf,length,light,long,margin,mm,oblong,obovate,obtuse,ovate,pair,pale,pedicel,peduncle,petiole,pinnae,pinnate,poricidal,primary,pubescent,purple,rarely,red,ripe,shoot,size,sometimes,sparsely,stem,stigma,style,terminal,time,tip,tripinnate,turning,violet,white,winged,woody,x,yellow,â10,â12.5,â19,â3	.0,0.4,0.5â1.5,0.6,0.6â1.2,0.6â2.0,0.9â1.0,1,1.0,1.0â1.5,1.0â1.8,1.4â2.5,1.5,1.6â2.7,1.8â3.8,10,1â3,1â6,1â8,2.2â4.2,2â20,3.0â4.2,3.3â5.5,3â22,4â10,4â30,5.5â8.5,7â10,abaxially,absen,adaxiall,adaxially,ag,along,apart,appressed,arequipa,arranged,articulated,asymmetrically,axe,ba,beyond,blade,cell,cylindrical,decreasing,densely,difoliate,eaf,eed,entire,equal,erect,extending,filament,flange,forming,geminat,hair,irregularly,lobe,lon,longitudinal,lower,m.,midrib,moderately,multicellular,narrow,nflorescence,node,occasionally,often,opening,orolla,parallel,pendant,pentagonal,perfect,pitted,plurifoliate,pore,prostrate,rapidly,rotate,ruit,running,secondary,shallowly,shaped,side,simple,spaced,specimen,split,stone,straight,subglabrous,surface,tacna,tal,tamen,tear-drop,tem,tertiary,tube,unicellular,uniseriate,unit,usually,vary,wide,wing,winge,ympodial,â3.2,â46,â48	arrangement,characteristic,colour,corolla,form,growth,height,history,inflorescence,life,number,ovary,plant,seed,shape,staman,type
332	wfo-0001029704	success	146	114	91	55	23	0.623	-17,-3,0-1.5,1-4,1.5-2.5,1.5-3,10-14,1000-1200,140-185,15-25,2-2.5,2-3,2-5,3-4-celled,3-5,4,5,7-,7-10,9-20,acuminate,acute,along,anther,apex,base,berry,blue,branch,broadly,brown,cell,cm,composed,conical,corolla,cuneate,dark,deeply,dia,ellipsoid,extra-axillary,few-flowered,filament,flower,fork,fruiting,glabrous,globose,green,halfway,lanceolate,leaf,less,lobed,minute,minutely,mm,mottled,obovate,obovoid,occasionally,one,ovary,pedicel,peduncle,petiole,pinnatisect,poricidal,pubescent,purple,record,reddish,reticulate,shrub,simple,single,stellate,stigma,stone,stout,striped,style,subdiscoidal,surface,tip,trichome,variously,vein,white,x	.5,0.5,1,1-2,1.5,4-7,acuman,also,anthesi,apparently,aspect,axi,c.,calyx,cunate,cut,deflexed,diam,eaf,eed,enlarged,erect,especially,exerted,flowering,gradually,lengthening,lobe,long,lower,midrib,moderately,nflorescence,plurifoliat,pore,rounded,ruit,shoot,short,sinus,slit,sombre,sprawling,straight,subglobo,swollen,tub,tube,twig,ud,unit,variable,within,ympodial,young	arrangement,bud,characteristic,colour,diameter,form,fruit,growth,height,inflorescence,length,lobing,number,per,plant,plurifoliate,seed,shape,size,stem,subglobose,texture,type
333	wfo-0001029727	success	260	114	91	169	23	0.35	-10,-3,/3,0-30,0-4,0.4-1,0.7-0.9,1-1.2,1-4,1.5-5.5,1.6-3,1/3-1/2,2.5-3.2,2.8-4,3-11,3-6,acuminate,acute,anther,anthesi,apex,apparently,articulated,bark,base,berry,brown,calyx,chartaceous,clavate,cm,colourles,cordate,corolla,cupular,densely,diameter,drying,erect,filament,finely,flattened-reniform,glabrous,lateral,leaf,length,lobed,long,margin,mauve,mm,obconical,oblong,occasional,orange-brown,ovate,pair,papillose,pedicel,peduncle,per,petiole,pitted,poricidal,prickly,primary,red-brown,reddish,rounded,seed,shallowly,shape,shrub,simple,size,smooth,stellate,stellate-pubescent,stem,stigma,style,subentire,surface,tapering,terminal,tip,trichome,tube,vein,wide,yellowish	-1/3,.5,0-15,0-2,0-20,0-40,0-5,0-8,0.1-5,0.15-0.2,0.15-0.3,0.2,0.2-0.5,0.2-2.5,0.3,0.4,0.5,0.5-1.2,0.5-3,0.7-1,1,1-,1-2,1.2-2,1.5-2.3,1.5-2.5,1.5-3,1/2-2/3,1/4,1/8-1/5,2-5,2.5,2.5-5.5,3-7,3/,4-7,4-merou,4-merous,4.5,4.5-,5-12,5-8,5-9,5.5-7,6-11,7-10,abaxial,abaxially,acicular,adaxial,age,almost,along,alternate,alyx,ame,apar,apart,apically,blade,branched,bristle,c.,climber,connivent,covered,curved,darker,deltate,deltoid,developing,different,dimorphic,discolorous,divided,eaf,edge,eed,elongating,equal,except,extending,ferrugineous,filiform,filiform-acuminat,fissure,flower,free,geminate,increasing,inside,lengthening,less,like,lobe,lon,longer,lower,m.,mature,middle,midpoint,midvein,minor,minutely,mixture,moderately,narrow-deltate,nflorescence,nther,older,one,open,orolla,oung,outside,papillo,perfec,perfect,pit,plurifoliat,pore,porrect,portion,prickl,prickle,protruding,pubescent,raised,rarely,ray,red-brow,reduced,regular,scandent,scar,series,sessile,short,sinus,sometimes,spaced,spreading,stalk,stalked,straight,strongly,tamen,tearing,terete,tertiary,time,toward,translucent,transverse,unarmed,uneven,unit,upper,variable,variously,vary,venation,violet,visible,way,x,ympodial,young	arrangement,branch,characteristic,colour,exertion,form,fruit,fruiting,glabrousnes,growth,height,history,inflorescence,life,lobing,na,new,number,ovary,perennial,plant,texture,type
334	wfo-0001029731	success	246	141	115	131	26	0.467	.5,.6,1-2,1-2.5,1.5,1.5-2.5,10-20,2-3,2.5,2.5-4.5,3-4,31,4,4-9,6,6-7,7-11,8-9,abaxially,acuminate,acute,adaxially,almost,along,anther,apex,apically,bark,basally,base,beak,berry,black,branch,branched,branching,brown,calyx,clavate,cm,concolorous,conical,coriaceous,corolla,cuneate,diameter,dilated,distributed,drying,dull,elliptic,entire,epiphyte,erect,evenly,exserted,filament,flaring,fruit,fruiting,glabrous,ground,lateral,leaf,liana,like,linear,lobed,long,long-ellipsoid,longitudinal,margin,maturity,mauve,midvein,mm,obconical,oblong,obovate,orange-brown,pedicel,peduncle,pendulous,petiole,primary,pyriform,raised,revolute,ribbed,ridge,ridged,rounded,several,slender,sometimes,sparsely,stem,stigma,stretched,style,succulent,sunk,surface,terminal,thick,toward,tube,vein,white,wide,widely,winged,x,yellow,yellow-green	0.05,0.1-0.8,0.25-0.3,1,1-1.5,1.5-3,1/3,1994,2,2-6,3,3-10,4-5,accrescent,acquiring,age,alyx,anthesi,apar,apparently,arcy,articulated,basal,becoming,boundary,broadly,bumpy,clearly,connate,crinkled,darker,delimited,delineated,deltoid,dense,development,different,domatia,dorsal,dorsifixed,dry,eaf,early,elongating,enlarge,equal,even,faint,filiform,fine,finely,flattened,fleshy,flower,free,hair,iscoid,lamina,large,later,lengthening,less,lobe,lon,longitudinally,lower,main,mature,much,narrowly,nflorescence,nther,obtuse,occasionally,often,orolla,pair,papillae,papillose,part,perfec,pericarp,persisting,plurifoliat,pore,poricidal,portion,prominent,protruding,rachi,rakotozafy,rarely,reflexed,reported,ruit,scar,see,shallowly,shorter,simple,sinus,slightly,small,smaller,smoot,straight,stump,tearing,thickened,thinner,though,time,tip,trichome,tub,tuft,ud,unit,usually,vary,venation,ventral,visibl,visible,well-developed,wing,woody,wrinkling,ympodial,young,â	arrangement,bud,characteristic,colour,exertion,form,glabrousnes,growth,height,history,inflorescence,length,life,lobing,na,new,number,ovary,per,plant,seed,shape,size,smooth,texture,type
335	wfo-0001029741	success	137	107	79	58	28	0.577	.4,.5,0.9-1.2,1-3.5,1.1-1.3,1.5-4,1.5-6,10-50-flowered,2-2.5,2.5-7.8,9.5-22.5,?,acute,age,anther,apex,attenuate,base,becoming,berry,black,calyx,capitate,cm,completely,corolla,dark,dia,difoliate,drying,early,elliptic,exserted,filament,fruit,fruiting,furcate,glabrous,globose,green,growth,inflorescence,leaf,lenticellate,lighter,lobed,long,minutely,mm,nearly,new,opposite,ovary,ovate,papillose,pedicel,petiole,pore,poricidal,reddish-brown,shaped,shrub,size,slender,stem,stigma,straight,style,tapering,tear-drop,tip,tree,tube,unit,usually,vein,weak,white,x	0.5-1.5,0.8-3.5,1-1.5,1.5,2.2-9,3,accrescent,anthesi,apiculate,branched,ca,caly,closely,deflexed,deltoid,differing,divisio,dry,eaf,edicel,eed,erect,flower,free,geminat,glabrou,immature,known,lateral,lobe,lon,lower,main,major,middle,minor,nflorescence,overlapping,pair,papillo,planar,portion,produced,prominent,proximal,quite,raised,ruit,scar,slightly,spaced,tall,ud,variable,widest,wood,woody,ympodial	arrangement,bud,characteristic,colour,corrugation,diameter,exertion,form,geminate,glabrousnes,height,history,length,life,lobing,margin,na,number,peduncle,per,plant,primary,seed,shape,surface,sympodial,texture,type
336	wfo-0001029744	success	113	85	65	48	20	0.575	0.3-0.6,1.5,2,5-8,50,8-10-flowered,acute,apex,bark,base,blunt,calyx,cm,deltate,dendritic,densely,difoliate,elliptic,entire,extreme,flattened,flexuous,form,fruit,geminate,glabrescent,glabrous,golden,incrassate,lanceolate,leaf,lobe,long-acuminate,margin,minutely,mm,narrowly,oblanceolate,oblique,occasionally,older,ovoid-reniform,pale,pedicel,petiole,pitted,pubescent,revolute,shape,shrub,simple,slightly,small,sometimes,somewhat,stem,surface,thin,tip,trichome,unicellular,unifoliate,uniseriate,x,young	0.5-1,1,1.5-3.2,2-4,7-15,8-11,abaxially,adaxially,along,apart,beginning,branch,brow,denser,distinct,eaf,eed,examined,fide,inflorescenc,lamina,leave,looping,lower,major,marginal,mature,minor,nflorescence,node,non-reproductive,opposite,pair,primary,pubescence,scar,see,similar,single-celled,smaller,smith,spaced,thee,ud,unit,vein,white,ympodial	abaxial,adaxial,arrangement,brown,characteristic,colour,growth,hair,height,history,inflorescence,length,life,plant,seed,seen,size,texture,type,unicellularity
337	wfo-0001029746	success	179	108	90	89	18	0.503	0.7-1,1,1-1.3,1-1.5,1.2-1.5,1.5,2-2.5,2-7,2-8,3,3-4,4-9,8-11,acuminate,acute,anther,apex,base,berry,broadly,brown,calyx,capitate,centre,cm,conical,cordate,corolla,crenate,cup-shaped,curved,dark,darker,densely,diameter,ellipsoid,entire,erect,filament,flattened,fleshy,fruit,fruiting,glandular,globose,greenish,herb,heteromorphic,hollow,inflorescence,internodal,irregularly,leaf,less,margin,minutely,mm,nodding,orange,ovary,ovate,ovoid,pale,papillose,pedicel,petiole,pitted,principal,pubescent,purple,red,reddish,reflexed,shallowly,simple,slender,slightly,somewhat,stem,stigma,strongly,style,subshrub,surface,triangular,tube,upward,vein,x,â3	.5,0.3-2,0.5-1,2,2-4,3-4-pluri-foliate,3-4.5,3-6,6,6-7,8-10,abaxially,adaxially,age,anthesi,apart,bearing,becoming,blackish,c.,cell,ciliate,color,crowded,eaf,edicel,eed,elliptic,enlarged,exerted,flower,flush,free,glabrous,gland-tipped,growing,horn,lamina,lengthening,lobe,lon,long,longer,longest,lower,markedly,mature,maturit,mid-length,mixed,narrowly,near,nflorescence,occasionally,pair,papillo,peduncle,pericarp,plan,pore,poricidal,portion,primary,pubescen,rachi,ruit,scar,shortest,single,slit,spaced,sparse,sparsely,spreading,straight,testal,thin,third,tip,trichome,ud,uniseriate,unit,upper,wall,widely,widest,woody,ympodial	appearance,arrangement,bud,characteristic,colour,form,giving,growth,height,history,length,life,plant,seed,shape,size,texture,type
338	wfo-0001029769	success	142	108	86	56	22	0.606	.25,.5,1-1.2,1-3,1.5-2,30-60-flowered,4,5-8,6-17,7-8,abaxially,acuminate,acute,adaxially,along,anther,anthesi,apex,bark,base,bearing,berry,branch,brown,calyx,capitate,cm,conical,corolla,curl-tipped,cyathiform,dark,densely,dia,elliptic,filiform,flower,fresh,fruiting,glabrous,globose,golden,hen,horizontally,leaf,less,lobe,lobed,long,main,midrib,minutely,mm,nearly,onto,ovary,ovoid-reniform,pedicel,petiole,pitted,puberulent,pubescent,reflexed,ried,scattered,shaped,shrub,simple,smooth,somewhat,sparsely,stem,stigma,style,surface,swollen,tear-drop,three,time,tip,trichome,two,uniseriate,vein,white,winged	0.5-1.5,1.5-2.5,2.5-3,2.5-8,3.5-4,4-5,8-9,8.5-17,apar,ape,archin,ba,brochidodromu,cerro,deflexed,deltoid,eaf,edicel,eed,exserted,filament,free,green,inglÃ©,internodal,lateral,like,lon,lower,margin,nflorescence,older,opposite,pair,papillo,papillose,pore,poricidal,portion,ruit,scar,spaced,straight,tall,tub,tube,ud,unevenly,unifoliat,unit,wide,widely,woody,x,ympodial,young	arching,arrangement,characteristic,colour,diameter,form,fruit,growth,height,history,inflorescence,length,life,lobing,perennial,plant,seed,shape,size,texture,type,unifoliate
339	wfo-0001029780	success	204	94	77	127	17	0.377	1-1.2,1-2,1.4-1.9,11-24,15-22,15-45,2-2.5,2-2.8,2-3.5,2-5.5,2.4-4.2,3,3-6,3.5-7.3,4-6,4.5-6,5.5-13,8-12,abaxially,absent,adaxially,anther,berry,blade,brownish,chartaceous,cm,condition,corolla,densely,diameter,drying,filament,fresh,fruit,glabrous,globose,green,greenish,herb,interjected,invested,lateral,leaflet,length,membranous,minute,minutely,mm,non-glandular,odd-pinnate,ovoid,pale,pedicel,peduncle,petiole,pinkish,plant,puberulent,pubescent,rarely,rotate,seed,short,size,stem,stigma,streak,style,terminal,trichome,typically,unwinged,white,whitish,x,yellow	1-10,1.5-2,120-210,2-12,20-60,5-7,5-merou,5.5,50-70,600-950,?,acumen,acute,ag,along,alyx,apart,apex,apparently,articulated,attenuate,axe,axillary,base,borne,bud,capitat,cell,ciliate,connivent,cordate,covering,cuneate,dark,decumbent,digestion,distal,dorsally,eaf,edge,eed,end,enzyme,erec,especially,exceeding,except,flat,flower,folded,forked,geminat,generally,glabrou,gland,glandular,greatly,green-white,hair,hair-like,hal,half,head,high,homostylous,honeycomb-shaped,lanceolate,lengthening,like,living,lobe,long,longer,lower,make,margin,midrib,mucilaginous,nflorescence,obtuse,often,orbicular,orolla,ovate,pair,perfect,petiolulate,petiolule,plurifoliate,pore,poricidal,proximal,reduced,removed,ripe,ruit,sessile,seudostipule,singly,slit,spaced,specimen,stamen,ste,stolo,straight,stripe,subequal,subtending,tall,tamen,tem,testal,tetralobulate,thick,throughout,tip,tri-,truncate,tube,tuber,unit,usually,vary,wall,wet,ympodial	arrangement,calyx,capitate,colour,form,growth,height,history,inflorescence,leaf,life,ovary,pseudostipule,pubescence,shape,texture,type
340	wfo-0001029784	success	237	123	105	132	18	0.443	-5,.5,0.2-,0.2-0.3,0.25-0.3,0.3-0.5,0.3-1,0.4-,0.4-0.45,0.4-0.6,0.5-,0.5-1.5,0.6-1,0.7-1.2,0.9-1.2,1-1.1,1-1.2,1-1.5,1-2,1-4,1.0-1.3,1.2-2.5,1.5-,1.7-2.6,2,2-,2-2.5,3-,3-5,5-14,5-8,abaxial,acute,anther,articulated,base,berry,broadly,brown,calyx,capitate,cm,column,conical,corolla,crenate-serrate,dark,densely,developed,diameter,distal,elliptic,filament,fruit,fruiting,glabrous,globose,golden,green,hair-like,half,herb,imparipinnate,inflorescence,interjected,interrupted,lateral,leaflet,lobe,long,long-acuminate,margin,mm,narrowly,node,obovate,orbicular,outgrowth,ovary,pale,pedicel,peduncle,pentagonal,perennial,petiole,plant,present,primary,pseudostipule,pubescent,simple,soft,sparsely,staminal,stem,stigma,stripe,style,surface,terminal,thick,truncate,velvety,wide,yellow	-12,.1,.2,0-4,0.1-,0.1-0.15,0.1-0.5,0.2,0.2-0.5,0.3-0.35,0.3-0.4,0.4-0.5,0.5,1,1-,1-2-celled,1/3,2-3-celled,2-4,2-4.5,2-foliate,2-locular,2.5-3.5,2/3,5-10,abaxially,absent,abundant,acuminate,adaxially,adpressed,along,angled,anthesi,apex,apical,appearance,appendage,arising,articulation,axi,basal,basicopically,beneath,bract,cell,crenation,decurrent,deeper,distributed,due,eaf,edicel,eed,eglandular,enclosing,entire,evenly,exserted,flower,giving,glabrescent,glandular,gree,hal,halfway,head,included,internode,interspersed,irregularly,lamina,lanceolate,larger,like,live,lon,loosely,lower,markedly,maturing,mostly,multicellular,nflorescence,northern,occasionally,often,pair,paler,patent,petiolule,population,proximal,pubescence,rarely,reflexed,ripe,robust,ruit,scattered,secondary,sessile,silky,smaller,sometimes,somewhat,sparse,spreadin,sterile,stout,straight,strongly,tem,tertiary,testa,trailing,trichome,tube,ud,undulate,unicellular,uniseriate,unit,unseriate,usually,vein,wall,white,winged,woody,x,ympodial	adaxial,arrangement,bud,colour,form,growth,height,history,leaf,length,life,presence,seed,shape,size,texture,type,width
341	wfo-0001029785	success	223	139	118	105	21	0.529	0-2,0.1-0.5,0.3-2.2,0.4-4.9,0.8-1,1-1.2,1-2,1-5,1.2-3.2,1.5-3.6,1.8-3.5,1.8-7,10-26,2-4,3-6,3-8,3.5-5,3.8-7.2,4-10.5,5-16,5-9,6,8-11,abaxially,absent,adaxially,along,anther,axillary,blade,borne,brownish,bud,chartaceous,clavate,cm,commonly,condition,connivent,corolla,dark,darker,decumbent,denser,diameter,distal,drying,end,especially,filament,flower,forked,fresh,fruit,generally,glabrous,globose,green,greenish,hair,half,herb,interjected,invested,lanceolate,lateral,leaf,leaflet,like,lobe,long,margin,membranous,midrib,minute,minutely,mm,mottled,multiple-celled,non-glandular,odd-pinnate,outer,ovoid,pedicel,peduncle,petiole,plant,puberulent,pubescent,purple,purple-tinged,ripe,scale-like,seed,short,singly,size,slightly,sparsely,stem,stigma,straight,style,subglabrous,subtending,terminal,tube,tuber,typically,unbranched,unwinged,usually,vein,violet,whitish,wide,x,yellow	0-3,1-10,3-4,5-merou,acumen,acute,ag,alyx,apart,apex,apparently,articulation,attenuate,axe,base,berry,broadly,capitat,cell,cordate,covering,cuneate,decreasing,digestion,dorsally,eaf,edge,eed,elliptic,enzyme,erec,exceeding,flat,folded,geminat,glabrou,greatly,green-white,hair-like,homostylous,honeycomb-shaped,larger,lengthening,living,lower,make,markedly,medium,middle,much,mucilaginous,nflorescence,oblique,obovate,obtuse,one-quarte,orbicular,orolla,ovate,pair,pale,pentagonal,perfect,petiolulate,petiolule,plurifoliate,point,pore,poricidal,present,quite,rarely,removed,rotate,rounded,ruit,sessile,seudostipule,shallowly,slit,sometimes,spaced,specimen,stamen,ste,stolo,stripe,tall,tamen,tem,testal,thick,throughout,tip,toward,tri-,truncate,unequal,unit,variable,vary,wall,wet,white,ympodial	abaxial,adaxial,arrangement,calyx,capitate,colour,erect,form,growth,height,history,inflorescence,length,life,number,ovary,presence,pseudostipule,shape,stolon,texture
342	wfo-0001029789	success	167	79	59	108	20	0.353	0-2,0.2-0.5,0.5-2.8,0.8-3.5,1-2,1-3,1.5-2,1.7-8.5,1.8-6.5,12,2-6,2-6.5,2.7-4.7,3-8.5,4-13,5-7,7-21,8-9,acumen,anther,blue,broadly,chartaceous,clavate,cm,corolla,diameter,glabrous,herb,interjected,lanceolate,leaf,leaflet,lilac,lunate,membranous,minute,mm,narrowly,odd-pinnate,ovary,ovate,pedicel,peduncle,pentagonal,petiole,plant,pubescent,rachi,rotate,size,sparsely,stigma,style,subglabrous,terminal,tube,white,x	1-10,2-25,2-3,3-5,4-10,5-merou,6,6-7,7-16.6,abaxially,acuminate,acute,adaxiall,adaxially,ag,alyx,apart,apex,apparently,articulated,attenuate,axe,axillary,base,basiscopic,blade,bud,capitat,connivent,dark,decreasing,decurrent,distal,dorsally,eaf,edge,eed,erec,exceeding,filament,flat,flower,folded,forked,formed,fruit,geminat,generally,greatly,green,hair,hal,half,homostylous,lant,lateral,lengthening,light,like,linear,lobe,long,long-attenuate,lower,maturing,minutely,mottled,never,nflorescence,orbicular,orolla,pair,perfect,petiolulate,plurifoliate,pore,poricidal,pubescen,purpl,rarely,sessile,seudostipule,short,side,simple,slightly,slit,spaced,stamen,star,ste,sterile,straight,subequal,subtending,tall,tamen,tem,tinged,tip,toward,tri-,typically,unit,usually,vary,yellow,ympodial	abaxial,adaxial,arrangement,capitate,characteristic,colour,form,glabrousnes,growth,height,history,inflorescence,length,life,new,pseudostipule,shape,stem,surface,texture
343	wfo-0001029810	success	149	109	88	61	21	0.591	.5,0.5-3,1-1.3,1-10,1-2,1-3,1.1-2.3,1.5-3,2-3,3-6,5-15-flowered,5-16,5-6,acuminate,acute,adaxially,along,anther,apex,apically,arachnoid,attenuate,base,berry,calyx,capitate,cm,compact,compressed,congested,corolla,dark,dendritic,densely,dia,ellipsoid,elliptic,exserted,fruiting,glabrous,globose,green,inflorescence,internodal,later,leaf,like,lobed,long,minutely,mm,narrowly,nearly,occasionally,opposite,ovary,ovoid-reniform,pale,papillose,pedicel,petiole,pitted,pointed,pubescent,reddish-brown,rest,shaped,shining,shrub,simple,size,slender,small,sparsely,stem,stigma,style,surface,tan,tapering,tear-drop,tree,trichome,tube,vein,white,wide,young	.25,0.5-1,1-1.5,2-5,2.5-3,3-3.5,3-4,4-10,8-12,abaxially,anthesi,ape,bark,brown,closely,conical,deflexed,deltate,differing,difoliate,drying,eaf,edicel,eed,filament,fleshy,free,geminat,glabrou,large,lateral,lenticel,less,lobe,lon,lower,main,major,margin,middle,minor,nflorescence,older,overlappin,papillo,planar,pore,poricidal,portion,ruit,scar,spaced,tall,tip,tub,ud,unit,widest,woody,yellowish,ympodial	alternate,arrangement,bud,characteristic,colour,diameter,exertion,form,fruit,growth,height,history,length,life,lobing,peduncle,plant,seed,shape,texture,type
344	wfo-0001029811	success	225	147	123	102	24	0.547	-3,0-35,0.3-1,0.5-2,0.8-1.5,1-1.5,1-3,1.3-1.7,1.5-6,1/2-2/3,1/3,13-20,2-2.5,2-5.5,2.5-3,2.8-3.2,3-5,3-5.5,3-7,3.5-4.5,4.5-5,5-11,6-12,7-18,8-12,abaxial,adaxial,anther,apex,apparently,articulated,bark,base,berry,calyx,cell,chartaceous,cm,connivent,cordate,cream,cuneate,dark,densely,diameter,discolorous,drying,erect,filament,flattened-reniform,flower,fruit,fruiting,glabrous,glandular,green,hair,herb,lateral,leaf,length,lobe,lobed,lobing,long,long-styled,lower,margin,marking,maturity,mauve,minute,mm,moderately,multangulate,obtuse,orange-brown,outline,ovate,pair,pale,pedicel,peduncle,petiole,pit,plant,poricidal,porrect,prickly,primary,raised,scandent,sessile,short-styled,shrub,side,simple,slightly,small,smooth,sometimes,spherical,stalked,stellate,stellate-pubescent,stem,stout,straight,style,surface,tapering,terete,tip,trichome,tube,unbranched,upper,vein,way,wide,yellow,yellow-green,young	-6,-merous,.5,/3,0,0-30,0.1-0.3,0.1-0.4,0.2,0.2-0.6,0.3-1.5,1,1-2.5,1.5-2.5,1/,1/3-2/3,10-22,15-23,15-50,2-5,20-100,4-8,5,5-17,5-40,5-9,7-9,8-18,abaxially,acicular,alyx,andromonoecious,apar,apart,apically,blade,broad-deltate,brown,distal,distance,eaf,eed,elongate,elongating,equal,extending,eye,faint,fewer,flattened,free,green-brow,hermaphrodite,heterostylous,inflated,infructescence,less,long-acuminat,longer,lowermost,mature,midpoint,midvein,naked,narrow-deltate,nflorescence,often,older,one,open,orolla,oung,pendulous,per,pericarp,perpendicular,plurifoliat,portion,prickl,prickle,ray,ruit,scar,secondary,short,shorter,spaced,sparsely,spreading,stalk,staminat,tamen,tertiary,time,unarmed,unit,usually,vary,venation,visible,woody,ympodial	1/2,arrangement,branch,characteristic,colour,corolla,exertion,form,glabrousnes,green-brown,growth,height,history,inflorescence,life,na,new,ovary,seed,shape,size,stigma,texture,type
345	wfo-0001029978	success	208	138	118	90	20	0.567	0.5-0.6,0.7-1.9,0.9-2.3,1-2,1.3-1.5,1.4-1.5,1.8-5,15-27,3-5,3-7,3.1-6.3,3.2-2.5,3.5-9.5,3.7-8.1,4-11,4-7,4.2-5.2,5,5-16.5,8-10,abaxially,acuminate,adaxially,along,anther,apex,axillary,base,berry,blade,brownish,bud,cell,chartaceous,ciliate,clavate,cm,coarsely,condition,conical,connivent,corolla,covering,dark,diameter,distal,drying,especially,filament,finely,flower,forked,fresh,fruit,generally,glabrous,green,green-white,greenish,hair,hair-like,half,herb,homostylous,lanceolate,lateral,leaf,leaflet,light,lobe,long,make,margin,medium,membranous,midrib,minute,minutely,mm,moniliform,mottled,mucilaginous,odd-pinnate,ovoid,pedicel,peduncle,pentagonal,plant,puberulent,pubescent,purple,ripe,rotate,seed,semierect,simple,size,sparsely,stem,stigma,straight,style,subsessile,subtending,terminal,testal,thick,throughout,tip,tube,tuber,usually,wall,wet,whitish,wide,x,yellow	0.3-0.4,0.3-0.7,0.8,1-10,1.5-3.1,11-19,2-4,5-merou,acumen,ag,alyx,apart,apparently,arranged,articulated,asymmetrical,attenuate,axe,basiscopic,bead,capitat,commonly,darker,decreasing,digestion,dorsally,eaf,edge,eed,elliptic,enzyme,erec,exceeding,flat,folded,fourt,geminat,glabrou,gradually,honeycomb-shaped,interjected,larger,lengthening,less,like,living,lower,middle,multiple,narrow,necklace,nflorescence,orbicular,orolla,ovate,pair,perfect,petiole,petiolule,plurifoliate,pore,poricidal,pubescen,ray,removed,ruit,secondary,sessile,seudostipule,side,slightly,slit,spaced,specimen,stamen,ste,stolon,subequal,symmetrical,tall,tamen,tem,tissue,toward,tri-,typically,unit,vary,wing,ympodial	5-merous,abaxial,adaxial,arrangement,calyx,capitate,colour,erect,form,growth,height,history,inflorescence,length,life,ovary,pseudostipule,shape,surface,texture
346	wfo-0001029980	success	173	126	107	66	19	0.618	.1,0.1-0.25,0.25-0.5,0.5-1.2,0.5-2.5,0.5-5,0.7-1.3,0.8-1.2,1-1.7,1.5-2,2-5,2/3,3-4,3-9,5-50-flowered,6.4-17,anther,appearing,appressed,bark,base,berry,black,bright,brown,bud,calyx,cm,corolla,curved,dark,decurrent,deflexed,dia,difoliate,dried,drying,elliptic,especially,exserted,filament,five,flattened-reniform,fruiting,glabrous,globose,gray,green,greenish-white,knob,leaf,live,lobe,lobed,long,material,minutely,mm,near,node,often,older,one,opposite,ovary,ovate,pale,papillose,pedicel,petiole,pitted,plant,pore,poricidal,puberulent,rounded,shape,shaped,shiny,shrub,side,simple,size,slender,slightly,small-capitate,soon,stem,stigma,straight,style,surface,tan,tapering,tear-drop,tip,trichome,tube,tuft,unicellular,uniseriate,unit,way,white,winged,x,young	.5,0.25-1,0.5-1,0.9-4.5,1-1.5,1.2-2.5,1.5-6,2-6,5-10,abaxially,acute,adaxially,anthesi,apar,apex,axil,ba,closely,conical,deltoid,density,differing,eaf,edicel,eed,elevation,free,geminat,greatly,high,impressed,incrassate,lateral,lon,lower,main,major,margin,middle,minor,nflorescence,onto,orbicular,overlapping,pair,paler,portion,prominent,proximal,race,reflexed,ruit,scar,somewhat,spaced,specimen,tall,ud,varying,vein,venezuelan,whit,widest,woody,yellowish,ympodial	arrangement,characteristic,colour,diameter,exertion,form,fruit,geminate,growth,height,history,inflorescence,length,life,lobing,seed,sympodial,texture,type
347	wfo-0001029989	success	161	93	70	91	23	0.435	/2,0.5-1.5,1-1.5,1-2,1-2.5,1.3-2.3,1.5-2.5,2.5-3,3-5,3-8,3.5-8,4-4.5,5-10-flowered,7-20,abaxial,anther,berry,calyx,capitate,cm,corolla,dendritic,densely,dia,difoliate,elliptic,exserted,flattened,fruiting,glabrous,globose,golden,green,greenish-black,incrassate,inflorescence,internodal,leaf,lenticular,long,margin,minutely,mm,occasionally,opposite,ovary,pedicel,petiole,pitted,pubescent,reddish-brown,shaped,shining,shrub,simple,small,stem,stigma,style,surface,tear-drop,tree,tree-like,trichome,tube,unifoliate,way,white,wide,x	.2,.5,0.25-0.5,0.5-1,1-4,10-14,5-6,abaxially,acute,adaxially,anthesi,apex,bark,base,branch,branched,broadly,brownish-re,central,closely,collection,congested,conical,deflexed,deltoid,dense,described,dimaeter,discussion,drying,due,eaf,edicel,eed,erect,filament,fleshy,free,geminat,gray,heteromorphic,inflorescenc,lamina,lateral,like,lobe,lobed,lon,lower,main,middle,nearly,nflorescence,nodding,northern,older,overlappin,pair,papillo,peru,peruvian,perÃº,petal,petaloid,planar,population,pore,poricidal,portion,probably,pubescence,reddish,rest,ruit,scar,scattered,see,short-style,somewhat,spaced,sparsely,tall,tip,ud,unit,vein,widest,woody,yellow,ympodial,young	2.5-6,adaxial,arrangement,bud,characteristic,colour,diameter,exertion,form,fruit,growth,height,history,length,life,perennial,plant,seed,shape,size,texture,type,width
348	wfo-0001030000	success	155	152	128	27	24	0.826	-4,-5,-50,-7,-pilose,0.5-,0.5-1,0.5-14,0.5-3,1,1-,1-10,1-2,1.5-,1.5-2,10-,10-20,15-25,2-2.5,2-3,2-4,2-5,2.5-,2.5-3,2.5-3.5,25-30,3-4,3.5-5,30-50,4,4-4.5,4-5,7-15,abaxially,absent,acute,adaxially,also,apart,apex,apiculate,articulated,axe,base,calyx,chartaceous,cm,connective,connivent,conspicuous,coriaceous,cucullate,deltate,densely,dia,diameter,dilated,directed,distally,eglandular,ellipsoidal,equal,exceeding,flattened,flower,fruit,glabrous,globose,green,hair,immature,laterally,leaving,lobe,long,margin,mature,mm,moderately,narrowly,oblong,obtuse,occasionally,orange,ovoid,pedicel,pedicellar,peduncle,perfect,pilose,pore,produced,puberulent,pubescent,purplish,rachi,radiu,rarely,remnant,scar,shorter,shrub,slightly,small,sparsely,spotted,stellate,stigma,strongly,style,subcoriaceous,swelling,thecae,tinge,tip,tomentose,tree,triangular,truncate,tube,umbrella-shaped,unbranched,white,wide,x,yellow,yellow-brown,yellowish	3-,3-16,4-foliat,aggregate,ape,biglandula,cell,ciliat,creamy-whit,eed,lon,lower,nflorescence,nther,orolla,pubescen,ruit,smal,spaced,stamen,stone,tal,tem,ud,unit,vary,ympodial	anther,articulation,biglandular,bud,characteristic,ciliate,colour,corolla,creamy-white,direction,form,glabrousnes,growth,height,inflorescence,length,ovary,plant,seed,shape,size,spacing,stem,theca
349	wfo-0001030000	success	178	151	98	80	53	0.551	-50,-7,0.5-,0.5-1,0.5-13,0.5-3,1-10,1-2,1-5,1.5-,10-,15-25,2-,2-2.5,2-4,2.5-,2.5-3.5,25-30,3-,3-4,3.5-5,30-50,4-25,4-4.5,4-5,5-25,7-15,acuminate,acute,adaxially,also,apex,apiculate,basal,base,calyx,cm,cordate,cucullate,deltate,densely,dia,diameter,eglandular,ellipsoidal,entire,flattened,flower,fruit,glabrous,globose,green,hair,immature,lobe,long,margin,mature,mm,moderately,narrowly,oblique,oblong,obtuse,occasionally,often,orange,ovate,ovoid,pedicel,peduncle,perfect,petiole,pilose,puberulent,pubescent,purplish,shrub,simple,slightly,small,sparsely,spotted,stigma,style,subcoriaceous,tinge,tip,tree,triangular,truncate,tube,unbranched,vein,white,x,yellow,yellow-brown	-2,-4,-5,-pilose,0.5-14,1,1-,1-1.5,1.5-2,10-20,2-3,2-5,2.5-3,3-16,4,4-foliat,abaxially,absent,aggregate,apart,ape,articulated,axe,biglandula,blade,cell,chartaceous,ciliat,connective,connivent,conspicuous,coriaceous,creamy-whit,dilated,directed,distally,eaf,eed,elliptic,equal,exceeding,glabrescent,laterally,leaving,lon,lower,nflorescence,nther,orolla,pedicellar,pilo,pore,produced,pubescen,rachi,radiu,rarely,remnant,ruit,scar,shorter,smal,spaced,stamen,stellate,stone,strongly,swelling,tal,tem,thecae,time,tomentose,ud,umbrella-shaped,unit,vary,wide,yellowish,ympodial	anther,appearance,arrangement,bark,biglandular,border,branch,bud,characteristic,colour,corolla,corrugation,distal,drying,exertion,filament,form,fruiting,giving,glabrousnes,growth,height,history,inflorescence,interjected,lateral,leaf,leaflet,length,life,lobing,midpoint,na,new,number,ovary,per,plant,prickle,primary,pseudostipule,ray,seed,shape,size,stem,surface,terminal,texture,thicknes,type,variation,width
350	wfo-0001030004	success	177	118	99	78	19	0.559	0-1.5,0.2-1,0.8-1.1,1-1.5,1-2,1.2-2,1.5-2.5,15,2-20,20-200-flowered,3-3.5,3.5-5,4-15,5-25,9-30,abaxial,across,acuminate,acute,adaxially,along,anther,apex,bark,basal,base,berry,branched,calyx,capitate,cm,collection,corolla,crotaloid,dendritic,dense,densely,dia,elliptic,exserted,flattened-reniform,fruiting,glabrous,globose,green,incrassate,inflorescence,later,lateral,leaf,lobed,long,loose,many,margin,mm,nearly,obovate,obovoid,occasionally,onto,ovary,pale,pedicel,petiole,plant,plurifoliate,portion,prominent,pubescence,pubescent,seed,sessile,shaped,shrub,small,sparsely,stem,stigma,stout,strongly,style,surface,tan,tear-drop,terminal,time,translucent,tree,trichome,tube,variously,vein,white,wide,winged,x,yellowish-green,young	.3,0-0.5,0.3-1,15-20,3-4,abaxially,always,anthesi,apar,appearanc,axillary,barely,blade,body,branching,broadly,bushy,cone,conical,decurrent,deltate,denser,diamete,distal,drying,eaf,edicel,eed,erect,especially,filament,flat,fleshy,free,giving,greenish-yello,hard,juvenile,knob,lamina,large,like,lobe,lower,main,middle,minutely,much,nflorescence,often,older,pair,papillate,papillo,pericarp,pitted,planar,pore,poricidal,possessing,rest,ruit,scar,simple,spaced,surpassing,tall,thick,thin,tip,tub,tuft,ud,unevenly,widest,woody,yellowish,ympodia	arrangement,bud,characteristic,colour,diameter,exertion,form,fruit,greenish-yellow,growth,height,history,length,life,lobing,shape,size,texture,type
351	wfo-0001030007	success	168	106	80	88	26	0.476	.4,.5,0.8-1,1-1.5,1-15,1-2,1.6-2.2,15-20,2-4,3/4,6-10-flowered,7-10,7-9,acuminate,acute,anther,apex,bark,base,berry,brown,bud,calyx,campanulate,clavate,cm,corolla,decurrent,densely,dia,elliptic,exserted,filament,flattened,fruiting,glabrous,globose,golden-pubescent,green,lateral,leaf,long,main,margin,minutely,mm,oblique,onto,ovary,pair,pale,papillose,pedicel,petiole,pitted,plant,pubescent,reniform,shaped,shrub,simple,slender,slightly,soon,sparsely,stem,stigma,straight,style,surface,tapering,tear-drop,tube,type,vein,way,white,winged,x,young	.05,0.1-0.5,0.2-1,0.5-1,1.5-5,2-7,3-5,4.5-5,abrupt,along,anthesi,apart,ba,becoming,beneath,branched,broadly,closely,cork,dark,deltoid,difoliate,dry,edicel,eed,erect,fleshy,free,geminateleaf,glabrate,golden,gre,hooded,impressed,incrassate,inflorescenc,like,live,lobe,lobed,lon,longer,lower,major,material,middle,midrib,minor,nflorescence,obovoid,occasionally,older,one,opposite,outline,papillo,planar,pore,poricidal,portion,prominent,raised,rest,rounded,ruit,scar,short,shorter,small,soft,spaced,specimen,tall,thick,thickened,tip,tree,trichome,trunk,tub,two,ud,uniseriate,unit,widening,widest,woody,ympodial	alternate,arrangement,branch,characteristic,colour,diameter,exertion,form,fruit,glabrousnes,grey,growth,height,history,inflorescence,length,life,lobing,new,peduncle,perennial,primary,seed,shape,size,texture
352	wfo-0001030010	success	156	113	95	61	18	0.609	.5,.75,/4,0.5-5,0.9-1.1,1-1.3,1-1.5,1.5-2,10-15,10-50-flowered,2-2.2,2-7,2.5,20-40,5-7,acuminate,acute,anther,apex,area,attenuate,bark,basal,base,beneath,berry,brown,calyx,cm,corolla,cyathiform,dark,deciduous,decurrent,dia,exserted,f,filament,fruit,fruiting,furcate,glabrate,glabrous,globose,green,grey,leaf,lobed,long,midrib,minute,minutely,mm,near,nearly,obovate,occasionally,often,older,opposite,ovary,ovoid-reniform,papillose,pedicel,petiole,pitted,pore,poricidal,puberulent,reddish,shaped,shrub,simple,size,slightly,small,smooth,soon,stem,stigma,style,surface,tapering,tear-drop,tiny,tip,tree,trichome,tube,uniseriate,way,white,winged,x,young	0.7-1,1-2,1.2-1.5,11-12,3-5,4-4.5,7-10,anthesi,appearing,bud,closely,deflexed,deltate,differing,difoliate,distal,dry,eaf,edicel,eed,ellipsoid,fleshy,free,geminat,hooded,lateral,lobe,lon,lower,m.,main,major,margin,materia,material,middle,minor,nflorescence,one,orange,overlappin,pair,persistent,planar,portion,prominent,rather,ruit,scar,shin,spaced,straight,styl,tall,trunk,ud,unit,vein,widest,woody,ympodial	characteristic,colour,diameter,exertion,form,growth,height,history,inflorescence,length,life,lobing,plant,seed,shape,shiny,texture,type
353	wfo-0001030023	success	171	111	85	86	26	0.497	0-100+,0.5-1,1-2,1-8,1.5-7,10-25,11-40+,2.5-3.5,20-30,3-4.5,3-5,30-50+,4,4-12,5,5-,5-16,5-6,6-26,7-9,acute,apex,apiculate,basal,base,branched,calyx,cm,connivent,cordate,cuneate,deeply,densely,diameter,ellipsoidal,entire,finely,flattened,fleshy,flower,forked,fruit,glabrous,glandular-puberulent,globose,greenish-white,highly,lanceolate,lobe,long,loosely,margin,membranaceous,mm,moderately,narrowly,oblique,oblong,obtuse,occasionally,often,pedicel,peduncle,peltiform,petiole,puberulent,pubescent,purplish-,rachi,short-acuminate,simple,sparsely,stellate,stigma,style,tip,tree,triangular,truncate,tube,unbranched,unit,usually,x,yellowish	-,1,1-,1.5-2,10-,12-18,13-20,2,2-3,4-10,4-foliat,6-7,abaxially,adaxially,aggregate,apart,ape,articulated,axe,beyond,blade,capitat,cell,ciliate,color,connective,cylindrical,denser,dilated,directed,distally,eaf,eed,elliptic,especially,exceeding,except,exserted,glandular-puberulen,hair,leaving,lon,lower,main,narrow,near,nflorescence,nther,orolla,ovate,pedicellar,perfect,pore,presen,present,probably,prominent,pubescen,pubescence,pubescent-pilo,radiu,remnant,ripe,ruit,shorter,slightly,small,somewhat,spaced,stamen,stone,subcoriaceous,swelling,tal,tem,thecae,time,ud,unknow,unknown,vary,vein,villous,wide,ympodial,young	4-foliate,abaxial,adaxial,anther,bud,capitate,characteristic,corolla,form,growth,height,history,inflorescence,leaf,length,life,ovary,perennial,plant,pubescent-pilose,seed,shape,size,stem,sympodial,texture
354	wfo-0001030032	success	250	117	92	158	25	0.368	0.4-1.5,0.5,0.5-0.6,0.5-1.5,0.8-1.0,1-1.3,1-1.5,1.5-2.5,11-20,13-35,2-10,2-3-locular,2-4,2-5,2.4-3.5,3.0-3.5,3.5-12,30,4.3-5.0,5-plurifoliate,60-80,8-10,8-20,acuminate,acute,anther,apex,articulated,base,branched,bright,brown,capitate,cm,completely,conical,corolla,dark,decurrent,densely,diameter,elliptic,entire,exserted,free,fruit,fruiting,golden,green,greenish-brown,hair-like,halfway,imparipinnate,internode,interrupted,leaf,length,long,many,margin,mm,oblanceolate,obovate,orbicular,outgrowth,ovary,pale,pedicel,peduncle,petiole,primary,pseudostipule,pubescence,pubescent,rotate,rotate-stellate,seed,stem,stigma,straight,style,surface,thick,time,truncate,unit,vein,vine,white,wide,woody,yellow	+,.05,.5,0.1-0.4,0.1-0.5,0.2,0.2-0.3,0.2-0.5,0.25-0.4,0.5-0.7,0.5-1,0.5-2,0.6-1.1,0.7-0.8,0.8-1.1,1-2-celled,1-3,1-celled,1.5-2,2,2-3.5,2-60,2-lobed,3,3-5,4-5,4-6-celled,4-celled,6-11,7-16,7.5-10,8-10-celled,abaxially,absent,abundant,adaxial,adaxially,along,also,anthesi,apical,appearance,appendage,articulation,basal,basally,basiscopically,bent,border,branche,breaking,calyx,cell,clambering,column,conspicuou,deltate,densest,desne,dry,eaf,ebracteate,edicel,eed,filament,flower,give,glabrous,glandular,gree,hea,head,herbarium,interjected,irregularly,lamina,large,larger,lateral,leaflet,leave,like,lobe,longest,lower,markedly,middle,midvein,mixed,moderately,much,multicellular,nflorescence,node,oblique,occasionally,often,older,onto,opposite,pair,paler,patent,petiolule,pithy,present,rachi,reflexed,rest,rough,round,ruit,secondary,set,shorter,silky,simple,slightly,smaller,soft,sometimes,somewhat,sparsely,sparser,specimen,splitting,spreading,stamen,staminal,sterile,subopposite,swollen,tall,tangled,tem,terminal,tertiary,testa,thickened,tiny,tip,touch,transparent,trichome,tube,ud,unicellular,uniseriate,usually,vegetatio,venation,wall,weaker-walled,well-developed,winged,ympodial,younger,Â½-3/4	arrangement,branch,bud,characteristic,colour,dense,drying,exertion,form,glabrousnes,growth,height,history,inflorescence,life,new,perennial,plant,shape,size,staman,sympodial,texture,type,width
355	wfo-0001030048	success	156	115	92	64	23	0.59	0.5-1.5,1-1.5,1.2-2,1.3-1.6,1.5-3.5,1.5-7,2-3,2-5,3-5,4-15,5-10-flowered,5-8,abaxial,acute,adaxially,along,anther,anthesi,apex,apically,arachnoid,bark,base,becoming,berry,bi-lobed,blue,brown,calyx,clavate,cm,completely,corolla,covered,decurrent,densely,dia,difoliate,drying,ellipsoid,elliptic,exserted,felt-like,fruiting,glabrous,globose,golden,green,greyish,internodal,lamina,leaf,lobed,long,main,matted,minutely,mm,nearly,occasionally,onto,opposite,ovary,ovoid-reniform,pale,pedicel,petiole,pitted,pointed,pubescent,reddish-brown,shaped,shiny,shrub,simple,small,somewhat,stem,stigma,strongly,style,surface,tan,tear-drop,tree,trichome,trifoliate,tube,unit,vein,white,wide	.5,1-2,10-16,3-3.5,4-4.5,5973,abaxially,ape,apparently,bi-colored,broadly,closely,conical,deflexed,deltate,eaf,edicel,eed,fide,filament,fleshy,four-angle,free,geminat,glabrate,impressed,inflorescenc,lateral,lightly,like,lobe,lon,lower,margin,middle,nflorescence,older,overlappin,pair,papillo,papillose,planar,pore,poricidal,portion,prominent,rather,rest,ruit,scar,solomon,spaced,sparsely,tall,thick,thickened,tip,tub,ud,widest,woody,yellowish,ympodial,young	arrangement,bud,characteristic,colour,diameter,exertion,form,fruit,growth,height,history,inflorescence,length,life,lobing,perennial,plant,seed,shape,size,sympodial,texture,type
356	wfo-0001030053	success	141	84	63	78	21	0.447	0.5-1,1-1.3,1-13,1.3-3.5,1.8-2,2.5-3,3.5-4,abruptly,acuminate,acute,anthesi,apex,apical,base,berry,branched,brown,calyx,cm,corolla,decurrent,diameter,elliptic,entire,exserted,far,filiform,flattened,fragrant,glabrous,greenish,growth,inflorescence,long,many,margin,minutely,mm,new,nipple,pale,pedicel,peduncle,petiole,pitted,reniform,revolute,shining,shiny,simple,slightly,stem,surface,terminal,time,truncate,tube,turbinate,vine,white,woody,x,yellowish	0.5,1.5-5.5,10-20,100,2-2.5,4-,5,5-merou,7-11,7-9,<,abscission,aiding,alyx,apart,apiculae,ark,around,articulated,bfeore,branch,cell,climbin,completely,coriaceous,cyathiform,eaf,eed,fide,fine,flower,frui,fruiting,hyaline,irregularly,leaving,lobe,lobed,lower,mentz,near,nflorescence,older,orolla,pair,papilla,papillo,parallel,peg,pendant,per,perfect,plurifoliat,primary,rectangular,rim,scar,secondary,shallowly,shin,sleeve,small,spaced,spreadin,spreading,strongly,support,tem,testal,tiny,tip,twining,ud,unit,usually,vein,venation,ympodial	4-11,arrangement,bark,bud,characteristic,colour,exertion,form,fragrance,fruit,glabrousnes,history,leaf,length,life,papillose,seed,shape,size,texture,type
357	wfo-0001030057	success	141	81	66	75	15	0.468	-2,2-3-celled,2-4,2-4.5,2-6,2.1-4.1,20-30,20-80,3-5,3.5-8,4-10,4.3-8.2,5.5-12,7-14,8,8-19,abaxially,absent,acuminate,acute,adaxially,apex,base,berry,blade,chartaceous,cm,cordate,cuneate,diameter,elliptic,flower,forked,fruit,globose,green,greenish,hair,herb,interjected,lateral,leaf,leaflet,long,membranous,mm,mucilaginous,odd-pinnate,ovate,ovoid,pedicel,peduncle,petiole,petiolule,plant,pubescent,seed,short,size,stem,subglabrous,terminal,truncate,tuber,whitish,x	1-10,1-2,apart,apparently,articulated,axe,axillary,borne,broadly,brownish,bud,cell,condition,covering,decreasing,digestion,distal,drying,eaf,eed,end,enzyme,erec,extremely,fresh,geminat,generally,glabrou,greatly,green-white,hair-like,half,high,honeycomb-shaped,larger,like,living,lunate,make,mottled,narrow,nflorescence,pair,perfect,plurifoliate,purple,removed,ruit,scale-like,seudostipule,singly,small,sometimes,spaced,specimen,ste,stolo,suborbicular,subtending,tall,tem,testal,thick,thir,throughout,toward,tri-,typically,unit,unwinged,usually,wall,wet,wing,ympodial	arrangement,colour,form,growth,height,history,inflorescence,length,life,presence,present,pseudostipule,shape,texture,type
358	wfo-0001030057	success	197	166	145	52	21	0.736	-10,-2,.5-3.5,1-10,1-2,2-3-celled,2-4,2-4.5,2.1-4.1,20-30,20-80,3-5,3.5-8,4-10,4.3-8.2,5-10,5-6,5.5-12,7-14,8,8-19,abaxially,absent,acuminate,acute,adaxially,along,anther,apart,apex,axillary,base,berry,blade,borne,brownish,bud,cell,chartaceous,ciliate,cm,condition,connivent,cordate,corolla,covering,cuneate,diameter,distal,dorsally,drying,edge,end,especially,extremely,filament,flat,flower,folded,forked,fresh,fruit,generally,glabrous,globose,green,green-white,greenish,greenish-yellow,hair,hair-like,half,herb,homostylous,interjected,lanceolate,lateral,leaf,leaflet,lengthening,like,linear,lobe,long,lunate,make,margin,membranous,middle,midrib,minutely,mm,mottled,mucilaginous,narrow,odd-pinnate,ovate-lanceolate,ovoid,pedicel,peduncle,pentagonal,petal,petiole,petiolule,plant,pore,poricidal,puberulent,pubescent,purple,rotate,scale-like,seed,short,singly,size,slit,small,sometimes,star,stem,stigma,straight,striped,style,subglabrous,subtending,terminal,testal,thick,throughout,tip,truncate,tube,tuber,typically,unwinged,usually,wall,wet,white,whitish,wing,x,yellow	2-3,2-5,2-6,5-merou,acumen,ag,alyx,apparently,articulated,axe,broadly,decreasing,digestion,eaf,eed,elliptic,enzyme,erec,exceeding,geminat,glabrou,globo,greatly,high,honeycomb-shaped,larger,living,lower,nflorescence,orolla,ovate,pair,perfect,plurifoliate,removed,ruit,seudostipule,spaced,specimen,stamen,ste,stolo,suborbicular,tall,tamen,tem,thir,toward,tri-,unit,vary,ympodial	5-merous,age,arrangement,calyx,colour,form,growth,height,history,inflorescence,length,life,ovary,presence,pseudostipule,shape,spacing,stolon,surface,texture,type
359	wfo-0001030080	success	186	132	109	77	23	0.586	0.3-7,0.4-1.5,0.5-4,1-2,1-3,1.5-2,1.5-2.5,1.8-4.5,2-3,2-4,2.1-7.1,3-10,3-5,3.3-7.7,4-12,4-7,5-13.5,5-7,5.5-9.9,6.5-18.6,8-23,9.9-33,abaxially,absent,acuminate,adaxially,anther,apex,articulated,axillary,base,blade,brownish,bud,cell,clavate,cm,condition,coriaceous,corolla,covering,cuneate,dark,decurrent,diameter,distal,dot,drying,filament,flower,forked,fresh,fruit,generally,glabrous,green,green-white,greenish,hair-like,half,herb,high,homostylous,interjected,lanceolate,lateral,leaf,leaflet,light,lobe,make,mm,moniliform,mottled,mucilaginous,odd-pinnate,onto,ovate,ovoid,pedicel,peduncle,petiole,plant,purple,pyriform,rachi,seed,size,sometimes,stellate,stigma,straight,style,subtending,terminal,testal,thick,throughout,tiny,tube,tuber,usually,wall,wet,white,whitish,winged,x,yellow	1999,5-merou,8-16,abaxiall,acumen,ag,along,alyx,apart,apparently,arranged,axe,bead,berry,capitat,ccording,connivent,decreasing,digestion,dorsally,eaf,edge,eed,elliptic,enzyme,erec,exceeding,flat,folded,geminat,glabrescent,glabrou,hair,hal,honeycomb-shaped,inconspicuous,larger,lengthening,like,linear,living,long,lower,medium,multiple,necklace,nflorescence,ochoa,orolla,pair,perfect,plurifoliate,pore,poricidal,removed,second,seudostipule,slightly,slit,spaced,specimen,stamen,stolon,strongly,subequal,tall,tamen,tem,tip,toward,tri-,typically,unit,unknown,vary,width,ympodial	5-merous,abaxial,adaxial,arrangement,articulation,calyx,capitate,colour,erect,form,growth,height,history,inflorescence,length,life,ovary,pseudostipule,shape,spacing,stem,surface,texture
360	wfo-0001030081	success	157	117	89	68	28	0.567	.5,0.5-1,0.5-1.5,0.5-2.5,1,1-2,1-4,1-5,1.5,10-20,2-4,2-foliate,3-10,3-6,4-6,5-12,5-15,absent,abundant,acute,anther,apex,base,berry,brown,calyx,center,chartaceous,ciliate,cm,cordate,decurrent,densely,diameter,dm,drying,edge,elliptic,elliptic-ovoid,entire,filament,fine,flower,fruit,geniculate,glabrous,globose,hair,herb,immature,interpetalar,linear-lanceolate,long,margin,maturing,membranaceous,mm,moderately,nearly,oblong,obtuse,often,parallel,pedicel,peduncle,petiole,pubescent,radiating,raised,ridge,rotate,rounded,running,semitransparent,shallow,short,sparsely,stigma,style,surface,tissue,triangular,tube,two-celled,unbranched,usually,white,x,yellow	0.25-0.5,1-2-celled,1-3,1.5-3,1.5-7,10-35,1st,2-7,2nd,abaxially,adaxiall,adaxially,along,apically,axe,beyond,blade,cell,connected,dehiscing,denser,eaf,eed,emarginat,equal,explosively,exserted,few-branched,flat,frui,geminat,held,lobe,longer,lower,lying,maturit,mesocarp,nfloresence,notch,one,orolla,other,per,placenta,pointing,pressure,pubescen,rachi,rarely,ruit,single-,slightly,small,sometimes,stamen,straight,swollen,tal,tamen,tem,unit,vary,vein,watery,wid,woody,ympodial	abaxial,adaxial,arrangement,characteristic,colour,corolla,emarginate,form,geminate,glabrousnes,growth,height,inflorescence,leaf,length,lobing,na,new,ovary,plant,seed,shape,size,staman,stem,texture,type,wide
361	wfo-0001030083	success	146	94	68	78	26	0.466	.75,0.5-2,0.8-1,0.8-3,1-1.5,1-2,10-30,2-3,2-5-flowered,4-15,4-6,acute,anther,apex,bark,base,berry,calyx,cm,corolla,decurrent,deeply,dia,elliptic,exserted,fruit,fruiting,glabrous,globose,green,greenish-white,hyaline,leaf,long,long-acuminate,long-styled,minutely,mm,narrowly,onto,ovary,ovate,ovoid-reniform,pale,papillose,pedicel,petiole,pitted,poricidal,red-papillose,short-styled,shrub,simple,single-stemmed,slender,small-capitate,soon,stem,stigma,strongly,style,surface,tan,tip,tube,white,winged,x	.5,0.1,0.25-0.5,0.5-1,1.5-3,2,3-4,3/4,9-11,accrescent,anthesi,beginning,broadly,closely,cup-shaped,dar,deciduous,deflexed,deltoid,dry,drying,eaf,edicel,eed,elongate,fleshy,flower,greyish-re,inflorescenc,internodal,lateral,lobe,lobed,lon,lower,main,membranous,middle,near,nflorescence,older,opposite,overlapping,pair,paler,papillae,pore,prominent,proximal,raised,reddish-gold,reflexed,ruit,scar,shallowly,shaped,slightly,somewhat,spaced,specimen,straight,tall,tapering,tear-drop,terminal,thickened,thin,translucent,tub,ud,unifoliat,unit,vein,way,widest,woody,ympodial,young	arrangement,branch,bud,characteristic,colour,diameter,exertion,form,glabrousnes,greyish-red,growth,height,history,inflorescence,length,life,new,peduncle,perennial,plant,seed,shape,size,texture,type,unifoliate
362	wfo-0001030093	success	181	133	104	77	29	0.575	0.1-0.3,0.2-0.5,0.5-1.1,0.6-1.5,1-1.5,1-12,1-5,2-2.5,3-4,3.5-12,4-6,7-30,7-9,8-9,acuminate,acute,anther,apex,attenuate,bark,base,becoming,beneath,berry,branched,brownish-tan,calyx,campanulate,case,clavate,cm,continues,corolla,cuneate,densely,dia,ellipsoid,elliptic,erect,especially,exserted,filament,fruiting,glabrous,globose,golden,green,greenish-white,growth,hirsutulous,lateral,leaf,lobed,main,margin,minutely,mm,narrowly,nearly,new,obovate,occasionally,often,opposite,ovary,ovoid-reniform,pair,pale,paler,pedicel,petiole,pitted,plant,population,puberulent,pubescent,shaped,shiny,shoot,shrub,simple,size,slender,slightly,small,soon,southern,stem,stigma,straight,style,surface,tapering,tear-drop,terminal,tiny,tree,trichome,tube,uniseriate,vein,white,x,yellowish	.2,.5,0,0.2,0.2-1,0.75-1,1.3-4.5,2.5-11,5-50-flowered,5-8,anthesi,apar,closely,collection,commonly,deflexed,deltoid,differing,difoliate,eaf,edicel,eed,evenly,except,expanded,flower,forest,free,furcate,geminat,greyish-brow,guyanese,hyaline,impressed,inundated,like,lobe,lon,long,long-styled,lower,major,many,member,middle,minor,nflorescence,older,one,onto,open,orbicular,papillo,persisting,pore,poricidal,portion,present,quite,reflexed,remaining,ruit,scar,short-styled,spaced,tall,thickened,time,tip,tub,ud,underside,unit,widest,woody,ympodial,young	1.5-4,alternate,arrangement,branch,bud,characteristic,colour,corrugation,diameter,drying,exertion,form,fruit,glabrousnes,greyish-brown,height,history,inflorescence,length,life,lobing,na,papillose,peduncle,primary,seed,shape,texture,type
363	wfo-0001030145	success	153	117	98	55	19	0.641	-3,0.2-2,0.3-,0.5,0.5-1,0.5-4,1,1-2,1-2.5,1-3,1-5,1.5-2,1.5-4.5,1.5-7,10-12,2-4,2.5-6.5,3-10,3-4,3-5,6-40,abaxially,acute,adaxially,adpressed,apart,apex,basal,base,calyx,campanulate,chartaceous,cm,compound,connective,cuneate,cylindrical,deltate,densely,diameter,dunal,ellipsoidal,elliptic-ovate,entire,exceeding,fide,fleshy,flower,forked,fruit,glabrous,glandular,globose,hair,herb,lanceolate,leaf,less,lobe,long,margin,mm,moderately,narrowly,obtuse,ovate-elliptic,pedicel,peduncle,petiole,pilose,puberulent,rachi,radiu,reddish,remnant,ripe,shorter,shrub,simple,sinuate,slender,slightly,somewhat,sparsely,stigma,style,subcordate,ternately,thecae,toward,triangular,truncate,tube,unbranched,unknown,violet,x,yellow	-2,1-1.5,1.5,2-3,3,4-5,4-8,4-foliat,8-11,absent,aggregate,also,ape,articulated,axe,beyond,blade,cell,color,directed,distally,eaf,eed,elliptic,exserted,larger,lateral,leaflet,leaving,lon,lower,near,nflorescence,nther,orolla,pedicellar,pore,presen,puberulen,ruit,spaced,stamen,stone,subcoriaceous,tal,tem,terminal,time,tomento,truncat,ud,unit,vary,wide,ympodial	anther,arrangement,bud,characteristic,colour,corolla,form,growth,height,inflorescence,length,ovary,plant,seed,shape,size,spacing,stem,texture
364	wfo-0001030146	success	210	124	105	105	19	0.5	0.2â0.4,0.5,0.5â1,0.6â0.7,0.6â2,0.9â1,1.2â1.5,1â1.1,1â1.5,2.5â9,20,3â6,40â50,5â8,60+,8â15,9â9.5,>,abaxial,acuminate,acute,adaxial,anther,anthesi,apex,articulated,axe,base,berry,branched,brown,brownish,c.,calyx,capitate,cm,corolla,dark,densely,diameter,drying,echinoid,ellipsoidal,elliptic,entire,filament,flattened-reniform,flower,fresh,fruiting,glabrous,globose,golden,green,growth,halfway,inflorescence,leaf,length,like,long,many,margin,minutely,mm,multangulate,narrowly,new,nodding,olive,pale,pedicel,peduncle,peltate,per,persistent,petiole,pitted,plant,pubescent,ray,reddish,revolute,ripe,shiny,short-stalked,simple,small,stem,stigma,stout,style,surface,tan,terminal,time,tree,treelet,trichome,tube,undersurface,way,white,wide,â18	.1,.2,.5,1.5â2,16â20,20â30,2â5,3â4,4â30,4â4.5,5-merou,6.5â16,6â7,abaxially,absent,ag,almost,along,alyx,apar,appearing,ark,beig,beneath,branching,bright,cell,center,closely,connivent,coriaceous,covered,cup-shaped,deeply,deltate,dense,dichasia,discolorous,eaf,edge,eed,elongate,erec,exserted,free,fused,gradually,ilament,impressed,lamina,layer,lengthening,less,lobe,lobed,loosely,lower,midpoint,narrowing,nflorescence,older,orolla,pair,papillose,part,perfect,pericarp,plurifoliate,pore,poricidal,portion,primary,projection,pubescence,reflexed,regularly,rhachi,ruit,scar,scurfy,sessile,slit,spaced,sparsely,stellate,strongly,subtended,tall,tangled,tem,testal,thin,tiny,tip,ud,unevenly,unit,upper,vary,varying,vein,visible,woody,yellow,ympodial	arrangement,bark,beige,bud,characteristic,colour,exertion,form,fruit,glabrousnes,height,lobing,number,ovary,seed,shape,size,texture,type
365	wfo-0001030147	success	158	77	54	104	23	0.342	-8,0.5-2,1-4,1-5,10-19,14-35,15-30,2-10,2-10.5,2-13,2-3,2-5,2.5-7.5,4-5.5,4.2-7.5,4.5-10,5-8,blue,branched,calyx,cm,conical,corolla,deep,diameter,dichasially,distal,filament,finely,forked,green,herbaceous,interjected,lateral,leaf,leaflet,medium,mm,mucilaginous,odd-pinnate,ovoid,pair,pedicel,peduncle,perennial,petiole,plant,pubescent,purple,seed,size,style,terminal,tuber-bearing	0-5,1.0-2.0,1.0-2.2,2,3-,3-6-foliat,4-3.,5-7,8-38,abaxiall,abaxially,acumen,acuminate,acute,adaxially,apex,apical,apically,articulate,attenuate,base,cell,connate,covering,cuneate,cyme,dehiscent,dichasial,digestion,diminishing,dorsally,eaf,ebracteate,edge,eed,elliptical,emoval,enzyme,exceeding,flat,flower,folded,generally,globo,gradually,green-white,hair-like,half,honeycomb,introrse,living,lobe,lon,long,long-attenuate,lower,lunat,make,maturing,monochasial,narrowly,nflorescence,nther,oblique,obtuse,often,orolla,ovate,pattern,perfect,petiolule,plan,poricidally,proximal,reveal,rotate,rounded,ruit,sessile,seudostipule,short,slit,specimen,stamen,stigma,straight,subequal,subsessile,tal,tem,testal,thick,throughou,throughout,tip,toward,typically,unit,vary,wall,wide,yellow,ympodial,Â¼	3-7,4-31,abaxial,adaxial,anther,arrangement,branching,colour,form,fruit,growth,height,history,inflorescence,length,life,ovary,pseudostipule,shape,stem,surface,texture,width
366	wfo-0001030151	success	175	101	78	97	23	0.446	-50,0.2-0.5,1-17,1-3,1.5-2.5,10-25,15-35,2-11,2-6,2-7-compound,3-5,5-6,6-9,abundantly,acuminate,acute,adaxial,apex,apiculate,base,blotch,calyx,chartaceous,cm,connective,cordate,cuneate,decurrent,deltate,diameter,elliptic,entire,except,flower,fruit,glabrous,globose,hair,lanceolate,leaf,lilac-tinged,line,longitudinal,margin,membranaceous,mm,narrowly,oblique,oblong,obovate,often,pedicel,peduncle,petiole,pinnately,probably,puberulent,pyriform,rachi,ripe,sand-punctate,shallowly,simple,slightly,sometimes,sparsely,stigma,stripe,style,surface,tip,tree,truncate,unbranched,white,x,yellow,yellow-green	-3,0.3-0.5,0.5,0.5-1,1,1-1.5,1-2,1-5,1.5-2,10-20,2-25,2-3,20-30,3-14,3.5-32,4-5,4-foliat,?,abaxially,absent,adaxially,aggregate,apart,ape,around,articulated,axe,basal,beyond,blade,cell,channe,ciliat,compound,connate,cylindrical,directed,distally,eaf,eed,eglandular,exceeding,exserted,glabrate,glandular,glandular-puberulent,leaflet,leaving,less,lobe,lon,long,lower,near,nflorescence,nther,obtuse,orolla,pedicellar,perfect,pore,presence,purplish,radiu,remnant,ring,ruit,sand-punctat,scattered,short,shorter,slender,small,somewhat,spaced,stalked,stamen,stellate,stone,tal,tem,thecae,time,toward,triangular,truncat,tube,ud,unit,unknow,vary,vein,veiny,white-puberulent,whitish,wide,ympodial	abaxial,anther,arrangement,bud,channel,characteristic,colour,corolla,form,growth,height,history,inflorescence,length,life,ovary,perennial,plant,seed,shape,size,stem,texture
367	wfo-0001030153	success	147	129	105	42	24	0.714	.1,.2,/3,0.2-1,0.8-0.9,1-10,1-2,1-2.5,1.3-1.5,1.3-1.9,2-8,2-lobed,3-4,3-5,3-50,3.5-10.5,5-6,6-8,absent,acuminate,acute,age,anther,anthesi,apart,apex,apparently,attenuate,axil,bark,base,berry,branched,calyx,clavate,cm,conical,corolla,dark,diameter,distinct,domatia,ellipsoid,elliptic,entire,erect,exerted,filament,flower,fruiting,glabrous,globose,green,growth,impressed,internodal,irregularly,lanceolate,lengthening,less,margin,minutely,mm,narrowly,new,nodding,occasionally,older,ovary,pair,papillate,pedicel,peduncle,petiole,pit-like,plane,pore,poricidal,primary,rachi,revolute,ripe,scar,simple,slightly,slit,small,spaced,stem,stigma,strongly,style,surface,terminal,time,tip,tree,treelet,tube,vein,way,white,x,yellowish,young	0.8-1.3,1-1.2,1-1.5,1.5-2,2.5-4,abaxially,adaxially,ape,apiculate,brittle,broadly,caly,campanulate,deltate,densely,dot,dry,eaf,enlarged,free,glabrou,known,lobe,lobed,lower,markedly,membranous,nflorescence,ot,paler,papillat,perfect,plurifoliat,portion,resinous,ruit,specimen,straight,thin,ud,unit,ympodial	abaxial,adaxial,arrangement,bud,characteristic,colour,exertion,form,fruit,glabrousnes,height,history,inflorescence,leaf,length,life,lobing,na,plant,seed,shape,size,texture,type
368	wfo-0001030167	success	141	99	60	81	39	0.426	.8,acuminate,along,anther,apex,base,berry,branch,calyx,chartaceous,ciliate,climbing,cm,densely,diameter,entire,extra-axillary,fertile,flattened,flower,fruit,glabrous,green,herbaceous,lanceolate,less,margin,membranaceous,membranous,minutely,mm,moderately,near,obtuse,ovate,ovoid,pedicel,peduncle,petal,petiole,pointed,rachi,rounded,sand-punctate,simple,slender,somewhat,sparsely,stellate,stigma,style,symmetrical,thinly,tip,unbranched,unknown,vine,weakly,white,x	.9,0.1â0.2,0.5â0.6,0.5â0.7,0.6,0.6â0.8,0.7â1.2,0.8â1,1.2â2.5,1.5â2,1.5â7,12,14â19,15â20,17â58,1â1.2,1â1.5,2â3,2â4.5,4.5â8,4â10,4â4.5,4â5,4â7,5-merous,8â10,abaxially,accrescent,acute,adaxially,alyx,apar,apically,axe,blade,c.,ciliat,clavate,contiguously,eaf,eed,enlarged,filament,fruiting,gap,glabrou,immature,lobe,long,lower,m.,maturity,nearly,nflorescence,nternode,orolla,pair,penden,perfec,pinnate,plurifoliat,reflexed,ruit,scar,secondary,seen,slightly,spaced,subequal,tamen,tem,time,truncat,tube,unit,vary,vegetation,vein,venation,wide,ympodial	0.1-0.2,0.7-1.2,0.8-1,1-1.2,1-1.5,1.5-2,1.5-7,15-20,2-4.5,4-10,4-4.5,8-10,abaxial,adaxial,arrangement,characteristic,colour,corolla,form,growth,habit,history,inflorescence,internode,leaf,length,life,ovary,pendent,punctation,seed,shape,staman,stem,surface,texture,truncate,type,ye
369	wfo-0001030176	success	171	102	79	92	23	0.462	-6.25,.2,.7,0.4-1.5,0.5-2,0.7-1.4,1.2-2.5,2.25-3.25,2â3,3-5,3-lobed,3.75-5,6-8,acute,anther,apex,attenuate,base,berry,bilobed,broad,broadly,calyx,ciliate,cm,connivent,decumbent,dehiscent,depressed-globose,diameter,especially,extra-axillary,few-branched,filament,flattened-reniform,flower,fruit,glabrous,herb,hermaphroditic,lanceolate-oblong,light,long,margin,midrib,mm,near,nearly,node,oblong,often,ovate,pale,partially,pedicel,peduncle,petiole,plant,pore,prostrate,pubescent,rachi,rarely,ripe,simple,slightly,sometimes,somewhat,sparsely,stigma,style,tip,unbranched,violet,white,x,yellow,yellow-orange,young	-1.4,-4.25,.75-1.5,0.5,0.6-0.9,0.7â0.8,1,1-2,1-5,1.2,1.5-2,1.5-2.5,1.6,1/3,1/6,2-3,2-foliate,2.5,2.5â7.5,2.5â9,4-9,5-merou,6â8,abaxially,accrescent,adaxiall,adaxially,alyx,angulate,apart,apparently,articulated,asymmetrically,axe,ba,basal,bi-lobed,blade,branch,capitat,chartaceous,contact,covering,cylindrical,downward,eaf,eed,erec,forming,fruiting,geminat,hair,hold,interlobal,juic,lance-ovate,lateral,line,lobe,lon,longitudinall,lower,major,mesocarp,minutely,nflorescence,numerous,orolla,patch,perfect,recurve,recurved,rooting,rotate-stellate,round,ruit,sinus,soil,spaced,tamen,tem,terminal,time,triangular,tube,unit,vary,vein,white-puberulent,wide,winged,ympodial	5-merous,arrangement,capitate,characteristic,colour,corolla,form,growth,height,history,inflorescence,leaf,length,life,longitudinally,ovary,seed,shape,staman,stem,surface,texture,type
370	wfo-0001030180	success	135	104	83	52	21	0.615	.1,.75,0.05-1,0.8-2,0.9-1.8,1-1.5,1.1-1.2,10-30-flowered,3-4,3-8,4.5-5,6,8.5-23,?,abruptly,accrescent,anther,anthesi,apex,appearing,attenuate,bark,base,becoming,berry,calyx,clavate,cm,corolla,dark,decurrent,dia,erect,fruit,fruiting,furcate,glabrate,glabrous,globose,green,height,immature,leaf,linear,lobe,lobed,long,long-acuminate,minutely,mm,narrowing,nearly,occasionally,opposite,ovary,papillate,papillose,pedicel,petiole,planar,puberulent,rounded,shaped,shrub,slender,slightly,soon,sparsely,stem,stigma,style,surface,tear-drop,terminal,tip,trichome,tube,uniseriate,unknown,white,winged,woody,x	.5,0.5-1,8-10,apart,apiculate,clu,deflexe,deltoid,eaf,edicel,eed,ellipsoid,exserted,filament,free,inflorescenc,interpetalar,known,lateral,lenticellat,lon,lower,main,middle,minute,nflorescence,older,overlapping,pair,peduncl,plurifoliat,pore,poricidal,portion,prominent,proximal,raised,ruit,scar,sinus,spaced,straight,thin,ud,unevenly,unit,vein,widely,widest,yellowish,ympodial,young	characteristic,club,colour,deflexed,diameter,form,growth,history,inflorescence,length,life,lobing,na,number,per,plant,seed,shape,size,texture,type
371	wfo-0001030189	success	188	106	81	107	25	0.431	/3,0-1,0-30,0.5-1.6,0.9-1.1,1,1-1.5,1.3-4.2,1.5-4.5,1/3,2-5.5,3.2-4.5,4-5.5,abaxially,anther,apex,apparently,articulated,bark,base,berry,calyx,chartaceous,cm,cordate,densely,diameter,dull,elliptic,entire,erect,evenly,filament,flattened-reniform,fruit,fruiting,glabrescent,gray,green,lateral,leaf,length,long,lower,margin,maturity,mauve,mm,moderately,oblong,obtuse,orange,ovate,pedicel,peduncle,per,petiole,poricidal,purple,red,rounded,shrub,simple,sometimes,sparsely,spherical,stellate-pubescent,stem,style,surface,tapering,terminal,tip,tube,unarmed,upper,way,wide,yellow,yellow-green,young	-1/2,-4,.2,0-15,0.1,0.1-0.2,0.2-0.3,0.2-0.5,1-2,1-3-cellular,1-4-cellula,1-4-cellular,1.1-2.7,1.5-2,1.5-5,1/,1/6-1/3,2,2-3,2.5-4,3-4,4-13,5-,5-10,5-6,5-merous,6-10,6-12,8,8-10,8-18,acut,alyx,apar,apically,appressed,blade,branched,concolorous,connivent,curved,deltate,drying,eaf,eed,elongating,equal,faint,flower,foliaceous,free,frui,glabrescen,glabrous,gland-tipped,infructescence,lobe,lobed,longer,mature,midpoint,nflorescence,often,older,one,open,orolla,oung,pair,perfec,pericarp,plurifoliat,porrect,portion,primary,ray,recurved,red-brow,reflexed,ruit,scandent,scar,sessile,shorter,slender,smooth,somewhat,spaced,spreading,stalk,stalked,stellate,strongly,tamen,terete,tertiary,time,trichome,unarme,unit,variously,vary,vein,venation,visible,woody,ympodial	1/4,arrangement,branch,characteristic,colour,corolla,exertion,form,glabrousnes,growth,height,inflorescence,lobing,na,new,number,ovary,plant,red-brown,seed,shape,size,stigma,texture,type
372	wfo-0001030219	success	191	135	90	101	45	0.471	0.1â0.3,0.2â2.3,0.5,0.5â,0.7â1.1,1.0â2.2,1.5,1.6â,2.0â2.5,2.0â3.2,2.4â6.0,2â,2â3,3,4.8â11.5,4â5,4â7,60,6â8,9â10,abaxially,adaxially,anther,anthesi,base,black,blue,branched,brown,calyx,cm,decurrent,deeply,densely,diameter,elliptic,filament,flattened,flower,fruit,glabrescent,glabrous,globose,green,hair,incised,indistinct,lanceolate,leaf,lilac,lobe,long,margin,marking,mm,moderately,multicellular,number,oblong,olive,ovate,pair,pale,paler,pedicel,peduncle,perennial,petiole,pitted,pubescent,purple,regularly,shallowly,shrub,simple,size,spaced,sparsely,stigma,style,surface,time,tube,unicellular,uniseriate,velutinous,winged,woody,x,â9.5	0.4â1.0,0.8â3.0,0â,1.0â1.2,1.0â1.5,1.0â2.0,1.3â2.9,1.4â2.8,10,15,1â2.5,2.0â5.5,2â2.5,2â4.5,4.5â5.5,5,5â,5â8,6â,6â10,7â11,8â18,9â12,abaxiall,acut,acute,adaxiall,adnate,ag,along,anisophyllous,apart,apex,apical,apparently,appearing,arising,arranged,articulated,axe,ba,basal,blade,bractâlike,cell,chartaceous,clavat,concave,connivent,convex,cylindrical,decreasing,diamete,difoliate,directed,distally,eaf,eed,equal,erect,geminat,internode,longitudinal,lower,nflorescence,opening,opposed,oppositely,orolla,pentagonal,perfect,pore,present,procumbent,rapidly,redâpurple,rounded,ruit,serrate,sessile,sid,side,smaller,split,stone,straight,stripe,strongly,tal,tamen,tem,two,unit,vary,white,wide,wing,yellow,ympodial,â3.0,â7.0	appearance,arrangement,border,branch,bud,characteristic,clavate,colour,corolla,distal,drying,exertion,form,fruiting,giving,glabrousnes,growth,height,history,inflorescence,interjected,lateral,leaflet,length,life,lobing,mentioned,na,new,opposite,ovary,per,plant,prickle,primary,pseudostipule,seed,shape,stem,terminal,texture,type,variation,vein,width
373	wfo-0001030225	success	155	124	73	82	51	0.471	-30,.5-2.5,1,1-4,1-6,10-15,10-30,2-18,2-3,2-6,3-11-compound,3-20,3-5,4-5,8-15,acuminate,acute,apex,apical,basal,base,bilobed,calyx,cm,conivent,cordate,cuneate,deltate,densely,diameter,elliptic-ovate,entire,expanded,flower,forked,fruit,glabrous,gland,globose,leaf,leaflet,less,lobe,long,margin,mm,moderately,narrowly,oblong,obtuse,pedicel,peduncle,petiole,pinnately,possibly,puberulent,purple,shallowly,shrub,simple,small,sparsely,stigma,style,succulent,tip,tree,triangular,truncate,tube,two,unbranched,x	-1.5,-11,-4,-45,-7,.5,0,0-20,0-5,1.5,1.5-2.5,2,2-2.5,3-4,3-foliat,abaxially,absent,adaxially,apart,ape,apically,articulated,ature,axe,beyond,blade,campanulate,color,compound,connective,coriaceous,cylindrical,dilated,directed,distally,eaf,eed,equal,especially,exceeding,exserted,fleshy,glabrate,immature,laterally,leaving,lower,minutely,nflorescence,nther,one,orolla,papillose,perfect,pore,prominent,puberulen,rachi,radiu,scar,see,seen,slightly,somewhat,spaced,stalked,stamen,stellate,strongly,tal,tem,thecae,time,tomento,toward,ud,unit,unknow,unknown,vary,wide,ympodial	anther,appearance,arrangement,bark,border,branch,bud,characteristic,colour,corolla,corrugation,distal,drying,exertion,filament,form,fruiting,giving,glabrousnes,growth,height,history,inflorescence,interjected,lateral,length,life,lobing,midpoint,na,new,number,ovary,per,plant,prickle,primary,pseudostipule,ray,seed,shape,size,stem,surface,terminal,texture,thicknes,type,variation,vein,width
374	wfo-0001030250	success	169	104	83	86	21	0.491	/4,0.5-1,1-1.5,1-3,1.1-1.2,1.1-3.5,1.4-1.5,1.7-7,1.9-2.6,2.1-6,4-7,5-50-flowered,5-6,anther,bark,base,berry,brown,bullate,calyx,capitate,cm,conical,corolla,curved,dark,decurrent,dia,dry,elliptic-ovate,exerted,fruiting,glabrous,globose,green,greenish-white,greenish-yellow,horizontally,inflorescence,leaf,lobe,lobed,long,minor,minutely,mm,node,ovary,ovoid-reniform,pale,papillose,pedicel,pendulous,petiole,pit,pitted,sea-green,seed,shallow,shape,shaped,shrub,simple,size,slender,slightly,soon,specimen,spreading,stem,stigma,straight,style,surface,tan,tapering,tear-drop,translucent-green,tube,way,white-lenticellate,winged,x	.5,0-seeded,1.25-1.5,11.2-22,11.3,2-2.5,2.5-3.25,25,3-5,3.4-6.6,3.5-4,6-8,across,anthesi,apart,apex,appearing,arching,attenuate,beginning,beneath,broadly,carinate-hooded,consisting,cuneate,cup-shaped,deflexed,differing,difoliate,eaf,edicel,eed,elliptic,filament,five,free,fresh,geminat,glabrou,inflorescenc,irregularly,lateral,lon,long-acuminate,lower,main,major,maturity,middle,n,nflorescence,occasionally,older,one,opposite,orbicular,orbiculate,pair,paler,papillo,pore,poricidal,portion,projection,prominent,proximal,raised,reflexed,rim,ruit,scar,smooth,spaced,tall,tip,translucent,two,ud,unit,usually,vein,white-lenticellat,wide,widest,woody,ympodial	abaxial,adaxial,alternate,arrangement,bud,characteristic,colour,diameter,exertion,form,fruit,growth,height,history,length,life,lobing,perennial,plant,texture,type
375	wfo-0001030271	success	195	131	105	90	26	0.538	0-2,0.15-0.75,0.5-1.2,0.7-9.5,0.9-2.5,0.9-3.6,1-2,1-2.5,1-3,1-7,1.4-2.1,1.9-6.6,15-61,2-2.7,2-3,2-4,2-6,2.4-5.6,3-10,3-5,3.4-7.5,4-22,4-7,5-8,5.6-12.3,6-15,acumen,acute,anther,apex,attenuate,base,berry,blade,blue,brownish,clavate,cm,coloration,completely,condition,connivent,coriaceous,corolla,dark,deep,diameter,drying,edge,erect,filament,flat,flower,forked,fresh,fruit,glabrous,green,greenish,herb,interjected,lanceolate,lateral,leaf,leaflet,light,lilac,lobe,long,medium,mm,moniliform,mottled,mucilaginous,odd-pinnate,ovate,ovoid,pedicel,peduncle,pentagonal,perfect,petiole,petiolulate,plant,purple,ripe,rotate,rounded,seed,size,slightly,spot,stigma,straight,style,terminal,tube,tuber,vein,wet,white,whitish,wide,x,yellow	1-4,1-6,5-merou,abaxially,adaxiall,adaxially,ag,along,alyx,apart,apparently,arranged,articulated,asymmetric,axe,axillary,basiscopic,bead,bud,capitat,cell,considerably,covering,decreasing,digestion,distal,dorsally,eaf,eed,elliptic,enzyme,exceeding,folded,geminat,generally,glabrou,green-white,habi,hair-like,half,homostylous,honeycomb-shaped,larger,lengthening,like,linear,living,lower,make,middl,multiple,necklace,nflorescence,orbicular,orolla,pair,plurifoliate,pore,poricidal,removed,rosette,ruit,sessile,seudostipule,side,slit,sometimes,spaced,specimen,stamen,stolon,subtending,symmetric,tall,tamen,tem,testal,thick,throughout,tip,tissue,toward,tri-,typically,unit,unwinged,usually,vary,wall,ympodial	abaxial,adaxial,arrangement,articulation,calyx,capitate,colour,connivence,form,glabrousnes,growth,height,history,inflorescence,length,life,middle,number,ovary,pseudostipule,shape,spacing,stem,surface,texture,type
376	wfo-0001030272	success	179	119	101	78	18	0.564	.3,.5,/4,0.5-1,0.5-1.5,0.6-0.9,0.65-1,0.7-2.5,0.8-1.5,1,1-1.5,1-2.8,1.2-1.8,1.5-2.5,1/3,2-6.5,2.5-3.5,2.8-3.5,4-6,4-8,acute,almost,anther,apex,apically,apparently,articulated,base,berry,bright,calyx,cm,concolorous,deltate,densely,diameter,drying,elliptic,entire,erect,evenly,filament,flattened-reniform,flower,fruit,fruiting,glabrescent,glabrous,glandular,green,hair,lateral,leaf,length,less,long,long-attenuate,margin,maturity,mauve,membranous,minute,mm,near,obtuse,orange-brown,pair,pedicel,peduncle,petiole,poricidal,primary,red,red-brown,rounded,shallowly,shrub,simple,slender,sometimes,sparsely,spherical,stellate-pubescent,stem,straight,style,surface,tapering,terete,terminal,tip,trichome,tube,unarmed,unbranched,undulate,upper,vein,way,wide,young	-6,0-20,0.05-0.1,0.05-1.5,0.5-2,1.5-3,1/3-2/3,10-20,2-2.5,2.5-3,3-8,3.5-5,4-10,4-15,5-7,5-merous,abaxially,acut,alyx,ame,apar,ba,bark,blade,c.,connivent,difoliate,eaf,eed,elongating,equal,free,geminat,glabrescen,gland,gra,infructescence,lobe,lobed,longer,lower,mature,midpoint,moderately,multangulate,narrow-deltate,nflorescence,older,one,open,orolla,oung,per,perfec,pericarp,porrect,portion,ray,reduced,reflexe,ruit,scar,sessile,shorte,smooth,spaced,spreading,stellate,tamen,tertiary,time,unarme,unit,vary,venation,visible,woody,ympodial	arrangement,characteristic,colour,corolla,form,glabrousnes,growth,height,inflorescence,lobing,new,ovary,plant,seed,shape,size,texture,type
377	wfo-0001030287	success	150	131	104	46	27	0.693	-11,-40,0-15,0.5-1,1,1-10,1-15,1-2,1-2.5,1-3,1-4,1-5.5,1.5-2.5,1966,2,2-,2-12,2-5,2.5-4,3,3-9,4-5,4.5-6,5-10,8-13,acute,apart,apex,articulated,base,bluish,branched,calyx,chartaceous,cm,compound,cylindrical,deltate,dendritic,dendritically,densely,diameter,directed,down,eglandular,ellipsoidal,elliptic-ovate,entire,fide,flattened,flower,forked,glabrous,gland,glandular,hair,herb,lanceolate,leaf,lilac,lobe,long,long-stalked,margin,membranaceous,mm,moderately,narrowly,oblong,often,ovoid,pedicel,pedicellar,peduncle,petiole,pinnately,pore,puberulent,pubescent,purple,rachi,radiu,rugulose,scar,scattered,shrub,simple,slightly,smith,stalked,stellate,stigma,strongly,style,subcordate,subcoriaceous,tip,triangular,truncate,tube,unbranched,unknown,x,yellow	-foliat,-many,.5-2.5,1.5-10,2-10,4-6,?,abaxially,adaxiall,adaxially,aggregate,axe,basiscopically,blade,cell,color,connivent,decurrent,dendritic-pubescen,distall,eaf,eed,lateral,leaflet,leaving,lon,lower,nflorescence,nther,obtuse,orolla,presen,ruit,spaced,sparsely,sparser,stone,subcapitat,tal,tem,time,unit,upper,vary,wide,ympodial	abaxial,adaxial,anther,arrangement,articulation,characteristic,colour,corolla,dendritic-pubescent,direction,distally,form,fruit,growth,height,inflorescence,length,ovary,plant,seed,shape,size,spacing,stem,subcapitate,surface,texture
378	wfo-0001030300	success	235	136	106	129	30	0.451	-7,0.4-0.5,0.5,0.5-0.6,0.5-4,0.7-1.2,0.9-1,1,1-1.3,1-2,1-4,1.4-2.4,2-2.1,2-2.5,2-foliate,2-locular,3/4,4-11,almost,anther,anthesi,apex,appendage,articulated,basal,base,bifid,brittle,broadly,brown,calyx,capitate,cm,cordate,corolla,crenate,curved,deltate,densely,diameter,distal,ellipsoidal,elliptical,elongate,entire,filament,finely,fruit,fruiting,glabrous,globose,golden,green,hair-like,halfway,herb,imparipinnate,inflorescence,interrupted,introrse,irregularly,large,less,like,long,margin,mm,obovate,occasionally,once-branched,orbicular,outgrowth,ovary,pale,pedicel,peduncle,pentagonal,perennial,petiole,plant,population,pore,primary,pubescent,rounded,simple,slightly,sparsely,spathulate,stem,stigma,strongly,style,surface,thick,triangular,tube,unit,united,vein,wide,woody,yellow,yellowish,yellowish-green,zygomorphic	-0.9,-1,.5,0.1,0.1-0.15,0.15-1,0.2,0.2-0.5,0.2-1.5,0.4-1.5,0.4-4.5,0.5-1,0.5-5,0.6-0.7,0.6-0.8,0.7-0.8,0.7-1.5,0.8-1,0.8-3,0.8-4,1-2-celled,1-6,1-celled,1.2-,1.5-,1.5-2.5,2-3,2-4,2.2-7.5,3.5-13,4-celled,6-15,6-8-celled,9-12,abaxially,absent,abundant,acute,adaxial,adaxially,although,always,apical,appearance,articulation,ba,bent,beyond,bract,bracteate,cell,coherent,column,crenat,developed,diamete,eaf,edicel,eed,eglandular,even,exserted,face,flower,frequently,give,glandular,glutinous-viscose,gree,head,interjected,internode,lamina,larger,lateral,leaflet,leave,lobe,lon,longer,markedly,midvein,minute,moderately,multicellular,narrowly,nflorescence,node,oblique,pair,papillae,partially,petal,petiolule,pith,present,pseudostipule,pubescence,reflexed,rest,ruit,secondary,silky,spreadin,spreading,staminal,sterile,straight,tall,tem,terminal,tertiary,testa,tip,trichome,two,ud,underlying,unicellular,uniseriate,upper,usually,velvety,wall,weak,well,wider,winged,ympodial	1.2-7.5,1.5-13,arrangement,bark,branch,bud,characteristic,colour,corrugation,drying,exertion,form,glabrousnes,growth,height,history,leaf,length,life,lobing,na,new,number,per,seed,shape,size,sympodial,texture,type
379	wfo-0001030311	success	182	131	87	95	44	0.478	.2,0.6â1,0.8â1.2,1.2â7,1.5â5.5,1.5â8,1.8â2,15â22,1â1.5,1â2.5,1â3,2.2â2.5,2.2â3,2â2.5,2â6,3â5,5-pinnate,5â10,acuminate,acute,anther,apex,appearance,base,berry,brown,calyx,chartaceous,clavate,cm,cordate,deltoid,densely,diameter,distal,entire,extra-axillary,filament,flattened,flower,fruit,fruiting,giving,glabrous,granular,green,half,herbaceous,lateral,leaflet,lenticular,lobe,lower,margin,membranaceous,membranous,minutely,mm,oblique,obtuse,orangish,ovoid-rhomboid,papillose,pedicel,peduncle,petiole,pubescent,purplish,rounded,sand-punctate,slender,slightly,sparsely,stellate,stem,stigma,style,surface,tan,thickened,tip,tube,unbranched,vein,vine,white,x	.5,.5â1.8,0.1,0.1â0.2,0.3â1.5,0.4â2,0.5â0.8,0.5â1,0.5â2,0.5â2.5,0.6â2.4,0.8â4,0.8â4.5,1.5â2,1.5â3,1.5â6,1â1.2,1â2,2.5â9,2â10,3â7,<,abaxially,accrescent,adaxial,adaxially,along,alyx,apar,apical,axe,basal,blade,c.,capitat,ciliat,ciliate,color,cuneate,dense,eaf,eed,elliptical,especially,falcate,fallen,glabrou,groov,groove,ground,hair,lanceolate,like,log,lon,long,m.,midvein,nflorescence,nternode,obovate,occasionally,orolla,pair,petiolulate,petiolule,plurifoliat,present,proximal,pubescence,rachi,rhomboid,ruit,scattered,sessile,short,shortly,side,smaller,spaced,strongly,tamen,tem,terrestrial,thick,thinner,trailing,trichome,unit,upper,vary,wide,wide-diameter,widely,ympodial	0.5,arrangement,bark,border,branch,bud,capitate,characteristic,colour,corolla,corrugation,drying,exertion,form,glabrousnes,growth,height,history,inflorescence,interjected,leaf,length,life,lobing,midpoint,na,new,number,ovary,per,plant,prickle,primary,pseudostipule,ray,seed,shape,size,terminal,texture,thicknes,type,variation,width
380	wfo-0001030311	success	203	123	79	124	44	0.389	.2,0.4-2,0.6-1,0.8-1.2,0.8-4,1-1.5,1-2.5,1-3,1.2-7,1.5-2,1.5-5.5,1.5-8,1.8-2,15-22,2-2.5,2-6,2.2-2.5,2.2-3,3-5,5-10,5-pinnate,absent,adaxial,anther,appearance,basally,base,brown,chartaceous,cm,cordate,densely,diameter,distal,entire,filament,flattened,flower,fruit,giving,glabrous,granular,green,half,herb,interjected,lateral,leaflet,lenticular,lobe,long,lower,margin,membranaceous,minutely,mm,oblong,orangish,ovoid-rhomboid,papillose,pedicel,peduncle,petiole,plurifoliate,pubescent,purplish,slender,sparsely,stem,stigma,style,surface,tan,trailing,tube,unbranched,vein,white,x	.5,.5-1.8,0-2.5,0.1,0.5-0.8,0.5-1,0.5-2,0.6-2.4,0.8-4.5,1-1.2,1.5-3,1.5-6,2-10,2224,3-7,5-merou,8031,<,[,],abaxially,absen,accrescent,acuminate,acute,adaxially,ag,aggregate,along,alyx,apart,apex,apical,apparently,articulated,axe,ba,basal,blade,capitat,cell,ciliat,ciliate,clavate,color,connivent,cuneate,deltoid,dense,dig,directed,distally,eaf,eed,elliptical,equal,especially,falcate,fallen,formation,g,geminat,gh,groov,groove,ground,hair,large,like,log,lon,longitudinal,m.,midvein,nflorescence,node,oblique,obovate,obtuse,occasionally,opening,orolla,pair,perfect,petiolulate,petiolule,pittier,pore,present,proximal,rachi,rhomboid,rooting,rounded,ruit,scattered,sessile,short,shortly,side,simple,sinple,slightly,slit,smaller,spaced,stellate,stone,strongly,tamayo,tamen,tem,thick,thickened,thinner,tip,uniseriate,unit,upper,vary,wide,widely,yellow,ympodial	0.5,abaxial,arrangement,bark,border,branch,bud,calyx,capitate,characteristic,colour,corolla,corrugation,drying,exertion,form,fruiting,glabrousnes,growth,history,inflorescence,leaf,length,life,lobing,midpoint,na,new,number,ovary,per,prickle,primary,pseudostipule,ray,seed,shape,size,terminal,texture,thicknes,type,variation,width
381	wfo-0001030335	success	153	140	112	41	28	0.732	.25,.75,0-5,0.05-0.2,0.1-0.5,0.25-0.5,0.5-1,0.7-1,1-1.5,1-2,1-3-flowered,1.1-1.4,2-2.2,2-4.5,2-5,3/4,5-6,5-7,7-13,acuminate,acute,along,anther,anthesi,apex,bark,base,beneath,berry,bi-lobed,branch,bud,calyx,cm,conical,corolla,dark,deciduous,decurrent,densely,dia,dry,elliptic,erect,exserted,filament,filiform,flattened,fruiting,gently,giving,glabrous,globose,green,greyish-red,horizontally,lateral,leaf,lightly,like,lobe,lobed,long,main,material,minute,minutely,mm,narrowly,obovoid,often,older,onto,opposite,ovary,ovoid-reniform,pair,pale,papillose,pedicel,petiole,pitted,pore,poricidal,puberulent,pubescent,reflexed,ripe,shaped,shrub,simple,soon,spreading,stem,stigma,strongly,style,surface,tan,tapering,tear-drop,tip,trichome,tube,uniseriate,vein,way,white,winged,x,yellowish-green,young	.1,.5,1.1.5,2-2.5,2.5-3,aspec,ba,deflexed,deltoid,eaf,edicel,eed,except,expanded,free,geminate,lamina,lenticellate,lon,lower,middle,nflorescence,occasionally,papillo,portion,prominent,puberulen,raised,ruit,slightly,sparsely,straight,tall,ud,underside,unifoliat,unit,widest,woody,yellow,ympodial	arrangement,aspect,characteristic,colour,diameter,exertion,form,fruit,glabrousnes,growth,height,history,inflorescence,length,life,lobing,margin,na,new,peduncle,plant,primary,seed,shape,size,texture,type,unifoliate
382	wfo-0001030336	invalid_json	266	226	184	82	42	0.692	-1.5,-10,-19,-2,.5,0.1-1,0.15-0.2,0.2-1,0.2-1.5,0.5,0.5-0.7,0.8-1.3,1,1-1.5,1-3,1-celled,1.0-1.4,1.5-,1.5-2,1.5-5,1.6-7,1.7-2.3,1.8-3.0,1/4-1/3,10,2-foliate,2-locular,2/3,4-,4-10,4-celled,8-16,8-20,8-celled,acute,adpressed,almost,amongst,anther,anthesi,apex,appearance,articulated,basal,base,basiscopically,bent,bifurcate,bluntly,bract,bracteate,branch,bright,brown,calyx,capitate,cell,cm,coat,conical,cordate,corolla,crenate,curved,dark,darker,decurrent,deeply,densely,diameter,distal,divided,eglandular,elliptic,elongate,entire,essentially,exserted,filament,first,flower,flushed,fruit,fruiting,giving,glandular,globose,grayish,green,greenish,hair-like,half,halfway,head,herb,imparipinnate,inflorescence,interjected,internode,interrupted,lanceolate,largest,lateral,leaf,leaflet,less,like,lobe,lobed,long,longer,margin,markedly,midvein,minutely,mixed,mm,mostly,node,oblique,obovate,occasionally,once-branched,orbicular,outgrowth,ovary,pale,part,pedicel,peduncle,perennial,petiole,population,present,primary,proximal,pseudostipule,puberulent,pubescent,purple,rachi,range,rest,rotate,rounded,scattered,shaggy,shorter,silky,simple,slightly,sometimes,southern,sparse,stellate,stem,stigma,strongly,style,surface,surrounding,ten,terminal,testa,thick,tip,trichome,truncate,tube,two,unicellular,uniformly,uniseriate,unit,upper,usually,velvety,wall,way,white,wide,woody,yellow,young	0-,0.1-0.3,0.1-0.5,0.1-0.7,0.15-0.9,0.2,0.2-0.25,0.2-0.8,0.3-0.4,0.3-1.1,0.5-1,0.5-1.5,0.6-0.8,0.6-1.5,0.8-0.9,0.8-1.2,0.8-3,1-1.4,1.5-3.5,2-4,2-9,3-5,4,6,absent,apical,appearing,appendage,articulation,berry,clavat,column,completely,developed,diamete,eaf,edicel,eed,entir,erect,extremely,glandula,investing,large,larger,leave,lon,loosely,lower,maturity,mere,middl,minute,narrowing,narrowly,nflorescence,often,pair,papillate,petiolule,reflexed,ruit,secondary,sessile,shrub,sinus,small,soft,spreadin,spreading,staminal,sterile,straight,stripe,tall,tem,tertiary,ud,united,weak-walled,winged,ympodial	'',0-2,[,``,arrangement,bark,bud,characteristic,clavate,colour,corrugation,drying,exertion,form,glabrousnes,growth,height,history,length,life,lobing,middle,midpoint,na,new,number,per,plant,ray,seed,shape,size,sympodial,texture,thicknes,type,value,variation,vein,width,{,}
383	wfo-0001030342	success	155	107	83	72	24	0.535	.2,1.2â3,1.5â13,1.5â5,1.5â7.5,10â25,1â1.5,1â2.5,1â3,1â7,2â,2â2.5,2â4,3,3-pinnate,4â5,6â7,abundant,acuminate,acute,adaxially,along,anther,apex,berry,brown,calyx,chartaceous,cm,cylindrical,deltoid,dense,diameter,entire,extra-axillary,filament,flattened,flower,fruit,glabrous,greenish,herbaceous,lanceolate,leaf,lenticular,light,like,long,margin,membranous,minutely,mm,mottled,often,ovoid-rhomboid,pedicel,peduncle,petiole,pointed,pubescent,rarely,revolute,scattered,slender,smooth,stem,stigma,style,surface,tip,trichome,truncate,tube,unbranched,undulate,vein,vine,white,wide-diameter,widely,x,yellowish,â7	.5,0.1â0.2,0.3â1.2,0.5â1,0.5â3,0.5â5,0.8â1.5,0.8â4,1-5,1-6.5,1.5,1.5â2,1â1.2,1â5.5,1â6,3â12,4â8,5-merous,abaxially,accrescent,alyx,apar,apical,apiculate,axe,base,blade,broadly,c.,capitat,ciliat,cordate,cuneate,eaf,eed,elliptical,fruiting,glabrou,lateral,leaflet,lobe,lon,lower,m.,nflorescence,nternode,oblique,obtuse,orolla,perfec,petiolule,plurifoliat,proximal,pubescen,rachi,rhomboid,rounded,ruit,sand-punctate,side,slightly,spaced,sparsely,stellate,tamen,tem,terrestria,truncate-acuminat,unit,vary,wide,ympodial	abaxial,arrangement,capitate,characteristic,colour,corolla,exertion,form,glabrousnes,growth,history,inflorescence,length,life,lobing,new,ovary,primary,seed,shape,size,terrestrial,texture,type
384	wfo-0001030342	success	153	105	83	70	22	0.542	.2,.5,0.5-5,0.8-4,1-1.5,1-5.5,1-6,1-6.5,1-7,1.5-13,1.5-2,1.5-5,1.5-7.5,10-25,2-3,3-12,3-pinnate,4-5,absent,acuminate,acute,anther,apical,basally,blade,broadly,brown,calyx,chartaceous,cm,cylindrical,deltoid,diameter,elliptical,entire,extra-axillary,filament,flower,glabrous,hair,herb,interjected,lateral,leaf,leaflet,lenticular,light,lobe,long,margin,membraceous,mm,oblong,pedicel,peduncle,perfect,petiole,pubescent,rachi,rarely,rhomboid,rounded,sagittate,scattered,simple,slender,smooth,stellate,stigma,style,surface,terrestrial,tip,truncate,tube,unbranched,undulate,uniseriate,white,wide,widely,x,yellow	-7,0.5-1,0.5-3,1-1.2,1-3,1-5,1.2-3,2-,2-2.5,3,4-8,5-merou,6-7,abaxially,abundant,accrescent,adaxially,ag,along,alyx,apart,apex,apiculate,apparently,articulated,axe,ba,base,capitat,ciliat,connivent,cordate,cuneate,directed,distally,eaf,eed,equal,fruit,fruiting,geminat,lanceolate,longitudinal,lower,minutely,nflorescence,node,oblique,obtuse,opening,orolla,petiolule,plurifoliate,pore,proximal,pubescen,revolute,rooting,side,slightly,slit,spaced,tamen,tem,trailing,truncate-acuminat,unit,vary,vein,ympodial	5-merous,abaxial,adaxial,arrangement,capitate,characteristic,colour,corolla,form,glabrousnes,growth,history,inflorescence,length,life,ovary,seed,shape,size,stem,texture,type
385	wfo-0001030353	success	227	126	98	129	28	0.432	.2,.7,0-6,0.5-0.9,0.8-1.2,1-6,1.2-1.8,1.8-2.2,1.8-3,1/2-2/3,1/3,2.5-4,2.8-3.7,3-4,4-4.5,6-8,abaxial,acute,adaxial,almost,anther,apex,apically,apparently,articulated,bark,base,berry,brown,calyx,chartaceous,cm,cuneate,densely,diameter,discolorous,drying,ellipsoid,elliptic,erect,evenly,filament,flattened-reniform,flower,fruit,fruiting,green,lateral,leaf,length,lobed,long,long-styled,lower,margin,maturity,mauve,mm,moderately,multangulate,narrow-deltate,pair,pedicel,peduncle,per,petiole,plant,poricidal,prickly,primary,red-brown,reddish-green,sessile,shape,short-styled,shrub,simple,small,stellate-pubescent,stem,strongly,style,subentire,surface,tapering,terminal,tip,tree,trichome,tube,unarmed,vein,way,weakly,white-gray,wide,yellow,young	-0.2,-1.5,-1/2,-2,-3,-5,-6,-merous,.1,.5,0,0-15,0-2,0.1-0.2,0.1-0.3,0.15-0.3,0.5,0.8,1,1-2,1-3,1-7,1/,1/5,1/6,1/6-1/4,10-15,11-16,2-10,2-7,20-200,3-5.5,3.5-4,4-,4-5,5,5-6,6,6-15,7-10,8-15,abaxially,alyx,andromonoecious,apar,apart,apiculat,blade,broad-deltate,c.,conical,connivent,curved,deltate,development,distal,distance,eaf,eed,elongating,equal,extending,flattened,free,glabrescent,glabrous,half,hermaphrodite,heterostylous,infructescence,less,lobe,longer,lowermost,mature,midpoint,midvein,nflorescence,older,one,open,orange-brown,orolla,oung,patch,pendulous,pericarp,plurifoliat,pointed,porrect,portion,prickle,ray,reflexed,retaining,rounded,ruit,scar,shorter,side,smooth,sometimes,somewhat,spaced,sparsely,spreading,stalk,stalked,staminat,stellate,stout,straight,tamen,terete,tertiary,throughout,time,unarme,unbranched,unit,upper,vary,venation,visible,warty,whit,wo,woody,ympodial	30,4-6,apiculate,arrangement,branch,bud,characteristic,colour,corolla,exertion,form,glabrousnes,growth,hair,height,inflorescence,lobing,na,new,number,ovary,seed,size,stelate,stigma,texture,type,white
386	wfo-0001030407	success	182	141	117	65	24	0.643	.2,.5,0.7-3.2,1-10,1-2,1.5-5,12-14,2-5,2-6.7,2-7,3-10.5,3-4,3-6.5,3-9,3.5-9.5,30-60,4-5,5,6-7,6.5-18.5,7-8,abaxially,acumen,acuminate,adaxially,anther,apart,apex,articulated,axillary,base,berry,blade,brownish,bud,cell,chartaceous,ciliate,cm,condition,conical,connivent,corolla,covering,densely,diameter,distal,dorsally,drying,edge,end,filament,flat,flower,folded,forked,fresh,fruit,generally,glabrous,green,green-white,greenish,hair,hair-like,half,herb,homostylous,lanceolate,lateral,leaf,leaflet,light,like,lobe,long,make,margin,middle,minute,mm,mottled,mucilaginous,obtuse,odd-pinnate,one,ovoid,pedicel,peduncle,pentagonal,petiole,placed,plant,proximal,pubescent,purple,ripe,round,seed,size,style,subtending,terminal,testal,thick,throughout,tube,tuber,typically,unwinged,usually,wall,wet,whitish,wide,x,yellow	1-3,1-4,12-15,2-2.5,5-merou,absent,ag,alyx,apparently,axe,capitat,decreasing,digestion,eaf,eed,elliptic-lanceolate,enzyme,especially,exceeding,geminat,glabrou,gradually,honeycomb-shaped,interjected,larger,lengthening,living,lower,nflorescence,orolla,ovate,pair,perfect,petiolule,plurifoliate,pore,poricidal,pubescen,ray,removed,ruit,secondary,semierec,seudostipule,slit,spaced,specimen,stamen,ste,stigma,stolo,subequal,subsessile,symmetrical,tall,tamen,tem,thir,tip,toward,tri-,unit,vary,white,ympodial	arrangement,articulation,calyx,capitate,colour,form,growth,height,history,inflorescence,length,life,ovary,placement,pseudostipule,shape,spacing,stem,stolon,surface,texture,third,type,width
387	wfo-0001030420	success	170	139	87	83	52	0.512	-2,-20,-30,-pubescent,0.5-,0.5-1,0.5-4,0.5-8,1,1-1.5,1-2,1-3,1-4,1-7.5,1.5-5,10-,15-25,2-,2-14.5,2-9,3-lobed,4-7,5-15,acuminate,acute,also,apex,basal,base,beyond,calyx,chartaceous,cm,connivent,cordate,deltate,densely,diameter,eglandular,ellipsoidal,elongated,entire,exserted,flower,forked,fruit,glabrate,glabrous,glandular-,lanceolate,leaf,lobe,lobed,long,margin,mm,moderately,narrowly,obtuse,often,pedicel,peduncle,petiole,pinnately,puberulent,pubescent-pilose,purple,rarely,shrub,simple,small,sparsely,stamen,stigma,style,subcoriaceous,tip,tree,triangular,truncate,tube,unbranched,unknown,unlobed,vein,x,yellow	-35,-4,-9,1-,1-6,1.5-3,1/2,10-25,2-3,2-5,2-6,3-7,4-foliat,5-,5-6,6-7,7-19,7-22,7/8,abaxially,absent,adaxially,aggregate,apart,ape,articulated,axe,blade,cell,color,connective,cylindrical,dark,directed,distally,divided,eaf,eed,eglandular-pilo,eglandular-puberulent,elliptic-ovate,equal,glandular-puberulent,hair,leaving,lon,lower,midrib,nearly,nflorescence,nther,orolla,ovate,pedicellar,perfect,pilose,pore,presen,puberulent-pubescent,pubescent,pubescent-pilo,rachi,radiu,remnant,ripe,ruit,shorter,sinus,spaced,stellate,stone,tal,tem,thecae,time,tomento,truncat,ud,unit,vary,wide,yello,ympodial	anther,appearance,arrangement,bark,border,branch,bud,characteristic,colour,corolla,corrugation,distal,drying,eglandular-pilose,exertion,filament,form,fruiting,giving,glabrousnes,growth,height,history,inflorescence,interjected,lateral,leaflet,length,life,lobing,midpoint,na,new,number,ovary,per,plant,prickle,primary,pseudostipule,ray,seed,shape,size,stem,surface,terminal,texture,thicknes,type,variation,width
388	wfo-0001030426	success	158	112	88	70	24	0.557	-30,0.3-7,0.3-8,0.4-0.7,1-4,1-4.2,1.5-3,1.7-3.2,10,15-25,2,2-3,2.5-4,2.5-6,3-4,3-6,4-10,4-6.5,6-11.5,6-8,9,apical,apically,apiculate,branched,calyx,caudate,cell,cm,connate,corolla,covering,cyme,dehiscent,diameter,dichasial,dichasially,distal,ebracteate,exceeding,filament,forked,generally,glandular,globose,hair-like,half,heart-shaped,herbaceous,interjected,introrse,lateral,leaf,leaflet,lobe,long,make,maturing,mm,monochasial,mucilaginous,oblong,odd-pinnate,often,ovoid,pedicel,peduncle,perennial,petiole,pilose,plant,poricidally,seed,short,size,slit,stamen,stellate,stigma,straight,style,terminal,testal,thick,wall,white,wide,yellow	1.5-6.5,3-12,3-6-foliat,abaxially,absen,acumen,acute,adaxially,apex,articulate,base,decurrent,digestion,diminishing,dorsally,eaf,edge,eed,elliptic-lanceolate,emoval,enzyme,flat,flower,folded,globo,gradually,green,green-white,honeycomb,lanceolate,larger,linear,linear-lanceolate,linear-oblong,living,lon,lower,nflorescence,nther,oblique,obtuse,orolla,pair,pattern,perfect,pinnatifi,plan,proximal,rachi,reveal,rounded,ruit,second,sessile,seudostipule,specimen,spot,stripe,tal,tem,throughout,toward,tuber-bearing,typically,unit,vary,whit,without,ympodial,Â¼	abaxial,absent,adaxial,anther,arrangement,colour,form,fruit,growth,height,history,inflorescence,length,life,ovary,pinnatifid,pseudostipule,shape,stem,surface,texture,type,wet,width
389	wfo-0001030430	success	171	105	85	86	20	0.497	.2,0.5â12,0.8â3.0,0.8â5.6,0â20,1.0â2.0,1.3â8.0,1.4â1.5,1.6â1.8,12â20,2â3,30â200,3â17,3â4,3â5,3â8,5â10,5â6,acute,anther,anthesi,apex,axillary,base,blade,blue,borne,branched,brittle,brown,calyx,capitate,clavate,cm,connivent,decurrent,densely,diameter,equal,filament,flattened,fleshy,fruit,glabrous,globose,green,leaf,lobe,lobed,long,margin,mm,moderately,oblong,occasionally,pair,pale,pedicel,peduncle,pentagonal,perennial,petiole,pitted,poricidal,pubescent,purple,regularly,rounded,shallowly,shoot,shrub,simple,stigma,style,subglabrous,surface,terminal,time,tip,tube,violet,white,woody,x,yellow	.5,0.25,0.3,0.4,0.5,0.6,0.6â0.8,0.6â1.0,0.9â1.0,1.0â1.2,1.0â1.5,1.2â2.0,1.5â1.7,1.8â5.0,12â30,1â3,1â9,2.0â3.0,2.0â4.2,3.0â4.5,3â24,5,5.5â12,6â10,abaxially,abundant,adaxiall,adaxially,ag,apart,apical,appressed,articulated,axe,ba,basal,bud,cell,chartaceous,convex,cylindrical,dentate,diamete,eaf,eed,elliptic,erect,especially,few-seeded,flower,geminat,hair,indumentum,lon,longitudinal,lower,m.,multicellular,nflorescence,opening,orolla,ovate,perfect,pore,present,ruit,serrate,shaped,side,slit,spaced,stone,straight,tal,tamen,tear-drop,tem,toward,unifoliate,uniseriate,unit,vary,wide,ympodial,â2.7,â40	arrangement,characteristic,colour,corolla,form,growth,height,history,inflorescence,length,life,lobing,ovary,plant,seed,shape,size,stem,texture,type
390	wfo-0001030441	invalid_json	178	146	111	67	35	0.624	+,.5,0.5,0.5-0.75,0.5-1,0.5-3,1,1-1.4,1-2-celled,1.2-1.4,10-40,2,2-10,2-5.5,2.5,30,5-7.5,6-11,<,>,acuminate,acute,along,anther,anthesi,apex,attenuate,base,berry,branched,bright,c.,calyx,capitate,cell,cm,corolla,decurrent,diameter,ellipsoid,elliptic,entire,exerted,eye,filament,flattened,flexuous,flower,fruiting,glabrous,glandular,globose,green,growth,hair,lateral,lobe,lobed,long,making,many,margin,membranous,midvein,minutely,mm,narrowly,new,occasionally,onto,open,pale,pedicel,peduncle,per,petiole,plant,poricidal,pubescent,red,reniform,ridged,ripe,shrub,simple,slightly,spot,spreading,stellate,stem,stigma,strongly,style,surface,terminal,thin,time,tip,trichome,tube,undulate,uniseriate,usually,vine,violet,wall,way,white,wide,woody,yellow	1-1.5,1.5-2,2-3,3-4,4-5,5-14,5-6,5-7,5-merou,ag,alyx,apart,ark,articulated,brow,closely,deltate,distall,eaf,eed,free,glabrou,glandula,ilament,impressed,irregularly,juicy,leaving,lengthening,lon,lower,markedly,nflorescence,older,orolla,otherwise,pair,papillat,papillose,peg,perfect,pericarp,plurifoliat,pore,portion,primary,reflexed,ruit,scandent,scar,shiny,short,shrubby,slit,small,somewhat,spaced,spreadin,tem,trailing,triangular,ud,unit,upper,vary,vein,ympodial	'',[,],``,abaxial,adaxial,arrangement,bark,brown,bud,characteristic,colour,exertion,form,fruit,glabrousnes,height,history,inflorescence,leaf,length,life,lobing,number,ovary,papillate,perennial,seed,shape,size,texture,type,value,{,}
391	wfo-0001030444	success	196	121	100	96	21	0.51	0-24,0.15-0.8,0.8-2,1,1-10,1-2,1-4,1-5,1.2-1.8,11-45,2-8,2.3-3.6,2.4-3.8,3-10,3-5,4-17,4-7,5.3-9,6.1-12.8,7.1-17.5,9.4-20.1,anther,berry,blade,blue,brownish,cell,ciliate,clavate,cm,condition,coriaceous,corolla,covering,dark,deep,diameter,dot,drying,elliptic,filament,flower,fresh,fruit,glabrous,green,green-white,greenish,hair-like,herb,homostylous,interjected,lanceolate,lateral,leaf,leaflet,light,lilac,lobe,long,make,margin,medium,mm,moniliform,mucilaginous,narrow,odd-pinnate,ovate,ovoid,pair,pedicel,peduncle,pentagonal,petiole,plant,purple,ripe,rotate,seed,size,sometimes,stigma,straight,style,terminal,testal,thick,throughout,tube,tuber,unwinged,usually,wall,wet,white,whitish,wide,wing,x	1.1-2.7,2-3,2-6,3.7-6.8,4-39,5-merou,abaxiall,abaxially,acumen,acuminate,acute,adaxially,ag,along,alyx,apart,apex,apparently,arranged,articulated,asymmetric,attenuate,axe,axillary,base,basiscopic,bead,bud,capitat,connivent,decreasing,digestion,distal,dorsally,eaf,edge,eed,enzyme,erec,exceeding,flat,folded,forked,geminat,general,generally,glabrou,hal,half,high,honeycomb-shaped,larger,lengthening,like,linear,living,lower,multiple,necklace,nflorescence,orbicular,orolla,perfect,petiolulate,plurifoliate,pore,poricidal,removed,rough,rounded,ruit,sessile,seudostipule,shortly,side,slit,spaced,specimen,stamen,stolon,subequal,subtending,symmetric,tall,tamen,tem,tip,tissue,touch,toward,tri-,typically,unit,vary,yellow,ympodial	abaxial,adaxial,arrangement,calyx,capitate,colour,form,growth,height,history,inflorescence,length,life,ovary,presence,pseudostipule,shape,staman,stem,surface,texture
392	wfo-0001030445	invalid_json	226	124	93	133	31	0.412	0.2-0.4,0.2-0.5,0.6-2.2,1-1.3,1-7,1.3,1.3-2,1.7-2.4,10-14,14,15-35,3-5.4,4.1-8.7,4.2-10,5.9-15,6.1-9.1,7.5-16,8.1-10,abaxially,acuminate,adaxially,anther,apex,bark,base,berry,black,blunt-tipped,branch,branched,bud,calyx,capitate,cm,corolla,decurrent,deltoid-reniform,diameter,drying,elliptic,elliptical,elongated,entire,exserted,ferruginous-tomentose,filament,flower,fruit,glabrate,glabrous,globose,green,greyish-tan,leaf,long,many,margin,midrib,mm,oblong,oblong-lanceolate,obovate,obtuse,orangish-tan,orbicular,ovate,ovate-lanceolate,pedicel,peduncle,petiole,pseudoterminal,reniform,reticulate-punctate,semi-spherical,shrub,side,simple,slightly,small,soon,stem,stigma,style,sulcate,surface,time,tomentose,tree,vein,white,x,yellowish,yellowish-tan	.1,.5,/5-2/3,0.1-0.7,0.2,0.2-0.7,0.3,0.4,0.5,0.6-3.5,0.7,0.8,1,1.1-4.3,1.3-1.8,1.5-2.1,1.6-2,1.8-3.5,10-16,2.1-5.2,2.2-2.9,2.2-3.5,2.4-4.7,3.1-5,3.4-5.6,3.5-4.2,5-125,5-merou,5.2-7.1,5.9-8.3,8.2-18,abaxial,accrescent,acute,ag,along,alyx,apart,appressed,around,articulated,axillary,blade,blunt-tippe,brown,brownish-yellow,bulbous-based,concentrated,cylindrical,directed,distally,eaf,earl,edge,eed,erect,ferruginous,ferruginous-granular,free,fruiting,geminate,glabrescen,hair,high,homostylous,inserted,intermediate,lackin,lateral,lengthening,lobe,lobed,lon,longitudinal,lower,m.,main,midvein,mostly,multangulat,multangulate,nflorescence,obscured,older,open,orange,orolla,plurifoliate,pore,poricidal,porrect-stellat,porrect-stellate,pubescence,pubescent,rachi,ray,relatively,resorption,rounded,ruit,runk,sessile,slit,somewhat,spaced,sparse,sparsely,splitting,stalk,stamen,stellate,stout,subcampanulate,suture,tamen,thick,thick-textured,thicknes,thin,thin-,tip,tissue,tomentum,tube,unarme,unit,vary,vestigial-rayed,way,wide,yellow,ympodial,young	'',[,],``,arrangement,characteristic,colour,exertion,form,glabrousnes,growth,height,history,inflorescence,length,life,lobing,new,ovary,perennial,plant,primary,seed,shape,size,texture,type,unarmed,value,{,}
393	wfo-0001030447	success	276	149	125	151	24	0.453	.2,.3,.5,/5,0,0.4-0.9,0.5-0.65,0.5-10,0.7-1,0.8-1.7,0.8-3.5,1.8-2.5,1/3-2/3,2-4,2.2-2.8,2.5-6.5,3,3-5,30-45Â°,6-10,6-7,6.5-9,7-8,abaxially,acute,anther,apex,apparently,armed,bark,base,berry,calyx,cell,chartaceous,clavate,cm,corolla,cuneate,cupular,curved,development,diameter,discolorous,drying,filament,flat,flattened-reniform,flower,fruit,fruiting,glabrescent,glabrous,globose,irregular,lateral,leaf,length,lobed,long,long-styled,lower,margin,maturity,midvein,mm,moderately,narrow-deltate,obconical,oblique,oblong,often,opening,orange,orange-brown,orange-red,outline,ovate,pair,pale,pedicel,peduncle,per,petiole,pit,porrect,prickle,primary,purple,raised,red-brown,rounded,sessile,shallowly,short-styled,shortly,shrub,simple,small,sometimes,somewhat,spherical,spreading,stalked,stellate,stellate-pubescent,stem,stigma,straight,straw-yellow,style,surface,tapering,throughout,translucent,trichome,tube,unarmed,unbranched,vein,weakly,white,yellow,yellow-orange,Ã	0.1,0.1-0.3,0.15-0.3,0.2,0.2-0.4,0.4-0.7,0.5,0.5-3,1,1-1.5,1-10,1-2,1-2.5,1-3,1-5,1-6,1.5,1.5-2.5,1.5-7,1/3,1/3-1/2,1/4-1/3,2.5-10,3-4.5,4-8,5,5-15,5-merou,6,6-16,6-8,6-9,8,accrescent,adaxially,age,always,alyx,apar,apart,apical,apically,articulated,axe,beyond,blade,branche,broad-deltate,c.,characteristically,covering,dark,deltate,densely,difoliate,distance,divided,eaf,eed,elongating,equal,erect,exserted,extending,filiform,fine,finely,finger-hair,flattened,free,geminat,gently,herbaceous,infructescence,irregula,lengthening,less,lobe,long-ovoi,longer,longitudinal,mature,midpoint,minute,mostly,nflorescence,obtuse,older,one,open,orange-translucent,orolla,oung,papillo,pendulous,perfect,pericarp,persisting,point,pore,poricidal,portion,pronounced,prostrate,pubescent,rachi,ray,reduced,rest,ri,ridge,ridged,ruit,scar,shallow,shiny,shorter,side,sinus,slender,slit,smooth,spaced,sparse,sparsely,stalk,stout,stump,subsessile,tamen,terete,terminal,tertiary,thick,thin,time,tip,toward,ud,unequal,unit,usually,variously,vary,venation,visible,wide,widest,woody,x,ympodial	arrangement,branch,branched,bud,characteristic,colour,exertion,form,glabrousnes,growth,height,inflorescence,lobing,long-ovoid,new,number,ovary,papillose,plant,seed,shape,size,texture,type
394	wfo-0001030453	success	127	63	47	80	16	0.37	.25,.5,/4,0.8-1.5,1-1.3,1-1.5,1.5-1.6,1.5-2.5,3-3.5,4-5,9-14,acuminate,acute,anther,apex,arachnoid-pubescent,attenuate,base,broadly,calyx,clavate,cm,corolla,cup-shaped,densely,elliptic,filament,glabrous,leaf,minutely,mm,narrowly,occasionally,pedicel,petiole,pubescent,shrub,simple,sparsely,stem,stigma,style,surface,tall,tube,way,white	0.25-0.5,9-12,abaxially,adaxially,along,anthesi,arachnoid,axi,bark,closely,dark,deflexed,delicate,deltate,dendritic,dia,divided,eaf,edicel,eed,ellipsoid,especially,exserted,fine,flat,floccose,free,glabrate,know,known,later,lateral,less,lobe,lon,long,lower,main,margin,middle,midrib,minute,near,nearly,nflorescence,older,opposite,ovary,overlappin,pair,papillat,papillose,planar,pore,poricidal,portion,reddish,reddish-brow,rounded,ruit,scar,shaped,shiny,slender,soon,spaced,straight,strongly,tear-drop,tip,trichome,tub,ud,unifoliat,unit,vein,wide,widest,ympodial,young	arrangement,characteristic,colour,diameter,form,growth,history,inflorescence,length,life,lobing,papillate,shape,texture,unifoliate,width
395	wfo-0001030486	success	141	96	72	69	24	0.511	.5,1-1.5,1-5,1.1-1.4,1.7-2,2-3,3-3.5,3/4,4-4.5,5-8-flowered,6-7,anther,bark,basal,base,berry,brown,calyx,clavate,cm,corolla,dark,dia,dry,drying,ellipsoid,elliptic,erect,exserted,f,filament,fleshy,fresh,fruiting,glabrous,globose,green,later,leaf,lobed,long,material,minutely,mm,ovary,ovoid-reniform,pale,papillose,pedicel,petiole,pitted,pore,poricidal,shaped,shrub,simple,size,slightly,stem,stigma,stout,style,surface,tan,tapering,tear-drop,tip,tube,way,white,x,yellow-green	0.8-2.2,1.5-2,1/2,1/4,10-12,10-14.5,2-5.5,3-5,4-6.5,4.5-5,abaxially,acute,adaxially,anthesi,apex,ba,beneath,closely,clustered,completely,conical,deflexed,deltate,differing,difoliate,distal,eaf,edicel,eed,free,geminat,inflorescenc,internodal,lateral,lobe,lon,lower,m.,main,major,margin,middle,minor,nflorescence,older,opposite,overlapping,pair,papillo,planar,portion,reddish,ruit,scar,shin,small,spaced,tall,thickened,treelet,tub,ud,unit,usually,vein,widest,woody,ympodial,young	abaxial,adaxial,arrangement,bud,characteristic,colour,diameter,exertion,form,fruit,growth,height,history,inflorescence,length,life,lobing,perennial,plant,seed,shape,shiny,texture,type
396	wfo-0001030489	success	196	110	84	112	26	0.429	0.5-3,0.9-1.1,1-3,1.2-1.6,1.6-2.1,1.7-2,1.9-2.6,1/3-1/2,3-6,3-8,4-8,4.5-9,5,7-15,anther,apart,apex,appressed-pubescent,bark,base,becoming,berry,blunt-tipped,broadly,brown,bud,calyx,chartaceous,cinereous,cm,conical,continued,corolla,deltoid,densely,diameter,due,elliptic,elongate,entire,filament,flower,fruit,glabrate,glabrous,globose,greenish,growth,honeycombed,lateral,leaf,length,long-acuminate,margin,minutely,mm,oblong,ovate-lanceolate,pedicel,peduncle,petiole,probably,pubescent,rachi,reniform,reticulate-punctate,ripe,shrub,simple,somewhat,stellate-pubescent,stem,stigma,style,subcampanulate,subglobose,suborbicular,tomentose,unarmed,way,white,x,yellow,yellowish	-6.5,.5-2.8,.5-3,.75-5.25,0.25-0.4,0.6-0.9,0.75-0.9,1-1.3,1-3.75,1.1-1.3,1.2-1.5,1.75-2,1/5-1/2,100,12-24,2.1-2.9,5-6,6-8,abaxially,abruptly,absen,acuminate,acute,adaxiall,adaxially,ag,anthesi,apical-lateral,apparently,appressed,articulated,attenuate,axe,axillary,ba,blade,branch,branched,closely,cylindrical,dehiscing,dichotomously,eaf,echinoi,echinoid,eed,fleshy,free,hair,high,inserted,introrse,large,lobe,lobed,long,long-exserted,longitudinal,lower,main,midvein,minute,mostly,multangulate,narrowly,nflorescence,obtuse,older,orolla,ovate,pale,perfect,plurifoliate,pore,porrect-stellate,pseudo-terminal,puberulent,pulverulen,pulverulent,ruit,runk,sessile,several,short,short-stalked,side,slender,slit,small,smooth,spaced,sparingly,sparse,stellate-rotate,subcapitat,tamen,terete,testa,thick,time,toward,tree,tube,turn,unarme,unit,usually,vary,vein,wide,ympodial,young	2.5-2.8,5-6.5,abaxial,adaxial,arrangement,characteristic,colour,form,height,history,inflorescence,life,lobing,ovary,perennial,plant,pseud-terminal,seed,shape,size,spacing,subcapitate,surface,texture,thicknes,type
397	wfo-0001030509	success	220	146	122	98	24	0.555	-10,0,0-100,0-5,0.1-0.2,0.2,0.3-2.5,0.6-1,0.8-1.2,0.8-4,1-1.5,1-2,1-3,1-4,1.3-2,1.7-2,1/4,2-2.5,2-4.2,2-4.5,2-6,2.8-3,2/3-3/4,3-4,7-9,8-16,anther,apex,apparently,articulated,bark,base,berry,calyx,cm,cordate,cream,cuneate,dark,densely,diameter,entire,erect,filament,flattened-reniform,flower,fruit,fruiting,gland,globular,gray,green,half,herb,inflated,lateral,leaf,length,lobed,long,long-styled,lower,margin,marking,maturity,mauve,midpoint,mm,moderately,obtuse,often,one,open,orange,orange-brown,ovate,pair,pale,pedicel,peduncle,per,petiole,plant,poricidal,porrect,prickle,prickly,primary,purple,ray,reduced,rounded,shorter,shrub,simple,sometimes,sparsely,spherical,stalk,stalked,stellate,stellate-pubescent,stem,style,surface,tapering,terminal,time,tip,trichome,tube,unarmed,unbranched,upper,variously,vein,way,weakly,wide,yellow,yellow-green,young	-2,-6,/3,0-0.3,0-15,0-3,0.1,0.1-0.25,0.1-0.3,0.5-1.5,1,1-6,1.5-2,1/,1/3-2/3,2-3,3-10,4.5-10,4.5-12,4.5-8,5-10,5-merous,7-15,abaxially,alyx,andromonoecious,apar,apart,apical,apically,becoming,blade,broad-deltate,brow,chartaceous,connivent,curved,difoliate,discolorous,distal,distance,drying,eaf,eed,elongating,equal,extending,eye,free,geminat,glabrescent,glabrous,herbaceous,hermaphrodite,heterostylous,infructescence,lobe,long-acuminat,longer,lowermost,mature,midvein,naked,narrow-deltate,narrow-oblong,nflorescence,occasional,occasionally,older,orolla,oung,pendulous,pericarp,perpendicular,portion,ruit,scar,short-styled,shorte,side,slender,smooth,spaced,spreading,staminat,straight,subsessile,tamen,terete,tertiary,unarme,unit,usually,vary,venation,visible,woody,ympodial	arrangement,branch,brown,bud,characteristic,colour,corolla,exertion,form,glabrousnes,growth,height,inflorescence,lobing,na,new,number,ovary,seed,shape,size,stigma,texture,type
398	wfo-0001030516	invalid_json	172	99	69	103	30	0.401	0.4-1.5,1-7,1.1-3.5,1.1-4.1,1.5-2,1.8-2.4,2-12,2-3,3-8,3-9.8,4-22,4-6,4-7,4.2-10.7,6-15,8-9,9-22,acute,branched,calyx,cm,corolla,cyme,darker,diameter,dichasial,dichasially,ebracteate,forked,gland,globose,green,green-white,herbaceous,interjected,lateral,leaf,leaflet,light,lobe,long,long-attenuate,mm,monochasial,mucilaginous,odd-pinnate,ovoid,pedicel,peduncle,pentagonal,perennial,petiole,pilose,plant,puberulent,pubescent,rotate,seed,short-stalked,size,slightly,sometimes,stripe,style,terminal,throughout,triangular,wide,yellow	1-2.5,1-4,1.7,2-2.,2-4,3-6,3-6-foliat,4-4,9-32,abaxially,acumen,acuminate,adaxially,apex,apical,apically,articulate,base,cell,connate,cordate,covered,covering,cuneate,decurrent,dehiscent,densely,digestion,diminished,distal,dorsally,eaf,edge,eed,elliptical,emoval,enzyme,exceeding,filament,first,flat,flower,folded,generally,globo,gradually,hair,hair-like,half,honeycomb,introrse,less,living,lon,longer,lower,lunat,make,maturing,nflorescence,nther,oblique,often,orolla,outline,ovate,pair,pattern,perfect,plan,poricidally,proximal,rarely,reveal,ruit,second,sessile,seudostipule,short,short-petiolate,slit,specimen,spreading,stamen,stigma,straight,tal,tem,testal,thick,time,toward,triangulat,tuber-bearing,type,typically,unit,vary,wall,whit,ympodial,Â¼,â	'','type,2-21,[,],``,anther,arrangement,branching,characteristic,colour,form,fruit,growth,height,history,inflorescence,length,life,ovary,pseudostipule,shape,stem,surface,texture,value,wet,width,{,}
399	wfo-0001030551	success	167	129	76	91	53	0.455	-30,0-2,0.5-1,0.6-1.5,1-2,1-2.5,1-3.5,1-4,1.5-2.5,10-20,10-40,20-25,3-12,3-8,4-,5-6,acuminate,acute,adpressed,also,apex,basal,base,blue,calyx,chartaceous,cm,concave,cordate,densely,dia,diameter,ellipsoidal,entire,fading,flower,fruit,glandular-puberulent,globose,hair,lanceolate,lobe,long,margin,mm,moderately,narrowly,oblong-fusiform,obtuse,often,ovate,ovate-elliptic,ovoid,pedicel,peduncle,perfect,petiole,pilose,puberulent,pubescent-pilose,shrub,simple,sparsely,stigma,style,subcoriaceous,tip,triangular,triangular-elliptic,truncate,tube,unbranched,unknown,violet,x,yellowish	-12,-5,1,1-,1-10,1-5,1.5-,13.,2,2-3,2-6,2.5-4,2.5-5,3-,3-5,4-5,4-7,4-foliat,5-17,9-20,abaxially,abruptly,absent,adaxially,aggregate,apart,ape,articulated,axe,beyond,bilobe,blade,broad,campanulate,cell,clavate,color,connective,dilated,directed,distally,eaf,ed,equal,et,exceeding,exserted,fleshy,glabrous,laterally,leaving,lon,lower,martinelli,narrow,narrowed,nflorescence,nther,orolla,papillose,pedicellar,pore,puberulen,puberulent-pubescent,pubescent-pilo,rachi,radiu,remnant,ripe,round,ruit,seen,shorter,slightly,small,spaced,stamen,stellate,stone,tal,tem,thecae,time,tomento,ud,unit,unknow,vary,wide,widening,ympodial	anther,appearance,arrangement,bark,bilobed,border,branch,bud,characteristic,colour,corolla,distal,drying,exertion,filament,form,fruiting,giving,glabrousnes,growth,height,history,inflorescence,interjected,lateral,leaf,leaflet,length,life,lobing,midpoint,na,new,number,ovary,per,plant,prickle,primary,pseudostipule,ray,seed,shape,size,stem,surface,terminal,texture,thicknes,type,variation,vein,width
400	wfo-0001030570	success	173	143	93	80	50	0.538	0-,0.3-0.5,1-3,1-4,1-8,1.5,10-25,15-35,2-3,2-5,2-7-lobed,2-8,2.5-22,20-30,3-10,3-5,4-25,4-5,4-7,abaxially,acuminate,acute,adaxially,apex,apiculate,basal,base,beyond,calyx,cm,connivent,cordate,cylindrical,diameter,dilated,distally,eglandular,ellipsoidal,entire,exserted,flattened,flower,forked,fruit,glabrous,glandular-puberulent,globose,green,hair,lanceolate,leaf,lobe,lobed,long,margin,mm,narrowly,obtuse,occasionally,often,ovoid,pedicel,peduncle,petiole,pilose,pinnately,pubescent,purplish,rarely,rounded,rugose,simple,slightly,sometimes,sparsely,stamen,stigma,style,subcoriaceous,submarginally,tip,tree,triangular,truncate,tube,unbranched,unequal,unknown,unlobed,vein,white,x,yellow	-1,.3-0.5,0.5-,0.5-1,1,1-,1-1.5,1-2,1-5,1.5-2.5,1/2,10-17,15-20,2-2.5,2-4,2-7,3-6,3.5-5,4-foliat,4/5,5-,8-,absent,aggregate,apart,ape,articulated,axe,blade,campanulate,cell,color,connective,directed,divided,eaf,eed,elliptic-oblong,exceeding,fleshy,glabrat,leaving,lon,lower,midrib,near,nflorescence,nther,orolla,ovate,pedicellar,perfect,pilo,pore,presen,punctate,purpl,rachi,radiu,remnant,ripe,ruit,shorter,sinus,small,somewhat,spaced,stellate,stone,tal,tem,thecae,time,tomento,truncat,ud,unit,vary,wide,ympodial	anther,appearance,arrangement,bark,border,branch,bud,characteristic,colour,corolla,distal,drying,exertion,filament,form,fruiting,giving,glabrousnes,growth,height,history,inflorescence,interjected,lateral,leaflet,length,life,lobing,midpoint,na,new,number,ovary,per,plant,prickle,primary,pseudostipule,ray,seed,shape,size,stem,surface,terminal,texture,thicknes,type,variation,width
401	wfo-0001030581	success	187	136	100	87	36	0.535	1-4-celled,9,abaxial,acute,adaxial,along,angle,angled,anther,anthesi,apex,appressed,articulated,basal,base,berry,black,calyx,capitate,central,clustered,cm,conical,corolla,decurrent,densely,denser,diameter,ellipsoid,elliptic,entire,exserted,filament,flattened-reniform,flower,fruit,fruiting,globose,green,growth,halfway,herb,inflorescence,intermodal,lateral,leaf,less,like,lobe,long,margin,maturity,minute,minutely,mm,near,new,occasionally,often,once-branched,ovary,ovate,pair,papillate,pedicel,peduncle,per,petiole,pitted,plant,portion,primary,pubescent,purplish,ridge,ripe,shallow,simple,slightly,somewhat,sparsely,spreading,stem,stigma,straight,style,surface,terete,third,translucent,trichome,tube,turning,uniseriate,upper,vein,white,wide,yellow,yellowish	.3,.5,0.2â0.8,0.4â0.6,0.4â1.6,0.5,0.5â0.7,0.5â2.5,0.6â0.7,0.7â0.8,0.9â1,1,1.2â1.5,1.8â8,1â2,1â2-celled,1â2.5,1â4-celled,2,20â50,2â3-celled,35â45,3â4,3â5,4.5â12,4â7,4â9,5-merous,5â6,5â8,abaxially,adaxially,aggregate,apar,becoming,beyond,branched,bright,cell,cone,difoliate,drop,eaf,eed,florescence,free,geminat,glabrous,individual,lacking,later,leave,live,lobed,lon,lower,markedly,narrowly,outline,pentagonal,perfect,rachi,reflexe,reflexed,remaining,rounded,ruit,scar,shiny,shorter,spaced,sprawlin,stellate,stone,strongly,tall,tangled,tem,testal,ud,unit,usually,winged,woody,ympodial,â15,â5	0.2-0.8,0.4-1.6,0.5-2.5,0.6-0.7,0.9-1,1-2-celled,1-2.5,1.2-1.5,20-50,3-4,3-5,35-45,4-7,4-9,5,5-6,5-8,arrangement,bud,characteristic,colour,exertion,form,glabrousnes,height,history,length,life,lobing,number,perennial,seed,shape,size,texture,type
402	wfo-0001030583	success	166	102	80	86	22	0.482	.5,0.1-0.5,0.2-1,0.3-1,0.8-1,1,1-1.5,1-8,1/2,2.5,2.5-3,3-4,3/4,5-6,abaxial,anther,bark,base,berry,calyx,cm,corolla,crisped,cultivar,deep,dendritic,densely,dia,dry,ellipsoid,elliptic,flattened-reniform,flower,form,fruit,fruiting,glabrous,globose,golden,green,immature,included,incrassate,irregular,leaf,lobe,lobed,long,margin,minutely,mm,narrowly,often,orange-red,ovary,pale,pedicel,petiole,pitted,plant,prostrate,pubescent,ripe,shaped,shrub,simple,size,small-capitate,stem,stigma,style,surface,tall,tan,tear-drop,trichome,way,white,x,yellow	.2,0.4-2.7,0.5-1,0.7-4.5,0.9-3.5,1-2,1.5-4,2.5-9,4-6,5-7,6-7,abaxially,acute,adaxially,along,anthesi,apex,ba,brow,cell,closely,conical,corky,cultivated,dark,deflexed,differing,difoliate,eaf,edicel,eed,enlarged,erect,especially,filament,free,frui,geminat,lateral,leave,like,live,lon,long-rectangular,long-triangular,lower,main,major,midvein,minor,nflorescence,occasionally,older,opposite,outline,overlapping,pair,papery,papillo,papillose,pericarp,planar,pore,poricidal,portion,rest,rounded,ruit,scar,small,soon,spaced,spathulate,specimen,stout,testal,thin,tip,tube,ud,uniseriate,unit,vein,woody,ympodial,young	adaxial,alternate,arrangement,brown,bud,characteristic,colour,diameter,exertion,growth,hair,height,history,inflorescence,length,life,lobing,perennial,seed,shape,texture,type
403	wfo-0001030605	success	144	132	106	38	26	0.736	.4,.5,0.1,0.3-0.5,1,1-4,1.5-2,1.7,12-19-flowered,2,2.5,7,acute,adaxially,almost,along,anther,anthesi,apex,apical,area,attenuate,base,berry,branch,branched,brown,calyx,cinereous,cm,commonly,conical,coriaceous,corolla,covered,cylindrical,dark,dendritic-echinoid,densely,dia,difoliate,dry,ellipsoid,exerted,filament,fruiting,glabrate,glabrous,globose,gold,green,growth,inflorescence,internodal,leaf,less,light,lobe,long,margin,material,midrib,minutely,mm,nearly,new,obovate,obtuse,occasionally,olive,opposite,ovary,ovoid-reniform,pedicel,peduncle,petiole,pitted,pubescent,rarely,reflexed,revolute,rounded,scattered,shaped,shiny,shrub,simple,slender,slightly,smooth,soon,sparsely,stigma,style,surface,tear-drop,thickened,tinged,tip,trichome,tube,unifoliate,vein,way,white,woody	1.5-5.5,1/3-1/2,2-3,5-12.5,abaxially,apart,ape,beginning,beneath,deflexed,drying,eaf,edicel,eed,entire,free,geminat,inflorescenc,lobed,lower,nflorescence,otherwise,ovate,overlapping,papillate,papillosefruit,pore,poricidal,portion,scar,somewhat,sparesly,tub,ud,unit,x,yellow,ympodial	abaxial,adaxial,arrangement,bud,characteristic,colour,diameter,exertion,form,fruit,geminate,glabrousnes,height,history,length,life,lobing,na,papillose,plant,seed,shape,size,stem,texture,type
404	wfo-0001030624	success	170	99	71	99	28	0.418	.5,0.9-1,1-3,1.2-1.8,1.2-2,1.5-2,2-10,3-3.5,3.5-4,anther,axil,bark,base,berry,calyx,clavate,cm,corolla,dia,ellipsoid,elliptic,exserted,falcate,filament,flattened-reniform,fruiting,furcate,glabrate,glabrous,glandular,globose,green,hyaline,later,lateral,leaf,longitudinally,main,minutely,mm,narrowly,nearly,occasionally,ovary,pedicel,petiole,pitted,puberulent,shining,shrub,simple,size,slender,small,soon,stem,stigma,straight,style,surface,tapering,tree,trichome,tube,tuft,uniseriate,vein,white,x,yellowish,yellowish-green	.25,0.5,0.5-1,0.5-1.5,2,2-3,2.5-5.5,25-40-flowered,3,4.5-8,6-13,7-9,acute,anthesi,apart,apex,apiculate,appearing,attenuate,ba,beginning,branch,caly,cell,decurrent,deflexed,differing,difoliate,dimorphic,distal,dry,eaf,edicel,eed,end,erect,except,expanded,extreme,free,geminat,greyish,incrassate,inflorescenc,large,like,lobe,lobed,lon,long,lower,major,margin,material,middle,midrib,minor,near,nflorescence,older,one,opposite,outer,pair,pale,papillose,planar,pore,poricidal,portion,prominent,raised,remaining,round,rugo,ruit,scar,short,slightly,somewhat,spaced,square,tall,thickened,three,ti,tip,trunk,two,ud,unevenly,unit,wall,widest,woody,yellow,yellowish-grey,ympodial,young	abaxial,adaxial,alternate,arrangement,bud,characteristic,colour,diameter,exertion,form,fruit,growth,height,history,inflorescence,length,life,lobing,na,plant,presence,rugose,rugosity,seed,shape,texture,type,variation
405	wfo-0001030638	success	177	108	86	91	22	0.486	0.1,0.5-1,0.5-1.5,0.7-1.5,1-1.2,1-1.5,1.4-1.7,1.5-2,1.6-2.2,2-3,2-7-flowered,2.5-4,3-10,8,8-9,anther,anthesi,apically,bark,base,berry,broadly,bud,calyx,cm,corolla,cup-shaped,deflexed,densely,dia,difoliate,elliptic,exfoliating,filament,flattened,fruit,fruiting,geminate,glabrate,glabrous,glandular,globose,green,inflorescence,later,leaf,less,lobed,long,minor,minutely,mm,nearly,obovate,occasionally,open,opposite,ovary,pale,papillose,pedicel,petiole,poricidal,red,red-glandular,rugose,seed,shape,shrub,simple,size,stem,stigma,style,surface,tapering,terminal,thickening,tip,transversely,tree,tube,unit,white,x,young	0.5,0.5-0.7,0.5-2,1-2,2-5,3-13,4-6,8-11,acute,along,apex,appear,appearing,axi,axil,ba,beginning,beneath,blade,branched,closely,conspicuously,corky,cucullate,deltoid,differing,dry,eaf,eed,entire,erect,extending,fleshy,free,geminat,gre,impressed,irregular,known,lamina,large,lateral,like,lobe,lon,lower,main,major,margin,material,middle,near,nflorescence,often,older,one,overlapping,ovoi,pair,paler,papillae,papillo,persistent,planar,pore,portion,present,prominent,rather,reddish,rest,roundish,ruit,scar,shaped,soon,spaced,speciman,straight,tall,tear-drop,thick,thickened,trichome,uniseriate,usually,vein,wall,widest,woody,ympodial	abaxial,arrangement,characteristic,colour,diameter,form,grey,growth,hair,height,history,length,life,lobing,na,number,ovoid,per,plant,sympodial,texture,type
406	wfo-0001030661	success	183	139	113	70	26	0.617	.5,0,0.5-0.6,0.5-2,0.7-0.8,1-1.2,1-1.4,1-1.5,1.5-7,2-2.5,3-3.5,4-15,5-5.5,50-100+,acute,along,anther,anthesi,apex,articulated,attenuate,base,berry,branched,brown,calyx,capitate,cell,cm,connivent,corolla,densely,denser,diameter,ellipsoid,elliptic,entire,erect,exserted,extending,filament,flattened,flower,fruiting,glabrescent,glabrous,globose,growth,inflorescence,insertion,lamina,lateral,leaf,lobed,long,loosely,many,margin,mature,membranous,midrib,minute,minutely,mm,narrowly,near,new,nodding,occasionally,onto,pedicel,peduncle,per,petiole,pitted,point,poricidal,pubescent,red,reddish,reniform,scattered,shrub,simple,sleeve,slender,slightly,small,sparsely,stem,stigma,strongly,style,surface,tangled,terminal,time,tinged,tip,tree,trichome,tube,uniseriate,usually,vein,violet,way,white,winged,woody,x,Â½,Â¾	-24,.2,0.5-0.75,1-,1-.,1-1.3,1.2-7,1.5-2,12-16,2-,3-20,3-4,4-6,5-10,5-merou,ag,alyx,ark,branch,brow,clustered,conical,dar,deltate,drying,eaf,eed,em,erec,free,glabrou,group,ilament,lengthening,lobe,lon,lower,never,nflorescence,older,orolla,otherwise,pair,pale,papillo,perfect,pericarp,planar,platform,plurifoliat,pore,portion,primary,rectangular,ruit,scar,shiny,slit,spreading,stellate,testal,thin,twinin,ud,unit,upper,vary,yellow,yellowish,ympodial	1-5,abaxial,adaxial,arrangement,bud,characteristic,colour,exertion,form,fruit,glabrousnes,height,history,length,life,lobing,number,ovary,papillose,plant,seed,shape,size,stelate,texture,type
407	wfo-0001030676	success	220	115	91	129	24	0.414	0.4,1-1.2,1.1-1.4,1.2-1.3,16,2.2-5.7,3-6,4-6,7-8,8-10,abaxially,abruptly,acute,adaxially,angled,anther,anthesi,apex,appressed-tomentose,bark,base,becoming,berry,blunt-tipped,branch,branched,brown,bud,calyx,cm,conical,continued,corolla,deltoid,diameter,dichotomously,due,elongate,entire,exserted,filament,finely,fleshy,fruit,globose,granular-tomentose,green,greenish,grooved,growth,honeycombed,lateral,leaf,length,longitudinally,margin,minutely,mm,oblique,oblong,oblong-elliptic,often,openly,ovate-lanceolate,pedicel,peduncle,petiole,probably,pulverulent,reniform,reticulate-punctate,ripe,scabrous,short-attenuate,shrub,simple,somewhat,stem,stigma,strongly,style,subcampanulate,subglobose,suborbicular,terete,velutinous,white,whitish,x,yellow,yellowish	-1.6,-2.5,-3.9,-8.5,/10-1/5,0-100,0.6-1.2,1,1-3,1.1-1.9,1.3-1.5,1.7-2,1/4,11-14,14-17,19-35,2.1-2.3,2.1-2.6,2.4-3.1,2.5-5.5,2.75-3.25,3-3.5,3-5,4-6.5,7-10,7-9,8-12,along,apart,apical-lateral,apparently,appearing,articulated,axillary,ba,blade,chartaceous,closely,crown,cylindrical,dehiscing,densely,eaf,echinoi,echinoid,eed,except,flat-topped,flower,forming,free,glabrescen,glabrescent,glabrous,hair,high,horizontal,initially,inserted,introrse,lackin,lamina,large,lengthen,lined,lobe,lobed,long,longitudinal,lower,main,midvei,midvein,minute,moderately,mostly,multangulate,nearly,nflorescence,obtuse,occasional,older,opening,orolla,ovate,parallel,perfect,plurifoliate,pore,pseudo-terminal,pubescent,rachi,rather,ray,ridged,ruit,runk,scattered,sessile,short-stalked,side,slit,small,spaced,sparsely,spreading,stellate,stellate-pubescent,subcapitat,tamen,tending,testa,thick,thin,time,tip,tomentose,tree,tube,tuft,unarme,unit,usually,vary,vein,way,wide,ympodial,young	arrangement,characteristic,colour,exertion,form,glabrousnes,height,history,inflorescence,life,lobing,new,ovary,perennial,plant,pseud-terminal,seed,shape,size,subcapitate,surface,texture,type,unarmed
408	wfo-0001030686	success	182	121	103	79	18	0.566	.5,1-1.1,1-1.2,1-2,1.2-1.5,1.5-4.5,1.6-3,15,2-2.5,2-3,2-6.5,2.5-8,5-12,5-25,5-30,8-9,abruptly,acuminate,acute,age,anther,apex,bark,base,berry,bifid,black,branched,brown,c.,calyx,centre,cm,conical,corolla,dark,darker,deeply,densely,diameter,drying,elliptic,entire,erect,exerted,filament,flattened,flower,form,fruit,fruiting,globose,golden,height,internodal,leaf,leaf-opposed,lengthening,lepidote,lilac,lobe,long,margin,maturity,mm,oblique,orange,ovary,pair,pale,pedicel,peduncle,petiole,pitted,plant,pore,poricidal,primary,pubescent,purple,seed,shallow,shallowly,shiny,simple,slit,sparsely,spreading,stem,stigma,strongly,style,surface,time,tip,tree,tube,uniformly,usually,vein,way,x,yellow	.2,.5-1,0.5-1,1-1.5,1.5-2,1972,2.5-4,3-3.5,5-6,?,abaxially,aborted,adam,adaxially,anthesi,apart,basal,beneath,breast,brittle,bu,closely,cup-shaped,denser,different,difoliate,discolorous,dry,eaf,edicel,eed,empty,fide,fragrant,free,geminat,glabrescen,glabrous,half,heteromorphic,lamina,less,lobed,lower,many,midrib,midvein,minutely,nflorescence,noddin,older,overlapping,paler,papillae,papillose,pericarp,planar,portion,pubescen,rachi,ruit,scar,scarious,short,slightly,somewhat,space,spaced,stellate,styl,thin,tissue,trichome,ud,unit,visible,woody,ympodial,â	arrangement,bud,characteristic,colour,exertion,glabrescent,glabrousnes,growth,history,inflorescence,length,life,lobing,new,shape,size,texture,type
409	wfo-0001030709	success	217	129	111	106	18	0.512	-9,0-,0.7-1,0.9-1.5,1-1.2,1-1.6,1-4.5,1.3-1.4,1.4-2,1.6-2.1,1.9-2.8,1/3-1/2,1/4,2-6,2-8,2.3-3,3-,5-20,5-6,5-9,6-21,6-7,7-9,8-11,abaxially,acuminate,acute,almost,anther,apex,apically,apparently,articulated,bark,base,berry,branched,calyx,chartaceous,cm,connivent,cordate,diameter,discolorous,drying,dull,elliptic,erect,filament,finely,flattened-reniform,fruit,fruiting,inflorescence,lateral,leaf,length,lobe,lobed,lobing,long,margin,maturity,mauve,middle,mm,moderately,narrow-deltate,orange-brown,pair,pedicel,peduncle,petiole,pitted,poricidal,porrect,prickle,prickly,primary,purple,red-green,seed,shrub,side,simple,size,smooth,sparsely,spherical,spreading,stalked,stellate-pubescent,stem,style,surface,tapering,terete,terminal,tip,trichome,truncate,tube,unarmed,upper,variously,vein,way,weakly,wide,yellow,yellow-green	-2,-5,0,0-20,0-30,0.1-0.2,0.15-0.5,0.2-0.5,0.3-1.5,0.4,0.8-4,1-6,1/2-2/3,1/4-1/3,10-14,10-50,2-4,2-5,2/3-3/4,4-5-merous,5-10,5-7,6-10,6-8,7-8,8-15,adaxially,alyx,ame,apar,apart,ape,blade,bright,broad-deltate,brow,c.,conical,cuspidate,deltate,distance,eaf,edge,eed,elongating,equal,extending,flower,free,glabrescent,glabrous,increasing,infructescence,lanceolate,lengt,lon,long-acuminat,longer,lower,mature,midpoint,midvein,nflorescence,occasionally,often,older,one,open,orolla,oung,pendulous,per,perfect,pericarp,perpendicular,pit,plurifoliat,portion,prickl,ray,red-orange,reflexed,retrorse,rounded,ruit,scar,secondary,short-styled,shorter,slender,sometimes,spaced,stalk,stellate,straight,tamen,tertiary,time,toward,unit,usually,vary,venation,visible,woody,ympodial	arrangement,branch,brown,characteristic,colour,corolla,exertion,form,glabrousnes,growth,height,long-acuminate,new,ovary,plant,shape,texture,type
410	wfo-0001030714	success	178	140	120	58	20	0.674	-3,.2,/3,0.1-0.3,0.5,0.5-0.8,0.5-1.9,0.7-0.8,1.2-1.5,1.2-4,1/3,2-2.6,20,5-100,7-17,>,acuminate,acute,adaxially,age,aid,along,anther,apex,articulating,bark,basal,base,becoming,beneath,berry,blue,blue-black,branching,calyx,clavate,cm,conical,cordate,corolla,dark,denser,diameter,ellipsoid,elliptic,entire,especially,except,exserted,flattened,flower,fruit,glabrous,globose,gradually,greyish,growth,herbaceous,leaf-opposed,leaving,lengthening,liana,like,lobed,long,many,margin,membranous,midrib,minute,minutely,mm,narrowly,new,node,ob-ellipsoid,ob-elliptic,oblique,occasionally,ovary,overall,pale,papillate,pedicel,peduncle,peg,per,petiole,pitted,pore,poricidal,pubescent,reniform,ripe,shape,simple,slightly,slit,sparsely,stellate,stem,stigma,strongly,style,surface,tapering,terminal,time,tip,trichome,truncate,tube,twining,uniseriate,vein,vine,violet,way,woody,yellow	.5,0.3-0.4,0.8-1,1-1.2,1-1.3,1-1.5,1-2.5,1.4-3.5,1.5-2,2-2.5,3-3.5,3-7,5-6,abaxial,abaxially,anthesi,apar,campanulate,climbin,cup,densely,eaf,eed,fide,filament,free,grading,gree,howard,joined,lobe,lower,narrow,nflorescence,nodding,older,pair,paler,papillat,pedice,perfect,planar,plurifoliat,portion,primary,prominent,quadrate,ruit,scar,spaced,submarginal,thickened,tub,ud,unit,widely,x,ympodial	arrangement,bud,characteristic,climbing,colour,exertion,form,glabrousnes,green,history,inflorescence,leaf,length,life,lobing,number,seed,size,texture,type
411	wfo-0001030733	success	130	85	62	68	23	0.477	/4,1-1.2,1-1.5,1-2,1.7-2.7,3-5,5-8-flowered,6-7,abaxially,acuminate,acute,adaxially,anther,apex,bark,base,berry,bi-lobed,broadly,brown,calyx,capitate,cm,conical,corolla,dark,decurrent,densely,dia,ellipsoid,elliptic,erect,fruiting,glabrous,globose,green,later,leaf,long,minutely,mm,moderately,narrowly,onto,ovary,ovoid-reniform,pedicel,petiole,pubescent,shaped,shrub,simple,smooth,somewhat,stem,stigma,style,surface,tear-drop,treelet,way,white	.5,0.5-1,1.5-5,2-2.5,3-4,4-15,4.5-5,6-9,?,along,anthesi,ape,clearly,closely,coriaceous,deltate,denser,eaf,eed,elongate,embryo,exserted,filament,free,grayish-brow,lamina,lateral,like,lobe,lobed,lon,lower,main,margin,middle,nflorescence,older,opposite,overlappin,pair,papillo,planar,pore,poricidal,portion,rounded,ruit,scar,spaced,sparsely,strongly,tall,testa,thick,tip,trichome,tube,ud,unifoliat,uniseriate,unit,vein,visible,widest,woody,x,ympodial,young	arrangement,bud,characteristic,colour,diameter,form,fruit,grayish-brown,growth,height,history,inflorescence,length,life,lobing,peduncle,plant,seed,shape,size,texture,type,unifoliate
412	wfo-0001030772	success	155	113	91	64	22	0.587	-2,.05,.2,.25,.5,0.2-0.8,0.25-0.5,0.9-1,0.9-3.1,1-2,1-2.5,1.2-5,1.4-1.6,3-3.5,3-5,4.2-6.5,5-10-flowered,5-6,9-15,anther,bark,base,becoming,berry,branch,bud,calyx,capitate,cm,corolla,dark,deflexed,dia,ellipsoid,elliptic,extreme,filament,fruit,fruiting,gently,glabrous,globose,green,grey,later,leaf,lenticellate,lobe,lobed,long,long-acuminate,minor,minutely,mm,nearly,node,occasionally,ovary,ovoid-reniform,pale,paler,papillose,pedicel,petiole,pitted,pore,poricidal,shape,shaped,shining,shrub,simple,size,slender,slightly,soon,stem,stigma,style,surface,swollen,tan,tapering,tear-drop,tip,trichome,tube,uniseriate,white,x,young	0.5-1,0.75-1,1.5-2,2-7,8-10,acuminate,acute,anthesi,apex,archin,attenuate,ba,beginning,beneath,closely,differing,difoliate,eaf,edicel,eed,erect,free,geminat,impressed,inflorescenc,large,lateral,lon,long-triangular,lower,main,major,margin,methyl,middle,nflorescence,older,one,opposite,overlapping,pair,papillo,per,portion,prominent,reflexed,ripe,rounded,ruit,salicylate,scar,smelling,spaced,straight,strongly,tall,ud,unit,usually,vein,widest,wintergreen,woody,ympodial	abaxial,adaxial,alternate,arching,arrangement,characteristic,colour,diameter,form,growth,height,history,inflorescence,length,life,lobing,na,plant,seed,swelling,texture,type
413	wfo-0001030781	success	213	157	135	78	22	0.634	0-5,1-10,1-2,1-4,1-8,1.5-12,1.5-2,1.5-9,1.6-2.2,10-40,15-35,2-20,2.5-14,2.5-3.5,3-4,4-15,5-6,5-7,6-7,7.5-9,abaxially,adaxially,along,anther,apart,axillary,borne,broadly,brown,brownish,bud,cell,chartaceous,ciliate,cm,condition,connivent,corolla,covering,dark,deep,densely,diameter,distal,dot,drying,elliptic,end,erect,especially,filament,finely,flower,forked,fresh,fruit,generally,glabrous,glandular,globose,gray-green,green,green-white,greenish,hair,hair-like,half,herb,homostylous,interjected,lanceolate,lateral,leaf,leaflet,light,like,lobe,long,make,margin,membranous,midrib,minutely,mm,mucilaginous,obovate,odd-pinnate,ovate,ovoid,pair,papillose,pedicel,peduncle,pentagonal,pilose,plant,poricidal,puberulent,pubescent,purple,rarely,rotate-pentagonal,scattered,seed,simple,singly,size,small,sometimes,somewhat,sparsely,stem,stigma,straight,style,subovoid,subtending,terminal,testal,thick,throughout,tip,tube,tuber,typically,unwinged,usually,violet,wall,wet,white,whitish,wide,x,yellow	0.2-4,0.5-6,0.5-8,1-1.5,1-12,2-3,3-6,5-8,5-merou,abruptly,acumen,ag,alyx,apex,apiculate,apparently,articulated,axe,base,berry,blade,caly,capitat,cuneate,decreasing,decurrent,digestion,dorsally,eaf,edge,eed,enzyme,exceeding,flat,folded,geminat,glabrou,gradually,high,honeycomb-shaped,larger,lengthening,living,low-growin,lower,narrowed,nflorescence,orbicular,orolla,ovate-lanceolate,perfect,petiole,petiolulate,plurifoliate,pointed,pore,rachi,removed,rounded,ruit,sessile,seudostipule,short,slightly,slit,spaced,specimen,stamen,ste,stolo,tall,tamen,tem,toward,tri-,unit,vary,ympodial	5-merous,abaxial,adaxial,arrangement,calyx,capitate,colour,form,growth,height,history,inflorescence,length,life,ovary,pilosity,presence,pseudostipule,shape,spacing,stolon,texture
414	wfo-0001030782	success	198	148	128	70	20	0.646	0-1,0-7,0.4-1.5,1-2,1-3,1-6,1.3-1.6,1.5-2,1.5-7.5,1.6-4.6,11-47,12-30,13-22,15,2,2-3,2.2-4,3-10,4-11.6,4-6,4.6-26,5-20,7-15.6,abaxially,acumen,acuminate,acute,adaxially,anther,apex,attenuate,axillary,base,blade,broadly,brownish,bud,cell,clavate,cm,condition,connivent,coriaceous,corolla,covering,dark,deep,diameter,distal,dorsally,drying,edge,elliptic,filament,flat,flower,folded,forked,fresh,fruit,generally,glabrescent,glabrous,globose,green,green-white,greenish,hair,hair-like,half,herb,interjected,lanceolate,lateral,leaf,leaflet,light,lilac,lobe,long,make,medium,mm,moniliform,mottled,mucilaginous,odd-pinnate,ovate,ovoid,pair,pedicel,peduncle,pentagonal,petiole,petiolulate,plant,poricidal,prominently,purple,rachi,ripe,rotate,rounded,scarce,seed,sessile,short,size,stigma,straight,style,subtending,terminal,testal,thick,throughout,tip,tube,tuber,usually,wall,wet,white,whitish,wide,winged,x,yellow	1-5,1.2-3.9,2.4-11.5,3-5,5-merou,6-8,abaxiall,ag,along,alyx,apart,apparently,arranged,articulated,asymmetric,axe,basiscopic,bead,berry,capitat,cuneate,decreasing,digestion,eaf,eed,enzyme,exceeding,geminat,glabrou,hal,high,homostylous,honeycomb-shaped,inconspicuous,lengthening,like,living,lower,multiple,necklace,nflorescence,orbicular,orolla,perfect,plurifoliate,pore,removed,ruit,second,seudostipule,side,slit,smaller,sometimes,spaced,specimen,stamen,stolon,subequal,tal,tamen,tem,tissue,totally,toward,tri-,typically,unit,vary,ympodial	abaxial,adaxial,arrangement,calyx,capitate,colour,form,growth,height,history,inflorescence,length,life,number,ovary,pseudostipule,shape,stem,surface,texture
415	wfo-0001030802	success	171	130	102	69	28	0.596	.3,.5,0,0.5-0.75,0.5-1,0.9-1,1,1-1.1,1-1.2,2-3,2-5,2.5-3,3-4,3-6,4-6,5-10-flowered,abrupt,acuminate,acute,anther,anthesi,apex,appearing,bark,base,beneath,berry,brown,bud,calyx,cm,cordate,corolla,deeply,densely,dia,difoliate,dry,ellipsoid,evenly,exerted,filament,filiform,flattened-reniform,fruit,fruiting,glabrous,glandular,globose,halfway,hanging,heart-shaped,internodal,lateral,leaf,length,lobe,lobed,long,main,margin,material,minutely,mm,obconic,older,ovary,ovoid,pair,pale,papillate,pedicel,per,petiole,pitted,plant,pubescent,raised,red,reddish,shaped,shrub,simple,slender,somewhat,soon,specimen,stem,stigma,style,subshrub,surface,tapering,tear-drop,tube,unifoliate,vein,white,x,yellow,yellowish,young	.5mm,0.25-0.4,0.5-1.5,0.7-1cm,0.75-1,1-1.5,2-2.5,3-3.5x,4-5mm,abaxially,adaxially,along,basal,becoming,beginning,campanulate,cucullate,deflexed,denser,eaf,edicel,eed,except,exudate,free,geminat,gland,glandurla,incrassate,inflorescenc,invest,irregularly,lamina,later,line,live,long-triangular,lower,m.,markedly,midvein,near,nflorescence,palmate,papillose,persistently,pore,poricidal,portion,prominent,pubescen,ruit,scar,single-celled,spaced,stigm,straight,strongly,tip,tipped,trichoem,trichome,ud,uniseriate,unit,variable,widely,woody,ympodial	0.7-1,4-5,arrangement,branch,characteristic,colour,corrugation,diameter,drying,exertion,form,glabrousnes,growth,height,history,inflorescence,life,lobing,na,new,number,peduncle,primary,seed,shape,size,texture,type
416	wfo-0001030809	success	154	86	52	102	34	0.338	1.2-1.4,1.4-1.5,1.5-3.5,2-2.5,4.5-5,6-8,8,9.9-12,acute,anther,apex,bark,base,berry,calyx,clavate,cm,corolla,dia,ellipsoid,elliptic,erect,exserted,falcate,filament,fruit,fruiting,glabrous,globose,green,leaf,lobed,mm,nearly,ovary,ovate,pedicel,petiole,pubescent,size,soon,stem,stigma,style,tapering,tomentose,tree,tube,vein,white,x,yellow-brown	.5,0.2,0.5-1,1-1.25,1-1.5,1.5-2.4,2.3-5.5,20-60-flowered,5-8,across,along,also,anthesi,apar,appearing,beneath,branched,broadly,caly,campanulate,curl-tipped,curved,dark-papillo,deciduous,deflexed,deltoid,dense,densely,difoliate,distally,eaf,edicel,eed,especially,evenly,free,geminat,golden,hair,hidden,interpetalar,known,large,lateral,leave,like,lobe,lon,long,long-papillose,lower,main,major,markedly,mature,membranous,middle,midrib,minor,minutely,nflorescence,older,one,opposite,overtopping,planar,pore,poricidal,portion,present,round,ruit,scar,scattered,several,shinin,shining,shoot,simple,sinus,slender,slightly,small,spaced,straight,tall,terminal,three,time,tip,triangular,trichome,two,ud,underside,unequal,uniseriate,unit,wide,widest,ympodial,young	0.5,1,arrangement,branch,bud,characteristic,colour,corrugation,dark-papillose,diameter,drying,exertion,form,glabrousnes,growth,height,history,inflorescence,length,life,lobing,margin,na,new,number,peduncle,per,plant,primary,seed,shape,surface,texture,type
417	wfo-0001030810	success	191	103	64	127	39	0.335	anther,apex,axillary,base,bipinnate,blue,borne,branched,brown,calyx,clavate,cm,colour,dark,decreasing,densely,diameter,divided,elliptic,elliptical,filament,flattened,fleshy,fruit,glabrous,globose,green,greyish,leaf,leafy,long,margin,mm,moderately,oblong,older,opposed,pair,pale,pedicel,peduncle,pentagonal,petiole,pinnae,pinnate,pitted,primary,pubescent,shallowly,shiny,shoot,shrub,size,stem,stigma,style,subglabrous,surface,time,tomentose,unknown,violet,woody,x	0.2,0.2â0.3,0.3,0.4,0.5â,0.5â0.8,0.6â1.0,0.7â1.4,0.8â5.5,0.95â2.0,0â,1,1.0â1.5,1.0â2.0,1.0â3.0,1.1â2.0,1.1â2.2,1.2â1.5,1.5â1.9,1â2,1â3,1â5,2.9â4.5,20â100,2â3,2â4,3.0â5.0,3.3â5.5,3.3â8.5,3.5â4.6,3â19,4â14,4â5,4â7,5,5â15,5â30,5â32,6â10,6â22,7â10,7â11,8â10,abaxially,absen,accrescent,acute,adaxiall,adaxially,ag,along,anthesi,apart,articulated,axe,ba,blade,cell,chartaceous,connivent,cylindrical,denser,eaf,eed,equal,erect,especially,flower,geminat,hair,half,hig,indumentum,irregular,lobe,lon,longitudinal,lower,m.,midrib,midvein,multicellular,narrow,nflorescence,obtu,occasionally,opening,orolla,oung,perfect,plurifoliate,pore,poricidal,rarely,reflexed,rounded,ruit,secondary,shaped,side,simple,slit,sometimes,spaced,sparsely,stone,straight,tamen,tardily,tear-drop,tip,tube,unicellular,uniseriate,unit,vary,white,wide,wing,yellow,ympodial,â2.5,â3,â3.4,â4.5,â5.0,â8	0.2-0.3,0.6-1.0,0.8-5.5,1-2,1.1-2.2,1.2-1.5,1.5-1.9,20-100,3,3.3-5.5,3.3-8.5,4-14,4-5,4-7,5-32,7-10,8-10,abaxial,adaxial,arrangement,characteristic,corolla,form,glabrousnes,growth,height,history,inflorescence,length,life,lobing,new,ovary,plant,seed,shape,texture,type,vein
418	wfo-0001030822	success	146	72	55	91	17	0.377	0.4-1,0.5-1.5,0.8-1,0.9-1,1-1.2,1-1.5,11-15.5,2-2.5,2-3.8,2-5,3.5-7,5-6,5-7,anther,berry,clavate,cm,corolla,elliptic-obovate,exserted,filiform,flattened-reniform,fruiting,glabrous,globose,inflorescence,internodal,leaf,long-ellipsoid,margin,minutely,mm,ovary,pale,pedicel,petiole,pitted,revolute,shaped,shiny,shrub,simple,size,stem,stigma,strongly,style,surface,tan,tear-drop,usually,white,winged,x,yellowish-brown	.2,0-0.5,0.1-0.2,0.4,1.5-2,3-3.5,3-5,8-9,abaxially,acute,adaxially,anthesi,apex,attenuate,ba,base,beneath,broadly,calyx,closely,clustered,completely,cucullat,cucullate,cup,decurrent,deflexed,deltate,dia,differing,difoliate,eaf,edicel,eed,erect,filament,fleshy,flower,free,geminat,green,incrassate,inflorescenc,later,lateral,lobe,lobed,lon,long,lower,main,major,middle,minor,minute,near,nearly,nflorescence,occasionally,older,onto,open,opposite,pair,papillo,papillose,perhaps,planar,pore,poricidal,portion,present,red-papillose,ruit,scar,slightly,somewhat,spaced,sparsely,tall,tapering,tip,tube,ud,unit,vein,widest,woody,yellowish,ympodial,young	bud,characteristic,colour,diameter,exertion,form,fruit,growth,height,history,length,life,plant,seed,shape,texture,type
419	wfo-0001030871	invalid_json	248	182	147	101	35	0.593	0-120,0.2-0.4,0.3-4,0.6-1.5,0.7-1.3,1-18,1.3-2,1.5-3,1.8-2.6,1/2-3/4,11,2-8,3-32,3-5,3-6,3.5-14,30,4.5-6.5,4.8-9.5,6-40,9-13,abaxially,abruptly,acuminate,acute,adaxial,adaxially,along,anther,anthesi,apex,apical-lateral,appressed,attenuate,bark,base,becoming,berry,blade,blunt-tipped,branch,branched,brown,bud,calyx,campanulate,chartaceous,cm,conical,continued,corolla,dark,decurrent,dehiscing,deltoid,densely,diameter,due,early,echinoid,elongate,entire,equal,erect,exserted,extend,filament,fleshy,flower,free,fruit,fruiting,glabrescent,glabrous,granular-tomentose,green,greenish,growth,hair,honeycombed,introrse,large,lateral,leaf,length,long,longer,longitudinal,margin,midvein,mm,mostly,narrowly,nearly,nodding,oblong,obtuse,often,orbicular,ovate,ovate-lanceolate,pale,pedicel,peduncle,petiole,pore,probably,prominent,pubescent,purple,reflexed,reniform,reticulate-punctate,ripe,scabridulous,sessile,short,short-stalked,shrub,side,simple,slit,sometimes,sparingly,stamen,stem,stigma,strongly,style,subglobose,suborbicular,sulcate,terete,terminal,time,tomentose,tree,tube,unarmed,vein,velutinous,violet,way,white,x,yellow,yellowish	.2-3,.8-3.5,.9-1.2,/30-1/5,0.4-1.8,0.7-2.5,1-1.3,1.3-3,1.4-2.7,1.5-6,1.8-3.5,1/2,1/4,1/4-1/3,2-3,2.8-4.5,3-4.4,5-33,5-7,7-12,accrescent,ag,apart,apparently,appressed-tomentose,articulated,axe,axillary,ba,capitat,closely,dendritic-echinoi,dendritic-echinoid,dendritic-multangulate,directed,distal,eaf,earl,echinoi,eed,elliptic,evident,glabrescen,grayish,held,high,inserted,lobe,lobed,long-,long-stalked,lower,m.,main,minute,mixed,multangulat,multangulate,nflorescence,occasionally,older,open,orbicula,orolla,overlapping,partly,perfect,plait,plurifoliate,porrect-stellate,present,rachi,rather,ray,relatively,rotate-stellate,ruit,runk,short-,small,somewhat,soon,spaced,sparsely,splitting,stellate-tomentose,striate,suture,tamen,testa,thick,thick-stalked,thin-stalked,toward,unarme,unit,usually,vary,wide,ympodial,young	'',[,],``,age,arrangement,capitate,characteristic,colour,drying,exertion,form,glabrousnes,height,history,inflorescence,life,lobing,na,new,number,ovary,per,perennial,plant,primary,seed,shape,size,surface,texture,type,value,{,}
420	wfo-0001030872	success	166	122	96	70	26	0.578	0.5,0.8-1,0.8-2,1-1.2,1-2,1.2-1.5,1.2-3,1.5-2,1.5-5,12-18,2-5,3-7,4-6,4-6-flowered,5-6,5.5-7,6-12.5,acuminate,acute,anther,apex,area,bark,base,berry,black,brown,calyx,closed,cm,completely,corky,corolla,dark,deflexed,dia,ellipsoid-ovoid,elliptic,erect,exserted,filament,fleshy,fruiting,glabrate,glabrous,globose,green,hooded,large,leaf,lenticel,lenticellate,less,like,lobe,lobed,long,minor,minutely,mm,nearly,oblique,one,opposite,ovary,ovate,pair,papillose,pedicel,petiole,primary,puberulent,rather,red-glandular-puberulent,reddish-glandular,rest,rounded,shaped,shining,simple,size,small,soon,stem,stigma,strongly,style,tear-drop,tip,tree,treelet,tube,white,woody,x,young	.5,0.5-1,1-1.5,adaxial,age,along,anthesi,appearing,beginning,broadly,caly,center,closely,consisting,crateriform,cucullate,darker,deltoid,densely,difoliate,dry,eaf,edicel,eed,free,full,geminat,incurved,inflorescenc,known,live,lon,lower,major,margin,material,middle,nerve,nflorescence,older,overlapping,pale,paler,petal,planar,pore,poricidal,portion,prominent,proximal,raised,reddish-glandular-puberulent,relative,ridge,ruit,scar,shorter,side,slightly,spaced,specimen,straight,styl,tall,tapering,thickened,ud,unit,widest,ympodial	arrangement,bud,characteristic,colour,diameter,exertion,form,fruit,growth,height,history,inflorescence,length,life,lobing,na,number,per,perennial,plant,seed,shape,surface,texture,type,vein
421	wfo-0001030882	success	144	98	75	69	23	0.521	.5,0.5-1,0.5-1.1,0.8-1.1,0.8-2.4,0.9-1.1,1-1.3,1-1.5,1-4,1.6-2,2,2-5.4,2.2-4.6,3/4,6.5-15.6,8-12,acuminate,anther,apex,attenuate,base,berry,calyx,capitate,cm,corolla,crenulate,dia,difoliate,elliptic,exserted,fruit,fruiting,glabrous,globose,green,lateral,leaf,lightly,main,margin,minor,minutely,mm,narrowly,nearly,occasionally,ovary,ovoid,ovoid-reniform,pair,papillose,pedicel,petiole,pitted,shaped,shrub,simple,size,small,soon,stem,stigma,style,surface,tan,tear-drop,tree,truncate,tube,unit,vein,way,white,x	.1,0.5-0.75,0.75-1,2-6,3-3.5,?,accrescent,anthesi,bark,beginning,beneath,closely,conical,deflexed,deltoid,differing,eaf,edicel,eed,erect,extreme,filament,free,geminat,inflorescenc,lobe,lobed,lon,long,lower,major,middle,nflorescence,older,one,opposite,overlapping,pale,paler,papillo,peelin,planar,pore,poricidal,portion,prominent,raised,ruguse,ruit,scar,short,slender,slightly,spaced,straight,tall,tapering,terminal,thick,thickened,tip,transversely,tub,ud,widest,woody,yellowish,ympodial,young	arrangement,bud,characteristic,colour,diameter,exertion,form,geminate,growth,height,history,inflorescence,length,life,lobing,peduncle,plant,primary,seed,shape,sympodial,texture,type
422	wfo-0001030883	success	179	132	115	64	17	0.642	-3,.05,.1,.5,0.5-3,0.5-5,1-1.1,1-1.2,1-1.3,1-4,1.5-2,10-18,18-44.5,2-5,20-50-flowered,3/4,5-6,9.5-27.5,acuminate,acute,anther,apex,arching,bark,base,berry,brown,calyx,cell,clavate,cm,collapsed,corolla,dark,dia,dry,elliptic,epidermal,filament,finely,fleshy,fruit,fruiting,furcate,glabrous,glandular,globose,green,hollow,inflorescence,large,later,lateral,leaf,like,live,long,long-acuminate,main,massive,material,midrib,minute,minutely,mm,oblique,occasionally,older,opposite,ovary,ovate,ovoid-reniform,pair,pale,papillate,papillose,pedicel,perpendicular,petaloid,petiole,plant,pore,poricidal,puberulent,quite,reticulate,russet,seed,shaped,shrub,size,slender,soon,stem,stigma,stout,style,surface,tan,tapering,tear-drop,thick,time,tip,trichome,tube,uniseriate,upper,vein,wall,way,white,woody,x,young	1-1.5,1.5-3.5,3-3.5,3-4,accrescent,across,anthesi,apart,appearing,approximatately,becoming,branched,bu,collection,deflexed,differing,difoliate,eaf,edicel,eed,erect,evenly,free,geminat,geminate,hard,imbedded,laminar,lenticellat,less,little,living,lobe,lobed,lon,lower,malodorous,markedly,middle,narrowly,nflorescence,papillo,pitted,placenta,portion,present,proximal,pulp,rather,reflexed,ruit,scar,slightly,sometimes,spaced,straight,strongly,tall,triangular,two,ud,unit,widest,ympodial	alternate,approximately,arrangement,bud,characteristic,colour,diameter,form,growth,height,history,length,life,lobing,shape,texture,type
423	wfo-0001030884	success	218	137	112	106	25	0.514	0.4-3,0.5-1.2,0.8-1,1-1.2,1-1.5,1.5,1.5-2,1.5-2.5,100,2-5,4-13,5-30,5-6,6-25,9-11,>,abruptly,acute,along,anther,anthesi,apex,bark,basal,base,berry,brown,c.,calyx,capitate,cm,conical,dark,decurrent,densely,diameter,elliptic,filament,flower,fruiting,glabrous,glandular,gray-tinged,green,greenish,growth,half,inflorescence,lateral,leaf,length,like,lobed,long,long-styled,long-triangular,margin,mature,minute,minutely,mixture,mm,moderately,new,ovary,ovoid-reniform,pair,pale,pedicel,peduncle,per,petiole,plant,poricidal,prickly,primary,pubescent,red,reddish,reflexed,rest,sagittate,sessile,shallowly,short-stalked,short-styled,shrub,simple,size,slender,sparsely,spherical,spreading,stellate,stem,stigma,strongly,style,surface,tannish,tapering,tip,treelet,trichome,tube,uniseriate,vein,way,white,wide,wing,winged	.2,.5,.7,0.3,0.3-0.5,0.5,0.9-5,1,1-3,10,2,4-5,4.5-5,5,5-merous,5.5-7,6-10,6-8,7-8,abaxial,abaxially,adaxial,adaxiall,also,alyx,andromonoeciou,apar,arme,articulated,blade,broad-based,connivent,curved,di-,differing,directed,discolorous,distal,eaf,eed,equal,extend,extending,flowering,free,geminate,gree,herbaceous,heterostylous,infructescence,leafy,lobe,long-stalked,lower,magnification,midpoint,midrib,nflorescence,node,occasionally,older,one,onto,open,orolla,oung,outlin,papillat,pore,porrect,portion,present,prickle,principal,ray,reflexe,regularly,ruit,scar,scattered,shap,short,similar,spaced,stellate-pubescent,stiff,still,tall,tamen,time,trifoliate,unarmed,unicellular,uniformly,unit,upward,usually,vary,varying,visible,weakly,without,woody,yellow,ympodial,young	armed,arrangement,branch,bud,characteristic,colour,corolla,drying,exertion,form,fruit,glabrousnes,height,history,life,lobing,na,number,outline,papillate,perennial,seed,shape,texture,type
424	wfo-0001030899	success	146	92	70	76	22	0.479	-45,0.3-0.5,0.5-1,10-20,2-3,2-3.5,2.5-3.5,20-25,3-12,3-4,3-5,3.5-4,4-5,5-6.5,?,acuminate,apex,basal,base,bronze,calyx,cm,connective,cordate,deeply,densely,desc,diameter,dilated,distally,ellipsoidal,end,entire,ex,flattened,fruit,glandular-puberulent,globose,green,inside,lobe,margin,mm,mucronate,obconical,oblong,outside,ovate,ovoid,pedicel,peduncle,petiole,puberulent,pubescent,purple,rachi,radiu,shrub,simple,splotch,stellate,stigma,stripe,strongly,style,triangular,unbranched,white,x,yellow	.5-2,0.5,1,1-1.5,1-2,1-3,1-6,1.5-2,10-13,2,3-foliate,5-10,6.5-31,7-27,8-11,abaxially,absent,acute,adaxially,aggregate,apart,ape,articulated,axe,beyond,blade,cell,chartaceous,connivent,coriaceous,directed,eaf,eed,exceeding,exserted,extrorse,flower,glabrous,leaving,less,light,lon,long,lower,narrowly,nflorescence,nther,obtuse,orang,orolla,pedicellar,peltifor,perfect,pore,presen,puberulen,remnant,ruit,shorter,slightly,spaced,stamen,stone,tal,tem,thecae,time,tomento,tube,ud,unit,upward,vary,vein,wide,ympodial	anther,arrangement,bud,characteristic,colour,corolla,form,growth,height,inflorescence,leaf,length,ovary,peltiform,plant,seed,shape,size,stem,surface,texture,theca
425	wfo-0001030902	success	159	120	66	93	54	0.415	-2,0.6-1.5,1-6,1.5-13,1.5-2.5,10-15,2-3,2-5,2.5-4,3-13,4-7,5-7,5-9,6-24,8-14,acuminate,acute,angled,apex,apiculate,base,brown-pilose,calyx,cm,connivent,cordate,dark,deltate,densely,diameter,eglandular,ellipsoidal,entire,flattened,fruit,glabrescent,glabrous,globose,hair,lobe,long,margin,mature,mm,narrowly,oblong,occasionally,orange,ovate,pedicel,peduncle,petiole,purple,reddish,simple,stigma,style,subcoriaceous,tip,tree,triangular,truncate,tube,vein,x,yellow	-20,-5,0-15,1-2,1.5-,1.5-2,15-50,2,2.5,3-20,3-4,3.5-4,30-50,4,4-22,4-6,4-foliat,abaxially,absent,adaxially,aggregate,along,apart,ape,apically,articulated,axe,basal,beyond,blade,branched,brow,cell,connective,cylindrical,dilated,directed,distally,eaf,eed,equalling,exceeding,except,exserted,fleshy,flower,forked,glabrat,glandular,glandular-puberulen,laterally,leaving,lon,lower,nflorescence,nther,obtuse,orolla,pedicellar,perfect,pinkish,pore,presen,present,puberulence,purplish,rachi,radiu,rarely,remnant,ruit,shorter,slightly,small,somewhat,spaced,sparse,sparsely,stamen,stellate,stone,subcapitat,tal,tem,thecae,time,tomento,ud,unbranched,unit,vary,wide,ympodial	anther,appearance,arrangement,bark,border,branch,bud,characteristic,colour,corolla,corrugation,distal,drying,exertion,filament,form,fruiting,giving,glabrate,glabrousnes,growth,height,history,inflorescence,interjected,lateral,leaf,leaflet,length,life,lobing,midpoint,na,new,number,ovary,per,plant,prickle,primary,pseudostipule,ray,seed,shape,size,stem,subcapitate,surface,terminal,texture,thicknes,type,variation,width
426	wfo-0001030914	success	186	83	63	123	20	0.339	0.7-1,0.8-1.3,1.2-1.5,1.5-2,1.5-3,1.5-8,2-10,7-8,anther,bark,berry,bud,capitate,cm,corolla,dark,deflexed,elliptic,erect,exserted,fruiting,furcate,glabrate,glabrous,globose,golden,inflorescence,leaf,lemon-yellow,length,lobed,many,minutely,mm,obovate,ovary,ovoid-reniform,pale,pedicel,petiole,pitted,plant,puberulent,reddish-brown,shape,shaped,shrub,simple,small,stem,stigma,straight,style,surface,tan,tapering,tear-drop,time,tree,trichome,uniseriate,white,winged	.1,.5,/4,0-0.25,0.1-0.5,0.5-1,0.8-1,1-1.5,1-2,2-2.5,2.5-11,2.5-3,3-4,3.5-17,5-17,5-25-flowered,7-10,9-35,acute,along,anthesi,apex,attenuate,base,beneath,blade,calyx,campanulate,closely,constriction,decurrent,deltoid,densely,dia,differing,difoliate,distal,dry,eaf,edicel,eed,ellipsoid,equal,even,evenly,filament,flower,free,geminat,green,greyish-brow,individual,later,lateral,like,live,lobe,lon,long,long-styled,lower,main,major,margin,middle,minor,narowly,nflorescence,occasionally,often,older,one,onto,opposite,otherwise,overlappin,pair,papillo,papillose,planar,pore,poricidal,portion,prominent,pubescent,quite,raised,rest,ripe,rounded,ruit,scar,short-styled,size,slender,slightly,sometimes,soon,spaced,sparsely,specimen,tall,thick,third,ti,tip,trunk,tub,tube,ud,unit,usually,variable,vein,way,weight,widest,within,woody,x,yellow,ympodial,young	abaxial,adaxial,alternate,arrangement,characteristic,colour,diameter,exertion,form,fruit,growth,hair,height,history,life,lobing,perennial,seed,texture,type
427	wfo-0001030918	success	230	150	112	118	38	0.487	-2.3,-3.2,-40,-5,-6,-9,.5,0-25,0-4,0.3-1.5,0.5-0.7,0.6-2.5,0.7-1.2,0.7-1.7,1,1-1.5,1-1.8,1-2,1.5-2.5,1.5-5.5,2-2.5,2-25,2-7,2-8,2.8-3,3-4,abaxially,acicular,acute,anther,apex,apically,apparently,articulated,bark,base,berry,calyx,cell,chartaceous,cm,cuneate,dark,diameter,drying,dull,elliptic,erect,filament,flattened,flattened-reniform,fruit,fruiting,glabrous,green-brown,lateral,leaf,length,lobe,lobed,lobing,long,margin,mauve,midpoint,mm,moderately,narrow-deltate,obtuse,orange,orange-brown,outline,pair,pale,pedicel,peduncle,per,perpendicular,petiole,pit,poricidal,prickle,prickly,primary,purple,raised,ray,red,red-brown,reflexed,seed,shrub,simple,small,smooth,sometimes,somewhat,spherical,stellate,stellate-pubescent,stem,style,surface,tapering,terminal,tip,trichome,tube,vein,weakly,wide,yellow	-12,-4,-4.5,.7,0-10,0-20,0-6,0.1,0.1-0.25,0.2-0.4,0.25-0.45,0.5-2,0.5-2.5,0.6,1-4,1.5-2,1/2-2/3,1/2-3/4,1/3,1/3-,1/3-1/2,1/4-1/3,2-10,2-3,2-4,2/,3-15,3-6.5,3-7,3.5-6,4-7,5-7,5-8,5-merous,5.5-7,6-8,7-10,abaxial,adaxial,alyx,ame,apar,apart,blade,branched,brow,c.,caudat,connivent,curved,deltate,densely,difoliate,discolorous,distance,eaf,elongated,elongating,equal,evenly,extending,faint,flower,free,geminat,glabrescent,green,infructescence,longer,lower,mature,maturity,midvein,mixture,nflorescence,oblong,occasionally,older,one,open,orolla,oung,pendulous,perfec,pericarp,porrect,portion,prickl,pubescent,reduced,ruit,scandent,scar,secondary,sessile,side,slender,spaced,sparsely,spreading,stalk,stalked,straight,strongly,tamen,terete,tertiary,time,unit,upper,usually,vary,venation,visible,way,woody,ympodial,young	appearance,arrangement,border,branch,brown,bud,caudate,characteristic,colour,corolla,corrugation,distal,exertion,form,giving,glabrousnes,growth,height,history,inflorescence,interjected,leaflet,life,na,new,number,ovary,perennial,plant,pseudostipule,shape,size,stigma,texture,thicknes,type,variation,width
428	wfo-0001030943	success	167	123	97	70	26	0.581	.5,0,0.5-1,1-1.2,1-1.5,1.1,1.5-2,1.8-2.2,1/2,12-15,2-6,3,3-4,3/4,4-4.5,7-13.5,abaxial,absent,acuminate,acute,adaxial,age,anther,apex,apical,bark,basal,base,becoming,berry,bi-lobed,black,branch,calyx,cm,conical,corolla,decurrent,dendritic,densely,diameter,drying,echinoid,elliptic,exserted,filament,flattened,fruiting,glabrous,globose,golden,golden-yellow,growth,im,large,lateral,leaf,lenticular,minute,minutely,mm,narrowly,outline,ovary,overtopping,pale,pedicel,per,petiole,pitted,plurifoliate,pore,poricidal,pubescent,purplish-black,reddish-brown,scattered,shoot,shrub,slit-like,small,stem,stigma,strongly,style,surface,tapering,terminal,tip,tree,tree-like,trichome,tube,violet,way,x,yellowish-white	0.5-3,10-25,4-5,4-6,7-8,8-10,abaxially,adaxially,along,anthesi,belo,branching,cupulate,dark,deflexed,denser,eaf,edicel,eed,elongate,erect,ew,fide,flower,free,glabrat,horizontal,inserted,lobe,lobed,lon,long,lower,m.,main,monochasia,nflorescence,nodding,often,older,pair,papillo,pearce,pericarp,planar,portion,raised,ruit,scar,secondary,showy,sleeve,slightly,somewhat,sparsely,stamen,tall,thin,time,triangular,tub,ud,unit,upper,vein,wide,woody,yellow,ympodial,young	arrangement,bud,characteristic,colour,exertion,form,fruit,glabrousnes,height,history,inflorescence,length,life,lobing,monochasial,na,new,number,papillose,peduncle,plant,seed,shape,size,texture,type
429	wfo-0001030959	success	164	84	59	105	25	0.36	.8,/5,0.5-1.5,0.7-1.2,1-10,1-7,1.2-1.8,10-15,2.5-5,4-6,5-9,almost,anther,apart,apex,bark,base,brown,brown-green,cm,color,deltate,diameter,drying,elliptic,erect,filament,fresh,glabrous,glandular,hair,inflorescence,known,lateral,leaf,length,long-acuminate,margin,membranous,minute,mm,pedicel,peduncle,petiole,prickle,scar,shrub,simple,spaced,straight,straw,style,subentire,surface,tapering,toward,tube,way,yellow	.05,.2,0.5,1-2,1.5-2,1.5-3.5,1/5-1/10,2-4,2.5-4,2.5-4.5,4-8,5-6,5-merous,6-8,9-12,abaxially,alyx,ame,apar,apically,apparently,armed,articulated,blade,branched,c.,concolorous,connivent,cuneate,curved,densely,difoliate,distributed,eaf,eed,equal,evenly,flower,free,geminat,gently,glabrescent,glabrou,green-brow,know,less,like,lobe,lobed,long,long-acuminat,longer,lower,midpoint,narrow-deltate,nflorescence,numerous,older,one,open,orolla,oung,pair,part,perfec,perpendicular,poricidal,porrect,portion,present,prickl,prickly,primary,prominent,ray,ruit,scrambling,secondary,sessile,several,short,side,slender,sparsely,spreading,stellate,stellate-pubescent,stem,tamen,terete,tertiary,time,tip,trichome,unarmed,unit,usually,vary,vein,venation,visible,whole,wide,ympodial,youngest	0.2,abaxial,adaxial,arrangement,calyx,characteristic,colour,corolla,form,fruit,green-brown,growth,height,history,life,lobing,na,ovary,perennial,plant,seed,shape,texture,type,width
430	wfo-0001030982	success	215	140	124	91	16	0.577	-2-2.5,.1,.5,0.05,0.05-0.5,0.5,0.5-0.9,0.5-1,1-1.5,1.5,1.5-2,2/3,3-8,4-12,6-8,abaxially,acuminate,acute,adaxially,angular,anther,apex,base,berry,broadly,brown,brownish,bud,caducous,calyx,capitate,chartaceous,ciliate,cm,conic,conical,corolla,dark,diameter,dry,drying,ellipsoid,elliptic,enlarged,entire,exerted,external,filament,flattened-reniform,flower,form,fresh,fruit,fruiting,glabrescent,glabrous,globose,golden-green,green,growth,impressed,inconspicuously,larger,later,leaf,less,long,margin,material,maturity,minutely,mm,mostly,new,obovate,occasionally,olive,opposite,ovary,ovate,pair,pale,papillate,papillose,pedicel,peduncle,pitted,plant,poricidal,primary,prominent,puberulent,pubescent,reddish,reflexed,revolute,rhizomatous,sagittate,seed,shoot,simple,sinuate,size,slightly,somewhat,sparsely,stem,stigma,strongly,style,subshrub,surface,tip,trichome,tube,uniseriate,vegetative,vein,way,weakly,white,x,yellowish,young	.2,0.1,0.1-0.15,0.2-3,0.3-2,0.5-3,1,1-8,1.5-3,3-21,4-5,age,anisophyllous,anthesi,ape,appressed,ba,beneath,central,channelled,closely,cream,cucullate,cuneate,curved,deflexed,deltate,differing,difoliate,distall,distally,distichou,eaf,edicel,eed,extension,fleshy,foliage,free,geminate,glandular,glandular-papillose,greenish,hilum,internal,isostylous,lengthening,like,live,lobe,lobed,lower,major,materia,midvein,minor,near,nflorescence,oblique,often,one,overlappin,packed,papillae,papillat,petiole,planar,pore,portion,projection,prominently,rest,ruit,scar,separated,sigmoidally,situated,slit,stamen,straight,stripe,testa,tetramerous,tightly,time,transverse,tub,ud,unit,veined,ympodial	abaxial,adaxial,arrangement,characteristic,colour,exertion,glabrousnes,height,history,inflorescence,length,life,lobing,shape,texture,type
431	wfo-0001030989	success	177	120	97	80	23	0.548	.5,0.5-1,1-1.5,1-10,1-2,12-15,15-27.5,2-3.5,3-4,3-5.5,3-7.5,4-5,4-8,5,5.5-7.9,6-13,6-6.5,9-10,abaxially,adaxially,anther,apart,articulated,berry,blade,brownish,cell,chartaceous,ciliate,cm,condition,conical,connivent,corolla,covering,densely,diameter,dorsally,drying,edge,end,filament,flat,flower,folded,forked,fresh,fruit,glabrous,green,greenish,hair,hair-like,herb,homostylous,interjected,lanceolate,lateral,leaf,leaflet,light,like,long,margin,minute,mm,occurring,odd-pinnate,ovoid,pedicel,peduncle,petiole,plant,proximal,pubescent,ripe,rotate,seed,semierect,singly,size,sparsely,stem,style,terminal,testal,thick,tube,tuber,typically,unwinged,violet,wall,whitish,wide,x,yellow	3-20,4-7,5-merou,acuminate,ag,alyx,apex,apparently,axe,axillary,base,bud,capitat,decreasing,digestion,distal,eaf,eed,enzyme,erec,especially,geminat,generally,glabrou,gradually,green-white,half,honeycomb-shaped,larger,lengthening,living,lobe,lower,make,mucilaginous,nflorescence,obtuse,orbicular,orolla,ovate,ovate-lanceolate,pair,pale,perfect,petiolule,plurifoliate,pore,poricidal,present,pubescen,ray,removed,ruit,secondary,seudostipule,slit,spaced,specimen,ste,stigma,stolo,subequal,subsessile,subtending,symmetrical,tall,tamen,tem,thir,throughout,tip,toward,tri-,triangular,unit,usually,vary,wet,wider,ympodial	5-merous,arrangement,articulation,calyx,capitate,colour,erect,form,growth,height,history,inflorescence,length,life,occurrence,ovary,pseudostipule,shape,spacing,stolon,surface,texture,third
432	wfo-0001030991	success	204	128	106	98	22	0.52	.5,0,0.5,0.5-0.7,0.5-1,0.5-1.5,0.7-1.2,1-1.5,1-1.6,1-2.2,1-2.5,1.5,2/3,3-5-lobed,9-11,absent,acuminate,acute,along,angled,anther,anthesi,apex,apparently,appressed,ascending,attenuate,basal,base,berry,brown,calyx,capitate,cm,corolla,densely,diameter,ellipsoid,ellipsoidal,elliptic,elongate,entire,exerted,filament,filiform,flattened,fruiting,furcate,fusiform,glabrous,globose,grey,growth,herb,inflorescence,lanceolate,lateral,leaf,leaf-opposed,like,lobed,margin,minutely,mm,narrowly,nearly,new,occasionally,pedicel,peduncle,per,petiole,pinnatifid,pitted,pubescent,red,reniform,rest,ripe,scattered,short,shrub,simple,slightly,small,sparsely,stellate,stem,stigma,strongly,style,suffrutescent,surface,terminal,trichome,tube,uniseriate,variably,vein,violet,weak,white,winged,x,yellowish,young	0.1,0.2,0.2-0.7,0.3-0.4,0.5-3.5,0.6-0.8,1-7,10-20,2-plurifoliat,2.5-10,2.5-3,3-,4-10,5-5.5,5-merou,<,abaxially,adaxiall,adaxially,ag,alyx,arising,ark,articulated,bulbous,cell,color,conical,connivent,different,distally,drying,eaf,eed,enlarged,eye,flower,free,frui,glabrescen,ilament,incised,leave,lengthening,less,lobe,long-triangular,loosely,lower,midrib,minute,nflorescence,nodding,often,older,orolla,outline,packed,pair,papillo,part,particularly,pendant,perfect,pericarp,platfor,pointing,pore,poricidal,portion,primary,pseudoumbel,rectangular,reflexed,rootstoc,ruit,scar,shallowly,shiny,sleeve,slit,somewhat,spreading,tangled,tem,testal,thin,tightly,tip,twinin,ud,uniformly,unit,upper,vary,weight,woody,ympodial	arrangement,bark,bud,characteristic,colour,exertion,form,fruit,glabrousnes,height,history,length,life,lobing,number,ovary,plant,seed,shape,size,texture,type
433	wfo-0001031005	success	231	96	79	152	17	0.342	/3-1/2,0.8,0.9,1-2,1-2.5,1-3,2-3.2,2.3-3,2.5,acuminate,acute,almost,anther,anthesi,apex,apically,attenuate,bark,base,berry,black,blue,brachyblast,branch,branched,brown,calyx,capitate,chartaceous,clustered,cm,conical,corolla,cupular,dendritic,diameter,dilated,drying,elliptic,form,fruit,fruiting,glabrous,greenish,lateral,leaf,length,liana,lobed,membranous,mm,oblong,obovate,occasionally,older,orange-brown,ovoid,pedicel,peduncle,petiole,pubescent,purple,ridged,seed,short,slender,somewhat,sparsely,stem,stigma,style,surface,terminal,thick-chartaceous,tip,toward,unarmed,white,x	.4,.5,0-0.5,0.1,0.3-0.5,0.5-1.5,1,1-1.5,1.5-2.5,1.5-4,10,2.5-4,3-10,3-4,3-6.5,4-6,5,5-7,5-8,5Â°,6-12,abaxial,abaxially,accrescent,adaxially,age,along,alyx,apar,apparently,articulated,branching,clearly,clum,common,concolorous,curved,dark,datum,deeply,delineated,deltoid,dendritic-pubescent,denser,density,detaching,developing,discolorous,divided,domatia,eaf,ellipsoi,elongated,entire,equal,evenly,extending,eye,fertilisation,filament,fine,flat,flattened,flexuous,flower,forming,free,immature,increasing,inside,junction,known,leave,lengthening,like,linear,lobe,long,longitudinally,loop,lower,m.,main,margin,midvein,minute,much,naked,network,nflorescence,nther,obscure,occasional,often,onl,orolla,ou,outside,ovate,pair,pendulous,perfec,pericarp,plurifoliat,pointed,pore,poricidal,portion,primary,prominent,protruding,rachi,raised,ray,region,rest,ruit,scar,secondary,side,simple,smaller,smoot,smooth,sometimes,soon,spread,spreading,standing,strongly,stump,surrounding,tangling,tearing,terete,tertiary,thin,trichome,tube,ud,uneven,unit,usually,vary,vein,venation,visible,weakly,well-developed,wide,ympodial,young	arrangement,characteristic,colour,exertion,glabrousnes,growth,inflorescence,lobing,na,new,number,ovary,per,shape,size,texture,type
434	wfo-0001031007	success	207	173	150	57	23	0.725	.5,0.2,0.5-1,0.5-10,0.75-1.5,1,1-1.2,1-1.5,1-3.5,1.2-1.5,1.6-2,1.9-3,1/3,11-14,15,3-4,4-7,5,5.5-6,50-100,6,7-10,8-10,<,acute,alfway,almost,along,anther,anthesi,apex,apparently,articulated,base,beginning,berry,bifid,black,branched,broad,brown,c.,calyx,campanulate,capitate,cell,chartaceous,clustered,cm,completely,connivent,corolla,cuneate,dark,dendritic,densely,diameter,dilated,drying,dull,elliptic,entire,exserted,extending,filament,flattened-reniform,fleshy,flower,fruit,fruiting,glabrous,globose,growth,herbarium,impressed,inflorescence,intramarginal,irregularly,lamina,leaving,lengthening,lilac,lobe,lobed,long,looping,loose,loosely,many,margin,markedly,matte,midvein,minutely,mm,narrowly,near,new,nodding,occasionally,often,outline,papillate,pedicel,peduncle,peg,petiole,pitted,planar,pore,poricidal,primary,prominent,pubescent,reddish,revolute,round-rectangular,sagittate,scar,shiny,shrub,simple,sleeve,slender,slightly,slit,spaced,sparsely,specimen,stellate,stellate-pentagonal,stem,stigma,strongly,style,surface,tangled,terminal,testal,time,tip,trichome,tube,usually,vein,vine,way,woody,x,yellow	0.5,1.3-,1.5-2,2.5-,2.5-5,4-6,4.5-5,5-12,5-merou,abaxiall,abruptly,ag,alyx,apar,ark,becoming,branching,broadly,cup-shaped,deltate,eaf,eed,ellipsoid,free,geminat,glabrescen,glabrou,ilament,junction,lax,lower,m.,multi-celled,narrowing,nflorescence,older,orolla,pale,papillat,per,perfect,pericarp,plurifoliate,portion,rat,ruit,splitting,spreading,stout,thin,tiny,twining,ud,unit,upper,vary,ympodial	abaxial,abaxially,age,apart,arrangement,bark,characteristic,colour,exertion,form,glabrousnes,height,leaf,length,lobing,ovary,paler,plant,seed,shape,size,texture,type
435	wfo-0001031007	success	206	121	101	105	20	0.49	0.2,0.75-1.5,1,1-1.5,1-3.5,1.2-1.5,1.6-2,1.9-3,15,3-4,4-6,5.5-6,6,7-10,<,acute,adaxial,alfway,almost,along,anther,anthesi,apex,bark,base,becoming,beginning,berry,bifid,black,branched,broad,brown,c.,calyx,capitate,chartaceous,cm,completely,corolla,cuneate,dendritic,diameter,ellipsoid,elliptic,entire,exserted,extending,filament,flattened,fleshy,fruit,fruiting,glabrous,globose,growth,inflorescence,lamina,lilac,lobed,long,loose,many,margin,minutely,mm,narrowly,near,new,occasionally,pedicel,peduncle,per,petiole,pitted,poricidal,pubescent,reddish,reniform,revolute,sagittate,shrub,simple,slender,sparsely,stem,stigma,strongly,style,surface,tall,tangled,terminal,time,tip,trichome,tube,usually,vein,vine,wide	.5,0.5,0.5-1,0.5-10,1-1.2,1.3-,1.5-2,1/3,11-14,2.5-,2.5-5,4-7,4.5-5,5,5-12,5-merou,50-100,8-10,abaxially,abruptly,ag,alyx,apar,apparently,articulated,branching,broadly,campanulate,cell,clustered,cup-shaped,dark,deltate,densely,dilated,drying,dull,eaf,eed,flower,free,glabrescen,glabrou,herbarium,ilament,impressed,intramarginal,irregularly,junction,lax,leaving,lengthening,lobe,looping,lower,m.,markedly,matte,midvein,multi-celled,narrowing,nflorescence,nodding,often,older,orolla,outline,pale,papillat,papillate,peg,perfect,pericarp,planar,plurifoliat,pore,portion,primary,prominent,rat,round-rectangular,ruit,scar,shiny,sleeve,slightly,slit,spaced,specimen,splitting,spreading,stellate,stellate-rotate,stout,testal,thin,tiny,twinin,ud,unit,upper,vary,way,woody,ympodial	abaxial,arrangement,bud,characteristic,colour,exertion,form,glabrousnes,height,leaf,length,lobing,number,ovary,plant,seed,shape,size,texture,type
436	wfo-0001031036	success	150	127	99	51	28	0.66	.2,.25,.5,0.8-1,0.8-1.2,1-1.3,1-2.5,1.2-1.5,1.5-3,10-20-flowered,12-15,2-2.5,4.5-6.5,5-6,7-8,abaxially,acuminate,acute,adaxially,along,angle,anther,apex,axil,base,becoming,berry,bi-lobed,broadly,brown,calyx,cm,conical,corolla,crisped,dark,decurrent,dia,difoliate,dry,drying,ellipsoid,elliptic,exserted,filament,filiform,flattened-reniform,fruiting,glabrous,globose,green,greenish-white,lateral,leaf,lobed,long,main,margin,material,minutely,mm,nearly,oblique,onto,opposite,ovary,pair,papillose,pedicel,petiole,pitted,pointed,poricidal,sagittate,shiny,short,shrub,simple,size,slightly,soon,stem,stigma,strongly,style,surface,tapering,thickened,tip,trichome,tube,uniseriate,unit,usually,vein,white,winged,x,yellowish	0.5-1,2.2-3.7,3-4,3-5,3.5-5.5,anthesi,arising,ba,closely,deflexed,differing,eaf,edicel,eed,enlarged,erect,fleshy,free,fresh,geminat,knob-like,lamina,lobe,lon,lower,major,middle,minor,nflorescence,older,overlappin,papillo,perhaps,planar,pore,portion,rounded,ruit,scar,shaped,sinus,spaced,spathulate,tall,tear-drop,tub,ud,widest,woody,ympodial,young	arrangement,branch,bud,characteristic,colour,corrugation,diameter,exertion,form,fruit,geminate,glabrousnes,growth,height,history,inflorescence,length,life,lobing,new,peduncle,plant,primary,seed,shape,sympodial,texture,type
437	wfo-0001031064	success	179	109	85	94	24	0.475	.0-2.5,.5,0,0.5-0.7,1-1.2,1-2,1-3,1.2,1.7-4.2,10-12,10-12.5,10-17,2.5-3,3-5.5,3-7,3.5-4,5-10.5,5-6,6-16,7-16,anther,basal,base,berry,bright,cm,completely,conical,conspicuous,corolla,dark,densely,diameter,elongate,filament,fleshy,fruit,fruiting,glabrous,globose,green,half,inflorescence,lateral,leaf,leaflet,lenticel,lobed,lower,minute,minutely,mm,nearly,node,obovate,occasionally,ovary,ovate,ovoid-reniform,pair,pedicel,per,petiole,pinnate,pubescent,purple,rachi,scattered,short-pubescent,shrub,simple,somewhat,sparsely,stem,stigma,style,terminal,translucent,trichome,tube,uniseriate,white,winged,without,x	.05,.5-1,0-15,0.5,0.5-0.8,1,1.5-2,2,3,4-5-celled,8-10-celled,abaxially,acroscopic,acuminate,adaxially,along,anthesi,anticlinal,apex,arising,attenuate,axil,bearing,blade,broader,calyx,cell,clavat,commentary,deltate,denser,distal,dr.,eaf,edicel,eed,epidermal,erec,exserted,flower,free,highly,irregular,irregularly,lamina,leave,lightly,like,lobe,lon,long,lost,margin,narrower,near,nflorescence,nodding,often,open,papillate,petiolule,planar,poricidal,portion,projection,prominent,pubescen,rugose,ruit,scar,see,side,single,sinuous,sinus,slender,smaller,splitting,strongly,surface,swollen,tal,tem,thickening,time,tip,tub,ud,unifoliat,unit,usually,vein,wand-like,ympodial	abaxial,adaxial,arrangement,bud,clavate,colour,dry,form,glabrousnes,growth,height,history,length,life,lobing,number,perennial,plant,seed,shape,size,texture,type,variation
438	wfo-0001031071	success	186	101	80	106	21	0.43	0-10,0.2-0.8,1-1.5,1-2,1.5-2.2,2-8,2.1-3,2.4-3.4,3-10,3.8-5.4,5-9.4,5.7-8.8,6-8,7-16.5,7-8,8-28,anther,berry,blade,blue,brownish,clavate,cm,color,condition,coriaceous,corolla,dark,deep,diameter,distal,drying,filament,forked,fresh,fruit,generally,glabrous,globose,green,green-white,greenish,half,herb,interjected,lanceolate,lateral,leaf,leaflet,lilac,long,medium,mm,moniliform,mottled,mucilaginous,odd-pinnate,ovate,ovoid,pedicel,peduncle,pentagonal,petiole,plant,purple,rotate,seed,size,spot,star,stigma,style,terminal,throughout,tuber,wet,white,whitish,x,yellow	0.4-2,1-3,1-7,2-3,2-5,3-5,3-6,4-25,4-6,5-merou,abaxiall,abaxially,acumen,acute,adaxially,ag,along,alyx,apart,apex,apparently,arranged,articulated,asymmetric,attenuate,axe,axillary,base,basiscopic,bead,bud,capitat,cell,connivent,covering,decreasing,digestion,dorsally,eaf,edge,eed,elliptic,enzyme,erec,exceeding,flat,flower,folded,geminat,glabrou,hair-like,homostylous,honeycomb-shaped,lengthening,like,living,lobe,lower,make,middl,multiple,narrowly,necklace,nflorescence,orbicular,orolla,pair,perfect,petiolulate,plurifoliate,pore,poricidal,removed,ripe,round,ruit,sessile,seudostipule,short,side,slightly,slit,spaced,specimen,stamen,stolon,straight,subequal,subtending,tall,tamen,tem,testal,thick,tip,tissue,toward,tri-,tube,typically,unit,usually,vary,wall,winged,ympodial	abaxial,adaxial,arrangement,calyx,capitate,colour,form,growth,height,history,inflorescence,length,life,ovary,pseudostipule,shape,staman,stem,surface,texture,type
439	wfo-0001031097	success	174	94	74	100	20	0.425	0.45,1-4,1-4.5,1.6-5.5,1.8-2.5,1.8-2.6,13-30,2-3,2-3.3,3-5,3.5-6,3.7-8.4,4-6,5-11,5-12,5-9,8-11,9-21,abaxial,abaxially,adaxially,along,branched,calyx,cm,corolla,cyme,darker,deep,diameter,dichasial,dichasially,dotted,ebracteate,edge,filament,forked,green,green-white,herbaceous,lateral,leaf,leaflet,light,lighter,long,margin,medium,mm,monochasial,mottled,narrow,odd-pinnate,ovoid,pedicel,peduncle,pentagonal,perennial,petiole,plant,puberulent,pubescent,purple,rotate,seed,side,size,strigose,style,terminal,throughout,violet,violet-blue,wide	0.5,1,1-3,1.5,2-4,3-6-foliat,4-7,acumen,acuminate,acute,apex,apical,apically,articulate,base,cell,connate,covering,cuneate,decurrent,dehiscent,digestion,diminishing,distal,dorsally,eaf,eed,elliptical,emoval,enzyme,exceeding,flat,flower,folded,frequently,generally,globo,gree,hair-like,half,highly,honeycomb,interjected,interpetalar,introrse,living,lobe,lon,lower,lunat,make,maturing,mucilaginous,nflorescence,noticeably,nther,oblique,obovate,often,orolla,ovate,pair,pattern,perfect,petal,petiolulate,petiolule,plan,poricidally,proximal,rachi,rapidly,rarely,reveal,ruit,sessile,seudostipule,short,slit,sometimes,specimen,stamen,stigma,straight,tal,tem,testal,thick,tissu,toward,tuber-bearing,typically,unit,vary,vbase,wall,without,yellow,ympodial,Â¼	adaxial,anther,arrangement,colour,form,fruit,globose,growth,height,history,inflorescence,length,life,ovary,pseudostipule,shape,stem,texture,type,width
440	wfo-0001031101	success	197	130	105	92	25	0.533	-1,-5,/2,0.3-0.5,0.5-0.8,0.5-3,0.6-0.8,0.8-,1-2,1-2.3,1.3-2,1.3-2.5,1.4-1.7,1/4-1/2,2-2.8,2-6,2.5-3.5,2.5-3.8,3-15,4-7,abaxially,acuminate,almost,anther,apex,apical,apically,apparently,articulated,bark,base,berry,branched,bright,calyx,cm,deltate,diameter,dull,entire,erect,evenly,filament,filiform,flattened-reniform,fruiting,glabrescent,glabrous,glandular,green,green-brown,hair,lateral,leaf,length,lobed,long,long-acute,margin,maturity,mauve,membranous,minute,mm,moderately,narrow-deltate,near,obtuse,often,orange-brown,orange-red,ovate,pale,pedicel,peduncle,petiole,poricidal,red,resembling,rounded,shrub,simple,sparsely,spherical,spreading,stellate,stellate-pubescent,stem,straight,style,surface,tapering,terete,terminal,tip,trichome,tube,umbel,unarmed,way,white,wide,yellow,yellow-green,young	-16,-20,-30,-8,/2-equal,0.05-0.2,0.1-0.2,0.1-0.3,0.7-0.8,1-,1-3,1.5-3,1/3-1/2,10-30,2-4,2-5,2.5-,3-10,3-8,3.5-4.5,4-10,4-5-merous,4.5-9,5-20,5-6,6-10,8-15,abaxial,adaxial,alyx,ame,apar,ba,blade,c.,concolorous,connivent,difoliate,drying,eaf,eed,elongating,equal,flower,free,frui,geminat,herbaceous,infructescence,lobe,long-acuminat,longer,lower,mature,midpoint,multangulate,nflorescence,older,one,open,orolla,oung,pair,pendulous,per,perfec,pericarp,porrect,portion,primary,ray,red-brow,ruit,scandent,scar,sessile,smooth,spaced,stalk,stalked,stellate-pubescen,tamen,tertiary,time,unarme,unit,variously,vary,vein,venation,visible,ympodial	arrangement,branch,characteristic,colour,corolla,exertion,form,fruit,glabrousnes,growth,height,inflorescence,lobing,long-acuminate,na,new,ovary,plant,red-brown,seed,shape,size,stigma,texture,type
441	wfo-0001031114	success	208	136	115	93	21	0.553	.2,.5,0.5,0.5-1,0.7-1.5,0.8-1.2,1-10,1-2,1-7,1.5-4,2-17,2-3,2-4,2-7,2.5-3,2/3,25-50,3-10,3-4,4-10,4.5-6,6-7,acuminate,acute,anther,apex,base,becoming,berry,branched,brown,calyx,chartaceous,cm,connivent,cylindrical,dark,deltate,densely,diameter,discolorous,distal,echinoid,elliptic-ovate,entire,equal,erect,especially,filament,first,flattened,fleshy,flower,free,fruit,glabrous,globose,green,hair,highly,homostylous,lacking,leaf,leaf-opposed,light,lobe,long,margin,membanaceous,mm,multangulate,nearly,nodding,oblong,obtuse,outline,ovate,part,pedicel,peduncle,petiole,porrect,pubescent,purple,rachi,reniform,ripe,rounded,rugulose,shrub,simple,small,sparsely,stellate,stellate-pubescent,stem,stigma,straight,strongly,style,subcoriaceous,subcuneate,surface,thickened,tip,toward,tree,truncate,tube,white,white-pubescent,white-stellate,x,yellow,yellowish	.1,0-0.3,0.3-0.5,1-1.5,1-4.5,1-8,1.5-2.5,10-15,3-5,3-7,4-5,4-8,5-10,5-8,5-merou,7-15,abaxially,absen,accrescent,adaxiall,adaxially,ag,alyx,apart,apparently,articulated,axe,ba,blade,capitat,covering,differentiated,directed,distally,dried,eaf,eed,frui,fruiting,geminate,impressed,interpetalar,introrsely,juic,large,like,long-stalked,longitudinal,lower,major,midpoint,minor,nflorescence,often,one,opening,orolla,paired,perfect,pericarp,plurifoliate,pore,prominent,ray,ruit,sessile,short,short-,short-stalked,side,slightly,slit,somewhat,spaced,stalk,ste,subcucullate,subtending,tall,tamen,tem,thin,time,tissue,triangular,unarme,unit,vary,vein,whitish,wide,without,ympodial	5-merous,abaxial,adaxial,arrangement,capitate,characteristic,colour,corolla,form,growth,height,inflorescence,length,ovary,plant,seed,shape,size,staman,texture,type
442	wfo-0001031116	success	191	149	127	64	22	0.665	-10,.5,.8,/4,0,0.05-0.15,0.3-0.5,0.7-0.9,0.7-1,1-5,1/2,2-5,2.7-3.2,3.5-4,30-100,4-10,4-7,8-11,9-13,abaxial,abaxially,acuminate,adaxial,almost,ame,anther,apex,apically,apparently,articulated,attenuate,bark,base,berry,branching,bristle,broad-deltate,c.,calyx,caudate,cm,collapsed,connivent,densely,diameter,discolorous,drying,dull,elliptic,epidermi,erect,evenly,filament,flat,flattened-reniform,flower,fragile,fruit,fruiting,glabrescent,glabrous,glaucous-green,green,lateral,leaf,length,lobe,long,lower,margin,maturity,mauve,membranous,midpoint,mm,moderately,multangulate,narrow-deltate,obovate,obtuse,often,orange-brown,orange-red,pair,pedicel,peduncle,petiole,poricidal,primary,ray,recurved,red-brown,reflexed,rounded,secondary,sessile,sharply,shortly,shrub,simple,slender,small,soft,sometimes,sparsely,spherical,stalked,stellate,stellate-pubescent,stem,straight,style,subentire,surface,tapering,tip,tree,trichome,tube,unarmed,upper,vein,way,weakly,wide,yellow,young	.2,0.1,0.4-0.7,1,1/3-2/,1/6-1/4,10-14,15-25,30-50,5,5-15,5-merous,alyx,apar,apart,arachnoid,blade,brow,clearly,dirty-white,eaf,eed,elongated,elongating,equal,flexuous,free,hair,infructescence,less,lobed,longer,mature,minute,nflorescence,obtu,older,one,open,orolla,oung,per,perfec,pericarp,perpendicular,plurifoliat,portion,ruit,scar,single,smooth,spaced,stalk,tamen,terete,tertiary,time,unarme,unit,vary,venation,visible,woody,ympodial	1/3-2/3,arrangement,branch,brown,characteristic,colour,corolla,exertion,form,glabrousnes,growth,height,inflorescence,lobing,new,ovary,plant,seed,shape,size,texture,type
443	wfo-0001031128	success	213	129	105	108	24	0.493	/4,0.3-0.8,0.5-0.7,0.5-0.8,0.6-1,0.8-1.7,1-1.6,1.2-2,1.5-3,3-4,3.5-4.5,4-7,5-19,almost,anther,apex,apparently,articulated,bark,base,berry,branched,bristle,brown,calyx,cm,concolorous,connivent,cuneate,densely,diameter,drying,dull,elliptic,entire,erect,evenly,filament,filiform,flattened-reniform,fruit,fruiting,glabrescent,glabrous,glandular,green,hair,inflorescence,lateral,leaf,length,lobed,long,long-acuminate,lower,margin,maturity,mauve,membranous,minute,mm,moderately,multangulate,narrow-deltate,near,orange-brown,pale,pedicel,peduncle,petiole,poricidal,purple-black,recurved,red,red-brown,reflexed,sessile,shallowly,short-attenuate,shrub,simple,soft,spherical,spreading,stalked,stellate,stellate-pubescent,stem,straight,style,surface,tapering,terminal,tip,trichome,tube,unarmed,undulate,variously,way,white,wide,yellow,yellow-green,young	-10,-100,-4.5,-6.5,0,0-30,0.05-0.2,0.05-0.25,0.2,0.2-0.4,0.5-1.5,0.5-5,1,1-,1.5-3.5,1/,1/6-1/3,10-20,10-35,2-5,2-9.5,2.3-,2.5-10,2.5-3.5,20-50,20-60,4-5-merous,5-,5-15,5-30,8-12,8-23,abaxial,abaxially,acute,alyx,apar,apart,ape,apically,blade,branching,deltate,eaf,eed,elongated,elongating,equal,eye,flexuous,flower,free,gland,gra,infructescence,less,lobe,lon,long-acuminat,longer,mature,midpoint,multangualte,naked,nflorescence,occasionally,often,older,one,open,orolla,oung,pair,per,perfect,pericarp,perpendicular,plurifoliat,portion,primary,ray,reduced,ruit,scar,secondary,short-styled,side,single,smooth,spaced,stalk,staminate,tamen,terete,tertiary,time,unarme,unit,usually,vary,vein,venation,visible,weakly,whitish,woody,yellow-brown,ympodial	0-10,1-6.5,1/3,20-60-100,arrangement,branch,characteristic,colour,corolla,exertion,form,glabrousnes,gray,growth,height,lobing,new,ovary,plant,seed,shape,size,texture,type
444	wfo-0001031135	success	189	148	97	92	51	0.513	0-2,0.7-2,1-1.5,1-10,1-3,1.5-2,1.5-3,10-20,2,2-,2-2.5,2-23,2-3.5,2-4,2.5-28,3-4,3.5-12,5-30,5-9-pinnate,abaxially,acuminate,acute,adaxially,adpressed,also,apex,basal,base,beyond,calyx,cm,compound,cordate,cuneate,cylindrical,darker,deflexed,deltate,densely,diameter,ellipsoidal,entire,exserted,fading,flattened,flower,frequently,fruit,fusiform,green,lateral,leaf,leaflet,light,lobe,lobed,long,longitudinal,margin,mm,moderately,obconical,oblong,obtuse,often,ovoid,pedicel,peduncle,peltiform,petiole,pilose,pink,pinnately,pinnatifid,puberulent,pubescent,purple,ripe,shrub,simple,sparsely,stamen,stigma,stripe,style,tip,tree,triangular,truncate,tube,unbranched,unlobed,white,whitish,x,yellow-green,yellowish	-7,0.5-2,1-,1-2.5,1-4,1.5-9,2-3,2-5,3-10,3-5,4-5,4-foliat,5-11,7-15,absent,aggregate,along,apart,ape,articulated,axe,basiscopically,biglandula,blade,broad,campanulate,cell,chartaceous,color,connective,coriaceous,decurrent,dilated,directed,distally,eaf,eed,eglandular-pubescent,ellipsoida,elliptic,equal,especially,exceeding,glabrous,glandular-,hair,interstitial,irregularly,laterally,leaving,lon,lower,midrib,narrowed,nflorescence,nther,oblique,occasionally,orolla,ovate,papillose,pedicellar,perfect,pilo,pore,present,rachi,radiu,remnant,ruit,shorter,slightly,small,smaller,spaced,stone,strongly,subcoriaceous,tal,tem,thecae,time,tomento,toward,ud,unit,unknow,upper,vary,violet,wide,ympodial	anther,appearance,arrangement,bark,biglandular,border,branch,bud,characteristic,colour,corolla,corrugation,distal,drying,exertion,filament,form,fruiting,giving,glabrousnes,growth,height,history,inflorescence,interjected,length,life,lobing,midpoint,na,new,number,ovary,per,plant,prickle,primary,pseudostipule,ray,seed,shape,size,stem,surface,terminal,texture,thicknes,type,variation,vein,width
445	wfo-0001031144	success	231	140	124	107	16	0.537	.2,.5,0.8-1.4,1-4,1.1-2.5,100,2,2-3,2.5-3,2/3,25,3-7,4,4-4.5,5,6,7-10,acuminate,acute,adaxially,anther,anthesi,apex,articulated,asymmetric,axi,base,basiscopically,berry,branch,bright,broadly,brown,calyx,capitate,cm,commonly,connivent,cordate,corolla,diameter,divaricate,ellipsoid,elliptic,entire,exserted,filament,flattened-reniform,flower,form,fruiting,glabrous,globose,groove,growth,inflated,inflorescence,later,lateral,leaf,leaflet,leaving,less,like,lobe,lobed,long,loosely,many,margin,minute,minutely,mm,new,oblique,occasionally,often,open,outline,pair,pale,pedicel,peduncle,peg,petiole,pinnately,pinnatifid,pitted,pubescent,red,reddish,ripe,seed,shiny,simple,sleeve,slightly,small,smaller,sparsely,stem,stigma,strongly,style,surface,tan,terete,terminal,tiny,triangular,trichome,truncate,tube,uniseriate,upper,usually,vein,vine,violet,way,white,x,yellowish,Â½	-11,-13,0.2,0.5,1-,1-1.5,2-,2-6,2-9,3-4.5,3.5-10,4-20,4-6,5-9,5-merou,<,ag,alyx,apart,apicula,apiculae,appearing,ark,around,away,basal,blac,branche,brow,cell,closer,corresponding,cupped,curved,densely,drying,eaf,eed,elongate,elongating,extending,flattened,four,free,geminat,ilament,irregularly,lamina,larger,lengthening,longer,longest,lower,markedly,membranous,mere,near,nflorescence,number,older,one,orolla,papillo,pendant,pentagonal,per,perfect,pericarp,plurifoliate,pore,poricidal,portion,primary,progress,quite,rim,ruit,scar,slit,sometimes,spaced,spreading,stellate-rotate,tangle,tem,testal,thin,third,tip,together,tuft,twinin,twining,two,ud,unequal,unit,variable,vary,wall,weight,widest,wing,wood,woody,yellow,ympodial	arrangement,bark,bud,characteristic,colour,exertion,fruit,glabrousnes,length,lobing,ovary,papillose,shape,size,texture,type
446	wfo-0001031152	success	232	149	122	110	27	0.526	-1.5,-10,.4,0.2-0.3,0.2-1.5,1-1.5,1-3,1-6,1.1-2.2,1.4-2.6,1/2-3/4,11,13-27,2.5-7.5,4-19,4-6,4-8,9-13,abaxially,acuminate,acute,adaxially,anther,anthesi,apex,attenuate,basal,base,becoming,berry,blunt-tipped,branch,branched,brown,bud,bullate,calyx,cm,conical,continued,corolla,decurrent,deltoid,densely,diameter,due,entire,exserted,filament,fleshy,flower,fruit,fruiting,glabrous,globose,granular-tomentose,green,greenish,growth,hair,honeycombed,lanceolate,lateral,lavender,leaf,length,lilac,long,long-,margin,midvein,mm,mostly,multangulate,narrowly,nearly,oblanceolate,oblong,obtuse,openly,orbicular,ovate,pale,pedicel,peduncle,persistently,petiole,porrect-stellate,probably,pubescent,rather,reddish,reniform,reticulate-punctate,ripe,scabrous,sessile,shrub,side,simple,slightly,soon,sparingly,stelliform,stem,stigma,strongly,style,suborbicular,surface,terete,terminal,thick-stalked,time,tube,unarmed,variously,vein,violet,x,yellow,yellowish	-5.5,/100-1/16,0-100,0.3-1.3,0.3-3,1.1-3,1.2-1.8,1.3-4,1.5-3,1.5-3.5,1/2-2/3,2-5,2.7-3.7,2.7-4.5,2.7-6,2.8-4,3.7-7,4-7,5-6,6.5-10,8-20,accrescent,ag,along,apart,apical-lateral,apparently,articulated,axe,axillary,ba,blade,blister,capitat,chartaceous,closely,dehiscing,directed,eaf,earl,eed,evident,extend,few-rayed,free,glabrescen,high,inserted,introrse,lackin,large,less,lobe,lobed,longer,longitudinal,lower,m.,main,mixed,moderately,multangulat,nflorescence,occasionally,one,open,orolla,partly,perfect,pitted,plurifoliate,pore,rachi,ray,reddish-brown,relatively,rotate-stellate,ruit,runk,short-,short-stalked,slit,somewhat,spaced,sparsely,splitting,stamen,stellate-pubescent,stipitate-glandular,stout-stalked,suture,swelling,tamen,testa,thick,thin,thin-,thin-stalked,tomentose,touching,toward,tree,unarme,unit,usually,vary,way,wide,ympodial,young	arrangement,bark,capitate,characteristic,colour,drying,exertion,form,glabrousnes,height,history,inflorescence,life,lobing,na,new,number,ovary,per,perennial,plant,primary,seed,shape,size,texture,type
447	wfo-0001031202	success	198	130	106	92	24	0.535	0-0.5,0-1,0.5-1,0.6-1.1,0.8-1,1-1.5,1-1.7,1.5-2,1.5-2.5,15-40,2-8,2/3,6-25,9-11,9-20,acute,along,anther,apex,bark,base,beneath,berry,broadly,bud,calyx,capitate,cm,completely,cordate,corolla,cup-shaped,decurrent,deflexed,densely,dia,enclosed,erect,exserted,filament,fleshy,fruit,fruiting,glabrate,glabrous,globose,golden,green,inflorescence,later,lateral,leaf,lobed,main,margin,minute,minutely,mm,obovate,occasional,occasionally,opposite,ovary,overtopping,ovoid-reniform,pair,pale,papillose,pedicel,petiole,pitted,plant,puberulent,pubescent,quite,reddish-brown,scattered,sessile,shape,shaped,shoot,shrub,size,slightly,small,stem,stigma,straight,style,surface,tan,tear-drop,terminal,thicker,tip,tree,trichome,tube,uniseriate,variable,vein,way,white,winged,x,young	.1,.5,0.1-0.3,0.5,1-5,1.5-9,2-3,2.5-13,2.5-3.5,2.5-4,20-100-flowered,3.5-4,abrupt,accrescent,anthesi,apart,apiculate,axi,complex,condition,corky,deltoid,differing,difoliate,distal,dry,due,eaf,edicel,eed,extremely,flower,free,frui,furcate,geminat,greenish-white,greyi,hard,irregularly,large,like,live,lobe,lon,long,long-ellipsoid,long-styled,longer,lower,major,many,material,middle,minor,narrowing,nflorescence,often,older,one,orbicular,paler,papillo,planar,pore,poricidal,portion,prominent,raised,rounded,ruit,scar,short-styled,slender,spaced,sparsely,specimen,tall,tapering,thick,thickened,third,time,tub,ud,unit,usually,weight,whitish,widest,woody,ympodial	alternate,arrangement,branch,characteristic,colour,diameter,drying,exertion,form,glabrousnes,greyish,growth,height,history,length,life,lobing,new,peduncle,perennial,primary,seed,texture,type
448	wfo-0001031207	success	219	135	107	112	28	0.489	-4,-7,-8,/5,0,0-20,0.25-0.5,0.3-0.5,0.5-1,0.6-0.9,0.6-1.2,0.7-2,0.85-1.4,0.9-1.6,1.4-2,1.5-5,1/4-1/3,2.1-2.3,2.8-3,3-5,anther,apex,apparently,articulated,bark,base,berry,bristly,calyx,cell,chartaceous,cm,concolorous,cordate,dark,densely,diameter,discolorous,drying,dull,erect,evenly,filament,flattened-reniform,fruit,fruiting,gray,green,herb,lateral,leaf,length,lobed,long,lower,margin,maturity,mauve,mm,moderately,narrow-deltate,oblong,obtuse,orange-brown,outline,ovate,pair,pale,pedicel,peduncle,per,petiole,pit,poricidal,prickly,primary,raised,red,reflexed,scandent,shrub,simple,small,smooth,sometimes,spherical,spreading,stellate,stellate-pubescent,stem,style,subentire,surface,tapering,terminal,tip,tube,upper,vein,visible,way,weakly,white,wide,yellow,yellow-green,young	-0.4,-1/2,-11,-5,.1,0-0.5,0-10,0.1-0.2,0.1-0.3,0.1-0.5,0.2,0.2-0.3,0.8,1,1-3,1-4,1-5,1/,1/3,1/3-equal,2-3,2-4,2.5-,3.5-7,5-8,5-merous,6-8,6.5-8,9,abaxially,acuminat,acute,alyx,ame,apar,apart,apically,blade,branched,bristle,broad-deltate,brow,c.,curved,difoliate,distance,eaf,eed,elongated,elongating,equal,extending,eye,filiform,flower,free,geminat,gently,glabrescent,glabrous,herbaceous,infructescence,lanceolate,less,like,lobe,longer,mature,midpoint,midvein,multangulate,naked,nflorescence,occasionally,older,one,open,orolla,oung,pendulous,perfec,pericarp,perpendicular,persistent,porrect,portion,prickl,prickle,ray,rounded,ruit,scar,sessile,shorter,side,spaced,stalk,stalked,straight,tamen,terete,tertiary,time,toward,trichome,unarmed,unit,usually,variously,vary,venation,ympodial	1/4,arrangement,branch,brown,bud,characteristic,colour,corolla,exertion,form,glabrousnes,growth,height,history,inflorescence,life,lobing,na,new,number,ovary,plant,seed,shape,size,stigma,texture,type
449	wfo-0001031218	success	154	154	98	56	56	0.636	0.5,0.5-1,1-2,1-4,15-25,2-22,2-3,2.5-3,3-5,4-28,4-7,4-8,40,40-100+,5-37,5.5-7,6-10,6-7,6-9,8-17,abaxially,acuminate,acute,adaxially,apex,apiculate,basal,base,beyond,branched,calyx,cm,connivent,cordate,dark,densely,diameter,directed,distally,eglandular,eglandular-pilose,ellipsoidal,entire,especially,exserted,flattened,flower,fruit,glabrous,glandular,glandular-puberulent,globose,greenish-purple,hair,introrse,lanceolate,lavender,less,lobe,long,margin,minutely,mm,moderately,mottled,narrowly,oblique,obtuse,orange,ovate,ovate-elliptic,ovoid,pedicel,peduncle,perfect,petiole,pore,puberulent,pubescent,purple,ripe,shorter,simple,slightly,sometimes,sparsely,stamen,stigma,style,succulent,tip,toward,tree,triangular,tube,violet,x,yellow	-5,1-3,10-19,2-2.5,3,3-14,4-5,4-foliat,5-7,8-20,aggregate,apart,ape,articulated,axe,blade,cell,connective,coriaceous,cylindrical,eaf,eed,equal,exceeding,glabrou,leaving,lon,lower,nflorescence,nther,orolla,papillo,pedicellar,presen,present,purpl,rachi,radiu,remnant,ruit,small,spaced,stellate,stone,subcoriaceous,tal,tem,thecae,time,tomento,truncat,ud,unit,vary,wide,ympodial	anther,appearance,arrangement,bark,border,branch,bud,characteristic,colour,corolla,corrugation,distal,drying,exertion,filament,form,fruiting,giving,glabrousnes,growth,height,history,inflorescence,interjected,lateral,leaf,leaflet,length,life,lobing,midpoint,na,new,number,ovary,papillose,per,plant,prickle,primary,pseudostipule,ray,seed,shape,size,stem,surface,terminal,texture,thicknes,tomentose,truncate,type,variation,vein,width
450	wfo-0001031225	success	163	136	109	54	27	0.669	.25,.5,0.2,0.2-0.75,0.7-6,0.8-1,1-1.5,1-1.7,1-5,2,3-9,3/4,5-50-flowered,5-6,6-8,7-9,9-16,acute,along,anther,anthesi,apex,bark,base,berry,broadly,bud,calyx,characteristic,cm,corolla,cup-shaped,darker,decurrent,dia,dry,ellipsoid,elliptic,exserted,filament,fruiting,furcate,glabrate,glabrous,globose,green,growth,inflorescence,lateral,leaf,less,like,lobe,lobed,long,main,margin,minute,minutely,mm,narrowly,often,older,opposite,ovary,ovate,ovoid-reniform,pair,pale,papillose,pedicel,petiole,pitted,plant,pore,poricidal,prominent,pubescent,red-papillose,reflexed,rest,shape,shaped,shrub,size,slender,slightly,small,soon,specimen,stem,stigma,straight,strongly,style,surface,tan,tapering,tear-drop,tip,tree,trichome,tube,uniseriate,vein,way,white,x,young	/3,0.1-0.75,0.5,0.5-1,0.75-1,1-3,1.5-5,2.5-3,apart,beginning,closely,conspicuous,deltoid,differentiated,differing,difoliate,eaf,edicel,eed,erect,flattene,fragrant,free,geminat,greyish-brow,inflorescenc,live,lon,lower,major,middle,minor,much,nflorescence,one,outline,papillo,portion,proximal,raised,rhomboidal,rounded,ruit,scar,spaced,sweetly,swelling,tall,ud,unevenly,unit,widest,woody,ympodial	alternate,arrangement,branch,colour,corrugation,diameter,drying,exertion,flattened,form,fruit,glabrousnes,greyish-brown,height,history,length,life,lobing,na,new,number,peduncle,per,primary,seed,texture,type
451	wfo-0001031231	success	175	107	85	90	22	0.486	-2,.5,0.5-1.5,1-1.5,1-2,1.5-2,2-3,37/2,37/3,4-8,5-7,8-10,acuminate,acute,almost,anther,apex,axillary,base,berry,branch,branched,brown,calyx,campanula,campanulate,cm,colour,corolla,dark,dia,discoidal,ellipsoid,elliptic,entire,equal,erect,except,filament,fork,glabrous,globose,green,greyish,hair,juvenile,lanceolate,lasting,leaf,len,less,long,loosely,marbled,minute,mm,oblong,occasionally,ovary,pedicel,peduncle,petal,pinnatisect,plant,purple,rh,ripening,rounded,rugose-ruminate,seed,several,shrub,simple,soft,sometimes,stout,style,surface,tinged,tip,vigorous,violet,wooded,x,year	1-3,1-4,13,2-4,2.5-3,25-35,3-4,80-110,absent,acumen,adherent,along,anthesi,aromatic,aspect,axi,basal,becoming,beyond,blunt,bluntly,cell,clonal,cluster,declinate,developed,eaf,eed,exceeding,exerted,expanded,facetted,fleshy,flower,flowering,folded,general,glandular,gree,habit,herbarium,interacuminal,lengthening,lobe,lon,lower,margin,mature,mauve,midrib,nflorescence,often,pedice,pedicellate,pentagonal,plurifoliat,pore,poricidal,projecting,rarely,readily,recurve,ripe,rotate,ruit,sessile,shallow,shed,short,sinus,slightly,slit,small,specimen,stigma,stone,stonrgly,succulent,tissue,toward,translucent,triangular,tub,ud,unit,usually,variable,well,without,ympodial	arrangement,bud,characteristic,exertion,form,fruit,glabrousnes,growth,height,history,inflorescence,length,life,new,plurifoliate,primary,shape,size,stem,texture,type,vein
452	wfo-0001031252	success	170	152	121	49	31	0.712	0.2-1.5,0.3-1.1,1-2,1-3,1.3-1.9,1.75-5.2,16-33,2-3,2.5-7,2.8-3.6,3-10,3-5,3-6,5-17,5-8,5-9,5.5-6.5,7-18,abaxially,absent,acumen,acute,adaxially,anther,apart,apex,articulated,attenuate,axillary,base,berry,brownish,bud,cell,ciliate,clavate,cm,condition,coriaceous,corolla,covering,cuneate,dark,deep,diameter,distal,dorsally,drying,edge,elliptic,entire,filament,flat,flower,folded,forked,fresh,fruit,generally,glabrous,globose,green,green-white,greenish,hair-like,half,herb,high,homostylous,interjected,lanceolate,lateral,leaflet,lengthening,light,lobe,long,make,margin,medium,mm,moniliform,mottled,mucilaginous,ovate,ovoid,pedicel,peduncle,petiole,plant,pore,poricidal,purple,ripe,rotate,rounded,seed,serrate,simple,slit,sometimes,stigma,straight,stripe,style,subtending,terminal,testal,thick,throughout,tip,tube,tuber,unwinged,usually,wall,wet,white,whitish,x,yellow	0.4-3,12-20,5-merou,adaxiall,ag,along,alyx,apparently,arranged,axe,bead,blade,capitat,connivent,digestion,eaf,eed,enzyme,erec,exceeding,geminat,glabrou,hal,honeycomb-shaped,like,linear,living,lower,multiple,necklace,nflorescence,orolla,perfect,plurifoliate,removed,ruit,seudostipule,spaced,specimen,stamen,stolon,tall,tamen,tem,tri-,typically,unit,vary,ympodial	5-merous,abaxial,adaxial,age,arrangement,articulation,axi,calyx,capitate,colour,erect,form,glabrousnes,growth,height,history,inflorescence,leaf,length,life,ovary,pseudostipule,shape,size,spacing,staman,state,stem,surface,texture,type
453	wfo-0001031257	success	206	161	119	87	42	0.578	-12,-6,0,0.7-1,0.75-2.5,1-1.3,1.1-1.2,1.5-1.7,2-,2-4.5,3.5-5.7,4-10,5,5-8.5,6-celled,7.5-9,abaxially,abundant,acuminate,adaxially,anther,anthesi,antrorse,apex,ascending,attenuate,basal,base,berry,blue-violet,branch,bud,calyx,cm,coarsely,connectival,corolla,cuneate,dark,dentate,diameter,directed,dorsally,edentate,ellipsoidal,erect,filament,finely,flexuous,foliage,fruiting,glabrous,glandular,globose,half,herb,herbaceous,hollow,honey-combed,inconspicuous,lamina,lateral,leaf,length,light,like,little,lobe,long,long-stalked,longer,longitudinally,margin,midvein,mm,non-glandular,odorles,outward,ovate,pair,papillate,patent,petiole,prolongation,pubescent,purple,reduced,ridged,ring,robust,secondary,seed,serrate,shrub,simple,smooth,somewhat,spur-like,stem,stigma,striate,style,subglobose,thickened,tip,tooth,trans-ovoidal,trichome,tube,unequal,upward,vein,ventrifixed,verrucate,viscid,white,within,x,yellow	-22.5,-5,0.4,0.5,0.5-0.8,1-1.2,1.5,1.5-2,1/10,10-16,11.5-15,3,3.5-,4-4.5,4.5-,5-,6-12,7-,8,8-celled,accrescen,ag,aggregate,bicellular,broad,campanulate,cell,coat,cotyledon,curved,cuticle,deep,densely,diamete,difoliate,eaf,eed,elliptical,embryo,endosperm,epidermal,free,geminat,hair-like,head,high,inserted,lon,longitudinal,lower,many-seeded,narrowly,opening,orolla,pericarp,pore,poricidal,portion,rarely,ree,rest,ruit,saddle-shape,scarce,scarcely,separated,short-stalked,shorter,single-celled,sinus,slightly,slit,small,solitary,stalk,stone,strand,tem,thecae,thickening,time,triangular,unit,vary,viscid-pubescen,wall,ympodial	appearance,arrangement,border,characteristic,colour,distal,exertion,form,fruit,giving,glabrousnes,growth,height,history,inflorescence,interjected,leaflet,life,lobing,midpoint,na,new,number,ovary,pedicel,peduncle,per,plant,prickle,pseudostipule,ray,saddle-shaped,shape,size,surface,terminal,texture,thicknes,type,variation,viscid-pubescent,width
454	wfo-0001031270	success	234	171	152	82	19	0.65	+,0.4-1.5,0.5-1,1,1-1.2,1-4,1.2-1.6,1.5,1/3,10,10-12,100,2-2.5,2-3,2-4,2.5-3,3-10,3-20,4-5,5,5-10,6-50,7-12,>,abaxial,acute,adaxial,along,anther,anthesi,apex,bark,base,berry,bipinnatifid,bright,brown,calyx,capitate,clavate,cm,conical,curved,deeply,densely,depressed-spherical,diameter,differentiated,directed,elliptic,entire,few-rayed,filament,flower,free,fruiting,glabrous,glandular,glandular-pubescent,green,growth,herb,inflorescence,later,lateral,leaf,leaf-opposed,length,like,live,lobe,lobed,long,long-styled,margin,membranous,midpoint,midvein,minute,minutely,mixture,mm,multangulate,multiseriate,new,obovate,often,ovoid,pale,pedicel,peduncle,per,petiole,pinnatifid,pitted,plant,pore,poricidal,prickle,prickly,pubescent,ray,red,reddish,reflexed,reniform,rest,ripe,rounded,scattered,sessile,shallowly,short-stalked,short-styled,shrub,simple,size,slender,slightly,small,sparsely,spherical,spreading,stalk,stellate,stem,stigma,straight,straw-colored,style,surface,tan,tapering,terete,tip,tissue,trichome,truncate,tube,uniseriate,upward,usually,varying,vein,way,well,white,wide,wing,yellow,yellowish,Â½	.5,1-3,1.5-2,2-20,2-7,3-5,5-15,5-6,5-merous,6-17,8,9-10,abaxially,accrescent,adaxiall,alyx,apart,arme,articulated,associated,basal,beginning,blade,brow,c.,cell,celled,colored,connivent,consistently,difoliate,distal,eed,ellipti,equal,erect,frui,geminat,gland,heavily,heterostylous,infructescence,investing,leafy,lon,longer,loosely,lower,narrowly,nflorescence,occasionally,older,orolla,oung,outline,pair,papillo,pericarp,portion,primary,rachi,ruit,scar,secondary,shallow,shining,single,sinuate,staminat,strongly,tall,tamen,testal,thin,thus,tightly,unit,vary,wice,wid,woody,ympodial	arrangement,characteristic,colour,corolla,exertion,form,fruit,glabrousnes,height,history,life,lobing,number,ovary,papillose,seed,shape,texture,type
455	wfo-0001031283	success	52	91	33	19	58	0.635	-0.25,0.1-0.15,0.4-0.5,0.5-0.7,0.7,2.2-2.8,30-40,apex,appearance,base,brown,calyx,cell,cm,diameter,fruit,hair-like,lateral,lobe,long,mm,obovate,outgrowth,pale,pubescent,shrub,silky,surface,testa,thick,wall,wide,woody	.7-2.3,acute,eed,elongating,erect,fide,give,lo,markedly,moore,narrowly,pleasant,small,smelling,somewhat,sprawling,spreadin,tall,winged	1.7-2.3,anther,arrangement,bark,border,branch,bud,characteristic,colour,corolla,corrugation,distal,drying,exertion,filament,form,fruiting,giving,glabrousnes,growth,height,history,inflorescence,interjected,leaf,leaflet,length,life,lobing,margin,midpoint,na,new,number,ovary,pedicel,peduncle,per,petiole,plant,prickle,primary,pseudostipule,ray,seed,shape,size,stem,stigma,style,terminal,texture,thicknes,tube,type,variation,vein,width
456	wfo-0001031287	success	147	98	77	70	21	0.524	.5,0.5-1.5,0.9-1,1,1-1.2,1-1.3,1-1.5,1-5,1.5-2,3-4,4-5,6-10-flowered,6-7,abaxially,acute,adaxially,anther,apex,attenuate,bark,base,berry,bi-lobed,branch,calyx,cm,conical,corolla,dark,dendritic,densely,dia,divergently,ellipsoid,elliptic,elongate,erect,exserted,fruiting,glabrous,globose,green,greenish-white,later,leaf,long,minutely,mm,onto,ovary,ovoid-reniform,pale,pedicel,petiole,pitted,pointed,pubescent,red-papillose,rounded,shaped,shrub,simple,somewhat,stem,stigma,strongly,style,surface,tan,tear-drop,trichome,tube,tuft,white,winged,x,young	1.5-5.5,2-2.5,3-5,4-6,4.5-5,5-14,anthesi,apar,ape,axil,bearing,connective,coriaceous,deflexed,deltate,difoliate,eaf,edicel,eed,enlarged,filament,fleshy,free,frui,geminate,internodal,knob,lamina,lateral,lobe,lobed,lon,lower,main,many,margin,membranous,middle,nearly,nflorescence,occasionally,older,pair,papillo,papillose,planar,plurifoliate,pore,poricidal,portion,reddish-brow,reflexed,ruit,scar,shoot,short,sinus,small,spaced,thick,thin,tip,tub,ud,unevenly,unit,vein,widest,woody,ympodial	arrangement,bud,characteristic,colour,diameter,exertion,form,fruit,growth,height,inflorescence,length,peduncle,plant,reddish-brown,seed,shape,size,specified,texture,type
457	wfo-0001031300	success	219	124	100	119	24	0.457	-2.2,.5,/4,0.2-0.4,0.2-0.5,0.3,0.5-0.9,0.5-18,0.6-0.8,0.7-0.9,0.7-1.2,0.8-1.5,1-2,1.2-1.7,1.5-3.5,2-4,2-5.5,2.2-2.3,2.2-2.7,3-4,5-15,acute,anther,apex,apparently,articulated,attenuate,bark,base,berry,branched,brown-green,calyx,cell,chartaceous,cm,curved,densely,diameter,dull,erect,filament,filiform,flattened-reniform,fruit,fruiting,glabrous,gray-green,lateral,leaf,length,lobed,long,margin,maturity,membranous,mm,moderately,near,oblanceolate,orange,orange-brown,orange-green,outline,pair,pedicel,peduncle,petiole,pit,poricidal,prickle,prickly,primary,pubescent,raised,rarely,red,rounded,shrub,simple,small,smooth,sparsely,spherical,stellate,stellate-pubescent,stem,style,surface,tapering,terete,tip,trichome,tube,vein,way,white,wide,yellow,yellow-green	-4,-5,-6,0-15,0-20,0-3,0-8,0.1,0.1-0.5,0.1-0.6,0.15-0.7,0.2-0.7,0.2-1,0.3-0.6,0.3-1.3,0.5-1.5,0.5-2,0.6-1,0.6-1.2,1-4,1-5,1.3-2,1/2-3/4,1/3-1/2,1/6-1/4,10-30,2-,2-3,2-6,2.5-3.2,3-,4,4.5-6,5-merous,6-8,abaxially,absent,also,alyx,apar,apart,apically,ba,blade,brow,bulbous,caudat,concolorous,connivent,creeping,deltate,difoliate,distance,drying,eaf,eed,elongating,equal,extending,eye,flattened,flower,free,geminat,geniculate,glabrescent,hair,herbaceous,highly,infructescence,lobe,lon,longer,lower,mature,midpoint,midvein,minute,naked,nflorescence,oblong,obtuse,older,one,open,orolla,oung,pale,pendulous,per,perfec,pericarp,porrect,portion,prickl,ray,reduced,ruit,scar,sessile,side,spaced,spreading,stalk,stalked,tamen,tertiary,thin,time,uniradiate,unit,vary,venation,visible,weakly,wider,winged,yellow-orange,ympodial	arrangement,branch,brown,bud,characteristic,colour,corolla,exertion,form,glabrousnes,growth,height,inflorescence,lobing,na,new,ovary,plant,seed,shape,size,stigma,texture,type
458	wfo-0001031310	success	203	165	141	62	24	0.695	.5,0-3,0-4,1-10,1-2,1-3,1-6,1.5-4,15-40,2-3,2.5-5.5,2.5-8.5,3-10,4-12,4.5-4.8,5-7,5.5-21,6-7,abaxially,absent,acumen,acuminate,adaxially,along,anther,apart,apex,attenuate,axillary,base,berry,blue,blue-purple,broadly,brown,brownish,bud,cell,chartaceous,ciliate,cm,condition,connivent,corolla,covering,cuneate,decurrent,diameter,distal,dorsally,drying,edge,elliptic,especially,filament,flat,flower,folded,forked,fresh,fruit,generally,glabrous,globose,green,green-white,greenish,hair,hair-like,half,herb,high,homostylous,interjected,lanceolate,lateral,leaf,leaflet,less,light,like,lobe,make,margin,membranous,midrib,minutely,mm,mottled,mucilaginous,multicellular,narrowly,obtuse,odd-pinnate,ovate-elliptic,ovate-lanceolate,ovoid,pair,pale,pedicel,peduncle,petiole,petiolule,pilose,plant,pointed,puberulent,pubescent,purple,rosette-forming,rotate,seed,shortly,simple,size,slightly,sometimes,somewhat,sparsely,stem,stigma,straight,streak,style,subrosette-forming,subtending,terminal,testal,thick,throughout,tip,tube,tuber,unwinged,usually,wall,wet,white,whitish,x,yellow	0.5-3,1-5.5,4-10,5-6,5-merou,ag,alyx,apparently,articulated,axe,blade,borne,caly,conspicuously,decreasing,digestion,eaf,eed,end,enzyme,erect-decumben,exceeding,extremely,geminat,glabrou,gradually,honeycomb-shaped,larger,lengthening,living,long,lower,nflorescence,orolla,ovate,perfect,plurifoliate,pore,poricidal,rachi,removed,ruit,seudostipule,singly,slit,small,spaced,specimen,stamen,ste,stolo,subellipsoi,tall,tamen,tem,tissue,toward,tri-,typically,unit,vary,ympodial	abaxial,adaxial,arrangement,articulation,calyx,colour,erect-decumbent,form,growth,height,history,inflorescence,length,life,ovary,presence,present,pseudostipule,shape,spacing,subellipsoid,surface,texture,type
459	wfo-0001031316	success	207	134	111	96	23	0.536	-2,.1,/3,0.3-1,0.4-0.8,0.5-2,0.8-1.2,0.8-1.8,0.9-1.3,1.2-2.1,1.5-2,1.5-3.5,2-3,3-10,3.5-3.8,3.8-5,4-7,5-10,abaxially,acuminate,acute,almost,ame,anther,apex,apically,apparently,articulated,bark,base,berry,blue-mauve,bright,c.,calyx,cm,colored,connivent,contrast,cream,curved,dark,densely,diameter,dull,entire,erect,filament,flattened-reniform,fruit,fruiting,glabrescent,glabrous,gray,green,held,inward,lateral,leaf,length,lobe,long,lowermost,margin,marking,maturity,membranous,midpoint,mm,moderately,multangulate,narrow-deltate,obtuse,orange,orange-brown,ovate,pale,pedicel,peduncle,petiole,poricidal,porrect,purple,ray,red-brown,sessile,shrub,simple,slender,sparsely,spherical,stellate-pubescent,stem,strongly,style,surface,tapering,terete,terminal,tip,trichome,tube,unarmed,way,white,white-green,whitish,wide,yellow,yellow-green,young	0.05-0.1,0.05-0.15,0.1-0.2,0.4-0.6,0.6-1,1-5,1.3-3.5,1.5-,1.5-5,1/3-1/2,1/3-2/3,2-20,2-4,2.5-8,3-8,4,4-9,5-15,5-6,5-8,5-merous,6-20,8-11,8-12,8-25,abaxial,adaxial,alyx,apar,becoming,blade,branched,broad,concolorous,difoliate,discolorous,drying,eaf,eed,elongating,eye,fifth,flower,foliaceou,four,free,geminat,glabrou,hair,herbaceous,infructescence,lobed,long-acuminat,longer,lower,mature,minute,naked,nflorescence,older,one,open,orolla,oung,pair,pendulous,per,perfec,pericarp,portion,primary,red-brow,reflexed,ruit,scar,smooth,sometimes,spaced,spreading,stalk,stalked,stellate,stellate-pubescen,tamen,tertiary,time,unarme,unequal,unit,usually,variously,vary,vein,venation,visible,ympodial	arrangement,branch,characteristic,colour,corolla,exertion,form,glabrousnes,growth,height,inflorescence,lobing,long-acuminate,na,new,ovary,plant,seed,shape,size,stigma,texture,type
460	wfo-0001031333	success	194	98	75	119	23	0.387	1-1.5,1-4,1.2-2,1.5,1.5-1.7,1.5-2,1/2,3-4,3/4,7-9,?,acuminate,acute,almost,anther,anthesi,apex,base,berry,bilobed,branched,brown,calyx,capitate,cm,conical,densely,diameter,ellipsoidal,elliptic,entire,exserted,filament,flattened,fruting,glabrous,globose,golden,green,greenish,growth,immature,inflorescence,many,margin,membranous,minute,minutely,mm,narrowly,new,nodding,ovate,pale,pedicel,peduncle,petiole,pitted,pubescent,reniform,simple,somewhat,sparsely,stem,stigma,strongly,style,surface,terminal,time,tube,vine,way,white,woody	+,.5,0.1-0.5,0.5,1-5,2,2-3,2.5-3,2.7-7,30-40,5-7,5-8,5-merou,50,7-10,<,>,abaxially,adaxiall,adaxially,adjacent,ag,alyx,apart,appearing,ark,articulated,branche,broadly,cell,clustered,collection,composed,crea,cupped,denser,eaf,eed,flower,free,glabrescen,glabrescent,half,high,ilament,lamina,leaving,lengthening,less,like,lobe,lobed,long,lower,m.,matte,mere,near,nflorescence,occasionally,older,orolla,outline,pair,papillat,peg,penden,pentagonal,per,perfect,pericarp,planar,plurifoliat,pore,poricidal,portion,primary,pubescent-papillate,quadrate,rest,rhachi,ruit,scar,sinus,slightly,slit,small,soon,splitting,ste,stellate,striped,tangled,tem,testal,thickened,thin,tip,trailing,triangular,trichome,truncate,twining,ud,undersurface,undulation,unequal,unevenly,uniseriate,unit,upper,vary,vein,venation,whitish,x,yellow,yellowish,ympodial	abaxial,adaxial,arrangement,bark,bud,characteristic,colour,corolla,exertion,form,fruit,glabrousnes,history,leaf,length,life,lobing,ovary,seed,shape,size,texture,type
461	wfo-0001031333	success	194	94	75	119	19	0.387	1-1.5,1-4,1.5,1.5-1.7,1.5-2,1/2,3-4,3/4,7-9,?,acuminate,acute,almost,anther,anthesi,apex,bark,base,berry,bilobed,branched,broadly,brown,capitate,cm,corolla,densely,diameter,ellipsoid,elliptic,entire,exserted,filament,flattened,fruiting,glabrous,globose,golden,green,greenish,growth,immature,inflorescence,many,margin,membranous,minute,minutely,mm,narrowly,new,nodding,ovate,pale,pedicel,peduncle,petiole,pitted,pubescent,reniform,simple,somewhat,sparsely,stem,stigma,strongly,style,surface,terminal,time,truncate,tube,vine,way,white	+,.5,0.1-0.5,0.5,1-5,1-5-2,2,2-3,2.5-3,2.7-7,3,30-40,5-7,5-8,5-merou,50,7-10,<,>,abaxially,adaxiall,adaxially,adjacent,ag,alyx,apart,appearing,articulated,branche,calyx,cell,clustered,composed,conical,cream,cupped,denser,eaf,eed,flower,free,glabrescen,glabrescent,half,high,ilament,lamina,leaving,lengthening,less,like,lobe,lobed,long,lower,m.,matte,mere,near,nflorescence,occasionally,older,orolla,outline,pair,papillat,peg,penden,per,perfect,pericarp,planar,plurifoliat,pore,poricidal,portion,primary,pubescent-papillate,quadrate,rest,rhachi,rotate-stellate,ruit,scar,sinus,slightly,slit,small,soon,spaced,splitting,stellate,striped,tangled,testal,thickened,thin,tip,trailing,triangular,trichome,tub,twinin,ud,undersurface,undulation,unequal,unevenly,uniseriate,unit,upper,vary,vein,venation,whitish,wide,woody,yellowish,ympodial	abaxial,adaxial,arrangement,bud,characteristic,colour,exertion,form,fruit,glabrousnes,leaf,length,lobing,ovary,seed,shape,size,texture,type
462	wfo-0001031359	success	166	125	98	68	27	0.59	.02,.25,.5,/4,0.5-1,0.5-6,1-4,1.1-1.6,1.2-1.6,1.2-2.5,1.3-1.6,1.9-2.3,12-21,2.5-3,3-3.5,3.6-8.8,5-30-flowered,5-angled,6-7,acuminate,angle,anther,apex,attenuate,axil,bark,base,beneath,berry,bi-lobed,brown,calyx,cm,corolla,dark,dia,dried,dull,elliptic,extending,filament,flattened-reniform,fruiting,glabrous,globose,green,internodal,lateral,leaf,live,long,main,margin,minutely,mm,narrowly,nearly,obovoid,occasionally,often,opposite,outline,ovary,papillae,papillose,pedicel,petiole,pit,pitted,plant,ripe,round,rusty,shaped,shiny,shrub,simple,size,slender,somewhat,specimen,stem,stigma,style,surface,tan,tapering,tear-drop,trichome,tube,tuft,uniseriate,vein,way,white,x,yellow,yellow-orange	0.75-1,1.5-2,1.6-2.8,5-7,5.3-7.5,anthesi,apart,apiculate,appearing,ba,beginning,broadly,curled,deflexed,differing,difoliate,distal,eaf,edicel,eed,evenly,free,geminat,incrassate,inflorescenc,interpetalar,lamina,lobe,lobed,lon,lower,major,membraneous,middle,minor,near,nflorescence,older,one,originating,pair,paler,papillo,planar,pore,poricidal,portion,reflexed,ridged,ruit,scar,sinus,slightly,spaced,straight,strongly,tall,tip,triangular,tub,ud,undulate,unit,white-lenticellat,widest,woody,ympodial,young	arrangement,bud,characteristic,colour,corrugation,diameter,drying,exertion,form,fruit,growth,height,history,inflorescence,length,life,lobing,na,number,peduncle,per,primary,seed,shape,texture,type,white-lenticellate
463	wfo-0001031362	success	138	78	58	80	20	0.42	.2,.5,0.5-1,0.7-1,1-1.1,1-4,1.5-2,2-2.5,?,anther,bark,base,berry,brown,cm,corolla,dendritic,densely,dia,ellipsoid,flattened-reniform,fruiting,glabrous,globose,golden,incrassate,lanceolate,leaf,lobed,long,margin,minutely,mm,nearly,orange-red,ovary,pale,pedicel,petiole,pitted,pubescent,pubesent,red,shaped,shrub,simple,small-capitate,sparsely,stem,stigma,style,subshrub,surface,tan,tear-drop,trichome,white,x	.3,0.4-0.5,1-1.5,1-3,1-3-flowered,3-4,3-6,abaxially,acute,adaxially,along,anthesi,apex,appearance,attenuate,branch,bushy,calyx,cell,closely,conical,denser,eaf,edicel,eed,erect,exceeding,exserted,filament,flattened,free,giving,golden-brow,inflorescenc,internodal,lamina,lateral,like,lobe,lon,long-triangular,lower,main,middle,nflorescence,nodding,older,opposite,outline,overlappin,packed,pair,papillo,papillose,pericarp,planar,plurifoliat,pore,poricidal,portion,rectangular,rest,rounded,ruit,scar,shiny,slender,somewhat,spaced,straight,thin,tip,tube,ud,unit,vein,widest,woody,ympodial,young	abaxial,adaxial,arrangement,bud,characteristic,colour,diameter,form,fruit,golden-brown,growth,inflorescence,length,lobing,plurifoliate,seed,shape,size,texture,type
464	wfo-0001031400	success	161	100	77	84	23	0.478	0.25-0.8,0.4-1.7,0.6-1.8,0.7-6,0.8-1.1,1-4,1.2-2,1.5-5,10-11,2-3,2-5,2-9,4-,4-13,4-6.5,4-7,5-12.5,6-23,7-25,7-28,abaxial,apical,apically,branched,calyx,cell,cm,corolla,covering,cyme,deeply,dehiscent,diameter,dichasial,dichasially,ebracteate,filament,forked,globose,hair-like,herbaceous,interjected,introrse,lateral,leaf,leaflet,long,make,maturing,mm,monochasial,mucilaginous,odd-pinnate,often,ovoid,pedicel,peduncle,perennial,petiole,plant,poricidally,puberulent,seed,short,size,slit,stellate,style,subglabrous,terminal,testal,thick,tone,violet,wall,white,wide	-3,1,1-,2,3-6-foliat,4-17,abaxially,abruptly,absen,acumen,acute,adaxially,apex,apiculate,articulate,base,connate,cuneate,dark,decurrent,digestion,diminishing,distal,dorsally,eaf,edge,eed,emoval,enzyme,exceeding,flat,flower,folded,forming,generally,globo,green,green-white,half,honeycomb,linear,linear-lanceolate,living,lobe,lon,lower,lunat,nflorescence,nther,oblique,oblong,occasionally,orolla,pair,pattern,perfect,plan,proximal,rachi,reveal,ruit,sessile,seudostipule,side,specimen,stamen,stigma,straight,stripe,structure,tal,tem,throughout,tip,toward,trilobe,tuber-bearing,typically,unit,vary,without,yellow,ympodial,Â¼	absent,adaxial,anther,arrangement,branching,colour,dehiscence,form,fruit,growth,height,history,inflorescence,length,life,ovary,pseudostipule,shape,stem,surface,texture,wet,width
465	wfo-0001031401	success	182	141	118	64	23	0.648	0.5,0.6-1.2,0.8-1.2,1,1-1.4,1-1.5,1-6,1.1-3,1/2,2-2.4,2-5,2.5-4,3,3.5-4,3/4,5,5-9,7-9,abaxial,acute,adaxial,age,along,anther,apex,apical,appearing,attenuate,bark,basal,base,becoming,berry,bi-lobed,black,branch,brown,calyx,cm,corolla,dark,deciduous,dendritic,densely,diameter,drying,ecuador,elliptic,exserted,flattened,fork,fruit,fruiting,glabrous,globose,golden,golden-yellow,growth,lateral,leaf,lenticular,long,matted,minutely,mm,narrowly,new,node,occasionally,often,outline,ovary,overtopping,pair,pedicel,per,petiole,pore,poricidal,prominently,puberulent,pubescent,purplish-black,raised,rounded,roundish,scar,secondary,shiny,shoot,short,shrub,slit-like,small,sometimes,somewhat,sparsely,stem,stigma,strongly,style,surface,tapering,terminal,tip,tree,tree-like,trichome,tube,vein,violet,way,white,wide,winged,x,yellow,young	1.5-2,5-7,8-10,abaxially,adaxially,anthesi,axi,blade,branching,clearly,conical,deflexed,deltoid,denser,dichasial,differentiated,eaf,ecuadorian,edicel,eed,ew,filament,finely,flower,free,impressed,inserted,less,lobe,lobed,long-triangular,lower,m.,mesophyll,monochasia,near,nflorescence,noddin,nodding,older,papillo,pericarp,pitted,planar,plurifoliate,portion,pubescen,pyramidal,reddish-brown,ruit,sleev,specimen,stamen,ste,tall,thin,time,tub,ud,unit,usually,visible,woody,ympodial	arrangement,bud,characteristic,colour,exertion,form,glabrousnes,height,history,inflorescence,length,life,lobing,number,papillose,peduncle,plant,seed,shape,size,staman,texture,type
466	wfo-0001031480	success	237	140	118	119	22	0.498	/3,0.5-2,0.6-0.8,0.8-1,1-1.3,1-1.5,1-2,1-3,1.5-2.2,1.7-2.2,1.8-3,1/3,2-2.7,3-6,3-7,3.5-7,4-5,4-6,6-13,8-12,acute,anther,apex,apically,apparently,articulated,bark,base,berry,bright,broad-deltate,calyx,cell,cm,cream,cuneate,curved,dark,deltate,densely,diameter,dull,ellipsoid,entire,erect,filament,flattened-reniform,fruit,fruiting,glabrous,glandular,green,hair,lateral,leaf,length,lobed,long,margin,marking,maturity,mauve,minutely,mm,moderately,near,obtuse,orange-brown,outline,ovate,pair,pale,pedicel,peduncle,petiole,pit,plant,poricidal,porrect,prickly,primary,purple,raised,red,red-brown,red-green,red-yellow-green,reticulate,scandent,shallowly,shrub,simple,slender,small,smooth,spherical,spreading,stalked,stellate-pubescent,stem,straight,style,surface,tapering,terminal,thick-chartaceous,tip,trichome,truncate,tube,unarmed,upper,variously,vein,way,wide,yellow,young	-0.25,-2,0,0-0.5,0-1,0-2,0-30,0-5,0.1,0.1-0.3,0.1-0.4,0.15-0.3,0.2-0.35,0.4,0.4-0.8,0.5-,0.7,0.8,1-4,1/2,1/4,1/6-1/5,2-,2-3,2-5,2-6,3,3-10,5-8,5-merous,6-30,6-8,7-8,abaxial,abaxially,acuminat,adaxial,alyx,andromonoecious,apar,apart,ba,blade,branched,branching,difoliate,discolorous,distal,distance,drying,eaf,eed,elongate,elongating,equal,extending,eye,faint,flattened,flower,free,geminat,glabrescent,hermaphrodite,heterostylous,inconspicuous,infructescence,lobe,long-styled,longer,lower,lowermost,mature,midpoint,midvein,naked,nflorescence,often,older,one,open,orolla,oung,pendulous,per,pericarp,persistent,portion,prickle,pubescent,ray,red-brow,reduced,rounded,ruit,scar,sessile,short-styled,shorter,side,slightly,somewhat,spaced,sparsely,stalk,staminat,stellate,tamen,terete,tertiary,time,unarme,unit,vary,venation,visible,weakly,woody,ympodial	acuminate,arrangement,branch,characteristic,colour,corolla,exertion,form,glabrousnes,growth,height,history,inflorescence,life,lobing,new,ovary,seed,shape,size,texture,type
467	wfo-0001031483	success	154	123	92	62	31	0.597	/2,0,0.5,0.5-2,1-2,1.2-1.4,1.7-5.5,11-20.5,2-2.5,3-4,3-8-flowered,6-10,7-10,across,acuminate,acute,almost,anther,apex,attenuate,base,berry,ca,calyx,clavate,cm,corky,corolla,decurrent,deltoid,dia,difoliate,distal,dry,end,exserted,filament,filiform,fresh,fruiting,fusiform,glabrous,green,larger,lateral,leaf,lenticellate,linear,lobed,long,main,markedly,minutely,mm,oblanceolate,obovate,obovoid,often,ovary,ovoid-reniform,pair,pale,paler,papillose,pedicel,per,pointed,pore,poricidal,shape,shaped,short-triangular,shrub,simple,slender,slightly,soon,stem,stigma,style,subshrub,tan,tapering,tear-drop,tip,tube,turbinate,unit,vein,way,white,x	.5,1,1.1-2.5,1/3,2-3,2.5-3.2,anew,anthesi,apart,ba,bearing,beginning,beneath,blade,caly,continuous,cork,deflexed,eaf,edicel,eed,evenly,flower,free,geminat,indistinc,indistinct,internode,lea,less,lobe,lower,major,minor,nflorescence,oblong,opposite,orbiculate,papillo,petiole,planar,portion,prominent,quite,raised,rounded,ruit,scar,short,somewhat,spaced,straight,strongly,tall,third,ud,variable,widest,wing,winged,woody,ympodial	arrangement,bud,characteristic,colour,diameter,exertion,form,fruit,geminate,glabrousnes,growth,height,history,inflorescence,length,life,lobing,margin,na,new,number,peduncle,plant,primary,seed,size,surface,sympodial,texture,type,variation
468	wfo-0001031492	success	175	141	115	60	26	0.657	.5,/4,0.5,0.7-1.3,0.9-1.1,08,1-1.3,1-1.5,1.3-2,1.5-1.8,1.5-2.5,10-15,2-10,2-3,2-5,20,3-4,3-5,4-10,4-4.5,6-8,8-11,8-9,absent,acuminate,acute,age,anther,apex,apical,appearing,attenuate,bark,basal,base,becoming,berry,bi-lobed,branching,calyx,cm,conical,corolla,dark,decurrent,densely,diameter,distinguishable,drying,dull,echinoid,elliptic,exserted,filament,flattened,flower,fruit,fruiting,glabrous,globose,golden,grey,growth,lamina,lateral,leaf,lenticular,lightly,lobed,long,minutely,mm,narrowly,ovary,overtopping,pair,pedicel,per,petiole,pitted,pore,poricidal,pubescent,purplish-black,pyramidal,reddish-brown,scarcely,scattered,secondary,shiny,shoot,short,shrub,size,slit-like,sometimes,sparsely,stem,stigma,strongly,style,surface,tapering,terminal,time,tip,tree-like,trichome,tube,vein,violet,way,wide,winged,x	abaxially,adaxially,anthesi,axe,ba,beneath,bitter,dbh,deciduous,deltoid,dendritic,denser,eaf,edicel,eed,erect,ew,free,inserted,juice,lobe,lower,m.,medium,monochasia,nflorescence,nodding,occasionally,older,papillo,pericarp,planar,plurifoliate,portion,predominantly,prominent,rather,remaining,ruit,scar,sleeve,slightly,somewhat,stamen,ste,sticky,sunken,tall,thin,tree,tub,ud,undersurface,unit,upper,upturned,woody,ympodial,young,younger	arrangement,branch,bud,characteristic,colour,exertion,form,glabrousnes,height,history,inflorescence,length,life,lobing,margin,na,new,number,papillose,peduncle,plant,primary,seed,shape,texture,type
469	wfo-0001031503	success	142	135	81	61	54	0.57	-10,-15,-25,-30,-7,0.3-3,0.5-1,0.5-4,1-,1-3,1-5,1.5-7,2-3,2.5-10,3-15,3-4,3-5,7-10,7-15,abruptly,acuminate,acute,angled,apex,base,branched,calyx,chartaceous,cm,connivent,cuneate,decurrent,deltate,densely,diameter,distally,eglandular,elliptic,entire,flower,forked,glabrous,globose,hair,lanceolate,lobe,margin,mm,moderately,narrowed,narrowly,obtuse,often,orange,ovate,pedicel,peduncle,petiole,puberulent,pubescent,rarely,reddish,ripe,rounded,rugose-pubescent,shrub,simple,slightly,sparsely,stigma,style,tip,triangular,truncate,tube,unbranched,unequal,usually,vein,white,x	-6,1-2.5,1-7,1.5-2,1.5-3,1.5-8,1.7-3.5,10-19,3-6,5613,6-7,6-many-foliat,abaxially,absen,adaxially,aggregate,apart,articulated,axe,ba,blade,cell,curled,cylindrical,directed,distall,eaf,eed,except,fide,gland,long,lower,mostly,nflorescence,nther,occasionally,orolla,perfect,pore,present,rachi,radiu,ruit,spaced,stalked,stellate,stone,subcapitat,subclavate,tal,tem,time,toward,uniseriate,unit,vary,venturi,wide,yellow,ympodial	anther,appearance,arrangement,bark,border,branch,bud,characteristic,colour,corolla,corrugation,distal,drying,exertion,filament,form,fruit,fruiting,giving,glabrousnes,growth,height,history,inflorescence,interjected,lateral,leaf,leaflet,length,life,lobing,midpoint,na,new,number,ovary,per,plant,prickle,primary,pseudostipule,ray,seed,shape,size,stem,subcapitate,surface,terminal,texture,thicknes,type,variation,width
470	wfo-0001031586	success	167	70	54	113	16	0.323	0.1-1,0.5-1,1-1.2,1-2,1.4-2.5,2,7-10-flowered,acute,anther,apex,attenuate,base,bud,calyx,capitate,cm,corolla,cream-colored,ellipsoid,elliptic,exerted,glabrous,globose,green,greenish,inflorescence,leaf,lobe,lobed,long,mm,nearly,onto,ovary,pale,papillate,pedicel,petiole,poricidal,ridged,shiny,shrub,simple,somewhat,soon,stem,stigma,style,surface,tapering,tip,truncate,white,yellow	-2,.25,0.5-0.8,1,1-1.5,1.3-5,1.5-2,2-2.5,3-11,5-10,5-6,abrupt,absent,anthesi,apart,apparently,appearing,bark,becoming,beneath,borne,branch,bright,broadly,campanulate,closer,completely,conical,cucullate,deflexed,deltate,dia,differing,difoliate,distance,drying,eaf,edicel,eed,exfoliatin,filament,fleshy,flower,free,fresh,geminate,gree,inflorescenc,know,known,later,lateral,leave,lower,main,major,margin,material,may,minor,minutely,mucro,near,new,nflorescence,notched,occasionally,older,olive,one,open,opposite,overtopping,pair,paler,papillose,planar,pore,portion,present,prominent,raised,remaining,rounded,ruit,scar,shap,shaped,shin,size,slender,small,sometimes,spaced,sparsely,straight,swollen,tall,tear-drop,thick,thickened,trichome,trunk,tube,ud,uniseriate,unit,vein,widely,x,yellowish,ympodial,young	characteristic,colour,diameter,exertion,form,fruit,growth,height,length,lobing,na,plant,seed,shape,texture,type
471	wfo-0001031587	success	142	91	68	74	23	0.479	0.8-1,1-1.5,1.5-2,1.7-2,10-15,12-16,17-30,2,2-2.5,2/3,3-4,5,6-7,6-8,abaxially,acute,adaxially,anther,apex,attenuate,bark,base,bi-lobed,broadly,calyx,clavate,cm,conical,corolla,decurrent,dendritic,densely,elliptic-ovoid,filament,fleshy,glabrous,golden-red,inflorescence,leaf,minor,minutely,mm,oblique,occasional,pale,papillate,pedicel,petiole,pubescent,reddish-grey,shape,shaped,size,soft,somewhat,stem,stigma,style,surface,tear-drop,thick,tree,trichome,tube,way,white,winged,x	.5,2-9-celled,7-9,along,anthesi,apart,axi,closely,cone,deflexed,deltate,denser,dia,differing,drying,eaf,edicel,eed,elliptic,erect,evenly,exserted,fide,free,furcate,globose,included,irregular,know,known,lamina,later,lateral,like,lobe,lobed,long,loose,lower,lowered,main,major,middle,mostly,ocasionally,older,ovary,overlappin,pair,papillo,parallel,perpendicular,persisten,pore,poricidal,portion,rarely,rect,rest,ruit,scar,simple,spaced,steinbach,tall,thickened,tip,tub,ud,uniseriate,vein,verrucose,widest,young	1,1.5,2.5,characteristic,colour,diameter,form,fruit,growth,height,history,length,life,lobing,na,occasionally,papillose,perennial,plant,seed,texture,type,width
472	wfo-0001031589	success	222	118	98	124	20	0.441	-6.5,0.1-0.5,0.2-0.5,0.4,0.5-1,0.55-0.7,0.6-1.2,0.8-2.3,0.9-1.3,0.9-1.6,1-1.8,1.2-1.5,1/3,1/3-1/4,2.5-6,3-5,3/4,acute,anther,apex,apically,articulated,attenuate,base,berry,bright,brown-green,calyx,cell,chartaceous,cm,cream,dark,deltate,densely,diameter,dull,elliptic,erect,filament,flattened-reniform,fruit,fruiting,glabrous,gray-green,green,lateral,leaf,length,lobed,long,long-obovate,lower,margin,marking,maturity,mauve,membranous,mm,moderately,narrow-cuneate,occasionally,often,orange-brown,outline,pair,pale,pedicel,petiole,pit,plant,poricidal,prickly,primary,raised,rounded,shiny,shrub,small,smooth,sparsely,spherical,stellate-pubescent,stem,style,subentire,surface,tapering,tip,upper,vein,way,white,whole,wide,yellow,yellow-green,young	-0.5,-15,-6,.5,/6,0,0-1,0-10,0-3,0-30,0.1,0.15-0.3,0.2-0.4,0.2-3,0.7,1,1-5,1.5-5,1.7-2.5,1.8-2.9,1/3-1/2,10-30,2-,2-10,2-3.5,2.5-4.5,2.8-4,3-4,4-6.5,4/5,5-8,5-merous,6-8,8-14,8-30,abaxially,alyx,ame,apart,apparently,bark,blade,broadly,brow,c.,caudat,concolorous,connivent,density,difoliate,discolorous,distance,drying,eed,elongating,equal,extending,eye,flower,free,geminat,glabrescent,higher,infructescence,lengt,lobe,lon,longer,mature,midpoint,midvein,multangulate,naked,narrow,nflorescence,oblong,obovate,older,orange-green,orolla,oung,part,pendulous,per,perfec,pericarp,porrect,portion,prickl,prickle,ray,reflexed,ruit,scandent,sessile,shorter,side,simple,solitary,sometimes,somewhat,spaced,spreading,stalk,stalked,stellate,stout,straight,subsessile,tamen,terete,tertiary,time,trichome,tube,unit,vary,venation,visible,weakly,winged,woody,yellow-orange,ympodial	arrangement,caudate,characteristic,colour,corolla,exertion,form,glabrousnes,growth,height,inflorescence,lobing,new,ovary,peduncle,seed,shape,size,texture,type
473	wfo-0001031609	success	154	101	78	76	23	0.506	0.4-3,0.5-3,1-10,1-6,1.3-3,10-25,2-,2-3,20-25,3-24,3-5,3-9-lobed,4,4-5,4-6,4.5-60,8-20,acute,apex,apiculate,around,base,brownish,calyx,campanulate,cm,connective,connivent,cuneate,dark,deltate,dia,diameter,ellipsoidal,elliptic,elliptic-ovate,entire,flattened,fleshy,forked,fruit,glabrous,globose,green,inflorescence,leaf,lobe,lobed,margin,mm,obovate,obtuse,orange,pedicel,peduncle,petiole,pinnately,puberulent,rachi,reticulate,ripe,shallowly,shrub,simple,small,stellate,stigma,style,succulent,tip,tree,triangular,truncate,tube,unbranched,unlobed,x,yellow	.5,/4,0-30,0.5-1,1.5-2,1.5-3,2,2.5-4,3-foliat,5-25,5/6,abaxially,absen,absent,adaxially,aggregate,ape,articulated,axe,barely,beyond,bilobe,blade,branch,brow,cell,conspicuous,contiguous,dilated,directed,distally,divided,eaf,eed,emerging,equal,exceeding,exserted,flower,glabrou,laterally,leaving,long,lower,midrib,minutely,nearly,nflorescence,nther,obconical,occasionally,orolla,papillose,pedicellar,point,pore,radiu,rounded,ruit,scar,sinus,stamen,stone,strongly,succulen,tal,tem,thecae,time,tomento,two,ud,unit,vary,wide,ympodial	abaxial,adaxial,anther,arrangement,bilobed,brown,bud,characteristic,colour,corolla,form,growth,height,length,ovary,plant,seed,shape,size,stem,surface,texture,type
474	wfo-0001031615	success	154	95	70	84	25	0.455	.5,0,0.5-1,0.8-1,0.9-1.1,1-1.6,1.3-1.8,1.5,1.5-5,11-15.5,2-4.2,3.8-6.1,4-6.5,5-20-flowered,5-6,6-8,anther,bark,berry,bilobed,calyx,capitate,cm,corolla,deep,dia,difoliate,elliptic,exserted,flattened-reniform,fruit,fruiting,furcate,glabrous,glandular,globose,green,inflorescence,leaf,long,major,minor,minutely,mm,occasionally,older,opposite,ovary,pedicel,per,petiole,scarcely,shaped,shrub,simple,size,small,stem,stigma,style,subumbellate,surface,tear-drop,tree,trichome,uniseriate,unit,white,x,young	0.5,2-3,8-10,acuminate,acute,anthesi,apex,arising,attenuate,axil,ba,base,becoming,brown,caly,closely,dark,dark-papillo,decurrent,deflexed,deltoid,differing,distal,eaf,edicel,eed,expanded,filament,free,geminat,impressed,incrassate,interpetalar,lamina,lateral,less,lobe,lobed,lon,lower,main,margin,maroo,middle,minute,nearly,nflorescence,one,overlappin,packed,pair,paler,papillae,papillose,pitted,pore,poricidal,portion,prominent,reflexed,ruit,scar,shiny,sinus,slender,slightly,somewhat,straight,tall,tapering,terminal,thickened,thin,tip,tube,tuft,ud,unicellular,urceolate,vein,widest,winged,woody,ympodial	abaxial,arrangement,bud,characteristic,colour,dark-papillose,diameter,exertion,form,geminate,growth,hair,height,hirsute,history,length,life,maroon,number,plant,seed,shape,sympodial,texture,type
475	wfo-0001031618	success	184	101	80	104	21	0.435	-2,0-3,0.5-1.5,1-1.5,1.5-2,10-18,2-3,3-4,3-8,4-5,5-12,90-110,acute,anther,apex,axil,base,berry,branch,broadly,calyx,capitate,cm,corolla,cuneate,cyme,darker,discoidal,ellipsoid,equal,erect,except,filament,finely,glabrous,glandular,green,greyish,growing,hair,lavender-purple,leaf,less,lobe,long,marbled,maturity,minute,mm,narrowly,obovoid,ovary,ovoid,pale,pedicel,peduncle,petiole,pinatisect,point,purple,reddish-brown,reticulate,rounded,rugose,scorpioid,shrub,simple,somewhat,stem,stigma,stripe,surface,tapering,terete,tinged,triangular,unequal,variable,x,young	1-7,1.5-3.5,10-lobed,13,2-2.5,3,40-60,5,acuman,almost,also,anthesi,appearance,appearing,aspect,becoming,beyond,blunt,bluntly,c.,cell,clonal,cluster,column,conical,covering,cut,developed,dia,eaf,eed,elliptic,emarginate,enlarged,exerted,extending,facetted,fleshy,floral,flower,fork,forked,frui,general,giving,greatly,gree,habit,half,interacuminal,lanceolate,lasting,lengthening,lobed,lon,loosely,lower,mauve,may,mid-vein,midrib,nflorescence,oblong,occasional,occur,often,ovate-lanceolate,pal,pedicellate,petal,plurifoliat,pore,poricidal,rarely,rhachi,ripe,rotate,ruit,sessile,several,shallowly,side,single,sinus,slit,soft-wooded,sometimes,specimen,stone,stout,strongly,styl,succulent,tip,tissue,tub,ud,unit,vigorous,way,well,year,ympodial,younger	bud,characteristic,colour,diameter,form,fruit,growth,height,history,inflorescence,length,life,number,per,plant,seed,shape,size,style,texture,type
476	wfo-0001031646	success	171	123	78	93	45	0.456	.2,0.2-0.8,0.5-2,0.8-1.5,1-1.8,1-6,1.2-2.5,15-25,18-38,2-3,2.5-10,4-18,4-20,4-5,7-8,8-15,absent,acuminate,acute,anther,apex,articulated,basally,base,berry,blue,branched,brown,calyx,chartaceous,cm,cuneate,densely,diameter,ellipsoidal,entire,filament,flattened,flower,fruit,fruiting,glabrous,globose,green,highly,immature,interjected,lateral,leaf,leaflet,light,lobe,margin,mature,mm,oblique,oblong,ovate-lanceolate,pedicel,peduncle,petiole,pubescent,red,rotate-pentagonal,rounded,rugulose,shortly,shrub,size,smooth,stem,stigma,stout,style,surface,tube,violet,x	-7,-pinnate,.5,1-10,1.5-3.5,1.5-4,1962,2-10,2-2.5,20,3.5-4,4-8,4-foliate,5,5-6,5-7,5-7.5,5-merou,abaxially,absen,accrescent,acut,adaxially,aggregate,alyx,apart,apical,apparently,axe,ba,blade,cell,ciliat,climbing,connivent,correll,covered,cylindrical,darker,decreasing,directed,distall,eaf,eed,elliptic,elliptic-lanceolate,equal,fide,geminat,glandular,hair,high,homostylous,hyaline,long,lower,maroon,multicellular,nflorescence,obliquely,obtuse,orolla,ovate-lanceolat,part,perfect,petiolule,pore,present,pubescen,pubescence,rachi,ruit,scandent,seudostipule,simple,slightly,small,spaced,spreading,stone,tamen,tawny,tem,tip,toward,tree,truncat,uniseriate,unit,vary,vine,yellow,ympodial	appearance,arrangement,bark,border,branch,bud,characteristic,colour,corolla,corrugation,distal,drying,exertion,form,giving,glabrousnes,growth,height,history,inflorescence,length,life,lobing,midpoint,na,new,number,ovary,per,pinnate,plant,prickle,primary,pseudostipule,ray,seed,shape,terminal,texture,thicknes,truncate,type,variation,vein,width
477	wfo-0001031651	success	201	126	101	100	25	0.502	-3.5,.6,.7,/5,0-20,0.3-0.5,0.3-0.8,0.3-1.5,0.6-1,0.6-1.3,0.7-1,1-1.7,1.2-2,1.2-3,1.3-1.6,3-5,4-5,absent,anther,apex,apparently,articulated,bark,base,berry,branched,calyx,cell,chartaceous,cm,concolorous,cordate,dark,densely,diameter,discolorous,drying,dull,elliptic,entire,erect,faint,filament,flattened-reniform,fruit,fruiting,gray,herb,lateral,leaf,length,lobed,long,lower,margin,maturity,mm,obtuse,orange-brown,outline,ovate,pair,pedicel,peduncle,per,petiole,pit,poricidal,prickly,primary,purple,raised,red,red-green,rounded,shrub,simple,small,smooth,sometimes,spherical,spreading,stellate-pubescent,stem,style,subentire,surface,tapering,terete,terminal,tip,tube,unarmed,vein,visible,way,weakly,white,wide,yellow,yellow-green	-2,-3,.1,/3,0.1,0.1-0.15,0.1-0.2,0.1-0.25,0.15-0.2,0.2-0.5,1,1-2,1-4,1.5-2,1/5,1/6-1/4,2-10,2-3,2-3.5,2/3-3/,4-6,4.5-7,5-merous,abaxial,abaxially,acuminat,acute,adaxial,alyx,ame,apar,apart,apically,blade,brown,c.,curved,deltate,difoliate,eaf,eed,elongating,equal,eye,filiform,flower,free,geminat,glabrescent,glabrous,gra,herbaceous,infructescence,lanceolate,lobe,longer,mature,midpoint,naked,nflorescence,oblong,older,one,open,orolla,oung,pendulous,perfec,pericarp,persistent,porrect,portion,prickl,prickle,ray,reflexed,ruit,scandent,scar,shorter,spaced,stalk,stalked,stellate,straight,subsessile,tamen,tertiary,thick,thick-stalked,time,toward,trichome,unarme,unit,upper,variously,vary,venation,ympodial	2/3-3/4,arrangement,branch,bud,characteristic,colour,corolla,exertion,form,glabrousnes,growth,height,inflorescence,lobing,na,new,number,ovary,plant,seed,shape,size,stigma,texture,type
478	wfo-0001031656	success	154	120	96	58	24	0.623	/4,0.5-1,1-2,1-2.5,1.2-1.5,1.5-2,1.5-5,10-20,2.5-3.5,4-9,5-7,5-ribbed,6-8,acuminate,acute,anther,anthesi,apex,arising,bark,base,berry,bright,calyx,capitate,cm,corolla,dia,difoliate,directly,drying,ellipsoid,elliptic,enclosing,fleshy,flower,fruit,fruiting,glabrous,globose,green,greyish,lateral,leaf,live,lobe,long,long-acuminate,lower,main,matte,minor,minutely,mm,node,oblique,opposite,ovary,ovate,pair,papillose,pedicel,persistent,petiole,planar,plant,prominent,rather,red-papillose,reddish,reflexed,rounded,sessile,shaped,shiny,shrub,size,slightly,somewhat,stem,stigma,straight,strongly,style,surface,swollen,tear-drop,thick,tip,unit,upper,vein,way,white,woody,x	.5,0.5,1-1.5,3-3.5,3-5,also,ba,closely,cork,densely,differing,eaf,edicel,eed,erect,extremely,filament,free,geminat,hooded,known,lobed,lon,major,margin,mature,middle,minute,nflorescence,often,older,one,pale,paler,papillo,peelin,pore,poricidal,portion,proximal,rib,ridged,ruit,scar,spaced,specimen,tall,terminal,thickened,top,transversely,tube,ud,visible,wide,widest,ympodial,young	arrangement,bud,characteristic,colour,diameter,exertion,form,geminate,growth,height,history,inflorescence,length,life,lobing,na,number,per,primary,seed,shape,sympodial,texture,type
479	wfo-0001031667	success	153	77	54	99	23	0.353	0.6-1,1-1.5,1-4,1.4-3,1.5-2,10-13,12-35,2-5,2.5-5,3-13,3-5,5-9,6-10,8-13,8-15,branched,calyx,cm,corolla,cyme,diameter,dichasial,dichasially,ebracteate,filament,globose,herbaceous,interjected,irregularly,lateral,leaf,leaflet,lobed,long,mm,monochasial,mucilaginous,odd-pinnate,ovoid,pedicel,peduncle,perennial,petiole,pilose,plant,seed,size,stellate,stigma,style,terminal,tuber-bearing,white,yellow	0.6-1.5,2-3,2-6,3-6-foliat,3-8,4-1.,5-15,abaxially,abruptly,acumen,acuminate,acute,adaxially,apex,apical,apically,apiculate,articulate,base,caudate,cell,connate,cordate,covering,cuneate,dark,dehiscent,digestion,diminishing,distal,dorsally,eaf,edge,eed,elliptic-lanceolate,emoval,enzyme,exceeding,flat,flower,folded,forked,generally,globo,green,green-white,hair-like,half,honeycomb,introrse,lanceolate,living,lobe,lon,lower,lunat,make,maturing,nflorescence,nther,oblique,oblong,often,orolla,pair,pattern,perfect,petiolate,petiolule,plan,poricidally,proximal,reveal,rounded,ruit,sessile,seudostipule,short,slit,specimen,spot,stamen,straight,stripe,tal,tem,testal,thick,throughout,toward,typically,unit,vary,wall,whit,wide,without,ympodial,Â¼	4-10,abaxial,adaxial,anther,arrangement,characteristic,colour,form,fruit,growth,height,history,inflorescence,length,life,lobing,ovary,pseudostipule,shape,stem,surface,texture,width
480	wfo-0001031672	success	157	101	77	80	24	0.49	0-2,0.3-0.5,0.5-1.5,1-10,1-2,1-5,1.5-2,1.5-2.5,1.5-3.5,1.5-5,10-20,15-20,15-50,4,6,9-lobed,acuminate,acute,apex,apiculate,basal,base,calyx,chartaceous,cm,connective,cordate,cylindrical,densely,diameter,entire,flattened,flower,fruit,glabrous,glandular-puberulent,globose,green,greenish-brown,hair,lanceolate,leaf,lobe,lobed,long,margin,mature,membranaceous,mm,moderately,narrowly,ovate,ovoid,pedicel,peduncle,petiole,pilose,pinnately,puberulent,purple,rachi,rounded,simple,sparsely,stellate,stigma,style,subcoriaceous,tip,tree,triangular,truncate,unbranched,white,whitish,x,yellow	0,0.5,0.5-1,1,1-,1-1.5,2-12,2-28,3-4-foliat,3/4,4-34,4.5-5,4/5,5-6,abaxially,absent,adaxially,aggregate,apart,ape,articulated,aublet,axe,beyond,blade,cell,ciliat,directed,distally,divided,eaf,eed,exceeding,exserted,fide,fleshy,leaving,lon,lower,midrib,near,nflorescence,nther,obtuse,occasionally,often,one,orolla,pedicellar,perfect,pilo,pore,presen,present,pubescent,radiu,remant,represented,ruit,shorter,sinus,slightly,small,spaced,stamen,stone,tal,tem,thecae,time,toward,truncat,tube,ud,unit,unlobed,vary,wide,yello,ympodial	abaxial,adaxial,anther,arrangement,bud,characteristic,colour,corolla,form,growth,height,history,inflorescence,length,life,ovary,perennial,plant,seed,shape,size,stem,surface,texture
481	wfo-0001031684	success	161	127	108	53	19	0.671	.25,.5,.75,/4,0.1,0.4-1.5,0.5-0.7,0.5-0.8,0.7-1,1-1.2,1-5,10-100,2-9,3-3.5,3-30,4-17,acuminate,acute,along,anther,apex,base,bearing,beneath,berry,black,borne,branched,calyx,clavate,cm,corolla,curly,decurrent,densely,dia,difoliate,drying,elliptic,expanded,exserted,extremely,filament,filiform,flower,fruiting,geminate,glabrous,globose,green,inflorescence,internodal,irregularly,leaf,less,lobe,lobed,long,lower,minutely,mm,occasionally,older,opposite,ovary,ovoid-reniform,pale,papillose,pedicel,persistently,petiole,pitted,pore,poricidal,previously,pubescent,scar,shaped,short,shrub,size,slender,slightly,small,soon,sparsely,stem,stigma,straight,style,surface,tan,tapering,tear-drop,time,tip,tipped,tree,trichome,tube,unifoliate,uniseriate,vein,way,white,winged,x,young	0.5-1,0.75-1,2,5-7,anthesi,apar,bark,causing,deflexed,denser,differing,eaf,edicel,eed,elongated,except,free,gre,greatly,lateral,like,lon,long-triangular,main,major,middle,midrib,minor,nflorescence,obconic,one,pair,papillo,planar,portion,present,pulled,raised,reflexe,reflexed,rest,ruit,single,siz,spaced,tall,ud,unevenly,unit,varying,widely,widest,ympodial	arrangement,bud,characteristic,colour,diameter,exertion,form,fruit,growth,height,history,length,life,lobing,plant,seed,shape,texture,type
482	wfo-0001031695	success	185	136	111	74	25	0.6	0.5-1,0.5-2,1,1-2,1-9,1.5-8,10-35,2-3,2.5-5,20-30,3-10,3-17,3-19,3-7,30-40,4-10,4-5,4-6,5-20,6-10,6-20,abaxially,abruptly,acuminate,acute,also,apart,apex,apically,apiculate,basal,base,branched,broadened,calyx,campanulate,cm,color,connective,connivent,cordate,cylindrical,dark,deep,densely,diameter,dilated,ellipsoidal,entire,exceeding,flattened,flower,fruit,glabrescent,glabrous,glandular-puberulent,green,greenish,hard,immature,lanceolate,lavender,leaf,lobe,lobed,long,margin,mm,moderately,mottled,narrowly,oblique,oblong,obtuse,occasionally,often,ovate,ovoid,pedicel,peduncle,petiole,pilose,pilose-hirsute,puberulent,puberulent-pubescent,pubescent,purple,purplish,rachi,radiu,remnant,ripe,shorter,shrub,simple,slightly,sometimes,somewhat,sparsely,stigma,stripe,style,thecae,tip,triangular,tube,unbranched,unequal,unknown,x,yellow	1-3,1.5-2,1/2,1/3,10-,10-15,15-20,2-4,2-5,3-,4-foliat,5,5-7,6-8,7-,?,adaxially,aggregate,ape,articulated,axe,beyond,blade,capitat,cell,chartaceous,d,directed,divided,eaf,eed,eglandular,eglandular-pilose,exserted,fleshy,glabrate,hair,lateral,laterally,leaving,lilac,lon,lower,midrib,nflorescence,nther,orolla,pedicellar,perfect,pilo,pilose-hirsut,pore,presen,present,rounded,ruit,sinus,slight,small,spaced,stamen,stone,subcoriaceous,swelling,tal,tem,time,tomento,tree,unit,unlobed,vary,wide,ympodial	abaxial,adaxial,anther,arrangement,bud,capitate,characteristic,colour,corolla,form,growth,height,history,inflorescence,length,life,ovary,perennial,plant,seed,shape,size,spacing,stem,texture
483	wfo-0001031698	success	58	56	31	27	25	0.534	2-2.5,2.5,2.5-3,4-4.5,bark,base,branch,cm,dull,elliptic,flattened,fruiting,glabrous,green,leaf,margin,minutely,mm,pale,pedicel,pitted,reddish-brown,reniform,rugose,shrub,stem,stout,strongly,surface,winged,x	'',``,ape,decurrent,deflexed,dia,difoliate,eaf,eed,fide,geminat,incrassate,long,maguire,older,otherwise,paler,papillae,persistin,repandly,tall,unit,wing,woody,yellowish,ympodial,young	1,apex,arrangement,characteristic,colour,decument,diameter,form,fruit,growth,height,history,length,life,na,number,per,plant,primary,seed,shape,size,texture,type,vein
484	wfo-0001031707	success	178	113	91	87	22	0.511	/4,0.5-1,1-1.2,1-1.3,1-1.5,1-3,1.2-1.8,1.2-2,1.5-1.7,1.5-6,1/3,16-20,2-4,2-6,3,6-7,8-12,9-15,acuminate,acute,almost,anther,apex,apically,attenuate,axillary,base,basiscopically,bearing,berry,brown,calyx,capitate,cm,conical,conspicuously,corolla,densely,diameter,distal,elliptic,enlarged,erect,flattened,flower,four-lobed,fruiting,glabrous,globose,green,greenish,lanceolate,leaf,leaflet,long,mm,narrowly,oblique,obovate,occasionally,ovary,pair,pedicel,petiole,petiolule,pink,pinnate,plant,pointed,poricidal,pubescent,reddish,round,sagittate,slightly,smooth,somewhat,sparsely,stigma,stout,style,surface,ternate,tip,type,vine,way,white,white-lenticellate,woody,x	-3,.5,1.5-2,2,2-10,2-3,24,4-5,4-6,5-10-celled,80-140,abaxially,absent,adaxially,along,anthesi,apical,axil,basal,c.,cateniform,cell,clavat,climbing,cucullate,dense,distinct,drying,eaf,edicel,eed,endrophilum,epidermal,exserted,filament,flap-like,flat,fleshy,free,high,horizonta,inflorescenc,lateral,less,like,lobe,lobed,lon,lower,margin,minutely,narrower,nflorescence,open,papillate,penden,per,planar,portion,primary,quadrate,quite,raised,regular,rest,ruit,scar,scattered,simple,smaller,spaced,strongly,tem,terminal,thickening,time,trichome,tub,tube,ud,unifoliat,uniseriate,unit,usually,vein,widely,ympodial	0.5,arrangement,characteristic,clavate,colour,form,fruit,glabrousnes,growth,height,history,horizontal,inflorescence,length,life,lobing,new,seed,shape,size,stem,texture
485	wfo-0001031723	success	228	164	142	86	22	0.623	-1.5,-2,-5,0,0.1-0.2,0.2-1,0.4,0.4-,0.4-0.9,0.4-1,0.55-0.9,0.6-1,0.7-1,0.8-1.5,1-,1-2,1-2.5,1-3,1.2-2,15-45,2-,2-3.5,2.5-4.5,2.5-5,2/3-3/4,4-11,5-9,8-20,abaxial,abaxially,acuminate,acute,adaxial,ame,anther,apex,apically,apparently,articulated,bark,base,berry,branched,branching,brown,c.,calyx,chartaceous,cm,connivent,cuneate,curved,dark,deltate,densely,diameter,discolorous,drying,dull,elongated,entire,erect,evenly,filament,filiform,finely,flattened-reniform,fruit,fruiting,gently,glabrescent,glabrous,glandular,green,hair,lateral,leaf,length,lobe,lobed,long,margin,marking,maturity,mauve,midpoint,minute,mm,moderately,multangulate,narrow-deltate,near,obtuse,orange,orange-brown,ovate,pale,pedicel,peduncle,petiole,poricidal,porrect,prickle,prickly,primary,ray,recurved,red,reflexed,rounded,secondary,sessile,shrub,simple,sometimes,sparsely,spherical,spreading,stalked,stellate,stellate-pubescent,stem,straight,strongly,style,subentire,surface,tapering,terminal,tip,trichome,tube,unarmed,usually,variously,way,weakly,white,wide,yellow,yellow-green,young	-1/2,-15,-16,-6,-6.5,-8,-merous,0.05-0.2,0.1-0.3,0.1-0.5,0.15,1-5,1.5-,1.5-10,1.5-2.5,1/3-1/2,1/4-1/3,1/6-,10-30,2-5.5,2-7,2/3,3-10,3-15,4-,4-10,4-20,4-5,4-6,5-40,acut,alyx,apar,apart,ba,blade,brow,conical,eaf,eed,elongating,equal,eye,flower,free,gland,gland-tipped,gray,herbaceous,inflated,infructescence,longer,lower,mature,naked,nflorescence,older,one,open,orolla,oung,pair,per,perfec,pericarp,perpendicular,plurifoliat,portion,ruit,scar,smooth,spaced,stalk,tamen,terete,tertiary,time,unarme,unit,vary,vein,venation,visible,whitish,woody,ympodial	arrangement,branch,characteristic,colour,corolla,exertion,form,glabrousnes,growth,height,inflorescence,lobing,na,new,ovary,plant,seed,shape,size,stigma,texture,type
486	wfo-0001031729	success	161	112	88	73	24	0.547	-2,-45,..,0.5-1,0.5-4,0.6-,1-1.5,1-2,1-2.5,1.0-1.3,1.5,1.5-2,10-20,11-30,2-3,2.5-,2.5-5,3-4,3.5-4,4.1-16,5-,5-6,5-7,abruptly,acuminate,anther,apex,apiculate-deltate,attenuate,base,branch,branched,calyx,cm,conical,corolla,dark,darker,deltate,diameter,drying,elliptic,filament,flattened,fruit,fruiting,glabrous,globose,green,greenish,later,lobe,long,markedly,middle,mm,mottling,nearly,obovate,occasionally,ovary,ovate-reniform,pair,pale,pedicel,peduncle,per,petiole,pink,point,pointed,purplish,quadrate,reddish,shrub,single,small,smooth,somewhat,stem,stripe,surface,tan,time,tube,white,x,young	-0.5,0.5,12-13,2-2.5,3-celled,50,8-9,along,anthesi,apicula,beneath,branc,brittle,brow,c.,cell,cucullate,curve,dry,eaf,edicel,eed,elongate,erec,flattened-capitat,flower,glandular,gradually,less,lobed,lower,membranous,minute,minutely,narrowly,never,nflorescence,noddin,open,outer,outline,papillae,papillate,papillose,pericarp,planar,plurifoliat,primary,regularly,ruit,scar,scattered,short,single-stemmed,sinuate,stigma,striate,testa,thin,thing,tip,toward,triangular,trichome,tuft,ud,unit,usually,vein,wall,wand-like,widening,ympodial	0-0.5,arrangement,bud,characteristic,colour,curved,form,growth,height,history,inflorescence,leaf,length,life,lobing,number,perennial,plant,plurifoliate,seed,shape,size,texture,type
487	wfo-0001031738	success	231	166	146	85	20	0.632	-15,-5,0,0-2,0.2-0.3,0.7-1,0.7-1.1,0.9-2.1,1-1.5,1-1.8,1-4,1.4-1.7,1.5-,1.5-4,1/2-2/3,1/3,1/3-2/3,10-15,15-40,2-,2-4,2.3-3,3-4,3-6,4,4-5,4-8,5-8,6-15,7-12,abaxial,abaxially,acute,adaxial,always,anther,apex,apically,apparently,articulated,auriculate,bark,base,berry,branched,calyx,cell,chartaceous,cm,connivent,cordate,dark,deltate,densely,diameter,discolorous,distance,drying,dull,erect,evenly,extending,filament,flattened-reniform,flower,frequently,fruit,fruiting,glabrescent,glabrous,gray,green,lateral,leaf,length,lobe,lobed,lobing,long,long-styled,margin,maturity,midpoint,midvein,mm,narrow-deltate,oblong,obovate,often,one,open,orange,orange-brown,outline,ovate,pale,pedicel,peduncle,petiole,pit,plant,poricidal,porrect,prickle,prickly,prominent,raised,ray,reflexed,rounded,secondary,sessile,shorter,shrub,side,simple,small,smooth,sometimes,spherical,spreading,stellate-pubescent,stem,strongly,style,surface,tapering,terete,terminal,time,tip,tree,trichome,truncate,tube,unarmed,upper,way,weakly,white,wide,yellow,yellow-green,yellow-orange,yellowish,young	-6,-merous,.5,0-3,0.1-0.25,0.25-0.8,0.3-1,1-3,1/,1/4-1/3,1/6-1/4,20-200,3-7,3.5-3.8,3.5-4.5,4-10,4-6,5,7-12.5,8-10,8-18,acuminat,adaxially,almost,alyx,andromonoecious,apar,apart,blade,curved,distal,eaf,eed,elongating,equal,flattened,free,held,hermaphrodite,heterostylous,infructescence,inside,longer,lower,lowermost,mature,multangulate,nflorescence,older,orolla,oung,pair,per,pericarp,plurifoliat,poorly,portion,prickl,primary,pubescent,resin,ruit,scar,short-styled,spaced,sparsely,stalk,stalked,staminat,stellate,sticky,stout,straight,tamen,tertiary,unit,usually,variously,vary,vein,venation,visible,white-brow,woody,ympodial	acuminate,arrangement,branch,characteristic,colour,corolla,exertion,form,glabrousnes,growth,height,inflorescence,new,ovary,seed,shape,size,texture,type,white-brown
488	wfo-0001031752	success	172	142	89	83	53	0.517	-10,-100,-6,0.5-1,1,1-2,1-4,1.5-3,1.5-3.5,15-25,15-40,2-2.5,2-5,20-35,3-11.5,3-4,3-7,3.5-5,5-23,5-8,acuminate,acute,apex,apiculate,basal,base,beyond,calyx,chartaceous,cm,connivent,cuneate,darker,deltate,diameter,ellipsoidal,elliptic,entire,exserted,flattened,flower,fruit,fusiform,glabrescent,glabrous,glandular-puberulent,green,immature,lanceolate,less,light,lobe,margin,mm,moderately,narrowly,oblong,older,ovate,ovoid,pedicel,peduncle,petiole,pink,puberulent,purplish,ripe,rounded,rugose,shrub,simple,small,stamen,stigma,stripe,style,subcordate,subcoriaceous,tip,tree,triangular,truncate,tube,unbranched,white,wide,x,yellow,young	-3,-44,-47,-pubescent,0.5-1.5,1-,1-1.5,1-3,1.5-10.5,1.5-2,1.5-2.5,2-3,3-4-foliat,3.5-15,5-6,8-15,9-16,abaxially,adaxially,aggregate,apart,ape,articulated,axe,blade,cell,ciliat,ciliate,connective,cylindrical,densely,directed,distally,eaf,eed,equal,exceeding,fleshy,glabrate,gland,glandular-puberulen,leaving,linear,lon,long,lower,membranaceous,near,nearly,nflorescence,nther,obtuse,often,olde,orolla,pedicellar,perfect,pore,presen,present,pubescent,purpl,rachi,radiu,remnant,ruit,slightly,spaced,sparsely,stalked,stellate,stone,swelling,tal,tem,thecae,time,tomentose,truncat,ud,unit,vary,ympodial	anther,appearance,arrangement,bark,border,branch,bud,characteristic,colour,corolla,corrugation,distal,drying,exertion,filament,form,fruiting,giving,glabrousnes,growth,height,history,inflorescence,interjected,lateral,leaf,leaflet,length,life,lobing,midpoint,na,new,number,ovary,per,plant,prickle,primary,pseudostipule,ray,seed,shape,size,stem,surface,terminal,texture,thicknes,type,variation,vein,width
489	wfo-0001031756	success	186	102	75	111	27	0.403	.5,.8,/2,0-2,0.4-1.6,0.5-1,0.6-1.2,0.6-1.6,0.8-1,1-4,1.5-2,1.8-2.5,abaxially,anther,apex,apically,articulated,bark,base,berry,calyx,cm,color,cordate,deltate,densely,diameter,entire,erect,evenly,filament,finely,flattened-reniform,fruit,fruiting,glabrous,gray,green,known,leaf,long,margin,mature,mauve,mm,moderately,orange-brown,ovate,pale,pedicel,peduncle,petiole,pitted,poricidal,prickly,rounded,shoot,short,shrub,simple,spherical,stellate-pubescent,stem,style,surface,tapering,terminal,tip,truncate,tube,way,white,wide,yellow-green,young	-1,-5,.1,0,0-5,0.02-0.2,0.1,0.15-0.25,0.2,0.5-1.3,0.7-1.7,00,1-1.8,1-2,1-3,1.5-3.5,1/2,1/3,10,2-6,3-15,3-5,3-7,4-5,4.5,5-merous,6-9,7-10,9-14,accrescent,acut,alyx,apar,apart,apparently,blade,branched,broad-deltate,chartaceous,concolorous,conical,connivent,curved,drying,eaf,eed,elongating,enclosing,equal,eye,flower,free,fully,glabrescent,glabrou,herbaceous,inflated,infructescence,invested,lobe,lobed,longer,lower,midpoint,naked,nflorescence,older,one,open,orolla,oung,pair,pendulous,per,perfec,pericarp,perpendicular,plurifoliat,porrect,portion,prickl,prickle,primary,ray,red-brown,ruit,scandent,scar,sessile,shorter,slender,small,smooth,spaced,sparsely,spreading,stalk,stalked,stellate,straight,tamen,terete,time,trichome,unarmed,unit,variously,vary,vein,visible,ympodial	acute,arrangement,branch,characteristic,colour,corolla,exertion,form,glabrousnes,growth,height,history,inflorescence,length,life,lobing,na,new,ovary,perennial,plant,seed,shape,size,stigma,texture,type
490	wfo-0001031786	success	209	116	96	113	20	0.459	/3,0.2-2.5,0.5-1.5,0.7-1,0.7-1.6,0.7-4,0.8-1.2,1.2-1.6,1.5-1.9,1.5-2.5,2-3,2-7,2.5-3.5,4-5,acute,almost,anther,apex,apparently,articulated,bark,base,becoming,berry,branched,calyx,cell,chartaceous,cm,connivent,cuneate,curved,dark,deep,diameter,drying,elliptic,erect,evenly,flattened-reniform,fruit,fruiting,glabrous,gray,green,herb,lateral,leaf,length,lobed,long,margin,maturity,mauve,membranous,minute,mm,orange,orange-brown,outline,ovate,pale,pedicel,peduncle,petiole,pit,poricidal,prickle,raised,red,red-brown,reflexed,shiny,shrub,simple,small,smooth,sometimes,sparsely,spherical,spreading,stellate-pubescent,stigma,straight,style,surface,tapering,tip,trichome,truncate,way,weakly,white,wide,yellow-orange,young	-5,.4,.5,/2,0,0-2,0-20,0-3,0-5,0.1,0.1-0.4,0.2-0.3,0.25-0.5,0.8,1,1-2,1-3,1-4,1-6,1/3-1/2,2-13,2-8,3-4,3-5.5,5-7,5-merous,6-8,8-12,abaxially,acut,alyx,ame,apar,apart,apically,blade,c.,clavat,concolorous,deltate,densely,distance,eaf,eed,elongating,equal,extending,eye,filament,filiform,flattened,flower,free,glabrescent,gray-brow,herbaceous,inconspicuous,infructescence,lobe,lon,longer,lower,mature,midpoint,midvein,naked,nflorescence,obtuse,older,one,open,orolla,oung,pair,pendulous,per,perfec,pericarp,plurifoliat,porrect,portion,prickl,prickly,primary,ray,rounded,ruit,scandent,scar,sessile,shorter,side,slightly,spaced,stalk,stalked,stellate,stem,tamen,terete,tertiary,thick,time,tube,unarmed,unit,variously,vary,vein,venation,visible,woody,ympodial	arrangement,characteristic,clavate,colour,corolla,form,gray-brown,growth,height,inflorescence,lobing,ovary,plant,seed,shape,size,staman,texture,type,width
491	wfo-0001031793	success	188	110	88	100	22	0.468	-4,.5,0,1-1.5,1-2,1-8,1.5-2,1.5-4,10-15,13-20,15-20,2-3,2-5,26,3-8,8-11,abundant,acuminate,aging,almost,anther,apex,armed,articulated,base,berry,black,branched,broadly,brownish,capitate,cm,cuneate,densely,diameter,elliptic,extra-axillary,filament,flattened,flower,forked,fruit,fruiting,globose,hair,inflorescence,interpetalar,leaf,lobe,lobing,long,many,margin,minutely,mm,oblong-lanceolate,orange-yellow,orbicular-ovate,ovate,pedicel,peduncle,per,petiole,porocidal,prickle,pubescent,rachi,rounded,scattered,shallow,shrub,simple,size,small,stellate,stellate-pubescent,stem,stigma,style,tip,tissue,tree,unbranched,well-developed,white,x,yellow,yellow-brown	1,1-3,1/3,1/4,1/5,20,3-4,3/4,4,40,5-merous,7,absent,accrescent,acumen,acute,adult,alyx,apparently,aspect,axe,ba,bilobe,blade,branche,broad,brown,calyx,central,chartaceous,cut,difoliate,distal,eaf,eed,elongatin,erec,erect,evident,extreme,ferrugineous,geminat,general,glandular,homostylou,larger,linear,lon,lower,main,maturing,midpoint,midrib,mostly,mucilaginous,nflorescence,oblique,obtuse,often,older,orolla,perfect,pore,porrect,principal,reddish,reduced,reticulation,ruit,rusty,scarcely,sessile,side,similar,single,sinus,smaller,sparsely,stellate-pubescen,stipitate,stout,surface,tall,tamen,tem,testa,thickened,triangular,triangular-acuminat,trichome,tube,unarmed,unit,upward,usually,uvenile,vary,way,woody,ympodial	abaxial,adaxial,arrangement,bilobed,characteristic,colour,corolla,form,growth,height,history,juvenile,length,life,number,ovary,perennial,plant,seed,shape,texture,type
492	wfo-0001031829	success	138	89	69	69	20	0.5	.5,0.7-1,1-2,1.3-1.5,1.5-3.5,2-4,3/4,4-8.5,acute,adaxial,anther,apex,bark,base,berry,branched,calyx,capitate,cm,corolla,deflexed,densely,drying,elliptic,exserted,fruiting,glabrous,globose,green,greenish-brown,growth,immature,inflorescence,known,leaf,leathery,like,lobed,long,margin,mm,occasionally,ovary,pedicel,petiole,pubescent,revolute,shaped,shrub,simple,size,soft,somewhat,sparsely,stem,stigma,style,surface,tapering,tear-drop,thick,trichome,tube,uniseriate,vein,way,white,x,yellowish	.25,0.5-2.1,1,1.5-2,1.5-2.5,1.5-4.5,3-5-flowered,4-4.5,7-10,abaxially,absent,adaxially,along,anthesi,ape,apiculae,bae,broadly,conical,crystalline,denser,dia,differing,difoliate,eaf,edicel,eed,epidermi,erect,filament,free,geminat,glabrat,large-celled,lateral,lobe,lon,lower,main,major,minor,minute,minutely,nflorescence,often,older,opposite,overlappin,packed,pair,papillo,papillose,planar,pore,poricidal,portion,quadrate,ruit,scar,tall,tip,tub,tuft,ud,unit,waxy,woody,ympodial,young	abaxial,bud,characteristic,colour,diameter,exertion,form,fruit,height,length,lobing,na,number,peduncle,per,plant,seed,shape,texture,type
493	wfo-0001031832	success	232	121	103	129	18	0.444	0.1-0.3,0.2-1.5,0.3-3,0.7-2,0.8-1.2,1-12,1.2-1.6,14,2-6,3-6.5,3-7,4-20,9,abaxially,acuminate,acute,adaxially,anther,anthesi,apart,apex,articulated,attenuate,base,becoming,berry,blunt-tipped,branch,branched,brown,brownish,bud,bullate,calyx,closely,cm,conical,continued,corolla,dark,deltoid,diameter,due,entire,exserted,ferrugineous,filament,fleshy,flower,fruit,glabrescent,globose,granular-tomentose,green,greenish,growth,honeycombed,lanceolate,lateral,leaf,length,margin,mm,mostly,oblanceolate,oblong,obovoid,obtuse,orbicular,ovate,pale,pedicel,peduncle,persistent,petiole,pitted,probably,reniform,reticulate-punctate,ripe,rough,scabrous,shrub,simple,somewhat,soon,spaced,stem,stigma,style,suborbicular,surface,terete,terminal,time,tree,unarmed,violet,weakly,white,x,yellow,yellowish	-8,.5-1,/50-1/10,0-150,0.2-0.6,0.3-0.8,0.7-1.5,0.7-1.6,1.1-2.4,1.2-2,1.2-2.5,1.3-4.2,1.5-4,1.7-4,1.8-4,1/2-3/4,2-3.6,2-4,2.5-6.5,2.8-4.8,3.5-7,4-7,5-21,5.5-10,7-10,8-25,accrescent,ag,apical-lateral,apice,apparently,axe,axillary,ba,bark,basal,blade,blister,capitat,chartaceous,connate,decurrent,dehiscing,directed,eaf,eed,evident,extend,few-rayed,forming,free,fruiting,glabrescen,glabrous,hair,half,high,indument,inserted,introrse,lackin,large,line,lobe,lobed,long,long-,longer,longitudinal,lower,m.,main,midvein,minute,mixed,multangulate,nearly,nflorescence,occasionally,older,orolla,partly,perfect,plurifoliate,pore,porrect-stellat,porrect-stellate,pubescence,pubescent,rachi,rather,ray,relatively,rotate-stellate,ruit,runk,sessile,short-,short-stalked,side,slit,smooth,sometimes,sparingly,sparse,splitting,stamen,stellate-pubescent,stipitate-glandular,subcampanulate,suture,swelling,tamen,testa,thick,thick-stalked,toward,translucent,tube,unarme,unit,usually,vary,vein,way,whitish,wide,ympodial,young	arrangement,capitate,characteristic,colour,exertion,form,glabrousnes,height,inflorescence,lobing,new,ovary,plant,seed,shape,size,texture,type
494	wfo-0001031834	success	150	113	64	86	49	0.427	0.5,0.5-3,0.5-3.5,0.6-1.4,0.8-1,0.8-1.3,1.5,1.6-2,1.9-6.5,2/3,6-7,6.5-14,acuminate,acute,anther,apex,base,berry,calyx,cm,corolla,decurrent,deltoid,dia,filament,flattened-reniform,fruit,fruiting,globose,green,greenish-yellow,leaf,less,lobe,margin,minutely,mm,ovary,ovate,pale,papillose,pedicel,petiole,pitted,pubescent,scabrous,shaped,shrub,simple,slender,sparsely,stem,stigma,style,surface,tan,tapering,tear-drop,tube,vein,way,white,x,yellow	.5,0.5-1,0.9-1.4,1,1.5-4,2.9-7,accrescent,across,anthesi,apar,apically,apiculate,appear,attenuate,bi-cellular,borne,campanulate,covered,deciduou,deciduous,deflexed,depression,difoliate,eaf,edicel,eed,expanded,eye,few-flowered,free,geminat,glabrou,glabrous,hook,hooked,incrassate,lamina,larger,leaving,like,lobed,lon,long,lower,major,markedly,middle,minor,minute,mound-like,multicellular,naked,nflorescence,often,opposite,papillo,persistent,planar,pore,poricidal,portion,proximal,ruit,scar,short,slightly,small,soon,spaced,speck,straight,tall,tip,trichome,tufted,ud,unevenly,uni-,uniseriate,unit,upper,usually,widest,woody,ympodial,young	2,alternate,appearance,arrangement,bark,border,branch,bud,characteristic,colour,corrugation,diameter,distal,drying,exertion,form,giving,glabrousnes,growth,height,history,inflorescence,interjected,lateral,leaflet,length,life,lobing,midpoint,na,new,number,peduncle,per,perennial,plant,prickle,primary,pseudostipule,ray,seed,shape,size,terminal,texture,thicknes,type,variation,width
495	wfo-0001031842	success	161	132	108	53	24	0.671	.4,.5,.75,0.1-0.5,0.6-1,0.7-1,1-1.8,1-3.5,1.5-2,10-20,10-30-flowered,2-10,2-3,3-8,3/4,4.5-6,7-9,acute,anther,anthesi,apex,attenuate,axil,bark,base,bearing,beneath,berry,bi-lobed,brown,calyx,capitate,cm,corolla,dark,decurrent,deeply,dia,difoliate,dry,ellipsoid,elliptic,exsertion,filament,flattened-reniform,fruiting,glabrous,globose,green,later,lateral,leaf,leaf-opposed,lobe,lobed,long,main,margin,minor,minutely,mm,near,new,often,onto,opposite,ovary,overtopping,pale,papillose,pedicel,petiole,pitted,pore,poricidal,reddish-resinous,reflexed,shaped,shiny,shoot,shrub,simple,size,slender,somewhat,soon,specimen,stem,stigma,strongly,style,surface,tapering,tear-drop,terminal,time,tip,tree,trichome,tube,tuft,uniseriate,unit,vein,way,white,x,young	.1,0.5-1,0.5-2,1,1-1.5,10-12,2.5-3,2.5-6,9-15,apart,ba,beginning,cup-shaped,cusp,deflexed,densely,differing,eaf,edicel,eed,exserte,free,geminat,incrassate,inflorescenc,irregularly,lon,lower,major,middle,nflorescence,older,one,pair,paler,papillo,portion,prominent,pubescent,quadrate,reddish,ruit,scar,spaced,sparsely,straight,tall,ud,widest,woody,yellowish,yellowish-whit,ympodial	arrangement,bud,characteristic,colour,diameter,exertion,exserted,form,fruit,geminate,growth,height,history,inflorescence,length,life,lobing,plant,seed,shape,sympodial,texture,type,yellowish-white
496	wfo-0001031843	success	245	143	125	120	18	0.51	.5,0.6-1.2,0.7-2,0.8-2,1-7,1.2-2,1.2-2.2,1.5,1.8-2.5,2-3,2.5,3-4,3-7,4-12,45-60Â°,5-10,5-12,6-9,abaxially,adaxially,almost,along,anther,apex,apically,appressed,bark,basal,base,berry,black,branch,branched,branching,brown,calyx,canaliculate,capitate,cm,completely,conical,corolla,cupular,curved,dark,deeply,density,diameter,dilated,discoid,distributed,drying,dull,erect,evenly,fine,finely,flat,flower,forming,fruiting,glabrous,green,honeycomb,leaf,length,liana,like,long,loop,main,margin,midvein,mm,network,oblong,obovate,orange,orange-brown,orange-yellow,pair,part,partly,pattern,pedicel,peduncle,petiole,pitted,primary,prominent,pubescent,raised,rarely,red,reddish,scar,seed,shiny,shrub,side,slender,sometimes,sparsely,spheroidal,spreading,stem,stigma,straight,stump,style,surface,terminal,tertiary,thick-chartaceous,trichome,twice,unarmed,variable,vein,venation,violet,visible,white,x,young	.2,.3,.6,0-4,0.2-2,0.4-0.5,0.5-1,0.5-1.5,0.7-1.2,1-2,1.5-2,1/6-1/4,1mm,2-4,accrescent,acuminate,age,always,alyx,anthesi,apar,apice,apparently,around,articulated,attenuate,becoming,broadly,caudate,clearly,collapsing,cuspidate,delineated,deltoid,dendritic,detaching,discolorous,domatia,eaf,eed,ellipsoi,entire,equal,even,eye,fertilisation,filament,flexuous,free,hand,inner,largely,leave,len,lengthening,lignified,lobe,lobed,longitudinally,looping,lower,m.,much,multiseriate,naked,never,nflorescence,nther,oblique,obscure,older,opening,orolla,outline,ovate,papillo,pendulous,perfec,pericarp,pit,plurifoliat,pore,poricidal,portion,present,pronounced,protruding,rachi,recurve,reveal,ribbed,ridged,rounded,ruit,see,shallowly,shortly,simple,sinus,slightly,small,smaller,smooth,soon,strongly,surfac,tearing,thickened,thin,tip,tube,tuft,ud,unit,vary,weakly,wide,wider,without,ympodial	apart,arrangement,bud,characteristic,colour,ellipsoid,form,fruit,growth,inflorescence,lobing,ovary,papillose,prominence,shape,size,texture,type
497	wfo-0001031852	success	155	118	70	85	48	0.452	0.1-1,0.5-1.3,0.5-3,1-4,1-4.2,1-9,1.3-2.5,1.4-3,12-35,2-5.5,2.6-9.5,3.5-10,4-10,4-6,5-15,7-,9-11,acuminate,acute,apex,base,branched,calyx,cm,conical,corolla,cyme,decurrent,diameter,dichasial,dichasially,distal,ebracteate,elliptic,elliptic-lanceolate,filament,green,green-white,herbaceous,interjected,lanceolate,lateral,leaf,leaflet,light,lobe,long,mm,monochasial,mucilaginous,oblique,oblong,odd-pinnate,ovate-elliptic,ovoid,pedicel,peduncle,perennial,petiole,plant,pubescent,seed,sessile,size,stigma,style,terminal,throughout,white,wide	-8,1-,1.5-3,2-3,3-4,3-6-foliat,3-9,4-,4-5,abaxially,abruptly,absen,acumen,adaxially,apical,apically,apiculate,articulate,attenuate,cell,connate,covering,dehiscent,digestion,diminishing,dorsally,eaf,edge,eed,emoval,enzyme,exceeding,flat,flower,folded,forked,generally,globo,hair-like,half,honeycomb,introrse,living,lon,lower,lunat,make,maturing,nflorescence,nther,often,orolla,pair,pattern,perfect,plan,poricidally,proximal,rachi,reveal,ruit,seudostipule,short,shortly,slit,specimen,stamen,stellate,straight,tal,tem,testal,thick,throughou,toward,tuber-bearing,typically,unit,vary,wall,white-crea,without,yellow,ympodial,Â¼	absent,anther,appearance,arrangement,bark,border,branch,bud,characteristic,colour,corrugation,drying,exertion,form,fruit,fruiting,giving,glabrousnes,globose,growth,height,history,inflorescence,length,life,lobing,margin,midpoint,na,new,number,ovary,per,prickle,primary,pseudostipule,ray,shape,stem,surface,texture,thicknes,tube,type,variation,vein,white-cream,width
498	wfo-0001031864	success	140	137	91	49	46	0.65	.2,.25,.5,0.2-0.5,0.5-13.5,0.7-0.8,0.8-1,1-1.2,1-1.8,1-2,1-5,1-6.5,1.2-1.5,1.5,1.5-2.5,15-60,2-3,2.5-6,3-3.5,3-pinnate,acuminate,acute,adaxially,anther,apex,apiculate,base,berry,calyx,chartaceous,ciliate,clavate,cm,cuneate,deltoid,dense,diameter,entire,extra-axillary,filament,fine,flattened,fleshy,flower,fruit,fruiting,glabrous,hair,herbaceous,lateral,leaflet,lenticular,lobe,long,margin,middle,minutely,mm,oblique,ovoid-deltoid,papillose,pedicel,peduncle,petiole,pointed,pubescence,pubescent,rotate,rounded,sand-punctate,scattered,short,slender,slightly,sparsely,stem,stigma,style,surface,tip,trichome,truncate,tube,unbranched,unknown,vein,vine,violet,wide-diameter,widely,x	0.4-3,0.5-4,0.6-3.5,0.6-4,1-3,1.5-10,2,5-15,5-9,5-merous,7.5-8,abaxially,accrescent,alyx,apar,apical,axe,blade,c.,capitat,color,densely,eaf,eed,emarginate,glabrou,like,lon,lower,m.,moderately,near,nflorescence,nternode,orolla,perfec,petiolule,plurifoliat,pubescenc,rachi,ruit,spaced,tamen,tem,terrestria,typical,unit,vary,ympodial	appearance,arrangement,bark,border,branch,bud,capitate,characteristic,colour,corolla,corrugation,distal,drying,exertion,form,giving,glabrousnes,growth,height,history,inflorescence,interjected,leaf,length,life,lobing,midpoint,na,new,number,ovary,per,plant,prickle,primary,pseudostipule,ray,seed,shape,size,terminal,texture,thicknes,type,variation,width
499	wfo-0001031864	success	148	101	81	67	20	0.547	.25,.5,0.5-13.5,1-1.2,1-2,1-5,1-6.5,1.5,15-60,2-3,3-3.5,3-5-celled,3-pinnate,5-15,5-9,7.5-8,abaxially,absent,acuminate,acute,adaxially,anther,apart,articulated,basally,base,blue-purple,calyx,center,ciliate,clavate,cm,connivent,cordate,deltoid,dense,densely,diameter,entire,extra-axillary,filament,fine,fleshy,flower,fruit,glabrous,hair,herb,interjected,leaflet,lenticular,long,margin,mm,oblong,papillose,pedicel,peduncle,pubescence,pubescent,scattered,short,simple,slender,somewhat,spaced,sparsely,stigma,style,terrestrial,thick,tip,tube,unbranched,uniseriate,weakly,widely,wiry,woody,x,yellow	.2,0.4-3,0.5-4,0.6-3.5,0.6-4,1-1.8,1-3,1.2-1.5,1.5-2.5,2,2.5-6,5-merou,accrescent,ag,alyx,apex,apical,apiculate,apparently,axe,ba,blade,capitat,color,cuneate,directed,distally,eaf,eed,emarginate,equal,etiole,fruiting,geminat,large,lateral,lobe,longitudinal,lower,m.,minutely,near,nflorescence,node,oblique,opening,orolla,perfect,petiolule,plurifoliate,pore,pubescenc,rachi,rooting,rotate,rounded,slightly,slit,surface,tamen,tem,trailing,truncate,unit,unknown,vary,ympodial	arrangement,capitate,characteristic,colour,corolla,form,growth,history,inflorescence,leaf,length,life,lobing,ovary,petiole,seed,shape,size,stem,texture
500	wfo-0001031871	invalid_json	185	128	95	90	33	0.514	0.4-2,0.6-1.2,1-2,1.4-2.1,1.5-11,1.5-2,1.5-2.1,1.6-2.7,2-3,2-4,2.9-6,3-10,3.5-4,33-40,36-44,4-6,4-7,5.4-12.3,6-12,6-7,6.5-20.5,7-9,7.5-23,anther,berry,blade,brownish,cell,chartaceous,clavate,cm,condition,corolla,covering,dark,deep,diameter,dot,drying,end,filament,flower,fresh,fruit,glabrous,globose,green,green-white,greenish,hair,hair-like,herb,homostylous,interjected,lateral,leaflet,lobe,long,make,medium,mm,mottled,mucilaginous,narrowly,odd-pinnate,one,ovoid,pedicel,peduncle,petiole,placed,plant,purple,ripe,seed,short,size,stigma,style,subglabrous,terminal,testal,thick,throughout,tiny,tube,tuber,typically,wall,wet,white,whitish,wide,winged,x	14-22,3-4,3-5,5-merou,abaxially,acumen,acute,adaxiall,adaxially,ag,alyx,apart,apex,apparently,articulated,asymmetric,attenuate,axe,axillary,base,basiscopic,bud,capitat,connivent,digestion,distal,dorsally,eaf,edge,eed,elliptic,enzyme,erec,exceeding,flat,folded,forked,geminat,generally,glabrou,hal,half,high,honeycomb-shaped,lanceolate,lengthening,linear,living,lower,nflorescence,orbicular,orolla,ovate,pair,perfect,petiolulate,plurifoliate,pore,poricidal,pubescent,removed,rotate,round,rounded,ruit,sessile,seudostipule,side,slit,sometimes,spaced,specimen,stamen,stolo,straight,subequal,subglabrou,subtending,symmetric,tall,tamen,tem,tip,tissue,tri-,unit,usually,vary,yellow,ympodial	'',5-merous,[,``,abaxial,adaxial,arrangement,calyx,capitate,characteristic,colour,erect,form,growth,height,history,inflorescence,leaf,length,life,ovary,placement,pseudostipule,shape,staman,stem,stolon,surface,texture,type,value,{,}
501	wfo-0001031876	success	140	93	62	78	31	0.443	.1,.5,0.5,0.8-1,1-1.6,1.5-2.2,27-35,9-15,acute,anther,apex,arc,bark,base,berry,bright,calyx,cm,corolla,cup-like,decurrent,dia,elliptic,filament,fruiting,glabrous,globose,green,leaf,less,lightly,long,long-acuminate,margin,mm,nearly,oblanceolate,oblique,ovary,papillose,pedicel,petiole,primary,recurved,reflexed,shaped,shrub,simple,slender,slightly,stem,stigma,straight,style,tapering,tear-drop,tube,vein,white,winged,x,yellow	0-flowered,1,1-1.5,1-4,3,5,?,across,anthesi,apiculate,arising,ba,bearing,beneath,closely,convergence,corky,differing,eaf,edicel,eed,erect,family,flower,free,glabrou,granular,greenish-yellow,immature,irregularity,known,lateral,lenticellat,lobe,lobed,lower,main,major,melastomataceae,member,middle,minute,minutely,nflorescence,often,opposite,otherwise,overlappin,pair,parallel,perpendicular,persistent,point,pore,poricidal,portion,present,prominent,raised,resemble,ruit,running,scar,secondary,spaced,styl,tall,time,tip,ud,unifoliat,unit,venation,wide,widest,woody,ympodial,young	arrangement,bud,characteristic,colour,diameter,drying,exertion,form,fruit,glabrousnes,growth,height,history,inflorescence,length,life,lobing,na,new,number,peduncle,per,plant,seed,shape,size,surface,texture,type,unifoliate,ye
502	wfo-0001031877	success	216	122	99	117	23	0.458	0.3-1,0.3-1.2,0.6-1.2,1-1.5,1-3,1.5,1.5-1.9,2,2.5,6-8,abruptly,acuminate,acute,adaxially,angled,anther,anthesi,apex,basal,basally,base,berry,bright,brown,calyx,capitate,clavate,cm,conical,connivent,corolla,deltate,densely,diameter,ellipsoid,ellipsoidal,entire,exserted,filament,flattened,fruit,fruiting,glabrous,globose,growth,hastate,later,lateral,line,lobe,lobed,long-acuminate,loosely,margin,minute,minutely,mm,nearly,new,often,outline,pedicel,peduncle,per,petiole,pitted,plant,plump,pubescent,purple,red,reddish,reniform,ripe,scrambler,seed,simple,slender,slightly,somewhat,sparsely,stellate,stem,stigma,strongly,style,surface,terminal,tinged,tip,triangular,trichome,truncate,tube,uniseriate,usually,vine,white,x	+,.3,.5,0.2,0.3-,0.5,0.5-1,0.8-0.9,1,1-3.5,1-4,1.1-,1.5-2,1.8-5,2-,3-5,3-6,3.5-4,5-merou,6-10,abaxially,adaxiall,ag,along,alyx,apar,apparently,ark,articulated,ascending,cell,deep,deflexed,distal,dried,eaf,eed,enlarged,erect,especially,exposed,eye,fleshy,flower,free,furcate,green,greenish,ilament,impressed,internal,irregularly,lamina,lengthening,like,linear,long,lower,material,mature,midvein,nflorescence,occasionally,older,orolla,pair,pale,papillate,papillo,parallel,part,perfect,pericarp,plurifoliat,pointing,pore,poricidal,portion,primary,prominently,pubescence,purplish,rectangular,reflexed,rest,rounded,ruit,scar,semi-woody,shiny,short,shorte,silky,sinuate,sleeve,slit,sometimes,spaced,spreadin,subshru,tem,testal,thin,twinin,ud,uniformly,unit,upper,vary,vein,visible,wall,weak,woody,yello,ympodial,young	2-6-10,arrangement,bud,characteristic,colour,exertion,form,glabrousnes,height,history,inflorescence,leaf,length,life,lobing,number,ovary,perennial,shape,size,sparingly,texture,type
503	wfo-0001031880	success	180	120	97	83	23	0.539	0.5-2,0.7-0.8,1,1-1.3,1-1.5,1.5,2-3,2-9,2.5-8,3-3.5,3-foliate,3-lobed,4,4-8,6-9,acuminate,acute,anther,anthesi,apex,base,berry,broadly,brown,calyx,capitate,ciliate,cm,conical,cordate,corolla,crenate,cup-shaped,curved,dark,densely,diameter,ellipsoid,elliptic,enlarged,entire,erect,exerted,filament,flattened,flower,fruit,fruiting,glandular,globose,green,herb,heteromorphic,hollow,inflorescence,internodal,irregularly,leaf,less,long,margin,minutely,mm,nodding,orange,ovary,ovate,ovoid,pale,papillose,pedicel,peduncle,petiole,pitted,pubescent,purple,red,reddish,reflexed,shallowly,simple,slender,slightly,spreading,stem,stigma,strongly,style,subshrub,surface,toothed,triangular,truncate,tube,upward,x,â5	.5,0.5-1,1-2,2,2-4,3-4-pluri-foliate,5,5-6,7-9,abaxially,adaxially,age,apart,basal,bearing,becoming,c.,cell,color,crowded,eaf,edicel,eed,fleshy,flush,free,glabrous,gland,gland-tipped,growing,horn,lamina,lengthening,lobe,lon,longest,lower,markedly,mature,maturit,mid-length,middle,narrowly,near,nflorescence,pair,papillo,pericarp,plan,pore,poricidal,portion,primary,pubescen,rachi,ruit,scar,shortest,single,slit,sometimes,spaced,sparse,sparsely,straight,terminal,testal,thin,tip,trichome,ud,unicellula,uniseriate,unit,unlobed,upper,vein,wall,widely,widest,woody,yellow,ympodial	appearance,arrangement,bud,characteristic,colour,exertion,form,giving,glabrousnes,growth,height,history,length,life,lobing,maturity,new,plant,seed,shape,size,texture,type
504	wfo-0001031881	invalid_json	168	115	87	81	28	0.518	.5,0.2,0.5-0.7,1-1.3,1-1.5,1-7,1.2-6,1.5-2.5,1/3,2,3/4,5-6,absent,anther,base,beneath,branch,branched,broadly,brown,bud,calyx,campanulate,capitate,cm,corolla,dark,decurrent,deflexed,densely,dia,distal,dry,ellipsoid,elliptic,erect,exserted,filament,fruit,fruiting,glabrous,globose,golden,golden-pubescent,green,inflorescence,leaf,lightly,lobed,long,material,minute,minutely,mm,obovate,opposite,ovary,ovoid-reniform,papillose,pedicel,petiole,pitted,pore,poricidal,puberulent,pubescent,shape,shaped,shrub,size,small,soon,sparsely,stem,stigma,style,surface,tear-drop,tip,tree,tube,usually,way,white,winged,x,young	0.1-0.5,0.2-0.6,0.4-1,0.5-1,10-12,10-30,2-9,3-19,3.5-4,7-14,acute,along,anthesi,apar,apex,apparent,attenuate,axil,ba,bark,constriction,deltoid,differing,difoliate,drying,eaf,edicel,eed,either,evenly,fleshy,free,geminat,golden-puberulent,greyish-brow,incrassate,inflorescenc,junction,lateral,like,lobe,lon,lower,main,major,margin,maturity,middle,midrib,minor,nflorescence,occasionally,older,one,orbicular,pair,papillo,planar,portion,puberulen,rest,rounded,ruit,scar,simple,slender,slightly,somewhat,spaced,straight,strong,tall,tapering,trichome,ud,uniseriate,unit,vein,widest,woody,ympodial	'',[,],``,abaxial,adaxial,alternate,arrangement,characteristic,colour,diameter,exertion,form,growth,hair,height,history,length,life,lobing,perennial,plant,seed,texture,type,value,{,}
505	wfo-0001031886	success	169	103	80	89	23	0.473	-25,-9,.5,0.1,1-1.5,1-4,1.2-2.5,1.5-2,2-4,2-5,2.0-2.5,3-6,3.0,4-15,5-6,5-ridged,6-20,9-10,absent,acuminate,anther,apex,attenuate,basal,base,berry,bright,brown,bud,calyx,capitate,cm,completely,conical,corolla,diameter,elliptic,equal,filament,fleshy,fruit,fruiting,glabrous,green,greenish,lanceolate,lateral,leaflet,long,minutely,mm,nearly,occasionally,ovary,ovoid-reniform,papillae,pedicel,per,petiole,petiolule,pinnate,poricidal,reddish,rugose,seed,shape,shrub,simple,smaller,somewhat,sparse,stigma,strongly,style,surface,terminal,tip,tube,white,x	-1.2,-4,0,0.5-1,10-40,2,2-2.5,2-3,20-30,4,5-10,6-8,abaxially,abruptly,adaxially,along,anthesi,anticlinal,arising,axil,axillary,beak,bearing,broadly,cell,clavat,commonly,deltate,distinctly,dry,eaf,earl,edicel,eed,either,em,epidermal,erec,exserted,flower,free,half,irregular,le,lobe,lobed,lower,margin,narrowed,near,nflorescence,noddin,node,oblique,open-conical,pair,papillate,papillose,portion,primary,projection,purple,rachi,raised,reflexed,ripe,ruit,scar,scattered,similar,single,sinuous,smelling,specimen,thickening,time,triangular,trichome,tub,ud,unifoliat,uniseriate,unit,usually,vein,wintergreen,without,woody,ympodial	1,1-1.2,40,arrangement,clavate,colour,form,growth,height,history,inflorescence,leaf,length,life,lobing,na,nodding,number,plant,size,stem,texture,type
506	wfo-0001031895	success	160	130	107	53	23	0.669	-1.5,0.5,1-1.5,1.5-2,1.5-3,1.5-6,2-2.5,2.5-3,3-10,3-4,3-8,3.5-6,4,4-5,4.5-16.5,5,5-6,6-9,acute,anther,anthesi,apex,attenuate,bark,base,beneath,berry,bluish,broadly,calyx,capitate,cm,completely,conical,corolla,cup-shaped,dark,deltate,diameter,drying,ellipsoid,elliptic,entire,erect,exerted,exfoliating,filament,fleshy,flower,fruiting,glabrous,globose,green,growth,immature,irregular,leaf-opposed,leafy,less,lobe,margin,matte,minutely,mm,new,occasionally,older,once-branched,ovary,overlapping,ovoid,pair,pale,papillate,patch,pedicel,peduncle,peeling,petiole,pitted,poricidal,primary,reddish,reniform,revolute,shiny,shoot,short,shrub,simple,slightly,stem,stigma,stout,strongly,style,surface,tan,terminal,tip,tube,vein,violet,way,white,x,Â¼-1/2	0.5-1,0.5-2,5-8,6-7,age,apparently,articulating,blac,campanulate,cell,densely,eaf,eed,emarginated,enlarging,erec,expand,fragrant,free,glabrou,inflorescenc,intensely,leaving,lengthening,lobed,lower,nflorescence,papillat,part,peg,perfect,pericarp,planar,plurifoliat,pore,portion,ruit,scar,sinuate,slender,slit,small,somewhat,straight,testal,thick,thin,tree,tub,ud,unit,woody,ympodial	arrangement,black,bud,characteristic,colour,exertion,form,fruit,glabrousnes,height,history,inflorescence,leaf,length,life,lobing,na,plant,seed,shape,size,texture,type
507	wfo-0001031897	success	264	114	94	170	20	0.356	.1,.8,0.1-0.5,0.15,0.6,1.1,1.3-2,1.7-3,2-4,6-9,acute,almost,along,anther,apex,apically,bark,base,berry,black,brachyblast,branch,branched,brown,calyx,chartaceous,clavate,clustered,cm,conical,coriaceous,corolla,curved,dendritic,densely,diameter,distributed,dull,elliptic,epiphyte,erect,evenly,eye,fruit,fruiting,glabrous,green,grey,hair,lanceolate,larger,lateral,leaf,light,long,main,mauve,mm,multicellular,naked,never,obconical,oblong,occasionally,ovoid,pedicel,petiole,plant,pointed,pubescent,reddish,ribbed,short,shrub,simple,slender,slightly,sparse,sparsely,stem,stigma,style,surface,terete,terminal,thick,trichome,unarmed,visible,weakly,white,winged,x,young	.5,0-1,0.2-0.4,0.4-1.1,0.5-1,0.5-3,0.8-1.5,0Â°,1,1-1.5,1-2,1-2.5,1.5,1.5-8,13,2/3,4-5,462.,5-6,8,abaxial,abaxially,absent,accrescent,adaxial,adaxially,age,alyx,anthesi,apar,apparently,appearing,appendage,arising,aristate,articulated,attenuate,axillary,bendy,boiteau,cell,clearly,concolorous,condensed,connate,covering,cuneate,dark,datum,dehiscing,delineated,dense,developed,developing,development,dilated,divided,domatia,dorsal,dorsifixed,dry,drying,eaf,earliest,ed,enlarged,entire,equal,even,except,extending,faint,filament,filiform,fine,flower,foliaceous,free,immature,indistinc,inner,inside,known,lamina,least,lengthening,like,linear,lobe,lobed,longitudinal,longitudinally,looped,lower,m.,margi,margin,membranous,midvein,minute,minutely,multiseriate,nflorescence,nther,oblon,obtuse,occasional,one,orange,orange-brown,orolla,outside,ovate,overlapping,pair,papillose,part,partly,peduncle,pendulous,perfec,pericarp,persisting,plurifoliat,pore,poricidal,portion,primary,prominent,pronounced,protruding,raised,rarely,reach,revolute,ridge,ridged,ruit,scar,secondary,see,seen,shoot,side,sinus,smaller,smoot,smooth,sometimes,stump,subulate,sunk,tearing,tertiary,thin,tip,toward,tube,ud,unbranched,unicellular,unit,usually,vary,vein,venation,well-developed,wide,wrinkle,ympodial	arrangement,characteristic,colour,form,growth,history,inflorescence,length,life,lobing,na,number,ovary,per,perennial,seed,shape,size,texture,type
508	wfo-0001032157	success	136	106	83	53	23	0.61	.5,.75,0.25,0.6-1,1-3,1.9-2.2,2.2,3-6,5-15-flowered,5-9,7-9,9-17,acute,anther,apex,bark,base,becoming,beneath,berry,bi-lobed,calyx,cm,completely,corolla,crystalline,decurrent,deflexed,dia,dry,elliptic,exserted,filament,fruiting,glabrous,globose,golden,green,lateral,leaf,less,live,lobed,long,longitudinal,main,minutely,mm,nearly,ovary,ovoid-reniform,pair,paler,papillose,pedicel,peeling,petiole,pitted,plant,pore,poricidal,reddish,rounded,shaped,shiny,shrub,simple,size,slender,soon,stem,stigma,strip,style,surface,tapering,tear-drop,tip,tube,vein,white,x,yellowish	0.5-1,0.75-1,2-3,2-5,5-8,anthesi,apart,beginning,caly,deltoid,differing,difoliate,eaf,edicel,eed,evenly,free,frui,geminat,glabrou,incrassate,inflorescenc,living,lobe,lon,lower,major,margin,middle,minor,nflorescence,obscure,older,one,opposite,papillo,persistent,portion,raised,reflexed,ruit,scar,slightly,spaced,straight,tall,translucen,ud,unit,widest,woody,ympodial,young	arrangement,bud,characteristic,colour,diameter,exertion,form,fruit,growth,height,history,inflorescence,length,life,lobing,na,number,per,primary,seed,shape,texture,type
509	wfo-0001032161	success	146	90	69	77	21	0.473	0.4-1.2,0.7-4,0.8-1,1-1.5,1-11,1-3,1.2-1.3,1.4-2,2-7,2.5-3,3.5-4,?,adaxially,anther,area,bark,base,berry,calyx,cm,conical,corolla,dark,delicate,densely,dia,drying,ellipsoid,elliptic,filiform,fruiting,glabrous,globose,green,inflorescence,internodal,later,leaf,lobed,margin,merely,minutely,mm,mustard,nearly,obovate,opposite,ovary,ovoid-reniform,papillose,pedicel,petiole,pitted,plant,pubescent,revolute,shaped,shrub,sparsely,stem,stigma,style,sulcate,surface,tear-drop,thin,white,x,yellow	.5,0.5-1,0.75-1,2-8-flowered,abaxially,acute,adaxiall,anthesi,apex,apical,ba,beneath,branched,brownish-blac,closely,color,coriaceous,deflexed,deltate,dendritic,difoliate,eaf,edicel,eed,exserted,filament,free,giving,golden,hanging,lamina,like,lobe,long,lower,many,middle,minute,nflorescence,occasionally,older,overlappin,pale,pericarp,persistent,plurifoliate,pore,poricidal,portion,projection,quadrate,reflexed,rest,ruit,scar,shiny,shoot,short,simple,spaced,strongly,styl,tall,tan,tip,trichome,tub,tube,ud,uniseriate,unit,usually,vein,widest,yellowish,ympodial,young	abaxial,adaxial,brownish-black,bud,characteristic,colour,diameter,form,fruit,growth,height,history,length,life,lobing,perennial,seed,shape,size,texture,type
510	wfo-0001032165	success	197	81	63	134	18	0.32	1-1.2,1-1.5,1-2,10-25,2-2.5,3-6,5-15,5-6,5-7,8-9,anther,bark,berry,brown,bud,capitate,center,cm,corolla,dark,densely,dia,dry,ellipsoid,elliptic,exserted,fruiting,glabrous,globose,golden-puberulent,golden-pubescent,green,greyish-brown,inflorescence,later,leaf,minutely,mm,obovate,occasionally,once-furcate,ovary,ovoid-reniform,pedicel,petiole,plant,purplish,ripe,shape,simple,size,specimen,stem,stigma,strongly,style,surface,tear-drop,tinged,tree,white,x,young	.25,.5,0.1,0.1-0.3,0.25-0.5,0.3-1,0.75-1,1.5-4,2.5-3.5,3-4,3.5-8.5,4-6,5-30-flowered,5-9.5,abaxial,acute,adaxial,along,anthesi,apex,apparent,appearing,ba,base,beginning,beneath,broadly,calyx,closely,continued,cucullate,cup-shaped,deciduous,decurrent,deltoid,denser,differing,difoliate,distal,due,dull,eaf,edged,edicel,eed,end,entire,erect,even,expansion,exsertion,filament,free,geminat,golden,immature,inflorescenc,lateral,less,like,live,lobe,lobed,lon,long,lower,main,major,margin,markedly,medial,middle,midrib,minor,minute,near,nearly,nflorescence,node,older,one,onto,opposite,orbicular,overlapping,pair,pale,paler,papillo,papillose,pitted,planar,pore,poricidal,portion,presence,prominent,puberulent,rather,rest,ridge,rounded,ruit,scar,shaepd,single,slender,slightly,slow,small,smoot,spaced,stout,straight,stripe,swollen,tall,tapering,terminal,thickened,time,tip,trichome,tub,tube,ud,uniseriate,unit,vein,widest,winged,woody,yellowish,ympodial	alternate,arrangement,characteristic,colour,diameter,exertion,form,fruit,growth,height,history,length,life,perennial,seed,shaped,texture,type
511	wfo-0001032167	success	163	85	65	98	20	0.399	.5,0.5-1,0.5-2.5,1,1-2.5,1-5,1.5,10-20,10-35,12-20,2-foliate,3-6,5-15,7-10,absent,acute,anther,apex,berry,brown,calyx,chartaceous,ciliate,cm,dense,densely,diameter,drying,elliptic,elliptic-ovoid,entire,flower,fruit,glabrous,globose,growth,herb,immature,linear-lanceolate,margin,maturing,membranaceous,mm,moderately,nearly,new,oblong,pedicel,peduncle,per,petiole,pubescent,purple,rotate,seed,semitransparent,sparsely,staman,stigma,style,surface,twisted,white,x,yellow	0.5-1.5,0.75-3,1-2,1-2-celled,1-3,1-7,2-4,2-7,3-7,4-10,4-6,abaxially,abundant,adaxiall,adaxially,along,appressed,axe,base,blade,cell,closely,common,connected,cordate,curved,decurrent,dehiscing,denser,dm,eaf,eed,emarginat,explosively,few-,filament,flat,flattened,forming,frui,geminat,geniculate,growt,hair,held,interpetalar,larger,lobe,long,longer,lower,lowermost,lying,many-branched,maturit,mesocarp,near,netlike,nfloresence,notch,obtuse,often,older,one-celled,orolla,placenta,pressure,projection,pubescen,rachi,raised,rounded,ruit,shorter,slightly,small,smaller,sometimes,stamen,straight,tal,tamen,tem,tissue,triangular,tube,two-celled,unbranched,unit,upper,usually,vary,vein,wall,watery,wid,woody,ympodial	abaxial,adaxial,arrangement,characteristic,colour,corolla,form,glabrousnes,inflorescence,leaf,length,number,ovary,shape,size,sparingly,stem,texture,type,wide
512	wfo-0001032176	success	177	136	113	64	23	0.638	.5,0,0.5-0.7,0.5-1,0.8-1,0.8-6,1-1.2,1-10,1.5-1.6,1.5-2.5,1/2,3-3.5,3-4,3-7,5-6-celled,6,6-10,7,adaxially,along,anther,apex,apical,basal,base,becoming,berry,branched,calyx,cell,cm,conical,copiously,corolla,creeping,densely,denser,diameter,drying,ellipsoid,elliptic,epidermal,equal,especially,exserted,filament,filiform,fruiting,glabrous,globose,green,greenish,grey-brown,greyish,herb,lateral,leaf,leaflet,lengthening,like,lobe,lobed,long,long-papillose,lower,minute,mm,nearly,nodding,node,obovate,occasionally,ovary,ovoid-reniform,pair,pale,pedicel,per,petiole,pinnate,pore,poricidal,projection,pubescent,quadrate,rachi,rest,rooting,rounded,seed,simple,sinuous,size,slit,smaller,soon,sparsely,stem,stigma,strait,strongly,style,terminal,thickening,tip,trichome,tube,uniseriate,vein,wall,white,without,x	0.42,0.5,0.5-0.75,1.5-6,100,2-3,2.5-10,3-15,adhering,anthesi,apart,arising,attaining,attenuate,axil,axillary,beak,capitat,cateniform,containing,cucullate,eaf,edicel,eed,fallen,flower,free,hangin,inflorescenc,lengt,log,margin,minutely,nflorescence,obtuse,often,onto,open,papillose,petiolule,portion,reflexed,ruit,scar,separate,single,slightly,somewhat,spaced,tem,tightly,time,tree,truncate,trunk,tub,ud,ultimate,unevenly,unifoliat,unit,whit,winged,ympodial	arrangement,branching,bud,capitate,cateniforme,colour,density,exsertion,form,fruit,growth,history,inflorescence,length,life,lobing,number,plant,pubescence,shape,surface,texture,type
513	wfo-0001032187	success	139	112	92	47	20	0.662	-11,-4,-4.2,-5,-9,0.1â1.4,0.5,0.5-,0.5â1,0.6â1.3,1.1â3.2,1.8â2,1.8â2.8,100,22,24.6â26.3,2â9,3.1â3.5,3â3.2,3â4,5-merous,5â7,7â11,9,acuminate,acute,angular,anther,apex,appressed,aromatic,base,berry,blade,brown,brownish,cm,consisting,corolla,cyme,dark,dull,eglandular,elliptic,entire,filament,flowered,forked,glabrescent,globose,green,hair,herb,leaf,light,long,margin,marked,mature,mm,numerous,obovate,occasionally,ovate,pedicel,peduncle,pentagonal,per,persistent,petiole,plant,pollen,purple,rarely,ridge,simple,small,soft,sparse,stage,stellate,stem,style,sub-glabrous,texture,tinged,tooth,truncate,well,yellowish,Â±,Âµm	-2.1,1.3â1.8,1.6â2.1,1â1.7,adherent,alyx,ape,branch,broadly,changing,di-foliate,dia,eaf,eed,equal,erect,fully,geminat,granule,hite,hooked,hydrated,lobe,lower,many,nflorescence,penden,perfec,petiolate,predominantly,presen,protruding,ruit,running,sclerotic,short,sometimes,spreading,straight,triangular,unit,widest,wing,yellow,ympodial,Â±1,Ã	arrangement,calyx,characteristic,colour,diameter,flower,form,fruit,growth,height,history,inflorescence,length,life,number,seed,shape,type,white,width
514	wfo-0001032206	invalid_json	216	183	112	104	71	0.519	-20,-5,.5,0,1/3,acute,anther,apart,apex,apically,apparently,approximately,armed,articulated,bark,base,berry,branched,calyx,chartaceous,cm,concolorous,connivent,cream,cuneate,dark,deltate,diameter,discolorous,distal,distance,drying,elliptic,erect,extending,filament,flattened,flattened-reniform,flower,foliaceous,fruit,fruiting,glabrescent,glabrous,green,green-brown,lateral,leaf,length,lobe,lobed,lobing,long,long-styled,margin,marking,maturity,mauve,midpoint,midvein,mm,moderately,obtuse,often,one,open,orange-brown,ovate,pair,pale,pedicel,peduncle,pendent,per,petiole,plant,poricidal,prickle,primary,purple,rarely,ray,secondary,short-styled,shrub,side,slender,sometimes,spaced,spherical,stellate,stellate-pubescent,stem,straight,style,surface,tapering,time,tip,toward,trichome,truncate,tube,unarmed,usually,vein,weakly,white,wide,yellow,yellow-orange,young	-0.8,-2,..,.2,0.2,0.2â0.4,0.2â0.5,0.5â1,0.8â1.2,00â200,0â20,0â30,0â5,1,1.1â1.2,1.2â2.2,1.5â2,1.5â2.5,1/4â1/2,1/4â1/3,1/6,10â80,11â22,1â2,1â2.3,1â3,1â4,2.5â3.3,2.7â3.5,2â2.5,2â3,2â8,3.5â9,30â80,3â4,4.5â5.8,4â6,5-merous,5â15,5â20,5â6,5â8,5â9,6â10,6â15,6â8,7â10,8â20,abaxially,accrescent,adaxially,alyx,andromonoecious,apar,blade,bluntly,broad-deltate,brow,clearly,covering,curved,eaf,eed,equal,free,functionally,gently,hermaphroditic,heterostylous,infructescence,lengt,longer,lowermost,mal,mature,nflorescence,older,orolla,ower,pendulous,pericarp,plurifoliat,porrect,portion,reflexed,scar,sessile,smooth,sparsely,spreading,stalk,stalked,stout,tamen,tertiary,uit,ung,unit,variously,vary,venation,visible,woody,ympodial	'',0-20,0-5,0.5-1.5,0.8-1.2,00-200,1-2,1-2.3,1-3,1-4,1.1-1.2,1.2-2.2,1.5-2.5,1/4-1/2,11-22,2-2.5,2-3,2.5-3.3,2.7-3.5,3-4,3.5-9,4-6,4.5-5.8,5-15,5-20,5-6,5-8,5-9,6-10,6-15,8-20,[,``,appearance,arrangement,border,branch,brown,bud,characteristic,colour,corolla,exertion,form,giving,glabrousnes,growth,height,history,inflorescence,interjected,leaflet,life,na,new,number,ovary,pseudostipule,seed,shape,size,stigma,terminal,texture,thicknes,type,value,variation,width,{,}
515	wfo-0001032209	success	257	125	101	156	24	0.393	.5,0.5-1,1-6,1.5,1.5-6,10-13,2,2-3,2-5,20-30,3-7,6-8,acute,anther,anthesi,apex,appearing,base,berry,bilobed,blue,branch,broadly,brown,calyx,capitate,cell,climbing,cm,colour,conical,cordate,corolla,dark,deeply,densely,diameter,early,ellipsoid,elliptic,entire,exerted,filament,flattened-reniform,fruiting,glabrous,globose,growth,hairy,hollow,inflorescence,lateral,leaf,length,lobed,margin,metallic,minute,minutely,mm,narrowly,nearly,new,occasionally,ovate,pair,pedicel,peduncle,per,petiole,pinnatifid,primary,puberulent,pubescent,purple,red,reddish,ripe,shiny,simple,sometimes,somewhat,spreading,stellate,stem,stigma,stout,style,surface,tapering,terminal,testa,truncate,tube,vein,vine,violet,wall,white,woody,x	-11,-20,-30+,0.3,0.5,1,1-1.5,1-2,1-2-celled,1.5-,1.5-2,1.5-2.5,100,12-16,2-3-lobed,2.5-,2/3,3-9,4,4-20,5-8,5-merou,6-15,absent,adaxial,ag,along,alyx,apart,apiculae,apparently,arching,ark,articulated,axi,basal,berr,branched,bu,canopy,cast,chartaceous,connivent,conspicuously,coriaceous,cucullat,deltate,dendritic,denser,distally,distinct,dried,eaf,ecuador,eed,enlarged,equal,erect,especially,evenly,finely,fleshy,flower,flowering,free,geminat,giving,glabrescen,groove,hanging,hastate,held,ilament,keeled,lamina,large,leathery,leaving,lengthening,less,like,lobe,long,longer,longest,lower,markedly,material,mean,mere,middle,midrib,midvein,mixture,near,nflorescence,nipple,often,older,one,orolla,papillae,papillat,papillate,part,particularly,peg,pentagonal,perfect,pericarp,pinnately,planar,plurifoliate,pointed,pore,poricidal,portion,probably,pubescence,rest,rhachi,rim,ruit,sagittate,scar,several,sleeve,slit,small,spaced,sparser,tem,testal,thin,third,tightly,time,tiny,tip,trichome,twinin,twining,ud,unequal,uniseriate,unit,upper,usually,variable,vary,w,weight,widest,within,yellow,ympodial	2.5-15-20,4-20-30+,arrangement,bark,bud,characteristic,drying,exertion,form,fruit,glabrousnes,height,history,life,lobing,na,number,ovary,plant,seed,shape,size,texture,type
516	wfo-0001032232	success	137	112	88	49	24	0.642	.5,0.25,0.5,0.5-1,0.6-3,0.8-1,1-3,1.8-2,18.8-27.5,2,2-2.6,20-100-flowered,3/4,4.8-7.3,5-6,abruptly,age,anther,apex,attenuate,bark,base,becoming,berry,calyx,clavate,cm,corolla,dark-papillose,decurrent,dia,distally,elliptic,erose,filiform,fruiting,glabrous,globose,green,greenish-brown,immature,lateral,leaf,lenticellate,less,light,lightly,lobed,long,long-acuminate,main,margin,minutely,mm,narrowly,occasionally,onto,ovary,ovoid-reniform,pair,pale,paler,papillose,pedicel,petiole,pitted,revolute,shrub,simple,slightly,somewhat,sparsely,stem,stigma,straight,style,subshrub,surface,tip,translucent,tube,umbonate,undulate,vein,way,wide,widening,winged	0.1,?,anthesi,ba,closely,cup-shaped,deflexed,eaf,edicel,eed,erect,evenly,exfoliatin,filament,flower,free,irregular,lobe,lower,middle,midrib,minute,nflorescence,node,opposite,overlappin,packed,papillo,pore,poricidal,portion,prominent,raised,reflexed,rounded,ruit,scar,shaped,short-styled,tall,tear-drop,ti,tub,ud,unifoliat,unit,widest,woody,ympodial	arrangement,bud,characteristic,colour,diameter,exfoliating,form,fruit,glabrousnes,growth,height,history,inflorescence,length,life,lobing,plant,seed,shape,size,texture,type,unifoliate,width
517	wfo-0001032233	success	160	117	88	72	29	0.55	0.3-2,1-1.5,1.5-2.5,10-15,157,2-15,2-3,2-5.5,2-6,20-100+,25-40,3-15,3-4,3.5-4,4-18,4-5,4-7,5-6,6-25,acuminate,acute,adaxial,almost,apart,apex,basal,base,branched,calyx,chartaceous,cm,connective,convex,cordate,coriaceous,cylindrical,dark,densely,diameter,dilated,distally,ellipsoidal,entire,flattened,fleischmann,flower,fruit,glabrescent,glabrous,glandular-puberulent,globose,green,lobe,longitudinal,margin,mm,moderately,oblong,obtuse,orange,ovate,ovoid,pedicel,peduncle,petiole,puberulent,pubescent,purple,radiu,shallowly,sparsely,stellate,stigma,stripe,style,subcoriaceous,subpeltiform,tip,tree,triangular,truncate,unbranched,unit,white,x,yellow,yellow-green,yellow-orange	0-2,1-2,1-3,2-4,2.5-4,3-4.5,3-5,4-foliat,5-16,8-12,abaxially,absen,absent,adaxially,aggregate,ape,articulated,axe,bent,beyond,biglandula,blade,brow,cell,connivent,directed,eaf,eed,equal,especially,exceeding,exserted,fleshy,glabrate,laterally,leaving,lon,long,lower,narrowly,nflorescence,nther,orolla,pedicellar,perfect,pore,present,projection,puberulen,rachise,remnant,ruit,shorter,simple,slightly,small,somewhat,spaced,stamen,stone,tal,tem,thecae,time,tomento,toward,tube,ud,vary,vein,wide,ympodial	4-foliate,abaxial,anther,biglandular,brown,bud,characteristic,colour,corolla,form,growth,height,history,inflorescence,leaf,length,life,ovary,perennial,plant,rachi,seed,shape,size,spacing,stem,surface,sympodial,texture
518	wfo-0001032259	success	202	109	88	114	21	0.436	.5,/3,0.45-0.6,0.5-0.8,0.7-1.1,0.8-1.3,0.9-1.2,1-2.5,1.5-4.5,10-30,2-2.5,2.2-3,3-4,4-5,7-16,9-22,abaxially,acute,almost,anther,apex,apparently,articulated,bark,base,becoming,berry,brownish,calyx,chartaceous,cm,connivent,cordate,cuneate,dark,densely,diameter,dull,evenly,filament,flattened-reniform,fruit,fruiting,glabrous,green,lateral,leaf,length,lobed,long,margin,maturity,mauve,mm,moderately,orange,orange-brown,ovate,pair,pedicel,peduncle,petiole,poricidal,prickly,primary,recurved,red,shrub,side,simple,spherical,stellate,stellate-pubescent,stem,style,surface,tapering,terminal,tip,toward,trichome,vein,way,white,wide,yellow,yellow-green,young	-4,/4,0,0-10,0-2,0-20,0-4,0-5,0.1-0.2,0.1-0.3,0.15-0.3,0.5-1.5,1-1.8,1-2,1/2,1/3,1/4-1/3,1/6-1/5,15-40,2-4,2-5,20-60,3/,4,4-6,4-9,5,5-30,5-merous,5.5-8,7-8,abaxial,acut,adaxial,alyx,apar,apart,apically,blade,branched,broad-deltate,brown,conical,deltate,difoliate,discolorous,distance,drying,eaf,eed,elongating,equal,erect,extending,flattened,flower,free,fully,geminate,glabrescent,gland,green-brow,hair,infructescence,lobe,longer,lower,mature,midpoint,midvein,minute,nflorescence,older,one,open,opening,orolla,oung,pendulous,per,perfec,pericarp,porrect,portion,prickl,prickle,pubescent,ray,reduced,rounded,ruit,scar,sessile,shorter,slender,smooth,sometimes,spaced,sparsely,spreading,straight,strongly,tamen,terete,tertiary,time,tube,unarmed,unit,vary,venation,visible,woody,ympodial	arrangement,branch,characteristic,colour,corolla,exertion,form,glabrousnes,green-brown,growth,height,inflorescence,lobing,new,ovary,plant,seed,shape,size,texture,type
519	wfo-0001032260	success	216	118	92	124	26	0.426	-1.5,-10,-8,/5,0-5,0.5-0.8,0.5-2,0.6-0.8,0.7-1.5,0.8-1.1,1-1.7,1.2-1.7,1.5-4,2,2.5,2.5-3,2.5-3.5,3-5,3-8,3-9,acuminate,acute,anther,apex,apparently,articulated,bark,base,berry,calyx,cell,cm,cuneate,curved,densely,diameter,dull,elliptic,erect,filament,flattened-reniform,fruit,fruiting,glabrous,glaucous,green-brown,lateral,leaf,length,lobed,long,margin,maturity,mauve,mm,orange-brown,outline,ovate,pair,pedicel,peduncle,petiole,pit,poricidal,prickly,primary,purple,raised,red,rounded,scandent,shallowly,shrub,simple,slender,small,spherical,stellate,stellate-pubescent,stem,style,subentire,surface,tapering,terminal,tip,tube,vein,way,wide,yellow,yellow-green	-0.5,-3,.1,0-,0-0.5,0-10,0-20,0-8,0.1,0.1-0.3,0.1-0.4,0.15-0.3,0.2,0.2-0.5,0.4,0.5-5,0.7,1-3,1-5,1-6,1/2,1/3,1/3-1/2,1/3-1/5,10-30,2-20,2-4,2-5,3-10,4-,5-,5-20,5-merous,6-10,6-8,7-15,abaxial,abaxially,acuminat,adaxial,alyx,apar,apart,apically,blade,branched,broad-deltate,chartaceous,connivent,deltate,difoliate,discolorous,distance,drying,eaf,eed,elongating,equal,extending,eye,flattened,flower,free,geminat,glabrescent,glabrou,gland,globular,gray-brow,infructescence,lobe,lon,long-styled,longer,lower,mature,midpoint,midvein,moderately,naked,narrow-ovate,nflorescence,older,one,open,orolla,oung,pale,pendulous,per,perfec,pericarp,porrect,portion,prickl,prickle,pubescent,ray,reduced,reflexed,ruit,scar,sessile,shorter,side,smooth,spaced,sparsely,spreading,stalk,stalked,strongly,tamen,terete,tertiary,time,trichome,unit,variously,vary,venation,visible,woody,ympodial	arrangement,branch,bud,characteristic,colour,corolla,exertion,form,glabrousnes,gray-brown,growth,height,history,inflorescence,life,lobing,na,new,ovary,plant,seed,shape,size,stigma,texture,type
520	wfo-0001032264	success	183	136	114	69	22	0.623	.2,.5,0.25-0.5,0.25-0.75,0.6-2.2,0.8-10,0.8-4,1.2-2,1.5-1.8,1.8-3,2-50-flowered,3,3-15,3-9,acuminate,acute,along,anther,apex,apiculate,appearing,bark,base,berry,branched,bud,calyx,cell,cell-layer,cm,corolla,deciduous,densely,dia,dry,elliptic,epidermal,exserted,filament,flattened-reniform,flower,fruiting,glabrous,globose,gnarled,green,hair,inflorescence,lamina,layer,leaf,like,lobed,long,margin,material,minor,minute,minutely,mm,multiseriate,narrowly,nearly,occasionally,older,one,opposite,ovary,ovoid,pale,papillose,pedicel,peeling,petiole,pitted,plant,pore,poricidal,primarily,pubescent,red-papillose,reddish-tan,revolute,several,shaped,sheet,short,shrub,simple,size,small-capitate,soon,sparsely,stem,stigma,style,surface,tear-drop,thick,time,tip,transversely,tree,trichome,tube,uniseriate,vein,weak,white,whitish,wide,x,yellowish-brown,young	0.5-1,1-1.5,10-22,2-6,4.5-5,5-9,6-17,anthesi,apar,ba,broadly,bullate,closely,cup-like,curling,deflexed,differing,difoliate,eaf,edicel,eed,fleshy,free,geminat,greyi,habitat,incrassate,large,larger,lateral,live,lobe,lon,lower,main,major,middle,nflorescence,often,overlapping,pair,papillo,parallel,planar,pointed,portion,prominent,quite,raised,reddish,rounded-deltoid,ruit,scar,scattered,sheltered,slender,small-celled,somewhat,spaced,straight,tall,tapering,trunk,ud,unit,upper,widest,woody,ympodial	abaxial,adaxial,alternate,arrangement,characteristic,colour,diameter,exertion,form,fruit,greyish,growth,height,history,length,life,lobing,perennial,seed,shape,texture,type
521	wfo-0001032274	success	192	94	72	120	22	0.375	0.15-0.2,0.5-0.7,0.5-1,0.7-1.8,0.9-1,1-1.2,1-1.5,1-3,1.5-2,3-6,3/4,5-7,acuminate,acute,anther,apex,axillary,base,berry,brown,capitate,cm,corolla,densely,diameter,ellipsoid,elliptic,entire,exserted,filament,filiform,flattened-reniform,fruiting,glabrous,globose,growth,inflorescence,lanceolate,leaf,margin,minutely,mm,new,obtusely,once-branched,pedicel,peduncle,petiole,pitted,plurifoliate,pubescent,purple,red,reddish,rounded,shape,shiny,shoot,short,shrub,simple,size,sparsely,stem,stigma,style,suckering,surface,terminal,way,white,x	.5,0,0.5,0.5-1.5,2,2-3.5,2-7,3-10,3-4,3-5,5-merou,<,ag,alyx,anthesi,apiculate,apparently,appearance,arching,ark,articulated,ba,basal,borne,branch,calyx,cell,clustered,conical,connivent,deltate,dendritic,distal,eaf,eed,fleshy,flower,free,geminat,glabrou,green,grey,group,highly,ilament,irregular,lax,lengthening,less,like,lobe,lobed,long,loosely,lower,markedly,membranous,minute,nflorescence,nodding,non-reproductive,occasionally,often,older,one,orolla,pair,pale,papillo,peg,pendan,per,perfect,pericarp,platfor,platform,pore,poricidal,portion,primary,puberulent,quadrate,reflexed,reproductive,ridge,ridged,ripe,ruit,scar,sleeve,slit,small,sometimes,somewhat,square,stellate,strongly,tem,testal,thin,tinged,tip,trichome,truncate,tube,twinin,two,ud,uniseriate,unit,upper,usually,variable,vary,vein,violet,visible,woody,yellow,ympodial	abaxial,adaxial,arrangement,bud,characteristic,colour,exertion,form,fruit,glabrousnes,height,history,length,life,lobing,ovary,perennial,plant,seed,texture,type,ye
522	wfo-0001032276	success	152	105	76	76	29	0.5	-,.25,0.3-1,0.5-0.75,0.8-1,1-1.5,1-2,1.8-2,2-2.5,2.5-4,3-3.5,5-7,7-8,9-18,acute,anther,apex,attenuate,bark,base,broadly,brown,calyx,cm,corolla,cup-shaped,dark,densely,dia,elliptic,exserted,filament,filiform,fruiting,glabrous,globose,green,lateral,leaf,lobed,long-pubescent,main,margin,minute,minutely,mm,narrowly,nearly,ovary,ovoid-reniform,pair,pale,pedicel,petiole,pitted,plant,pubescent,shaped,short,shrub,simple,soon,sparsely,stem,stigma,strongly,style,surface,tear-drop,tube,unifoliate,vein,white,winged,x,yellow	.5,0.25-1.5,0.5-1,1,3-6-flowered,along,anthesi,apart,ba,beneath,blade,capitat,converging,curly-tipped,decurrent,deflexed,deltoid,dry,eaf,edicel,eed,ellipsoid,evenly,except,free,geminate,greyish-gree,lamina,later,like,lobe,long,lower,material,middle,nflorescence,node,non-reproductive,obovoid,occasionally,older,onto,opposite,papillose,perhaps,pore,poricidal,portion,prominent,raise,raised,reflexed,remaining,rest,ruit,scar,slender,slightly,somewhat,spaced,straight,straw-colored,tall,tapering,tip,triangular,trichome,tub,ud,uniseriate,unit,widely,widest,woody,ympodial,young	8,arrangement,branch,bud,capitate,characteristic,colour,diameter,exertion,form,fruit,glabrousnes,greyish-green,growth,height,history,inflorescence,length,life,lobing,new,peduncle,perennial,primary,seed,shape,size,texture,type
523	wfo-0001032277	success	163	71	55	108	16	0.337	0.8-3,1-1.1,1-2,1.5-1.8,2-6-flowered,5-6,8-9,anther,base,beneath,berry,bright,calyx,cm,corolla,cup-shaped,densely,dia,elliptic,flattened-reniform,fruit,glabrous,globose,green,immature,inflorescence,internodal,leaf,margin,minutely,mm,opposite,ovary,pale,pedicel,petiole,pitted,poricidal,pubescent,revolute,ripe,shrub,simple,slender,sparsely,stem,style,surface,tapering,tip,translucent,tube,white,yellow,yellowish-tan	.5,0.1-0.5,0.2-0.6,0.75-1,1-1.2,1-1.5,1-5,1/2,10-14,2-2.5,2-4,3-3.5,3-9,acute,along,anthesi,apex,apiculate,appear,appearing,area,auriculate,ba,bark,blade,blunt,branched,closely,coriaceous,deltoid,drooping,dry,eaf,edicel,eed,ellipsoid,erect,exserted,filament,free,fruiting,geminat,gre,impressed,incrassate,indentation,lateral,lax,like,lobe,lobed,long,lower,main,mature,middle,nflorescence,number,obscured,occasionally,older,overlapping,pair,paler,papillae,papillose,partially,pore,portion,prominent,puberulent,pubescenc,raised,reddish,remaining,rest,round,rounded,ruit,scar,slende,small,spaced,specimen,spicy-fragrant,stigma,straight,strict,strongly,styl,tall,trichome,truncate,trunk,tub,two,ud,uniseriate,unit,varying,vein,virgately,way,widest,woody,x,ympodial,young	characteristic,colour,diameter,form,growth,height,history,length,life,perennial,plant,seed,shape,size,texture,type
524	wfo-0001032304	success	249	162	123	126	39	0.494	0.2-0.3,0.5-4.5,1-3.5,1.1-2,1.2-2.3,1.3-2.1,1.6-1.9,10,18,2-5,2.5-19.5,2/3-3/4,3-10,3-15,3-4.5,3-6,4-7.5,5.5-9,7-27,9-13,abaxially,acuminate,acute,adaxially,anther,anthesi,apex,bark,base,becoming,berry,blackish,blunt-tipped,branch,branched,broadly,brown,brownish,bud,calyx,campanulate,cm,conical,continued,corolla,dark,deltoid,densely,diameter,distal,due,elliptic,entire,exserted,filament,fleshy,flower,fruit,fruiting,glabrescent,glabrous,granular-tomentose,green,greenish,growth,honeycombed,lateral,leaf,least,length,lobe,long-attenuate,margin,midvein,mm,mostly,oblong,obtuse,orbicular,ovate,ovate-lanceolate,pale,pedicel,peduncle,petiole,plant,probably,pubescent,rather,ray,reniform,reticulate-punctate,ripe,scabridulous,seed,short-,shrub,side,simple,small,sparingly,spreading,stamen,stem,stigma,style,subglobose,suborbicular,terete,time,tomentose,tree,tube,unarmed,vein,velutinous,violet,way,white,whitish,x,yellow,yellowish	-3,.6-1.2,.9-1.4,/20,0-120,0.3-1.5,0.5-3,0.9-1.3,1,1.2-3,1.5-3.2,1.8-4,1/2,1/3-1/2,1/5,1/8,2-4,2-4.2,21,3-20,3.2-3.8,3.2-5.5,44,5-6,7.5-12,accrescent,ag,along,apart,apical-lateral,apparently,appressed-tomentose,articulated,ascending,axe,axillary,ba,blade,capitat,chartaceous,closely,decurrent,dehiscing,dendritic,dendritic-echinoi,dendritic-echinoid,directed,eaf,echinoi,echinoid,especially,extend,few-,few-rayed,free,glabrescen,hair,high,inserted,introrse,juvenile,large,lobed,long,long-,long-stalked,longitudinal,lower,m.,main,many,many-rayed,mixed,multangulat,multangulate,nflorescence,obscured,occasionally,often,older,opaque,orolla,ovat,overlapping,partly,perfect,plurifoliate,pore,porrect-stellate,present,pseudo-terminal,rachi,rarely,relatively,rotate-stellate,ruit,runk,sessile,short,short-stalked,slit,somewhat,spaced,stellate-tomentose,strongly,sulcate,suture,tamen,testa,thick,thick-stalked,thin,thin-,thin-stalked,tomentu,touching,toward,triangular-ovate,unarme,unit,usually,vary,wide,within,ympodial,young	0.9-1.4,appearance,arrangement,border,capitate,characteristic,colour,corrugation,drying,exertion,form,giving,glabrousnes,height,history,inflorescence,interjected,leaflet,life,lobing,midpoint,na,new,number,ovary,per,prickle,primary,pseud-terminal,pseudostipule,shape,size,surface,terminal,texture,thicknes,type,variation,width
525	wfo-0001032307	success	153	114	93	60	21	0.608	/3,0.4-1.3,1-1.5,1-2,1.5-5,2-5,2.5-12,30,4-8,5-12,5-25-flowered,7-18,abaxial,acute,along,anther,apex,bark,base,berry,branch,branched,calyx,campanulate,capitate,christmas-tree-like,cm,congested,corolla,dark,dendritic,densely,dia,ellipsoid,elliptic,erect,exserted,flattened-reniform,fruiting,glabrate,glabrous,globose,green,growth,incrassate,inflorescence,later,lateral,leaf,like,lobed,long,loose,many,margin,minutely,mm,new,ovary,pale,pedicel,petiole,pitted,plant,prominent,pubescent,reddish,reddish-brown,shaped,shrub,small,sparsely,stem,stigma,strongly,style,surface,tan,tear-drop,terminal,thick,time,tree,tree-like,trichome,truncate,tube,type,upper,vein,way,white,wide	.5,0.2-0.5,1.5-2,10-20,2.5-3,2.5-3.5,3.5-4,?,adaxial,anthesi,apar,blade,body,brow,deltate,eaf,edicel,eed,either,elongate,filament,flat,fleshy,free,immature,inflorescenc,lobe,lon,lower,main,middle,minute,nflorescence,older,pair,papillae,papillo,petal,planar,plurifoliat,pore,poricidal,portion,rest,ruit,scar,spaced,stout,tall,thickened,tip,tub,ud,unevenly,variable,widest,within,woody,ympodia,young	arrangement,brown,bud,characteristic,colour,diameter,exertion,form,fruit,glabrousnes,height,history,length,life,lobing,perennial,plurifoliate,seed,shape,size,texture
526	wfo-0001032308	success	190	150	125	65	25	0.658	0-3,0.7-1,0.7-1.2,1-10,1-2,1.5-2.5,1.8-2.5,1.9-3,12-16,2,2-4,3-10,3-6,3.8-5,4-7,4-8,4.8-7.7,5-7,6,6-11,8-9,abaxially,absent,acumen,adaxially,anther,base,berry,blade,broadly,brownish,cell,chartaceous,ciliate,clavate,cm,condition,connivent,corolla,covering,cuneate,deep,diameter,distal,dorsally,dot,drying,edge,elliptic,filament,flat,flower,folded,forked,fresh,fruit,generally,glabrous,globose,green,green-white,greenish,hair,hair-like,half,interjected,lanceolate,lateral,leaflet,lengthening,like,lobe,lobed,long,make,margin,medium,membranous,minute,minutely,mm,mucilaginous,odd-pinnate,often,ovoid,pair,pedicel,peduncle,pentagonal,perfect,petiole,plurifoliate,pore,poricidal,puberulent,pubescent,pure,ripe,scattered,seed,shape,slightly,slit,stem,stigma,straight,style,substellate,sympodial,terminal,testal,thick,throughout,tip,tri-,truncate,tube,unit,wall,wet,white,whitish,wide,x,yellow	0.2-2.1,0.3-5,2-3,2-6,5-merou,acute,ag,along,alyx,apart,apex,apparently,articulated,axe,axillary,bud,capitat,cordate,digestion,eaf,eed,enzyme,especially,exceeding,geminat,glabrou,greatly,hal,homostylous,honeycomb-shaped,invested,irregular,larger,leave,living,lower,midrib,much,narrowly,nflorescence,non-glandular,obtuse,orbicular,orolla,ovate,petiolulate,petiolule,plant,removed,rounded,ruit,sessile,seudostipule,short,spaced,specimen,stamen,ste,subtending,tamen,trichome,typically,usually,vary,varying	abaxial,adaxial,age,arrangement,articulation,calyx,capitate,colour,form,growth,history,inflorescence,leaf,length,life,na,number,ovary,pseudostipule,size,spacing,state,surface,texture,type
527	wfo-0001032335	success	215	138	99	116	39	0.46	.2,0.4,100,100+,15,16,>,abaxial,acuminate,acute,adaxial,along,anther,anthesi,apex,articulated,attenuate,axe,base,berry,branched,bright,c.,calyx,capitate,chartaceous,cm,connivent,corolla,cup-shaped,densely,diameter,ellipsoidal,elliptic,entire,evenly,exserted,filament,flattened-reniform,flower,fruiting,glabrous,globose,gold,golden-yellow,gradually,growth,inflorescence,length,like,long,loosely,many,margin,membranous,minute,minutely,mm,moderately,narrowing,narrowly,new,nodding,onto,orange,pale,pedicel,peduncle,peltate,per,persistent,petiole,pitted,plane,porrect-stellate,pubescent,ray,reddish,ripe,sessile,short-stalked,shrub,simple,small,somewhat,stem,stigma,stout,strongly,style,surface,terminal,time,tree,trichome,tube,way,white,wide	'',.5,0,0.05,0.2,0.2â0.3,0.5,0.5â1,0.9â1,1.5â2,10â12,12â15,1â1.2,1â1.5,1â3,2.5â3,2â10,2â2.5,2â5,3361,4â14,4â5,4â6-rayed,5-merou,5â6,6â19,6â6.5,7â10,abaxially,ag,alyx,apar,appearing,ark,beneath,boh,branching,cell,center,closely,covered,deltate,dichasia,discolorous,drying,eaf,eed,elongate,equal,erec,fide,free,fused,golden-brow,half,ilament,impressed,lamina,lengthening,less,lobe,lobed,lower,markedly,midpoint,multangulate,near,nflorescence,older,orolla,pair,papillo,part,perfect,pericarp,plurifoliate,pore,poricidal,porrect,portion,primary,pubescence,reflexed,regularly,ruit,scar,scurfy,shiny,short,silvery,slightly,slit,sometimes,spaced,sparsely,square,stellate,stub,tal,tem,testal,thin,tip,ud,unevenly,unit,upper,vary,varying,vein,visible,woody,yellow,ympodial,â4,âstellate	0.2-0.3,0.5-1,0.9-1,1-1.2,1-1.5,1-3,1.5-2,2-5,4,4-14,4-6-rayed,5-6,6-6.5,7-10,arrangement,bark,branch,bud,characteristic,colour,dichasial,exertion,form,fruit,glabrousnes,height,history,leaf,life,lobing,number,ovary,perennial,plant,seed,shape,size,texture,type
528	wfo-0001032337	success	225	112	91	134	21	0.404	0.4-1.5,0.5-3.5,1-2,1.2-2.8,1.4-2,1.5,1.6-4,2-3.5,2-7,2.3-11.5,2.3-4.8,3-8,3.6-5,4-17,4-6,4-9,4.5-14.5,5-11,8-10,8-17,9-29,abaxially,adaxially,anther,berry,blade,borne,brownish,canescent,chartaceous,clavate,cm,condition,corolla,darker,deep,densely,diameter,drying,end,filament,flower,fresh,fruit,glabrous,globose,green,greenish,hair,herb,homostylous,lateral,leaf,leaflet,light,like,lobe,membranous,mm,mottled,odd-pinnate,often,ovoid,pedicel,peduncle,petiole,plant,pubescent,purple,ray,seed,short,singly,size,sometimes,sparsely,stem,stigma,style,subglabrous,terminal,tube,tuber,typically,unwinged,violet,violet-purple,whitish,wide,wing,x	0,1,1-10,1-4,10,2,2-14,2-4,2-4.5,3-4,5-merou,9-21,acumen,acuminate,acute,ag,along,alyx,apart,apex,apiculate,apparently,articulated,attenuate,axe,axillary,base,basiscopic,broadly,bud,capitat,cell,ciliate,connivent,cordate,covering,cuneate,decurrent,digestion,distal,dorsally,dot,eaf,edge,eed,elliptic,enzyme,erec,especially,exceeding,except,flat,folded,forked,frequently,geminat,generally,glabrou,greatly,green-white,hair-like,half,honeycomb-shaped,interjected,lanceolate,lengthening,living,long,lower,make,margin,middl,midrib,minutely,mucilaginous,nflorescence,oblique,obtuse,orbicular,orolla,ovate,pair,paired,pentagonal,perfect,petiolulate,petiolule,plurifoliate,pore,poricidal,proximal,puberulent,rarely,reduced,removed,ripe,rotate,rounded,ruit,scattered,sessile,seudostipule,side,slightly,slit,small,spaced,specimen,stamen,ste,stolo,straight,subequal,subsessile,subtending,tall,tamen,tem,tertiary,testal,thick,throughout,tip,tissue,tri-,unit,unpaired,usually,vary,wall,wet,white,yellow,ympodial	5-merous,arrangement,calyx,capitate,colour,erect,form,growth,height,history,inflorescence,length,life,ovary,presence,pseudostipule,shape,staman,stolon,texture,type
529	wfo-0001032344	success	157	118	95	62	23	0.605	0.2-0.5,1-1.3,1-3,1-4,1.5-4.5,1.5-6,1.6-2.4,10-29,2-2.8,2-3,2.2-4,3-5,3-7,3-8.5,3-9,3.5-6.5,4-8,5-10,6-15,9.5-21,absent,acumen,acute,apical,apically,bluish,branched,calyx,cell,cm,connate,corolla,covering,cyme,dark,dehiscent,diameter,dichasial,dichasially,dot,ebracteate,exceeding,filament,forked,globose,green,hair-like,herbaceous,interjected,introrse,lateral,leaf,leaflet,lobe,long,long-attenuate,make,maturing,medium,mm,monochasial,mucilaginous,odd-pinnate,often,ovoid,pedicel,peduncle,perennial,petiole,plant,poricidally,puberulent,pubescent,purple,rotate,rotate-pentagonal,scarce,seed,short,size,slit,smooth,stamen,stigma,straight,style,terminal,testal,thick,typically,violet,wall,white,wide,yellow	2.8,3-6-foliat,4-11,abaxially,abruptly,acuminate,adaxially,apex,articulate,base,belo,broadly,cuneate,decurrent,digestion,diminishing,distal,dorsally,eaf,edge,eed,elliptical,emoval,enzyme,flower,generally,globo,green-white,half,honeycomb,inrolled,layeral,living,lon,lower,lunat,nflorescence,nther,oblique,orolla,ovate,pair,pattern,perfect,petiolule,plan,proximal,reveal,ruit,sessile,seudostipule,sometimes,specimen,tal,tem,throughout,toward,tuber-bearing,unit,vary,ympodial,Â¼	7,abaxial,adaxial,anther,arrangement,colour,form,fruit,growth,height,history,inflorescence,length,life,lunate,ovary,pseudostipule,shape,stem,surface,texture,wet,width
530	wfo-0001032354	success	171	131	80	91	51	0.468	1-10,1-2,2-2.5,2.5-3,250-400,38/2,anther,aster,axillary,base,becoming,berry,bilobed,branch,broadly,brown,calyx,campanulate,capitate,cm,coarsely,colour,corolla,cuneate,dia,discoidal,distal,ellipsoid,exerted,filament,fork,glabrous,glandular,globose,green,greenish-ivory,greyish,hair,halfway,lasting,leaf,lobe,lobed,maturity,minutely,mm,narrow,obovate,obovoid,ovary,ovoid,pedicel,peduncle,pinnatisect,poricidal,puberulent,rh,rugose-reticulate,several,shape,shrub,simple,size,slightly,soft,somewhat,stem,stigma,straight,strongly,style,surface,tip,variable,vein,violet,wing,wooded,woody,year	0,0-5,0.3,0.5-1,0.8-1,0.8-1.2,1-3,1-5,10-lobed,2,25,29,3-4,4-6,40-75,5-10,5-15,acuminate,acute,almost,angular,anthesi,apex,aspect,axi,branched,c.,cell,creating,cut,decurrent,deep,deeply,eaf,eed,effect,except,facetted,fleshy,flower,general,gre,gree,lanceolat,large,lengthening,linear,lower,midrib,minute,nflorescence,occasionally,oval,ovate,pair,pale,pebble-shaped,pedicellate,plurifoliat,pore,pubescent,rather,rotate,rounded,ruit,secondary,seedling,shoot,single,sinus,slit,small,smaller,smel,sparse,spreading,stellate,stone,tall,trichome,tub,ud,uniseriate,unit,unpleasant,usually,wide,within,x,ympodial,young	10,4,5,appearance,arrangement,bark,border,bud,characteristic,corrugation,decument,diameter,drying,exertion,form,fruit,fruiting,giving,glabrousnes,growth,height,history,inflorescence,interjected,lateral,leaflet,length,life,lobing,margin,midpoint,na,new,number,per,perennial,petiole,plant,plurifoliate,prickle,primary,pseudostipule,ray,seed,terminal,texture,thicknes,tube,type,variation,width
531	wfo-0001032358	success	216	159	137	79	22	0.634	.1,.2,.3,.4,.5,/2,0.2-4,0.5-3,0.7-1,1-2,1.3-1.7,1.5-2,13-20,15-40,2-10,2-3,2-4,2.2-7.5,3-10,3-4,3.5-13,4-4.5,4-7,4-8,4.5-5,acute,anther,anthesi,apart,apex,appearing,armed,bark,base,based,berry,branched,broad,brown,calyx,capitate,center,cm,cordate,corolla,curved,densely,diameter,entire,equal,expanding,exserted,filament,flattened,flower,fruit,fruiting,furcate,glabrescent,glabrous,globose,green,growth,inflorescence,internodal,irregular,leaf,left,like,lobe,long,longer,lower,margin,markedly,midpoint,minutely,mm,new,occasionally,often,orangish,ovate,ovoid,pair,pale,paler,part,pedicel,peduncle,peg,persistent,petiole,pitted,planar,porrect,present,prickle,prickly,primary,pubescent,purple,ray,red,reniform,rhachi,ripening,scar,sessile,short-stalked,shrub,simple,sinuate,slightly,small,somewhat,spaced,sparsely,spreading,stellate,stem,stigma,strongly,style,surface,tan,time,trichome,tube,tuberculate,type,unevenly,vein,way,widely,x,yellowish	0,0.6-0.8,0.6-1,1-1.6,1.5-2.5,1/4-1/2,12-20,2,2-5,4-merous,abaxially,abscissio,adaxially,along,another,away,basal,bulbous,cell,cupuliform,difoliate,dorsal,drying,eaf,eed,erect,free,frui,geminate,glabrescen,heteromorphic,interpetalar,irregularly,lamina,lengthening,linear,lobed,lowermost,margined,maturity,membranous,midrib,midvein,nflorescence,nodding,older,one,papillat,papillate,per,perfect,pericarp,pore,poricidal,portion,rotate-stellate,ruffly,ruit,shiny,short,sinus,slit,sometimes,space,staman,thick,thin,three,tip,tub,two,ud,unisexual,unit,upper,usually,whitish,ympodial,zygomorphic	abaxial,abscission,adaxial,arrangement,bud,characteristic,colour,exertion,form,glabrousnes,height,history,length,life,lobing,perennial,plant,pubescence,seed,shape,size,texture
532	wfo-0001032367	success	231	129	79	152	50	0.342	0-0.3,0.4-0.5,0.7-1.1,1-2.1,100-300,6-8,acute,anther,apex,base,berry,branch,calyx,capitate,cm,conical,cordate,dark,diameter,erect,filament,flattened-reniform,free,fruiting,glabrous,glandular-puberulent,globose,green,greenish,immature,inflorescence,lateral,leaf,length,light,lobe,lobed,long,margin,maturity,membranous,midpoint,minute,minutely,mm,mottled,nearly,obtuse,ovary,ovate,pale,pedicel,peduncle,per,petiole,prickle,pubescent,ray,red-brown,sessile,shrub,simple,size,spreading,stellate,stem,stigma,style,suborbicular,surface,tapering,tip,triangular,truncate,tube,vein,white,wide,yellow	-3,.2,.4,0.2â0.35,0.4â0.5,0.4â0.6,0.4â1,0.5â0.8,0.5â2,0.6,0.6â0.8,0.8,0.8â2,1-2,1.2,1â1.5,1â1.8,2,2-3-celled,2-4,2.2â2.5,2.2â2.8,2.5â3,2â2.5,3-5,3-celled,3.2â4,3â10,3â5,3â6,4,4â6.5,5-merous,5.5â6.9,5â18,6.8â8.2,7â10,8,abaxial,abaxially,accrescent,acicular,adaxial,adaxiall,adaxially,also,alyx,anthesi,arme,around,axi,ba,blade,broad-based,congested,connivent,copious,cream,curved,deciduous,densely,difoliate,directed,distall,eaf,eed,enlarged,entire,equal,expand,fertile,flower,geminat,geminate,gland-tipped,grading,hair,herbarium,heterostylous,hyaline,infructescence,lanceolate,largest,layer,least,long-styled,longer,lower,lowermost,major,many,mesocarp,mixed,mixture,moderately,narrowly,nflorescence,often,one,orolla,oung,pair,papillat,pore,poricidal,portion,prickly,puberulent,pubescence,rarely,recurved,rest,ruit,scarcely,scattered,secondary,shallow,short-styled,shorter,similar,slender,small,smaller,somewhat,sparsely,specimen,spongy,spreadin,staminat,ste,straight,tall,tamen,terete,thick,tightly,time,tooth,trichome,twice,unarmed,unbranched,uniformly,uniseriate,unit,usually,variable,vary,whitish,ympodial,â15,â5	0.5-0.8,0.5-2,1-1.8,15,2-2.5,2.2-2.5,2.2-2.8,3-6,5.5-6.9,6.8-8.2,7-10,appearance,armed,arrangement,bark,border,bud,characteristic,colour,corolla,corrugation,distal,drying,exertion,form,fruit,giving,glabrousnes,growth,height,history,interjected,leaflet,life,lobing,na,new,number,papillate,plant,primary,pseudostipule,seed,shape,terminal,texture,thicknes,type,variation,width
533	wfo-0001032407	success	216	122	102	114	20	0.472	0-4,0.4-4,0.5-3,1-2,1-2.4,1.2-7,1.4-2.7,1.5-2.2,10-19.5,10-27,2-10.5,2.5-10.5,2.5-9,3-15,3.1-13.5,4-11,4-7,5,5-23,5-30,7-9,8-10,abaxially,adaxially,anther,berry,blade,brownish,cell,chartaceous,ciliate,clavate,cm,coarsely,condition,conical,connivent,corolla,covering,dark,densely,diameter,drying,filament,finely,flower,fresh,fruit,glabrous,green,greenish,hair,hair-like,herb,homostylous,interjected,lanceolate,lateral,leaf,leaflet,light,like,lobe,long,margin,medium,membranous,minute,minutely,mm,moniliform,mottled,odd-pinnate,ovoid,pedicel,peduncle,petiole,plant,puberulent,pubescent,purple,rarely,ripe,seed,semierect,simple,size,sparsely,stem,stigma,straight,style,terminal,testal,thick,tube,tuber,wall,white,whitish,wide,x	0.3-0.6,0.3-8,0.8,0.8-0.3,1-10,1-5,12,2-4,30,38,4-48,5-merou,6,absent,acumen,acuminate,ag,along,alyx,apart,apex,apparently,arranged,articulated,asymmetrical,attenuate,axe,axillary,base,basiscopic,bead,bud,capitat,commonly,decreasing,digestion,distal,eaf,edge,eed,elliptic,elongated,enzyme,erec,especially,exceeding,folded,forked,geminat,generally,glabrou,gradually,green-white,half,honeycomb-shaped,larger,lengthening,less,living,lower,make,middle,mucilaginous,multiple,narrow,necklace,nflorescence,obtuse,orbicular,orolla,ovate,pair,pentagonal,perfect,petiolule,plurifoliate,pore,poricidal,proximal,pubescen,ray,removed,rotate,round,ruit,secondary,sessile,seudostipule,side,slit,spaced,specimen,stamen,ste,stolon,subequal,subtending,symmetrical,tall,tamen,tem,throughout,tip,tissue,tri-,typically,unit,unwinged,usually,vary,wet,wing,yellow,ympodial	5-merous,abaxial,adaxial,arrangement,calyx,capitate,colour,erect,form,growth,height,history,inflorescence,length,life,ovary,pseudostipule,shape,surface,texture
534	wfo-0001032465	success	233	177	158	75	19	0.678	+,-11,-14,.5,0.2,0.5-,0.5-2,1-,1-1.5,1-1.7,1.2-1.5,1.5-1.8,1.5-2,1.5-5,1/3,2,2-2.5,25,3-3.5,3-5,3-8,4,5,5-8,9,abaxial,acuminate,acute,angled,anther,anthesi,apex,articulated,axi,basal,base,berry,black,branched,brown,calyx,capitate,ciliate,clasping,cm,commonly,conical,connivent,cordate,corolla,de,deep,deeper,deeply,deltate,densely,diameter,distal,edge,ellipsoid,elliptic,entire,filament,filiform,flattened,flower,fringe,fruiting,glabrous,gland,glandular,glandular-tipped,globose,greenish,growth,included,inflorescence,janeiro,larger,later,lateral,leaf,leaving,length,lengthening,like,lobe,lobed,long,loosely,lower,margin,minute,minutely,mm,narrowly,new,nodding,often,outline,ovate,pair,papillate,pedicel,peduncle,peg,petiole,pinnate,pinnatifid,planar,pore,poricidal,pubescent,purplish,reddish,reniform,reticulate,revolute,rio,ripe,scattered,seed,shallow,shape,similar,simple,size,sleeve,slit,sparsely,stellate-rotate,stem,stigma,strongly,style,surface,terminal,time,tiny,tip,transparent,trichome,truncate,tube,unicellular,uniseriate,upper,usually,variously,varying,vine,violet,way,white,woody,x,young,Â½	-10,-9,.2,0,1-celled,1.5,2.5-5.5,3-4,3-9,5-7,5-merou,ag,alyx,apar,apically,appearing,ark,cell,coriaceous,decreasing,drying,eaf,eed,elongate,erect,exserte,free,glabrescen,green,growing,half,ilament,irregular,irregularly,mature,membranous,nflorescence,occasionally,older,orolla,paired,papillo,pendan,pentagonal,per,perfect,pericarp,plurifoliat,portion,primary,puberulent,ruit,scar,shiny,sinus,somewhat,spaced,splitting,subshrub,tem,testal,thicker,thin,toward,tuft,twinin,twining,ud,unit,vary,vein,wall,widest,yellowish,ympodial	age,arrangement,bark,bud,characteristic,colour,exertion,exserted,form,fruit,glabrescent,glabrousnes,history,life,lobing,ovary,papillose,texture,type
535	wfo-0001032494	success	163	97	78	85	19	0.479	.5,0.8-1,0.9-1.2,1-1.5,1.45-1.5,1.5-8,1.6-2,1.8-4.5,16.5-20.5,2.3-2.5,2.5,2.5-8,3.4-14.5,3/4,5-40,5-6.4,acuminate,anther,apex,attenuate,bark,base,berry,brown,calyx,clavate,cm,corolla,decurrent,dia,flattened-reniform,flowered,fruit,fruiting,furcate,glabrous,globose,greenish-yellow,leaf,light,long,minor,minutely,mm,narrowly,occasionally,opposite,ovary,ovate,pale,papillose,pedicel,petiole,pitted,shaped,shrub,simple,size,slender,small,stem,stigma,style,surface,tapering,tear-drop,tree,triangular,trichome,tube,two-winged,uniseriate,way,white,whitish-green,winged,x,zig-zag	.1,.4,0.6-1,0.75-1,1.1-1.2,1.5,3-4,4-8,8-11,accrescent,anthesi,apart,appearing,axil,ba,beginning,beneath,bullate,deflexed,differing,difoliate,dry,eaf,edicel,eed,equal,evenly,except,expanded,exserted,filament,free,geminat,geminate,incrassate,inflorescenc,lateral,lax,lenticellat,lobe,lobed,lon,lower,main,major,margin,material,middle,nearly,nflorescence,node,orange,ovoid,pair,papillae,papillo,planar,pore,poricidal,portion,prominent,proximal,pubescent,quite,raised,revolute,ridge,ruit,scar,slightly,somewhat,spaced,straight,tall,tan,tip,ud,unit,upper,vein,venation,widest,woody,yellow,ympodial	2.4,alternate,arrangement,characteristic,colour,diameter,form,growth,height,history,inflorescence,length,life,lobing,plant,seed,shape,texture,type
536	wfo-0001032507	success	206	90	56	150	34	0.272	0.3,1,6,abaxial,acuminate,anthesi,apex,berry,branched,brown,cm,compound,diameter,entire,flattened-reniform,fruiting,glabrous,globose,green,hair,herbaceous,internode,light,margin,minutely,mm,pedicel,peduncle,perennial,pericarp,petiole,pinnate,pinnately,pinnatifid,pitted,present,prickle,pulp,rachi,rarely,reddish,rounded,rugose,shape,simple,slender,stem,strongly,surface,terminal,unbranched,variously,vine,white,woody,Ã	.2,.5,/4,0.25,0.5,0.7-1.2,0.8,1.2-1.7,1.3,1.5â2,1.5â7,10â20,15â20,1â1.5,1â10,2,2.5â4,2.5â6,20â30,2â9,3â5,3â7,4â10,5â10,5â20,5â8,8â15,abaxially,absent,abundant,acute,adaxiall,adaxially,adjacent,ag,alyx,anther,apiculate,armed,articulated,base,becoming,blade,blue,broadly,bud,calyx,campanulate,cell,chartaceous,collection,confluent,connivent,corolla,cream,curved,deep,deltate,distally,distinct,dr.,eaf,eed,either,ellipsoid,elliptic,elongating,equal,exserted,fertile,fifth,filament,flower,flowering,four,herbarium,highly,individual,interpetalar,larger,lateral,leaflet,lengthening,lobe,lobed,long,longer,lower,major,material,midrib,narrowly,nearly,nflorescence,oblong,observe,occasionally,often,one,orolla,ovate,pale,papery,pentagonal,pistillate,plant,plurifoliat,pore,poricidal,puberulent,purple,purplish,quadrate,ranging,recurve,regularly,rotate-pentagonal,ruit,side,single,sinus,slightly,slit,sometimes,spreading,staminate,stigma,stout,straight,style,tamen,tear,testal,time,tip,tissue,tube,unequal,unit,unlobed,usually,variable,vary,vein,way,wide,widest,wood,yellowish,ympodial	0.25-0.8,1-10,1.5-7,10-20,15-20,3-5,4,4.5,5-10,5-20,8-15,adaxial,arrangement,characteristic,colour,dry,form,fruit,glabrousnes,greyish,growth,history,inflorescence,leaf,length,life,new,plurifoliate,presence,recurved,seed,size,texture,type
537	wfo-0001032523	success	200	144	109	91	35	0.545	-5,.2,.5,/4,0.3-0.5,0.6-0.7,0.6-0.8,1-1.5,1-3,1.3-1.6,1.5-3,10-50,2-2.4,2-4,2-5.5,2.7-3,3-15,5-20,6-10,6-8,abaxially,acuminate,acute,anther,apart,apex,apically,apparently,bark,base,berry,calyx,cm,conical,cuneate,curved,deltate,diameter,discolorous,drying,dull,elliptic,entire,erect,evenly,filament,filiform,flattened-reniform,fruit,fruiting,gently,glabrescent,glabrous,green,inflated,lateral,leaf,length,lobe,long,margin,maturity,mauve,membranous,midpoint,mm,moderately,older,orange,orange-brown,ovate,pair,pale,pedicel,peduncle,per,petiole,poricidal,prickle,prickly,primary,ray,recurved,red,red-brown,shrub,simple,sometimes,spaced,sparsely,spherical,stellate-pubescent,stem,straight,strongly,style,subentire,surface,tapering,terminal,tip,tube,unarmed,vein,way,weakly,wide,yellow,young	-2,0-0.15,0-10,0-12,0-15,0-3,0.1-0.2,0.2,0.2-0.4,0.4-1,0.4-1.5,0.5-1,1-2,1-8,1/3-1/2,1/4-1/3,15-30,2,2-2.5,2.5-6,3-4,3.5-4,4-5-merous,4-7,5-12,6-20,abaxial,acuminat,adaxial,alyx,ame,apar,articulated,blade,branching,brow,c.,connivent,eaf,eed,elongating,equal,flower,free,glabrou,hair,herbaceous,infructescence,lobed,lon,longer,lower,mature,minute,multangulate,narrow-deltate,nflorescence,one,open,orolla,oung,perfec,pericarp,perpendicular,plurifoliat,porrect,portion,reflexed,ruit,scandent,scar,secondary,sessile,smooth,spreading,stalk,stalked,stellate,tamen,terete,tertiary,time,trichome,unarme,unit,variously,vary,venation,visible,woody,ympodial	appearance,arrangement,border,branch,brown,bud,characteristic,colour,corolla,distal,exertion,form,giving,glabrousnes,growth,height,inflorescence,interjected,leaflet,lobing,na,new,number,ovary,plant,pseudostipule,seed,shape,size,stigma,texture,thicknes,type,variation,width
538	wfo-0001032524	success	205	87	68	137	19	0.332	1-2,1-2.5,1.5-2,1.5-4,10-35,12-13,14-50,2-5,2.5-8,25-90,3-5,3.5-4.5,4.5-8,5-6,5-9,6-13,6-16.5,7-8,anther,blade,chartaceous,clavate,cm,corolla,densely,diameter,elliptic,filament,flower,fruit,globose,grayish-green,green,greenish,herb,homostylous,interjected,lateral,leaflet,length,light,lilac,lobe,membranous,mm,moniliform,narrowly,odd-pinnate,ovate,ovoid,pair,pedicel,peduncle,plant,pubescent,purple,seed,size,stem,stigma,style,terminal,tube,tuber,unwinged,violet,whitish,x	1-10,120-210,2-3,3-4,3-8.5,4,4-5,4.5-5,5-merou,50-70,7-35,?,abaxially,acumen,acute,adaxially,ag,along,alyx,apart,apex,apparently,arranged,articulated,ascending,attenuate,axe,axillary,base,bead,berry,brownish,bud,capitat,cell,ciliate,condition,connivent,covering,cuneate,different,digestion,distal,dorsally,drying,eaf,edge,eed,enzyme,erec,especially,exceeding,except,flat,folded,forked,fresh,geminat,generally,glabrou,glabrous,greatly,green-white,hair,hair-like,hal,half,head,honeycomb-shaped,lanceolate,lengthening,like,living,long,lower,make,margin,middle,midrib,minutely,mucilaginous,multicellular,multiple,necklace,nflorescence,non-glandular,obtuse,often,orolla,pentagonal,perfect,petiole,petiolulate,petiolule,plurifoliate,pore,poricidal,proximal,puberulent,reduced,removed,ripe,rotate,rounded,ruit,sessile,seudostipule,short,silky,silvery-white,slit,spaced,specimen,stamen,ste,stolon,straight,subequal,subtending,tall,tamen,tem,testal,tetralobulate,thick,throughout,tip,tri-,trichome,typically,unit,usually,vary,wall,wet,yellow,ympodial	5-merous,abaxial,adaxial,arrangement,calyx,capitate,colour,form,growth,height,history,inflorescence,leaf,life,ovary,pseudostipule,shape,staman,texture
539	wfo-0001032532	success	161	78	55	106	23	0.342	0.3-2.5,1-4,1.5-2.6,1.5-3.2,1.5-4.3,13-52,15-30,2-10,2-13,2-3,2.8-3.6,2.8-9.5,3-10,3.4-12.2,3.7-10,4-5.5,4.5,6,6-22,branched,calyx,cm,conical,corolla,deep,diameter,dichasially,filament,finely,forked,green,herbaceous,interjected,lateral,leaf,leaflet,light,long,medium,mm,mucilaginous,odd-pinnate,ovoid,pedicel,peduncle,perennial,petiole,plant,pubescent,purple,seed,size,style,terminal,wide	0-.,1-1.5,2,2-,3-5,3-6-foliat,8-38,abaxiall,abaxially,absent,acumen,acuminate,acute,adaxially,apex,apical,apically,articulate,attenuate,base,cell,coarsel,connate,covering,cuneate,cyme,dehiscent,dichasial,digestion,diminishing,distal,dorsally,eaf,ebracteate,edge,eed,elliptical,emoval,enzyme,exceeding,flat,flower,folded,generally,globo,gradually,green-white,hair-like,half,honeycomb,introrse,living,lobe,lon,long-attenuate,lower,lunat,make,maturing,minute,monochasial,narrowly,nflorescence,nther,oblique,obtuse,often,orolla,ovate,pair,pattern,perfect,petiolule,plan,poricidally,proximal,reveal,rotate,rounded,ruit,sessile,seudostipule,short,slit,specimen,stamen,stigma,straight,subequal,subsessile,tal,tem,testal,thick,throughou,throughout,tip,toward,tuber-bearing,typically,unit,vary,wall,yellow,ympodial,Â¼	0-2,abaxial,adaxial,anther,arrangement,branching,coarsely,colour,form,fruit,growth,height,history,inflorescence,length,life,ovary,pseudostipule,shape,stem,surface,texture,width
540	wfo-0001032536	success	254	156	125	129	31	0.492	/3,0.5,1-2.5,1.3-2.2,10,10-30,100,2-3,2.5-3,20-22,20-50,3-3.5,4-6,4-9,5-8,5.5-8,7-10,<,>,abruptly,acute,age,almost,anther,anthesi,apex,armed,bark,basal-most,base,berry,bright,bristle,bristly,brown,calyx,capitate,chartaceous,clavate,cm,conical,curved,dark,deeply,densely,depressed,diameter,elliptic,entire,fading,filament,flattened,fruit,fruiting,glabrous,glandular,globose,grayish,growth,inflorescence,lateral,leaf,leaf-opposed,length,lobe,lobed,long,margin,maturity,membranous,midpoint,minute,minutely,mixture,mm,multiseriate,narrowing,near,new,number,oblique,olive-green,once-branched,ovary,papillae,papillate,part,pedicel,peduncle,per,petiole,plant,poricidal,porrect,prickle,primary,pubescent,purple,ray,reddish,reniform,simple,slightly,somewhat,sparsely,spreading,stellate,stem,stigma,style,surface,tapering,terete,terminal,tip,tree,trichome,truncate,tube,unarmed,vein,way,white,wide,yellow-green	-3,1,1-2,1.5,10-20,10-50,13-24,14-16,20-25,3,3-6,4-8,5,5-6,5-merous,abaxial,abaxially,adaxial,adaxiall,adaxially,along,alyx,angle,apar,appressed,around,articulated,axi,berr,blade,broad-based,broadly,caudat,caudate,cell,clearly,coriaceous,cu,dbh,deltate,denser,difoliate,directed,diverging,eaf,eed,enlarged,equal,evenly,flower,free,geminate,glabrescent,glandular-puberulent,halfway,hanging,heterostylous,inflorescenc,infructesecnce,interpetalar,irregularly,juvenile,lamina,leaving,like,long-stalked,long-styled,lower,mature,midrib,midvein,mixed,multangulate,narrowly,nflorescence,occasionally,occurring,odor,older,open,orolla,oung,papillat,pentagonal,pericarp,pore,portion,potato,prickl,prickly,prominent,protuberance,rarely,reproductive,rough,ruit,scar,scattered,shallowly,short-,short-styled,slender,small,smooth,soft,spaced,stalk,staminate,stellate-pubescent,strongly,tall,tamen,thick,time,tissue,triangular,trunk,unequal,unit,upward,urceolate,usually,vary,visible,wood,woody,yellowish,ympodial,younger	appearance,arrangement,border,branch,bud,characteristic,colour,corolla,distal,drying,exertion,form,giving,glabrousnes,height,history,interjected,leaflet,life,lobing,na,perennial,pseudostipule,seed,shape,size,texture,thicknes,type,variation,width
541	wfo-0001032542	success	161	108	90	71	18	0.559	/4,0.5-1,0.7-1,1-1.3,1-1.5,1-5,1.5-3.5,10-15-flowered,10-28,2-3,2.5-5,3-4,3-5,4-9.5,4.5-5,5-8,abaxial,acuminate,acute,adaxially,anther,apex,attenuate,bark,base,berry,bluish-green,bright,brown,calyx,capitate,cm,corolla,dark,deflexed,dendritic,densely,dia,difoliate,elliptic,elliptic-obovate,exserted,flattened-reniform,fruiting,glabrous,globose,golden,green,growth,incrassate,inflorescence,later,leaf,less,long,margin,minor,mm,new,opposite,ovary,pedicel,petiole,pubescent,reddish-brown,rounded,shape,shaped,shining,shrub,simple,size,slender,small,sparsely,stem,stigma,strongly,style,surface,tear-drop,treelet,trichome,tube,unit,way,wide,x,yellow-green,young	.25,.25-0.5,.5,.5-1,1-2,2-3.5,4-7,abaxially,along,anthesi,apical,axi,ba,basal,beginning,closely,compact,conical,deltate,di,differing,distal,dry,eaf,edicel,eed,either,erect,filament,free,geminat,inflorescenc,lamina,lateral,like,lobe,lobed,lon,loose,lower,main,major,minute,minutely,narrowly,near,nflorescence,older,overlapping,pair,papillo,persisten,pitted,planar,pore,poricidal,portion,ruit,scar,slightly,somewhat,spaced,swollen,tip,triangular,tub,ud,vein,woody,yellowish,ympodial	arrangement,bud,characteristic,colour,diameter,exertion,form,fruit,geminate,glabrousnes,height,length,lobing,plant,seed,sympodial,texture,type
542	wfo-0001032564	success	160	95	75	85	20	0.469	.05-0.1,.5,0.3-1,1-1.3,1-1.5,1-2,1.3-2.5,1.5,2-2.5,4-5,4-6-flowered,5.5-9,6-7,along,anther,arched,bark,base,becoming,beneath,berry,branch,broadly,brown,calyx,clavate,cm,conical,corolla,dark,deflexed,densely,dia,dry,elliptic,flattened,fresh,fruiting,glabrous,globose,green,greenish-white,greyish-red,leaf,lobed,long,material,minutely,mm,narrowly,nearly,ovary,ovate,ovoid-reniform,pedicel,petiole,puberulent,ripe,shaped,shiny,shrub,simple,stem,stigma,style,surface,tan,tear-drop,thread-like,trichome,unifoliate,uniseriate,vein,x,yellowish-green	.05,.1,0.25-0.5,0.75-1,1-1.2,8-9,anthesi,apar,apart,apex,aspec,ba,bud,converging,deltoid,eaf,edicel,eed,except,expanded,exserted,extreme,filiform,flower,geminate,giving,glabrate,golden,halfway,lamina,later,lateral,like,lobe,long-acuminate,lower,main,margin,member,middle,minute,nflorescence,node,non-reproductive,obovoi,often,older,one,open,opposite,pair,papillo,papillose,pitted,planar,point,pore,poricidal,projection,prominent,proximal,raised,reflexed,rounded,ruit,scar,slightly,small,soon,straight,strongly,tall,tapering,time,tiny,tip,truncate,tube,ud,unit,widest,winged,woody,ympodial,young	arrangement,characteristic,colour,diameter,form,fruit,growth,height,history,inflorescence,length,life,lobing,perennial,plant,seed,shape,size,texture,type
543	wfo-0001032569	success	164	106	81	83	25	0.494	.5,/3,0.5-10,0.8-1,1-1.2,1.2-5,1.5-2,1.7-2,4-18,5-6,7-27,7-9,acute,anther,apex,bark,base,berry,bilobed,branched,broadly,brown,bullate,calyx,cm,conical,corolla,corrugated,dark,decurrent,deflexed,dendritic,densely,dia,dry,ellipsoid,elliptic,erect,exserted,filament,flattened,fruiting,glabrous,globose,green,inflorescence,later,lateral,leaf,lobed,main,minutely,mm,occasionally,onto,ovary,ovate,pair,pedicel,petiole,pitted,pubescent,reniform,shaped,shrub,simple,size,somewhat,stem,stigma,strongly,style,surface,tear-drop,thick,trichome,tube,vein,way,white,x	1-1.5,1-2,1-4,1.5,2-3,2-4,4-8,5-60-flowered,abaxially,adaxially,along,anthesi,apparently,appearing,axi,bearing,cell,closely,dense,denser,differing,difoliate,drying,eaf,edicel,eed,fleshy,free,geminate,golden,gra,incrassate,irregularly,lea,like,lobe,lon,long,los,lower,major,margin,matted,mature,middle,minor,moderately,nflorescence,obscured,open,opposite,otherwise,paler,papillo,papillose,pericar,planar,pore,poricidal,portion,present,pubecsence,rich,ruit,scar,spaced,sparsely,splitting,stone,tall,time,tip,triangular,tub,tuft,ud,unifoliate,unit,waxy,widest,woody,ympodial,young	abaxial,adaxial,arrangement,bud,characteristic,colour,diameter,exertion,form,fruit,gray,growth,height,history,length,life,lobing,na,peduncle,plant,primary,seed,shape,texture,type
544	wfo-0001032576	success	229	137	113	116	24	0.493	/5,0-5,0.3-0.5,0.3-0.7,0.5-1,0.5-2,0.5-4,0.8-1.2,0.8-1.4,1.2-1.8,1.5-2,1.5-2.3,1.5-7.5,1.8-2.5,1/3,2-4,3-14,4,4-6,abaxially,acute,anther,apex,apically,apparently,articulated,bark,base,berry,bright,brown,brown-green,calyx,cell,chartaceous,cm,cuneate,deltate,densely,diameter,dull,ellipsoid,entire,erect,evenly,filament,flattened-reniform,fruit,fruiting,glabrescent,glabrous,glandular,gray,green,hair,herb,lanceolate,lateral,leaf,length,lobed,long,margin,maturity,membranous,minutely,mm,moderately,near,obtuse,often,orange-brown,outline,ovate,pair,pedicel,peduncle,petiole,pit,poricidal,prickly,primary,purple,raised,red,red-green,reflexed,reticulate,shiny,shrub,simple,small,sparsely,spherical,spreading,stellate,stellate-pubescent,stem,style,surface,tapering,terminal,tip,trichome,tube,upper,vein,way,white,wide,yellow,yellow-green,young	-10,-12,-2,-2/3,/4,0,0-1.5,0-3,0-30,0.1,0.1-0.15,0.1-0.2,0.1-0.25,0.5-1.5,0.8-2,1-3,1-4,1/2,1/3-1/6,2-10,2-3,2-5,2.5-3,2.5-4,4-,4-5-merous,4-6.5,5-30,6-8,7-8,acuminat,alyx,apar,apart,ascendant,ba,blade,branched,branching,brow,concolorous,conical,curved,difoliate,distance,drying,eaf,eed,elongating,equal,extending,eye,faint,flattened,flower,free,geminat,gland,globular,herbaceous,infructescence,lobe,longer,lower,mature,midpoint,midvein,naked,narrow-deltate,narrow-ovate,nflorescence,obovate,older,one,open,orolla,oung,pale,per,perfec,pericarp,porrect,portion,prickl,prickle,ray,reduced,rounded,ruit,scandent,scar,sessile,short,shorter,side,slender,slightly,smooth,sometimes,spaced,stalk,stalked,straight,tamen,tertiary,time,unarmed,unit,usually,variously,vary,venation,visible,woody,yellow-orange,ympodial	acuminate,arrangement,branch,bud,characteristic,colour,corolla,exertion,form,glabrousnes,growth,height,inflorescence,lobing,na,new,ovary,plant,seed,shape,size,stigma,texture,type
545	wfo-0001032595	success	200	123	98	102	25	0.49	-20,-25,0-,0.5-1,0.5-3.5,1-3,1-6.5,1.5-2,1.5-2.5,1.5-4.5,1.5-5,15-25,15-40,25-40,3-10,3-12,3-4,4-7,5-6,6-7,acuminate,acute,along,also,anther,apex,apical,basal,base,branch,branched,brownish-purple,cm,connivent,cordate,cream,deeply,densely,diameter,dull,eglandular,ellipsoidal,entire,finely,flattened,flower,fork,forked,fruit,fusiform,glabrous,gland,glandular,greenish,hair,lanceolate,leaf-opposed,lobe,long,loosely,margin,mature,mm,moderately,oblique,often,ovate,ovoid,pale,pedicel,peduncle,petiole,pilose,prominent,pseudohair,puberulent,pubescent,purplish,rachi,rarely,reniform,rugulose,shrub,simple,small,sparsely,stellate,stigma,style,subcoriaceous,tree,truncate,two,unbranched,violet,white,x,yellow	-pilose,1,1-2,1-2.5,1-6,12-16,2-3,2-4,2.3-24,3-4-foliate,3-5,4-25,4-5,5-merou,9-14,abaxially,accrescen,adaxially,aggregate,alyx,apart,ape,apiculate,articulated,axe,blade,brownish,calyx,cell,ciliat,connective,coriaceous,crow,cucullate,deltate,dense,denser,dilated,directed,distally,eaf,eed,equal,exceeding,filament,free,fruiting,geminate,homostylous,larg,leaving,lon,longitudinal,lower,m.,major,midrib,narrowly,near,nflorescence,opening,orolla,part,pedicellar,per,perfect,pilo,pore,produced,purple,remnant,ruit,shallow,shorter,side,single,slightly,slit,spaced,spreading,stamen,stone,strongly,swelling,tall,tamen,tem,thecae,time,tip,tomentose,toward,triangular,trunk,tube,ud,umbrella-shaped,unit,vary,vein,wide,ympodial	abaxial,adaxial,arrangement,bud,characteristic,colour,corolla,form,growth,height,history,inflorescence,leaf,length,life,ovary,perennial,plant,seed,shape,size,stem,surface,texture,type
