	coreid	status	nwords_original	nwords_result	nwords_recovered	nwords_omitted	nwords_created	prop_recovered	common_words	original_only	result_only
0	wfo-0001025652	success	156	125	88	68	37	0.564	0.5-1,1-1.5,1.5-2,10-20,15-17,15-19,2-5,2-6,20-50,3-3.5,3-5,4-6,4-7,9-11,abruptly,acuminate,acute,anther,anthesi,apex,bark,base,calyx,campanulate,closed,cm,completely,corolla,decurrent,densely,difoliate,elliptic,envelope,filament,fleshy,flower,fruit,furcate,glabrate,glabrous,green,greyish,growth,lateral,leaf,lobed,main,matte,minor,minutely,mm,narrowing,nearly,new,occasionally,opposite,ovoid,pair,paler,papillose,parallel,pedicel,petiole,planar,plant,pore,poricidal,red-papillose,shape,shaped,shiny,shrub,simple,size,small,stem,strongly,tear-drop,tip,tree,tube,unit,vein,white,wing,winged,x,young	.3,.5,1,2-3,3-5-flowered,4,appearing,bilobed,blade,broad,closely,connate,dia,differing,dry,eaf,edicel,eed,emerge,free,geminat,greyi,growing,irregular,like,live,lobe,lon,long,lower,major,margin,middle,minute,nflorescence,older,one,onto,ovary,overlappin,ovoid-reniform,pale,papillae,papillo,pinkish-grey,pitted,portion,rather,ry,scar,soon,spaced,specimen,stigma,straight,style,surface,tall,tan,tapering,tear,thick,thicker,tightly,ud,wider,widest,ympodial	abaxial,adaxial,breeding,cell,colour,connective,form,fruiting,geminate,hair,height,heteromorphism,inflorescence,length,marking,na,number,orientation,placement,position,prickle,pseudostipule,rhizome,seed,spot,staman,stone,structure,symmetry,sympodial,system,texture,tuber,type,venation,width,xylopodia
1	wfo-0001025657	success	239	116	66	173	50	0.276	1-1.6,1.3-2,2-10,2.7-4.3,accrescent,also,anther,apex,articulated,ascending,base,berry,bluish,blunt-tipped,branched,brown,calyx,chartaceous,cm,conical,cordate,corolla,dark,dried,entire,filament,fleshy,fruit,fruiting,hair,leaf,length,light,long,lower,margin,mm,multangulate,oblong,orbicular,pedicel,perfect,persistent,petiole,plurifoliate,pore,poricidal,pseudo-terminal,ray,reportedly,ripe,scented,shrub,simple,somewhat,stellate,stem,strongly,surface,tip,tree,unarmed,unit,white,x,yellow	-2,/3,0.1-0.4,0.2-0.4,0.5-2.5,1-1.1,1-1.3,1-3,1.2-1.5,1.5-1.8,1.7-1.9,12x,2-3.5,2.2-5.5,2.5-9.3,2/3,25-60,3-4,3-4.8,3-6,3.2-6,4-4.4,4-4.5,4-7,5-14,5-16,6-12,6-8,6.5-10,7-27,7-9,7-9.5,8-10.5,8.3-12,abaxially,acute,adaxially,ag,anthesi,apart,apparently,appearing,ark,around,axe,axillary,ba,blade,branch,broadly,bud,capitat,central,closely,cylindrical,deltoid,dendritic-multangulat,dendritic-multangulate,dense,densely,diameter,directed,distally,due,eaf,earl,edge,eed,elliptic,especially,evident,exerted,expanded,exserted,farinose,few-rayed,flower,free,glabrous,glandula,glandular,granular,green,half,inserted,lanate-pubescent,lanceolate,lateral,lengthening,lobe,lobed,long-stalked,longitudinal,m.,magnification,main,midrib,minutely,mixed,narrowly,nearly,nflorescence,obtuse,occasional,often,older,open,orolla,ovat,ovate,ovate-lanceolate,overlapping,pale,part,parted,partly,peduncle,persistently,porrect-stellate,present,pubescence,pubescent,rachi,reticulate-punctate,ruit,semi-ovate,sessile,short,short-,short-stalked,side,slightly,slit,soft,spaced,splitting,stamen,stellate-pubescent,stigma,stipitate-glandular,stipitate-multangulate,style,subcampanulate,subcoriaceous,suborbicular,suture,tall,tamen,tan,terete,thick-stalked,thickened,thin-stalked,time,tomentose,tomentose-pubescent,tomentum,transparent,tube,two-third,ud,unarme,upper,usually,vary,vein,velutinous-pubescent,way,weakly,wide,yellowish,ympodial,young	appressed,articulation,bract,branching,breeding,broad-based,cell,colour,connective,form,growth,heteromorphism,inflated,inflorescence,insertion,interjected,interpetalar,leaflet,marking,mature,modification,na,needle-like,odour,orientation,paired,pattern,placement,position,prickle,pseudostipule,rhizome,scale,shape,smell,spot,staman,stone,structure,symmetry,sympodial,system,texture,tissue,trichome,tuber,type,vegetative,xylopodia,zygomorphy
2	wfo-0001025669	invalid_json	216	124	98	118	26	0.454	'',.5,0-7,0.1-0.3,1,1-2,1-2.2,1-4,1.3-4.2,1.4-2.5,13-35,2-3,2-4,2.2-6,2.4-7,3-5,3-7,4-6,9-24.5,``,abaxially,absent,adaxially,anther,base,blade,blue,broadly,brownish,chartaceous,clavate,cm,condition,corolla,diameter,drying,end,filament,flower,fresh,fruit,glabrous,globose,green,greenish,hair,herb,homostylous,interjected,lanceolate,lateral,leaflet,lengthening,long,membranous,minute,minutely,mm,moderately,monochasium,mottled,obovate,odd-pinnate,one,orbicular,ovoid,pair,pedicel,peduncle,placed,plant,pore,poricidal,puberulent,pubescent,purple,rarely,ripe,scale-like,seed,size,slightly,slit,sometimes,stem,stigma,streaked,style,subglabrous,terminal,tinged,tip,tuber,typically,white,whitish,wide,x	0-1,0-5,0.8-2.4,1-10,1-3,1.6-4.4,2,2.2-6.5,5-merou,absen,acumen,acuminate,acute,ag,along,alyx,apart,apex,apparently,articulation,axe,berry,capitat,cell,ciliate,clearly,connivent,contracted,covering,cuneate,decurrent,digestion,discussion,distal,distinct,dorsally,eaf,edge,eed,elliptic,enzyme,erec,especially,exceeding,except,extra,flat,flowered,folded,forming,geminat,glabrou,greatly,green-white,hair-like,half,highly,honeycomb-shaped,larger,like,living,lobe,lower,make,margin,midrib,mucilaginous,multicellular,near,nflorescence,oblique,obtuse,often,orolla,ovate,perfect,petiole,petiolulate,petiolule,plurifoliate,proximal,reduced,removed,rosette,rotate,rounded,ruit,see,sessile,seudostipule,short,single,spaced,species,specimen,stamen,ste,stolo,straight,subequal,tall,tamen,tem,testal,thick,throughout,tri-,truncate,tube,unbranched,unequal,unit,unwinged,vary,wall,wet,yellow,ympodial	'extra,[,],age,arrangement,calyx,capitate,characteristic,colour,form,growth,height,inflorescence,leaf,length,ovary,placement,pseudostipule,shape,staman,stolon,texture,type,value,{,}
3	wfo-0001025697	invalid_json_followup	181	168	116	65	52	0.641	-9,0-14,0.15-0.75,0.8-2,1-1.7,1-2,1-3,1.7-8.6,10-26,2-4,2-6,25-35,3-10,3-4,3-5,3-6,5.5-11.5,abaxially,acumen,acuminate,acute,adaxially,anther,apex,asymmetric,attenuate,base,basiscopic,berry,blade,blue,brownish,cell,clavate,cm,condition,connivent,coriaceous,corolla,dark,decurrent,deep,diameter,digestion,distal,dorsally,drying,edge,elliptic,enzyme,filament,flat,flower,folded,forked,fresh,fruit,glabrescent,glabrous,globose,green,greenish,hair,half,herb,high,homostylous,honeycomb-shaped,interjected,lanceolate,lateral,leaf,leaflet,lengthening,light,lilac,lobe,medium,mm,odd-pinnate,ovate,ovoid,pair,pedicel,peduncle,pentagonal,perfect,petiole,plant,pore,poricidal,purple,rachi,removed,ripe,rotate,rounded,seed,sessile,short,side,slightly,slit,stigma,straight,stripe,style,terminal,testal,tip,tissue,tube,typically,wall,whitish,yellow	0.6-3.5,1.5-1.8,2-10.5,2-2.6,3.3-11,4-7.5,5-merou,6.5-13.5,adaxiall,ag,alyx,apart,apparently,articulated,axe,axillary,bud,capitat,covering,decreasing,eaf,eed,erec,exceeding,geminat,generally,glabrou,green-white,hair-like,hal,linear,living,long,lower,make,mucilaginous,nflorescence,orbicular,orolla,petiolulate,plurifoliate,ruit,seudostipule,size,spaced,specimen,stamen,subequal,subglabrou,subtending,tall,tamen,tem,thick,throughout,toward,tri-,unit,unwinged,usually,vary,wet,wood,x,ympodial	'',[,``,abaxial,adaxial,age,appressed,arrangement,articulation,asymmetry,bract,branching,breeding,calyx,capitate,characteristic,colour,connective,connivence,decurrency,form,fruiting,growth,height,inflated,inflorescence,length,marking,mature,modification,na,number,ovary,pattern,position,pseudostipule,scale,shape,spacing,spot,staman,stem,subglabrous,symmetry,system,texture,trichome,type,value,woody,{,}
4	wfo-0001025699	success	181	120	70	111	50	0.387	1-1.5,1-2.5,1-3,1.5-2,1/3,4-5,5-winged,acute,age,anther,apex,appearing,attenuate,base,becoming,berry,branching,calyx,cm,corolla,cup-shaped,difoliate,ellipsoid,entire,filament,fruiting,glabrous,globose,green,growth,inflorescence,leaf,leaf-opposed,leafy,lengthening,lobe,lobed,lower,margin,markedly,midrib,minutely,mm,papillose,pedicel,perfect,petiole,plurifoliate,pore,poricidal,reticulate-pitted,rounded-sagittate,shoot,short,simple,slightly,slit,somewhat,stem,surface,tangled,time,tip,tree,trichome,unit,way,white,x,Â½	.2,.5,0.5,1,1-2,1.5,10,15-20,2,2-2.5,2-6,2cm,3-15,3-3.5,3-5.5,3-8,499,5-8,5.5-14,8-9,abaxially,absent,adaxially,almost,anthesi,apart,apparently,articulating,bark,brown,c.,campanulate,capitate,completely,conical,conspicuously,continuing,corrugate,crystal,dark,darker,deltate,densely,diameter,dorsal,dry,drying,eaf,eed,elliptic,erect,exerted,face,fide,flower,free,glabrou,grey-brown,immature,included,inclusion,inflorescenc,irregularly,lanceolate,leaving,less,narrowly,new,nflorescence,nodding,older,one,onto,ovary,oxalate,pair,pale,papillat,peduncle,peg,penden,per,portion,primary,red,reddish,reniform,rounded,ruit,sand,scar,small,spaced,stearn,stigma,straight,strongly,style,thickened,triangular,tube,ud,vein,white-spotted,wide,wing,winged,woody,yellow,ympodial,young	appressed,articulation,bract,breeding,broad-based,cell,colour,connective,corrugated,form,fruit,hair,heteromorphism,inflated,insertion,interjected,interpetalar,leaflet,length,marking,mature,modification,na,needle-like,odour,orientation,paired,pattern,placement,position,prickle,pseudostipule,rhizome,scale,shape,smell,spot,staman,stone,structure,symmetry,sympodial,system,texture,tissue,tuber,type,vegetative,xylopodia,zygomorphy
5	wfo-0001025700	invalid_json_followup	189	161	101	88	60	0.534	0-16,0.30-2.0,0.5-2,0.7-2.7,0.8-2.6,1-3,1.5-2,10-40,10.5-12,2-7,2.5-4,3-8,3.5-10.5,4-5,5-15,5-20,5.3-17.5,5.5-18,5.5-8,9-31,abaxially,acumen,adaxially,anther,apex,attenuate,base,berry,blade,brownish,cell,chartaceous,clavate,cm,condition,corolla,covering,diameter,distal,dot,drying,filament,flower,forked,fresh,fruit,glabrescent,glabrous,globose,green,greenish,hair,hair-like,half,herb,high,homostylous,interjected,lanceolate,lateral,leaf,leaflet,lilac,lobe,long,lower,medium,mm,narrowly,odd-pinnate,ovoid,pair,pedicel,pentagonal,petiole,plant,pore,poricidal,purple,ripe,rotate-pentagonal,rounded,seed,short,size,sometimes,stigma,straight,style,terminal,testal,thick,tip,tissue,tube,unwinged,wall,white,whitish,winged,x	0.8-4,1-2,1.1-2.3,15-40,2-12,3-4,3.7-8.6,5-merou,acuman,acuminate,acute,ag,alyx,apiculate,apparently,articulated,asymmetric,axe,axillary,basal,basiscopic,bud,capitat,connivent,considerably,decrease,decreasing,digestion,dorsally,eaf,edge,eed,elliptic,enzyme,erec,exceeding,except,flat,folded,geminat,generally,glabrou,green-white,hal,honeycomb-shaped,larger,lengthening,light,linear,living,make,mucilaginous,nflorescence,orbicular,orolla,ovate,par,peduncle,perfect,petiolulate,plurifoliate,proximal,removed,ruit,sessile,seudostipule,side,slightly,slit,specimen,stamen,subequal,subglabrou,subtending,tall,tamen,tem,throughout,toward,tri-,typically,unit,usually,vary,wet,whose,yellow,ympodial	'',[,``,abaxial,adaxial,appressed,arrangement,articulation,bract,branching,breeding,broad-based,calyx,capitate,characteristic,colour,connective,form,fruiting,growth,hairines,height,inflated,inflorescence,insertion,interpetalar,length,margin,marking,mature,modification,na,needle-like,number,odour,orientation,ovary,paired,pattern,position,prickle,pseudostipule,scale,shape,smell,spot,staman,stem,subglabrous,surface,symmetry,system,texture,trichome,type,value,vegetative,winging,{,}
6	wfo-0001025704	success	248	105	61	187	44	0.246	0.5-1.5,1/2-4/5,4.5-6.5,anther,apex,articulated,auriculate,base,berry,branched,calyx,cell,chartaceous,connivent,cordate,discolorous,drying,ellipsoid,erect,evenly,filament,fruit,fruiting,green,green-yellow,lateral,leaf,length,lobed,lower,margin,mature,maturity,mauve,mm,pedicel,petiole,poricidal,prickle,rarely,shape,shrub,small,sometimes,spherical,stellate,stem,strongly,surface,tapering,terminal,tip,tree,trichome,truncate,unbranched,unit,way,white,yellow,young	-10,-2,-3,-5,/6,0,0-100,0-2,0-3.5,0-5,0.1,0.1-0.3,0.1-0.5,0.15-0.8,0.3-0.8,0.7-1,1,1-3.5,1-4,1-6,1.2-3,1.5-2,1.5-3.2,1.5-4.5,1.8-3.5,1/4-3/4,1/5,2,2-10,2-3,2-4.5,2-5,2-7,2.5-4.5,2.7-4,3-10,3-15,3-5,3-6,4-12,4-5,5-20,5-merous,6-12,6-15,8-12,8-15,8-17,abaxial,abaxially,acute,adaxial,age,almost,alyx,andromonoecious,apar,apart,apically,apiculate,apparently,axe,ba,bark,blade,broad-deltate,brow,cm,covering,curved,deltate,densely,development,diameter,distal,distance,eaf,eed,elliptic,elongating,end,equal,extending,flattened,flattened-reniform,flower,free,glabrescent,glabrous,gray,half,hermaphrodite,heterostylous,infructescence,irregular,less,lobe,lobing,long,long-styled,longer,lowermost,midpoint,midvein,moderately,multangulate,near,nflorescence,obtuse,occasionally,often,older,one,open,orange,orange-brown,orolla,oung,outline,ovate,pair,pale,peduncle,pendulous,per,pericarp,pit,plant,plurifoliat,porrect,portion,prickl,prickly,primary,prominent,raised,ray,recurved,red-brown,red-green,reflexed,retaining,round,rounded,ruit,scar,secondary,sessile,short-styled,shorter,side,slender,smooth,somewhat,spaced,sparsely,spreading,stalk,stalked,staminat,stellate-pubescen,stellate-pubescent,stout,straight,style,tamen,terete,tertiary,throughout,time,tube,unarmed,upper,variously,vary,vein,venation,visible,warty,white-gray,wide,widening,woody,yellow-green,yellowish,ympodial,Ã	appressed,articulation,bract,branching,broad-based,colour,corolla,form,growth,hair,heteromorphism,inflated,inflorescence,insertion,interjected,interpetalar,leaflet,marking,na,needle-like,odour,orientation,paired,placement,plurifoliate,position,present,pseudostipule,rhizome,scale,smell,spot,staman,stone,structure,symmetry,sympodial,texture,tissue,tuber,type,vegetative,xylopodia,zygomorphy
7	wfo-0001025729	success	177	136	85	92	51	0.48	/4,0.25-0.5,0.7-1.2,1-1.5,1-5,1.1-1.5,4-5,4-8,9-17,abaxially,acute,adaxially,anther,anthesi,apex,axil,bark,base,black,blackish,calyx,cm,corolla,cyathiform,deflexed,dia,difoliate,dirty,drying,elliptic,filament,flattened-reniform,fruiting,furcate,glabrous,globose,green,greenish-yellow,greyish-brown,lateral,leaf,like,live,lobed,long,main,margin,mm,oblique,occasionally,opposite,ovary,pale,pedicel,petiole,pitted,plant,pore,ripening,rounded,shaped,shiny,short,simple,size,stem,stigma,stout,style,surface,tear-drop,tree,treelet,trichome,tube,tuft,uniseriate,unit,usually,vein,way,white,woody,x,yellow	-20,.5,1.2-1.8,1.5-2,1.75,2,2-3.5,20,3-6,5-50-flowered,6-8,7-8,abaxial,abrupt,along,apar,apical,apiculate,appearing,basal,berry,branched,bright,bristly,bud,covered,covering,dark,deltoid,densely,denser,diam,differing,eaf,edicel,eed,enclosed,expanded,f,fleshy,free,geminat,gently,glabrou,growing,incrassate,lamina,lat,lobe,lon,lower,m.,mainly,major,member,middle,minor,minute,minutely,nflorescence,often,older,one,overlapping,overtopping,pair,papillo,papillose,partially,pit,poricidal,portion,prominent,pubescent,quite,raised,reflexed,ruit,scar,sparsely,straight,tall,tapering,terminal,tip,touching,tub,ud,widening,widest,ympodial,young	4-20,5-50,articulation,bract,branching,breeding,cell,colour,connective,flower,form,fruit,geminate,growth,hair,height,heteromorphism,inflorescence,insertion,interjected,interpetalar,leaflet,length,marking,mature,modification,na,number,odour,orientation,pattern,placement,position,prickle,pseudostipule,rhizome,scale,seed,shape,spot,staman,stone,structure,symmetry,sympodial,system,texture,tissue,tuber,type,xylopodia
8	wfo-0001025749	success	217	114	63	154	51	0.29	0-5,0.1-0.4,0.2-1.5,0.5-0.8,2.5-6,6-8,anther,apex,apparently,articulated,base,berry,branched,calyx,chartaceous,cm,cuneate,curved,difoliate,elongating,equal,filament,flattened,fruit,fruiting,gently,lateral,leaf,length,lobed,long,lower,margin,markedly,mature,mauve,mm,moderately,narrow-deltate,orange-red,pedicel,petiole,poricidal,porrect,prickle,rarely,rounded,sessile,shrub,sparsely,spherical,spreading,stalked,stellate,stellate-pubescent,stem,straight,surface,tapering,tip,trichome,unit,white	-1,-12,.5,/5,0-10,0-3,0-6,0-8,0.1,0.1-0.2,0.1-0.3,0.2,0.3-1.5,0.4-0.7,0.5,0.5-0.9,0.5-1.3,0.5-3,0.6-4.5,0.8-0.9,1,1-10,1-13,1-2,1-3,1-6,1-8.5,1-9,1.5,1.5-2,1.5-2.5,1/4-1/3,1/5-1/2,2-10,2-2.5,2/3,3-20,3-5,4-8,5-,5-10,5-20,5-merous,abaxial,abaxially,acuminat,acute,adaxial,adaxially,adnate,almost,alyx,apar,apart,apically,bark,blade,broad-deltate,concolorous,dark,densely,diameter,discolorous,distance,drying,dull,eaf,eed,erect,extending,filiform,flattened-reniform,flower,free,geminat,glabrescent,glabrous,gray,green-brown,herbaceous,indistinct,infructescence,light,lobe,lon,long-ovate,longer,magnification,maturity,midpoint,midvein,narrow-ovate,nflorescence,oblong,obtuse,occasionally,older,one,open,orange-brow,orange-brown,orbicular,orolla,oung,ovate,pair,pale,peduncle,pendulous,per,perfec,pericarp,portion,prickl,prickly,primary,procumbent,purple,ray,recurved,red-brown,reduced,ruit,scar,shorter,side,smooth,sometimes,spaced,stalk,straw-yellow,strongly,style,tamen,terete,tertiary,time,toward,tube,usually,variously,vary,vein,venation,visible,way,wide,without,yellow,yellow-green,yellow-orange,yellowish,ympodial,Â½-2/	appressed,articulation,bract,branching,breeding,broad-based,cell,colour,connective,corolla,form,geminate,growth,hair,heteromorphism,inflated,inflorescence,insertion,interjected,interpetalar,leaflet,marking,modification,na,needle-like,odour,orientation,paired,pattern,perfect,placement,position,pseudostipule,rhizome,scale,shape,smell,spot,staman,stone,structure,symmetry,sympodial,system,texture,tissue,tuber,type,vegetative,xylopodia,zygomorphy
9	wfo-0001025754	invalid_json_followup	164	149	88	76	61	0.537	-celled,.5,0.5-1,0.5-1.5,1,1-2,1-3,1.5,1.5-3,10-20,10-35,3-6,4,5-15,abundant,acuminate,acute,anther,apex,asymmetrical,base,berry,brown,calyx,center,chartaceous,ciliate,cm,cordate,cordiform,decumbent,decurrent,densely,dm,drying,edge,eglandular,entire,filament,fine,flower,fruit,glabrous,globose,hair,herb,immature,interpetalar,leaf,lobe,long,lower,margin,maturing,membranaceous,mm,moderately,much-branched,nearly,oblong,often,parallel,pedicel,per,petiole,pubescent,radiating,raised,ridge,rotate,running,semitransparent,shallow,slightly,solitary,sparsely,stem,surface,tissue,triangular,truncate,tube,unbranched,upright,white,woody,x,yellow	0.1-0.2,1-3.5,1.5-4,2-4,2-5-celled,2-7,2-foliate,3-10,3-5,4-6,5-12,abaxially,absent,adaxiall,adaxially,along,axe,barely,beyond,blade,branch,connected,dehiscing,denser,diameter,dried,eaf,eed,emarginat,equal,erect,explosively,exserted,flat,geminat,glandular,held,leaving,like,linear-lanceolate,lying,main,material,maturit,mesocarp,mixed,nfloresence,notch,orolla,palmately,peduncle,penden,placenta,pressure,probably,pubescen,rachi,ruit,short,small,sometimes,stamen,stigma,straight,style,swollen,tal,tamen,tem,unit,vary,vein,visible,watery,wid,ympodial	'',[,``,abaxial,adaxial,appressed,arrangement,articulation,bract,branching,breeding,broad-based,character,characteristic,colour,connective,corolla,emarginate,form,fruiting,geminate,growth,height,inflated,inflorescence,insertion,interjected,leaflet,length,marking,mature,modification,na,needle-like,number,odour,orientation,paired,pattern,pendent,placement,plant,pore,position,prickle,scale,seed,shape,smell,spot,stellate,symmetry,system,texture,trichome,type,value,vegetative,zygomorphy,{,}
10	wfo-0001025760	success	210	109	62	148	47	0.295	-6,0.4-0.8,1-4,2.3-4,anther,apex,apparently,articulated,base,berry,calyx,chartaceous,cm,cream,cuneate,curved,dark,difoliate,equal,filament,fruit,fruiting,geminate,gently,green,hair,herb,lateral,leaf,length,lobed,long,margin,marking,mature,maturity,membranous,mm,orange,pale,pedicel,petiole,poricidal,porrect,rounded,sessile,shape,shrub,spherical,stalked,stellate,stem,subentire,tapering,tip,unarmed,unbranched,unit,usually,weakly,white,young	-10,-12,-3,-5,.5,/3,0-0.5,0-100,0.1,0.1-0.2,0.15-0.3,0.2-0.35,0.3-1,0.45-0.9,0.5-1.5,0.5-2,0.7-2.5,0.8-1.8,1,1-,1-1.8,1-2,1.5,1.5-2.5,1.5-4.5,1.5-5,1/4,1/4-1/2,1/4-1/3,1/5,2-2.5,2-3,2.1-3.5,2.5-10,2.5-8,2/3,3,3-6,3.5-17,3.5-9,5-10-merous,5-18,8-10,abaxial,abaxially,acut,acute,adaxial,almost,alyx,annual,apar,apically,bark,black,blade,broad-deltate,brow,concolorous,connivent,cultivar,deltate,diameter,discolorous,distance,drying,dull,eaf,eed,elliptic,elongating,erect,extending,flattened-reniform,flower,free,geminat,glabrescent,glabrous,infructescence,lengt,lobe,longer,lower,midpoint,midvein,minute,moderately,nflorescence,often,older,one,open,orange-brown,orolla,oung,ovate,pair,peduncle,pendulous,per,perennial,perfec,pericarp,portion,primary,ray,recurved,red-brown,reflexe,ruit,scar,shorter,side,simple,slender,smooth,sometimes,spaced,spreading,stalk,stellate-pubescen,stellate-pubescent,stout,straight,style,surface,tamen,terete,tertiary,thick-stalked,time,trichome,tube,unarme,upper,various,variously,vary,vein,venation,visible,way,wide,woody,yellow,yellow-green,ympodial	appressed,articulation,bract,branching,breeding,broad-based,cell,colour,connective,corolla,form,growth,heteromorphism,inflated,inflorescence,insertion,interjected,interpetalar,leaflet,modification,na,needle-like,odour,orientation,paired,pattern,perfect,placement,pore,position,prickle,pseudostipule,reflexed,rhizome,scale,spot,staman,stone,structure,symmetry,sympodial,system,texture,tissue,tuber,type,xylopodia
11	wfo-0001025782	success	200	106	56	144	50	0.28	0.4-0.6,1.2-6,4-4.5,andromonoecious,anther,apex,base,berry,calyx,chartaceous,cm,conical,connivent,cuneate,curved,difoliate,elongating,equal,evenly,filament,flattened,fruit,fruiting,geminate,gently,green,hair,lateral,leaf,length,lobed,long,lower,margin,mature,membranous,mm,pedicel,petiole,poricidal,porrect,prickle,sessile,shrub,sparsely,spherical,stellate,stellate-pubescent,stem,surface,tapering,trichome,unbranched,unit,white,yellow	-2,.5,0-10,0-5,0.1-0.15,0.1-0.2,0.1-0.25,0.3-1,0.5-1,0.55-0.75,0.9-1.3,1,1-1.7,1-2,1-2.5,1-4,1.3-1.6,1.5-3,1/4-1/2,1/4-1/3,1/6,10-13,2-10,2-2.5,2-3,2-5,2-7,2.5-3.5,2/3-3/4,20,3-4,3-5,4,4.5-9,5-20,5-6.5,5-8,5-merous,5.5-6,6-14,6-8,abaxial,abaxially,acuminat,acuminate,adaxial,also,alyx,apar,apart,apically,apparently,articulated,bark,blade,brown,climbing,concolorous,deltate,densely,diameter,discolorous,distal,distance,drying,dull,eaf,eed,elliptic,elongated,extending,flattened-reniform,flower,free,geminat,glabrescent,glabrous,green-brown,hermaphrodite,heterostylous,infructescence,lengt,less,lobe,long-styled,longer,lowermost,maturity,midpoint,midvein,minute,moderately,nflorescence,occasionally,older,one,open,orange-brown,orolla,oung,pair,peduncle,pendulous,per,pericarp,plant,portion,prickl,prickly,primary,ray,red-brow,reduced,ruit,scar,short-styled,shorter,side,simple,smooth,spaced,spreading,staminat,stout,straight,style,tamen,terete,tertiary,time,tip,toward,tube,vary,vein,venation,visible,way,weakly,wide,woody,yellow-green,ympodial,young	appressed,articulation,bract,branching,breeding,broad-based,cell,colour,connective,corolla,form,growth,heteromorphism,inflated,inflorescence,insertion,interjected,interpetalar,leaflet,marking,modification,na,needle-like,odour,orientation,paired,pattern,placement,pore,position,present,pseudostipule,rhizome,scale,shape,smell,spot,staman,stone,structure,symmetry,sympodial,system,texture,tissue,tuber,type,vegetative,xylopodia,zygomorphy
12	wfo-0001025783	invalid_json	179	135	100	79	35	0.559	.5,0.5,0.5-1,0.5-1.5,0.8-3.5,1-1.2,1-1.5,1-3,1.8-2,2,2-3+,2-5,2-6.5,5,7-10,<,abaxially,acute,anther,anthesi,apart,apex,base,branching,brown,bud,c.,calyx,cluster,cm,coriaceous,corolla,dendritic,diameter,ellipsoid,elliptic,entire,expanded,exserted,flattened,fleshy,flexuous,flower,fruiting,glabrous,globose,greyish,growth,inserted,known,lateral,less,lobed,long,margin,minutely,mm,narrowly,new,number,obtuse,pale,pedicel,peduncle,petiole,pitted,pubescent,purple,reniform,revolute,ripe,sagittate,scar,shiny,shoot,short,shrub,simple,sleeve,slightly,sometimes,somewhat,sparse,sparsely,stellate,stem,strongly,surface,suture,terminal,thin,time,trichome,truncate,type,uniseriate,vine,violet,way,within	3-4,5-merou,abaxiall,adaxiall,adaxially,along,alyx,ape,ark,articulated,axil,berry,branched,cell,completely,confined,conical,densely,eaf,eed,erect,exposed,filiform,free,glabrou,green,groove,hromosome,ilament,keeled,lax,lobe,long/tall,lower,mature,midrib,midvein,minute,mmm,near,nflorescence,nodding,obscured,occasionally,older,orolla,outlin,pair,penden,pentagonal,perfect,pericarp,plurifoliat,point,portion,possibly,primary,ruit,scarious,see,spaced,stigma,style,testal,transparent,triangular,tube,tuft,twinin,ud,unit,upper,vary,vein,weak,wide,woody,yellowish,ympodial	'',3,[,``,abaxial,adaxial,arrangement,articulation,bark,characteristic,chromosome,colour,dense,exsertion,filament,form,fruit,glabrousnes,height,inflorescence,leaf,length,ovary,plant,position,seed,shape,spacing,texture,thicknes,value,width,ye,{,}
13	wfo-0001025788	invalid_json_followup	158	158	94	64	64	0.595	0.5-2,1-4,1-5,1.8-2.7,1.8-3.9,10-24,14-48,15-30,2-10,2-13,2-3,2-5,2.8-9.5,4-5.5,4.5-10.1,4.5-12.5,5-8,6.2-12.5,8-38,acute,apex,apical,apically,base,blue,branched,calyx,cm,conical,connate,corolla,cuneate,cyme,deep,dehiscent,diameter,dichasial,dichasially,distal,dorsally,edge,filament,finely,flat,flower,folded,green,hair-like,herbaceous,interjected,introrse,lateral,leaf,leaflet,lobe,long,long-attenuate,maturing,medium,mm,monochasial,mucilaginous,oblique,obtuse,odd-pinnate,often,ovoid,pattern,pedicel,peduncle,perennial,perfect,petiole,plant,poricidally,proximal,pubescent,purple,rotate,rounded,seed,short,slit,stigma,straight,style,terminal,throughout,tip,tuber-bearing,unit,wall,yellow,Â¼	-8,0-6,2m,3-,3-6-foliat,4-3.,6-7,abaxiall,abaxially,acumen,acuminate,adaxially,articulate,attenuate,cell,covering,digestion,diminishing,eaf,ebracteate,eed,elliptical,emoval,enzyme,exceeding,forked,generally,globo,gradually,green-white,half,honeycomb,living,lon,lower,lunat,make,narrowly,nflorescence,nther,orolla,ovate,pair,petiolule,plan,reveal,ruit,sessile,seudostipule,size,specimen,stamen,subequal,subsessile,tal,tem,testal,thick,throughou,toward,typically,vary,wide,ympodial	'',3-6-foliate,4-31,[,``,anther,appressed,arrangement,articulation,bract,branching,breeding,characteristic,colour,connective,ebbrate,form,fruit,fruiting,globose,growth,hair,height,inflated,inflorescence,insertion,interpetalar,length,lunate,margin,marking,mature,modification,na,number,odour,orientation,ovary,paired,perfection,placement,pore,position,presence,present,prickle,pseudostipule,scale,shape,spot,stem,structure,symmetry,sympodial,system,texture,tissue,type,value,wet,width,zygomorphy,{,}
14	wfo-0001025792	success	203	120	102	101	18	0.502	0.4-0.7,1-2,1-3,2-11,2-3,2.5-4,3-5,3.5-6,4-12,4-6,5,5-10,5-6,5-9,7-10,8-10,9-12,abaxially,adaxially,along,anther,auriculate,blade,blue-mauve,blue-purple,brownish,cell,chartaceous,ciliate,cm,condition,corolla,dark,densely,diameter,digestion,dorsally,drying,edge,elliptic,enzyme,especially,filament,flat,flower,folded,forked,fresh,fruit,glabrous,globose,green,greenish,hair,hair-like,herb,homostylous,honeycomb-shaped,interjected,lanceolate,lateral,leaflet,lengthening,like,lobe,long,margin,mauve,membranous,midrib,minute,minutely,mm,narrowly,odd-pinnate,ovoid,pair,petiole,plant,pore,poricidal,puberulent,pubescent,purple,removed,ripe,rotate-pentagonal,seed,size,slit,stem,stigma,streak,terminal,testal,tinged,tip,tube,wall,white,whitish,x	1-10,1-4,10-15,2-3.5,2.5-3.5,21-28,3-4,4.5-7,5-merou,7.5-8,acumen,acuminate,acute,ag,alyx,apart,apex,apparently,articulated,articulation,axe,axillary,base,basiscopic,berry,broadly,bud,capitat,connivent,covering,decurrent,developing,distal,distinct,distinctly,eaf,eed,exceeding,except,geminat,generally,glabrou,greatly,green-white,hal,half,high,indistinct,living,lower,make,mottle,mucilaginous,narrow,nflorescence,oblique,often,onto,orolla,papillose,pedicel,peduncle,perfect,petiolulate,plurifoliate,proximal,rachi,reduced,rounded,ruit,semi-erec,semi-rosette,sessile,seudostipule,short,shortly,side,slightly,spaced,specimen,stamen,ste,straight,style,sub-rosette,subequal,subtending,tall,tamen,tem,thick,throughout,tri-,unit,usually,vary,wet,wing,yellow,ympodial,young	5-merous,age,arrangement,branching,calyx,capitate,colour,form,growth,height,inflorescence,leaf,length,pseudostipule,shape,staman,texture,type
15	wfo-0001025804	invalid_json_followup	155	180	121	34	59	0.781	.25,.5,0.5-1,1-1.5,1-3,1.2-1.5,1.4-1.7,1.5-2,11-20,16-35,2-2.5,2.5-4,3-4.5,3.5-12,4-10,6-8,7-10,?,abaxially,acute,adaxially,age,anther,anthesi,apex,apiculate,attenuate,bark,base,berry,bilobed,branched,calyx,clavate,cm,conical,corolla,covered,cream,cucullate,dark,decurrent,densely,dia,ellipsoid,elliptic,erect,exserted,filament,flattened,fleshy,fruiting,glabrous,glandular,globose,green,incrassate,internodal,lateral,leaf,lengthening,light,lobe,lobed,long,main,major,many,margin,mere,middle,minor,minute,minutely,mm,nearly,obovate,occasionally,often,onto,opposite,ovary,pair,paler,papillae,papillate,papillose,pedicel,pitted,planar,pore,poricidal,projection,red,reddish-brown,regularly,reniform,rim,scar,sessile,shrub,size,slit,somewhat,spaced,stem,stigma,strongly,style,surface,thick,time,tip,tube,vein,white,whitish-green,widest,winged,x,young	10-20,5,apar,ape,ba,c.,deflexed,differing,difoliate,drying,eaf,edicel,eed,flower,free,geminat,later,lower,near,nflorescence,older,papillat,plurifoliate,portion,red-papillose,reddish-brow,ruit,tall,tub,ud,unit,wing,woody,ympodial	'',[,``,apart,articulation,bract,branching,breeding,bud,cell,characteristic,colour,connective,diameter,exsertion,form,fruit,growth,hair,height,heteromorphism,inflorescence,insertion,interjected,interpetalar,leaflet,length,marking,mature,modification,na,odour,orientation,part,pattern,petiole,placement,plant,position,prickle,pseudostipule,rhizome,scale,seed,shape,spot,staman,state,stone,symmetry,system,texture,thicknes,tissue,type,value,ye,{,}
16	wfo-0001025813	invalid_json	197	102	77	120	25	0.391	'',0-2,1.2-4.5,1.3-7,1.5-1.8,1.5-6.5,15-30,2-5,3-3.5,3-4,3-5,3-6,3-7,5-18.5,5-6,``,abaxially,absent,adaxially,anther,base,blade,blue,borne,brownish,chartaceous,cm,condition,corolla,dark,densely,diameter,drying,end,flower,fresh,fruit,globose,green,greenish,hair,herb,homostylous,interjected,lanceolate,lateral,leaflet,light,long,membranous,minute,mm,monochasium,odd-pinnate,ovoid,pair,pedicel,peduncle,pilose,pore,poricidal,pubescent,rarely,seed,singly,size,stem,strongly,style,terminal,tip,tuber,typically,violet,white,whitish,x	0.7-1.7,1-1.5,1-10,1-2,1-4,1.5-2,2-3,2-4,5-merou,6-7,acumen,acuminate,acute,ag,along,alyx,apart,apex,apparently,articulated,axe,berry,broadly,cell,ciliate,connivent,contracted,covering,cuneate,decreasing,decurrent,digestion,discussion,distal,distinct,dorsally,eaf,edge,eed,elliptic,enzyme,especially,exceeding,extra,filament,flat,folded,geminat,glabrou,glabrous,green-white,hair-like,half,highly,honeycomb-shaped,larger,lengthening,like,living,lobe,longer,lower,make,margin,midrib,minutely,mucilaginous,near,nflorescence,obtuse,often,orbicular,orolla,ovate,ovoi,perfect,petiole,petiolulate,plant,plurifoliate,puberulent,rachi,removed,rosette-formin,rotate,ruit,see,sessile,seudostipule,short,single-flowered,slit,sometimes,spaced,species,specimen,stamen,ste,stigma,stolo,straight,suborbicular,tamen,tem,testal,thick,thir,throughout,toward,tri-,tube,unforked,unit,unwinged,vary,vein,wall,wet,yellow,ympodial	'extra,[,],arrangement,calyx,characteristic,colour,form,formation,growth,inflorescence,leaf,length,presence,pseudostipule,pubescence,rosette,rosette-forming,shape,stolon,texture,type,value,{,}
17	wfo-0001025825	invalid_json_followup	187	146	92	95	54	0.492	0-0.21,0.4-1,0.5-10.4,0.9-2,1-2,1-3,1-5.5,10-24,10.5-26,14-85,2-3.7,22-86,3-10,3-5,3.7-6.5,4-8,4-9,5-7,6-10,6.6-14,anther,apex,base,berry,blade,brownish,clavate,cm,condition,coriaceous,corolla,dark,diameter,distal,drying,elliptic,filament,flower,forked,fresh,fruit,glabrescent,glabrous,green,greenish,hair,half,herb,high,homostylous,interjected,lanceolate,lateral,leaf,leaflet,light,lilac,lobe,medium,mm,mucilaginous,odd-pinnate,ovate,ovoid,pair,pedicel,peduncle,pentagonal,petiole,petiolulate,plant,pore,poricidal,rotate-pentagonal,seed,sessile,shiny,short,size,stigma,straight,streak,style,terminal,tip,tissue,tube,wet,white,whitish,wing,x	0.4-3,0.5-0.8,0.7-2.2,0.9-4,1.1-1.4,2-5,3-8.5,5-10,5-merou,abaxially,acumen,acuminate,acute,adaxiall,adaxially,ag,alyx,apart,apparently,articulated,asymmetric,attenuate,axe,axillary,back,basiscopic,bud,capitat,cell,connivent,covering,cuneate,decreasing,decurrent,digestion,dorsally,eaf,edge,eed,enzyme,erec,exceeding,flat,folded,geminat,generally,glabrou,green-white,hair-like,hal,honeycomb-shaped,increasing,lengthening,living,long,lower,make,middle,nflorescence,orbicular,orolla,perfect,plurifoliate,rachi,removed,rounded,ruit,seudostipule,side,slightly,slit,smaller,spaced,specimen,stamen,subequal,subglabrou,subtending,tall,tamen,tem,testal,thick,throughout,toward,tri-,unit,unwinged,usually,vary,wall,wide,winged,yellow,ympodial	'',[,``,abaxial,adaxial,appressed,arrangement,articulation,bract,branching,breeding,calyx,capitate,characteristic,colour,connective,form,fruiting,growth,height,inflated,inflorescence,insertion,interpetalar,length,margin,marking,mature,modification,na,number,odour,orientation,ovary,paired,pattern,placement,position,prickle,pseudostipule,scale,shape,spot,staman,stem,subglabrous,symmetry,system,texture,type,value,width,{,}
18	wfo-0001025838	success	217	161	110	107	51	0.507	.5,0.5-1,0.7-2,1-1.2,1-1.5,1.5-3.5,1.5-5,2-5,2/3,4-15,4.5-5.5,acuminate,anther,apart,apex,articulated,attenuate,base,berry,black,branch,branched,brown,calyx,cell,clustered,cm,connivent,corolla,dark,dendritic,dense,densely,diameter,ellipsoidal,elliptic,entire,filament,fleshy,flower,fruit,fruiting,glabrous,globose,greenish,growth,inflorescence,inserted,irregularly,lanceolate,lateral,leaf,lengthening,like,lobed,loosely,lower,many,margin,membranous,mm,mostly,narrowly,often,onto,ovoid,pedicel,peduncle,perfect,petiole,platform,pointed,pore,poricidal,pubescent,purple,reddish,revolute,ripe,scar,shiny,short,shrub,simple,sleeve,slightly,slit,small,sometimes,spaced,sparsely,stellate,stem,surface,terminal,time,tinged,tip,tree,trichome,tuft,turbinate,uniseriate,unit,upper,way,white,winged,x,Â¾	-20,0.5,1.2-5,1.5-1.7,1.5-2,1.5-2.5,1.8-2,10-15,10-60,2-2.5,2.5-3,20-40,3.5-,5,5-merou,6-15,6.5-7,abruptly,adaxial,adaxially,ag,along,alyx,anthesi,apiculate,appearing,archin,ark,axil,basall,broad,capitate,clavate,cucullate,cup-shaped,decurrent,denser,disintegrating,drying,eaf,eed,erect,exserted,extending,flattened,free,glabrescent,hairy,ilament,insertion,keeled,lamina,less,lobe,long,m.,midrib,minute,minutely,narrowing,never,new,nflorescence,nodding,occasionally,older,orolla,pair,pale,papillat,papillo,per,pericarp,pitted,plurifoliat,point,portion,primary,quadrate,reniform,ruit,seed,shin,sinus,slender,spreading,square,stigma,strongly,style,tall,tem,testal,thi,thin,tube,twinin,ud,vary,vein,wall,weight,wing,woody,yellow,yellowish,ympodial	5-merous,age,appressed,arching,articulation,bark,basally,bract,branching,breeding,bud,colour,connective,form,hair,height,heteromorphism,inflated,interjected,interpetalar,leaflet,length,marking,mature,modification,na,odour,orientation,pattern,placement,plant,plurifoliate,position,prickle,pseudostipule,rhizome,scale,shape,spot,staman,stone,structure,symmetry,sympodial,system,texture,tissue,tuber,type,xylopodia,zygomorphy
19	wfo-0001025845	success	180	151	94	86	57	0.522	0.4-1.5,0.5-11,0.5-2.5,1-4.5,1.5-13,1.5-2,1.5-7,2-15,2-3,2-5-lobed,3,3-13,3-4,3-6,4-6,5-6,6-6.5,6-9,acuminate,acute,aggregate,along,anther,apart,apex,apiculate,articulated,base,branch,calyx,cell,chartaceous,cm,corolla,cuneate,deltate,diameter,directed,distally,ellipsoidal,entire,extra-axillary,filament,fork,fruit,glabrous,greenish,herb,leaf,light,lobe,lobed,located,lower,margin,membranaceous,minutely,mm,narrowly,obtuse,orange,ovate,ovoid,pedicel,peduncle,perfect,petiole,pinnately,pore,puberulent,rachi,radiu,rotate-stellate,sagittate,shrub,side,simple,small,sparsely,stone,strongly,subcordate,tapered,tip,triangular,truncate,tube,unbranched,unit,unlobed,vein,white,x,yellow	.5,0.3-0.5,1,1-1.8,1-2,1.5,1.5-2.5,2,2.5-4,3-foliat,4-5,7-10,abaxially,abundantly,adaxial,adaxially,around,ascending,axe,ba,blade,brown,channe,compressed,connivent,cylindrical,dark,decurrent,diamete,distall,divided,eaf,eed,eglandular,elliptic,especially,flattened,flower,free,glabrou,green,inserted,lateral,laterally,long,longitudinal,major,mesocarp,midrib,near,nearly,nflorescence,obovate,often,orolla,part,patch,pubescent,purple,rarely,rounded,rugose-verrucate,ruit,sand-punctate,shorter,sinus,spaced,stigma,stripe,style,tal,tamen,tem,terminal,thecae,thick,tightly,time,tomento,truncat,vary,veiny,wide,yellowish,ympodial,youn	3-foliate,articulation,bract,branching,breeding,broad-based,colour,connective,decurred,form,fruiting,growth,hair,height,heteromorphism,inflorescence,insertion,interjected,interpetalar,leaflet,length,lobing,marking,modification,na,needle-like,odour,orientation,paired,pattern,placement,plant,position,prickle,pseudostipule,rhizome,scale,shape,size,smell,spacing,spot,staman,stellate,stem,structure,surface,symmetry,sympodial,system,texture,tissue,trichome,tuber,type,vegetative,xylopodia
20	wfo-0001025850	success	197	146	89	108	57	0.452	.5,0.5,0.5-1,0.5-3,0.6-1,1.5,15-20,acute,anther,apex,articulated,base,berry,branched,brown,calyx,cell,cm,connivent,corolla,densely,denser,diameter,divaricate,ellipsoid,elliptic,entire,filament,flattened,fleshy,flower,fruiting,glabrous,glandular,globose,green,growth,inflorescence,later,lateral,lobed,loosely,lower,many,margin,membranous,mm,narrowly,nearly,node,openly,orange,pale,papillate-puberulent,pedicel,peduncle,per,perfect,petiole,pinnatifid,plurifoliate,pore,poricidal,pubescent,reddish,reniform,rhomboid,scattered,shallowly,shrub,simple,sleeve,slender,slightly,small,stellate,stem,surface,tan,terminal,time,tip,trichome,truncate,uniseriate,unit,vine,white,x	-5,-7,.8,0.5-,1,1-1.5,1-3,1-celled,1.5-5,2,2-12,2-6.5,3-4,30,4-5,5-7,5-merou,6-7,abaxial,ag,along,alyx,anthesi,apar,apparently,ark,axi,basal,broadly,capitate,cupped,cyathiform,deciduous,deflexed,deltate,divided,drying,eaf,eed,elongate,em,erect,exserted,extending,free,geminat,glabrou,gland,half,halfway,ilament,irregularly,lamina,lax,leaving,lengthening,less,lobe,long,midrib,minute,minutely,new,nflorescence,nodding,occasionally,often,older,orolla,outline,pair,papillo,peg,pitted,planar,portion,primary,puberulen,ripe,rounded,ruit,scar,shiny,sinuate,sinus,slit,sometimes,soon,spaced,splitting,spreadin,spreading,stigma,strongly,style,surfac,testal,thin,tiny,tube,twinin,ud,vary,vein,woody,yellow,ympodial,young	appressed,articulation,bark,bract,branching,breeding,broad-based,colour,connective,density,form,fruit,geminate,glabrousnes,hair,heteromorphism,inflated,insertion,interjected,interpetalar,leaf,leaflet,length,marking,mature,na,needle-like,none,number,odour,orientation,paired,pattern,placement,position,present,prickle,pseudostipule,rhizome,scale,seed,shape,smell,spot,staman,stone,structure,symmetry,sympodial,system,texture,tissue,tuber,type,vegetative,xylopodia,zygomorphy
21	wfo-0001025872	success	160	135	94	66	41	0.588	.1,.5,0.25-0.5,0.5-1,0.6-1,1,1-1.3,1-1.5,1-2,1.2-1.5,1.2-1.6,1.7-3,10-25-flowered,2-2.5,2-5,2/3,3.5-4,4-4.5,4.5-13,6-10,6-8,acute,anther,apex,bark,base,becoming,blade,branched,broadly,brownish,calyx,capitate,cm,coriaceous,corolla,crowded,cup-shaped,dark,dia,dry,elliptic,filament,flattened-reniform,fleshy,flower,fruiting,glabrous,globose,green,greenish-tan,junction,later,lateral,leaf,live,lobed,long,main,margin,material,midrib,mm,narrowly,occasionally,opposite,ovary,pair,papillae,pedicel,petiole,plant,pore,revolute,rounded,several,shaped,shrub,simple,stem,stigma,style,tapering,tear-drop,terminal,thick,time,tube,uniseriate,unit,vein,way,white,x	0.5,along,anthesi,apart,apically,auriculate,ba,beginning,beneath,berry,bright,crinkled,decurrent,deeply,deflexed,dense,densely,eaf,edicel,eed,exserted,flattened,free,glandular-resinous,grayish-brow,incrassate,inflorescenc,irregularly,lobe,lon,lower,minutely,nflorescence,often,older,onto,paler,papillo,papillose,pitted,planar,plurifoliat,poricidal,portion,prominent,pubescent,red-papillose,rounded-triangular,ruit,scar,somewhat,soon,spaced,specimen,straight,surface,tall,thickened,tip,trichome,tub,ud,visible,woody,ympodial,young	bract,branching,cell,colour,connective,diameter,form,fruit,grayish-brown,growth,hair,height,heteromorphism,inflorescence,length,marking,modification,na,number,orientation,pattern,placement,plurifoliate,position,prickle,pseudostipule,rhizome,scale,seed,shape,size,spot,staman,stone,structure,symmetry,sympodial,texture,tuber,type,xylopodia
22	wfo-0001025893	success	157	127	76	81	51	0.484	.5,0.5-1.5,1-1.2,1-1.5,1-4,1.5-1.7,1.5-2,2-2.5,2-3,3-5,5-6,along,anther,apex,attenuate,bark,base,beneath,berry,bi-lobed,branched,broadly,calyx,capitate,cm,corolla,cup-shaped,dia,difoliate,elliptic,faintly,filament,flower,fruit,fruiting,geminate,glabrate,glabrous,globose,golden-puberulent,green,greyish,internodal,leaf,lobe,lobed,long,longitudinally,lower,minutely,mm,narrowly,nearly,obovate,occasionally,opposite,ovary,ovoid-reniform,pedicel,petiole,pitted,pore,shaped,shrub,sometimes,stem,stigma,style,surface,tear-drop,tube,unicellular,unit,vein,white,x	.25,.4,0.8-1,1-2.5,11-20,6-10,accrescent,anthesi,bank,barely,bearing,beginning,blade,brownish-green,closely,decurrent,deflexed,deltoid,densely,dry,eaf,early,eed,ellipsoid,erect,even,exserted,free,gravelly,growing,impressed,inflorescenc,lateral,lon,long-acuminate,main,many,margin,material,middle,nflorescence,older,overlapping,pair,pale,papillo,papillose,planar,plurifoliat,poricidal,portion,puberulent,red-papillose,reflexed,river,rocky,ruit,sandy,scar,slender,slightly,spaced,specimen,straight,stream,striat,tall,tapering,thickened,time,tip,trichome,ud,usually,visible,widest,winged,woody,yellowish,ympodial,young	articulation,bract,branching,breeding,broad-based,cell,colour,connective,diameter,form,growth,hair,height,heteromorphism,inflorescence,insertion,interjected,interpetalar,leaflet,length,marking,mature,modification,na,number,odour,orientation,pattern,placement,plant,plurifoliate,position,prickle,pseudostipule,rhizome,seed,shape,size,spot,staman,stone,striate,structure,symmetry,sympodial,system,texture,tissue,tuber,type,xylopodia
23	wfo-0001025896	success	146	131	103	43	28	0.705	-3,-30,0.5,0.5-2,1-1.5,1-25,1-3,1-6.5,1-8,1.5-2,1.5-9,10-15,10-25,2-2.5,2.5-14,2.5-5,4,4-5,4-6,5-15,5-7,6-10,7-,7743,abaxial,acosta,acuminate,acute,aggregate,angled,apart,apex,base,brownish,calyx,cell,chartaceous,cm,connivent,constricted,cuneate,cylindrical,deltate,densely,diameter,eglandular,elliptic-ovate,entire,flower,forked,fruit,glabrous,gland,globose,greenish,hair,inflated,like,lobe,margin,membranaceous,mm,moderately,obtuse,occasionally,orange,ovate,pale,pedicel,peduncle,petiole,pore,present,puberulent,pubescent,purple,rachi,radiu,red,ripe,rotate-stellate,rugose,short-stalked,shrub,simple,smooth,solÃ­,sparsely,stalked,stem,stigma,stone,style,subcordate,tip,triangular-ovate,triangular-subulate,tube,unbranched,unit,white,x,yellow	.5-2.5,2-14,4-12,4-23,6-13,abaxially,absen,adaxiall,adaxially,also,articulated,axe,ba,blade,branched,dendritically,directed,distall,eaf,eed,especially,long,lower,many-foliat,near,nearly,nflorescence,nther,often,orolla,perfect,pubescen,ruit,spaced,surface,tal,tem,time,truncat,vary,vein,wide,ympodial	absent,adaxial,anther,articulation,branching,colour,connivence,corolla,dendritic,form,glabrousnes,growth,height,inflorescence,leaf,length,many-foliate,na,ovary,plant,seed,shape,spacing,structure,sympodial,texture,truncate,type
24	wfo-0001025902	invalid_json	211	163	135	76	28	0.64	.2,.5,/2,0.1-0.5,0.5-2.5,1-1.5,1.2-1.5,1.5,1/3,11-15,1983,4,4-5,40,5-6,8-15,>,abaxially,absent,acute,adaxially,aid,along,anther,anthesi,apex,articulated,attenuate,axi,bark,base,becoming,beginning,berry,black,branched,branching,cabrera,cell,circular,clavate,cm,completely,corolla,densely,diameter,dull,ellipsoid,entire,fide,filament,flattened-reniform,flower,fruiting,glabrous,globose,green,growth,inflorescence,lateral,leaf,leaf-opposed,leaving,length,lengthening,less,lobed,low,lower,margin,markedly,mature,minute,minutely,mm,new,occasionally,often,ovary,pale,papillose,pedicel,peduncle,peg,pendant,per,perfect,petiole,pitted,pore,poricidal,pubescent,ridged,rotate-stellate,rounded,scattered,scrambling,simple,sleeve,slender,slit,small,sometimes,soon,sparsely,spreading,stem,stigma,strongly,style,surface,tangled,tapering,terminal,testal,time,tip,trichome,twining,ultimate,uniseriate,usually,vegetation,vine,violet,water,way,weight,whitish,wing,woody,x,yellow,yellowish,Â½	0.5-2,1-1.2,1.5-2,1.5-3,2-6,2.5-4,3-10,4-13,4-6,5-merou,8-10,8-9,accompanied,ag,always,alyx,apar,ark,berr,branch,broadly,c.,calyx,chartaceous,climbin,conical,connivent,deciduou,deltate,eaf,eed,either,except,exfoliatin,exserted,fleshy,free,geminat,ilament,lanceolate,linear,lobe,long,loosely,midvei,nflorescence,obscured,older,one,orolla,pair,papillat,pericarp,planar,plurifoliate,portion,primary,prominent,revolute,ruit,scar,semi-aquati,semi-circular,shallow,somewhat,spaced,tem,thin,tube,ud,unit,vary,vein,weak,widely,ympodial	'',5-merous,[,``,age,bud,characteristic,climbing,colour,deciduous,exfoliating,form,fruit,midvein,number,orientation,papillate,placement,position,prickle,seed,semi-aquatic,shape,texture,type,value,{,}
25	wfo-0001025906	invalid_json_followup	188	153	95	93	58	0.505	0-14,0.1-2,0.20-0.60,1-2,1.1-2,1.6-12.4,16-51,2-4.4,2-6,2.6-5.2,3-10,4-10,4-12,4-7,5-6,5-7,5.2-9,8-16,8.5-12.5,anther,apex,base,berry,blade,blue,brownish,cell,clavate,cm,condition,coriaceous,corolla,covering,cuneate,dark,diameter,distal,drying,filament,flower,forked,fresh,fruit,glabrous,globose,green,greenish,hair,half,herb,high,homostylous,interjected,lanceolate,lateral,leaf,leaflet,light,lilac,linear,long,lower,mm,odd-pinnate,ovoid,pair,pedicel,peduncle,pentagonal,petiole,plant,pore,poricidal,pubescent,purple,rotate,seed,shiny,short,size,sparsely,stigma,straight,stripe,style,sub-glabrous,subglabrous,terminal,testal,thick,tip,wall,white,whitish,width	0.15-0.6,0.2-0.6,1-3,1-6,1.8-4.8,3-5,4-5,5-merou,abaxially,acumen,acute,adaxiall,adaxially,ag,alyx,apart,apparently,articulated,axe,axillary,bud,capitat,connivent,decreasing,decurrency,decurrent,delimited,digestion,diminishing,dorsally,eaf,edge,eed,enzyme,erec,exceeding,falcate,first,flat,folded,geminat,generally,glabrou,green-white,hair-like,hal,honeycomb-shaped,lengthening,living,lobe,make,mucilaginous,next,nflorescence,obtuse,orolla,perfect,plurifoliate,rachi,removed,ripe,ruit,second,sessile,seudostipule,slightly,slit,smaller,spaced,specimen,stamen,subequal,subglabrou,subtending,tall,tamen,tem,third,throughout,toward,tri-,tube,typically,unit,unwinged,usually,vary,well,wet,wood,x,yellow,ympodial	'',[,\u201chair-like\u201d,``,abaxial,adaxial,appressed,arrangement,articulation,bract,branching,breeding,broad-based,calyx,capitate,characteristic,colour,connective,form,fruiting,growth,height,inflated,inflorescence,insertion,interpetalar,length,margin,marking,mature,modification,na,needle-like,number,odour,orientation,ovary,paired,pattern,position,prickle,pseudostipule,scale,shape,smell,spot,stem,surface,symmetry,system,texture,tissue,trichome,type,value,vegetative,{,}
26	wfo-0001025907	success	148	97	43	105	54	0.291	.05,1,1-5,1.5-2,acute,anther,apex,attenuate,axillary,base,berry,c,calyx,cell,cm,conical,densely,filament,fruit,fruiting,glabrous,green,growth,included,lobed,long,lower,margin,mm,pedicel,petiole,poricidal,pubescent,scattered,shrub,simple,surface,tip,trichome,tube,uniseriate,unit,x	-4,.5,.5-1,0,0-60,0.8-1.8,1-1.2,1-2.3,1-3,1.5-2.2,10-15,12-45,2,2-3.5,2-8,2/3,3-,3-4,3/2,4-5,5-15,absent,acuminate,along,anthesi,anthesis5-7,anticlinal,appearing,axil,beak,bearing,breaking,brown,clavat,conspicuously,deciduous,diameter,eaf,edicel,eed,elliptic,epidermal,erec,flattened,flower,free,globose,greenish,highly,iquito,irregular,isolated,lamina,lobe,lon,minutely,near,nearly,new,nflorescence,obovate,occasionally,open,ovary,ovoid-reniform,pair,papillate,papillose,per,plant,population,portion,primary,projection,raised,red-papillate,reflexed,remaining,round,rugose,ruit,scar,seed,single-stemmed,sinuous,size,slender,soon,sparsely,stigma,style,tal,tem,thickening,time,truncate,tub,ud,unifoliat,variable,vein,white,white-lenticellate,without,ympodial	appressed,articulation,bract,branching,breeding,broad-based,colour,connective,corolla,form,hair,heteromorphism,inflated,inflorescence,insertion,interjected,interpetalar,leaf,leaflet,length,marking,mature,modification,na,needle-like,odour,orientation,paired,pattern,placement,pore,position,prickle,pseudostipule,rhizome,scale,shape,smell,spot,staman,stem,stone,structure,symmetry,sympodial,system,texture,tissue,tuber,type,unifoliate,vegetative,xylopodia,zygomorphy
27	wfo-0001026203	success	197	99	80	117	19	0.406	0-39,0.06-0.86,0.38-11.3,0.4-3,0.5-2.3,0.7-2.6,1-13,1-2,1-4,1-9,1.2-5.5,2-10,2-4.9,2-8.5,2.2-13.3,3-10,3-11,3.2-22,3.2-23,7-47,anther,blade,blue,cell,clavate,cm,coriaceous,corolla,dark,deep,diameter,filament,flower,forked,fruit,glabrescent,glabrous,globose,green,greenish,hair,herb,homostylous,honeycomb-shaped,interjected,lanceolate,lateral,leaf,leaflet,light,lilac,long,medium,mm,moniliform,mucilaginous,odd-pinnate,ovoid,pair,pedicel,peduncle,pentagonal,petiole,plant,pore,poricidal,rotate,seed,short,size,stigma,straight,style,subglabrous,terminal,tip,tuber,whitish,wide,x	0-7,0.3-11,0.3-6,0.5-3.2,1-5,1.1-7.9,2-43,2-5,3-5,5-merou,abaxially,acumen,acuminate,acute,adaxially,ag,along,alyx,apart,apex,apparently,arranged,articulated,asymmetric,attenuate,axe,axillary,base,basiscopic,bead,berry,brownish,bud,capitat,condition,connivent,covering,decreasing,decurrent,digestion,distal,dorsally,drying,eaf,edge,eed,elliptic,enzyme,erect,exceeding,flat,folded,fresh,geminat,generally,glabrescen,glabrou,green-white,hair-like,hal,half,high,lengthening,like,linear,living,lobe,lower,make,middle,multiple,necklace,nflorescence,orbicular,orolla,ovate,perfect,plurifoliate,rachi,removed,ripe,rosett,rounded,ruit,sessile,seudostipule,side,slightly,slit,sometimes,spaced,specimen,stamen,stolon,stripe,subequal,subtending,tall,tamen,tem,testal,thick,throughout,tissue,toward,tri-,tube,typically,unit,unwinged,usually,vary,wall,wet,white,yellow,ympodial	abaxial,adaxial,arrangement,branching,calyx,capitate,colour,form,growth,height,inflorescence,length,ovary,pseudostipule,shape,staman,stem,symmetry,texture
28	wfo-0001026208	success	214	109	62	152	47	0.29	1-5,3.5-5,anther,apex,apparently,articulated,base,berry,branched,bright,calyx,chartaceous,cm,connivent,cuneate,curved,dark,densely,difoliate,equal,erect,evenly,filament,fruit,fruiting,geminate,glabrous,green,lateral,leaf,length,lobed,long,margin,mature,maturity,mauve,membranous,mm,moderately,orange,pale,pedicel,petiole,poricidal,prickle,recurved,red,rounded,shrub,sometimes,spherical,stellate,stellate-pubescent,straight,surface,tapering,terminal,tip,unit,white,young	-1/2,-10,-3,-5,.5,/3,0,0-20,0-4,0-5,0-8,0.1,0.1-0.2,0.1-0.25,0.1-0.3,0.5-0.8,0.5-1.2,0.6-0.8,0.6-0.9,0.7-2,0.8-1.3,0.8-1.5,1-2,1-4,1.5,1.5-2.5,1.8-2.3,1.8-2.5,1/3,1/4-1/3,1/4-1/6,11-25,2,2-20,2-3,2-4,2.5-5,2.5-6,3-30,3-5,3-6,3/,4-7,4-9,5,5-,5-17,5-22,5-merous,6-22,6-8,abaxial,abaxially,acuminate,acut,acute,adaxial,alyx,apar,apart,apically,bark,becoming,blade,broad-deltate,brown,conical,deltate,diameter,discolorous,distance,drying,dull,eaf,eed,elliptic,elongated,elongating,extending,flattened,flattened-reniform,flower,free,geminat,glabrescent,gray-greenish,green-brown,infructescence,lobe,longer,lower,midpoint,midvein,nflorescence,older,one,open,orange-brown,orolla,oung,ovate,pair,peduncle,pendulous,per,perfec,pericarp,porrect,portion,prickly,primary,pubescent,ray,red-brow,ruit,scar,sessile,shorter,side,slender,smooth,somewhat,spaced,sparsely,spreading,stalk,stalked,stem,stout,straw-yellow,style,subentire,tamen,terete,tertiary,time,toward,trichome,tube,unarme,unarmed,usually,variously,vary,vein,venation,visible,way,wide,woody,yellow,ympodial	appressed,articulation,bract,branching,breeding,cell,colour,connective,corolla,form,growth,hair,heteromorphism,inflated,inflorescence,insertion,interjected,interpetalar,leaflet,marking,modification,na,odour,orientation,paired,pattern,perfect,placement,pore,position,present,pseudostipule,rhizome,scale,shape,spot,staman,stone,structure,symmetry,sympodial,system,texture,tissue,tuber,type,xylopodia
29	wfo-0001026215	invalid_json_followup	150	172	115	35	57	0.767	-3,.05,.5,0,0.05,1-3,1.5,1.5-2,1.5-2.2,13-35,15-2,18-20,2-3,2-3.5,2-4,3/4,4-15,7-8,absent,along,anther,anthesi,anticlinal,apex,axillary,base,beak,broadly,brown,calyx,cell,clavate,cm,completely,conical,conspicuously,corolla,densely,diameter,elliptic,enlarged,entire,epidermal,erect,exserted,filament,flattened-round,flower,fruit,fruiting,glabrous,globose,green,greenish,herb,highly,horizontal,internode,irregular,kink,length,less,lobe,lobed,long,marked,markedly,minutely,mm,nearly,nodding,occasionally,often,ovary,ovoid-reniform,pair,papillae,papillate,pedicel,per,petiole,poricidal,portion,primary,projection,purple,raised,red-papillose,reflexed,rugose,scar,seed,shrub,simple,sinuous,stem,stigma,strongly,style,surface,thickening,time,tip,tube,unit,usually,vein,way,white,white-lenticellate,white-pubescent,wing,winged,without,x	0.5-1,1,2,4-5,abaxially,abruptly,acuminate,ape,axil,berry,bifi,continually,deltate,eaf,edicel,eed,free,lower,narrowing,nflorescence,noddin,onto,papillat,rounded,ruit,shortsympodial,single-stemmed,small,ste,tal,tem,tub,ud,unifoliat,wide	'',[,``,abaxial,bifid,bract,branching,breeding,bud,characteristic,colour,connective,exsertion,form,glabrousnes,growth,hair,height,inflorescence,interjected,interpetalar,leaf,leaflet,lenticellate,lobing,margin,marking,mature,modification,na,number,odour,orientation,paired,pattern,plant,pore,position,pubescence,reflexion,scale,shape,short,size,spot,symmetry,sympodial,system,tall,texture,tissue,type,unifoliate,value,width,{,}
30	wfo-0001026229	success	299	113	69	230	44	0.231	1,accrescent,anther,apex,articulated,asymmetric,base,berry,black,branching,calyx,corolla,cuneate,cyme,densely,diameter,elliptic,elongated,entire,fruit,geminate,glandular-capitate,globose,green,growth,hair,hirsute,immature,inflorescence,insertion,internodal,lateral,leaf,lobed,long,lower,margin,mature,membranaceous,mm,moderately,oblong,orientation,paired,pale,pedicel,petiole,plurifoliate,pore,poricidal,purple,rarely,rounded,shrub,simple,small,stellate,stem,subopposite,surface,terminal,tree,trichome,trifoliate,type,unbranched,unit,white,Â¾	0.1â1.47,0.2â0.8,0.35,0.3â0.9,0.3â1.2,0.4,0.8â1.2,0.8â2,0.9,0.9â4.3,1-celled,1.2â4.8,1.3â1.5,1.3â1.7,1.4,1.7â11.8,1.7â2.3,1.8,1.8â5.5,1.9â2.5,1/3,13,1â1.4,1â2,1â4,2,2.3â3.4,2.8â4,2â3,2â3-celled,2â4-celled,3,35,3â4,3â5,4.5â6.5,4â6,5,5-merou,5â9,6â15,6â7,6â8,8.6â12,8â10,9â31,abaxial,abaxially,acuminate,acute,adaxial,adaxiall,adaxially,ag,almost,also,always,alyx,anthesi,ark,associated,attenuate-caudate,axe,ba,barely,beneath,blade,branch,broadly,broken,brown,camptodromous,capitate,celled,central,changing,clavate,cm,commentary,commonly,completely,concentrated,connivent,cordate,covered,creating,cylindrical,dark,deltoid,develope,developed,differing,directed,discolorous,diÂ­,dried,drying,eaf,eed,eglandular,ellipsoidal,even,faces,few-rayed,flattened,flower,found,free,frequently,fresh,fully,glabrescent,glabrous,gland,glandular,golden,head,hispid,hyaline,ilament,impressed,included,introrsely,involute,irregular,lamina,lanceolate,larger,less,like,lobe,long-stalked,longer,longitudinal,mainly,material,maturit,midpoint,midri,midvein,minute,mixed,much,multangulate,multangulate-stellate,multiseriate,narrow-ovate,narrowly,near,nearly,new,nflorescence,often,old,older,one,open,opening,orolla,other,oung,ovate,ovate-elliptic,pair,papillose,peduncle,pedunculate,per,perfect,pink,pit,point,poorly,porrect-stellate,portion,primary,pubescent,purplish,ra,rachi,raised,ray,remnant,reniform,revolute,ruit,secondary,see,sessile,shin,shiny,short-,short-stalked,shorter,size,slightly,slit,smaller,solitary,sometimes,somewhat,sparsely,spread,spreadin,spreading,stalk,stigma,strongly,style,subsessile,supported,surfac,three,tube,tuft,ud,unequal,upper,usually,vary,vein,venation,vestiture,visible,weakly,whitish-green,wide,yellow,yellowish-white,ympodial	1.8-5.5,2.8-4,appressed,articulation,bract,broad-based,cell,colour,connective,di-,filament,form,fruiting,heteromorphism,inflated,interjected,interpetalar,leaflet,length,marking,needle-like,none,odour,pattern,placement,position,prickle,pseudostipule,rhizome,scale,shape,smell,spot,staman,stone,structure,symmetry,sympodial,texture,tissue,tuber,vegetative,xylopodia,zygomorphy
31	wfo-0001026230	success	144	148	100	44	48	0.694	.25,.5,0.3-1.5,0.9-2,1-4,1.9-4.1,12.6-20.8,2-4,2-5,3-4,4.6-9.3,5-10,5-20-flowered,acuminate,acute,anther,apart,apex,apiculate,area,bark,base,beginning,beneath,berry,broadly,bud,calyx,clavate,cm,cordate,corolla,deflexed,difoliate,distal,elliptic,erect,evenly,except,filament,fruit,fruiting,geminate,glabrous,globose,green,grey,large,leaf,lobe,lobed,long,long-acuminate,lower,major,margin,minor,minutely,mm,nearly,obtuse,older,opposite,orbicular,ovary,ovoid,pair,papillose,pedicel,petiole,pore,raised,rounded,rusty-papillose,scar,shaped,shrub,simple,slender,slightly,small,spaced,stem,stigma,straight,strongly,style,surface,tapering,tear-drop,tip,tree,tube,unit,vein,white,winged,woody,x,young	.8,0.5-3,0.75-1,1-1.4,1-1.5,1.1-1.8,1.8-2.3,anisomorphic,anisophyllou,anthesi,appears,back,clu,completely,coroll,deltoid,dia,eaf,edicel,eed,enclosing,free,immature,inflorescenc,lateral,lon,long-triangular,main,middle,nflorescence,pointed,poricidal,portion,reflexed,ruit,sinus,tall,thickened,ud,umbonate,unknown,white-lenticellat,widest,ympodial	anisophyllous,appressed,articulation,bract,branching,broad-based,cell,club,colour,flower,form,growth,hair,height,heteromorphism,inflated,inflorescence,insertion,interjected,interpetalar,leaflet,length,mature,na,needle-like,odour,orientation,paired,placement,plant,position,prickle,pseudostipule,rhizome,scale,shape,size,staman,stone,structure,symmetry,sympodial,texture,tissue,tuber,type,white-lenticellate,xylopodia
32	wfo-0001026233	invalid_json_followup	165	161	97	68	64	0.588	-1,-1.9,-3.8,-5.5,-50,-8.1,.25,.75,0.7-0.8,0.8-1.55,1-,1.1,1.2-2.7,1.5,1/2,2,2-,2.4-3.5,2/3,3.5-4.5,5-30,6,accrescent,acute,annular,anther,apex,basal,base,bearing,berry,broadly,calyx,campanulate,capitate,cm,coat,conspicuous,cuneate-attenuate,curved,cylindrical,densely,diameter,dimorphic,ellipsoidal,elliptic,embryo,entire,few-,filament,fruiting,glabrous,globose,hair,herb,herbaceous,investing,leaf,less,lilac,lobe,lobed,longitudinally,margin,mm,moderately,narrowly,near,non-glandular,ovate,ovule,pale,partially,petiole,pinnatisect,pore,poricidal,protuberance,pubescent,ridged,scarcely,seed,simple,sparsely,stigma,style,subglobose,tip,trans-ovoidal,trichome,tube,tuberculate,unifoliate,unit,winged,x,yellow	0.3,0.5,0.7-,0.8-1.3,0.8-4,1,2.1,2.3-7,2.6,3.2-3.7,3.2-4.7,4-,5-6.2,abundant,ag,annual,antrorse,articulated,ascending,difoliat,eaf,eed,evident,hig,interlobular,lamina,larger,long,longitudinal,lower,membrane,minutely,multicellular,obtuse,occasionally,opening,orolla,other,outer,papery-scarious,pinnatipartite,portion,present,pubescen,ree,reticulate,rounded,ruit,seede,serrate,shorter,slender,slightly,slit,small,smaller,striate,strongly,styl,surface,tem,unequal,uniseriate,vary,venatio,verrucose,wider,ympodial	'',0.7-1.3,4-6.2,[,``,articulation,bract,branching,breeding,cell,characteristic,colour,connective,corolla,difoliate,dimorphism,form,fruit,growth,height,heteromorphism,inflorescence,insertion,interjected,interpetalar,leaflet,length,marking,modification,na,number,odour,orientation,ovary,paired,pattern,pedicel,placement,plant,position,prickle,pseudostipule,rhizome,ridging,scale,seeded,shape,size,spot,staman,stem,stone,structure,symmetry,sympodial,system,texture,tissue,tuber,type,value,xylopodia,{,}
33	wfo-0001026241	success	220	132	77	143	55	0.35	10-20,109,abaxially,adaxially,anther,apex,appearing,appears,articulated,base,berry,black,branching,brown,cell,cm,cordate,corolla,covered,densely,depressed-globose,dry,et,filament,fruit,fruiting,galiano,glandular-pubescent,globose,herb,inflorescence,internodal,leaf,lobed,mm,near,orangish,outline,ovate,ovoid,papillate,pedicel,peduncle,per,perennial,petiole,pinnatifid,pitted,pore,pubescent,pulp,rachi,remain,reniform,seed,shallowly,sinuate,slightly,somewhat,stellate,stem,subshrub,succulent,sulcate,surface,taproot,ternate,testa,thick,thickened,triangular,tuberculate,unit,way,white,woody,x	.2,.3,.5,0.1â0.15,0.2â,0.3â,0.3â0.4,0.3â0.6,0.3â1,0.5,0.5â0.7,0.5â0.8,0.5â1,0.7â1.1,1-,1-celled,1.2â1.5,1.2â2,1.5â1.7,1.5â2.5,1.5â3.5,1.9â2.1,1/3â1/2,1â,1â1.1,1â1.4,1â1.5,1â2,2-flowered,2.5â3,2â2.1,2â3,3,3-,30â50,3â3.1,4-,4.5â5,5,5-celled,5-merous,6,always,anthesi,apical,attenuate,ba,basal,basiscopically,beak,brittle,broader,calyx,campanulate,capitate,center,conical,connecting,cup,curved,curving,darker,decurrent,deflexe,dehiscing,deltate,denser,dia,difoliate,discrete,drying,dwarf,eaf,eglandular,elliptic,enclosed,entire,equal,erect,erose,extended,flower,foliat,foliose,free,geminate,glabrous,gland,glandular,intially,irregularly,larger,lateral,leaflet,like,lobe,lon,long,longitudinal,main,margin,midvein,mixture,much,nflorescence,oblique,one,onto,open,ovary,papillat,perfect,pericarp,portion,prolonged,pubescen,robust,ruit,shiny,simple,slit,small,smaller,sometimes,spatulate,stamen,stigma,stout,strongly,style,terminal,tip,tissue,trichome,truncate,tube,ud,uniseriate,usually,vein,wide,wing,ympodial	0.1-0.15,0.5-0.7,1-1.1,1-1.4,1-2,1.2-1.5,1/3-1/2,2-2.1,2.5-3,30-50,arrangement,articulation,breeding,broad-based,bud,colour,connective,diameter,form,growth,hair,height,heteromorphism,history,length,life,lower,marking,modification,na,needle-like,number,orientation,pattern,placement,plant,position,prickle,pseudostipule,rhizome,root,shape,spot,staman,stone,structure,sulcation,symmetry,sympodial,system,texture,tuber,type,xylopodia,zygomorphy
34	wfo-0001026242	success	210	108	57	153	51	0.271	/4,0,0.4-2,0.55-0.9,0.7-1.3,1-1.5,1.5-4,10-20,2.5-2.8,2.5-4.5,6.5-8,anther,apex,articulated,base,berry,branched,bright,calyx,cm,cuneate,diameter,difoliate,erect,filament,flower,fruit,fruiting,glandular,hair,lateral,leaf,length,lobed,lower,mature,membranous,minute,mm,pedicel,per,petiole,poricidal,prickle,recurved,red,red-brown,shrub,stellate,stellate-pubescent,stem,style,surface,tapering,trichome,unit,white	-0.9,-1.5,-2,-5,-6,0-2,0.05-0.2,0.1,0.3-0.5,0.35-,0.4-0.5,0.4-0.55,0.5,0.5-0.7,0.5-1,0.7,1-2.5,1-3,1.2-2,1.5-3,1/2,1/5-1/3,1/6-1/4,10-,2-2.5,2-5,3-6.5,30-80,4-10,4-13,4-5-merous,4.5-5.5,5-,5-18,5-7,7-17,8-20,abaxial,abaxially,acut,acute,almost,alyx,ame,apar,apart,apically,apparently,bark,blade,broad-deltate,c.,concolorous,connivent,curved,deltate,densely,distance,drying,dull,eaf,eed,elliptic,elongating,equal,evenly,extending,eye,filiform,flattened,flattened-reniform,free,geminat,glabrescent,glabrou,glabrous,green,green-gra,infructescence,irregularly,largely,lobe,long,longer,margin,maturity,midpoint,midvein,moderately,multangulate,naked,narrow-deltate,nflorescence,obtuse,occasionally,older,one,open,orange-brown,orolla,oung,pair,pale,pale-brown,peduncle,perfec,pericarp,porrect,portion,prickl,prickly,primary,ray,reflexed,rounded,ruit,scar,sessile,shorte,shorter,side,simple,smooth,sometimes,spaced,sparsely,spherical,spreading,stalk,stalked,straight,subentire,tamen,terete,tertiary,time,tip,tube,unarme,unarmed,upper,variously,vary,vein,venation,visible,way,weakly,wide,woody,yellow,ympodial,young	0-5,0.35-0.9,articulation,bract,branching,breeding,broad-based,cell,colour,connective,corolla,form,growth,height,heteromorphism,inflorescence,insertion,interjected,interpetalar,leaflet,marking,modification,na,number,odour,ovary,pattern,perfect,placement,plant,pore,position,pseudostipule,rhizome,scale,seed,shape,smell,spot,staman,stone,structure,symmetry,sympodial,system,texture,tissue,tuber,type,vegetative,xylopodia
35	wfo-0001026259	success	233	130	85	148	45	0.365	.8,0.3â1.2,0404,1â2-celled,1â3-celled,3.0â3.4,?,affected,age,anther,apex,appressed,base,berry,branching,calyx,cell,central,cm,corolla,decurrent,difoliate,ellipsoid,entire,et,filament,fleshy,fruit,fruiting,green,green-orange,herb,inflorescence,internodal,knapp,lateral,leaf,length,lengthening,lilac,long,lower,margin,membranous,mm,much,narrowly,occasionally,often,once-branched,pathogen,pedicel,per,perfect,petiole,pore,poricidal,pubescent,purple,purple-black,rarely,ripe,rounded,shrub,simple,slit,somewhat,sparsely,star,stellate,stem,stone,surface,tightly,tinged,tip,translucent,trichome,turning,uniseriate,unit,white,winged,yellow,yellow-green	.1,.7,0.1â0.2,0.2â0.4,0.4â0.6,0.5,0.5â0.6,0.7â0.9,0â2,1,1-celled,1.0â1.2,1.0â3.3,1.2â8.4,1.4â4.0,1.5,1.5â2.0,11â22,12â24,1m,1â2,2-ridged,2/3,2â17,2â3-celled,35â45,4â5,5-merous,5â14,5â7-celled,6,7â10,8â11,abaxial,abaxially,acuminate,acute,adaxial,adaxially,anthesi,apar,arising,becoming,beyond,branch,branched,broadly,brown,close,coloured,concave-reniform,cone,congested,conical-ellipsoid,cream-coloured,cylindrical,dehiscing,deltate,densely,diameter,drop,eaf,eed,elongating,end,especially,exerted,flower,free,geminat,glabrous,globose,gradually,growt,halfway,hilum,individual,larger,leave,less,like,live,lobe,lobed,lon,longer,lowermost,minutely,narrower,near,nearly,nflorescence,node,one,outline,ovary,ovate-lanceolate,pair,pale,papillate,peduncle,pentagonal,pericarp,plant,portion,positioned,primary,purple-coloured,rachi,recurving,reduced,reflexed,relatively,remaining,ruit,scar,shiny,short,shorter,similar,slightly,smooth,sometimes,spaced,splitting,spreading,stigma,stout,straight,strongly,style,sub-laterally,tall,tapering,tem,testal,thick,together,toward,tube,two,ud,vein,wide,woody,ympodial,young,â15	articulation,bract,breeding,broad-based,colour,connective,form,geminate,growth,hair,heteromorphism,inflated,insertion,interjected,interpetalar,leaflet,marking,mature,modification,na,needle-like,odour,orientation,paired,pattern,placement,position,prickle,pseudostipule,rhizome,scale,shape,smell,spot,staman,structure,symmetry,sympodial,system,texture,tissue,tuber,type,vegetative,xylopodia
36	wfo-0001026267	success	162	148	94	68	54	0.58	.25,.5,0.1-1,0.6-1.7,0.7-1.1,1-1.2,1-1.5,1-2.6,1-4,1.5-2,1.5-2.3,2.5-3,3-15,3.2-8.6,5-7,acuminate,acute,anther,anthesi,apex,attenuate,bark,base,body,bright,calyx,closely,cm,corolla,crateriform,cuneate,dia,difoliate,drying,filament,flattened-reniform,fruiting,glabrous,globose,green,greenish-white,greyish-green,incrassate,larger,leaf,lobed,long,margin,minor,minutely,mm,narrowly,nearly,occasionally,opposite,ovary,ovate,overlapping,pale,papillose,pedicel,petiole,pitted,pitting,pore,pubescent,ripening,rough,scar,scattered,shaped,shrub,size,slender,slightly,small,spaced,stem,stigma,straight,style,surface,tapering,tear-drop,tip,tree,trichome,tube,uniseriate,unit,white,winged,x,yellow-green	0.5-1,20-30-flowered,3-6.1,4-8,8-10,8.5-15,axil,ba,beginning,beneath,berry,blackish,broadly,decurrent,deflexed,densely,depressed,differing,distally,distinct,eaf,edicel,eed,except,exerted,free,geminat,hard,inflorescenc,lateral,lavender,lobe,lon,longinflorescence,lower,main,major,maturity,middle,often,older,one,pair,papillo,poricidal,portion,quickly,raised,reflexed,remaining,ruit,scarious,simple,softening,soon,sparsely,tall,tan,tinge,triangular,tuft,ud,vein,widest,wing,woody,ympodial,young	20-30,articulation,bract,branching,breeding,bud,cell,colour,connective,diameter,flower,form,fruit,geminate,growth,hair,height,heteromorphism,inflorescence,insertion,interjected,interpetalar,leaflet,length,marking,modification,na,number,odour,orientation,pattern,placement,plant,position,prickle,pseudostipule,pubescence,rhizome,scale,seed,shape,spacing,spot,staman,stone,structure,symmetry,sympodial,system,texture,tissue,tuber,type,xylopodia
37	wfo-0001026279	success	248	123	74	174	49	0.298	0.8-2.3,1-3.5,3.1-4.2,accrescent,acuminate,anther,apex,appressed,articulated,attenuate,base,berry,black,blunt-tipped,branched,brown,calyx,chartaceous,cm,completely,corolla,covering,cuneate,dark,dendritic-echinoid,drying,echinoid,entire,enveloping,filament,fleshy,fruit,fruiting,globose,green,hair,immature,lavender,leaf,length,lilac,lower,many,margin,mature,minute,mm,multangulate,narrowly,oblong,pale,pedicel,perfect,petiole,plurifoliate,pore,poricidal,porrect-stellate,rounded,sessile,short,shrub,simple,somewhat,stellate,stem,surface,time,tip,tree,unarmed,unit,unwinged,white	-11.4,-2.9,-34.3,-4,-5.9,/14-1/8,0.2-0.4,0.25-0.4,0.9-1,0.9-1.8,1-1.4,1-10,1.1-1.6,1.1-1.9,1.5-1.8,1.5-3,1.7-2.3,1.9-3,1.9-3.2,1/2,11.5-19.7,14-27,2.4-3.2,2.5-3.2,2.6-4.8,2/3,3-4,3.1-3.6,3.4-5.2,3.5-7.8,3.8-5.1,4-7.5,5-200,5-8,8,8-11,8.5-10.5,9-22,abaxially,acute,adaxiall,adaxially,ag,anthesi,apart,apparently,appearing,ark,around,axe,axillary,ba,blade,branch,bud,capitate,closely,conical,cylindrical,deltoid,dendritic-echinoi,dense,diameter,directed,distally,due,eaf,earl,echinoi,edge,eed,elliptic,elongated,equal,evident,exerted,expanded,farinose,few-rayed,flower,free,glabrescen,glabrescent,glabrous,granular,grayish,grayish-green,half,inserted,lanceolate,lateral,lengthening,lobe,lobed,long,long-stalked,longer,longitudinal,longitudinall,m.,main,midrib,mixed,multangulate-pubescent,multiseriate,nflorescence,obovate,occasional,occasionally,often,older,open,orbicular,orolla,ovate-lanceolate,overlapping,partly,peduncle,plant,present,prominent,pseudo-terminal,pubescence,rachi,reticulate-punctate,ruit,scabridulous,scabrous,scattered,secondary,semi-ovate,short-,short-decurrent,short-stalked,side,slightly,slit,slowly,spaced,splitting,stalk,stamen,stigma,style,subcampanulate,subcoriaceous,suborbicular,subsessile,sulcate,suture,tall,tamen,tertiary,thickened,thin,thin-stalked,tomentose,tomentose-pubescent,tube,ud,unarme,upper,usually,vary,vein,way,whitish,wide,x,yellow,yellowish,yellowish-tan,ympodial,young	articulation,bract,branching,breeding,broad-based,cell,colour,connective,form,growth,heteromorphism,inflated,inflorescence,insertion,interjected,interpetalar,leaflet,marking,modification,na,needle-like,odour,orientation,paired,pattern,placement,position,prickle,pseudostipule,pseudoterminally,rhizome,scale,shape,smell,spot,staman,stone,structure,symmetry,sympodial,system,texture,tissue,trichome,tuber,type,vegetative,xylopodia,zygomorphy
38	wfo-0001026299	success	239	117	73	166	44	0.305	--,-1,-3.5,0-8,0.1-0.2,0.1-0.4,0.1-0.5,0.25-0.5,0.4-0.5,0.5,0.5-2.5,2-4,2-foliate,2-locular,5,acute,anther,apex,base,bract,calyx,cell,cm,corolla,dark,densely,developed,distal,filament,fruit,fruiting,glabrous,globose,green,half,herb,imparipinnate,inflorescence,interjected,interrupted,investing,lanceolate,leaf,leaflet,less,long,loosely,lower,margin,middle,mm,node,pair,pedicel,pentagonal,petiole,present,pseudostipule,pubescent,short,simple,sparsely,spreading,stem,stripe,surface,trichome,truncate,uniseriate,unit,weak-walled,wide,yellow	-0.8,-10,-2.5,-5,.5,0.1-0.25,0.15-0.2,0.2-0.25,0.2-1,0.3-0.4,0.4-2,0.5-0.6,0.5-0.7,0.5-1,0.6-2,0.7-3.5,0.8-0.9,0.8-1,0.9-1,1,1-1.4,1-celled,1.1-1.7,1.2-1.6,1.2-5,1.5-,1.5-2.3,1.8-2,2-6,2.2-3.2,2.5,2.5-7,25,3-,3.5-10,5-15,5-20,6-20,7-12,abaxially,absent,abundant,acroscopically,adaxially,almost,along,angled,anthesi,apical,appearance,appendage,approximately,articulated,axi,basal,basiscopically,beneath,berr,bracteate,broadly,brown,capitate,change,chota,column,conical,could,crenat,crenate-serrate,decurrent,diamete,diameter,eaf,ebracteate,edicel,eed,eglandular,elliptic,entire,erect,exserted,flower,give,glandular,gree,hair-like,hal,head,intermixed,internode,irregularly,jequetepeque,lacking,larger,lateral,like,lobe,lobed,lon,long-acuminate,longer,maraÃ±Ã³n,maturity,minute,minutely,mixture,multicellular,narrowly,nearly,nflorescence,oblique,obovate,occasionally,often,outgrowth,ovary,pale,patent,peduncle,perennial,petiolule,population,primary,prostrate,pubescence,purple,rachi,reflexed,regularly,rest,ruit,scarcely,scattered,secondary,sessile,silky,size,sparse,staminal,sterile,stigma,stout,straight,style,tall,tem,terminal,tertiary,testa,thick,tip,toward,tube,ud,unicellular,usually,valley,variously,vein,velvety,wall,way,white,winged,woody,ympodial	appressed,articulation,berry,branching,breeding,broad-based,colour,form,growth,hair,heteromorphism,inflated,insertion,interpetalar,length,marking,mature,na,needle-like,odour,orientation,paired,pattern,placement,position,prickle,rhizome,scale,shape,smell,spot,staman,stone,structure,symmetry,sympodial,system,texture,tissue,tuber,type,vegetative,xylopodia,zygomorphy
39	wfo-0001026305	success	135	129	74	61	55	0.548	.25,/4,0.2-1,0.5-2,0.6-1,0.7-1,1-1.5,1.3-1.5,2-2.5,2-6-flowered,5-7,abaxial,abaxially,acute,adaxially,anther,anthesi,apex,area,attenuate,bark,base,berry,calyx,cm,congested,conical,corolla,dark,dendritic,densely,difoliate,drying,elliptic,filament,fruiting,glabrous,globose,green,greenish-white,leaf,leaf-opposed,lobed,long,margin,minute,minutely,mm,occasionally,ovary,ovoid-reniform,papillose,pedicel,petiole,pitted,pore,pubescent,rounded,shaped,shining,shrub,simple,sparsely,stigma,style,surface,tear-drop,tip,trichome,tube,unifoliate,unit,way,x	0.25-0.5,2.5-3,3-8.5,4-4.5,6-9,7-16,7-9,along,apical,ba,beige-tan,closely,deflexed,deltate,dia,eaf,edicel,eed,exserted,free,geminat,glabrate,interlocking,knob-like,lamina,lateral,like,lobe,lon,lower,main,middle,midrib,nflorescence,older,overlappin,pair,pale,planar,poricidal,portion,projection,reddish-brow,ruit,scar,scattered,slender,spaced,stem,strongly,styl,tall,tan,tub,ud,vein,visible,widest,woody,ympodial,young	appressed,arrangement,articulation,bract,branching,breeding,cell,colour,connective,diameter,flower,form,fruit,geminate,growth,hair,height,heteromorphism,inflated,inflorescence,insertion,interjected,interpetalar,leaflet,length,marking,mature,modification,na,odour,orientation,paired,pattern,placement,plant,position,prickle,pseudostipule,reddish-brown,rhizome,scale,seed,shape,spot,staman,stone,structure,symmetry,sympodial,system,texture,tissue,tuber,type,xylopodia
40	wfo-0001026307	success	193	129	94	99	35	0.487	0.2â1.5,0.5â5.0,0.8â2,0.8â5,1.0â1.2,2.0â3.5,2.6â13,3.0â4.0,3.5â7.0,3â8-celled,4â5.7,abaxial,acute,adaxial,age,angled,anther,apex,appressed,base,berry,black,broadly,calyx,cell,central,clavate,cm,corolla,cuneate,cylindrical,decurrent,densely,diameter,difoliate,ellipsoid,entire,eye,filament,fruit,fruiting,glabrous,glandular,globose,green,growth,herb,internodal,lateral,length,lengthening,lobed,long,margin,membranous,minutely,mm,narrowing,ovary,ovate,paler,per,petiole,pore,poricidal,pubescent,purple,purple-yellow,reflexed,ripe,shallowly,shape,shrub,simple,slit,sparsely,stellate,stem,stigma,stone,style,surface,tinged,tip,toward,translucent,trichome,turning,undulate,uniseriate,variable,white,wide,yellow-green	.0â1.2,.3,.5,.5â4.0,.6,.8,0.2â0.5,0.4,0.5â0.6,0.5â0.7,0.6,0.8â0.9,1.0â1.5,1.0â2.0,1.0â2.4,1.0â2.5,1â3-celled,1â6-celled,2.0,2.0â3.0,2/3,35â45,3â8,5-merous,5â7,8â12,9,abaxially,acute-acuminate,adaxially,anthesi,apar,articulated,becoming,beyond,cone,eaf,eed,end,exerted,facing,flattened-reniform,flower,free,geminat,gradually,hilum,later,like,lobe,longer,lower,middle,narrower,new,nflorescence,one,outline,pair,papillat,pedicel,peduncle,pentagonal,perfect,portion,positioned,primary,recurved,reflexe,restricted,ruit,scar,shallow,shorter,side,slightly,spaced,spreading,ste,straight,strongly,sub-laterally,tal,tem,testal,three,triangular,tube,two,ud,unequal,unevenly,unit,upper,vein,vigorous,weak-stemmed,yellow,ympodial	angle,branching,colour,form,geminate,glandularity,height,heteromorphism,inflorescence,interjected,interpetalar,leaf,leaflet,marking,na,odour,orientation,paired,papillate,placement,plant,position,prickle,pseudostipule,pubescence,rhizome,size,spot,staman,symmetry,texture,tissue,tuber,type,xylopodia
41	wfo-0001026317	success	169	138	87	82	51	0.515	.5,/4,0.25-1,0.3-1.2,0.5,0.5-0.6,1-1.2,10-12,2-,2-2.5,2-4,2.5-10,3-foliate,6x,acuminate,acute,anther,anthesi,apex,approximately,attenuate,bark,base,berry,branched,bright,brown,calyx,closely,cm,corolla,dark,dendritic,densely,diameter,distally,elliptic,entire,filament,fruiting,glabrous,globose,growth,inflorescence,internodal,less,lobed,lower,many,margin,mm,narrowly,new,occasionally,orange,packed,pair,pedicel,peduncle,petiole,planar,pore,poricidal,primary,pubescence,pubescent,red,reflexed,scar,shiny,shrub,simple,slightly,sparsely,stem,surface,terminal,time,tip,trichome,uniseriate,unit,vein,way,white,x,yellowish	0.5-0.8,0.5-1,0.6-,0.7-0.9,0.8-1,1-1.5,1-5.7,3,3-3.5,3.5-15,4-5,50-200,6-8,?,abaxially,absent,adaxially,age,apart,apically,capitate,clonal,conical,correlated,deltate,dense,drying,eaf,eed,em,erec,erect,essentially,exerted,extremely,flattened,flower,found,free,geminat,halfwa,lamina,lengthening,like,lobe,longer,maturity,minutely,nflorescence,nodding,often,ovary,pale,papillat,papillate,per,perfect,pericarp,pitted,plane,plant,population,portion,pubescen,pulp,rachi,reniform,ruit,slit,sticky,stigma,straight,style,swollen,thin,toward,triangular,tube,ud,variable,woody,ympodial	abaxial,adaxial,appressed,arrangement,articulation,bract,branching,broad-based,bud,cell,colour,connective,exertion,form,fruit,geminate,hair,halfway,heteromorphism,inflated,insertion,interjected,interpetalar,leaf,leaflet,length,modification,na,needle-like,odour,orientation,paired,placement,position,prickle,pseudostipule,rhizome,scale,shape,smell,staman,stone,structure,symmetry,sympodial,texture,tissue,tuber,type,vegetative,xylopodia
42	wfo-0001026335	success	157	124	89	68	35	0.567	.5,0.25-0.5,0.5-1,0.6-1,1-2,1.5-2,10-20,10-30,2,2-3,2-4,2-7.5,3-18,4-5,5-15,5-7,abaxially,accrescent,acuminate,adaxially,anther,apex,articulated,base,branched,calyx,chartaceous,cm,cuneate,curved,cylindrical,dense,densely,diameter,directed,distally,elliptic,elliptic-ovate,entire,filament,flattened,flower,forked,fruit,fruiting,glabrescent,glabrous,globose,green,hair,large,leaf,leaf-opposed,like,longitudinal,margin,mm,moderately,multangulate,oblong,opening,pedicel,peduncle,petiole,pore,probably,pubescence,pubescent,rachi,reticulate,ripe,rounded,sessile,shrub,simple,slightly,slit,stellate,stem,stigma,straight,style,surface,unripe,usually,white,whitish,x,yellowish	.5-3.5,0.1-0.3,0.8-1.3,1,1-1.5,1-3,1-4,1.5-4,3-5,5-,7-8,acute,adaxiall,ag,apart,apparently,axe,ba,blade,capitat,connivent,covering,deltate,eaf,eed,equal,erect,especially,frui,geminate,glandula,glandular,held,lanceolate,lobe,long,lower,many-foliate,midpoint,much,nflorescence,often,orolla,paired,perfect,ray,ruit,scattered,smaller,sometimes,spaced,ste,stellate-pubescent,subtending,tal,tamen,tem,time,tip,toward,tube,unit,uprigh,vary,vein,wide,yellow,ympodial	age,appressed,articulation,branching,breeding,capitate,colour,connective,corolla,form,growth,height,inflated,inflorescence,length,marking,mature,modification,na,number,ovary,pattern,plant,position,seed,shape,size,spot,staman,symmetry,system,texture,trichome,type,zygomorphy
43	wfo-0001026343	success	221	110	63	158	47	0.285	.5,0.05-0.5,2-5,7-12,andromonoecious,anther,apex,articulated,base,berry,branched,calyx,chartaceous,cm,connivent,cream,cuneate,curved,dark,densely,elongating,equal,erect,filament,flattened,fruit,fruiting,green,lateral,leaf,length,lobed,long,lower,margin,marking,mature,maturity,mauve,mm,orange,pale,pedicel,petiole,poricidal,prickle,purple,reflexed,rounded,shrub,small,spherical,stellate,stellate-pubescent,stem,surface,tapering,tip,tree,trichome,unit,yellow,young	-1,-1.5,-15,-3.5,-4,-7,/2,/5,0,0-10,0-2,0-4,0-40,0-5,0.05-0.2,0.1-0.2,0.15,0.2,0.2-0.3,0.2-0.7,0.3,0.45-1,0.5,0.5-1.5,0.8-1.5,1-2,1-3,1-4,1.3-1.7,1.5-2,1.5-2.5,1.8-2.2,1.8-3,1/,1/3,1/4-2/3,1/5,10-30,2-3,2-3.2,2-4,2-6,2-8,2.2-3.2,2.5-8,3-4,3-5,3.5-4.5,5-10,5-merous,5.5-9,6-9,7-14,7-8,7-9,abaxial,abaxially,acuminat,acute,adaxial,alyx,apar,apart,apically,apparently,bark,blade,broadly,brow,concolorous,deltate,diameter,distal,distance,drying,dull,eed,elliptic,extending,faint,flattened-reniform,flower,free,glabrescent,glabrous,green-brown,hermaphrodite,heterostylous,infructescence,less,lobe,lobing,lon,long-styled,longer,lowermost,midpoint,midvein,moderately,multangulate,narrow-deltate,nflorescence,obtuse,older,one,open,orange-brown,orolla,oung,ovate,pair,peduncle,pendulous,per,pericarp,plant,plurifoliat,porrect,portion,prickl,prickly,primary,ray,reddish,reduced,ruit,scar,secondary,sessile,short-styled,side,smooth,sometimes,spaced,sparsely,spreading,stalk,stalked,staminat,stout,style,tamen,terete,tertiary,time,tube,unarmed,upper,variously,vary,vein,venation,visible,way,weakly,wide,woody,ympodial	appressed,articulation,bract,branching,breeding,broad-based,cell,colour,corolla,form,growth,hair,heteromorphism,inflated,inflorescence,insertion,interjected,interpetalar,leaflet,na,needle-like,odour,orientation,paired,pattern,placement,plurifoliate,position,pseudostipule,rhizome,scale,shape,smell,spot,staman,stone,structure,symmetry,sympodial,system,texture,tissue,tuber,type,vegetative,xylopodia,zygomorphy
44	wfo-0001026352	success	209	157	107	102	50	0.512	.5,0.5,0.5-0.8,0.5-1.5,0.5-3,0.7-2,0.9-1,1-10,10+,4-4.5,<,?,abaxially,acuminate,acute,anther,antrorsely,apart,apex,articulated,articulation,axi,base,berry,blue,branching,broadly,calyx,cell,chartaceous,cm,cordate,corolla,curved,deltate,densely,diameter,ellipsoid,entire,evenly,filament,flattened,fruiting,globose,green,growth,inflorescence,irregularly,leafy,leaving,length,lengthening,like,lobe,lobed,long,lower,many,margin,mature,membranous,mm,narrowly,near,nearly,outline,ovate,pale,papillate,pedicel,peduncle,peg,per,perfect,petiole,pink,pore,poricidal,pubescent,reniform,revolute,scar,shallowly,shoot,short,simple,sleeve,slit,small,spaced,stellate,stem,surface,terminal,time,tip,trichome,truncate,tube,uniseriate,unit,vine,violet,weak,white,woody,yellowish	.3,0.5-1,0.6-,1-,1-1.5,1-2-celled,1.2-1.7,1.5,1.5-2,1.5-4.6,12-60,2,2-3-celled,3-15,3.5-9,5-6,5-merou,6-7,7-9,adaxiall,ag,almost,alyx,angle,anthesi,apparently,appearance,arising,bark,basal,bending,branch,brown,capitate-truncate,conical,deciduous,denser,discolorous,eaf,eed,eventually,expanded,exserted,few-celled,flower,free,giving,glabrous,greenish,half,heigh,herbarium,ilament,immature,impressed,inflorescenc,junction,lamina,large,largest,leave,minutely,new,nflorescence,older,orolla,pair,papillo,pericarp,plurifoliat,point,portion,primary,principal,rachi,reflexed,rest,right,ruit,seen,shiny,sparser,specimen,spreadin,spreading,stigma,straw-colored,strongly,style,tem,thin,third,tub,tuberculate,ud,unspecified,upper,vary,vein,wide,widest,ympodial	age,appressed,bract,breeding,broad-based,colour,connective,form,fruit,hair,heteromorphism,inflated,insertion,interjected,interpetalar,leaf,leaflet,marking,modification,na,needle-like,number,odour,orientation,paired,pattern,placement,plurifoliate,position,prickle,pseudostipule,rhizome,scale,seed,shape,smell,spot,staman,stone,structure,symmetry,sympodial,system,texture,tissue,tuber,type,vegetative,xylopodia,zygomorphy
45	wfo-0001026352	invalid_json_followup	214	165	116	98	49	0.542	.5,0.5,0.5-0.8,0.5-1.5,0.5-3,0.9-1,1-1.5,1-10,10+,2,4-4.5,5-6,<,?,abaxially,acuminate,acute,adaxially,anther,antrorsely,apart,apex,articulated,articulation,axi,basal,base,berry,branch,branching,calyx,capitate-truncate,chartaceous,cm,connivent,cordate,corolla,curved,densely,diameter,ellipsoid,entire,evenly,filament,flattened-reniform,form,fruiting,glabrous,globose,green,growth,half,inflorescence,irregularly,lamina,leaf,leafy,leaving,length,lengthening,like,lobed,long,lower,many,margin,mature,membranous,minutely,mm,narrowly,near,nearly,outline,papillate,pedicel,peduncle,peg,per,perfect,petiole,pink,pore,poricidal,principal,pubescent,revolute,scar,shallowly,shiny,shoot,short,simple,sleeve,slit,small,spaced,stellate,stem,stigma,style,surface,terminal,time,tip,trichome,truncate,twining,uniseriate,vein,vine,violet,weak,white,x,yellowish	.3,0.5-1,0.6-,0.7-2,1-,1-2-celled,1.2-1.7,1.5,1.5-2,1.5-4.6,12-60,2-3-celled,3-15,3.5-9,5-merou,6-7,7-9,ag,almost,alyx,angle,anthesi,apparently,appearance,arising,ark,bending,blue,broadly,brown,cell,conical,deciduous,deltate,denser,discolorous,eaf,eed,eventually,expanded,exserted,few-celled,flower,free,geminat,giving,greenish,heigh,herbarium,ilament,immature,impressed,inflorescenc,junction,large,largest,lobe,new,nflorescence,older,orolla,ovate,pair,pale,papillo,pericarp,plurifoliate,point,portion,primary,rachi,reflexed,rest,right,ruit,seen,sparser,speciman,specimen,spreadin,spreading,straw-colored,strongly,tem,thin,third,tub,tube,tuberculate,ud,unit,unspecified,upper,vary,widest,woody,yellow,ympodial	'',[,\u201cpale,``,age,appressed,blue\u201d,bract,breeding,broad-based,characteristic,colour,connective,fruit,hair,inflated,insertion,interjected,interpetalar,leaflet,marking,modification,na,needle-like,number,odour,orientation,ovary,paired,papillose,pattern,placement,position,prickle,scale,seed,shape,smell,spot,symmetry,system,texture,tissue,type,value,vegetative,zygomorphy,{,}
46	wfo-0001026379	success	219	124	81	138	43	0.37	0.7-1,0.8-1.2,1-2,2.6-3.7,accrescent,adaxially,along,anther,apex,articulated,axillary,base,berry,blunt-tipped,branch,branched,brown,calyx,chartaceous,cm,completely,corolla,covering,dark,directed,distally,dried,entire,enveloping,filament,finely,fleshy,free,fruit,fruiting,globose,growth,hair,lacking,large,leaf,length,long-attenuate,many,margin,mature,minutely,mm,nearly,oblong,obtuse,often,pale,pedicel,perfect,petiole,plant,plurifoliate,pore,poricidal,porrect-stellate,present,rather,recent,rich,scabrous,shrub,simple,small,somewhat,stellate,thin,time,tip,tree,unit,velutinous-pubescent,violet,x,yellow,young	-4.5,0.2-0.38,0.2-0.4,0.7-2.5,0.9-1.2,1-1.7,1-10,1-3.7,1.3-2.1,1.5-2.3,1.7-4.9,1.8-2.6,1.8-3.2,1.8-5,1.9-3.4,1/2,13,2-2.8,2-7,2.4-5.1,2.9-4,2/3,3-11,3/4,4-5,4.1-7,5.3-10.2,50-450,6-10.6,8-13,8-15,8-29,8.3-10,9-14,abaxially,acute,adaxiall,ag,anthesi,apart,apparently,around,attenuate,ba,bark,basal,blade,capitat,closely,conical,cylindrical,dendritic-echinoid,densely,diameter,distal,eaf,echinoi,echinoid,echinoid-pubescent,edge,eed,ellipsoid,evident,farinose,few-rayed,flower,glabrous,granular,gray-brown,grayish,hig,included,inserted,lateral,lengthening,line,lobe,lobed,long,lower,m.,main,midrib,minute,mostly,multangulat,multangulate,multangulate-pubescent,nflorescence,obovate,older,orolla,ovate,ovate-lanceolate,partly,peduncle,persistently,pitted,pubescen,rachi,reniform,ruit,runk,scattered,semi-ovate,sessile,short-stalked,side,size,slit,sometimes,spaced,sparse,stellate-,stellate-pubescent,stellate-tomentose,stelliform,stem,stigma,style,suture,tamen,terete,testa,tomentose-pubescent,translucent,tube,ud,uneven,upper,usually,vary,vein,vestigial,way,whitish,whitish-brown,ympodial	appressed,articulation,bract,branching,breeding,cell,colour,connective,form,heteromorphism,inflated,inflorescence,insertion,interjected,interpetalar,leaflet,marking,modification,na,odour,orientation,paired,pattern,placement,position,prickle,pseudostipule,pubescent,rhizome,scale,shape,spot,staman,stone,structure,symmetry,sympodial,system,texture,tissue,tuber,type,xylopodia
47	wfo-0001026400	invalid_json_followup	187	162	118	69	44	0.631	0.2-0.8,0.4-1,0.5-1.2,0.7-1.1,1-10,1-2,1.3-2.6,10-18,10-28,12-27,13-30,2-8,2.4-5.9,3.4-4.8,3.5-5.9,30-55,4-7,5-7,6-13,6-15,6.5-20,8-12,9-13,acumen,anther,asymmetric,attenuate,base,basiscopic,berry,blade,blue,brownish,cell,clavate,cm,condition,coriaceous,corolla,dark,deep,diameter,digestion,distal,dorsally,drying,edge,elliptic,enzyme,filament,finely,flat,flower,folded,forked,fresh,fruit,glabrescent,glabrous,globose,green,greenish,hair,half,herb,high,homostylous,honeycomb-shaped,interjected,lanceolate,lateral,leaf,leaflet,lengthening,light,lilac,linear,lobe,mm,moderately,odd-pinnate,ovate,ovoid,pair,pedicel,peduncle,pentagonal,petiole,plant,pore,poricidal,puberulent,pubescent,purple,removed,ripe,rounded,seed,semi-stellate,sessile,short,side,simple,size,slit,stigma,straight,stripe,style,terminal,testal,tip,tissue,tube,wall,white,whitish,x	0.5-1,1.7-2.2,2-6,3-6,5-merou,abaxially,acuminate,acute,adaxiall,adaxially,ag,alyx,apart,apex,apparently,articulated,axe,axillary,bud,capitat,connivent,covering,decreasing,decurrent,eaf,eed,erec,exceeding,geminat,generally,glabrou,gree,green-white,hair-like,hal,living,long,lower,make,mucilaginous,nflorescence,orbicular,orolla,perfect,petiolulate,plurifoliate,ruit,seudostipule,slightly,spaced,specimen,stamen,subequal,subtending,tall,tamen,tem,thick,throughout,toward,tri-,typically,unit,unwinged,usually,vary,wet,yellow,ympodial	'',[,``,abaxial,adaxial,age,arrangement,articulation,bract,branching,breeding,calyx,capitate,characteristic,colour,connective,form,fruiting,growth,height,inflorescence,interpetalar,length,marking,modification,na,odour,ovary,pattern,position,pseudostipule,scale,shape,spacing,spot,staman,stem,symmetry,system,texture,type,value,{,}
48	wfo-0001026406	success	219	98	61	158	37	0.279	.2,2-3,2.5-8,6.5-7,anther,apex,articulated,base,berry,branched,chartaceous,cm,connivent,cordate,cream,curved,dark,equal,erect,filament,flower,fruit,gently,green,herb,lateral,leaf,length,lobed,long,long-styled,lower,margin,marking,maturity,mauve,midvein,mm,obtuse,pale,pedicel,pendent,petiole,poricidal,prickle,purple,short-styled,shrub,spherical,stellate-pubescent,stem,straight,surface,tapering,terminal,tip,trichome,unit,white,yellow,young	-1,.5,0,0-3,0-30,0-5,0.3,0.3-0.5,0.3-0.7,0.4-0.8,0.4-0.9,0.5,0.5-1.5,0.5-2.5,0.8,00-200,1,1-2,1.3-1.5,1.5-2,1.5-5,1.8-2.4,1/,1/3,1/4,1/4-1/2,1/4-1/3,10-30,12-19,2-2.7,2-6,2.9-3.2,20-60,3-10.5,3-4,3.2-3.8,30-60,5,5-25,5-50,5-6,5-7,5-8,5-merous,6-12,6-15,7-10,7-8,7-9,9-15,abaxial,abaxially,acute,adaxial,adaxially,alyx,ame,andromonoecious,apar,apart,apically,apparently,bark,blade,broad-deltate,c.,calyx,conical,deltate,densely,diameter,dirty-whitish,discolorous,distal,distance,drying,eaf,eed,elongated,elongating,extending,flattened,flattened-reniform,foliaceous,free,fruiting,fully,glabrous,hermaphrodite,heterostylous,infructescence,least,lobe,lon,longer,lowermost,mature,midpoint,moderately,nflorescence,oblong,older,one,open,opening,orange-brown,orolla,oung,ovate,pair,peduncle,pendulous,per,pericarp,plant,plurifoliat,porrect,portion,prickl,prickly,primary,ray,red-brown,reflexed,rounded,ruit,scar,sessile,side,smooth,sometimes,spaced,sparsely,spreading,stalk,stalked,staminat,stellate,stout,style,tamen,terete,tertiary,time,tube,upper,variously,vary,vein,velvety,venation,visible,way,weakly,wide,woody,yellow-brow,ympodial	articulation,bract,branching,broad-based,cell,colour,corolla,form,growth,hair,heteromorphism,inflorescence,insertion,na,needle-like,odour,orientation,placement,plurifoliate,position,present,pseudostipule,rhizome,scale,shape,smell,staman,stone,structure,symmetry,sympodial,texture,tuber,type,vegetative,xylopodia,zygomorphy
49	wfo-0001026407	success	221	146	104	117	42	0.471	.5,/3,0.5,0.5-0.6,0.5-1,0.5-2,1,1-10,3.5,acute,apart,apex,around,articulated,axi,base,becoming,berry,black,branched,broadly,brownish,calyx,cell,chartaceous,cm,congested,corolla,deep,dendritic,densely,diameter,ellipsoid,elliptic,entire,erect,filament,fleshy,flower,fruiting,glabrous,globose,golden,golden-pubescent,growth,inflorescence,internodal,interpetalar,irregularly,lateral,lax,leaving,like,lobed,long,lower,many,margin,membranous,mm,narrowly,new,numerous,oblique,obscured,occasionally,outline,pale,pedicel,peduncle,peg,perfect,persistent,petiole,plurifoliate,pubescence,pubescent,purple,purplish,ripe,scar,shiny,short,shrub,simple,sleeve,slightly,small,spaced,stellate,stem,stiff,surface,terminal,time,trichome,truncate,unit,upper,vine,violet,way,woody,yellow	+,-11,-6,0.9-3,1-1.2,1.2-1.5,1.3,1.5-1.7,1.5-2,1.5-7,2-2.5,2.5-3,20-30,20-40,3.5-5.5,4-5,5,5-10,5-7,5-merou,7-10,7-8,abaxially,adaxially,ag,aid,along,always,alyx,anther,anthesi,appearing,area,ark,basal,beneath,berr,blunt,branch,brown,capitate,clear,climbin,conical,connivent,deltate,dense,denser,discolorous,eaf,eed,evenly,exserted,flattened-reniform,free,geminat,glabrescen,glabrou,ilament,lamina,leafy,lengthening,lobe,loosely,markedly,midvein,minutely,mixture,near,nflorescence,often,older,open,orolla,pair,paler,papillat,papillate,pedice,pentagonal,per,pericarp,pitted,planar,pore,poricidal,portion,primary,pubescenc,reddish,revolute,ruit,sinus,slit,sparsely,sparser,spreading,stigma,stout,strongly,style,tangled,tem,testal,thin,tip,transition,tube,twining,ud,undulate,usually,vary,vein,weak,x,ympodial	5-merous,arrangement,articulation,bark,bract,branching,bud,colour,discoloration,form,fruit,geminate,glabrescent,hair,heteromorphism,interjected,leaf,leaflet,length,marking,na,odour,orientation,placement,position,prickle,pseudostipule,rhizome,scale,shape,spot,staman,stone,structure,symmetry,sympodial,texture,tissue,tuber,type,xylopodia,ye
50	wfo-0001026424	success	138	112	62	76	50	0.449	0.75-1.5,1-1.5,1-10,1-2,1.5-2,10-15,12-60,15,15-30,3-11,3-4,acuminate,acute,apex,base,blush-violet,broadly,calyx,campanulate,cell,cm,conspicuous,corolla,cuneate,cyme,distinct,ellipsoid,elliptic,facetted,glabrous,glandular,growing,hair,lanceolate,lanceolate-elliptic,larger,leaf,lobed,long,minute,mm,oblique,obovate,pedicel,petiole,pinnatisect,point,rarely,rotate-stellate,rounded,scorpioid,shrub,simple,stem,stone,tip,tissue,triangular,unwinged,usually,x,young	-25,-3.5,-4,1,1-,10,2,637/1,8-,acuman,acumen,age,angular,anthesi,aspect,axil,ba,becoming,blunt,bluntly,broad,clonal,close,common,cut,dia,downard,eaf,erect,exceeding,except,exerted,facing,floral,flower,fork,forked,general,gree,interacuminal,lacking,lasting,lavender,line,lobe,lon,lower,midvein,nflorescence,often,part,pedicellate,peduncle,plurifoliat,rachi,raised,rh,second,several,shallowly,short,sinus,slightly,soft-wooded,soon,straggly,time,toward,tub,ud,unit,violet,within,woody,year,ympodial	1-3.5,1-4,8-25,anther,articulation,bract,branching,breeding,bud,colour,connective,diameter,filament,form,fruit,growth,heteromorphism,inflorescence,insertion,interjected,interpetalar,leaflet,length,margin,marking,modification,na,number,odour,orientation,paired,pattern,placement,pore,position,prickle,pseudostipule,rhizome,scale,shape,size,spot,staman,symmetry,system,texture,trichome,tuber,type,xylopodia
51	wfo-0001026440	success	181	158	132	49	26	0.729	0-15,1-5,1.1-1.5,1.3-1.7,1.5-2.1,1/2,1/2-2/3,2-2.8,2-4,2.9-4.4,3-7,3-8,3/4,5-7,7-14,9,abaxially,accrescent,acute,adaxially,along,anther,apex,appressed,articulated,bark,basal,base,berry,blunt-tipped,bract-like,branch,branched,broadly,brown,calyx,chartaceous,closely,cm,conical,corolla,dendritic-echinoid,dense,diameter,dichotomy,directed,distal,distally,echinoid,elliptic,entire,filament,first,fleshy,flower,fruiting,globose,granular,green,greenish-yellow,hair,large,leaf,length,lengthening,lobe,long-attenuate,many,margin,minute,minutely,mm,mostly,multangulate,multangulate-pubescent,nearly,oblong,obovate,obovoid-oblong,obscure,obtuse,often,openly,ovate,pair,pale,pedicel,peduncle,perfect,persistently,petiole,pitted,pore,porrect-stellate,reniform,ripe,scabrous,semi-ovate,sessile,short-acuminate,short-stalked,shrub,simple,size,slit,small,somewhat,spaced,sparse,stellate,stellate-pubescent,stigma,style,suture,terete,testa,time,tomentose,tomentose-pubescent,tomentum,translucent,tree,truncate,tube,turning,uneven,usually,way,white,x,yellow,young	1.1-1.4,1.8-4.5,1.9-3.7,14-30,3-5,3.9-6.5,4-12,adaxiall,ag,always,anthesi,apparently,axillary,ba,blade,branche,capitat,developed,eaf,echinoi,eed,free,high,included,inserted,lobed,long,lower,m.,multangulat,nflorescence,older,orolla,plurifoliate,poricidal,pubescen,rather,ruit,runk,sometimes,stem,tamen,thick,thin,tip,ud,unit,vary,ympodial	age,articulation,bract,branching,bud,capitate,colour,form,fruit,growth,height,inflorescence,insertion,lobing,ovary,pattern,plant,pubescent,seed,shape,spacing,staman,texture,thicknes,trunk,type
52	wfo-0001026441	success	197	124	69	128	55	0.35	0-2,1-2,2-8,5,abaxially,adaxially,anther,apex,axillary,base,berry,bud,cell,chartaceous,cm,conical,corolla,distal,filament,forked,fruit,generally,glabrous,green,hair,half,herb,homostylous,interjected,lanceolate,leaf,leaflet,lengthening,light,like,long,lower,margin,middle,minute,mm,obtuse,odd-pinnate,orbicular,ovate,pale,pedicel,petiole,plant,plurifoliate,pore,poricidal,pubescent,ripe,rotate,rounded,slit,sparsely,stem,subsessile,subtending,symmetrical,terminal,tip,tri-,tuber,unit,usually,violet	.5,0.3-0.7,0.4-3,0.5-1.5,0.8,1-1.5,1-10,1.5-2,1.5-2.5,10,10-14,15-20,2-2.5,2-5.5,3-5,4-6,4-8,4-8.5,4.5-6.5,5-10.5,5-merou,6-15,7-20,7-8,9-14,absent,acumen,acuminate,ag,alyx,apart,apparently,articulated,attenuate,axe,blade,brownish,capitat,ciliate,condition,connivent,covering,decreasing,diameter,digestion,dorsally,drying,eaf,edge,eed,elliptic-lanceolate,end,enzyme,equal,erec,especially,exceeding,flat,flower,folded,fourt,fresh,geminat,glabrou,gradually,green-white,greenish,hair-like,honeycomb-shaped,internal,larger,lateral,living,lobe,make,minutely,mottled,mucilaginous,narrow,nflorescence,one,orolla,ovoid,pair,peduncle,perfect,petiolule,placed,puberulent,purple,removed,ruit,secondary,seed,semierect,seudostipule,short,size,slightly,spaced,specimen,stamen,star,ste,stigma,stolo,straight,style,subequal,tall,tamen,tem,testal,thick,throughout,toward,tube,typically,vary,wall,wet,white,whitish,wide,wing,x,yellow,ympodial	5-merous,age,appressed,articulation,bract,branching,breeding,broad-based,calyx,colour,connective,form,fourth,fruiting,geminate,growth,heteromorphism,inflated,inflorescence,insertion,interpetalar,length,marking,mature,modification,na,needle-like,odour,orientation,paired,pattern,placement,position,prickle,pseudostipule,rhizome,scale,shape,smell,spot,staman,stellate,stone,structure,surface,symmetry,sympodial,system,texture,tissue,trichome,type,vegetative,xylopodia,zygomorphy
53	wfo-0001026460	invalid_json_followup	131	127	80	51	47	0.611	.1,.5,0.5-1.5,1-1.5,1.5-2,1/2,10-15,13.5-21,2-2.5,2.5-3,4.5-5,5,6-7,6-9,8-10,acute-acuminate,anther,anthesi,apex,axi,base,berry,branched,brown,calyx,capitate,closely,cm,completely,corolla,dark,distal,drying,elliptic,filament,filiform,floccose,flower,fruiting,glabrous,globose,green,greenish,inflorescence,leaf,less,lobed,long,long-exserted,minutely,mm,nearly,opposite,ovary,ovoid-reniform,pair,pale,pedicel,pitted,pore,poricidal,reddish,scar,shaped,shrub,simple,spaced,stigma,style,subshrub,surface,tear-drop,tiny,tip,trichome,tube,vein,white,x,yellow	513,7-9,abaxially,acut,adaxially,becoming,conical,deflexed,deltate,dia,do,eaf,edicel,eed,erect,fide,free,frui,inflorescenc,internodal,like,lobe,lower,major,membraneous,middle,nflorescence,often,older,papillo,papillose,portion,puberulent,reddish-brow,reflexed,ruit,santo,slightly,somewhat,soon,stem,tall,tapering,tub,ud,unifoliat,unit,widest,woody,ympodial,young	'',[,``,abaxial,acute,appressed,articulation,branching,breeding,bud,characteristic,colour,connective,deflexion,form,fruit,growth,hair,height,inflated,insertion,length,margin,marking,mature,modification,na,number,odour,paired,pattern,plant,position,seed,shape,size,spacing,spot,subsh,symmetry,system,texture,type,value,width,{,}
54	wfo-0001026489	success	153	107	67	86	40	0.438	.3,0.05-0.1,0.25-0.5,0.8-1.3,1-1.5,1.5-5,2-5,2.5-4,2/3,5-6,acute,along,anther,anthesi,apex,area,axil,base,berry,branched,brown,calyx,cm,corolla,dark,deflexed,densely,difoliate,elliptic,erect,filament,flattened-reniform,fruiting,glabrous,globose,green,leaf,lobed,long,margin,minutely,mm,opposite,ovary,papillose,pedicel,petiole,pitted,pore,poricidal,pubescent,shaped,shrub,simple,stigma,style,tear-drop,tip,trichome,tube,uniseriate,unit,vein,way,white,widened,woody	0.5,0.5-0.75,0.5-1,0.5-2,0.6-1.4,0.8-1.2,0.8-3.7,1.3-3,2-3,2-4,2-8-flowered,2.5-13,8-13,appearing,ba,bark,beneath,broadly,closely,cup-shaped,deltoid,dia,differing,dry,eaf,edicel,eed,exserted,extending,flattened,fleshy,free,geminat,gra,incrassate,lamina,later,lateral,lobe,lon,lower,main,major,middle,minor,nflorescence,occasionally,often,older,one,overlappin,pair,paler,papillo,parallel,perpendicular,planar,portion,prominent,red-papillose,rhachi,ruit,scar,shiny,size,slender,somewhat,soon,spaced,specimen,stem,straight,strongly,surface,tall,tapering,terminal,thickened,tub,ud,usually,whitish,widest,x,ympodial,young	abaxial,articulation,bract,branching,cell,colour,diameter,form,fruit,geminate,growth,hair,height,heteromorphism,inflorescence,insertion,length,marking,na,odour,orientation,paired,placement,plant,position,prickle,pseudostipule,rhizome,seed,shape,spot,staman,stone,structure,symmetry,sympodial,texture,tuber,type,xylopodia
55	wfo-0001026490	success	272	156	104	168	52	0.382	7-pinnate,absent,accrescent,along,anther,anthesi,apex,articulated,axillary,base,bract,bracteate,branched,calyx,chartaceous,climbing,cm,connivent,corolla,crisped,darker,densely,directed,distally,ellipsoidal,elliptic,equal,extra-axillary,filament,flat,fruit,fruiting,glabrous,green,ground,immature,incurved,inflorescence,interjected,large,latrorse-introrse,leaf,leaflet,length,lobe,longitudinal,lower,main,margin,mature,midvein,mm,moderately,mottled,node,oblique,obliquely,oblong,obtusely,one,opening,orange,ovate,pedicel,pentagonal,per,perfect,petiole,plurifoliate,pointed,pore,present,pseudostipule,pubescence,pubescent,reflexed,rounded,shape,shoot,short,simple,slightly,slit,sometimes,sparsely,spur,stem,striping,strongly,surface,tawny,terminal,tip,transparent,trichome,truncate,unit,vegetation,vine,violet,white,woody,yellow,Ã	.5,0.1â0.2,0.1â2.5,0.2â1,0.2â1.5,0.3â3.5,0.4â0.8,0.5â1,0.5â1.5,0.5â3.5,0.5â8,0.7â3,0.8â1.5,0.8â12,1.2â8,1.5,1.5â2,1.5â3.5,1.5â5,1.8â2.2,1.9,10â20,1â1.2,1â15,1â2.5,1â3,1â8,2,2.5â3.5,2â2.5,2â4,2â6,2â8,3,3â4.2,3â4.5,3â5,3â5-pinnate,3â8,4.6,4â4.5,4â5,5-merous,5â7,6,7,7â15,=,[,],abaxially,acuminate,acute,adaxially,ag,alyx,apart,apical,apicall,apparently,around,axe,ba,becoming,blade,broadly,brown,capitat,cauline,ciliate,commonly,completely,contiguously,cordate,covered,cylindrical,decreasing,diameter,distal,eaf,eed,eglandular,entire,exceeding,expanded,flattened,flower,free,fused,geminat,irregularly,lacking,lateral,lenticular,light,lobed,long,lowermost,lunate,markedly,match,mean,mean=,medium,middle,minute,multicellular,near,nearly,nflorescence,obliqu,oblon,obtuse,occasionally,orolla,ovate-lanceolate,pair,papillose,part,peduncle,perfec,petiolule,pubescen,punctate,pur,rachi,radial,reniform,resulting,revolute,rooting,ruit,sand,seed,seudostipule,shorter,similar,size,slender,smaller,smooth,somewhat,spaced,stamen,stigma,striation,style,tamen,teardrop-shaped,tem,thickened,toward,trailing,trichomessympodial,tube,typically,unbranched,undulate,vary,wide,wing,yellowish-tan,youn,Â½,â4,â4.5,â8,â9.5	0.1-2.5,0.4-0.8,0.5-1.5,3-4.5,4.5,age,appressed,articulation,berry,branching,breeding,broad-based,cell,colour,connective,form,geminate,growth,hair,heteromorphism,inflated,insertion,interpetalar,marking,modification,na,needle-like,odour,orientation,paired,pattern,placement,position,prickle,rhizome,scale,smell,spot,staman,stone,structure,symmetry,sympodial,system,texture,tissue,tuber,type,vegetative,xylopodia,young,zygomorphy
56	wfo-0001026491	invalid_json	165	149	115	50	34	0.697	.5,1,1-2,1.5-2,1.5-2.5,1.5-3.5,1.7,10-50,2-3,2-4,2-celled,2.5-3.5,3,3-pinnate,5-6,5-8,6-8,7-8,abaxially,absent,acuminate,acute,adaxially,anther,apex,appressed,articulated,averaging,base,bent,berry,blade,bract,branched,branching,broadly,cellular-papillose,cellular-pilose,central,cm,conspicuously,cuneate,deciduous,deep,deltoid,diameter,directed,elliptic-lanceolate,entire,flower,glistening,globose,green,hair,highly,homostylous,inflorescence,interjected,lanceolate,leaf,leaflet,less,light,lobe,long,margin,middle,minutely,mm,near,oblong-elliptic,obtuse,often,ovate,ovate-elliptic,ovoid,pale,pedicel,peduncle,perfect,petiole,pilose,pore,poricidal,porrect-incurved,present,pubescent,purple,readily,rotate-pentagonal,rotate-substellate,rounded,row,sharp,shortly,shrub,simple,small,spotted,stigma,strigose,strongly,subacute,suborbicular-ovate,surface,tawny,tip,tube,uniseriate,usually,ventral,white,whitish,x,yellow	1977,5-merou,abaxiall,alyx,anderson,apparently,axe,ba,bayonet,capitat,connivent,crinkly,densely,distall,eaf,eed,equal,filament,first,geminat,greatly,growing,lateral,lower,lunulat,mean,nflorescence,orolla,plurifoliate,point,rachi,rarely,reduced,ruit,scandent,seudostipule,similar,slender,straight,strigo,strong,tal,tamen,tem,terminal,tightly,tyle,unit,upright,ympodial	'','bayonet,5-merous,[,],``,articulation,calyx,capitate,characteristic,colour,corolla,distally,form,fruit,growth,height,length,lunulate,number,pilosity,plant,pseudostipule,seed,shape,size,staman,stem,style,texture,type,value,{,}
57	wfo-0001026501	success	195	91	48	147	43	0.246	.5,0.27-0.7,3-9,3.5-4,4-5,?,acicular,anther,apex,apparently,articulated,base,berry,branched,calyx,chartaceous,cm,cuneate,elongating,entire,filament,fruit,fruiting,green,leaf,length,lobed,long,margin,mauve,mm,pale,pedicel,petiole,poricidal,prickle,prickly,rounded,shrub,simple,spherical,spreading,stellate-pubescent,surface,tapering,terminal,unit,white	-1.7,-3,.1,.35,.6,.7,/3,0,0-1,0-2,0.05-0.3,0.1,0.2-1.8,0.5,0.5-0.6,0.5-0.9,0.5-1,0.6-1,0.6-1.1,0.6-2,0.9-2.2,1,1-2,1-2.5,1.8-2.2,1/2-2/3,1/4,1/6-1/2,2-10,2.5-4,2.8-3,3-4,3-5,4-7,5-merous,6-9,7-9,abaxially,acute,almost,alyx,apar,apart,apically,bark,becoming,blade,borne,brown,brown-green,color,concolorous,curved,deltate,densely,diameter,discolorous,drying,dull,eaf,eed,elliptic,elongated,equal,erect,eye,filiform,filiform-acuminat,flattened,flattened-reniform,flower,free,glabrou,glabrous,gray,infructescence,known,light,lobe,longer,lower,mature,midpoint,moderately,naked,nflorescence,often,older,one,open,orange-brown,orbicular,orolla,oung,ovate,pair,peduncle,pendulous,per,perfec,pericarp,plurifoliat,porrect,portion,prickl,primary,ray,reddish,ruit,scandent,scar,sessile,shoot,short,shorter,slender,small,smooth,sometimes,somewhat,spaced,sparsely,stalk,stalked,stellate,stem,straight,style,subsessile,tamen,terete,time,tip,trichome,tube,unarme,unarmed,upper,variously,vary,vein,visible,way,wide,yellow,yellow-green,ympodial	articulation,bract,branching,breeding,broad-based,cell,colour,corolla,form,growth,hair,heteromorphism,inflorescence,insertion,interjected,interpetalar,leaflet,marking,na,odour,orientation,pattern,perfect,placement,plurifoliate,pore,position,pseudostipule,rhizome,scale,shape,spot,staman,stone,structure,symmetry,sympodial,system,texture,tissue,tuber,type,xylopodia
58	wfo-0001026513	success	138	137	73	65	64	0.529	.1,/3,0.8-2,1-1.5,1-3,2-2.2,2-5,3-5,4-5,7-9,8-16,acute,anther,apex,area,bark,base,calyx,closely,cm,completely,corolla,decurrent,elliptic,filament,flower,fruit,fruiting,glabrous,globose,green,lanceolate,lateral,leaf,less,lobed,long,long-styled,lower,main,mature,mm,opposite,ovary,pair,papillose,pedicel,petiole,plant,pore,scar,shaped,short-styled,shrub,slender,small,spaced,stem,stigma,style,surface,tear-drop,tip,treelet,trichome,tube,uniseriate,unit,vein,venation,way,white,young	.25,.3,.75,3-6-flowered,6-8,anthesi,apiculate,ba,berry,broadly,caly,darkish,deflexed,delicate,deltoid,dia,differentiated,dry,eaf,edicel,eed,erect,except,exserted,free,gre,hirsute,immature,known,leave,live,lobe,longer,middle,minute,minutely,much,nflorescence,obscure,older,overlappin,pale,poricidal,portion,prominent,raised,reflexed,rest,ruit,shiny,simple,somewhat,soon,specimen,straight,styl,tall,ud,undersurface,unifoliat,wide,widest,woody,x,ympodial	0.25,0.75,1,3,3-6,appressed,articulation,bract,branching,breeding,broad-based,bud,cell,colour,connective,diameter,form,grey,growth,hair,height,heteromorphism,inflated,inflorescence,insertion,interjected,interpetalar,leaflet,length,margin,marking,modification,na,needle-like,number,odour,orientation,overlapping,pattern,placement,position,prickle,pseudostipule,rhizome,scale,shape,smell,spacing,spot,staman,stone,structure,symmetry,sympodial,system,texture,tissue,tuber,type,unifoliate,vegetative,width,xylopodia,zygomorphy
59	wfo-0001026529	invalid_json_followup	219	170	115	104	55	0.525	0-25,0.3-1,0.5-4.5,1-10,1-2,1.1-2.5,1.5-2.5,1.5-4,10-28,11-14,12-22,3-12,3-5,3-6,3-9.5,5-15,5-17,5-9,6-20,abaxially,adaxially,anther,apex,axillary,base,berry,blue,brownish,bud,cell,chartaceous,clavate,cm,condition,cordate,corolla,covering,creamy,dark,deep,diameter,distal,drying,elliptic,faintly,filament,flower,forked,fresh,fruit,glabrous,glandular,globose,greatly,green,greenish,hair,half,herb,interjected,lanceolate,lateral,leaflet,length,light,like,lilac,long,lower,margin,medium,membranous,mm,moderately,non-glandular,oblique,odd-pinnate,ovate,ovoid,pair,pedicel,peduncle,pentagonal,petiole,plant,pore,poricidal,pubescent,pure,rarely,ripe,rounded,seed,shape,short,size,slightly,stem,stigma,straight,style,substellate,subtending,terminal,testal,thick,tip,trichome,typically,varying,wall,white,whitish,x,yellowish	1,1-3,1-4.5,10,120-210,2,2-5,2-7.5,20-60,4-8,5-merou,50-70,600-950,?,acumen,acuminate,acute,ag,along,alyx,apart,apparently,articulated,attenuate,axe,blade,broadly,capitat,ciliate,connivent,densely,digestion,dorsally,dot,eaf,edge,eed,enzyme,erec,especially,exceeding,except,flat,folded,geminat,generally,glabrou,gland,gree,green-white,hair-like,hal,head,homostylous,honeycomb-shaped,lengthening,living,lobe,longer,lunate,make,midrib,minutely,mucilaginous,narrowly,nflorescence,often,orbicular,orolla,perfect,petiolulate,petiolule,plurifoliate,proximal,puberulent,reduced,removed,ruit,scattered,sessile,seudostipule,slit,spaced,specimen,stamen,ste,subequal,subsessile,tall,tamen,tem,tetralobulate,throughout,tri-,tube,unit,unwinged,usually,vary,wet,wide,wing,yellow,ympodial	'',[,\u201chair-like\u201d,``,appressed,arrangement,articulation,bract,branching,breeding,broad-based,calyx,capitate,characteristic,colour,connective,form,fruiting,glabrousnes,growth,height,inflated,inflorescence,insertion,interpetalar,leaf,marking,mature,modification,na,needle-like,odour,orientation,ovary,paired,pattern,position,prickle,pseudostipule,scale,smell,spacing,spot,staman,surface,symmetry,system,texture,tissue,type,value,vegetative,zygomorphy,{,}
60	wfo-0001026534	success	150	171	114	36	57	0.76	0.5-1,1-2,1-2.5,1-3,1.5-6,1.5-9,10-20,10-50,15-50,2-2.5,2-7,2-8,2.5-15,3-,3-10,3-25,3-4,3-5,3.5-4,4-10,4.5-5,5-6,6-35,7-40,abaxially,absent,acuminate,acute,adaxially,apart,apex,apiculate,auriculate,basal,base,beyond,branched,bright,calyx,cell,chartaceous,cm,connective,connivent,cordate,cylindrical,darker,deltate,densely,diameter,directed,distally,eglandular,ellipsoidal,entire,equal,flattened,fleshy,flower,fruit,glabrous,glandular,hair,lanceolate,leaving,lobe,long,longitudinal,m.,margin,mm,moderately,narrowly,obtuse,often,orange,ovate,ovoid,pale,pedicel,pedicellar,peduncle,perfect,petiole,pinkish,pore,puberulent,pubescent,purple,rachi,radiu,red,remnant,shorter,simple,slightly,stamen,stellate,stigma,stone,stripe,style,subcoriaceous,thecae,tip,tree,triangular,truncate,unbranched,unit,vein,white,x,yellow	-1.5,10-15,2-3,2.5-4,4-foliat,7-12,aggregate,ape,articulated,axe,blade,eaf,eed,exserted,lemon-yello,lon,lower,nflorescence,nther,orolla,presen,puberulen,ruit,small,spaced,sparsely,tal,tem,time,tomento,truncat,tube,ud,vary,wide,ympodial	4-foliate,anther,articulation,bract,branching,breeding,bud,colour,corolla,direction,exsertion,filament,form,growth,height,heteromorphism,inflorescence,insertion,interjected,interpetalar,leaf,leaflet,lemon-yellow,length,marking,mature,na,odour,orientation,ovary,paired,pattern,placement,plant,position,present,prickle,pseudostipule,rhizome,scale,seed,shape,size,spacing,spot,staman,stem,structure,symmetry,sympodial,system,texture,theca,tissue,tuber,type,xylopodia
61	wfo-0001026535	success	248	178	149	99	29	0.601	.5,.8,0.15,0.2,0.7-1.5,1,1-2,1.2-2,1.3,1.5-3,1/3,2-5,2.5,3-5,3.5-4,4-15,5-7,7-8,abaxial,abaxially,accrescent,adaxially,age,almost,along,anther,apically,apparently,around,bark,base,becoming,berry,black,brachyblast,branch,branched,branching,broadly,brown,calyx,chartaceous,clavate,clustered,cm,conical,corolla,cuneate,cup,dark,dendritic,dendritic-pubescent,dense,developed,developing,diameter,dilated,distributed,dorsal,dry,drying,elliptic,elongated,entire,evenly,except,filament,fine,flat,flexuous,forming,fruit,fruiting,glabrous,green-brown,leaf,length,liana,like,lobe,lobed,long,loose,lower,main,margin,membranous,midvein,minute,minutely,mm,network,number,oblong,obovate,older,orange-brown,ovate,ovoid,pair,partly,pedicel,peduncle,pericarp,petiole,plant,pointed,pore,poricidal,primary,prominent,pubescent,rachi,raised,rarely,ray,ridged,shrub,side,slightly,smooth,sparsely,stem,stigma,style,surface,terete,terminal,tertiary,thin,tip,tissue,trichome,truncate,tube,unarmed,unevenly,unlignified,vein,venation,violet,visible,white,widely,wider,x,yellowish,young,youngest	.1,.2,.4,0-0.5,0.1-0.2,0.2-0.3,0.2-1.5,0.5-1,1-3,1-5,1.5-2,1/2-2/3,2-3,3,3-4.5,5-10,5Â°,absent,acute,alternate,alyx,anthesi,apar,apex,area,articulated,clearly,concolorous,condensed,cupular,curved,deeply,delineate,delineated,deltoid,detaching,discolorous,divided,domatia,eaf,eed,ellipsoi,equal,eye,fertilisation,flower,free,frui,increasing,inside,known,leave,lengthening,linear,lon,loop,m.,marginal,mostly,much,naked,nflorescence,nther,obscure,orolla,outside,papillo,pendulous,perfec,plurifoliat,portion,protruding,reaching,rounded,ruit,scar,secondary,see,short,simple,sinus,slender,smaller,soon,spaced,spreading,stump,tearing,toward,translucent,tufted,two,ud,uneven,unit,vary,weakly,wide,ympodial	-0.5,0.1,1.5,45Â°,accrescence,angle,arming,arrangement,articulation,breeding,bud,colour,ellipsoid,form,growth,inflorescence,marking,na,ovary,papillose,pattern,perfect,position,shape,spot,symmetry,system,texture,type
62	wfo-0001026604	success	192	114	75	117	39	0.391	.75,2.3-3.5,5,age,aid,along,anther,apex,articulated,articulation,base,berry,branching,c.,calyx,cell,clearly,climbing,cm,cordate,corolla,densely,differentiated,distal,entire,expanding,filament,fruit,fruiting,glabrous,globose,growth,leaf-opposed,lengthening,liana,lobed,margin,midrib,minute,mm,nodding,oblique,papillose,pedicel,perfect,petiole,point,pore,poricidal,purple,quarter,red,ripe,shape,shrub,simple,slit,stellate,stout,structure,support,surface,terminal,time,tip,trichome,truncate,tube,twisting,uniseriate,unit,vining,violet,way,woody	.4,.5,0,0.1,0.4-0.6,0.8-0.9,0.8-1,1-1.2,1.1-1.3,1.2-1.7,1.5-2,1.5-9,10-30,2-2.3,2-2.5,3-3.5,3-5,3.5-4,4-4.5,4.5-7,5-7,50-100,<,?,absent,acuminate,always,anthesi,apart,appearing,atop,bark,basal,brow,brown,capitate,comical,conical,cucullate,cupped,dark,deflexed,diameter,distinct,drying,due,eaf,eed,ellipsoid,elongate,exserted,flattened,flexuous,flower,free,inflated,later,leaving,lobe,lower,mere,minutely,narrowly,new,nflorescence,occasionally,older,outline,ovary,ovate,overall,ovoid,pair,pale,papillo,part,particularly,peduncle,peg,per,pericarp,pitted,planar,plurifoliat,poin,portion,primary,pubescent,receptacle-like,reddish,reniform,rim,ruit,scar,series,shiny,sinuate,slender,slightly,somewhat,spaced,stem,stigma,strongly,style,swolle,testal,thin,tub,ud,undulation,upper,vein,widely,x,ympodial,Â½	bract,breeding,colour,connective,form,hair,heteromorphism,inflorescence,insertion,interjected,interpetalar,leaf,leaflet,length,marking,na,odour,orientation,paired,pattern,placement,plurifoliate,position,prickle,pseudostipule,rhizome,scale,spot,staman,stone,symmetry,sympodial,system,texture,tissue,tuber,type,xylopodia,zygomorphy
63	wfo-0001026607	success	204	144	98	106	46	0.48	0-3,0-4,0.1-0.3,0.5-5.8,0.8-3.4,0.8-4.5,0.8-5,1-2,1-8,1.5-4,10-30,2-10,2-2.5,2.4-5.8,2.5-3.8,2.7-19,4-10,4-6,5,5.8-19.8,6-10,abaxially,absent,adaxially,anther,apex,base,berry,blade,brownish,cell,chartaceous,clavate,cm,coarse,condition,corolla,deep,diameter,distal,drying,filament,finely,flower,forked,fresh,fruit,glabrous,globose,green,greenish,hair,half,herb,high,interjected,lanceolate,lateral,leaf,leaflet,like,long,margin,medium,membranous,minute,mm,moderately,odd-pinnate,ovoid,pair,pedicel,peduncle,pentagonal,perfect,petiole,plant,plurifoliate,pore,poricidal,puberulent,pubescent,rachi,rarely,ripe,seed,simple,size,stem,stigma,style,terminal,tip,tri-,unit,violet,whitish,x	0.3-1.8,1-10,1-3.8,1-5,2-3,3-8,5-merou,acumen,acute,ag,along,alyx,apart,apparently,articulated,attenuate,axe,axillary,basiscopic,bud,capitat,ciliate,clearly,connivent,covering,decreasing,decurrent,digestion,dorsally,dot,eaf,edge,eed,elliptic,enzyme,especially,exceeding,flat,folded,forming,geminat,generally,glabrou,greatly,gree,green-white,hair-like,hal,homostylous,honeycomb,larger,lengthening,living,lobe,lower,make,marked,midrib,minutely,much,mucilaginous,nflorescence,obtuse,often,orbicular,orolla,ovate,petiolulate,present,removed,rosette,rounded,ruit,scattered,semierec,sessile,seudostipule,shaped,short,side,slit,sometimes,spaced,specimen,stamen,ste,straight,subtending,tall,tamen,tem,testal,thick,throughout,toward,tube,typically,unwinged,usually,vary,wall,wet,white,without,yellow,ympodial	appressed,arrangement,articulation,bract,branching,breeding,calyx,capitate,colour,connective,form,fruiting,growth,height,heteromorphism,inflated,inflorescence,insertion,interpetalar,length,marking,mature,modification,na,number,odour,orientation,ovary,paired,pattern,placement,position,prickle,pseudostipule,scale,shape,spot,staman,stone,structure,symmetry,sympodial,system,texture,tissue,type
64	wfo-0001026613	invalid_json_followup	159	155	100	59	55	0.629	1-10,1-2,1.5-4,11-19.5,2-7.5,2.3-8,2.5-2.8,3-5,4.5-8.5,5,5-6,5-7,5.5-7,6-12,6.2-9.5,8-18,8.5-10,8.5-9,9.5-13.5,abaxially,absent,acumen,adaxially,along,anther,apex,base,berry,blade,borne,chartaceous,cm,conical,connivent,cordate,corolla,densely,diameter,dorsally,edge,especially,filament,flat,flower,folded,forked,fruit,glabrous,green,hair,half,herb,immature,interjected,lanceolate,lateral,leaf,leaflet,lengthening,like,long,margin,mature,membranous,middle,midrib,minute,minutely,mm,mottled,odd-pinnate,ovate,pedicel,peduncle,perfect,petiole,plant,pore,poricidal,proximal,puberulent,pubescent,purple,rotate-pentagonal,singly,size,slit,stem,stigma,style,symmetrical,terminal,tip,tube,tuber,typically,unknown,unwinged,x,yellow	0.5-1,0.6,3-10,4-5,5-merou,6-8,acuminate,ag,alyx,apart,apparently,articulated,attenuate,axe,axillary,bud,capitat,ciliate,decreasing,distal,eaf,eed,end,erec,geminat,generally,greatly,hal,homostylous,larger,lobe,lower,m-1.2,nflorescence,orolla,pair,petiolule,plurifoliate,pubescen,ruit,secondary,semierect,seudostipule,spaced,sparsely,ste,stolo,subequal,subtending,tall,tamen,tem,toward,tri-,unit,unknow,usually,vary,ympodial	'',0.6-1.2,[,``,age,appressed,arrangement,articulation,bract,branching,breeding,calyx,capitate,characteristic,ciliation,colour,connective,connivence,form,fruiting,growth,height,inflated,inflorescence,insertion,interpetalar,length,marking,modification,na,number,odour,ovary,paired,pattern,position,presence,present,prickle,pseudostipule,pubescence,scale,seed,shape,spacing,spot,symmetry,system,texture,tissue,type,value,width,{,}
65	wfo-0001026614	success	200	136	84	116	52	0.42	0.5,1.3-1.8,3-foliate,abaxially,acute,adaxially,anther,apex,armed,articulated,base,berry,black,blunt-tipped,broad-based,brown,calyx,clavate,cm,commonly,dark,developed,directed,distally,dried,entire,especially,evenly,extra-axillary,filament,fruit,fruiting,geminate,glabrescent,glabrous,gland-tipped,globose,hair,homostylous,interpetalar,irregularly,leaf,linear,lobe,lobed,long,lower,margin,minute,mm,mottled,oblique,orange,orange-red,pair,pedicel,petiole,pore,prickle,rarely,repand,ripe,rotate-pentagonal,rounded,shallowly,shrub,simple,slightly,smaller,sometimes,sparsely,spreading,stellate,stellate-pubescent,stem,surface,tapering,tissue,unarmed,weakly,well,white,x,yellowish	.8,0.2,0.2â0.3,0.4-0.7,0.5â2,1-,1.5â2,11-15,15â30,1â2,1â3,1â5,2.2,2.2-5.5,2.5,2.5â3,20â25,2â4,2â4-branched,2â6.5,3.2-5.2,3â10,4-7,4.5â11,4.5â5.5,5,5-merou,5.3-8.2,50,6.4-8.4,6â8,7.2-9.8,8â10,9â16,>,absent,across,acuminate,adaxiall,alyx,apart,apparently,axe,ba,blade,campanulate,capitat,chartaceous,closely,concentrated,cylindrical,densely,denser,diameter,eaf,eed,erect,expanded,flattened-reniform,fleshy,flower,foveolate,globo,golden,internode,lanceolate-attenuate,lateral,less,lon,midpoint,midvein,minutely,nearly,nflorescence,obtuse,often,orolla,ovate,ovate-lanceolate,ovoid,peduncle,per,perfect,pubescence,pubescent,rachi,ray,reflexed,ruit,scattered,sessile,shin,side,similar,somewhat,soon,spaced,stellae,stigma,style,tall,tamen,tem,time,tissu,tube,ud,unarme,usually,vary,vein,wide,yellow,ympodia,young,â5	0.5-2,1-2,1-3,2-4-branched,4.5-5.5,5-merous,appressed,articulation,bract,branching,breeding,cell,colour,connective,corolla,form,growth,heteromorphism,inflated,inflorescence,insertion,interjected,leaflet,length,marking,mature,modification,na,needle-like,odour,orientation,paired,pattern,placement,position,pseudostipule,rhizome,scale,shape,spot,staman,stone,structure,symmetry,sympodial,system,texture,tuber,type,unit,xylopodia,zygomorphy
66	wfo-0001026642	success	193	156	80	113	76	0.415	0.1,0.25,5,6,<,abaxial,abaxially,along,annual,anther,anthesi,apart,apex,articulated,axillary,base,bipinnate,black,blade,blue,brown,calyx,cell,clavate,cm,dark,densely,denser,diameter,elliptic,filament,flattened,flower,fruit,glabrous,glandular,globose,green-purple,hair,herb,lavender,leaf,length,lilac,long,mm,multicellular,number,oblong,often,ovate,pale,pedicel,peduncle,pentagonal,perennial,perfect,petiole,pinnate,pitted,pore,present,pubescent,shallowly,simple,sparsely,stigma,stone,style,surface,time,tube,uniseriate,usually,vein,violet,white,woody,x,yellow	.05,.1,.8,0.1â0.3,0.2,0.4,0.4â2.2,0.5,0.5â,0.5â0.7,0.5â1.7,0.5â2.0,0.5â3.5,0.6,0.6â1.0,0.75â1.0,0.75â2.0,0.7â1.6,0.8â1.2,1.0,1.0â2.0,1.2â1.7,1.2â2.0,1.2â3.5,1.2â6.2,1.6â8.0,1.9â3.0,12â30,1â10,1â3,2.0â4.0,2.5â3.5,2.5â4.0,2.8â3.0,3.0â5.1,3â5,4.0â6.0,4â7,5.0â7.0,50â100,acute,adaxiall,adaxially,ag,appressed,axe,ba,borne,branched,chartaceous,circular,connivent,cylindrical,decreasing,decumbent,divided,eaf,eed,either,equal,erect,fleshy,geminat,glabrescen,gland,half,indumentum,lobe,lon,longitudinal,lower,m.,moderately,narrow,nflorescence,obtuse,occasionally,opening,orolla,pair,pinnae,poricidal,primary,probably,rapidly,rounded,ruit,secondary,sessile,shoot,side,slit,sometimes,spaced,straight,subglabrous,tal,tamen,tem,tip,unicellular,unifoliate,unit,vary,wide,wing,ympodial,â1.2,â11.0,â2.0,â4.5,â6,â7	0.4-2.2,0.5-2.0,0.5-3.5,0.5-6.2,0.5-8.0,0.75-1.0,0.75-2.0,0.8-1.2,1-10,1-3,1.2-1.7,1.2-3.5,12-30,2.0-4.0,2.8-3.0,3.0-5.1,4-7,4.0-6.0,5.0-7.0,50-100,articulation,bract,branching,breeding,colour,connective,corolla,form,fruiting,glabrousnes,glandularity,growth,height,heteromorphism,history,inflorescence,insertion,interjected,interpetalar,leaflet,life,margin,marking,mature,modification,na,odour,orientation,ovary,paired,pattern,placement,plant,position,prickle,pseudostipule,pubescence,rhizome,scale,seed,shape,size,spacing,spot,staman,stem,symmetry,system,texture,tissue,tuber,type,venation,width,xylopodia,ye
67	wfo-0001026651	invalid_json_followup	222	160	97	125	63	0.437	-celled,1.8,2.8,3,3-plurifoliate,4,accrescent,acuminate,acute,anther,antrorse,apex,appressed,arcuate,articulated,attenuate,base,beneath,berry,brochidodromous,brownish-green,calyx,chartaceous,ciliate,connivent,cyme,dark,decurrent,densely,drying,dull,entire,erect,exfoliating,filament,flattened,flower,fruit,geminate,glabrescent,glabrous,globose,green,hair,herb,introrsely,lanceolate,lateral,leaf,length,light,lobe,long,margin,membranaceous,mm,moderately,mostly,much-branched,narrowly-elliptic,oblong-ellipsoid,onto,ovate-reniform,pedicel,peduncle,pedunculate,per,perfect,petiole,plant,pore,pubescent,revolute,ripe,rounded,seed,shape,shrub,similar,simple,slightly,sometimes,stellate,stem,style,sub-opposite,surface,terminal,translucent,trichome,unbranched,undulate,uniseriate,unit,venation,white,woody	0.2â1.3,0.35â2.6,0.9â3,1,1â2,2.2â10,2â11.5,2â13,2â3,2â3.3,2â4,2â4.5,2â8,3â5,3â7,4â6,4â7.8,5-merou,6â10,6â14,8,abaxially,absent,adaxiall,adaxially,along,alyx,anisophyllous,antror,antrorsely,apar,ark,asymmetric,axi,beyond,branch,broadly,brown,capitat,capitate,cell,circular,cm,cordate,cylindrical,decumbent,diameter,differing,directed,discolorous,eaf,eed,elliptic,emarginate,equal,exserted,eye,flexuous,frui,geniculate,glabrou,glandular,growt,head,highly,hilum,hollow,impressed,less,like,longitudinal,lower,lying,major,markedly,matte,midrib,minor,moderate,multicellular,naked,new,nflorescence,normally,obtuse,older,one,opening,orolla,ovate-deltate,ovate-lanceolate,parallel,poricidal,prominent,pubescence,reduce,region,ruit,secondary,shiny,single-celled,size,slit,small,smaller,spaced,stalk,stamen,stigma,straight,subapical,tall,tamen,tem,turning,upper,usually,vary,vein,visible,wide,yellow,ympodial,young,Ã	'',1\u20132,2.2\u201310,2\u201,2\u201313,2\u20133,2\u20134,2\u20138,3\u20137,4\u20136,5-merous,6\u201314,[,``,arrangement,articulation,bark,bract,branching,breeding,characteristic,colour,connective,corolla,form,fruiting,glabrousnes,growth,height,inflated,inflorescence,insertion,interjected,interpetalar,leaflet,marking,mature,modification,na,number,odour,orientation,ovary,paired,pattern,position,scale,smell,spot,staman,structure,symmetry,sympodial,system,texture,tissue,type,value,vegetative,ye,zygomorphy,{,}
68	wfo-0001026656	invalid_json_followup	211	177	110	101	67	0.521	0-4,1,1-1.8,1-10,1-2,1.1-8.1,2-6,2.5-17,20-60,4-13,4-8,5-18,5-35,5.5-27,9-11,abaxially,acuminate,acute,adaxially,anther,apex,base,blade,blue,broadly,brownish,bud,cell,chartaceous,cm,condition,connate,connivent,corolla,cuneate,dark,densely,diameter,distal,dorsally,dot,drying,edge,elliptic,filament,flat,flower,folded,fresh,fruit,glabrous,globose,green,greenish,hair,herb,interjected,lanceolate,lateral,leaflet,lengthening,light,long,lower,lunate,margin,membranous,minutely,mm,moderately,mottled,narrowly,oblique,odd-pinnate,ovate,ovoid,pair,pedicel,peduncle,pentagonal,petiole,plant,plurifoliate,pore,poricidal,puberulent,pubescent,purple,rotate-pentagonal,scale-like,scattered,seed,slit,somewhat,stem,style,subglabrous,subtending,symmetrical,terminal,tip,tri-,truncate,tuber,unit,unwinged,violet,white,whitish,wing	0.3-3,0.3-4.2,0.4-6.5,0.7-10.5,0.9-13,1-3.8,1-4,1-5,1.5-7,10,2-8,4-10,5,5-merou,absent,acumen,ag,along,alyx,apart,articulated,attenuate,bearing,borne,capitate,ciliate,clavat,covering,curved,decurrent,digestion,eaf,eed,end,enzyme,erec,especially,exceeding,forked,geminat,generally,glaucous,greatly,green-white,greenish-yellow,hair-like,half,homostylous,honeycomb-shaped,larger,like,living,lobe,make,middl,midvein,mucilaginous,nflorescence,non-glandular,occasionally,often,orolla,petiolulate,petiolule,pubescen,rachi,ranging,removed,ruit,seudostipule,short,singly,slightly,sometimes,spaced,specimen,stamen,star,ste,stigma,stolo,straight,subequal,tall,tamen,tem,tertiary,testal,therefore,thick,throughout,tinged,tube,typically,vary,wall,wet,wide,without,yellow,ympodial	'',[,``,age,appressed,arrangement,articulation,bract,branching,breeding,broad-based,calyx,characteristic,colour,connective,form,fruiting,geminate,growth,height,heteromorphism,inflated,inflorescence,insertion,interpetalar,leaf,length,marking,mature,middle,modification,na,needle-like,number,odour,orientation,ovary,paired,pattern,placement,position,presence,present,prickle,pseudostipule,scale,shape,smell,spot,staman,stone,structure,surface,symmetry,sympodial,system,texture,tissue,trichome,type,value,vegetative,width,winged,zygomorphy,{,}
69	wfo-0001026663	success	251	127	76	175	51	0.303	0.9-1.5,1-3.2,1.1-2.1,2.9-5,abaxially,accrescent,adaxially,anther,apex,appressed,articulated,attenuate,base,berry,blunt-tipped,branched,brown,calyx,cm,completely,constricted,corolla,covering,dark,directed,distally,drying,echinoid,echinoid-pubescent,entire,enveloping,filament,fleshy,fruit,fruiting,glabrescent,globose,green,hair,immature,lanceolate,leaf,length,long,lower,many,margin,mm,multangulate,obtuse,openly,pedicel,perfect,persistent,petiole,plurifoliate,pore,poricidal,rich,scabrous,shrub,simple,slightly,small,somewhat,stellate,stem,time,tip,tomentose,tree,unarmed,unit,violet,white,x	-15,-2.9,-8,-9.7,.5-2.5,/25-1/15,/3,0-160,0.2-0.6,0.3-0.8,0.4-2.2,1,1-2.5,1-5,1.1,1.2-2,1.4-2.6,1.4-3.1,1.6-2.3,1.9-2.6,1/2,1/3,1/4-1/2,10-26,10.3-13.2,12-14,2-12,2.1-2.6,2.5-3.7,2.8-5.3,2/3,24-45,3-5,3.5-5,3.8-5.7,31,4.5-5.7,4.7-25.9,5-8,5.5-,5.5-8.8,7.5-9,8-17,acuminate,acute,adaxiall,ag,along,angled,anthesi,apart,apparently,around,ascending,axe,axillary,bark,becoming,blade,branch,broadly,bud,capitat,chartaceous,closely,conical,cylindrical,densely,diameter,distributed,eaf,echinoi,edge,eed,elongated,especially,evident,exserted,farinose,flared,flower,free,glabrescen,glabrous,granular,granular-tomentose,greenish-brown,grooved,inserted,lateral,lengthening,less,light,line,lined,lobe,lobed,long-stalke,long-stalked,longer,longitudinal,longitudinally,m.,main,matur,midrib,midvein,minute,multangulate-pubescent,nearly,nflorescence,occasional,occuring,older,opening,orolla,ovate,ovate-lanceolat,ovate-lanceolate,pale,peduncle,porrect-stellate,present,pseudo-terminal,pubescence,pubescent,rachi,rather,ray,ridged,robust,ruit,runk,sessile,short,short-stalked,side,slit,sometimes,soon,spaced,sparsely,stalk,stalked,stamen,stigma,strongly,style,subcampanulate,subcoriaceous,subglabrous,subglobose,suture,tall,tamen,tangled,terete,thick,thin,tomentose-pubescent,tomentum,touching,tube,ud,unarme,upper,usually,vary,vein,way,whitish,wide,yellow,ympodial,young	articulation,bract,branching,breeding,broad-based,cell,colour,connective,form,growth,heteromorphism,inflated,inflorescence,insertion,interjected,interpetalar,leaflet,marking,mature,modification,na,needle-like,odour,orientation,paired,pattern,placement,position,prickle,pseudostipule,pseudoterminally,rhizome,scale,shape,smell,spot,staman,stone,structure,surface,symmetry,sympodial,system,texture,tissue,trichome,tuber,type,vegetative,xylopodia,zygomorphy
70	wfo-0001026686	invalid_json_followup	196	160	99	97	61	0.505	.4,0.6-0.9,1-2,1.2-3.4,1.5-7,1.7-2.5,10-28,2.4-3.6,3-4,3.7-8,5,5-16.5,5-8,6.5-12.7,7-9,8-10,8-14,8-27,abaxially,adaxially,anther,apex,base,berry,blade,brownish,cell,chartaceous,cm,condition,conical,corolla,densely,diameter,digestion,distal,dorsally,drying,edge,enzyme,filament,flat,flower,folded,forked,fresh,fruit,glabrous,green,greenish,hair,herb,honeycomb-shaped,interjected,lanceolate,lateral,leaf,leaflet,light,like,long,lower,margin,middle,minute,minutely,mm,mottled,obtuse,odd-pinnate,ovoid,pedicel,peduncle,perfect,petiole,plant,pore,poricidal,puberulent,pubescent,purple,purple-violet,removed,ripe,rotate-stellate,round,seed,size,sparsely,stigma,style,terminal,testal,tip,tuber,wall,whitish,wide,x	0.2-0.5,1,1-10,1-2.5,1.2-3.6,2-10,2-9,2.5-8,3-5,4-6,5-merou,absent,acumen,acuminate,ag,along,alyx,apart,apparently,articulated,axe,axillary,borne,bud,capitat,ciliate,connivent,covering,decreasing,eaf,eed,elliptic-lanceolate,end,equal,erec,especially,exceeding,geminat,generally,glabrou,gradually,green-white,hair-like,half,homostylous,larger,lengthening,living,lobe,make,midrib,mucilaginous,nflorescence,often,orbicular,orolla,ovate,pair,petiolule,plurifoliate,pubescen,ruit,secondary,semierect,seudostipule,singly,slightly,slit,spaced,specimen,stamen,star,ste,stolo,straight,stripe,subequal,subsessile,subtending,symmetrical,tall,tamen,tem,thick,throughout,toward,tri-,tube,typically,unit,usually,vary,wet,white,wing,yellow,ympodial	'',[,``,appressed,arrangement,articulation,bract,branching,breeding,broad-based,calyx,capitate,characteristic,colour,connective,form,fruiting,growth,height,inflated,inflorescence,insertion,interpetalar,length,marking,mature,modification,na,needle-like,number,odour,orientation,ovary,paired,pattern,placement,position,presence,present,prickle,pseudostipule,rhizome,scale,shape,smell,spot,staman,stem,surface,symmetry,system,texture,tissue,trichome,type,value,vegetative,zygomorphy,{,},Â¼
71	wfo-0001026696	invalid_json	139	129	91	48	38	0.655	0.3-4.5,0.8-7,0.9-7.2,1,1-1.3,1-4,1.3-2.1,2-17,3-17,3-3.5,3-6,3-8.5,4-16,5-35,9,abaxially,acute,adaxially,apex,apical,apically,base,branched,broadly,calyx,cell,cm,connate,corolla,covering,cuneate,cyme,decurrent,dehiscent,densely,diameter,dichasial,dichasially,distal,ebracteate,filament,flower,generally,globose,green,green-white,hair-like,half,herbaceous,introrse,lanceolate,lateral,light,linear,make,maturing,mm,monochasial,mucilaginous,obtuse,odd-pinnate,often,ovate,ovoid,pedicel,peduncle,perennial,perfect,petiole,plant,poricidally,proximal,pubescent,rounded,seed,short,simple,slit,stellate,stigma,straight,style,testal,thick,throughout,tuber-bearing,typically,unit,wall,white-cream,Â¼	1.5-3,2-3,3-6-foliat,acumen,apiculate,articulate,digestion,dorsally,eaf,edge,eed,emoval,entire,enzyme,exceeding,flat,folded,forked,globo,honeycomb,light-yello,living,lobe,lon,long,lower,lunat,margin,nflorescence,nther,oblong,orolla,pattern,plan,reveal,ruit,seudostipule,sinuate,specimen,stamen,tal,tem,throughou,vary,wide,without,yellow,ympodial	'','hair-like,3-6-foliate,[,],``,anther,arrangement,articulation,branching,characteristic,colour,form,fruit,growth,height,inflorescence,leaf,length,light-yellow,lunate,number,ovary,pore,position,pseudostipule,shape,stem,structure,sympodial,tall,texture,type,value,wet,width,{,}
72	wfo-0001026706	success	232	105	63	169	42	0.272	0.9-2,1-5,3-4.6,accrescent,acute,anther,apex,apparently,articulated,axillary,base,berry,blunt-tipped,branched,calyx,chartaceous,cm,completely,coriaceous,corolla,covering,cuneate,dendritic-echinoid,dendritic-multangulate,entire,enveloping,filament,fleshy,fruit,fruiting,globose,green,hair,lacking,lanceolate,leaf,length,many,margin,minute,mixed,mm,multangulate,obtuse,pedicel,perfect,petiole,plurifoliate,pore,poricidal,porrect-stellate,sessile,short-stalked,shrub,simple,small,stalked,stellate,time,tip,tree,unit,white	-3.1,-4.4,-5.5,-6.1,.5,/14-1/6,0-240,0.2-0.3,0.2-0.5,0.6-2.2,0.8-1.2,0.8-1.5,0.8-2.8,0.9-1.9,1-2.2,1.1-4,1.5-3,1/2-2/3,10-15,12,14-32,2.2-3.3,2.3-3.8,2.5-3,2.7-4,2.9-6,2/3-3/4,3.1-3.8,3.6-5.7,4,4.2-12,4.5-5.5,5-6.5,5.3-6.4,6-10,6-8,6.1-,7-16,8-14,9.8-15.4,abaxially,adaxiall,adaxially,ag,anthesi,apart,appearing,around,attenuate,axe,ba,bark,becoming,blade,branch,brown,bud,capitat,closely,crisped,cylindrical,dark,densely,diameter,directed,distally,eaf,edge,eed,exserted,farinose,flower,fourth,free,furfuraceou,glabrate,glabrous,golden,grayish,herbarium,indument,inserted,lackin,lateral,lengthening,lobe,lobed,long,long-stalked,longitudinal,lower,m.,main,matted,midrib,multangulat,nearly,nflorescence,oblong,obscured,occasionally,often,older,orolla,ovate,ovate-elliptic,ovate-lanceolate,pale,peduncle,persistent,pseudo-terminal,pubescence,pubescent,rachi,rather,reddish,reticulate-punctate,ruit,runk,semi-ovate,short-,side,slightly,slit,softly,somewhat,soon,spaced,sparsely,specimen,splitting,stamen,stem,stigma,strongly,style,subcampanulate,subconical,subglobose,suborbicular,sulcate,surface,suture,tall,tamen,thin-walled,tomentose-pubescent,tomentu,touching,translucent,transparent,tube,ud,unarme,unarmed,unevenly,upper,vary,vein,velutinous,wavy,way,whitish,wide,x,yellow,yellowish-tan,ympodial,young	articulation,bract,branching,breeding,cell,colour,connective,form,growth,heteromorphism,inflorescence,insertion,interjected,interpetalar,leaflet,marking,na,odour,orientation,paired,pattern,placement,position,prickle,pseudostipule,pseudoterminally,rhizome,scale,shape,spot,staman,stone,structure,symmetry,sympodial,system,texture,tissue,tuber,type,xylopodia,zygomorphy
73	wfo-0001026707	success	196	114	73	123	41	0.372	-3,.5,/3,0,0.5-1,0.5-3,2.5-6,3-4,5-10,?,anther,apex,apparently,articulated,attenuate,base,berry,branched,broadly,calyx,chartaceous,cm,concolorous,connivent,discolorous,drying,elongating,entire,erect,filament,foliaceous,fruit,fruiting,glabrous,green,known,lateral,leaf,length,lobed,long,lower,margin,mauve,mm,moderately,narrow-deltate,pedicel,petiole,poricidal,prickle,pubescent,red-brown,shrub,simple,small,sometimes,sparsely,spherical,stellate,stellate-pubescent,straight,surface,tapering,terminal,tip,tree,unit,way,weakly,white,wide,Â¼	-1/3,-5,.8,0-20,0.05,0.05-0.15,0.1-0.2,0.3-0.8,0.6-0.7,0.6-0.8,0.7-1,0.7-1.4,0.7-1.5,1-1.7,1-3,1-5,1.5-1.8,1.6-2,1/3,1/3-1/2,1/3-3/4,1/4-1/3,1/8-1/4,11-16,2-10,2-2.3,2-6,2.5-3,2.5-4,3-4.5,3-7,3-8,4,5-25,5-7,5-8,5-merous,8-15,abaxially,acute,alyx,apar,apart,apically,bark,blade,branche,broad-deltate,clustered,color,curved,cuspidat,decurrent,densely,diameter,eaf,eed,equal,eye,flattened-reniform,flower,free,fused,gently,glabrescent,glabrou,gray,inflated,infructescence,juvenil,less,lobe,longer,mature,midpoint,naked,narrow-oblong,nflorescence,obtuse,older,one,open,orange-brown,orolla,oung,peduncle,per,perfec,pericarp,plurifoliat,porrect,porrect-lepidote,portion,prickly,ray,reflexed,rounded,ruit,scar,sessile,shorter,slender,smooth,spaced,spreading,stalk,stalked,stem,stout,style,tamen,terete,time,trichome,tube,unarmed,upper,variously,vary,venation,visible,yellow-green,ympodial	articulation,bract,branching,breeding,cell,colour,corolla,form,growth,hair,heteromorphism,inflorescence,insertion,interjected,interpetalar,leaflet,marking,na,odour,orientation,paired,perfect,placement,plurifoliate,position,pseudostipule,rhizome,scale,shape,spot,staman,stone,structure,symmetry,sympodial,system,texture,tissue,tuber,type,xylopodia
74	wfo-0001026711	success	210	118	68	142	50	0.324	.8,0.5-1.5,1/2-2/3,3-5,3.5-5.2,acicular,anther,apex,apparently,articulated,base,berry,branched,calyx,cell,cm,connivent,cuneate,densely,difoliate,elongating,equal,erect,filament,fruit,fruiting,glabrous,lateral,leaf,length,lobed,long,lower,margin,mature,maturity,mauve,mm,occasionally,orange,pedicel,perpendicular,petiole,poricidal,prickle,prickly,purple,red,reflexed,rounded,shrub,sometimes,somewhat,spherical,stellate,stellate-pubescent,stem,straight,surface,tapering,terminal,thick-chartaceous,tip,trichome,unarmed,unit,way,weakly	-15,-2,-5,-6,-7,.2,.5,0,0-0.2,0-25,0-4,0-6,0.1,0.15,0.2-0.3,0.3-1,0.7-,0.7-0.9,0.7-1.4,0.75-1,0.8,0.8-2.2,0.9-1.1,0.9-1.5,1-,1-2,1-30,1.5-,1.5-2.2,1.7-4,1/,1/3,1/4,1/4-1/3,2-2.2,2-2.5,2-3.5,2-4,2-6,2.1-2.5,3-4,3-4.5,3-7,4-8,4.5-7,5-merous,7-8,abaxially,acuminat,acute,alyx,ame,apar,apart,apically,bark,blade,brow,c.,concolorous,curved,deltate,diameter,discolorous,distance,drying,dull,eaf,eed,elliptic,evenly,extending,faint,flattened-reniform,flower,free,geminat,green,infructescence,less,lobe,longer,midpoint,midvein,moderately,narrow-deltate,nflorescence,obtuse,older,one,open,orange-brown,orolla,oung,outline,pair,pale,peduncle,pendulous,per,perfec,pericarp,pit,porrect,portion,prickl,primary,raised,ray,reduced,ruit,scar,sessile,shallowly,shorter,side,slender,small,smooth,spaced,spreading,stalk,stalked,style,tamen,terete,tertiary,time,tube,uniform,upper,variously,vary,vein,venation,visible,wide,woody,yellow,yellow-green,ympodial,young	appressed,articulation,bract,branching,breeding,broad-based,colour,connective,corolla,form,geminate,growth,hair,heteromorphism,inflated,inflorescence,insertion,interjected,interpetalar,leaflet,marking,modification,na,needle-like,odour,orientation,paired,pattern,perfect,placement,position,pseudostipule,rhizome,scale,shape,smell,spot,staman,stone,structure,symmetry,sympodial,system,texture,tissue,tuber,type,vegetative,xylopodia,zygomorphy
75	wfo-0001026717	success	207	125	76	131	49	0.367	1-2,2.5-4.5,3-6,4-8,5,abaxially,adaxially,anther,apex,articulated,axillary,base,berry,bud,cell,chartaceous,cm,conical,corolla,dark,darker,distal,filament,forked,fruit,generally,glabrous,green,hair,half,herb,homostylous,interjected,lanceolate,leaf,leaflet,lengthening,light,like,lobe,long,lower,margin,membranous,middle,minute,mm,obtuse,odd-pinnate,often,orbicular,ovate,pedicel,pentagonal,petiole,plant,plurifoliate,pore,poricidal,pubescent,purple,ripe,rotate,round,sessile,slit,sparsely,stripe,subtending,symmetrical,terminal,tip,tri-,tuber,unit,violet	0.3-0.6,0.3-2.5,0.3-5,0.6-1.5,0.8,1-10,1-2.5,1-3,1.3-2.5,1.4-2.2,1.8-3,13-28,14-22,15-34,2.2-5,2.5-5.5,3-4,3-5,3.3-11,4-6,4-9,5-11,5-13.5,5-6,5-merou,5.3-9,7-11,acumen,acuminate,ag,along,alyx,apart,apparently,attenuate,axe,blade,borne,brownish,capitat,ciliate,condition,connivent,covering,decreasing,decurrent,diameter,digestion,dorsally,drying,eaf,edge,eed,elliptic,end,enzyme,equal,erec,especially,exceeding,flat,flower,folded,fresh,geminat,glabrou,gradually,green-white,greenish,hair-like,honeycomb-shaped,larger,lateral,living,make,medium,midrib,minutely,mottled,mucilaginous,narrow,nflorescence,one-quarte,orolla,ovoid,pair,peduncle,perfect,petiolule,present,puberulent,pubescen,removed,ruit,secondary,seed,semierect,seudostipule,singly,size,slightly,spaced,specimen,stamen,ste,stigma,stolo,straight,style,subequal,subglabrous,subsessile,tall,tamen,tem,testal,thick,throughout,toward,tube,typically,usually,vary,wall,wet,whitish,wide,wing,x,yellow,ympodial	age,articulation,bract,branching,breeding,broad-based,calyx,colour,form,fruiting,geminate,growth,heteromorphism,inflorescence,insertion,interpetalar,length,marking,na,needle-like,odour,one-quarter,orientation,paired,pattern,placement,position,prickle,pseudostipule,rhizome,scale,shape,smell,spot,staman,stem,stone,structure,surface,symmetry,sympodial,system,texture,tissue,trichome,type,vegetative,xylopodia,zygomorphy
76	wfo-0001026725	success	166	97	51	115	46	0.307	.3,.5,0.2,0.7-1.2,1.5,accrescent,acute,anther,apex,base,beneath,berry,broadly,calyx,cm,corolla,cup-shaped,difoliate,elliptic,filament,fruit,fruiting,glabrous,globose,green,greenish-white,interpetalar,leaf,less,long,margin,minutely,mm,opposite,ovate,papillose,pedicel,petiole,pore,poricidal,pubescent,shaped,shrub,subshrub,tear-drop,tip,trichome,uniseriate,unit,white,x	/4,1-1.2,1-1.5,1-4.5,1-5,1.2-1.7,1.5-2,1.6-2,1/2,2,2.2-4,3.5-4,3.6-7.7,5-20-flowered,5-5.5,5-6,8-18.6,8-9,anthesi,apart,attenuate,axil,bark,becoming,black,bluish,brownish-papillose,capitate,character,crackin,dark,deflexed,dia,differing,dry,drying,eaf,edicel,eed,ellipsoid,evenly,extremely,flattened-reniform,free,geminat,geographically,glandular-papillose,incrassate,inflorescenc,large,lateral,lobe,lobed,lon,lower,main,major,margine,material,middle,minor,nflorescence,occasionally,often,older,one,onto,open,ovary,ovoid,pair,pale,paler,papillo,pitted,planar,portion,prominent,proximal,reddish-brown,reflexed,rounded,ruit,scar,scarious,short,simple,sinus,size,slender,slightly,spaced,split,stem,stigma,straight,stretching,style,surface,tall,tan,tapering,triangular,tube,tuft,ud,upper,varying,vein,way,widest,winged,woody,ympodial,young	appressed,articulation,bract,branching,breeding,cell,colour,connective,form,geminate,growth,hair,heteromorphism,inflated,inflorescence,insertion,interjected,leaflet,length,marking,mature,modification,na,odour,orientation,paired,pattern,placement,position,prickle,pseudostipule,rhizome,scale,shape,spot,staman,stone,structure,symmetry,sympodial,system,texture,tissue,tuber,type,xylopodia
77	wfo-0001026733	success	188	169	107	81	62	0.569	-2,-7,-8,0.3-0.5,0.3-2,0.5-1,1,1-1.5,1-7,1.5-14,4,4-5,4.5-5,5-8,abaxially,acute,acute-acuminate,adaxially,aggregate,apex,articulated,basal,base,calyx,cell,chartaceous,cm,color,connective,connivent,cordate,curled,dense,densely,directed,distally,eglandular-pilose,eglandular-pubescent,ellipsoidal,elliptic-ovate,entire,equal,exceeding,flattened,forked,fruit,fusiform,glabrate,glabrous,gland-tipped,glandular-,glandular-puberulent,green,greyish,hair,hirsute,immature,lanceolate,leaving,lobe,long,longitudinal,lower,margin,membranaceous,mm,moderately,narrowly,near,oblique,ovate,ovoid,pedicel,pedicellar,perfect,petiole,pilose,pore,pubescent-pilose,remnant,ripe,round,shining,shorter,simple,slightly,smooth,sometimes,stellate,stigma,stone,stripe,style,submarginally,thecae,tree,triangular,truncate,unbranched,unit,unknown,vein,villous,white,white-puberulent,x,yellowish	-1,-11,-13,-14,-15,-4,.5-3,0.5,0.5-2,0.5-4,1-2,1-3,1.5-2,1.5-2.5,10-20,15-,2-2.5,2-3,2-4,2-6,2.5-7.5,20-50,25-40,3-15,3-3.5,3-4-foliat,3-7,4-23,7-10,8-12,acuminate,apart,ape,axe,beyond,blade,capitat,ciliat,cylindrical,deltate,dia,diameter,eaf,eed,eglandular-villous,especially,exserted,flower,glandula,glandular-tomentose,linear-triangular,lon,midrib,nflorescence,nther,orolla,ovum,peduncle,present,pubescent,pubescent-pilo,rachi,radiu,ruit,small,spaced,sparsely,stamen,swelling,tal,tem,time,toward,tube,ud,unknow,usually,vary,wide,yellow,ympodial	3-4-foliate,abaxial,adaxial,anther,articulation,berry,bract,branching,breeding,broad-based,bud,capitate,colour,corolla,filament,form,fruiting,growth,height,heteromorphism,inflorescence,insertion,interjected,interpetalar,leaf,leaflet,length,marking,modification,na,needle-like,odour,orientation,oval,ovary,paired,pattern,placement,plant,position,prickle,pseudostipule,rhizome,scale,seed,shape,smell,spot,staman,stem,structure,surface,symmetry,sympodial,system,texture,tissue,trichome,tuber,type,vegetative,xylopodia
78	wfo-0001026734	success	266	111	62	204	49	0.233	0.5,accrescent,anther,apex,articulated,asymmetric,base,berry,branched,calyx,chartaceous,corolla,cuneate,densely,elliptic,entire,foliate,fruit,geminate,globose,green,growth,hair,immature,internodal,lateral,leaf,length,lobed,long,lower,margin,mature,maturity,membranaceous,mm,moderately,much,obtuse,paired,pale,pedicel,perfect,petiole,pore,poricidal,porrect-stellate,pubescent,purple,sessile,shape,short-stalked,shrub,simple,stellate,stem,subopposite,surface,trichome,unbranched,unit,white	0.1,0.2,0.3,0.6,0.7â0.9,0.7â1,0.8â1,1,1.6â2,1.6â2.5,1.8â2.2,1.8â3,1/4,1â1.2,1â3,2.2â7,2.3â5,2.5â3,2â2.4,2â3,3,3.2â3.8,3â4,3â4-celled,3â8,4â6,4â7,4â8,4â9,5-merou,5â9,8,abaxial,abaxially,absent,acuminate,acute,adaxial,adaxiall,adaxially,ag,also,always,alyx,anthesi,apical,apice,archin,ark,associated,axi,barely,becoming,beneat,beneath,blade,branch,bright,broadly,brown,caly,camptodromous,capitate,celled,central,clavate,closely,cm,commonly,congested,connivent,covered,covering,cylindrical,cyme,dark,dense,denser,diameter,differing,directed,discolorous,distally,downward,dried,drying,due,eaf,eed,eglandular,emergent,erect,f.,fewer,flat,flattened,flower,forked,found,free,frequently,glabrescen,glabrescent,glabrous,glandular,gray,held,ilament,initially,introrsely,irregular,j,lamina,lanceolate,large,less,lobe,long-attenuate,longer,longitudinal,lying,material,maturit,midpoint,midri,minute,mostly,multiseriate,narrow,near,new,nflorescence,normally,oblong,obovate,observed,often,old,older,one,one-celled,opening,orolla,other,oung,ovary,ovate,pair,papillose,peduncle,pit,plane,pointing,porrect,portion,pubescence,purplish,rachi,raised,rarely,ray,rayed,reaching,reniform,rounded,ruit,scandent,secondary,shiny,shorter,size,slightly,slit,smaller,sometimes,spaced,sparse,sparsely,spread,spreading,stalk,stigma,still,style,subsessile,surfac,terminal,tube,tuft,ud,unequal,uniseriate,upward,vary,vein,venation,vestiture,visible,whole,wide,yellow,yellowish,ympodial,Â¾	1.6-2,2-3,2.3-5,appressed,articulation,bract,branching,breeding,broad-based,cell,colour,connective,filament,form,fruiting,heteromorphism,inflated,inflorescence,insertion,interjected,interpetalar,leaflet,marking,na,needle-like,odour,orientation,pattern,placement,position,prickle,pseudostipule,rhizome,scale,smell,spot,staman,stone,structure,symmetry,sympodial,system,texture,tissue,tuber,type,vegetative,xylopodia,zygomorphy
79	wfo-0001026740	success	171	152	95	76	57	0.556	0-10,0.5-1,1-2,1-4,1-5,2-3,2-4,2.5-27,5-8,6-10,abaxially,absent,acuminate,acute,adaxially,aggregate,also,apex,articulated,basal,base,branched,calyx,cell,cm,connective,connivent,cordate,curled,darker,densely,directed,distally,eglandular,ellipsoidal,elliptic,entire,equal,especially,exceeding,flattened,fruit,glabrous,glandular-puberulent,greenish,hair,immature,lanceolate,leaving,lobe,long,lower,margin,mature,mm,moderately,near,nearly,obtuse,often,orange,ovate,ovoid,pedicel,pedicellar,petiole,pilose,pore,present,puberulent,purple,remnant,reticulate,scar,sessile,shorter,simple,slightly,small,stellate,stone,stripe,style,subcoriaceous,swelling,thecae,tree,truncate,unbranched,unit,white-puberulent,whitish,x,yellow,young	-17,-2,1-10,1-12,1-3,10-20,10-30,2.5-3,2.5-4.5,2.5-6,20-50,3-15,3-3.5,3-5,3-foliat,3.5-40,4-5,4.5-10,5-40,8-19,absen,acute-acuminate,apart,ape,apiculate,axe,beyond,blade,browni,ciliate,corky,cylindrical,deltate,diameter,eaf,eed,exserted,fleshy,flower,glabrate,lon,narrowly,nflorescence,nther,oblong,orolla,peduncle,perfect,pilo,pubescent,rachi,radiu,rarely,ruit,sometimes,spaced,sparsely,stamen,stigma,tal,tems,time,tomentose,toward,triangular,truncat,tube,ud,unlobed,vary,vein,villous,violet,wide,woody,ympodial	3-foliate,anther,articulation,bract,branching,broad-based,brownish,bud,colour,corolla,filament,form,fruiting,growth,height,heteromorphism,inflorescence,insertion,interjected,interpetalar,leaf,leaflet,length,marking,modification,na,needle-like,odour,orientation,ovary,paired,placement,plant,position,prickle,pseudostipule,rhizome,scale,seed,shape,smell,spot,staman,stem,structure,surface,symmetry,sympodial,texture,tissue,trichome,tuber,type,unknown,vegetative,xylopodia,zygomorphy
80	wfo-0001026752	success	169	160	102	67	58	0.604	-25,-4,1,1-3,1-5,1-6,1.5-12,1.5-2.5,10-20,2,2-2.5,2.5-5,20-30,3-18,3-4,3-5,3.5-4,4-5,abruptly,acute,apart,apex,base,beyond,black,branched,campanulate,cell,chartaceous,cm,connective,cordate,coriaceous,cuneate,cylindrical,darker,densely,diameter,dilated,directed,distally,ellipsoidal,elliptic-oblong,elliptic-ovate,entire,finely,flattened,fleshy,forked,fruit,glabrous,globose,green,greenish-brown,hair,immature,lanceolate,laterally,long,margin,mm,moderately,narrowly,near,nearly,obtuse,ovoid,pedicel,peduncle,perfect,petiole,pilose,pore,possibly,pubescent,pubescent-pilose,purplish,rachi,rarely,rather,ripe,short-acuminate,simple,slightly,somewhat,stamen,stellate,stigma,stone,stripe,style,tree,triangular,truncate,unbranched,unit,violet,white,whitish,wide,x,yellow	-3,-50,0-,1-1.5,1-12,1-2,1.5-2,15-35,2-3,2-4,2.5-20,3,3-foliat,4-45,7-15,8-16,abaxially,absent,adaxially,aggregate,also,ape,apiculate,articulated,axe,basal,blade,calyx,capitat,connivent,deltate,eaf,eed,equal,exceeding,exserted,flower,leaving,less,lobe,lon,lower,nflorescence,nther,orolla,papillose,pedicellar,pilo,presence,present,radiu,remnant,ruit,small,spaced,tal,tem,thecae,time,tomento,tube,ud,unknow,vary,vein,yello,ympodial	3-foliate,abaxial,adaxial,anther,articulation,bract,branching,breeding,bud,capitate,colour,corolla,exsertion,filament,form,growth,height,heteromorphism,inflorescence,interjected,interpetalar,leaf,leaflet,length,marking,mature,modification,na,odour,orientation,ovary,pattern,placement,plant,position,prickle,pseudostipule,rhizome,scale,seed,shape,size,spacing,spot,staman,stem,structure,symmetry,sympodial,system,texture,theca,tissue,tuber,type,unknown,xylopodia,zygomorphy
81	wfo-0001026754	success	176	95	47	129	48	0.267	0.5-1,2,5-lobed,anther,apex,articulated,asymmetric,base,berry,branched,calyx,corolla,deeply,dendritic,ellipsoid,filament,globose,growth,inflorescence,later,lateral,leaf,lobed,many,margin,mature,membranous,mm,oblique,pedicel,perfect,petiole,pore,poricidal,simple,slit,stellate-rotate,terminal,time,tip,truncate,twining,unit,vine,white,woody,x	-6+,.5,0.5,0.9-1.1,1,1-,1.5-3,1/2,10,198.,2-2.5,2-3,2-4,2.5-3.5,2/3,3-4-celled,30+,4-5,5,5-merou,5.5-9,7-9,9,9-11,abaxially,acute,adaxially,ag,along,alyx,anthesi,apar,apparently,ark,axi,basal,broadly,brow,cabrera,clavate,cm,complete,conical,connivent,cucullat,densely,denser,diameter,distal,divided,eaf,ed,elliptic,entire,especially,exerted,extending,fide,flower,free,glabrous,half,halfway,ilament,irregularly,lamina,leaving,lengthening,like,lobe,long,loosely,lower,midvein,minute,minutely,mixture,mostly,narrowly,new,nflorescence,older,orolla,outline,pair,papillo,peduncle,peg,pinnate,planar,plurifoliat,portion,primary,puberulent,pubescent,ruit,scandent,scar,seen,sleeve,slender,small,sometimes,spaced,sparsely,splitting,spreading,stem,stigma,style,surface,tangled,tem,transparent,trichome,tub,tube,twinin,ud,uniseriate,upper,vary,vein,way,weak,within,yellow,yellowish,ympodial	5-merous,age,appressed,articulation,bract,branching,breeding,cell,colour,connective,form,fruit,fruiting,hair,heteromorphism,inflated,insertion,interjected,interpetalar,leaflet,length,marking,modification,na,odour,orientation,paired,pattern,placement,plurifoliate,position,prickle,pseudostipule,rhizome,scale,shape,spot,staman,stone,structure,symmetry,sympodial,system,texture,tissue,tuber,type,xylopodia
82	wfo-0001026756	success	147	127	68	79	59	0.463	0-7-1.2,0.5-1,0.5-3,1-1.5,1-2,1.5-1.7,1.5-10,1.5-2,1.5-3,1.8-3,3-4,3.5-8.5,5-10,5-5.5,6-16,acute,anther,apex,attenuate,bark,base,bilobed,broadly,calyx,cm,conical,corolla,dendritic,difoliate,elliptic,filament,fruiting,glabrous,globose,green,lax,leaf,lobed,lower,mm,nearly,occasionally,opposite,ovary,ovate,ovoid-reniform,pale,pedicel,petiole,pinkish-white,pore,pubescent,shape,shaped,shrub,sparsely,stem,stigma,style,surface,tear-drop,tree,trichome,tube,unifoliate,unit,white,young	.25,.5,0.25-0.5,5-10-flowered,6-10,abaxial,abaxially,adaxially,along,anthesi,apiculate,ba,berry,brown,closely,corresponding,dark,deflexed,deltate,densely,denser,dia,differing,distal,eaf,edicel,eed,erect,exserted,fleshy,free,geminat,glabrescent,grayish-brow,hard,inflorescenc,irregular,lamina,lateral,like,lobe,long,main,major,middle,minor,minutely,nflorescence,older,overlappin,pair,papillo,perhaps,pericarp,pitted,planar,poricidal,portion,present,pubescence,rest,ruit,scar,simple,somewhat,soon,spaced,strongly,tall,thick,tip,tub,ud,uniseriate,vein,wide,widest,woody,ympodial	0.25,0.5,articulation,bract,branching,breeding,broad-based,cell,colour,connective,diameter,flower,form,fruit,geminate,grayish-brown,growth,hair,height,heteromorphism,inflorescence,insertion,interjected,interpetalar,leaflet,length,margin,marking,modification,na,needle-like,number,odour,orientation,pattern,placement,plant,position,prickle,pseudostipule,rhizome,scale,seed,smell,spot,staman,stone,structure,symmetry,sympodial,system,texture,tissue,tuber,type,vegetative,width,xylopodia,zygomorphy
83	wfo-0001026777	success	168	133	83	85	50	0.494	.5,0.25-0.5,0.5-1.5,0.9-3,1-1.3,1-10,1-2,1-4,1.5-3,1.5-5,2-4,3-3.5,5-50-flowered,5-7,acute,anther,apex,base,beneath,blue,branching,brown,calyx,capitate,cell,cm,corolla,cup,decurrent,deflexed,dense,difoliate,elliptic,fide,filament,filiform,flattened,flattened-reniform,fruiting,glabrous,globose,green,growth,leaf,lobed,long,lower,matted,minor,minutely,mm,narrowly,nearly,occasionally,often,onto,opposite,ovary,papillose,pedicel,petiole,pore,pubescent,quite,russet,seed,shaped,shiny,shrub,size,slightly,stem,stigma,style,surface,tear-drop,trichome,tube,uniseriate,unit,vellozo,white,x	.25,/3,0.5-1,0.5-5,1-1.5,1.2-1.8,2-4.5,2-5,4-8,5-14,acuminate,anthesi,apart,apiculate,axil,ba,beginning,berry,body,campanulate,dia,differing,distal,eaf,edicel,eed,end,exserted,flexuous,free,geminat,glabrate,greyi,hyaline,incrassate,inflorescenc,irregularly,lateral,like,lobe,lon,main,major,margin,middle,near,new,nflorescence,older,one,outline,overtopping,pair,papillo,pitted,planar,poricidal,portion,prominent,quadrate-deltoid,rest,ruit,scar,sinuate,smooth,somewhat,soon,spaced,sparsely,straight,tall,tapering,testa,thread-like,tip,tuft,ud,vein,wall,way,widest,woody,yellowish,ympodial,young	articulation,bract,breeding,broad-based,colour,connective,diameter,flower,form,fruit,geminate,hair,height,heteromorphism,inflorescence,insertion,interjected,interpetalar,leaflet,length,marking,modification,na,needle-like,number,odour,orientation,pattern,placement,plant,position,prickle,pseudostipule,rhizome,scale,shape,smell,spot,staman,stone,structure,symmetry,sympodial,system,texture,tissue,tuber,type,vegetative,xylopodia
84	wfo-0001026819	invalid_json_followup	218	156	100	118	56	0.459	0-27,1-10,1-2,1.5-10,1.5-12,10-26,2-6,3-120,3-18,3-20,3-35,3-38,4-7,5-30,6-11,7,absent,acuminate,acute,anther,apex,base,blade,blue,broadly,brownish,chartaceous,cm,condition,corolla,dark,densely,diameter,distal,dot,drying,elliptic,filament,flower,fresh,fruit,glabrous,glaucous,globose,green,greenish,greenish-yellow,hair,herb,interjected,lanceolate,lateral,leaflet,light,like,long,lower,lunate,margin,membranous,middle,mm,moderately,mottled,narrowly,oblique,odd-pinnate,ovate,ovoid,pair,pedicel,peduncle,pentagonal,petiole,petiolule,plant,pore,poricidal,pubescent,purple,rotate-pentagonal,scale-like,scattered,seed,slightly,sometimes,somewhat,star,stem,stripe,style,subglabrous,symmetrical,terminal,tinged,tip,tuber,violet,white,whitish	0.3-4.7,0.5-1.5,1-2.3,1-5,1.2-36,1.5-3.0,1.5-3.3,1.5-3.5,1.6-3.5,10,2-5,2.5-5,4,4-10,5-merou,abaxially,acumen,adaxially,ag,along,alyx,apart,articulated,ascending,attenuate,bearing,borne,bud,capitate,cell,ciliate,clavat,connate,connivent,covering,cuneate,curved,decurrent,digestion,dorsally,eaf,edge,eed,end,enzyme,erec,especially,exceeding,flat,folded,forked,geminat,generally,glabrou,greatly,green-white,hair-like,half,homostylous,honeycomb-shaped,larger,lengthening,living,lobe,make,midvein,minutely,mucilaginous,nflorescence,non-glandular,often,orolla,pedice,plurifoliate,puberulent,rachi,ranging,removed,ruit,seudostipule,short,singly,slit,spaced,specimen,stamen,ste,stigma,stolo,straight,subequal,suborbicular,subrosette,subtending,tall,tamen,tem,tertiary,testal,therefore,thick,throughout,tri-,truncate,tube,typically,unit,unwinged,usually,vary,wall,wet,wide,wing,within,without,yellow,ympodial	'',[,``,abaxial,arrangement,articulation,bract,branching,breeding,broad-based,characteristic,colour,connective,form,growth,height,inflorescence,insertion,interpetalar,leaf,length,marking,mature,modification,na,needle-like,number,odour,orientation,ovary,paired,pattern,placement,position,presence,present,prickle,pseudostipule,scale,shape,smell,spacing,spot,surface,symmetry,system,texture,tissue,trichome,type,value,vegetative,width,zygomorphy,{,}
85	wfo-0001026821	success	204	133	81	123	52	0.397	0.2-1.5,0.3-1.2,0.3-2.5,0.5-3.5,0.8-1,1-1.5,1-5,2-3.5,2-celled,3-branched,anther,apex,appressed,articulated,auriculate,base,bayonet,berry,bract,broadly,cell,cm,cordate,dark,directed,distally,ellipsoidal,filament,forked,frequent,fruit,gglobose,glabrous,green,hair,herb,homostylous,incurved,interjected,large,leaf-opposed,leaflet,length,light,longitudinal,lower,margin,mature,membranous,mm,oblique,obliquely,oblong,odd-pinnate,opening,paired,pale,pedicel,petiole,pilose,plurifoliate,pore,present,pseudostipular,pubescent,rarely,reniform,rounded,slit,somewhat,sparsely,stellate,stripe,subglabrous,substellate,surface,tri-,unbranched,unit,white,x	.2,/3,0-20,0.4-1.5,0.5-1.2,0.7-1.8,1-2,1-20,1-3,1.2-1.5,1.5-2.5,10-15,17,1977,2-15,2-6,2.5-18,3-11,3-18,3-6,3-7,3-celled,4-4.5,5-10,5-12,5-20,5-34,5-merou,abaxially,acuminate,acut,adaxial,adaxially,ag,alyx,anderson,angular,apart,apical,apically,apiculate,axe,ba,basal,blade,brown,chartaceous,ciliat,cuneate,deltate,diameter,distal,due,eaf,eed,elliptic,equal,especially,exceeding,flattened,flower,fused,geminat,glabrou,gland-tipped,greatly,interstaminal,lanceolate,lateral,lobe,long,long-attenuate,lowermost,many,mean,membrane,minute,minutely,moderately,much,narrowly,nflorescence,obtuse,occasional,occasionally,one-celled,orolla,pair,peduncle,per,perfect,petiolule,puberulent,pubescen,rachi,reduced,remnant,ruit,scandent,seudostipule,short,slender,slightly,small,smaller,spaced,stamen,stigma,style,subtended,tamen,tem,terminal,thickening,time,truncat,tube,vary,wall,wide,winged,yellow,ympodial	5-merous,acute,age,articulation,branching,breeding,broad-based,calyx,colour,connective,corolla,form,fruiting,geminate,growth,heteromorphism,inflated,inflorescence,insertion,interpetalar,leaf,marking,modification,na,needle-like,odour,orientation,pattern,placement,position,prickle,pseudostipule,rhizome,scale,shape,smell,spot,staman,stem,stone,structure,symmetry,sympodial,system,texture,tissue,trichome,tuber,type,vegetative,xylopodia,zygomorphy
86	wfo-0001026827	success	143	136	86	57	50	0.601	.5,/3,0.4-0.6,0.6-1,1-1.5,1-2,1-2.1,1.3-1.6,1.5-2,2-2.2,3-9,5-6,7-9,abaxially,acute,age,and/or,anther,anthesi,apart,apex,arachnoid,attenuate,base,branched,calyx,cm,corolla,dendritic,densely,diameter,distally,drying,ellipsoid,especially,exerted,filament,glabrescent,glabrous,growth,inflorescence,internodal,lamina,lanceolate,leaf,lengthening,less,like,lower,margin,mm,narrowly,new,nodding,oblanceolate,pair,paler,papillate,pedicel,petiole,plane,pore,poricidal,primary,pubescent,rachi,reddish,revolute,scar,shrub,simple,sinus,slit,sparsely,stem,stout,strongly,surface,tip,trichome,tube,uniseriate,vein,way,white,x	0.2-0.5,0.5-2,1-,1-1.1,2-2.5,2-4,?,adaxiall,appearing,bark,branch,broadly,clavate,conical,crowded,deciduou,deltate,dense,dry,eaf,erect,fleshy,flower,free,irregularly,know,known,lobe,lobed,minutely,near,nflorescence,ot,ovary,papillat,peduncle,perfect,planar,plurifoliat,portion,slender,small,soon,stigma,straight,style,surfac,terminal,thick,thickened,third,tub,ud,unit,upper,widest,ympodial	adaxially,articulation,bract,branching,breeding,broad-based,bud,cell,colour,connective,distance,exertion,form,fruit,hair,heteromorphism,insertion,interjected,interpetalar,leaflet,length,lobing,marking,modification,na,needle-like,odour,orientation,pattern,placement,plurifoliate,position,prickle,pseudostipule,rhizome,scale,shape,smell,spot,staman,stone,symmetry,system,texture,tissue,tuber,type,vegetative,width,xylopodia
87	wfo-0001026830	invalid_json	198	136	109	89	27	0.551	0-10,0.3-1.3,0.4-1,0.5-1.0,0.9-1.9,1-2,1.4-4,1.5-4,2-4,2.5-5,3.5-8.5,4-10,4-14.5,4-7,4.4-14.5,4.5-17.5,5-11,6-13,7-18,abaxially,adaxially,anther,berry,blade,brown,brownish,cell,ciliate,clavate,cm,condition,connivent,coriaceous,corolla,covering,deep,diameter,drying,elliptic,filament,finely,flower,forked,fresh,fruit,glabrescent,glabrous,globose,green,green-white,greenish,hair,hair-like,herb,homostylous,interjected,lanceolate,lateral,leaf,leaflet,lengthening,light,lobe,make,margin,medium,mm,moderately,moniliform,mucilaginous,odd-pinnate,ovate,ovoid,pair,pentagonal,petiole,plant,pore,poricidal,puberulent,pubescent,purple,ripe,rotate,seed,short,simple,size,slit,stigma,straight,stripe,style,subglabrous,terminal,testal,thick,throughout,tip,tube,tuber,unwinged,wall,wet,white,whitish,x,yellow,yellowish	0.5-1.2,1-10,1-11,1.1-2.7,10-57,2-6,2.5-4.4,2.7-8,5-merou,acumen,acuminate,acute,adaxiall,ag,along,alyx,apart,apex,apparently,arranged,articulated,asymmetric,attenuate,axe,axillary,base,basiscopic,bead,bud,capitat,decreasing,digestion,distal,dorsally,eaf,edge,eed,enzyme,erec,exceeding,flat,folded,geminat,generally,glabrou,hal,half,high,honeycomb,like,linear,living,long,lower,multiple,necklace,nflorescence,orbicular,orolla,pedicel,peduncle,perfect,petiolulate,plurifoliate,removed,rounded,ruit,sessile,seudostipule,shaped,side,spaced,specimen,stamen,stolon,subequal,subglabrou,subtending,tall,tamen,tem,tissue,toward,tri-,typically,unit,usually,vary,ympodial	'',5-merous,[,``,age,arrangement,branching,calyx,capitate,characteristic,colour,form,growth,height,inflorescence,length,number,ovary,pseudostipule,shape,staman,stem,texture,type,value,{,}
88	wfo-0001026831	success	207	106	62	145	44	0.3	.5,0-3,3-5,3-6,anther,apex,articulated,attenuate,base,berry,branched,bright,calyx,cell,chartaceous,cream,curved,dark,difoliate,elongating,equal,erect,filament,fruit,fruiting,gray-brown,green,lateral,leaf,length,lobed,long,lower,margin,marking,mature,maturity,mauve,membranous,mm,moderately,narrow-cuneate,orange,orange-brown,pale,pedicel,petiole,poricidal,prickle,shrub,sometimes,spherical,stellate-pubescent,stem,surface,tapering,tip,trichome,unit,white,yellow,young	-0.25,-5,-6.5,-9,/4,0-10,0-20,0-6,0.1,0.1-0.2,0.1-0.25,0.15-0.25,0.2-0.4,0.2-1,0.3-0.6,0.3-0.65,0.5-1.2,0.6,0.6-2,0.65-1,0.7-1.1,0.7-2,1-10,1-2,1-2.2,1-2.5,1-3,1-4,1-6,1.2-2,1.5-2.5,1/3,1/3-1/,1/3-2/3,1/5-1/4,2-2.5,2-3,2-4,2.3-2.9,2.5-4.5,3.5-10,5-merous,7-10,7-8,abaxially,acute,alyx,apar,apart,apically,apparently,bark,blade,broad-deltate,brow,caudat,cm,concolorous,connivent,deltate,densely,diameter,distance,drying,dull,eaf,eed,elliptic,extending,eye,flattened-reniform,flower,free,fully,geminat,glabrescent,glabrous,herbaceous,infructescence,less,lobe,longer,midpoint,midvein,multangulate,naked,nflorescence,oblong,occasionally,older,one,open,opening,orolla,oung,outline,ovate,pair,peduncle,pendulous,per,perfec,pericarp,porrect,portion,prickl,prickly,primary,raised,ray,red-brown,reduced,rounded,ruit,scandent,scar,sessile,shiny,shorter,side,slender,smooth,spaced,sparsely,spreading,stalk,stellate,style,subsessile,tamen,terete,tertiary,time,tube,upper,usually,vary,vein,venation,visible,way,white-gray,wide,yellow-green,ympodial	appressed,articulation,bract,branching,broad-based,colour,corolla,form,geminate,growth,hair,heteromorphism,inflated,inflorescence,insertion,interjected,interpetalar,leaflet,na,needle-like,odour,orientation,paired,placement,position,present,pseudostipule,rhizome,scale,shape,smell,spot,staman,stone,structure,symmetry,sympodial,texture,tissue,tuber,type,vegetative,xylopodia,zygomorphy
89	wfo-0001026841	success	139	98	45	94	53	0.324	0.25-0.3,0.75-1,1.5-2,4-8,acute,anther,apex,base,berry,calyx,corolla,curly-tipped,deflexed,elliptic,filament,filiform,fruiting,glabrous,globose,green,inflorescence,leaf,lobed,long,lower,margin,minutely,mm,opposite,papillose,pedicel,petiole,pore,pubescent,shaped,shining,shrub,simple,sparsely,stem,tear-drop,trichome,uniseriate,unit,white	.25,.5,/4,0.05,0.25-0.5,0.5-0.75,0.5-1,0.5-2,0.6-1,0.8-1,0.8-3,1.5,2-2.5,3-6.5,3.5-5,5-8-flowered,6-8,7-9,9.2-18,along,anthesi,apart,arch,axi,ba,bark,beneath,bi-lobed,broadly,clavate,cm,conical,coroll,decurrent,deltoid,dia,eaf,edicel,eed,ellipsoid,exsertion,free,glabrate,greyish-gree,hyaline,immature,joined,known,later,lateral,like,lobe,lon,main,middle,nflorescence,older,ovary,pair,paler,papillo,poricidal,portion,prominent,raised,reddish,reflexed,rest,ruit,scar,series,slender,slightly,spaced,stigma,straight,style,tall,tapering,terminal,thickened,tip,tube,ud,unevenly,unifoliat,vein,way,widest,winged,woody,x,ympodial,young	appressed,articulation,bract,branching,breeding,broad-based,cell,colour,decurren,form,fruit,growth,hair,heteromorphism,inflated,insertion,interjected,interpetalar,leaflet,length,marking,mature,na,needle-like,odour,orientation,paired,pattern,placement,position,prickle,pseudostipule,rhizome,scale,shape,smell,spot,staman,stone,structure,surface,symmetry,sympodial,system,texture,tissue,tuber,type,unifoliate,vegetative,width,xylopodia,zygomorphy
90	wfo-0001026849	success	180	98	56	124	42	0.311	0.5-1,1-1.5,1-2,2-3,38/2,637/2,anther,apex,aster,axil,base,berry,calyx,cell,cm,colour,conical,corolla,developed,entire,filament,fork,fruiting,glabrous,glandular,green,growth,hair,inflorescence,lavender,leaf,long,long-cuneate,margin,mature,minute,mm,oblong,pedicel,petiole,pore,poricidal,rh,rotate,sea,shrub,simple,slightly,slit,stem,stone,tip,tissue,unit,violet,well	-50,0-10,1,1-6,1.5-2.5,1.75-2,100-130,11,2,30-,40,5,5-10,7-8,80-,acute,adherent,adult,amongst,appearing,aspect,australian,brown,capitate,composed,conspicuous,curved,cut,cyme,deflexed,dia,discoidal,distinct,distinctly,eed,ellipsoid,emarginate,enlarge,erect,exceeding,except,exerted,expanded,facetted,filled,flesh,floral,flower,flowered,free,general,globose,globular,granule,greater,gree,grey-brown,half,interacuminal,large,leave,lengthening,less,linear-lanceolate,little,lobe,lon,loosely,lower,maturity,mid-vein,minutely,native,nflorescence,oblong-lanceolate,occasionally,often,ovary,pal,pale,pedicellate,peduncle,petal,plurifoliat,preparation,pruinose,purple,rarely,relatively,reproducing,reticulate,rhachi,rounded,ruit,ruiting,seed,shallow,shed,short-lived,sinus,slende,soft-wooded,solanum,solitary,sometimes,somewhat,soon,stigma,stony,stout,style,surface,thus,tub,tube,ud,unarmed,undulate,uvenile,vegetatively,way,x,ympodial,young	appressed,articulation,bract,branching,breeding,connective,enlarged,form,fruit,heteromorphism,inflated,insertion,interjected,interpetalar,leaflet,length,marking,modification,na,odour,orientation,paired,pattern,placement,plurifoliate,position,prickle,pseudostipule,rhizome,scale,shape,spot,staman,structure,symmetry,sympodial,system,texture,tuber,type,xylopodia,zygomorphy
91	wfo-0001026858	invalid_json_followup	153	174	108	45	66	0.706	-30,0.5,0.8,0.8-1,1-10,1-11.5,1-4,1-5,1.3-1.5,1.5-4,2-2.5,2-3,2-4,2.5-3,3-4,4-24,4.5-10.5,6-10,6-18,6-7,abaxially,acumen,adaxially,apex,apical,apically,articulate,base,branched,calyx,cell,cm,connate,cordate,corolla,covering,cuneate,cyme,dehiscent,diameter,dichasial,dichasially,distal,exceeding,filament,flower,forked,generally,glabrescent,glabrous,globose,green,green-white,hair-like,half,herbaceous,interjected,introrse,lateral,leaf,leaflet,light,lobe,long,lower,make,maturing,minute,mm,monochasial,mucilaginous,mucronate,oblique,oblong,odd-pinnate,often,ovoid,pattern,pedicel,peduncle,perennial,perfect,petiole,plant,poricidally,proximal,seed,shiny,short,size,slightly,slit,stamen,stellate,stigma,straight,style,testal,thick,throughout,triangular,tuber-bearing,typically,unit,wall,wide,yellow,Â¼	-4,0-.,1-,3-,3-6-foliat,5-15,abruptly,acute,digestion,diminishing,dorsally,eaf,ebracteate,edge,eed,emoval,enzyme,flat,folded,globo,honeycomb,living,lon,lunat,nflorescence,nther,obtuse,orolla,ovate,ovate-lanceolate,pair,plan,reveal,rounded,ruit,seudostipule,specimen,tal,tem,throughou,toward,vary,white-crea,without,ympodial	'',0-2,3-15,3-6-foliate,[,\u201chair-like\u201d,``,anther,appressed,arrangement,articulation,bract,branching,breeding,broad-based,characteristic,colour,connective,ebbrate,form,fruit,fruiting,growth,hair,height,inflated,inflorescence,insertion,interpetalar,length,lunate,margin,marking,mature,modification,na,number,odour,ovary,paired,pore,position,prickle,pseudostipule,scale,shape,smell,spot,stem,structure,surface,symmetry,sympodial,system,texture,tissue,trichome,type,value,vegetative,wet,white-cream,width,zygomorphy,{,}
92	wfo-0001026895	success	166	127	83	83	44	0.5	0.5-1,0.5-1.2,0.5-1.5,0.5-2,1-1.5,1.4-2.1,2/3,4.5-5,abaxial,acute,anther,apex,apically,attenuate,base,berry,broadly,brown,calyx,cm,conical,corolla,dark,deflexed,dendritic,difoliate,drying,elliptic,erect,filament,filiform,flattened,fruiting,glabrous,globose,green,incrassate,internodal,lamina,leaf,lobed,lower,margin,minutely,mm,mustard,narrowly,often,pale,pedicel,petiole,pitted,pointed,pore,pubescent,reddish,reniform,scattered,shape,shaped,shrub,shrublet,simple,small,somewhat,stem,surface,swollen,swollen-based,tan,tear-drop,toothed,trichome,tube,type,uniseriate,unit,usually,way,white,woody,x,yellow	.5,0-0.5,0.8-1,1-5,1.5-2,2-2.3,2-2.5,2-3,2.5-3.2,3-12,5-6,5-8-flowered,adaxial,along,anthesi,apical,appearing,ba,bark,borne,broad,campanulate,capitate,closely,contracted,deltoid,denser,dia,differing,eaf,edicel,eed,ellipsoid,elongate,free,geminat,glabrate,hard,lateral,like,lobe,lon,long,long-exserted,main,major,middle,minor,minute,nflorescence,obovate,older,ovary,overlappin,pair,papillo,pericarp,poricidal,portion,present,projection,reddish-brow,ruit,scar,shoot,short,side,size,soon,spaced,sparsely,stigma,style,tall,thin,tip,tub,tuft,ud,vein,widest,ympodial,young	appressed,articulation,bract,branching,breeding,broad-based,cell,colour,connective,form,fruit,geminate,growth,hair,height,heteromorphism,inflated,inflorescence,length,marking,modification,na,needle-like,orientation,pattern,placement,plant,position,prickle,pseudostipule,rhizome,scale,seed,spot,staman,stellate,stone,structure,symmetry,sympodial,system,texture,tuber,xylopodia
93	wfo-0001026905	success	204	113	71	133	42	0.348	-2,.5,0,0-2,0.5-1.5,1-6,1/2-3/4,2.5-3.5,anther,apex,articulated,attenuate,base,berry,branched,calyx,cell,chartaceous,cm,connivent,cream,dark,difoliate,elongating,equal,erect,filament,fruit,fruiting,glabrous,green,inflorescence,lateral,leaf,length,lobed,long,lower,margin,marking,mature,maturity,mauve,mm,orange,pale,pedicel,petiole,poricidal,prickle,prickly,red,rounded,shrub,sometimes,spherical,stellate,stem,subentire,surface,tapering,tip,trichome,unarmed,unit,usually,way,weakly,white,wide,young	-1.5,-10,-2/3,-3,-4,.2,0-20,0-25,0.1,0.15,0.2-0.3,0.2-0.5,0.3-0.4,0.4,0.4-0.9,0.4-1,0.5-0.7,0.6-0.7,0.7-1.4,0.75-1.1,0.9-1.3,1,1-2,1-2.5,1-20,1-3.7,1-4,1.9-2.5,1/3,1/4,1/5-1/3,2-3,2.5-2.9,2/3-3/,3-5,3-8,5-6,5-merous,6-8,7-8,abaxially,acuminat,acute,alyx,ame,apar,apart,apically,apparently,bark,blade,brow,c.,curved,deltate,densely,diameter,discolorous,distance,drying,dull,eaf,eed,extending,eye,flattened-reniform,flower,free,geminat,gray-green,infructescence,lobe,longer,midpoint,midvein,moderately,naked,oblong,older,one,open,orange-brown,orolla,oung,outline,ovate,pair,peduncle,pendulous,per,perfec,pericarp,pit,porrect,portion,prickl,primary,raised,ray,reduced,ruit,scar,sessile,shallowly,shorter,side,slender,small,smooth,somewhat,spaced,sparsely,spreading,stalk,stalked,stellate-pubescent,straight,style,tamen,terete,tertiary,time,tube,upper,variously,vary,vein,venation,visible,woody,yellow,yellow-green,ympodial	appressed,articulation,bract,branching,broad-based,colour,corolla,form,geminate,growth,hair,heteromorphism,inflated,insertion,interjected,interpetalar,leaflet,na,needle-like,odour,orientation,paired,placement,position,pseudostipule,rhizome,scale,shape,smell,spot,staman,stone,structure,symmetry,sympodial,texture,tissue,tuber,type,vegetative,xylopodia,zygomorphy
94	wfo-0001026923	invalid_json_followup	177	158	100	77	58	0.565	.1-0.3,.5,0.25-0.5,0.5-1,0.6-0.8,0.8-1,1,1-7,1.5-4,2,2-2.5,2-6,3-5,4-18,5-10,5-15,5-6,5-9,abaxially,acuminate,adaxially,anther,apex,articulated,base,black,branched,brown,calyx,chartaceous,cm,cuneate,cylindrical,densely,diameter,directed,distally,elliptic,elliptic-ovate,entire,filament,flattened,flower,forked,fruit,glabrescent,glabrous,globose,green,hair,intermediate,large,leaf,leaf-opposed,light,like,longitudinal,lower,margin,mm,moderately,multangulate,oblong,opening,paired,pedicel,peduncle,peltate,petiole,pore,possibly,pubescent,purple,rachi,red,ripening,rounded,rugulose,scale,sessile,shrub,simple,slit,small,sometimes,sparsely,stellate,stem,stigma,strongly,style,surface,tree,trichome,usually,white,whitish,x,yellow,yellowish	-5,0-5,0.5,1-1.5,1-3,1-4,1.5-2,10,2-3,20-50,3-4,4-5-,absent,accrescent,acute,adaxiall,ag,apart,apparently,axe,ba,blade,capitat,center,connivent,covering,curved,deltate,denser,eaf,eed,eglandular,equal,erect,frui,fruiting,fused,geminate,gland-tippe,glandular,held,lanceolate,lateral,lobe,long,many-foliate,midpoint,midvein,much,nearly,nflorescence,orange,orolla,perfect,pubescence,ray,relatively,ruit,short,slightly,smaller,somewhat,spaced,ste,straight,subtending,tal,tamen,tem,time,tip,tube,unit,uprigh,vary,wide,ympodial	'',[,``,age,articulation,bract,branching,breeding,broad-based,capitate,character,characteristic,colour,connective,corolla,form,growth,height,heteromorphism,inflorescence,insertion,interjected,interpetalar,leaflet,length,marking,mature,modification,na,needle-like,odour,orientation,ovary,pattern,placement,plant,position,prickle,pseudostipule,rhizome,seed,shape,size,smell,spot,staman,symmetry,system,texture,tissue,tuber,type,value,vegetative,xylopodia,zygomorphy,{,}
95	wfo-0001026925	success	215	133	81	134	52	0.377	0-20,1-1.3,1-3.5,1/3-1/2,4-10,5-6,6-8,andromonoecious,anther,apex,articulated,attenuate,base,berry,branched,calyx,chartaceous,cm,connivent,cream,curved,dark,deltate,elliptic,equal,filament,flattened,flattened-reniform,flower,fruit,fruiting,gently,glabrous,green,hair,lateral,leaf,length,lobed,long,long-styled,lower,margin,marking,mature,maturity,mauve,membranous,minute,mm,moderately,orange-brown,ovate,pale,pedicel,per,petiole,poricidal,prickle,rarely,reflexed,short-styled,shrub,simple,sparsely,spherical,stellate,stellate-pubescent,stem,straight,surface,tapering,terminal,tip,trichome,unit,way,white,yellow,yellow-orange,young	-2,.5,/6,0,0-10,0-5,0-7,0.1,0.1-0.2,0.1-0.3,0.2,0.5-1.5,0.5-4,0.7-1.8,0.9-1.8,00-200,1-1.4,1-25,1-3,1-4,1.5-2,1.5-2.5,1.5-4.5,1.8-2,1.8-2.5,1/3,1/4-2/3,1/6-1/3,2-4,2-5,2.4-2.6,2.4-3,2.5-6,2/,3-20,3-7,4-14,4-5,4-7,5-8,5-merous,5.5-10,6-10,6-17,7-12,abaxially,acuminat,acute,alyx,ame,apar,apart,apically,apparently,bark,blade,broad-deltate,brow,c.,concolorous,diameter,distal,distance,drying,eaf,eed,elongating,erect,extending,free,glabrescent,green-brown,hermaphrodite,heterostylous,infructescence,lobe,lobing,longer,lowermost,midpoint,midvein,narrow-deltate,nflorescence,oblong,older,one,open,orolla,oung,pair,peduncle,pendent,pendulous,pericarp,plant,plurifoliat,porrect,portion,prickl,prickly,primary,ray,red-brown,reduced,rounded,ruit,scar,secondary,sessile,side,smooth,sometimes,spaced,spreading,stalk,stalked,staminat,stout,style,tamen,terete,tertiary,time,translucent,tube,unarmed,upper,vary,vein,venation,visible,wide,woody,ympodial	100-200,abaxial,adaxial,articulation,bract,branching,breeding,broad-based,cell,colour,connective,corolla,form,growth,heteromorphism,inflorescence,insertion,interjected,interpetalar,leaflet,modification,na,needle-like,number,odour,orientation,paired,pattern,placement,plurifoliate,pore,position,pseudostipule,rhizome,scale,seed,shape,smell,spot,staman,stone,structure,symmetry,sympodial,system,texture,tissue,tuber,type,vegetative,xylopodia,zygomorphy
96	wfo-0001026946	success	205	109	83	122	26	0.405	0-20,1-2,1-4,10-39,3-20,4-7,5-7,6-24,abaxially,adaxially,anther,axillary,berry,blade,brownish,bud,cell,chartaceous,cm,condition,connivent,corolla,creamy,deeply,densely,digestion,dot,drying,enzyme,filament,forked,fresh,fruit,glabrous,globose,green,greenish,hair,herb,honeycomb-shaped,interjected,lanceolate,lateral,leaflet,lengthening,like,long,membranous,mm,odd-pinnate,ovoid,pair,pentagonal,petiole,plurifoliate,pore,poricidal,pubescent,pure,purple,removed,ripe,scattered,seed,short-pubescent,size,slightly,slit,stellate,stem,streak,subtending,terminal,testal,tip,tri-,unit,usually,wall,white,whitish,x,yellow-white	0-5,0.5-2,0.9-3.5,0.9-4.3,1,1-10,1.5-2,1.6-3.7,12-23,2,2-15,2-5,2.5-10.5,2.7-9,3-5,3-6,3.5-10,4.1-9.4,5-merou,8-15,8-25,acumen,acuminate,acute,ag,along,alyx,apart,apex,apparently,articulation,attenuate,axe,base,borne,broadly,capitat,ciliate,clavate,covering,diameter,distal,dorsally,eaf,edge,eed,elliptic,end,erec,especially,exceeding,except,extremely,flat,flower,folded,geminat,generally,glabrou,greatly,green-white,hair-like,half,homostylous,living,lobe,lower,make,margin,midrib,minutely,mottled,mucilaginous,narrowly,nflorescence,oblique,often,orbicular,orolla,ovate,pedicel,peduncle,perfect,petiolulate,petiolule,plant,proximal,puberulent,pubescen,reduced,rounded,ruit,sessile,seudostipule,short,singly,spaced,specimen,stamen,ste,stigma,stolo,straight,style,subequal,tall,tamen,tem,thick,thir,throughout,truncate,tube,tuber,typically,unwinged,variable,vary,wet,wing,yellow,ympodial	age,arrangement,branching,colour,form,geminate,growth,heteromorphism,inflorescence,leaf,length,marking,na,position,pseudostipule,pubescence,shape,spot,staman,stone,structure,symmetry,sympodial,texture,type,zygomorphy
97	wfo-0001026962	invalid_json_followup	205	148	94	111	54	0.459	.05,0,0.3-0.7,0.8-1,1,1-1.2,1-1.5,1-3,1-4.5,1-6,1.5-17,1.5-2,1.5-5,10-12,2-2.5,2-6,2/3-3/4,3-3.5,4-5,6-7,abrupt,accrescent,acute,anther,apex,base,broadly,calyx,chartaceous,cm,corolla,deltate,diameter,dry,elliptic,entire,filament,flattened-reniform,fruit,fruiting,glabrous,globose,green,inflorescence,internodal,leaf,lobe,lobed,longitudinal,margin,material,mm,narrowly,oblong,occasionally,opening,opposite,pale,pedicel,peduncle,petiole,pore,purplish,rachi,rounded,sagittate,shaped,shrub,simple,size,slender,slightly,slit,small,sometimes,somewhat,stellate,stem,stigma,style,surface,tear-drop,tinged,tip,tree,triangular,trichome,tube,unbranched,uniseriate,way,white,x,yellow	.5,0.5,0.5-0.8,0.5-1,0.5-1.5,1-2,1.5-3,10-20,15-22,2-5,3-6,9-12,9-17,abaxially,abruptly,adaxially,ag,alyx,anthesi,apparently,appearing,arising,articulated,axe,bark,basebud,becoming,beneath,blade,brittle,bud,capitat,cell,closely,composed,connivent,constricted,cucullat,cylindrical,darker,deflexed,densely,denser,differing,difoliate,dimorphic,eaf,eed,elongate,evenly,except,exerted,flower,free,geminat,glabrate,glabrou,ilament,incrassate,later,lateral,like,long,main,major,minor,minutely,nflorescence,obconic,obovoid,often,older,one,orolla,oung,outline,ovate-lanceolate,overlapping,packed,pair,papillose,paten,pendent,perfect,pitted,portion,prominent,pubescen,pubescent,raised,reflexed,remaining,rest,rounder,ruit,soon,straight,tal,tapering,tooth,trunk,unarmed,unifoliate,unit,vary,vein,whit,woody,yellowish,ympodial,young	'',[,``,abaxial,adaxial,age,appressed,arrangement,articulation,bract,branching,breeding,broad-based,capitate,characteristic,colour,connective,form,growth,hair,height,inflated,insertion,interjected,interpetalar,leaflet,length,lower,marking,mature,modification,na,odour,ovary,paired,pattern,plant,position,prickle,scale,seed,shape,smell,spot,symmetry,system,texture,tissue,type,value,vegetative,zygomorphy,{,}
98	wfo-0001026964	success	128	100	64	64	36	0.5	.5,0,0.5,0.5-1,1-2.5,10,10-30,2-4,3-5,3.5-7,4.5-8.5,acuminate,acute,anther,apex,attenuate,axillary,basal,base,berry,calyx,cm,conical,corolla,diameter,elliptic,filament,filiform,fruiting,glabrous,globose,green,greenish,herb,horizontal,lateral,leaflet,lobed,long-attenuate,mm,nearly,obovate,onto,pair,pedicel,petiole,pinnate,poricidal,primary,pubescent,purple,rachi,shape,simple,size,sparsely,terminal,tip,trichome,uniseriate,unit,vein,x,yellow	.2,1-1.2,2-2.5,7-8,?,along,anthesi,beak,bearing,capitat,conspicuously,differentiated,distinct,eaf,edicel,equal,erec,exserted,fleshy,flower,free,glabrou,immature,known,lenticellate,lightly,line,lobe,long,lower,margin,minutely,nflorescence,noddin,often,one,open,ot,ovary,papillate,petiolule,portion,purpli,reflexed,rugose,ruit,scar,side,slender,small,smooth,somewhat,stigma,style,surface,tal,tem,time,tub,tube,ud,unifoliat,winged,ympodial	arrangement,bract,branching,bud,cell,colour,connective,form,fruit,growth,hair,height,heteromorphism,inflorescence,leaf,length,marking,na,nodding,number,orientation,placement,plant,position,prickle,purplish,spot,staman,stem,stone,structure,symmetry,sympodial,texture,type,unifoliate
99	wfo-0001026981	success	252	127	89	163	38	0.353	-14,-2.5,-35,0.1-0.2,0.2,0.3-0.5,0.5-30,1-2,1-3-celled,1.5-8.5,1/3,2-3-branched,2-locular,3-foliate,3.5-14,4-8,abaxially,absent,accrescent,adaxially,anther,apex,articulation,asymmetric,axi,base,bract,bracteole-like,calyx,cell,citrus-like,cm,cordate,corolla,dark,densely,distal,filament,fruit,fruiting,glabrescent,glandular,globose,green,herb,imparipinnate,interjected,interrupted,leaf,leaflet,lime,linear,long,lower,margin,maturity,mm,multicellular,occasionally,orange,patent,pedicel,pentagonal,petiole,petiolule,present,pseudostipule,pubescent,rounded,sessile,short,shorter,simple,slender,sometimes,sparsely,stem,strong,surface,trichome,type,uni-,uniseriate,unit,usually,velvety,wide,without,yellow	-0.4,-0.8,-2,-4,-8,.2,.2-0.2,0-5,0.05-0.1,0.1-0.3,0.15-0.2,0.2-0.4,0.2-2,0.25-0.4,0.3.6,0.4-0.5,0.4-0.7,0.4-2,0.45-1.3,0.5,0.5-0.3,0.6-1.4,0.6-2,0.7-0.8,0.8-1.2,0.8-6,0.9-1.4,0.9-1.5,1,1-2-cellular,1-3,1-3.3,1-4,1.5-2.0,1.5-5,1.8-2.8,11,196.,2-3,4,4-celled,6-10,7.5,<,absen,abundant,academy,acute,adpressed,along,amongst,angled,anthesi,apical,appearance,appendage,appressed,articulated,basiscopically,bay,beak,becoming,brown,capitate,coastal,column,composed,cone,conical,d,deltate,diameter,eaf,ebracteate,edicel,eed,entire,erect,exserted,flower,giving,gree,hair-like,half,halfway,head,included,initially,internode,irregularly,jointles,larger,later,lateral,less,like,lobe,lobed,lon,mainly,minutely,mixed,much,narrowly,nflorescence,obovate,orbicular,outgrowth,ovary,ovate,pair,pale,peduncle,per,perennial,plant,population,primary,procumbent,pronounced,proximal,pubescence,rachi,reflexed,rick,robust,ruit,scen,secondary,see,several,shaggy,shaped,silky,smaller,sparser,specimen,spreadin,staminal,sterile,stigma,straight,style,tangled,tem,terminal,tertiary,testa,thick,tightly,transparent,tub,tube,unicellular,upto,variously,villous,viny,wall,winged,ympodial,â,â	branching,broad-based,colour,form,growth,hair,heteromorphism,inflorescence,insertion,interpetalar,length,marking,mature,na,needle-like,odour,orientation,paired,placement,position,prickle,rhizome,scale,scent,shape,smell,spot,staman,stone,structure,symmetry,sympodial,texture,tissue,tuber,vegetative,xylopodia,zygomorphy
100	wfo-0001026992	success	243	120	71	172	49	0.292	0.5-1.2,1.4-1.6,1.7-4.3,2.8-4.7,abaxially,abruptly,accrescent,adaxially,anther,apex,appressed,articulated,attenuate,base,berry,blunt-tipped,branched,calyx,chartaceous,cm,completely,corolla,covering,directed,distally,entire,enveloping,filament,fleshy,fruit,fruiting,geminate,globose,hair,homostylous,lanceolate,leaf,length,lower,many,margin,mature,mm,pedicel,petiole,plurifoliate,pore,poricidal,ripe,scabridulous-,short,shrub,simple,small,sometimes,somewhat,stellate,stem,surface,terminal,time,tip,tomentose,tree,unarmed,unit,velutinous,violet,white,x,yellow	-2.5,/7,0.2-0.5,0.25-0.45,0.6-1.5,0.8-3.4,00-170,1-4,1.2-1.4,1.2-1.7,1.3-2.6,1.3-4.3,1.4-1.9,1.5-3.4,1.7-1.9,1.7-2.4,1/2,10-12,12-33,2-10,2-5.6,2.3-3.3,2.6-4.6,2.8-4.6,3-4,3.3-5.5,3.3-5.6,4-8,5-15,5-merou,5.3-12.1,6-10,8,8-11,8-14,abaxial,acuminate,acute,adaxiall,ag,along,alyx,angled,anthesi,apart,apparently,approximately,around,axe,axillary,ba,bark,blade,branch,broadly,brown,capitat,coriaceous,crown,cylindrical,dark,deltoid,densely,diameter,drying,eaf,echinoi,echinoid,edge,eed,elliptic,equal,evident,exserted,farinose,flat-topped,flower,forming,free,glabrescen,glabrous,granular-tomentose,greenish,grooved,high,immature,inserted,lacking,lance-ovate,lateral,lengthening,less,line,lobe,lobed,long,long-stalked,longitudinal,longitudinally,m.,main,maturity,midrib,minute,moderately,mostly,multangulate,nearly,nflorescence,oblong,obtuse,occasional,occasionally,often,older,orange-tan,orolla,ovate,ovate-lanceolate,overlapping,peduncle,perfect,plant,porrect-stellate,pubescence,pubescent,rachi,rare,rather,reniform,reticulate-punctate,ruit,runk,semi-ovate,sessile,short-,short-stalked,shorter,side,size,slit,spaced,sparingly,split,spreading,stalked,stamen,stigma,stout-stalked,style,subcampanulate,subglobose,suture,tamen,tan,terete,thin-textured,tube,ud,unarme,unequal,usually,vary,vein,way,weakly,whitish,wide,yellowish,ympodial,young,Â½	5-merous,articulation,bract,branching,breeding,broad-based,cell,colour,connective,form,growth,heteromorphism,inflated,inflorescence,insertion,interjected,interpetalar,leaflet,marking,modification,na,needle-like,odour,orientation,paired,pattern,placement,position,prickle,pseudostipule,rhizome,scale,shape,smell,spot,staman,stone,structure,symmetry,sympodial,system,texture,tissue,trichome,tuber,type,vegetative,xylopodia,zygomorphy
101	wfo-0001026994	success	266	112	84	182	28	0.316	0.5,0.5-0.8,4-15,anther,articulation,base,bent,berry,bifurcate,bracteate,branched,bright,brown,calyx,cell,cm,corolla,dark,darker,densely,developed,distal,ebracteate,eglandular,elliptic,filament,fruit,fruiting,glandular,globose,greenish,hair-like,half,head,herb,imparipinnate,inflorescence,interrupted,investing,lanceolate,lateral,leaf,less,lobe,locule,loosely,lower,margin,medial,midvein,mm,narrowly,node,oblique,obovate,occasionally,outgrowth,pedicel,peduncle,perennial,pseudostipule,pubescent,purple,rachi,regularly,ripe,rotate-stellate,simple,spreading,stem,stripe,surface,testa,tip,trichome,unicellular,uniseriate,usually,velvety,wall,weak-walled,well,white,yellow	-0.7,-10,-20,-30,-foliate,.2,.5,0.05-0.1,0.05-0.2,0.1,0.1-0.2,0.1-0.3,0.15-0.2,0.2-0.4,0.2-0.5,0.25,0.3-0.4,0.4-0.5,0.4-1.2,0.5-0.6,0.5-0.7,0.5-0.9,0.5-1.2,0.5-1.3,0.5-2,0.7-2.5,0.9-1.2,0.9-1.3,1,1-1.2,1-1.4,1-1.5,1-1.6,1-2,1.2-1.6,1.2-3.5,1.4-2.1,10-20,12-,2,2-,2-2.6,2-4,2-5-locular,2.2-3.2,2.5-6.5,20-50,3,3-branched,4,4-celled,5,5-,5-7,6-20,7-13,8,8-12,abaxially,absent,abundant,acroscopically,acuminate,acute,additional,adpressed,along,also,amongst,andscattered,anthesi,apex,apical,apically,appearance,appendage,articulate,basal,basally,basiscopically,becoming,beneath,bifurcation,bract,broader,broadly,capitate,celled,column,conical,crenat,crenate,crowded,decreasing,decumbent,decurrent,deeply,diameter,eaf,edicel,eed,erect,especially,essentially,exserted,fewer,flower,giving,glabrous,grayish,gree,green,habitat,hal,halfway,interjected,internode,irregularly,lamina,large,larger,largest,leaflet,leave,like,lobed,lon,long,markedly,minutely,moderately,much,narrower,narrowing,nearly,nflorescence,often,ovary,pair,paler,papillate,petiole,petiolule,present,primary,puberulent,rarely,reflexed,robust,rocky,secondary,sessile,set,shaggy,short,silky,sinus,size,slightly,sometimes,sparsely,specimen,spreadin,staminal,sterile,stigma,straight,style,tall,tem,terminal,tertiary,thick,toward,tube,ud,unit,wide,winged,woody,ympodial,young	abaxial,arrangement,branching,colour,decurred,form,growth,hair,hirsute,history,length,life,marking,mature,modification,na,orientation,placement,pore,position,prickle,scattered,seed,shape,spot,symmetry,texture,type
102	wfo-0001026996	success	188	103	83	105	20	0.441	0-6,0.6-1,0.9-2.7,1-2,1.3-7.7,1.8-4.4,14-33,15-28,3-10,3-7,3.3-6,3.8-14.1,4-4.4,4-8,4.5-10.5,5-8,6-8,6.9-10.9,8.7-18.6,abaxially,acumen,adaxially,anther,blade,blue,brownish,cell,cm,condition,coriaceous,corolla,dark,deep,diameter,drying,flower,forked,fresh,fruit,glabrous,globose,green,greenish,herb,homostylous,honeycomb-shaped,interjected,lanceolate,lateral,leaf,leaflet,lilac,medium,mm,moniliform,mottled,mucilaginous,odd-pinnate,ovoid,pedicel,peduncle,pentagonal,petiole,plant,pore,poricidal,purple,ripe,rotate,seed,size,slightly,stripe,style,terminal,testal,tip,tuber,unwinged,wet,white,whitish,x	1-3,1-4,1-5,1.2-1.8,2-3,3-5,5-merou,abaxiall,acuminate,acute,ag,along,alyx,apart,apex,apparently,arranged,articulated,asymmetric,attenuate,axe,axillary,base,basiscopic,bead,berry,bud,capitat,clavate,connivent,considerably,covering,decreasing,digestion,distal,dorsally,eaf,edge,eed,elliptic,enzyme,erec,exceeding,filament,flat,folded,geminat,generally,glabrou,green-white,hair-like,half,larger,lengthening,like,linear,living,lobe,long,lower,make,middl,multiple,necklace,nflorescence,orbicular,orolla,ovate,pair,perfect,petiolulate,plurifoliate,removed,rounded,ruit,sessile,seudostipule,side,slit,sometimes,spaced,specimen,stamen,stigma,stolon,straight,subglabrou,subtending,symmetric,tall,tamen,tem,thick,throughout,tissue,toward,tri-,tube,typically,unit,usually,vary,wall,yellow,ympodial	arrangement,articulation,branching,calyx,colour,form,growth,height,inflorescence,length,middle,number,ovary,position,pseudostipule,shape,stem,subglabrous,symmetry,texture
103	wfo-0001027010	invalid_json_followup	198	158	112	86	46	0.566	0-2,0.4-5.1,0.5-1.5,1-10,1-2,1-4,1.2-1.7,1.2-1.9,10-60,14-46,2-9.4,2.1-15.3,2.1-4.3,2.2-12.9,3-10,3-5,3-6,3-8,4-12,4-8,4.4-29,4.9-31,5-13,5-14,abaxially,acute,adaxially,anther,attenuate,axillary,base,blade,brownish,bud,cell,clavate,cm,condition,coriaceous,corolla,deep,diameter,digestion,distal,drying,elliptic,enzyme,filament,flower,forked,fresh,fruit,glabrescent,glabrous,green,greenish,hair,half,herb,high,homostylous,honeycomb-shaped,interjected,lanceolate,lateral,leaf,leaflet,light,lobe,long,mm,moniliform,occasionally,odd-pinnate,ovate,ovoid,pair,pedicel,peduncle,pentagonal,petiole,petiolulate,plant,pore,poricidal,purple,removed,ripe,rotate,rounded,scabrous,seed,sessile,short,size,spot,stigma,straight,stripe,style,subtending,terminal,testal,tip,tissue,tube,tuber,wall,white,whitish,wide,x	0-2.5,0-3,1-7,1.4-6.9,2-6,3.5-13.6,5-merou,acumen,acuminate,adaxiall,ag,along,alyx,apart,apex,apparently,arranged,articulated,asymmetric,axe,basiscopic,bead,capitat,coloration,connivent,covering,decreasing,dorsally,eaf,edge,eed,erec,exceeding,flat,folded,geminat,generally,glabrescen,glabrou,green-white,hair-like,hal,larger,lengthening,like,living,lower,make,mucilaginous,multiple,narrow,necklace,nflorescence,orbicular,orolla,perfect,plurifoliate,present,ruit,scabrou,seudostipule,side,slightly,slit,sometimes,spaced,specimen,stamen,stolon,subequal,tall,tamen,tem,thick,throughout,toward,tri-,typically,unit,usually,vary,wet,wing,winged,yellow,ympodial	'',[,``,abaxial,adaxial,appressed,arrangement,articulation,bract,branching,breeding,calyx,capitate,character,characteristic,colour,connective,form,fruiting,growth,height,inflated,inflorescence,interpetalar,length,marking,mature,modification,na,ovary,pattern,position,pseudostipule,scale,shape,spacing,staman,stem,symmetry,system,texture,trichome,type,value,{,}
104	wfo-0001027019	invalid_json	142	126	98	44	28	0.69	.5,/4,0-0.5,0.5-1,1-1.5,1.5-2,1.5-3,1/2,12-30,2-3,2-5,2-8,4-5,4-8.5,7-14,abaxial,abaxially,acute,adaxially,anther,anthesi,apex,attenuate,bark,base,branched,bright,calyx,capitate,cm,constriction,corolla,cyathiform,densely,dia,distal,ellipsoid,elliptic,exserted,filament,flattened,fleshy,fruiting,glabrous,globose,golden,green,inflorescence,largely,later,leaf,like,live,lobed,long,major,minor,minutely,mm,obovate,older,onto,opposite,ovary,overlapping,ovoid-reniform,pale,papillose,pedicel,petiole,planar,plant,pore,pubescent,scar,shaped,shrub,small,somewhat,spaced,sparsely,stem,stigma,strongly,style,surface,tan,tapering,tear-drop,tree,trichome,tube,waxy,way,white,winged,x,young	1-2,10,10-40-flowered,abruptly,along,apparent,ba,berry,deflexed,deltoid,difoliate,eaf,edicel,eed,erect,even,free,geminat,glabrate,inflorescenc,lobe,lon,lower,midrib,narrowed,nflorescence,papillo,pitted,poricidal,portion,reddish-brow,rest,ruit,straight,tall,third,tip,tub,ud,unit,widest,wing,woody,ympodial	'',10-40,[,``,branching,bud,characteristic,colour,diameter,exsertion,flower,form,fruit,growth,height,length,number,position,reddish-brown,seed,shape,size,spacing,texture,value,winging,{,}
105	wfo-0001027030	success	234	124	81	153	43	0.346	.5,0-4,0.1-0.7,0.1-0.9,0.15-0.2,0.2-0.3,0.3-0.7,0.4-0.5,0.4-0.8,0.5,0.5-0.7,0.5-1,0.6-0.7,0.8-1,1-3,2-3,2-foliate,anther,apex,articulation,base,basiscopically,berry,bract,branched,bright,calyx,cell,cm,corolla,crenate,decurrent,distal,entire,extremely,filament,fruit,fruiting,globose,green,half,herb,imparipinnate,inflorescence,interjected,interrupted,investing,irregularly,lanceolate,leaflet,long,loosely,lower,margin,mm,oblique,pair,pedicel,petiole,pseudostipule,pubescent,rotate-stellate,sessile,simple,slender,soft,sometimes,somewhat,sparsely,spreading,stem,surface,trichome,truncate,uniseriate,unit,velvety,weak,wide,woody,yellow	-11,-15,.2,0.05-0.1,0.2,0.2-1,0.3-,0.3-0.5,0.4-1.5,0.5-,0.5-0.8,0.6-0.8,0.6-1.8,0.7-1,0.8-0.9,0.9-1.1,1,1-,1-1.2,1-1.3,1-3.4,1.2-1.6,1.5-,1.6-2,2-,2-4,2-4.8,2-6,2-7,2-locular,2.2-3.2,3-4-celled,3-8,3-9,4-celled,5-12,8-celled,abaxial,abaxially,absent,abundant,acuminate,acute,adaxially,adpressed,angled,anthesi,apical,appearance,appendage,articulated,axi,basal,beneath,beyond,brown,capitate,column,conical,crenat,crenation,dark,darker,deeper,deeply,densely,denser,diamete,diameter,due,eaf,edicel,eed,eglandular,elliptic,evenly,exserted,flower,giving,gland,glandular,grayish,gree,growt,hair-like,hal,halfway,internode,interspersed,lamina,larger,lateral,less,like,lobe,lon,longer,minutely,multicellular,narrowly,near,nflorescence,node,obovate,occasionally,often,outgrowth,ovary,pale,paler,papillate,peduncle,perennial,petiolule,present,primary,pubescence,reflexed,robust,ruit,secondary,silky,similar,size,slightly,small,smaller,spread,spreadin,staminal,sterile,stigma,straight,stripe,style,tall,tem,terminal,tertiary,testa,thick,tiny,trailing,tube,ud,unicellular,usually,vein,wall,white,winged,ympodial,young	appressed,branching,breeding,broad-based,colour,form,growth,hair,heteromorphism,inflated,insertion,interpetalar,leaf,length,marking,mature,na,needle-like,odour,orientation,paired,pattern,placement,position,prickle,rhizome,scale,shape,smell,spot,staman,stone,structure,symmetry,sympodial,system,texture,tissue,tuber,type,vegetative,xylopodia,zygomorphy
106	wfo-0001027035	invalid_json_followup	199	155	107	92	48	0.538	0-36,0.1-0.9,0.3-2.3,0.4-12.8,0.5-7,0.8-4.2,0.9-3.1,1-2,1-3,1-3.4,1-8,1.7-8,1.8-5.2,10-80,2-38,2-7,2.8-10.3,3-10,4-18,4-18.5,4.9-23.5,anther,apex,attenuate,base,blade,blue,brownish,cell,clavate,cm,completely,condition,corolla,deep,diameter,digestion,distal,drying,elliptic,enzyme,filament,flower,forked,fresh,fruit,glabrescent,glabrous,globose,green,greenish,hair,half,herb,high,homostylous,honeycomb,interjected,lanceolate,lateral,leaf,leaflet,light,lilac,lobe,long,medium,mm,moniliform,odd-pinnate,ovate,ovoid,pair,pedicel,peduncle,pentagonal,petiole,petiolulate,plant,pore,poricidal,purple,removed,rotate,rounded,seed,sessile,shape,shaped,short,size,stigma,straight,style,terminal,testal,throughout,tip,tissue,tube,tuber,usually,wall,white,whitish,wide,x	0-7,0.5-3.4,0.5-5,0.8-3,1.5-5.9,3-5,5-merou,abaxially,acumen,acuminate,acute,adaxiall,adaxially,ag,along,alyx,apart,apparently,arranged,articulated,asymmetric,axe,axillary,basiscopic,bead,bud,capitat,coloration,connivent,covering,decreasing,dorsally,eaf,edge,eed,erec,exceeding,flat,folded,geminat,generally,glabrescen,glabrou,green-white,hair-like,hal,larger,lengthening,like,living,lower,make,mucilaginous,multiple,necklace,nflorescence,orbicular,orolla,perfect,plurifoliate,present,ripe,ruit,second,seudostipule,side,slightly,slit,smaller,sometimes,spaced,specimen,stamen,stolon,stripe,subequal,subglabrous,subtending,tall,tamen,tem,thick,toward,tri-,typically,unit,unwinged,variable,vary,wet,yellow,ympodial	'',[,``,abaxial,arrangement,articulation,bract,branching,breeding,calyx,capitate,characteristic,colour,connective,form,fruiting,glabrousnes,growth,height,inflorescence,insertion,interpetalar,length,margin,marking,mature,modification,na,number,odour,orientation,ovary,paired,pattern,position,prickle,pseudostipule,scale,spot,staman,stem,symmetry,system,texture,type,value,{,}
107	wfo-0001027050	success	244	126	84	160	42	0.344	-12,/3,1-2,2-5,2.5-3,5-7,5-9,absent,abundant,adult,anther,apex,articulated,base,berry,branch,branched,broad-based,calyx,chartaceous,cm,cordate,cuneate,curved,deeply,densely,difoliate,directed,distally,entire,filament,fruit,fruiting,glabrous,green,growth,hair,heterostylous,inflorescence,interpetalar,lanceolate,lateral,leaf,leaf-opposed,length,lobed,long,margin,mature,minute,mm,oblique,obtuse,pedicel,petiole,pore,poricidal,present,prickle,ripe,rounded,scattered,several,shrub,slightly,small,spherical,stellate,stellate-pubescent,straight,time,tip,tissue,tree,truncate,unbranched,unit,usually,way,weakly,white,wide,yellowish-green,younger	-9,.2,.5,0-0.2,0-3,0.1-0.3,0.1-3,0.2-0.5,0.2-1,0.3-1.5,0.5-3,0.8,0.9-2.1,1,1-1.5,1.5-2,1.5-6,10-13.5,12-15,15-50+,2-2.5,2-3,2-4,2-8,3-5,4-20,4-8,5,5-10,5-6,5-merous,50,6-8,7-30+,8-26,abaxial,abaxially,absen,acuminate,acute,adaxial,adaxiall,alyx,andromonoeciou,apar,arme,axe,bark,basal,blade,broad,broadly,brow,brown,capitate,closely,coarsely,conical,connivent,diameter,distal,distall,drying,eaf,eed,eglandular,elliptic,equal,erec,erect,except,ferruginous,flattened,flattened-reniform,flower,free,geminat,glandular-puberulent,half,infructescence,inside,juicy,juvenile,larger,least,less,like,lobe,long-styled,longer,lower,markedly,mid-way,midpoint,midrib,midvein,minutely,moderately,moist,mucilaginous,multiseriate,narrowly,near,nflorescence,numerous,occasionally,often,older,orolla,oung,ovate,ovate-lanceolate,pale,papillat,peduncle,per,pericarp,plant,porrect,portion,pricklier,prickly,pubescent,ray,rest,ruit,scar,secondary,sessile,shallowly,shiny,short-stalked,short-styled,shorter,side,somewhat,spaced,sparsely,stalk,stalked,stem,stigma,style,surface,tall,tamen,terete,thicker,toothed,touching,triangular,trichome,tube,unarmed,vary,whitish,woody,yellow,ympodial,young	andromonoecious,appressed,articulation,bract,branching,breeding,cell,colour,connective,corolla,form,geminate,heteromorphism,inflated,insertion,interjected,leaflet,marking,modification,na,odour,orientation,paired,pattern,placement,position,pseudostipule,rhizome,scale,shape,spot,staman,stone,structure,symmetry,sympodial,system,texture,tuber,type,xylopodia,zygomorphy
108	wfo-0001027050	success	234	115	76	158	39	0.325	1-2,2-foliate,5-9,absent,accrescent,andromonoecious,anther,apex,articulated,base,branched,broad-based,brown,calyx,chartaceous,coarsely,cordate,cuneate,curved,cylindrical,directed,distally,entire,extra-axillary,ferruginous,filament,flattened,forked,fruit,fruiting,globose,green,growth,hair,inflorescence,interpetalar,lanceolate,leaf,leaf-opposed,length,lobed,margin,minute,minutely,mm,oblique,obtuse,pedicel,petiole,pitted,pore,present,prickle,rounded,shallowly,shrub,simple,slightly,small,stellate,stellate-pubescent,stem,stigma,straight,style,surface,tissue,toothed,tree,truncate,unbranched,unit,usually,weakly,white,yellowish-green	.2,0-0.2,0-0.5,0-1,0-3,0.1-3,0.2-0.6,0.2-1,0.3-0.6,0.4-1,0.5-0.8,0.5-1,0.5-3,0.8,1-1.5,1-5,1.5-2,1.5-6,10-13.5,10-30,11-21,12-15,14-20,15-50+,16-40,2-10,2-2.5,2-3,2-3-locular,2-4,2-5,2-6,2-8,2.5-3,23-40+,3-15,3-5,4-19,4-40,4-8,5,5-10,5-6,5-7,5-merous,6-8,7-30+,8-26,8-40+,abaxially,absen,abundant,across,acuminate,acute,adaxiall,adaxially,adult,anvil-shape,apart,armed,axe,ba,blade,branche,broadly,capitat,cm,connivent,contiguous,cross-section,deeply,densely,diameter,distall,distributed,drying,eaf,eed,eglandular,elliptic,erect,except,exocarp,flower,functional,geminat,glabrous,glandular-puberulent,half,held,juicy,juvenile,lateral,less,like,lobe,long,longer,lower,markedly,mature,mesocarp,midpoint,midvein,moderately,moist,mucilaginous,multiseriate,narrowly,nearly,nflorescence,often,orolla,ovate,ovate-lanceolate,pair,pale,peduncle,per,pinnatifid,placenta,plant,porrect,rachi,ray,ruit,scattered,sessile,shorter,side,somewhat,spaced,sparsely,stalk,stalked,stellae,tal,tamen,tem,thick,thicker,throughout,time,tip,triangular,tube,unarme,unarmed,upper,upright,vary,whitish,wide,x,yellow,ympodial,younger	articulation,berry,bract,branching,breeding,capitate,cell,colour,connective,corolla,form,geminate,heteromorphism,insertion,interjected,leaflet,marking,odour,orientation,pattern,placement,position,pseudostipule,rhizome,scale,seed,shape,spot,staman,stone,structure,symmetry,sympodial,system,texture,tuber,type,xylopodia,zygomorphy
109	wfo-0001027091	invalid_json_followup	142	180	104	38	76	0.732	1-1.6,1.1-1.6,1.8-2.6,1/2-2/3,2.3-2.9,3-8,3-9,30-60,4-10,5-11,6-10,8.5-11.5,9-13,accrescent,acute-tipped,along,annual,anther,arcuate,armed,base,berry,blade,blue,branched,bristly,broadly,brown,calyx,campanulate,capitate-glandular,cm,dark,deltoid,densely,developing,dm,dry,enveloped,few-rayed,glabrous,gland,glandular,hair,herb,internodal,invested,lenticular,linear-lanceolate,lobe,long,longer,low,main,maturity,mm,mostly,narrowly,near,obtuse,occasionally,oriented,ovate,pedicel,per,petiole,pinnatifid,pinnatisect,prickly,radially,reticulately,ridge,rounded,scattered,sessile,short,short-stipitate,simple,sometimes,sparsely,spherical,splitting,spreadingly,stellae,stellate-pentagonal,stem,strait,suffused,surface,tapering,terete,terminally,tightly,tube,twice,undulate,uniseriate,usually,variously,vein,vestiture,violet,wholly,wrinkled	.3,0.7,0.8,2.5-3.5,6-10-flowere,across,alyx,anthesi,beneath,cauline,dia,difoliate,divided,eaf,eed,extended,fully,geminat,green,high,lon,nflorescence,orolla,ruit,slende,somewhat,ste,tamen,taprooted,tigma,tub,tyle,unexpande,unit,vary,yello,ympodial,younger	'',6-10-flowered,[,``,apex,armednes,articulation,bract,branching,breeding,broad-based,characteristic,colour,connective,corolla,diameter,envelopment,filament,flower,form,fruit,fruiting,glabrousnes,glandularity,growth,height,history,inflorescence,insertion,interjected,interpetalar,investment,leaf,leaflet,length,life,lobing,margin,marking,mature,modification,na,needle-like,number,odour,orientation,ovary,paired,pattern,pinnation,placement,plant,pore,position,prickle,prickling,pseudostipule,rhiz,scale,seed,shape,slender,spot,stellate,stigma,style,symmetry,system,texture,tissue,type,unexpanded,value,yellow,{,}
110	wfo-0001027102	success	167	106	52	115	54	0.311	0.5-1,0.5-2,1.5-2,3-4,absent,accrescent,adaxially,anther,apex,base,broad,calyx,cell,cm,connivent,cuneate,curved,difoliate,directed,distally,entire,filament,forked,fruit,fruiting,glabrous,globose,hair,leaf,leaf-opposed,long-tapered,margin,mm,oblong,orange,pedicel,perfect,petiole,pore,rarely,shrub,simple,slender,stellate,stem,stone,subcoriaceous,surface,unbranched,unit,white,x	.5,.5-6,0.2-2,0.5,0.5-3,1-1.5,1-2,1-2.5,1-3,1-4,1-6,10-20,15,15-35,2-2.5,2-3,3,3-12,3-5,4-5,4-7,5-12,<,abaxially,absen,acuman,acuminate,acute,adaxial,adaxiall,ag,aggregate,almost,alyx,apart,appearance,articulated,axe,ba,blade,broadly,channe,chartaceous,ciliate,congested,corky,cylindrical,deltate,densely,diameter,differing,dimorphic,eaf,eed,elliptic,few-,flattened,flower,free,geminat,giving,ilament,lanceolate,lobe,long,longitudinal,m.,major,minor,moderately,multiseriate,narrowly,nflorescence,obtuse,often,one,opening,orolla,ovate,peduncle,per,portion,pubescent,rachi,ripe,roughened,rugulose,ruit,short,size,slit,small,somewhat,spaced,sparsely,stigma,straight,style,tal,tem,time,tip,tomentose,triangular,truncat,truncate,tube,unarme,usually,vary,wide,yellow,yellow-brown,ympodial,young	appressed,articulation,berry,bract,branching,breeding,broad-based,colour,connective,corolla,form,geminate,growth,heteromorphism,inflated,inflorescence,insertion,interjected,interpetalar,leaflet,length,lower,marking,mature,modification,na,needle-like,odour,orientation,paired,pattern,placement,position,prickle,pseudostipule,rhizome,scale,shape,smell,spot,staman,structure,symmetry,sympodial,system,texture,tissue,trichome,tuber,type,unarmed,vegetative,xylopodia,zygomorphy
111	wfo-0001027104	success	141	137	74	67	63	0.525	0.15-0.35,0.5-0.8,1-3,1-4,1.2-6,1.5-2.3,1.5-4.2,10-15,2-3,2-6,3-5.5,4-15,5-15,6-7.5,acuminate,acute,apex,apically,attenuate,base,branched,calyx,cell,cm,connate,cordate,corolla,covering,dehiscent,diameter,dichasially,distal,filament,finely,flower,globose,green,green-white,hair-like,half,herbaceous,lateral,linear,lower,mm,narrowly,odd-pinnate,ovate,ovoid,pattern,pedicel,peduncle,perennial,perfect,petiole,plant,poricidally,proximal,pubescent,seed,stellate,straight,style,testal,thick,throughout,tone,truncate,tuber-bearing,unit,wall,white,yellow-green,Â¼	1-1.5,2.2-5,3-6-foliat,abaxially,acumen,adaxially,apical,articulate,condition,cyme,dichasial,digestion,dorsally,eaf,ebracteate,edge,eed,emoval,enzyme,epiphyti,epiphytic-like,exceeding,flat,folded,forked,generally,globo,growing,honeycomb,introrse,living,lobe,lon,long,make,maturing,monochasial,mos,mucilaginous,mucronate,nflorescence,nther,often,orolla,ovat,plan,rarely,reveal,ruit,seudostipule,short,simple,slit,specimen,stamen,stigma,tall,tem,terrestrial,throughou,typically,vary,viole,wide,without,yellow,ympodial	3-6-foliate,anther,appressed,arrangement,articulation,bract,branching,breeding,broad-based,colour,connective,form,fruit,fruiting,growth,hair,height,heteromorphism,inflated,inflorescence,insertion,interjected,interpetalar,leaf,leaflet,length,margin,marking,mature,modification,na,needle-like,odour,orientation,ovary,paired,placement,pore,position,prickle,pseudostipule,rhizome,scale,shape,smell,spot,staman,stem,stone,structure,surface,symmetry,sympodial,system,texture,tissue,trichome,tuber,type,vegetative,violet,width,xylopodia
112	wfo-0001027114	invalid_json_followup	154	136	75	79	61	0.487	-17,-30,.5,1-1.2,1-1.5,1.5-1.7,1.5-2,1/2,13-21,2-2.5,2-3,3-4,3-7,6-8,6-9,7-9,abaxial,acute,anther,apex,appearing,base,berry,branched,calyx,capitate,cm,conical,corolla,dendritic,dia,elliptic,filament,flattened-reniform,fruiting,glabrous,globose,green,inflorescence,lateral,leaf,lobed,long,main,many,margin,minute,minutely,mm,occasionally,opposite,ovary,pair,pedicel,petiole,pitted,pore,poricidal,projection,shoot-terminal,shrub,size,soft,stigma,style,surface,time,tip,triangular,trichome,tube,vein,way,white,wide	-2,0.5-1,1-1.1,1-2,20-40,5,7-10,abaxially,adaxially,along,alternating,anthesi,apar,axillary,ba,bark,bushy,closely,commonly,dark,deltate,densely,differing,difoliate,drying,due,eaf,edicel,eed,erect,exserted,flowered,free,geminate,glabrou,growt,halfway,inflorescenc,investing,lamina,like,lobe,lon,lower,major,minor,nflorescence,older,opening,papillo,planar,plurifoliate,portion,pubescent,rapid,reddish,reddish-brown,rest,ruit,scar,scattered,several,shoot,simple,slit,spaced,stem,tall,tapering,thickened,tub,ud,unevenly,uniseriate,unit,woody,yellowish,ympodial,young	'',0.5,1.5,[,``,appressed,articulation,bract,branching,breeding,cell,characteristic,colour,connective,diameter,form,fruit,growth,hair,height,heteromorphism,inflated,insertion,interjected,interpetalar,leaflet,length,marking,mature,modification,na,odour,orientation,papillose,pattern,placement,plant,position,prickle,pseudostipule,pubescence,rhizome,scale,seed,shape,spot,staman,stellate,stone,symmetry,system,texture,tissue,tuber,type,value,venation,width,xylopodia,{,}
113	wfo-0001027117	success	235	103	57	178	46	0.243	.5,1-2,2-8,4.5-6.5,accrescent,anther,apex,apparently,articulated,attenuate,base,berry,branched,calyx,cell,chartaceous,cm,connivent,cordate,enclosing,erect,evenly,filament,fruit,fruiting,glabrous,green,herb,lateral,leaf,length,lobed,long,lower,margin,mature,maturity,mauve,mm,oblong,pedicel,petiole,poricidal,prickle,spherical,spreading,staman,stellate,stem,surface,tapering,tip,tissue,unequal,unit,yellow,young	-1.5,-11,-12,-2.8,-3/4,/3,0-10,0-15,0-20,0-25,0-40,0-5,0.1,0.1-,0.1-0.7,0.15-0.25,0.15-0.35,0.2,0.2-0.45,0.5,0.5-1.5,0.6-0.9,0.7-0.9,0.7-1.3,0.7-1.5,0.8-,1-4,1-6,1.2,1.5-,1.5-2.3,1.5-6.5,1.7-2.5,1.8-2.5,1/,1/3,1/4,1/8-1/2,10-20,2-3,2-6,2.3-2.8,25-100,3-10,3-15,3-6,4-6.5,4-7,4-8,4.5-8,5-11,5-14,5-merous,6-10,6-9,7-,8,abaxially,acicular,acute,almost,alyx,ame,apar,apart,apically,bark,beyond,black,blade,brittle,brown,c.,concolorous,curved,dark,deltate,densely,diameter,discolorous,distance,drying,eaf,eed,elongating,extending,fifth,fine,flattened-reniform,flower,four,free,gently,glabrescent,gra,herbarium,infructescence,irregularly,less,lobe,lon,long-acuminat,longer,membranous,midpoint,midvein,moderately,narrow-deltate,narrow-elliptic,narrow-lanceolate,nflorescence,obovate,older,one,open,orolla,oung,outline,ovate,pair,pale,peduncle,pendulous,per,perfec,pericarp,perpendicular,pit,plurifoliat,porrect,portion,prickl,prickly,primary,raised,ray,red-brown,reduced,reflexed,rounded,ruit,scar,sessile,shallowly,shiny,shorter,side,small,smooth,sometimes,spaced,sparsely,specimen,stalk,stalked,stellate-pubescent,straight,style,tamen,tearing,terete,tertiary,time,translucent,trichome,tube,upper,variously,vary,vein,venation,visible,way,weakly,wide,woody,yellow-green,ympodial	appressed,articulation,bract,branching,breeding,broad-based,colour,connective,corolla,form,growth,hair,heteromorphism,inflated,inflorescence,insertion,interjected,interpetalar,leaflet,marking,modification,na,needle-like,odour,orientation,paired,pattern,perfect,placement,plurifoliate,pore,position,pseudostipule,rhizome,scale,shape,spot,stone,structure,symmetry,sympodial,system,texture,tuber,type,xylopodia
114	wfo-0001027123	success	181	107	54	127	53	0.298	0.3-1.6cm,1-1.5,1.5-2,4-6,5-6,acute,anther,apex,attenuate,base,branched,brown,calyx,cell,corolla,dark,filament,flattened,fruiting,glabrous,inflorescence,inserted,leaf,lobed,long,loose,lower,margin,mauve-purple,mm,nodding,papillate,pedicel,perfect,petiole,plurifoliate,reddish,reniform,short,simple,sleeve,sparsely,stellate,stem,subshrub,surface,terminal,time,trichome,unit,violet,way,x,Â¾	-10,-20,.3,.5,0.5,0.5-0.8,0.7-3.5,0.8-1.3,0.9-1.3,1,1-1.2,2-2.2,2-2.5,2-2.6,2-3,2-5.5,2-lobed,2.5-10.4,2.5-4,2.5-6,3-15,3-4,4-5,5-10,abaxial,adaxial,adaxially,along,anthesi,appearing,axe,axi,bark,bright,broadly,campanulate,clavate,cm,commonly,completely,conical,constricted,coriaceous,cup-shaped,darker,deltate,dendritic,densely,denser,diameter,drying,eaf,edge,eed,elliptic,enlarged,erect,exerted,fide,flower,free,glandular,globose,green,lamina,lax,less,lewi,like,lobe,lon,loosely,midvein,minute,minutely,monopodia,narrowly,nflorescence,older,outline,ovary,pair,papillae,peduncle,perhaps,petal,pitted,planar,portion,primary,prominent,pubescent,revolute,scar,scatted,scattered,shin,shinin,shining,shiny,sinuate,slightly,sometimes,soon,spaced,stigma,stoutish,straight,strongly,style,testal,thick,tip,trailing,tub,tube,turned,ud,upper,usually,vein,warty,white,widely,wood,ympodial,young	appressed,articulation,bract,branching,breeding,broad-based,colour,connective,form,fruit,growth,hair,heteromorphism,inflated,insertion,interjected,interpetalar,leaflet,length,marking,mature,modification,monopodial,na,needle-like,odour,orientation,paired,pattern,placement,pore,position,prickle,pseudostipule,rhizome,scale,seed,shape,smell,spot,staman,stone,structure,symmetry,sympodial,system,texture,tissue,tuber,type,vegetative,xylopodia,zygomorphy
115	wfo-0001027146	invalid_json	213	155	130	83	25	0.61	0-11,0.3-2.2,0.7-2.4,0.8,0.8-5.8,1-10,1-2,1-2.5,1-9.5,10,13-36,2-12.2,2-13,2-4.2,2-5,3.3-6.1,3.5-22,4-11,4-12.5,4-38,4-8,6-10,6-17.5,6.5-52,abaxially,adaxially,along,anther,apart,berry,blade,brownish,cell,chartaceous,ciliate,clavate,cm,coarsely,condition,conical,connivent,corolla,covering,dark,deep,diameter,dorsally,drying,edge,elliptic,especially,filament,finely,flat,flower,folded,forked,fresh,fruit,glabrous,green,green-white,greenish,hair,hair-like,herb,homostylous,interjected,lanceolate,lateral,leaf,leaflet,lengthening,like,lobe,long,make,margin,medium,membranous,midrib,minute,minutely,mm,moniliform,mottled,mucilaginous,odd-pinnate,ovate,ovoid,pair,pedicel,peduncle,pentagonal,petiole,plant,pore,poricidal,puberulent,pubescent,purple,ripe,rotate,seed,simple,size,slit,stem,stigma,straight,style,subglabrous,terminal,testal,thick,throughout,tinged,tip,tube,tuber,unwinged,violet,wall,wet,white,whitish,wide,wing,x,yellow	0.5-3.2,0.6-3.3,0.8-3.1,1.9-10,5-merou,6,acumen,acuminate,ag,alyx,apex,apparently,arranged,articulated,asymmetrical,attenuate,axe,axillary,base,basiscopic,bead,bud,capitat,commonly,darker,decreasing,digestion,distal,eaf,eed,enzyme,erec,exceeding,fourt,fourth,geminat,generally,glabrou,gradually,half,honeycomb-shaped,living,lower,multiple,necklace,nflorescence,orbicular,orolla,perfect,petiolule,plurifoliate,proximal,rarely,ray,removed,ruit,secondary,semierect,sessile,seudostipule,side,sometimes,spaced,specimen,stamen,ste,stolon,subequal,subglabrou,subsessile,subtending,symmetrical,tall,tamen,tem,tissue,toward,tri-,typically,unit,usually,vary,ympodial	'',[,``,age,arrangement,branching,calyx,capitate,characteristic,colour,form,glabrousnes,growth,height,inflorescence,length,ovary,pseudostipule,shape,spacing,texture,value,width,{,}
116	wfo-0001027157	success	207	113	61	146	52	0.295	0-3,0.9-2.8,1,1-2,4-5,absent,anther,apex,axillary,base,berry,bud,cell,chartaceous,cm,conical,cordate,corolla,deeply,filament,forked,fruit,glabrous,green,hair,hair-like,herb,homostylous,interjected,lanceolate,leaf,leaflet,lengthening,long,lower,margin,membranous,mm,oblique,odd-pinnate,ovoid,pedicel,petiole,plurifoliate,pore,poricidal,ripe,rounded,slit,sometimes,stellate,stem,subtending,terminal,tinged,tip,tri-,tuber,unit,violet,white	0.15-0.3,0.7-2,1-10,1-3,1-3.8,1-6,1.5-6.5,10-30,2,2-15,2-2.5,2-3,2-5,2.3-4,2.5-3,3-12,3-7,3.3-7.8,3.8-8.3,5-merou,6.5-14.5,9-12,abaxially,acumen,acuminate,acute,adaxially,ag,along,alyx,among,apart,apparently,articulated,attenuate,axe,blade,broadly,brownish,capitat,ciliate,clavate,condition,connivent,covering,cuneate,decreasing,decurrent,densely,diameter,digestion,distal,dorsally,drying,eaf,edge,eed,elliptic,end,enzyme,erec,especially,exceeding,flat,flower,folded,fresh,geminat,generally,glabrou,grassland,greatly,green-white,greenish,half,honeycomb-shaped,lateral,like,living,lobe,low-growing,make,markedly,middl,midrib,minutely,mucilaginous,narrowly,nflorescence,obtuse,one,orbicular,orolla,ovate,pair,peduncle,perfect,petiolulate,petiolule,placed,plant,puberulent,pubescent,rarely,removed,ruit,seed,semi-rosette,sessile,seudostipule,shady,short,situation,size,slightly,spaced,specimen,stamen,ste,stigma,stolo,straight,style,subsessile,sunny,tall,tamen,tem,testal,thick,throughout,toward,tube,typically,unequal,unwinged,usually,vary,wall,wet,whitish,wide,woodland,x,yellow,ympodial	age,appressed,articulation,bract,branching,breeding,broad-based,calyx,colour,connective,form,fruiting,growth,heteromorphism,inflated,inflorescence,insertion,interpetalar,length,marking,mature,middle,modification,na,needle-like,odour,orientation,paired,pattern,placement,position,prickle,pseudostipule,rhizome,scale,shape,smell,spot,staman,stone,structure,surface,symmetry,sympodial,system,texture,tissue,trichome,type,vegetative,xylopodia,zygomorphy
117	wfo-0001027184	success	219	107	64	155	43	0.292	.3,.7,0.8,1â2,1â4,2â4-celled,3-4-,3.5â8,accrescent,anther,apex,appressed,axillary,base,blue,bract-like,broad,calyx,cell,cm,connivent,directed,epidermal,extension,filament,fleshy,foliaceous,fruit,fruiting,globose,hair,hairlike,imparipinnate,introrsely,leaf,leaflet,long,lower,margin,membranous,mm,oblong,obtuse,orange,pedicel,petiole,plurifoliate,pore,pseudostipule,red,shape,simple,slightly,stellate,stem,surface,truncate,unbranched,unequal,unit,vine,wall,white,x	.5,.8,0-,0-0.2,0.2-0.4,0.4-2,0.4â0.9,0.5-2,0.8â1.6,0â3,1-2,1.5,1.5-5,1.8â3.5,13â18,19,1â2.5,2,2.8â4.1,3-foliolate,3â,3â4-celled,4,4â12,5,5-7,7,9,abaxially,absent,acute,adaxiall,adaxially,adventitious,ag,along,always,alyx,apart,articulated,axe,axi,ba,basal,blade,borne,branch,broadly,brown,chartaceous,clavat,cluster,cordat,covered,cylindrical,densely,diameter,eaf,eed,elliptic,entire,especially,fasciculate,flattened,flower,free,geminat,generally,glabrescent,glabrou,glabrous,grading,half,herbaceous,ilament,lanceolate,larger,largest,lateral,leafy,least,less,light,like,lobe,longitudinal,m.,meter,midrib,minutely,mostly,much,narrowly,nearly,nflorescence,node,often,older,opening,opposite,orolla,ovate,ower,peduncle,per,petiolule,pilose,portion,prominent,prominently,puberulent,pubescent,rachi,raised,rarely,reticulate,revolute,ripe,root,ruit,scarcely,secondary,several,shoot,short,size,slit,small,soft-woody,somewhat,spaced,sparsely,stigma,straight,style,subopposite,sulcate,terminal,tertiary,tightly,tip,tree,trunk,tube,unarme,uniform,usually,vary,vein,visible,weak,yellow,ympodial,young,â9	articulation,bract,branching,breeding,broad-based,colour,connective,cordate,corolla,form,growth,heteromorphism,inflated,inflorescence,insertion,interjected,interpetalar,length,marking,mature,na,odour,orientation,paired,pattern,placement,position,prickle,rhizome,scale,spot,staman,stone,structure,symmetry,sympodial,system,texture,tissue,tuber,type,xylopodia,ye
118	wfo-0001027186	invalid_json_followup	168	160	109	59	51	0.649	-6,.4,.5,0.5-1,1-1.5,1-2.5,1.4-1.6,1.5-2,1.5-2.5,2-6,3-4,3.5-4,4-9,9-10,abaxial,acute,age,anther,anthesi,apart,apex,attenuate,bark,base,berry,branched,broadly,brown,calyx,cm,conical,corolla,dark,deflexed,deltate,dendritic,densely,diameter,ellipsoid,elliptic,enlarging,entire,exerted,filament,filiform,fruit,fruiting,glabrescent,glabrous,globose,golden,green,growth,irregularly,lengthening,less,like,lobe,lobed,loose,lower,margin,maturity,midrib,minutely,mm,narrowly,new,pair,pale,papillate,pedicel,peduncle,perfect,petiole,plane,pointed,pore,poridical,primary,pubescent,rachi,reddish,rough,scar,shiny,simple,slightly,slit,soon,spaced,sparsely,spreading,stem,strongly,surface,terminal,time,tip,tree,treelet,trichome,tube,uniseriate,variably,vein,way,white,x	1.5,1.6-5,15,2-lobed,2.5-3,30-40,4-15,5-10,6-7,?,abaxially,adaxially,always,apparently,axil,branch,clavate,dbh,denditic,denser,dry,eaf,flower,free,immature,incrassat,keeled,lamina,longer,m.,much,nflorescence,occasionally,ovary,ovoid,papillat,pendent,pericarp,pitted,planar,plurifoliat,portion,pubescen,reniform,ruit,scattered,seed,short,small,stalk,stigma,straight,style,tub,ud,unit,woody,yellow,ympodial	'',[,``,adaxial,appressed,articulation,bract,branching,breeding,broad-based,bud,characteristic,colour,connective,exertion,form,hair,inflated,inflorescence,insertion,interjected,interpetalar,keeling,leaf,leaflet,length,marking,mature,na,needle-like,odour,orientation,paired,placement,position,prickle,pseudostipule,scale,shape,smell,spot,symmetry,system,texture,tissue,type,value,vegetative,zygomorphy,{,}
119	wfo-0001027198	invalid_json_followup	191	160	110	81	50	0.576	.4,.5,0.5-0.75,0.8-1,1-1.5,1-10,1.5-10,1.5-2,10-11,11-20,2-5.5,3/4,4-9,5-6,7.5-9,acuminate,acute,anther,anthesi,apart,apex,attenuate,base,berry,calyx,channeled,clavate,cm,corky,corolla,cyathiform,decurrent,dendritic,densely,dia,difoliate,elliptic,erect,female,filament,flower,fruiting,furcate,glabrate,glabrous,globose,golden,green,inflorescence,lateral,leaf,lobe,lobed,major,male,many,margin,middle,minor,minute,minutely,mm,obovate,often,older,opposite,ovary,ovoid-reniform,paler,papillose,pedicel,petiole,pitted,planar,plant,pore,puberulent,pubescent,rather,reflexed,scar,set,shaped,shining,shrub,simple,size,slightly,speciman,stem,stigma,straight,style,surface,tear-drop,time,tip,trichome,tube,two,type,uniseriate,unit,vein,way,white,widest,woody,x,young	0.05-1.0,0.5-1,0.7-1,1-5,5-120-flowered,abruptly,always,axil,ba,beginning,beneath,broadening,bushy,caly,closely,complex,constriction,corresponding,deltoid,differing,dry,eaf,edge,edicel,eed,entire,evenly,exserted,extremely,eye,found,free,geminat,impressed,inflorescenc,invisible,large,like,live,lon,long,lower,main,medium,meet,naked,nearly,nflorescence,overlapping,ovoid,pale,papillo,pendan,poricidal,portion,pubescence,reddi,rest,rounded,ruit,sessile,short,slender,small,soon,spaced,specimen,strong,styled,tall,tannish-yellow,testae,thickened,thin,top,tree,ud,undersurface,usually,yellowish,ympodial	'',5-120,[,``,abaxial,adaxial,appressed,bract,branching,breeding,characteristic,colour,connective,diameter,form,fruit,geminate,growth,hair,height,inflated,interjected,interpetalar,leaflet,length,marking,mature,modification,na,number,pattern,pendant,position,reddish,scale,seed,shape,spacing,spot,structure,symmetry,sympodial,system,texture,tissue,value,width,zygomorphy,{,}
120	wfo-0001027200	success	139	138	89	50	49	0.64	0.05-0.25,0.25-0.5,0.5-0.75,0.6-1,0.7-2.5,1-1.5,1.2-1.5,1.5-2,1.5-5,1.6-6,2-3,2.5-3,3-3.5,3.5-6,6-8,8-15,acute,anther,anthesi,apex,bark,base,beneath,berry,capitate,cm,corolla,decurrent,deeply,deflexed,dia,elliptic,filament,fruiting,geminate,glabrous,globose,golden,green,grey-brown,horizontally,inflorescence,leaf,lobed,long,lower,major,minor,minute,mm,nearly,node,non-reproductive,occasionally,onto,ovary,ovoid-reniform,pedicel,petiole,pitted,planar,pore,puberulent,reflexed,shaped,shrub,size,slightly,small,sparse,sparsely,spreading,stem,stigma,style,surface,tear-drop,tree,trichome,unicellular,unifoliate,uniseriate,unit,vein,white,widened,woody,x,young	0.5-1,1-1.4,9-11,across,aspec,ba,branch,branche,broadly,brown,calyx,conical,converging,dark,deltoid,densely,differing,eaf,eed,except,flattened,free,giving,impressed,lateral,lightly,like,lobe,lon,main,margin,middle,minutely,near,older,papillo,papillose,poricidal,portion,prominent,rest,ruit,straight,tall,tip,tube,widest,winged,yellowish,ympodial	arrangement,bract,branching,breeding,broad-based,cell,colour,connective,diameter,form,fruit,growth,hair,height,heteromorphism,interjected,interpetalar,leaflet,length,marking,modification,na,needle-like,odour,orientation,pattern,placement,plant,position,prickle,pseudostipule,rhizome,seed,shape,smell,spot,staman,stone,structure,symmetry,sympodial,system,texture,tissue,tuber,type,vegetative,xylopodia,zygomorphy
121	wfo-0001027213	success	231	100	55	176	45	0.238	-3.3,0-2.5,0.8-1.8,1-2,2.9-3.8,accrescent,anther,apex,articulated,attenuate,base,blunt-tipped,branched,calyx,cell,cm,corolla,cuneate,entire,filament,fruit,fruiting,glabrescent,globose,green,hair,lanceolate,leaf,length,lower,many,margin,mm,ovate,ovate-lanceolate,pedicel,petiole,plurifoliate,pore,poricidal,scabrous,shrub,simple,stem,surface,time,tip,tree,unarmed,unit,unwinged,violet,white,x,yellow-green	-19,-230,-4.5,/10,0-160,0.2-0.4,0.2-0.5,0.7-2.3,1-5,1.1-1.7,1.2-1.6,1.2-1.7,1.2-2.5,1.3-2.2,1.7-3.6,1.7-3.9,1.8-2.8,1.8-3.2,1/2-2/3,10-24,12.3-16.3,2-5,2.4-4.7,2.5-5.1,2.9-4.8,2/3,3.5-5,3.5-8,4-9.5,4.2-5.9,5-7.5,5-8,5-merou,5.7-6.2,8-24,8.2-10.5,9-13,abaxially,acuminate,acute,adaxially,ag,along,alyx,anthesi,apart,apparently,ark,around,axe,axillary,ba,basal,blade,branch,broadly,brown,capitat,completely,conical,covering,cylindrical,dark,decurrent,deltoid,diameter,directed,distally,drying,eaf,early,edge,eed,elliptic,enveloping,epidermal,eventually,exserted,farinose,few-rayed,flower,free,glabrescen,glabrous,granular,grayish-brown,group,high,homostylous,immature,inserted,lackin,lateral,lengthening,lobe,lobed,long,long-,long-stalked,longitudinal,m.,main,midrib,mixed,moderately,mostly,multangulat,multangulate,nearly,nflorescence,oblanceolate,obovate,obscured,obtuse,often,older,orbicular,orolla,pale,partly,peduncle,perfect,porrect-stellat,porrect-stellate,prominent,pseudo-terminal,pubescence,pubescent,rachi,rather,relatively,reniform,reticulate-punctate,ruit,sessile,short,short-,short-attenuate,short-stalked,side,slit,sometimes,somewhat,spaced,sparsely,stamen,stellate,stigma,style,subcampanulate,suture,tamen,terete,thick,thick-stalked,thin-stalked,ti,tomentose,tomentose-pubescent,tomentu,touching,tube,ud,unarme,vary,vein,vestigial-rayed,way,whitish,whitish-green,wide,yellow,yellow-tan,yellowish,ympodial,young	appressed,articulation,bract,branching,broad-based,colour,form,growth,heteromorphism,inflated,inflorescence,insertion,interjected,interpetalar,leaflet,marking,mature,na,needle-like,odour,orientation,paired,placement,position,prickle,pseudostipule,pseudoterminal,rhizome,scale,shape,smell,spot,staman,stone,structure,symmetry,sympodial,texture,tissue,trichome,tuber,type,vegetative,xylopodia,zygomorphy
122	wfo-0001027214	success	181	141	85	96	56	0.47	0.25,0.5-1,0.7-2.5,0.8-1,1-1.5,1-2.8,1.5,1.5-1.8,10-13,2,2-9,3-6,6-12,anther,anticlinal,apex,apical,base,broadly,calyx,cell,cm,conical,corolla,deltate,densely,diameter,elliptic,epidermal,filament,flattened-round,flower,fruit,fruiting,glabrous,green,greenish,grown,height,herb,inflorescence,irregular,leaflet,length,lobe,long-acuminate,long-conical,lower,margin,minutely,mm,oblique,occasionally,once-branched,ovary,pedicel,per,petiole,pinnate,pointed,poricidal,projection,pubescent,rachi,rugose,rugosity,seed,sharply,simple,sinuous,somewhat,stigma,style,surface,thickening,tip,triangular,trichome,truncate,tube,uniseriate,unit,white,without,x	-20,-38,-9,..,.25,.5,0,0-16,0.3-1.5,0.3-1.7,0.5-0.8,0.7-2,1.2-3,1.5-6,10-,12-17,15-25,3-,4-5,5-6,6-,7-12,8-9,abaxially,absent,acuminate,acute,adaxially,along,anthesi,basal,berry,capitat,climbing,composed,conspicuously,decurrent,dr.,drying,eaf,edicel,eed,erect,exserted,extending,finely,free,globose,groove,horizontal,inflorescenc,lamina,lanceolate,lateral,less,like,lobed,lon,long,markedly,midrib,narrowly,nearly,nflorescence,noddin,nodding,obovate,often,onto,open,opposite,pair,paired,papilla,papillate,perfectly,petiolule,portion,reflexed,rest,ruit,scar,scattered,scrambling,smaller,tem,terminal,time,tub,ud,unevenly,unifoliat,vein,white-lenticellate,whitish,ympodial	0.5,2.0,3-5,40,5,arrangement,articulation,bract,branching,breeding,broad-based,capitate,colour,connective,form,growth,hair,heteromorphism,insertion,interjected,interpetalar,leaf,marking,modification,na,needle-like,number,odour,orientation,pattern,placement,plant,pore,position,prickle,pseudostipule,rhizome,scale,shape,size,smell,spot,staman,stem,stone,structure,symmetry,sympodial,system,texture,tissue,tuber,type,unifoliate,vegetative,xylopodia
123	wfo-0001027219	invalid_json_followup	143	154	104	39	50	0.727	.5,/4,0.4-0.6,0.5,0.5-0.8,1-15,1.5-2.5,2,2-2.5,2-3,2-3.5,2-4,3-5,3-6,6-8,acuminate,acute,age,anther,anthesi,apex,axillary,bark,base,berry,bright,broadly,brown,calyx,capitate,closely,cm,conical,corolla,deltate,densely,diameter,edge,elliptic,entire,filament,flower,fruiting,glabrescent,glabrous,globose,green,greyish,growth,hard,heterostylous,known,leaf-opposed,lengthening,less,lobe,lobed,long-conical,long-styled,margin,maturity,minutely,mm,new,ovary,pale,papillose-pubescent,pedicel,pendent,pericarp,petiole,planar,pointed,pore,poricidal,pubescent,purple,scar,sharply,shoot,short,short-styled,shrub,simple,slightly,slit,somewhat,spaced,stem,stigma,style,surface,terminal,thickened,tip,trichome,uniseriate,violet,way,weight,white,woody,x,â1/3	0.3,1,1-2,1-3,1.5-2,7-8,absent,berr,c.,completely,cup-shaped,drying,eaf,eed,erect,exerte,exfoliatin,free,glabrou,lower,nflorescence,overlappin,pair,papillo,peduncle,plurifoliat,portion,primary,ruit,sometimes,soon,stout,tube,tuft,ud,unit,vein,yellowish,ympodial	'',[,``,appressed,arrangement,bract,branching,breeding,bud,characteristic,colour,connective,exfoliating,form,fruit,hair,inflated,inflorescence,information,interjected,interpetalar,leaf,leaflet,length,marking,mature,modification,na,odour,overlapping,paired,papillose,pattern,position,scale,seed,shape,size,smell,spot,symmetry,system,texture,tissue,type,value,vegetative,zygomorphy,{,}
124	wfo-0001027223	success	189	106	85	104	21	0.45	1-2,1.5-3.5,1.8-3.5,2-4,3-5,3-5.2,3.5-7,4-6,5-21,5-8,5.9-12.2,9-22,abaxially,acumen,adaxially,anther,axillary,berry,blade,brownish,bud,cell,cm,condition,conical,corolla,deep,densely,diameter,digestion,dorsally,drying,edge,elliptic,enzyme,filament,flat,folded,forked,fresh,fruit,green,green-white,greenish,hair,herb,honeycomb-shaped,hyaline,interjected,lanceolate,lateral,leaf,leaflet,light,like,long,mm,mucilaginous,odd-pinnate,ovate,ovoid,pair,pentagonal,petiole,pore,poricidal,present,pubescent,removed,rotate,seed,short,size,subtending,terminal,testal,throughout,tip,tube,usually,wall,wet,white,whitish,x	.5,0.19-0.75,0.3-1.2,1-3,1.3-2,16-41,2-7,3-10,3-11,3.5-4,3.5-6,3.7-9.3,5-10,5-merou,9-15,9-35,acuminate,adaxiall,ag,alyx,apart,apex,apparently,articulated,asymmetric,attenuate,axe,base,basiscopic,capitat,clavate,connivent,covering,decreasing,distal,dot,eaf,eed,end,erec,exceeding,flower,geminat,generally,glabrou,glabrous,hair-like,hal,half,homostylous,larger,lengthening,living,lobe,lower,make,middle,nflorescence,one,orbicular,orolla,pedicel,peduncle,perfect,petiolulate,placed,plant,plurifoliate,purple,ripe,rounded,ruit,sessile,seudostipule,shortly,side,slightly,slit,sometimes,spaced,specimen,stamen,ste,stigma,stolo,straight,stripe,style,subequal,tall,tamen,tem,thick,tissue,toward,tri-,tuber,typically,unit,unwinged,vary,wide,yellow,ympodial	abaxial,adaxial,arrangement,branching,calyx,colour,connective,form,fruiting,growth,inflorescence,length,position,property,pseudostipule,pubescence,shape,stem,symmetry,type,zygomorphy
125	wfo-0001027237	success	122	110	59	63	51	0.484	.5,/4,1.5-2,1.5-2.5,30-100-flowered,6-11,6-8,8,anther,anthesi,bark,base,berry,black,branched,calyx,cm,completely,corolla,cup-shaped,deflexed,difoliate,drying,ellipsoid,filament,fruiting,geminate,glabrous,globose,green,greenish-white,inflorescence,internodal,later,leaf,lobed,lower,many,margin,mm,occasionally,pedicel,pore,shaped,shining,shrub,small,stem,surface,tapering,tear-drop,time,tree,tube,unit,way,white,x,young	0.5-1,1-1.2,2-3,3-3.5,3-4,5,apart,apiculae,apiculate,appearing,ba,blac,branc,broadly,brown,clavate,cucullate,dark,deltoid,dia,edicel,eed,erect,exsertion,flattened,free,greyi,lobe,long,minutely,nflorescence,older,ovary,paler,papillate,papillo,papillose,part,pitted,plurifoliat,poricidal,portion,reflexed,regularly,regulary,reniform,ruit,scar,slender,spaced,stigma,straight,style,tall,terminal,tip,ud,upper,usually,widely,woody,x.,ympodial	0.5,apex,articulation,bract,branching,breeding,broad-based,bud,cell,colour,diameter,flower,form,fruit,greyish,growth,hair,height,heteromorphism,insertion,length,na,needle-like,number,odour,orientation,pattern,petiole,placement,plant,plurifoliate,position,prickle,pseudostipule,rhizome,scale,shape,smell,staman,stone,structure,symmetry,sympodial,system,texture,trichome,tuber,type,vegetative,xylopodia,zygomorphy
126	wfo-0001027238	success	204	154	100	104	54	0.49	-25,0-1,0-1.5,0.3-0.5,0.3-0.8,0.3-5,0.5-1,0.5-16,1-1.5,1.5-3,2-4,3-4,4-,5-7,6-15,anther,apex,articulated,base,berry,black,brown,chartaceous,cm,connivent,cuneate,dark,densely,diameter,directed,discolorous,distally,elliptic,elliptic-ovate,entire,extra-axillary,filament,flattened,fleshy,flower,fruit,geminate,globose,green,greenish,hair,homostylous,interpetalar,introrsely,large,lavender,leaf,light,long,longitudinal,lower,margin,membranaceous,mm,multangulate,oblique,oblong,obtuse,opening,outline,pale,pedicel,petiole,plurifoliate,pore,porrect-stellate,pubescent,purple,reniform,ripe,rounded,scandent,shiny,shrub,simple,slit,small,sometimes,somewhat,sparsely,sprawling,stellate,stellate-pubescent,stem,strongly,surface,tissue,tree,unbranched,unit,white,whitish,x,yellow,yellowish	-5,.3,.5,0-0.7,0.3-1,0.5-2,1-2,1.5-4,1.5-7,10,15-30,2-3,3-5,3-6,4-10,4-16,4-5,4-8,5-15,5-merou,6-8,abaxially,accrescent,acuminate,acute,adaxiall,adaxially,ag,alyx,apparently,axe,ba,blade,branch,calyx,capitat,contiguous,covering,cylindrical,deltate,differentiated,eaf,eed,equal,foliaceous,fork,free,frui,fruiting,glabrescent,glabrous,gland,gland-tipped,growt,juic,lighter,like,lobe,major,midpoint,minor,minutely,mixed,narrowly,near,nearly,new,nflorescence,often,one,orolla,paired,part,peduncle,perfect,pericarp,pitted,rachi,ray,ruit,sessile,short-stalked,side,similar,sparse,ste,stigma,straight,style,subtending,tamen,tem,time,tip,toward,triangular,tube,unarme,unequal,vary,vein,wide,without,ympodial	abaxial,adaxial,age,articulation,bract,branching,breeding,broad-based,cell,colour,connective,corolla,form,growth,heteromorphism,inflorescence,insertion,interjected,leaflet,length,marking,mature,modification,na,needle-like,number,odour,orientation,pattern,placement,position,prickle,pseudostipule,rhizome,scale,seed,shape,size,smell,spot,staman,stone,structure,symmetry,sympodial,system,texture,trichome,tuber,type,unarmed,vegetative,xylopodia,zygomorphy
127	wfo-0001027244	success	294	115	70	224	45	0.238	-2,0.2-1,0.25-0.4,0.45-0.6,0.5,2-4-celled,2-foliate,anther,apex,apical,appendage,articulation,base,berry,bifurcate,bract,branched,calyx,cell,cm,cordate,corolla,dark,decurrent,deltate,densely,distal,filament,fruit,fruiting,globose,green,greenish,half,herb,imparipinnate,inflorescence,interjected,interrupted,lanceolate,leaflet,length,long,lower,margin,middle,mm,narrowly,oblique,patent,pedicel,petiole,present,pseudostipule,pubescent,purple,rotate-stellate,simple,stem,sterile,stout,stripe,surface,trichome,truncate,uniseriate,unit,vivid,white,yellow	-1.2,-12,-3.2,.5,0-,0.02-,0.04-,0.05,0.05-1,0.07-0.15,0.1-,0.1-0.3,0.1-0.5,0.1-0.6,0.15-0.2,0.2,0.2-,0.3,0.3-0.4,0.3-0.5,0.3-0.6,0.3-0.8,0.4-,0.4-0.6,0.4-1,0.5-0.8,0.5-1,0.6-0.9,0.6-09,0.7-1,0.7-1.5,0.7-2,0.7-3,0.8-1.2,0.9-1.3,0.9-1.7,1,1-2-celled,1-2.5,1-3.5,1-celled,1.1-1.3,1.2-1.6,1.5-2,1.5-2.1,1.5-2.4,1.5-6.5,1.7-3.0,1/2,2-,2-4,2-9,2-locular,2.1-8,3-5,3.5-13,3/4,4-12,4-celled,5-,5-10,5-9-celled,7-12,8-16,8-celled,abaxially,absent,abundance,abundant,acroscopically,acuminate,acute,adaxially,adpressed,alfway,along,also,always,amongst,angled,anthesi,apparently,appearance,arequipa,around,articulated,articulatio,axi,basal,berr,bracteate,broadly,brown,c.,cage,capitate,column,common,conical,crenate,curved,deciduous,decumbent,deeper,dense,density,dentate,developed,diamete,diameter,eaf,edicel,eed,eglandular,either,elliptic,elliptical,erect,exserted,extremely,flower,flushed,forming,general,giving,glabrescent,glabrous,gland,glandular,gree,hair-like,halfway,head,hyaline,internode,investing,irregularly,lamina,larger,largest,lateral,leave,like,lobe,lobed,lobing,lon,longer,midvein,minute,mixed,mixture,multicellular,near,node,obovate,occasionally,often,onto,orbicular,outgrowth,ovary,pair,papillate-pubescent,peduncle,perennial,petiolule,population,primary,rachi,reflexed,rest,ripe,rounded,ruit,scattered,secondary,sessile,shaggy,short,shorter,silky,sinus,size,slender,small,sometimes,somewhat,sparse,sparsely,sparser,spreading,staminal,stigma,straight,strongly,style,tall,tem,terminal,tertiary,testa,thick,tiny,tip,tipped,toward,tube,two,ud,undulate,unicellular,united,upper,usually,variable,variety,vein,velvety,wall,wide,winged,woody,ympodial	appressed,branching,breeding,broad-based,colour,connective,form,growth,hair,heteromorphism,inflated,insertion,interpetalar,leaf,marking,mature,modification,na,needle-like,odour,orientation,paired,pattern,placement,pore,position,prickle,rhizome,scale,shape,smell,spot,staman,stone,structure,symmetry,sympodial,system,texture,tissue,tuber,type,vegetative,xylopodia,zygomorphy
128	wfo-0001027248	success	158	96	46	112	50	0.291	.5,0.7-1.2,3-4,acute,anther,apex,arachnoid-pubescent,base,berry,calyx,cm,corolla,dirty,elliptic,filament,fleshy,fruit,fruiting,globose,green,leaf,lobed,long,lower,margin,mm,nearly,opposite,papillose,pedicel,petiole,pore,poricidal,shaped,shrub,simple,small,stem,surface,tear-drop,tip,tree,trichome,unifoliate,unit,white	0,0.5-1,0.5-2.5,1-1.5,1-2,1-3,1-5,2-2.5,2-4.5,3-7,3-7-flowered,3.5-4,4-8,5-5.5,6-13,6.5-8,7-9,abaxial,abaxially,adaxially,along,anthesi,ape,appearing,arachnoid,arachnoid-pubescen,area,bark,beige,beneath,broadened,broadly,brown,brownish,brownish-gra,closely,conical,dark,deflexed,deltate,densely,denser,dia,differing,difoliate,eaf,edicel,eed,ellipsoid,erect,exserted,felty,free,geminate,glabrescent,glabrous,grayish-green,impressed,lamina,later,lateral,lightly,lobe,main,major,merely,minor,minutely,nflorescence,node,occasionally,older,ovary,overlappin,ovoid-reniform,pair,pale,papillo,patch,per,pitted,planar,portion,present,pubescence,pubescent,ruit,scar,scattered,shoot,size,somewhat,soon,spaced,sparsely,specimen,stigma,strongly,style,tall,thick,top,tub,tube,ud,vein,wid,wide,winged,woody,ympodial,young	appressed,articulation,bract,branching,breeding,broad-based,cell,colour,connective,form,growth,hair,heteromorphism,inflated,inflorescence,insertion,interjected,interpetalar,leaflet,length,marking,modification,na,needle-like,odour,orientation,paired,pattern,placement,position,prickle,pseudostipule,rhizome,scale,shape,smell,spot,staman,stone,structure,symmetry,sympodial,system,texture,tissue,tuber,type,vegetative,xylopodia,zygomorphy
129	wfo-0001027258	invalid_json_followup	178	170	119	59	51	0.669	.25,.5,/4,0.25-0.5,0.5-1,0.6-2,0.9-1.3,1-1.5,1-4,2.5-8,3-4,3-6,4-5,4.5-5,5-10-flowered,7-13,7-9,acuminate,acute,age,anther,anthesi,apex,apical,apiculae,attenuate,axil,bark,base,berry,broadly,calyx,cm,corolla,crystal,deflexed,deltate,dense,densely,deposit,difoliate,dissecting,ellipsoid,elliptic,evenly,exserted,filament,fruit,fruiting,glabrous,globose,green,greenish-yellow,internodal,lamina,large,lateral,leaf,length,lengthening,lenticel,lobed,long,main,major,margin,microscope,middle,minor,minute,mm,occasionally,onto,opposite,ovate,pair,pale,pedicel,petiole,pore,poricidal,projection,prominent,pubescent,red-papillose,reddish,sand,scar,scattered,shrub,simple,size,slender,slightly,slit,small,spaced,sparsely,speck,stem,strongly,swollen,tiny,tip,treelet,trichome,tube,tuft,uniseriate,unit,urceolate,vein,visible,way,white,widest,winged,x,young	1-2.3,1.2-2,1.5-1.6,2-2.5,3.5-4,6-8,abaxially,abruptly,adaxially,along,apar,ba,beneath,capitate,darker,decurrent,dia,differing,drying,eaf,edicel,eed,enlarge,entire,extending,fide,flattened-reniform,fragrant,free,geminat,glabrou,incrassate,lobe,lower,minutely,nee,nflorescence,often,older,ovary,papillo,papillose,pitted,planar,portion,ruit,stigma,straight,style,surface,sweetly,tall,tub,ud,widening,woody,yellowish,yellowish-tan,ympodial	'',[,``,abaxial,adaxial,apart,bract,branching,breeding,bud,characteristic,colour,connective,diameter,enlarged,exsertion,form,geminate,growth,hair,height,inflorescence,interjected,interpetalar,leaflet,marking,modification,na,odour,paired,part,pattern,placement,plant,position,scale,shape,smell,spot,structure,symmetry,sympodial,system,texture,tissue,type,value,vegetative,zygomorphy,{,}
130	wfo-0001027260	invalid_json_followup	176	187	123	53	64	0.699	-17,-2,-60,-7,0.25-1,0.5-1,0.5-3,0.5-6.5,0.75-1,1-2,1-4,1.5-13,1.5-2,10-25,15-30,2-18,2-2.5,2.5-3.5,3-11,3-4.5,3-6,5-25,5-merous,abaxially,absent,acuminate,acute,acute-,adaxially,age,also,apart,apex,articulated,basal,base,berry,branched,chartaceous,clavate,cm,connective,connivent,cordate,cylindrical,darker,densely,diameter,directed,distally,eglandular,ellipsoidal,elliptic,elliptic-ovate,entire,equal,exceeding,fading,flattened,flower,fruit,glabrate,glabrous,globose,greenish,hair,lanceolate,lavender,leaving,lobe,long,longitudinal,margin,membranaceous,mm,moderately,narrowly,nearly,obtuse,often,ovate,pedicel,pedicellar,peduncle,perfect,petiole,pilose,pink,pore,puberulent,puberulent-pubescent,pubescent,pubescent-pilose,purple,rachi,radiu,remnant,shorter,shrub,simple,slightly,small,spaced,sparsely,stellate,stigma,stripe,strongly,style,subcoriaceous,tapered,thecae,tree,triangular,truncate,unbranched,usually,vein,white,x,yellow,yellow-green,yellowish	0.8-2,1-,1-3,1-6,1-7,2-,2-10,2.5-14,3-,3-10,3.5-25,4-25,4-32,4-5-foliat,4-6,4.5-14,5-,5-40,6-20,aggregate,alyx,ape,axe,beyond,blade,cell,diamete,eaf,eed,exserted,lon,lower,nflorescence,nther,orolla,perfec,pilo,presen,puberulent-pubescen,ruit,stamen,stone,tal,tem,time,tomento,tube,ud,unit,vary,wide,yellow-orang,ympodial	'',1-10,1-4.5-14,15-40,2-20,[,``,anther,appressed,arrangement,articulation,bract,branching,breeding,bud,calyx,characteristic,colour,corolla,filament,form,fruiting,growth,height,inflated,inflorescence,insertion,interjected,interpetalar,leaf,leaflet,length,marking,mature,modification,na,number,odour,ovary,paired,pattern,plant,position,present,scale,seed,shape,size,smell,spot,stem,symmetry,system,texture,theca,tissue,trichome,type,value,vegetative,yellow-orange,zygomorphy,{,}
131	wfo-0001027265	invalid_json_followup	159	139	80	79	59	0.503	.2,.3,0.5,0.5-1,1-3,1.2-1.3,1.2-2,2-3,3-lobed,4-5,accrescent,acute,anther,apart,apex,articulated,base,berry,broad,calyx,chartaceous,cm,diameter,entire,extra-axillary,filament,flattened-reniform,flower,fruit,fruiting,glabrous,globose,granule,hair,herb,hermaphroditic,leaf-opposed,light,lobe,long-attenuate,margin,minutely,mm,near,nearly,oblong,orange,ovate-lanceolate,paired,partially,pedicel,peduncle,petiole,pitted,pore,present,prominent,puberulent,pubescent,purple,rachi,rarely,red,rotate-stellate,scarcely,sclerotic,seed,simple,slightly,sometimes,sparsely,subcoriaceous,surface,tip,triangular,tube,white,winged,x,yellow	-2.5,.5,0.1â2,0.2-0.4,0.5â0.6,1-1.3,1-2.5,1.2â1.4,1.5-2.5,1.5â1.8,1.5â2,1.5â4,2,2-,2-4,2/3,20-30,2â2.5,2â3,3-,30â50,4.5â8,4â6,4â7-branched,5-merou,58409,abaxially,adaxiall,adaxially,alyx,apparently,axe,ba,blade,capitat,ciliate,connivent,covering,croat,cylindrical,dehiscent,eaf,eed,erect,foliate,frui,geminat,juic,larger,lon,long,longitudinall,low,lower,mesocarp,nflorescence,node,numerous,obtuse,orolla,recurved,ripe,rooting,ruit,somewhat,spaced,stigma,style,tall,tamen,tem,time,unit,usually,vary,weak,white-puberulent,wide,ympodial	'',0.1-2,1.2-1.4,1.5-1.8,1.5-2,2-2.5,30-50,4-6,4-7-branched,[,``,appressed,arrangement,articulation,bract,branching,breeding,characteristic,colour,connective,corolla,form,growth,height,inflated,inflorescence,insertion,interjected,interpetalar,leaf,leaflet,length,longitudinally,marking,mature,modification,na,odour,orientation,pattern,plant,position,prickle,scale,shape,size,spacing,spot,staman,stem,symmetry,system,texture,tissue,type,value,winging,{,}
132	wfo-0001027265	invalid_json_followup	156	144	83	73	61	0.532	.2,0.2-0.4,0.5,0.5-1,1-1.3,1-3,1.2-1.3,1.2-2,2,2-3,2/3,4-5,accrescent,acute,anther,apart,apex,articulated,base,broad,calyx,chartaceous,cm,cylindrical,diameter,entire,extra-axillary,filament,flattened-reniform,flower,fruit,fruiting,glabrous,globose,granule,hair,herb,hermaphroditic,larger,leaf-opposed,light,lobe,long-attenuate,lower,margin,minutely,mm,near,oblong,orange,ovate-lanceolate,paired,partially,pedicel,peduncle,petiole,pitted,pore,prominent,puberulent,pubescent,purple,rachi,red,ripe,rotate-stellate,scarcely,sclerotic,seed,simple,sometimes,sparsely,stigma,style,subcoriaceous,surface,tip,triangular,tube,white,winged,x,yellow	-2.5,.3,.5,0.1â2,0.5â0.6,1-2.5,1.2â1.4,1.5-2.5,1.5â1.8,1.5â2,1.5â4,2-,2-4,20-30,2â2.5,2â3,3-,3-lobed,30â50,4.5â8,4â6,4â7-branched,5-merou,58409,abaxially,adaxiall,adaxially,alyx,apparently,axe,ba,blade,capitat,ciliate,connivent,covering,croat,dehiscent,eaf,eed,erect,foliate,frui,geminat,juic,lon,long,longitudinall,low,mesocarp,nearly,nflorescence,node,numerous,obtuse,orolla,rarely,recurved,rooting,ruit,slightly,somewhat,spaced,tall,tamen,tem,time,unit,vary,weak,white-puberulent,wide,ympodial	'',0.1-2,1.2-1.4,1.5-1.8,1.5-2,2-2.5,30-50,4-6,4-7-branched,[,``,abaxial,adaxial,arrangement,articulation,bract,branching,breeding,capitate,characteristic,colour,connective,corolla,form,growth,height,inflorescence,interjected,interpetalar,leaf,leaflet,length,longitudinally,marking,mature,modification,na,odour,ovary,pattern,plant,position,scale,shape,size,smell,spacing,spot,staman,symmetry,system,texture,tissue,trichome,type,value,vegetative,winging,zygomorphy,{,}
133	wfo-0001027284	success	172	133	87	85	46	0.506	0.1â0.5,0.1â2,0.7â0.9,0.7â1,1.2â1.5,1.5â5.5,1.5â8,1.8â2,1â1.5,1â3,2â16,2â2.2,3.5â14,3â4,4â12,5â7,9â18,abaxially,adaxially,anther,apex,axillary,base,berry,branched,brownish,climbing,cm,cordate,densely,elliptic,entire,extra-axillary,filament,fine,flattened-reniform,fleshy,flower,fruit,glabrous,globose,green,inflorescence,margin,maturity,midvein,minutely,mm,near,nearly,oblique,orangish,ovate,ovoid,pair,pale,pedicel,peduncle,petiole,pinnate,plurifoliate,pubescence,pubescent,rachi,rarely,reticulate-rugulose,rounded,scandent,secondary,shrub,simple,size,sometimes,somewhat,sparsely,stellate,stem-terminal,surface,tan,truncate,unbranched,unit,vein,venation,vine,white,x	.3,0.2â,1.5â2,1.5â2.5,1â2,2.5â3,2.5â3.5,4,4â6,5-merous,5â8,accrescent,acuminate,acute,alyx,anthesi,axe,blade,branch,c.,calyx,capitat,ciliat,conspicuous,contiguousl,cylindrical,deflected,deltoid,diameter,distally,eaf,eed,enlarged,flattened,fruiting,glabrescen,glabrou,gradually,herbaceous,immature,leafy,lobe,long,lower,m.,nflorescence,nternode,one,orolla,pendulou,perfec,pink,planar,pointed,prominent,reduced,ruit,sand-punctat,sand-punctate,scar,seen,shortly,side,slightly,soon,spaced,spreading,stigma,style,tamen,tem,thickened,thickly,time,tip,toward,tree,tube,understory,unifoliat,vary,weakly,wide,woody,ympodial	0.2â1,abaxial,adaxial,alternate,arrangement,bract,branching,breeding,cell,ciliate,colour,corolla,form,growth,habit,heteromorphism,internode,leaf,length,marking,na,number,orientation,pattern,perfect,placement,pore,position,prickle,pseudostipule,rhizome,seed,shape,spot,staman,stone,structure,symmetry,sympodial,system,texture,tuber,type,unifoliate,xylopodia,â1.5
134	wfo-0001027302	success	188	117	66	122	51	0.351	.5,0.5-1,1-1.5,2.2,3.5-5,3/4,5-7,7/8,age,anther,anthesi,apex,appearing,base,becoming,berry,branching,bright,calyx,cm,conical,cordate,corolla,dendritic,filament,fruiting,glabrous,globose,growth,inserted,later,lateral,leaf,length,lobed,long,lower,margin,mm,monochasial,narrowly,nodding,occasionally,ovate,petiole,plurifoliate,pore,poridical,puberulent,red,shrub,sleeve,slit-like,small,somewhat,stem,surface,terminal,time,tip,tree,trichome,truncate,unit,violet,way	0.4-5,0.5,0.6-1,0.8-1,1,1-1.3,1-2,1-3,1.2-1.6,1.2-2.5,1.5-2,10,10-20,2,2-3,2-6,2.7-7.5,6-12,7,abaxial,abaxially,acuminate,acute,adaxial,adaxially,along,apical,ba,bark,basal,blade,broader,brownish-yellow,capitate,clavate,crispate,cultivation,decurrent,deflexed,deltoid,densely,denser,diameter,dichasia,discussion,eaf,edicel,eed,elliptic,entire,especially,ew,exserted,fine,flat-topped,flattened,flower,free,growing,juvenile,larger,lax,lenticular,less,like,lobe,lon,long-triangular,m.,main,minutely,nflorescence,older,otherwise,ovary,overtopping,pair,pale,papillo,pedicle,per,pericarp,pitted,planar,plant,portion,prominent,pubescent,pyramidal,reddish-brown,reflexed,ruit,scar,scattered,scrambling,secondary,see,shade,shin,shoot,simple,sparsely,stamen,stigma,strongly,style,tall,tapering,thin,tiny,tub,tube,ud,undulate,usually,vein,wide,winged,woody,x,ympodial,young	appressed,articulation,bract,breeding,broad-based,cell,colour,connective,dichasial,form,fruit,hair,heteromorphism,inflated,inflorescence,insertion,interjected,interpetalar,leaflet,marking,mature,modification,na,needle-like,odour,orientation,paired,pattern,pedicel,placement,position,prickle,pseudostipule,rhizome,scale,shape,smell,spot,staman,stone,structure,symmetry,sympodial,system,texture,tissue,tuber,type,vegetative,xylopodia,zygomorphy
135	wfo-0001027310	success	215	92	64	151	28	0.298	/3,0.6-1,0.7-2,4-10,4.5-5.5,anther,apex,articulated,base,berry,branched,branching,broadly,calyx,chartaceous,cm,connivent,cuneate,deltate,entire,erect,evenly,filament,flattened,foliaceous,fruit,fruiting,green,hair,lateral,leaf,length,lobed,long,margin,maturity,mauve,mm,moderately,pedicel,petiole,poricidal,prickle,primary,purple,rounded,secondary,shrub,simple,sometimes,sparse,spherical,stellate-pubescent,stem,straight,tapering,terminal,tip,tree,truncate,unit,way,yellow,young	-2.2,-20,.8,0,0-20,0-5,0.05,0.05-0.15,0.1,0.1-0.2,0.15-0.3,0.9-0.17,1-1.2,1-1.7,1-6,1.1-1.5,1.5-2.2,1.5-5,1/10-1/6,1/3-1/2,1/3-3/4,11-16,2-10,2-3.1,2-4,2-5,2.2-2.5,2.8-3,2/3,20-60,22-30,3-15,4-9,4.5-7,5-10,5-20,5-7,5-merous,6-8,7-10,8-10,9-13,abaxial,abaxially,acut,acute,adaxial,alyx,andromonoecious,apar,apart,apically,apparently,bark,blade,curved,dark,densely,diameter,discolorous,distal,drying,eaf,eed,elongating,equal,faint,flattened-reniform,flower,free,fused,gently,glabrescent,glabrou,glabrous,glaucous,gray,green-brown,hermaphrodite,heterostylous,inflated,infructescence,lanceolate,less,lobe,long-styled,longer,lower,lowermost,mature,midpoint,minutely,nflorescence,older,one,open,orange-brown,orolla,oung,pair,pale,peduncle,pendulous,per,pericarp,pitted,plant,plurifoliat,porrect,porrect-lepidote,portion,prickly,pubescent,ray,red,reddi,reflexed,ruit,scar,sessile,shallowly,short-styled,shorter,smooth,spaced,sparsely,spreading,stalk,stalked,staminat,stellate,stout,strongly,style,surface,tamen,terete,tertiary,time,toward,trichome,tube,unarme,unarmed,vary,vein,venation,visible,wide,woody,ympodial	articulation,broad-based,cell,colour,corolla,form,growth,heteromorphism,inflorescence,insertion,na,odour,orientation,plurifoliate,position,pseudostipule,rhizome,scale,shape,staman,stone,structure,symmetry,sympodial,texture,tuber,type,xylopodia
136	wfo-0001027317	invalid_json_followup	144	135	83	61	52	0.576	.5,0.1-0.2,0.3-1,0.4-1.5,0.5-1,1,1-1.5,1-2,1.5-2,3-3.5,4.5-5,?,acute,adaxially,along,anther,apex,apically,base,beneath,berry,bilobed,broadly,calyx,cm,conical,corolla,densely,dia,drying,ellipsoid,elliptic,erect,filament,fruit,fruiting,glabrous,globose,golden,green,known,leaf,like,lobed,long,long-exserted,lower,major,margin,mature,minor,minute,minutely,mm,nearly,offset,opposite,ovary,papillose,pedicel,petiole,pointed,pore,poricidal,pubescent,rest,shaped,shrub,simple,slightly,sparsely,stem,stigma,style,surface,tear-drop,tip,trichome,tube,uniseriate,vein,white,x	.25,0.5-3,0.8-3.5,1-5,1.4-1.6,2-3-flowered,2-9,7-9,abaxial,acuminate,anthesi,apical,arch,ba,bark,closely,cucullate,deciduous,deflexed,deltoid,differing,difoliate,eaf,edicel,eed,elongated,expanded,filiform,free,geminat,greyish-whit,immature,inflorescenc,joined,lateral,lobe,lon,main,nflorescence,older,overlappin,pair,pale,papillo,portion,projection,prominent,reflexed,ruit,scar,series,size,soon,spaced,strongly,tall,tub,ud,woody,ympodia,young	'',[,``,appressed,articulation,bract,branching,breeding,broad-based,bud,characteristic,colour,connective,diameter,exsertion,form,growth,hair,height,inflated,inflorescence,information,insertion,interjected,interpetalar,leaflet,length,marking,modification,na,needle-like,odour,orientation,pattern,placement,plant,position,prickle,scale,seed,shape,smell,spot,symmetry,system,texture,tissue,type,value,vegetative,{,}
137	wfo-0001027323	success	175	71	40	135	31	0.229	/3,0.5-1,2.5-3,anther,apex,asymmetric,attenuate,base,berry,corolla,decurrent,difoliate,elliptic,filament,fleshy,flower,fruit,furcate,glabrous,globose,leaf,lobed,long,margin,mm,occasionally,opposite,papillose,pedicel,petiole,pinkish-grey,pore,shaped,slightly,tear-drop,treelet,unit,way,white,winged	.75,1-1.5,1-2,1.2-1.5,10-15,14-21,2-3,2-6,20-45,3-5,5-20-flowered,5-7,6-11,7-9,acute,adaxial,along,anthesi,apparent,appearing,area,arising,ba,bark,broadened,bud,calyx,campanulate,character,closed,closely,cm,cork,deflexed,densely,dia,differing,dried,dry,eaf,edicel,eed,elongate,entire,erect,erose,exserted,five-pointed,flopping,free,fruiting,geminat,glabrate,grey,growing,held,higher,hood,hooded,immature,interpetalar,lateral,like,live,lobe,lon,long-triangular-deltoid,lower,main,major,matte,mature,measured,middle,minor,minutely,nflorescence,older,one,onto,ovary,overlapping,ovoid,ovoid-reniform,pair,papillae,papillo,partially,persistent,pitted,planar,plant,poricidal,portion,prominent,proximal,rather,red-papillose,reddish-grey,rest,ridge,ruit,scar,secondary,seen,sinus,size,small,smoot,soon,spaced,specimen,stem,stigma,straight,style,surface,tall,tan,thickened,thin,tiny,tip,trunk,tube,two,ud,upper,vein,visible,widest,woody,x,ympodial,young	articulation,branching,cell,colour,decurren,form,geminate,growth,hair,heteromorphism,inflorescence,insertion,length,na,odour,orientation,placement,position,prickle,pseudostipule,rhizome,shape,staman,stone,structure,symmetry,sympodial,texture,tuber,type,xylopodia
138	wfo-0001027340	success	189	156	135	54	21	0.714	0.5-0.9,1-10,1-2,1-3,1.5-2.7,10-16,16-22,2-3,2-4,2.7-4.5,3.5-5,3.5-9,4-6,4-7.5,5-11,5-6,6-8.5,7-18,7-8,8-14,8-9.5,abaxially,abruptly,absent,acumen,acuminate,adaxially,along,anther,apart,apex,auriculate,axillary,base,blade,brownish,bud,cell,chartaceous,ciliate,cm,condition,connivent,cordate,corolla,dark,decreasing,diameter,digestion,distal,dorsally,drying,edge,elliptic,enzyme,especially,filament,flat,flower,folded,forked,fresh,fruit,generally,glabrous,globose,green,greenish,hair,half,herb,homostylous,honeycomb-shaped,interjected,lanceolate,lateral,leaflet,lengthening,like,lilac-purple,lobe,long,margin,membranous,midrib,minute,minutely,mm,narrow,narrowed,odd-pinnate,ovate,ovoid,pair,papillose,pedicel,peduncle,petiole,petiolulate,plant,pointed,pore,poricidal,puberulent,pubescent,purple,removed,ripe,rotate,rounded,seed,sessile,short,shortly,size,slit,sparsely,splotched,stem,stigma,straight,style,subtending,terminal,testal,tinged,tip,truncate,tube,usually,wall,whitish,wing,x,yellow	2-3.5,2.5-4.5,3-4,5-merou,ag,alyx,apparently,articulated,articulation,axe,berry,capitat,covering,developing,distinct,eaf,eed,exceeding,geminat,glabrou,green-white,hair-like,hal,high,indistinct,living,lower,make,mucilaginous,nflorescence,orolla,perfect,plurifoliate,purpl,ruit,semi-erec,semi-rosette,seudostipule,slightly,spaced,specimen,stamen,ste,tall,tamen,tem,thick,throughout,tri-,unit,vary,wet,ympodial,young	5-merous,age,arrangement,branching,calyx,capitate,colour,form,growth,height,inflorescence,leaf,length,ovary,position,pseudostipule,shape,spacing,staman,texture,type
139	wfo-0001027354	invalid_json_followup	166	147	102	64	45	0.614	.5,0,0.5-2,0.7-1.3,1-1.2,1-1.5,1-7,1.7-5,2.5-3.5,3-4,3.4-4,3/4,4-10,5-7,6.5-13,8-12,abaxial,abaxially,acute,adaxial,along,anther,apex,appearing,bark,base,berry,bi-lobed,branch,branching,calyx,cm,corolla,dark,dendritic,densely,diameter,elliptic,entire,erect,filament,flattened,fork,fruit,fruiting,glabrous,globose,golden,growth,later,lateral,leaf,length,lenticular,less,lobed,long,loosely,minutely,mm,monochasial,narrowly,nodding,occasionally,ovary,pair,pedicel,petiole,pitted,pore,poricidal,pubescent,purplish-black,pyramidal,raised,reddish-brown,scar,secondary,shrub,sleeve,small,somewhat,sparsely,stem,stigma,style,surface,tapering,terminal,time,tiny,tip,tree,tree-like,trichome,type,vein,violet,way,white,woody,x	0.5,1,1.5-1.8,1.5-2,10,10-20,absent,age,anthesi,apical,ba,basal,becoming,belo,blade,conical,covered,deltoid,denser,dichasia,drying,eaf,edicel,eed,ew,exserted,flower,free,glabrate,inserted,like,lobe,loose,lower,m.,mostly,near,nflorescence,older,papillo,per,pericarp,planar,plurifoliate,portion,pubescen,ruit,side,simple,slightly,slit-like,stamen,strongly,tall,thecalyx,thin,tub,tube,ud,unit,wide,winged,ympodial,young	'',[,``,bract,breeding,bud,characteristic,colour,connective,dichasial,form,hair,height,inflorescence,insertion,interjected,interpetalar,leaflet,marking,mature,modification,na,new,odour,papillose,pattern,plant,position,scale,seed,shape,size,smell,spot,staman,symmetry,system,texture,tissue,value,vegetative,venation,width,{,}
140	wfo-0001027359	success	224	89	66	158	23	0.295	-3,.5,/3,0,0-5,0.3-1.2,0.5,1-1.2,4-,5-6.5,anther,apex,base,berry,branched,bright,calyx,chartaceous,cm,cream,cuneate,dark,deltate,entire,equal,filament,filiform,flattened,fruit,fruiting,green,lateral,leaf,length,less,lobed,long,margin,marking,maturity,membranous,mm,pale,pedicel,petiole,poricidal,prickle,purple,red,reflexed,shrub,spherical,spreading,stellate,stellate-pubescent,stem,style,surface,tapering,terminal,tip,way,white,yellow,yellow-brown,young	-0.25,-2,-20,-4,-7,-9,.1,.2,/4,0-2,0-3,0-9,0.1,0.1-0.2,0.1-1.5,0.3-0.5,0.5-1,0.5-2,0.6-0.8,0.6-1,1-2,1-3,1-4,1-5,1.2-1.5,1.2-2,1.5-2,1.5-2.5,1.8-3.2,1/5-1/4,2-10,2-3,2-4,2.5-3.5,2.5-5.5,3-10,4-5,5-,5-merous,6-8,7-8,abaxially,acut,acute,alyx,apar,apart,apically,apparently,articulated,ba,bark,blade,brow,cell,concolorous,coroll,curved,densely,diameter,difoliate,distinctive,drying,dull,eaf,eed,elongate,elongating,erect,eye,flattened-reniform,flower,free,geminat,glabrescent,glabrous,gray,herbaceous,infructescence,like,lobe,longer,lower,mature,midpoint,minutely,moderately,naked,narrow-deltate,narrow-ovate,near,nflorescence,obtuse,occasional,often,older,one,open,orange-brown,orolla,oung,outline,ovate,ovoid,pair,peduncle,per,perfec,pericarp,pit,porrect,portion,prickly,primary,rachi,raised,rarely,ray,reticulate,ruit,scandent,scar,sessile,shallowly,shorter,simple,slender,slightly,small,smooth,sometimes,spaced,sparsely,stalk,stalked,stump,tamen,terete,tertiary,time,tinge,trichome,tube,ud,unarme,unarmed,undulate,unit,usually,variously,vary,vein,venation,visible,weakly,wide,woody,ympodial	articulation,branching,broad-based,colour,corolla,form,growth,hair,heteromorphism,inflorescence,insertion,na,needle-like,odour,orientation,placement,position,scale,shape,staman,symmetry,texture,type
141	wfo-0001027366	success	136	102	75	61	27	0.551	/4,0.25-0.5,0.5-1,1-1.5,1-2,1-3,1.5-2,11-21,2-2.5,3-10-flowered,4-4.5,4-5,5-7,6-19,abaxially,acute,adaxially,anther,anthesi,apex,bark,base,berry,bright,broadly,brown,calyx,capitate,cm,conical,conspicuously,corolla,dark,elliptic,erect,filament,fruiting,glabrous,globose,golden,green,greenish-white,internodal,leaf,lobed,minutely,mm,opposite,orbicular,ovary,ovoid-reniform,pale,papillose,parallel,pedicel,petiole,pitted,pore,poridical,rounded,shaped,shrub,simple,sometimes,stigma,straight,style,surface,tear-drop,tip,tube,unit,venation,way,woody	.5,/2,0.7-1,3-9,603,ape,axe,ba,closely,deflexed,deltate,dia,drying,eaf,edicel,eed,et,except,exserted,fide,free,lamina,lateral,less,lobe,lon,long,long-triangular,lower,main,margin,middle,nflorescence,older,overlappin,ovoid,packed,pair,papillo,planar,pointed,portion,ramo,reddish,ruit,scar,secondary,shining,somewhat,stem,tall,trichome,tub,ud,unifoliat,vein,wide,widest,yellowish-gre,ympodial,young	0.5,abaxial,branching,colour,diameter,form,fruit,growth,height,inflorescence,length,marking,plant,position,seed,shape,spot,structure,symmetry,sympodial,texture,type,unifoliate,width,ye,yellowish-grey,zygomorphy
142	wfo-0001027368	success	145	130	68	77	62	0.469	-20,-5,0.3-2.5,0.5-3.5,0.5-5,1-2,1.5-2,2,2-2.5,3,4-6,5-15,acuminate,acute,adaxially,apex,articulated,base,calyx,cell,chartaceous,cm,cuneate,decurrent,densely,diameter,directed,distally,ellipsiodal,elliptic,elliptic-ovate,entire,forked,glabrous,globose,hair,lanceolate,lenticular,lower,margin,mm,moderately,narrowly,nearly,oblong,occasionally,otherwise,ovoid-fusiform,pedicel,peduncle,petiole,pore,puberulent,pubescent,purple,rachi,shrub,simple,sparsely,stellate,stone,subcoriaceous,subhastate,unbranched,unit,unknown,white,x	-10,-15,-2,.5,0.8-2,1-15-flower,1-6,1.5-2.5,2-3,2-4,2-9,3-12.5,4-many-foliat,5-10,5-6,8-13,abaxially,abruptly,absen,adaxiall,aggregate,also,apart,axe,ba,blade,branched,color,connivent,contiguous,cylindrical,darker,deltate,dendritically,denser,eaf,eed,except,gland,lighter,lobe,long,long-stalked,midvein,narrowed,nflorescence,nther,obtuse,often,orolla,pubescen,radiu,ray,ruit,small,sometimes,spaced,stalked,star,stigma,style,subcapitat,tal,tem,terminal,three,time,tip,triangular,truncate,tube,usually,vary,vein,wide,yellow,ympodial	4-many-foliate,abaxial,absent,adaxial,anther,appressed,articulation,bract,branching,breeding,broad-based,colour,connective,corolla,filament,form,fruit,fruiting,growth,height,heteromorphism,inflated,inflorescence,interjected,interpetalar,leaf,leaflet,length,marking,modification,na,needle-like,odour,orientation,pattern,placement,plant,position,prickle,pseudostipule,rhizome,scale,seed,shape,size,smell,spot,staman,stem,structure,surface,symmetry,sympodial,system,texture,tissue,trichome,tuber,type,vegetative,xylopodia,zygomorphy
143	wfo-0001027369	success	191	122	85	106	37	0.445	-1,-10,-2,.5,.7,/4,0,0-15,0.2-0.5,0.5,1-2.5,1.2-2.5,1.2-3,2-4,3,3-10,4-8,5,anther,apart,apex,articulated,bark,base,berry,branched,calyx,cm,concolorous,cordate,diameter,drying,erect,eye,flower,fruit,fruiting,glabrous,hair,known,lateral,leaf,length,less,lobed,long,lower,margin,mature,mauve,membranous,mm,multangulate,naked,one,orbicular,pale,pedicel,per,perpendicular,petiole,poricidal,prickle,reflexed,reniform,sessile,shrub,simple,slightly,sparsely,spherical,spreading,stellate-pubescent,stem,straight,surface,tapering,terminal,tip,trichome,unequal,venation,visible,wide,yellow	-11,.1,.4,0-1,0-3,0-5,0-6,0.05-0.15,0.1,0.1-0.2,0.1-0.3,0.25-0.4,0.3-1.5,0.5-0.8,0.5-1.5,0.6-0.8,1-,1-2,1-3,1-4,1.5-2,1/3,2-3,2-5,3-4,4-5,5-merous,7-15,abaxially,acut,almost,alyx,ame,apar,apically,apparently,blade,broad-deltate,c.,color,curved,deltate,densely,difoliate,distance,eaf,eed,elongating,equal,extending,filament,filiform,free,geminat,glabrou,glaucous,gra,green,herbaceous,infructescence,know,lanceolate,lobe,lon,midpoint,midvein,moderately,narrowly,nflorescence,older,open,orolla,oung,peduncle,pendulous,perfec,pericarp,porrect,portion,prickl,prickly,ray,rounded,ruit,scandent,scar,side,slender,smooth,spaced,stalk,stalked,stellate,strongly,style,tamen,terete,time,tube,unarmed,unit,vary,way,wider,winged,ympodial	articulation,bract,branching,broad-based,cell,colour,corolla,elbowing,form,gray,growth,heteromorphism,inflorescence,insertion,na,needle-like,number,odour,orientation,placement,position,pseudostipule,rhizome,scale,shape,size,smell,specified,staman,stone,symmetry,texture,tuber,type,vegetative,width,xylopodia
144	wfo-0001027378	invalid_json_followup	149	147	78	71	69	0.523	5-merous,abaxially,acuminate,acute,adaxially,anther,apex,base,berry,blue,broadly,calyx,chartaceous,cm,cordate,deeply,densely,diameter,extra-axillary,filament,flattened,fleshy,flower,fruit,fruiting,glabrous,hair,hair-tipped,herbaceous,lanceolate,leaf,light,lobe,long,margin,markedly,membranous,minutely,mm,moderately,obscure,often,ovate,ovoid,palmate,pedicel,peduncle,pentagonal,petiole,primary,pubescent,rachi,revolute,rotate-stellate,rounded,sand-punctate,scattered,short,simple,slightly,small,somewhat,spaced,sparsely,stem,terrestrial,tip,tooth,trichome,tube,unbranched,unknown,vein,venation,vine,white,widely,x	.2,0.5â1,0.7â1,0.8â2.5,1.2â1.5,1.2â1.8,1.5â1.8,1.5â8,15â35,1â1.5,1â3,2.3â5,2.5â7,2â11,2â2.2,2â2.5,3â4.5,3â5,3â6,4â6,4â9,5-8,5â10,5â13,5â7,6â10,6â7,adaxial,alyx,apar,apicall,axe,blade,c.,capitat,ciliate,clavate,climbin,color,cylindrical,deltoid,eaf,eed,glabrou,half,like,lon,longer,lower,m.,narrowly,nflorescence,nternode,orolla,papillose,perfec,plurifoliat,pointed,ruit,sand-punctat,side,slender,stigma,style,tamen,tem,unit,unknow,vary,wide,ympodial	'',0.5\u20131,0.7\u20131,0.8\u20132.5,1.5\u20131.8,15\u201335,1\u20131.5,2.5\u20137,2\u201311,2\u20132.2,3\u20134.5,5\u201310,5\u201313,5\u20137,6\u201310,[,``,appressed,articulation,bract,branching,breeding,characteristic,climbing,colour,connective,corolla,form,growth,habit,inflated,inflorescence,insertion,interjected,internode,interpetalar,leaflet,length,marking,mature,merosity,modification,na,odour,orientation,paired,pattern,perfect,placement,plant,pore,position,prickle,pseudostipule,rhizome,scale,shape,spot,staman,stellate,symmetry,system,texture,tissue,tuber,type,value,{,}
145	wfo-0001027378	success	141	143	92	49	51	0.652	.2,0.7-1,0.8-2.5,1-1.5,1.5-1.8,1.5-8,15-35,2-11,2-2.2,2-4,2.5-7,3-4.5,3-5,4-6,5-13,6-10,abaxially,acuminate,acute,adaxially,anther,apex,basally,base,blue,broadly,calyx,chartaceous,clavate,climbing,cm,cordate,cylindrical,deeply,diameter,directed,distally,extra-axillary,filament,fleshy,flower,fruit,fruiting,glabrous,hair,herb,lanceolate,large,leaf,light,lobe,longitudinal,margin,minutely,mm,node,oblong,opening,ovate,pedicel,peduncle,perfect,petiole,plurifoliate,pore,pubescent,rachi,revolute,rooting,rotate-pentagonal,rounded,simple,slender,slit,small,somewhat,spaced,sparsely,stigma,style,terrestrial,tip,tooth,trailing,tube,unbranched,unit,unknown,white,widely,x,yellow	1-3,1.2-1.5,2.3-5,3-6,4-9,5-8,5-merou,6-7,ag,alyx,apart,apicall,apparently,articulated,axe,ba,blade,capitat,ciliate,connivent,deltoid,densely,eaf,eed,equal,geminat,hair-tipped,long,longer,lower,moderately,multicellular,narrowly,nflorescence,obscure,often,orolla,pubescen,scattered,short,slightly,tamen,tem,unknow,vary,vein,weakly,wide,ympodial	age,articulation,bract,branching,breeding,capitate,cell,colour,connective,corolla,form,growth,habit,heteromorphism,inflorescence,insertion,interjected,interpetalar,leaflet,length,marking,modification,na,odour,orientation,ovary,paired,pattern,placement,plant,position,prickle,pseudostipule,rhizome,scale,seed,shape,size,spot,staman,stem,stone,structure,symmetry,sympodial,system,texture,tissue,tuber,type,xylopodia
146	wfo-0001027384	success	155	153	107	48	46	0.69	.75,0.4-1.1,0.5-1,0.9-1,1-1.3,1-1.5,1-3,1-4,1.5-2,2.5-6.5,3-3.5,3-4,3/4,4-7,5-15-flowered,5-5.5,7-14,7.5-8,acute,anther,anthesi,apart,apex,bark,base,berry,breaking,brown,bud,calyx,capitate,clavate,closely,cm,corolla,cuneate,deep,dia,difoliate,drying,ellipsoid,filament,flattened-reniform,fruiting,geminate,glabrous,globose,green,hard,herbarium,later,lateral,leaf,lobed,long-exserted,lower,main,margin,minutely,mm,mustard,narrowly,obovate,older,opposite,ovary,overlapping,pair,pale,papillose,pedicel,peeling,petiole,pitted,pore,pseudo-terminal,rarely,reddish-purple,rounded,scar,section,shaped,shining,shrub,slender,small,spaced,specimen,stem,stigma,style,sulcate,surface,tapering,tear-drop,transverse,tree,trichome,tube,unit,vein,way,white,widely,yellow,yellowish,young	.25,.5,/3,abov,anothe,ba,beginning,beneath,broadly,distal,eaf,edicel,eed,equal,erect,free,incrassate,inflorescenc,lobe,long,member,middle,nflorescence,occasionally,paler,papillo,planar,poricidal,portion,prominent,ruit,simple,siz,straight,subcoriaceous-fleshy,tall,thick,tip,triangular,tub,tuft,ud,uniseriate,widest,without,woody,x,ympodial	1.5,articulation,bract,branching,broad-based,cell,colour,diameter,flower,form,fruit,growth,hair,height,heteromorphism,inflorescence,insertion,length,na,needle-like,number,odour,orientation,placement,plant,position,prickle,pseudostipule,rhizome,scale,seed,shape,smell,spacing,staman,stone,structure,symmetry,sympodial,texture,tuber,type,vegetative,venation,width,xylopodia
147	wfo-0001027389	success	154	103	54	100	49	0.351	.1,.25,.5,0.25-0.5,0.5-1.5,0.6-1,11-14,3-4.5,5-7,anther,apex,base,berry,broadly,calyx,cm,conical,corolla,deflexed,deltoid,elliptic,erect,foetid,fruiting,glabrous,globose,green,inflorescence,leaf,lobe,lobed,margin,mm,nearly,one,opposite,ovate,pedicel,petiole,pore,poricidal,shaped,shrub,side,simple,stem,tear-drop,tip,trichome,truncate,tube,uniseriate,unit,white	0.25-0.3,0.5-0.75,1,1-1.5,1-2,1.8-1.9,2-2.5,3-3.5,4-5-flowered,7-8,acuminate,acute,along,anthesi,apart,ba,bark,beneath,broadening,brown,bud,dark,decurrent,dia,dry,eaf,edicel,eed,ellipsoid,evenly,except,expanded,exserted,filament,filiform,foliage,free,geminate,hispidulous,lateral,like,lon,long,lower,main,making,material,middle,minutely,nflorescence,node,non-reproductive,obovoi,occasionally,often,older,ovary,ovoid-reniform,pair,paler,papillo,papillose,pitted,portion,prominent,prominently,proximal,puberulent,raise,raised,reddish-golden,reflexed,rest,ruit,scar,shin,slender,slight,slightly,soon,spaced,sparsely,stigma,straight,style,surface,tall,tapering,thread-like,top,ud,unifoliat,vein,widest,winged,woody,x,yellowish,ympodial,young	appressed,articulation,bract,branching,breeding,cell,colour,connective,decurren,diameter,form,fruit,growth,hair,heteromorphism,inflated,insertion,interjected,interpetalar,leaflet,length,marking,mature,modification,na,odour,orientation,pattern,placement,position,prickle,pseudostipule,rhizome,scale,shape,spot,staman,stone,structure,symmetry,sympodial,system,texture,tissue,tuber,type,unifoliate,width,xylopodia
148	wfo-0001027395	success	153	105	72	81	33	0.471	.25,.5,0.25-0.5,0.75-1,1-1.5,1-2,1-5,1.1-1.5,1.5-1.9,1.5-2.5,12.5-17.3,2-3,3.5-4,5-6.5,8,acute,anther,anthesi,apex,apiculate,attenuate,bark,base,calyx,capitate,cm,corolla,deltoid,densely,dia,difoliate,exfoliating,filament,fruit,fruiting,glabrous,globose,green,immature,leaf,lobe,lobed,minutely,mm,narrowly,nearly,obovate,occasionally,once-furcate,opposite,ovary,pedicel,petiole,piece,pore,pubescent,rusty-papillate,shaped,shrub,simple,size,small,stigma,style,tear-drop,transverse,trichome,tube,uniseriate,unit,white,x	0.6-1.1,1.6-2.9,10-20-flowered,11-15,2.2-7,4-6,apically,becoming,beginning,beneath,berry,black,caly,closely,conical,constricted,cucullate,decurrent,deflexed,depressed,differing,drying,eaf,edicel,eed,enlarging,erect,exserted,fleshy,free,geminat,imperceptibly,inflorescenc,known,large,lateral,lon,long,lower,main,major,margin,midrib,minor,nflorescence,older,overlapping,ovoid,pair,papillo,papillose,partially,planar,pointed,poricidal,portion,primary,raised,restricted,robust,ruit,scar,secondary,shining,shiny,somewhat,spaced,stem,straight,tall,tapering,thick,thickened,tip,ud,vein,within,without,woody,ympodial,young	10-20,abaxial,adaxial,articulation,branching,cell,colour,diameter,flower,form,geminate,growth,height,heteromorphism,inflorescence,insertion,length,na,number,odour,orientation,placement,plant,position,prickle,shape,staman,stone,structure,symmetry,sympodial,texture,type
149	wfo-0001027396	success	244	143	93	151	50	0.381	/3,0-4,0-5,0.5-1.5,1/4-1/3,1/6,15-40,20-100,5-50,5.5-7.5,6.5-7.5,almost,andromonoecious,anther,apart,apex,articulated,attenuate,base,berry,blade,calyx,chartaceous,cm,connivent,cream,cuneate,dark,decurrent,densely,difoliate,elongate,elongating,equal,filament,flattened,flower,fruit,fruiting,glabrous,glandular,green,hair,herb,lateral,leaf,length,less,lobed,long,long-styled,lower,margin,marking,mature,maturity,mauve,mm,often,pale,pedicel,perpendicular,petiole,poricidal,prickle,pubescent,purple,reflexed,rotate,short-styled,shrub,simple,sometimes,somewhat,spaced,sparsely,spherical,stellate-pubescent,stem,straight,surface,tapering,tearing,tip,trichome,unbranched,unit,usually,way,white,yellow,yellowish,young	-2,-5,-6,0-100,0-3,0-30,0.1-0.5,0.1-1,0.4-0.7,0.5-1,0.5-2,0.5-2.5,0.7-2.5,0.8,0.8-1.3,1,1-4,1.2-2,1.5-3,1.5-3.5,1.8-3,1/2-2/3,1/3,10-15,10-25,10-30,10-35,12-25,2-3,2-3.5,2-7,2.5-4,2.8-4.5,3-,3-9,3.5-6,4,4-5,4-6,4-7,5-10,5-20,5-30,5-8,5-merous,6-20,7-10,7-15,8-20,abaxial,abaxially,acute,adaxial,alyx,ame,apar,apically,apparently,ba,bark,black,broad,broad-deltate,brown,bulbous,c.,concolorous,curved,deltate,diameter,discolorous,distal,distance,drying,eaf,eed,elliptic,erect,extending,extensive,fewer,flattened-reniform,free,fully,geminat,glabrescent,gray-brow,hermaphrodite,heterostylous,infructescence,lignified,lobe,lobing,lon,long-acuminat,longer,lowermost,midpoint,midvein,moderately,near,nflorescence,obtuse,older,one,open,opening,orange,orolla,oung,pair,peduncle,pendulous,per,pericarp,plant,porrect,portion,prickl,prickly,primary,ray,red-brown,ruit,scar,secondary,sessile,side,smooth,spreading,stalk,stalked,staminat,stout,style,tamen,terete,tertiary,time,tube,unarmed,upper,variously,vary,vein,venation,visible,wide,woody,yellow-green,ympodial	appressed,articulation,bract,branching,breeding,broad-based,cell,colour,connective,corolla,form,geminate,growth,heteromorphism,inflated,inflorescence,insertion,interjected,interpetalar,leaflet,modification,na,needle-like,odour,orientation,paired,pattern,placement,pore,position,pseudostipule,rhizome,scale,shape,smell,spot,staman,stellate,stone,structure,symmetry,sympodial,system,texture,tissue,tuber,type,vegetative,xylopodia,zygomorphy
150	wfo-0001027449	success	160	91	43	117	48	0.269	.4,0.8-1.5,3-3.5,acute,anther,apex,base,berry,calyx,cm,corolla,difoliate,elliptic,filament,fruit,fruiting,glabrous,globose,green,inflorescence,leaf,lobed,long,minutely,mm,narrowly,opposite,papillose,pedicel,persistent,petiole,pore,red-papillose,shaped,shrub,small,tear-drop,tree,trichome,uniseriate,unit,white,x	.5,.75,/3,0.5-1,0.5-1.5,0.9-1.1,1.2-1.5,1.4-1.5,1.5-2.5,10-15-flowered,2-3,2-4,3,3-7,4-6,5-6,8-15,acuminate,anthesi,appearing,area,arising,around,axil,bark,becoming,beginning,beneath,brown,bud,closely,cup,dark,deciduous,deflexed,dense,densely,density,dia,differing,dry,eaf,edicel,eed,ellipsoid,erect,exserted,extreme,forming,free,frui,geminat,glabrate,inflorescenc,lamina,later,lateral,like,lobe,lon,long-acuminate,long-triangular,lower,main,major,material,minor,nflorescence,obconic,oblique,often,older,one,orangish,ovary,overlapping,ovoid-reniform,packed,pair,pale,pitted,pointed,poricidal,portion,prominent,pubescent,raised,reddish-brow,reflexed,rest,ruit,scar,simple,size,slender,soon,sparse,sparsely,stem,stigma,straight,styl,style,surface,tall,tapering,tip,trunk,tube,tuft,ud,varying,vein,way,woody,ympodial,young	appressed,articulation,bract,branching,breeding,cell,colour,connective,form,geminate,growth,hair,heteromorphism,inflated,insertion,interjected,interpetalar,leaflet,length,margin,marking,mature,na,odour,orientation,paired,pattern,placement,position,prickle,pseudostipule,rhizome,scale,shape,spot,staman,stone,structure,symmetry,sympodial,system,texture,tissue,tuber,type,xylopodia,ye,zygomorphy
151	wfo-0001027452	success	152	138	82	70	56	0.539	.5,0.5-1,0.5-1.5,1,1-5,1.5,1.5-3,10-20,2-4,2-foliate,3-9,4-6,5-12,5-20,absent,abundant,acute,anther,apex,base,berry,branched,brown,calyx,cell,chartaceous,ciliate,cm,connected,cordate,densely,diameter,drying,elliptic,elliptic-ovoid,entire,filament,flower,fruit,glabrous,globose,hair,herb,immature,interpetalar,large,lower,margin,membranaceous,mm,moderately,nearly,notched,oblong,obtuse,outer,pedicel,peduncle,per,perpendicular,petiole,placenta,pubescent,rachi,raised,ridge,rotate,rounded,running,seed,semitransparent,significantly,single,sparsely,style,swollen,tissue,unit,usually,white,x,yellow	0.5-2,0.5-2.5,1-2,1-3,1-4.5,2-6,3-6,4,abaxially,adaxiall,adaxially,along,axe,beyond,blade,celled,center,decurrent,dehiscing,denser,dm,eaf,eed,emarginat,equal,explosively,exserted,flat,frui,geminat,growt,held,linear-lanceolate,lobe,long,lying,maturing,maturit,mesocarp,new,nfloresence,often,one-,orolla,parallel,pressure,pubescen,ruit,short,slightly,smaller,smoother,sometimes,stamen,stigma,straight,tal,tamen,tem,triangular,tube,two-celled,unbranched,vary,vein,wall,watery,wid,woody,ympodial	arrangement,bract,branching,breeding,broad-based,colour,connective,corolla,decument,emarginate,form,geminate,growth,heteromorphism,inflorescence,interjected,leaf,leaflet,length,marking,modification,na,needle-like,notching,number,odour,orientation,ovary,pattern,placement,pore,position,prickle,pseudostipule,rhizome,scale,shape,simple,smell,spot,staman,stellate,stem,stone,structure,surface,symmetry,sympodial,system,texture,trichome,tuber,type,vegetative,xylopodia,zygomorphy
152	wfo-0001027471	invalid_json_followup	165	158	125	40	33	0.758	.5,/4,0.1-0.2,0.2-0.4,0.2-0.5,0.4-1,0.5,0.5-0.6,0.5-0.7,0.5-1.5,0.7-0.9,1-1.6,1.4-3,1.5-2,2-2.5,2-3,2-lobed,3-4,3-7,4-5,6-7,acute,age,anther,anthesi,apex,appressed,ascending,bark,base,berry,bifid,branched,calyx,closely,cm,conical,corolla,deltate,dendritic,densely,desnsely,diameter,drying,elliptic,entire,erect,filament,flattened,flower,fruiting,glabrous,globose,growth,herb,included,inflorescence,internodal,leaf,leaf-opposed,lengthening,less,lobe,lobed,major,margin,maturity,minor,minutely,mm,new,nodding,orbicular,ovary,ovate,overlapping,pair,pale,pedicel,peduncle,perfect,petiole,pitted,planar,plane,pore,poridical,primary,pubescent,pubscent,rachi,red-orange,reflexed,reniform,scar,shape,shrub,similar,simple,size,slightly,slit,small,somewhat,spaced,sparsely,stem,stigma,straight,style,subshrub,surface,tan,thickened,tip,trichome,tube,uniseriate,usually,vein,way,white,woody,x,yellowish	0.9-1,1-1.2,1-1.5,abaxially,adaxially,along,brittle,c.,differing,difoliate,distant,eaf,eed,erec,especially,free,furcate-dendritic,geminate,lamina,like,long-triangular,lower,midvein,mixture,nflorescence,node,occasionally,open-conical,papillat,pericarp,petal,portion,ruit,scattered,slender,thin,trifoliat,ud,unit,ympodial	'',[,``,arrangement,branching,breeding,bud,characteristic,colour,connective,form,fruit,hair,inclusion,length,marking,modification,na,number,orientation,papillate,pattern,position,pubescence,seed,spacing,spot,symmetry,system,type,value,{,}
153	wfo-0001027473	success	138	94	43	95	51	0.312	0.5-1,3.5-5,?,anther,apex,base,berry,calyx,corolla,decurrent,dendritic,densely,di-,filament,fruiting,globose,green,leaf,lobed,lower,margin,mm,obovate,occasionally,pedicel,petiole,pointed,pore,poricidal,pubescent,sessile,shape,shaped,shrub,stem,subshrub,surface,tear-drop,tip,trichome,trifoliate,unit,white	.25,/2,0.25-0.5,0.8-1,1-1.5,1-2,1.3-2,1.5-2,1.8-2,1/3,2-2.5,2.5-3,4.5-13,5,6-9,8.5-37,abaxially,absen,acute,adaxially,along,anthesi,ape,apparently,bark,brown,clavate,cm,conical,deccurent,deep,deflexed,denser,dia,differing,drying,eaf,eed,empty,erect,flattened-reniform,free,geminat,giving,glabrous,incrassate,later,lateral,less,like,lobe,long,long-triangular,main,major,middle,minor,minute,minutely,near,older,ovary,overall,pair,pale,papillo,pitted,planar,portion,pubesent,rootstock,ruit,rusty,sac,somewhat,sparsely,sterile,stigma,strongly,style,tall,thick,tube,usually,vein,way,wide,widest,wing,winged,woody,yellowish,yellowish-brow,ympodial,young	absent,appressed,articulation,bract,branching,breeding,broad-based,cell,colour,connective,form,fruit,growth,hair,heteromorphism,inflated,inflorescence,insertion,interjected,interpetalar,leaflet,length,marking,mature,modification,na,needle-like,odour,orientation,paired,pattern,placement,position,prickle,pseudostipule,rhizome,scale,smell,spot,staman,stone,structure,symmetry,sympodial,system,texture,tissue,tuber,type,vegetative,xylopodia
154	wfo-0001027483	success	164	121	70	94	51	0.427	1-4,1-5,1.5-3,2-4,2-4.5,abaxially,adaxially,apex,apical,apically,articulate,base,branched,calyx,cell,cm,coarsely,connate,corolla,cuneate,dehiscent,dichasially,distal,dot,ebracteate,filament,finely,generally,globose,green,half,herbaceous,interjected,interpetiolar,introrse,leaf,leaflet,light,lighter,long,maturing,medium,mm,odd-pinnate,often,ovoid,pattern,pedicel,perennial,perfect,petiole,plant,poricidally,proximal,pubescent,purple,ray,rotate,rounded,short,slit,smooth,sometimes,tuber-bearing,uniform,unit,violet,violet-purple,white,Â¼	0-1.,0.2-1.9,0.6,1,1-2,1-2.5,1.2-2.5,1.5-10,1.5-2.6,2,2-3,3-15,3-6,3-6-foliat,3.5-20,4.5-8,5-10,5-6,acumen,acute,basal,covering,cyme,decurrent,diameter,dichasial,digestion,diminishing,dorsally,eaf,edge,eed,elliptical,emoval,enzyme,erec,exceeding,flat,flower,folded,forked,globo,gradually,green-white,hair-like,honeycomb,lateral,living,lobe,lon,lower,lunat,make,minute,monochasial,mucilaginous,nflorescence,nther,obtuse,orolla,ovate,pair,peduncle,petiolule,plan,rachi,reveal,rosette,ruit,seed,sessile,seudostipule,size,specimen,stamen,stigma,straight,style,subsessile,tall,tem,terminal,testal,thick,throughout,tissu,toward,typically,vary,varying,wall,wide,yellow,ympodial	0-10,3-6-foliate,anther,appressed,articulation,bract,branching,breeding,colour,connective,form,fruit,fruiting,growth,hair,heteromorphism,inflated,inflorescence,insertion,interpetalar,length,lunate,margin,marking,mature,modification,na,odour,orientation,paired,placement,pore,position,prickle,pseudostipule,rhizome,scale,shape,spot,staman,stone,structure,symmetry,sympodial,system,texture,tissue,tuber,type,xylopodia,zygomorphy
155	wfo-0001027506	success	215	115	69	146	46	0.321	.5,/2,/6,0.5-1.5,5-10,6-13,andromonoecious,anther,apex,articulated,base,berry,branched,calyx,cell,chartaceous,cm,connivent,cordate,cream,cuneate,dark,elongating,entire,equal,erect,filament,fruit,fruiting,green,lateral,leaf,length,lobed,long,lower,margin,marking,mature,maturity,mauve,mm,occasionally,pale,pedicel,petiole,poricidal,prickle,purple,reflexed,shrub,simple,small,sometimes,spherical,stellate,stem,subentire,surface,tapering,terminal,tip,tree,truncate,twice,unit,way,yellow,young	-0.35,-1,-20,-3,-7,-7.5,.2,0,0-10,0-2,0-6,0-60,0.1-,0.1-0.3,0.2,0.2-0.3,0.25,0.5-6,0.7-1.3,0.8-1.5,1-2,1-3,1-4,1.2-1.5,1.5-2.2,1.8,1/3,1/6-1/4,10-40,2-3.2,2.2-3.5,2.5-5,2.5-8,3-10,3-5,3-6,3.5-5,5-7,5-merous,6.5-10,7-8,7-9,8-10,9-13,abaxially,acuminat,acuminate,acute,alyx,ame,apar,apart,apically,apparently,bark,becoming,blade,brow,brown,c.,concolorous,curved,densely,diameter,distal,dry,drying,eaf,eed,fine,flattened,flattened-reniform,flower,free,glabrescent,glabrous,hard,hermaphrodite,heterostylous,infructescence,lengt,lobe,long-styled,longer,lowermost,midpoint,moderately,multangulate,narrow-deltate,nflorescence,older,one,open,orange,orange-brown,orolla,oung,outline,ovate,pair,peduncle,pendulous,per,pericarp,pit,plant,plurifoliat,porrect,portion,prickl,prickly,primary,raised,ray,reddish,reduced,ruit,scar,sessile,short-styled,smooth,spaced,spreading,stalk,stalked,staminat,stellate-pubescent,stout,style,tamen,terete,tertiary,time,trichome,tube,unarmed,upper,variously,vary,vein,venation,visible,wide,woody,yellow-green,ympodial	appressed,articulation,bract,branching,breeding,broad-based,colour,connective,corolla,form,growth,hair,heteromorphism,inflated,inflorescence,insertion,interjected,interpetalar,leaflet,modification,na,needle-like,odour,orientation,paired,pattern,placement,plurifoliate,pore,position,pseudostipule,rhizome,scale,shape,spot,staman,stone,structure,symmetry,sympodial,system,texture,tissue,tuber,type,xylopodia
156	wfo-0001027548	success	216	152	104	112	48	0.481	.3,0.3-1.2,0.5,0.5-2,1,1-1.5,1-10,10-12,acuminate,acute,almost,anther,apart,apex,area,articulated,articulation,attenuate,axi,base,bent,berry,black,branched,branching,brown,c.,cell,cm,connivent,corolla,dark,dendritic,densely,depressed-elliptic,diameter,ellipsoid,entire,filament,flattened-reniform,flower,glabrous,glandular,globose,green,growth,immature,inflorescence,irregularly,lamina,leaf,leaving,lengthening,like,lilac,lobed,long,loose,loosely,lower,many,margin,membranous,minutely,mm,outline,papillae,papillate,pedicel,peduncle,per,perfect,petiole,pitted,plurifoliate,point,pore,poricidal,prominent,pubescent,rachi,revolute,ripe,scar,simple,slit,spaced,sparse,stellate,stem,surface,swollen,terminal,time,tinged,tip,trichome,type,unit,vein,vine,way,white,x	-11.5,0.2,1-2.5,1-3.5,1.2,1.5,1.5-2,1.5-2.5,10-50,3-7,4-6,4-8,4.5,5-merou,6-9,7-10,8-9,abaxiall,adaxially,ag,along,also,although,alyx,anthesi,apical,apparently,appearing,ark,basal,beneath,branch,bu,calyx,capitate,conical,darker,deflexe,deltate,denser,drying,dull,eaf,early,eed,elliptic,elongate,em,exserted,extending,flexuous,free,fruiting,geminat,glabrescen,half,herbarium,ilament,less,lobe,lon,long-styled,matte,minute,mixed,narrowly,near,new,nflorescence,occasionally,older,orolla,pair,pale,papillo,pericarp,planar,portion,primary,puberulent,rectangular,reddish,ruit,scattered,size,slender,small,sometimes,somewhat,sparsely,specimen,spreading,stigma,strongly,style,tapering,testal,thickened,thin,tiny,transparent,tube,twinin,ud,uniseriate,upper,usually,vary,warty,woody,yellow,ympodial	abaxial,age,bract,breeding,broad-based,colour,connective,form,fruit,geminate,hair,heteromorphism,insertion,interjected,interpetalar,leaflet,length,marking,modification,na,needle-like,number,odour,orientation,paired,pattern,placement,position,prickle,pseudostipule,rhizome,scale,seed,shape,smell,spot,staman,stone,structure,symmetry,sympodial,system,texture,tissue,tuber,vegetative,xylopodia,zygomorphy
157	wfo-0001027581	success	200	112	67	133	45	0.335	abaxial,acute,adaxial,anther,apex,base,berry,branched,branching,broadly,brown,c.,calyx,cm,connivent,corolla,dark,densely,echinoid,ellipsoidal,elliptic,entire,evenly,filament,fruiting,globose,green,growth,inflorescence,leaf,length,lobed,long,loosely,many,margin,mm,moderately,multangulate,new,part,petiole,plane,plurifoliate,poricidal,pubescent,purple,reddish,ripe,sessile,short-stalked,shrub,simple,size,small,stellate,stem,terminal,time,tip,tree,trichome,unevenly,unit,upper,way,wide	0.2â0.3,0.3,0.3â1,0.5â1,0.5â1.5,1,1.2â1.5,1.3â1.5,1.5,1.5â2,1.5â3,10,100+,10â16,12,12â30,15â20,1â1.5,1â3-rayed,2.5â3,200,3.5â4.5,3â3.5,4.5â16,4â8,5-merou,6â7,7â10,7â9,8,8â10,9â11,9â9.5,>,abaxially,ag,along,alyx,anthesi,apar,ark,articulated,axe,beneath,brow,bulbous,clavate,clearly,closely,cup-shaped,deltate,diameter,dichasia,discolorous,distally,drying,eaf,eed,erec,exserted,flattened-reniform,flower,free,glabrescent,glabrous,golden,gradually,greyish,ilament,lamina,largest,lengthening,less,like,lobe,longest,lower,midvei,minute,minutely,mixed,multiseriate,narrowing,near,nflorescence,nodding,older,orolla,pair,papillo,pedicel,peduncle,per,perfect,pericarp,pitted,pore,porrect-stellate,portion,primary,ray,reflexed,rhachi,ruit,scar,scarcely,shiny,slit,smaller,spaced,sparsely,spreading,stalk,stigma,stout,style,surface,tall,tem,thin,tube,ud,undersurface,vary,varying,vein,visible,weak,whit,woody,yellow,yellowish,ympodial	1-3-rayed,1.5-3,12-30,15-20,2.5-3,3-3.5,4-8,4.5-16,bark,cell,colour,connective,dichasial,form,fruit,hair,height,heteromorphism,interjected,interpetalar,leaflet,marking,modification,na,odour,orientation,pattern,placement,plant,position,prickle,pseudostipule,rhizome,shape,spot,staman,stone,structure,symmetry,sympodial,texture,tissue,tuber,type,xylopodia
158	wfo-0001027584	success	144	142	105	39	37	0.729	-16,-2,0.5-1.5,0.9-1,0.9-2.5,1-1.2,1.2-1.4,1.6-1.9,10-15,11.5-45,2,2-10,3,3-.,4-6,4-7,4.5-20,7-10,abruptly,absent,acuminate,anther,apex,attenuate,bark,base,beneath,branched,broadly,calyx,cell,cm,conical,corolla,cucullate,darker,deltate,densely,ellipsoid,elliptic,filament,flattened,four,fruit,fruiting,glabrous,green,herb,irregular,lamina,lobe,lobed,long,lower,margin,markedly,minutely,mm,narrowly,nearly,outer,outline,ovary,ovate,pair,pale,papillate,pedicel,peduncle,per,petiole,present,primary,reddish,regularly,reniform,scattered,shrub,single-stemmed,sinuate,smooth,sparse,sparsely,stem,stigma,striate,stripe,style,suffruticose,surface,tan,testal,thickening,time,tip,triangular,trichome,tube,uniseriate,unit,vein,wall,white,without,x	..,.5,0.5-1,1.5-2,1.5-8,100,2.5-3,8-9,anthesi,apical,becoming,beginning,branch,brittle,brow,c.,capitat,deflexe,diameter,dry,eaf,edicel,eed,erec,flower,nflorescence,open,pericarp,planar,plurifoliat,pointed,ruit,scar,single,small,thin,tuft,ud,ympdoial	arrangement,branching,broad-based,brown,capitate,colour,cucullation,deflexed,deflexion,erect,flowering,form,glabrousnes,growth,habit,height,inflorescence,leaf,length,needle-like,number,orientation,papillation,placement,plant,plurifoliate,presence,prickle,seed,shape,size,striation,structure,sympodial,texture,type,venation
159	wfo-0001027600	invalid_json_followup	185	156	105	80	51	0.568	-10,0.5-1.5,1,1-14,1-2,1-4,1-5,1.5-2,10-20,2-11,2-18,2-3,2-3.5,2-4,2-4.5,2-5,2-6,2.5-21,2.5-6,20-30,3-15,3-5,3-5-lobed,3-6,4-6,5-13,8-17,abaxially,abruptly,acuminate,acute,apex,apical,apiculate,basal,base,calyx,campanulate,cm,concave,connective,cordate,cuneate,deltate,densely,diameter,directed,distally,ellipsoidal,entire,fading,flattened,forked,fruit,glabrescent,glabrous,gland,greenish-white,laterally,leaf,lobe,lobed,margin,mature,minutely,mm,moderately,narrowed,oblong,obtuse,occasionally,older,orange,ovoid,pedicel,peduncle,perfect,petiole,pilose,pinnately,pore,puberulent,purple,purplish,rachi,radiu,rarely,remnant,rounded,simple,stigma,style,tree,triangular,truncate,tube,two,unbranched,unit,unlobed,white,x,yellow,yellow-green,young	-3,0.5-1,1.5-2.5,1/2-3/4,10-,15-25,4-foliat,absen,absent,adaxial,adaxially,adpressed,aggregate,along,apart,ape,articulated,axe,beyond,blade,brow,cell,channe,collection,coriaceous,cream,dilated,divided,eaf,eed,elliptic,especially,exceeding,except,exserted,fleshy,flower,glandular-puberulent,leaving,lon,long,lower,main,midrib,nflorescence,nther,obconical,orolla,ovate,papillose,pedicellar,pilo,puberulen,puberulence,pubescent,ruit,shorter,sinus,slightly,small,somewhat,spaced,sparsely,stamen,stone,strongly,subcoriaceous,surface,tal,tem,thecae,time,tip,tomento,ud,vary,vein,wide,yellowish,ympodial	'',4-foliate,[,``,anther,appressed,articulation,bract,branching,breeding,bud,characteristic,colour,corolla,filament,form,fruiting,growth,hair,height,inflated,inflorescence,interjected,interpetalar,leaflet,length,marking,modification,na,ovary,pattern,plant,position,scale,seed,shape,spacing,spot,stem,structure,symmetry,sympodial,system,theca,tissue,trichome,type,value,width,{,}
160	wfo-0001027607	success	167	95	61	106	34	0.365	.25,.5,0.5,1,2-4,3/4,8-9,acute,anther,apex,base,berry,branch,calyx,corky,corolla,decurrent,deflexed,elliptic,evenly,except,filament,filiform,fruiting,geminate,glabrous,globose,green,leaf,lobed,long,lower,minutely,mm,narrowly,non-reproductive,opposite,papillose,pedicel,petiole,pore,poricidal,raised,rarely,shaped,short,shrub,simple,slightly,spaced,tear-drop,tip,treelet,tube,unifoliate,unit,way,white,winged,woody,x	.1,0.25-0.5,0.5-1,0.8-1,1-4,1.2-1.5,1.5-3,2-2.5,2-3,2.5-3,3-3.5,4-10-flowered,5-10,5-7,acuminate,age,anthesi,apar,arching,area,aspect,ba,bark,basal,becoming,branche,brown,cm,curling,dark,deltoid,densely,dia,dry,eaf,edicel,eed,ellipsoid,elongate,erect,exserted,f,flattened,free,gently,giving,glabrate,golden,lamina,lateral,lenticellat,less,like,lobe,lon,m.,main,material,middle,midrib,minute,narrow,nflorescence,obovoid,occasionally,older,ovary,ovoid-reniform,pagoda-like,pair,pitted,plant,portion,present,prominent,pubescent,reddish-brown,reflexed,ruit,scar,slender,slight,small,soon,stem,stigma,straight,strongly,styl,style,surface,tall,tan,tapering,trichome,tub,ud,uniseriate,vein,widened,widening,widest,yellowish,ympodial,young,zig-zag	apart,articulation,branching,cell,colour,form,fruit,growth,heteromorphism,inflorescence,insertion,length,margin,marking,na,odour,orientation,placement,position,prickle,pseudostipule,rhizome,shape,spot,staman,stone,structure,symmetry,sympodial,texture,tuber,type,xylopodia,zygomorphy
161	wfo-0001027618	success	202	142	92	110	50	0.455	-pubescent,0.5,1,1-13,1-14,1-23,1-5,11-16,11-pinnate,15-35,2-12,3-30,3-7-pinnate,4,5-20,5.5-12,6-40,8-35,abaxially,acute,adaxially,aggregate,also,apart,apex,basal,base,blade,branched,bud,campanulate,cell,chartaceous,cm,compound,cordate,cuneate,deltate,densely,ellipsoidal,elliptic,fleshy,flower,fruit,fusiform,glabrous,globose,greenish,leaf,leaflet,length,less,lobe,long,lower,margin,membranaceous,mm,moderately,near,obtuse,orange,pedicel,peduncle,per,perfect,pilose,pinnately,puberulent,puberulent-pubescent,pubescent,pubescent-pilose,purple,rachi,ripe,shallowly,shrub,simple,sometimes,sparsely,stone,sympodial,tree,triangular,truncate,unbranched,unit,urceolate,white,without,x,yellow	-10,0-10,0.5-1,0.5-6,1-,1-1.5,1-3,1-9,1.4-4,1.5-13,1.5-3,1.5-7,1.5-8.5,11-22,12-27,15-30,2-11,2-11.5,2-27,2-5,2-8.5,2-9,2.5-6,3-18,3-5,3-7,3.5-6,4-8,5-18,5-30,5-7.5,5-merous,6-25,7-25,8-16,acuminat,acut,alyx,ape,articulated,ascending,axe,beyond,capitate,connective,cylindrical,darker,dia,diamete,diameter,dilated,directed,distally,eaf,eed,elliptic-ovate,entire,exceeding,exserted,lateral,laterally,leaving,lon,longitudinal,mesocarp,minutely,nflorescence,nther,oblong,obovate,obtu,often,orolla,ovate,papillose,pedicellar,perfec,petiole,petiolule,pilo,pore,presen,puberulent-pilo,radiu,ranch,ratio,remnant,reticulate,rown,ruit,runk,shorter,slightly,small,somewhat,spaced,spreading,stamen,stigma,stripe,style,tal,terminal,thecae,tomentose,tube,uni,vary,wide,width	acuminate,arrangement,articulation,bract,branching,broad-based,calyx,colour,corolla,crown,filament,form,fruiting,growth,hair,height,heteromorphism,inflorescence,interjected,interpetalar,marking,na,needle-like,number,odour,orientation,pattern,placement,plant,position,prickle,pseudostipule,puberulent-pilose,rhizome,scale,shape,spacing,spot,staman,stem,structure,surface,symmetry,texture,tissue,trunk,tuber,type,xylopodia,zygomorphy
162	wfo-0001027622	invalid_json_followup	203	190	139	64	51	0.685	.5,0-14,0-16,0.3-10,1,1-2,1.5-3.5,1.5-4.2,1.6-4.5,12-23,2-25,2-6,2.5-3.5,3-16,3-4,3-4.5,3.5-11,4-9.5,5-11,6-17,6-7,8-16,8-20,abaxially,acuminate,adaxially,anther,axillary,base,berry,blade,blue,blue-purple,borne,brownish,bud,cell,chartaceous,clavate,cm,condition,connivent,corolla,covering,diameter,different,distal,drying,end,except,filament,flower,forked,fresh,fruit,generally,glabrescent,glabrous,globose,greatly,green,green-white,greenish,hair,half,herb,homostylous,interjected,lanceolate,lateral,leaflet,lengthening,light,like,lobe,long,make,membranous,middle,mm,mottled,mucilaginous,oblique,odd-pinnate,often,ovate-lanceolate,ovoid,pair,pale,pedicel,peduncle,pentagonal,petal,petiole,petiolule,plant,population,pore,poricidal,proximal,pubescent,purple,reduced,rounded,seed,shortly,singly,size,slightly,slit,sometimes,stellate,stem,stigma,straight,striped,style,subequal,subglabrous,subtending,terminal,testal,thick,throughout,tip,truncate,tube,tuber,typically,unwinged,usually,varying,wall,wet,whitish,wide,wing,x,yellow	1-10,1/,2-3,4-5,5-merou,acumen,acute,ag,along,alyx,apart,apex,apparently,articulated,axe,broadly,capitat,ciliate,decumben,digestion,dorsally,eaf,edge,eed,elliptic,elliptical,enzyme,erect,especially,exceeding,flat,folded,geminat,glabrou,hair-like,honeycomb-shaped,living,lower,margin,midrib,minutely,narrowly,nflorescence,orolla,ovate,perfect,plurifoliate,puberulent,removed,ruit,seudostipule,spaced,specimen,stamen,star,ste,stolo,tall,tamen,tem,tri-,unit,vary,ympodial	'',5-merous,[,\u201chair-like\u201d,\u201cstar\u201d,``,age,appressed,arrangement,bract,branching,breeding,calyx,capitate,characteristic,colour,connective,form,fruiting,growth,height,inflated,inflorescence,interpetalar,leaf,length,marking,mature,modification,na,ovary,pattern,position,presence,pseudostipule,scale,shape,spot,staman,stolon,symmetry,system,texture,tissue,trichome,type,value,variation,zygomorphy,{,}
163	wfo-0001027624	invalid_json_followup	189	159	107	82	52	0.566	0-7,0.1-0.9,0.3-1,0.4-3,0.5-1.5,0.8-5.6,1-2,1-3,1.1-8.4,1.2-2.6,1.3-2.9,1.5-6.6,2-20,2-5,2.4-4.8,2.9-12,3-10,3-11,4-15.2,4-7,4-8,5-9,6-18.5,9-41,acuman,anther,articulated,axillary,base,berry,blade,brownish,bud,cell,clavate,cm,condition,corolla,decurrent,deep,densely,diameter,digestion,drying,entirely,enzyme,filament,flower,forked,fresh,fruit,glabrous,globose,green,greenish,hair,herb,homostylous,honeycomb-shaped,interjected,lanceolate,lateral,leaf,leaflet,light,like,lobe,long,mm,moniliform,mottled,odd-pinnate,onto,ovate,ovoid,pedicel,peduncle,pentagonal,petiole,plant,pore,poricidal,pubescent,purple,rachi,removed,rotate,seed,short,size,sometimes,stigma,straight,style,subtending,terminal,testal,tip,tube,tuber,usually,wall,white,whitish,wide,widely,x	0-3,1-5,2-7,3-4,3-5,5-merou,abaxially,acumen,acuminate,acute,adaxially,ag,along,alyx,apart,apex,apparently,arranged,axe,bead,capitat,connivent,considerably,covering,cuneate,decreasing,decumben,distal,dorsally,eaf,edge,eed,elliptic,erect,exceeding,flat,folded,geminat,glabrou,green-white,hair-like,half,larger,leave,lengthening,living,lower,make,middl,mucilaginous,multiple,necklace,nflorescence,orbicular,orolla,pair,perfect,plurifoliate,present,ruit,sessile,seudostipule,slightly,slit,spaced,specimen,stamen,stolon,tall,tamen,tem,thick,throughout,toward,tri-,typically,unit,unwinged,vary,wet,yellow,ympodial	'',[,``,abaxial,adaxial,appressed,arrangement,articulation,bract,branching,breeding,calyx,capitate,characteristic,colour,connective,form,fruiting,growth,height,inflated,inflorescence,insertion,interpetalar,length,margin,marking,mature,middle,modification,na,number,odour,ovary,paired,pattern,position,pseudostipule,pubescence,scale,shape,spot,staman,stem,symmetry,system,texture,tissue,type,value,{,}
164	wfo-0001027626	success	152	105	80	72	25	0.526	.3,.5,0.1â0.2,0.2â0.6,0.5â1,1,1.5â8,13â14,14â116,2â49,2â5,3â4,3â55,5â6,8,acuminate,along,anther,apex,arrangement,base,berry,calyx,chartaceous,clavate,cm,cordate,coriaceous,distichous,distinct,elliptical,entire,extra-axillary,filament,fleshy,flower,frequently,fruit,fruiting,glabrous,greenish-white,leaf-opposed,liana,line,margin,membranous,midvein,minutely,mm,moderately,nearly,oblique,ovate,pair,pedicel,peduncle,petiole,pinnate,possibly,pubescent,rachi,rounded,secondary,shrub,slender,somewhat,spindle-shaped,stellate,stigma,style,terminal,trichome,truncate,unbranched,unknown,vein,venation,white,wiry-woody,x	0.5-1,0.7â1,0.7â2.8,1.3â4.5,1.5â2,2â3,3â4.5,3â5,4.4â11,4â6,5-merous,9â18,abaxially,accrescen,acute,adaxially,alyx,apar,axe,blade,broadly,c.,capitat,center,ciliat,climbing,color,densely,diameter,distant,eaf,eed,glabrou,immature,lamina,lanceolate,lobe,long,lower,m.,maturity,mor,nflorescence,nternode,orolla,perfec,petal,plurifoliat,pointed,reflexed,ruit,sand-punctat,sand-punctate,scandent,scar,seen,shortly,side,simple,spaced,sparsely,ste,tamen,tem,time,tip,tube,two,unit,vary,wide,ympodial	abaxial,accrescent,apart,branching,capitate,ciliate,colour,corolla,form,growth,height,inflorescence,leaf,length,na,number,ovary,plant,position,seed,shape,spacing,stem,texture,type
165	wfo-0001027630	success	149	106	67	82	39	0.45	0.5-1,0.5-1.2,0.5-2,1-5,1.4-1.7,1.5-2,4-6,5.5-11.2,6-10,acute,anther,anthesi,apart,apex,bark,base,berry,calyx,ciliate,climbing,cm,corolla,deflexed,erose,filament,fruit,fruiting,glabrate,globose,golden,green,hirsute,internodal,lanceolate,lateral,leaf,linear,lobed,long-acuminate,main,margin,mm,occasionally,opposite,pair,partially,pedicel,petiole,pore,poricidal,pubescent,scar,shaped,shrub,sparsely,stem,strongly,tear-drop,tip,trichome,tube,uniseriate,unit,vein,white,winged,young	.1,.2,.5,0.05-0.1,1-1.5,2-3,2-6-flowered,3/4,8-9,also,arising,beginning,blunt,branchlet,broadly,de,decurrent,deltoid,densely,dia,distinguishable,eaf,edicel,eed,elongat,except,extreme,free,glabrous,globo,immature,indistinct,inflorescenc,irregularly,knob-like,known,lobe,lon,long,lower,middle,midrib,minutely,near,nflorescence,novo,older,ovary,paler,papillose,portion,prominent,proximal,puberulent,raised,reflexed,rest,rounded,ruit,seen,simple,slender,spaced,stigma,straight,style,swollen,tall,tapering,terminal,thickened,ti,ud,ultimate,unifoliat,way,wide,widest,wing,x,yellowish,ympodial	2-6,breeding,cell,colour,elongate,flower,form,growth,hair,height,heteromorphism,inflorescence,length,marking,na,number,orientation,placement,plant,position,prickle,pseudostipule,rhizome,shape,spacing,spot,staman,stone,structure,symmetry,sympodial,system,texture,tuber,type,unifoliate,venation,width,xylopodia
166	wfo-0001027661	invalid_json	222	168	139	83	29	0.626	+,-10,0.5,0.5-2,0.6-1.1,0.6-1.5,1-1.5,1-5,1.2-6,1.3,1.5,1.5-2,2,2.5-7,30,4-8-celled,4.5-6,5-9,6-12,8-10,>,acuminate,acute,along,anther,apart,apex,articulate,axi,basal,base,berry,branch,branched,bright,capitate,cell,cm,commonly,cordate,corolla,deeply,dendritic,densely,denser,diameter,ellipsoid,entire,even,extremely,filament,flattened,free,fruiting,glabrous,globose,grey,growth,lamina,leaf,leaving,lengthening,like,lobe,lobed,long,lower,many,margin,minute,minutely,mixture,mm,moderately,narrowing,near,often,pale,papillate,pedicel,peduncle,peg,pentagonal,per,petiole,pinnatifid,pitted,pore,poricidal,portion,prominent,pubescence,pubescent,purple,rarely,red,reniform,ripe,scar,shape,short,simple,single,sinus,size,sleeve,slit,small,sparsely,stellate,stem,stigma,style,surface,swollen,tan,tangled,ternately,testa,time,tip,trichome,truncate,tube,turbinate,two,type,uniseriate,upper,usually,variable,vein,vine,violet,way,white,yellow,yellowish,Â¾	0.5-,1-,1-7,2.5-3,4-15,40,5-merou,6-8,6-9,<,abaxially,adaxiall,ag,alyx,anthesi,ark,broadly,calyx,column,conical,connivent,creeping,density,eaf,eed,elliptic,flower,fused,gre,green,ground,herbaceous,hue,ilament,irregularly,lateral,leaf-opposed,long-exserted,markedly,membraneous,new,nflorescence,occasionally,older,open,orolla,outline,ovate,pair,papillat,papillo,perfect,pericarp,plurifoliat,pointed,primary,pubescen,purplish,rachi,reflexed,ruit,shiny,slender,spaced,spot,spreadin,spreading,strongly,tem,terminal,thin,tightly,trailing,triangular,ud,underground,unieriate,unit,vary,wide,woody,ympodial,zig-za	'',.5-3,0.5-7,1-15,[,``,age,arrangement,articulation,bark,branching,bud,characteristic,colour,form,fruit,inflorescence,length,number,ovary,papillose,seed,spacing,texture,value,width,zig-zag,{,}
167	wfo-0001027714	success	251	126	77	174	49	0.307	/3,1.5-3,3-3.5,4.5-5,5,acute,almost,anther,apex,articulated,base,berry,branched,bright,calyx,cell,cm,connivent,cordate,corolla,deep,densely,diameter,ellipsoid,filament,flattened,fleshy,fruit,fruiting,globose,growth,inflated,inflorescence,juicy,lateral,leaf,lobed,loosely,lower,many,margin,mature,mm,occasionally,papillate,pedicel,perfect,petiole,pinnatifid,pore,poricidal,purple,red,ripe,simple,sleeve,slender,slightly,somewhat,stellate-rotate,stem,surface,terminal,thick,time,tiny,tip,trichome,truncate,uniseriate,unit,usually,vine,violet,way,woody,x	+,.5,0,0.4,0.5,0.5-0.7,0.6-0.7,0.9-1.5,1,1-,1-1.5,1-1.6,1-2,1.5-2,1.5-2.5,1.5-5,14-16,2-,2-2.5,2-8,2.5-,2.5-4,2373.,4-10,4-5,5-10,5-6,5-merou,6-7,7-20,80,<,abaxial,abaxially,acuminate,adaxial,adaxially,age,aid,along,alyx,angle,anthesi,apar,apice,appearance,ark,around,axi,basal,brown,canop,capitate,channelled,climbin,confined,conical,connected,corky,creating,cucullate,cupped,deflexed,dendritic,denser,drying,eaf,eed,elliptic,elongate,enlarged,entire,especially,exserted,fide,flower,free,furcate,giving,glabrate,glabrou,glabrous,groove,hairy,hanging,ilament,immature,individual,irregularly,lamina,large,leaving,lengthening,like,lobe,lon,long,longer,marginal,mere,minute,minutely,mpodial,nee,new,nflorescence,nodding,obovate,often,older,orolla,otherwise,outline,ovary,pair,pale,papillo,peduncle,peg,per,pericarp,petal,petiolule,pitted,plat,plurifoliat,portion,primary,prominent,pubescence,pubescent,reaching,rectangular,reddish,reniform,rim,ruit,scar,seed,shiny,showy,similar,slit,small,spaced,sparsely,spreading,stigma,strongly,style,tangled,tem,testa,testal,thecae,thickened,thin,third,tooth,tube,twining,ud,uniformly,upper,vein,visible,wall,weak,weight,widest,wing,yellow,yellowish,younger	appressed,articulation,bract,branching,breeding,broad-based,colour,connective,form,hair,heteromorphism,insertion,interjected,interpetalar,leaflet,length,marking,modification,na,needle-like,odour,orientation,paired,pattern,placement,plate,plurifoliate,position,prickle,pseudostipule,rhizome,scale,shape,smell,spot,staman,stellate,stone,structure,symmetry,sympodial,system,texture,tissue,tuber,type,vegetative,xylopodia,zygomorphy
168	wfo-0001027720	success	184	101	53	131	48	0.288	1-1.5,1-3.5,1-locular,2-branched,2-foliate,4-5.5,absent,anther,apex,articulated,base,calyx,chartaceous,cm,cuneate,directed,distally,extra-axillary,filament,fruit,fruiting,glabrous,globose,hair,inflorescence,lanceolate,leaf,length,lilac,long,lower,margin,mature,minute,mm,oblique,pedicel,perfect,petiole,pore,present,prickle,red,rhizomatous,scarce,shrub,simple,slightly,stellate,surface,tissue,unarmed,unit	%,.25-0.3,0,0-15,0.15-0.25,0.25-0.35,0.3-5,0.4-0.7,0.4-0.8,0.5-0.8,0.5-1,0.6-1.2,0.8-1,1-2,1.5-2,13-23,13-35,15-25,2-3,2-4,2-7,2.8-3.1,23-35,3-13,4-,4-7,4.3-15,4.3-7.5,5-merous,6,7-10,7-8,7-9,8-11,8-16,9-15,abaxially,absen,acute,adaxiall,adaxially,adult,alyx,apparently,axe,ba,berry,blade,brown,capitat,confined,connivent,cylindrical,deltate,densely,diameter,distall,eaf,eed,eglandular,elliptic,entire,erect,finger,flattened,flower,geminat,gland-tipped,green,half,hig,homostylous,incomplete,intepetalar,juicy,juvenile,lamina,lateral,less,lobe,loosely,markedly,mesocarp,mid-point,midpoint,midrib,narrowly,nflorescence,notched,orolla,ovate,pale,part,peduncle,per,perennial,perfec,porrect,pubescent,rachi,ray,ruit,septum,sessile,short,sparsely,stellae,stellate-pubescent,stigma,straight,style,subreniform,succulen,tamen,tem,thick,thicker,time,toward,triangular,tube,unarme,upper,vary,white,wide,without,x,yellow,yellowi,ympodial	appressed,articulation,bract,branching,breeding,broad-based,cell,colour,connective,corolla,form,geminate,growth,heteromorphism,inflated,insertion,interjected,interpetalar,leaflet,marking,modification,na,needle-like,odour,orientation,paired,pattern,placement,position,pseudostipule,rhizome,scale,shape,smell,spot,staman,stem,stone,structure,symmetry,sympodial,system,texture,trichome,tuber,type,vegetative,xylopodia
169	wfo-0001027720	success	272	120	76	196	44	0.279	0.8â1.3,0.8â1.9,1.5â2.5,1.5â9.0,3.2,3.6,3.7â5.7,anther,apex,apical,armed,articulated,attenuate,base,berry,broad-based,calyx,cm,concave,corolla,developed,diameter,distally,entire,extra-axillary,filament,fruit,glabrous,globose,gradually,growth,hair,homostylous,increasing,interpetalar,lateral,lavender,leaf,long,margin,mature,minute,mm,narrowly,oblong,occasionally,orange,pedicel,petiole,poorly,pore,porrect-stellate,prickle,red,sessile,short,shrub,side,simple,slightly,small,sparsely,stellate,stellate-pubescent,straight,subcoriaceous,tissue,tree,triangular,twice-branched,unarmed,violet,wavy,wide,yellow-ferruginous,Ã	.0,.04,.2,.3,.5,.9,0,0.1â0.6,0.2â0.4,0.3â0.4,0.7â0.9,0.7â1.1,0.7â1.2,0.8â2.0,0.9,1.4â1.9,1.5â1.7,1.5â2.0,1.5â3.3,1.7â1.8,1.7â2.0,1.7â2.5,1.8â2.0,1.9â2.2,1/2,1/3,1/3â1/2,10.0,10.8â18.2,12â16,13.0,19.7â30.0,2.0,2.5,2.5â2.8,2.5â2.9,2â3,3.9,4.0â12.6,4.0â18.0,4â5-merou,5.1â18.6,6.5â9.5,6â8,8.0,8.0â11.9,8.2â10.5,8.5â9.4,9.5â16.0,abaxially,acuminate,acute,adaxially,adnate,aequilateral,alyx,anthesi,apiculate,apparently,appearing,attachment,axe,ba,becoming,bilobed,blade,branch,broad,brochidodromous,bud,cancellate,capitate,channel,channeled,colore,congested,conical,connivent,cream,crisped,curved,deciduous,dehiscence,densely,dentate,difoliate,dorsally,dry,eaf,eed,either,elliptic,emerging,endocarp,erect,especially,exocarp,fertile,filiform,flattened-irregular,flattened-orbicular,flattened-reniform,flower,free,geminat,glandular,glossy,heavily,hooked,inclined,internode,intersepalar,juic,juvenile,lamina,large,least,like,line,lobe,lon,longer,lower,m.,major,midpoint,midrib,midvein,minor,moderately,nearly,nflorescence,notched,oblique,often,orolla,ovate,part,peduncle,per,perforate,point,porrect,portion,potentially,presumably,proximal,pubescent,raised,ray,reflexed,rigid,rip,row,ruit,scattered,shorter,sinus,soon,splitting,spread,stamen,stellae,stellate-pubescen,stem,stigma,style,subacute,surface,suture,tall,tamen,tem,thin,time,tip,toward,translucent,truncate,tube,two,ud,upper,vary,vein,way,weakly,white,yellow,yellow-ferruginou,yellow-tan,ympodia,young,youngest,Â±equal,â4	appressed,articulation,bract,branching,breeding,cell,colour,connective,difuoliate,form,fruiting,geminate,heteromorphism,inflated,inflorescence,insertion,interjected,leaflet,length,marking,modification,na,odour,orientation,paired,pattern,placement,position,pseudostipule,rhizome,scale,shape,spot,staman,stone,structure,symmetry,sympodial,system,texture,tuber,type,unit,xylopodia
170	wfo-0001027757	success	186	110	51	135	59	0.274	0.5,12,anther,apex,axillary,base,blue,branching,brown,calyx,campanulate,cell,cm,colour,filament,fruit,glabrous,globose,hair,leaf,lilac,long,margin,mm,moderately,multicellular,oblong,ovate,pale,pedicel,perennial,petiole,plurifoliate,pore,poricidal,pubescent,rootstock,rotate,serrate,shrub,simple,sparsely,stone,tip,unbranched,uniseriate,unit,unknown,violet,woody,x	0.2,0.2â0.3,0.3â2.0,0.6,0.6â1.0,0.7,0â1.4,1.0â1.1,1.0â2.5,1.2â4.0,1.5â1.6,1.5â2.5,1.6â2.4,1.9â2.7,1â1.5,1â11,1â2,1â3,2,2.5,2.5â4,2.5â5.5,2.5â7,2â,2â10,3â12,3â5,4â9,5,5â,60â100,6â9,7â8,8â16,abaxially,absen,accrescent,acute,adaxiall,adaxially,ag,along,anthesi,apart,apical,arising,articulated,axe,ba,basal,blade,borne,chartaceous,clavate,concave,connivent,convex,cylindrical,dark,decurrent,deeply,densely,diameter,directed,distally,eaf,eed,elliptic,entire,equal,erect,erose,flattened,fleshy,flower,geminat,glabrescen,glabrou,irregularly,lanceolate,leafy,lobe,lobed,lon,longitudinal,lower,m.,narrowly,nflorescence,obtuse,occasionally,often,opening,opposed,orolla,pair,peduncle,perfect,pitted,primary,probably,regularly,ruit,secondary,shoot,side,slit,smaller,sometimes,spaced,stigma,straight,style,surface,tall,tamen,tem,thic,thickened,time,toward,tube,unicellular,vary,white,wide,yellow,ympodial,â19,â2.7,â3.2,â4.0,â5.5,â6,â9	0-1.4,0.3-2.0,1-1.5,1.2-4.0,2.5-5.5,2.7,4-9,5.5,60-100,abaxial,absent,adaxial,articulation,bract,connective,corolla,decurred,form,fruiting,green,growth,height,heteromorphism,history,inflorescence,insertion,interjected,interpetalar,leaflet,length,life,marking,mature,modification,na,odour,orientation,paired,placement,plant,position,prickle,pseudostipule,rhizome,scale,shape,size,spot,staman,stem,structure,symmetry,sympodial,texture,thicknes,tissue,tuber,type,xylopodia
171	wfo-0001027765	success	167	141	86	81	55	0.515	-30,-44,0.8,1,1-10,1-11.5,1-4,1-5,1.5-6,10-13,2-2.5,2-4,2.5-4.2,20-30,3-,3-12,3-20,5-15,5-6,5-8,7-20,apex,apical,apiculate,base,branched,calyx,cell,cm,connate,cordate,corolla,cyme,dehiscent,diameter,dichasial,dichasially,distal,filament,flower,glandular,globose,green,hair,herbaceous,interjected,introrse,lateral,leaf,leaflet,light,long,maturing,mm,monochasial,mucilaginous,odd-pinnate,often,ovoid,pattern,pedicel,peduncle,perennial,perfect,petiole,pilose,plant,proximal,seed,short,simple,size,slit,stellate,stigma,straight,style,terminal,throughout,tone,tuber-bearing,unit,violet,white,wide,Â¼	-4,0-.,1-,1-2,2-3,2.5-4,3-6-foliat,5,abaxial,abaxially,abruptly,acumen,acuminate,acute,apically,articulate,covering,cuneate,digestion,diminishing,dorsally,eaf,ebracteate,edge,eed,elliptic,elliptic-lanceolate,emoval,enzyme,exceeding,flat,folded,forked,generally,globo,green-white,hair-like,half,honeycomb,living,lobe,lon,lower,lunat,make,nflorescence,nther,oblique,obtuse,orolla,ovate,ovate-elliptic,ovate-lanceolate,pair,petiolate,petiolule,plan,poricidally,reveal,rounded,ruit,sessile,seudostipule,side,slightly,specimen,stamen,tal,tem,testal,thick,throughou,tip,toward,truncate,typically,vary,wall,without,yellow,ympodial	0-2,3-6-foliate,anther,apicidally,arrangement,articulation,bract,branching,breeding,colour,connective,ebbrate,form,fruit,fruiting,growth,height,heteromorphism,inflorescence,insertion,interpetalar,length,lunate,margin,marking,modification,na,number,odour,orientation,ovary,paired,placement,pore,position,prickle,pseudostipule,rhizome,scale,shape,spot,staman,stem,stone,structure,symmetry,sympodial,system,texture,tissue,tuber,type,wet,width,xylopodia
172	wfo-0001027807	success	116	90	73	43	17	0.629	0-0.2,0.1-1,0.2-0.9,0.9-1,1-1.5,15-30,2-6,acuminate,acute,apex,attenuate,bark,base,berry,brittle,brown,bud,closely,cm,diameter,dry,drying,elliptic,flattened,flower,fruiting,glabrous,globose,gray,grayish,green,growth,internodal,lanceolate,leaf,leaf-opposed,margin,material,midrib,minutely,narrowly,new,occasionally,older,overlapping,pair,pale,paler,papillate,pedicel,peduncle,petiole,pitted,primary,reddish,reniform,revolute,scar,seemingly,shrub,simple,slightly,small,spaced,sparsely,stem,surface,thickened,tree,vein,white,winged,yellowish	.5,0.2-0.3,0.3-0.4,0.9-2.5,2-5,3.5-9,abaxially,adaxially,almost,barely,decurrent,deflexe,deflexed,difoliate,eaf,eed,ellipti,geminat,know,known,maturity,mm,nflorescence,ot,papillae,parallel,plane,prominent,rachi,reddi,reproductive,ruit,shoot,slender,somewhat,ud,unifoliate,unit,usually,visible,x,ympodial,young	arrangement,brittlenes,colour,form,fruit,inflorescence,length,na,number,papilla,position,seed,shape,spacing,texture,type,winging
173	wfo-0001027816	invalid_json_followup	187	139	86	101	53	0.46	.5,0.5,0.5-1,0.6-0.8,1,1-3,1.2-2,1.5-2,12-14,4-5,<,acuminate,acute,anther,apex,articulated,attenuate,base,becoming,berry,bluish,branched,brown,calyx,capitate,cm,corolla,dark,densely,diameter,ellipsoid,entire,filament,filiform,flattened,fleshy,flower,fruiting,glabrous,gland-tipped,glandular,globose,growth,inflorescence,lateral,leaf,lower,margin,minute,minutely,mm,occasionally,often,orange,patent,pedicel,peduncle,per,perfect,petiole,pitted,pore,poricidal,pubescent,purple,reddish,reniform,several,shrub,simple,sparsely,stellate,stem,stigma,style,surface,terminal,time,tip,trichome,tube,uniformly,uniseriate,upper,variable,x	..,0.2,0.5-2,0.7-1,1-1,1-1.5,1-4,1.8-6,2-2.5,2-4,2/3,3-3.5,3.5-4,5-30,5-merou,6-9,ag,almost,along,alyx,anthesi,apar,ark,axi,cell,confined,conical,connivent,cupped,dense,drying,eaf,eed,em,erect,exserted,free,half,ilament,irregularly,lanceolate,leaving,lengthening,less,like,linear,lobe,lobed,loosely,m.,markedly,new,nflorescence,nodding,older,orolla,pair,papillo,peg,perhaps,pericarp,plant,plurifoliat,portion,primary,prominen,pubescen,rectangular,red,ripe,rounded,ruit,scar,shiny,sleeve,slightly,slit,small,sometimes,somewhat,spaced,sparse,spreadin,spreading,square,testal,thin,triangular,twinin,ud,ultimate,unit,usually,vary,vein,viscous,way,woody,yellowish,ympodial,Â½	'',[,``,appressed,articulation,bract,branching,breeding,broad-based,characteristic,colour,connective,form,fruit,hair,inflated,insertion,interjected,interpetalar,leaflet,length,marking,mature,modification,na,needle-like,number,odour,orientation,ovary,paired,papillose,pattern,placement,position,prickle,pseudostipule,pubescence,rhizome,scale,seed,shape,smell,spot,symmetry,system,texture,tissue,type,value,vegetative,{,}
174	wfo-0001027819	success	199	135	93	106	42	0.467	1-2,1-5,10-20,10-50,2-15,20-35,25-35,3-40,4,4-10,4-15,4-25,4-5,5-6,5-merous,8-10,abaxially,adaxially,apex,apical,base,cell,cm,concave,connective,cordate,cuneate,cylindrical,deeply,densely,directed,distally,ellipsoidal,elliptic,fading,finely,fleshy,flower,forked,fruit,glabrous,globose,green,hair,leaf,length,lobed,long,margin,mesocarp,mm,moderately,narrowly,near,oblong,obtuse,occasionally,ovate,pedicel,peduncle,per,perfect,petiole,pore,present,probably,protuberance,puberulent,purple,rachi,rugose,simple,sparsely,stellate,stigma,stone,style,subcoriaceous,sympodial,tree,triangular,truncate,two,umbrella-shaped,unbranched,unit,unknown,unlobed,usually,whitish,wide,x,yellow	-100,0.5-1,1,1-,1.5-2,12-21,15-22,16-25,2,2-,2-3,20-25,20-40,22-35,3-5,3-5-lobed,5,9-12,acute,aggregate,also,alyx,apart,ape,apiculat,articulated,axe,ba,basal,beyond,blade,branched,ciliate,color,denser,dia,diamete,diameter,dilated,divided,eaf,eed,eglandular,eglandular-pilose,elliptic-ovate,entire,equal,especially,exceeding,except,exserted,halfway,leaving,lobe,lon,lower,main,midrib,narrow,nflorescence,nther,oblique,obtu,often,orolla,pedicellar,perfec,pilose,pinnately,prominent,puberulen,puberulence,purplish,radiu,ranch,rarely,ratio,remnant,ripe,rounded,rown,ruit,runk,shallowly,short-acuminat,shorter,sinus,slightly,small,sometimes,spaced,stamen,strongly,swelling,tal,thecae,toward,tube,ud,uni,vary,vein,villous,width,without,young	anther,arrangement,articulation,berry,branching,breeding,bud,calyx,colour,corolla,crown,filament,form,growth,height,heteromorphism,inflorescence,insertion,marking,modification,na,odour,orientation,ovary,pattern,placement,plant,position,prickle,pseudostipule,rhizome,seed,shape,spot,staman,structure,symmetry,system,texture,tuber,type,xylopodia
175	wfo-0001027834	success	236	103	55	181	48	0.233	1-1.9,1-10,2.3-3.4,accrescent,acute,anther,apex,base,berry,blunt-tipped,branched,branching,calyx,cm,completely,connivent,corolla,covering,dendritic-echinoid,discolorous,echinoid,ellipsoid,entire,enveloping,equal,filament,fleshy,fruit,fruiting,globose,granular-tomentose,hair,leaf,many,margin,mm,multangulate,obtuse,pedicel,petiole,plurifoliate,pore,poricidal,rounded,shrub,simple,small,stellate,subcoriaceous,time,tip,tree,unit,white,yellow	-6.1,.5-3,0-110,0.2-0.3,0.2-0.4,0.2-0.6,0.4-1.1,0.5-2,0.9-1.8,1-1.6,1-2.5,1.1-1.6,1.1-1.8,1.4-2,1.6-2.7,1.8-4.9,1/2,10-25,2-3.8,2-8,2.2-4.3,2.4-6.2,2.7-7.3,2.9-4.2,25,3-15,3-4.3,4-5.2,4-6,4.8-6.9,5-20,5-merous,5.1-8,6.9-18.1,9-11.9,9-13,abaxial,abaxially,absent,acuminate,adaxial,adaxially,ag,alyx,angled,anthesi,apar,apical,around,articulated,attenuate,axillary,ba,bark,becoming,blade,branch,brown,bud,capitat,closely,concentrated,coriaceous,crown,cylindrical,deltoid,dendritic-echinoi,densely,diameter,dichasia,directed,distally,drying,eaf,echinoi,edge,eed,enclosing,erec,exserted,farinose,finely,flat-topped,flower,forming,glabrescent,glabrous,gray,grooved,high,included,inserted,lengthening,lenticular,less,light,lobe,lobed,long,long-stalked,longitudinal,longitudinally,lower,mostly,multangulat,near,nflorescence,numerous,obovate,obscured,older,orbicular,orolla,ovate,ovate-elliptic,ovate-lanceolate,pair,peduncle,perfec,persistent,porrect-stellate,primary,pseudo-terminal,pubescence,pubescent,rachi,rarely,ray,reticulate-punctate,ripe,ruit,runk,scabridulous,scar,semi-ovate,semi-spherical,sessile,short,short-stalked,slit,soft,sometimes,somewhat,spaced,sparsely,spreading,stalked,stamen,stellate-pubescent,stem,stigma,style,subcampanulate,surface,suture,tamen,though,tomentose,tomentu,tomentum,toward,trichome,tube,turbinoid,ud,unarme,usually,vary,vein,velutinous-tomentose,villous,way,whitish,whitish-tomentose,wide,x,yellowish,yellowish-tan,yellowish-tomentose,ympodial,young	appressed,articulation,bract,breeding,cell,colour,connective,dichasial,form,growth,heteromorphism,inflated,inflorescence,insertion,interjected,interpetalar,leaflet,length,marking,mature,modification,na,odour,orientation,paired,pattern,perfect,placement,position,prickle,pseudostipule,pseudoterminally,rhizome,scale,shape,spot,staman,stone,structure,symmetry,sympodial,system,texture,tissue,tuber,type,xylopodia,zygomorphy
176	wfo-0001027843	success	154	115	60	94	55	0.39	.75,0.5-1,0.8-3.5,1-1.3,1-1.5,1.2-1.5,2-2.5,5-6,acute,anther,anthesi,apex,base,berry,broadly,calyx,clavate,cm,conical,corolla,densely,erose,filament,flower,fruiting,glabrous,globose,green,leaf,lobed,lower,margin,mm,nearly,opposite,ovary,ovate,pedicel,pore,poricidal,pubescent,shape,shaped,shrub,simple,somewhat,stem,stigma,style,surface,tapering,tear-drop,tip,trichome,tube,uniseriate,unit,way,white,x	.5,/3,0.5-0.75,1-1.2,1.2-2.5,2-4,3-15-flowered,3-6,6-13,6-9,along,apart,apiculate,ba,bark,bearing,becoming,beginning,beneath,coroll,curly,deflexed,deltoid,denser,dia,differing,difoliate,distally,eaf,edicel,eed,ellipsoid,exsertion,free,geminat,glabrate,hairy,impressed,irregularly,known,lamina,larger,later,lateral,like,lobe,lon,long,long-acuminate,main,major,middle,minor,minutely,near,nflorescence,occasionally,older,one,orbicular,pair,papillo,papillose,petiole,pleated,portion,prominent,proximal,reddish-gre,reflexed,rounded,ruit,scar,sinus,size,slender,slightly,spaced,sparsely,sparser,stiff,straight,strongly,tall,time,tipped,two,ud,vein,widest,winged,woody,ympodial,young	1/3,3-15,abaxial,adaxial,articulation,bract,branching,breeding,broad-based,cell,colour,connective,diameter,form,fruit,growth,hair,height,heteromorphism,inflorescence,insertion,interjected,interpetalar,leaflet,length,marking,modification,na,needle-like,number,odour,orientation,paired,pattern,placement,plant,position,presence,prickle,pseudostipule,rhizome,scale,seed,spot,staman,stone,structure,symmetry,sympodial,system,texture,tissue,tuber,type,xylopodia
177	wfo-0001027847	success	219	106	61	158	45	0.279	-6,/3,0.4-1,2-4,5-6,5.5-8,anther,apex,articulated,base,berry,branched,calyx,chartaceous,cm,connivent,cordate,curved,densely,elongating,equal,erect,filament,fruit,fruiting,lateral,leaf,length,lobed,long,lower,margin,mature,maturity,mauve,mm,orange,pedicel,perpendicular,petiole,poricidal,prickle,purple,red,retrorse,rounded,shrub,simple,sparsely,spherical,stellate-pubescent,stem,straight,surface,tapering,terminal,tip,trichome,unit,way,white	-0.8,-2,-2.5,-3,-4,-5,.35,.7,/2,0,0-2,0-7,0.1-0.4,0.15-0.2,0.2,0.5,0.5-1,0.8,0.8-0.9,0.8-1.2,1,1-2,1-2.5,1.5-2,1.5-2.5,1.5-5,1.9-2.3,1/2,1/4,1/6-1/3,2-2.8,2-3,2-5,2.2-3,2.5-3.5,2/,3-15,3-5,3-6,3.5-6,4-5-merous,5-25,6-11,6-8,7-10,abaxially,acute,almost,alyx,ame,apar,apart,apically,apparently,bark,blade,broadly,brow,c.,deltate,diameter,dimorphic,discolorous,distance,drying,dull,eaf,edge,eed,elliptic,evenly,extending,faint,filiform,filiform-acuminat,finely,flattened,flattened-reniform,flower,free,geminate,glabrescent,glabrous,gray,green,increasing,infructescence,lobe,lon,longer,middle,midpoint,midvein,minor,moderately,narrow-deltate,nflorescence,older,one,open,orange-brown,orbicular,orolla,oung,ovate,pair,peduncle,pendulous,per,perfec,pericarp,pit,pitted,plurifoliat,porrect,portion,prickl,prickly,primary,ray,red-brown,reddish,ruit,scandent,scar,seed,sessile,side,size,slender,smooth,sometimes,spaced,spreading,stalk,stalked,stellate,strongly,style,tamen,terete,tertiary,time,toward,tube,unarmed,upper,usually,variously,vary,vein,venation,visible,weakly,wide,yellow,ympodial,young	appressed,articulation,bract,branching,broad-based,cell,colour,corolla,form,growth,hair,heteromorphism,inflated,inflorescence,insertion,interjected,interpetalar,leaflet,marking,na,needle-like,odour,orientation,paired,placement,plurifoliate,position,pseudostipule,rhizome,scale,shape,smell,spot,staman,stone,structure,symmetry,sympodial,texture,tissue,tuber,type,vegetative,xylopodia,zygomorphy
178	wfo-0001027872	invalid_json_followup	190	187	132	58	55	0.695	1,1-4,1-8,10,12-35,15,2,2-3,2.2-3.5,20,35,4-6,5-7,5-8,5-lobed,6-20,8-11,abaxially,acuminate,acute,adaxially,angular,apex,apical,apically,articulate,b,base,becoming,branched,ca,calyx,celled,clasping,cm,commonly,connate,cordate,cuneate,cyme,decreasing,deep,dehiscent,densely,diameter,dichasial,dichasially,distal,elliptic,erect,filament,flower,forked,four-celled,generally,glabrescent,gland,glandular,glandular-pubescent,globose,gray-green,green,hair-like,half,herbaceous,homogeneously,interjected,introrse,lanceolate,lateral,leaflet,light,longer,maturing,middle,mm,moderately,monochasial,mottled,mucilaginous,narrowly,nearly,obliquely,odd-pinnate,often,ovate,ovoid,pair,pattern,pedicel,peduncle,perennial,petiolule,plant,poricidally,puberulent,pubescent,purple,rarely,rhizomatous,rhizome,rotate,rounded,seed,semi-lunate,shape,short,single,size,slightly,slit,sometimes,somewhat,stigma,straight,style,subequal,symmetrically,terete,terminal,tinged,tip,trailing,type,typically,unbranched,unit,usually,wall,wider,yellow,yellowish-green	0.5,1-1.2,1.0-1.3,1.5-4,2.8,3-6-foliat,5-10,acumen,apiculate,ba,basal,caudate,cell,covering,digestion,eaf,ebracteate,eed,emoval,enzyme,exceeding,externally,globo,green-white,honeycomb,living,lobe,lon,long,lower,make,nflorescence,nther,oblong,orolla,pentagonal,perfect,petiolate,petiolulate,purpl,reduced,reveal,rotate-,ruit,sessile,seudostipule,specimen,stamen,ste,tem,testal,thick,uniformly,vary,viole,wid,wide,ympodial	'',3-6-foliate,[,``,anther,arrangement,articulation,bract,branching,breeding,characteristic,colour,connation,connective,corolla,dehiscence,ebbrate,forkednes,form,fruit,glandularity,growth,habit,hair,height,inflorescence,leaf,length,marking,modification,mottling,na,number,ovary,petiole,pore,position,presence,present,property,pseudostipule,pubescence,rotate-pentagonal,spot,stem,structure,symmetry,sympodial,system,texture,value,violet,width,{,}
179	wfo-0001027880	success	185	81	50	135	31	0.27	0.5-5,0.8-1.5,2-3,anther,apex,base,branching,calyx,cell,cordate,coriaceous,entire,extra-axillary,filament,fruit,fruiting,globose,greenish,inflorescence,leaf,leaf-opposed,longitudinal,margin,minutely,mm,nearly,oblong,ovoid,perfect,petiole,pink,plurifoliate,pore,purple,red-brown,revolute,ripe,shrub,simple,slit,somewhat,stellate,stone,truncate,unbranched,undulate,unit,vine,white,x	-3,-3.5,.25,0.3-3,0.5-1.5,0.6-1,0.6-1.5,1-14,1-15,1-2,1-2.5,1-3,1.5-2,1.5-3,10-15,2-80,2/,3-4,4-10,4-6,5-11,5-8,5-merou,8,abaxially,absen,accrescen,acuminate,acute,adaxially,ag,aggregate,along,alyx,apart,apiculate,apparently,articulated,axe,ba,blade,branch,chartaceous,ciliat,clavate,cm,conical,connivent,contiguously,curled,cylindrical,deltate,dense,densely,diameter,diminishing,directed,discolorous,distally,distichous,distinct,distinctly,eaf,eed,epiphytic,equal,flattened,flower,geminat,glabrous,green,growing,hair,increasing,internode,line,lobe,long,longer,lower,midvein,multicellular,nflorescence,node,oblique,oblong-ovate,occasionally,often,opening,orolla,ovate,pair,pale,papillose,pedicel,peduncle,point,pubescen,pubescent,rachi,reddish,rooting,rounded,rugulose,ruit,scar,secondary,size,slender,slightly,sometimes,spaced,sparsely,ste,stigma,style,surface,tamen,tan,tem,thickened,time,tip,trailing,tree,trunk,tube,typically,uniseriate,usually,vary,vein,wide,yellow,ympodial	absent,accrescent,age,arrangement,breeding,colour,corolla,form,growth,heteromorphism,length,marking,na,odour,orientation,placement,position,prickle,pseudostipule,rhizome,shape,spot,staman,structure,symmetry,sympodial,system,texture,tuber,type,xylopodia
180	wfo-0001027880	success	170	130	67	103	63	0.394	0.2-0.5,0.5,2-80,absent,acute,anther,apex,apiculate,arrangement,base,bluish-purple,calyx,chartaceous,cm,conical,cordate,coriaceous,curled,densely,diameter,distichous,entire,extra-axillary,filament,flower,fruit,glabrous,globose,greenish,hair,leaf,leaf-opposed,lower,margin,membranous,midvein,mm,nearly,oblique,oblong-ovate,ovate,ovoid,pedicel,peduncle,petiole,pink,pubescent,rachi,red,reddish-brown,rounded,rugulose,simple,slender,sparsely,stellate,surface,trichome,truncate,unbranched,undulate,uniseriate,unit,vine,white,woody,x	.25,0.3â3,0.5â1.5,0.5â5,0.6â1,0.6â1.5,0.8â1.5,1.5â2,1.5â3,10â15,1â14,1â15,1â2,1â2.5,1â3,2/3,2â3,3â4,4â10,4â6,5-merous,5â11,5â8,8,abaxially,accrescen,acuminate,adaxially,along,alyx,apar,axe,berry,blade,c.,capitat,ciliat,clavate,climbing,contiguously,cylindrical,deltate,dense,discolored,distinct,distinctly,eaf,eed,flattened,fruiting,green,lanceolate,line,lobe,long,longer,m.,minutely,mottled,nflorescence,nternode,occasionally,often,orolla,pair,pale,papillose,perfec,pinnate,plurifoliat,reddish,revolute,rip,ruit,sand-punctat,sand-punctate,scar,secondary,shrubby,slightly,sometimes,somewhat,spaced,ste,stigma,style,tamen,tan,tem,thickened,time,tip,tree,trunk,tube,typically,vary,vegetatio,vein,venation,wide,ympodial,â3.5	-3.5,0.5-1.5,0.6-1.5,0.8-1.5,1-14,1-15,1-2,1.5-2,1.5-3,10-15,2-3,4-10,5-8,bract,branching,breeding,broad-based,cell,colour,connective,corolla,form,growth,heteromorphism,inflorescence,interjected,internode,interpetalar,leaflet,length,marking,mature,na,needle-like,number,odour,orientation,pattern,perfect,placement,plurifoliate,position,prickle,pseudostipule,rhizome,scale,seed,shape,smell,spot,staman,stem,stone,structure,symmetry,sympodial,system,texture,tissue,tuber,type,vegetative,xylopodia
181	wfo-0001027881	success	215	141	81	134	60	0.377	-3,5-merous,abundant,acute,anther,apex,articulated,attenuate,base,berry,blackish,camptodromous,chartaceous,ciliate,cm,commonly,connivent,cordate,cordiform,cylindrical,decurrent,densely,diameter,difoliate,eglandular,entire,extra-axillary,filament,flattened,flower,fruit,geminate,glabrous,glandular,globose,greenish,groove,hair,herb,immature,interpetalar,introrsely,lateral,leaf,light-brown,lower,margin,membranaceous,mm,moderately,ovate-elliptic,parallel,pedicel,per,petiole,pore,projection,pubescence,pubescent,raised,reniform,rotate,seed,simple,slightly,solitary,sparsely,staman,stem,stigma,style,subapically,subopposite,surface,tissue,translucent,unbranched,unit,venation,white,yellow	.3â0.5,0.5â2.2,0.8â1.5,1-celled,1.3â2,1.8â2.9,10â25,1â2,1â2-celled,1â2.5,1â2.6,1â3,1â3-celled,1â4,2.5â3.6,20â40,2â4,2â6,2â7,4â6,4â9.5,5,6â10,7â14,7â9,8,abaxially,absent,accrescent,acuminate,adaxiall,adaxially,almost,alyx,appressed,asymmetric,axe,ba,barely,blade,bulge,calyx,capitat,case,central,closely,connected,contiguous,curved,dehiscing,denser,directed,dorsally,drying,eaf,ed,emarginate,emerging,equal,erect,exceeding,exclusively,explosively,eye,few-,fewer,forming,frequent,giving,half,held,hollow,impression,larger,less,like,lobe,long,longer,longitudinal,mainly,many-branched,maturit,maturity,mesocarp,mixed,much,multicelled,multicellular,naked,near,netlike,nflorescence,normally,one,opening,orolla,other,pair,part,peduncle,perfec,placenta,pressure,primary,prominent,rachi,ruit,secondary,sessile,short,side,similar,size,slit,small,smaller,sometimes,stalk,stamen,tal,tamen,tem,triangular,tube,two,vary,vein,visible,watery,winged,woody,ympodial,Ã	0.3-0.5,0.5-2.2,1-2,1-2.5,1-3,10-25,20-40,4-6,6-10,7-14,7-9,arrangement,articulation,branching,breeding,broad-based,capitate,cell,colour,connective,corolla,decurrency,dried,form,glabrousnes,growth,height,heteromorphism,inflorescence,length,marking,mature,merosity,modification,na,needle-like,number,orientation,ovary,pattern,perfect,placement,plant,position,prickle,pseudostipule,rhizome,shape,spot,stellate,stone,structure,symmetry,sympodial,system,texture,trichome,tuber,type,xylopodia
182	wfo-0001027882	success	184	124	104	80	20	0.565	0.5-1,1-1.5,1.5-2,1.5-2.2,1.5-6,2-6,2.1-2.6,3-4,3.5-4,3.5-5,4-5,9-13,acuminate,age,anther,apart,apex,apparently,appearing,attenuate,bark,base,berry,branch,branched,branching,broadly,brown,c.,calyx,cm,completely,conical,corolla,dark,deltate,diameter,drying,elliptic,entire,erect,exerted,filament,flattened,flower,fork,fusiform,glabrous,globose,green,growth,hairy,inflorescence,irregularly,leaf-opposed,lengthening,less,lobe,lobed,margin,maturity,minutely,mm,new,ovoid,pair,pale,pedicel,perfect,petiole,pitted,plane,pointed,pore,poricidal,primary,rachi,reddish,reniform,scar,shiny,shrub,simple,slit,small,sometimes,spaced,sparse,sparsely,stem,strongly,surface,time,tip,tree,trichome,tube,uniseriate,vein,way,white,x,yellow,yellowish	.25,.5,0.1,06a,1,1-5,1.5-,1.6-2.2,10-25,10-40,2-3,2-lobed,2.5-3,3.2-6,6-9,7-,abaxially,absent,adaxially,along,anthesi,axil,caly,clavate,cucullate,dense,densely,difoliate,dry,eaf,eed,et,fide,free,fruiting,geminat,glabrou,hollow,hooked,junction,kallunki,lamina,lower,markedly,midrib,nflorescence,nodding,occasionally,ovary,papillat,papillate,paulo,peduncle,penden,planar,population,portion,pulp,rarely,red-papillat,ruit,shattering,slender,specimen,sticky,stigma,stout,straight,structurally,style,sweet-scented,swollen,sÃ£o,thickened,tuft,ud,unit,usually,woody,ympodial	abaxial,adaxial,bud,colour,form,fruit,hair,leaf,length,marking,na,position,red-papillate,seed,shape,size,spot,symmetry,texture,type
183	wfo-0001027889	success	151	163	113	38	50	0.748	-2.5,-pubescent,.5,0,0.5-1,0.5-11,0.7-2,1,1-3,1-3.5,1.5,10-12,10-20,10-30,2-3,3-4,3-8,3-9,5-10,abaxially,acuminate,acute,acute-acuminate,adaxially,apart,apex,basal,base,beyond,calyx,cell,chartaceous,cm,connective,connivent,cylindrical,darker,densely,diameter,dilated,directed,distally,eglandular-puberulent,eglandular-pubescent,elliptic,entire,equal,exceeding,extending,finely,flower,fruit,glabrous,glandular-,green,greenish,immature,introrse,laterally,leaving,length,light,lobe,long,longitudinal,lower,margin,mm,moderately,narrow,oblong,ovate,ovoid,pedicel,pedicellar,peduncle,perfect,petiole,pore,present,probably,puberulent,puberulent-pubescent,rachi,radiu,remnant,ripe,shrub,simple,slightly,somewhat,sparsely,stamen,stellate,stigma,stone,stripe,style,subcordate,subcoriaceous,swelling,thecae,tomentose,tree,triangular,truncate,tube,unbranched,unknown,violet,white,x,yellowish	.5-2,1-10,1.5-2,2-20,4-foliat,aggregate,ape,apiculate,articulated,axe,blade,capitat,color,deltate,eaf,eed,exserted,lon,nflorescence,nther,orolla,presen,puberulen,puberulent-pubescen,ruit,small,spaced,tal,tem,time,tip,tomento,ud,unit,vary,wide,yello,ympodial	abaxial,adaxial,anther,articulation,branching,breeding,broad-based,bud,capitate,colour,corolla,exsertion,filament,form,fruiting,growth,hair,height,heteromorphism,inflorescence,leaf,marking,mature,modification,na,needle-like,orientation,ovary,pattern,placement,plant,prickle,pseudostipule,rhizome,shape,spacing,spot,staman,stem,surface,symmetry,system,texture,theca,trichome,tuber,type,xylopodia,yellow,zygomorphy
184	wfo-0001027901	success	156	125	87	69	38	0.558	.5,0.3-1.2,0.5-1,0.8-1,0.8-2,0.9-2.3,1-1.5,1-2.5,1.5-1.8,1.8-4.5,2.5-3,3-5,4-5,4.7-12,abaxially,acuminate,acute,adaxially,anther,anthesi,apex,area,attenuate,bark,base,bright,broadened,brown,cm,corolla,dark,difoliate,direction,dry,elliptic,filament,fresh,fruiting,glabrous,globose,green,immature,inflorescence,leaf,lobed,lower,major,material,minor,minutely,mm,nearly,opposite,orbicular,oriented,ovary,ovoid-reniform,papillose,pedicel,petiole,pitted,pore,pubescent,ripe,rounded,shape,shaped,shiny,shrub,simple,single,size,stem,stigma,style,surface,swollen,tear-drop,translucent,trichome,tube,uniseriate,unit,usually,white,x,yellow	.25,1-2,4-10-flowered,6-7,?,abaxial,ba,beneath,berry,brow,calyx,closely,conical,curled,deflexed,densely,dia,differing,drying,eaf,edicel,eed,ellipsoid,exserted,firm,fleshy,free,geminat,imbedded,keeled,later,lateral,like,lobe,lon,long,main,matrix,middle,midrib,nflorescence,older,overlappin,pair,papillo,planar,poricidal,portion,prominently,reddish,reflexed,rest,ruit,scar,slender,spaced,sparsely,straight,strongly,tall,tip,triangular,tub,ud,vein,widest,woody,ympodial,young	0.25,0.5,1,2,articulation,broad-based,cell,colour,diameter,form,fruit,geminate,growth,height,heteromorphism,insertion,length,margin,na,needle-like,odour,orientation,paired,placement,plant,position,prickle,rhizome,seed,staman,stone,structure,symmetry,sympodial,texture,tuber,type,xylopodia
185	wfo-0001027902	invalid_json	128	113	82	46	31	0.641	-2.5,0.5-1,1-1.5,1-2,1-6,10-20,15-30,2-12,2-15,2-8,2-9,20-50,3-4,3-5,4-25,4-5,5-20,6-37,7-9,abaxially,acute,adaxially,angled,apart,apex,base,branched,chartaceous,cm,cordate,cylindrical,deeply,densely,diameter,distally,eglandular,entire,flower,forked,fruit,glabrous,glandular,globose,hair,lobe,long,margin,mm,moderately,narrowly,nearly,obtuse,ovate,pedicel,peduncle,petiole,pore,puberulent,pubescent,purple,purplish,rachi,remnant,reticulate,shrub,simple,small,sparsely,stellate,stigma,style,subcoriaceous,tree,triangular,truncate,tube,unbranched,unknown,usually,whitish,x,yellow	1.5-3,10-15,2,2-3,3-foliat,8-13,absen,acuminate,adaxiall,aggregate,articulated,axe,blade,calyx,cell,color,connivent,directed,distall,eaf,eed,inflated,leaving,like,lon,lower,nflorescence,nther,orolla,pedicellar,pubescen,radiu,ripe,ruit,spaced,ste,stone,tal,tem,time,tip,truncat,unit,vary,wide,ympodial	'',[,``,abaxial,adaxial,anther,articulation,axi,branching,characteristic,colour,corolla,direction,form,growth,height,inflorescence,leaf,length,ovary,plant,seed,shape,size,spacing,stem,texture,type,value,{,}
186	wfo-0001027929	success	193	123	67	126	56	0.347	1-4,1-8,4-5,5-lobed,along,apex,apical,apically,articulate,base,branched,calyx,cell,connate,cordate,corolla,cuneate,deep,dehiscent,dichasially,distal,except,filament,generally,glabrous,globose,green,hair,half,herbaceous,interjected,introrse,lanceolate,leaflet,lower,maturing,middle,mm,obliquely,occasional,odd-pinnate,often,pattern,pedicel,perennial,perfect,plant,poricidally,puberulent,purple,rhizomatous,rhizome,rotate,rounded,shape,short,slit,spot,star,symmetrically,typically,unit,vein,violet,violet-blue,white,without	0.2-0.9,1,1-10,1.0-1.3,1.5-4,10,15,2,2-3,2.0-3.0,20,3-6-foliat,3.5-5,35,4-30,4-6,5-10,5-6,6-15,abaxially,acumen,acuminate,acute,adaxially,angular,apiculate,ba,basal,becoming,beyond,caudate,cente,center,clasping,cm,coat,color,covering,cyme,dark,darker-violet-blue,decreasing,diameter,dichasial,digestion,eaf,ebracteate,eed,elliptic,embryo,emoval,enzyme,erect,exceeding,flower,forked,formed,globo,green-white,hair-like,honeycomb,included,lateral,light,living,lobe,lon,long,make,monochasial,mostly,mucilaginous,narrowly,nearly,nflorescence,nther,oblong,orolla,ovate,ovoid,pair,peduncle,pentagonal,petiolate,petiolulate,petiolule,purpl,radiating,rarely,reduced,reveal,rotate-,ruit,seed,semi-lunate,sessile,seudostipule,size,slightly,sometimes,somewhat,specimen,stamen,ste,stigma,straight,style,subequal,tem,terete,terminal,testal,thick,tinged,tip,trailing,unbranched,usually,vary,visible,wall,wid,wide,wider,yellow,ympodial	3-6-foliate,anther,appressed,articulation,bract,branching,breeding,broad-based,colour,connective,form,fruit,fruiting,growth,heteromorphism,inflated,inflorescence,insertion,interpetalar,leaf,length,margin,marking,mature,modification,na,needle-like,odour,orientation,paired,petiole,placement,pore,position,present,prickle,pseudostipule,rotate-pentagonal,scale,smell,staman,stellate,stem,stone,structure,surface,symmetry,sympodial,system,texture,tissue,trichome,tuber,type,vegetative,xylopodia
187	wfo-0001027948	invalid_json_followup	186	179	121	65	58	0.651	-15,-16,-6,.5,0.5-2,0.8-,1-1.2,1-2,1.2-2.2,1.3-1.8,1.5-4.5,10-14,13,2-,2.2-,2.5-,3-8.2,3.2-5.2,3.7-4,5-,6-celled,7,7-15,7.5-10,8-celled,abaxially,abundant,acuminate,adaxially,anther,apex,articulate,attenuate,basal,base,berry,branch,calyx,campanulate,cell,cm,connectival,corolla,delicate,diameter,directed,dorsally,edentate,ellipsoidal,elliptical,filament,finely,flexuous,fragrance,fruiting,generally,glabrous,glandular,globose,head,herb,herbaceous,hollow,ill-smelling,leaf,length,light,lobe,long,longer,longitudinal,longitudinally,lower,margin,mm,narrow,narrowly,non-glandular,occasionally,odorles,opening,ovate,ovoid,pair,papillate,patent,petiole,pore,poricidal,prolongation,pubescent,purple,ridged,serrulate,shorter,simple,single-celled,slightly,slit,spur-like,stalk,stem,stigma,straight,striate,style,sub-shrub,thickened,tip,tooth,triangular,trichome,tube,unequal,upward,verrucate,violet,viscid-pubescent,x,Â¼,Â½	0-,0.4,0.5-0.7,0.6,1.6,1/10,14,3.5,5,accrescen,ag,aggregate,antrorse,ape,ature,bicellular,c.,crushed,cuticle,dark,diamete,difoliate,eaf,erect,free,hig,inconspicuous,inserted,lamina,long-stalked,many-,midvein,near,orolla,pericarp,portion,pubescence,reduced,ree,ruit,saddle-shape,scarce,scarcely,secondary,seed,seeded,seen,separated,short-stalked,sinus,small,smooth,solitary,stone,striat,sub-opposite,tem,thecae,time,twice,unit,vary,vein,ventrifixed,ympodial	'',[,``,accrescent,age,arrangement,articulation,bract,branching,breeding,broad-based,characteristic,colour,connective,edentation,form,fruit,growth,hair,height,inflorescence,insertion,interjected,interpetalar,leaflet,marking,modification,na,needle-like,odour,orientation,ovary,paired,pattern,pedicel,placement,plant,position,prickle,ridging,saddle-shaped,scale,shape,size,smell,spot,stellate,surface,symmetry,system,texture,tissue,type,value,vegetative,zygomorphy,{,}
188	wfo-0001027961	invalid_json_followup	177	149	103	74	46	0.582	.5,0.25,0.25-0.5,0.5-1,0.9-1,1-1.5,1-5,2-2.5,3-3.5,4.5-5,8-10,<,?,abaxially,acute,always,anther,apex,articulated,asymmetric,base,berry,branched,c.,calyx,clavate,cm,cordate,corolla,curling,densely,diameter,ellipsoid,elliptic,entire,fading,filament,flower,fruiting,fusiform,glabrous,globose,green,growth,immature,inflorescence,irregularly,lateral,lobed,long,lower,many,margin,mature,membranous,midrib,mm,new,obovate,observed,occasionally,often,one,other,pedicel,peduncle,perfect,petiole,pinnatifid,pore,poricidal,present,pubescent,purple,reddish,rotate-stellate,scar,simple,sleeve,slightly,small,spaced,sparsely,stem,stigma,style,surface,terminal,time,tip,triangular,trichome,truncate,twining,uniseriate,upper,vine,violet,way,white,white-pubescent,woody,x	1,1-3,1-4,1-9,10-50,2.3-2.5,2.5-9,5-8,5-merou,6-9,7-9,adaxiall,adaxially,age,alyx,anthesi,apar,ark,axil,broadly,brow,clear,conical,connivent,deltate,distributed,eaf,early,eed,equalling,exserted,free,geminat,ilament,lamina,lengthening,lobe,lon,loosely,maturity,minute,minutely,nflorescence,older,orolla,pair,papillo,pendan,pericarp,pinched,planar,plurifoliate,portion,primary,probably,pubescen,ruit,shiny,slender,slit,spreading,tem,thin,transition,tube,tuft,twinin,ud,unequal,unit,vary,vein,yellow,ympodial	'',5-merous,[,``,apart,appressed,arrangement,articulation,bark,bract,branching,breeding,brown,bud,characteristic,colour,connective,form,fruit,hair,inflated,interjected,interpetalar,leaf,leaflet,length,marking,modification,na,ovary,pattern,pendant,position,presence,scale,seed,shape,spot,symmetry,system,texture,tissue,type,value,{,}
189	wfo-0001027966	invalid_json_followup	207	170	121	86	49	0.585	0.4-0.5,0.7-3,0.8,1-1.8,1-10,1-2,1-3,1-4.2,1-5,1.2-4.5,1.3-2.2,10,10-30,2.2-2.9,2.5-10.5,2.8-9,3-4,3-5,3-7,4,40-80,5-10,5-6,5-9.5,5.5-14,6-11,abaxially,absent,acumen,acuminate,adaxially,anther,apex,attenuate,axillary,base,berry,blade,blue-violet,brownish,cell,chartaceous,cm,condition,conical,corolla,decreasing,densely,diameter,digestion,dorsally,drying,edge,enzyme,filament,flat,flower,folded,forked,fresh,fruit,glabrous,gradually,green,greenish,hair,herb,homostylous,honeycomb-shaped,interjected,lanceolate,lateral,leaf,leaflet,lengthening,less,light,lobe,medium,membranous,middle,minute,mm,moniliform,mottled,odd-pinnate,ovate,ovoid,pedicel,peduncle,pentagonal,petiole,plant,pore,poricidal,proximal,pubescent,purple,rarely,removed,ripe,rotate,seed,size,slit,somewhat,sparsely,stem,stigma,subequal,subtending,terminal,testal,tip,tube,tuber,usually,wall,whitish,wing,x	0.8-2.5,1.5-3,1.5-5.2,5-merou,ag,along,alyx,apart,apparently,arranged,articulated,asymmetrical,axe,basiscopic,bead,bud,capitat,ciliate,commonly,connivent,covering,distal,eaf,eed,elliptic,erec,especially,exceeding,geminat,generally,glabrou,green-white,hair-like,half,larger,like,living,long,lower,make,margin,mucilaginous,multiple,narrow,necklace,nflorescence,orbicular,orolla,pair,pale,perfect,petiolule,plurifoliate,ray,ruit,secondary,semierect,sessile,seudostipule,shorter,side,slightly,spaced,specimen,stamen,ste,stolon,straight,subsessile,symmetrical,tall,tamen,tem,thick,throughout,tissue,tri-,tyle,typically,unit,violet,wet,white,wide,yellow,ympodial	'',[,``,abaxial,adaxial,age,appressed,arrangement,articulation,bract,branching,breeding,calyx,capitate,characteristic,colour,connective,density,form,fruiting,growth,height,inflated,inflorescence,length,marking,mature,modification,na,number,pattern,position,pseudostipule,scale,shape,spacing,spot,staman,style,symmetry,system,texture,trichome,type,value,width,{,},Â¼
190	wfo-0001028014	success	222	116	67	155	49	0.302	-1/2,-2.5,/5,0.2-1.6,0.7-1,1/4,4.5-7,anther,apex,apparently,articulated,base,berry,branched,calyx,cell,chartaceous,cm,connivent,cordate,curved,densely,difoliate,elongating,equal,filament,flattened,fruit,fruiting,lateral,leaf,length,lobed,long,lower,margin,mature,maturity,mauve,membranous,mm,occasionally,orange,pedicel,petiole,poricidal,prickle,purple,red,reflexed,rounded,shrub,simple,spherical,spreading,stellate-pubescent,stem,straight,strongly,surface,tapering,terminal,tip,trichome,unit,way,weakly	-0.5,-1,-10,-15,-3,-4,-5,-6,.5,0,0.1-0.2,0.15,0.15-0.3,0.2,0.2-0.4,0.2-1,0.25,0.3-0.4,0.5,0.5-1,0.5-1.5,0.5-2,0.5-3,0.6-0.9,0.7-1.6,0.9-1.2,1-,1-10,1-2,1-3,1-4,1.3-2.4,1.5,1.5-2,1.8-3,1/4-2/3,2,2-20,2-3,2-4.5,2-6.5,2.5-4,3-10,4-10,5-merous,6-10,6-11,abaxially,acuminat,almost,alyx,ame,apar,apart,apically,around,bark,black,blade,broad-deltate,brown,brown-green,c.,concolorous,decurrent,deltate,diameter,discolorous,distance,drying,eaf,edge,eed,erect,extending,eye,flattened-reniform,flower,free,geminat,glabrescent,glabrou,glabrous,gland,globular,gray,gray-green,herbaceous,infructescence,lobe,lon,longer,midpoint,midvein,moderately,naked,nflorescence,obtuse,older,one,open,orange-gra,orolla,oung,outer,outline,ovate,pair,pale,peduncle,pendulous,per,perfec,pericarp,pit,porrect,portion,prickl,prickly,primary,raised,ray,reduced,rough,ruit,scandent,scar,seed,sessile,shiny,shorter,side,slender,smooth,sometimes,spaced,stalk,stalked,stellate,style,tamen,terete,tertiary,time,tube,vary,vein,venation,visible,visibly,wide,winged,yellow,yellow-green,ympodial	appressed,articulation,bract,branching,breeding,broad-based,colour,corolla,form,geminate,growth,hair,heteromorphism,inflated,inflorescence,insertion,interjected,interpetalar,leaflet,marking,na,needle-like,odour,orientation,paired,pattern,perfect,placement,position,present,pseudostipule,rhizome,scale,shape,smell,spot,staman,stone,structure,symmetry,sympodial,system,texture,tissue,tuber,type,vegetative,xylopodia,zygomorphy
191	wfo-0001028017	success	158	131	99	59	32	0.627	-2.5,0.3-1,1-10,1-2,1-3,1.5-2,15-35,2,2-3,2-4,2.5-5,3,3-12,3-14,3-4,40-50,5-7,5-9,6-7,6-8,absent,acuminate,acute,apex,apiculate,base,beyond,brown,calyx,clavate,cm,connective,connivent,cream,cuneate,cylindrical,densely,diameter,directed,distally,eglandular,eglandular-puberulent,eglandular-pubescent,ellipsoidal,elliptic,entire,flattened,fleshy,forked,fruit,fusiform,glabrous,glandular,glandular-,glandular-puberulent,green,greenish,hair,immature,introrse,lanceolate,lobe,margin,mm,moderately,narrowly,near,oblique,obtuse,ovate,ovoid,pedicel,peduncle,petiole,pore,pubescent,purple,rachi,radiu,rarely,ripe,short-acuminate,simple,sometimes,sparsely,stamen,stellate,stellate-campanulate,stigma,style,subcoriaceous,tan,tip,tree,truncate,unbranched,white,x,yellow	1,10-22,13-40,15-50-flower,3-foliat,5,9-11,abaxially,absen,adaxially,aggregate,apart,ape,articulated,axe,basal,blade,cell,chartaceous,ciliat,eaf,eed,exceeding,exserted,flower,leaving,lon,long,lower,nflorescence,nther,orolla,pedicellar,perfect,pointed,puberulen,purplish,remnant,ruit,shorter,slightly,small,spaced,stone,tal,tem,thecae,time,tomentose,triangular,truncat,tube,ud,unit,vary,vein,wide,without,ympodial	abaxial,adaxial,anther,articulation,bract,branching,bud,colour,corolla,exsertion,form,growth,height,inflorescence,leaf,length,mature,na,ovary,plant,position,puberulent,seed,shape,size,spacing,stem,symmetry,texture,theca,trichome,type
192	wfo-0001028033	success	157	103	76	81	27	0.484	2â4,3â5,4â12,4â5,50,6â12,abaxially,anther,attenuate,base,brochidodromous,brown,calyx,chartaceous,cm,connivent,cylindrical,cyme,darker,decurrent,deeply,densely,discolorous,drying,elliptic,few-branched,filament,flower,fruit,glabrescent,glabrous,green,greenish,growth,herb,hispid-pubescent,introrsely,known,lateral,length,light,like,lobed,longitudinal,mm,new,oblong,opening,pedicel,perfect,petiole,pore,pubescence,pubescent,rhizomatous,shiny,shrub,simple,slightly,slit,solitary,sparsely,spreading,stellate,stem,stigma,straight,style,surface,trichome,unbranched,uniseriate,upright,venation,white,woody	.6,1.4â1.8,1.5,1â4,1â5,2â3,2âfoliate,3,3â11,3â4,5-merou,5â7,acuminate,acute,adaxiall,adaxially,along,alyx,anthesi,apex,ark,ascending,becoming,blade,branch,capitat,cell,ciliate,contiguou,cordate,denser,diameter,directed,eaf,eed,emarginate,entire,equal,eye,florescence,geminat,high,know,linear-lanceolate,lobe,long,lower,mainly,margin,membranaceous,midrib,naked,nearly,older,onto,order,orolla,ovate-lanceolate,poricidal,prominent,prostrat,recurved,ruit,secondary,sessile,shin,shorter,strongly,subapical,tamen,tem,tube,unit,unknown,vary,vein,visible,wide,yellow,ympodial,Ã	5-merous,arrangement,bark,branching,capitate,colour,corolla,form,hair,height,inflorescence,leaf,marking,na,odour,ovary,pattern,plant,position,rhizome,seed,shape,spot,symmetry,texture,type,ye
193	wfo-0001028067	success	139	85	61	78	24	0.439	-30,0.5-2,1-10,1-7,1.5-2.5,10-25,2,2-2.5,2.5-3,3-17,3-5,5-7,6-18,7-11-compound,7-20,acuminate,acute,apart,apex,base,calyx,cm,cuneate,dark,diameter,elliptic-fusiform,elliptic-ovate,entire,flattened,fruit,glabrous,hair,leaf,lobe,margin,mm,moderately,narrowly,pedicel,petiole,pink,pinnately,pore,puberulent,purple,radiu,rarely,shrub,simple,slightly,sparsely,stellate,strongly,subcoriaceous,tomentulose,triangular,triangular-deltate,truncate,unbranched,x,yellow	0.5-1,0.5-1.5,1,1-11,1-2,1-3,2-3,3-4,3-7,4-foliat,6-12,7-9,8-13,abaxially,adaxiall,adaxially,aggregate,along,articulated,axe,basiscopically,blade,cell,chartaceous,color,compound,connivent,cylindrical,decurrent,directed,distall,eaf,eed,especially,flower,glabrou,lateral,leaflet,leaving,lon,long,lower,midrib,nearly,nflorescence,nther,obtuse,often,orolla,pedicellar,peduncle,per,puberulen,rachi,remnant,ripe,ruit,several,smal,spaced,stigma,stone,style,tal,tem,time,tip,truncat,tube,unequal,unit,unknown,upper,usually,vary,wide,ympodial,zigzag	anther,arrangement,articulation,branching,colour,connective,corolla,form,fruiting,growth,height,inflorescence,length,modification,na,plant,position,seed,shape,size,spacing,stem,texture,type
194	wfo-0001028069	success	253	98	58	195	40	0.229	0.3-0.45,0.6-4,1-2.7,2-3-branched,2-locular,3,3-foliate,accrescent,anther,apex,base,bract,calyx,cell,citru,cm,corolla,decurrent,deep,densely,eglandular,filament,fruit,fruiting,globose,herb,imparipinnate,interjected,interrupted,leaf,leaflet,length,linear,long,lower,margin,mm,oblique,occasionally,orange,pale,patent,pedicel,pentagonal,petiole,present,pseudostipule,pubescent,scent,simple,stem,strong,surface,trichome,uniseriate,unit,weak,yellow	-0.4,-30,-6,.1,.1-0.2,.2,.5,0.05-0.1,0.1-0.15,0.1-0.2,0.1-0.3,0.1-0.5,0.1-0.6,0.2-0.3,0.2-0.5,0.3,0.3-0.4,0.3-0.6,0.3-0.7,0.3-1,0.4,0.4-0.5,0.4-0.8,0.4-1,0.5,0.5-0.7,0.5-1.8,0.5-2,0.6-1.1,0.7-1,0.7-1.3,0.7-1.5,0.8-1.2,1-2-celled,1-3.5,1-4.5,1.4,1.5-2.0,1.5-3.5,1.6-3.2,10,10-12,10-30,12,2-17,2-4,2-7,3-,4-celled,5-22,5-25,6-,<,abaxially,absen,abundant,acute,adjacent,adpressed,along,alternate,always,among,anthesi,apical,appearance,appendage,appressed,articulated,axi,ba,basal,basioscopically,becoming,berry,bilaterally,bracteole-like,bright,brown,column,composed,cone-shaped,conical,cordate,cuneate,curving,deeply,dense,diameter,due,eaf,ebracteate,edicel,eed,erect,exserted,flower,forming,fusion,giving,glabrescent,gland,gland-tippe,gland-tipped,glandular,glandular-villous,gree,green,hair-like,half,halfway,head,included,initially,internode,larger,later,lateral,less,like,lime,lobe,lobed,lon,longer,longest,maturity,middl,midvein,minute,minutely,multicellular,narrowly,nflorescence,obovate,often,one,outgrowth,ovary,ovate,pair,peduncle,per,perennial,petiolule,plant,population,primary,procumbent,pubescence,quaternary,rarely,reflexed,robust,rounded,ruit,scarcely,secondary,sessile,several,shaggy,short,shorter,silky,single-celled,size,slender,smaller,somewhat,staminal,sterile,stigma,straight,style,subopposite,symmetric,tangled,tem,terminal,tertiary,testa,thick,tightly,toward,transparent,tube,ud,unicellular,usually,varying,viny,wall,wide,winged,ympodial	absent,articulation,branching,broad-based,colour,form,growth,hair,heteromorphism,inflorescence,insertion,interpetalar,marking,mature,middle,na,needle-like,odour,orientation,paired,placement,position,prickle,rhizome,scale,shape,smell,spot,staman,stone,structure,symmetry,sympodial,texture,tissue,tuber,type,vegetative,xylopodia,zygomorphy
195	wfo-0001028075	invalid_json_followup	196	152	94	102	58	0.48	1.5-2.5,1.5-7,1.6-2.7,10-35,2-4.5,2-6,2.5-10,3-11,3-23.5,5-12,5-14,5-17,5-7,5-9,7-13,7-30,8-12,abaxially,absent,adaxially,anther,apex,base,berry,blade,brownish,cell,chartaceous,ciliate,cm,condition,corolla,covering,dark,diameter,drying,edge,end,filament,flat,flower,forked,fresh,fruit,glabrescent,glabrous,globose,green,greenish,herb,homostylous,interjected,lanceolate,lateral,leaf,leaflet,light,long,margin,membranous,minutely,mm,oblique,odd-pinnate,ovoid,pale,pedicel,peduncle,pentagonal,petiole,plant,pore,poricidal,puberulent,rotate,rounded,seed,size,slightly,stigma,straight,style,subcordate,terminal,testal,thick,tip,tuber,typically,wall,white,whitish,wide,x	.5,1-10,1-2,1-2.7,1-3,2-3,4-12,4-7,5-8,5-merou,acuman,acumen,acuminate,acute,ag,along,alyx,apart,apparently,articulated,axe,axillary,borne,broadly,bud,capitat,connivent,cuneate,decreasing,differentiated,digestion,distal,distally,distinctively,dorsally,dot,eaf,eed,elliptic-lanceolate,enzyme,erec,especially,exceeding,folded,geminat,generally,glabrescen,green-white,hair-like,half,honeycomb-shaped,larger,lengthening,ligulate,living,lobe,lower,make,middl,midrib,much,mucilaginous,narrow,nflorescence,obtuse,often,orolla,ovate,ovate-elliptic,pair,perfect,petiolule,plurifoliate,purple,reflexed,removed,ruit,scattered,seudostipule,singly,slit,sometimes,spaced,specimen,stamen,star,stolo,subtending,tall,tamen,tem,throughout,toward,tri-,tube,unit,usually,vary,wet,wing,yellow,ympodial	'',[,\u201chair-like\u201d,``,appressed,arrangement,articulation,bract,branching,breeding,broad-based,calyx,capitate,characteristic,colour,connective,form,fruiting,growth,hair,height,inflated,inflorescence,insertion,interpetalar,length,location,marking,mature,middle,modification,na,number,odour,ovary,paired,pattern,position,presence,present,prickle,pseudostipule,scale,shape,smell,spot,stem,stolon,symmetry,system,texture,tissue,trichome,type,value,vegetative,{,}
196	wfo-0001028076	invalid_json_followup	195	169	122	73	47	0.626	.5,0.4-0.5,0.5,1-1.3,1-10,1-2,1.8-2.2,110,12-22,13-14,2-12,2-3,2-5.4,2.2-2.6,2.2-3.7,2.5-4,4-5,4.5-7,5,5-20,5-6,5-6.5,7-8,abaxially,adaxially,anther,apart,attenuate,axillary,berry,blade,borne,brownish,bud,cell,chartaceous,ciliate,cm,condition,conical,connivent,corolla,densely,diameter,digestion,distal,dorsally,drying,edge,elliptic,end,enzyme,filament,flat,flower,folded,forked,fresh,fruit,generally,glabrous,green,greenish,hair,half,herb,homostylous,honeycomb-shaped,lanceolate,lateral,leaf,leaflet,lengthening,less,light,like,lobe,long,margin,medium,membranous,minute,mm,odd-pinnate,ovate,ovoid,pedicel,peduncle,pentagonal,petiole,plant,pore,poricidal,proximal,pubescent,purple,removed,ripe,rotate,seed,singly,size,slit,stem,stigma,straight,style,subtending,terminal,testal,tip,tube,tuber,typically,unwinged,usually,wall,whitish,wide,wing,x,yellow	1-3,1.2-2.2,2.5-3,2.6-3.8,5-merou,?,absent,acumen,acuminate,ag,alyx,apex,apparently,articulated,axe,base,capitat,covering,decreasing,eaf,eed,erec,especially,exceeding,geminat,glabrou,gradually,green-white,hair-like,interjected,larger,living,lower,make,mucilaginous,nflorescence,obtuse,orolla,pair,perfect,petiolule,plurifoliate,pubescen,rarely,ray,round,ruit,secondary,semierect,sessile,seudostipule,slightly,spaced,specimen,stamen,ste,stolo,subequal,subsessile,symmetrical,tall,tamen,tem,thick,thir,throughout,toward,tri-,unit,vary,wet,white,ympodial	'',5-merous,[,``,age,appressed,arrangement,articulation,branching,breeding,calyx,capitate,characteristic,colour,connective,connivence,form,fruiting,glabrousnes,growth,height,inflated,inflorescence,length,marking,mature,merosity,modification,na,ovary,pattern,position,pseudostipule,shape,spacing,spot,stolon,symmetry,system,texture,third,trichome,type,value,width,{,}
197	wfo-0001028105	success	150	120	77	73	43	0.513	0.3-1.5,0.5,0.5-1,0.5-2,0.6-1,1-1.2,1-1.5,1-2.5,1.5,1.5-2,1.5-4.5,2,2-2.2,2-5,3.5-4,abaxially,acuminate,acute,adaxially,anther,anthesi,apex,attenuate,bark,base,bilobed,calyx,clavate,cm,conical,corolla,dark,difoliate,elliptic,filament,flattened-reniform,fruiting,glabrous,glandular,globose,green,incrassate,leaf,lobed,margin,minor,minutely,mm,nearly,opposite,ovary,pale,papillose,pedicel,petiole,pitted,pore,pubescent,reddish-brown,shaped,shrub,simple,size,slightly,small,stigma,style,surface,tear-drop,tip,tree,trichome,tube,uniseriate,unit,white,x	.1,.4,.5,1.5-1.8,3-5-celled,3-6,5-7-flowered,6-7,9.5-15,apar,apical,axi,axil,ba,berry,deflexed,dense,dia,differing,distinct,drying,eaf,edicel,eed,ellipsoid,erect,evenly,exserted,filiform,free,geminat,greenish-yello,lamina,lateral,like,lobe,lon,long,lower,main,major,middle,nflorescence,occasionally,older,olive-green,pair,papillo,planar,poricidal,portion,projection,quadrate,reflexed,ruit,scar,scattered,spaced,sparsely,spreading,stem,straight,strongly,tall,tub,tuft,ud,vein,widest,woody,yellowish,ympodial,young	0.1,2.5,3,3.5,articulation,bract,branching,cell,colour,diameter,form,fruit,geminate,greenish-yellow,growth,hair,height,heteromorphism,inflorescence,insertion,interjected,interpetalar,leaflet,length,na,odour,orientation,placement,plant,position,prickle,rhizome,seed,shape,staman,stone,structure,sympodial,texture,tissue,tuber,type,xylopodia
198	wfo-0001028109	success	205	113	68	137	45	0.332	/3,0.4-0.8,1.5-5.5,2.5-3,2/3-3/4,anther,apex,articulated,base,berry,branching,bright,calyx,chartaceous,cm,connivent,cuneate,densely,elongating,entire,equal,evenly,filament,fruit,fruiting,green,lateral,leaf,length,lobed,long,lower,margin,mature,maturity,mauve,mm,moderately,multangulate,pedicel,perpendicular,petiole,poricidal,prickle,primary,red,reflexed,secondary,shrub,simple,small,sometimes,spherical,stalked,stellate,stellate-pubescent,stem,surface,tapering,terminal,tip,tree,trichome,unarmed,unit,way,white,young	-20,-4,-7,.5,0.05-0.15,0.05-0.2,0.1,0.1-0.2,0.3,0.4-1.5,0.45-0.65,0.5-1.2,0.5-2.5,0.6-0.8,0.7,0.8-1.5,0.8-1.6,1.5-10,1.5-2.5,1/8-1/4,10-25,10-30,12-40,15-100,2-15,2-4,2.3-2.9,2.5-5,20-60,3-,3-7,3.5-6,3/4,30-150,4-13,4-5-merous,5-13,5-30,8-12,8-15,8-25,abaxial,abaxially,acuminate,acut,acute,adaxial,almost,alyx,ame,apar,apart,apically,apparently,bark,blade,brow,c.,curved,deltate,diameter,dimorphic,discolorous,drying,dull,eaf,eed,elliptic,erect,flattened-reniform,flower,free,fully,geminate,gently,glabrescent,glabrou,glabrous,gray-green,green-brown,infructescence,light,lobe,long-styled,longer,midpoint,minor,nflorescence,obtuse,occasionally,older,one,open,opening,orange-brown,orolla,oung,pair,peduncle,per,perfec,pericarp,plurifoliat,porrect,portion,prickl,prickly,ray,recurved,red-brown,ruit,scar,sessile,slender,smooth,spaced,spreading,stalk,straight,strongly,style,tamen,terete,tertiary,time,tube,unarme,usually,vary,vein,venation,visible,weakly,wide,woody,yellow,ympodial	appressed,articulation,bract,broad-based,cell,colour,corolla,form,growth,hair,heteromorphism,inflated,inflorescence,insertion,interjected,interpetalar,leaflet,marking,na,needle-like,odour,orientation,paired,placement,plurifoliate,position,present,pseudostipule,rhizome,scale,shape,smell,spot,staman,stone,structure,symmetry,sympodial,texture,tissue,tuber,type,vegetative,xylopodia,zygomorphy
199	wfo-0001028115	invalid_json_followup	165	165	106	59	59	0.642	-1.1,-2.5,-5.2,.6,0.42,0.7-0.8,1-3,1.1-1.8,1.8-3.5,2-3.2,2.5-,3-4.5,3-5,4.7-,5-15,5-8.5,6-10,9-17,abaxially,abundant,accrescent,adaxially,alternate,annular,anther,antrorse,apex,articulate,attenuate,base,berry,blue,calyx,campanulate,capitate,cm,coat,curved,diameter,ellipsoidal,elliptical,embryo,entire,especially,evident,filament,fruiting,glabrescent,glabrous,globose,growing,herb,herbaceous,inflated,length,light,linear,lobe,long,longitudinally,margin,mm,moderately,much,narrowly,near,nerve,non-glandular,opposite,ovate,pair,pale,papery-scarious,petiole,pinnatifid,pinnatipartite,pinnatisect,pore,poricidal,pubescent,rarely,reticulate,ridged,seed,simple,slender,slightly,stem,stigma,strongly,style,tip,trans-ovoidal,triangular,trichome,tube,tuberculate,uniseriate,venation,violet,wide,wider,width,winged,x,yellow	.2,0.2-0.3,0.5,0.6-0.7,0.8-,1-2.4,1.3-1.8,1.4-1.7,1.7-2.2,12-13.5,2-,3-6.5,7-7.5,acuminat,acute,ag,amply,basal,blade,connectival,difoliat,dorsal,eaf,eed,exceeding,glandular,half,hig,longer,longitudinal,lower,mixed,multi-seeded,oblong,one,opening,orolla,papillo,portion,prolongation,prostrate,ree,ruit,scarce,segment,similar,slit,small,smooth,sometimes,styl,subsessil,tem,time,unequal,unifoliate,unit,vary,ympodial	'',[,``,arrangement,articulation,bract,branching,breeding,cell,characteristic,colour,connective,corolla,form,fruit,growth,hair,height,heteromorphism,inflorescence,insertion,interjected,interpetalar,leaf,leaflet,marking,mature,modification,na,number,odour,orientation,ovary,paired,pattern,pedicel,placement,plant,position,prickle,pseudostipule,rhizome,scale,shape,size,spot,staman,stone,symmetry,system,texture,tissue,tuber,type,value,xylopodia,zygomorphy,{,}
200	wfo-0001028131	success	208	115	73	135	42	0.351	0-4,0.1-0.3,1-10,1.5-5,2-5,5-6.5,abaxial,absent,adaxial,anther,apart,apex,articulated,attenuate,base,berry,branched,calyx,cell,chartaceous,connivent,curved,densely,difoliate,dull,erect,filament,flattened,flattened-reniform,fruit,fruiting,glabrescent,glabrous,herb,lateral,leaf,length,lobed,long,lower,margin,marking,mauve,membranous,mm,narrow-obovate,narrow-ovate,orange,orange-brown,pale,pedicel,petiole,poricidal,prickle,prickly,purple,red,reflexed,simple,spaced,sparsely,spherical,spreading,stellate,stellate-pubescent,stem,surface,tapering,tip,unarmed,unit,wide,yellow	-1.2,.1,.5,/5,0-0.6,0-2,0-3,0-30,0.05-0.2,0.1-0.15,0.2-1.5,0.3-0.7,0.4-0.8,0.5-1.1,0.7-1.1,0.8-1,0.8-1.1,1-3,1-4,1-5,1.5-3,1.8-2,1.8-2.2,1/4-2/3,1/5,2-2.8,2-4,2-6.5,2/3,3-6,4-6,5-8,5-merous,6-7,7-8,abaxially,acuminat,alyx,apar,apically,apparently,bark,blade,broad-deltate,cm,concolorous,cream,dark,deltate,diameter,distance,drying,eaf,eed,elongating,epidermi,equal,extending,eye,filiform,flower,free,geminat,gland,green,infructescence,lanceolate,lengt,like,lobe,longer,mature,maturity,midpoint,midvein,moderately,naked,nflorescence,oblong,obtuse,often,older,one,open,orolla,oung,outline,pair,pale-brown,pale-gra,peduncle,pendulous,per,perfec,pericarp,pit,porrect,portion,prickl,primary,raised,ray,reduced,rounded,ruit,scar,sessil,sessile,shiny,shorter,side,small,smooth,sometimes,straight,strongly,style,sunk,tamen,terete,tertiary,time,trichome,tube,unarme,upper,vary,vein,venation,visible,way,woody,yellow-green,ympodial,young	appressed,articulation,branching,breeding,broad-based,colour,connective,corolla,form,geminate,growth,hair,heteromorphism,inflated,inflorescence,insertion,modification,na,needle-like,odour,orientation,perfect,placement,position,pseudostipule,rhizome,seed,shape,smell,spot,staman,stone,structure,symmetry,sympodial,system,texture,tuber,type,vegetative,xylopodia,zygomorphy
201	wfo-0001028148	success	157	126	101	56	25	0.643	-6,0.6-3.5,0.75-2,1-15,1-3.5,1.5,10-30,12-15,2,2-7,2.5-4,20-50,3.5-4,3.5-9,5,5-20,5-7,5-8,6-18,abaxially,acute,adaxially,aggregate,angled,apart,apex,apiculate,articulated,base,blue-black,branched,broadly,cell,chartaceous,cm,dark,decurrent,densely,diameter,directed,distal,elliptic,entire,especially,except,fleshy,flower,fruit,glabrous,glaucous,globose,hair,highly,less,light-colored,lobe,margin,minute,mm,moderately,narrowly,often,orange,ovate,part,pedicel,peduncle,perfect,petiole,pink,plicae,plicate,pore,puberulent,puberulent-pubescent,purple,rachi,radiu,rarely,ridge,ripe,rotate-stellate,scalloped,shrub,simple,slightly,smooth,sometimes,sparse,stone,succulent,tapered,tip,treelet,triangular,tube,unbranched,violet,whitish,x,yellow	.5-4,0.25-0.5,0.5-1.5,1.5-2.5,15,2-3,4-10,4.5-10,5-10,absen,axe,ba,blade,calyx,central,connivent,cylindrical,deltate,distall,eaf,eed,fresh,long,lower,many-foliat,margi,material,mature,midrib,nflorescence,nther,obtuse,orolla,puberulence,rhizomatous,ruit,slender,smoot,spaced,star,stigma,style,surface,tal,tem,thickened,time,truncat,unit,usually,vary,white,wide,winge,ympodial,young	0.5-4,absent,anther,articulation,branching,colour,corolla,direction,distally,form,growth,height,inflorescence,leaf,length,number,plant,seed,shape,size,spacing,stem,texture,type,winged
202	wfo-0001028161	invalid_json	124	85	58	66	27	0.468	.5,0.1-0.25,0.25-0.5,0.7-1.7,1-1.5,1-2,1-2.3,1/3,2-9,2.5-3,3-4,3-7,4-5,6-9,acuminate,acute,along,anthesi,apex,attenuate,base,branch,branched,cell,closely,cm,dendritic,densely,denser,distal,elliptic,fruiting,globose,green,lanceolate,leaf,minor,minutely,mm,narrowly,opposite,orbicular,outline,ovoid-reniform,pedicel,petiole,pitted,pubescent,rounded,shape,shrub,simple,sinuate,size,surface,trichome,vein,x	1-1.3,1.5-4.5,2-5-flowered,7.5-12,9-11,abaxially,adaxially,arising,ba,bark,berry,brown,calyx,congested,consisting,corolla,deflexed,dia,differing,difoliate,eaf,edicel,eed,exserted,geminat,glabrescen,incrassate,inflorescenc,later,lateral,like,lon,long,main,major,margin,middle,nflorescence,obovoid,often,older,overlappin,pair,pale,probably,pubescence,reddish-brown,rest,ruit,scar,short,somewhat,spaced,sparsely,stem,strongly,tall,tan,tapering,thin,tub,ud,unit,widest,ympodial,young	'',2-5,[,``,abaxial,adaxial,characteristic,colour,density,diameter,flower,form,fruit,growth,height,inflorescence,length,number,origin,plant,position,seed,texture,type,value,{,}
203	wfo-0001028164	success	197	85	61	136	24	0.31	/4,1-1.5,1-4.5,2.5-4,anther,apex,articulated,attenuate,base,berry,branched,bright,calyx,cm,concolorous,connivent,difoliate,drying,entire,equal,erect,evenly,filament,fruit,fruiting,glabrous,green,hair,lateral,leaf,length,lobed,long,margin,maturity,mauve,membranous,midvein,mm,pale,pedicel,petiole,poricidal,recurved,red,shallowly,shrub,simple,sometimes,spherical,spreading,stem,tapering,terminal,tip,unarmed,undulate,unit,way,white,young	-1,-14,-6,-8,0-20,0.05-0.2,0.05-1.5,0.1,0.3-0.8,0.4-0.8,0.5-0.8,0.5-1,0.7-1.1,0.8-1.5,0.9-1.6,1,1.5-2.5,1.8-2.5,1/3,1/6-1/4,12-20,2-2.5,2.5-4.5,2.8-4,3-17,3-7,3.6-4.8,4-13,4-5-merous,4-7,4-8,6-8,8-15,8-17,abaxial,abaxially,acuminate,acute,almost,alyx,ame,apar,apically,apparently,bark,blade,c.,curved,dark,deltate,densely,diameter,dull,eaf,eed,elliptic,elongating,eye,filiform,flattened-reniform,flower,free,geminat,glabrescen,glabrescent,glabrou,glandular,gray,infructescence,less,lobe,long-acuminat,longer,lower,mature,midpoint,minute,moderately,multangulate,naked,narrow-deltate,nflorescence,obtuse,often,older,one,open,orange-brown,orolla,oung,pair,peduncle,per,perfec,pericarp,porrect,portion,primary,ray,red-brown,reflexe,ruit,scar,sessile,shorte,shorter,side,smooth,spaced,sparsely,stalk,stalked,stellate,stellate-pubescent,straight,style,surface,tamen,terete,tertiary,time,trichome,tube,unarme,upper,variously,vary,vein,venation,visible,wide,woody,yellow,yellow-gra,yellow-green,ympodial	articulation,branching,colour,corolla,form,geminate,growth,heteromorphism,inflorescence,insertion,na,odour,orientation,placement,position,prickle,reflexed,shape,staman,structure,symmetry,sympodial,texture,type
204	wfo-0001028180	success	147	129	75	72	54	0.51	.5,/2,1-1.2,1-1.5,1-1.8,1-3,1.5-5,15-28,2-2.2,2-3,2.5-3,3-10,3-4,4.5-5,5-6,5-8,7,8-10,anther,apex,attenuate,base,beginning,berry,calyx,capitate,closely,cm,conical,corolla,deflexed,dia,difoliate,elliptic,filament,fruiting,glabrous,globose,golden,green,leaf,leathery,lobed,long,margin,minor,minutely,mm,nearly,opposite,ovary,ovoid-reniform,pair,pedicel,petiole,pinkish-white,pore,pubescent,scar,shaped,simple,size,spaced,stigma,style,tear-drop,tree,tube,uniseriate,unit,way,white,winged,woody,x	.05,0.7-1,20-30-flowered,abaxially,acute,adaxially,along,anthesi,ba,bark,c.,cucullate,dark,darker,deltate,densely,differing,distinctly,drying,eaf,eed,elongate,erect,falcate,fleshy,four-angled,free,geminat,glabrat,gold,irregularly,know,larger,lateral,lobe,lon,lower,main,major,midrib,nflorescence,obscure,older,onto,overlappin,pale,papillose,pitted,planar,poricidal,portion,puberulent,ruit,shiny,small,somewhat,sparsely,stem,straight,styl,surface,tall,tan,thick,tip,trichome,ud,underside,vein,yellow-gray,ympodial,young	abaxial,adaxial,appressed,articulation,bract,branching,breeding,cell,colour,connective,form,fruit,geminate,growth,hair,height,heteromorphism,inflated,inflorescence,insertion,interjected,interpetalar,leaflet,length,marking,mature,modification,na,odour,orientation,overlapping,paired,pattern,placement,plant,position,prickle,pseudostipule,rhizome,scale,seed,shape,spot,staman,stone,structure,symmetry,sympodial,system,texture,tissue,tuber,type,xylopodia
205	wfo-0001028182	success	150	99	78	72	21	0.52	0-90,0.1-0.2,0.5-0.6,0.5-1,0.9-1,1-1.5,2-2.5,2-6.5,3-5,4-6,5-ribbed,6-9,anther,apart,apex,arching,bark,base,bending,branch,calyx,capitate,ciliate,cm,conical,corolla,deflexed,ellipsoid,evenly,filament,filiform,glabrous,globose,inflorescence,internodal,later,lateral,leaf,lobed,long-acuminate,main,minutely,mm,narrowly,nearly,obovoid,opposite,ovary,ovate,pair,papillose,pedicel,petiole,planar,pore,pubescent,purplish,reflexed,scar,shaped,shrub,simple,slender,slightly,spaced,sparsely,stem,stigma,strongly,style,tear-drop,trichome,tube,uniseriate,vein,white,young,zig-zag	.5,0.5,0.8-1,2,3,5-15-flowered,along,anthesi,apiculae,apiculate,axi,beneath,black,blade,brown,cordate,deltoid,densely,dia,dry,eaf,edicel,eed,except,extreme,flower,free,gre,hemiepiphyte,keeled,know,known,lax,less,like,lobe,long,lower,margin,material,midrib,minute,nflorescence,older,papillo,poricidal,portion,present,prominent,proximal,rib,rounded,ruit,sca,shiny,somewhat,sparser,specimen,spindly,still,surface,tapering,third,time,tip,truncate,ud,unifoliat,unit,widest,x,ympodial	articulation,branching,bud,colour,form,fruit,grey,growth,hair,length,na,pattern,position,seed,shape,symmetry,texture,type,unknown,venation,width
206	wfo-0001028183	success	237	134	95	142	39	0.401	-10,-5.3,0.2-0.5,0.5-2.5,0.7-2,0.8-3.1,10-15,2-4.2,2-5,2.8-4.2,5-8,5.2-6.2,6.6-20,7.5-23,abaxial,accrescent,anther,anthesi,apex,apparently,articulated,attenuate,bark,base,berry,blunt-tipped,branch,branched,bud,calyx,cell,chartaceous,cm,corolla,cuneate,diameter,dull,elliptic,entire,filament,flower,fruit,fruiting,glabrescent,glabrous,globose,granular-punctate,hair,lanceolate,leaf,long,longitudinal,lower,many,margin,mm,narrowly,nearly,oblong,pedicel,peduncle,petiole,plurifoliate,pore,poricidal,porrect-stellate,present,pubescence,pubescent,purple,rachi,ripe,scabrous,shrub,simple,slit,somewhat,soon,sparingly,stellate,stem,streak,surface,tan,time,tip,tree,unit,usually,violet,white,whitish,x,yellowish,yellowish-tomentose	.5-3,0.1,0.1-0.2,0.1-0.4,0.1-0.9,0.2-0.3,0.2-0.4,0.5,0.6,0.7-1.2,0.8-1.4,1.1-1.8,1.2-1.4,1.3-1.4,1.3-1.7,1.4-2.8,1.5-3.4,1.6-2.3,1.7-2.7,1.9-3.7,1/3-1/2,11-30,2.2-5.7,2.5-4.1,2.6-4.4,3.2-,3.5-6.6,4.5-9,4.6-6.4,5-8.5,50-400,8-9.1,9-13,abaxially,acute,adaxially,ag,along,alyx,apart,around,axi,axillary,blade,brown,capitate,central,closely,cylindrical,dark,deltoid,dendritic-multangulate,directed,distally,distantly,drying,eaf,earl,edge,eed,elongated,epidermal,especially,evident,except,exserted,farinose,few-rayed,free,glabrescen,group,half,high,inserted,lackin,lateral,lengthening,lobe,lobed,lon,long-decurrent,m.,main,midrib,multangulate,nflorescence,obovoid,older,open,orangish-tan,orolla,ovate-lanceolate,overlapping,perfec,porrect-stellat,prominent,pseudoterminal,rarely,relatively,reportedly,reticulate-punctate,ruit,runk,sessile,short,short-,side,small,spaced,sparse,spherical,splitting,stage,stalk,stamen,stigma,stipitate-glandular,stout,strongly,style,sub-lenticular,subcampanulate,suture,tamen,terete,thick,thin,thin-textured,tomentose,touching,translucent,tube,ud,unarme,upper,vary,vein,way,wide,yellow,ympodial,young	adaxial,arrangement,articulation,branching,breeding,broad-based,colour,connective,form,growth,height,heteromorphism,inflorescence,length,marking,modification,na,needle-like,orientation,perfect,placement,plant,prickle,pseudostipule,rhizome,shape,spot,staman,stone,structure,symmetry,sympodial,system,texture,trunk,tuber,type,xylopodia,zygomorphy
207	wfo-0001028227	success	236	104	61	175	43	0.258	-6.2,0.8-1.4,0.9-1.4,1-4.2,3-4.9,acute,anther,apex,appressed,articulated,base,berry,blunt-tipped,branched,brownish,cm,corolla,cuneate,dendritic-echinoid,echinoid,entire,filament,fleshy,fruit,globose,hair,leaf,long,lower,many,margin,mm,multangulate,oblong,obtuse,occasionally,ovate-lanceolate,pale,pedicel,petiole,plurifoliate,pore,poricidal,porrect-stellate,pseudoterminal,purple,ripe,scabridulous,sessile,shrub,simple,stem,surface,time,tree,unit,velutinous,violet,well,x,yellow	-2/3,.5-4,0-250,0.1,0.2,0.2-0.3,0.2-0.4,0.2-0.5,0.3,0.4,0.5,0.7-2.1,0.8,0.9,0.9-1.2,1,1-1.7,1-2.5,1.1-3.1,1.2-2,1.3-4,1.4,1.4-2.6,1.5-2.3,1.7-2.8,1.9,1.9-4.2,1.9-5.8,1/2,1/2-3/4,10,10-24,11-15,2-12,2-3.8,2.5-7.8,2.6-5.9,2.9-4.7,3.7-6.3,3.7-7,4-13,4.8-7.6,5-7.5,6-16,6.7-15,8.1-18,8.5-22,abaxial,abaxially,accrescent,acuminate,adaxially,ag,age,along,alyx,anthesi,apart,apparently,around,attenuate,axillary,bark,becoming,blade,blunt-tippe,branch,brown,bud,c.,calyx,closely,cylindrical,dark,decurrent,deltoid,diameter,directed,distally,drying,eaf,early,echinoi,edge,eed,elliptic,elongate,ength,exserted,farinose,flower,free,fruiting,glabrescent,glabrous,granular-tomentose,gray,grayish,green,high,inserted,lacking,lanceolate,lateral,lengthening,less,lobe,lobed,lon,longitudinal,m.,main,midrib,midvein,mostly,nflorescence,oblong-lanceolate,obscured,often,older,orangish-tan,orbicular,orolla,ovate-orbicula,overlapping,peduncle,perfec,present,prominent,pubescence,pubescent,quarter,rachi,relatively,reticulate-punctate,rounded,ruit,runk,side,slightly,slit,somewhat,spaced,sparsely,stalk,stamen,stellate,stigma,stout,style,subcampanulate,sublenticular,subspherical,sulcate,suture,tamen,thick,thicker,thin,tip,tomentose,tomentu,touching,tube,ud,unarme,upper,usually,vary,vein,way,wide,yellowish,ympodial,young	articulation,bract,branching,broad-based,cell,colour,form,growth,heteromorphism,inflorescence,insertion,interjected,interpetalar,leaflet,length,marking,na,needle-like,odour,orientation,paired,placement,position,prickle,pseudostipule,rhizome,scale,shape,smell,spot,staman,stone,structure,symmetry,sympodial,texture,tissue,trichome,tuber,type,vegetative,xylopodia,zygomorphy
208	wfo-0001028228	success	143	137	111	32	26	0.776	.5,0.1-1.7,0.75,1-1.5,1.1-1.2,1.1-2.5,1.5-2,1.8-3.4,10-30-flowered,2,2-5,2-8,2.1-4.2,2.8-6.5,3/4,6-7,6-8,7.5-12.5,abruptly,acute,age,anther,anthesi,apex,area,bark,base,becoming,berry,brown,calyx,campanulate,clavate,closely,cm,coriaceous,corolla,dark,deflexed,dia,difoliate,distal,dry,elliptic,erect,exserted,filament,fragrant,fruiting,glabrous,globose,green,greenish-yellow,lateral,leaf,lobed,long,main,major,material,middle,minor,minute,minutely,mm,narrowing,obovate,occasionally,older,opposite,ovary,overlapping,ovoid,ovoid-reniform,pair,pale,papillose,pedicel,petiole,pore,portion,reticulate,rounded,scar,shaped,shining,shrub,small,spaced,stem,stigma,straight,style,surface,sweetly,tear-drop,terminal,thickened,tip,tree,tube,unit,usually,vein,way,weight,white,widest,woody,x,young	1.2-1.8,ba,beginning,beneath,caly,deltoid,eaf,edicel,eed,free,geminat,impressed,inflorescenc,lobe,lon,lower,margin,nflorescence,planar,poricidal,prominent,ruit,shinin,simple,slender,slightly,styl,tall,tapering,thick-margined,ud,ympodial	bud,colour,diameter,exsertion,flower,form,fragrance,fruit,geminate,growth,height,inflorescence,length,number,part,pattern,plant,position,seed,shape,size,spacing,structure,sympodial,texture,type
209	wfo-0001028263	success	156	152	91	65	61	0.583	0.25,1-4,11-13,11-23,14-44,2-3,2.6,3,3.4,4,6,6-8,8-14,9,abaxially,acuminate,acute,adaxially,apex,apical,apically,base,branched,broadly,cell,cm,conical,connate,cordate,corolla,cuneate,cyme,darker,deep,dehiscent,diameter,dichasial,dichasially,distal,dorsally,edge,elliptical,filament,flat,flower,folded,green,green-white,hair-like,herbaceous,interjected,introrse,lateral,leaf,leaflet,light,lower,maturing,medium,mm,monochasial,oblique,odd-pinnate,often,ovate,ovoid,pedicel,peduncle,perennial,perfect,plant,poricidally,proximal,puberulent,pubescent,rotate,seed,sessile,short,slit,stigma,straight,strigose,style,throughout,tuber-bearing,unit,violet,wall,yellow,Â¼	1-2,1-3,2,2-4,3-6-foliat,3.5-4.2,4-5,5-7,5-7.5,8-1.,abaxiall,acumen,articulate,atenuate,calyx,covering,digestion,diminishing,eaf,ebracteate,eed,emoval,enzyme,equal,exceeding,first,forked,generally,globo,gradually,half,honeycomb,living,lobe,lon,long,lunat,make,mucilaginous,nflorescence,nther,orolla,pair,pattern,petiole,plan,reveal,ruit,seudostipule,size,specimen,stamen,tal,tem,terminal,testal,thick,throughou,toward,truncate,two,typically,vary,wide,ympodial	3-6-foliate,8-19,anther,arrangement,articulation,attachment,bract,branching,broad-based,colour,connective,dehiscence,ebbrate,fork,form,fruit,globose,growth,hair,height,heteromorphism,inflorescence,interpetalar,length,lunate,marking,modification,na,needle-like,number,odour,orientation,ovary,perfection,placement,pore,position,presence,present,prickle,pseudostipule,scale,shape,smell,spot,staman,stem,stone,structure,surface,symmetry,sympodial,texture,tissue,trichome,tuber,type,vegetative,width,xylopodia,zygomorphy
210	wfo-0001028280	success	87	91	52	35	39	0.598	.5,0.7-1,1-2,1-2-flowered,2-2.5,2-3,7-8,acuminate,almost,apex,arching,attenuate,bark,base,berry,ciliate,closely,cm,completely,dark,elliptic,flattened,fruiting,glabrous,globose,green,lanceolate,lateral,leaf,main,margin,middle,minutely,mm,narrowly,onto,opposite,pair,pedicel,petiole,rounded,scar,shrub,simple,spaced,stem,surface,tip,vein,widest,winged,woody	1.5-2.7,6-9,anthesi,ape,axil,branch,brow,decurrent,dia,eaf,eed,immature,know,known,lon,long,lower,new,nflorescence,older,papillae,pendant,present,ruit,sessil,small,somewhat,tall,ud,ultimate,unifoliat,unit,x,ympodial,young	branching,brown,cell,ciliation,colour,decurren,decurrency,diameter,flower,form,fruit,glabrousnes,growth,height,heteromorphism,inflorescence,length,na,number,odour,orientation,pattern,placement,plant,position,prickle,pseudostipule,rhizome,sessile,shape,spacing,staman,stone,symmetry,texture,tuber,type,width,xylopodia
211	wfo-0001028281	invalid_json_followup	267	174	138	129	36	0.517	+,-1,-20,-3,-36,-45,-5,.5,0.2-0.3,0.2-0.5,0.3-0.5,0.5-0.6,0.5-0.7,0.5-1,0.5-1.1,0.5-1.2,0.75-1,1,1-1.5,1-3,1.0-1.6,1.1-1.4,1.1-2.4,1.2-1.6,1.4-4,1.7-2.5,10-30,2-13,2-4,2-locular,2.1-3.0,3-16,3-foliate,7-30,abaxial,acuminate,acute,adaxial,almost,anther,apex,apical,appendage,articulation,axi,base,basiscopically,bent,bract,branching,broadly,brown,calyx,capitate,cell,cm,column,conical,corolla,dark,darker,deep,densely,diameter,distal,doubly,eglandular,elliptic,elongate,entire,extended,filament,form,fruit,fruiting,glandular,globose,golden,green,hair-like,half,head,imparipinnate,inflorescence,interjected,internode,interrupted,lateral,leaf,leaflet,like,lobe,margin,medial,mm,multi-cellular,narrowly,oblique,obovate,occasionally,once-branched,outgrowth,ovary,ovate,pale,paler,pedicel,peduncle,point,pseudostipule,pubescent,regularly,rotate,serrate,shrub,small,smooth,sometimes,sparsely,staminal,stem,sterile,stigma,stripe,strongly,style,testa,three,toward,transparent,trichome,type,uniseriate,unit,usually,vine,wall,yellow	-0.9,-10,-7,-8,.2,.4,0.05-0.4,0.1-0.15,0.15-0.2,0.2-0.7,0.3-1,0.5-,0.7-,0.7-1.2,0.7-2.5,0.8-1,1-,1-5,1.2-1.5,1.5-2,1.5-6,10-18,2-4-celled,2-6.5,2.5-,20-30,3-5,3-8.5,5-8-celled,6,6-15,abaxially,absent,alternate,anthesi,appearance,appressed,arising,autogamous,berr,blade,bracteate,composed,covering,decreasing,decurrent,developed,dry,eaf,edicel,eed,either,elongate-triangular,enclosing,exerted,exserted,flower,fragile,free,generally,giving,glabrous,gland,gree,hal,halfway,included,large,largest,less,lon,long,longest,lower,material,midvein,minute,mixture,multi-celled,multicellular,nflorescence,node,opposite,orbicular,other,pair,patent,petiole,petiolule,population,portion,present,primarily,primary,probably,proximal,rachi,rest,ruit,secondary,serrat,sessile,set,shorter,silky,size,smaller,sparser,sprawling,stiff,straight,subopposite,surface,tem,terminal,tertiary,thick,thin,tip,tube,ud,unicellular,vein,weak,weak-walled,well,wide,winged,ympodial	'',1-2,2.5-6-15,[,``,arrangement,bend,breeding,bud,character,characteristic,colour,connective,growth,hair,length,marking,modification,na,pattern,pore,position,pubescence,seed,shape,spot,structure,symmetry,sympodial,system,thicknes,value,width,zygomorphy,{,}
212	wfo-0001028317	success	204	138	87	117	51	0.426	0,0.5-3.5,0.6-1.2,0.6-1.5,0.8-1.1,1-1.3,1-4,1/4-2/3,1/5,5-8,anther,apex,articulated,base,berry,branched,bright,brown,calyx,chartaceous,cm,cream,cuneate,curved,dark,densely,difoliate,dull,elongating,equal,filament,filiform,flattened-reniform,fruit,fruiting,gray,green,hair,herb,lanceolate,lateral,leaf,length,lobed,lower,margin,marking,mature,maturity,mauve,mm,moderately,obtuse,orange-brown,ovate,pale,pedicel,per,petiole,poricidal,prickle,purple,red,reflexed,shrub,simple,sometimes,sparsely,spherical,spreading,stellate,stellate-pubescent,stem,straight,style,surface,tapering,terminal,tip,toward,trichome,unit,upper,white,yellow,yellow-green,young	-1.5,-5,/5,0-1,0-5,0.1,0.1-0.25,0.1-0.3,0.1-0.4,0.3-0.4,0.3-1,0.6-0.8,0.8-2.5,1-3,1.1-1.9,1.4-2,1.8-2.5,1/,1/3-1/4,2-2.8,2-4,2-4.5,2.5-6.5,2.8-3.3,2/3,3-10,3-4,3-5,4-5-merous,4-6,4-8,6-10,abaxially,absent,acuminat,acute,almost,alyx,apar,apart,apically,apparently,bark,blade,broad-deltate,brow,concolorous,deltate,diameter,distance,drying,eaf,eed,erect,extending,eye,flower,free,geminat,glabrous,herbaceous,infructescence,lobe,long,longer,midpoint,midvein,minute,naked,nflorescence,oblong,older,one,open,orolla,oung,pair,peduncle,pendulous,perfec,pericarp,porrect,portion,prickl,prickly,primary,ray,reduced,rounded,ruit,scandent,scar,sessile,shorter,side,smooth,spaced,stalk,stalked,subsessile,tamen,terete,tertiary,time,translucent,truncate,tube,unarme,unarmed,variously,vary,vein,venation,visible,way,wide,ympodial	articulation,bract,branching,breeding,broad-based,cell,colour,connective,corolla,form,geminate,growth,heteromorphism,inflorescence,insertion,interjected,interpetalar,leaflet,modification,na,needle-like,number,odour,orientation,ovary,paired,pattern,placement,pore,position,pseudostipule,rhizome,scale,seed,shape,smell,spot,staman,stone,structure,symmetry,sympodial,system,texture,tissue,tuber,type,vegetative,width,xylopodia,zygomorphy
213	wfo-0001028323	success	164	118	66	98	52	0.402	0.2-1,1-1.5,1.5-2.5,3.5-4,anther,apex,appressed,articulated,attenuate,base,berry,blue-green,c.,calyx,cell,cm,coriaceous,corolla,dark,dendritic,densely,ellipsoid,entire,fading,filament,fruiting,growth,inflorescence,internodal,leaf-opposed,lengthening,lobed,lower,margin,maturity,minute,mm,occasionally,ovoid,pale,papillose,pedicel,peg,perfect,petiole,pore,poricidal,remaining,revolute,shoot,short,shrub,simple,small,sometimes,stem,surface,thick,tip,trichome,uniseriate,unit,violet,way,white,x	-2,0.2-0.5,0.4-1.3,0.5,0.5-1,0.6-1,0.8,0.9-1.2,1,1-1.2,1-2,1.1-4.5,1.5,2-3,2-9,3,3-5,3-6,5-6,7.5-9,abaxially,abscissio,absent,acute,along,anthesi,apart,apparently,ba,bark,brown,capiatate,conical,cup-shaped,deltate,diameter,drying,eaf,eed,elliptic,erect,fleshy,flower,free,glabrescen,glabrescent,glabrous,globose,grey,included,lanceolate,less,like,lobe,longer,main,minutely,new,nflorescence,ovary,ovate,pair,papillat,peduncle,pericarp,pitted,planar,plurifoliat,portion,primary,proceed,pubescent,reddish,rounded,ruit,scar,scattered,shiny,sinus,soft,somewhat,soon,sparely,sparsely,splitting,stigma,straight,style,tearing,testal,thin,tube,tuft,ud,vein,wall,woody,ympodial	abscission,articulation,bract,branching,breeding,broad-based,colour,connective,form,fruit,hair,heteromorphism,inflated,insertion,interjected,interpetalar,leaf,leaflet,length,marking,mature,modification,na,needle-like,odour,orientation,paired,pattern,placement,plurifoliate,position,present,prickle,pseudostipule,rhizome,scale,shape,smell,spot,staman,stone,structure,symmetry,sympodial,system,texture,tissue,tuber,type,vegetative,xylopodia,zygomorphy
214	wfo-0001028329	success	215	93	55	160	38	0.256	0.8-1.4,0.9-1.3,1-6,2-3,anther,apex,apical-lateral,articulated,asperous,base,berry,blunt-tipped,branched,calyx,cm,corolla,dichotomously,filament,finely,fleshy,fruit,green,growth,hair,introrse,large,leaf,length,long-attenuate,margin,minutely,mm,obelliptic,oblong,pedicel,petiole,plurifoliate,pore,pseudo-terminal,ripe,short-,shrub,simple,slightly,small,stellate,stellate-rotate,tree,turning,unarmed,unit,velutinous,white,x,yellow	.5-3,.75-2,.75-5.75,/10-3/10,0-100,0.2-0.3,0.8-1.1,1.0-1.4,1.1-2.5,1.3-1.8,1.3-2,1.5-2.3,1.5-2.75,1.5-3.5,1.5-8,10-34,12,2-4,2.2-3.9,2.6-5,2.75-4.5,3-14,3-8,3.75-7,3/4,4-15,4-5,5-10,6-11,6-8,6-9,7-19,abaxially,absen,acuminate,acute,adaxially,ag,angled,anthesi,apart,apparently,axe,axillary,ba,bark,becoming,blade,branch,brown,bud,chartaceous,closely,conical,continued,cylindrical,dehiscing,deltoid,dendritic-echinoi,dendritic-echinoid,diameter,distantly,distinct,due,eaf,echinoid,eed,entire,flower,free,glabrescen,glabrous,granular,granular-tomentose,gray,grooved,high,honeycombed,inserted,lateral,lengthening,lobe,lobed,long,longitudinally,lower,main,midvein,moderately,mostly,multangulat,multangulate,nflorescence,obovate,obscured,obtuse,occasional,older,orbicular,orolla,ovate,ovate-elliptic,pale,peduncle,perfect,porrect-stellate,present,pubescent,rachi,rather,receptacle,relatively,reniform,reticulate-punctate,ruit,runk,sessil,sessile,several,short-stalked,side,slit,sometimes,spaced,sparse,sparsely,stalked,stellat,stellate-pubescent,stelliform,stem,stigma,style,subcapitat,subglobose,suborbicular,suture,swollen,tamen,testa,thick,thickened,thin,time,tomentose,tomentu,touching,toward,tube,unarme,usually,vary,vein,vestigial,way,whitish,wide,yellowish,ympodial,young	articulation,bract,branching,cell,colour,connective,form,fruiting,glabrescent,heteromorphism,inflorescence,insertion,interjected,interpetalar,leaflet,marking,na,odour,orientation,paired,placement,position,prickle,pseudostipule,rhizome,scale,shape,spot,staman,stone,structure,symmetry,sympodial,texture,tissue,tuber,type,xylopodia
215	wfo-0001028337	invalid_json_followup	195	145	85	110	60	0.436	-2,-2.5,-4,.5,0.3-0.5,0.4-0.7,0.7-0.9,1-2,1-3,1.5-3,1.8-2,2-2.2,2-4,4-5,5-25,5-8,abaxial,adaxial,anther,apex,articulated,base,berry,calyx,chartaceous,cm,connivent,cuneate,dark,densely,diameter,elongating,entire,evenly,filament,flattened-reniform,flower,fruit,fruiting,glabrescent,glaucous,green,green-brown,hair,inflorescence,juvenile,lateral,leaf,length,lobed,long,lower,margin,marking,mature,mauve,mm,moderately,narrow-oblong,orange-brown,pedicel,per,petiole,poricidal,porrect-lepidote,prickle,prickly,rounded,sessile,shrub,simple,sparse,spherical,stellate,stellate-pubescent,stem,surface,tapering,terete,terminal,trichome,unarmed,white,wide,young	-6,.8,/3,0,0.05-0.15,0.05-1,0.1-0.3,0.4-0.8,0.7-1,1,1-1.8,1.5-4,1/2,1/3-2/3,1/4-1/3,1/8-1/4,11-16,15-50,3-4,5-6,5-merous,6-7,8-10,8-14,abaxially,acut,alyx,apar,apart,ape,apically,apparently,bark,blade,branched,color,conical,curved,deltate,discolorous,drying,eaf,eed,equal,erect,eye,free,fused,gently,glabrou,glabrous,gray,gray-brown,infructescence,juvenil,known,lobe,long-styled,longer,midpoint,minutely,naked,nflorescence,occasionally,older,one,open,orolla,oung,pale,peduncle,perfect,pericarp,pitted,plurifoliat,porrect,portion,primary,ray,reddish,reflexed,ruit,scar,shallowly,shoot,short,short-styled,shorter,slender,small,smooth,spaced,staminate,stout,straight,strongly,style,tamen,time,tip,toward,tube,unarme,unit,usually,vary,vein,visible,way,ympodial	'',[,``,adult,appressed,articulation,bract,branching,breeding,broad-based,cell,character,characteristic,colour,connective,corolla,form,growth,height,heteromorphism,inflated,insertion,interjected,interpetalar,leaflet,modification,na,needle-like,number,odour,orientation,ovary,paired,pattern,placement,plant,pore,position,pseudostipule,rhizome,scale,seed,shape,size,smell,spot,staman,stone,symmetry,system,texture,tissue,tuber,type,value,vegetative,xylopodia,zygomorphy,{,}
216	wfo-0001028339	success	195	129	96	99	33	0.492	.5,0.05-0.1,1-2,1-5,1.1-1.4,1.5,1.5-2,1.7-3.2,10-30-flowered,3.5-4,5-7,8182,anther,apex,appressed,bark,base,beneath,berry,blue,broadly,bud,calyx,capitate,cm,connate,corolla,cuneate,cup-shaped,decurrent,dia,difoliate,dried,filament,filiform,flattened,flower,fruiting,glabrate,glabrous,globose,growth,later,leaf,like,lobed,long,minutely,mm,mustard,nearly,oblique,opposite,ovary,ovate,ovoid-reniform,papillate,pedicel,petiole,pitted,pore,red-brown,schwarz,shaped,shining,shrub,simple,size,slender,slightly,small,somewhat,specimen,speckled,stem,stigma,straight,strongly,style,surface,tapering,tear-drop,texture,tightly,tree,trichome,tube,uniseriate,unit,urceolate,vein,white,winged,x,yellow,young	0.8-1.2,1-1.2,1-1.5,1.2-1.5,10.2-18.5,2.5-5,3.4-5.5,43191,5-angled,5.8-7.9,7-11,8-10,across,acuminate,acute,almost,anthesi,appearance,appearing,attenuate,becoming,brown,carinate,carpel,closely,covered,crystalline,dark,deflexed,densely,differing,distinctly,dry,eaf,edicel,eed,enclosed,epidermi,erect,evenly,exserted,fide,first,floccose,free,frui,geminat,grainy,greyish-brown,irregular,large-celled,lateral,leave,little,lobe,lon,long-triangular,lower,main,major,margin,middle,minor,nee,nflorescence,obscure,occasionally,older,one,overlappin,ovoid,papery,papillose,planar,poricidal,portion,proximal,pulp,reflexed,ruit,scar,secondary,septum,spaced,sparsely,strong,tall,tip,tub,ud,venation,white-lenticellat,white-papillo,white-speckled,wide,widest,woody,yellowish,ympodial	branching,cell,colour,form,fruit,geminate,hair,height,heteromorphism,inflorescence,length,marking,na,odour,orientation,placement,plant,position,prickle,rhizome,seed,shape,spot,staman,stone,structure,symmetry,sympodial,tuber,type,white-lenticellate,white-papillose,xylopodia
217	wfo-0001028351	success	175	140	107	68	33	0.611	.2,.8,0,0.2,0.5,0â,1.0â,1.0â2.5,1.5â4.0,1.6â,2.0â5.0,2â2.5,2â4,3,3â4,4,40,5,5.0,5.0â5.5,5.5â10.5,6â12,abaxially,absent,acute,adaxially,along,annual,anther,apex,base,becoming,blue,branching,brown,calyx,capitate,clavate,cm,colour,densely,diameter,directed,distally,erect,filament,flattened,flower,fruit,glabrous,glandular,globose,green,hair,herb,lanceolate,leaf,like,lobe,lobed,long,longitudinal,margin,midvein,mm,moderately,multicellular,narrowly,number,oblong,occasionally,opening,opposed,ovate,pair,pale,pentagonal,perennial,perfect,petiole,pitted,pore,pubescent,regularly,shallowly,shaped,simple,slender,slit,smaller,stem,stigma,style,surface,tardily,teardrop,truncate,tube,unbranched,unicellular,uniseriate,velutinous,winged,woody,x,â,â3.0	.8â1.0,0.1,0.6,1.0â1.6,1.0â2.0,1.4â1.5,10,2,2.0â2.5,2.1â3.5,2/3,3.4â5.0,5â7,6.5â8.5,8â15,adaxiall,ag,anthesi,apart,apical,articulated,axe,ba,basal,blade,cell,chartaceous,connivent,convex,cylindrical,eaf,eed,equal,fleshy,geminat,indumentum,lamin,lon,lower,m.,nfloresence,obtuse,orolla,pedicel,peduncle,plurifoliate,present,probably,ruit,serrate,shiny,side,spaced,sparsely,stone,straight,tal,tamen,tem,time,unit,unknown,vary,white,wide,wing,ympodial,young	1.5,age,appressed,bract,corolla,form,fruiting,growth,height,heteromorphism,history,inflated,inflorescence,lamina,length,life,marking,na,odour,ovary,plant,position,seed,shape,size,smell,spot,staman,symmetry,texture,type,vegetative,zygomorphy
218	wfo-0001028353	invalid_json	177	134	110	67	24	0.621	/3,0.2-0.4,0.5,1,1-4,1.4-2,1.5-2,1.5-5,2,2-3,2-4,3-5,4-7,6-8,7,acute,age,anther,anthesi,apart,apex,base,beneath,berry,bluntly,bright,calyx,campanulate,capitate,cell,centre,clasping,cm,coarsely,conical,cordate,corolla,dark,deep,deeply,diameter,ellipsoid,elliptic,erect,exerted,filament,fleshy,fruiting,glabrous,globose,green,greenish,herb,heteromorphic,hollow,honey-comb,internodal,leaf,lengthening,less,like,long,margin,midrib,minute,minutely,mm,nodding,ovary,ovoid,pale,papery,papillose,pedicel,peduncle,petiole,pitted,plant,plump,pore,poricidal,pubescent,purple,rhomboid,ripe,scar,scattered,short,simple,size,slender,slit,somewhat,sparsely,stem,stigma,strongly,style,surface,tan,testal,tip,toothed,trichome,truncate,uniseriate,vein,way,x,yellow	.5,0.5-,0.9-1.2,1-2,3,8-10,abaxially,accrescent,along,area,becoming,ciliate,cup-shaped,curved,decreasing,decumben,densely,difoliate,distally,dry,drying,eaf,edicel,eed,emarginated,flower,fracturing,free,frui,geminat,gree,growing,horn,horned,inserted,lobe,lon,lower,m.,material,nflorescence,often,open,outline,pair,papillate,pericarp,point,portion,primary,principal,reddish,ruit,sessil,sessile,shallow,sleeve,slightly,straight,thin,toward,tube,ud,unit,wall,wrinkled,ympodial	'',[,``,abaxial,arrangement,bud,characteristic,colour,form,fruit,growth,hair,height,inflorescence,length,modification,position,seed,shape,texture,type,value,{,}
219	wfo-0001028390	invalid_json_followup	147	143	74	73	69	0.503	0.5,0.5-1,0.5-1.5,0.5-2.5,1-2.5,1.5-2,1.5-3.5,10-15,3-4,3-5,4-5,5-7,7-8,acute,angled,apex,apiculate,base,calyx,chartaceous,cm,cuneate,cylindrical,deltate,densely,diameter,directed,divided,elliptic,entire,felty-pubescent,forked,glabrous,globose,hair,lanceolate,lobe,lower,margin,mm,near,obtuse,often,orange,ovate,pedicel,peduncle,perfect,petiole,pore,pseudohair,pubescent,rachi,radiu,rarely,shrub,simple,slightly,sparsely,stellate,stigma,style,subclavate,subcordate,subcoriaceous,truncate,unbranched,unequally,unit,violet,white,white-pubescent,x,yellow	-10,.5-3.3,0,1,1-3,1-5,1.5-5.5,2,2.5,4-11,6-many-foliat,7,9,abaxially,absen,adaxiall,adaxially,aggregate,apart,articulated,axe,blade,branched,cell,connivent,curled,dendritically,dendritically-branched,dense,distall,eaf,eed,eglandular,flower,gland,leaving,less,like,lon,long,midvein,mixed,moderately,mostly,narrowly,nflorescence,nther,occasionally,orolla,peg,presen,puberulent,pubescen,ripe,ruit,scar,short,small,spaced,stalked,ste,stone,subcapitat,tal,tem,time,tip,triangular,tube,usually,vary,wide,ympodial	'',6-many-foliate,[,``,abaxial,adaxial,anther,appressed,articulation,bract,branching,breeding,broad-based,characteristic,colour,connective,corolla,direction,distally,filament,form,fruit,fruiting,growth,height,inflated,inflorescence,insertion,interjected,interpetalar,leaf,leaflet,length,marking,mature,modification,na,needle-like,odour,orientation,ovary,paired,pattern,placement,plant,position,prickle,pseudostipule,scale,seed,shape,smell,spot,stem,structure,subcapitate,surface,symmetry,sympodial,system,texture,tissue,trichome,type,value,vegetative,zygomorphy,{,}
220	wfo-0001028405	success	149	96	68	81	28	0.456	0.4-0.5,0.5-3,1-4,1-9,1.5-6.5,10-11,2,2-2.5,2-3,3-20,3-4,3.5-10,4-11.5,4-6,6-7,7-14.5,8-15,9-15,branched,calyx,cm,conical,connate,corolla,cyme,dehiscent,diameter,dichasially,distal,elliptic,elliptic-lanceolate,filament,flower,forked,generally,green,green-white,half,herbaceous,honeycomb,interjected,lanceolate,lateral,leaf,leaflet,mm,mucilaginous,odd-pinnate,ovoid,pattern,pedicel,peduncle,perennial,perfect,petiole,plant,proximal,puberulent,seed,size,stellate,straight,style,terminal,throughout,tuber-bearing,unit,Â¼	1.3-8,2-4,3-6-foliat,3.5-6.5,abaxially,absen,acumen,acute,adaxially,apex,apical,apically,apiculate,articulate,attenuate,base,cell,covering,decurrent,dichasial,digestion,diminishing,dorsally,eaf,ebracteate,edge,eed,emoval,enzyme,exceeding,flat,folded,globo,gradually,hair-like,introrse,living,lobe,lon,long,lower,lunat,make,maturing,monochasial,nflorescence,nther,oblique,oblong,often,orolla,ovate-elliptic,pair,plan,poricidally,rachi,reveal,ruit,seudostipule,short,short-acuminate,short-petiolate,slit,specimen,stamen,stigma,subsessile,tal,tem,testal,thick,throughou,toward,typically,vary,wall,whit,wide,without,yellow,ympodial	3-6-foliate,absent,anther,apicidally,arrangement,articulation,branching,colour,form,fruit,growth,height,inflorescence,length,lunate,number,ovary,pore,position,pseudostipule,shape,stem,structure,sympodial,texture,type,white,width
221	wfo-0001028429	success	162	123	69	93	54	0.426	1-4,1.5-3,2.5-7.5,4-14,abaxially,adaxially,apex,apical,apically,articulate,base,branched,calyx,cell,cm,connate,cordate,corolla,cuneate,darker,dehiscent,dichasially,distal,filament,generally,glabrescent,glabrous,globose,green,greenish,hair,hair-like,half,herbaceous,interjected,introrse,leaf,leaflet,light,long,lower,maturing,medium,mm,oblique,odd-pinnate,often,ovoid,pattern,pedicel,pentagonal,perennial,perfect,petiole,plant,poricidally,proximal,rotate,scattered,short,slightly,slit,spot,throughout,tuber-bearing,unit,violet,white,Â¼	0.2-0.4,0.8-1.2,0.9-2.3,1-2.5,1.5-4,10-11,10-27,10.5-21,2-1.,2-3,2-4,2-8,2.5-12,2.5-4,2.7-3.6,3-6,3-6-foliat,5-12,6-18,6-28,7-7,abaxiall,acumen,acuminate,acute,broadly,covering,cyme,diameter,dichasial,digestion,diminishing,dorsally,eaf,ebracteate,edge,eed,elliptical,emoval,enzyme,especially,exceeding,flat,flower,folded,forked,globo,gradually,green-white,honeycomb,lateral,living,lobe,lon,long-attenuate,lunat,make,monochasial,mucilaginous,narrowly,nflorescence,nther,obovate,orolla,ovate,pair,peduncle,petiolule,plan,reveal,ruit,seed,seudostipule,size,specimen,stamen,stigma,straight,style,tal,tem,terminal,testal,thick,throughou,toward,typically,vary,vein,wall,wide,yellow,ympodial	2-19,3-6-foliate,anther,appressed,articulation,bract,branching,breeding,broad-based,colour,connective,form,fruit,fruiting,growth,heteromorphism,inflated,inflorescence,insertion,interpetalar,length,lunate,margin,marking,mature,modification,na,needle-like,odour,orientation,paired,placement,pore,position,present,prickle,pseudostipule,rhizome,scale,shape,staman,stem,stone,structure,surface,symmetry,sympodial,system,texture,tissue,tuber,type,xylopodia,zygomorphy
222	wfo-0001028436	success	150	140	84	66	56	0.56	.5,0.2-0.4,0.5,1-2,1-2-celled,1.5,1.5-2,1.5-2.5,10-20,2-4,2.5-3,4,5-10,5-12,5-15,5-8,7,8-12,absent,abundant,acute,anther,apex,base,berry,brown,calyx,cell,center,chartaceous,ciliate,diameter,difficult,dm,dried,edge,elliptic,entire,filament,fine,flower,fruit,fruiting,glabrous,globose,hair,interpetalar,leaf,linear,linear-lancolate,lobe,margin,membranaceous,mm,moderately,much-branched,oblong,parallel,pedicel,per,petiole,pubescent,radiating,raised,ridge,rotate,running,shallow,shrub,stem,stigma,structure,style,surface,taproot,tissue,triangular,tube,two-celled,unbranched,unit,white,woody,x	0.5-1,0.8-1.5,1-3,1st,2-3,2nd,abaxially,adaxiall,adaxially,along,apically,appearance,appearing,axe,beyond,blade,cm,connected,cordat,decurrent,deflated,dehiscent,due,eaf,eed,evaluat,explosively,exserted,flat,frui,geniculate,glabrescen,lengt,like,long,lower,lying,nearly,nflorescence,notch,often,older,orolla,oung,peduncle,placenta,pointing,presence,pubescen,rachi,reaching,rhizomatous,ruit,small,sparsely,stamen,swollen,tal,tamen,tear,thick,unifoliate,vary,wid,wrinkled,ympodial	appressed,articulation,bract,branching,breeding,colour,connective,cordate,corolla,evaluate,form,growth,height,heteromorphism,inflated,inflorescence,insertion,interjected,leaflet,length,marking,mature,modification,na,number,odour,orientation,ovary,paired,pattern,placement,plant,pore,position,prickle,pseudostipule,pubescence,reproduction,rhizome,root,scale,seed,shape,spot,staman,stone,symmetry,sympodial,system,texture,tuber,type,wide,width,xylopodia,zygomorphy
223	wfo-0001028465	success	159	113	64	95	49	0.403	1-4,10,2-6,3-4,3-8,4.5-5.5,5-7,apex,apical,apically,articulate,base,branched,calyx,cell,cm,connate,corolla,cuneate,dehiscent,dichasially,distal,ebracteate,filament,generally,globose,green,half,herbaceous,interjected,interpetalar,introrse,leaf,leaflet,long,maturing,medium,mm,oblique,odd-pinnate,often,pattern,pedicel,perennial,perfect,petiole,petiolule,plant,poricidally,proximal,puberulent,pubescent,purple,rotate,sessile,short,slit,spot,strigose,throughout,tuber-bearing,unit,white,Â¼	0.75,1-2,1.2-2,1.5-2.9,10-24,11-23,2,2-3,2-4,2-9.3,2.4-2.8,2.5-4,3-5,3-6-foliat,3.8-7,4-1.,4-8,7-15,8-10,9-19,abaxially,acumen,acuminate,acute,adaxially,attenuate,broadly,covering,cyme,decurrent,diameter,dichasial,digestion,diminishing,dorsally,eaf,edge,eed,elliptical,emoval,enzyme,equal,exceeding,first,flat,flower,folded,forked,globo,gradually,green-white,hair-like,honeycomb,lateral,living,lobe,lon,lower,lunat,make,monochasial,mucilaginous,nflorescence,nther,orolla,ovoid,pair,peduncle,plan,rachi,rarely,reveal,ruit,seed,seudostipule,size,specimen,stamen,stigma,straight,style,tal,tem,terminal,testal,thick,tissu,toward,two,typically,vary,wall,wide,yellow,ympodial	3-6-foliate,4-18,anther,appressed,articulation,bract,branching,breeding,colour,connective,form,fruit,fruiting,growth,hair,heteromorphism,inflated,inflorescence,insertion,length,lunate,margin,marking,mature,modification,na,odour,orientation,paired,placement,pore,position,prickle,pseudostipule,rhizome,scale,shape,staman,stone,structure,symmetry,sympodial,system,texture,tissue,tuber,type,xylopodia,zygomorphy
224	wfo-0001028468	success	255	131	83	172	48	0.325	-10,.3-0.4,/10-1/5,0.6-2,0.7-2.5,2-9,20,5-21,accrescent,along,anther,apex,appressed,articulated,attenuate,base,berry,blade,blue,broad-based,brown,calyx,central,chartaceous,clavate,cm,compressed,corolla,directed,distally,extra-axillary,filament,fruit,fruiting,glabrous,hair,interpetalar,lateral,laterally,length,light,lower,margin,mixed,mm,oblique,oblong-lanceolate,occasionally,orange,orangish,pedicel,per,perfect,petiole,pore,porrect-stellate,prickle,purple,recurved,rotate-stellate,sessile,short,short-stalked,shrub,similar,simple,slightly,somewhat,stellate-pubescent,stem,straight,subcuneate,subglobose,subshrub,surface,tissue,unbranched,unifoliate,unit,usually,vein,x,yellow	-1.3,-3,-4,-5.5,-7,.1-0.2,.1-0.3,.1-0.4,.2,.2-0.4,.3,.5,.5-1.5,.5-1.6,.6-1,/4-1/3,0.05,0.1,0.2-0.3,0.2-0.6,0.2-1.5,0.4-1,0.4-4,0.5-2,0.5-3,0.5-3.3,0.5-3.5,0.5-8,0.6-1.2,0.8-3.5,1,1.2-1.5,1.3-2,1.5-2.2,1.5-3.1,1.6,1/3-1/2,1/5-1/2,16,2,2.2-3,2.5-4,2.8-4.1,2/3-3/4,3-4,4-6,4-9,5-9,6-10,6-9,abaxially,acuminate,acute,adaxially,apart,ark,armed,axe,becoming,beyond,broadly,bu,bud,c.,campanulate,cauline,commonly,compresse,connivent,d.,dark,decreasing,densely,density,diameter,distal,distantly,dry,eaf,eed,ellipsoid,equal,exserted,flattened,flower,foveate,geminat,glabrescent,gradually,gray,green,greenish,half,increasing,inserted,introrsel,lamin,lobe,lobed,long,longer,m.,main,midpoint,midvein,minutely,moderately,mostly,multangulat,multangulate,narrowly,nflorescence,oblong-conical,obtuse,older,orolla,ovate,overlapping,ovoid,pair,pale,papillo,peduncle,proximal,pubescence,pubescent,rachi,ray,reduced,relatively,reticulate,rhombic,ruit,shallowly,short-,side,similarly,spaced,sparsely,specimen,stalk,stamen,stelliform,stigma,style,subacuminate,subcapitate,subchartaceous,subelliptic,sublenticular,subreniform,subsessile,tal,tamen,terete,testa,thick,thick-stalked,thicknes,time,touching,toward,triangular,tube,unarmed,upper,vary,way,wide,yellowish,ympodial,young	articulation,bract,branching,breeding,cell,colour,dm,form,geminate,growth,heteromorphism,inflated,inflorescence,insertion,interjected,introrsely,lamina,leaf,leaflet,marking,mature,na,needle-like,odour,orientation,paired,pattern,placement,position,pseudostipule,rhizome,scale,shape,smell,spot,staman,stone,structure,symmetry,sympodial,system,texture,trichome,tuber,type,vegetative,xylopodia,zygomorphy
225	wfo-0001028470	invalid_json_followup	185	178	121	64	57	0.654	0-18,0.25-0.75,0.9-2.2,0.9-2.3,1-12.3,1-2,1-3,1.6-3.2,11.8-21,12-44,2-10,2-7,2-8,2.1-3.9,3-10,3-5,3.5-16,3.5-7,4-6,4-7,5.5-11.6,6-33,abaxially,adaxially,anther,articulated,asymmetric,attenuate,axillary,base,basiscopic,berry,blade,brownish,bud,cell,chartaceous,clavate,cm,condition,corolla,covering,dark,deep,diameter,distal,dot,drying,end,filament,flower,forked,fresh,fruit,generally,glabrous,green,green-white,greenish,hair,half,herb,high,homostylous,interjected,lanceolate,lateral,leaf,leaflet,light,lobe,long,make,medium,mm,mottled,mucilaginous,odd-pinnate,one,ovoid,pair,pedicel,peduncle,pentagonal,petiolulate,placed,plant,pore,poricidal,purple,ripe,rounded,scarce,seed,short,side,size,sometimes,stigma,straight,style,substellate,subtending,terminal,testal,thick,throughout,tip,tissue,tube,tuber,typically,unwinged,usually,wall,wet,white,whitish,wide,wing,x	1.5-2.8,2-5,3.2-5.5,5-merou,acumen,acute,adaxiall,ag,alyx,apart,apex,apparently,axe,capitat,connivent,decreasing,digestion,dorsally,eaf,edge,eed,elliptic,enzyme,erec,exceeding,flat,folded,geminat,glabrescent,glabrou,hair-like,hal,honeycomb-shaped,lengthening,living,lower,nflorescence,orbicular,orolla,ovate,perfect,petiole,plurifoliate,pubescent,removed,ruit,sessile,seudostipule,slit,spaced,specimen,stamen,stolo,subequal,subglabrou,tall,tamen,tem,toward,tri-,unit,vary,yellow,ympodial	'',[,\u201chair-like\u201d,``,abaxial,adaxial,appressed,arrangement,articulation,bract,branching,breeding,calyx,capitate,characteristic,colour,connective,form,fruiting,growth,height,inflated,inflorescence,interpetalar,length,margin,marking,mature,modification,na,number,odour,ovary,paired,pattern,placement,position,presence,pseudostipule,scale,shape,smell,spacing,spot,staman,stem,stolon,subglabrous,symmetry,system,texture,trichome,type,value,vegetative,{,}
226	wfo-0001028476	success	246	104	57	189	47	0.232	-6,0.4-0.6,0.5,1-4,2-foliate,3-foliate,absent,anther,apex,base,bifurcate,bract,branched,calyx,cell,cm,corolla,dark,distal,filament,fruit,fruiting,globose,green,half,herb,imparipinnate,inflorescence,interjected,interrupted,leaf,leaflet,less,long,lower,margin,mm,pedicel,petiole,present,pseudostipule,pubescent,purple,rarely,regularly,simple,stellate,stem,stripe,surface,trichome,truncate,uniseriate,unit,usually,weak-walled,yellow	-1,-16,-20,-8,.05-0.1,.5,0-,0-0.5,0.1-0.15,0.1-0.4,0.15-0.2,0.15-0.4,0.2-0.3,0.2-0.5,0.2-0.6,0.25-0.4,0.25-0.5,0.3-0.4,0.3-0.5,0.3-0.7,0.3-1.2,0.4-0.5,0.4-1.5,0.5-0.6,0.5-1.7,0.7-2.5,0.8-1.2,0.8-1.6,1,1-1.2,1-1.4,1-1.5,1-2,1-2-celled,1-6,1-celled,1.1-1.5,1.1-1.6,1.2-2.5,1.8-2.5,12-30,2,2-6,2-locular,2.4-3,3-12,3-7,3.5-13,4-celled,5-15,6-,7-10,8-30,abaxially,abundant,acroscopically,acuminate,acute,age,almost,along,also,alternate,anthesi,ape,apical,appearance,appendage,articulated,axi,basal,basiscopically,becoming,bifurcation,bracteate,bright,brown,capitate,column,conical,curved,decurrent,deeply,diamete,diameter,eaf,ebracteate,edicel,eed,elliptic,elongate,entire,especially,exserted,first,flower,fortaleza,give,glabrescent,glandular,gradually,gree,hair-like,hal,head,hyaline,incurved,internode,irregularly,lanceolate,largest,lateral,like,lobe,lobed,lon,main,maturity,midvein,minute,minutely,mixed,narrowly,nflorescence,node,numerous,oblique,obovate,occasionally,often,outgrowth,ovary,pair,pale,peduncle,perennial,petiolule,population,primary,prominent,puberulent,pubescence,rachi,recurve,reflexed,rest,rounded,ruit,rÃ­o,scattered,secondary,sessile,set,short,silky,sinus,slightly,smaller,sparsely,sprawling,spreading,staminal,sterile,stiff,stigma,straight,style,subopposite,tall,tem,terminal,tertiary,testa,thick,tip,toward,tube,ud,unicellular,uniformly,unpaired,vein,wall,white,wid,wide,winged,woody,ympodial	appressed,articulation,berry,branching,breeding,broad-based,colour,connective,form,growth,hair,heteromorphism,inflated,insertion,interpetalar,length,marking,mature,modification,na,needle-like,odour,orientation,paired,pattern,placement,pore,position,prickle,rhizome,scale,shape,smell,spot,staman,stone,structure,symmetry,sympodial,system,texture,tissue,tuber,type,vegetative,xylopodia,zygomorphy
227	wfo-0001028481	success	194	166	119	75	47	0.613	.1,.5,0.5-1,0.6-1,0Â°,1-3,1-4,1.5,1.8-2.5,1/2-2/3,2.5-3,3-3.5,3-4,3-6,5.5-7.5,8,absent,acuminate,almost,along,anther,anthesi,apex,apically,apparently,attenuate,bark,base,branch,branched,brown,chartaceous,clavate,close,cm,colour,conical,corolla,cuneate,cupular,deeply,dendritic,dendritic-pubescent,diameter,dilated,distributed,divided,dorsifixed,dry,drying,elliptic,entire,equal,evenly,filament,flaking,flower,free,glabrous,green,leaf,length,less,liana,like,lobed,long,longer,longitudinally,main,margin,midvein,mm,oblique,oblong,occasional,often,orange-brown,pair,pedicel,peduncle,petiole,pore,poricidal,primary,pubescent,ray,reddish,ridged,scar,shortly,shrub,side,size,small,smoothly,sparsely,stem,stigma,stump,style,surface,terminal,tertiary,thickly,tip,together,trichome,tube,unarmed,unit,unknown,vein,venation,visible,white,x,yellowish,young	.3,0-2,0.1-0.2,0.15,1-1.4,1-2,1.5-2,2-3,3,3-4.5,abaxially,acute,adaxially,age,alyx,apar,articulated,canaliculate,clearly,delineated,deltoid,density,different,discolorous,domatia,eaf,eed,ellipsoi,erect,except,extending,extent,eye,faint,flat,flexuous,increasing,know,known,lamina,lengthening,linear,lobe,lon,long-acuminate,lower,m.,mostly,naked,narrowly,nflorescence,nther,orolla,ovate,perfec,plurifoliat,portion,protruding,rachi,raised,ribbed,ruit,see,simple,sinus,slender,smoot,spreading,tearing,toward,ud,uneven,vary,wide,ympodial	angle,apart,armament,arrangement,articulation,branching,bud,calyx,cell,connective,division,ellipsoid,form,fruit,growth,hair,heteromorphism,inflorescence,marking,modification,na,number,orientation,ovary,pattern,perfect,placement,plurifoliate,position,prickle,protrusion,pseudostipule,rhizome,seed,shape,smooth,spacing,spot,staman,stone,structure,symmetry,sympodial,texture,tuber,type,xylopodia
228	wfo-0001028482	success	224	118	68	156	50	0.304	.1,/3,0.5,1-4,1.1-5,2-celled,3-4,acute,age,anther,apex,asymmetric,base,berry,branched,calyx,chartaceous,cm,corolla,curved,cymose,diffusely,difoliate,entire,expanding,filament,flower,fruit,fruiting,glandular,globose,green,growth,internodal,leaf-opposed,lengthening,lobed,lower,margin,mm,pedicel,petiole,pore,poricidal,pubescent,revolute,shaped,simple,size,slightly,slit,sparsely,stem,straight,subcoriaceous,subglobose,surface,tear-drop,tip,tree,trichome,twice,unifoliate,unit,vegetative,way,white,x	.5,0,0.2,0.5-1,0.5-5,0.7-1.1,00,1-1.5,1-11,1-2,1.2-1.6,1.5-2,1.5-3,10,2-3,3-12,4-5,5-25,6-50,7-14,abaxially,acuminate,adaxially,alternate,angled,anthesi,apiculae,ascending,bark,basal,becoming,berr,bifid,bifurcate,bilobed,bright,broadly,brochiodromous,brownish,bud,campanulate,capitate,channeled,circinate,closely,constriction,coriaceous,corky,corrugated,creamy,cucullate,deciduous,deflexed,deltate,densely,diameter,discolorous,distally,distinct,dry,drying,eaf,eed,ellipsoid,elliptic,emarginate,embryo,enlarged,exerted,exfoliating,flattened-reniform,fleshy,free,fresh,geminat,glabrou,glabrous,golden,grayish,halfway,hard,heterostylous,impressed,incrassate,individual,investing,irregular,keeled,less,lobe,long,markedly,materia,material,maturity,midrib,midvein,minute,minutely,new,nflorescence,nodding,obovate,occasionally,olive,ovary,overlappin,pair,pale,papillat,peduncle,pentamerous,per,pericarp,petal,pitted,portion,primary,reddish,row,ruit,scandent,scar,shiny,short,small,sometimes,somewhat,soon,spaced,stigma,stout,style,subpyramidal,tan,tightly,tiny,transparent,transversely,truncate,tub,tube,tuberculate,tuft,two,ud,uniseriate,usually,vein,venation,woody,yellow,yellowish,ympodial,young,Âµm	appressed,articulation,bract,branching,breeding,broad-based,cell,colour,connective,form,hair,heteromorphism,inflated,inflorescence,insertion,interjected,interpetalar,leaf,leaflet,length,marking,mature,modification,na,needle-like,odour,orientation,paired,pattern,placement,position,prickle,pseudostipule,rhizome,scale,shape,smell,spot,staman,stone,structure,symmetry,sympodial,system,texture,tissue,tuber,type,xylopodia,zygomorphy
229	wfo-0001028487	invalid_json_followup	195	158	102	93	56	0.523	0-9,0.3-0.7,0.4-1.5,0.9-3,1-2,1-3,1.1-1.5,1.4-1.7,10-41,2-4,2-4.8,2-6,2.5-3.5,3-10,3-19,3.4-7.8,4-7,4.6-13.6,5-6,7.8-16.4,anther,apex,attenuate,axillary,base,berry,blade,brownish,bud,central,clavate,cm,condition,coriaceous,corolla,dark,deep,diameter,distal,drying,filament,flower,forked,fresh,fruit,glabrescent,glabrous,green,greenish,hair,half,herb,high,homostylous,interjected,lanceolate,lateral,leaf,leaflet,light,lobe,long,medium,mm,moniliform,mucilaginous,odd-pinnate,ovate,ovoid,pair,pedicel,pentagonal,petiole,petiolulate,plant,pore,poricidal,purple,ripe,rounded,scabrous,scarce,seed,short,size,star,stigma,straight,style,substellate,subtending,terminal,tip,tissue,tube,tuber,wet,white,whitish,wide,wing,x	1-3.2,1.7-7,10-4.3,15-28,3-4,3-5,5-merou,abaxially,acumen,acuminate,acute,adaxiall,adaxially,ag,along,alyx,apart,apparently,arranged,articulated,asymmetric,axe,basiscopic,bead,capitat,cell,connivent,considerably,covering,decreasing,digestion,dorsally,eaf,edge,eed,elliptic,enzyme,erec,exceeding,flat,folded,geminat,generally,glabrou,green-white,hair-like,hal,honeycomb-shaped,lengthening,like,living,lower,make,multiple,narrow,necklace,nflorescence,orbicular,orolla,peduncle,perfect,plurifoliate,removed,ruit,second,sessile,seudostipule,side,slit,smaller,sometimes,spaced,specimen,stamen,stolon,subequal,subglabrou,tall,tamen,tem,testal,thick,throughout,toward,tri-,typically,unit,unwinged,usually,vary,wall,yellow,ympodial	'',[,``,abaxial,adaxial,appressed,arrangement,articulation,bract,branching,breeding,broad-based,calyx,capitate,characteristic,colour,connective,form,fruiting,growth,height,inflated,inflorescence,insertion,interpetalar,length,margin,marking,mature,modification,na,number,odour,ovary,paired,pattern,position,prickle,pseudostipule,scale,shape,smell,spot,staman,stem,subglabrous,symmetry,system,texture,trichome,type,value,vegetative,zygomorphy,{,}
230	wfo-0001028489	success	224	120	71	153	49	0.317	-2.5,0-50,0.3-0.5,0.3-1.2,1/3-1/2,3.5-6,acicular,anther,apex,apparently,articulated,base,berry,branched,calyx,cell,chartaceous,cm,connivent,cordate,cream,cuneate,dark,difoliate,elongating,equal,erect,filament,fruit,fruiting,glabrous,green,hair,lateral,leaf,length,lobed,long,lower,margin,marking,mature,maturity,mauve,membranous,mm,moderately,orange,pale,pedicel,perpendicular,petiole,poricidal,prickle,purple,shrub,simple,sometimes,spherical,stellate,stellate-pubescent,stem,straight,surface,tapering,tip,trichome,truncate,unit,white,young	-0.6,-10,-4,-5,-6,/4,0-10,0-15,0-20,0-3,0.1,0.1-0.6,0.2,0.2-,0.2-0.4,0.2-0.5,0.2-0.6,0.2-0.7,0.3-0.7,0.3-1,0.4-0.8,0.5-0.8,0.5-1,0.5-1.1,0.5-1.5,0.6-1.2,0.7-3,1-3,1-4,1-6,1-7,1.5-3,1.5-4,1.8-2.2,1.8-4,1.8-5.5,1/3,1/4-1/2,2-3,2-4,2-6,2.1-3,3-7,4-10,4-13,4-8,5-25,5-8,5-merous,7.5,abaxially,acute,alyx,apar,apart,apically,ba,bark,beyond,blade,broad-deltate,caudat,concolorous,curved,deltate,densely,diameter,distance,drying,dull,eaf,eed,elliptic,extending,eye,flattened-reniform,flower,free,geminat,gray,herbaceous,infructescence,less,lobe,lon,longer,midpoint,midvein,minute,naked,nflorescence,obtuse,occasionally,often,older,one,open,orange-brown,orange-green,orolla,oung,outline,ovate,pair,peduncle,pendulous,per,perfec,pericarp,porrect,portion,prickly,primary,protruding,raised,ray,red-brown,rounded,ruit,scar,sessile,shiny,side,slender,smooth,spaced,sparsely,spreading,stalk,style,subsessile,tamen,terete,tertiary,time,toward,tube,unarme,unarmed,upper,vary,vein,venation,visible,way,weakly,white-gra,wide,woody,yellow,yellow-green,yellow-orange,ympodial	appressed,articulation,bract,branching,breeding,broad-based,colour,connective,corolla,form,geminate,growth,heteromorphism,inflated,inflorescence,insertion,interjected,interpetalar,leaflet,modification,na,needle-like,none,odour,orientation,paired,pattern,perfect,placement,position,pseudostipule,rhizome,scale,shape,smell,spot,staman,stone,structure,symmetry,sympodial,system,texture,tissue,tuber,type,vegetative,xylopodia,zygomorphy
231	wfo-0001028492	success	130	113	81	49	32	0.623	0.2-2,0.5-1,1-2.5,1-4,1-5,1.5-2.5,1.5-6,15-20,2-2.5,3,3-6,4,5-15,5-8,6-11,8-15,abaxially,acute,aggregate,angled,apart,apex,axi,base,calyx,cell,chartaceous,cm,colored,crystal,cylindrical,dark,deltate,diameter,elliptic-ovate,entire,except,forked,fruit,glabrous,globose,hair,herb,lobe,margin,mm,narrowly,obtuse,pedicel,peduncle,petiole,pore,pubescent,punctate,purple,rachi,radiu,rarely,reticulate,ripe,rounded,shrub,simple,somewhat,sparse,stellate,stigma,stone,style,subcordate,subcoriaceous,succulent,tip,triangular,unbranched,unit,unknown,white,white-punctate,whitish,x	-5-foliat,1.5-3,1.75-3.5,2-3,2-4,2-5,2.5-9,5-25-flower,6-12,absen,adaxially,apiculate,articulated,axe,blade,ciliolate,color,connivent,containing,directed,distall,eaf,eed,glabrou,irregularly,leaving,long,lower,nflorescence,nther,orolla,ruit,san,sand-punctate,scar,spaced,splitting,tal,tem,time,triangular-ovate,truncat,tube,unevenly,vary,veiny,wide,x1-3,ympodial	-5-foliate,5-25,absent,anther,articulation,branching,colour,content,corolla,direction,distally,flower,form,growth,height,inflorescence,leaf,length,ovary,plant,position,sand,seed,shape,spacing,stem,structure,sympodial,texture,truncate,type,width
232	wfo-0001028501	invalid_json_followup	195	156	103	92	53	0.528	0-3,0-3.2,0-4,0.3-0.7,0.8-1.6,0.8-1.7,1,1-2,1-8,1.8-10.7,13-41,2.8-18,2.8-4.9,3-10,3-7,3.1-10.4,3.1-12,4-8,4.8-18,6.6-21.1,8-10,8-34,adaxially,anther,apex,base,berry,blade,broadly,brownish,clavate,cm,condition,coriaceous,corolla,dark,decurrent,diameter,distal,drying,filament,flower,forked,fresh,fruit,glabrescent,glabrous,green,greenish,hair,half,herb,high,homostylous,interjected,lanceolate,lateral,leaf,leaflet,light,lobe,long,medium,mm,moniliform,mottled,narrow,narrowly,odd-pinnate,ovate,ovoid,pair,pedicel,peduncle,petiole,plant,pore,poricidal,purple,pyriform,rotate,scarce,seed,sessile,short,simple,size,sometimes,spot,stigma,straight,style,terminal,tip,tube,tuber,unwinged,usually,white,whitish,wide,wing,x	0.3-3.3,0.6-5.8,1-3,2-4,2-5,3-5,5-merou,abaxially,acumen,acuminate,acute,adaxiall,ag,along,alyx,apart,apparently,arranged,articulated,attenuate,axe,axillary,bead,bud,capitat,cell,connivent,considerably,covering,decreasing,digestion,dorsally,eaf,edge,eed,elliptic,enzyme,erec,exceeding,flat,folded,geminat,generally,glabrou,green-white,hair-like,hal,honeycomb-shaped,larger,lengthening,like,linear,living,lower,make,mucilaginous,multiple,necklace,nflorescence,onto,orbicular,orolla,perfect,plurifoliate,present,rachi,removed,ripe,ruit,seudostipule,slit,spaced,specimen,stamen,stolon,subglabrou,subtending,tall,tamen,tem,testal,thick,throughout,toward,tri-,typically,unit,vary,wall,wet,yellow,ympodial	'',[,``,abaxial,adaxial,appressed,arrangement,articulation,bract,branching,breeding,calyx,capitate,characteristic,colour,connective,form,fruiting,growth,height,inflated,inflorescence,insertion,interpetalar,length,margin,marking,mature,modification,na,number,odour,ovary,paired,pattern,position,presence,prickle,pseudostipule,scale,shape,staman,stem,subglabrous,symmetry,system,texture,tissue,type,value,zygomorphy,{,}
233	wfo-0001028502	invalid_json_followup	158	122	83	75	39	0.525	0.5-1,1-2,1.5-2,1.5-2.5,1.5-6,1.6-2.4,2-4,2-5,2-7,2-8,3.5-15,3.5-4,abaxial,abaxially,acute,adaxially,anther,anthesi,apex,bark,base,beige,blade,branched,brown,calyx,campanulate,christmas-tree-like,clavate,closely,cm,congested,corolla,dark,dendritic,densely,fawn,filament,flattened-reniform,fruiting,glabrous,globose,inflorescence,leaf,light,lobed,lower,margin,minutely,mm,obovate,ovary,packed,papillose,pedicel,petiole,pitted,pore,poricidal,pubescent,reddish-brown,rest,scattered,seed,shining,shrub,small,spaced,stem,stigma,structure,style,surface,time,tip,tree,tree-like,trichome,tube,unclear,unevenly,warty,white	.5,/2,1.5-3,2-2.5,5-15,5-6,6-8,?,age,along,apar,ba,body,branch,cazalet,cone,constricted,deltate,denser,dia,eaf,edicel,eed,elliptic,erect,exserted,fide,flat,fleshy,flower,free,glabrat,heteromorphic,impressed,included,incrassate,inflorescenc,later,lateral,lengthening,like,lobe,lon,long,long-styled,main,matted,middle,narrower,nflorescence,often,older,pair,papillo,planar,plurifoliat,portion,prominent,ruit,scar,short-styled,slit,tall,terminal,thick,tub,ud,vein,way,wide,widest,within,woody,ympodia,young	'',0.5,1,4-6,[,``,branching,characteristic,colour,diameter,form,fruit,glabrate,growth,hair,height,heteromorphism,length,mature,packing,pistil,plant,prickle,pseudostipule,rhizome,scale,shape,spacing,staman,texture,tuber,type,upper,value,width,xylopodium,ye,{,}
234	wfo-0001028505	success	168	134	88	80	46	0.524	.01,.3,.5,/3,0.25-0.5,0.8-1,0.8-1.5,1-3,1.2-2.5,10-14-flowered,2.5-4.5,anther,apex,basal,base,beneath,body,broadly,calyx,cm,conical,corolla,darker,deflexed,dia,elliptic,erect,expanded,f,filament,fruiting,gently,glabrous,globose,greatly,green,incrassate,leaf,lobe,lobed,long,lower,margin,minor,minutely,mm,narrowly,opposite,ovary,ovate,ovoid-reniform,papillose,pedicel,petiole,pitted,plant,pore,poricidal,prominent,pubescent,purple,rounded,seed,shape,shaped,shrub,size,slightly,somewhat,stem,stigma,style,surface,tan,tapering,tear-drop,tip,trichome,truncate,tube,unicellular,uniseriate,unit,way,white,woody,x,yellowish	.1,1,1/3,10-15,2,3-5,3.5-5,7-8,acuminate,acute,anthesi,aspect,ba,barely,bark,berry,black,blade,branch,bright,bud,characteristic,deciduous,decurrent,delicate,deltoid,differentiated,differing,difoliate,distance,distinct,dried,dry,drying,eaf,edicel,eed,exserted,exsertion,flattened,free,geminat,grey,lateral,live,lon,m.,main,major,materia,material,member,minute,nflorescence,obovoid,obvious,older,overlapping,pair,pale,portion,proximal,reflexed,ruit,scar,short,simple,soon,specimen,straight,strongly,tall,touching,ud,usually,vein,whit,widest,ympodial,young	articulation,bract,branching,breeding,broad-based,cell,colour,decurren,flower,form,fruit,growth,hair,height,heteromorphism,inflorescence,insertion,interjected,interpetalar,leaflet,length,marking,na,needle-like,number,orientation,pattern,placement,position,prickle,pseudostipule,rhizome,spot,staman,stone,structure,symmetry,sympodial,system,texture,tissue,tuber,type,venation,xylopodia,zygomorphy
235	wfo-0001028524	success	236	125	78	158	47	0.331	/10-3/10,0.6-1.4,1.2-1.3,2-6,3-4.3,4-6,accrescent,acute,anther,apex,apical-lateral,apparently,articulated,axillary,base,becoming,berry,blade,blunt-tipped,branched,calyx,chartaceous,cm,continued,corolla,cream,dehiscing,due,entire,extend,filament,fleshy,free,fruit,fruiting,glabrous,greenish,growth,hair,interpetalar,introrse,lacking,lanceolate,large,lateral,leaf,length,longitudinal,lower,margin,mm,oblong,obtuse,ovate,pedicel,perfect,petiole,plurifoliate,pore,present,probably,ripe,rounded,simple,slightly,slit,somewhat,stellate,stem,subcoriaceous,subglobose,time,tissue,tree,unit,x,yellow,yellowish	-2.7,-3,.5-1,0-150,0.3,0.3-0.8,0.5-3.5,1-5,1.1-1.2,1.5-1.6,1.5-3,1.8-2.5,1/3-2/3,10-20,11,2-3.8,2.5-3.4,2.5-3.8,2.5-4,2.8-3.5,3-10,3-15,3.3-4,3.4-3.6,4-8,4.3-6,6-7,6-9,7-10,7-11,8-13,9-14,abaxially,acuminate,adaxially,ag,along,anthesi,apart,ascending,axe,ba,bark,branch,brown,bud,capitat,closely,conical,dark,deltoid,densely,diameter,distal,dm,eaf,echinoi,echinoid,eed,elliptic,exserted,ferrugineous,few-,few-rayed,first,flower,glabrescen,glabrescent,granular-tomentose,gray,green,half,high,honeycombed,indument,inserted,lanceolat,late,later,lobe,lobed,long,m.,main,many-rayed,matted,midvei,midvein,mixed,multangulate,nearly,nflorescence,obscured,often,older,orbicular,orolla,ovate-lanceolate,overlapping,pale,partly,peduncle,persistent,porrect-stellate,prominent,pseudo-terminal,pubescent,rachi,rather,ray,relatively,reniform,reticulate-punctate,ruit,runk,scabridulous,sessile,short,short-stalked,side,small,spaced,sparingly,sparsely,stalked,stamen,stelliform,stigma,stout-stalked,strongly,style,suborbicular,sulcate,suture,tamen,terete,testa,thick,thick-stalked,thin,thin-stalked,tomentose,tomentu,touching,translucent,tube,unarme,unarmed,usually,vary,vein,velutinous,warty,way,wide,yellowish-green,ympodial,young	age,appressed,articulation,bract,branching,breeding,broad-based,cell,colour,connective,form,heteromorphism,inflated,inflorescence,insertion,interjected,leaflet,marking,mature,modification,na,needle-like,odour,orientation,paired,pattern,placement,position,prickle,pseud-terminal,pseudostipule,rhizome,scale,shape,spot,staman,stone,structure,surface,symmetry,sympodial,system,texture,tuber,type,xylopodia,zygomorphy
236	wfo-0001028525	success	257	131	81	176	50	0.315	0.5-1.5,1-2,1mm,2,4-5,6,accrescent,almost,anther,apex,apically,apparently,articulated,attenuate,base,berry,black,branch,branched,branching,broadly,brown,calyx,chartaceous,cm,cordate,corolla,density,developed,dilated,drying,elongated,entire,filament,form,fruit,fruiting,increasing,lateral,leaf,less,liana,light,lobed,lower,lumpy,margin,mature,mauve,membranous,mm,much,multicellular-dendritic,oblong,orange-brown,partly,pedicel,petiole,pore,poricidal,pyriform,shrub,simple,slender,slightly,smaller,sometimes,spheroidal,stem,structure,surface,tangling,terminal,tip,trichome,truncate,unit,weakly,white,whitish,x	.25,.4,0.2-0.3,0.2-0.6,0.5,0.5-2.5,0Â°,1-1.5,1-2.5,1-4,1.1-1.7,1.2-1.6,1.5,1.5-3,1/3-3/4,10,10-13,2-2.5,2-3,2.5-5,3,3-5,3-7,4,4-15,4-7,7,7-13,7.5,acuminate,acute,age,along,alternate,alyx,anthesi,apar,apart,apice,around,axil,bark,becoming,brachyblast,capitate,centre,clavate,clearly,clum,clustered,conical,cup,curved,dark,deeply,delineated,deltoid,dendritic,dendritic-pubescent,densely,detaching,developing,diameter,discolorous,divided,domatia-like,dorsal,dorsifixed,eaf,eed,ellipsoi,equal,erect,eye,fertilisation,fewer,fine,flat,flattened,flexible,flexuous,flower,formed,forming,free,frequently,frui,glabrescent,glabrous,green-brown,grey,inside,known,lamina,laterally,leave,lengthening,like,linear,lobe,long,longer,longitudinally,loop,loose,m.,main,midvein,minute,naked,narrowly,nflorescence,nther,obconical,obscuring,often,one,orolla,outside,ovate,overlapping,ovoid,pair,peduncle,pendulous,perfec,pericarp,plurifoliat,portion,primary,prominent,protruding,puberulous,pubescent,rachi,ray,red-brown,ridged,rounded,ruit,scar,scattered,sessile,side,sinus,size,small,smoot,smooth,somewhat,soon,sparsely,spreading,stigma,stripe,stump,style,tearing,terete,tertiary,thick,thin,toward,tube,ud,unarmed,uneven,vary,vein,venation,visible,well-developed,wide,wider,ympodial,young	appressed,articulation,bract,breeding,broad-based,cell,clump,colour,connective,growth,hair,heteromorphism,inflated,inflorescence,insertion,interjected,interpetalar,leaflet,length,marking,modification,na,needle-like,odour,orientation,paired,pattern,perfect,placement,plurifoliate,position,prickle,pseudostipule,rhizome,scale,shape,smell,spot,staman,stone,symmetry,sympodial,system,texture,tissue,tuber,type,vegetative,xylopodia,zygomorphy
237	wfo-0001028528	invalid_json_followup	155	144	91	64	53	0.587	.5,0.9-1.2,1.5,1.8-2,2-3,2-4,3.5-4,3/4,6-7,8-9,absent,acute,age,along,anther,apex,attenuate,bark,base,becoming,berry,bi-lobed,blackish,branch,branching,calyx,cm,coriaceous,corolla,decurrent,dendritic,densely,denser,diameter,elliptic,erect,except,filament,flattened,fork,fruiting,glabrous,globose,growth,later,leaf,lobed,long,margin,minutely,mm,mucronate,narrowly,obovate,occasionally,outline,ovary,pair,pedicel,per,petiole,pitted,pore,poricidal,prominent,pubescent,reddish-brown,revolute,round,scar,secondary,shiny,shrub,sleeve,slit-like,sparsely,stem,stigma,strongly,style,surface,terminal,time,tip,trichome,tube,vein,violet,way,white,x	1-2,1.1-1.2,2.5-3,3.5-6,4-5,4-6,6-10,?,abaxial,acuminate,adaxial,adaxially,anthesi,apical,ba,basal,conical,dichasia,eaf,edicel,eed,ew,exserted,flower,free,glabrat,glandular,immature,impressed,inserted,leave,like,lobe,lower,m.,midvein,minute,nflorescence,nodding,older,papillo,pericarp,petal,planar,plurifoliate,portion,pyramidal,ruit,short,somewhat,stamen,ste,tall,tapering,thin,triangular,tub,ud,unit,wide,winged,woody,ympodial,young	'',[,``,appressed,articulation,bract,breeding,bud,characteristic,colour,connective,dichasial,form,fruit,glabrate,hair,height,inflated,inflorescence,insertion,interjected,interpetalar,leaflet,length,marking,mature,modification,na,new,odour,orientation,paired,papillose,pattern,placement,plant,position,prickle,pubescence,scale,seed,shape,size,spot,symmetry,system,texture,tissue,type,value,width,{,}
238	wfo-0001028529	success	164	133	74	90	59	0.451	.2,0.1,0.5-2,0.8-1.3,0.8-3.2,2.5-3,2/3,5-6,8-14,acuminate,anther,apart,apex,attenuate,bark,base,bluish,brown,bud,cast,cm,corolla,dark,decurrent,erect,exfoliating,filament,flower,fruiting,furcate,glabrous,globose,green,internodal,lanceolate,leaf,less,lobed,lower,metallic,minutely,mm,narrowly,nearly,oblanceolate,occasionally,opposite,ovary,ovoid-reniform,paler,pedicel,petiole,pitted,pore,poricidal,scar,shape,shaped,shrub,simple,slightly,smooth,somewhat,stem,subshrub,surface,tapering,tear-drop,tip,tube,way,white,winged,woody	0.5,0.8-3,1,1-1.2,1-1.5,1.5,3-40-flowered,3-5,6-9,7-8,across,acute,age,anthesi,apiculate,becoming,beginning,beneath,berry,calyx,capitate,close,cork,course,deflexe,deltoid,dia,distal,eaf,edicel,eed,ellipsoi,elliptic,evenly,exserted,free,growing,heterostylous,hrub,hyaline,immature,indistinct,inflorescenc,lateral,lenticellat,linear,lobe,lon,long,main,major,middle,minor,minute,much,nflorescence,older,one,pair,papillae,papillo,papillose,planar,portion,present,prominent,range,reflexed,river,ruit,scattered,short,size,slender,small,soon,spaced,species,stigma,straight,style,tall,ud,umbonate,variable,vein,widest,x,yellowish,young	3-40,articulation,bract,branching,breeding,broad-based,cell,colour,connective,deflexed,form,fruit,glabrousnes,growth,hair,height,heteromorphism,inflorescence,insertion,interjected,interpetalar,leaflet,length,margin,marking,modification,na,needle-like,number,odour,orientation,pattern,placement,plant,position,prickle,pseudostipule,rhizome,scale,seed,smell,spacing,spot,staman,stone,structure,symmetry,sympodial,system,texture,tissue,trichome,tuber,type,unit,vegetative,width,xylopodia,zygomorphy
239	wfo-0001028532	success	186	101	81	105	20	0.435	0-19,0.2-1,1-2,1-3,1.4-1.6,2-8,2.2-4.2,3-10,3-7,3.9-5,4-7,5-9,5.5-15,6.5-9.2,7.5-15.2,abaxially,adaxially,anther,axillary,blade,brownish,bud,cell,chartaceous,clavate,cm,condition,corolla,dark,deep,diameter,drying,filament,flower,forked,fresh,fruit,glabrous,globose,green,greenish,herb,homostylous,honeycomb-shaped,interjected,lanceolate,lateral,leaf,leaflet,lobe,medium,mm,moniliform,mottled,mucilaginous,odd-pinnate,ovate,ovate-lanceolate,ovoid,pair,pentagonal,petiole,plant,pore,poricidal,purple,rotate,seed,size,stigma,straight,style,subtending,terminal,tip,tube,tuber,wet,white,whitish,x	1-1.6,1-1.7,1-5,1.3-8.7,15-36,17-42,2-3,2-6,3-5,3.3-4.4,5-merou,abaxiall,acumen,acuminate,acute,ag,along,alyx,apart,apex,apparently,arranged,articulated,asymmetric,attenuate,axe,base,basiscopic,bead,berry,capitat,connivent,covering,decreasing,digestion,distal,dorsally,eaf,edge,eed,enzyme,erec,exceeding,flat,folded,geminat,generally,glabrou,green-white,hair-like,half,larger,lengthening,like,linear,living,long,lower,make,middl,multiple,necklace,nflorescence,orbicular,orolla,pedicel,peduncle,perfect,petiolulate,plurifoliate,removed,ripe,rounded,ruit,second,sessile,seudostipule,side,slightly,slit,sometimes,spaced,specimen,spot,stamen,stolon,subequal,symmetric,tall,tamen,tem,testal,thick,throughout,tissue,toward,tri-,typically,unit,unwinged,usually,vary,wall,yellow,ympodial	arrangement,branching,calyx,capitate,colour,form,growth,hair,height,inflorescence,length,ovary,position,pseudostipule,shape,staman,stem,symmetry,texture,type
240	wfo-0001028547	success	224	117	70	154	47	0.312	/5,1-2.5,10-12,2-4,anther,apex,articulated,base,berry,branched,branching,bright,calyx,cell,chartaceous,cm,conical,connivent,cuneate,curved,deltate,discolorous,drying,elongating,entire,equal,filament,flattened,fruit,fruiting,inflorescence,lateral,leaf,length,lobed,long,lower,margin,marking,mature,maturity,mauve,mm,orange,pedicel,perfect,petiole,poricidal,prickle,purple,red,reflexed,shallowly,shrub,simple,sometimes,somewhat,spherical,stellate,stellate-pubescent,stem,straight,surface,tapering,terminal,tip,trichome,truncate,unit,way	-1/2,-13,-3,-6,.2,.5,.7,.8,/2,0,0-1,0-10,0-15,0-2,0-30,0-5,0.05-0.15,0.1-0.2,0.15,0.2-0.35,0.3-0.4,0.5-,0.7-1,0.8-1,1-2,1-4,1-5,1.2-1.4,1.5-2.5,1.7-2,1/3,1/5-1/4,2-1.5,2-2.5,2-6,2.5-2.8,2.8-3.2,3-5,3.5-4.5,4-5,4-6,5-merous,6-8,7-10,7-9,abaxial,abaxially,absent,acute,adaxial,alyx,apar,apart,ape,apically,apparently,appearing,bark,blade,bulbous,cream,dark,densely,diameter,distance,dull,eaf,eed,elongate,erect,extending,faint,flattened-reniform,flower,free,gently,glabrescent,glabrou,glabrous,gray-brow,green,infructescence,lobe,lon,long-acuminate,long-styled,longer,midpoint,midvein,moderately,narrow-deltate,nflorescence,oblong,occasionally,often,older,one,open,orange-brown,orolla,oung,outline,ovate,pair,pale,peduncle,pendulous,per,pericarp,pit,plurifoliat,porrect,portion,prickl,prickly,primary,raised,ray,reddish,rounded,ruit,scandent,scar,sessile,short-styled,side,slender,small,smooth,spaced,spreading,stalk,stalked,staminate,style,subsessile,tamen,terete,tertiary,thin-acuminat,time,tube,usually,vary,vein,venation,villous,wide,woody,yellow,yellow-green,yellow-orange,ympodial,young	appressed,articulation,bract,breeding,broad-based,colour,connective,corolla,form,growth,hair,heteromorphism,inflated,insertion,interjected,interpetalar,leaflet,modification,na,needle-like,odour,orientation,paired,pattern,placement,plurifoliate,pore,position,pseudostipule,rhizome,scale,shape,smell,spot,staman,stone,structure,symmetry,sympodial,system,texture,tissue,tuber,type,vegetative,xylopodia,zygomorphy
241	wfo-0001028587	invalid_json_followup	178	178	124	54	54	0.697	.4,.5,0,0.3,0.3-1,0.5,0.5-1,0.7-1.2,0.8-1.8,0.8-2.9,1-1.3,1-2,1-4,1.3-5.1,2.1-6.9,2.5,6-8,6.5-17.7,8-10-flowered,abruptly,accrescent,across,acuminate,acute,anther,anthesi,bark,base,becoming,berry,brown,calyx,closely,cm,coat,corolla,cracking,cup,densely,dia,difoliate,drying,ellipsoid,filament,flower,forming,fruit,fruiting,geminate,glabrous,globose,green,greenish-white,lamina,leaf,length,like,lobed,long,long-styled,lower,major,minor,minute,minutely,mm,narrowing,nearly,obovate,obovoid,often,older,open,opposite,ovary,ovate,ovoid-reniform,paler,papillose,pedicel,peeling,per,petiole,pitted,pore,poricidal,puberulent,pubescent,pubesent,scar,scattered,seed,short,shrub,simple,slender,slit-like,spaced,sparsely,stem,stiff,stigma,straight,straw-colored,style,subumbellate,surface,terminal,thickened,thin,tip,trichome,tube,type,unicellular,uniseriate,unit,upon,upper,vein,white,wide,x,young	.75,0.8-1.6,1-1.5,1/4,2-5,3-8,8-10,apex,baseflower,ca,chartaceou,deflexed,degree,different,distal,eaf,edicel,eed,erect,free,geminat,impressed,keeled,lateral,layer,lobe,lon,main,middle,midrib,nflorescence,obe,occasionally,outer,overlappin,pair,papillo,persistent,portion,pubescence,reflexed,ruit,slightly,tall,transversel,triangular,two,ud,umbonate,usually,variable,widest,woody,ympodial	'',[,``,appressed,arrangement,articulation,bract,branching,breeding,bud,characteristic,chartaceous,colour,connective,form,growth,hair,height,inflated,inflorescence,interjected,interpetalar,leaflet,margin,marking,mature,modification,na,number,odour,overlapping,paired,pattern,plant,position,scale,shape,size,smell,spot,stellate,structure,symmetry,sympodial,system,texture,thicknes,tissue,transversely,value,vegetative,zygomorphy,{,}
242	wfo-0001028594	success	142	148	91	51	57	0.641	.5,0-100,0.8-1.8,1-1.2,1-1.3,1-1.5,1-2,1-3,1.5-9,12,12-14,2,3-4,3-9,6-20,abaxially,acuminate,acute,anther,apex,axil,axillary,base,becoming,black,bottle-shaped,calyx,cell,cm,conical,corolla,densely,diameter,drying,ellipsoid,elliptic,epidermal,especially,exserted,filament,flattened-reniform,fruit,fruiting,glabrous,globose,green,hair-like,herb,immature,inflorescence,leaf,length,lobe,long,lower,margin,maturity,minute,minutely,mm,obtuse,orange-brown,ovary,ovate,pedicel,per,petiole,planar,projection,pubescent,purple,rectangular,reddish,reflexed,regular,rounded,simple,slightly,smooth,somewhat,sparsely,spreading,stigma,strongly,style,surface,trichome,tube,unit,violet,x	0.3-1.0,3-6,5-6,6-7,adaxially,along,anthesi,bearing,berry,capitat,climbing,denser,eaf,edicel,eed,floo,flower,forest,free,glabrat,inflorescenc,lax,like,lon,nflorescence,noddin,often,open,pair,papillate,pendent,portion,primary,quit,rest,ruit,scar,scattered,side,soft,strait,tem,time,tip,trailing,tub,ud,unifoliat,uniseriate,vein,ympodial	arrangement,articulation,bract,branching,breeding,broad-based,bud,capitate,colour,connective,exsertion,form,growth,hair,height,heteromorphism,insertion,interjected,interpetalar,leaflet,marking,modification,na,needle-like,nodding,number,odour,orientation,pattern,placement,plant,pore,position,prickle,pseudostipule,rhizome,scale,seed,shape,size,smell,spot,staman,stem,stone,straith,structure,symmetry,sympodial,system,texture,tissue,tuber,type,unifoliate,vegetative,xylopodia
243	wfo-0001028660	invalid_json_followup	204	159	101	103	58	0.495	0.2-1.1,0.5-2.8,0.5-5.5,0.9-2.5,1-2,1.5-2.8,1.5-4,1.5-7.6,2-11,2-5,2-6,2-9,3-30,3.8-13,4-6,5-8,6,7-10,abaxially,absent,adaxially,anther,apex,axillary,base,berry,blade,blue,broadly,brownish,bud,chartaceous,cm,condition,corolla,decurrent,densely,diameter,distal,dorsally,drying,edge,entirely,filament,flat,flower,folded,forked,fresh,fruit,glabrous,globose,green,greenish,hair,herb,homostylous,interjected,lanceolate,lateral,leaflet,lengthening,lower,margin,membranous,minutely,mm,oblique,odd-pinnate,ovoid,pair,pedicel,peduncle,pentagonal,petiole,plant,pore,poricidal,puberulent,pubescent,purple,rarely,ripe,rotate,seed,size,slit,sparsely,stem,style,substellate,subtending,terminal,tinged,tip,tuber,typically,unwinged,white,whitish,x	0-5,0.1-0.3,0.3-1.1,0.7-4.2,0.8-1,1-10,20,3-5,3-7,3-9,5-merou,acumen,acute,ag,along,alyx,apart,apparently,articulated,attenuate,axe,borne,capitat,cell,ciliate,clavate,connivent,covering,decumbent,digestion,dot,eaf,eed,elliptic,end,enzyme,erec,especially,exceeding,except,geminat,generally,glabrou,greatly,green-white,hair-like,half,honeycomb-shaped,less,like,linear,living,lobe,long,make,middl,midrib,mucilaginous,narrowly,nflorescence,obtuse,often,orbicular,orolla,ovate,perfect,petiolulate,petiolule,plurifoliate,proximal,reduced,removed,ruit,scabrous,scattered,sessile,seudostipule,short,singly,spaced,specimen,stamen,ste,stigma,stolo,straight,subequal,sunny,tall,tamen,tem,testal,thick,throughout,tri-,tube,unit,usually,vary,wall,wet,yellow,ympodial	'',[,``,age,appressed,arrangement,articulation,bract,branching,breeding,broad-based,calyx,characteristic,colour,connective,form,fruiting,growth,height,inflated,inflorescence,insertion,interpetalar,leaf,length,marking,mature,middle,modification,na,needle-like,odour,orientation,ovary,paired,pattern,placement,position,presence,present,prickle,pseudostipule,scale,shape,smell,spot,staman,surface,symmetry,system,texture,tissue,trichome,type,value,vegetative,{,}
244	wfo-0001028667	success	129	144	88	41	56	0.682	-2.6,.5,0.4-0.7,0.7-4,1-1.5,1-6,5,5-20,8-10,acute,aid,anthesi,apex,around,articulated,axillary,base,berry,branch,branched,calyx,cell,climbing,clustered,cm,completely,coriaceous,corolla,creamy,diameter,discolorous,dry,ellipsoid,elliptic,entire,exfoliating,exserted,flattened,flower,fruiting,glabrous,growth,inflorescence,irregularly,leaf,like,margin,minutely,mm,narrowly,new,occasionally,other,outer,pale,pedicel,peduncle,per,perfect,petiole,pitted,primary,reniform,revolute,scar,shiny,shoot,short,simple,sleeve,slightly,small,spaced,stem,straw-colored,strongly,support,surface,terminal,tip,twice,unit,vein,vine,white,woody,wrinkling,yellow	1-2-1.5,1-4.5,1.3-2,3,3-11,5-merou,alyx,apar,appearing,ark,climbin,conical,curling,deciduous,eaf,eed,exfoliatin,fide,fragrant,lobe,long,lower,mentz,midrib,nflorescence,older,orolla,papilla,papillat,pendan,plurifoliat,slender,soon,tem,triangular,tube,twining,ud,visible,x,ympodial	5-merous,anther,apart,appressed,arrangement,articulation,bark,bract,branching,breeding,bud,colour,connective,discoloration,exfoliation,exsertion,filament,form,fruit,hair,heteromorphism,inflated,interjected,interpetalar,leaflet,length,marking,modification,morphology,na,number,odour,orientation,papillae,pattern,placement,plurifoliate,pore,position,prickle,pseudostipule,rhizome,seed,shape,spot,staman,stone,structure,symmetry,sympodial,system,texture,tissue,tuber,type,xylopodia
245	wfo-0001028688	success	137	94	70	67	24	0.511	.5,0.4-1,0.5-0.75,0.5-1,0.9-1,1-3,1-5,1.1-1.2,2-3,5-6,across,acuminate,acute,along,anther,anthesi,apex,area,bark,base,calyx,clavate,cm,corolla,deflexed,densest,difoliate,filament,furcate,glabrous,golden,lanceolate,leaf,lobed,major,minor,mm,near,nearly,occasionally,opposite,ovary,overtopping,papillose,pedicel,petiole,pilose,pore,poricidal,reddish-brown,shaped,shiny,shoot,shrub,size,slender,slightly,stigma,straight,style,tapering,tear-drop,tip,trichome,tube,uniseriate,unit,usually,vein,white	0.5,0.5-1.5,1-1.5,1-1.8,1.4-2.8,2.2-4.8,5-11,apar,beneath,bi-cellular,branch,curl-tipped,deciduous,decreasing,deltoid,densely,dia,differing,eaf,edicel,eed,elliptic,exfoliatin,exserted,free,geminat,globose,interpetalar,irregularly,know,known,like,lobe,lon,long,lower,markedly,membraneous,middle,minutely,nflorescence,often,older,paler,planar,portion,proximal,pubescent,ruit,scar,sinus,soon,spaced,sparsely,stem,styl,tall,terminal,thickened,thin,tub,ud,wide,widest,x,ympodial,young	abaxial,adaxial,branching,colour,deflexion,density,exfoliating,exfoliation,form,fruit,geminate,growth,height,inflorescence,length,modification,na,plant,position,shape,structure,sympodial,texture,type
246	wfo-0001028698	success	166	114	62	104	52	0.373	1-4,2-10,5-15,5-6,apex,apical,apically,articulate,base,branched,calyx,cell,cm,conical,connate,corolla,dark,dehiscent,dichasially,distal,dot,ellipsoid,filament,green,hair-like,half,herbaceous,interjected,introrse,leaf,leaflet,light,long,maturing,medium,mm,oblique,odd-pinnate,often,pattern,pedicel,pentagonal,perennial,perfect,petiole,plant,poricidally,proximal,puberulent,pubescent,raised,rotate,short,slit,smooth,strigose,tuber-bearing,typically,unit,violet,white,Â¼	0-1.,0.3-0.75,1-2,1-9.8,1.8-5,1.9-4,13-25,2-3,2-4,3-17,3-5,3-6-foliat,3.5,4-14,5-8,6,6-13,6-27,8-10,9-35,abaxiall,abaxially,acumen,acuminate,acute,adaxially,broadly,commonly,covering,cuneate,cyme,darker,decurrent,diameter,dichasial,digestion,diminishing,dorsally,eaf,ebracteate,edge,eed,elliptical,emoval,enzyme,equal,exceeding,first,flat,flower,folded,forked,generally,globo,gradually,green-white,honeycomb,lateral,living,lobe,lon,long-attenuate,lower,lunat,make,minute,monochasial,mucilaginous,nflorescence,nther,orolla,ovate,ovoid,pair,peduncle,petiolule,plan,rachi,rarely,reveal,ruit,seed,sessile,seudostipule,size,specimen,stamen,stigma,straight,style,tal,tem,terminal,testal,thick,throughout,toward,two,usually,vary,wall,wide,yellow,ympodial	0-10,3-6-foliate,anther,appressed,articulation,bract,branching,breeding,colour,connective,ebbrate,form,fruit,fruiting,growth,hair,heteromorphism,inflated,inflorescence,insertion,interpetalar,length,lunate,margin,marking,mature,modification,na,odour,orientation,paired,placement,pore,position,prickle,pseudostipule,rhizome,scale,shape,spot,staman,stone,structure,symmetry,sympodial,system,texture,tissue,tuber,type,xylopodia,ye
247	wfo-0001028716	success	145	154	96	49	58	0.662	.2,.5,0.5,0.6-1.9,0.75,1-2,1.9-5.5,10-40-flowered,11-16.4,2.2-7.9,2.5-8,3.6-8.8,8-9,9-10,acuminate,anther,anthesi,apart,apex,bark,base,beginning,bi-cellular,branched,brown,calyx,cm,corolla,cuneate,dark,decurrent,difoliate,ellipsoid,elliptic,evenly,except,filament,fruit,geminate,glabrous,glandular,hirsute,lateral,leaf,less,like,lobed,long,lower,main,major,middle,minor,minutely,mm,nearly,node,often,older,opposite,orbicular,ovary,ovate,pair,papillose,pedicel,petiole,pore,proximal,puberulent,pubescent,rounded,scar,shape,shaped,shrub,simple,size,slightly,spaced,sparsely,stem,straight,strongly,style,tear-drop,trichome,truncate,uniseriate,unit,vein,white,widening,widest,x,young	2-4,5-6,7-8,across,anisophyllou,appearing,asymmetric,ba,becoming,beneath,deflexed,dia,differing,eaf,edicel,eed,fertilization,fifth,filiform,free,inflorescenc,intermediate,know,known,lengthening,lenticellat,lobe,lon,long-triangular,markedly,much,nflorescence,one,pointed,poricidal,portion,prominent,raised,reflexed,remaining,ruit,stigm,tall,tip,triangular,tube,two,ud,ympodial	anisophyllous,appressed,articulation,bract,branching,breeding,broad-based,bud,cell,colour,diameter,flower,form,fruiting,growth,hair,height,heteromorphism,inflated,inflorescence,insertion,interjected,interpetalar,leaflet,length,lenticellate,margin,marking,mature,na,needle-like,odour,orientation,pattern,placement,plant,position,prickle,pseudostipule,rhizome,smell,spacing,spot,staman,stigma,stone,structure,surface,symmetry,sympodial,system,texture,tissue,tuber,type,vegetative,xylopodia,zygomorphy
248	wfo-0001028723	invalid_json_followup	211	151	96	115	55	0.455	-1.5,0-0.5,0.2,0.8-1,1,1-1.8,1-2.2,1-2.5,1/3-1/2,1/5-1/3,10-15,2-2.5,2-2.7,3-4,3.5-4,4-5,5,5-6,5-7,abaxially,acute,adaxially,almost,anther,anthesi,apex,base,branched,branching,broadly,brown,calyx,capitate,clustered,cm,common,conical,corolla,dark,dendritic,diameter,domatia,elliptic,entire,faint,filament,fine,flat,glabrous,green,leaf,length,less,liana,lobed,long-attenuate,lower,margin,membranous,midvein,minutely,mm,obconical,oblong,obovate,occasional,orange-brown,pair,pedicel,peduncle,petiole,pore,poricidal,primary,pubescent,raised,ray,shrub,simple,smooth,sparsely,stem,stigma,style,surface,terminal,tertiary,tip,trichome,tube,unarmed,unevenly,vein,venation,widely,x	.3,.5,0.8-2,0Â°,1-1.5,10-16,2-4,2.5,4,abaxial,age,alternate,alyx,another,apar,apically,apice,apparently,articulated,bark,becoming,brachyblast,branch,clearly,concolorous,curved,decurrent,delineated,deltoid,densely,density,developed,dilated,divided,dorsifixed,drying,eaf,eed,ellipsoi,equal,except,ey,flexuous,flower,formed,free,frequent,gradual,increasing,inner,junction,know,known,lengthening,like,lobe,long,longitudinally,m.,main,middle,mostly,much,multiply,naked,narrowly,nflorescence,nther,obtuse,one,orolla,outer,ovate,overlapping,pale,papillo,perfec,plurifoliat,poorly,portion,prominent,protruding,rachi,region,regular,ridged,ruit,scar,separated,short,side,sinus,slender,small,smaller,spreading,stump,surrounding,tearing,tissu,toward,transition,tuft,ud,uneven,unit,vary,visible,white,wide,wrinkled,yellow,ympodial,young,youngest	'',[,``,appressed,arrangement,articulation,bract,breeding,broad-based,characteristic,colour,connective,division,form,fruit,fruiting,growth,habit,hair,inflated,inflorescence,insertion,interjected,interpetalar,leaflet,marking,mature,modification,na,number,odour,ovary,paired,papillose,pattern,plant,position,prickle,prominence,protrusion,scale,seed,shape,size,smell,spot,symmetry,system,texture,tissue,type,value,vegetative,{,}
249	wfo-0001028736	success	180	150	127	53	23	0.706	0.2-0.4,0.5-1,0.5-1.5,0.5-1mm,0.5-2,1,1-1.5,1-2,1-3,1/6,10-15,2-4,2-5,3-6,3-8,3.5-5,4-6,40-70,5-10,6-8,abaxially,absent,acute,adaxially,anther,apex,apical,apparently,armed,attenuate,base,berry,beyond,brown,chartaceous,cm,connivent,contiguous,created,cut,cylindrical,dark,decurrent,densely,diameter,directed,either,exserted,extra-axillary,filament,flattened,flower,fruit,glabrous,glandular,globose,green,hair,immature,leaf,length,less,light,like,lobe,lobed,long,major,many,mature,midpoint,midvein,mm,moderately,mottled,multicellular,multiseriate,nearly,netlike,obtuse,occasionally,onto,orange,pedicel,per,perfect,petiole,pit,porrect-stellate,prickle,pubescent,purple,raised,ray,red,reniform,rhombic,ridge,roselike,shrub,side,simple,sinus,small,spaced,sparsely,stalk,stamen,stellate,stem,stigma,style,surface,tapering,thin-skinned,unarmed,unbranched,unicellular,uniseriate,unlobed,vein,way,white,wide,x,yellow,yellow-white	0.5,1.5,1.5-3,2-7,3-5,4-12,4-9,5-15,5-merou,6-13x3-8,accrescent,adaxiall,alyx,apar,axe,blade,calyx,cordate,difoliate,discolorous,eaf,eed,filiform,frui,fruiting,geminate,glabrou,gree,introsel,lower,m.,midrib,narrowly,nflorescence,occasional,orolla,pair,peduncle,pore,rachi,recurved,ruit,scanden,slightly,ste,tamen,tem,triangular,tube,unequa,unit,vary,ympodial	5-merous,apart,articulation,branching,colour,corolla,form,growth,inflorescence,introsely,marking,number,ovary,position,pubescence,recurred,seed,shape,spot,staman,texture,type,width
250	wfo-0001028737	success	151	110	49	102	61	0.325	1-4,1.5-3.5,10,6,apex,apically,articulate,base,branched,calyx,cell,cm,connate,corolla,dehiscent,dichasially,distal,ebracteate,filament,generally,glabrescent,glandular,globose,green,hair-like,half,herbaceous,interjected,leaf,leaflet,long,lower,mm,oblique,odd-pinnate,pattern,pedicel,perennial,perfect,petiole,plant,poricidally,proximal,stellate,throughout,tuber-bearing,typically,unit,Â¼	0.2-0.5,0.7-2,1,1-2.5,1-6,12-14,16-30,2-3,2-5,2.8-3.5,3-4,3-5,3-6-foliat,4-10,4-6.5,4-9,5-6,7-15,abaxially,absen,acumen,acuminate,acute,adaxially,apical,apiculate,attenuate,caudate,covering,cyme,decurrent,diameter,dichasial,digestion,diminishing,dorsally,eaf,edge,eed,elliptic-lanceolate,emoval,enzyme,exceeding,flat,flower,folded,forked,globo,gradually,green-white,honeycomb,introrse,lanceolate,larger,lateral,living,lobe,lon,make,maturing,monochasial,mucilaginous,nflorescence,nther,oblong,often,orolla,ovoid,pair,peduncle,pinnatifi,plan,rachi,reveal,ruit,second,seed,sessile,seudostipule,short,size,slit,specimen,stamen,stigma,straight,strongly,style,tal,tem,terminal,testal,thick,throughou,toward,vary,wall,whit,wide,without,yellow,ympodial	3-6-foliate,absent,anther,appressed,articulation,berry,bract,branching,breeding,broad-based,colour,connective,form,fruit,fruiting,growth,hair,heteromorphism,inflated,inflorescence,insertion,interpetalar,length,margin,marking,mature,modification,na,needle-like,odour,orientation,paired,pinnatifid,placement,pore,position,present,prickle,pseudostipule,rhizome,scale,shape,smell,spot,staman,stem,stone,structure,surface,symmetry,sympodial,system,texture,tissue,trichome,tuber,type,vegetative,white,xylopodia,zygomorphy
251	wfo-0001028777	invalid_json_followup	205	162	109	96	53	0.532	-10,-2.5,-4,.5,.8,0-30,0.4-0.8,0.6-1,0.7-1.2,0.7-1.3,0.8-2.2,1-2.5,1-3,1.5-3,1.5-4,1.8-2.5,1/4,2.5-5,3.5-5,3/4-4/5,4.5-8,anther,apex,articulated,attenuate,base,berry,branched,calyx,chartaceous,cm,concolorous,connivent,dark,diameter,discolorous,drying,elongating,entire,equal,erect,filament,flattened-reniform,flower,free,fruit,fruiting,glabrescent,glabrous,green,green-brown,inflorescence,leaf,length,less,lobed,long,long-styled,lower,margin,marking,mature,maturity,mauve,minute,mm,moderately,obovate,occasionally,orange,orange-brown,ovate,pale,pedicel,per,perfect,petiole,poricidal,portion,reflexed,shoot,short,short-styled,shrub,simple,small,sometimes,spherical,staminate,stellate,stellate-pubescent,stem,style,surface,tapering,terete,terminal,tip,tree,trichome,truncate,tube,unarmed,usually,way,white,wide,yellow-green,young	-12,-3,.9,0-2,0.1-0.2,0.1-0.3,0.2,0.5-1.3,0.8-1,1,1-2,1.5,1/4-1/2,2-,2.5,2.5-3,3,4-5-merous,6-10,7-11,8,8-15,abaxially,acuminat,acute,alyx,ame,apar,ape,apically,bark,blade,briefly,c.,curved,deciduou,deltate,eaf,eed,faint,glabrescen,infructescence,lengt,lobe,longer,midpoint,multangulate,narrow-deltate,nflorescence,older,one,open,orolla,oung,pair,peduncle,pericarp,plurifoliat,porrect,present,primary,ray,recurved,red-brown,reflexe,retuse,rounded,ruit,scar,sessile,shorte,shorter,smooth,somewhat,soon,spaced,sparsely,spreading,stalk,stalked,stout,strongly,tamen,tertiary,time,unarme,unit,variously,vary,vein,venation,visible,whole,wider,woody,ympodial	'',[,``,appressed,arming,articulation,bract,branching,breeding,broad-based,characteristic,colour,connective,corolla,form,growth,hair,height,inflated,insertion,interjected,interpetalar,leaflet,modification,na,needle-like,number,odour,orientation,ovary,pattern,placement,plant,pore,position,prickle,pseudost,scale,seed,shape,size,smell,spot,staman,symmetry,system,texture,tissue,type,value,vegetative,{,}
252	wfo-0001028791	success	257	109	65	192	44	0.253	-9,0-6,0.05-0.2,0.4-0.65,2-7,2-locular,4-5+,5-plurifoliate,absent,acuminate,anther,apex,articulation,base,branched,breaking,calyx,cell,cm,corolla,deciduous,deltate,developed,dichotomously,filament,fruit,fruiting,glabrous,globose,green,imparipinnate,interjected,interrupted,leaf,leaflet,liana,long,lower,many,margin,middle,near,oblique,pedicel,per,petiole,poorly,pseudostipule,rough,sandpapery,simple,somewhat,stellate,stem,surface,time,touch,trichome,truncate,uniseriate,unit,usually,vine,woody,yellow	+,-0.6,-1.5,.5,0.05,0.2-0.3,0.2-0.4,0.2-0.8,0.25-0.3,0.3-0.4,0.3-0.5,0.3-0.6,0.3-0.8,0.4-0.5,0.4-0.6,0.4-1.1,0.45-0.55,0.5,0.6-0.8,0.6-0.9,0.7-1.5,0.8-1,0.8-1.3,1-1.5,1-2,1-2-celled,1-3,1-3-celled,1-celled,1.5-,1.5-2,1.6-4.5,1.7-2.1,1.8-3.3,10,100,2-3,2-3.5,2-7-celled,2.5-4.5,2.8-3.0,20-to,3-,3-4,4-11.5,4-15,4-celled,5-,5-10,5-15,5-22,50-80,8-10-celled,9-30,9-35,abaxially,absen,abundant,acute,adaxially,addition,ag,along,anthesi,apical,appearance,appendage,articulated,basal,basiscopically,beneath,berr,border,broadly,brown,bullate,capitate,clambering,colo.,column,conical,consistently,dark,darker,densely,densest,diameter,eaf,ebracteate,edicel,eed,eglandular,elliptic,elongating,enlarged,entire,even,exserted,extended,flower,free,give,glabrescent,glandular,gree,grow,growing,hair-like,half,halfway,head,internode,lamina,large,lateral,leaving,less,like,lobe,lon,midvein,minutely,mixture,mm,much,multicellular,nflorescence,obovate,occasionally,often,outgrowth,ovary,pair,pale,paler,papillate,peduncle,petiolule,plant,present,primary,protuberance,pubescence,pubescent,rachi,reflexed,rest,round,ruit,scandent,secondary,seed,sessile,short,shorter,silky,single,slightly,small,smaller,sometimes,sparse,sparsely,spreading,stamen,staminal,sterile,stiff,stigma,straight,style,tal,tem,terminal,tertiary,testa,thick,thickened,tip,transparent,tube,ud,unicellular,upper,vegetation,vein,wall,white,wide,winged,ympodial,â1-2-celled	appressed,bract,branching,breeding,broad-based,colour,form,growth,hair,heteromorphism,inflated,inflorescence,insertion,interpetalar,length,marking,mature,na,needle-like,odour,orientation,paired,pattern,placement,position,prickle,rhizome,scale,shape,smell,spot,staman,stone,structure,symmetry,sympodial,system,texture,tissue,tuber,type,vegetative,xylopodia,zygomorphy
253	wfo-0001028798	success	214	111	59	155	52	0.276	0-1,0.9-1.2,2-3,3.3-5.6,accrescent,anther,apex,apical-lateral,attenuate,base,berry,blunt-tipped,branched,calyx,chartaceous,cm,corolla,extend,filament,fruit,fruiting,greenish,growth,hair,introrse,large,leaf,length,long,longitudinal,lower,margin,mm,multangulate,oblong,obovate,pale,pedicel,perfect,persistent,petiole,plurifoliate,pore,porrect-stellate,probably,ripe,rotate-stellate,shrub,simple,slightly,slit,somewhat,stem,subcoriaceous,subglobose,time,unarmed,unit,yellow	.5-5,0-60,0.2-0.4,0.5-2,1-3,1-4.5,1-6,1.1-2,1.5-1.8,1/2-2/3,1/20,10,15-19,2-3.75,2-6,2-7,2.4-4.4,2.5-3.5,2.6-4,2/3,3-4,3-5,3.8-4.2,4-5.4,5-8,5.25-7.5,6-10,6-8,7-8,8-18,8.5-13,abaxially,acuminate,acute,adaxially,ag,anthesi,apart,apparently,articulated,axe,axillary,ba,becoming,blade,boat-shaped,branch,bud,capitat,conical,continued,curved,cylindrical,decurrent,dehiscing,densely,diameter,distal,dm,downward,due,eaf,echinoi,echinoid,eed,entire,exserted,fleshy,flower,free,glabrous,granular,granular-tomentose,green,hal,high,included,inserted,irregularly,lacking,lanceolate,lateral,less,lined,lobe,lobed,m.,main,many,midvein,minutely,mixed,multangulat,nearly,nflorescence,oblanceolat,oblanceolate,obscured,obtuse,often,orbicular,orolla,oung,ovate-lanceolate,overlapping,peduncle,persistently,present,prominent,pseudo-terminal,pubescent,quite,rachi,rather,ray,rough,rough-granular,ruit,semi-ovate,sessile,short,short-stalked,side,small,spaced,sparingly,splitting,stalked,stamen,stellate-pubescent,stigma,strongly,style,subcampanulate,sulcate,suture,tamen,thick,tip,tomentose,tomentu,tomentum,toward,translucent,tube,unarme,unknow,vary,vein,velutinous,way,wide,x,yellowish,ympodial	age,appressed,articulation,bract,branching,breeding,broad-based,cell,colour,connective,form,heteromorphism,inflated,inflorescence,insertion,interjected,interpetalar,leaflet,marking,mature,modification,na,needle-like,odour,orientation,paired,pattern,placement,position,prickle,pseudostipule,pseudoterminally,rhizome,scale,shape,smell,spot,staman,stone,structure,surface,symmetry,sympodial,system,texture,tissue,trichome,tuber,type,vegetative,xylopodia,zygomorphy
254	wfo-0001028815	success	196	101	53	143	48	0.27	1-2,1-4,1-5,2-4,3-5,anther,apex,articulation,base,berry,cell,chartaceous,cm,corolla,cuneate,dark,distinct,filament,forked,fruit,globose,green,hair,hair-like,herb,indistinct,interjected,lanceolate,leaflet,lilac-purple,lower,margin,medium,membranous,mm,odd-pinnate,ovoid,pedicel,petiole,plurifoliate,pore,poricidal,purple,red-purple,rotate,rounded,slightly,stem,terminal,tinged,tip,tri-,unit	0.4-0.8,0.5-1,1-10,1-3.5,10-15,14-28,2-4.5,2-9,2.5-6.5,22-35,3-4,3-7,4-10,5-6,5-7,5-merou,6-10,6-8,7-16,abaxially,acumen,acute,adaxially,ag,along,alyx,apart,apparently,articulated,auriculate,axe,axillary,basiscopic,blade,broadly,brownish,bud,capitat,ciliate,condition,connivent,covering,decreasing,decurrent,developing,diameter,digestion,distal,dorsally,drying,eaf,edge,eed,elliptic,elliptic-lanceolate,enzyme,especially,exceeding,flat,flower,folded,fresh,geminat,generally,glabrou,glabrous,green-white,greenish,hal,half,high,homostylous,honeycomb-shaped,lateral,lengthening,like,living,lobe,long,make,midrib,minutely,mucilaginous,narrowly,nflorescence,obtuse,onto,orolla,ovate,pair,papillose,peduncle,perfect,petiolulate,plant,pointed,puberulent,pubescent,purpl,rachi,removed,ripe,rugose,ruit,seed,semi-erec,semi-rosette,sessile,seudostipule,short,side,size,slit,spaced,sparsely,specimen,splotched,stamen,ste,stigma,straight,style,subtending,tall,tamen,tem,terminated,testal,thick,throughout,triangular-lanceolate,tube,unwinged,usually,vary,wall,wet,whitish,winged,x,yellow,ympodial,young	appressed,bract,branching,broad-based,calyx,colour,connective,form,fruiting,growth,heteromorphism,inflated,inflorescence,insertion,interpetalar,leaf,length,marking,mature,na,needle-like,odour,orientation,paired,placement,position,prickle,pseudostipule,rhizome,scale,shape,smell,spot,staman,stellate,stone,structure,surface,symmetry,sympodial,texture,tissue,trichome,tuber,type,vegetative,xylopodia,zygomorphy
255	wfo-0001028876	success	127	102	64	63	38	0.504	.5,/4,0.4-1,0.5-2,1-2,1.5-2,4-5,5-6,abaxial,acute,adaxially,along,anther,apex,attenuate,base,calyx,capitate,cm,conical,corolla,dendritic,densely,difoliate,elliptic,filament,glabrous,internodal,leaf,like,lobed,long,midrib,minutely,mm,occasionally,opposite,ovary,papillose,pedicel,petiole,pore,pubescent,rest,sagittate,shaped,shining,shrub,simple,small,sparsely,stigma,style,subshrub,surface,tear-drop,trichome,tube,type,uniseriate,unit,way,white,x	1.5-3,2-2.3,3-5,3-8,4-8,abaxially,anthesi,bark,branched,brown,closely,dark,dia,drying,eaf,edicel,eed,ellipsoid,flower,free,geminat,glabrat,golden,hroughout,included,inflorescenc,know,known,lamina,lateral,leave,lobe,long-triangular,lower,main,middle,nflorescence,nodding,older,overlappin,pair,papillae,papillo,planar,poricidal,portion,reddish,rounded,ruti,scar,slender,spaced,speciman,stem,straight,tall,tip,tub,ud,vein,widest,ympodial,young	articulation,branching,breeding,cell,colour,diameter,form,fruit,fruiting,geminate,growth,hair,height,heteromorphism,inflorescence,insertion,length,marking,na,odour,orientation,placement,plant,position,prickle,pseudostipule,rhizome,shape,spot,staman,stone,structure,symmetry,sympodial,system,texture,tuber,xylopodia
256	wfo-0001028883	success	207	98	50	157	48	0.242	accrescent,anther,apex,articulated,attenuate,base,berry,calyx,cell,chartaceous,connivent,coriaceous,cyme,dark,drying,dull,entire,filament,fruit,glabrous,globose,green,growth,herb,lateral,leaf,length,long,margin,membranaceous,mm,oblong,pedicel,perfect,petiole,plurifoliate,pore,poricidal,ripe,shrub,simple,slightly,small,stellate,subopposite,trichome,unbranched,uniseriate,unit,white	0.3â0.6,0.4â1.2,0.5â2,0.6,1,1.5â7,1â2,1â6,2,2â3,2â5,3â5,4,4â6,5,5-merou,50,6,6â10,6â12,abaxially,absent,acuminate,acute,adaxiall,adaxially,almost,along,alyx,antrorse,antrorsely,apar,arched,ark,ascending,axi,becoming,blade,branch,brochidodromous,brow,capitat,capitate,ciliate,circular,cm,common,completely,concolorous,curved,cylindrical,decurrent,deltate,densely,diameter,differing,directed,eaf,eed,elliptic,elliptic-ovate,emarginate,equal,erect,exfoliating,eye,flattened,flower,frui,geminate,geniculat,glabrescent,glabrou,glandular,greenish,head,hilum,hollow,impressed,introrsely,less,light,like,lobe,longitudinal,lower,lying,midrib,minor,moderately,multicellular,naked,narrowly,new,nflorescence,normally,notably,obtuse,often,older,onto,opening,orolla,ovate-lanceolate,parallel,peduncle,pendan,per,present,primarily,prominent,pubescence,pubescent,rachi,rarely,region,reniform,rounded,ruit,secondary,seed,sessile,shap,shiny,similar,single,single-celled,size,slit,sometimes,spaced,sparse,sparsely,spreading,stalk,stem,stigma,straight,style,subapical,subsessile,surface,swollen,tall,tamen,tem,undulate,vary,vein,venation,visible,whitish,wide,woody,yellow,ympodial,Ã	1-2,2-5,5-merous,appressed,articulation,bract,branching,breeding,colour,connective,corolla,form,fruiting,hair,heteromorphism,inflated,inflorescence,insertion,interjected,interpetalar,leaflet,marking,mature,modification,na,odour,orientation,paired,pattern,placement,position,prickle,pseudostipule,rhizome,scale,shape,spot,staman,stone,structure,symmetry,sympodial,system,texture,tissue,tuber,type,xylopodia
257	wfo-0001028885	invalid_json_followup	214	138	85	129	53	0.397	.5,0.5-1,0.7-2,1-2,1.5-1.7,10-20,2/3,3-5,3.5-4.5,7-8,9-11,abaxial,acute,adaxially,anther,apex,attenuate,base,berry,black,branched,calyx,capitate,cm,corolla,densely,diameter,ellipsoid,elliptic,entire,filament,fleshy,flower,fruiting,furcate,glabrescent,glabrous,globose,growth,height,inflorescence,known,lanceolate,lateral,leaf,lobed,long,lower,margin,mm,multicellular,narrowly,occasionally,pedicel,petiole,plant,pore,poricidal,pubescent,purple,recorded,revolute,ripe,scandent,scattered,shrub,simple,slightly,sometimes,sparsely,stellate,stem,stigma,style,surface,terminal,time,tip,trichome,uniseriate,upper,vine,way,winged,woody	-1,0.3-0.5,0.5-5,1-1.2,1-1.5,1-3,1.5-3.5,2,2-,2-2.5,2.3-2.5,2.5-3.5,3.5-8.5,4-5,5-merou,7-9,9-12,?,adaxial,ag,along,alyx,anthesi,apart,apiculate,apparently,archin,ark,articulated,basal,blackish,branch,broadly,brown,cell,collapsing,connivent,cup-shaped,dark,dark-pigmented,decurrent,deltate,dendriti,distal,dried,drying,eaf,eed,erect,exserted,extending,free,glabrou,glandular,golden,gradually,groove,groupe,ilament,immature,inserted,irregularly,lamina,leaving,lengthening,less,like,live,lobe,loosely,material,midvein,minute,minutely,mostly,narrowing,new,nflorescence,noddin,nodding,often,older,orolla,pair,papillo,part,peduncle,peg,perfect,pericarp,pigmentation,plurifoliat,portion,primary,quarter,reddish,retaining,rhachi,ruit,scar,shin,shiny,short,sleeve,slender,slit,small,smaller,spaced,spheroidal,spreading,strongly,tangled,tem,thin,third,tube,twinin,ud,unit,usually,vary,vein,wall,weak,weak-walled,wide,ympodial,Â¾	'',[,\u00be,``,appressed,arching,articulation,bract,branching,breeding,broad-based,characteristic,colour,connective,form,fruit,hair,inflated,insertion,interjected,interpetalar,leaflet,length,marking,mature,modification,na,needle-like,odour,orientation,ovary,paired,pattern,placement,position,presence,prickle,scale,seed,shape,smell,spot,symmetry,system,texture,tissue,type,value,vegetative,ye,zygomorphy,{,}
258	wfo-0001028888	invalid_json_followup	207	189	137	70	52	0.662	0-7,0.15-0.5,1-1.5,1-10,1-2,10-25,12.5-25,2.3-5,2.3-7,3-4,3.6-12.5,4-25,5-10,5-7,6-11,8-11,8-13.5,abaxially,adaxially,along,anther,apart,axillary,base,berry,blade,brownish,bud,cell,center,chartaceous,ciliate,clavate,cm,condition,connivent,corolla,covering,diameter,distal,dorsally,dot,drying,edge,end,especially,except,filament,flat,flower,folded,forked,fresh,fruit,generally,glabrous,glaucous,globose,greatly,green,green-white,greenish,hair,half,herb,homostylous,interjected,lanceolate,lateral,leaflet,lengthening,like,lobe,long,low,make,margin,membranous,middle,midrib,minutely,mm,mottled,mucilaginous,oblique,odd-pinnate,often,one,ovoid,pair,pedicel,peduncle,pentagonal,petiolulate,placed,plant,pore,poricidal,proximal,puberulent,pubescent,purple,reduced,ripe,rounded,scattered,seed,sessile,short,size,slightly,slit,sometimes,sparsely,stem,stigma,straight,streak,style,subequal,subglabrous,substellate,subtending,terminal,testal,thick,throughout,tip,tuber,typically,usually,violet,wall,wet,white,whitish,x	0-3.5,0-5,1,1-3,1.5-4,2-5,2-6,2.5-3.3,3-5,3.8-8.3,4-7,5-merou,acumen,acuminate,acute,ag,alyx,apex,apiculate,apparently,articulated,axe,broadly,capitat,central,covered,cuneate,digestion,eaf,eed,elliptic,enzyme,erec,exceeding,geminat,glabrou,hair-like,hal,honeycomb-shaped,less,living,lower,nflorescence,orbicular,orolla,ovate,perfect,petiole,petiolule,plurifoliate,removed,ruit,seudostipule,spaced,specimen,stamen,ste,stolo,tall,tamen,tem,tri-,truncate,tube,unit,unwinged,vary,wing,yellow,ympodial	'',[,\u201chair-like\u201d,``,age,appressed,arrangement,articulation,bract,branching,breeding,calyx,capitate,characteristic,colour,connective,form,fruiting,growth,height,inflated,inflorescence,interpetalar,leaf,length,marking,mature,modification,na,number,odour,ovary,pattern,placement,position,pseudostipule,scale,shape,smell,spacing,spot,stolon,symmetry,system,texture,tissue,trichome,type,value,vegetative,{,}
259	wfo-0001028920	success	152	112	89	63	23	0.586	.25,.5,0.2-1,0.5-1,0.8-1.1,1-1.5,1-2.4,1-3,2-2.5,3-15-flowered,3-3.5,6-6.5,abaxially,acute,adaxially,anther,anthesi,apex,arachnoid,arachnoid-pubescent,area,attenuate,bark,base,berry,broadly,brownish,calyx,cm,congested,conical,corolla,cucullate,dendritic,dense,difoliate,elliptic,erect,felty,filament,fruiting,glabrate,glabrous,globose,green,leaf,lobed,long-styled,minutely,mm,nearly,obovate,occasionally,opposite,ovary,ovoid-reniform,papillose,pedicel,petiole,pitted,pore,poricidal,pubescence,pubescent,shape,shaped,short-styled,shrub,simple,size,small,soon,stem,stigma,strongly,style,surface,tear-drop,tip,tree,trichome,tube,tuft,unifoliate,uniseriate,unit,white,woody,x	1-1.2,1.5-2,2-7,3-4,5-9,6-15,acuminate,axil,ba,brown,closely,dark,decurrent,deflexed,deltate,densely,dia,differing,eaf,edicel,eed,ellipsoid,exserted,fleshy,flower,free,geminat,gray-brow,later,lateral,lightly,lobe,lon,long,lower,main,major,middle,minor,nflorescence,obovoid,older,overlappin,pair,planar,portion,present,ruit,scar,somewhat,spaced,sparsely,styl,tall,tapering,thick,tub,ud,vein,widest,winged,ympodial,young	branching,colour,diameter,form,fruit,geminate,gray-brown,growth,hair,height,inflorescence,length,marking,plant,position,seed,spot,structure,symmetry,sympodial,texture,type,zygomorphy
260	wfo-0001028929	success	210	106	58	152	48	0.276	0-20,0.7-2,2-6,5-6,8-10,acicular,anther,apex,articulated,base,berry,branched,calyx,cell,chartaceous,cm,connivent,cuneate,difoliate,elongating,equal,erect,filament,fruit,fruiting,hair,inflorescence,lateral,leaf,length,lobed,long,lower,margin,mature,mm,pedicel,perfect,perpendicular,petiole,poricidal,porrect,prickle,red,sessile,shrub,simple,spherical,stalked,stellate,stem,straight,surface,tapering,tip,trichome,unit,white	-2,-2/3,.5,.7,.9,/5,0,0-1,0-10,0-3,0.1,0.15-0.3,0.2-0.3,0.2-0.4,0.2-0.8,0.3-0.6,0.4-0.8,0.5-1.5,0.5-2,0.7-1,0.8-1,1,1-1.1,1-3,1.5-2.4,1/2,1/4-1/3,2-3,2-4,2-9,2.2-2.3,2.5-4,2.7-3,2/3-3/4,3-20,3-4,4-6,5-25,5-7.5,5-merous,6-8,7-9,abaxial,abaxially,acute,adaxial,alyx,apar,apart,ape,apically,apparently,bark,blade,concolorous,curved,densely,diameter,discolorous,distance,drying,dull,eaf,eed,elliptic,extending,flattened-reniform,flower,foliaceous,free,geminat,gently,glabrescent,glabrou,glabrous,gra,infructescence,lobe,lon,long-styled,longer,maturity,midpoint,midvein,minute,minutely,narrow-deltate,narrow-ovate,nflorescence,oblong,obovate,obtu,obtuse,occasionally,older,one,open,orange-brown,orolla,oung,outline,pair,pale,patch,peduncle,pendulous,per,pericarp,pit,portion,prickl,prickly,primary,raised,ray,red-brown,red-green,reticulate,rounded,ruit,scar,short-styled,side,slender,small,smooth,sometimes,spaced,spreading,stalk,staminate,stellate-pubescent,style,subsessile,tamen,terete,tertiary,time,tube,unarmed,usually,variously,vary,vein,venation,visible,way,wide,woody,yellow,yellow-green,ympodial	0.5-1,appressed,articulation,bract,branching,breeding,broad-based,colour,connective,corolla,form,geminate,growth,heteromorphism,inflated,insertion,interjected,interpetalar,leaflet,marking,modification,na,needle-like,odour,orientation,paired,pattern,placement,position,pseudostipule,rhizome,scale,shape,smell,spot,staman,stone,structure,symmetry,sympodial,system,texture,tissue,tuber,type,vegetative,xylopodia,zygomorphy
261	wfo-0001028963	success	197	122	80	117	42	0.406	0-0.4,0.1,0.1-0.25,0.15-0.3,0.3-0.6,0.3-1,2-4,3.5-4.2,4-10,7-8,acute,anther,apex,attenuate,base,berry,bright,calyx,cell,chartaceous,cm,connivent,densely,difoliate,dull,entire,evenly,filament,flower,fruiting,glabrous,gray-green,green,herb,inflorescence,lanceolate,lateral,leaf,length,lobed,long,lower,margin,mature,maturity,mauve,midpoint,mm,moderately,narrow-cuneate,narrow-elliptic,obtuse,orange,pale,petiole,poricidal,porrect,purple,ray,red,sessile,shorter,shrub,simple,spherical,stalked,stellate,stellate-pubescent,stem,surface,tapering,terete,terminal,tip,trichome,unarmed,unbranched,unit,variously,young	.5,/2,0-2,0.1-0.2,0.3-0.7,0.3-1.5,0.45-0.6,0.6-0.9,0.6-1,0.8-1.8,0.9-1.5,1-4,1.5-2,1/,1/4-1/3,1/5,1/6,2-2.3,2-3,2-5,2-9,2.4-2.8,3-4.5,4-8,5-25,5-merous,6-10,abaxially,alyx,apar,ape,apically,apparently,articulated,bark,becoming,blade,broad-deltate,brown,concolorous,curved,cuspidat,deltate,diameter,discolorous,drying,eaf,eed,elongating,equal,erect,eye,flattened-reniform,free,frui,geminat,glabrescent,gra,herbaceous,infructescence,less,light,lobe,long-styled,longer,naked,narrowly,nflorescence,occasionally,older,one,open,orolla,oung,outline,pair,pedicel,peduncle,pendulous,per,perfect,pericarp,pit,portion,primary,raised,ruit,scar,short-styled,slender,slightly,small,smooth,spaced,spreading,stalk,staminate,straight,style,subsessile,tamen,tertiary,time,tube,unarme,upper,usually,vary,vein,venation,visible,way,wide,winged,woody,yellow-orange,ympodial	appressed,branching,breeding,broad-based,colour,connective,corolla,form,fruit,geminate,growth,hair,height,heteromorphism,inflated,marking,modification,na,needle-like,number,odour,orientation,pattern,placement,plant,pore,position,prickle,pseudostipule,rhizome,shape,spot,staman,stone,structure,symmetry,sympodial,system,texture,tuber,type,xylopodia
262	wfo-0001028971	success	225	111	90	135	21	0.4	-0.8,0.1-0.4,0.2-0.5,0.25-0.6,0.3-0.6,0.4-0.9,0.4-1.5,0.8-2.5,1-2,1.5-2.2,1.75-2.5,10-15,2.2-3.5,2.5-3.5,3-14,4-9,5-10,6-8.5,6-9,7-16,acute,anther,apex,articulated,attenuate,base,broad-based,broadly,calyx,campanulate,cm,coarsely,compressed,connivent,densely,dentate,diameter,directed,elongate-deltoid,essentially,extra-axillary,farinaceous,flower,form,fruit,globose,hair,inflorescence,lateral,laterally,leaf,length,lenticular,linear-lanceolate,margin,midpoint,minute,mixture,mm,often,orange,outline,ovate,pedicel,peduncle,perennial,petiole,pore,prickle,pubescent,rachi,ray,reniform-ovate,ripe,sericeous,sessile,simple,spreading-hirsute,stellate,stem,stigma,stipitate,style,thin-textured,trichome,unbranched,variable,white,x,yellow	-1.4,.1-0.2,0.1-0.5,0.25-1.25,05-2.5,1-5,1.5-4,1/5-1/2,15-30,2-5,2-foliate,2.5-4.5,2.5-5,20-35,3-5,3-6,4-5,5-15,5-8,6-16,abaxially,acute-,adaxiall,adaxially,along,also,apart,appearance,appearing,armed,ascending,axe,ba,bearing,becoming,blade,branched,capitat,cauline,close,cylindrical,delicate,deltoid,distal,distall,eaf,eed,elongate,entire,erect,felty,felty-pubescent,female-sterile,filament,frequently,geminat,glabrous,grading,growt,inserted,interlobal,invested,lanceolate,largest,later,least,lignescent,like,lobe,lon,long,longer,longest,lower,major,manifestly,maturit,midrib,minutely,much,multiseriate,narrowly,nflorescence,numerous,obtuse,occasionally,one,orolla,other,ovate-apiculate,ovate-lanceolate,pair,per,persistent,pitted,prickly,principal,reduced,round-tipped,ruit,scattered,short,short-stalked,shorter,side,similar,sinus,smaller,sometimes,spaced,sparse,spreadingly,stalk,ste,stellae,stellate-pubescent,surface,tal,tamen,tan,tem,termination,time,tooth-like,truncate,tube,underdeveloped,unit,usually,variously,vary,vein,well-developed,wide,ympodial	abaxial,adaxial,arrangement,articulation,branching,capitate,colour,connective,corolla,distally,growth,height,orientation,ovary,placement,plant,position,seed,shape,texture,type
263	wfo-0001028975	success	163	141	82	81	59	0.503	.2,0.1-1,1,1-3,1-5,1.5-1.8,2.2-6,3-10-flowered,3-3.5,5.5-10,6-6.5,8-9,?,acute,along,anther,apex,area,bark,base,broad,brown,calyx,cm,conical,corolla,dark,decurrent,densely,denser,difoliate,elliptic,filament,fruit,fruiting,glabrous,globose,golden,green,leaf,length,lobed,long,lower,minor,minutely,mm,nearly,once-furcate,opposite,ovary,ovoid-reniform,pedicel,petiole,pore,pubescent,shaped,shiny,short,shrub,simple,size,slender,small,sparsely,stem,stigma,style,surface,tapering,tear-drop,tip,tree,trichome,tube,uniseriate,unit,varying,vein,white,wide,x	.5,0.5-1,1.2-1.5,1.5-2,3-6.5,5-ribbed,7.5-15,acuminate,anthesi,apart,appearing,beneath,berry,closely,conically,corky,cup-shaped,deflexed,dia,differing,eaf,edicel,eed,entire,epidermi,equal,erect,exserted,extension,free,geminat,hyaline,immature,large-celled,late,lateral,like,lobe,lon,main,mainly,major,margin,member,mere,middle,narrowly,nflorescence,obscured,occasionally,older,one,pair,papillo,pitted,poricidal,portion,prominent,pubescenc,raised,reddi,reflexed,remaining,rib,ruit,scar,sinus,slightly,somewhat,spaced,straight,strongly,tall,triangular,tub,ud,upper,widest,woody,ympodial,young	0.5,9,articulation,bract,branching,breeding,broad-based,bud,cell,colour,connective,density,diameter,flower,form,geminate,growth,hair,height,heteromorphism,inflorescence,insertion,interjected,interpetalar,leaflet,marking,modification,na,needle-like,number,odour,orientation,papillose,pattern,placement,plant,position,prickle,pseudostipule,reddish,rhizome,scale,seed,shape,smell,spot,staman,stone,structure,symmetry,sympodial,system,texture,tissue,tuber,type,vegetative,width,xylopodia
264	wfo-0001028980	success	168	101	50	118	51	0.298	.5,1.5-1.8,1.5-2,4-5,acute,anther,anthesi,apex,base,berry,calyx,cm,corolla,dia,difoliate,elliptic,filament,fleshy,fruiting,furcate,glabrate,globose,green,leaf,long,lower,margin,mm,opposite,ovate,pedicel,petiole,planar,pore,reflexed,shaped,shrub,slightly,small,stem,surface,tear-drop,tree,trichome,type,uniseriate,unit,white,woody,x	.1,.75,/3,0.5-1.5,1-1.2,1.2-1.8,1.2-3,1.5-6,2.5,2.5-5,20-25-flowered,3-4,3/4,5-6,5-8,6,6-8,7-12,acuminate,along,apart,axil,bark,basal,beginning,beneath,black,broadly,capitate,clearly,coarsely,conical,corky,cucullate,deflexed,deltoid,densely,differentiated,differing,dry,drying,eaf,edicel,eed,expanded,exserted,extending,f,flattened-reniform,free,frui,geminat,glabrous,glandular,impressed,incrassate,inflorescenc,lamina,lateral,lenticellat,like,lobe,lobed,lon,m.,main,major,material,member,middle,minor,minutely,nflorescence,occasionally,older,one,ovary,ovoid,pair,pale,paler,papillose,peduncle,pit,pitted,poricidal,portion,prominent,pubescent,reddish,ruit,scar,scarious,seed,sharply,shining,simple,size,soon,sparsely,speciman,stigma,strongly,style,tall,tapering,thick,ti,tip,tube,ud,usually,vein,way,widest,yellowish,ympodial,young	appressed,articulation,bract,branching,breeding,broad-based,cell,colour,form,fruit,geminate,growth,hair,heteromorphism,inflated,inflorescence,insertion,interjected,interpetalar,leaflet,length,marking,mature,na,needle-like,odour,orientation,paired,pattern,placement,position,present,prickle,pseudostipule,rhizome,scale,shape,smell,spot,staman,stone,structure,symmetry,sympodial,system,texture,tissue,tuber,vegetative,xylopodia,zygomorphy
265	wfo-0001028984	invalid_json_followup	180	174	112	68	62	0.622	-2,-3,-6,-65,0.5-,1,1-,1-2,1-6,1-9,1.2-4,1.5,10-20,15-35,2,2-2.5,2-3,2-4,20-40,3-26,4-30,4-5,4-6,4-6.3,7-14,abaxially,abruptly,acuminate,acute,adpressed,age,almost,also,apex,apical,articulated,basal,base,broad,broadly,calyx,campanulate,chartaceous,cm,concave,connective,cordate,densely,diameter,dilated,directed,distally,eglandular,ellipsoid-fusiform,entire,flower,forked,fruit,glabrous,gland,globose,greenish,hair,lanceolate,laterally,leaving,lobe,long,lower,margin,mm,moderately,narrowed,obconical,obtuse,often,ovate,ovoid,pale,pedicel,pedicellar,peduncle,petiole,pilose,pore,presence,puberulent,puberulent-pubescent,pubescent-pilose,purple,rachi,radiu,rarely,remnant,shrub,simple,small,sparsely,stigma,strongly,style,subcoriaceous,tip,tree,truncate,turning,two,unbranched,unknown,violet,x,yellow	-14,-2.5,-9,1-1.7,1-2.5,12-20,2-,2-16,3-10,3-28,3-6,4-7,4-foliat,5,5-10,8-15,absen,adaxially,aggregate,apart,ape,axe,blade,cell,color,eaf,eed,equalling,especially,exceeding,fleshy,glandular-puberulent,lon,longer,minutely,near,nflorescence,nther,orolla,papillose,perfect,pilo,possibly,present,pubescent-pilo,ripe,ruit,shorter,slightly,spaced,stamen,stone,swelling,tal,tem,thecae,time,tomento,tomentose,toward,triangular,tube,ud,unit,unknow,vary,wide,ympodial	'',[,``,abaxial,adaxial,anther,appressed,articulation,bract,branching,breeding,broad-based,bud,characteristic,colour,corolla,filament,form,fruiting,growth,height,inflated,inflorescence,insertion,interjected,interpetalar,leaf,leaflet,length,marking,mature,modification,na,needle-like,odour,orientation,ovary,paired,pattern,placement,plant,position,prickle,scale,seed,shape,smell,spot,stem,surface,symmetry,system,texture,theca,tissue,trichome,type,value,vegetative,zygomorphy,{,}
266	wfo-0001028997	success	136	107	82	54	25	0.603	.5,0.5-0.7,0.8-1.1,1-1.2,1-1.5,3-4,3.3.5,4-10,4-4.5,4-angled,5-6,6-7,acute,anther,apex,appearing,area,attenuate,bark,base,berry,branched,broadened,calyx,cm,conical,coriaceous,corolla,deflexed,difoliate,dry,elliptic-obovate,erect,filament,filiform,flattened-reniform,fragrant,fruiting,glabrous,globose,golden,green,height,lateral,leaf,lobed,main,many,margin,matte,minutely,mm,mustard,nearly,opposite,ovary,pair,papillose,partially,pedicel,petiole,pitted,pore,revolute,shaped,shiny,shrub,stem,stigma,style,surface,tear-drop,terminal,time,trifoliate,tube,unknown,vein,white,woody,x,yellow	0.5-1,0.5-1.5,2-2.5,2-3.5,20-50-flowered,6-10,abaxially,adaxially,anthesi,apar,ba,cucullate,dia,drying,eaf,edicel,eed,elliptic,exserted,free,geminat,glabrou,greenish-brow,incrassate,later,lobe,lon,long,lower,merely,middle,nflorescence,older,pale,pericarp,poricidal,portion,quadrate,ruit,scar,spaced,specimen,strongly,styl,tan,thick,thickened,tip,tub,ud,unevenly,widest,ympodia,young	0.5,abaxial,adaxial,articulation,branching,colour,diameter,form,fruit,greenish-brown,growth,inflorescence,length,odour,plant,position,seed,shape,size,structure,sympodial,texture,type,unit,venation
267	wfo-0001029003	invalid_json	207	134	106	101	28	0.512	0-6,0.5,1-2,1-3,1.2-1.9,1.2-2.5,1.5-2.3,11-32,12.2-30,13-36,2.5-10,3,3-20,3-5,3.5-7.5,4-8,5,5-10.5,5-12.5,7-15.5,7-9,9-14,abaxially,adaxially,anther,berry,blade,blue-violet,brownish,cell,chartaceous,cm,condition,conical,corolla,covering,diameter,drying,end,filament,flower,forked,fresh,fruit,glabrous,green,green-white,greenish,hair,hair-like,herb,homostylous,interjected,lanceolate,lateral,leaf,leaflet,light,like,long,make,medium,membranous,minute,mm,mottled,mucilaginous,odd-pinnate,one,ovoid,pale,pedicel,peduncle,pentagonal,petiole,placed,plant,pore,poricidal,pubescent,purple,ripe,rotate,seed,size,sparsely,stem,stigma,straight,style,subcapitate,subglabrous,terminal,testal,thick,throughout,tip,tuber,typically,usually,violet,wall,wet,whitish,wide,x	0.3-0.5,0.4-3,1,1-10,1-2.5,1-5,2-6,2.5-7.5,5-merou,absent,acumen,acuminate,ag,alyx,apart,apex,apparently,articulated,attenuate,axe,axillary,base,bud,capitat,ciliate,connivent,decreasing,digestion,distal,dorsally,eaf,edge,eed,elliptic,elongated,enzyme,equal,erec,especially,exceeding,flat,folded,fourth,geminat,generally,glabrou,gradually,hal,half,highly,honeycomb-shaped,larger,lengthening,living,lobe,lower,margin,middle,nflorescence,obtuse,orbicular,orolla,ovate,pair,perfect,petiolule,pigmentation,plurifoliate,prostrate,proximal,rarely,ray,removed,rounded,ruit,secondary,sessile,seudostipule,slightly,slit,sometimes,spaced,specimen,stamen,ste,stolo,subequal,subtending,symmetrical,tall,tamen,tem,toward,tri-,tube,unit,vary,white,wing,yellow,ympodial	'',5-merous,[,``,arrangement,branching,calyx,capitate,characteristic,colour,form,glabrousnes,growth,height,inflorescence,length,number,ovary,placement,pseudostipule,shape,staman,stolon,texture,type,value,{,}
268	wfo-0001029006	success	217	141	90	127	51	0.415	-+,0.4-2.5,1-1.5,1-4,2-3,3.5-4,5,adaxial,age,anther,anthesi,apex,articulated,asymmetrical,axi,base,berry,blackish,branched,c.,calyx,cell,chartaceous,cm,connivent,corolla,deeply,ellipsoid,filament,filiform,fruiting,glabrous,globose,groove,growth,inflated,inflorescence,irregular,later,lateral,leaving,lengthening,lobe,lobed,long,loosely,lower,many,margin,membranous,minutely,mm,nodding,oblique,occasionally,often,pale,pedicel,peg,perfect,petiole,pinnatifid,pore,poricidal,puberulent,purple,ripe,rotate-stellate,sagittate,simple,sleeve,slit,small,spreading,stem,surface,terminal,time,tip,trichome,truncate,twining,uniseriate,unit,usually,vine,violet,way,white,x	.5,0.2,0.5,0.5-2,0.5-4,1,1-5,1.2-1.5,1.8-2.2,1/3,10,10-20,2-6,2.5,4-6,5-6,5-merou,50,7-8,7-9,<,>,abaxially,acuminate,acute,adaxiall,ag,along,alyx,apar,area,ark,axil,basal,beyond,bilobed,black,bright,broadest,clavat,conical,deltate,dense,depending,diameter,drying,eaf,eed,elliptic,elongate,entire,exserted,extending,flattened,flower,free,green,growing,ilament,intramarginal,irregularly,keeled,lamina,markedly,midrib,minute,narrowly,nearly,new,nflorescence,obvious,older,one,orolla,pair,papillate,part,peduncle,pendan,pentagonal,per,pericarp,pitted,planar,plurifoliat,portion,primary,puberulen,pubescent,purplish,reaching,reddish,reniform,ruit,scar,shiny,size,smaller,sometimes,somewhat,spaced,sparsely,stigma,strong,strongly,style,sunligh,tan,tem,testal,thin,tiny,tube,tuft,twinin,ud,upper,variable,variously,vary,vein,widest,within,woody,ympodial,young,zig-zag	5-merous,appressed,articulation,bract,branching,breeding,broad-based,colour,connective,form,fruit,hair,heteromorphism,insertion,interjected,interpetalar,leaf,leaflet,length,marking,mature,modification,na,needle-like,odour,orientation,paired,pattern,placement,plurifoliate,position,prickle,pseudostipule,rhizome,scale,shape,smell,spot,staman,stone,structure,symmetry,sympodial,system,texture,tissue,tuber,type,vegetative,xylopodia,zygomorphy
269	wfo-0001029031	success	213	119	75	138	44	0.352	.5-1.2,0.5-1.5,1-1.5,2-3,4-5-,accrescent,adaxially,angle,anther,apex,articulated,base,becoming,berry,black,bluish,branched,calyx,chartaceous,cm,connivent,corolla,cuneate,directed,distally,entire,erect,filament,fleshy,flower,forked,fruit,fruiting,geminate,glabrescent,globose,green,hair,held,large,lateral,leaf,leaf-opposed,length,many-foliate,margin,mm,oblong,obtuse,occasionally,paired,pedicel,peltate-stellate,perfect,petiole,pore,possibly,pseudoterminal,pubescent,ripening,rounded,shrub,simple,slightly,small,sometimes,somewhat,sparsely,stellate,tree,trichome,unbranched,unit,white,x	-11.4,-12.3,-3.6,-8,.1-0.3,0-5,0.1-0.5,0.5,0.5-4,0.6-1.2,0.7-1.1,1-2,1-2.5,1-2.6,1-3,1-5,1-9.4,1.3-3.3,1.5-2.8,1.5-3.5,1.8-2.7,1.8-4,1/3,10,13.5,2-10.7,2-3.3,2-5,2.5-5.5,2.5-5.6,20-150,3-10,4-7.5,5-17,6-12,6-21,abaxially,absent,acuminate,acute,adaxiall,ag,apart,apexacute,apparently,around,axe,ba,bilobe,blade,brown,capitate,center,covering,curved,cylindrical,deltate,densely,denser,diameter,eaf,edge,eed,eglandula,eglandular,elliptic,elliptic-ovate,equal,farinose,flattened,frui,fused,glabrous,immature,impressed,inserted,lanceolate,least,light,like,lobe,long,longitudinal,lower,major,midpoint,midvein,nearly,nflorescence,opening,orange,orolla,outline,peduncle,peltate,porrect-stellate,prominent,pubescen,pubescence,rachi,rarely,ray,reniform,rugulose,ruit,sessile,short,short-stalked,side,silvery,slit,smaller,spaced,ste,stellate-pubescent,stem,stigma,straight,strongly,style,suborbicular,subtending,surface,tall,tamen,tem,time,tip,tube,unarme,usually,vary,vein,whitish,wide,yellow,yellowish,ympodial	appressed,articulation,bract,branching,breeding,cell,colour,connective,form,growth,heteromorphism,inflated,inflorescence,insertion,interjected,interpetalar,leaflet,marking,mature,modification,na,odour,orientation,pattern,pellate-stellate,placement,position,prickle,pseudostipule,rhizome,scale,shape,spot,staman,stone,structure,symmetry,sympodial,system,texture,tissue,tuber,type,xylopodia
270	wfo-0001029048	success	162	129	107	55	22	0.66	.01,.2,.5,/3,0.5,0.5-1.7,0.8-1,1-2,1-8,14,2,25,26,3-4,3-7,3.5-4,4-6,9-15,anther,anthesi,apex,arching,attenuate,basal,base,beneath,bicellular,broadly,calyx,cm,conical,corolla,decurrent,dia,elliptic,elongated,expanded,f,filament,filiform,fruiting,glabrate,glabrous,globose,golden,greatly,greenish-white,greenish-yellow,hanging,hispidulous,incrassate,leaf,less,like,lobe,lobed,long,margin,matte,minute,minutely,mm,obovoid,obtuse,older,opposite,ovary,ovoid-reniform,pale,papillose,pedicel,petiole,pitted,planar,pore,poricidal,puberulent,reflexed,ripe,scar,shaped,sharply,shrub,slender,slightly,small-capitate,somewhat,spaced,stem,stigma,straight,style,surface,tapering,tear-drop,thread-like,tip,trichome,tube,unevenly,uni-,vein,way,widely,winged,x,young	0.5-1,1,1.5-2,11,5-8,8-10,acuminate,angle,another,apar,apparent,bearing,becoming,berry,blade,branch,bright,eaf,edicel,eed,except,flower,free,geminate,green,greenish-yello,lateral,live,lower,main,middle,midrib,much,nflorescence,node,non-reproductive,one,pair,papillo,parallel,portion,right,rounded,ruit,specimen,tall,tan,time,translucent,ud,unifoliate,unit,widest,ympodial,zig-zag	apart,branching,bud,colour,diameter,form,fruit,growth,hair,height,inflorescence,length,marking,pattern,plant,position,seed,shape,size,spacing,spot,width
271	wfo-0001029055	invalid_json	169	128	88	81	40	0.521	0.4-1.5,1-4,1-5,1.8-3.5,14-50,2-4,2.2-3,3-10,4-10,4-6,4-7,5-24,5.5-9,6-14,8-9,9-22,acute,apical,apically,base,branched,calyx,cm,connate,corolla,cyme,dehiscent,diameter,dichasial,dichasially,diminishing,distal,dorsally,edge,exceeding,filament,flat,flower,folded,gland,green,green-white,herbaceous,interjected,introrse,lateral,leaf,leaflet,lobe,long,long-attenuate,maturing,mm,monochasial,mucilaginous,odd-pinnate,often,outline,ovoid,pedicel,peduncle,pentagonal,perennial,perfect,petiole,pilose,plant,poricidally,proximal,pubescent,rotate,seed,short,short-stalked,size,slit,stamen,straight,style,terminal,throughout,toward,triangular,tuber-bearing,type,unit,yellow,Â¼	1-2.6,1.6-3.5,1.7-2.2,2-1.,2-3,2.5-8,3,3-6,3-6-foliat,abaxially,acumen,acuminate,adaxially,apex,articulate,attenuate,cell,cordate,covered,covering,cuneate,dark,decurrent,densely,digestion,eaf,ebracteate,eed,elliptcal,elliptical,emoval,enzyme,first,forked,generally,globo,hair,hair-like,half,honeycomb,living,lon,longer,longitudional,lower,lunat,make,near,nflorescence,nther,oblique,orolla,ovate,pair,pattern,plan,purple,rarely,reveal,ruit,second,sessile,seudostipule,short-petiolate,sometimes,specimen,spreading,stigma,stripe,tal,tem,testal,thick,time,typically,vary,wall,whit,wide,widest,ympodial	'','type,2-11,3-6-foliate,[,],``,anther,articulation,bract,branching,characteristic,colour,connective,ebbrate,form,fruit,growth,height,inflorescence,length,lunate,number,ovary,perfection,pore,presence,property,pseudostipule,shape,stem,structure,sympodial,texture,value,wet,white,width,{,}
272	wfo-0001029059	invalid_json	199	115	95	104	20	0.477	.5,0.1-0.5,0.2,0.5-1,1-1.5,1-3,1-4,1-6,1.2-3,1.5-2,10-19,2.5,3-3.5,3-6.5,3.5-6,3.5-8,4-10.5,7-9,acute,along,anther,base,branched,bud,clavate,closely,cm,cordate,corolla,cuneate,dense,densely,dia,dirty,elliptic,extremely,filament,flattened-reniform,fruiting,glabrous,globose,hispidulous,inflorescence,leaf,lobed,long,major,member,minor,minute,minutely,mm,nearly,oblique,occasionally,often,opposite,orbiculate,ovary,pair,papillose,pedicel,petiole,pitted,pubescence,pubescent,purplish,ripe,rounded,scar,shape,shaped,shrub,size,small,somewhat,spaced,sparse,stigma,style,surface,tear-drop,tinge,tree,trichome,underside,unicellular,uniseriate,variable,vein,waxy,white,x,yellowish-green,young	0.1-1,0.2-0.5,0.5,1-1.2,1.3-1.7,1.5-2.8,5,5-15-flowered,6-10,anisophyllou,anthesi,apar,ape,apex,apiculae,apiculate,arising,bark,beneath,berry,bout,calyx,coiba,connivent,covered,de,deep,deflexed,deltoid,differing,difoliate,eaf,edicel,eed,ellipsoid,expanded,exserted,extending,foetid,free,geminate,glabrate,greatly,impressed,incrassate,interpetalar,isla,lamina,lateral,lobe,lon,longest,lower,main,margin,membranous,middle,narrowly,nflorescence,older,one,orange,orangish-yellow,pale,paler,panama,papillo,partially,planar,pointed,population,pore,poricidal,portion,prominent,reddish-gre,rest,ruit,shallowly,simple,sinus,slender,soon,specimen,stem,straight,tall,tapering,terminal,thickened,ti,tightly,tip,triangular,tube,ud,unit,usually,wide,widest,woody,yellowish,yellowish-tan,ympodial	'',[,],``,apart,characteristic,colour,form,fruit,growth,hair,height,length,plant,position,seed,texture,value,{,}
273	wfo-0001029072	success	235	106	56	179	50	0.238	1-1.5,12-19,2-7,3-5,5-7,andromonoecious,anther,apex,articulated,base,berry,branched,bright,calyx,chartaceous,cm,conical,connivent,cordate,curved,elongating,equal,filament,flattened,fruit,fruiting,herb,lateral,leaf,length,lobed,long,lower,margin,marking,mature,mauve,mm,pedicel,petiole,poricidal,prickle,shrub,simple,spherical,stellate,stellate-pubescent,stem,surface,tapering,terminal,tip,trichome,unit,white,yellow	-1/2,-15,-2.5,.5,/6,0,0-2,0-20,0-4,0-8,0.1-0.4,0.2-0.3,0.2-0.4,0.3,0.4-0.9,0.5-2,0.5-3,0.7,0.8,0.8-1.5,00-200,1,1-1.2,1-25,1-3,1.5-2.5,1.5-2.6,1.5-3.2,1/3,1/4-1/2,1/4-1/3,2-10,2-5,2-8,2.2-2.5,2.2-3.2,2.5-3.5,2.5-3.8,2.5-4.5,20-50,3-10,3-20,3-50,3-8,3.5-6,3/,4-,4-10,4.2-6.5,4.5-9,5-10,5-50,5-9,5-merous,7-10,7-15,8-20,8-27,abaxial,abaxially,acute,adaxial,adaxially,alyx,ame,angled,apar,apart,apically,apparently,bark,blade,broad-deltate,broadly,c.,clearly,cream,cuneate,dark,deltate,densely,diameter,dirty,discolorous,distal,distance,drying,dull,eaf,eed,elongated,erect,extending,flattened-reniform,flower,free,gently,glabrous,gra,green,green-brown,hermaphrodite,heterostylous,infructescence,least,lobe,long-styled,longer,longitudinal,lowermost,maturity,midpoint,midvein,moderately,multangulate,narrow-deltate,nflorescence,obtu,older,one,open,orange-brown,orolla,oung,ovate,pair,pale,peduncle,pendent,pendulous,per,pericarp,plant,plurifoliat,porrect,portion,prickl,prickly,primary,raised,ray,reflexed,ridge,rounded,ruit,scar,sessile,short-styled,side,smooth,sometimes,spaced,sparsely,spreading,stalk,stalked,staminat,stout,straight,strongly,style,tamen,tertiary,time,tube,unarmed,upper,variously,vary,vein,venation,visible,way,weakly,whitish,wide,woody,ympodial,young	appressed,articulation,bract,branching,breeding,broad-based,cell,colour,connective,corolla,form,growth,hair,heteromorphism,inflated,inflorescence,insertion,interjected,interpetalar,leaflet,modification,na,needle-like,odour,orientation,paired,pattern,placement,plurifoliate,pore,position,pseudostipule,rhizome,scale,shape,smell,spot,staman,stone,structure,symmetry,sympodial,system,texture,tissue,tuber,type,vegetative,xylopodia,zygomorphy
274	wfo-0001029073	invalid_json_followup	211	142	97	114	45	0.46	.5,0.3-1,0.6-2,1-1.2,1-1.5,1.1-1.5,1.5-2,10-16,2-3,4-5,5-8,acuminate,acute,adaxially,anther,apex,base,berry,broad-based,brown,calyx,chartaceous,cm,corolla,curved,dark,dense,densely,diameter,elliptic,entire,filament,flattened,fruiting,glabrous,globose,growth,inflorescence,internodal,interpetalar,lanceolate,leaf,length,lengthening,lobed,lower,margin,maturity,minutely,mm,narrowly,occasionally,orange,pale,papillose,pedicel,peduncle,per,perfect,petiole,pore,poricidal,porrect,prickle,pubescence,pubescent,purple,reniform,reticulate,shallowly,shrub,simple,sinuate,slit,splitting,stellate,stem,stigma,straight,strongly,style,surface,tan,tapering,tip,tissue,trichome,truncate,tube,unequally,unisexual,upward,whitish,x,yellow,yellowish,zygomorphic	.7,0.5,0.5-1,0.6-0.7,1-2.5,1-3,1.2-1.6,10-15,2,2-4,2/3,3.5-9,4-6,5-6,5-merous,6-9,7-10,8-14,abaxially,along,another,anthesi,apart,armed,articulated,away,awn-like,ba,bark,basal,beneath,cell,conical,cream,darker,difoliate,dimorphic,discolorous,drying,eaf,eed,enlarged,equal,erect,except,exserted,flower,four,free,frui,geminat,golden,gre,hooked,lamina,like,linear,lobe,long,long-styled,midpoint,midvein,mixture,multangulate,new,nflorescence,nodding,oblique,older,one,opposite,pair,paler,pericarp,planar,plurifoliate,portion,prickly,primary,ray,rectangular,ruit,scar,sessile,shiny,short,short-stalked,shorter,slightly,sometimes,somewhat,spaced,sparsely,styled,testal,thin,three,ti,triangular,two,ud,unarmed,underside,unequal,unit,upper,vein,visible,wall,way,wide,woody,ympodial,Â½	'',0.7,[,``,abaxial,appressed,articulation,bract,branching,breeding,characteristic,colour,connective,form,fruit,hair,inflated,insertion,interjected,leaflet,marking,mature,modification,na,needle-like,number,odour,orientation,paired,pattern,placement,position,scale,seed,shape,smell,spot,symmetry,system,texture,type,value,vegetative,{,}
275	wfo-0001029074	invalid_json	174	137	110	64	27	0.632	.1,.5,0,0.2-1,0.3-0.8,0.5-1,0.5-1.2,0.7-0.8,1-1.2,1-1.5,1-2,1.4-1.8,1.5-2,2-2.3,2-4,3.5-5,5-6,acute,anther,anthesi,apart,apex,apparently,articulation,base,berry,black,broadly,calyx,capitate,cm,conical,corolla,cuneate,densely,diameter,ellipsoid,entire,exerted,filament,flattened,flower,fruiting,glabrous,globose,green,grey,growth,herb,immature,internodal,lacking,leaf,less,like,lobe,lobed,margin,midpoint,minutely,mixture,mm,opposite,ovary,ovate,pale,pedicel,peduncle,per,perfect,pericarp,petiole,pitted,poricidal,pubescent,pulp,purplish,ray,reflexed,reniform,ripening,rounded,sagittate,scar,sessile,simple,small,sparsely,stalked,stellate,stem,stigma,strongly,style,subshrub,surface,thin,tip,triangular,trichome,truncate,tube,underside,uniformly,watery,way,white,x,yellowish,Â¾	0.3-0.4,0.7-0.95,1,1-,1.5-4,11,2-5,2-7,3-,3-6,5-7,abaxially,absent,adaxially,age,almost,along,appearing,bark,basa,deflexed,denser,eaf,eed,expanding,free,frui,glabrescen,lengthening,lignescent,longest,lower,markedly,midvein,new,nflorescence,obscuring,often,older,pair,papillat,petal,planar,plurifoliat,pore,portion,primary,prominent,ruit,scattered,slit,somewhat,stalk,stellate-pubescent,swollen,tub,ud,uniseriate,unit,usually,vein,woody,yellow,ympodial	'',[,``,abaxial,adaxial,basal,bud,characteristic,colour,consistency,form,fruit,hair,height,inflorescence,length,number,papillate,plant,position,seed,shape,thicknes,type,value,{,}
276	wfo-0001029075	invalid_json_followup	217	183	125	92	58	0.576	.3,.5,0-8,0.8-1.5,1-2,1-2.5,2-4,2.5-3,30-60,4-10,4-14,4-7,4.5-6.5,5-10,5-8.5,6-12,7-17,7-9,8-9,abaxially,adaxially,along,anther,axillary,base,berry,blade,brown,brownish,bud,canescent,cell,ciliate,cm,condition,connivent,corolla,covering,cuneate,dark,densely,diameter,distal,dot,drying,end,especially,filament,flecked,flower,forked,fresh,fruit,generally,glabrescent,glabrous,glandular-pilose,glandular-puberulent,gray-green,green,green-white,greenish,hair,half,herb,homostylous,interjected,lanceolate,lateral,leaf,leaflet,lengthening,like,long,make,margin,midrib,minutely,mm,mucilaginous,odd-pinnate,orne,ovoid,pair,pedicel,pentagonal,petiole,plant,pore,poricidal,puberulent,pubescent,rounded,seed,short,singly,size,slightly,slit,small,stem,stigma,straight,style,substellate,subtending,terminal,testal,thick,throughout,tip,tuber,typically,unwinged,usually,wall,wet,white,whitish,whitish-gray,wide,x,yellow,yellow-green,yellowish-white	0-3,0.5-0.8,0.8-1.2,1-10,1-3,10-20,2-5,2.7-4.2,4-5,5-8,5-merou,abruptly,acumen,ag,alyx,apart,apex,apparently,articulated,attenuate-acuminate,atypically,axe,broadly,clavifor,decreasing,decurrent,digestion,dorsally,eaf,edge,eed,elliptic-lanceolate,enzyme,erect,erect-ascendin,etota,exceeding,flat,folded,geminat,glabrou,gradually,greatly,hair-like,honeycomb-shaped,larger,light,living,lobe,long-spatulate,lower,middl,narrowed,narrowly,nflorescence,orbicular,orolla,ovate,peduncle,perfect,petal,petiolulate,petiolule,plurifoliate,pointed,purple,rachi,removed,ruit,sec,sessile,seudostipule,sometimes,spaced,specimen,stamen,ste,stolo,subequal,subobtuse,subquadrate,tall,tamen,tem,toward,tri-,tube,unit,upper,vary,woody,ympodial	'',0,5-merous,[,\u201chair-like\u201d,``,abaxial,adaxial,age,appressed,arrangement,articulation,bract,branching,breeding,calyx,characteristic,claviform,colour,connective,form,fruiting,growth,height,inflated,inflorescence,insertion,interpetalar,length,marking,mature,middle,modification,na,number,odour,ovary,paired,pattern,position,presence,pseudostipule,scale,shape,smell,spot,stolon,symmetry,system,texture,tissue,trichome,type,value,vegetative,zygomorphy,{,}
277	wfo-0001029084	success	192	142	95	97	47	0.495	.5,0.8-2,0.8-2.1,1-10,1-2,1.1-2.2,1.5-2.5,10-50,2-3.5,2-5,3-6,3.5-7.5,3.5-8,4-17,4-7,4.5-6.5,5,6-13,7-9,8-23,absent,anther,apex,base,blade,brownish,cell,chartaceous,cm,condition,conical,corolla,diameter,digestion,drying,enzyme,filament,flower,forked,fresh,fruit,glabrous,green,greenish,herb,homostylous,honeycomb-shaped,interjected,interpetalar,lanceolate,lateral,leaf,leaflet,lengthening,light,lilac,long,margin,middle,minute,mm,moniliform,mottled,odd-pinnate,ovoid,pedicel,peduncle,petiole,plant,plurifoliate,pore,poricidal,proximal,pubescent,purple,removed,ripe,rotate,seed,size,slit,sparsely,style,subglabrous,terminal,testal,tip,tissue,tri-,tuber,unit,wall,whitish,wide,x	1-3,1-4,2-4,4.5-10,5-7,5-merou,abaxially,acumen,acuminate,adaxially,ag,along,alyx,apart,apparently,arranged,articulated,axe,axillary,bead,berry,bud,capitat,ciliate,connivent,covering,darker,decreasing,distal,dorsally,eaf,edge,eed,especially,exceeding,flat,folded,geminat,generally,glabrou,gradually,green-white,hair-like,half,larger,like,living,lobe,lon,lower,make,midrib,minutely,mucilaginous,multiple,narrow,necklace,nflorescence,obtuse,orolla,ovate-lanceolate,pair,perfect,petiolule,pilose,puberulent,ray,ruit,secondary,semierec,seudostipule,spaced,specimen,stamen,stigma,stolon,subequal,subglabrou,subsessile,subtending,symmetrical,tall,tamen,tem,thick,thir,throughout,toward,tube,typically,unwinged,usually,vary,wet,wing,yellow,ympodial	age,arrangement,articulation,bract,branching,breeding,colour,connective,form,growth,hair,height,heteromorphism,inflorescence,insertion,length,marking,mature,modification,na,number,odour,orientation,ovary,paired,pattern,placement,position,prickle,pseudostipule,rhizome,scale,shape,spacing,spot,staman,stem,stone,structure,symmetry,sympodial,system,texture,third,type,width,xylopodia
278	wfo-0001029088	success	149	122	87	62	35	0.584	0.1,0.9â1.5,1.3â4.5,15â25,1â1.6,2.5â20,2.5â4.2,25â30,2â2.5,3â16,4â8,5,5-merous,5â8,<,abaxially,acuminate,adaxially,anther,apex,base,berry,bronze-brown,calyx,climbing,cm,cordate,densely,diameter,entire,extra-axillary,filament,flavor,flower,fragrant,fruit,glabrous,greenish-brown,hair,heavy,herbaceous,immature,juicy,leaf,lenticular,light,margin,mature,membranous,minutely,mm,moderately,near,obtuse,ovoid-rhomboid,palmate,pedicel,peduncle,petiole,primary,pubescent,purplish,rachi,reddish-brown,revolute,rounded,rugose,sand-punctate,scent,shortly,simple,slender,slightly,sparsely,stellate,strongly,surface,sweet,terrestrial,unbranched,unit,vein,venation,vine,white,x,â7	.2,.3,0.6â3.2,1.5â2,1.5â3,1â1.2,1â1.5,1â3,2-lobe,2â3,3.5â7,3.5â8,6-10,accrescent,acute,alyx,apar,apicall,axe,blade,c.,capitate,ciliate,cylindrical,eaf,eed,emarginate,flattened,fleshy,fruiting,glabrou,groun,half,lanceolate,lobe,long,lower,m.,narrowly,nflorescence,nternode,orolla,papillose,perfec,plurifoliat,ruit,somewhat,spaced,stigma,stout,straight,style,swee,tamen,tem,tip,truncate,truncate-acuminat,tube,vary,wider,ympodial	branching,cell,colour,corolla,form,fragrance,growth,habit,height,heteromorphism,inflorescence,internode,juicines,length,merosity,na,odour,orientation,perfect,placement,plant,plurifoliate,pore,position,prickle,seed,shape,staman,stem,stone,structure,symmetry,sympodial,texture,type
279	wfo-0001029089	success	177	135	78	99	57	0.441	/4,0.1-0.25,0.5-0.6,0.5-1,0.8-1,1,1-1.5,1.5-2,1.5-6,10-25,4.5-5,5-10,5-20-flowered,5-9,6-7,acute,anther,anthesi,apex,base,bilobed,branched,calyx,campanulate,caniculate,cm,corolla,decurrent,deflexed,densely,dia,difoliate,elliptic,filament,flattened-reniform,fruiting,furcate,glabrous,globose,golden,green,incrassate,leaf,lobed,lower,margin,minutely,mm,occasionally,opposite,ovary,pedicel,petiole,pitted,pore,pubescent,purplish,shaped,shiny,shrub,simple,size,slightly,small,stem,stigma,style,surface,tear-drop,tree,trichome,tube,uniseriate,unit,usually,way,white,x	.5,.75,0.8-1.2,1/2,2.5-3.5,5-6,8-9,abrupt,along,apart,apiculate,axil,ba,bark,beginning,beneath,berry,bud,closely,completely,covered,covering,cracking,dark,differing,drying,eaf,edicel,eed,either,enclosed,entire,erect,expand,exserted,free,geminat,glabrou,impressed,inflorescenc,lamina,later,lateral,like,lobe,lon,long,main,major,material,member,middle,minor,nflorescence,obovoid,older,one,otherwise,overlapping,pair,papillo,papillose,part,peeling,persistent,pinkish,planar,poricidal,portion,primary,prominent,reddish-grey,resinou,resinous,rounded,rounded-deltoid,ruit,scar,secretion,smooth,somewhat,spaced,still,straight,tall,tan,tapering,tip,tub,ud,underside,varnish,varnished,vein,widening,widest,woody,ympodial,young	abaxial,adaxial,articulation,bract,branching,breeding,broad-based,cell,colour,connective,diameter,flower,form,fruit,geminate,growth,hair,height,heteromorphism,inflorescence,insertion,interjected,interpetalar,leaflet,length,marking,modification,na,needle-like,number,odour,orientation,pattern,placement,plant,position,prickle,pseudostipule,rhizome,scale,seed,shape,smell,spot,staman,stone,structure,symmetry,sympodial,system,texture,tissue,tuber,type,vegetative,xylopodia,zygomorphy
280	wfo-0001029091	invalid_json_followup	212	172	113	99	59	0.533	-4,1-10,1-2,1.5-,10,2-2.5,2-3,20-30,3,3-11-lobed,3-4,46/1,635/1,7-8,acuminate,acute,age,anther,apex,aromatic,articulated,articulation,axil,base,becoming,berry,broadly,brownish,buff,calyx,capitate,cell,clonal,close,cm,colour,conspicuous,corolla,cuneate,cyme,discoidal,effect,ellipsoid,elliptic,filament,flattened,flower,flushed,fork,fresh,fruiting,giving,glandular,globose,globular,grey,growing,hair,half,intense,irregularly,lasting,lavender,leaf,lengthening,light,long,lower,may,mineral,minutely,mm,oblong,obovate,ochre-yellow,ovate,ovoid,pale,pattern,pedicel,pentagonal,petiolate,petiole,point,pore,poricidal,pubescent,reddish-purple,rh,several,shortly,shrub,simple,slightly,slit,soft,sparsely,speckled,stellate-rotate,stem,stigma,stone,straggly,style,surface,tip,tissue,toward,upper,violet,violet-purple,woody,year	-1,-15,-4.5,0.3-,0.5-0.8,0.5-1,1,1.5-2,10-20,10-toothed,15-40,170-210,2-12,2.5-,3-,4,5,5-7,appearing,aspect,ba,blunt,bluntly,campanulate,common,cut,dark,deeply,develop,developed,dia,downward,eed,emarginated,erect,exceeding,exerted,floral,forked,general,gree,interacuminal,irregular,juvenile,lacking,larger,later,lateral,lavende,line,linear,linear-lanceolate,lobe,long-triangular,mid-vein,narrowly,nflorescence,obscure,occasionally,overlain,ower,pedicellate,peduncle,petiol,plurifoliat,rachi,raised,readily,relatively,reticulate-concentric,ridge,ridged,ripe,rounded,ruit,scarcely,separate,shallowly,shed,sigmoid,sinus,slender,soft-wooded,soon,subulate,succulent,swollen,tall,transverse,triangular,tub,ud,unit,usually,well,winged,without,x,ympodial	'',[,``,age-related,appressed,bract,branching,breeding,broad-based,bud,characteristic,clonality,connective,form,fruit,growth,habit,height,history,inflated,inflorescence,insertion,interjected,interpetalar,leaflet,length,life,lobing,margin,marking,mature,modification,na,needle-like,odour,orientation,paired,placement,plant,position,prickle,pseudostipule,pubescence,rhizome,scale,seed,shape,smell,spot,symmetry,system,texture,trichome,tuber,type,value,vegetative,{,}
281	wfo-0001029101	success	233	119	70	163	49	0.3	/3,/4,1-1.5,1-3,3-7,5-7,8-15,andromonoecious,anther,apex,articulated,base,berry,branched,calyx,cell,chartaceous,cm,concolorous,connivent,cuneate,discolorous,drying,elongating,equal,filament,flattened,fruit,fruiting,glabrous,lateral,leaf,length,lobed,long,lower,margin,marking,mature,maturity,mauve,mm,narrow-deltate,obtuse,pale,pedicel,petiole,poricidal,porrect,prickle,rarely,reflexed,sessile,shrub,simple,sparsely,spherical,stalked,stellate,stellate-pubescent,stem,straight,surface,tapering,tip,trichome,unit,way,yellow,yellow-orange	-15,-3,.5,0-100,0-2,0-20,0-5,0-8,0.1,0.1-0.4,0.1-0.5,0.1-0.7,0.1-1,0.2,0.4-1.5,0.5-1,0.7-,0.8-3.5,00-200,1,1-4,1-8,1.3-2,1.3-2.6,1.4-2.2,1.5-2,1.5-2.5,1.7,1.8-3,1/5-1/4,10-14,10-20,2-,2-20,2-6,2.5-3.5,2.5-6,2.8-3.3,2/3-3/4,3-,3-10,3-4,30-100,4-12,4-7,5-,5-20,5-6,5-8,5-9,5-merous,5.5-8,6-8,7-13,abaxial,abaxially,acute,adaxial,almost,always,alyx,apar,apart,apically,apparently,bark,blade,broad-deltate,brown-green,cream,dark,darker,deltate,diameter,distal,distance,dull,eaf,eed,elliptic,erect,extending,flattened-reniform,flower,free,glabrescent,green,green-brow,hermaphrodite,heterostylous,infructescence,lengt,like,lobe,lon,long-styled,longer,lowermost,midpoint,midvein,moderately,multangulate,nflorescence,oblong,obovate,often,older,one,open,orange-brown,orolla,oung,outline,ovate,pair,peduncle,pendulous,per,pericarp,pit,plant,plurifoliat,portion,present,prickl,prickly,primary,raised,ray,reduced,rounde,rounded,ruit,scar,secondary,short-styled,side,small,smooth,sometimes,spaced,spreading,stalk,staminat,style,suborbicular,tamen,terete,tertiary,thick,time,tube,variously,vary,vein,venation,visible,well-developed,wide,woody,yellow-green,ympodial,young	appressed,articulation,bract,branching,breeding,broad-based,colour,connective,corolla,form,growth,hair,heteromorphism,inflated,inflorescence,insertion,interjected,interpetalar,leaflet,modification,na,needle-like,odour,orientation,paired,pattern,placement,plurifoliate,pore,position,pseudostipule,rhizome,scale,shape,smell,spot,staman,stone,structure,symmetry,sympodial,system,texture,tissue,tuber,type,vegetative,xylopodia,zygomorphy
282	wfo-0001029106	success	200	109	62	138	47	0.31	/3,0-5,0.5-1,2-8,3-4,4-6,anther,apex,apparently,articulated,base,berry,branched,calyx,cell,cm,concolorous,cuneate,curved,discolorous,drying,elongating,equal,erect,filament,fruit,fruiting,gently,glabrous,lateral,leaf,length,lobed,long,margin,mature,maturity,mauve,membranous,mm,obtuse,orange,pedicel,petiole,poricidal,prickle,red,reflexed,shrub,simple,spherical,spreading,stellate,straight,subentire,surface,tapering,tip,unit,way,weakly,white	-6,.1,.5,0,0-0.3,0-10,0-2,0-20,0-6,0.1,0.2-0.4,0.2-1,0.25-0.7,0.5,0.5-0.8,0.5-0.9,0.5-2.5,0.9-1.2,1-1.6,1-2,1-5,1.5-1.8,1.5-2,1.5-3.5,1/4,1/5-1/4,2-3.5,2-4,2-5.5,2-6,2.2-3,2/,3-25,3-3.5,4-8,5-14,5-8,5-merous,6-8,abaxially,acuminat,acute,alyx,ame,apar,apart,apically,appearing,bark,blade,c.,deltate,densely,diameter,distance,eaf,eed,elliptic,extending,eye,flattened,flattened-reniform,flower,free,glabrescent,infructescence,light,lobe,lon,longer,lower,midpoint,midvein,naked,nflorescence,older,one,open,orange-brow,orange-brown,orbicular,orolla,oung,outline,ovate,pair,pale,peduncle,pendulous,per,perfec,pericarp,pit,plurifoliat,porrect,portion,prickl,prickly,primary,raised,ray,rounded,scandent,scar,sessile,shallow,shiny,shorter,side,size,slender,small,smooth,sometimes,spaced,sparsely,stalk,stalked,stellate-pubescent,stem,style,tamen,terete,tertiary,time,trichome,tube,uit,variously,vary,vein,venation,visible,wide,woody,yellow-orange,yellowish-green,ympodial	appressed,articulation,bract,branching,breeding,colour,connective,corolla,form,growth,hair,heteromorphism,inflated,inflorescence,insertion,interjected,interpetalar,leaflet,marking,modification,na,odour,orientation,paired,pattern,perfect,placement,plurifoliate,pore,position,present,pseudostipule,rhizome,scale,shape,spot,staman,stone,structure,symmetry,sympodial,system,texture,tissue,tuber,type,xylopodia
283	wfo-0001029112	invalid_json	190	123	98	92	25	0.516	0.9-1.7,1-10,1-2,1.4-2.5,1.5-1.8,1.5-2,10-17,10-21,2-3.5,2.5-4.5,2.6-3,2.7-3.5,2.7-4.2,2.7-5.7,20,3-7,3.5-4.5,3.5-7,5,6.5-5.5,9.5-13,abaxially,adaxially,anther,berry,blade,brownish,cell,chartaceous,ciliate,cm,condition,conical,corolla,covering,densely,diameter,distal,dorsally,drying,edge,filament,flat,flower,folded,forked,fresh,fruit,glabrous,green,green-white,greenish,hair,hair-like,herb,lanceolate,lateral,leaf,leaflet,lengthening,light,like,make,margin,middle,minute,mm,moniliform,mottled,mucilaginous,odd-pinnate,ovoid,pale,pedicel,peduncle,petiole,plant,pore,poricidal,pubescent,purple,ripe,rotate,seed,size,slit,style,terminal,testal,thick,throughout,tip,tuber,violet,wall,wet,whitish,x	0-2,0.5,1-3,1-4,3-4,3-5,3-6,5-8,5-merou,acumen,acuminate,ag,along,alyx,apart,apex,apparently,arranged,articulated,axe,axillary,base,bead,bud,capitat,connivent,decreasing,digestion,eaf,eed,elliptic-lanceolate,enzyme,equal,especially,exceeding,geminat,generally,glabrou,gradually,half,homostylous,honeycomb-shaped,interjected,larger,living,lobe,long,lower,multiple,narrow,necklace,nflorescence,obtuse,orolla,ovate,pair,perfect,petiolule,plurifoliate,present,pubescen,ray,removed,ruit,secondary,semierec,seudostipule,slightly,spaced,specimen,stamen,ste,stigma,stolon,subequal,subtending,symmetrical,tall,tamen,tem,thir,toward,tri-,tube,typically,unit,usually,vary,wide,wing,yellow,ympodial	'',[,``,age,arrangement,articulation,branching,characteristic,colour,form,growth,height,inflorescence,length,ovary,pseudostipule,shape,spacing,stem,texture,third,value,width,{,}
284	wfo-0001029120	success	168	75	56	112	19	0.333	0.1-0.5,0.5-1.5,0.7-1,1-1.5,1.1-1.5,3-3.5,6-8,acuminate,acute,anther,apex,bark,base,calyx,cm,corolla,dark,decurrent,deflexed,erose,especially,filament,glabrous,golden,greenish-brown,internodal,larger,leaf,lobed,margin,minutely,mm,narrowly,nearly,opposite,ovary,ovate,pale,pedicel,petiole,pore,pubescent,shaped,shrub,simple,slightly,sparsely,stem,stigma,style,tear-drop,trichome,tube,uniseriate,white,yellow-green	.05,.5,.75,/2,1.1-2,2.5-3.5,2.6-7,5-10-flowered,5-8,6.5-16.5,8511,abrupt,anthesi,apart,basal,beginning,beneath,black,bud,bullate,cell,densely,dia,difoliate,dry,drying,eaf,edicel,eed,epidermi,evenly,f,fide,fleshy,free,geminat,globose,hirsute,inflorescenc,infloresence,know,known,lanceolate,large,later,lateral,lehmann,like,lobe,lon,long,long-triangular,lower,main,middle,midrib,minor,narrow,narrower,nflorescence,occasionally,often,older,outer,pair,paler,papillose,peduncl,peduncle,petaloid,point,poricidal,portion,present,prominently,proximal,raised,reproductive,rest,ruit,scar,scattered,slender,spaced,specimen,speckle,straight,surface,sympodial,tall,tapering,terminal,thickened,tip,tub,ud,unbranched,unifoliate,unit,upper,urceolate,vein,venation,way,white-papillo,wide,widening,widest,x,yellow,ympodial,young	articulation,branching,colour,decument,form,fruit,growth,hair,height,inflorescence,length,na,plant,position,shape,texture,type,white-papillose,width
285	wfo-0001029121	success	161	119	68	93	51	0.422	0,1-4,1-5,2-10,2-3-celled,4-5.5,apex,apical,apically,articulate,base,blue,branched,calyx,cell,cm,conical,connate,corolla,covering,cuneate,deep,dehiscent,dichasially,distal,ebracteate,filament,generally,glabrous,green,hair,hair-like,half,herbaceous,interjected,introrse,lateral,leaf,leaflet,long,maturing,medium,mm,oblique,odd-pinnate,often,pattern,pedicel,perennial,perfect,petiole,plant,poricidally,proximal,purple,rarely,rotate,rounded,scattered,short,slit,testal,thick,tuber-bearing,typically,unit,wall,Â¼	-6,0-2,0.2-2,1.1-3.9,1.2-2.5,1.2-3.3,10,15-30,2-,2-13,2-3,3-5,3-6-foliat,3.6-9,3.8-11,4-10,4.5-10.0,5-20,5-8,8-16,9-33,abaxiall,abaxially,acumen,acuminate,acute,adaxially,attenuate,commonly,cyme,diameter,dichasial,digestion,diminishing,dorsally,eaf,edge,eed,elliptical,emoval,enzyme,exceeding,flat,flower,folded,forked,globo,gradually,green-white,honeycomb,living,lobe,lon,lower,lunat,make,monochasial,mucilaginous,narrowly,nflorescence,nther,obtuse,orolla,ovate,ovoid,pair,peduncle,petiolule,plan,reveal,ruit,seed,sessile,seudostipule,short-attenuate,size,specimen,stamen,stigma,straight,style,subequal,tal,tem,terminal,throughou,throughout,tip,toward,vary,wide,yellow,ympodial	3-6-foliate,6,anther,appressed,articulation,bract,branching,breeding,colour,connective,form,fruit,fruiting,growth,heteromorphism,inflated,inflorescence,insertion,interpetalar,length,lunate,margin,marking,mature,modification,na,odour,orientation,paired,placement,pore,position,prickle,pseudostipule,rhizome,scale,shape,spot,staman,stellate,stone,structure,symmetry,sympodial,system,texture,tissue,tuber,type,xylopodia,zygomorphy
286	wfo-0001029125	success	197	125	72	125	53	0.365	abaxially,age,anther,anthesi,apex,appressed,articulated,attenuate,base,berry,black,branching,calyx,cell,central,cm,corolla,cuneate,densely,difoliate,ellipsoid,entire,filament,fruit,fruiting,glabrous,globose,green,herb,internodal,lateral,leaf,lengthening,long,lower,margin,maturity,mm,oblique,occasionally,pedicel,per,perfect,petiole,pore,poricidal,pubescent,purple,purplish,ripe,simple,single,slightly,slit,small,spreading,star,stellate,stem,stemmed,stone,straight,subshrub,surface,tip,trichome,turning,unequal,uniseriate,unit,white,yellow	.0â3.5,.1,.1â1.4,.2,.4,.5â2.0,.6,0.5,0.5â0.6,0.5â1.0,0.8â0.9,0.9,1,1.0â1.2,1.0â1.5,1.0â4.0,1.5â2.0,1.5â3.0,1.7-,1.8â3.5,1â2-celled,2.5â12.0,2/3,20â100,2â3-celled,2â4,3.0â3.4,3.5â4,35â45,3â5,3â5-celled,4â8,5-merous,5â6,6,6â7,abaxial,acuminate,acute,adaxial,adaxially,along,apar,apparently,arising,ba,beyond,brownish,closely,concave-reniform,cone,conical,delicate,deltate,diameter,eaf,eed,end,especially,exerted,flower,free,geminat,growt,hilum,later,like,live,lobe,lobed,lon,maximum,minutely,narrower,nearly,nflorescence,often,one,orange,outline,ovary,ovate-lanceolate,pair,pale,papillate,peduncle,pentagonal,place,plant,portion,positioned,primary,purple-tinged,reflexe,reflexed,ridged,ruit,scar,scattered,seed,shiny,shorter,spaced,sparsely,stigma,strongly,style,sub-lateral,tall,tem,terete,testal,tinged,toward,traingular,tube,ud,usually,vein,whitewith,wide,woody,ympodial,young,Â¼	0.5-1.0,1-2-celled,1.0-1.2,1.7-3.4,articulation,bract,breeding,broad-based,colour,connective,form,geminate,growth,hair,heteromorphism,inflated,inflorescence,insertion,interjected,interpetalar,leaflet,length,marking,mature,modification,na,needle-like,odour,orientation,paired,pattern,placement,position,present,prickle,pseudostipule,rhizome,scale,shape,smell,spot,staman,structure,symmetry,sympodial,system,texture,tissue,tuber,type,vegetative,xylopodia,zygomorphy
287	wfo-0001029150	success	177	113	60	117	53	0.339	0.3-0.5,0.8-1,6,8-shaped,accrescent,acute,adaxially,anther,apex,base,berry,branched,calyx,climbing,cm,conical,cros,ellipsoidal,elliptical,entire,extra-axillary,filament,fleshy,fruit,fruiting,glabrous,larger,leaf,long,margin,membranaceous,midvein,mm,moderately,nearly,oblique,opposed,ovate,petiole,pinnate,pubescent,rarely,rounded,sand-punctate,section,simple,slightly,small,somewhat,sparsely,stellate,stem,trichome,truncate,unit,venation,vine,white,woody,x	.5,0.3,0.3â0.5,0.5â1.1,0.8â1,0.8â1.5,0.8â3.5,1.2â1.5,1.5,1.5â2,1.5â2.2,15,1â1.5,1â11,1â2,1â5,1â6,2.5â3,2.5â5,2.5â8,2â10,2â2.5,2â3,3-5,3â10,3â4,3â50,5-merous,7â8,9â12,abaxially,across,adaxiall,alyx,apar,apicall,apically,apiculate,attenuate,axe,blade,c.,canopy,capitat,ciliate,color,cylindrical,delicate,diameter,distant,dried,eaf,eed,enlarged,except,flattened,flower,flush,glabrou,inconspicuous,lamina,lanceolate,light,living,lobe,lon,lower,m.,material,minutely,mor,nflorescence,nternode,older,orolla,pair,pale,pedicel,peduncle,perfec,pinkish-white,plurifoliat,pointed,rachi,reaching,rounded-deltoid,rugose,ruit,scar,secondary,shortly,side,slender,spaced,specimen,stigma,strong,style,surface,tamen,tan,teardrop-shaped,tem,thick,thickened,time,tip,translucent,tree,tube,understory,vary,vegetation,vein,wide,wiry,ympodial	0.8-1.5,0.8-3.5,1-11,1-5,1.2-1.5,1.5-2.2,2.5-3,2.5-8,abaxial,appressed,bract,branching,breeding,cell,colour,connective,corolla,form,growth,hair,heteromorphism,inflated,inflorescence,internode,length,marking,mature,modification,na,odour,orientation,pattern,placement,plurifoliate,pore,position,prickle,pseudostipule,rhizome,shape,size,spot,staman,stone,structure,symmetry,sympodial,system,texture,tuber,type,xylopodia,zygomorphy
288	wfo-0001029152	success	197	89	44	153	45	0.223	0.5-1,2.5-3,anther,apex,appressed,attenuate,base,berry,calyx,cm,completely,corolla,cuneate,difoliate,elliptic,enclosing,filament,fruit,fruiting,glabrous,globose,green,inflorescence,leaf,lobed,long,margin,mm,obovate,opposite,pale,pedicel,petiole,pore,poricidal,red-floccose,shape,shaped,shrub,small,tear-drop,tree,unit,white	.1,.5,0.25-0.5,0.75-1,0.8-1,0.9-1.3,1,1-1.5,1-2,1-3,1-4,1.1-1.3,1.5-1.7,1.5-2,2-2.5,2-3,2-4,2-5,3-5,3-8-flowered,4-6,6-8,61-25,8.5-16,acuminate,acute,anthesi,appearanc,appearing,area,ba,bark,beginning,beneath,blade,branch,broadened,broadly,brown,bud,citronella,closely,conical,corky,dark,deciduous,decurrent,deep,deflexed,deltoid,densely,dia,differing,distal,dry,eaf,edicel,eed,ellipsoi,erect,et,exsertion,fide,flattened,floccose,flower,fragrance,free,geminat,giving,greyish-red,held,hyaline,inflorescenc,keeled,large-lenticellate,late,lateral,lightly,live,lobe,lon,long-styled,longer,lower,main,major,material,middle,midrib,minor,minutely,nearly,nflorescence,often,older,one,ovary,overlapping,ovoid-reniform,pair,papillose,per,pitted,planar,plane,plant,portion,prominent,prominently,quite,red,reddish,reddish-floccose,reflexed,reminiscent,rounded,ruit,scar,shiny,short-styled,simple,single,size,slender,slightly,somewhat,soon,spaced,stem,stigma,straight,styl,style,surface,tall,tapering,terminal,third,tillett,tip,trichome,tube,ud,usually,vein,weak,widest,winged,woody,x,ympodial,young	articulation,bract,branching,breeding,cell,colour,connective,decurred,form,geminate,growth,hair,heteromorphism,inflated,insertion,interjected,interpetalar,leaflet,length,marking,mature,modification,na,odour,orientation,paired,pattern,placement,position,prickle,pseudostipule,rhizome,scale,spot,staman,stone,structure,symmetry,sympodial,system,texture,tissue,tuber,type,xylopodia
289	wfo-0001029156	success	65	114	50	15	64	0.769	0.5,1.5-2,10-12,4-6,6,6-8,<,almost,apex,bark,berry,cell,center,cm,completely,deeply,diameter,exfoliating,flattened,fruiting,glabrous,golden,growth,lateral,liana,margin,markedly,minutely,mm,multiseriate,new,pale,pedicel,per,pitted,rectangular,reniform,rib-like,seed,shiny,sinuate,stem,surface,tan,testal,thickening,trichome,vine,wall,woody	-3,1,2,apparently,eed,epiphytic,fide,long,minute,nee,noddin,occasionally,older,shreddy,wide	2-3,anther,appressed,articulation,base,bract,branching,breeding,broad-based,calyx,colour,connective,corolla,form,fruit,hair,heteromorphism,inflated,inflorescence,insertion,interjected,interpetalar,leaf,leaflet,length,lower,marking,mature,modification,na,needle-like,nodding,number,odour,orientation,paired,pattern,petiole,placement,plant,pore,position,prickle,pseudostipule,rhizome,shape,smell,spot,staman,stellate,stone,structure,symmetry,sympodial,system,texture,tissue,tuber,type,unit,vegetative,width,xylopodia,zygomorphy
290	wfo-0001029156	success	65	107	45	20	62	0.692	0.5,1.5-2,10-12,4-6,6-8,<,almost,apex,berry,cell,cm,completely,deeply,diameter,exfoliating,flattened,fruiting,glabrous,golden,growth,liana,margin,markedly,minutely,mm,multiseriate,new,pale,pedicel,per,pitted,rectangular,reniform,rib-like,seed,shiny,sinuate,stem,surface,tan,testal,thickening,trichome,vine,woody	-3,1,2,apparently,ark,center,eed,em,epiphytic,fide,lateral,lon,minute,nee,noddin,occasionally,older,shreddy,wall,x	2-3,6,appressed,articulation,bark,base,bract,branching,breeding,broad-based,calyx,colour,corolla,filament,form,fruit,hair,height,heteromorphism,inflated,inflorescence,insertion,interjected,interpetalar,leaf,leaflet,length,lower,marking,mature,na,needle-like,nodding,number,odour,orientation,paired,petiole,placement,plant,position,prickle,pseudostipule,rhizome,shape,smell,spot,staman,stone,structure,symmetry,sympodial,system,texture,tissue,tuber,type,unit,vegetative,width,xylopodia,zygomorphy
291	wfo-0001029163	success	149	145	92	57	53	0.617	0.3-2.5,0.5-1,1,1-2,10-,13-18,2,2-18,2-3,2-6,2.5-3,20-30,3-14,3-4,4-20,4-6,5-8,7-9,abaxially,acuminate,acute,apart,apex,base,calyx,cell,chartaceous,cm,connivent,cuneate,cylindrical,decurrent,deltate,densely,diameter,directed,distally,elliptic,elliptic-ovate,entire,free,fruit,glabrous,globose,hair,herb,lanceolate,lenticular,lobe,long,margin,mm,moderately,narrowed,narrowly,nearly,obtuse,papillose,pedicel,peduncle,perennial,petiole,pore,pseudohair,puberulent,puberulent-pubescent,pubescence,purple,rachi,radiu,remnant,scale-like,shrub,simple,slightly,sparsely,stellate,stem,stigma,stone,style,subcoriaceous,thickened,tip,triangular,tube,unbranched,unit,unknown,white,whitish,x	-25,-4,-9,1.5-2,1.5-2.5,1.5-3,2-7,3-5,4-5-foliat,4.5-23,5-12,9-15,abaxial,absen,adaxiall,adaxially,aggregate,articulated,axe,band,blade,color,denser,distall,eaf,eed,eglandular,flower,glandular,leaving,like,lon,lower,nflorescence,nther,orolla,pedicellar,projection,puberulent-pubescen,ripe,roughened,ruit,small,sometimes,spaced,stalked,subapical,surface,tal,tem,time,truncat,vary,vein,wide,yellow,ympodial	4-5-foliate,absent,anther,arrangement,articulation,bract,branching,breeding,colour,connective,corolla,filament,form,fruiting,growth,height,heteromorphism,inflorescence,interjected,interpetalar,leaf,leaflet,length,marking,modification,na,odour,orientation,ovary,paired,placement,plant,position,prickle,pseudostipule,rhizome,seed,shape,size,spacing,spot,staman,structure,symmetry,sympodial,system,texture,thicknes,tissue,truncate,tuber,type,xylopodia
292	wfo-0001029171	invalid_json_followup	137	158	104	33	54	0.759	-,-10,-15,0.5,1-3,1-4.5,1-5,1.5-2,1.5-7.5,10-25,10-35,2-3,3-4,3.5-18,3.5-6.5,4-10,4-5,5-6,5-8,6-,7-9,abaxially,abruptly,acuminate,acute,adaxially,also,and/or,angled,apart,apex,articulated,base,branched,calyx,chartaceous,cm,connivent,cuneate,cylindrical,decurrent,deltate,dendritically,dense,densely,diameter,directed,eglandular,elliptic,entire,flower,forked,fruit,glabrous,gland,glandular,globose,hair,lanceolate,like,lobe,margin,mm,moderately,narrowed,narrowly,obtuse,often,orange,ovate-elliptic,pedicel,peduncle,perfect,petiole,pore,puberulent,pubescent,purple,rachi,radiu,rarely,red,ripe,rugose,shoot,short-stalked,shrub,simple,slightly,smooth,sometimes,sparsely,stellate,stigma,style,tip,triangular,tube,unbranched,unit,usually,white,x,yellow	11-20,8-17,absen,aggregate,axe,ba,blade,cell,distall,eaf,eed,except,glandula,long,lower,many-foliat,midrib,near,nearly,nflorescence,nther,orolla,ruit,spaced,ste,stone,tal,tem,time,truncat,vary,wide,ympodial	'',[,``,anther,appressed,articulation,axi,bract,branching,breeding,characteristic,colour,connective,corolla,distally,filament,form,fruiting,growth,height,inflated,inflorescence,interjected,leaf,leaflet,length,many-foliate,marking,mature,modification,na,number,ovary,pattern,placement,plant,position,scale,seed,shape,size,spacing,spot,stem,structure,symmetry,sympodial,system,texture,truncate,type,value,{,}
293	wfo-0001029215	success	49	50	33	16	17	0.673	-1.8-2.3,0.3-0.5,0.5-0.7,0.5-2.5,1,2.3-2.9,border,brown,calyx,cm,coarse,diameter,elongating,entire,fruit,hair-like,herb,lobe,long,markedly,mm,narrowly,obovate,outgrowth,pubescent,round,shrub,small,smelling,strong,wide,winged,woody	.2,appearance,cell,eed,fide,give,lateral,silky,spreadin,surface,tall,testa,thick,wall,weigend,xyledecor	0.2,colour,elongation,form,growth,height,leaf,length,odour,plant,seed,shape,spreading,texture,thicknes,width,wing
294	wfo-0001029216	success	243	87	63	180	24	0.259	+,0.4-0.5,0.5,1.2-6,2,2-locular,3-foliate,absent,accrescent,and/or,anther,articulated,articulation,base,basiscopically,branch,bright,calyx,cell,cm,corolla,decurrent,deep,distal,fasciated,filament,fruit,fruiting,glabrescent,globose,herb,imparipinnate,inflorescence,interjected,interrupted,leaflet,length,linear,long,margin,minute,mm,multilocular,oblique,often,orange,pedicel,pentagonal,petiole,present,pseudostipule,pubescent,rarely,red,shape,simple,sparsely,strong,trichome,unit,usually,varying,yellow	-0.5,-10,-5,.5,.8-1,0.1-0.3,0.1-0.5,0.1-0.6,0.1-0.8,0.2-0.25,0.2-0.3,0.2-0.4,0.2-0.8,0.3-0.4,0.3-0.5,0.3-2,0.4,0.5-0.8,0.5-1.5,0.5-2,0.6-0.8,0.6-1,0.8-2.5,1-1.2,1-2,1-3,1-4,1-6,1.5-2.3,1.5-2.5,1.5-3,1/,10,10-,10-14,2-4.5,2.5-3.3,20-35,3,3-,3-4,3-5,3-7,4,5,5-15-flower,6-10,7-10,<,absen,acroscopically,acute,adpressed,allogamous,always,angeld,annual,anthesi,apex,apical,appearance,appendage,attenuate,axi,basal,becoming,biennial,brown,capitate,cente,column,composed,cone,conical,cordate,crenate,cultivar,deeply,dentate,diameter,eaf,edicel,eed,elliptic,entire,erect,exserted,extending,facultatively,fruited,giving,gland-tipped,glandular,gree,green,hair-like,half,halfway,included,initially,internode,lanceolate,large,larger,later,lateral,less,like,lobe,lobulate,lon,longer,lower,mainly,maturity,minutely,mixture,multicellular,narrowly,near,nflorescence,numerous,obovate,one,outgrowth,ovary,ovate,pair,pale,particularly,peduncle,perennial,petiolule,plant,population,primary,procumbent,reflexe,ruit,scen,secondary,sessile,shaggy,shaped,short,silky,sometimes,somewhat,sparse,spreading,staminal,stem,sterile,stigma,straight,strongly,style,surface,tangled,tem,terminal,tertiary,testa,thick,thickening,tip,total,toward,truncate,tube,ud,unicellular,uniseriate,variety,villous,viny,wall,wide,winged,ympodial	1/3,branching,colour,form,growth,hair,heteromorphism,insertion,leaf,marking,na,odour,position,smell,spot,staman,stone,structure,symmetry,sympodial,texture,type,vegetative,zygomorphy
295	wfo-0001029226	invalid_json	206	163	130	76	33	0.631	-7,-9,.5,0.5,0.5-5,1-1.5,1-2,1-3,1-celled,10-40+,2,2-6,2-9,2.5-10,3-3.5,30,4,4-6,5-7,7-11,>,acuminate,acute,anther,anthesi,apart,apex,apparently,articulated,base,berry,branched,bright,calyx,capitate,cell,cm,congested,cordate,corolla,decurrent,densely,diameter,ellipsoid,elongate,entire,exserted,filament,flattened,flexuous,flower,fruiting,glabrous,gland,glandular,globose,green,growth,hairy,herbaceous,lateral,lavender,leaf,lengthening,like,lobe,lobed,long,lyrate,many,margin,mature,membranous,minute,minutely,mm,occasionally,open,pale,papillate,pedicel,peduncle,per,petiole,pinnatifid,pitted,pore,poricidal,pubescent,red,reniform,ripe,scar,seed,shiny,shrub,simple,sleeve,slit,small,sparsely,spot,stellate,stem,stigma,strongly,style,surface,tan,terminal,testal,thin,time,tip,translucent,trichome,truncate,tube,uniformly,uniseriate,usually,vine,wall,way,weak,white,wide,woody,yellowish,Â¾	.75,0-1,2-3,3-6,5-merou,8-13,ag,alyx,ark,ba,basal,black,blue,breaking,completely,conical,connivent,dark,deltate,distall,divided,dry,eaf,eed,enation,free,glabrescent,ilament,irregularly,juice,longer,loosely,lower,material,mere,new,nflorescence,often,older,one,orolla,overtopping,pair,papillat,papillo,perfect,pinnate,plurifoliat,portion,primary,reflexed,remainin,rim,ruit,sagittate,scarlet,short-glandular,shorter,slender,sometimes,spaced,sprawling,spreadin,spreading,staining,tangled,tem,third,twinin,ud,unit,vary,vein,widest,winged,ympodial	'',[,``,age,articulation,branching,bud,characteristic,colour,distally,exsertion,flexibility,form,fruit,glabrousnes,inflorescence,length,lobing,number,ovary,pubescence,shape,spacing,symmetry,texture,transparency,type,value,width,winging,ye,{,}
296	wfo-0001029236	success	159	87	48	111	39	0.302	0.5-1.5,1-2,1/2,2-4,absent,anther,apex,apically,base,berry,branching,calyx,coriaceous,corolla,dendritic,dichasial,elliptic,filament,fleshy,fruit,fruiting,globose,growth,leaf,lobed,margin,mm,narrowly,pedicel,petiole,plurifoliate,pointed,pore,poricidal,prominent,purplish-black,short,shrub,sleeve,slightly,terminal,time,tip,trichome,unit,usually,violet,way	.5,0.2-0.7,0.2-1,0.45-0.5,0.5,0.9-2.3,1-1.5,1.4-1.7,2-5,3,6-9,abaxially,adaxial,age,anthesi,apical,apparently,appearing,axi,ba,bark,basal,becoming,bi-lobe,branch,branchlet,broadly,cm,compact,completely,conical,cupulate,decurrent,deflexed,deltate,densely,diameter,eaf,edicel,eed,erect,ew,except,exserted,flattened,flower,free,glabrous,grey-brown,inserted,later,lateral,lenticular,less,lobe,long,lower,m.,many,middle,midvein,minutely,near,nflorescence,nodding,obscure,obscurely,occasionally,older,ovary,overtopping,packe,pale,per,pericarp,persistent,pitted,portion,pubescent,purplish,reddish-brown,revolute,ruit,scar,scattered,secondary,shiny,shoot,simple,slit-like,sparsely,stamen,stem,stigma,strongly,style,surface,tall,tapering,thin,trongly,tub,tube,ud,venation,wide,winged,woody,x,ympodial,young	articulation,bract,breeding,cell,colour,form,hair,heteromorphism,inflorescence,insertion,interjected,interpetalar,leaflet,length,marking,na,odour,orientation,pattern,placement,position,prickle,pseudostipule,rhizome,scale,shape,spot,staman,stone,structure,symmetry,sympodial,system,texture,tissue,tuber,type,width,xylopodia
297	wfo-0001029246	success	209	99	54	155	45	0.258	-1.5,0.1-0.4,1-1.5,3.5-5,8-16,acuminate,anther,apex,articulated,base,berry,calyx,chartaceous,cm,cuneate,elongating,entire,equal,filament,fruit,fruiting,lateral,leaf,length,lobed,long,lower,margin,mature,mauve,mm,moderately,narrow-deltate,orange-red,pale,pedicel,petiole,poricidal,prickle,recurved,shrub,simple,sparsely,spherical,stellate-pubescent,stem,straight,surface,tapering,tip,trichome,unbranched,unit,white	-1,-4,/5,0,0-15,0-5,0.1-0.3,0.15-0.3,0.2-1.5,0.3-0.5,0.3-0.8,0.5,0.5-1.5,0.7-1.3,0.7-1.5,0.7-2,0.8-1.1,0.8-3,0.9-1.3,1-1.8,1-10,1-3,1-4,1-5,1-8,1.2-2,1.5-2.3,1.5-2.5,1.5-6,1.7-6,1.8-3,1/10-1/5,1/3,2,2-3,2-3.5,2-5,2.5-3.2,2.8-4,2/3,2/3-3/,3-20,3-5,4-6,5-,5-20,5-merous,6-10,6-8,7-12,abaxial,abaxially,acuminat,acute,adaxial,almost,alyx,apar,apart,apically,apparently,bark,blade,broad-deltate,c.,concolorous,connivent,curved,deltate,densely,diameter,discolorous,distance,drying,dull,eaf,eed,elliptic,erect,extending,eye,flattened,flattened-reniform,flower,free,glabrescent,glabrous,infructescence,less,lobe,lon,longer,maturity,midpoint,midvein,naked,narrow-ovate,nflorescence,oblong,obtuse,older,one,open,orange-brow,orange-brown,orolla,oung,pair,peduncle,pendulous,per,perfec,pericarp,plurifoliat,porrect,portion,prickl,prickly,primary,procumbent,pubescent,purple,ray,rounded,ruit,scar,sessile,side,smooth,sometimes,spaced,spreading,stellate,stout,strongly,style,tamen,terete,tertiary,time,tube,unarmed,upper,usually,vary,vein,venation,visible,way,wide,woody,yellow,yellow-orange,ympodial,Â¼	appressed,articulation,bract,branching,broad-based,cell,colour,corolla,form,growth,hair,heteromorphism,inflated,inflorescence,insertion,interjected,interpetalar,leaflet,marking,na,needle-like,odour,orientation,paired,placement,plurifoliate,position,pseudostipule,rhizome,scale,shape,smell,spot,staman,stone,structure,symmetry,sympodial,texture,tissue,tuber,type,vegetative,xylopodia,zygomorphy
298	wfo-0001029286	invalid_json_followup	224	151	104	120	47	0.464	0.4-1.2,0.8,1-1.5,1.5-2,1.5-4,2-3,2.5-3,4-5,4-6,4.5-7,5-6,6-9,7-10,abaxial,abaxially,acute,adaxially,almost,anther,apart,apex,apically,apiculate,articulation,attenuate,bark,base,branched,branching,broadly,brown,capitate,chartaceous,clustered,cm,conical,corolla,dendritic,diameter,dilated,domatia,entire,faint,filament,flat,formed,glabrescent,glabrous,green,grey,hair,inside,isolated,leaf,length,liana,light,lilac,lobed,long,margin,mauve,membranous,midvein,minutely,mm,obconical,oblong,obovate,outside,pair,pedicel,peduncle,petiole,pore,poricidal,primary,prominent,raised,scar,simple,smooth,sometimes,sparsely,stem,stigma,stump,style,surface,terminal,tertiary,time,tip,tissue,translucent,trichome,tube,tuft,unarmed,unit,vein,venation,widely,x	.4,.5,0-0.5,0.1,0.15-0.4,0.6-1.2,0Â°,1-2,1.5-8,1/8,15-50,3-4,4.5,5,6-8,abscising,age,along,altered,alyx,another,anthesi,apar,apice,apparently,arising,around,articulated,axil,becoming,branch,canaliculate,clearly,closer,concave,concolorous,crenulate,curved,cuspidate,delineated,deltoid,density,distributed,drying,eaf,eed,equal,except,extending,fertilization,flexuous,flower,forming,free,fresh,globo,increasing,inflorescenc,junction,know,known,lamina,lengthening,less,lobe,lower,m.,main,margi,mas,meeting,middle,much,multicellular,narrowly,nflorescence,nther,occasional,often,one,orolla,ovate,papillo,perfec,plurifoliat,portion,protruding,rachi,rarely,regular,rounded,ruit,separated,shallowly,side,slender,smaller,somewhat,soon,specimen,spreading,stretchy,tangled,tearing,terete,textur,thick,thickened,thinner,together,toward,translucent-violet,ud,uneven,vary,visible,wide,yellowish,ympodial,young	'',[,``,appressed,arrangement,bract,breeding,calyx,characteristic,colour,connective,form,fruit,fruiting,growth,habit,inflated,inflorescence,interjected,interpetalar,leaflet,marking,mature,modification,na,number,ovary,papillose,pattern,plant,plurifoliate,position,prominence,scale,seed,shape,spacing,spot,structure,symmetry,sympodial,system,texture,type,value,{,}
299	wfo-0001029310	success	216	104	62	154	42	0.287	.5,/4,2-3.5,20-60,5-6,accrescent,andromonoecious,anther,apex,articulated,base,berry,branched,brown,calyx,cm,conical,connivent,cordate,dark,difoliate,enclosing,erect,filament,fruit,fruiting,glabrous,hair,herb,inflated,lateral,leaf,length,lobed,long,margin,mature,mauve,membranous,mm,pedicel,pendent,perpendicular,petiole,pinnatifid,poricidal,prickle,shrub,simple,spherical,stellate,stem,straight,strongly,surface,tapering,tip,tissue,truncate,unit,way,yellow	-16,-25,.1,.6,/6,0-20,0-5,0.1-0.2,0.2-0.3,0.2-0.8,0.5,0.5-3,0.6-1.1,00,1,1-1.5,1-2,1-4,1.2-1.5,1.8-3,1/,10,10-13,10-15,10-20,15-20,2-4,2.5-6,2/3-3/4,20-40,200-500,3-4,3-5,3.5,4-10,4-8,45-60,5,5-10,5-12,5-20,5-30,5-7,5-8,5-merous,6-8,7-12,7-13,8,abaxially,acute,alyx,ame,apar,apart,apically,apparently,bark,beyond,blade,c.,concolorous,deltate,diameter,distal,distance,drying,dull,eaf,eed,elliptic,elongating,equal,extending,filifor,flattened-reniform,flower,free,geminat,gently,glabrescent,gray,hermaphrodite,heterostylous,infructescence,lobe,lobing,lon,long-styled,longer,lower,lowermost,maturity,midpoint,midvein,minute,moderately,narrow-deltate,nflorescence,older,one,open,orange-green,ornately,orolla,oung,pair,peduncle,pendulous,per,pericarp,plant,porrect,portion,prickl,prickly,primary,ray,recurved,red-brow,retrorse,ruit,scar,secondary,sessile,short-styled,shorter,side,smooth,sometimes,spaced,sparsely,spreading,stalk,stalked,staminat,stellate-pubescent,stout,style,tamen,terete,tertiary,time,toward,trichome,tube,variously,vary,vein,venation,visible,wide,woody,ympodial	appressed,articulation,bract,branching,breeding,cell,colour,connective,corolla,form,geminate,growth,heteromorphism,inflorescence,insertion,interjected,interpetalar,leaflet,marking,na,odour,paired,pattern,placement,pore,position,pseudostipule,rhizome,scale,shape,spot,staman,stone,structure,symmetry,sympodial,system,texture,tuber,type,xylopodia,zygomorphy
300	wfo-0001029317	success	151	86	53	98	33	0.351	0.25,0.5,1,1-1.5,2-3,7-8,8-9,acuminate,anther,apex,attenuate,base,broadly,calyx,cm,corolla,cup-like,densely,difoliate,erect,filament,fruiting,geminate,glabrous,immature,inflorescence,leaf,lobed,margin,minutely,mm,narrowly,opposite,ovary,ovate,papillose,pedicel,petiole,pore,poricidal,pubescent,rounded,shaped,shrub,simple,stigma,style,tear-drop,trichome,tube,uniseriate,unit,white	.5,0.5-0.75,0.5-1,0.8-1,1.5-3.5,10-16,10-30-flowered,11-14,2.5-5,6-8,6.5-11,along,anthesi,apar,area,barely,beneath,brow,bud,ca,channeled,closely,deciduou,deflexed,deltoid,denser,dia,differing,dry,eaf,edicel,eed,ellipsoi,epidermi,exserted,extreme,free,frui,glabrate,globose,grayish,known,lateral,like,lobe,lon,long,lower,main,major,middle,minor,nearly,nflorescence,occasionally,often,older,one,otherwise,overlapping,ovoid,pair,paler,portion,probably,prominent,proximal,rachi,raised,reflexed,remaining,rest,ruit,scar,size,slender,slightly,soft,soon,spaced,sparsely,specimen,stem,straight,styl,tall,tapering,thickened,tip,tuft,ud,vein,visible,widest,x,yellowish,ympodial,young	2,5,breeding,cell,colour,form,fruit,growth,height,heteromorphism,length,marking,na,odour,orientation,placement,plant,position,prickle,pseudostipule,rhizome,shape,spot,staman,stone,structure,symmetry,sympodial,system,texture,tuber,type,xylopodia
301	wfo-0001029332	success	197	101	56	141	45	0.284	0,1-3,1.5-2,2-2.5,8.5-9.5,anther,apex,articulated,base,berry,calyx,chartaceous,cm,conical,connivent,cordate,curved,difoliate,elongating,erect,filament,flattened,fruit,fruiting,lateral,leaf,length,lobed,long,lower,margin,mature,maturity,mauve,mm,moderately,pedicel,petiole,poricidal,prickle,shrub,simple,spherical,spreading,stellate,stellate-pubescent,stem,surface,tapering,terminal,tip,trichome,unbranched,unit,weakly,yellow	-5,.5,/3,0-0.5,0-100,0-2,0-20,0-4,0-5,0.1,0.1-0.2,0.15-0.2,0.15-0.25,0.5-1,0.8-1,1-1.5,1-2,1-4,1.3-1.5,1/2,1/3,1/4,1/4-1/3,10-30,2,2-4,2.5-3.5,2.8-3.7,2/,2/3-3/4,3-4,3-6,3.5-5,4-10,4-15,5-6,5-8,5-merous,6-8,abaxial,abaxially,adaxial,alyx,andromonoecious,apar,apart,apically,apparently,bark,becoming,blade,broad-deltate,concolorous,densely,diameter,distal,distance,drying,eaf,eed,equal,extending,flattened-reniform,flower,free,geminat,glabrescent,glabrous,gland,globular,grayi,herbaceous,hermaphrodite,heterostylous,infructescence,less,lobe,long-acuminat,long-styled,longer,lowermost,midpoint,midvein,narrow-deltate,nflorescence,often,older,one,open,orange-brown,orolla,oung,ovate,pair,pale,peduncle,pendulous,per,pericarp,plant,porrect,portion,prickl,prickly,primary,pubescent,ray,reduced,rounded,ruit,scandent,scar,sessile,short-styled,shorter,side,slender,smooth,spaced,stalk,stalked,staminat,style,subsessile,tamen,terete,tertiary,time,tube,upper,variously,vary,vein,venation,visible,way,wide,woody,yellow-green,yellow-orange,ympodial	appressed,articulation,bract,branching,broad-based,cell,colour,corolla,form,geminate,growth,hair,heteromorphism,inflated,inflorescence,insertion,interjected,interpetalar,leaflet,marking,na,needle-like,odour,orientation,paired,placement,position,pseudostipule,rhizome,scale,shape,smell,spot,staman,stone,structure,symmetry,sympodial,texture,tissue,tuber,type,vegetative,xylopodia,zygomorphy
302	wfo-0001029333	invalid_json_followup	155	158	102	53	56	0.658	.25,.5,/4,0.5,0.5-1,0.7-1,1-1.5,1-15,1-7,1.5-3,10-15-flowered,100,17-26,2-2.5,3-7,3-7.5,5-6,8-15,9-13,abaxial,acuminate,acute,anther,apex,auriculate,bark,base,beige,berry,broadly,calyx,clavate,cm,conical,corolla,deflexed,dendritic,densely,dia,dry,elliptic-obovate,erect,exserted,filament,flower,fresh,fruiting,geminate,glabrous,globose,golden,green,lateral,leaf,lobed,long,long-styled,lower,main,margin,minor,minutely,mm,obovate,occasionally,opposite,orbicular,ovary,pair,pale,pedicel,petiole,pore,poricidal,pubescent,reddish-brown,scar,sessile,shape,shaped,shining,short-styled,shrub,small,somewhat,spaced,stem,stigma,strongly,style,surface,tear-drop,time,tip,tree,trichome,truncate,tube,type,vein,way,woody	1-1.2,1-2,1-3,1.5-2,1.5-2.5,abaxially,adaxially,along,anisophyllou,anthesi,ba,beneath,contracted,dendritic-pubescent,denser,differing,difoliate,eaf,edicel,eed,flattened-reniform,free,heteromorphic,incrassate,inflorescenc,like,lobe,lon,major,nflorescence,older,overlappin,paler,papillo,pitted,planar,portion,present,pubescence,rest,rounded,ruit,simple,size,slender,sparsely,tall,triangular,ud,unit,wide,ympodial,young	'',1,[,``,adaxial,appressed,articulation,bract,branching,breeding,broad-based,bud,characteristic,colour,connective,diameter,exsertion,form,fruit,growth,hair,height,inflated,inflorescence,insertion,interjected,interpetalar,leaflet,length,marking,mature,modification,na,needle-like,odour,orientation,overlapping,paired,papillose,pattern,placement,plant,position,prickle,scale,smell,spot,symmetry,system,texture,tissue,value,vegetative,width,{,}
303	wfo-0001029334	invalid_json_followup	211	149	90	121	59	0.427	0-4,0.15-0.3,1,1-2,1-3,1.3-4.5,1.5-3.9,1.5-6,2-2.5,2.5-3,3-5,3.2-5.8,4-5.5,4-8.5,5-10,7.5-15.5,8-30,9-12,abaxially,absent,adaxially,almost,anther,apex,base,berry,blade,brownish,chartaceous,ciliate,clavate,cm,condition,cordate,corolla,densely,diameter,drying,filament,flower,forked,fresh,fruit,glabrous,globose,green,greenish,hair,herb,homostylous,interjected,lanceolate,lateral,leaflet,long,lower,margin,membranous,minutely,mm,oblique,odd-pinnate,ovoid,pair,pedicel,peduncle,petiole,plant,pore,poricidal,puberulent,pubescent,pure,ripe,rounded,seed,size,stellate,stem,stigma,style,terminal,tinged,tip,tuber,violet,white,whitish,wide,x	.2,1-10,1-6,1.8-2.9,2,2-4,2-5,2-8,3-7,3.3-6.5,5-merou,acumen,acute,ag,along,alyx,among,apart,apparently,articulated,attenuate,axe,axillary,borne,broadly,bud,capitat,cell,connivent,covering,cuneate,decreasing,decurrent,digestion,distal,dorsally,eaf,edge,eed,elliptic,end,enzyme,erect,especially,exceeding,except,flat,folded,geminat,generally,glabrou,gradually,grassland,greatly,green-white,hair-like,half,honeycomb-shaped,lengthening,like,living,lobe,low-growin,make,middl,midrib,mucilaginous,narrowly,nflorescence,obtuse,often,orbicular,orolla,ovate,perfect,petiolulate,petiolule,plurifoliate,proximal,rarely,reduced,removed,ruit,semi-rosette,sessile,seudostipule,shady,short,singly,situation,slightly,slit,spaced,specimen,stamen,ste,stolo,straight,subequal,subsessile,subtending,sunny,tall,tamen,tem,testal,thick,throughout,toward,tri-,tube,typically,unit,unwinged,usually,vary,wall,wet,woodland,yellow,ympodial	'',[,``,appressed,arrangement,articulation,bract,branching,breeding,broad-based,calyx,capitate,characteristic,colour,connective,form,fruiting,growth,height,inflated,inflorescence,insertion,interpetalar,leaf,length,marking,mature,middle,modification,na,needle-like,odour,orientation,ovary,paired,pattern,placement,position,presence,present,prickle,pseudostipule,scale,shade,shape,smell,spot,surface,symmetry,system,texture,tissue,trichome,type,value,vegetative,zygomorphy,{,}
304	wfo-0001029344	success	147	122	69	78	53	0.469	.5,0.4-1,1,1-5,1.5,10-20,10-35,3-10,5-15,absent,abundant,acute,apex,base,berry,brown,calyx,center,chartaceous,ciliate,cm,densely,diameter,difoliate,drying,edge,elliptic,elliptic-ovoid,entire,filament,fine,flower,fruit,glabrous,globose,hair,herb,immature,interpetalar,lower,margin,membranaceous,mm,moderately,nearly,obtuse,parallel,pedicel,peduncle,per,petiole,pubescent,rachi,radiating,raised,rhizomatous,ridge,rotate,rounded,running,semitransparent,shallow,sparsely,surface,tissue,unit,white,x,yellow	0.5-1,0.5-1.5,0.5-3,1-2,1-3,1-6,1.5-3,1.5-4,2-3,2-3-celled,2-4,2-7,4-6,5-12,abaxially,adaxiall,adaxially,along,anther,axe,beyond,blade,connected,cordate,decurrent,dehiscing,denser,dm,eaf,eed,emarginat,equal,explosively,exserted,flat,frui,geminat,held,lacking,linear-lanceolate,lobe,long,lying,maturing,maturit,mesocarp,nflorescence,notch,oblong,obvious,often,one-,orolla,placenta,pressure,pubescen,ruit,short,slightly,sometimes,stamen,stigma,straight,style,swollen,tal,tamen,tem,triangular,tube,two-celled,unbranched,vary,vein,watery,wid,woody,ympodial	abaxial,adaxial,appressed,articulation,bract,branching,broad-based,cell,colour,corolla,decument,form,fruiting,geminate,growth,heteromorphism,inflated,inflorescence,insertion,interjected,leaf,leaflet,length,marking,na,needle-like,number,odour,orientation,paired,placement,position,present,prickle,pseudostipule,pubescence,rhizome,scale,seed,shape,smell,spot,staman,stem,stone,structure,symmetry,sympodial,texture,trichome,type,vegetative,zygomorphy
305	wfo-0001029363	success	152	140	86	66	54	0.566	.25,.75,/4,0.1-0.5,0.2-1.1,0.5,0.5-1,1,1.5-1.7,1.5-3.5,2-6,3-7,4-11,6-7,6-8,acuminate,acute,anther,anthesi,apex,bark,base,becoming,berry,bi-lobed,bud,calyx,capitate,cm,corolla,cup-shaped,deep,deflexed,densely,elliptic,filament,fruit,fruiting,glabrous,globose,green,greyish,immature,internodal,leaf,lobed,long,lower,margin,maroon,minutely,mm,narrowly,obtuse,occasionally,opposite,ovary,paler,pedicel,petiole,pore,poricidal,pubescent,shiny,shrub,small,somewhat,sparsely,stem,stigma,style,surface,tapering,terminal,thickened,tip,tree,trichome,tube,tuft,uniseriate,unit,way,white,white-papillose,young	0-0.1,1-1.2,5-7-flowered,7-10,axil,ba,beginning,beneath,closely,coroll,deltoid,dia,drying,eaf,edge,edicel,eed,erect,except,exsertion,free,inflorescenc,known,lamina,larger,later,lateral,lobe,lon,main,mature,meeting,middle,minute,much,near,nflorescence,often,older,overlapping,pair,pale,papillo,papillose,portion,prominent,reflexed,ruit,scar,simple,slender,slit-like,spaced,sparse,straight,tall,ud,unifoliat,upon,usually,vein,wide,widest,woody,yellowish,ympodial	5-7,articulation,bract,branching,breeding,broad-based,cell,colour,connective,diameter,flower,form,growth,hair,height,heteromorphism,inflorescence,insertion,interjected,interpetalar,leaflet,length,marking,modification,na,needle-like,number,odour,orientation,pattern,placement,plant,position,prickle,pseudostipule,rhizome,scale,shape,smell,spot,staman,stone,structure,symmetry,sympodial,system,texture,tissue,tuber,type,unifoliate,vegetative,width,xylopodia
306	wfo-0001029364	invalid_json_followup	153	149	91	62	58	0.595	-2,-6,.5,0.2-0.5,1-3,1-4,1-5,1.5-2,10-27,2,2-6,3-4,4-9,5-11,5-9,6-8,7-9,8-10,?,acuminate,acute,anther,apart,apex,base,calyx,chartaceous,cm,corolla,cream,cuneate,cylindrical,diameter,directed,distally,elliptic,entire,extra-axillary,filament,finger,fruit,glabrous,gland-tipped,globose,green,greenish,hair,herb,immature,lobe,major,margin,membranaceous,minutely,mm,narrowly,nearly,obtuse,ovate,pedicel,peduncle,perfect,petiole,pore,presence,puberulent,pubescent,rachi,radiu,sagittate,shallow,short-tomentose,shrub,side,simple,small,sparsely,spot,stellate,stigma,strongly,style,tapered,triangular,tube,unbranched,unknown,vein,white,wide,x	-3,1,1-,191.,2-,2-foliat,4-12,5-,8-15,abaxially,according,adaxially,aggregate,around,articulated,axe,ba,bitter,blade,blue,cell,center,color,connivent,curled,darker,deep,distall,eaf,ed,fide,flower,free,glandular-puberulen,inserted,long,lower,mesocarp,moderately,nflorescence,orolla,part,present,puberulen,ripe,ruit,rusby,shorter,spaced,stone,tal,tamen,tem,thecae,tightly,time,tomento,truncat,unit,vary,yellow,ympodial	'',1-6,2-12,[,``,abaxial,adaxial,appressed,articulation,bract,branching,breeding,characteristic,colour,connective,form,fruiting,growth,height,inflated,inflorescence,insertion,interjected,interpetalar,leaf,leaflet,length,marking,mature,modification,na,odour,ovary,pattern,plant,position,scale,seed,shape,size,smell,spacing,staman,stem,symmetry,system,texture,theca,tissue,trichome,truncate,type,value,vegetative,width,zygomorphy,{,}
307	wfo-0001029368	success	139	118	66	73	52	0.475	.5,0.5-2,0.9-1,1.5-1.6,1.5-3,1.5-4,2-5,2.5-4,5-6,abaxially,acute,anther,apex,bark,base,berry,broadly,calyx,capitate,closely,cm,conical,corolla,dia,elliptic,erect,filament,fruit,fruiting,glabrous,globose,golden,green,herb,inflorescence,internodal,known,leaf,long,margin,minutely,mm,obtuse,opposite,ovary,pedicel,petiole,pore,poricidal,puberulent,shaped,shrub,simple,somewhat,spaced,stigma,style,tear-drop,tip,trichome,uniseriate,unit,white,winged,woody,x	.2,.25,0,1.5-2,11-13,16-25,?,acuminate,adaxially,along,anthesi,apparently,bearing,bitter,borne,breaking,brow,coarse,crumpled,cup,deflexed,densely,distal,eaf,edicel,eed,exserted,few-branched,fide,flattened,flower,free,half,indistinct,inflorescenc,lamina,lanceolate,lateral,leaving,like,lobe,lower,main,margi,middle,midrib,minute,nflorescence,non-flower,older,one,overlappin,pair,papillo,papillose,parallel,portion,reflexed,rest,ruit,scar,stem,straight,strongly,tall,tube,ud,unifoliat,upper,vein,widest,ympodial,young	appressed,articulation,bract,branching,breeding,brown,cell,colour,connective,form,growth,hair,height,heteromorphism,inflated,insertion,interjected,interpetalar,leaflet,length,marking,mature,modification,na,odour,orientation,overlapping,paired,pattern,placement,plant,position,presence,prickle,pseudostipule,rhizome,scale,seed,shape,spot,staman,stone,structure,symmetry,sympodial,system,texture,tissue,tuber,type,unifoliate,xylopodia
308	wfo-0001029370	success	224	113	69	155	44	0.308	0.5-1,1.5-6,1/4-1/3,15-30,2-20,5.5-7,almost,andromonoecious,anther,apex,articulated,basal,base,berry,branched,calyx,chartaceous,cm,conical,connivent,cordate,curved,densely,discolorous,drying,elongating,equal,erect,filament,flattened,fruit,fruiting,herb,lateral,leaf,length,lobe,lobed,long,margin,marking,maturity,mauve,mm,overlapping,pale,pattern,pedicel,perpendicular,petiole,poricidal,prickle,prickly,rotate,shrub,simple,slightly,sometimes,spherical,stellate-pubescent,stem,straight,strongly,tapering,tip,unit,way,white,yellow	-20,-32,.1,.3,.5,/4,0-10,0-100,0-3,0-35,0.1,0.1-0.15,0.2,0.3,0.5-2.2,1,1-2,1-3,1-4,1.8-2.5,1.8-2.8,1/3-1/2,10-17,10-40,10-50,12-17,2-10,2-3,2-6,2.5-3.5,3-4,3.5-4,3.5-8,3/,4-6,4-7,4-9,5-10,5-12,5-merous,6-15,7-11,7-13,8-14,8-20,8-23,abaxial,abaxially,acut,adaxial,alyx,ame,apar,apart,apically,apparently,bark,blade,broad-deltate,c.,clearly,cream,dark,diameter,distal,distance,eaf,eed,elongate,extending,fewer,fine,flattened-reniform,flower,free,fully,gently,glabrescent,glabrous,green,greenish,hermaphrodite,heterostylous,infructescence,long-styled,longer,lower,lowermost,mature,midpoint,midvein,mixture,moderately,multangulate,nflorescence,obtuse,often,older,one,open,opening,orange,orange-brown,ornate,orolla,oung,ovate,pair,peduncle,pendulous,per,pericarp,plant,plurifoliat,porrect,portion,prickl,primary,ray,red-brown,reticulate,rounded,ruit,scar,sessile,shiny,short-styled,side,smooth,spaced,spreading,stalk,stalked,staminat,stout,style,surface,tamen,terete,tertiary,time,trichome,tube,unarmed,variously,vary,vein,venation,visible,white-gra,whitish,wide,woody,ympodial,young	articulation,bract,branching,breeding,broad-based,cell,colour,connective,corolla,form,growth,hair,heteromorphism,inflorescence,insertion,interjected,interpetalar,leaflet,na,none,odour,orientation,paired,placement,plurifoliate,position,pseudostipule,rhizome,scale,shape,spot,staman,stellate,stone,structure,symmetry,sympodial,system,texture,tissue,tuber,type,xylopodia,zygomorphy
309	wfo-0001029373	success	199	101	57	142	44	0.286	3,5,abaxial,acute,adaxial,age,anther,apex,appressed,bark,base,bayonet,berry,calyx,cell,cm,corolla,densely,diameter,ellipsoid,enclosing,entire,filament,fruit,fruiting,green,grey-brown,growth,hair,herb,internodal,lateral,leaf,lengthening,margin,mature,mm,moderately,new,obtuse,ovate-lanceolate,petiole,plurifoliate,pore,poricidal,pubescent,shallowly,shape,simple,slit,stellate,stem,terete,tip,trichome,unit,white	.0â1.2,.2,.3,.5,.5â2.0,0.3â0.5,0.4â1.6,0.5â1.2,0.5â1.8,0.6â0.7,1.0â1.2,1.0â1.6,1.2â1.5,1.3â2.2,1.4â3.5,1.5â2.0,1.5â2.5,1.5â2.7,1.8â2.0,1.8â2.3,180Â°,2-celled,2.0â2.5,2.7â3.0,20â30,2â4-celled,3.5â4.0,30â40,3â5,4â5,4â6,5-merous,5â6,6.8,8â9,abaxially,accrescent,acuminate,adaxially,anthesi,apar,appearanc,arising,articulated,basal,beyond,broadly,bud,capped,clavate,cone,conical,curved,deltate,developing,distal,eaf,eed,elongate,enclosed,exerted,finger,flattened-reniform,flower,free,fully,geminat,glabrous,glandular-tipped,globose,half,halfway,hilum,immature,individual,laterally,less,like,live,lobe,lobed,lon,long,lower,mesocarp,middle,minute,minutely,mouth,nflorescence,node,older,outline,ovary,pair,papillate,pedicel,peduncle,pentagonal,per,perfect,pitted,plant,portion,positioned,primary,reflexed,resembling,root,rounded,ruit,scar,seen,seudostipule,short,slightly,smoot,spaced,spreading,stigma,still,straight,style,surface,tall,tem,testal,thicker-walled,trailing,tub,tube,ud,uniseriate,upper,vein,wide,woody,yellow,yellow-green,yellowish,ympodial,â5	0.5-1.2,1.0-1.2,1.0-1.6,1.4-3.5,1.5-2.5,1.5-2.7,2.7-3.0,branching,breeding,colour,connective,form,geminate,heteromorphism,inflorescence,interjected,interpetalar,leaflet,length,marking,modification,na,odour,orientation,placement,position,prickle,pseudostipule,pubescence,rhizome,smooth,spot,staman,stone,structure,symmetry,sympodial,system,texture,tissue,tuber,type,width,xylopodia
310	wfo-0001029402	success	113	87	61	52	26	0.54	0.5-1,0.5-2,11-17,15-30,2,2-10,2-3,3-5,3-6,4-6,4-7,5-25,7-8,7-9,8-15,acuminate,acute,apex,articulated,base,branched,calyx,ciliolate,cm,connivent,cylindrical,deltate,diameter,elliptic,flower,forked,free,glabrate,glabrous,hair,lanceolate,lobe,margin,mm,moderately,narrowly,pedicel,peduncle,petiole,pore,pubescent,rachi,radiu,shrub,simple,sparsely,stellate,stigma,style,tapered,tip,triangular,tube,unknown,violet,x	1-2.5,3-4,4-8,6-16,7-11,abaxial,abaxially,adaxially,apart,axe,band,blade,chartaceous,color,denser,directed,distall,eaf,eed,fleshy,glabrou,inrolled,leaving,long,lower,many-foliat,narrowed,nearly,nflorescence,nther,often,orolla,papillose,pubescence,rachise,roughened,ruit,scale-like,scar,somewhat,spaced,surface,tal,tem,thickened,time,truncat,unit,unknow,vary,wide,ympodial	anther,articulation,branching,colour,connective,corolla,form,fruit,growth,height,inflorescence,leaf,length,modification,na,number,ovary,plant,position,seed,shape,spacing,stem,texture,truncate,type
311	wfo-0001029404	success	154	141	88	66	53	0.571	0.5-1,1-4,1.5-2,2-3,2-8,2.5-3,20-35,3-4,5-10,5-20,5-6,6-8,6-9,abaxially,acuminate,adaxially,anther,apex,apiculate,auriculate,base,branched,calyx,cell,center,chartaceous,cm,connective,connivent,cordate,cream,dark,darker,deltate,densely,diameter,distally,ellipsoidal,entire,flattened,flower,fruit,glabrous,green,hair,lanceolate,lemon,light,lobe,longitudinal,lower,margin,mm,moderately,mottling,narrowly,obtuse,orange,ovate,ovoid,pedicel,peduncle,perfect,petiole,pink,pore,puberulent,pubescent,purple,rachi,radiu,shrub,simple,somewhat,star,stellate,stigma,stone,style,toward,tree,triangular,unbranched,unit,vein,white,x,yellow	-1.5,-10,-3,-5,0-60-flower,1,15-25,2,2-4,2-5,2.5-22,3-5,3-8.5,4-foliat,5-24,6.5-34,8-12,absent,acute,aggregate,apart,ape,articulated,axe,basal,beyond,blade,cylindrical,directed,eaf,eed,eglandular,exserted,fleshy,glandular,glandular-puberulen,leaving,less,lon,long,nflorescence,nther,orang,orolla,pedicellar,presen,remnant,ripe,ruit,shorter,slightly,small,spaced,sparsely,subcoriaceous,tal,tem,thecae,time,tomento,truncat,tube,ud,vary,wide,ympodial	20-60,4-5,4-foliate,articulation,branching,breeding,broad-based,bud,colour,corolla,direction,filament,form,growth,height,heteromorphism,inflorescence,leaf,length,marking,mature,modification,na,needle-like,number,orientation,ovary,pattern,placement,plant,present,prickle,pseudostipule,rhizome,seed,shape,size,spot,staman,stem,structure,surface,symmetry,sympodial,system,texture,theca,trichome,truncate,tuber,type,xylopodia,zygomorphy
312	wfo-0001029406	success	136	114	80	56	34	0.588	0.3-1,0.5-1,0.6-1,0.7-1.5,1-1.5,1-10,1-2,1.5-2.2,1.5-2.5,1.5-5,2,2-11,2-3,2.5-3.5,28,3-9,30,4-18,4-6,abaxially,acute,adaxially,anther,apex,arachnoid,arachnoid-pubescent,bark,base,broadly,calyx,clavate,cm,conical,corolla,dark,deciduous,difoliate,elliptic,felt-like,filament,fruiting,glabrous,globose,grayish-brown,green,greenish-white,large,leaf,lenticel,lobed,margin,matted,maturity,minor,minutely,mm,nearly,ovary,ovoid,ovoid-reniform,pedicel,petiole,pitted,pore,pubescent,shaped,shiny,shrub,slightly,small,soon,stigma,style,surface,tear-drop,tree,trichome,tube,unit,white	.5,7-12,along,anthesi,ba,berry,brown,brownish,bullate,conspicuously,deflexed,deltate,densely,dia,differing,dry,eaf,eed,free,geminat,grayish-green,impressed,lateral,lilac,lobe,lon,long,lower,main,major,middle,occasionally,often,older,pair,pale,papillo,papillose,planar,pointed,population,poricidal,portion,ruit,size,stem,tall,tinge,tip,vein,waxy,wide,widest,woody,ympodial,young	articulation,cell,colour,diameter,form,fruit,geminate,growth,height,heteromorphism,insertion,length,na,odour,orientation,paired,placement,plant,position,prickle,pseudostipule,rhizome,seed,shape,staman,stone,structure,symmetry,sympodial,texture,tuber,type,width,xylopodia
313	wfo-0001029407	success	208	104	68	140	36	0.327	.5,/3,0.5-2,1-3,2-4,4.5-6,anther,apex,articulated,base,berry,bright-red,calyx,chartaceous,cm,connivent,cuneate,curved,difoliate,elliptic,elongating,entire,equal,erect,evenly,filament,flattened,free,fruit,fruiting,geminate,green,lateral,leaf,length,lobed,long,margin,mature,maturity,mauve,mm,orange,ovate,pale,pedicel,petiole,poricidal,portion,prickle,rarely,rounded,shrub,simple,sometimes,spherical,stellate-pubescent,straw-yellow,surface,tapering,tip,tube,unbranched,unit,way,white,wide,young	-10,-2,-25,-4,-6,-7,0,0-15,0-2,0-4,0-5,0.1-0.2,0.1-0.25,0.15-0.4,0.2-0.3,0.4-0.7,0.4-1,0.5-0.7,0.5-1.5,0.6,0.6-0.9,0.7-1.2,1,1-1.4,1-2,1-4,1-4.5,1.5,1.8-2.5,1/3,1/3-1/2,1/5,1/8-1/5,2-3,2-5,2.5-3,3-4,3-6,3.5-4.5,4-15,4-9,5-7,5-merous,6-13,6-20,7-8,abaxial,abaxially,acut,acute,adaxial,almost,alyx,apar,apart,apically,apparently,bark,blade,brow,dark,deltate,densely,diameter,discolorous,drying,dull,eaf,eed,flattened-reniform,flower,geminat,glabrescent,glabrous,gray-greenish,green-brown,infructescence,lengt,lobe,longer,lower,midpoint,moderately,nflorescence,obtuse,occasionally,older,one,open,orange-brown,orolla,oung,pair,peduncle,pendulous,per,perfec,pericarp,porrect,prickl,prickly,primary,pubescent,ray,recurved,reflexed,ruit,scar,sessile,shorter,side,slender,smooth,spaced,sparsely,spreading,stalk,stalked,stellate,stem,stout,straight,strongly,style,tamen,terete,tertiary,thick,time,trichome,upper,vary,vein,venation,visible,weakly,woody,yellow,yellow-green,ympodial	articulation,bract,branching,cell,colour,corolla,form,growth,hair,heteromorphism,inflorescence,insertion,interjected,interpetalar,leaflet,na,odour,orientation,paired,placement,position,present,pseudostipule,rhizome,scale,shape,staman,stone,structure,symmetry,sympodial,texture,tissue,tuber,type,xylopodia
314	wfo-0001029408	success	244	125	75	169	50	0.307	0.7-1.2,0.9-1.6,1-8,2.2-3.7,3-5,accrescent,acute,anther,apex,apical-lateral,articulated,base,becoming,berry,blunt-tipped,branched,calyx,cm,continued,corolla,cuneate,due,echinoid,entire,extend,filament,fleshy,fruit,fruiting,glabrous,globose,growth,hair,homostylous,interpetalar,introrse,large,lateral,leaf,length,lilac,longitudinal,lower,margin,mm,multangulate,oblong,pale,pedicel,persistent,petiole,plurifoliate,pore,pseudo-terminal,purplish,rarely,rather,ripe,rotate-stellate,short-attenuate,shrub,simple,slightly,slit,small,stem,thick-textured,time,tissue,tree,unarmed,unit,white,x,yellow	-1.5,-10.5,-4.5,.2-3.5,/10,0,0-100,0.2-0.3,0.3-5,0.5-2.5,0.9-1.3,1.1-1.5,1.4-1.9,1.5-3,1.6-2.8,1.7-2.4,1.8-3.5,1/2,1/2-3/4,1/4,11-31,2-12,2-3.5,2-4,2-5,2.5-7,2/3,3.5-5,4-14,4-20,4-7.5,5-24,5-6,5-6.5,5-8,5-merou,7-12,abaxially,acuminate,adaxiall,adaxially,ag,alyx,anthesi,apart,axe,axillary,ba,barely,bark,blade,branch,broadly,brown,bud,capitat,chartaceous,clavate,conical,dark,decurrent,dehiscing,deltoid,dendritic-echinoi,dendritic-multangulate,densely,develope,diameter,directed,distal,distall,eaf,echinoi,eed,elliptic,exserted,faintly,few-rayed,flower,free,gray,green,high,honeycombed,indument,inserted,lacking,lanate,lanceolate,lobe,lobed,long,long-,long-attenuate,long-stalked,m.,main,many,midvein,mixed,moderately,mostly,near,nearly,nflorescence,obscured,obtuse,often,older,orbicular,orolla,ovate,ovate-lanceolate,overlapping,part,partly,peduncle,perfect,porrect-stellate,present,pubescent,rachi,ray,relatively,reniform,reticulate-punctate,ribbed,ruit,runk,sessile,short-,short-stalked,side,sometimes,spaced,stamen,stelliform,stigma,style,subcampanulate,suborbicular,subovate,suture,tamen,terete,testa,thick,thick-stalked,thin-stalked,tomentose,tomentu,tomentum,top,touching,toward,tube,turbinate,unarme,usually,vary,vein,velutinous,way,well,whitish,wide,yellowish,ympodial,young	age,appressed,articulation,bract,branching,breeding,broad-based,cell,colour,connective,form,heteromorphism,inflated,inflorescence,insertion,interjected,leaflet,marking,mature,modification,na,needle-like,odour,orientation,paired,pattern,placement,position,prickle,pseudostipule,rhizome,scale,shape,smell,spot,staman,stellate,stone,structure,surface,symmetry,sympodial,system,texture,trichome,tuber,type,vegetative,xylopodia,zygomorphy
315	wfo-0001029417	invalid_json_followup	213	178	134	79	44	0.629	.5,0-7,0.2-0.6,0.7-3,1-10,1-2,1-4,1-8,1.3-8,1.5-1.8,1.5-8,12,2.5-10,2.8-3.5,3-14,3-5,4-7,5-15,6-11,8-15,8-9,abaxially,adaxially,anther,apart,attenuate,berry,blade,blue,borne,broadly,brownish,cell,chartaceous,clavate,cm,coarsely,condition,corolla,covering,dark,deep,diameter,distal,dorsally,dot,drying,edge,end,erect,filament,flat,flower,folded,forked,fresh,fruit,glabrous,globose,green,green-white,greenish,hair,half,herb,homostylous,interjected,lanceolate,lateral,leaflet,lengthening,like,linear,lobe,long,lunate,make,medium,membranous,minute,minutely,mm,moderately,mucilaginous,narrowly,non-glandular,odd-pinnate,often,orbicular,ovate,ovoid,pair,pedicel,peduncle,pentagonal,petiole,pilose,plant,pore,poricidal,puberulent,pubescent,purple,rarely,ripe,rotate,scattered,seed,singly,size,slightly,slit,sometimes,stem,stigma,straight,style,terminal,testal,thick,throughout,tinged,tip,trichome,tube,tuber,typically,violet,wall,wet,white,whitish,wide,x	0.4-8,1,1-1.5,1.5-10,2-4,5-merou,acumen,acuminate,acute,ag,along,alyx,apex,apiculate,apparently,articulated,axe,axillary,base,basiscopic,bud,capitat,central,ciliate,connivent,decreasing,decurrent,digestion,eaf,eed,enzyme,erec,especially,exceeding,geminat,generally,glabrou,greatly,hair-like,hal,honeycomb-shaped,living,lower,margin,midrib,nflorescence,orolla,perfect,petiolulate,plurifoliate,rapidly,removed,rounded,ruit,sessile,seudostipule,short,short-petiolulate,side,spaced,specimen,stamen,star,ste,stolo,subequal,subtending,tall,tamen,tem,tri-,unit,unwinged,usually,vary,widely,wing,yellow,ympodial	'',[,\u201chair-like\u201d,``,age,appressed,arrangement,articulation,bract,branching,breeding,calyx,capitate,characteristic,colour,connective,form,fruiting,growth,height,inflated,inflorescence,leaf,length,marking,mature,modification,na,ovary,pattern,presence,pseudostipule,scale,shape,spacing,spot,stolon,symmetry,system,texture,type,value,{,}
316	wfo-0001029461	success	217	100	56	161	44	0.258	-1.5,0.6-1,0.7-1,1/4-1/2,4.5-7,andromonoecious,anther,apex,attenuate,base,berry,calyx,cell,chartaceous,cm,cuneate,evenly,filament,fruit,fruiting,glabrous,green,leaf,length,lobed,long,lower,margin,maturity,mauve,mm,moderately,oblong,pedicel,petiole,poricidal,prickle,shrub,simple,spherical,spreading,staman,stellate,stellate-pubescent,stem,subentire,surface,tip,unarmed,unequal,unit,way,weakly,yellow,young,zygomorphic	-14,-2,-3,-3.2,-3/4,-4,-4.5,-5,.5,0,0.1,0.1-0.25,0.15-0.25,0.8,0.8-1.5,1-,1-1.6,1-2,1-3,1-4,1-6,1.2-1.7,1.2-1.8,1.3-2.2,1.5-,1.5-2,1/3,1/3-2/3,1/4,2-2.4,2-2.8,2-3,2-4,2.5-3,3-20,3-6,4-10,4-6.5,4-7,4.7-7.2,5-10,5-25,5-merous,7-10,7-12,8-9,abaxially,acuminat,almost,alyx,ame,apart,apically,bark,becoming,black,blade,breaking,brittle,broad-deltate,brown,c.,concolorous,curved,dark,densely,diameter,discolorous,distal,distance,drying,dull,eaf,eed,elliptic,elongating,erect,extending,faint,fifth,fine,flattened,flattened-reniform,flower,four,free,glabrescent,gra,hermaphrodite,heterostylous,infructescence,lengt,lobe,long-styled,longer,lowermost,mature,midpoint,midvein,obovate,obtuse,older,orange,orolla,oung,outline,ovate,pair,pendulous,per,pericarp,pit,plant,plurifoliat,porrect,portion,prickl,prickly,primary,raised,ray,reddish,reduced,reflexed,rounded,ruit,sessile,shallow,shiny,short-styled,shorter,side,slender,slightly,small,smooth,sometimes,spaced,sparsely,stalk,stalked,staminat,straight,strongly,style,tamen,terete,tertiary,time,trichome,tube,unarme,upper,variously,vary,vein,venation,visible,wide,woody,ympodial	articulation,bract,branching,breeding,broad-based,colour,connective,corolla,form,growth,hair,heteromorphism,inflorescence,insertion,interjected,interpetalar,leaflet,marking,na,needle-like,odour,orientation,paired,pattern,placement,plurifoliate,pore,position,present,pseudostipule,rhizome,scale,shape,spot,stone,structure,symmetry,sympodial,system,texture,tissue,tuber,type,xylopodia
317	wfo-0001029462	success	166	131	84	82	47	0.506	0.5-1,0.5-2,1-6,2-6.5,2.5-3.5,20-35,3-27,3-7,5-30,6-9,abaxially,abruptly,acuminate,acute,apex,base,broad,calyx,campanulate,cell,chartaceous,cm,connective,connivent,constricted,cuneate,curled,cylindrical,dark,densely,diameter,directed,eglandular,ellipsoidal,elliptic,entire,flattened,fruit,glabrous,green,hair,lanceolate,laterally,light,lobe,longitudinal,lower,margin,membranaceous,minutely,mm,moderately,near,obtuse,occasionally,ovate,ovoid,pedicel,peduncle,petiole,pore,puberulent,pubescent-pilose,purplish,rachi,radiu,rounded,simple,somewhat,sparsely,stellate-,stigma,stone,stripe,style,tip,tree,triangular,truncate,unbranched,unit,white,x,yellow	-2,-30,-4,-5,1,1-,1-2,1-3,1.5,1.5-2,1.5-3,1.5-7,10-,10-22,15-25,2-3,2.5-5.5,3,3-18,3-4,3-5,3-6,4-15,4-20,4-foliat,7-19,7-8,8-9,absent,adaxially,aggregate,apart,ape,articulated,axe,basal,beyond,blade,ciliate,dentate,eaf,eed,equal,exceeding,exserted,flower,leaving,lon,long,m.,narrowly,nflorescence,nther,often,orolla,oval,pedicellar,perfect,pubescent,pubescent-pilo,purpl,remnant,reticulate,ruit,shorter,slightly,small,smooth,spaced,stamen,tal,tem,thecae,time,tomentose,truncat,tube,ud,vary,wide,without,ympodial	1-15,10-25,4-foliate,abaxial,adaxial,anther,articulation,bract,branching,broad-based,bud,colour,corolla,form,fruiting,growth,height,heteromorphism,inflorescence,leaf,length,na,needle-like,orientation,ovary,placement,plant,position,prickle,pseudostipule,purple,rhizome,scale,shape,spacing,staman,stem,structure,surface,symmetry,sympodial,texture,theca,trichome,tuber,type,xylopodia
318	wfo-0001029464	success	235	132	82	153	50	0.349	1-10,1-3,12-50,2-3,5.5-7.5,abaxially,acicular,andromonoecious,anther,apex,around,articulated,base,berry,black,branched,brown,calyx,chartaceous,cm,connivent,cordate,cultivar,cup-shaped,curved,dark,difoliate,ellipsoid,elongating,equal,filament,fruit,fruiting,glabrescent,glabrous,globular,green,hair,herb,lateral,leaf,length,lobed,long,lower,margin,maroon,mature,maturity,mauve,mm,moderately,mottled,oblong,obtuse,often,ovoid,pedicel,petiole,pink,poricidal,prickle,purple,simple,sometimes,sparsely,stellate,stellate-pubescent,stem,straight,striped,surface,tapering,terminal,tip,trichome,unit,usually,variously,white,yellow-orange,young	-2/3,-3,-30,-5,.9,0,0-2,0-80,0.2,0.2-0.5,0.2-0.7,0.3-0.7,0.3-1,0.5,0.5-2,0.8-2,00-200,1,1-8,1.2-3,1.5-2,1/,1/4,1/4-1/2,1/4-1/3,10-15,10-23,10-40,10-50,2,2-3.5,2-4,2.2-2.5,2.4-4,2.5-5,2.5-8,2.9-3.2,3-20,3-5,3-7,3.5-5,4-7,4-8,4-8-merous,5-17,5-8,5.5-6,6-15,7-10,8-13,8-15,9-15,abaxial,acute,adaxial,alyx,ame,annual,apar,apart,apically,apparently,bark,blade,broad,broad-deltate,brow,c.,deltate,diameter,discolorous,distal,distance,drying,eaf,eed,elongated,erect,extending,flattened-reniform,flower,free,fully,geminat,glaucous,green-brown,hermaphrodite,heterostylous,infructescence,less,lobe,long-acuminat,long-styled,longer,lowermost,midpoint,midvein,minute,narrow-deltate,nflorescence,occasionally,older,one,open,opening,orange-brown,orolla,oung,ovate,pair,peduncle,pendent,pendulous,per,pericarp,plant,porrect,portion,prickl,prickly,primary,ray,red-brown,rounded,ruit,scar,sessile,short-styled,side,smooth,spaced,spreading,stalk,stalked,staminat,style,tamen,terete,tertiary,time,translucent,tube,unarmed,upper,vary,vein,venation,visible,way,wide,woody,yellow-green,ympodial	appressed,articulation,bract,branching,breeding,broad-based,cell,colour,connective,corolla,form,geminate,growth,heteromorphism,inflated,inflorescence,insertion,interjected,interpetalar,leaflet,marking,modification,na,needle-like,odour,orientation,paired,pattern,placement,pore,position,pseudostipule,rhizome,scale,shape,smell,spot,staman,stone,structure,symmetry,sympodial,system,texture,tissue,tuber,type,vegetative,xylopodia,zygomorphy
319	wfo-0001029546	invalid_json_followup	203	180	128	75	52	0.631	0-2,0.3-1,1-2,1-4.5,1.5-2,1.5-6.2,2.2-2.8,3-8,4-10,4.5-12.5,4.5-7,5,5-10,5-18,5-8,7-10,8-17,8-19.5,abaxially,absent,adaxially,anther,apex,articulated,axillary,base,berry,blue,broadly,brownish,bud,cell,chartaceous,clavate,cm,condition,connivent,cordate,corolla,curved,decreasing,densely,diameter,digestion,distal,dot,drying,elliptic,elliptical,enzyme,filament,flower,forked,frequently,fresh,fruit,generally,glabrous,glandular,globose,greatly,green,greenish,hair,half,herb,homostylous,honeycomb-shaped,interjected,lanceolate,lateral,leaf,leaflet,lengthening,long,longer,lunate,membranous,mm,nearly,non-glandular,oblique,odd-pinnate,often,orbicular,ovate,ovoid,pair,pedicel,peduncle,pentagonal,petiole,plant,pore,poricidal,pubescent,rachi,rarely,regular,removed,ripe,rotate-pentagonal,seed,short,simple,size,slightly,slit,soft,sometimes,stem,stigma,straight,style,subequal,subtending,terminal,testal,tinged,tip,trichome,typically,wall,white,whitish,wide,wing,x	1-10,1-3.2,1-5,1.6-6.5,2-4,2-9,3.5-5,5-merou,6.3-19.5,8,acumen,acuminate,acute,adaxiall,ag,alyx,apart,apiculate,apparently,attenuate,axe,blade,capitat,covered,covering,decumben,decurrent,dorsally,eaf,edge,eed,erect,exceeding,flat,folded,geminat,glabrou,green-white,hair-like,like,living,lobe,lower,make,middl,minutely,mottle,mucilaginous,nflorescence,perfect,petiolule,plurifoliate,purple,ruit,sessile,seudostipule,spaced,specimen,stamen,ste,tall,tamen,tem,thick,throughout,tri-,truncate,tube,unit,unwinged,usually,vary,wet,yellow,ympodial	'',[,``,age,appressed,arrangement,articulation,bract,branching,breeding,broad-based,calyx,capitate,characteristic,colour,connective,form,fruiting,growth,height,inflated,inflorescence,insertion,interpetalar,length,margin,marking,mature,middle,modification,na,odour,ovary,paired,pattern,position,prickle,pseudostipule,scale,shape,smell,spot,staman,symmetry,system,texture,tissue,type,value,vegetative,{,}
320	wfo-0001029552	invalid_json_followup	161	161	105	56	56	0.652	.25,.5,0.5,0.6-1,1-1.5,1-2,1-3,1-5,1.5-2,1.5-6.5,10-20,12,2-2.5,2-9,2.5-3,5-10-flowered,5.5-8,abaxially,abruptly,acuminate,acute,adaxially,along,anther,apex,area,bark,base,branched,broadened,calyx,clavate,cm,conical,contracted,corolla,decurrent,dendritic,densely,dia,elliptic,erect,filament,flattened-reniform,flower,fruiting,glabrous,globose,green,incrassate,inflorescence,lamina,leaf,like,lobed,long,long-styled,lower,major,margin,middle,minor,minutely,mm,nearly,occasionally,opposite,orbicular,ovary,pale,paler,pedicel,petiole,pitted,pore,poricidal,pubescent,rest,rounded,shape,shaped,shining,short-styled,shrub,simple,size,small,somewhat,sparsely,stem,stigma,style,surface,tan,tear-drop,tip,tree,tree-like,trichome,tube,vein,white,wide,widest,x	0.1-0.5,1-1.3,6-9,abaxial,anthesi,berry,broadly,closely,deflexed,deltate,denser,differing,difoliate,drying,eaf,edicel,eed,exserted,free,geminat,greyish-brow,heteromorphic,inflorescenc,later,lateral,lobe,lon,main,minute,nflorescence,older,onto,overlappin,pair,papillo,persistent,planar,portion,present,reflexed,ruit,scar,scattered,slender,slightly,spaced,strongly,swollen,tall,tub,ud,unit,woody,yellowish,ympodial,young	'',[,``,alternate,arrangement,articulation,bract,branching,breeding,broad-based,characteristic,colour,connective,diameter,form,fruit,greyish-brown,growth,hair,height,insertion,interjected,interpetalar,leaflet,length,marking,modification,na,needle-like,number,odour,orientation,papillose,placement,plant,position,prickle,pseudostipule,rhizome,scale,seed,smell,spot,symmetry,system,texture,tissue,tuber,type,value,vegetative,width,xylopodia,zygomorphy,{,}
321	wfo-0001029584	invalid_json_followup	180	166	108	72	58	0.6	0-30,1,1-2,1-6,1.5-6.5,16.2-33,2-3,2-4,3-10,3-7,4-14,4-15,4-5,4.5-11.5,6-7,6.1-9.4,7-14,8-15,9.7-23.4,9.8-17,abaxially,anther,apex,base,borne,brownish,cell,clavate,cm,condition,coriaceous,corolla,covering,dark,dense,densely,diameter,distal,drying,end,filament,finer,flower,forked,fresh,fruit,generally,glabrescent,glabrous,green,green-white,greenish,hair,half,herb,homostylous,interjected,lateral,leaf,leaflet,lengthening,light,lobe,long,lower,make,margin,mm,mucilaginous,oblong-lanceolate,odd-pinnate,ovoid,pair,pedicel,peduncle,pentagonal,petiole,plant,pore,poricidal,pubescent,purple,seed,short,simple,singly,size,slit,stigma,straight,style,substellate,terminal,testal,thick,throughout,tip,tissue,tube,tuber,typically,unwinged,usually,wall,wet,white,whitish,x	1-3,2.4-6.3,3-5,5-merou,5.3-13.3,acumen,acuminate,acute,adaxially,ag,alyx,apart,apparently,articulated,asymmetric,attenuate,axe,axillary,basiscopic,blade,bud,capitat,connivent,considerably,decreasing,digestion,dorsally,eaf,edge,eed,elliptic,enzyme,erry,flat,folded,geminat,hair-like,hal,honeycomb-shaped,larger,linear,living,middle,nflorescence,orbicular,orolla,ovate,perfect,petiolulate,plurifoliate,present,proximal,removed,second,semi-erec,sessile,seudostipule,side,spaced,specimen,stolo,subtending,tall,tamen,tem,toward,tri-,unit,unknow,vary,yellow,ympodial	'',[,\u201chair-like\u201d,``,abaxial,adaxial,age,appressed,arrangement,articulation,bract,branching,breeding,broad-based,calyx,capitate,characteristic,colour,connective,form,fruiting,growth,height,inflated,inflorescence,insertion,interpetalar,length,marking,mature,modification,na,odour,ovary,paired,pattern,position,presence,prickle,pseudostipule,scale,shape,smell,spot,staman,stem,stolon,surface,symmetry,system,texture,trichome,type,unknown,value,vegetative,{,}
322	wfo-0001029593	success	181	158	117	64	41	0.646	-10,0.05,0.5-1,0.5-5,0.8-1,0.8-1.2,1,1-1.2,1-1.5,1-8,1.6-2.3,10-50,2,2-3,2-5,2.3-3.0,3-4,3.5-8,35-60,4-6,5-15,7-25,9-15,abaxially,abruptly,acuminate,acute,age,always,anther,anticlinal,apex,apically,arising,attenuate,axil,axillary,basal,base,basiscopically,broadly,brown,calyx,capitate,cell,cm,conical,decurrent,densely,diameter,elliptic,enlarged,epidermal,filament,filiform,fruit,fruiting,glabrous,globose,green,half,irregular,lateral,leaf,leaflet,long,lower,markedly,minutely,mm,narrowing,oblique,obovate,occasionally,once-branched,onto,opposite,ovary,ovoid-reniform,pair,papillose,pedicel,per,perfectly,petiole,petiolule,pinnate,plant,pointed,poricidal,projection,pubescence,pubescent,purple,rachi,rarely,seed,shape,shrub,sinuous,slightly,smaller,somewhat,stigma,style,terminal,thickening,tip,trichome,tube,unit,usually,white,winged,without,woody,x	1-2,100,2-14,2.3,5-10,7.5-15,adaxially,anthesi,bearing,berry,cateniform,clavat,colony,cone,deltate,dry,drying,eaf,edicel,eed,entire,exserted,extremely,flower,free,glabrescent,growing,hollow,included,lamina,large,lobe,much,nflorescence,noddin,often,open,place,portion,primary,pubescen,reflecting,rest,ruit,scar,short-styled,similar,simple,single-stemmed,small,smooth,sparsely,surface,tall,tem,tub,ud,unifoliat,uniseriate,variable,vein,white-lenticellate,wider,ympodial	arrangement,bract,branching,breeding,bud,cateniforme,clavate,colour,connective,corolla,form,glabrescence,growth,hair,height,heteromorphism,inflorescence,length,marking,modification,na,nodding,number,pattern,pore,position,present,rhizome,size,spot,staman,stem,stone,structure,symmetry,sympodial,system,texture,tuber,unifoliate,xylopodia
323	wfo-0001029601	success	187	97	55	132	42	0.294	0-37,1-2,1-3,2-12,6-10,anther,apex,attenuate,axillary,base,berry,bud,cell,cm,coriaceous,corolla,dot,filament,forked,fruit,glabrous,globose,green,hair,herb,homostylous,interjected,lanceolate,leaf,leaflet,light,long,middle,mm,odd-pinnate,pedicel,pentagonal,petiole,plurifoliate,pore,poricidal,puberulent,ripe,rotate,rounded,slightly,small,subtending,terminal,tip,tissue,tri-,tuber,unit,white	0.2-0.8,0.5-5.8,0.5-8,1-4,1-53,1.1-2.7,1.2-2.3,1.7-6.5,2,2-3,2-7,2-9,2.2-4.5,2.3-5.9,2.8-10.5,3-10,3-5,3-7,4-13.5,5-41,5-merou,6.6-22,6.8-14.5,abaxiall,abaxially,acumen,acuminate,acute,adaxially,ag,alyx,apart,apparently,articulated,asymmetric,axe,basiscopic,blade,borne,brownish,capitat,clavate,condition,connivent,covering,dark,decreasing,diameter,digestion,distal,dorsally,drying,eaf,edge,eed,elliptic,end,enzyme,erec,exceeding,flat,flower,folded,fresh,geminat,generally,glabrescent,glabrou,green-white,greenish,hair-like,half,honeycomb-shaped,larger,lateral,lengthening,linear,living,lobe,lower,make,middl,mucilaginous,narrow,nflorescence,orbicular,orolla,ovate,ovoid,pair,peduncle,perfect,petiolulate,plant,removed,ruit,seed,sessile,seudostipule,short,side,singly,size,slit,spaced,specimen,stamen,stigma,stolo,straight,style,subequal,subglabrou,tall,tamen,tem,testal,thick,throughout,toward,tube,typically,unwinged,usually,vary,wall,wet,whitish,wing,x,yellow,ympodial	appressed,articulation,bract,branching,breeding,calyx,colour,connective,form,fruiting,growth,heteromorphism,inflated,inflorescence,insertion,interpetalar,length,margin,marking,mature,na,odour,orientation,paired,pattern,placement,position,prickle,pseudostipule,rhizome,scale,shape,spot,staman,stone,structure,symmetry,sympodial,system,texture,type,xylopodia
324	wfo-0001029621	success	165	109	57	108	52	0.345	0.5-0.75,1-1.5,2/3,3.5-4.5,accrescent,anther,apex,appressed,attenuate,base,becoming,berry,branched,calyx,corolla,decurrent,filament,fruit,fruiting,glabrous,globose,green,lanceolate,later,lateral,leaf,lobed,lower,many,margin,mm,oblanceolate,often,onto,papillate,pedicel,pore,poricidal,reddish,ripe,sessile,shaped,shrub,stem,surface,tear-drop,terminal,time,tip,trichome,uniseriate,unit,way,white,woody,x,yellowish	.1,0.5-1,0.5-1.2,0.5-1.5,0.7-1.1,0.8-1,0.8-4.5,1-2,1.5-2,1.5-2.5,1.5-5,1/3,2.5-3,3-3.5,5-20-flowered,6-20,6-8,7-9,acute,along,anthesi,apar,appearing,area,bark,beneath,borne,brown,caudate,cluster,cm,completely,constricted,course,cup-shaped,dark,deltoid,densely,dia,distal,dry,eaf,edicel,eed,ellipsoid,elongate,enclosed,erect,exsertio,fleshy,free,geminate,glabrate,irregularly,late,like,live,lobe,lon,long,main,material,merely,middle,minutely,nflorescence,occasionally,older,ovary,ovoid-reniform,pair,pale,papillo,papillose,pitted,planar,plant,plurifoliat,portion,prominent,puberulent,quite,rarely,reddish-gre,river,ruit,scar,shiny,small,somewhat,spaced,ste,stigma,straight,style,tall,tan,tapering,thick,tube,ud,vein,whorl-like,widened,widest,yellow,ympodial,young	articulation,bract,branching,breeding,broad-based,cell,colour,connective,form,growth,hair,heteromorphism,inflated,inflorescence,insertion,interjected,interpetalar,leaflet,length,marking,mature,modification,na,needle-like,odour,orientation,paired,pattern,petiole,placement,plurifoliate,position,prickle,pseudostipule,rhizome,scale,shape,smell,spot,staman,stone,structure,symmetry,sympodial,system,texture,tissue,tuber,type,vegetative,xylopodia,zygomorphy
325	wfo-0001029622	invalid_json_followup	182	153	104	78	49	0.571	.1,.5,/3,0.5-1,0.8-1,1-1.2,1-1.5,1-4,1.5,2-11,2.5-3,3-4,3-5,30-35,4-6.5,5-6,absent,accrescent,acute,anther,apex,appearing,attenuate,bark,base,beneath,brown,calyx,chartaceous,cm,connivent,consisting,corolla,cylindrical,deflexed,diameter,difoliate,elliptic,entire,filament,flower,fruit,fruiting,geminate,glabrous,globose,green,inflorescence,internodal,jointed,lateral,leaf,lobe,lobed,long-acuminate,long-triangular,longitudinal,main,margin,mature,mm,narrowly,obconic,oblong,occasionally,older,opening,opposite,ovate,pair,pedicel,peduncle,petiole,pore,rachi,reddish,rounded,sagittate,shaped,shiny,shrub,simple,single,size,slightly,slit,somewhat,stellate,stem,stigma,straight,style,tapering,tear-drop,tip,trichome,tube,tuft,uniseriate,unit,vein,way,white,x	.2,0.3,0.5,0.5-0.7,0.6-0.9,1-2.7,2-4,2-5,40,45-50,7-11,abaxially,adaxially,ag,alyx,anthesi,apparently,arising,axe,axil,blade,bud,capitat,deciduous,differing,dimorphic,eaf,eed,elongate,except,free,glabrou,ilament,immature,included,interlaced,known,lamina,less,long,m.,major,measured,midrib,minor,minute,minutely,nflorescence,often,one,onto,orolla,oung,ovate-lanceolate,papillose,pendent,portion,present,probably,raised,reflexed,remaining,ruit,scar,second,slende,slender,tal,thin,thus,ud,unarme,unifoliat,vary,within,yellow,ympodial,young	'',[,``,abaxial,adaxial,age,appressed,bract,branching,breeding,capitate,characteristic,colour,connective,form,glabrousnes,growth,hair,height,inflated,interjected,interpetalar,leaflet,length,marking,modification,na,odour,ovary,paired,pattern,plant,position,scale,shape,smell,spot,structure,symmetry,sympodial,system,texture,tissue,type,unarmed,value,vegetative,{,}
326	wfo-0001029625	success	168	189	133	35	56	0.792	-15,..,.1-0.2,0.5-1,0.5-2,0.5-2mm,0.8-1.4,0.8-1.8,1-1.5,1-2,1-3,1.2-1.6,2,3,3-,3-3.5,4-10,4-4,4-5-celled,4-7-celled,4-9,5,5-10,5-6,5-8,6-9,9-25,abaxial,along,anther,anthesi,bark,base,beneath,branch,branched,brittle,calyx,cell,cm,conical,corolla,cucullate,darker,deflexed,deltate,densely,denser,diameter,dry,elliptic,erect,filament,flattened,four,fruit,fruiting,glabrescent,glabrous,gland,gland-tipped,globose,green,greenish,growth,herb,hyaline,inflorescence,lamina,later,lighter,like,lobe,lobed,long,lower,margin,markedly,midline,mixed,mm,narrowly,nearly,occasionally,outer,outline,ovary,ovate-reniform,pale,papillate,pedicel,peduncle,per,pericarp,planar,point,pointed,pubescent,purplish,rarely,reddish,regularly,scattered,shrub,single,sinuate,slightly,small,smooth,sparsely,stem,stigma,striate,stripe,strongly,style,surface,tan,testa,thin,time,tinged,tip,triangular,trichome,tube,uniseriate,vein,wall,weight,white,x,young	.5,0.5-1.3,100,2.5-.,3-3,8-13,apical,branc,brow,capitat,cel,deflexe,distinct,eaf,edicel,eed,flower,frui,glandular,middle,minute,new,nflorescence,open,pair,plurifoliat,primary,ruit,scar,single-stemmed,tuft,ud,unit,without,ympodial	apex,arrangement,articulation,bract,branching,breeding,broad-based,brown,capitate,colour,connective,form,hair,heteromorphism,insertion,interjected,interpetalar,leaf,leaflet,length,marking,modification,na,needle-like,number,odour,orientation,paired,pattern,petiole,placement,plurifoliate,pore,position,prickle,pseudostipule,pubescence,rhizome,scale,seed,shape,size,smell,spot,staman,stellate,stone,symmetry,system,texture,tissue,tuber,type,vegetative,xylopodia,zygomorphy
327	wfo-0001029645	invalid_json_followup	160	169	113	47	56	0.706	.5-1,0.2-0.5,0.3-0.5,0.5-2.5,0.5-7,1,1-1.5,1-2,1-4,1.3-7,1.5-2,2-4,2.5-17,2.5-4,3-10,3-15,3-7,3.5-4,337,4-5,4-8,5,5-8,6-12,7-12,750,?,acuminate,acute,aggregate,along,anther,apart,apex,base,blue,calyx,cell,chartaceous,cm,corolla,cuneate,cylindrical,decurrent,deltate,diameter,directed,distally,entire,et,except,extra-axillary,fide,filament,finger,fruit,glabrous,gland-tipped,globose,green,greenish,hair,herb,immature,kayap,line,lobe,margin,membranaceous,minutely,mm,moderately,nearly,obtuse,ovate,ovate-elliptic,pedicel,peduncle,perfect,petiole,pore,puberulent,purple,rachi,radiu,rarely,red,rotate-stellate,sagittate,short,short-tomentose,side,simple,small,smith,sparsely,stigma,stone,strongly,style,subcordate,tapered,triangular,truncate,tube,unbranched,unit,vein,white,wide,x,yellow,Â±	-1,1.5,2-3-foliat,abaxially,abundantly,adaxially,around,articulated,axe,ba,blade,brown,connivent,distall,eaf,eed,flattened,flower,free,glabrou,inserted,knapp,long,lower,major,mesocarp,nflorescence,orolla,part,puberulen,rugose-verrucate,ruit,sand-punctate,shorter,shru,spaced,tal,tamen,tem,thecae,tightly,time,tomento,truncat,vary,veiny,ympodial	'',0.5-1,2-3-foliate,[,``,appressed,articulation,bract,branching,breeding,characteristic,colour,connective,form,fruiting,growth,height,inflated,inflorescence,insertion,interjected,interpetalar,leaf,leaflet,length,marking,mature,modification,na,ovary,pattern,plant,position,present,scale,shape,shrub,size,spacing,spot,staman,stellate,stem,structure,symmetry,sympodial,system,texture,theca,tissue,trichome,type,value,zygomorphy,{,}
328	wfo-0001029646	invalid_json_followup	141	141	79	62	62	0.56	0.1-0.6,0.5-0.8,0.7-2.2,1-4,1.5-2,1.5-4.9,10-15,2-3,3-14,4-5.5,5-15,6-8,7-15,acuminate,acute,apex,apically,attenuate,base,branched,calyx,cell,cm,corolla,covering,cyme,dehiscent,diameter,dichasial,dichasially,distal,elliptic,filament,finely,flower,free,globose,green,green-white,hair-like,half,herbaceous,honeycomb,lateral,leaf,linear,lobe,long,mm,monochasial,mucilaginous,mucronate,narrowly,ovate,ovoid,pattern,pedicel,peduncle,perennial,perfect,petiole,plant,poricidally,proximal,pubescent,seed,simple,stellate,style,testal,thick,throughout,tone,tuber-bearing,unit,wall,white,yellow-green,Â¼	0.5,3-6-foliat,abaxially,acumen,adaxially,apical,articulate,commonly,digestion,dorsally,eaf,ebracteate,edge,eed,emoval,enzyme,epiphytic,equaling,flat,folded,forked,generally,globo,ground,growing,introrse,living,lon,lower,make,maturing,mos,mould,nflorescence,nther,oak,often,orolla,ovat,pine,plan,rarely,reveal,ruit,seudostipule,short,slit,specimen,stamen,stigma,straight,tall,tem,throughou,tree,typically,vary,viole,wide,without,yellow,ympodial	'','hair-like,3-6-foliate,[,``,anther,appressed,articulation,bract,branching,breeding,characteristic,colour,connective,form,fruit,fruiting,growth,hair,height,inflated,inflorescence,insertion,interjected,interpetalar,leaflet,length,margin,marking,mature,modification,na,number,odour,orientation,ovary,paired,placement,pore,position,prickle,pseudostipule,rhizome,scale,shape,spot,stem,structure,symmetry,sympodial,system,texture,tissue,tuber,type,value,violet,wet,width,xylopodia,{,}
329	wfo-0001029652	success	160	120	70	90	50	0.438	0.5-1,0.5-4,0.8-1,1-2,1-3,1.5-2,2-2.5,2-4,2.5-3,3.5-4,3/4,4-4.5,anther,apex,attenuate,base,calyx,cm,conical,corolla,difoliate,elliptic-ovate,filament,fruiting,glabrous,globose,golden,green,greenish-white,leaf,lobed,long-styled,margin,minor,minutely,mm,narrowly,occasionally,opposite,ovary,ovoid-reniform,pale,papillose,pedicel,petiole,pitted,pore,poricidal,pubescent,shaped,short-styled,shrub,simple,size,slightly,stigma,style,surface,tan,tear-drop,thickened,tip,trichome,tube,undulate,uniseriate,unit,way,white,x	.25,.3,.5,0.75-1,1,2,25,6-15,7-9,abaxially,adaxially,along,anthesi,apar,ape,apical,arch,arching,ba,bark,bearing,berry,broadly,cone,curling,deciduous,deflexed,deltate,denser,dia,differing,drying,eaf,edicel,eed,evenly,exserted,filiform,flower,free,geminat,golden-red,hard,heteromorphic,hispid,included,joining,lamina,lateral,like,lobe,lon,long,long-acuminate,lower,main,major,maturity,middle,midrib,minute,near,nflorescence,older,pair,papillo,pericarp,portion,projection,reddish-brown,reflexed,ruit,scar,series,slende,slender,soon,spaced,sparsely,stem,swollen,tall,time,tub,ud,vein,widest,within,ympodial,young	0.25,0.5,abaxial,adaxial,bract,branching,breeding,cell,colour,connective,diameter,form,fruit,geminate,growth,hair,height,heteromorphism,inflorescence,interjected,interpetalar,leaflet,length,marking,modification,na,orientation,pattern,placement,plant,position,prickle,pseudostipule,rhizome,scale,seed,shape,spot,staman,stone,structure,symmetry,sympodial,system,texture,tissue,tuber,type,xylopodia,ye
330	wfo-0001029673	success	159	130	90	69	40	0.566	0.5-1,0.7-1.1,0.75-1,1-10,1-2,1.2-3.5,10-20,2-2.5,2-3,2-4,5.5-15,abaxial,accrescent,adaxial,age,anther,apical,appearing,bark,basal,becoming,berry,black,branch,branching,broadly,calyx,cm,corolla,deep,dendritic,densely,diameter,elliptic,exserted,filament,fork,fruit,fruiting,globose,greyish,greyish-yellow,growth,later,lateral,leaf,length,long,mm,monochasial,narrowly,occasionally,overtopping,pair,pedicel,petiole,planar,plurifoliate,pore,poricidal,prominent,pubescent,purple,pyramidal,reflexed,scar,secondary,shoot,shrub,sleeve,slightly,slit-like,small,somewhat,sparsely,stem,strongly,tapering,terminal,time,tip,tree,trichome,tube,unit,vein,violet,winged,x,young	.5,0.8-1,1-5,1.5-1.8,1.5-2,2.5,3-5,3/4,4-6,5-25,abaxially,absent,acuminate,acute,adaxially,along,anthesi,apex,base,blade,clavate,conical,decurrent,deflexed,deltoid,denser,dichasia,eaf,edicel,eed,ew,flower,free,glabrous,greyish-yello,individual,inserted,lamina,lenticular,like,lobe,lon,longer,lower,m.,minutely,nflorescence,nodding,older,ovary,papillo,pericarp,petal,pitted,portion,reddish-brown,ruit,stamen,stigma,style,surface,tall,thin,triangular,tub,ud,wide,woody,ympodial	breeding,bud,cell,colour,connective,dichasial,exsertion,form,hair,height,heteromorphism,inflorescence,insertion,marking,modification,na,new,pattern,plant,position,prickle,prominence,pseudostipule,rhizome,shape,size,spot,staman,stone,structure,symmetry,sympodial,system,texture,tuber,type,venation,winging,xylopodia,zygomorphy
331	wfo-0001029680	success	212	108	64	148	44	0.302	1.0â1.5,1.4â7.5,1.6â2.7,12,1â2,4.0â16,4.5â20,50,annual,anther,apex,axillary,base,becoming,bipinnate,blue,calyx,cell,cm,diameter,filament,fleshy,fruit,glabrous,globose,green,hair,herb,indistinct,leaf,length,light,long,margin,mm,oblong,pentagonal,petiole,pinnate,pore,pubescent,purple,rarely,red,ripe,rotate,shaped,sometimes,sparsely,stem,stone,tear-drop,terminal,time,tripinnate,turning,violet,white,wide,winged,woody,â19,â3,â3.2	.0,0.1,0.4,0.5â1.5,0.6,0.6â1.2,0.6â2.0,0.9â1.0,1,1.0,1.0â1.1,1.0â1.8,1.1â1.2,1.4â2.5,1.5,1.7â7,1.8â3.8,10,11â16,11â25,1â3,1â6,1â8,2.2â4.2,2â20,3.0â4.2,3.3â5.5,3â22,3â6,4.0â6.5,4.5â7.0,4â10,4â30,5,5.5â8.5,5â11,7â10,8â32,abaxially,absen,acute,adaxiall,adaxially,ag,along,anthesi,apart,appressed,arequipa,arranged,articulated,asymmetrically,axe,ba,beyond,blade,borne,branched,brown,clavate,connivent,cylindrical,decreasing,decurrent,densely,difoliate,divided,eaf,eed,entire,equal,erect,extending,flange,flattened,flower,forming,geminat,irregularly,lobe,lon,longitudinal,lower,m.,midrib,moderately,multicellular,narrow,nflorescence,node,obovate,obtuse,occasionally,often,opening,orolla,ovate,pair,pale,parallel,pedicel,peduncle,pendant,perfect,pinnae,pitted,plurifoliate,poricidal,primary,prostrate,rapidly,ruit,running,secondary,shallowly,shoot,side,simple,size,spaced,specimen,split,stigma,straight,style,subglabrous,surface,tacna,tal,tamen,tem,tertiary,tip,tube,unicellular,uniseriate,unit,usually,vary,wing,winge,x,yellow,ympodial,â10,â12.5,â46,â48	absent,branching,breeding,colour,connective,corolla,decurred,form,fruiting,growth,height,heteromorphism,history,inflorescence,interjected,interpetalar,leaflet,life,marking,modification,na,odour,orientation,paired,pattern,placement,plant,position,prickle,pseudostipule,ratio,rhizome,shape,spot,staman,symmetry,system,texture,tissue,tuber,type,width,xylopodia,zygomorphy
332	wfo-0001029704	success	146	137	85	61	52	0.582	.5,0-1.5,1-2,1-4,1.5,1.5-2.5,1.5-3,140-185,2-3,3-4-celled,3-5,7-10,acuminate,acute,anther,anthesi,apex,base,berry,blue,branch,broadly,brown,calyx,cell,cm,composed,conical,corolla,cuneate,cut,dark,diam,ellipsoid,enlarged,extra-axillary,few-flowered,filament,flower,fork,fruiting,glabrous,globose,green,lanceolate,leaf,lengthening,lobe,lower,midrib,minutely,mm,moderately,mottled,obovate,obovoid,occasionally,ovary,pedicel,peduncle,petiole,pinnatisect,pore,poricidal,pubescent,purple,reddish,reticulate,shrub,simple,single,slit,stellate,stigma,stone,stout,striped,style,subdiscoidal,surface,tip,trichome,variously,white,within	-17,-3,0.5,1,10-14,1000-1200,15-25,2-2.5,2-5,4,4-7,5,7-,9-20,acuman,along,also,apparently,aspect,axi,c.,cunate,deeply,deflexed,dia,eaf,eed,erect,especially,exerted,flowering,gradually,halfway,less,lobed,long,minute,nflorescence,one,plurifoliat,record,rounded,ruit,shoot,short,sinus,sombre,sprawling,straight,subglobo,swollen,tub,tube,twig,ud,unit,variable,vein,x,ympodial,young	articulation,bract,branching,breeding,broad-based,bud,colour,connective,form,fruit,growth,hair,height,heteromorphism,inflorescence,insertion,interjected,interpetalar,leaflet,length,margin,marking,mature,modification,na,needle-like,odour,orientation,paired,pattern,placement,plant,position,prickle,pseudostipule,rhizome,scale,seed,shape,smell,spot,staman,stem,subglobose,symmetry,system,texture,tissue,tuber,type,vegetative,xylopodia
333	wfo-0001029727	success	260	103	53	207	50	0.204	-3,0.4-1,0.7-0.9,3-7,4-merous,4.5,5.5-7,anther,apex,articulated,base,berry,branched,calyx,chartaceous,climber,cm,cordate,corolla,cupular,curved,filament,flattened-reniform,lateral,leaf,length,lobed,long,lower,margin,mature,mm,obconical,orange-brown,pedicel,petiole,pore,poricidal,prickle,rounded,shape,shrub,simple,stellate,stellate-pubescent,stem,straight,surface,tapering,terminal,trichome,unit,violet	-1/3,-10,.5,/3,0-15,0-2,0-20,0-30,0-4,0-40,0-5,0-8,0.1-5,0.15-0.2,0.15-0.3,0.2,0.2-0.5,0.2-2.5,0.3,0.4,0.5,0.5-1.2,0.5-3,0.7-1,1,1-,1-1.2,1-2,1-4,1.2-2,1.5-2.3,1.5-2.5,1.5-3,1.5-5.5,1.6-3,1/2-2/3,1/3-1/2,1/4,1/8-1/5,2-5,2.5,2.5-3.2,2.5-5.5,2.8-4,3-11,3-6,3/,4-7,4-merou,4.5-,5-12,5-8,5-9,6-11,7-10,abaxial,abaxially,acicular,acuminate,acute,adaxial,age,almost,along,alternate,alyx,ame,anthesi,apar,apart,apically,apparently,bark,blade,bristle,brown,c.,clavate,colourles,connivent,covered,darker,deltate,deltoid,densely,developing,diameter,different,dimorphic,discolorous,divided,drying,eaf,edge,eed,elongating,equal,erect,except,extending,ferrugineous,filiform,filiform-acuminat,finely,fissure,flower,free,geminate,glabrous,increasing,inside,lengthening,less,like,lobe,lon,longer,m.,mauve,middle,midpoint,midvein,minor,minutely,mixture,moderately,narrow-deltate,nflorescence,nther,oblong,occasional,older,one,open,orolla,oung,outside,ovate,pair,papillo,papillose,peduncle,per,perfec,perfect,pit,pitted,plurifoliat,porrect,portion,prickl,prickly,primary,protruding,pubescent,raised,rarely,ray,red-brow,red-brown,reddish,reduced,regular,scandent,scar,seed,series,sessile,shallowly,short,sinus,size,smooth,sometimes,spaced,spreading,stalk,stalked,stigma,strongly,style,subentire,tamen,tearing,terete,tertiary,time,tip,toward,translucent,transverse,tube,unarmed,uneven,upper,variable,variously,vary,vein,venation,visible,way,wide,x,yellowish,ympodial,young	appressed,articulation,bract,branching,breeding,broad-based,cell,colour,connective,form,fruit,fruiting,growth,hair,heteromorphism,inflated,inflorescence,insertion,interjected,interpetalar,leaflet,marking,modification,na,needle-like,odour,orientation,paired,pattern,placement,plurifoliate,position,pseudostipule,rhizome,scale,smell,spot,staman,stone,structure,symmetry,sympodial,system,texture,tissue,tuber,type,vegetative,xylopodia,zygomorphy
334	wfo-0001029731	success	246	115	71	175	44	0.289	.5,0.1-0.8,7-11,accrescent,almost,anther,apex,apically,base,becoming,berry,black,branch,branched,branching,calyx,cm,coriaceous,corolla,crinkled,cuneate,diameter,dilated,drying,dull,enlarge,entire,epiphyte,erect,filament,flattened,fleshy,fruit,fruiting,hair,lateral,leaf,liana,lobed,long,long-ellipsoid,lower,margin,mauve,mm,oblong,often,orange-brown,pedicel,pendulous,petiole,pore,poricidal,pyriform,reflexed,revolute,ridged,rounded,simple,slender,sometimes,sparsely,stem,succulent,surface,terminal,thick,tip,unit,white,yellow	.6,0.05,0.25-0.3,1,1-1.5,1-2,1-2.5,1.5,1.5-2.5,1.5-3,1/3,10-20,1994,2,2-3,2-6,2.5,2.5-4.5,3,3-10,3-4,31,4,4-5,4-9,6,6-7,8-9,abaxially,acquiring,acuminate,acute,adaxially,age,along,alyx,anthesi,apar,apparently,arcy,articulated,bark,basal,basally,beak,boundary,broadly,brown,bumpy,clavate,clearly,concolorous,conical,connate,darker,delimited,delineated,deltoid,dense,development,different,distributed,domatia,dorsal,dorsifixed,dry,eaf,early,elliptic,elongating,equal,even,evenly,exserted,faint,filiform,fine,finely,flaring,flower,free,glabrous,ground,iscoid,lamina,large,later,lengthening,less,like,linear,lobe,lon,longitudinal,longitudinally,main,mature,maturity,midvein,much,narrowly,nflorescence,nther,obconical,obovate,obtuse,occasionally,orolla,pair,papillae,papillose,part,peduncle,perfec,pericarp,persisting,plurifoliat,portion,primary,prominent,protruding,rachi,raised,rakotozafy,rarely,reported,ribbed,ridge,ruit,scar,see,several,shallowly,shorter,sinus,slightly,small,smaller,smoot,stigma,straight,stretched,stump,style,sunk,tearing,thickened,thinner,though,time,toward,trichome,tub,tube,tuft,ud,usually,vary,vein,venation,ventral,visibl,visible,well-developed,wide,widely,wing,winged,woody,wrinkling,x,yellow-green,ympodial,young,â	articulation,bract,broad-based,cell,colour,connective,form,growth,heteromorphism,inflorescence,insertion,interjected,interpetalar,leaflet,length,marking,na,needle-like,none,odour,orientation,paired,pattern,placement,plurifoliate,position,prickle,pseudostipule,rhizome,scale,shape,spot,staman,stellate,stone,structure,symmetry,sympodial,texture,tissue,tuber,type,xylopodia,zygomorphy
335	wfo-0001029741	success	137	131	104	33	27	0.759	.4,.5,0.5-1.5,0.8-3.5,1-1.5,1-3.5,1.1-1.3,1.5-4,1.5-6,10-50-flowered,2-2.5,2.2-9,2.5-7.8,3,9.5-22.5,?,accrescent,acute,age,anther,anthesi,apex,attenuate,base,becoming,berry,black,branched,calyx,capitate,closely,cm,completely,corolla,dark,deflexed,dia,difoliate,dry,drying,early,elliptic,erect,exserted,filament,flower,fruit,fruiting,furcate,glabrous,globose,green,growth,inflorescence,known,lateral,leaf,lenticellate,lighter,lobe,lobed,long,major,minor,minutely,mm,nearly,new,opposite,ovary,ovate,overlapping,papillose,pedicel,petiole,pore,poricidal,produced,prominent,raised,reddish-brown,scar,shaped,shrub,size,slender,slightly,spaced,stem,stigma,straight,style,tapering,tear-drop,tip,tree,tube,unit,usually,vein,weak,white,woody,x	0.9-1.2,1.5,apiculate,ca,caly,deltoid,differing,divisio,eaf,edicel,eed,free,geminat,glabrou,immature,lon,lower,main,middle,nflorescence,pair,papillo,planar,portion,proximal,quite,ruit,tall,ud,variable,widest,wood,ympodial	articulation,branching,bud,colour,diameter,division,exsertion,form,geminate,glabrousnes,height,length,lobing,modification,na,number,overlap,plant,position,presence,seed,shape,spacing,structure,sympodial,texture,type
336	wfo-0001029744	success	113	100	80	33	20	0.708	0.3-0.6,0.5-1,1.5-3.2,2,2-4,5-8,50,7-15,8-10-flowered,8-11,abaxially,acute,adaxially,along,apart,apex,bark,base,blunt,branch,calyx,cm,deltate,dendritic,densely,denser,difoliate,elliptic,entire,extreme,flattened,flexuous,form,fruit,geminate,glabrescent,glabrous,golden,incrassate,lanceolate,leaf,lobe,long-acuminate,margin,minutely,mm,narrowly,node,non-reproductive,oblanceolate,oblique,occasionally,opposite,ovoid-reniform,pair,pale,pedicel,petiole,pitted,primary,pubescent,revolute,scar,shape,shrub,simple,single-celled,slightly,sometimes,somewhat,stem,surface,thin,tip,trichome,unifoliate,uniseriate,vein,white,x	1,1.5,beginning,brow,distinct,eaf,eed,examined,fide,inflorescenc,lamina,leave,looping,lower,major,marginal,mature,minor,nflorescence,older,pubescence,see,similar,small,smaller,smith,spaced,thee,ud,unicellular,unit,ympodial,young	arrangement,brown,bud,colour,density,flower,growth,height,inflorescence,length,number,plant,position,presence,seed,seen,size,spacing,texture,type
337	wfo-0001029746	success	179	110	66	113	44	0.369	1-1.5,1.5,3-4-pluri-foliate,8-11,age,anther,apart,apex,base,berry,calyx,cell,centre,cm,cordate,corolla,darker,densely,enlarged,entire,erect,filament,flattened,fruit,fruiting,gland-tipped,glandular,globose,herb,heteromorphic,inflorescence,internodal,leaf,lengthening,margin,mature,minutely,mm,nodding,orange,pale,pedicel,petiole,pore,poricidal,principal,pubescent,purple,red,reddish,reflexed,simple,slightly,slit,somewhat,spaced,spreading,subshrub,tip,triangular,uniseriate,unit,vein,widely,x,â3	.5,0.3-2,0.5-1,0.7-1,1,1-1.3,1.2-1.5,2,2-2.5,2-4,2-7,2-8,3,3-4,3-4.5,3-6,4-9,6,6-7,8-10,abaxially,acuminate,acute,adaxially,anthesi,bearing,becoming,blackish,broadly,brown,c.,capitate,ciliate,color,conical,crenate,crowded,cup-shaped,curved,dark,diameter,eaf,edicel,eed,ellipsoid,elliptic,exerted,fleshy,flower,flush,free,glabrous,greenish,growing,hollow,horn,irregularly,lamina,less,lobe,lon,long,longer,longest,lower,markedly,maturit,mid-length,mixed,narrowly,near,nflorescence,occasionally,ovary,ovate,ovoid,pair,papillo,papillose,peduncle,pericarp,pitted,plan,portion,primary,pubescen,rachi,ruit,scar,shallowly,shortest,single,slender,sparse,sparsely,stem,stigma,straight,strongly,style,surface,testal,thin,third,trichome,tube,ud,upper,upward,wall,widest,woody,ympodial	appressed,articulation,bract,branching,breeding,colour,connective,form,growth,hair,heteromorphism,inflated,insertion,interjected,interpetalar,leaflet,length,marking,maturity,modification,na,odour,orientation,paired,pattern,placement,position,prickle,pseudostipule,rhizome,scale,shape,spot,staman,stone,structure,symmetry,sympodial,system,texture,tissue,tuber,type,xylopodia
338	wfo-0001029769	success	142	97	66	76	31	0.465	.25,.5,0.5-1.5,1-3,1.5-2,1.5-2.5,2.5-3,2.5-8,3.5-4,5-8,6-17,8.5-17,acuminate,acute,anther,apex,bark,base,berry,brown,calyx,cm,conical,corolla,curl-tipped,cyathiform,dark,deflexed,elliptic,filament,flower,fruiting,glabrous,globose,golden,green,horizontally,internodal,leaf,lobed,long,margin,minutely,mm,nearly,opposite,ovoid-reniform,papillose,pedicel,petiole,pore,poricidal,pubescent,shaped,shrub,somewhat,sparsely,swollen,tear-drop,tip,trichome,tube,unit,white,woody,x	1-1.2,30-60-flowered,4,4-5,7-8,8-9,abaxially,adaxially,along,anthesi,apar,ape,archin,ba,bearing,branch,brochidodromu,capitate,cerro,deltoid,densely,dia,eaf,edicel,eed,exserted,filiform,free,fresh,hen,inglÃ©,lateral,less,like,lobe,lon,lower,main,midrib,nflorescence,older,onto,ovary,pair,papillo,pitted,portion,puberulent,reflexed,ried,ruit,scar,scattered,simple,smooth,spaced,stem,stigma,straight,style,surface,tall,three,time,tub,two,ud,unevenly,unifoliat,uniseriate,vein,wide,widely,winged,ympodial,young	0.5,30-60,arching,branching,colour,connective,diameter,form,fruit,growth,hair,height,inflorescence,length,marking,na,number,pattern,plant,position,seed,shape,size,spot,structure,symmetry,sympodial,texture,type,unifoliate,zygomorphy
339	wfo-0001029780	invalid_json_followup	204	177	133	71	44	0.652	1-1.2,1-10,1-2,11-24,120-210,15-22,15-45,2-2.5,2-2.8,2-3.5,2-5.5,20-60,3,3-6,3.5-7.3,4-6,4.5-6,5-7,5.5-13,50-70,600-950,8-12,?,abaxially,absent,acumen,adaxially,along,anther,apart,articulated,attenuate,berry,blade,borne,brownish,cell,chartaceous,cm,condition,connivent,cordate,corolla,dark,densely,diameter,digestion,distal,dorsally,drying,edge,end,enzyme,especially,filament,flat,flower,folded,forked,fresh,fruit,generally,glabrous,glandular,globose,green,greenish,hair,half,head,herb,high,homostylous,honeycomb-shaped,interjected,invested,lanceolate,lateral,leaflet,length,lengthening,like,lobe,membranous,midrib,minute,minutely,mm,non-glandular,odd-pinnate,ovate,ovoid,pair,pale,pedicel,peduncle,petiole,pinkish,plant,pore,poricidal,puberulent,pubescent,rarely,removed,ripe,rotate,seed,short,singly,size,slit,stem,stigma,straight,streak,stripe,style,terminal,testal,tetralobulate,tip,trichome,tube,tuber,typically,unwinged,usually,wall,white,whitish,x,yellow	1.4-1.9,1.5-2,2-12,2.4-4.2,5-merou,5.5,acute,ag,alyx,apex,apparently,axe,axillary,base,bud,capitat,ciliate,covering,cuneate,decumbent,eaf,eed,erec,exceeding,except,geminat,glabrou,gland,greatly,green-white,hair-like,hal,living,long,longer,lower,make,margin,mucilaginous,nflorescence,obtuse,often,orbicular,orolla,perfect,petiolulate,petiolule,plurifoliate,proximal,reduced,ruit,sessile,seudostipule,spaced,specimen,stamen,ste,stolo,subequal,subtending,tall,tamen,tem,thick,throughout,tri-,truncate,unit,vary,wet,ympodial	'',[,``,age,appressed,arrangement,articulation,branching,breeding,calyx,capitate,characteristic,colour,connective,connivence,form,fruiting,growth,height,inflated,inflorescence,leaf,marking,mature,modification,na,number,ovary,pattern,presence,pseudostipule,pubescence,shape,spacing,spot,staman,stolon,symmetry,system,texture,type,value,{,}
340	wfo-0001029784	success	237	94	54	183	40	0.228	0-4,0.1-0.5,0.25-0.3,0.5,0.5-1.5,2-foliate,acute,anther,apex,articulation,base,berry,bract,calyx,cell,cm,corolla,distal,eglandular,enclosing,filament,fruit,fruiting,globose,golden,green,half,herb,imparipinnate,inflorescence,interjected,interrupted,lanceolate,leaflet,loosely,lower,margin,mm,pedicel,pentagonal,petiole,present,pseudostipule,pubescent,simple,sparsely,stem,surface,trichome,truncate,unit,velvety,white,yellow	-12,-5,.1,.2,.5,0.1-,0.1-0.15,0.2,0.2-,0.2-0.3,0.2-0.5,0.3-0.35,0.3-0.4,0.3-0.5,0.3-1,0.4-,0.4-0.45,0.4-0.5,0.4-0.6,0.5-,0.6-1,0.7-1.2,0.9-1.2,1,1-,1-1.1,1-1.2,1-1.5,1-2,1-2-celled,1-4,1.0-1.3,1.2-2.5,1.5-,1.7-2.6,1/3,2,2-,2-2.5,2-3-celled,2-4,2-4.5,2-locular,2.5-3.5,2/3,3-,3-5,5-10,5-14,5-8,abaxial,abaxially,absent,abundant,acuminate,adaxially,adpressed,along,angled,anthesi,apical,appearance,appendage,arising,articulated,axi,basal,basicopically,beneath,broadly,brown,capitate,column,conical,crenate-serrate,crenation,dark,decurrent,deeper,densely,developed,diameter,distributed,due,eaf,edicel,eed,elliptic,entire,evenly,exserted,flower,giving,glabrescent,glabrous,glandular,gree,hair-like,hal,halfway,head,included,internode,interspersed,irregularly,lamina,larger,lateral,like,live,lobe,lon,long,long-acuminate,markedly,maturing,mostly,multicellular,narrowly,nflorescence,node,northern,obovate,occasionally,often,orbicular,outgrowth,ovary,pair,pale,paler,patent,peduncle,perennial,petiolule,plant,population,primary,proximal,pubescence,rarely,reflexed,ripe,robust,ruit,scattered,secondary,sessile,silky,smaller,soft,sometimes,somewhat,sparse,spreadin,staminal,sterile,stigma,stout,straight,stripe,strongly,style,tem,terminal,tertiary,testa,thick,trailing,tube,ud,undulate,unicellular,uniseriate,unseriate,usually,vein,wall,wide,winged,woody,x,ympodial	appressed,branching,broad-based,colour,form,growth,hair,heteromorphism,inflated,insertion,interpetalar,leaf,length,marking,mature,na,needle-like,odour,orientation,paired,placement,position,prickle,rhizome,scale,shape,smell,spot,staman,stone,structure,symmetry,sympodial,texture,tissue,tuber,type,vegetative,xylopodia,zygomorphy
341	wfo-0001029785	success	223	107	70	153	37	0.314	0-2,1-2,1.2-3.2,3.5-5,6,abaxially,absent,adaxially,anther,apex,articulation,axillary,base,berry,bud,cell,chartaceous,cm,commonly,corolla,cuneate,dark,darker,distal,filament,forked,fruit,globose,green,hair,hair-like,herb,interjected,lanceolate,leaf,leaflet,long,margin,membranous,middle,minute,mm,multiple-celled,non-glandular,oblique,odd-pinnate,outer,ovoid,pedicel,pentagonal,petiole,plurifoliate,pore,poricidal,purple,quite,ripe,rotate,rounded,scale-like,short,slightly,subtending,terminal,tip,tri-,unbranched,unit,variable,violet	0-3,0.1-0.5,0.3-2.2,0.4-4.9,0.8-1,1-1.2,1-10,1-5,1.5-3.6,1.8-3.5,1.8-7,10-26,2-4,3-4,3-6,3-8,3.8-7.2,4-10.5,5-16,5-9,5-merou,8-11,acumen,acute,ag,along,alyx,apart,apparently,attenuate,axe,blade,borne,broadly,brownish,capitat,clavate,condition,connivent,cordate,covering,decreasing,decumbent,denser,diameter,digestion,dorsally,drying,eaf,edge,eed,elliptic,end,enzyme,erec,especially,exceeding,flat,flower,folded,fresh,geminat,generally,glabrou,glabrous,greatly,green-white,greenish,half,homostylous,honeycomb-shaped,invested,larger,lateral,lengthening,like,living,lobe,lower,make,markedly,medium,midrib,minutely,mottled,much,mucilaginous,nflorescence,obovate,obtuse,one-quarte,orbicular,orolla,ovate,pair,pale,peduncle,perfect,petiolulate,petiolule,plant,point,present,puberulent,pubescent,purple-tinged,rarely,removed,ruit,seed,sessile,seudostipule,shallowly,singly,size,slit,sometimes,spaced,sparsely,specimen,stamen,ste,stem,stigma,stolo,straight,stripe,style,subglabrous,tall,tamen,tem,testal,thick,throughout,toward,truncate,tube,tuber,typically,unequal,unwinged,usually,vary,vein,wall,wet,white,whitish,wide,x,yellow,ympodial	bract,branching,calyx,colour,connective,form,fruiting,growth,heteromorphism,inflorescence,insertion,interpetalar,length,marking,mature,na,odour,one-quarter,orientation,paired,placement,position,prickle,pseudostipule,rhizome,scale,shape,spot,staman,stellate,stone,structure,symmetry,sympodial,texture,tissue,type
342	wfo-0001029789	success	167	109	74	93	35	0.443	0-2,0.2-0.5,0.8-3.5,1-3,1.7-8.5,12,2-25,2-6,2-6.5,2.7-4.7,3-8.5,4-10,4-13,5-7,6-7,7-16.6,7-21,8-9,anther,apex,blade,blue,chartaceous,clavate,cm,corolla,diameter,filament,flower,forked,fruit,glabrous,green,hair,herb,homostylous,interjected,lanceolate,lateral,leaf,leaflet,light,lilac,long,membranous,minute,mm,mottled,odd-pinnate,ovary,pair,pedicel,peduncle,pentagonal,petiole,plant,plurifoliate,pore,poricidal,pubescent,rachi,rotate,size,sparsely,star,stigma,style,subglabrous,terminal,tip,tri-,unit,white,x	0.5-2.8,1-10,1-2,1.5-2,1.8-6.5,2-3,3-5,5-merou,6,abaxially,acumen,acuminate,acute,adaxiall,adaxially,ag,alyx,apart,apparently,articulated,attenuate,axe,axillary,base,basiscopic,broadly,bud,capitat,connivent,dark,decreasing,decurrent,distal,dorsally,eaf,edge,eed,erec,exceeding,flat,folded,formed,geminat,generally,greatly,hal,half,lant,lengthening,like,linear,lobe,long-attenuate,lower,lunate,maturing,minutely,narrowly,never,nflorescence,orbicular,orolla,ovate,perfect,petiolulate,pubescen,purpl,rarely,sessile,seudostipule,short,side,simple,slightly,slit,spaced,stamen,ste,sterile,straight,subequal,subtending,tall,tamen,tem,tinged,toward,tube,typically,usually,vary,yellow,ympodial	arrangement,branching,breeding,calyx,capitate,cell,colour,connective,form,growth,height,heteromorphism,inflorescence,length,marking,modification,na,orientation,placement,prickle,pseudostipule,rhizome,shape,spot,staman,stem,stone,structure,symmetry,sympodial,system,texture,tuber,type,xylopodia
343	wfo-0001029810	success	149	101	50	99	51	0.336	1-1.5,1.5-3,3-3.5,acute,adaxially,anther,apex,apically,arachnoid,attenuate,base,berry,calyx,cm,corolla,dendritic,difoliate,elliptic,filament,fruiting,glabrous,globose,green,inflorescence,internodal,leaf,lobed,long,lower,margin,mm,narrowly,nearly,occasionally,opposite,pedicel,petiole,pointed,pore,shaped,shining,shrub,small,stem,surface,tear-drop,tree,trichome,unit,white	.25,.5,0.5-1,0.5-3,1-1.3,1-10,1-2,1-3,1.1-2.3,2-3,2-5,2.5-3,3-4,3-6,4-10,5-15-flowered,5-16,5-6,8-12,abaxially,acuminate,along,anthesi,ape,bark,brown,capitate,closely,compact,compressed,congested,conical,dark,deflexed,deltate,densely,dia,differing,drying,eaf,edicel,eed,ellipsoid,exserted,fleshy,free,geminat,glabrou,large,later,lateral,lenticel,less,like,lobe,lon,main,major,middle,minor,minutely,nflorescence,older,ovary,overlappin,ovoid-reniform,pale,papillo,papillose,pitted,planar,poricidal,portion,pubescent,reddish-brown,rest,ruit,scar,simple,size,slender,spaced,sparsely,stigma,style,tall,tan,tapering,tip,tub,tube,ud,vein,wide,widest,woody,yellowish,ympodial,young	0.25,appressed,articulation,bract,branching,breeding,broad-based,cell,colour,form,fruit,geminate,growth,hair,heteromorphism,inflated,insertion,interjected,interpetalar,leaflet,length,marking,mature,na,needle-like,odour,orientation,pattern,placement,position,prickle,pseudostipule,rhizome,scale,shape,smell,spot,staman,stone,structure,symmetry,sympodial,system,texture,tissue,tuber,type,vegetative,width,xylopodia,zygomorphy
344	wfo-0001029811	success	225	116	69	156	47	0.307	0,0.5-2,1.5-6,15-23,20-100,7-9,abaxially,andromonoecious,anther,apex,articulated,base,berry,calyx,cell,chartaceous,cm,connivent,cordate,cuneate,dark,densely,elongating,equal,erect,filament,fruit,fruiting,glabrous,glandular,hair,herb,inflated,lateral,leaf,length,lobed,long,lower,margin,marking,mature,maturity,mauve,mm,moderately,pedicel,pendulous,per,perpendicular,petiole,poricidal,prickle,prickly,shrub,simple,sometimes,sparsely,spherical,stellate,stellate-pubescent,stem,surface,tapering,tip,trichome,unbranched,unit,yellow	-3,-6,-merous,.5,/3,0-30,0-35,0.1-0.3,0.1-0.4,0.2,0.2-0.6,0.3-1,0.3-1.5,0.8-1.5,1,1-1.5,1-2.5,1-3,1.3-1.7,1.5-2.5,1/,1/2-2/3,1/3,1/3-2/3,10-22,13-20,15-50,2-2.5,2-5,2-5.5,2.5-3,2.8-3.2,3-5,3-5.5,3-7,3.5-4.5,4-8,4.5-5,5,5-11,5-17,5-40,5-9,6-12,7-18,8-12,8-18,abaxial,acicular,adaxial,alyx,apar,apart,apically,apparently,bark,blade,broad-deltate,brown,cream,diameter,discolorous,distal,distance,drying,eaf,eed,elongate,extending,eye,faint,fewer,flattened,flattened-reniform,flower,free,green,green-brow,hermaphrodite,heterostylous,infructescence,less,lobe,lobing,long-acuminat,long-styled,longer,lowermost,midpoint,midvein,minute,multangulate,naked,narrow-deltate,nflorescence,obtuse,often,older,one,open,orange-brown,orolla,oung,outline,ovate,pair,pale,peduncle,pericarp,pit,plant,plurifoliat,porrect,portion,prickl,primary,raised,ray,ruit,scandent,scar,secondary,sessile,short,short-styled,shorter,side,slightly,small,smooth,spaced,spreading,stalk,stalked,staminat,stout,straight,style,tamen,terete,tertiary,time,tube,unarmed,upper,usually,vary,vein,venation,visible,way,wide,woody,yellow-green,ympodial,young	appressed,articulation,bract,branching,breeding,broad-based,colour,connective,corolla,form,growth,heteromorphism,inflorescence,insertion,interjected,interpetalar,leaflet,modification,na,needle-like,odour,orientation,paired,pattern,placement,plurifoliate,position,pseudostipule,rhizome,scale,seed,shape,smell,spot,staman,stone,structure,symmetry,sympodial,system,texture,tissue,tuber,type,vegetative,xylopodia,zygomorphy
345	wfo-0001029978	invalid_json_followup	208	184	133	75	51	0.639	0.5-0.6,0.8,0.9-2.3,1-10,1-2,1.3-1.5,1.4-1.5,1.5-3.1,11-19,15-27,2-4,3-5,3.1-6.3,3.5-9.5,3.7-8.1,4-7,4.2-5.2,5,5-16.5,8-10,abaxially,adaxially,anther,asymmetrical,axillary,base,basiscopic,berry,blade,brownish,bud,cell,chartaceous,clavate,cm,coarsely,commonly,condition,conical,corolla,covering,dark,decreasing,diameter,distal,dorsally,drying,edge,especially,filament,finely,flat,flower,folded,forked,fresh,fruit,generally,glabrous,gradually,green,green-white,greenish,hair,half,herb,homostylous,interjected,lanceolate,lateral,leaf,leaflet,lengthening,less,light,like,long,make,margin,medium,membranous,middle,minute,minutely,mm,moniliform,mottled,mucilaginous,odd-pinnate,orbicular,ovate,ovoid,pedicel,peduncle,pentagonal,petiole,plant,pore,poricidal,puberulent,pubescent,purple,ripe,rotate,seed,sessile,side,simple,size,slit,stem,stigma,straight,style,subequal,subsessile,subtending,symmetrical,terminal,testal,thick,throughout,tip,tissue,toward,tuber,wall,wet,whitish,wide,wing,x,yellow	0.3-0.4,0.3-0.7,0.7-1.9,1.8-5,3-7,3.2-2.5,4-11,5-merou,acumen,acuminate,ag,along,alyx,apart,apex,apparently,arranged,articulated,attenuate,axe,bead,capitat,ciliate,connivent,darker,digestion,eaf,eed,elliptic,enzyme,erec,exceeding,fourt,geminat,glabrou,hair-like,honeycomb-shaped,larger,living,lobe,lower,midrib,multiple,narrow,necklace,nflorescence,orolla,pair,perfect,petiolule,plurifoliate,pubescen,ray,removed,ruit,secondary,semierect,seudostipule,slightly,spaced,sparsely,specimen,stamen,ste,stolon,tall,tamen,tem,tri-,tube,typically,unit,usually,vary,ympodial	'',[,\u201chair-like\u201d,``,age,appressed,arrangement,articulation,bract,branching,breeding,calyx,capitate,characteristic,ciliation,colour,connective,form,fourth,fruiting,growth,height,inflated,inflorescence,interpetalar,length,marking,mature,modification,na,number,odour,ovary,pattern,position,pseudostipule,scale,shape,smell,spacing,spot,symmetry,system,texture,trichome,type,value,vegetative,width,{,}
346	wfo-0001029980	success	173	102	72	101	30	0.416	.1,0.1-0.25,0.25-0.5,0.25-1,0.5-1,0.5-2.5,0.5-5,0.7-1.3,1-1.5,1-1.7,1.2-2.5,2-5,2/3,5-50-flowered,acute,anther,apex,appressed,base,berry,black,calyx,cm,conical,corolla,decurrent,deltoid,dia,difoliate,drying,elliptic,filament,flattened-reniform,fruiting,glabrous,globose,green,greenish-white,leaf,lobe,lobed,long,mm,often,onto,opposite,ovate,pale,pedicel,petiole,plant,pore,rounded,shape,shaped,shrub,slender,slightly,somewhat,tan,tapering,tear-drop,trichome,tube,tuft,unicellular,uniseriate,unit,way,white,winged,x	.5,0.5-1.2,0.8-1.2,0.9-4.5,1.5-2,1.5-6,2-6,3-4,3-9,5-10,6.4-17,abaxially,adaxially,anthesi,apar,appearing,axil,ba,bark,bright,brown,bud,closely,curved,dark,deflexed,density,differing,dried,eaf,edicel,eed,elevation,especially,exserted,five,free,geminat,gray,greatly,high,impressed,incrassate,knob,lateral,live,lon,lower,main,major,margin,material,middle,minor,minutely,near,nflorescence,node,older,one,orbicular,ovary,overlapping,pair,paler,papillose,pitted,poricidal,portion,prominent,proximal,puberulent,race,reflexed,ruit,scar,shiny,side,simple,size,small-capitate,soon,spaced,specimen,stem,stigma,straight,style,surface,tall,tip,ud,varying,vein,venezuelan,whit,widest,woody,yellowish,ympodial,young	abaxial,cell,colour,flower,form,fruit,geminate,growth,hair,height,heteromorphism,inflorescence,length,na,odour,orientation,placement,position,prickle,rhizome,seed,staman,stone,structure,symmetry,sympodial,texture,tuber,type,xylopodia
347	wfo-0001029989	success	161	106	55	106	51	0.342	.2,1-2,1-2.5,3-5,acute,adaxially,anther,apex,base,berry,branched,calyx,cm,congested,conical,corolla,dendritic,densely,difoliate,elliptic,filament,fruiting,glabrous,globose,golden,green,greenish-black,inflorescence,internodal,leaf,lobed,long,lower,margin,mm,nearly,occasionally,opposite,pedicel,petiole,pore,shaped,shining,shrub,simple,small,stem,surface,tear-drop,tree,tree-like,trichome,unifoliate,unit,white	.5,/2,0.25-0.5,0.5-1,0.5-1.5,1-1.5,1-4,1.3-2.3,1.5-2.5,10-14,2.5-3,3-8,3.5-8,4-4.5,5-10-flowered,5-6,7-20,abaxial,abaxially,anthesi,bark,branch,broadly,brownish-re,capitate,central,closely,collection,deflexed,deltoid,dense,described,dia,dimaeter,discussion,drying,due,eaf,edicel,eed,erect,exserted,flattened,fleshy,free,geminat,gray,heteromorphic,incrassate,inflorescenc,lamina,lateral,lenticular,like,lobe,lon,main,middle,minutely,nflorescence,nodding,northern,older,ovary,overlappin,pair,papillo,peru,peruvian,perÃº,petal,petaloid,pitted,planar,population,poricidal,portion,probably,pubescence,pubescent,reddish,reddish-brown,rest,ruit,scar,scattered,see,short-style,somewhat,spaced,sparsely,stigma,style,tall,tip,tube,ud,vein,way,wide,widest,woody,x,yellow,ympodial,young	appressed,articulation,bract,branching,breeding,broad-based,cell,colour,form,fruit,growth,hair,heteromorphism,inflated,insertion,interjected,interpetalar,leaflet,length,marking,mature,na,needle-like,odour,orientation,paired,pattern,placement,position,prickle,pseudostipule,rhizome,scale,shape,smell,spot,staman,stone,structure,symmetry,sympodial,system,texture,tissue,tuber,type,vegetative,width,xylopodia,ye,zygomorphy
348	wfo-0001030000	invalid_json_followup	155	175	112	43	63	0.723	-4,-5,-50,-7,0.5-1,0.5-14,0.5-3,1-10,1-2,1.5-,1.5-2,10-20,15-25,2-2.5,2-5,2.5-,25-30,3-16,3-4,3.5-5,30-50,4,4-4.5,4-5,abaxially,absent,acute,adaxially,also,apart,apex,apiculate,articulated,base,calyx,chartaceous,cm,connective,connivent,coriaceous,deltate,densely,dia,diameter,dilated,directed,distally,eglandular,ellipsoidal,equal,exceeding,flattened,flower,fruit,glabrous,globose,green,hair,immature,laterally,lobe,long,margin,mature,mm,moderately,narrowly,oblong,obtuse,occasionally,orange,ovoid,pedicel,peduncle,perfect,pilose,pore,produced,puberulent,pubescent,purplish,rachi,radiu,rarely,shorter,shrub,slightly,small,sparsely,spotted,stellate,stigma,strongly,style,subcoriaceous,swelling,thecae,tinge,tip,tomentose,tree,triangular,truncate,umbrella-shaped,unbranched,unit,white,wide,x,yellow,yellow-brown,yellowish	-pilose,0.5-,1,1-,10-,2-3,2-4,2.5-3,2.5-3.5,3-,4-foliat,7-15,aggregate,ape,axe,biglandula,cell,ciliat,conspicuous,creamy-whit,cucullate,eed,leaving,lon,lower,nflorescence,nther,orolla,pedicellar,pubescen,remnant,ruit,scar,smal,spaced,stamen,stone,tal,tem,tube,ud,vary,ympodial	'',4-foliate,[,``,abaxial,adaxial,anther,appressed,artic,articulation,biglandular,bract,branching,breeding,bud,characteristic,ciliate,colour,corolla,creamy-white,filament,form,fruiting,growth,height,inflated,inflorescence,interjected,interpetalar,leaf,leaflet,length,marking,modification,na,number,odour,ovary,paired,pattern,plant,position,scale,seed,shape,smell,spacing,spot,stem,structure,symmetry,sympodial,system,texture,theca,tissue,trichome,type,value,vegetative,zygomorphy,{,}
349	wfo-0001030000	success	178	156	108	70	48	0.607	-5,-50,-7,-pilose,0.5-,0.5-1,0.5-13,0.5-14,0.5-3,1,1-10,1-2,1-5,1.5-,1.5-2,15-25,2-2.5,2-5,2.5-,2.5-3.5,25-30,3-,3-16,4,4-4.5,4-5,abaxially,acuminate,acute,also,apex,apiculate,articulated,basal,base,calyx,cell,cm,connective,conspicuous,cordate,deltate,densely,dia,diameter,dilated,directed,distally,eglandular,ellipsoidal,entire,fruit,glabrescent,glabrous,globose,green,hair,immature,laterally,leaving,lobe,long,margin,mature,mm,moderately,oblique,oblong,obtuse,occasionally,often,orange,ovate,ovoid,pedicel,pedicellar,peduncle,petiole,pilose,pore,puberulent,purplish,rachi,radiu,remnant,scar,shrub,simple,small,sparsely,spotted,stellate,stigma,stone,strongly,style,subcoriaceous,tinge,tip,tree,truncate,umbrella-shaped,unbranched,unit,white,x,yellow,yellow-brown	-2,-4,1-,1-1.5,10-,10-20,2-,2-3,2-4,2.5-3,3-4,3.5-5,30-50,4-25,4-foliat,5-25,7-15,absent,adaxially,aggregate,apart,ape,axe,biglandula,blade,chartaceous,ciliat,connivent,coriaceous,creamy-whit,cucullate,eaf,eed,elliptic,equal,exceeding,flattened,flower,lon,lower,narrowly,nflorescence,nther,orolla,perfect,pilo,produced,pubescen,pubescent,rarely,ruit,shorter,slightly,smal,spaced,stamen,swelling,tal,tem,thecae,time,tomentose,triangular,tube,ud,vary,vein,wide,yellowish,ympodial	4-foliate,abaxial,adaxial,anther,arrangement,articulation,biglandular,bract,branching,bud,colour,corolla,form,fruiting,growth,height,heteromorphism,inflorescence,interjected,interpetalar,leaf,leaflet,length,marking,na,odour,orientation,ovary,placement,plant,position,prickle,pseudostipule,rhizome,scale,shape,size,spot,staman,stem,structure,symmetry,sympodial,texture,tissue,tuber,type,xylopodia
350	wfo-0001030004	success	177	152	96	81	56	0.542	0-0.5,0-1.5,0.2-1,0.8-1.1,1-1.5,1-2,1.2-2,1.5-2.5,15,2-20,3-3.5,3-4,3.5-5,4-15,5-25,9-30,across,acute,adaxially,anther,apex,bark,base,branched,branching,calyx,capitate,cm,corolla,crotaloid,dendritic,densely,dia,elliptic,exserted,filament,flattened-reniform,fleshy,fruiting,glabrous,globose,green,incrassate,inflorescence,later,lateral,leaf,lobed,long,loose,lower,many,margin,minutely,mm,nearly,obovate,obovoid,occasionally,onto,ovary,pale,pedicel,petiole,plant,plurifoliate,pore,prominent,pubescence,pubescent,scar,seed,sessile,shaped,shrub,small,sparsely,stem,stigma,strongly,style,surface,tan,tear-drop,terminal,time,translucent,tree,trichome,tube,variously,white,wide,winged,x,yellowish-green	.3,0.3-1,15-20,20-200-flowered,abaxial,abaxially,acuminate,along,always,anthesi,apar,appearanc,axillary,barely,basal,berry,blade,body,broadly,bushy,collection,cone,conical,decurrent,deltate,dense,denser,diamete,distal,drying,eaf,edicel,eed,erect,especially,flat,free,giving,greenish-yello,hard,juvenile,knob,lamina,large,like,lobe,main,middle,much,nflorescence,often,older,pair,papillate,papillo,pericarp,pitted,planar,poricidal,portion,possessing,rest,ruit,simple,spaced,stout,surpassing,tall,thick,thin,tip,tub,tuft,ud,unevenly,vein,widest,woody,yellowish,ympodia,young	apart,articulation,bract,breeding,broad-based,bud,cell,colour,connective,diameter,exsertion,form,fruit,greenish-yellow,growth,hair,height,heteromorphism,insertion,interjected,interpetalar,leaflet,length,marking,modification,na,needle-like,odour,orientation,papillose,pattern,placement,position,prickle,pseudostipule,rhizome,scale,shape,size,smell,spacing,spot,staman,stone,structure,symmetry,sympodial,system,texture,tissue,tuber,type,unit,vegetative,width,xylopodia
351	wfo-0001030007	invalid_json_followup	168	162	120	48	42	0.714	.05,.4,.5,0.1-0.5,0.2-1,0.8-1,1-1.5,1-15,1-2,1.5-5,1.6-2.2,15-20,2-4,2-7,3-5,3/4,4.5-5,7-10,7-9,acuminate,acute,along,anther,anthesi,apart,apex,base,becoming,beneath,berry,branched,bud,calyx,campanulate,clavate,closely,cm,corolla,densely,dia,dry,elliptic,erect,exserted,filament,fleshy,fruiting,glabrate,glabrous,globose,golden,golden-pubescent,green,lateral,leaf,like,live,lobed,long,longer,main,major,margin,material,middle,midrib,minor,minutely,mm,oblique,obovoid,occasionally,older,one,onto,opposite,outline,ovary,pair,papillose,pedicel,petiole,plant,pore,poricidal,pubescent,raised,rest,rounded,scar,shaped,short,shrub,simple,slightly,small,soft,soon,spaced,sparsely,stem,stigma,style,tear-drop,thick,tip,tree,trichome,tube,two,type,uniseriate,vein,way,white,widest,winged,woody,x,young	0.5-1,6-10-flowered,abrupt,ba,bark,broadly,brown,cork,dark,decurrent,deltoid,difoliate,edicel,eed,flattened,free,geminateleaf,gre,hooded,impressed,incrassate,inflorescenc,lobe,lon,lower,nflorescence,pale,papillo,pitted,planar,portion,prominent,reniform,ruit,shorter,slender,specimen,straight,surface,tall,tapering,thickened,trunk,tub,ud,unit,widening,ympodial	'',[,``,bract,branching,breeding,characteristic,colour,connective,corky,development,form,fruit,growth,hair,height,inflorescence,interjected,interpetalar,leaflet,length,marking,mature,modification,na,odour,pattern,position,scale,shape,size,smell,spot,symmetry,system,texture,tissue,value,vegetative,zygomorphy,{,}
352	wfo-0001030010	success	156	95	77	79	18	0.494	.5,.75,/4,0.5-5,0.7-1,0.9-1.1,1-1.3,1-1.5,1.2-1.5,1.5-2,10-15,10-50-flowered,2-7,2.5,20-40,4-4.5,5-7,anther,anthesi,area,attenuate,base,calyx,cm,corolla,cyathiform,deciduous,dia,filament,fleshy,fruit,fruiting,furcate,glabrous,globose,green,leaf,lobe,lobed,long,minor,minutely,mm,nearly,obovate,often,opposite,ovary,ovoid-reniform,papillose,pedicel,persistent,petiole,pitted,planar,pore,puberulent,reddish,shaped,shrub,simple,size,small,smooth,soon,stigma,style,surface,tear-drop,tiny,tree,trichome,tube,way,white,woody,x	1-2,11-12,2-2.2,3-5,7-10,acuminate,acute,apex,appearing,bark,basal,beneath,berry,brown,bud,closely,dark,decurrent,deflexed,deltate,differing,difoliate,distal,dry,eaf,edicel,eed,ellipsoid,exserted,f,free,geminat,glabrate,grey,hooded,lateral,lon,lower,m.,main,major,margin,materia,material,middle,midrib,minute,near,nflorescence,occasionally,older,one,orange,overlappin,pair,poricidal,portion,prominent,rather,ruit,scar,shin,slightly,spaced,stem,straight,styl,tall,tapering,tip,trunk,ud,uniseriate,unit,vein,widest,winged,ympodial,young	branching,colour,count,diameter,flower,form,growth,hair,height,inflorescence,length,persistence,plant,position,seed,shape,symmetry,texture
353	wfo-0001030023	invalid_json_followup	171	162	91	80	71	0.532	0.5-1,1,1-8,1.5-7,10-25,2-3,2.5-3.5,20-30,3-4.5,3-5,4,4-12,5-6,6-7,7-9,acute,adaxially,apex,articulated,base,branched,calyx,cm,connective,connivent,cordate,cuneate,cylindrical,deeply,densely,diameter,dilated,directed,distally,ellipsoidal,elliptic,entire,especially,finely,flattened,fruit,glabrous,glandular-puberulent,globose,greenish-white,hair,highly,lanceolate,leaving,long,loosely,lower,margin,membranaceous,mm,moderately,narrowly,near,oblique,oblong,occasionally,often,ovate,pedicel,pedicellar,peduncle,peltiform,perfect,petiole,pore,puberulent,pubescent,purplish-,rachi,radiu,remnant,short-acuminate,simple,somewhat,sparsely,stellate,stigma,style,subcoriaceous,tree,triangular,truncate,unit,x,yellowish,young	-,0-100+,1-,1-2,1.5-2,10-,11-40+,12-18,13-20,2,30-50+,4-10,4-foliat,5,5-,5-16,6-26,abaxially,aggregate,apart,ape,apiculate,axe,basal,beyond,blade,capitat,cell,ciliate,color,denser,eaf,eed,exceeding,except,exserted,fleshy,flower,forked,glandular-puberulen,lobe,lon,main,narrow,nflorescence,nther,obtuse,orolla,presen,present,probably,prominent,pubescen,pubescence,pubescent-pilo,ripe,ruit,shorter,slightly,small,spaced,stamen,stone,swelling,tal,tem,thecae,time,tip,tube,ud,unbranched,unknow,unknown,usually,vary,vein,villous,wide,ympodial	'',10-50+,4-foliate,5-40+,[,``,abaxial,adaxial,anther,appressed,articulation,bract,branching,breeding,broad-based,bud,capitate,characteristic,colour,corolla,filament,form,fruiting,growth,height,inflated,inflorescence,insertion,interjected,interpetalar,leaf,leaflet,length,marking,mature,modification,na,needle-like,odour,orientation,ovary,paired,pattern,placement,plant,position,prickle,pseudostipule,pubescent-pilose,scale,seed,shape,size,smell,spot,stem,structure,surface,symmetry,sympodial,system,texture,theca,tissue,trichome,type,value,vegetative,zygomorphy,{,}
354	wfo-0001030032	success	250	113	70	180	43	0.28	0.4-1.5,0.5-0.6,0.5-1.5,1.5-2,2-3-locular,2-4,3-5,4-5,5-plurifoliate,7-16,anther,apex,articulated,articulation,base,basiscopically,branched,breaking,bright,calyx,cell,cm,completely,corolla,decurrent,deltate,densely,filament,fruit,fruiting,glabrous,golden,green,imparipinnate,interjected,interrupted,irregularly,leaf,leaflet,length,long,lower,many,margin,middle,mm,oblique,pair,pedicel,petiole,pseudostipule,pubescent,reflexed,rotate,rotate-stellate,simple,slightly,splitting,stem,surface,thickened,time,trichome,truncate,uniseriate,unit,vine,wide,woody,yellow	+,.05,.5,0.1-0.4,0.1-0.5,0.2,0.2-0.3,0.2-0.5,0.25-0.4,0.5,0.5-0.7,0.5-1,0.5-2,0.6-1.1,0.7-0.8,0.8-1.0,0.8-1.1,1-1.3,1-1.5,1-2-celled,1-3,1-celled,1.5-2.5,11-20,13-35,2,2-10,2-3.5,2-5,2-60,2-lobed,2.4-3.5,3,3.0-3.5,3.5-12,30,4-6-celled,4-celled,4.3-5.0,6-11,60-80,7.5-10,8-10,8-10-celled,8-20,abaxially,absent,abundant,acuminate,acute,adaxial,adaxially,along,also,anthesi,apical,appearance,appendage,basal,basally,bent,border,branche,brown,capitate,clambering,column,conical,conspicuou,dark,densest,desne,diameter,dry,eaf,ebracteate,edicel,eed,elliptic,entire,exserted,flower,free,give,glandular,gree,greenish-brown,hair-like,halfway,hea,head,herbarium,internode,lamina,large,larger,lateral,leave,like,lobe,longest,markedly,midvein,mixed,moderately,much,multicellular,nflorescence,node,oblanceolate,obovate,occasionally,often,older,onto,opposite,orbicular,outgrowth,ovary,pale,paler,patent,peduncle,petiolule,pithy,present,primary,pubescence,rachi,rest,rough,round,ruit,secondary,seed,set,shorter,silky,smaller,soft,sometimes,somewhat,sparsely,sparser,specimen,spreading,stamen,staminal,sterile,stigma,straight,style,subopposite,swollen,tall,tangled,tem,terminal,tertiary,testa,thick,tiny,tip,touch,transparent,tube,ud,unicellular,usually,vegetatio,vein,venation,wall,weaker-walled,well-developed,white,winged,ympodial,younger,Â½-3/4	appressed,bract,branching,breeding,broad-based,colour,form,growth,hair,heteromorphism,inflated,inflorescence,insertion,interpetalar,marking,mature,na,needle-like,odour,orientation,paired,pattern,placement,position,prickle,rhizome,scale,shape,smell,spot,staman,stone,structure,symmetry,sympodial,system,texture,tissue,tuber,type,vegetative,xylopodia,zygomorphy
355	wfo-0001030048	success	156	124	81	75	43	0.519	0.5-1.5,1-2,1.3-1.6,1.5-3.5,2-3,2-5,3-3.5,3-5,4-4.5,5-8,abaxial,acute,anther,apex,apically,arachnoid,bark,base,berry,bi-colored,bi-lobed,blue,calyx,clavate,cm,conical,corolla,decurrent,densely,difoliate,elliptic,felt-like,filament,fleshy,fruiting,glabrate,glabrous,globose,green,greyish,internodal,leaf,lightly,lobed,margin,matted,minutely,mm,nearly,onto,opposite,ovary,ovoid-reniform,pale,papillose,pedicel,petiole,pitted,pointed,pore,pubescent,reddish-brown,shaped,shiny,shrub,simple,small,somewhat,sparsely,stem,stigma,strongly,style,tan,tear-drop,tree,trichome,trifoliate,tube,unit,white	.5,1-1.5,1.2-2,1.5-7,10-16,4-15,5-10-flowered,5973,abaxially,adaxially,along,anthesi,ape,apparently,becoming,broadly,brown,closely,completely,covered,deflexed,deltate,dia,drying,eaf,edicel,eed,ellipsoid,exserted,fide,four-angle,free,geminat,golden,impressed,inflorescenc,lamina,lateral,like,lobe,lon,long,lower,main,middle,nflorescence,occasionally,older,overlappin,pair,papillo,planar,poricidal,portion,prominent,rather,rest,ruit,scar,solomon,spaced,surface,tall,thick,thickened,tip,tub,ud,vein,wide,widest,woody,yellowish,ympodial,young	0.5,1,1.5,adaxial,angle,articulation,branching,cell,colour,diameter,form,four-angled,fruit,geminate,growth,hair,height,heteromorphism,inflorescence,insertion,length,na,odour,orientation,paired,placement,plant,position,prickle,pseudostipule,rhizome,seed,shape,staman,stone,structure,symmetry,sympodial,texture,tuber,type,width,xylopodia
356	wfo-0001030053	success	141	84	35	106	49	0.248	1.3-3.5,apex,base,berry,branched,brown,calyx,cell,cm,completely,coriaceous,corolla,decurrent,fruiting,glabrous,growth,inflorescence,many,margin,pale,pedicel,perfect,petiole,simple,sleeve,slightly,small,terminal,time,truncate,unit,vine,white,woody,yellowish	0.5,0.5-1,1-1.3,1-13,1.5-5.5,1.8-2,10-20,100,2-2.5,2.5-3,3.5-4,4-,5,5-merou,7-11,7-9,<,abruptly,abscission,acuminate,acute,aiding,alyx,anthesi,apart,apical,apiculae,ark,around,articulated,bfeore,branch,climbin,cyathiform,diameter,eaf,eed,elliptic,entire,exserted,far,fide,filiform,fine,flattened,flower,fragrant,frui,greenish,hyaline,irregularly,leaving,lobe,lobed,long,lower,mentz,minutely,mm,near,new,nflorescence,nipple,older,orolla,pair,papilla,papillo,parallel,peduncle,peg,pendant,per,pitted,plurifoliat,primary,rectangular,reniform,revolute,rim,scar,secondary,shallowly,shin,shining,shiny,spaced,spreadin,spreading,stem,strongly,support,surface,tem,testal,tiny,tip,tube,turbinate,twining,ud,usually,vein,venation,x,ympodial	anther,appressed,articulation,bract,branching,breeding,colour,connective,filament,form,fruit,hair,heteromorphism,inflated,insertion,interjected,interpetalar,leaf,leaflet,length,marking,mature,modification,na,odour,orientation,paired,pattern,placement,plurifoliate,pore,position,prickle,pseudostipule,rhizome,scale,shape,spot,staman,stone,structure,symmetry,sympodial,system,texture,tissue,tuber,type,xylopodia
357	wfo-0001030057	success	141	115	94	47	21	0.667	-2,1-10,1-2,2-3-celled,2-4,2-4.5,2-6,20-30,20-80,3-5,3.5-8,4-10,5.5-12,7-14,8,8-19,abaxially,absent,adaxially,apart,axillary,base,blade,broadly,brownish,bud,cell,chartaceous,cm,condition,covering,decreasing,diameter,distal,drying,elliptic,extremely,flower,forked,fresh,fruit,generally,globose,greatly,green,green-white,greenish,hair,hair-like,half,herb,high,interjected,lateral,leaf,leaflet,like,long,lunate,make,membranous,mm,mottled,mucilaginous,odd-pinnate,ovate,ovoid,pedicel,peduncle,petiole,petiolule,plant,pubescent,purple,scale-like,seed,short,size,small,stem,subglabrous,suborbicular,subtending,terminal,testal,thick,throughout,toward,tuber,usually,wall,wet,whitish,x	2.1-4.1,4.3-8.2,acuminate,acute,apex,apparently,articulated,axe,berry,borne,cordate,cuneate,digestion,eaf,eed,end,enzyme,erec,geminat,glabrou,honeycomb-shaped,larger,living,narrow,nflorescence,pair,perfect,plurifoliate,removed,ruit,seudostipule,singly,sometimes,spaced,specimen,ste,stolo,tall,tem,thir,tri-,truncate,typically,unit,unwinged,wing,ympodial	arrangement,articulation,branching,colour,form,glabrous,growth,height,inflorescence,length,number,pattern,position,presence,present,pseudostipule,shape,spacing,texture,third,type
358	wfo-0001030057	success	197	151	123	74	28	0.624	.5-3.5,1-10,1-2,2-3-celled,2-4,2-4.5,2-6,20-30,20-80,3-5,3.5-8,4-10,5-10,5-6,5.5-12,7-14,8,8-19,abaxially,absent,adaxially,anther,apart,articulated,axillary,base,berry,blade,borne,brownish,bud,cell,chartaceous,cm,condition,connivent,corolla,covering,decreasing,diameter,distal,drying,end,extremely,filament,flower,forked,fresh,fruit,generally,globose,greatly,green,green-white,greenish,greenish-yellow,hair,hair-like,half,herb,high,homostylous,interjected,lanceolate,lateral,leaf,leaflet,lengthening,like,linear,lobe,long,lunate,make,membranous,middle,mm,mottled,mucilaginous,narrow,odd-pinnate,ovate-lanceolate,ovoid,pedicel,peduncle,pentagonal,petal,petiole,petiolule,plant,pore,poricidal,pubescent,purple,rotate,scale-like,seed,short,singly,size,slit,small,star,stem,striped,subglabrous,subtending,terminal,testal,thick,throughout,tip,toward,tube,tuber,typically,unwinged,usually,wall,wet,whitish,wing,x	-10,-2,2-3,2-5,2.1-4.1,4.3-8.2,5-merou,acumen,acuminate,acute,ag,along,alyx,apex,apparently,axe,broadly,ciliate,cordate,cuneate,digestion,dorsally,eaf,edge,eed,elliptic,enzyme,erec,especially,exceeding,flat,folded,geminat,glabrou,glabrous,globo,honeycomb-shaped,larger,living,lower,margin,midrib,minutely,nflorescence,orolla,ovate,pair,perfect,plurifoliate,puberulent,removed,ruit,seudostipule,sometimes,spaced,specimen,stamen,ste,stigma,stolo,straight,style,suborbicular,tall,tamen,tem,thir,tri-,truncate,unit,vary,white,yellow,ympodial	age,arrangement,articulation,branching,calyx,colour,connective,form,growth,height,inflorescence,length,marking,modification,pattern,position,presence,pseudostipule,shape,spacing,spot,stellate,stolon,symmetry,texture,third,type,zygomorphy
359	wfo-0001030080	success	186	97	78	108	19	0.419	0.3-7,0.4-1.5,0.5-4,1.5-2,1.5-2.5,1.8-4.5,2-4,2.1-7.1,4-12,4-7,5-13.5,5-7,5.5-9.9,6.5-18.6,8-16,8-23,9.9-33,acuminate,anther,apex,blade,cell,cm,coriaceous,corolla,dark,diameter,distal,elliptic,flower,forked,fruit,glabrous,green,greenish,half,herb,high,homostylous,honeycomb-shaped,lanceolate,lateral,leaf,leaflet,light,lobe,mm,moniliform,mottled,mucilaginous,odd-pinnate,ovate,ovoid,pair,pedicel,peduncle,petiole,plant,pore,poricidal,purple,pyriform,seed,size,stellate,strongly,style,terminal,testal,throughout,tip,tube,tuber,wet,white,whitish,winged,x	1-2,1-3,1999,2-3,3-10,3-5,3.3-7.7,5-merou,abaxiall,abaxially,absent,acumen,adaxially,ag,along,alyx,apart,apparently,arranged,articulated,axe,axillary,base,bead,berry,brownish,bud,capitat,ccording,clavate,condition,connivent,covering,cuneate,decreasing,decurrent,digestion,dorsally,dot,drying,eaf,edge,eed,enzyme,erec,exceeding,filament,flat,folded,fresh,geminat,generally,glabrescent,glabrou,green-white,hair,hair-like,hal,inconspicuous,interjected,larger,lengthening,like,linear,living,long,lower,make,medium,multiple,necklace,nflorescence,ochoa,onto,orolla,perfect,plurifoliate,rachi,removed,second,seudostipule,slightly,slit,sometimes,spaced,specimen,stamen,stigma,stolon,straight,subequal,subtending,tall,tamen,tem,thick,tiny,toward,tri-,typically,unit,unknown,usually,vary,wall,width,yellow,ympodial	abaxial,adaxial,arrangement,articulation,branching,calyx,colour,form,growth,height,inflorescence,length,number,ovary,position,pseudostipule,shape,stem,texture
360	wfo-0001030081	invalid_json_followup	157	153	91	66	62	0.58	.5,0.5-1,0.5-1.5,0.5-2.5,1,1-2-celled,1-4,1.5,1.5-3,10-20,10-35,1st,2-4,2-foliate,2nd,3-10,4-6,5-12,5-15,abundant,acute,along,anther,apex,apically,base,berry,blade,brown,calyx,cell,center,chartaceous,ciliate,cm,densely,denser,diameter,dm,drying,edge,elliptic,elliptic-ovoid,entire,few-branched,filament,fine,flat,flower,fruit,geniculate,glabrous,globose,hair,herb,immature,interpetalar,lower,lying,margin,maturing,membranaceous,mm,oblong,obtuse,parallel,pedicel,per,petiole,pointing,pubescent,radiating,raised,ridge,rotate,rounded,running,semitransparent,shallow,single-,sparsely,style,surface,tissue,two-celled,unbranched,usually,vein,white,x,yellow	0.25-0.5,1-2,1-3,1-5,1.5-7,2-7,3-6,abaxially,absent,adaxiall,adaxially,axe,beyond,connected,cordate,decurrent,dehiscing,eaf,eed,emarginat,equal,explosively,exserted,frui,geminat,held,linear-lanceolate,lobe,long,longer,maturit,mesocarp,moderately,nearly,nfloresence,notch,often,one,orolla,other,peduncle,placenta,pressure,pubescen,rachi,rarely,ruit,short,slightly,small,sometimes,stamen,stigma,straight,swollen,tal,tamen,tem,triangular,tube,unit,vary,watery,wid,woody,ympodial	'',[,``,appressed,arrangement,articulation,bract,branching,breeding,broad-based,characteristic,colour,connective,corolla,decument,form,fruiting,geminate,growth,height,inflated,inflorescence,insertion,interjected,leaf,leaflet,length,marking,mature,modification,na,needle-like,number,odour,orientation,ovary,paired,pattern,placement,plant,pore,position,prickle,scale,seed,shape,simple,smell,spot,staman,stem,symmetry,system,texture,trichome,type,unknown,value,vegetative,zygomorphy,{,}
361	wfo-0001030083	success	146	96	47	99	49	0.322	0.8-3,1-1.5,1.5-3,3/4,accrescent,acute,anther,apex,base,berry,calyx,cm,corolla,elliptic,fruit,fruiting,glabrous,globose,green,greenish-white,internodal,leaf,lobed,long,membranous,minutely,mm,narrowly,opposite,ovate,pedicel,petiole,pore,poricidal,red-papillose,shaped,shrub,somewhat,tear-drop,thin,tip,unit,way,white,winged,woody,x	.5,.75,0.1,0.25-0.5,0.5-1,0.5-2,0.8-1,1-2,10-30,2,2-3,2-5-flowered,3-4,4-15,4-6,9-11,anthesi,bark,beginning,broadly,closely,cup-shaped,dar,deciduous,decurrent,deeply,deflexed,deltoid,dia,dry,drying,eaf,edicel,eed,elongate,exserted,fleshy,flower,greyish-re,hyaline,inflorescenc,lateral,lobe,lon,long-acuminate,long-styled,lower,main,middle,near,nflorescence,older,onto,ovary,overlapping,ovoid-reniform,pair,pale,paler,papillae,papillose,pitted,prominent,proximal,raised,reddish-gold,reflexed,ruit,scar,shallowly,short-styled,simple,single-stemmed,slender,slightly,small-capitate,soon,spaced,specimen,stem,stigma,straight,strongly,style,surface,tall,tan,tapering,terminal,thickened,translucent,tub,tube,ud,unifoliat,vein,widest,ympodial,young	appressed,articulation,bract,branching,breeding,cell,colour,connective,filament,form,growth,hair,heteromorphism,inflated,inflorescence,insertion,interjected,interpetalar,leaflet,length,margin,marking,mature,modification,na,odour,orientation,paired,pattern,placement,position,prickle,pseudostipule,rhizome,scale,shape,spot,staman,stone,structure,symmetry,sympodial,system,texture,tissue,tuber,type,unifoliate,xylopodia
362	wfo-0001030093	success	181	156	100	81	56	0.552	.5,0.1-0.3,0.2-0.5,0.5-1.1,0.75-1,1-1.5,1-12,1-5,1.3-4.5,2-2.5,2.5-11,3-4,4-6,5-50-flowered,acuminate,acute,anther,anthesi,apex,attenuate,bark,base,beneath,branched,calyx,campanulate,clavate,cm,corolla,cuneate,densely,difoliate,elliptic,erect,expanded,filament,flower,fruiting,furcate,glabrous,globose,golden,green,greenish-white,growth,hirsutulous,leaf,lobed,long-styled,lower,many,minor,minutely,mm,narrowly,nearly,obovate,occasionally,often,opposite,ovary,ovoid-reniform,pedicel,petiole,pitted,plant,pore,poricidal,present,puberulent,pubescent,shaped,shiny,short-styled,shrub,simple,size,slender,slightly,small,stem,stigma,style,surface,tapering,tear-drop,terminal,time,tiny,tip,tree,trichome,tube,underside,uniseriate,unit,vein,white,woody,x	.2,0,0.2,0.2-1,0.6-1.5,3.5-12,5-8,7-30,7-9,8-9,apar,becoming,berry,brownish-tan,case,closely,collection,commonly,continues,deflexed,deltoid,dia,differing,eaf,edicel,eed,ellipsoid,especially,evenly,except,exserted,forest,free,geminat,greyish-brow,guyanese,hyaline,impressed,inundated,lateral,like,lobe,lon,long,main,major,margin,member,middle,new,nflorescence,older,one,onto,open,orbicular,pair,pale,paler,papillo,persisting,population,portion,quite,reflexed,remaining,ruit,scar,shoot,soon,southern,spaced,straight,tall,thickened,tub,ud,widest,yellowish,ympodial,young	appressed,articulation,bract,branching,breeding,broad-based,cell,colour,connective,form,fruit,geminate,greyish-brown,hair,height,heteromorphism,inflated,inflorescence,insertion,interjected,interpetalar,leaflet,length,marking,mature,modification,na,needle-like,number,odour,orientation,papillose,placement,position,prickle,pseudostipule,rhizome,scale,seed,shape,smell,spot,staman,stellate,stone,structure,symmetry,sympodial,system,texture,tissue,tuber,type,vegetative,xylopodia,zygomorphy
363	wfo-0001030145	invalid_json_followup	153	163	111	42	52	0.725	-3,0.2-2,0.3-,0.5,0.5-1,0.5-4,1,1-1.5,1-2,1-2.5,1-3,1-5,1.5,1.5-2,1.5-4.5,1.5-7,10-12,2-3,2-4,2.5-6.5,3,3-10,3-4,3-5,4-5,4-8,6-40,8-11,abaxially,acute,adaxially,adpressed,aggregate,also,apart,apex,basal,base,calyx,campanulate,cell,chartaceous,cm,compound,connective,cuneate,cylindrical,deltate,densely,diameter,directed,distally,ellipsoidal,elliptic-ovate,entire,exceeding,fleshy,flower,forked,fruit,glabrous,glandular,globose,hair,herb,lanceolate,leaf,leaflet,leaving,less,lobe,long,margin,mm,moderately,narrowly,near,obtuse,ovate-elliptic,pedicel,pedicellar,peduncle,petiole,pilose,pore,puberulent,rachi,radiu,reddish,remnant,shorter,shrub,simple,sinuate,slightly,somewhat,sparsely,stigma,stone,style,subcordate,subcoriaceous,ternately,thecae,triangular,truncate,tube,unbranched,unknown,violet,x	-2,4-foliat,absent,ape,articulated,axe,beyond,blade,color,dunal,eaf,eed,elliptic,exserted,fide,larger,lateral,lon,lower,nflorescence,nther,orolla,presen,puberulen,ripe,ruit,slender,spaced,stamen,tal,tem,terminal,time,tomento,toward,truncat,ud,unit,vary,wide,yellow,ympodial	'',[,``,anther,appressed,articulation,axi,bract,branching,breeding,bud,characteristic,colour,corolla,filament,form,fruiting,growth,height,inflated,inflorescence,interjected,interpetalar,length,marking,mature,modification,na,number,ovary,pattern,plant,position,present,pubescence,scale,seed,shape,size,spacing,spot,stem,symmetry,system,texture,theca,tissue,trichome,type,value,{,}
364	wfo-0001030146	success	210	123	71	139	52	0.338	acute,anther,anthesi,apex,appearing,articulated,base,berry,branched,branching,c.,calyx,cell,cm,connivent,coriaceous,corolla,cup-shaped,densely,echinoid,ellipsoidal,entire,filament,fruiting,globose,gradually,green,growth,inflorescence,leaf,length,lengthening,lobed,long,loosely,lower,many,margin,mm,multangulate,narrowing,nodding,pedicel,peltate,perfect,petiole,plurifoliate,pore,poricidal,pubescent,ray,revolute,ripe,scurfy,simple,slit,small,stellate,stem,surface,terminal,time,tip,tree,treelet,trichome,unevenly,unit,varying,way,white	.1,.2,.5,0.2â0.4,0.5,0.5â1,0.6â0.7,0.6â2,0.9â1,1.2â1.5,1.5â2,16â20,1â1.1,1â1.5,2.5â9,20,20â30,2â5,3â4,3â6,40â50,4â30,4â4.5,5-merou,5â8,6.5â16,60+,6â7,8â15,9â9.5,>,abaxial,abaxially,absent,acuminate,adaxial,ag,almost,along,alyx,apar,ark,axe,beig,beneath,bright,brown,brownish,capitate,center,closely,covered,dark,deeply,deltate,dense,diameter,dichasia,discolorous,drying,eaf,edge,eed,elliptic,elongate,erec,exserted,flattened-reniform,flower,free,fresh,fused,glabrous,golden,halfway,ilament,impressed,lamina,layer,less,like,lobe,midpoint,minutely,narrowly,new,nflorescence,older,olive,orolla,pair,pale,papillose,part,peduncle,per,pericarp,persistent,pitted,plant,portion,primary,projection,pubescence,reddish,reflexed,regularly,rhachi,ruit,scar,sessile,shiny,short-stalked,spaced,sparsely,stigma,stout,strongly,style,subtended,tall,tan,tangled,tem,testal,thin,tiny,tube,ud,undersurface,upper,vary,vein,visible,wide,woody,yellow,ympodial,â18	0.6-2,1-1.5,3-4,age,appressed,articulation,bract,breeding,broad-based,colour,connective,dichasial,form,fruit,hair,heteromorphism,inflated,insertion,interjected,interpetalar,leaflet,marking,mature,modification,needle-like,none,odour,orientation,paired,pattern,placement,position,prickle,pseudostipule,rhizome,scale,shape,smell,spot,staman,stone,structure,symmetry,sympodial,system,texture,tissue,tuber,type,vegetative,xylopodia,zygomorphy
365	wfo-0001030147	invalid_json_followup	158	142	80	78	62	0.506	0.5-2,1-4,1-5,1.0-2.0,1.0-2.2,10-19,14-35,15-30,2-10,2-10.5,2-13,2-3,2-5,2.5-7.5,4-5.5,4.2-7.5,4.5-10,5-8,8-38,acute,apex,apically,base,blue,branched,calyx,cm,conical,connate,corolla,cuneate,cyme,deep,dehiscent,diameter,dichasial,dichasially,distal,filament,finely,flower,green,green-white,hair-like,herbaceous,interjected,lateral,leaf,leaflet,lobe,long,long-attenuate,medium,mm,monochasial,oblique,odd-pinnate,ovoid,pattern,pedicel,peduncle,perennial,perfect,petiole,plant,poricidally,proximal,pubescent,purple,rotate,rounded,seed,straight,style,terminal,tuber-bearing,unit,wall,yellow,Â¼	-8,0-5,2,3-,3-6-foliat,4-3.,5-7,abaxiall,abaxially,acumen,acuminate,adaxially,apical,articulate,attenuate,cell,covering,digestion,diminishing,dorsally,eaf,ebracteate,edge,eed,elliptical,emoval,enzyme,exceeding,flat,folded,forked,generally,globo,gradually,half,honeycomb,introrse,living,lon,lower,lunat,make,maturing,mucilaginous,narrowly,nflorescence,nther,obtuse,often,orolla,ovate,pair,petiolule,plan,reveal,ruit,sessile,seudostipule,short,size,slit,specimen,stamen,stigma,subequal,subsessile,tal,tem,testal,thick,throughou,throughout,tip,toward,typically,vary,wide,ympodial	'',3-6-foliate,4-31,[,``,anther,appressed,arrangement,articulation,bract,branching,breeding,characteristic,colour,connective,ebbrate,form,fruit,fruiting,growth,hair,height,inflated,inflorescence,insertion,interpetalar,length,lunate,margin,marking,mature,modification,na,number,odour,orientation,ovary,paired,placement,pore,position,present,prickle,pseudostipule,rhiz,scale,shape,spot,stellate,stem,structure,symmetry,sympodial,system,texture,tissue,type,value,width,zygomorphy,{,}
366	wfo-0001030151	invalid_json_followup	175	149	88	87	61	0.503	-50,0.2-0.5,0.3-0.5,0.5-1,1-17,1-3,1.5-2.5,10-20,10-25,15-35,2-11,2-25,2-3,2-6,2-7-compound,3-14,3-5,3.5-32,4-5,5-6,6-9,abundantly,acuminate,acute,adaxial,apex,base,blade,blotch,calyx,chartaceous,cm,connective,cordate,cuneate,deltate,diameter,elliptic,entire,except,flower,fruit,glabrous,globose,hair,lanceolate,leaf,leaflet,lilac-tinged,line,lobe,longitudinal,lower,margin,membranaceous,mm,narrowly,near,oblique,oblong,obovate,often,pedicel,peduncle,perfect,petiole,pinnately,pore,puberulent,pyriform,rachi,radiu,sand-punctate,shallowly,simple,sometimes,sparsely,stellate,stigma,stripe,style,surface,tree,truncate,unbranched,white,x,yellow-green	-3,0.5,1,1-1.5,1-2,1-5,1.5-2,20-30,4-foliat,?,abaxially,absent,adaxially,aggregate,apart,ape,apiculate,around,articulated,axe,basal,beyond,cell,channe,ciliat,compound,connate,cylindrical,decurrent,directed,distally,eaf,eed,eglandular,exceeding,exserted,glabrate,glandular,glandular-puberulent,leaving,less,lon,long,nflorescence,nther,obtuse,orolla,pedicellar,presence,probably,purplish,remnant,ring,ripe,ruit,sand-punctat,scattered,short,shorter,slender,slightly,small,somewhat,spaced,stalked,stamen,stone,tal,tem,thecae,time,tip,toward,triangular,truncat,tube,ud,unit,unknow,vary,vein,veiny,white-puberulent,whitish,wide,yellow,ympodial	'',[,``,anther,appressed,articulation,bract,branching,breeding,broad-based,bud,channel,characteristic,colour,corolla,filament,form,fruiting,growth,height,inflated,inflorescence,insertion,interjected,interpetalar,length,marking,mature,modification,na,needle-like,odour,orientation,ovary,paired,pattern,placement,plant,position,prickle,punctation,scale,seed,shape,size,smell,spot,stem,symmetry,system,texture,theca,tissue,trichome,type,value,vegetative,width,zygomorphy,{,}
367	wfo-0001030153	success	147	127	103	44	24	0.701	.1,.2,/3,0.2-1,0.8-0.9,1-1.5,1-10,1-2,1.3-1.5,2-8,2-lobed,2.5-4,3-4,3-5,5-6,6-8,absent,acuminate,acute,age,anther,anthesi,apart,apex,apparently,attenuate,bark,base,berry,branched,calyx,campanulate,clavate,cm,conical,corolla,dark,densely,diameter,distinct,domatia,ellipsoid,elliptic,entire,erect,exerted,filament,free,fruiting,glabrous,globose,green,growth,impressed,internodal,lanceolate,lengthening,less,lobed,margin,minutely,mm,narrowly,new,nodding,occasionally,older,ovary,pair,papillate,pedicel,peduncle,petiole,pit-like,plane,pore,poricidal,portion,primary,rachi,revolute,ripe,scar,simple,slightly,slit,small,stem,stigma,strongly,style,surface,terminal,time,tip,tree,treelet,tube,vein,way,white,yellowish,young	0.8-1.3,1-1.2,1-2.5,1.3-1.9,1.5-2,3-50,3.5-10.5,abaxially,adaxially,ape,apiculate,axil,brittle,broadly,caly,deltate,dot,dry,eaf,enlarged,flower,glabrou,irregularly,known,lobe,lower,markedly,membranous,nflorescence,ot,paler,papillat,perfect,plurifoliat,resinous,ruit,spaced,specimen,straight,thin,ud,unit,x,ympodial	abaxial,absence,adaxial,branching,bud,colour,erectnes,exertion,form,fruit,glabrousnes,height,impression,inflorescence,leaf,length,number,papillation,position,shape,spacing,texture,type,width
368	wfo-0001030167	invalid_json_followup	141	150	74	67	76	0.525	.8,.9,0.6,12,5-merous,accrescent,acuminate,acute,along,anther,apex,apically,base,berry,calyx,chartaceous,ciliate,clavate,cm,contiguously,densely,diameter,enlarged,entire,extra-axillary,filament,flattened,flower,fruit,fruiting,glabrous,green,herbaceous,lanceolate,less,lobe,margin,maturity,membranaceous,membranous,minutely,mm,moderately,near,nearly,obtuse,ovate,ovoid,pedicel,peduncle,petal,petiole,pointed,rachi,reflexed,rounded,sand-punctate,simple,slightly,somewhat,sparsely,stellate,stigma,style,symmetrical,thinly,tip,tube,unbranched,unknown,vine,weakly,white,x	0.1â0.2,0.5â0.6,0.5â0.7,0.6â0.8,0.7â1.2,0.8â1,1.2â2.5,1.5â2,1.5â7,14â19,15â20,17â58,1â1.2,1â1.5,2â3,2â4.5,4.5â8,4â10,4â4.5,4â5,4â7,8â10,abaxially,adaxially,alyx,apar,axe,blade,branch,c.,ciliat,climbing,eaf,eed,fertile,gap,glabrou,immature,long,lower,m.,nflorescence,nternode,orolla,pair,penden,perfec,pinnate,plurifoliat,ruit,scar,secondary,seen,slender,spaced,subequal,tamen,tem,time,truncat,unit,vary,vegetation,vein,venation,wide,ympodial	'',0.1-0.2,0.5-0.6,0.5-0.7,0.7-1.2,0.8-1,1-1.2,1-1.5,1.2-2.5,1.5-2,1.5-7,15-20,2-4.5,4-10,4-4.5,4-5,8-10,[,``,apart,appressed,arrangement,bract,branching,breeding,characteristic,colour,connective,corolla,form,growth,hair,herbaceousnes,inflated,inflorescence,information,interjected,internode,interpetalar,leaf,leaflet,length,marking,mature,merosity,modification,na,odour,ovary,paired,pattern,perfect,pore,position,punctation,scale,seed,shape,size,smell,spacing,spot,staman,stem,symmetry,system,texture,tissue,trichome,truncate,type,value,vegetative,zygomorphy,{,}
369	wfo-0001030176	success	171	118	90	81	28	0.526	0.4-1.5,0.5,0.5-2,0.7-1.4,0.7â0.8,1,1.2-2.5,1.6,1/3,2.5,3-5,3-lobed,6-8,accrescent,acute,adaxially,anther,apex,articulated,attenuate,basal,base,berry,bi-lobed,bilobed,broad,broadly,calyx,chartaceous,ciliate,cm,covering,decumbent,depressed-globose,especially,extra-axillary,few-branched,filament,flattened-reniform,flower,fruit,fruiting,glabrous,hair,herb,hermaphroditic,lateral,light,line,lobe,long,lower,major,margin,midrib,mm,near,nearly,node,oblong,often,ovate,pale,partially,pedicel,peduncle,petiole,plant,pore,prostrate,pubescent,rachi,rarely,ripe,rooting,rotate-stellate,simple,slightly,sometimes,sparsely,tip,unbranched,vein,violet,white,winged,x,yellow,yellow-orange,young	-1.4,-4.25,-6.25,.2,.7,.75-1.5,0.6-0.9,1-2,1-5,1.2,1.5-2,1.5-2.5,1/6,2-3,2-foliate,2.25-3.25,2.5â7.5,2.5â9,2â3,3.75-5,4-9,5-merou,6â8,abaxially,adaxiall,alyx,angulate,apart,apparently,asymmetrically,axe,ba,blade,branch,capitat,connivent,contact,cylindrical,dehiscent,diameter,downward,eaf,eed,erec,forming,geminat,hold,interlobal,juic,lance-ovate,lanceolate-oblong,lon,longitudinall,mesocarp,minutely,nflorescence,numerous,orolla,patch,perfect,recurve,recurved,round,ruit,sinus,soil,somewhat,spaced,stigma,style,tamen,tem,terminal,time,triangular,tube,unit,vary,white-puberulent,wide,ympodial	abaxial,adaxial,arrangement,articulation,branching,colour,connective,corolla,form,growth,habit,inflorescence,leaf,length,longitudinally,marking,modification,na,odour,position,seed,shape,spot,stem,symmetry,texture,type,winging
370	wfo-0001030180	invalid_json_followup	135	160	98	37	62	0.726	.5,.75,0.05-1,0.5-1,0.8-2,0.9-1.8,1-1.5,1.1-1.2,10-30-flowered,3-8,4.5-5,6,8-10,8.5-23,?,abruptly,accrescent,anther,anthesi,apart,apex,appearing,attenuate,bark,base,becoming,berry,calyx,clavate,cm,corolla,dark,decurrent,dia,ellipsoid,erect,exserted,filament,fruit,fruiting,furcate,glabrous,globose,green,height,interpetalar,lateral,leaf,linear,lobed,long,long-acuminate,lower,main,minute,minutely,mm,narrowing,nearly,occasionally,older,opposite,ovary,pair,papillate,papillose,pedicel,petiole,planar,pore,prominent,puberulent,raised,rounded,scar,shaped,shrub,slender,slightly,soon,stem,stigma,style,surface,tear-drop,terminal,thin,tip,trichome,tube,uniseriate,unknown,vein,white,winged,woody,yellowish,young	.1,3-4,apiculate,clu,deflexe,deltoid,eaf,edicel,eed,free,glabrate,immature,inflorescenc,known,lenticellat,lobe,lon,middle,nflorescence,overlapping,peduncl,plurifoliat,poricidal,portion,proximal,ruit,sinus,spaced,sparsely,straight,ud,unevenly,unit,widely,widest,x,ympodial	'',2,[,``,arrangement,articulation,bract,branching,breeding,broad-based,bud,characteristic,club,colour,deflexed,diameter,exsertion,flower,form,growth,hair,inflorescence,insertion,interjected,leaflet,length,lenticellate,margin,marking,modification,na,needle-like,number,odour,orientation,paired,peduncle,placement,plant,plurifoliate,position,prickle,prominence,pseudostipule,rhizome,scale,shape,smell,spacing,spot,symmetry,system,texture,tissue,tuber,type,value,vegetative,width,xylopodia,{,}
371	wfo-0001030189	success	188	107	57	131	50	0.303	/3,0.5-1.6,5-6,anther,apex,apparently,appressed,articulated,base,berry,branched,calyx,chartaceous,cm,connivent,cordate,entire,erect,filament,fruit,fruiting,glabrescent,glabrous,lateral,leaf,length,lobed,long,lower,margin,mature,maturity,mauve,mm,moderately,orange,pedicel,petiole,poricidal,purple,red,rounded,shrub,simple,spherical,spreading,stellate,stellate-pubescent,stem,surface,tapering,terminal,tip,trichome,unarmed,unit,way	-1/2,-4,.2,0-1,0-15,0-30,0.1,0.1-0.2,0.2-0.3,0.2-0.5,0.9-1.1,1,1-1.5,1-2,1-3-cellular,1-4-cellula,1-4-cellular,1.1-2.7,1.3-4.2,1.5-2,1.5-4.5,1.5-5,1/,1/3,1/6-1/3,2,2-3,2-5.5,2.5-4,3-4,3.2-4.5,4-13,4-5.5,5-,5-10,5-merous,6-10,6-12,8,8-10,8-18,abaxially,acut,alyx,apar,apically,bark,blade,concolorous,curved,deltate,densely,diameter,drying,dull,eaf,eed,elliptic,elongating,equal,evenly,faint,flattened-reniform,flower,foliaceous,free,frui,glabrescen,gland-tipped,gray,green,infructescence,lobe,longer,midpoint,nflorescence,oblong,obtuse,often,older,one,open,orolla,oung,ovate,pair,peduncle,per,perfec,pericarp,plurifoliat,porrect,portion,primary,ray,recurved,red-brow,reflexed,ruit,scandent,scar,sessile,shorter,slender,smooth,sometimes,somewhat,spaced,sparsely,stalk,stalked,strongly,style,tamen,terete,tertiary,time,tube,unarme,upper,variously,vary,vein,venation,visible,wide,woody,yellow,yellow-green,ympodial,young	articulation,bract,branching,breeding,broad-based,cell,colour,connective,corolla,form,growth,hair,heteromorphism,inflated,inflorescence,insertion,interjected,interpetalar,leaflet,marking,na,needle-like,odour,orientation,paired,pattern,perfect,placement,plurifoliate,pore,position,prickle,pseudostipule,rhizome,scale,shape,smell,spot,staman,stone,structure,symmetry,sympodial,system,texture,tissue,tuber,type,vegetative,xylopodia
372	wfo-0001030219	invalid_json	191	137	82	109	55	0.429	0.5,1.5,3,5,60,abaxially,adaxially,anther,anthesi,apart,base,black,blue,brown,calyx,cm,cylindrical,deeply,diameter,difoliate,elliptic,filament,flattened,flower,fruit,glabrescent,glabrous,globose,green,hair,incised,indistinct,internode,lanceolate,leaf,lilac,lobe,long,longitudinal,margin,marking,mm,moderately,multicellular,number,oblong,opening,ovate,pair,pale,pedicel,peduncle,pentagonal,perfect,petiole,pitted,pore,pubescent,purple,rapidly,regularly,shallowly,shrub,simple,size,spaced,sparsely,split,stigma,straight,style,surface,time,tube,unicellular,uniseriate,unit,velutinous,wing,winged,woody,x	0.1â0.3,0.2â2.3,0.4â1.0,0.5â,0.7â1.1,0.8â3.0,0â,1.0â1.2,1.0â1.5,1.0â2.0,1.0â2.2,1.3â2.9,1.4â2.8,1.6â,10,15,1â2.5,2.0â2.5,2.0â3.2,2.0â5.5,2.4â6.0,2â,2â2.5,2â3,2â4.5,4.5â5.5,4.8â11.5,4â5,4â7,5â,5â8,6â,6â10,6â8,7â11,8â18,9â10,9â12,abaxiall,acut,acute,adaxiall,adnate,ag,along,anisophyllous,apex,apical,apparently,appearing,arising,arranged,articulated,axe,ba,basal,blade,bractâlike,branched,cell,chartaceous,clavat,concave,connivent,convex,decreasing,decurrent,densely,diamete,directed,distally,eaf,eed,equal,erect,geminat,lower,nflorescence,olive,opposed,oppositely,orolla,paler,perennial,present,procumbent,redâpurple,rounded,ruit,serrate,sessile,sid,side,smaller,stone,stripe,strongly,tal,tamen,tem,two,vary,white,wide,yellow,ympodial,â3.0,â7.0,â9.5	'',0.1-0.3,0.2-2.3,0.5-2.2,0.7-1.1,1.0-1.2,1.0-2.0,1.3-2.9,1.6-3.2,2-3,2-4.5,2-5,2.0-2.5,2.0-5.5,2.4-6.0,4-7,4.5-5.5,4.8-11.5,5-11,5-8,6-10,6-8,9-10,[,``,age,arrangement,articulation,branching,characteristic,clavate,colour,corolla,decurred,form,growth,height,inflorescence,length,opposite,ovary,plant,seed,shape,spacing,staman,stem,structure,sympodial,texture,type,value,width,{,}
373	wfo-0001030225	invalid_json_followup	155	162	104	51	58	0.671	-1.5,-11,-30,-4,-45,-7,.5-2.5,0,0-20,0-5,1,1-4,1-6,1.5,1.5-2.5,10-15,10-30,2,2-18,2-2.5,2-3,2-6,3-11-compound,3-20,3-4,3-5,4-5,abaxially,acuminate,acute,adaxially,apart,apex,apically,articulated,basal,base,blade,calyx,campanulate,cm,conivent,connective,cordate,coriaceous,cuneate,cylindrical,deltate,densely,diameter,dilated,directed,distally,elliptic-ovate,entire,expanded,fleshy,flower,forked,fruit,glabrous,globose,laterally,leaf,leaflet,less,lobe,long,lower,margin,mm,moderately,oblong,obtuse,pedicel,peduncle,perfect,petiole,pinnately,pore,possibly,puberulent,purple,rachi,radiu,shallowly,shrub,simple,small,somewhat,sparsely,stellate,stigma,strongly,style,succulent,time,tip,tree,truncate,unbranched,unknown,wide,x	.5,3-foliat,8-15,absent,ape,apical,ature,axe,beyond,bilobed,color,compound,eaf,eed,equal,especially,exceeding,exserted,glabrate,gland,immature,leaving,minutely,narrowly,nflorescence,nther,one,orolla,papillose,prominent,puberulen,scar,see,seen,slightly,spaced,stalked,stamen,tal,tem,thecae,tomento,toward,triangular,tube,two,ud,unit,unknow,vary,ympodial	'',[,``,anther,articulation,bract,branching,broad-based,bud,characteristic,colour,corolla,form,growth,hair,height,heter,inflorescence,insertion,interjected,interpetalar,length,mature,na,needle-like,number,odour,orientation,ovary,paired,pattern,placement,plant,position,prickle,pseudostipule,ratio,rhizome,scale,shape,size,smell,spacing,staman,stem,surface,symmetry,texture,theca,tissue,trichome,tuber,type,value,vegetative,xylopodia,{,}
374	wfo-0001030250	success	169	138	84	85	54	0.497	0.5-1,1-1.5,1-3,1.1-1.2,1.1-3.5,1.25-1.5,1.7-7,11.2-22,11.3,2-2.5,2.1-6,2.5-3.25,25,3.4-6.6,3.5-4,5-6,6-8,across,anther,apart,apex,bark,base,broadly,calyx,capitate,cm,conical,corolla,cup-shaped,dark,decurrent,dia,difoliate,elliptic,elliptic-ovate,exerted,filament,glabrous,globose,green,greenish-white,greenish-yellow,inflorescence,lateral,leaf,lobe,long,long-acuminate,lower,main,minor,minutely,mm,opposite,orbicular,ovary,ovoid-reniform,pair,pale,pedicel,petiole,pitted,pore,scar,sea-green,seed,shape,shaped,shrub,simple,size,soon,stem,stigma,style,surface,tear-drop,translucent-green,unit,vein,white-lenticellate,winged,x	.5,/4,0-seeded,1.4-1.5,1.9-2.6,3-5,4-7,5-50-flowered,anthesi,appearing,arching,attenuate,beginning,beneath,berry,brown,bullate,carinate-hooded,consisting,cuneate,curved,deflexed,differing,dry,eaf,edicel,eed,five,free,fresh,fruiting,geminat,glabrou,horizontally,inflorescenc,irregularly,lobed,lon,major,maturity,middle,n,nflorescence,node,occasionally,older,one,orbiculate,paler,papillo,papillose,pendulous,pit,poricidal,portion,projection,prominent,proximal,raised,reflexed,rim,ruit,shallow,slender,slightly,smooth,spaced,specimen,spreading,straight,tall,tan,tapering,tip,translucent,tube,two,ud,usually,way,white-lenticellat,wide,widest,woody,ympodial	0.5,abaxial,adaxial,articulation,bract,branching,breeding,broad-based,bud,cell,colour,exertion,form,fruit,geminate,glabrousnes,growth,height,heteromorphism,insertion,interjected,interpetalar,leaflet,length,margin,marking,na,needle-like,odour,orientation,pattern,placement,plant,position,prickle,pseudostipule,rhizome,smell,spacing,spot,staman,stone,structure,symmetry,sympodial,system,texture,tissue,tuber,type,vegetative,venation,xylopodia,zygomorphy
375	wfo-0001030271	invalid_json_followup	195	157	100	95	57	0.513	0-2,0.15-0.75,0.9-2.5,1-2,1-2.5,1-3,1-7,1.4-2.1,1.9-6.6,2-2.7,2-4,2-6,2.4-5.6,3-10,3.4-7.5,4-7,5-8,5.6-12.3,6-15,anther,apex,asymmetric,attenuate,axillary,base,berry,blade,blue,brownish,bud,clavate,cm,coloration,completely,condition,coriaceous,corolla,dark,deep,diameter,drying,filament,flower,forked,fresh,fruit,glabrous,green,greenish,herb,homostylous,interjected,lanceolate,lateral,leaf,leaflet,light,lilac,lobe,long,lower,medium,mm,moniliform,mottled,mucilaginous,odd-pinnate,ovoid,pair,pedicel,pentagonal,petiole,plant,pore,poricidal,purple,ripe,rotate,rounded,seed,size,slightly,sometimes,spot,stigma,straight,style,subtending,symmetric,terminal,tip,tissue,tube,tuber,vein,wet,white,whitish,wide,x	0.5-1.2,0.7-9.5,0.9-3.6,1-4,1-6,15-61,2-3,3-5,4-22,5-merou,abaxially,acumen,acute,adaxiall,adaxially,ag,along,alyx,apart,apparently,arranged,articulated,axe,basiscopic,bead,capitat,cell,connivent,considerably,covering,decreasing,digestion,distal,dorsally,eaf,edge,eed,elliptic,enzyme,erect,exceeding,flat,folded,geminat,generally,glabrou,green-white,habi,hair-like,half,honeycomb-shaped,larger,lengthening,like,linear,living,make,middl,multiple,necklace,nflorescence,orbicular,orolla,ovate,peduncle,perfect,petiolulate,plurifoliate,removed,rosette,ruit,sessile,seudostipule,side,slit,spaced,specimen,stamen,stolon,tall,tamen,tem,testal,thick,throughout,toward,tri-,typically,unit,unwinged,usually,vary,wall,yellow,ympodial	'',[,``,abaxial,adaxial,appressed,arrangement,articulation,bract,branching,breeding,broad-based,calyx,capitate,characteristic,colour,connective,form,fruiting,growth,hair,height,inflated,inflorescence,insertion,interpetalar,length,margin,marking,mature,middle,modification,na,needle-like,odour,orientation,ovary,paired,pattern,position,prickle,pseudostipule,scale,shape,smell,staman,stem,surface,symmetry,system,texture,trichome,type,value,vegetative,{,}
376	wfo-0001030272	success	179	99	76	103	23	0.425	-6,.5,/4,0-20,0.5-1,0.65-1,0.7-2.5,1.2-1.8,1.5-2.5,1/3-2/3,2.5-3.5,2.8-3.5,3.5-5,abaxially,anther,base,berry,blade,bright,calyx,cm,connivent,diameter,difoliate,elliptic,elongating,entire,equal,evenly,filament,flattened-reniform,free,fruit,fruiting,glabrescent,green,hair,lateral,leaf,length,lobe,lobed,long,long-attenuate,margin,mature,maturity,mauve,membranous,mm,orange-brown,per,petiole,poricidal,portion,red,shallowly,shrub,simple,sparsely,spherical,spreading,stellate-pubescent,stem,style,tapering,terminal,tip,tube,unarmed,unbranched,undulate,unit,way,wide,young	.3,0.05-0.1,0.05-1.5,0.5-1.5,0.5-2,0.6-0.9,0.8-1.5,1,1-1.5,1-2.8,1.5-3,1/3,10-20,2-2.5,2-6.5,2.5-3,3-8,4-10,4-15,4-6,4-8,5-7,5-merous,acut,acute,almost,alyx,ame,apar,apex,apically,apparently,articulated,ba,bark,c.,concolorous,deltate,densely,drying,eaf,eed,erect,flower,geminat,glabrescen,glabrous,gland,glandular,gra,infructescence,less,longer,lower,midpoint,minute,moderately,multangulate,narrow-deltate,near,nflorescence,obtuse,older,one,open,orolla,oung,pair,pedicel,peduncle,perfec,pericarp,porrect,primary,ray,red-brown,reduced,reflexe,rounded,ruit,scar,sessile,shorte,slender,smooth,sometimes,spaced,stellate,straight,surface,tamen,terete,tertiary,time,trichome,unarme,upper,vary,vein,venation,visible,woody,ympodial	branching,colour,corolla,form,geminate,growth,heteromorphism,inflorescence,na,number,position,prickle,proportion,reflexed,seed,shape,size,staman,structure,symmetry,sympodial,texture,type
377	wfo-0001030287	invalid_json_followup	150	158	100	50	58	0.667	-11,-40,-many,0-15,0.5-1,1,1-10,1-15,1-2,1-2.5,1-4,1-5.5,1.5-10,1.5-2.5,1966,2,2-,2-10,2-12,2-5,3-9,4-5,4-6,4.5-6,8-13,?,abaxially,acute,adaxially,apart,apex,axe,base,blade,bluish,calyx,chartaceous,cm,compound,cylindrical,deltate,dendritically,densely,diameter,directed,down,eglandular,ellipsoidal,elliptic-ovate,entire,fide,flattened,flower,forked,glabrous,glandular,hair,herb,lanceolate,leaf,leaflet,lilac,lobe,long,margin,membranaceous,mm,moderately,narrowly,oblong,ovoid,pedicel,peduncle,petiole,pinnately,pore,puberulent,pubescent,purple,rachi,radiu,rugulose,scar,shrub,simple,slightly,smith,stellate,stigma,strongly,style,subcordate,subcoriaceous,tip,truncate,unbranched,unit,unknown,x,yellow	-foliat,.5-2.5,1-3,2.5-4,3,5-10,adaxiall,aggregate,articulated,basiscopically,branched,cell,color,connivent,decurrent,dendritic,dendritic-pubescen,distall,eaf,eed,gland,lateral,leaving,lon,long-stalked,lower,nflorescence,nther,obtuse,often,orolla,pedicellar,presen,ruit,scattered,spaced,sparsely,sparser,stalked,stone,subcapitat,tal,tem,time,triangular,tube,upper,vary,wide,ympodial	'',-foliate,[,``,anther,appressed,articulation,bract,branching,breeding,characteristic,colour,connective,corolla,dendritic-pubescent,distally,filament,form,fruit,fruiting,growth,height,inflated,inflorescence,interjected,interpetalar,length,marking,mature,modification,na,odour,ovary,paired,pattern,plant,position,scale,seed,shape,size,smell,spacing,spot,stem,structure,subcapitate,symmetry,sympodial,system,texture,tissue,trichome,type,value,vegetative,{,}
378	wfo-0001030300	success	235	112	68	167	44	0.289	-1,0.5,0.5-4,0.6-0.8,1-celled,2-foliate,2-locular,4-celled,absent,anther,apex,articulated,articulation,base,bract,calyx,cell,cm,coherent,cordate,corolla,curved,developed,eglandular,filament,fruit,fruiting,glandular,globose,golden,green,herb,imparipinnate,inflorescence,interjected,interrupted,introrse,lateral,leaflet,less,long,margin,mm,moderately,node,once-branched,papillae,partially,pedicel,pentagonal,petiole,pore,present,pseudostipule,pubescent,simple,slightly,sparsely,stem,surface,tip,trichome,uniseriate,unit,usually,well,yellow,zygomorphic	-0.9,-7,.5,0.1,0.1-0.15,0.15-1,0.2,0.2-0.5,0.2-1.5,0.4-0.5,0.4-1.5,0.4-4.5,0.5-0.6,0.5-1,0.5-5,0.6-0.7,0.7-0.8,0.7-1.2,0.7-1.5,0.8-1,0.8-3,0.8-4,0.9-1,1,1-1.3,1-2,1-2-celled,1-4,1-6,1.2-,1.4-2.4,1.5-,1.5-2.5,2-2.1,2-2.5,2-3,2-4,2.2-7.5,3.5-13,3/4,4-11,6-15,6-8-celled,9-12,abaxially,abundant,acute,adaxial,adaxially,almost,although,always,anthesi,apical,appearance,appendage,ba,basal,bent,beyond,bifid,bracteate,brittle,broadly,brown,capitate,column,crenat,crenate,deltate,densely,diamete,diameter,distal,eaf,edicel,eed,ellipsoidal,elliptical,elongate,entire,even,exserted,face,finely,flower,frequently,give,glabrous,glutinous-viscose,gree,hair-like,halfway,head,internode,irregularly,lamina,large,larger,leave,like,lobe,lon,longer,markedly,midvein,minute,multicellular,narrowly,nflorescence,oblique,obovate,occasionally,orbicular,outgrowth,ovary,pair,pale,peduncle,perennial,petal,petiolule,pith,plant,population,primary,pubescence,reflexed,rest,rounded,ruit,secondary,silky,spathulate,spreadin,spreading,staminal,sterile,stigma,straight,strongly,style,tall,tem,terminal,tertiary,testa,thick,triangular,tube,two,ud,underlying,unicellular,united,upper,vein,velvety,wall,weak,wide,wider,winged,woody,yellowish,yellowish-green,ympodial	appressed,branching,breeding,broad-based,colour,connective,form,growth,hair,heteromorphism,inflated,insertion,interpetalar,leaf,length,lower,marking,mature,modification,na,needle-like,odour,orientation,paired,pattern,placement,position,prickle,rhizome,scale,shape,spot,staman,stellate,stone,structure,symmetry,sympodial,system,texture,tissue,tuber,type,xylopodia
379	wfo-0001030311	success	182	90	48	134	42	0.264	.2,.5,5-pinnate,accrescent,acuminate,acute,anther,berry,blade,brown,calyx,chartaceous,clavate,cm,deltoid,diameter,entire,extra-axillary,filament,flower,fruit,fruiting,green,half,lenticular,lower,margin,membranaceous,mm,orangish,ovoid-rhomboid,papillose,pedicel,peduncle,petiole,petiolule,purplish,rachi,slightly,stellate,stigma,style,tan,unbranched,unit,vine,white,x	.5â1.8,0.1,0.1â0.2,0.3â1.5,0.4â2,0.5â0.8,0.5â1,0.5â2,0.5â2.5,0.6â1,0.6â2.4,0.8â1.2,0.8â4,0.8â4.5,1.2â7,1.5â2,1.5â3,1.5â5.5,1.5â6,1.5â8,1.8â2,15â22,1â1.2,1â1.5,1â2,1â2.5,1â3,2.2â2.5,2.2â3,2.5â9,2â10,2â2.5,2â6,3â5,3â7,5â10,<,abaxially,adaxial,adaxially,along,alyx,apar,apex,apical,appearance,axe,basal,base,c.,capitat,ciliat,ciliate,color,cordate,cuneate,dense,densely,distal,eaf,eed,elliptical,especially,falcate,fallen,flattened,giving,glabrou,glabrous,granular,groov,groove,ground,hair,herbaceous,lanceolate,lateral,leaflet,like,lobe,log,lon,long,m.,membranous,midvein,minutely,nflorescence,nternode,oblique,obovate,obtuse,occasionally,orolla,pair,petiolulate,plurifoliat,present,proximal,pubescence,pubescent,rhomboid,rounded,ruit,sand-punctate,scattered,sessile,short,shortly,side,slender,smaller,spaced,sparsely,stem,strongly,surface,tamen,tem,terrestrial,thick,thickened,thinner,tip,trailing,trichome,tube,upper,vary,vein,wide,wide-diameter,widely,ympodial	0.5-1,0.5-2.5,0.6-1,0.8-1.2,1-1.5,1.2-7,1.5-5.5,1.5-8,1.8-2,15-22,2-2.5,2-6,2.2-2.5,2.5-9,3-5,3-7,5-10,arrangement,branching,capitate,cell,colour,corolla,form,growth,heteromorphism,inflorescence,internode,leaf,length,na,plurifoliate,position,seed,shape,size,staman,stone,structure,sympodial,texture,type
380	wfo-0001030311	success	203	97	59	144	38	0.291	.5,0.6-1,0.8-1.2,1-1.5,1.5-5.5,2-2.5,5-pinnate,absent,acute,anther,apex,articulated,basally,base,brown,cell,chartaceous,cm,cordate,diameter,directed,distally,entire,equal,flattened,fruit,glabrous,green,hair,herb,interjected,large,leaflet,longitudinal,lower,margin,membranaceous,minutely,mm,oblique,oblong,obtuse,opening,ovoid-rhomboid,pedicel,petiole,plurifoliate,pore,purplish,slightly,slit,stellate,stem,stone,surface,unbranched,unit,white,x	.2,.5-1.8,0-2.5,0.1,0.4-2,0.5-0.8,0.5-1,0.5-2,0.6-2.4,0.8-4,0.8-4.5,1-1.2,1-2.5,1-3,1.2-7,1.5-2,1.5-3,1.5-6,1.5-8,1.8-2,15-22,2-10,2-6,2.2-2.5,2.2-3,2224,3-5,3-7,5-10,5-merou,8031,<,[,],abaxially,absen,accrescent,acuminate,adaxial,adaxially,ag,aggregate,along,alyx,apart,apical,apparently,appearance,axe,ba,basal,blade,capitat,ciliat,ciliate,clavate,color,connivent,cuneate,deltoid,dense,densely,dig,distal,eaf,eed,elliptical,especially,falcate,fallen,filament,flower,formation,g,geminat,gh,giving,granular,groov,groove,ground,half,lateral,lenticular,like,lobe,log,lon,long,m.,midvein,nflorescence,node,obovate,occasionally,orangish,orolla,pair,papillose,peduncle,perfect,petiolulate,petiolule,pittier,present,proximal,pubescent,rachi,rhomboid,rooting,rounded,ruit,scattered,sessile,short,shortly,side,simple,sinple,slender,smaller,spaced,sparsely,stigma,strongly,style,tamayo,tamen,tan,tem,thick,thickened,thinner,tip,trailing,tube,uniseriate,upper,vary,vein,wide,widely,yellow,ympodial	age,arrangement,articulation,branching,broad-based,calyx,colour,corolla,form,fruiting,geminate,growth,heteromorphism,inflorescence,insertion,leaf,length,na,needle-like,odour,orientation,placement,position,prickle,pseudostipule,rhizome,shape,smell,staman,structure,symmetry,sympodial,texture,trichome,tuber,type,vegetative,xylopodia
381	wfo-0001030335	success	153	106	56	97	50	0.366	.25,0.05-0.2,0.25-0.5,2-2.5,2-5,3/4,acute,along,anther,apex,base,berry,calyx,corolla,densely,dia,elliptic,filament,filiform,fruiting,gently,glabrous,globose,green,horizontally,leaf,lobed,long,minute,minutely,mm,narrowly,opposite,pedicel,petiole,pore,poricidal,puberulent,pubescent,ripe,shaped,shrub,simple,spreading,tapering,tear-drop,tip,trichome,tube,uniseriate,unit,vein,way,white,x,yellowish-green	.1,.5,.75,0-5,0.1-0.5,0.5-1,0.7-1,1-1.5,1-2,1-3-flowered,1.1-1.4,1.1.5,2-2.2,2-4.5,2.5-3,5-6,5-7,7-13,acuminate,anthesi,aspec,ba,bark,beneath,bi-lobed,branch,bud,cm,conical,dark,deciduous,decurrent,deflexed,deltoid,dry,eaf,edicel,eed,erect,except,expanded,exserted,flattened,free,geminate,giving,greyish-red,lamina,lateral,lenticellate,lightly,like,lobe,lon,lower,main,material,middle,nflorescence,obovoid,occasionally,often,older,onto,ovary,ovoid-reniform,pair,pale,papillo,papillose,pitted,portion,prominent,puberulen,raised,reflexed,ruit,slightly,soon,sparsely,stem,stigma,straight,strongly,style,surface,tall,tan,ud,underside,unifoliat,widest,winged,woody,yellow,ympodial,young	appressed,articulation,bract,branching,breeding,cell,colour,connective,decurren,form,fruit,growth,hair,heteromorphism,inflated,inflorescence,insertion,interjected,interpetalar,leaflet,length,margin,marking,mature,modification,na,odour,orientation,paired,pattern,placement,position,prickle,pseudostipule,rhizome,scale,shape,spot,staman,stone,structure,symmetry,sympodial,system,texture,tissue,tuber,type,unifoliate,xylopodia
382	wfo-0001030336	success	266	124	90	176	34	0.338	-1.5,-2,0-,0.1-0.5,0.1-0.7,0.1-1,0.15-0.9,0.2-1.5,0.5-0.7,1-3,2-9,2-foliate,anther,apex,articulation,base,basiscopically,berry,bifurcate,bract,bracteate,bright,calyx,cell,cm,cordate,corolla,curved,darker,decurrent,densely,developed,eglandular,extremely,filament,flushed,fruit,fruiting,globose,green,greenish,half,herb,imparipinnate,inflorescence,interjected,interrupted,investing,large,leaf,leaflet,long,loosely,lower,margin,markedly,midvein,node,oblique,occasionally,once-branched,pedicel,petiole,petiolule,present,proximal,pseudostipule,pubescent,purple,rotate,scattered,sessile,simple,slightly,spreading,stellate,stem,surface,surrounding,ten,trichome,truncate,uniformly,uniseriate,unit,usually,velvety,white,wide,yellow	-10,-19,.5,0.1-0.3,0.15-0.2,0.2,0.2-0.25,0.2-0.8,0.2-1,0.3-0.4,0.3-1.1,0.5,0.5-1,0.5-1.5,0.6-0.8,0.6-1.5,0.8-0.9,0.8-1.2,0.8-1.3,0.8-3,1,1-1.4,1-1.5,1-celled,1.0-1.4,1.5-,1.5-2,1.5-3.5,1.5-5,1.6-7,1.7-2.3,1.8-3.0,1/4-1/3,10,2-4,2-locular,2/3,3-5,4,4-,4-10,4-celled,6,8-16,8-20,8-celled,absent,acute,adpressed,almost,amongst,anthesi,apical,appearance,appearing,appendage,articulated,basal,bent,bluntly,branch,brown,capitate,clavat,coat,column,completely,conical,crenate,dark,deeply,diamete,diameter,distal,divided,eaf,edicel,eed,elliptic,elongate,entir,entire,erect,essentially,exserted,first,flower,giving,glandula,glandular,grayish,hair-like,halfway,head,internode,lanceolate,larger,largest,lateral,leave,less,like,lobe,lobed,lon,longer,maturity,mere,middl,minute,minutely,mixed,mm,mostly,narrowing,narrowly,nflorescence,obovate,often,orbicular,outgrowth,ovary,pair,pale,papillate,part,peduncle,perennial,population,primary,puberulent,rachi,range,reflexed,rest,rounded,ruit,secondary,shaggy,shorter,shrub,silky,sinus,small,soft,sometimes,southern,sparse,spreadin,staminal,sterile,stigma,straight,stripe,strongly,style,tall,tem,terminal,tertiary,testa,thick,tip,tube,two,ud,unicellular,united,upper,wall,way,weak-walled,winged,woody,ympodial,young	branching,broad-based,colour,form,growth,hair,heteromorphism,insertion,length,marking,mature,middle,na,needle-like,odour,orientation,placement,position,prickle,rhizome,shape,smell,spot,staman,stone,structure,symmetry,sympodial,texture,tuber,type,vegetative,xylopodia,zygomorphy
383	wfo-0001030342	success	155	87	37	118	50	0.239	3-pinnate,accrescent,anther,apex,base,berry,calyx,chartaceous,cm,cordate,cuneate,entire,extra-axillary,filament,fruit,fruiting,greenish,leaf,leaflet,margin,membranous,mm,oblique,ovoid-rhomboid,pedicel,petiole,slightly,stellate,trichome,unbranched,undulate,unit,vine,white,wide-diameter,x,yellowish	.2,.5,0.1â0.2,0.3â1.2,0.5â1,0.5â3,0.5â5,0.8â1.5,0.8â4,1-5,1-6.5,1.2â3,1.5,1.5â13,1.5â2,1.5â5,1.5â7.5,10â25,1â1.2,1â1.5,1â2.5,1â3,1â5.5,1â6,1â7,2â,2â2.5,2â4,3,3â12,4â5,4â8,5-merous,6â7,abaxially,abundant,acuminate,acute,adaxially,along,alyx,apar,apical,apiculate,axe,blade,broadly,brown,c.,capitat,ciliat,cylindrical,deltoid,dense,diameter,eaf,eed,elliptical,flattened,flower,glabrou,glabrous,herbaceous,lanceolate,lateral,lenticular,light,like,lobe,lon,long,lower,m.,minutely,mottled,nflorescence,nternode,obtuse,often,orolla,peduncle,perfec,petiolule,plurifoliat,pointed,proximal,pubescen,pubescent,rachi,rarely,revolute,rhomboid,rounded,ruit,sand-punctate,scattered,side,slender,smooth,spaced,sparsely,stem,stigma,style,surface,tamen,tem,terrestria,tip,truncate,truncate-acuminat,tube,vary,vein,wide,widely,ympodial,â7	1-1.5,1.5-13,2-2.5,appressed,articulation,bract,branching,breeding,cell,colour,connective,corolla,form,growth,hair,heteromorphism,inflated,inflorescence,insertion,interjected,interpetalar,length,marking,mature,na,odour,orientation,paired,perfect,placement,plurifoliate,pore,position,prickle,pseudostipule,rhizome,scale,shape,spot,staman,stone,structure,symmetry,sympodial,system,texture,tissue,tuber,type,xylopodia
384	wfo-0001030342	invalid_json_followup	153	149	100	53	49	0.654	-7,.2,.5,0.5-3,1-1.5,1-3,1-5,1-6.5,1.2-3,1.5-13,1.5-2,1.5-5,10-25,2-2.5,2-3,3,3-12,3-pinnate,4-5,6-7,abaxially,absent,accrescent,acuminate,acute,adaxially,anther,apex,apical,apiculate,articulated,basally,base,blade,broadly,brown,calyx,chartaceous,cm,cordate,cuneate,cylindrical,deltoid,elliptical,entire,extra-axillary,flower,fruit,fruiting,glabrous,hair,herb,interjected,lanceolate,lateral,leaf,leaflet,lenticular,light,lobe,longitudinal,lower,margin,membraceous,mm,oblique,oblong,obtuse,opening,pedicel,peduncle,perfect,petiole,petiolule,pore,pubescent,rachi,rarely,rhomboid,rounded,sagittate,simple,slender,slightly,slit,smooth,stellate,stigma,style,surface,terrestrial,tip,truncate,tube,unbranched,undulate,uniseriate,white,x,yellow	0.5-1,0.5-5,0.8-4,1-1.2,1-5.5,1-6,1-7,1.5-7.5,2-,4-8,5-merou,abundant,ag,along,alyx,apart,apparently,axe,ba,capitat,ciliat,connivent,diameter,directed,distally,eaf,eed,equal,filament,geminat,long,minutely,nflorescence,node,orolla,plurifoliate,proximal,pubescen,revolute,rooting,scattered,side,spaced,tamen,tem,trailing,truncate-acuminat,unit,vary,vein,wide,widely,ympodial	'',[,``,age,appressed,arrangement,articulation,bract,branching,breeding,broad-based,capitate,characteristic,colour,corolla,form,growth,inflated,inflorescence,insertion,interpetalar,length,mature,na,needle-like,number,odour,orientation,ovary,paired,position,prickle,scale,seed,shape,size,smell,staman,stem,symmetry,system,texture,tissue,trichome,type,value,vegetative,{,}
385	wfo-0001030353	success	227	120	81	146	39	0.357	.7,0,0.5-0.9,1.2-1.8,1/2-2/3,1/5,2-10,2.5-4,20-200,3.5-4,5,andromonoecious,anther,apart,articulated,base,berry,brown,calyx,chartaceous,cm,conical,connivent,cuneate,curved,deltate,diameter,ellipsoid,elliptic,elongating,equal,erect,evenly,flattened,flattened-reniform,fruit,fruiting,green,lateral,leaf,length,lobed,long,lower,margin,maturity,mauve,mm,multangulate,pedicel,per,petiole,poricidal,prickle,reflexed,sessile,shape,shrub,small,somewhat,spaced,spreading,stalked,stellate-pubescent,stem,straight,style,subentire,surface,tapering,terminal,tip,tree,trichome,unbranched,unit,upper,way,weakly,yellow,young	-0.2,-1.5,-1/2,-2,-3,-5,-6,-merous,.1,.2,.5,0-15,0-2,0-6,0.1-0.2,0.1-0.3,0.15-0.3,0.5,0.8,0.8-1.2,1,1-2,1-3,1-6,1-7,1.8-2.2,1.8-3,1/,1/3,1/6,1/6-1/4,10-15,11-16,2-7,2.8-3.7,3-4,3-5.5,4-,4-4.5,4-5,5-6,6,6-15,6-8,7-10,8-15,abaxial,abaxially,acute,adaxial,almost,alyx,apar,apex,apically,apiculat,apparently,bark,blade,broad-deltate,c.,densely,development,discolorous,distal,distance,drying,eaf,eed,extending,filament,flower,free,glabrescent,glabrous,half,hermaphrodite,heterostylous,infructescence,less,lobe,long-styled,longer,lowermost,mature,midpoint,midvein,moderately,narrow-deltate,nflorescence,older,one,open,orange-brown,orolla,oung,pair,patch,peduncle,pendulous,pericarp,plant,plurifoliat,pointed,porrect,portion,prickly,primary,ray,red-brown,reddish-green,retaining,rounded,ruit,scar,short-styled,shorter,side,simple,smooth,sometimes,sparsely,stalk,staminat,stellate,stout,strongly,tamen,terete,tertiary,throughout,time,tube,unarme,unarmed,vary,vein,venation,visible,warty,whit,white-gray,wide,wo,woody,ympodial	articulation,bract,branching,breeding,cell,colour,corolla,form,growth,heteromorphism,inflorescence,insertion,interjected,interpetalar,leaflet,na,number,odour,orientation,ovary,paired,placement,plurifoliate,position,rhizome,seed,smell,staman,stone,structure,symmetry,sympodial,system,texture,tissue,tuber,type,vegetative,xylopodia
386	wfo-0001030407	invalid_json_followup	182	172	112	70	60	0.615	.2,.5,0.7-3.2,1-10,1-2,1.5-5,12-14,12-15,2-5,2-6.7,2-7,3-10.5,3-6.5,3.5-9.5,30-60,4-5,5,6.5-18.5,7-8,abaxially,absent,adaxially,anther,apart,apex,axillary,base,berry,blade,brownish,bud,cell,chartaceous,ciliate,cm,condition,conical,corolla,covering,densely,diameter,distal,dorsally,drying,edge,end,filament,flat,flower,folded,forked,fresh,fruit,generally,glabrous,green,green-white,greenish,hair,half,herb,homostylous,interjected,lanceolate,lateral,leaf,leaflet,lengthening,light,like,long,make,margin,middle,minute,mm,mottled,mucilaginous,obtuse,odd-pinnate,one,ovoid,pedicel,peduncle,pentagonal,petiole,placed,plant,pore,poricidal,proximal,pubescent,purple,ripe,round,seed,size,slit,style,subtending,symmetrical,terminal,testal,thick,throughout,tip,tuber,typically,wall,wet,whitish,x	1-3,1-4,2-2.5,3-4,3-9,5-merou,6-7,acumen,acuminate,ag,alyx,apparently,articulated,axe,capitat,connivent,decreasing,digestion,eaf,eed,elliptic-lanceolate,enzyme,especially,exceeding,geminat,glabrou,gradually,hair-like,honeycomb-shaped,larger,living,lobe,lower,nflorescence,orolla,ovate,pair,perfect,petiolule,plurifoliate,pubescen,ray,removed,ruit,secondary,semierec,seudostipule,spaced,specimen,stamen,ste,stigma,stolo,subequal,subsessile,tall,tamen,tem,thir,toward,tri-,tube,unit,unwinged,usually,vary,white,wide,yellow,ympodial	'',[,\u201chair-like\u201d,``,age,appressed,arrangement,articulation,bract,branching,breeding,broad-based,calyx,characteristic,colour,connective,form,fruiting,growth,hairines,height,inflated,inflorescence,insertion,interpetalar,length,marking,mature,modification,na,number,odour,ovary,paired,pattern,placement,position,prickle,pseudostipule,scale,shape,smell,spacing,spot,stellate,stem,stolon,symmetry,system,texture,third,tissue,trichome,type,value,vegetative,width,zygomorphy,{,}
387	wfo-0001030420	success	170	178	127	43	51	0.747	-2,-20,-30,-35,-9,-pubescent,0.5-,0.5-1,0.5-4,0.5-8,1,1-1.5,1-2,1-3,1-4,1-6,1-7.5,1.5-3,1.5-5,10-,10-25,15-25,2-,2-14.5,2-3,2-5,2-9,3-lobed,4-7,5-,5-15,5-6,6-7,abaxially,absent,acuminate,acute,adaxially,aggregate,also,apart,apex,basal,base,beyond,calyx,cell,chartaceous,cm,connective,connivent,cordate,cylindrical,dark,deltate,densely,diameter,directed,distally,eglandular,eglandular-puberulent,ellipsoidal,elliptic-ovate,elongated,entire,equal,flower,forked,fruit,glabrate,glabrous,glandular-,glandular-puberulent,hair,lanceolate,leaf,leaving,lobe,lobed,long,margin,mm,moderately,narrowly,nearly,obtuse,often,ovate,pedicel,pedicellar,peduncle,perfect,petiole,pilose,pinnately,pore,puberulent,pubescent,pubescent-pilose,purple,rachi,radiu,rarely,remnant,shorter,shrub,simple,small,sparsely,stamen,stellate,stigma,stone,style,subcoriaceous,thecae,tip,tree,triangular,truncate,tube,unbranched,unknown,unlobed,vein,x,yellow	-4,1-,1/2,2-6,3-7,4-foliat,7-19,7-22,7/8,ape,articulated,axe,blade,color,divided,eaf,eed,eglandular-pilo,exserted,lon,lower,midrib,nflorescence,nther,orolla,presen,puberulent-pubescent,pubescent-pilo,ripe,ruit,sinus,spaced,tal,tem,time,tomento,truncat,ud,unit,vary,wide,yello,ympodial	anther,articulation,bract,branching,breeding,bud,colour,corolla,eglandular-pilose,exsertion,filament,form,growth,height,heteromorphism,inflorescence,insertion,interjected,interpetalar,leaflet,length,lobing,marking,na,odour,orientation,ovary,paired,placement,plant,position,present,prickle,pseudostipule,rhizome,scale,seed,shape,size,spacing,spot,staman,stem,symmetry,system,texture,theca,tissue,tuber,type,xylopodia
388	wfo-0001030426	invalid_json_followup	158	144	77	81	67	0.487	-30,0.3-7,0.4-0.7,1-4,1-4.2,1.7-3.2,10,15-25,2,2.5-4,2.5-6,3-12,3-6,4-6.5,6-11.5,6-8,9,apex,apically,base,branched,calyx,cell,cm,connate,corolla,cyme,dehiscent,diameter,dichasial,dichasially,distal,ebracteate,filament,flower,glandular,globose,green,green-white,hair-like,heart-shaped,herbaceous,interjected,lateral,leaf,leaflet,long,mm,monochasial,oblique,odd-pinnate,ovoid,pair,pattern,pedicel,peduncle,perennial,perfect,petiole,pilose,plant,poricidally,proximal,rounded,seed,spot,stellate,straight,style,terminal,throughout,tuber-bearing,unit,wall,white,yellow,Â¼	0.3-8,1.5-3,1.5-6.5,2-3,3-4,3-6-foliat,4-10,abaxially,absen,acumen,acute,adaxially,apical,apiculate,articulate,caudate,covering,decurrent,digestion,diminishing,dorsally,eaf,edge,eed,elliptic-lanceolate,emoval,enzyme,exceeding,flat,folded,forked,generally,globo,gradually,half,honeycomb,introrse,lanceolate,larger,linear,linear-lanceolate,linear-oblong,living,lobe,lon,lower,make,maturing,mucilaginous,nflorescence,nther,oblong,obtuse,often,orolla,pinnatifi,plan,rachi,reveal,ruit,second,sessile,seudostipule,short,size,slit,specimen,stamen,stigma,stripe,tal,tem,testal,thick,toward,typically,vary,whit,wide,without,ympodial	'',3-6-foliate,[,``,absent,anther,appressed,arrangement,articulation,bract,branching,breeding,characteristic,colour,connective,form,fruit,fruiting,growth,hair,height,heteromorphism,history,inflated,inflorescence,insertion,interpetalar,length,life,margin,marking,mature,modification,na,number,odour,orientation,ovary,paired,pinnatifid,placement,pore,position,present,prickle,pseudostipule,rhizome,scale,shape,staman,stem,stone,structure,symmetry,sympodial,system,texture,tissue,tuber,type,value,width,xylopodia,ye,zygomorphy,{,}
389	wfo-0001030430	invalid_json_followup	171	160	84	87	76	0.491	.2,.5,0.25,0.4,5,abundant,acute,anther,anthesi,apart,apex,appressed,base,blue,brittle,brown,calyx,capitate,cell,clavate,cm,cylindrical,decurrent,densely,diameter,elliptic,few-seeded,filament,flattened,fleshy,flower,fruit,glabrous,globose,green,hair,leaf,lobe,lobed,long,longitudinal,margin,mm,moderately,multicellular,oblong,occasionally,opening,ovate,pair,pale,pedicel,peduncle,pentagonal,perennial,perfect,petiole,pitted,pore,present,pubescent,purple,regularly,rounded,shallowly,shaped,shrub,simple,slit,stigma,stone,straight,style,subglabrous,surface,tear-drop,time,tube,uniseriate,violet,white,woody,x,yellow	0.3,0.5,0.5â12,0.6,0.6â0.8,0.6â1.0,0.8â3.0,0.8â5.6,0.9â1.0,0â20,1.0â1.2,1.0â1.5,1.0â2.0,1.2â2.0,1.3â8.0,1.4â1.5,1.5â1.7,1.6â1.8,1.8â5.0,12â20,12â30,1â3,1â9,2.0â3.0,2.0â4.2,2â3,3.0â4.5,30â200,3â17,3â24,3â4,3â5,3â8,5.5â12,5â10,5â6,6â10,abaxially,adaxiall,adaxially,ag,apical,articulated,axe,axillary,ba,basal,blade,borne,branched,bud,chartaceous,connivent,convex,dentate,diamete,eaf,eed,equal,erect,especially,geminat,indumentum,lon,lower,m.,nflorescence,orolla,poricidal,ruit,serrate,shoot,side,spaced,tal,tamen,tem,terminal,tip,toward,unifoliate,unit,vary,wide,ympodial,â2.7,â40	'',0-20,0.5-12,0.8-5.6,1-3,1.0-1.2,1.0-2.0,1.2-2.0,1.3-8.0,1.4-1.5,1.6-1.8,12-20,12-30,2-3,2.7,3-17,3-4,3-5,3-8,30-200,40,5-10,5-6,[,``,abaxial,adaxial,age,arrangement,articulation,bract,branching,breeding,characteristic,colour,connective,corolla,form,fruiting,growth,height,history,inflated,inflorescence,interjected,interpetalar,leaflet,length,life,marking,mature,modification,na,number,ovary,pattern,plant,position,ratio,scale,seed,shape,size,spacing,spot,staman,stem,symmetry,system,texture,tissue,trichome,type,value,{,}
390	wfo-0001030441	invalid_json_followup	178	185	135	43	50	0.758	+,.5,0.5,0.5-0.75,0.5-3,1,1-1.4,1-1.5,1-2-celled,1.2-1.4,1.5-2,10-40,2,2-10,2-5.5,2.5,3-4,30,4-5,5-14,5-7,5-7.5,6-11,<,>,acuminate,acute,anther,anthesi,apart,apex,articulated,attenuate,base,berry,branched,bright,c.,calyx,capitate,cell,closely,cm,corolla,decurrent,deltate,diameter,ellipsoid,elliptic,entire,exerted,eye,filament,flattened,flexuous,flower,fruiting,glabrous,glandular,globose,green,growth,hair,irregularly,juicy,lateral,leaving,lengthening,lobe,lobed,long,lower,making,many,margin,membranous,midvein,minutely,mm,narrowly,new,occasionally,onto,open,pair,pale,pedicel,peduncle,peg,per,perfect,pericarp,petiole,plant,pore,poricidal,primary,pubescent,red,reniform,ridged,ripe,scar,shiny,short,shrub,simple,slightly,slit,spaced,spot,stellate,stem,stigma,strongly,style,surface,terminal,thin,time,tip,triangular,trichome,tube,undulate,uniseriate,upper,usually,vein,vine,violet,wall,way,white,yellow	0.5-1,2-3,5-6,5-merou,ag,along,alyx,ark,brow,distall,eaf,eed,free,glabrou,glandula,ilament,impressed,lon,markedly,nflorescence,older,orolla,otherwise,papillat,papillose,plurifoliat,portion,reflexed,ruit,scandent,shrubby,small,somewhat,spreadin,spreading,tem,trailing,ud,unit,vary,wide,woody,ympodial	'',5-merous,[,\u201chairs\u201d,``,age,arrangement,articulation,bark,bract,branching,breeding,brown,bud,characteristic,colour,connective,distally,exertion,form,fruit,height,inflorescence,interjected,interpetalar,leaf,leaflet,length,marking,modification,na,number,odour,ovary,papillate,pattern,position,ridging,seed,shape,symmetry,system,texture,thicknes,tissue,type,value,width,{,}
391	wfo-0001030444	invalid_json_followup	196	177	129	67	48	0.658	0-24,0.15-0.8,0.8-2,1,1-10,1-2,1-4,1.1-2.7,1.2-1.8,11-45,2-3,2-8,2.3-3.6,2.4-3.8,3-10,3-5,3.7-6.8,4-17,4-39,4-7,5.3-9,6.1-12.8,7.1-17.5,9.4-20.1,acumen,acuminate,acute,anther,apart,apex,asymmetric,attenuate,axillary,base,berry,blade,blue,brownish,bud,cell,ciliate,clavate,cm,condition,coriaceous,corolla,dark,deep,diameter,digestion,distal,dorsally,dot,drying,edge,elliptic,enzyme,filament,flat,flower,folded,forked,fresh,fruit,generally,glabrous,green,greenish,half,herb,high,homostylous,honeycomb-shaped,interjected,lanceolate,lateral,leaf,leaflet,lengthening,light,lilac,lobe,margin,medium,mm,moniliform,narrow,odd-pinnate,orbicular,ovate,ovoid,pedicel,peduncle,pentagonal,petiole,petiolulate,plant,pore,poricidal,purple,removed,ripe,rotate,rough,rounded,seed,sessile,shortly,size,slit,sometimes,stigma,straight,style,subtending,symmetric,terminal,testal,tip,touch,tube,tuber,unwinged,usually,wall,white,whitish,wing,x	1-5,2-6,5-merou,abaxiall,abaxially,adaxially,ag,along,alyx,apparently,arranged,articulated,axe,basiscopic,bead,capitat,connivent,covering,decreasing,eaf,eed,erec,exceeding,geminat,general,glabrou,green-white,hair-like,hal,larger,like,linear,living,long,lower,make,mucilaginous,multiple,necklace,nflorescence,orolla,pair,perfect,plurifoliate,ruit,seudostipule,side,spaced,specimen,stamen,stolon,subequal,tall,tamen,tem,thick,throughout,tissue,toward,tri-,typically,unit,vary,wet,wide,yellow,ympodial	'',5-merous,[,``,abaxial,adaxial,age,arrangement,articulation,attachment,branching,breeding,calyx,capitate,characteristic,colour,connective,erect,form,growth,hair,height,inflorescence,length,marking,merosity,modification,na,number,ovary,pattern,position,presence,pseudostipule,roughnes,shape,spacing,spot,staman,stem,symmetry,system,texture,value,width,zygomorphy,{,}
392	wfo-0001030445	success	226	117	76	150	41	0.336	0.6-2.2,1-7,1.3-2,10-14,14,15-35,3.5-4.2,5.9-15,8.2-18,abaxial,accrescent,acuminate,anther,apex,bark,base,berry,black,blunt-tipped,branch,branched,calyx,cm,corolla,decurrent,diameter,drying,elliptic,entire,ferruginous-granular,ferruginous-tomentose,filament,flower,fruit,fruiting,geminate,glabrate,globose,green,greyish-tan,hair,lateral,leaf,long,main,many,margin,midrib,mm,oblong,oblong-lanceolate,petiole,plurifoliate,pore,poricidal,porrect-stellate,pseudoterminal,pubescence,pubescent,relatively,shrub,side,simple,slightly,small,stellate,sulcate,thin,time,tissue,tomentose,tree,unit,vein,yellowish,young	.1,.5,/5-2/3,0.1-0.7,0.2,0.2-0.4,0.2-0.5,0.2-0.7,0.3,0.4,0.5,0.6-3.5,0.7,0.8,1,1-1.3,1.1-4.3,1.3,1.3-1.8,1.5-2.1,1.6-2,1.7-2.4,1.8-3.5,10-16,2.1-5.2,2.2-2.9,2.2-3.5,2.4-4.7,3-5.4,3.1-5,3.4-5.6,4.1-8.7,4.2-10,5-125,5-merou,5.2-7.1,5.9-8.3,6.1-9.1,7.5-16,8.1-10,abaxially,acute,adaxially,ag,along,alyx,apart,appressed,around,articulated,axillary,blade,blunt-tippe,brown,brownish-yellow,bud,bulbous-based,capitate,concentrated,cylindrical,deltoid-reniform,directed,distally,eaf,earl,edge,eed,elliptical,elongated,erect,exserted,ferruginous,free,glabrescen,glabrous,high,homostylous,inserted,intermediate,lackin,lengthening,lobe,lobed,lon,longitudinal,lower,m.,midvein,mostly,multangulat,multangulate,nflorescence,obovate,obscured,obtuse,older,open,orange,orangish-tan,orbicular,orolla,ovate,ovate-lanceolate,pedicel,peduncle,porrect-stellat,rachi,ray,reniform,resorption,reticulate-punctate,rounded,ruit,runk,semi-spherical,sessile,slit,somewhat,soon,spaced,sparse,sparsely,splitting,stalk,stamen,stem,stigma,stout,style,subcampanulate,surface,suture,tamen,thick,thick-textured,thicknes,thin-,tip,tomentum,tube,unarme,vary,vestigial-rayed,way,white,wide,x,yellow,yellowish-tan,ympodial	adaxial,arrangement,bract,branching,cell,colour,connective,form,growth,height,heteromorphism,inflorescence,interjected,interpetalar,leaflet,length,marking,na,odour,orientation,placement,plant,position,prickle,pseudostipule,rhizome,scale,shape,spot,staman,stone,structure,sulcation,symmetry,sympodial,texture,trunk,tuber,type,width,xylopodia
393	wfo-0001030447	success	276	107	61	215	46	0.221	0.4-0.7,0.5,0.8-3.5,1.5-7,1/4-1/3,2.5-10,accrescent,anther,apex,base,berry,calyx,cell,chartaceous,cm,corolla,cuneate,curved,difoliate,filament,fruit,fruiting,gently,globose,lateral,leaf,length,less,lobed,long,margin,mature,mm,moderately,oblique,orange-red,pedicel,perfect,petiole,point,pore,poricidal,prickle,rounded,shallowly,shrub,side,simple,slender,sparse,stellate,stellate-pubescent,stem,straight,tapering,trichome,unbranched,unit,white,wide,widest	.2,.3,.5,/5,0,0.1,0.1-0.3,0.15-0.3,0.2,0.2-0.4,0.4-0.9,0.5-0.65,0.5-10,0.5-3,0.7-1,0.8-1.7,1,1-1.5,1-10,1-2,1-2.5,1-3,1-5,1-6,1.5,1.5-2.5,1.8-2.5,1/3,1/3-1/2,1/3-2/3,2-4,2.2-2.8,2.5-6.5,3,3-4.5,3-5,30-45Â°,4-8,5,5-15,5-merou,6,6-10,6-16,6-7,6-8,6-9,6.5-9,7-8,8,abaxially,acute,adaxially,age,always,alyx,apar,apart,apical,apically,apparently,armed,articulated,axe,bark,beyond,blade,branche,broad-deltate,c.,characteristically,clavate,covering,cupular,dark,deltate,densely,development,diameter,discolorous,distance,divided,drying,eaf,eed,elongating,equal,erect,exserted,extending,filiform,fine,finely,finger-hair,flat,flattened,flattened-reniform,flower,free,geminat,glabrescent,glabrous,herbaceous,infructescence,irregula,irregular,lengthening,lobe,long-ovoi,long-styled,longer,longitudinal,lower,maturity,midpoint,midvein,minute,mostly,narrow-deltate,nflorescence,obconical,oblong,obtuse,often,older,one,open,opening,orange,orange-brown,orange-translucent,orolla,oung,outline,ovate,pair,pale,papillo,peduncle,pendulous,per,pericarp,persisting,pit,porrect,portion,primary,pronounced,prostrate,pubescent,purple,rachi,raised,ray,red-brown,reduced,rest,ri,ridge,ridged,ruit,scar,sessile,shallow,shiny,short-styled,shorter,shortly,sinus,slit,small,smooth,sometimes,somewhat,spaced,sparsely,spherical,spreading,stalk,stalked,stigma,stout,straw-yellow,stump,style,subsessile,surface,tamen,terete,terminal,tertiary,thick,thin,throughout,time,tip,toward,translucent,tube,ud,unarmed,unequal,usually,variously,vary,vein,venation,visible,weakly,woody,x,yellow,yellow-orange,ympodial,Ã	appressed,articulation,bract,branched,branching,breeding,broad-based,colour,connective,form,geminate,growth,hair,heteromorphism,inflated,inflorescence,insertion,interjected,interpetalar,leaflet,marking,na,needle-like,odour,orientation,paired,pattern,placement,position,pseudostipule,rhizome,scale,shape,spot,staman,stone,structure,symmetry,sympodial,system,texture,tissue,tuber,type,xylopodia,zygomorphy
394	wfo-0001030453	success	127	103	62	65	41	0.488	.25,.5,/4,1-1.3,1-1.5,1.5-1.6,1.5-2.5,3-3.5,4-5,9-14,acuminate,acute,anther,apex,arachnoid,arachnoid-pubescent,attenuate,bark,base,broadly,calyx,clavate,cm,corolla,cup-shaped,dark,divided,ellipsoid,elliptic,exserted,filament,floccose,glabrous,known,later,leaf,minutely,mm,narrowly,occasionally,opposite,ovary,pedicel,petiole,pore,pubescent,reddish,rounded,shaped,shiny,shrub,simple,sparsely,stigma,strongly,style,surface,tear-drop,tube,unit,way,white	0.25-0.5,0.8-1.5,9-12,abaxially,adaxially,along,anthesi,axi,closely,deflexed,delicate,deltate,dendritic,densely,dia,eaf,edicel,eed,especially,fine,flat,free,glabrate,know,lateral,less,lobe,lon,long,lower,main,margin,middle,midrib,minute,near,nearly,nflorescence,older,overlappin,pair,papillat,papillose,planar,poricidal,portion,reddish-brow,ruit,scar,slender,soon,spaced,stem,straight,tall,tip,trichome,tub,ud,unifoliat,vein,wide,widest,ympodial,young	abaxial,articulation,bud,cell,colour,connective,diameter,exsertion,form,fruit,growth,hair,height,heteromorphism,inflorescence,insertion,length,na,orientation,papillate,placement,plant,position,prickle,pseudostipule,pubescence,reddish-brown,rhizome,seed,shape,staman,stone,structure,symmetry,sympodial,texture,tuber,type,unifoliate,width,xylopodia
395	wfo-0001030486	success	141	142	88	53	54	0.624	.5,0.8-2.2,1-1.5,1-5,1.1-1.4,1.5-2,1/2,1/4,10-14.5,2-3,2-5.5,3-3.5,3/4,4-4.5,4-6.5,4.5-5,6-7,acute,anther,anthesi,apex,bark,basal,base,calyx,clavate,closely,clustered,cm,completely,conical,corolla,deflexed,dia,difoliate,distal,ellipsoid,elliptic,f,filament,fleshy,fruiting,glabrous,globose,green,internodal,later,leaf,lobed,long,margin,minor,minutely,mm,older,opposite,ovary,overlapping,ovoid-reniform,pale,papillose,pedicel,petiole,pitted,pore,scar,shaped,shrub,size,slightly,small,spaced,stem,stigma,style,surface,tapering,tear-drop,treelet,tube,unit,usually,way,white,woody,x,yellow-green,young	1.7-2,10-12,3-5,5-8-flowered,abaxially,adaxially,ba,beneath,berry,brown,dark,deltate,differing,dry,drying,eaf,edicel,eed,erect,exserted,free,fresh,geminat,inflorescenc,lateral,lobe,lon,lower,m.,main,major,material,middle,nflorescence,pair,papillo,planar,poricidal,portion,reddish,ruit,shin,simple,stout,tall,tan,thickened,tip,tub,ud,vein,widest,ympodial	5-8,articulation,bract,branching,breeding,bud,cell,colour,connective,exsertion,flower,form,fruit,geminate,growth,hair,height,heteromorphism,inflorescence,insertion,interjected,interpetalar,leaflet,length,marking,mature,modification,na,number,odour,orientation,pattern,placement,plant,position,prickle,pseudostipule,rhizome,scale,seed,shape,shiny,spot,staman,stone,structure,symmetry,sympodial,system,texture,tissue,tuber,type,xylopodia
396	wfo-0001030489	success	196	137	84	112	53	0.429	0.75-0.9,1.6-2.1,1/5-1/2,2.1-2.9,3-8,abaxially,abruptly,adaxially,anther,apex,apical-lateral,apparently,appressed,appressed-pubescent,articulated,attenuate,axillary,base,becoming,berry,blade,blunt-tipped,branched,calyx,chartaceous,cm,continued,corolla,dichotomously,due,echinoid,entire,filament,fleshy,fruit,glabrate,greenish,growth,hair,introrse,large,lateral,leaf,length,longitudinal,lower,margin,minute,minutely,mm,mostly,multangulate,narrowly,oblong,obtuse,pedicel,perfect,petiole,plurifoliate,pore,porrect-stellate,probably,pseudo-terminal,pubescent,pulverulent,ripe,short,short-stalked,shrub,simple,slender,slit,small,somewhat,sparse,stellate-rotate,stem,subglobose,tree,turn,unit,white,x,yellow	-6.5,.5-2.8,.5-3,.75-5.25,0.25-0.4,0.5-3,0.6-0.9,0.9-1.1,1-1.3,1-3,1-3.75,1.1-1.3,1.2-1.5,1.2-1.6,1.7-2,1.75-2,1.9-2.6,1/3-1/2,100,12-24,3-6,4-8,4.5-9,5,5-6,6-8,7-15,absen,acuminate,acute,adaxiall,ag,anthesi,apart,axe,ba,bark,branch,broadly,brown,bud,cinereous,closely,conical,cylindrical,dehiscing,deltoid,densely,diameter,eaf,echinoi,eed,elliptic,elongate,flower,free,glabrous,globose,high,honeycombed,inserted,lobe,lobed,long,long-acuminate,long-exserted,main,midvein,nflorescence,older,orolla,ovate,ovate-lanceolate,pale,peduncle,puberulent,pulverulen,rachi,reniform,reticulate-punctate,ruit,runk,sessile,several,side,smooth,spaced,sparingly,stellate-pubescent,stigma,style,subcampanulate,subcapitat,suborbicular,tamen,terete,testa,thick,time,tomentose,toward,tube,unarme,unarmed,usually,vary,vein,way,wide,yellowish,ympodial,young	absent,age,articulation,bract,branching,breeding,broad-based,cell,colour,connective,form,fruiting,heteromorphism,inflated,inflorescence,insertion,interjected,interpetalar,leaflet,marking,mature,modification,na,needle-like,odour,orientation,paired,pattern,placement,position,prickle,pseudostipule,rhizome,scale,shape,smell,sparingy,spot,staman,stellate,stone,structure,surface,symmetry,sympodial,system,texture,tissue,trichome,tuber,type,vegetative,xylopodia
397	wfo-0001030509	invalid_json_followup	220	162	121	99	41	0.55	-6,/3,0-100,0-5,0.3-2.5,0.5-1.5,0.6-1,0.8-4,1-1.5,1-2,1-4,1.3-2,2-2.5,2-3,2-4.2,2-4.5,2-6,2.8-3,2/3-3/4,3-10,3-4,4.5-8,5-merous,8-16,andromonoecious,anther,apart,apex,articulated,bark,base,berry,calyx,chartaceous,cm,connivent,cordate,cream,cuneate,curved,dark,densely,diameter,discolorous,drying,elongating,entire,equal,erect,filament,flower,fruit,fruiting,glabrescent,glabrous,gray,green,half,herb,heterostylous,inflated,lateral,leaf,length,lobed,long,margin,marking,mature,maturity,mauve,mm,moderately,obtuse,occasionally,orange,orange-brown,ovate,pair,pale,pedicel,peduncle,per,petiole,plant,poricidal,porrect,prickle,prickly,purple,rounded,shrub,simple,sometimes,sparsely,spherical,stalked,stellate,stellate-pubescent,stem,straight,surface,tapering,terminal,tertiary,tip,trichome,tube,unarmed,unbranched,upper,usually,variously,venation,visible,way,weakly,wide,yellow,yellow-green,young	-10,-2,0,0-0.3,0-15,0-3,0.1,0.1-0.2,0.1-0.25,0.1-0.3,0.2,0.8-1.2,1,1-3,1-6,1.5-2,1.7-2,1/,1/3-2/3,1/4,4.5-10,4.5-12,5-10,7-15,7-9,abaxially,alyx,apar,apical,apically,apparently,becoming,blade,broad-deltate,brow,difoliate,distal,distance,eaf,eed,extending,eye,flattened-reniform,free,geminat,gland,globular,herbaceous,hermaphrodite,infructescence,lobe,long-acuminat,long-styled,longer,lower,lowermost,midpoint,midvein,naked,narrow-deltate,narrow-oblong,nflorescence,occasional,often,older,one,open,orolla,oung,pendulous,pericarp,perpendicular,portion,primary,ray,reduced,ruit,scar,short-styled,shorte,shorter,side,slender,smooth,spaced,spreading,stalk,staminat,style,subsessile,tamen,terete,time,unarme,unit,vary,vein,woody,ympodial	'',[,``,appressed,articulation,bract,branching,breeding,brown,characteristic,colour,connective,corolla,form,growth,hair,height,inflorescence,modification,na,number,ovary,pattern,pore,position,presence,scale,seed,shape,size,spacing,spot,staman,symmetry,system,texture,type,value,width,{,}
398	wfo-0001030516	invalid_json	172	146	103	69	43	0.599	0.4-1.5,1-4,1-7,1.1-4.1,1.5-2,1.8-2.4,2-12,2-3,2-4,3-8,4-22,4-6,4-7,4.2-10.7,6-15,8-9,9-22,9-32,acute,apical,apically,base,branched,calyx,cm,connate,corolla,cyme,darker,dehiscent,diameter,dichasial,dichasially,diminished,distal,dorsally,edge,exceeding,filament,flat,flower,folded,gland,globose,gradually,green,green-white,hair,hair-like,herbaceous,interjected,introrse,lateral,leaf,leaflet,light,lobe,long,long-attenuate,maturing,mm,monochasial,mucilaginous,odd-pinnate,often,outline,ovoid,pedicel,peduncle,pentagonal,perennial,perfect,petiole,pilose,plant,poricidally,proximal,puberulent,pubescent,rotate,seed,short,short-stalked,size,slightly,slit,sometimes,spreading,stamen,straight,stripe,style,terminal,throughout,toward,triangular,tuber-bearing,type,unit,wall,wide,yellow,Â¼	1-2.5,1.1-3.5,1.7,2-2.,3-6,3-6-foliat,3-9.8,4-4,abaxially,acumen,acuminate,adaxially,apex,articulate,cell,cordate,covered,covering,cuneate,decurrent,densely,digestion,eaf,ebracteate,eed,elliptical,emoval,enzyme,first,forked,generally,globo,half,honeycomb,less,living,lon,longer,lower,lunat,make,nflorescence,nther,oblique,orolla,ovate,pair,pattern,plan,rarely,reveal,ruit,second,sessile,seudostipule,short-petiolate,specimen,stigma,tal,tem,testal,thick,time,triangulat,typically,vary,whit,ympodial,â	'','type,2-21,3-6-foliate,[,],``,anther,arrangement,articulation,bract,branching,characteristic,colour,connection,dehiscence,direction,ebbrate,fork,form,fruit,growth,height,inflorescence,length,lunate,number,ovary,perfection,presence,present,property,pseudostipule,shape,stem,structure,sympodial,texture,value,white,width,{,}
399	wfo-0001030551	success	167	136	100	67	36	0.599	-30,-5,0-2,1-10,1-2,1-3.5,1-4,1-5,10-20,2,2.5-4,20-25,3-12,3-5,4-5,5-17,5-6,abaxially,abruptly,absent,acuminate,acute,adaxially,adpressed,also,apex,basal,base,blue,broad,campanulate,cell,chartaceous,clavate,cm,concave,connective,cordate,densely,dilated,directed,distally,ellipsoidal,entire,et,exceeding,fading,fruit,glandular-puberulent,globose,hair,lanceolate,laterally,leaving,lobe,long,margin,martinelli,mm,moderately,narrow,narrowed,oblong-fusiform,obtuse,often,ovate,ovate-elliptic,ovoid,pedicel,pedicellar,peduncle,petiole,pore,puberulent,puberulent-pubescent,pubescent-pilose,rachi,remnant,ripe,round,seen,shorter,shrub,simple,slightly,small,sparsely,stellate,stigma,stone,style,subcoriaceous,thecae,truncate,tube,unbranched,unknown,violet,x,yellowish	-12,0.5-1,0.6-1.5,1,1-,1-2.5,1.5-,1.5-2.5,10-40,13.,2-3,2-6,2.5-5,3-,3-8,4-,4-7,4-foliat,9-20,aggregate,apart,ape,articulated,axe,beyond,bilobe,blade,calyx,color,dia,diameter,eaf,ed,equal,exserted,fleshy,flower,glabrous,lon,lower,narrowly,nflorescence,nther,orolla,papillose,perfect,pilose,puberulen,pubescent-pilo,radiu,ruit,spaced,stamen,tal,tem,time,tip,tomento,triangular,triangular-elliptic,ud,unit,unknow,vary,wide,widening,ympodial	138,anther,articulation,bilobed,bract,branching,bud,colour,corolla,form,growth,height,heteromorphism,inflorescence,leaf,length,marking,na,orientation,ovary,placement,plant,position,prickle,pseudostipule,rhizome,seed,shape,spot,staman,symmetry,texture,tomentose,tuber,type,xylopodia
400	wfo-0001030570	success	173	139	94	79	45	0.543	0.3-0.5,0.5-1,1-1.5,1-2,1-3,1-8,1.5,2-3,2-7-lobed,2-8,3-6,3.5-5,4-5,abaxially,acuminate,acute,apex,articulated,basal,base,calyx,campanulate,cell,cm,connective,connivent,cordate,cylindrical,diameter,dilated,directed,distally,eglandular,ellipsoidal,elliptic-oblong,entire,exceeding,flattened,forked,fruit,glabrous,glandular-puberulent,globose,green,hair,lanceolate,leaf,leaving,lobe,lobed,long,lower,margin,mm,narrowly,near,obtuse,occasionally,ovate,ovoid,pedicel,pedicellar,petiole,pilose,pinnately,pore,pubescent,purplish,radiu,rarely,remnant,rounded,rugose,shorter,simple,slightly,sometimes,sparsely,stellate,stigma,stone,style,submarginally,thecae,tree,triangular,truncate,unbranched,unit,unknown,unlobed,white,x,yellow	-1,.3-0.5,0-,0.5-,1,1-,1-4,1-5,1.5-2.5,1/2,10-17,10-25,15-20,15-35,2-2.5,2-4,2-5,2-7,2.5-22,20-30,3-10,3-5,4-25,4-7,4-foliat,4/5,5-,8-,absent,adaxially,aggregate,apart,ape,apiculate,axe,beyond,blade,color,divided,eaf,eed,exserted,fleshy,flower,glabrat,lon,midrib,nflorescence,nther,often,orolla,peduncle,perfect,pilo,presen,punctate,purpl,rachi,ripe,ruit,sinus,small,somewhat,spaced,stamen,subcoriaceous,tal,tem,time,tip,tomento,truncat,tube,ud,unequal,vary,vein,wide,ympodial	4-foliate,abaxial,adaxial,anther,articulation,bract,branching,broad-based,bud,colour,corolla,filament,form,growth,height,heteromorphism,inflorescence,length,marking,na,needle-like,orientation,ovary,placement,plant,position,present,prickle,pseudostipule,rhizome,seed,shape,spot,staman,stem,structure,surface,symmetry,sympodial,texture,trichome,tuber,type,xylopodia,zygomorphy
401	wfo-0001030581	invalid_json_followup	187	178	113	74	65	0.604	.5,1,1-4-celled,2,abaxial,acute,adaxial,adaxially,aggregate,along,angle,angled,anther,anthesi,appressed,articulated,basal,base,berry,black,bright,calyx,capitate,cell,central,clustered,cm,conical,corolla,decurrent,densely,denser,diameter,ellipsoid,elliptic,entire,filament,flattened-reniform,fruit,fruiting,glabrous,globose,green,growth,herb,inflorescence,intermodal,lacking,later,lateral,leaf,less,like,live,lobe,long,margin,markedly,maturity,minutely,mm,near,new,occasionally,often,once-branched,outline,ovary,ovate,pedicel,peduncle,pentagonal,per,perfect,petiole,pitted,plant,portion,pubescent,purplish,rachi,reflexed,ridge,ripe,scar,shallow,shiny,simple,somewhat,sparsely,spreading,stellate,stem,stigma,stone,strongly,style,surface,tangled,terete,testal,third,translucent,trichome,tube,turning,uniseriate,upper,vein,white,woody,yellow,yellowish	.3,0.2â0.8,0.4â0.6,0.4â1.6,0.5,0.5â0.7,0.5â2.5,0.6â0.7,0.7â0.8,0.9â1,1.2â1.5,1.8â8,1â2,1â2-celled,1â2.5,1â4-celled,20â50,2â3-celled,35â45,3â4,3â5,4.5â12,4â7,4â9,5-merous,5â6,5â8,9,abaxially,apar,apex,becoming,beyond,branched,cone,difoliate,drop,eaf,eed,exserted,florescence,flower,free,geminat,halfway,individual,leave,lobed,lon,lower,minute,narrowly,pair,papillate,primary,reflexe,remaining,rounded,ruit,shorter,slightly,spaced,sprawlin,straight,tall,tem,ud,unit,usually,wide,winged,ympodial,â15,â5	'',0.2-0.8,0.3,0.4-0.6,0.4-1.6,0.5-2.5,0.6-0.7,0.7-0.8,0.9-1,1-2.5,1.2-1.5,1.8-8,15,2-3-celled,20-50,3-4,35-45,4-7,4-9,4.5-12,5,[,``,apart,articulation,bract,branching,breeding,bud,characteristic,colour,connective,form,hair,height,interjected,interpetalar,leaflet,length,marking,modification,na,number,odour,paired,pattern,pore,position,present,scale,seed,shape,smell,spacing,spot,symmetry,system,texture,tissue,type,value,vegetative,width,{,}
402	wfo-0001030583	success	166	142	101	65	41	0.608	.5,0.2-1,0.3-1,0.4-2.7,0.5-1,0.8-1,0.9-3.5,1-1.5,1-8,1/2,2.5-3,3-4,3/4,5-6,abaxially,acute,adaxially,along,anther,apex,bark,base,calyx,cell,closely,cm,conical,corky,corolla,cultivated,dark,deep,dendritic,densely,dia,difoliate,elliptic,especially,filament,flattened-reniform,flower,form,fruit,fruiting,glabrous,globose,golden,green,immature,incrassate,leaf,live,lobe,lobed,long,long-rectangular,long-triangular,lower,margin,midvein,minor,minutely,mm,narrowly,occasionally,opposite,orange-red,outline,ovary,overlapping,pale,pedicel,petiole,pitted,plant,pore,pubescent,ripe,rounded,scar,shaped,shrub,simple,size,small-capitate,spaced,spathulate,stem,stigma,style,surface,tear-drop,testal,trichome,tube,uniseriate,unit,way,white,x,yellow	.2,0.1-0.5,0.7-4.5,1,1-2,1.5-4,2.5,2.5-9,4-6,5-7,6-7,abaxial,anthesi,ba,berry,brow,crisped,cultivar,deflexed,differing,dry,eaf,edicel,eed,ellipsoid,enlarged,erect,free,frui,geminat,included,irregular,lateral,leave,like,lon,main,major,nflorescence,often,older,pair,papery,papillo,papillose,pericarp,planar,poricidal,portion,prostrate,rest,ruit,small,soon,specimen,stout,tall,tan,thin,tip,ud,vein,woody,ympodial,young	0.1-1,branching,breeding,broad-based,brown,colour,connective,geminate,growth,hair,height,heteromorphism,inflorescence,length,marking,modification,na,needle-like,number,orientation,pattern,placement,position,prickle,pseudostipule,rhizome,seed,shape,spot,staman,stellate,stone,structure,symmetry,sympodial,system,texture,tuber,type,xylopodia,zygomorphy
403	wfo-0001030605	success	144	141	115	29	26	0.799	.4,.5,0.1,0.3-0.5,1-4,1/3-1/2,12-19-flowered,2,2-3,2.5,7,abaxially,acute,adaxially,almost,anther,anthesi,apart,apex,apical,area,attenuate,base,beginning,berry,branch,branched,brown,calyx,cinereous,cm,commonly,conical,coriaceous,corolla,covered,cylindrical,dark,deflexed,dendritic-echinoid,densely,difoliate,dry,ellipsoid,exerted,filament,fruiting,glabrate,glabrous,globose,gold,green,growth,inflorescence,internodal,leaf,less,light,lobe,lobed,long,margin,material,minutely,mm,nearly,new,obovate,obtuse,occasionally,olive,opposite,otherwise,ovary,ovate,overlapping,ovoid-reniform,papillate,pedicel,peduncle,petiole,pitted,pore,poricidal,pubescent,rarely,reflexed,revolute,rounded,scar,scattered,shaped,shiny,shrub,simple,slender,slightly,smooth,somewhat,soon,sparsely,stigma,style,surface,tear-drop,thickened,tinged,tip,trichome,tube,unifoliate,way,white,woody,x	1,1.5-2,1.5-5.5,1.7,5-12.5,along,ape,beneath,dia,drying,eaf,edicel,eed,entire,free,geminat,inflorescenc,lower,midrib,nflorescence,papillosefruit,portion,sparesly,tub,ud,unit,vein,yellow,ympodial	arrangement,branching,bud,colour,density,distance,entirely,exertion,flower,form,fruit,geminate,length,modification,na,number,odour,papillose,position,seed,shape,size,symmetry,texture,type,ye
404	wfo-0001030624	invalid_json_followup	170	161	106	64	55	0.624	.5,0.5,0.5-1.5,0.9-1,1-3,1.2-1.8,1.2-2,1.5-2,2-10,2-3,25-40-flowered,3-3.5,3.5-4,4.5-8,anther,anthesi,apart,attenuate,axil,bark,base,beginning,berry,branch,calyx,clavate,cm,corolla,difoliate,dimorphic,distal,dry,ellipsoid,elliptic,end,except,exserted,extreme,falcate,filament,flattened-reniform,fruiting,furcate,glabrate,glabrous,glandular,globose,green,greyish,hyaline,incrassate,large,later,lateral,leaf,lobed,longitudinally,main,margin,material,minor,minutely,mm,narrowly,near,nearly,occasionally,older,opposite,outer,ovary,papillose,pedicel,petiole,pitted,planar,pore,puberulent,round,scar,shining,short,shrub,simple,size,small,soon,stem,stigma,style,surface,tip,tree,trichome,trunk,tube,tuft,uniseriate,unit,vein,white,x,yellowish,yellowish-green,yellowish-grey,young	.25,0.5-1,2,2.5-5.5,3,6-13,7-9,acute,apex,apiculate,appearing,ba,caly,cell,decurrent,deflexed,dia,differing,eaf,edicel,eed,erect,expanded,free,geminat,inflorescenc,like,lobe,lon,long,lower,major,middle,midrib,nflorescence,one,pair,pale,poricidal,portion,prominent,raised,remaining,rugo,ruit,slender,slightly,somewhat,spaced,square,straight,tall,tapering,thickened,three,ti,two,ud,unevenly,wall,widest,woody,yellow,ympodial	'',[,``,appressed,bract,branching,breeding,bud,characteristic,colour,connective,diameter,exsertion,flower,form,fruit,geminate,growth,hair,height,inflated,inflorescence,interjected,interpetalar,leaflet,length,marking,mature,modification,na,number,odour,paired,pattern,plant,position,rugose,scale,seed,shape,smell,spacing,spot,stellate,structure,symmetry,sympodial,system,texture,tissue,type,value,vegetative,{,}
405	wfo-0001030638	success	177	128	83	94	45	0.469	0.5-1,0.5-1.5,0.7-1.5,1-1.2,1-1.5,1-2,1.4-1.7,1.5-2,1.6-2.2,2-3,2-5,2-7-flowered,2.5-4,3-10,3-13,4-6,8,8-11,8-9,acute,anther,apex,apically,base,broadly,bud,calyx,cm,corolla,cup-shaped,deflexed,difoliate,elliptic,filament,flattened,fruit,fruiting,geminate,glabrous,glandular,globose,green,inflorescence,large,later,leaf,lobed,minor,mm,nearly,obovate,occasionally,opposite,ovary,pair,papillose,pedicel,petiole,pore,poricidal,red,red-glandular,seed,shape,shaped,shrub,simple,size,stigma,style,tapering,tear-drop,terminal,thickening,tip,tree,trichome,tube,unit,vein,white,x,young	0.1,0.5,0.5-0.7,0.5-2,along,anthesi,appear,appearing,axi,axil,ba,bark,beginning,beneath,berry,blade,branched,closely,conspicuously,corky,cucullate,deltoid,densely,dia,differing,dry,eaf,eed,entire,erect,exfoliating,extending,fleshy,free,geminat,glabrate,gre,impressed,irregular,known,lamina,lateral,less,like,lobe,lon,long,lower,main,major,margin,material,middle,minutely,near,nflorescence,often,older,one,open,overlapping,ovoi,pale,paler,papillae,papillo,persistent,planar,portion,present,prominent,rather,reddish,rest,roundish,rugose,ruit,scar,soon,spaced,speciman,stem,straight,surface,tall,thick,thickened,transversely,uniseriate,usually,wall,widest,woody,ympodial	2,articulation,bract,branching,breeding,cell,colour,connective,diameter,flower,form,growth,hair,height,heteromorphism,insertion,interjected,interpetalar,leaflet,length,marking,modification,na,orientation,pattern,placement,plant,position,prickle,pseudostipule,rhizome,scale,spot,staman,stellate,stone,structure,symmetry,sympodial,system,texture,tissue,tuber,width,xylopodia
406	wfo-0001030661	success	183	131	81	102	50	0.443	.5,0.5-0.6,0.5-0.75,0.5-2,1-1.5,1.5-2,1.5-7,4-15,acute,anther,apex,articulated,attenuate,base,berry,branched,brown,calyx,cell,cm,connivent,corolla,densely,diameter,ellipsoid,elliptic,entire,filament,fruiting,glabrous,globose,growth,inflorescence,insertion,lateral,leaf,lengthening,lobed,loosely,lower,many,margin,mature,membranous,mm,narrowly,occasionally,pale,pedicel,peduncle,petiole,pore,poricidal,pubescent,red,shrub,simple,sleeve,slit,small,sparsely,stellate,stem,surface,terminal,time,tinged,tip,tree,trichome,uniseriate,unit,upper,usually,violet,way,white,x,yellowish,Â½,Â¾	-24,.2,0,0.7-0.8,1-,1-.,1-1.2,1-1.3,1-1.4,1.2-7,12-16,2-,2-2.5,3-20,3-3.5,3-4,4-6,5-10,5-5.5,5-merou,50-100+,ag,along,alyx,anthesi,ark,branch,brow,capitate,clustered,conical,dar,deltate,denser,drying,eaf,eed,em,erec,erect,exserted,extending,flattened,flower,free,glabrescent,glabrou,group,ilament,lamina,lobe,lon,long,midrib,minute,minutely,near,never,new,nflorescence,nodding,older,onto,orolla,otherwise,pair,papillo,per,perfect,pericarp,pitted,planar,platform,plurifoliat,point,portion,primary,rectangular,reddish,reniform,ruit,scar,scattered,shiny,slender,slightly,spreading,stigma,strongly,style,tangled,testal,thin,tube,twinin,ud,vary,vein,winged,woody,yellow,ympodial	1-5,age,appressed,articulation,bark,bract,branching,breeding,broad-based,colour,connective,form,fruit,hair,height,heteromorphism,inflated,interjected,interpetalar,leaflet,length,marking,modification,na,needle-like,odour,orientation,pattern,placement,plant,plurifoliate,position,prickle,pseudostipule,rhizome,scale,shape,spot,staman,stone,structure,symmetry,sympodial,system,texture,tissue,tuber,type,xylopodia,zygomorphy
407	wfo-0001030676	success	220	153	110	110	43	0.5	-3.9,1,1-1.2,1-3,1.1-1.4,11-14,14-17,16,2.2-5.7,3-5,3-6,4-6,7-10,8-10,abaxially,abruptly,adaxially,angled,anther,anthesi,apart,apex,apical-lateral,appressed-tomentose,bark,base,becoming,berry,blunt-tipped,branch,branched,brown,bud,calyx,cm,continued,corolla,crown,diameter,dichotomously,due,echinoid,elongate,entire,exserted,filament,finely,flat-topped,fleshy,flower,fruit,glabrescent,globose,granular-tomentose,green,greenish,grooved,growth,hair,introrse,large,lateral,leaf,length,lengthen,longitudinal,longitudinally,margin,minutely,mm,mostly,multangulate,oblique,oblong,oblong-elliptic,often,openly,pedicel,peduncle,perfect,petiole,plurifoliate,pore,probably,pubescent,rachi,ripe,scabrous,sessile,short-attenuate,short-stalked,shrub,simple,slit,small,somewhat,spreading,stellate,stem,strongly,subglobose,terete,tomentose,unit,velutinous,white,whitish,x,yellow,yellowish	-1.6,-2.5,-8.5,/10-1/5,0-100,0.4,0.6-1.2,1.1-1.9,1.2-1.3,1.3-1.5,1.7-2,1/4,19-35,2.1-2.3,2.1-2.6,2.4-3.1,2.5-5.5,2.75-3.25,3-3.5,4-6.5,7-8,7-9,8-12,acute,along,apparently,appearing,articulated,axillary,ba,blade,chartaceous,closely,conical,cylindrical,dehiscing,deltoid,densely,eaf,echinoi,eed,except,forming,free,glabrescen,glabrous,high,honeycombed,horizontal,initially,inserted,lackin,lamina,lined,lobe,lobed,long,lower,main,midvei,midvein,minute,moderately,nearly,nflorescence,obtuse,occasional,older,opening,orolla,ovate,ovate-lanceolate,parallel,pseudo-terminal,pulverulent,rather,ray,reniform,reticulate-punctate,ridged,ruit,runk,scattered,side,spaced,sparsely,stellate-pubescent,stigma,style,subcampanulate,subcapitat,suborbicular,tamen,tending,testa,thick,thin,time,tip,tree,tube,tuft,unarme,usually,vary,vein,way,wide,ympodial,young	articulation,bract,branching,breeding,cell,colour,connective,form,fruiting,height,heteromorphism,inflorescence,interjected,interpetalar,leaflet,marking,na,odour,orientation,placement,plant,position,prickle,pseud-terminal,pseudostipule,rhizome,scale,shape,spacing,spot,staman,stone,structure,symmetry,sympodial,system,texture,thicknes,tissue,trunk,tuber,type,xylopodia
408	wfo-0001030686	invalid_json	182	154	127	55	27	0.698	.5,.5-1,0.5-1,1-1.1,1-1.2,1-2,1.2-1.5,1.5-2,1.5-4.5,1.6-3,15,1972,2-2.5,2-3,2-6.5,2.5-4,2.5-8,3-3.5,5-12,5-6,?,abaxially,aborted,abruptly,acuminate,acute,adam,age,anther,anthesi,apart,apex,bark,basal,base,berry,bifid,black,branched,brittle,brown,c.,calyx,centre,cm,conical,corolla,dark,darker,deeply,densely,denser,diameter,different,dry,drying,elliptic,empty,entire,exerted,fide,filament,flattened,form,fragrant,fruit,fruiting,glabrous,globose,golden,half,leaf,lengthening,lepidote,lilac,lobe,long,many,margin,maturity,midrib,minutely,mm,oblique,orange,ovary,pale,paler,papillae,papillose,pedicel,peduncle,pericarp,petiole,pitted,plant,pore,poricidal,pubescent,purple,scar,seed,shallow,shallowly,shiny,simple,slit,sparsely,spreading,stellate,stem,stigma,strongly,style,surface,thin,time,tip,tree,trichome,tube,uniformly,usually,way,x,yellow,â	.2,1-1.5,5-25,5-30,8-9,adaxially,beneath,breast,bu,closely,cup-shaped,difoliate,discolorous,eaf,edicel,eed,erect,flower,free,geminat,glabrescen,height,heteromorphic,internodal,lamina,leaf-opposed,less,lobed,lower,midvein,nflorescence,noddin,older,overlapping,pair,planar,portion,primary,pubescen,rachi,ruit,scarious,short,slightly,somewhat,space,spaced,styl,tissue,ud,unit,vein,visible,woody,ympodial	'',0.5,[,``,arrangement,branching,bud,characteristic,colour,density,fragrance,glabrescent,growth,heteromorphism,inflorescence,length,lobing,position,pubescence,shape,size,spacing,texture,thicknes,value,{,}
409	wfo-0001030709	success	217	112	62	155	50	0.286	0-20,1-4.5,1/3-1/2,6-7,anther,apex,articulated,base,berry,branched,calyx,chartaceous,cm,conical,connivent,cordate,equal,erect,filament,flower,fruit,fruiting,inflorescence,lateral,leaf,length,lobed,long,lower,margin,mature,maturity,mauve,mm,moderately,occasionally,pedicel,perfect,perpendicular,petiole,poricidal,prickle,purple,reflexed,short-styled,shrub,simple,spherical,stellate,stellate-pubescent,stem,straight,surface,tapering,terminal,tip,trichome,truncate,unit,usually,way,yellow	-2,-5,-9,0,0-,0-30,0.1-0.2,0.15-0.5,0.2-0.5,0.3-1.5,0.4,0.7-1,0.8-4,0.9-1.5,1-1.2,1-1.6,1-6,1.3-1.4,1.4-2,1.6-2.1,1.9-2.8,1/2-2/3,1/4,1/4-1/3,10-14,10-50,2-4,2-5,2-6,2-8,2.3-3,2/3-3/4,3-,4-5-merous,5-10,5-20,5-6,5-7,5-9,6-10,6-21,6-8,7-8,7-9,8-11,8-15,abaxially,acuminate,acute,adaxially,almost,alyx,ame,apar,apart,ape,apically,apparently,bark,blade,bright,broad-deltate,brow,c.,cuspidate,deltate,diameter,discolorous,distance,drying,dull,eaf,edge,eed,elliptic,elongating,extending,finely,flattened-reniform,free,glabrescent,glabrous,increasing,infructescence,lanceolate,lengt,lobe,lobing,lon,long-acuminat,longer,middle,midpoint,midvein,narrow-deltate,nflorescence,often,older,one,open,orange-brown,orolla,oung,pair,peduncle,pendulous,per,pericarp,pit,pitted,plurifoliat,porrect,portion,prickl,prickly,primary,ray,red-green,red-orange,retrorse,rounded,ruit,scar,secondary,seed,shorter,side,size,slender,smooth,sometimes,spaced,sparsely,spreading,stalk,stalked,style,tamen,terete,tertiary,time,toward,tube,unarmed,upper,variously,vary,vein,venation,visible,weakly,wide,woody,yellow-green,ympodial	appressed,articulation,bract,branching,breeding,broad-based,cell,colour,connective,corolla,form,growth,hair,heteromorphism,inflated,insertion,interjected,interpetalar,leaflet,marking,modification,na,needle-like,odour,orientation,paired,pattern,placement,plurifoliate,pore,position,present,pseudostipule,rhizome,scale,shape,smell,spot,staman,stone,structure,symmetry,sympodial,system,texture,tissue,tuber,type,vegetative,xylopodia
410	wfo-0001030714	success	178	172	124	54	48	0.697	-3,.2,.5,/3,0.1-0.3,0.5,0.5-0.8,0.5-1.9,0.7-0.8,1-1.2,1-1.3,1-2.5,1.2-1.5,1.2-4,1/3,2-2.5,20,3-3.5,>,abaxial,acuminate,acute,adaxially,age,along,anther,apex,bark,basal,base,becoming,beneath,berry,blue,blue-black,branching,calyx,clavate,cm,conical,cordate,corolla,dark,densely,diameter,ellipsoid,elliptic,entire,especially,except,filament,flattened,fruit,glabrous,globose,gradually,greyish,growth,herbaceous,leaf-opposed,leaving,lengthening,liana,lobe,lobed,long,many,margin,membranous,midrib,minute,minutely,mm,narrowly,new,ob-ellipsoid,ob-elliptic,oblique,occasionally,ovary,pale,paler,papillate,pedicel,peduncle,peg,per,perfect,petiole,pitted,pore,poricidal,pubescent,quadrate,reniform,ripe,scar,shape,simple,slightly,slit,spaced,sparsely,stellate,stem,stigma,style,surface,tapering,terminal,time,tip,trichome,truncate,uniseriate,unit,vein,vine,violet,way,widely,woody,x,yellow	0.3-0.4,0.8-1,1-1.5,1.4-3.5,1.5-2,2-2.6,3-7,5-100,5-6,7-17,abaxially,aid,anthesi,apar,articulating,campanulate,climbin,cup,denser,eaf,eed,exserted,fide,flower,free,grading,gree,howard,joined,like,lower,narrow,nflorescence,nodding,node,older,overall,pair,papillat,pedice,planar,plurifoliat,portion,primary,prominent,ruit,strongly,submarginal,thickened,tub,tube,twining,ud,ympodial	apart,arrangement,articulation,bract,breeding,bud,cell,colour,connective,form,green,hair,heteromorphism,inflorescence,insertion,interjected,interpetalar,leaf,leaflet,length,marking,modification,na,number,odour,orientation,paired,pattern,placement,plurifoliate,position,prickle,pseudostipule,rhizome,seed,size,spot,staman,stone,structure,symmetry,sympodial,system,texture,tissue,tuber,type,xylopodia
411	wfo-0001030733	success	130	132	85	45	47	0.654	.5,/4,0.5-1,1-1.2,1-1.5,1-2,1.7-2.7,2-2.5,3-4,3-5,4.5-5,6-7,6-9,abaxially,acute,adaxially,anther,apex,bark,base,bi-lobed,broadly,brown,calyx,capitate,clearly,closely,cm,conical,coriaceous,corolla,dark,densely,ellipsoid,elliptic,embryo,erect,exserted,filament,fruiting,glabrous,globose,green,later,leaf,long,margin,middle,minutely,mm,moderately,narrowly,opposite,ovary,ovoid-reniform,pair,pedicel,petiole,pore,pubescent,scar,shaped,shrub,smooth,somewhat,spaced,stem,stigma,strongly,style,surface,tear-drop,testa,thick,treelet,trichome,tube,unit,vein,visible,way,white,widest,x,young	1.5-5,4-15,5-8-flowered,?,acuminate,along,anthesi,ape,berry,decurrent,deltate,denser,dia,eaf,eed,elongate,free,grayish-brow,lamina,lateral,like,lobe,lobed,lon,lower,main,nflorescence,older,onto,overlappin,papillo,planar,poricidal,portion,rounded,ruit,simple,sparsely,tall,tip,ud,unifoliat,uniseriate,woody,ympodial	5-8,arrangement,articulation,bud,cell,colour,diameter,exsertion,flower,form,fruit,grayish-brown,growth,height,heteromorphism,inflorescence,insertion,length,lobing,na,number,odour,orientation,overlapping,paired,papillose,part,placement,plant,position,prickle,pseudostipule,rhizome,seed,shape,spacing,staman,stone,structure,symmetry,sympodial,texture,tuber,type,unifoliate,visibility,xylopodia
412	wfo-0001030772	success	155	98	50	105	48	0.323	0.25-0.5,0.75-1,0.9-1,1.5-2,anther,apex,attenuate,base,beginning,berry,calyx,cm,corolla,difoliate,elliptic,filament,fruit,fruiting,gently,glabrous,globose,green,leaf,lobed,long,margin,methyl,minutely,mm,nearly,occasionally,opposite,papillose,pedicel,petiole,pore,poricidal,ripe,salicylate,shape,shaped,shrub,simple,strongly,tear-drop,tip,unit,white,wintergreen,x	-2,.05,.2,.25,.5,0.2-0.8,0.5-1,0.9-3.1,1-2,1-2.5,1.2-5,1.4-1.6,2-7,3-3.5,3-5,4.2-6.5,5-10-flowered,5-6,8-10,9-15,acuminate,acute,anthesi,archin,ba,bark,becoming,beneath,branch,bud,capitate,closely,dark,deflexed,dia,differing,eaf,edicel,eed,ellipsoid,erect,extreme,free,geminat,grey,impressed,inflorescenc,large,later,lateral,lenticellate,lobe,lon,long-acuminate,long-triangular,lower,main,major,middle,minor,nflorescence,node,older,one,ovary,overlapping,ovoid-reniform,pair,pale,paler,papillo,per,pitted,portion,prominent,reflexed,rounded,ruit,scar,shining,size,slender,slightly,smelling,soon,spaced,stem,stigma,straight,style,surface,swollen,tall,tan,tapering,trichome,tube,ud,uniseriate,usually,vein,widest,woody,ympodial,young	appressed,arching,articulation,bract,branching,breeding,cell,colour,connective,form,geminate,growth,hair,heteromorphism,inflated,inflorescence,insertion,interjected,interpetalar,leaflet,length,marking,mature,modification,na,odour,orientation,paired,pattern,placement,position,prickle,pseudostipule,rhizome,scale,spot,staman,stone,structure,symmetry,sympodial,system,texture,tissue,tuber,type,xylopodia,zygomorphy
413	wfo-0001030781	invalid_json	213	160	128	85	32	0.601	0-5,1-10,1-12,1-2,1.5-2,1.5-9,1.6-2.2,10-40,15-35,2-20,2.5-14,2.5-3.5,3-4,4-15,5-6,5-7,6-7,7.5-9,abaxially,adaxially,along,anther,apart,borne,broadly,brown,brownish,cell,chartaceous,cm,condition,corolla,covering,dark,deep,densely,diameter,distal,dot,drying,elliptic,end,especially,filament,finely,flower,forked,fresh,fruit,generally,glabrous,glandular,globose,gray-green,green,green-white,greenish,hair,hair-like,half,herb,homostylous,lanceolate,lateral,leaf,leaflet,lengthening,light,like,lobe,long,make,membranous,midrib,minutely,mm,mucilaginous,obovate,odd-pinnate,ovate,ovate-lanceolate,ovoid,pair,papillose,pedicel,peduncle,pentagonal,pilose,plant,pore,poricidal,puberulent,pubescent,purple,rarely,rotate-pentagonal,scattered,seed,simple,singly,size,slit,small,sometimes,somewhat,sparsely,stem,stigma,straight,style,subovoid,terminal,testal,thick,throughout,tip,tube,tuber,typically,unwinged,usually,violet,wall,wet,white,whitish,wide,x	0.2-4,0.5-6,0.5-8,1-1.5,1-4,1-8,1.5-12,2-3,3-6,5-8,5-merou,abruptly,acumen,ag,alyx,apex,apiculate,apparently,articulated,axe,axillary,base,berry,blade,bud,caly,capitat,ciliate,connivent,cuneate,decreasing,decurrent,digestion,dorsally,eaf,edge,eed,enzyme,erect,exceeding,flat,folded,geminat,glabrou,gradually,high,honeycomb-shaped,interjected,larger,living,low-growin,lower,margin,narrowed,nflorescence,orbicular,orolla,perfect,petiole,petiolulate,plurifoliate,pointed,rachi,removed,rounded,ruit,sessile,seudostipule,short,slightly,spaced,specimen,stamen,ste,stolo,subtending,tall,tamen,tem,toward,tri-,unit,vary,yellow,ympodial	'',5-merous,[,``,abaxial,adaxial,age,arrangement,branching,calyx,capitate,characteristic,colour,form,growth,height,inflorescence,length,number,ovary,pilosity,presence,pseudostipule,shape,spacing,staman,stolon,texture,type,value,{,}
414	wfo-0001030782	invalid_json_followup	198	172	118	80	54	0.596	0-7,0.4-1.5,1-2,1-3,1-6,1.3-1.6,1.5-2,1.6-4.6,11-47,12-30,15,2,2.2-4,3-10,4-11.6,4-6,4.6-26,5-20,6-8,7-15.6,abaxially,adaxially,anther,attenuate,axillary,base,berry,blade,broadly,brownish,bud,cell,clavate,cm,condition,coriaceous,corolla,covering,dark,deep,diameter,distal,drying,elliptic,filament,flower,forked,fresh,fruit,generally,glabrescent,glabrous,globose,green,green-white,greenish,hair,half,herb,high,homostylous,interjected,lanceolate,lateral,leaf,leaflet,light,lilac,lobe,long,make,medium,mm,moniliform,mottled,mucilaginous,odd-pinnate,ovate,ovoid,pair,pedicel,pentagonal,petiole,petiolulate,plant,pore,poricidal,prominently,purple,rachi,ripe,rotate,rounded,scarce,seed,sessile,short,size,stigma,straight,style,subtending,terminal,testal,thick,throughout,tip,tissue,tube,tuber,usually,wall,wet,white,whitish,wide,winged,x	0-1,1-5,1.2-3.9,1.5-7.5,13-22,2-3,2.4-11.5,3-5,5-merou,abaxiall,acumen,acuminate,acute,ag,along,alyx,apart,apex,apparently,arranged,articulated,asymmetric,axe,basiscopic,bead,capitat,connivent,cuneate,decreasing,digestion,dorsally,eaf,edge,eed,enzyme,exceeding,flat,folded,geminat,glabrou,hair-like,hal,honeycomb-shaped,inconspicuous,lengthening,like,living,lower,multiple,necklace,nflorescence,orbicular,orolla,peduncle,perfect,plurifoliate,removed,ruit,second,seudostipule,side,slit,smaller,sometimes,spaced,specimen,stamen,stolon,subequal,tal,tamen,tem,totally,toward,tri-,typically,unit,vary,yellow,ympodial	'',5-merous,[,\u201chair-like\u201d,``,abaxial,adaxial,appressed,arrangement,articulation,bract,branching,breeding,calyx,capitate,characteristic,colour,connective,form,fruiting,growth,height,inflated,inflorescence,insertion,interpetalar,length,margin,marking,mature,modification,na,number,odour,ovary,paired,pattern,position,pseudostipule,scale,shape,smell,spot,staman,stem,symmetry,system,texture,trichome,type,value,vegetative,{,}
415	wfo-0001030802	success	171	103	53	118	50	0.31	.5,0.75-1,1-1.1,1-1.5,3-3.5x,abrupt,anther,apex,base,berry,calyx,campanulate,cm,cordate,corolla,deeply,difoliate,filament,fruit,fruiting,glandular,globose,hanging,heart-shaped,internodal,leaf,length,long,long-triangular,lower,margin,mm,pedicel,persistently,petiole,pore,poricidal,pubescent,red,shaped,shrub,simple,stem,subshrub,surface,tear-drop,tip,trichome,unifoliate,uniseriate,unit,white,yellowish	.3,.5mm,0,0.25-0.4,0.5-0.75,0.5-1,0.5-1.5,0.7-1cm,0.9-1,1,1-1.2,2-2.5,2-3,2-5,2.5-3,3-4,3-6,4-5mm,4-6,5-10-flowered,abaxially,acuminate,acute,adaxially,along,anthesi,appearing,bark,basal,becoming,beginning,beneath,brown,bud,cucullate,deflexed,densely,denser,dia,dry,eaf,edicel,eed,ellipsoid,evenly,except,exerted,exudate,filiform,flattened-reniform,free,geminat,glabrous,gland,glandurla,halfway,incrassate,inflorescenc,invest,irregularly,lamina,later,lateral,line,live,lobe,lobed,m.,main,markedly,material,midvein,minutely,near,nflorescence,obconic,older,ovary,ovoid,pair,pale,palmate,papillate,papillose,per,pitted,plant,portion,prominent,pubescen,raised,reddish,ruit,scar,single-celled,slender,somewhat,soon,spaced,specimen,stigm,stigma,straight,strongly,style,tapering,tipped,trichoem,tube,ud,variable,vein,widely,woody,x,yellow,ympodial,young	appressed,articulation,bract,branching,breeding,broad-based,cell,colour,connective,form,growth,hair,heteromorphism,inflated,inflorescence,insertion,interjected,interpetalar,leaflet,marking,mature,modification,na,needle-like,odour,orientation,paired,pattern,placement,position,prickle,pseudostipule,rhizome,scale,shape,smell,spot,staman,stone,structure,symmetry,sympodial,system,texture,tissue,tuber,type,vegetative,xylopodia,zygomorphy
416	wfo-0001030809	success	154	119	65	89	54	0.422	0.5-1,1-1.25,1-1.5,1.2-1.4,1.4-1.5,1.5-3.5,2-2.5,4.5-5,6-8,8,acute,anther,apex,base,berry,branched,calyx,clavate,cm,corolla,curl-tipped,dia,difoliate,elliptic,falcate,filament,fruit,fruiting,glabrous,globose,golden,green,hair,interpetalar,known,large,leaf,lobed,long,mature,mm,nearly,opposite,ovary,ovate,pedicel,petiole,pore,pubescent,round,several,simple,size,small,stigma,style,terminal,time,tomentose,tree,trichome,tube,uniseriate,unit,white	.5,0.2,1.5-2.4,2.3-5.5,20-60-flowered,5-8,9.9-12,across,along,also,anthesi,apar,appearing,bark,beneath,broadly,caly,campanulate,curved,dark-papillo,deciduous,deflexed,deltoid,dense,densely,distally,eaf,edicel,eed,ellipsoid,erect,especially,evenly,exserted,free,geminat,hidden,lateral,leave,like,lobe,lon,long-papillose,lower,main,major,markedly,membranous,middle,midrib,minor,minutely,nflorescence,older,one,overtopping,planar,poricidal,portion,present,ruit,scar,scattered,shinin,shining,shoot,sinus,slender,slightly,soon,spaced,stem,straight,tall,tapering,three,tip,triangular,two,ud,underside,unequal,vein,wide,widest,x,yellow-brown,ympodial,young	1.5,2,2.5,20-60,articulation,bract,branching,breeding,cell,colour,connective,dark-papillose,flower,form,geminate,growth,height,heteromorphism,inflorescence,information,insertion,interjected,leaflet,length,margin,marking,modification,na,number,odour,orientation,pattern,placement,plant,position,prickle,pseudostipule,rhizome,scale,seed,shape,spot,staman,stone,structure,symmetry,sympodial,system,texture,tissue,tuber,type,width,xylopodia
417	wfo-0001030810	success	191	145	75	116	70	0.393	0.2,0.3,5,abaxially,adaxially,anther,apex,base,bipinnate,blue,brown,calyx,cell,clavate,cm,colour,dark,densely,diameter,divided,elliptical,erect,filament,fleshy,flower,fruit,glabrous,globose,green,hair,leaf,long,longitudinal,margin,mm,moderately,multicellular,oblong,occasionally,older,opening,pair,pale,pedicel,pentagonal,petiole,pinnae,pinnate,pitted,plurifoliate,pore,primary,pubescent,shallowly,shaped,shrub,simple,slit,stem,stigma,stone,style,subglabrous,surface,tardily,tear-drop,time,tomentose,tube,unicellular,uniseriate,unit,violet,woody,x	0.2â0.3,0.4,0.5â,0.5â0.8,0.6â1.0,0.7â1.4,0.8â5.5,0.95â2.0,0â,1,1.0â1.5,1.0â2.0,1.0â3.0,1.1â2.0,1.1â2.2,1.2â1.5,1.5â1.9,1â2,1â3,1â5,2.9â4.5,20â100,2â3,2â4,3.0â5.0,3.3â5.5,3.3â8.5,3.5â4.6,3â19,4â14,4â5,4â7,5â15,5â30,5â32,6â10,6â22,7â10,7â11,8â10,absen,accrescent,acute,adaxiall,ag,along,anthesi,apart,articulated,axe,axillary,ba,blade,borne,branched,chartaceous,connivent,cylindrical,decreasing,denser,eaf,eed,elliptic,equal,especially,flattened,geminat,greyish,half,hig,indumentum,irregular,leafy,lobe,lon,lower,m.,midrib,midvein,narrow,nflorescence,obtu,opposed,orolla,oung,peduncle,perfect,poricidal,rarely,reflexed,rounded,ruit,secondary,shiny,shoot,side,size,sometimes,spaced,sparsely,straight,tamen,tip,unknown,vary,white,wide,wing,yellow,ympodial,â2.5,â3,â3.4,â4.5,â5.0,â8	0.2-0.3,0.6-1.0,1-2,1.0-1.5,1.0-2.0,1.1-2.2,1.2-1.5,1.5-1.9,2.5,2.9-4.5,20-100,3,3.5-4.6,4-14,4-5,4-7,5-32,5.0,6-22,8-10,absent,age,articulation,bract,branching,breeding,connective,corolla,form,fruiting,geminate,growth,height,heteromorphism,inflorescence,insertion,interjected,interpetalar,leaflet,length,marking,mature,modification,na,number,odour,orientation,ovary,pattern,placement,plant,position,prickle,pseudostipule,rhizome,scale,seed,shape,spot,staman,structure,symmetry,sympodial,system,texture,tissue,tuber,type,xylopodia,young
418	wfo-0001030822	success	146	145	94	52	51	0.644	.2,0.1-0.2,0.4-1,0.5-1.5,1-1.2,1-1.5,11-15.5,2-2.5,2-3.8,2-5,3-3.5,3-5,3.5-7,5-6,5-7,8-9,abaxially,acute,adaxially,anther,apex,attenuate,base,berry,calyx,clavate,closely,clustered,cm,corolla,decurrent,dia,difoliate,elliptic-obovate,exserted,filament,flattened-reniform,flower,fruiting,glabrous,globose,green,incrassate,inflorescence,internodal,later,leaf,lobed,long,long-ellipsoid,major,margin,minor,minutely,mm,near,nearly,occasionally,older,opposite,ovary,pair,pale,papillose,pedicel,petiole,pitted,pore,red-papillose,revolute,scar,shaped,shiny,shrub,size,spaced,sparsely,stem,stigma,strongly,style,surface,tan,tear-drop,tip,tube,unit,usually,vein,white,winged,x,yellowish-brown,young	0-0.5,0.4,0.8-1,0.9-1,1.5-2,anthesi,ba,beneath,broadly,completely,cucullat,cucullate,cup,deflexed,deltate,differing,eaf,edicel,eed,erect,filiform,fleshy,free,geminat,inflorescenc,lateral,lobe,lon,lower,main,middle,minute,nflorescence,onto,open,papillo,perhaps,planar,poricidal,portion,present,ruit,simple,slightly,somewhat,tall,tapering,ud,widest,woody,yellowish,ympodial	articulation,bract,branching,breeding,bud,cell,colour,connective,diameter,exsertion,form,fruit,geminate,growth,hair,height,heteromorphism,insertion,interjected,interpetalar,leaflet,length,marking,mature,modification,na,odour,orientation,pattern,placement,plant,position,prickle,pseudostipule,rhizome,scale,seed,shape,spot,staman,stone,structure,symmetry,sympodial,system,texture,tissue,tuber,type,winging,xylopodia
419	wfo-0001030871	invalid_json_followup	248	168	116	132	52	0.468	0.3-4,0.4-1.8,0.6-1.5,0.7-1.3,1-1.3,1-18,1.3-2,1.5-6,1.8-2.6,2-8,2.8-4.5,3-32,3-4.4,3-6,3.5-14,30,5-33,5-7,6-40,abaxially,abruptly,accrescent,adaxially,anther,apical-lateral,apparently,appressed,articulated,attenuate,bark,base,becoming,berry,blunt-tipped,branch,branched,brown,bud,calyx,campanulate,chartaceous,cm,continued,corolla,dark,deltoid,dendritic-echinoid,diameter,due,echinoid,elliptic,entire,extend,filament,fleshy,flower,fruit,fruiting,glabrescent,granular-tomentose,grayish,green,greenish,growth,hair,honeycombed,introrse,large,lateral,leaf,length,long,longitudinal,margin,mm,mostly,multangulate,narrowly,oblong,occasionally,ovate,pale,pedicel,peduncle,perfect,petiole,pore,porrect-stellate,probably,purple,rachi,reniform,reticulate-punctate,ripe,rotate-stellate,scabridulous,shrub,simple,slit,somewhat,stellate-tomentose,stem,suborbicular,terminal,testa,time,tomentose,tree,unarmed,velutinous,violet,white,x,yellow,yellowish,young	.2-3,.8-3.5,.9-1.2,/30-1/5,0-120,0.2-0.4,0.7-2.5,1.3-3,1.4-2.7,1.5-3,1.8-3.5,1/2,1/2-3/4,1/4,1/4-1/3,11,2-3,3-5,4.5-6.5,4.8-9.5,7-12,9-13,acuminate,acute,adaxial,ag,along,anthesi,apart,apex,appressed-tomentose,axe,axillary,ba,blade,capitat,closely,conical,decurrent,dehiscing,dendritic-echinoi,dendritic-multangulate,densely,directed,distal,eaf,earl,early,echinoi,eed,elongate,equal,erect,evident,exserted,free,glabrescen,glabrous,held,high,inserted,lobe,lobed,long-,long-stalked,longer,lower,m.,main,midvein,minute,mixed,multangulat,nearly,nflorescence,nodding,obtuse,often,older,open,orbicula,orbicular,orolla,ovate-lanceolate,overlapping,partly,plait,plurifoliate,present,prominent,pubescent,rather,ray,reflexed,relatively,ruit,runk,sessile,short,short-,short-stalked,side,small,sometimes,soon,spaced,sparingly,sparsely,splitting,stamen,stigma,striate,strongly,style,subglobose,sulcate,suture,tamen,terete,thick,thick-stalked,thin-stalked,toward,tube,unarme,unit,usually,vary,vein,way,wide,ympodial	'',0,30-120,[,``,age,arrangement,articulation,bract,branching,breeding,characteristic,colour,connective,form,height,inflated,inflorescence,insertion,interjected,interpetalar,leaflet,marking,mature,modification,na,number,odour,pattern,plant,position,prickle,scale,seed,shape,size,smell,spot,stellate,symmetry,system,texture,thicknes,tissue,trichome,trunk,type,value,vegetative,zygomorphy,{,}
420	wfo-0001030872	success	166	102	50	116	52	0.301	.5,1-1.5,1.5-5,acute,anther,apex,base,berry,broadly,calyx,cm,corky,corolla,crateriform,difoliate,elliptic,erect,filament,fruiting,glabrous,globose,green,leaf,lenticellate,like,long,lower,margin,minutely,mm,oblique,opposite,ovate,pedicel,petiole,pore,rather,red-glandular-puberulent,shaped,shining,small,stem,strongly,tear-drop,tree,treelet,unit,white,woody,x	0.5,0.5-1,0.8-1,0.8-2,1-1.2,1-2,1.2-1.5,1.2-3,1.5-2,12-18,2-5,3-7,4-6,4-6-flowered,5-6,5.5-7,6-12.5,acuminate,adaxial,age,along,anthesi,appearing,area,bark,beginning,black,brown,caly,center,closed,closely,completely,consisting,cucullate,dark,darker,deflexed,deltoid,densely,dia,dry,eaf,edicel,eed,ellipsoid-ovoid,exserted,fleshy,free,full,geminat,glabrate,hooded,incurved,inflorescenc,known,large,lenticel,less,live,lobe,lobed,lon,major,material,middle,minor,nearly,nerve,nflorescence,older,one,ovary,overlapping,pair,pale,paler,papillose,petal,planar,poricidal,portion,primary,prominent,proximal,puberulent,raised,reddish-glandular,reddish-glandular-puberulent,relative,rest,ridge,rounded,ruit,scar,shorter,side,simple,size,slightly,soon,spaced,specimen,stigma,straight,styl,style,tall,tapering,thickened,tip,tube,ud,widest,ympodial,young	appressed,articulation,bract,branching,breeding,broad-based,cell,colour,form,fruit,geminate,growth,hair,heteromorphism,inflated,inflorescence,insertion,interjected,interpetalar,leaflet,length,marking,mature,na,needle-like,odour,orientation,pattern,placement,position,prickle,pseudostipule,rhizome,scale,shape,smell,spot,staman,stone,structure,surface,symmetry,sympodial,system,texture,tissue,trichome,tuber,type,vegetative,xylopodia,zygomorphy
421	wfo-0001030882	success	144	138	82	62	56	0.569	.5,0.5-0.75,0.5-1,0.5-1.1,0.8-1.1,0.9-1.1,1-1.3,1-1.5,1-4,1.6-2,3-3.5,accrescent,acuminate,anther,anthesi,apex,attenuate,bark,base,berry,calyx,capitate,closely,cm,corolla,crenulate,deflexed,deltoid,difoliate,elliptic,filament,fruit,fruiting,glabrous,globose,green,leaf,lightly,lobe,lobed,lower,margin,minutely,mm,narrowly,nearly,opposite,ovary,overlapping,ovoid-reniform,pale,papillose,pedicel,petiole,pitted,planar,pore,poricidal,scar,shaped,short,shrub,simple,slender,slightly,small,spaced,stem,stigma,style,surface,tan,tapering,tear-drop,tip,transversely,tree,truncate,tube,unit,white,woody	.1,0.75-1,0.8-2.4,2,2-5.4,2-6,2.2-4.6,3/4,6.5-15.6,8-12,?,beginning,beneath,conical,dia,differing,eaf,edicel,eed,erect,exserted,extreme,free,geminat,inflorescenc,lateral,lon,long,main,major,middle,minor,nflorescence,occasionally,older,one,ovoid,pair,paler,papillo,peelin,portion,prominent,raised,ruguse,ruit,size,soon,straight,tall,terminal,thick,thickened,tub,ud,vein,way,widest,x,yellowish,ympodial,young	5.5,articulation,bract,branching,breeding,broad-based,cell,colour,connective,diameter,form,geminate,growth,hair,height,heteromorphism,inflorescence,insertion,interjected,interpetalar,leaflet,length,marking,modification,na,needle-like,odour,orientation,paired,pattern,peeling,placement,plant,position,prickle,pseudostipule,rhizome,rugose,seed,shape,smell,spot,staman,stellate,stone,structure,symmetry,sympodial,system,texture,tissue,tuber,type,vegetative,xylopodia,zygomorphy
422	wfo-0001030883	success	179	147	99	80	48	0.553	-3,.05,.1,.5,0.5-3,0.5-5,1-1.3,1-4,1.5-2,1.5-3.5,18-44.5,2-5,20-50-flowered,3-4,3/4,5-6,9.5-27.5,acuminate,acute,anther,apart,apex,bark,base,brown,calyx,cell,clavate,cm,corolla,dark,deflexed,difoliate,dry,elliptic,filament,fruit,fruiting,furcate,geminate,glabrous,glandular,globose,green,hard,imbedded,inflorescence,leaf,little,live,lobe,lobed,long-acuminate,lower,massive,material,minute,minutely,mm,oblique,occasionally,opposite,ovary,ovate,ovoid-reniform,pale,papillate,papillose,pedicel,petaloid,petiole,pitted,placenta,plant,pore,puberulent,pulp,russet,scar,seed,shaped,shrub,size,sometimes,stem,stigma,stout,strongly,style,surface,tan,tear-drop,time,trichome,uniseriate,unit,way,white,x	1-1.1,1-1.2,1-1.5,10-18,3-3.5,accrescent,across,anthesi,appearing,approximatately,arching,becoming,berry,branched,bu,collapsed,collection,dia,differing,eaf,edicel,eed,epidermal,erect,evenly,finely,fleshy,free,geminat,hollow,laminar,large,later,lateral,lenticellat,less,like,living,lon,long,main,malodorous,markedly,middle,midrib,narrowly,nflorescence,older,pair,papillo,perpendicular,poricidal,portion,present,proximal,quite,rather,reflexed,reticulate,ruit,slender,slightly,soon,spaced,straight,tall,tapering,thick,tip,triangular,tube,two,ud,upper,vein,wall,widest,woody,ympodial,young	bract,branching,breeding,broad-based,bud,colour,connective,deflexion,diameter,flower,form,glandularity,growth,hair,height,heteromorphism,interjected,interpetalar,leaflet,length,lenticellation,marking,modification,na,needle-like,number,orientation,pattern,placement,position,prickle,pseudostipule,rhizome,scale,shape,spacing,spot,staman,stone,structure,symmetry,sympodial,system,texture,tissue,tuber,type,xylopodia
423	wfo-0001030884	success	218	142	89	129	53	0.408	1,1-1.2,1-1.5,1.5,1.5-2,1.5-2.5,4-13,4.5-5,5.5-7,6-25,9-11,abruptly,acute,anther,apex,base,berry,blade,broad-based,brown,c.,calyx,capitate,cm,conical,dark,decurrent,di-,diameter,elliptic,equal,filament,free,fruiting,geminate,green,greenish,growth,inflorescence,lateral,leaf,leafy,length,lobed,long-triangular,lower,margin,mature,minute,minutely,mm,occasionally,ovary,ovoid-reniform,pedicel,petiole,pore,poricidal,present,prickle,pubescent,reddish,reflexed,sagittate,shallowly,shrub,simple,slender,spherical,spreading,stellate,stem,stiff,stigma,strongly,style,surface,tapering,tip,treelet,trichome,trifoliate,tube,unicellular,unit,way,weakly,white,winged	.2,.5,.7,0.3,0.3-0.5,0.4-3,0.5,0.5-1.2,0.8-1,0.9-5,1-3,10,100,2,2-5,4-5,5,5-30,5-6,5-merous,6-10,6-8,7-8,>,abaxial,abaxially,adaxial,adaxiall,along,also,alyx,andromonoeciou,anthesi,apar,arme,articulated,bark,basal,connivent,curved,densely,differing,directed,discolorous,distal,eaf,eed,extend,extending,flower,flowering,glabrous,glandular,gray-tinged,gree,half,herbaceous,heterostylous,infructescence,like,lobe,long,long-stalked,long-styled,magnification,midpoint,midrib,mixture,moderately,new,nflorescence,node,older,one,onto,open,orolla,oung,outlin,pair,pale,papillat,peduncle,per,plant,porrect,portion,prickly,primary,principal,ray,red,reflexe,regularly,rest,ruit,scar,scattered,sessile,shap,short,short-stalked,short-styled,similar,size,spaced,sparsely,stellate-pubescent,still,tall,tamen,tannish,time,unarmed,uniformly,uniseriate,upward,usually,vary,varying,vein,visible,wide,wing,without,woody,yellow,ympodial,young	3,andromonoecious,appressed,articulation,bract,branching,breeding,cell,colour,connective,corolla,dense,form,fruit,hair,heteromorphism,inflated,insertion,interjected,interpetalar,leaflet,marking,modification,na,needle-like,odour,orientation,outline,paired,papillate,pattern,placement,position,pseudostipule,rhizome,scale,seed,shape,smell,spot,staman,stone,structure,symmetry,sympodial,system,texture,tissue,tuber,type,vegetative,width,xylopodia
424	wfo-0001030899	success	146	126	93	53	33	0.637	0.3-0.5,0.5-1,1,1-2,1-3,1.5-2,10-13,10-20,2,2-3,2-3.5,2.5-3.5,20-25,3-12,3-4,3-5,3-foliate,3.5-4,4-5,5-10,5-6.5,6.5-31,7-27,8-11,?,acuminate,aggregate,apex,base,bronze,calyx,cell,chartaceous,cm,connective,cordate,coriaceous,deeply,densely,diameter,directed,ellipsoidal,end,entire,extrorse,flattened,flower,fruit,glandular-puberulent,globose,green,inside,less,light,lobe,long,margin,mm,narrowly,obconical,oblong,obtuse,outside,ovate,ovoid,pedicel,peduncle,perfect,petiole,pore,puberulent,pubescent,purple,rachi,radiu,remnant,shrub,simple,slightly,splotch,stellate,stigma,stone,stripe,style,triangular,tube,unbranched,unit,upward,white,x,yellow	-45,.5-2,0.5,1-1.5,1-6,abaxially,absent,acute,adaxially,apart,ape,articulated,axe,basal,beyond,blade,connivent,desc,dilated,distally,eaf,eed,ex,exceeding,exserted,glabrous,leaving,lon,lower,mucronate,nflorescence,nther,orang,orolla,pedicellar,peltifor,presen,puberulen,ruit,shorter,spaced,stamen,strongly,tal,tem,thecae,time,tomento,ud,vary,vein,wide,ympodial	anther,arrangement,articulation,branching,bud,colour,corolla,form,growth,hair,height,inflorescence,leaf,length,na,orange,ovary,peltiform,plant,position,present,seed,shape,size,spacing,stem,structure,symmetry,sympodial,texture,theca,tomentose,type
425	wfo-0001030902	invalid_json_followup	159	162	94	65	68	0.591	-2,-20,0.6-1.5,1-2,1-6,1.5-13,1.5-2,1.5-2.5,10-15,15-50,2,2-3,2-5,2.5-4,3-20,3.5-4,30-50,4,4-22,4-6,4-7,5-7,5-9,absent,acuminate,acute,adaxially,angled,apart,apex,apically,base,branched,brown-pilose,calyx,cm,connective,cordate,cylindrical,dark,deltate,densely,diameter,dilated,directed,distally,eglandular,ellipsoidal,entire,flattened,fleshy,flower,forked,fruit,glabrescent,glabrous,globose,hair,laterally,lobe,long,lower,margin,mature,mm,oblong,obtuse,occasionally,orange,ovate,pedicel,peduncle,perfect,petiole,pore,present,purple,rachi,radiu,rarely,reddish,remnant,simple,somewhat,stellate,stigma,style,subcoriaceous,tree,truncate,unbranched,unit,x,yellow	-5,0-15,1.5-,2.5,3-13,3-4,4-foliat,6-24,8-14,abaxially,aggregate,along,ape,apiculate,articulated,axe,basal,beyond,blade,brow,cell,connivent,eaf,eed,equalling,exceeding,except,exserted,glabrat,glandular,glandular-puberulen,leaving,lon,narrowly,nflorescence,nther,orolla,pedicellar,pinkish,presen,puberulence,purplish,ruit,shorter,slightly,small,spaced,sparse,sparsely,stamen,stone,subcapitat,tal,tem,thecae,time,tip,tomento,triangular,tube,ud,vary,vein,wide,ympodial	'',4-foliate,[,``,abaxial,adaxial,anther,appressed,articulation,bract,branching,breeding,broad-based,brown,bud,characteristic,colour,corolla,filament,form,fruiting,glabrate,growth,height,inflated,inflorescence,insertion,interjected,interpetalar,leaf,leaflet,length,marking,modification,na,needle-like,odour,orientation,ovary,paired,pattern,placement,plant,position,presence,prickle,scale,seed,shape,smell,spacing,spot,stem,structure,subcapitate,surface,symmetry,sympodial,system,texture,theca,tissue,trichome,type,value,vegetative,{,}
426	wfo-0001030914	success	186	119	69	117	50	0.371	/4,0-0.25,1-1.5,1.5-3,3-4,acute,anther,apex,attenuate,base,beneath,berry,calyx,campanulate,cm,corolla,difoliate,elliptic,filament,fruiting,furcate,glabrous,globose,golden,green,inflorescence,leaf,lemon-yellow,length,lobed,long,lower,many,margin,minutely,mm,narowly,obovate,onto,opposite,otherwise,pale,papillose,pedicel,petiole,pore,poricidal,puberulent,ripe,shape,shaped,shrub,simple,small,sparsely,stem,surface,tear-drop,time,tip,tree,trichome,uniseriate,unit,usually,way,white,winged,x	.1,.5,0.1-0.5,0.5-1,0.7-1,0.8-1,0.8-1.3,1-2,1.2-1.5,1.5-2,1.5-8,2-10,2-2.5,2.5-11,2.5-3,3.5-17,5-17,5-25-flowered,7-10,7-8,9-35,along,anthesi,bark,blade,bud,capitate,closely,constriction,dark,decurrent,deflexed,deltoid,densely,dia,differing,distal,dry,eaf,edicel,eed,ellipsoid,equal,erect,even,evenly,exserted,flower,free,geminat,glabrate,greyish-brow,individual,later,lateral,like,live,lobe,lon,long-styled,main,major,middle,minor,nflorescence,occasionally,often,older,one,ovary,overlappin,ovoid-reniform,pair,papillo,pitted,planar,plant,portion,prominent,pubescent,quite,raised,reddish-brown,rest,rounded,ruit,scar,short-styled,size,slender,slightly,sometimes,soon,spaced,specimen,stigma,straight,style,tall,tan,tapering,thick,third,ti,trunk,tub,tube,ud,variable,vein,weight,widest,within,woody,yellow,ympodial,young	appressed,articulation,bract,branching,breeding,broad-based,cell,colour,connective,form,fruit,geminate,growth,hair,heteromorphism,inflated,insertion,interjected,interpetalar,leaflet,marking,mature,modification,na,needle-like,odour,orientation,paired,pattern,placement,position,prickle,pseudostipule,rhizome,scale,smell,spot,staman,stone,structure,symmetry,sympodial,system,texture,tissue,tuber,type,vegetative,xylopodia,zygomorphy
427	wfo-0001030918	success	230	108	60	170	48	0.261	0-10,0-4,0.3-1.5,1/2-2/3,5.5-7,anther,apex,apparently,articulated,base,berry,branched,calyx,cell,chartaceous,connivent,cuneate,difoliate,elongating,equal,erect,filament,fruit,fruiting,lateral,leaf,length,lobed,long,lower,margin,mature,maturity,mauve,mm,moderately,orange,pedicel,perpendicular,petiole,poricidal,prickle,purple,red,reflexed,shrub,simple,somewhat,spherical,spreading,stellate,stellate-pubescent,stem,surface,tapering,terminal,tip,trichome,unit,way	-12,-2.3,-3.2,-4,-4.5,-40,-5,-6,-9,.5,.7,0-20,0-25,0-6,0.1,0.1-0.25,0.2-0.4,0.25-0.45,0.5-0.7,0.5-2,0.5-2.5,0.6,0.6-2.5,0.7-1.2,0.7-1.7,1,1-1.5,1-1.8,1-2,1-4,1.5-2,1.5-2.5,1.5-5.5,1/2-3/4,1/3,1/3-,1/3-1/2,1/4-1/3,2-10,2-2.5,2-25,2-3,2-4,2-7,2-8,2.8-3,2/,3-15,3-4,3-6.5,3-7,3.5-6,4-7,5-7,5-8,5-merous,6-8,7-10,abaxial,abaxially,acicular,acute,adaxial,alyx,ame,apar,apart,apically,bark,blade,brow,c.,caudat,cm,curved,dark,deltate,densely,diameter,discolorous,distance,drying,dull,eaf,elliptic,elongated,evenly,extending,faint,flattened,flattened-reniform,flower,free,geminat,glabrescent,glabrous,green,green-brown,infructescence,lobe,lobing,longer,midpoint,midvein,mixture,narrow-deltate,nflorescence,oblong,obtuse,occasionally,older,one,open,orange-brown,orolla,oung,outline,pair,pale,peduncle,pendulous,per,perfec,pericarp,pit,porrect,portion,prickl,prickly,primary,pubescent,raised,ray,red-brown,reduced,ruit,scandent,scar,secondary,seed,sessile,side,slender,small,smooth,sometimes,spaced,sparsely,stalk,stalked,straight,strongly,style,tamen,terete,tertiary,time,tube,upper,usually,vary,vein,venation,visible,weakly,wide,woody,yellow,ympodial,young	appressed,articulation,bract,branching,breeding,broad-based,colour,corolla,form,geminate,growth,hair,heteromorphism,inflated,inflorescence,insertion,interjected,interpetalar,leaflet,marking,na,needle-like,odour,orientation,paired,pattern,perfect,placement,position,pseudostipule,rhizome,scale,shape,smell,spot,staman,stone,structure,symmetry,sympodial,system,texture,tissue,tuber,type,vegetative,xylopodia,zygomorphy
428	wfo-0001030943	success	167	103	55	112	48	0.329	1-1.5,4-4.5,4-6,8-10,acute,age,anther,apex,base,becoming,berry,branching,calyx,cm,conical,corolla,densely,diameter,echinoid,elliptic,filament,fruiting,globose,golden,golden-yellow,growth,large,lateral,leaf,long,mm,narrowly,overtopping,pedicel,petiole,plurifoliate,pore,poricidal,pubescent,purplish-black,shoot,showy,shrub,sleeve,slit-like,small,sparsely,terminal,time,tip,tree,tree-like,trichome,unit,violet	.5,0,0.5-1,0.5-3,1-1.2,1.1,1.5-2,1.8-2.2,1/2,10-25,12-15,2-6,3,3-4,3/4,4-5,7-13.5,7-8,abaxial,abaxially,absent,acuminate,adaxial,adaxially,along,anthesi,apical,bark,basal,belo,bi-lobed,black,branch,cupulate,dark,decurrent,deflexed,dendritic,denser,drying,eaf,edicel,eed,elongate,erect,ew,exserted,fide,flattened,flower,free,glabrat,glabrous,horizontal,im,inserted,lenticular,lobe,lobed,lon,lower,m.,main,minute,minutely,monochasia,nflorescence,nodding,often,older,outline,ovary,pair,pale,papillo,pearce,per,pericarp,pitted,planar,portion,raised,reddish-brown,ruit,scar,scattered,secondary,slightly,somewhat,stamen,stem,stigma,strongly,style,surface,tall,tapering,thin,triangular,tub,tube,ud,upper,vein,way,wide,woody,x,yellow,yellowish-white,ympodial,young	appressed,articulation,bract,breeding,cell,colour,connective,form,fruit,hair,heteromorphism,inflated,inflorescence,insertion,interjected,interpetalar,leaflet,length,margin,marking,mature,modification,monochasial,na,odour,orientation,paired,pattern,placement,position,prickle,pseudostipule,rhizome,scale,shape,spot,staman,stellate,stone,structure,symmetry,sympodial,system,texture,tissue,tuber,type,xylopodia
429	wfo-0001030959	success	164	126	75	89	51	0.457	0.5-1.5,0.7-1.2,1-2,1-7,1.2-1.8,10-15,2.5-5,4-6,4-8,5-6,5-9,abaxially,anther,apex,bark,base,branched,brown,brown-green,cm,color,connivent,cuneate,diameter,difoliate,elliptic,filament,flower,fresh,glabrescent,glabrous,glandular,hair,inflorescence,known,lateral,leaf,length,lobed,long-acuminate,lower,margin,membranous,minute,mm,numerous,older,one,open,pedicel,peduncle,perpendicular,petiole,poricidal,present,prickle,shrub,simple,sparsely,stellate,stellate-pubescent,stem,straight,straw,style,subentire,surface,tapering,time,tip,toward,trichome,unarmed,unit,yellow	.05,.2,.8,/5,0.5,1-10,1.5-2,1.5-3.5,1/5-1/10,2-4,2.5-4,2.5-4.5,5-merous,6-8,9-12,almost,alyx,ame,apar,apart,apically,apparently,armed,articulated,blade,c.,concolorous,curved,deltate,densely,distributed,drying,eaf,eed,equal,erect,evenly,free,geminat,gently,glabrou,green-brow,know,less,like,lobe,long,long-acuminat,longer,midpoint,narrow-deltate,nflorescence,orolla,oung,pair,part,perfec,porrect,portion,prickl,prickly,primary,prominent,ray,ruit,scar,scrambling,secondary,sessile,several,short,side,slender,spaced,spreading,tamen,terete,tertiary,tube,usually,vary,vein,venation,visible,way,whole,wide,ympodial,youngest	0.2,0.8,appressed,armament,articulation,bract,branching,breeding,broad-based,calyx,cell,colour,connective,corolla,form,fruit,fruiting,geminate,green-brown,growth,heteromorphism,inflated,marking,mature,modification,na,needle-like,number,opening,orientation,ovary,placement,pore,rhizome,scale,seed,shape,spacing,spot,staman,stone,structure,symmetry,sympodial,system,texture,tuber,type,width,xylopodia,zygomorphy
430	wfo-0001030982	success	215	113	70	145	43	0.326	.1,0.2-3,1,2/3,4-5,acute,age,anisophyllous,anther,apex,appressed,base,berry,brownish,calyx,chartaceous,cm,corolla,cuneate,difoliate,dry,drying,entire,filament,fleshy,form,fresh,fruit,fruiting,geminate,globose,green,growth,leaf,lengthening,lobed,long,lower,margin,material,maturity,minutely,mm,opposite,papillate,pedicel,petiole,pore,poricidal,puberulent,reflexed,rhizomatous,sagittate,simple,sinuate,slightly,slit,stem,subshrub,surface,tightly,tip,trichome,uniseriate,unit,vegetative,vein,way,white,x	-2-2.5,.2,.5,0.05,0.05-0.5,0.1,0.1-0.15,0.3-2,0.5,0.5-0.9,0.5-1,0.5-3,1-1.5,1-8,1.5,1.5-2,1.5-3,3-21,3-8,4-12,6-8,abaxially,acuminate,adaxially,angular,anthesi,ape,ba,beneath,broadly,brown,bud,caducous,capitate,central,channelled,ciliate,closely,conic,conical,cream,cucullate,curved,dark,deflexed,deltate,diameter,differing,distall,distally,distichou,eaf,edicel,eed,ellipsoid,elliptic,enlarged,exerted,extension,external,flattened-reniform,flower,foliage,free,glabrescent,glabrous,glandular,glandular-papillose,golden-green,greenish,hilum,impressed,inconspicuously,internal,isostylous,larger,later,less,like,live,lobe,major,materia,midvein,minor,mostly,near,new,nflorescence,oblique,obovate,occasionally,often,olive,one,ovary,ovate,overlappin,packed,pair,pale,papillae,papillat,papillose,peduncle,pitted,planar,plant,portion,primary,projection,prominent,prominently,pubescent,reddish,rest,revolute,ruit,scar,seed,separated,shoot,sigmoidally,situated,size,somewhat,sparsely,stamen,stigma,straight,stripe,strongly,style,testa,tetramerous,time,transverse,tub,tube,ud,veined,weakly,yellowish,ympodial,young	articulation,bract,branching,breeding,broad-based,cell,colour,distichous,hair,heteromorphism,inflorescence,insertion,interjected,interpetalar,leaflet,length,marking,mature,na,needle-like,odour,orientation,paired,pattern,placement,position,prickle,pseudostipule,rhizome,scale,shape,smell,spot,staman,stone,structure,symmetry,sympodial,system,texture,tissue,type,zygomorphy
431	wfo-0001030989	success	177	157	105	72	52	0.593	.5,0.5-1,1-1.5,12-15,15-27.5,2-3.5,3-20,3-5.5,3-7.5,4-5,4-8,5,5.5-7.9,6-13,6-6.5,abaxially,adaxially,anther,apex,articulated,axillary,base,berry,blade,brownish,bud,cell,chartaceous,cm,condition,conical,connivent,corolla,covering,densely,diameter,distal,drying,end,filament,flower,forked,fresh,fruit,generally,green,green-white,greenish,hair,hair-like,half,herb,homostylous,interjected,lanceolate,lateral,leaf,leaflet,lengthening,light,long,lower,make,margin,minute,mm,mucilaginous,obtuse,occurring,odd-pinnate,ovoid,pedicel,petiole,plant,plurifoliate,pore,poricidal,proximal,pubescent,ripe,rotate,seed,singly,size,slit,sparsely,stem,subtending,terminal,testal,thick,throughout,tip,tri-,tuber,typically,unit,unwinged,usually,violet,wall,wet,whitish,wide,x	1-10,1-2,3-4,4-7,5-merou,9-10,acuminate,ag,alyx,apart,apparently,axe,capitat,ciliate,decreasing,digestion,dorsally,eaf,edge,eed,enzyme,erec,especially,flat,folded,geminat,glabrou,glabrous,gradually,honeycomb-shaped,larger,like,living,lobe,nflorescence,orbicular,orolla,ovate,ovate-lanceolate,pair,pale,peduncle,perfect,petiolule,present,pubescen,ray,removed,ruit,secondary,semierect,seudostipule,spaced,specimen,ste,stigma,stolo,style,subequal,subsessile,symmetrical,tall,tamen,tem,thir,toward,triangular,tube,vary,wider,yellow,ympodial	5-merous,age,arrangement,articulation,bract,branching,breeding,broad-based,calyx,colour,connective,form,growth,height,heteromorphism,inflorescence,insertion,interpetalar,length,marking,mature,modification,na,needle-like,number,occurrence,odour,orientation,paired,pattern,placement,position,prickle,pseudostipule,rhizome,scale,shape,spot,staman,stellate,stolon,stone,structure,surface,symmetry,sympodial,system,texture,third,tissue,type,xylopodia
432	wfo-0001030991	invalid_json	204	149	123	81	26	0.603	.5,0,0.1,0.2,0.5,0.5-0.7,0.5-1.5,0.7-1.2,1-1.5,1-2.2,2/3,3-,3-5-lobed,5-5.5,9-11,<,abaxially,absent,acuminate,acute,adaxially,along,anther,apex,apparently,appressed,ascending,attenuate,basal,base,berry,brown,bulbous,capitate,cell,cm,color,connivent,corolla,densely,diameter,different,ellipsoid,ellipsoidal,elliptic,elongate,enlarged,entire,eye,filament,flattened,flower,fruiting,furcate,fusiform,glabrous,globose,growth,herb,inflorescence,lanceolate,lateral,leaf,leaf-opposed,lengthening,like,lobed,loosely,lower,margin,minute,minutely,mm,narrowly,nearly,new,occasionally,often,pedicel,peduncle,per,perfect,petiole,pinnatifid,pitted,pore,poricidal,pubescent,rectangular,red,reniform,ripe,scattered,short,shrub,simple,sleeve,slightly,slit,small,somewhat,spreading,stellate,stem,stigma,style,surface,terminal,testal,tip,trichome,uniformly,uniseriate,upper,variably,vein,violet,weak,white,winged,woody,x,yellowish	0.2-0.7,0.3-0.4,0.5-1,0.5-3.5,0.6-0.8,1-1.6,1-2.5,1-7,1.5,10-20,2-plurifoliat,2.5-10,2.5-3,4-10,5-merou,adaxiall,ag,alyx,angled,anthesi,arising,ark,articulated,calyx,conical,distally,drying,eaf,eed,exerted,filiform,free,frui,glabrescen,grey,ilament,incised,leave,less,lobe,long-triangular,midrib,nflorescence,nodding,older,orolla,outline,packed,pair,papillo,part,particularly,pendant,pericarp,platfor,pointing,portion,primary,pseudoumbel,reflexed,rest,rootstoc,ruit,scar,shallowly,shiny,sparsely,strongly,suffrutescent,tangled,tem,thin,tightly,tube,twinin,ud,unit,vary,weight,ympodial,young	'',5-merous,[,``,age,articulation,bud,characteristic,colour,form,fruit,hair,height,length,number,ovary,papillose,plant,position,rootstock,seed,shape,type,value,{,}
433	wfo-0001031005	success	231	122	72	159	50	0.312	.4,.5,0-0.5,1-1.5,1-2,2.5,accrescent,almost,anther,apex,apically,apparently,articulated,attenuate,base,berry,black,blue,branch,branched,branching,calyx,chartaceous,cm,corolla,dendritic,denser,diameter,dilated,drying,entire,filament,form,fruit,fruiting,glabrous,leaf,length,liana,like,lobed,lower,margin,membranous,mm,much,oblong,occasionally,older,orange-brown,ovoid,pedicel,petiole,pore,poricidal,pubescent,purple,ridged,simple,slender,smaller,sparsely,stem,strongly,surface,terminal,thick-chartaceous,tip,trichome,unarmed,unit,x	/3-1/2,0.1,0.3-0.5,0.5-1.5,0.8,0.9,1,1-2.5,1-3,1.5-2.5,1.5-4,10,2-3.2,2.3-3,2.5-4,3-10,3-4,3-6.5,4-6,5,5-7,5-8,5Â°,6-12,abaxial,abaxially,acuminate,acute,adaxially,age,along,alyx,anthesi,apar,bark,brachyblast,brown,capitate,clearly,clum,clustered,common,concolorous,conical,cupular,curved,dark,datum,deeply,delineated,deltoid,dendritic-pubescent,density,detaching,developing,discolorous,divided,domatia,eaf,ellipsoi,elliptic,elongated,equal,evenly,extending,eye,fertilisation,fine,flat,flattened,flexuous,flower,forming,free,greenish,immature,increasing,inside,junction,known,lateral,leave,lengthening,linear,lobe,long,longitudinally,loop,m.,main,midvein,minute,naked,network,nflorescence,nther,obovate,obscure,occasional,often,onl,orolla,ou,outside,ovate,pair,peduncle,pendulous,perfec,pericarp,plurifoliat,pointed,portion,primary,prominent,protruding,rachi,raised,ray,region,rest,ruit,scar,secondary,seed,short,side,smoot,smooth,sometimes,somewhat,soon,spread,spreading,standing,stigma,stump,style,surrounding,tangling,tearing,terete,tertiary,thin,toward,tube,ud,uneven,usually,vary,vein,venation,visible,weakly,well-developed,white,wide,ympodial,young	appressed,articulation,bract,breeding,broad-based,cell,colour,connective,growth,hair,heteromorphism,inflated,inflorescence,insertion,interjected,interpetalar,leaflet,marking,mature,modification,na,needle-like,odour,orientation,paired,pattern,perfect,placement,plurifoliate,position,prickle,pseudostipule,rhizome,scale,shape,smell,spot,staman,stone,structure,symmetry,sympodial,system,texture,tissue,tuber,type,vegetative,xylopodia,zygomorphy
434	wfo-0001031007	success	207	107	59	148	48	0.285	0.75-1.5,1.5-2,4.5-5,acute,alfway,anther,apex,articulated,base,berry,black,branching,c.,calyx,cell,chartaceous,connivent,corolla,cuneate,cup-shaped,dendritic,entire,filament,fleshy,fruit,fruiting,globose,growth,inflorescence,lengthening,lilac,lobed,loose,loosely,lower,many,margin,mm,pedicel,perfect,petiole,plurifoliate,pore,poricidal,sagittate,shrub,simple,slit,stellate,stellate-pentagonal,stem,surface,terminal,time,tip,trichome,unit,vine,x	.5,0.2,0.5,0.5-1,0.5-10,1,1-1.2,1-1.5,1-3.5,1.2-1.5,1.3-,1.6-2,1.9-3,1/3,11-14,15,2.5-,2.5-5,3-4,4-6,4-7,5,5-12,5-merou,5.5-6,50-100,6,7-10,8-10,<,abaxiall,abruptly,ag,almost,along,alyx,anthesi,apar,apparently,ark,becoming,beginning,bifid,branched,broad,broadly,brown,campanulate,capitate,clustered,cm,completely,dark,deltate,densely,diameter,dilated,drying,dull,eaf,eed,ellipsoid,elliptic,exserted,extending,flattened-reniform,flower,free,geminat,glabrescen,glabrou,glabrous,herbarium,ilament,impressed,intramarginal,irregularly,junction,lamina,lax,leaving,lobe,long,looping,m.,markedly,matte,midvein,minutely,multi-celled,narrowing,narrowly,near,new,nflorescence,nodding,occasionally,often,older,orolla,outline,pale,papillat,papillate,peduncle,peg,per,pericarp,pitted,planar,portion,primary,prominent,pubescent,rat,reddish,revolute,round-rectangular,ruit,scar,shiny,sleeve,slender,slightly,spaced,sparsely,specimen,splitting,spreading,stigma,stout,strongly,style,tangled,testal,thin,tiny,tube,twining,ud,upper,usually,vary,vein,way,woody,yellow,ympodial	age,appressed,articulation,bract,breeding,broad-based,colour,connective,form,hair,heteromorphism,inflated,insertion,interjected,interpetalar,leaf,leaflet,length,marking,mature,modification,na,needle-like,odour,orientation,paired,pattern,placement,position,present,prickle,pseudostipule,rhizome,scale,shape,spot,staman,stone,structure,symmetry,sympodial,system,texture,tissue,tuber,type,xylopodia,zygomorphy
435	wfo-0001031007	success	206	116	72	134	44	0.35	.5,0.75-1.5,1,1-1.5,1-3.5,1.5-2,4.5-5,5,acute,along,anther,apex,articulated,base,beginning,berry,black,branching,calyx,cell,chartaceous,cm,corolla,cuneate,dendritic,entire,extending,filament,fleshy,fruit,fruiting,glabrous,globose,growth,inflorescence,lamina,leaving,lilac,long,loose,many,margin,mm,near,occasionally,pedicel,peg,perfect,petiole,pore,poricidal,prominent,pubescent,revolute,sagittate,shrub,simple,sleeve,sparsely,stellate,stellate-rotate,stout,tangled,terminal,time,tip,trichome,unit,usually,vein,vine,wide	0.2,0.5,0.5-1,0.5-10,1-1.2,1.2-1.5,1.3-,1.6-2,1.9-3,1/3,11-14,15,2.5-,2.5-5,3-4,4-6,4-7,5-12,5-merou,5.5-6,50-100,6,7-10,8-10,<,abaxially,abruptly,adaxial,ag,alfway,almost,alyx,anthesi,apar,apparently,bark,becoming,bifid,branched,broad,broadly,brown,c.,campanulate,capitate,clustered,completely,cup-shaped,dark,deltate,densely,diameter,dilated,drying,dull,eaf,eed,ellipsoid,elliptic,exserted,flattened,flower,free,glabrescen,glabrou,herbarium,ilament,impressed,intramarginal,irregularly,junction,lax,lengthening,lobe,lobed,looping,lower,m.,markedly,matte,midvein,minutely,multi-celled,narrowing,narrowly,new,nflorescence,nodding,often,older,orolla,outline,pale,papillat,papillate,peduncle,per,pericarp,pitted,planar,plurifoliat,portion,primary,rat,reddish,reniform,round-rectangular,ruit,scar,shiny,slender,slightly,slit,spaced,specimen,splitting,spreading,stem,stigma,strongly,style,surface,tall,testal,thin,tiny,tube,twinin,ud,upper,vary,way,woody,ympodial	appressed,articulation,bract,breeding,colour,connective,form,hair,heteromorphism,inflated,insertion,interjected,interpetalar,leaf,leaflet,length,marking,mature,na,odour,orientation,paired,pattern,placement,plurifoliate,position,prickle,pseudostipule,rhizome,scale,shape,spot,staman,stone,structure,symmetry,sympodial,system,texture,tissue,tuber,type,width,xylopodia
436	wfo-0001031036	invalid_json_followup	150	145	87	63	58	0.58	.2,.25,0.8-1.2,1-1.3,1-2.5,1.2-1.5,1.5-3,10-20-flowered,12-15,2-2.5,2.2-3.7,3-4,3.5-5.5,4.5-6.5,5-6,acuminate,acute,anther,apex,base,berry,bi-lobed,brown,calyx,closely,cm,corolla,crisped,dark,decurrent,deflexed,ellipsoid,elliptic,erect,exserted,filament,flattened-reniform,fruiting,glabrous,globose,green,greenish-white,leaf,lobed,long,margin,middle,minor,minutely,mm,nearly,oblique,older,opposite,ovary,pedicel,petiole,pitted,pointed,pore,sagittate,scar,shaped,shiny,shrub,simple,size,slightly,spaced,stem,stigma,strongly,style,surface,tear-drop,thickened,tip,trichome,tube,uniseriate,usually,white,widest,winged,woody,x,young	.5,0.5-1,0.8-1,3-5,7-8,abaxially,adaxially,along,angle,anthesi,arising,axil,ba,becoming,broadly,conical,dia,differing,difoliate,dry,drying,eaf,edicel,eed,enlarged,filiform,fleshy,free,fresh,geminat,knob-like,lamina,lateral,lobe,lon,lower,main,major,material,nflorescence,onto,overlappin,pair,papillo,papillose,perhaps,planar,poricidal,portion,rounded,ruit,short,sinus,soon,spathulate,tall,tapering,tub,ud,unit,vein,yellowish,ympodial	'',[,``,abaxial,adaxial,appressed,articulation,bract,branching,breeding,bud,characteristic,colour,connective,exsertion,flower,form,fruit,geminate,growth,hair,height,inflated,inflorescence,insertion,interjected,interpetalar,leaflet,length,marking,mature,modification,na,number,odour,orientation,overlapping,paired,pattern,placement,plant,position,prickle,scale,seed,shape,spacing,spot,symmetry,system,texture,tissue,type,value,width,zygomorphy,{,}
437	wfo-0001031064	invalid_json_followup	179	148	99	80	49	0.553	.0-2.5,.05,.5,0,0.5-0.7,1-1.2,1-2,1-3,1.2,1.7-4.2,10-12,10-12.5,2.5-3,3-5.5,3-7,3.5-4,4-5-celled,5-10.5,5-6,6-16,anther,anticlinal,attenuate,basal,base,berry,bright,calyx,cell,cm,completely,conical,conspicuous,corolla,dark,densely,diameter,elongate,epidermal,filament,fleshy,fruit,fruiting,glabrous,globose,green,half,highly,inflorescence,irregular,lateral,leaf,leaflet,lenticel,lobed,long,lower,margin,minutely,mm,nearly,nodding,node,obovate,occasionally,ovary,ovate,ovoid-reniform,pair,papillate,pedicel,per,petiole,pinnate,poricidal,projection,pubescent,purple,rachi,scattered,short-pubescent,shrub,simple,sinuous,somewhat,sparsely,stem,stigma,style,terminal,thickening,tip,translucent,trichome,uniseriate,white,winged,without,x	.5-1,0-15,0.5,0.5-0.8,1,1.5-2,10-17,2,3,7-16,8-10-celled,abaxially,acroscopic,acuminate,adaxially,along,anthesi,apex,arising,axil,bearing,blade,broader,clavat,commentary,deltate,denser,distal,dr.,eaf,edicel,eed,erec,exserted,flower,free,irregularly,lamina,leave,lightly,like,lobe,lon,lost,minute,narrower,near,nflorescence,often,open,petiolule,planar,portion,prominent,pubescen,rugose,ruit,scar,see,side,single,sinus,slender,smaller,splitting,strongly,surface,swollen,tal,tem,time,tub,tube,ud,unifoliat,unit,usually,vein,wand-like,ympodial	'',[,``,abaxial,adaxial,appressed,arrangement,bract,branching,breeding,bud,characteristic,clavate,colour,connective,dry,erect,feature,form,growth,hair,height,inflated,interjected,interpetalar,length,marking,mature,modification,na,number,orientation,pattern,plant,pore,position,scale,seed,shape,size,spot,symmetry,system,texture,tissue,type,value,{,}
438	wfo-0001031071	success	186	98	78	108	20	0.419	0-10,0.2-0.8,1-2,1.5-2.2,2-5,2-8,2.1-3,2.4-3.4,3-10,3.8-5.4,4-25,4-6,5-9.4,6-8,7-16.5,7-8,8-28,anther,blade,blue,brownish,cell,cm,color,condition,coriaceous,corolla,dark,deep,diameter,drying,filament,flower,forked,fresh,fruit,glabrous,globose,green,greenish,hair-like,herb,homostylous,honeycomb-shaped,interjected,lanceolate,lateral,leaf,leaflet,lilac,medium,mm,moniliform,mottled,mucilaginous,odd-pinnate,ovoid,pair,pedicel,peduncle,petiole,plant,pore,poricidal,purple,seed,size,spot,star,style,terminal,testal,tip,tuber,wet,white,whitish,x	0.4-2,1-1.5,1-3,1-7,2-3,3-5,3-6,5-merou,5.7-8.8,abaxiall,abaxially,acumen,acute,adaxially,ag,along,alyx,apart,apex,apparently,arranged,articulated,asymmetric,attenuate,axe,axillary,base,basiscopic,bead,berry,bud,capitat,clavate,connivent,covering,decreasing,digestion,distal,dorsally,eaf,edge,eed,elliptic,enzyme,erec,exceeding,flat,folded,geminat,generally,glabrou,green-white,half,lengthening,like,living,lobe,long,lower,make,middl,multiple,narrowly,necklace,nflorescence,orbicular,orolla,ovate,pentagonal,perfect,petiolulate,plurifoliate,removed,ripe,rotate,round,ruit,sessile,seudostipule,short,side,slightly,slit,spaced,specimen,stamen,stigma,stolon,straight,subequal,subtending,tall,tamen,tem,thick,throughout,tissue,toward,tri-,tube,typically,unit,usually,vary,wall,winged,yellow,ympodial	abaxial,adaxial,arrangement,branching,calyx,colour,form,growth,hair,height,inflorescence,length,number,ovary,position,pseudostipule,shape,staman,stem,texture
439	wfo-0001031097	success	174	152	95	79	57	0.546	0.45,1,1-4,1-4.5,1.6-5.5,1.8-2.5,13-30,2-3,2-3.3,2-4,3-5,3.7-8.4,4-6,4-7,5-11,5-12,5-9,8-11,9-21,abaxial,abaxially,adaxially,apex,apically,articulate,base,branched,calyx,cell,cm,connate,corolla,cuneate,cyme,darker,deep,dehiscent,diameter,dichasially,distal,ebracteate,filament,flower,forked,generally,green,green-white,hair-like,half,herbaceous,interjected,interpetalar,lateral,leaf,leaflet,light,long,lower,margin,medium,mm,oblique,odd-pinnate,ovoid,pair,pattern,pedicel,peduncle,pentagonal,perennial,perfect,petal,petiole,petiolulate,plant,poricidally,proximal,puberulent,pubescent,purple,rarely,rotate,seed,side,sometimes,strigose,style,terminal,throughout,tuber-bearing,unit,violet,violet-blue,yellow,Â¼	0.5,1-3,1.5,1.8-2.6,3-6-foliat,3.5-6,acumen,acuminate,acute,along,apical,covering,decurrent,dichasial,digestion,diminishing,dorsally,dotted,eaf,edge,eed,elliptical,emoval,enzyme,exceeding,flat,folded,frequently,globo,gree,highly,honeycomb,introrse,lighter,living,lobe,lon,lunat,make,maturing,monochasial,mottled,mucilaginous,narrow,nflorescence,noticeably,nther,obovate,often,orolla,ovate,petiolule,plan,rachi,rapidly,reveal,ruit,sessile,seudostipule,short,size,slit,specimen,stamen,stigma,straight,tal,tem,testal,thick,tissu,toward,typically,vary,vbase,wall,wide,without,ympodial	2,3-6-foliate,adaxial,anther,arrangement,articulation,bract,branching,breeding,broad-based,colour,connective,form,fruit,growth,hair,height,heteromorphism,inflorescence,insertion,length,lunate,marking,mature,modification,na,needle-like,number,odour,orientation,ovary,paired,placement,pore,position,prickle,pseudostipule,rhizome,scale,shape,spot,staman,stellate,stem,stone,structure,surface,symmetry,sympodial,system,texture,tissue,tuber,type,width,xylopodia,ye
440	wfo-0001031101	invalid_json_followup	197	168	121	76	47	0.614	-1,-16,-20,-30,-5,-8,/2,0.05-0.2,0.1-0.2,0.1-0.3,0.5-0.8,0.5-3,0.6-0.8,0.8-,1-,1-2,1-2.3,1.3-2.5,1.4-1.7,1/4-1/2,10-30,2-5,2.5-,3-15,3.5-4.5,4-10,4-5-merous,4.5-9,6-10,8-15,abaxial,abaxially,acuminate,adaxial,almost,ame,anther,apex,apical,apparently,articulated,bark,base,berry,branched,bright,c.,calyx,cm,concolorous,connivent,diameter,drying,dull,elongating,entire,equal,erect,evenly,filament,flattened-reniform,flower,fruiting,glabrescent,glabrous,glandular,green,hair,lateral,leaf,length,lobed,long,long-acute,margin,mature,maturity,mauve,membranous,midpoint,minute,mm,moderately,multangulate,obtuse,often,orange-brown,orange-red,ovate,pale,pedicel,peduncle,per,petiole,poricidal,porrect,ray,red,rounded,sessile,shrub,simple,sparsely,spherical,stalked,stellate,stellate-pubescent,stem,style,surface,tapering,terete,terminal,tip,trichome,unarmed,way,white,wide,yellow,young	/2-equal,0.3-0.5,0.7-0.8,1-3,1.3-2,1.5-3,1/3-1/2,2-2.8,2-4,2-6,2.5-3.5,2.5-3.8,3-10,3-8,4-7,5-20,5-6,alyx,apar,apically,ba,blade,deltate,difoliate,eaf,eed,filiform,free,frui,geminat,green-brown,herbaceous,infructescence,lobe,long-acuminat,longer,lower,narrow-deltate,near,nflorescence,older,one,open,orolla,oung,pair,pendulous,perfec,pericarp,portion,primary,red-brow,resembling,ruit,scandent,scar,smooth,spaced,spreading,stalk,stellate-pubescen,straight,tamen,tertiary,time,tube,umbel,unarme,unit,variously,vary,vein,venation,visible,yellow-green,ympodial	'',[,``,appressed,arming,articulation,bract,branching,breeding,characteristic,colour,connective,corolla,form,fruit,growth,height,inflated,inflorescence,interjected,leaflet,marking,modification,na,number,ovary,pattern,perfect,plant,pore,position,pubescence,red-brown,scale,seed,shape,size,spot,staman,symmetry,system,texture,type,umbel-like,value,{,}
441	wfo-0001031114	success	208	127	76	132	51	0.365	0.5,0.5-1,2-3,25-50,accrescent,anther,apex,articulated,base,becoming,berry,branched,calyx,chartaceous,cm,connivent,densely,directed,distally,dried,entire,filament,first,fleshy,flower,fruit,fruiting,geminate,globose,green,hair,homostylous,interpetalar,introrsely,large,leaf,leaf-opposed,longitudinal,lower,margin,membanaceous,mm,oblong,obtuse,opening,paired,pedicel,petiole,plurifoliate,pore,purple,ripe,rounded,shrub,simple,slightly,slit,small,somewhat,sparsely,stellate,stellate-pubescent,stem,subcoriaceous,subcucullate,subcuneate,surface,tissue,tree,truncate,unit,white,white-pubescent,without,x,yellowish	.1,.2,.5,0-0.3,0.3-0.5,0.7-1.5,0.8-1.2,1-1.5,1-10,1-2,1-4.5,1-7,1-8,1.5-2.5,1.5-4,10-15,2-17,2-4,2-7,2.5-3,2/3,3-10,3-4,3-5,3-7,4-10,4-5,4-8,4.5-6,5-10,5-8,5-merou,6-7,7-15,abaxially,absen,acuminate,acute,adaxiall,adaxially,ag,alyx,apart,apparently,axe,ba,blade,brown,capitat,covering,cylindrical,dark,deltate,diameter,differentiated,discolorous,distal,eaf,echinoid,eed,elliptic-ovate,equal,erect,especially,flattened,free,frui,glabrous,highly,impressed,juic,lacking,light,like,lobe,long,long-stalked,major,midpoint,minor,multangulate,nearly,nflorescence,nodding,often,one,orolla,outline,ovate,part,peduncle,perfect,pericarp,porrect,prominent,pubescent,rachi,ray,reniform,rugulose,ruit,sessile,short,short-,short-stalked,side,spaced,stalk,ste,stigma,straight,strongly,style,subtending,tall,tamen,tem,thickened,thin,time,tip,toward,triangular,tube,unarme,vary,vein,white-stellate,whitish,wide,yellow,ympodial	5-merous,age,appressed,articulation,bract,branching,breeding,broad-based,cell,colour,connective,corolla,form,growth,heteromorphism,inflated,inflorescence,insertion,interjected,leaflet,length,marking,mature,na,needle-like,odour,orientation,pattern,placement,position,prickle,pseudostipule,rhizome,scale,shape,smell,spot,staman,stone,structure,symmetry,sympodial,system,texture,trichome,tuber,type,vegetative,xylopodia,ye,zygomorphy
442	wfo-0001031116	success	191	89	55	136	34	0.288	/4,3.5-4,4-7,anther,apex,articulated,base,berry,branching,calyx,cm,connivent,elongating,equal,erect,evenly,filament,fruit,fruiting,green,hair,lateral,leaf,length,lobed,long,margin,mature,maturity,mauve,membranous,minute,mm,obtuse,orange-red,pedicel,petiole,poricidal,primary,recurved,reflexed,rounded,secondary,shrub,simple,small,spherical,stellate-pubescent,tapering,tip,tree,unarmed,unit,way,young	-10,.2,.5,.8,0,0.05-0.15,0.1,0.3-0.5,0.4-0.7,0.7-0.9,0.7-1,1,1-5,1/2,1/3-2/,1/6-1/4,10-14,15-25,2-5,2.7-3.2,30-100,30-50,4-10,5,5-15,5-merous,8-11,9-13,abaxial,abaxially,acuminate,adaxial,almost,alyx,ame,apar,apart,apically,apparently,arachnoid,attenuate,bark,blade,bristle,broad-deltate,brow,c.,caudate,clearly,collapsed,densely,diameter,dirty-white,discolorous,drying,dull,eaf,eed,elliptic,elongated,epidermi,flat,flattened-reniform,flexuous,flower,fragile,free,glabrescent,glabrous,glaucous-green,infructescence,less,lobe,longer,lower,midpoint,moderately,multangulate,narrow-deltate,nflorescence,obovate,obtu,often,older,one,open,orange-brown,orolla,oung,pair,peduncle,per,perfec,pericarp,perpendicular,plurifoliat,portion,ray,red-brown,ruit,scar,sessile,sharply,shortly,single,slender,smooth,soft,sometimes,spaced,sparsely,stalk,stalked,stellate,stem,straight,style,subentire,surface,tamen,terete,tertiary,time,trichome,tube,unarme,upper,vary,vein,venation,visible,weakly,wide,woody,yellow,ympodial	articulation,bract,cell,colour,corolla,form,growth,heteromorphism,inflorescence,insertion,interjected,interpetalar,leaflet,na,odour,orientation,placement,plurifoliate,position,prickle,pseudostipule,rhizome,scale,shape,staman,stone,structure,symmetry,sympodial,texture,tissue,tuber,type,xylopodia
443	wfo-0001031128	success	213	84	52	161	32	0.244	0.5-0.8,anther,apex,articulated,base,berry,branched,branching,calyx,cm,cuneate,elongating,equal,erect,evenly,filament,fruit,fruiting,green,hair,inflorescence,lateral,leaf,length,lobed,lower,margin,mauve,membranous,mm,multangulate,pale,pedicel,petiole,poricidal,purple-black,recurved,red,sessile,short-attenuate,shrub,simple,spherical,stalked,stem,surface,tapering,terminal,tip,trichome,unit,white	-10,-100,-4.5,-6.5,/4,0,0-30,0.05-0.2,0.05-0.25,0.2,0.2-0.4,0.3-0.8,0.5-0.7,0.5-1.5,0.5-5,0.6-1,0.8-1.7,1,1-,1-1.6,1.2-2,1.5-3,1.5-3.5,1/,1/6-1/3,10-20,10-35,2-5,2-9.5,2.3-,2.5-10,2.5-3.5,20-50,20-60,3-4,3.5-4.5,4-5-merous,4-7,5-,5-15,5-19,5-30,8-12,8-23,abaxial,abaxially,acute,almost,alyx,apar,apart,ape,apically,apparently,bark,blade,bristle,brown,concolorous,connivent,deltate,densely,diameter,drying,dull,eaf,eed,elliptic,elongated,entire,eye,filiform,flattened-reniform,flexuous,flower,free,glabrescent,glabrous,gland,glandular,gra,infructescence,less,lobe,lon,long,long-acuminat,long-acuminate,longer,mature,maturity,midpoint,minute,moderately,multangualte,naked,narrow-deltate,near,nflorescence,occasionally,often,older,one,open,orange-brown,orolla,oung,pair,peduncle,per,perfect,pericarp,perpendicular,plurifoliat,portion,primary,ray,red-brown,reduced,reflexed,ruit,scar,secondary,shallowly,short-styled,side,single,smooth,soft,spaced,spreading,stalk,staminate,stellate,stellate-pubescent,straight,style,tamen,terete,tertiary,time,tube,unarme,unarmed,undulate,usually,variously,vary,vein,venation,visible,way,weakly,whitish,wide,woody,yellow,yellow-brown,yellow-green,ympodial,young	1-6.5,2.3-4.5,articulation,broad-based,cell,colour,corolla,form,growth,heteromorphism,insertion,na,needle-like,odour,orientation,placement,plurifoliate,pore,position,prickle,pseudostipule,shape,smell,staman,stone,structure,symmetry,sympodial,texture,type,vegetative,zygomorphy
444	wfo-0001031135	success	189	177	118	71	59	0.624	0-2,0.5-2,1-1.5,1-10,1-3,1-4,1.5-2,1.5-3,1.5-9,10-20,2,2-,2-2.5,2-3,2-4,3-4,3-5,3.5-12,4-5,5-30,5-9-pinnate,abaxially,acuminate,acute,adpressed,aggregate,also,apex,basal,base,broad,calyx,campanulate,cell,cm,compound,connective,cordate,cuneate,cylindrical,darker,deltate,densely,diameter,dilated,directed,distally,eglandular-pubescent,ellipsoidal,elliptic,entire,fading,flattened,flower,frequently,fruit,fusiform,glandular-,green,hair,laterally,leaf,leaflet,leaving,light,lobe,lobed,long,longitudinal,lower,margin,mm,moderately,narrowed,obconical,oblong,obtuse,often,ovate,ovoid,pedicel,pedicellar,peduncle,peltiform,perfect,petiole,pilose,pink,pinnately,pinnatifid,pore,puberulent,purple,rachi,radiu,remnant,ripe,shrub,simple,sparsely,stigma,stone,stripe,strongly,style,subcoriaceous,tip,tree,truncate,unbranched,unit,unlobed,violet,white,whitish,x,yellow-green,yellowish	-7,0.7-2,1-,1-2.5,2-23,2-3.5,2-5,2.5-28,3-10,4-foliat,5-11,7-15,absent,adaxially,along,apart,ape,articulated,axe,basiscopically,beyond,biglandula,blade,chartaceous,color,coriaceous,decurrent,deflexed,eaf,eed,ellipsoida,equal,especially,exceeding,exserted,glabrous,interstitial,irregularly,lateral,lon,midrib,nflorescence,nther,oblique,occasionally,orolla,papillose,pilo,present,pubescent,ruit,shorter,slightly,small,smaller,spaced,stamen,tal,tem,thecae,time,tomento,toward,triangular,tube,ud,unknow,upper,vary,wide,ympodial	4-foliate,anther,articulation,biglandular,bract,branching,breeding,broad-based,bud,colour,corolla,filament,form,growth,height,heteromorphism,inflorescence,insertion,interjected,interpetalar,length,marking,mature,modification,na,needle-like,odour,orientation,ovary,paired,pattern,placement,plant,position,prickle,pseudostipule,rhizome,scale,seed,shape,size,smell,spot,staman,stem,structure,surface,symmetry,sympodial,system,texture,theca,tissue,trichome,tuber,type,unknown,vegetative,xylopodia
445	wfo-0001031144	invalid_json	231	168	146	85	22	0.632	-11,-13,.2,.5,0.5,0.8-1.4,1-,1-1.5,1-4,2-,2-3,2-6,2-9,2.5-3,2/3,25,3-7,3.5-10,4,4-20,4-4.5,6,7-10,acuminate,acute,adaxially,anther,anthesi,apart,apex,appearing,around,articulated,asymmetric,away,base,berry,branch,bright,broadly,brown,calyx,capitate,cell,closer,cm,commonly,connivent,cordate,corolla,curved,densely,diameter,divaricate,ellipsoid,elliptic,elongate,entire,exserted,filament,flattened-reniform,form,four,fruiting,glabrous,globose,groove,growth,inflated,inflorescence,later,lateral,leaf,leaflet,leaving,less,lobed,long,longest,loosely,lower,many,margin,minute,minutely,mm,near,new,number,oblique,occasionally,open,pair,pale,pedicel,peduncle,pentagonal,per,petiole,pinnately,pinnatifid,pitted,pore,poricidal,pubescent,red,reddish,ripe,scar,seed,shiny,simple,sleeve,slightly,small,sparsely,stem,stigma,strongly,style,surface,tan,terete,terminal,testal,tiny,tip,together,triangular,trichome,truncate,tube,uniseriate,upper,usually,vine,violet,wall,way,white,wing,woody,x,yellow,yellowish,Â½	0.2,1.1-2.5,100,2,3-4.5,4-6,5,5-9,5-merou,<,ag,alyx,apicula,apiculae,ark,axi,basal,basiscopically,blac,branche,brow,corresponding,cupped,drying,eaf,eed,elongating,extending,flattened,flower,free,geminat,ilament,irregularly,lamina,larger,lengthening,like,lobe,longer,markedly,membranous,mere,nflorescence,often,older,one,orolla,outline,papillo,peg,pendant,perfect,pericarp,plurifoliate,portion,primary,progress,quite,rim,ruit,slit,smaller,sometimes,spaced,spreading,stellate-rotate,tangle,tem,thin,third,tuft,twinin,twining,two,ud,unequal,unit,variable,vary,vein,weight,widest,wood,ympodial	'',[,``,articulation,bark,branching,bud,characteristic,colour,fruit,hair,length,lobing,ovary,papillose,shape,size,spacing,type,value,{,}
446	wfo-0001031152	success	232	126	74	158	52	0.319	/100-1/16,0.2-1.5,1-1.5,1.2-1.8,2.7-3.7,4-8,abaxially,accrescent,acute,adaxially,anther,apex,apical-lateral,articulated,attenuate,base,becoming,berry,blade,blunt-tipped,branched,bullate,calyx,cm,continued,corolla,due,entire,extend,filament,fruit,fruiting,globose,greenish,growth,hair,introrse,large,lateral,lavender,leaf,length,lilac,longitudinal,lower,margin,mm,oblong,openly,pale,pedicel,perfect,petiole,plurifoliate,pore,probably,ripe,rotate-stellate,scabrous,shrub,simple,slit,somewhat,stellate-pubescent,stem,surface,terminal,time,tree,unit,violet,x,yellow,young	-1.5,-10,-5.5,.4,0-100,0.2-0.3,0.3-1.3,0.3-3,1-3,1-6,1.1-2.2,1.1-3,1.3-4,1.4-2.6,1.5-3,1.5-3.5,1/2-2/3,1/2-3/4,11,13-27,2-5,2.5-7.5,2.7-4.5,2.7-6,2.8-4,3.7-7,4-19,4-6,4-7,5-6,6.5-10,8-20,9-13,acuminate,ag,along,anthesi,apart,apparently,axe,axillary,ba,basal,blister,branch,brown,bud,capitat,chartaceous,closely,conical,decurrent,dehiscing,deltoid,densely,diameter,directed,eaf,earl,eed,evident,exserted,few-rayed,fleshy,flower,free,glabrescen,glabrous,granular-tomentose,green,high,honeycombed,inserted,lackin,lanceolate,less,lobe,lobed,long,long-,longer,m.,main,midvein,mixed,moderately,mostly,multangulat,multangulate,narrowly,nearly,nflorescence,oblanceolate,obtuse,occasionally,one,open,orbicular,orolla,ovate,partly,peduncle,persistently,pitted,porrect-stellate,pubescent,rachi,rather,ray,reddish,reddish-brown,relatively,reniform,reticulate-punctate,ruit,runk,sessile,short-,short-stalked,side,slightly,soon,spaced,sparingly,sparsely,splitting,stamen,stelliform,stigma,stipitate-glandular,stout-stalked,strongly,style,suborbicular,suture,swelling,tamen,terete,testa,thick,thick-stalked,thin,thin-,thin-stalked,tomentose,touching,toward,tube,unarme,unarmed,usually,variously,vary,vein,way,wide,yellowish,ympodial	age,appressed,articulation,bract,branching,breeding,broad-based,cell,colour,connective,form,glabrescent,heteromorphism,inflated,inflorescence,insertion,interjected,interpetalar,leaflet,marking,mature,modification,na,needle-like,odour,orientation,paired,pattern,placement,position,prickle,pseudostipule,rhizome,scale,shape,smell,spot,staman,stellate,stone,structure,symmetry,sympodial,system,texture,tissue,trichome,tuber,type,vegetative,xylopodia,zygomorphy
447	wfo-0001031202	success	198	111	63	135	48	0.318	0-0.5,0-1,1-5,3.5-4,accrescent,anther,apart,apex,base,berry,broadly,calyx,cm,complex,corky,corolla,cup-shaped,difoliate,erect,filament,fleshy,fruit,fruiting,furcate,glabrous,globose,golden,green,inflorescence,irregularly,leaf,long,lower,many,margin,minutely,mm,obovate,overtopping,pedicel,petiole,pore,puberulent,raised,shape,shaped,shrub,slightly,small,spaced,stem,surface,tear-drop,terminal,time,tree,trichome,uniseriate,unit,usually,variable,white,woody	.1,.5,0.1-0.3,0.5,0.5-1,0.6-1.1,0.8-1,1-1.5,1-1.7,1.5-2,1.5-2.5,1.5-9,15-40,2-3,2-8,2.5-13,2.5-3.5,2.5-4,2/3,20-100-flowered,6-25,9-11,9-20,abrupt,acute,along,anthesi,apiculate,axi,bark,beneath,bud,capitate,completely,condition,cordate,decurrent,deflexed,deltoid,densely,dia,differing,distal,dry,due,eaf,edicel,eed,enclosed,exserted,extremely,flower,free,frui,geminat,glabrate,greenish-white,greyi,hard,large,later,lateral,like,live,lobe,lobed,lon,long-ellipsoid,long-styled,longer,main,major,material,middle,minor,minute,narrowing,nflorescence,occasional,occasionally,often,older,one,opposite,orbicular,ovary,ovoid-reniform,pair,pale,paler,papillo,papillose,pitted,planar,plant,poricidal,portion,prominent,pubescent,quite,reddish-brown,rounded,ruit,scar,scattered,sessile,shoot,short-styled,size,slender,sparsely,specimen,stigma,straight,style,tall,tan,tapering,thick,thickened,thicker,third,tip,tub,tube,ud,vein,way,weight,whitish,widest,winged,x,ympodial,young	appressed,articulation,bract,branching,breeding,broad-based,cell,colour,form,geminate,growth,hair,heteromorphism,inflated,insertion,interjected,interpetalar,leaflet,length,marking,mature,na,needle-like,odour,orientation,paired,pattern,placement,position,prickle,pseudostipule,rhizome,scale,smell,spot,staman,stone,structure,symmetry,sympodial,system,texture,tissue,tuber,type,vegetative,xylopodia,zygomorphy
448	wfo-0001031207	success	219	97	61	158	36	0.279	0.5-1,1/3-equal,5-8,anther,apex,articulated,base,berry,branched,calyx,cell,chartaceous,cm,cordate,curved,densely,difoliate,elongating,erect,evenly,filament,fruit,fruiting,gently,green,herb,lateral,leaf,length,lobed,long,margin,mature,maturity,mauve,mm,moderately,obtuse,pale,pedicel,perpendicular,petiole,poricidal,prickle,red,reflexed,shrub,simple,sometimes,spherical,spreading,stellate-pubescent,stem,straight,subentire,tapering,terminal,tip,unit,white,young	-0.4,-1/2,-11,-4,-5,-7,-8,.1,/5,0,0-0.5,0-10,0-20,0.1-0.2,0.1-0.3,0.1-0.5,0.2,0.2-0.3,0.25-0.5,0.3-0.5,0.6-0.9,0.6-1.2,0.7-2,0.8,0.85-1.4,0.9-1.6,1,1-3,1-4,1-5,1.4-2,1.5-5,1/,1/3,1/4-1/3,2-3,2-4,2.1-2.3,2.5-,2.8-3,3-5,3.5-7,5-merous,6-8,6.5-8,9,abaxially,acuminat,acute,alyx,ame,apar,apart,apically,apparently,bark,blade,bristle,bristly,broad-deltate,brow,c.,concolorous,dark,diameter,discolorous,distance,drying,dull,eaf,eed,elongated,equal,extending,eye,filiform,flattened-reniform,flower,free,geminat,glabrescent,glabrous,gray,herbaceous,infructescence,lanceolate,less,like,lobe,longer,lower,midpoint,midvein,multangulate,naked,narrow-deltate,nflorescence,oblong,occasionally,older,one,open,orange-brown,orolla,oung,outline,ovate,pair,peduncle,pendulous,per,perfec,pericarp,persistent,pit,porrect,portion,prickl,prickly,primary,raised,ray,rounded,ruit,scandent,scar,sessile,shorter,side,small,smooth,spaced,stalk,stalked,stellate,style,surface,tamen,terete,tertiary,time,toward,trichome,tube,unarmed,upper,usually,variously,vary,vein,venation,visible,way,weakly,wide,yellow,yellow-green,ympodial	articulation,bract,branching,colour,corolla,form,geminate,growth,hair,heteromorphism,inflorescence,insertion,interjected,interpetalar,leaflet,na,odour,orientation,paired,placement,position,present,pseudostipule,rhizome,scale,shape,staman,stone,structure,symmetry,sympodial,texture,tissue,tuber,type,xylopodia
449	wfo-0001031218	invalid_json_followup	154	153	96	58	57	0.623	-5,0.5-1,1-2,1-3,10-19,15-25,2-2.5,2-22,2-3,3,3-14,3-5,4-5,4-7,4-8,40,5-7,5.5-7,6-10,6-7,6-9,acuminate,aggregate,apex,apiculate,base,beyond,branched,calyx,cell,cm,connective,connivent,cordate,coriaceous,cylindrical,dark,densely,diameter,directed,distally,eglandular-pilose,ellipsoidal,entire,flattened,fruit,glabrous,glandular-puberulent,globose,greenish-purple,hair,introrse,lanceolate,lavender,lobe,long,margin,minutely,mm,mottled,oblique,obtuse,orange,ovate,ovate-elliptic,ovoid,pedicel,pedicellar,peduncle,perfect,petiole,pore,present,puberulent,pubescent,purple,rachi,radiu,remnant,ripe,simple,sometimes,sparsely,stamen,stellate,stigma,stone,style,subcoriaceous,succulent,tip,tree,unit,violet,x,yellow	0.5,1-4,2.5-3,4-28,4-foliat,40-100+,5-37,8-17,8-20,abaxially,acute,adaxially,apart,ape,articulated,axe,basal,blade,eaf,eed,eglandular,equal,especially,exceeding,exserted,flower,glabrou,glandular,leaving,less,lon,lower,moderately,narrowly,nflorescence,nther,orolla,papillo,presen,purpl,ruit,shorter,slightly,small,spaced,tal,tem,thecae,time,tomento,toward,triangular,truncat,tube,ud,vary,wide,ympodial	'',4-foliate,[,``,abaxial,adaxial,anther,appressed,articulation,bract,branching,breeding,bud,characteristic,colour,corolla,exsertion,filament,form,fruiting,growth,height,inflated,inflorescence,interjected,leaf,leaflet,length,marking,mature,modification,na,ovary,papillose,pattern,plant,position,scale,seed,shape,size,spacing,spot,stem,structure,symmetry,sympodial,system,texture,theca,trichome,truncate,type,value,zygomorphy,{,}
450	wfo-0001031225	success	163	168	116	47	52	0.712	.5,/3,0.2,0.2-0.75,0.5,0.7-6,0.75-1,1-1.7,1-3,1-5,1.5-5,2,2.5-3,3-9,3/4,5-50-flowered,5-6,7-9,9-16,acute,along,anther,anthesi,apart,apex,bark,base,beginning,broadly,bud,calyx,characteristic,closely,cm,corolla,cup-shaped,decurrent,differentiated,difoliate,dry,ellipsoid,elliptic,exserted,filament,fragrant,fruiting,furcate,glabrate,glabrous,globose,green,growth,inflorescence,leaf,less,like,lobe,lobed,long,lower,major,margin,minor,minute,minutely,mm,much,narrowly,often,older,opposite,ovary,ovate,ovoid-reniform,pale,papillose,pedicel,petiole,pitted,plant,pore,poricidal,pubescent,red-papillose,reflexed,rest,scar,shape,shaped,shrub,size,slightly,small,soon,spaced,specimen,stem,stigma,strongly,style,surface,sweetly,tan,tear-drop,tip,tree,trichome,tube,unevenly,uniseriate,unit,vein,way,white,x,young	.25,0.1-0.75,0.5-1,0.8-1,1-1.5,6-8,berry,conspicuous,darker,deltoid,dia,differing,eaf,edicel,eed,erect,flattene,free,geminat,greyish-brow,inflorescenc,lateral,live,lon,main,middle,nflorescence,one,outline,pair,papillo,portion,prominent,proximal,raised,rhomboidal,rounded,ruit,slender,straight,swelling,tall,tapering,ud,widest,woody,ympodial	0.25,articulation,bract,branching,breeding,broad-based,cell,colour,connective,diameter,flattened,flower,form,fragrance,fruit,geminate,greyish-brown,hair,height,heteromorphism,insertion,interjected,interpetalar,leaflet,length,marking,modification,na,needle-like,number,orientation,pattern,placement,position,prickle,pseudostipule,rhizome,scale,seed,spot,staman,stone,structure,symmetry,sympodial,system,texture,tissue,tuber,type,xylopodia,zygomorphy
451	wfo-0001031231	success	175	179	132	43	47	0.754	-2,0.5-1.5,1-1.5,1-2,1-3,1-4,1.5-2,13,2-3,2-4,2.5-3,25-35,37/2,37/3,4-8,5-7,8-10,80-110,acuminate,acute,adherent,almost,anther,apex,aromatic,aspect,axillary,basal,base,berry,beyond,blunt,branch,branched,brown,calyx,campanula,campanulate,cell,clonal,cluster,cm,colour,corolla,dark,declinate,developed,dia,discoidal,ellipsoid,entire,equal,erect,exerted,expanded,facetted,filament,flower,fork,glabrous,glandular,globose,green,greyish,habit,hair,juvenile,lasting,leaf,len,lengthening,less,lobe,long,loosely,marbled,margin,mature,mauve,minute,mm,oblong,occasionally,often,ovary,pedicel,pedicellate,pentagonal,petal,pinnatisect,plant,pore,poricidal,projecting,purple,rarely,rh,ripe,ripening,rotate,rounded,rugose-ruminate,seed,sessile,several,shallow,shrub,simple,slightly,slit,small,soft,sometimes,stigma,stone,stout,style,succulent,surface,tinged,tip,tissue,toward,unit,usually,variable,vigorous,violet,well,wooded,x,year	.5,3-4,absent,acumen,along,anthesi,axi,becoming,bluntly,eaf,eed,elliptic,exceeding,except,fleshy,flowering,folded,general,gree,herbarium,interacuminal,lanceolate,lon,lower,midrib,nflorescence,pedice,peduncle,plurifoliat,readily,recurve,ruit,shed,short,sinus,specimen,stonrgly,translucent,triangular,tub,ud,without,ympodial	articulation,bract,branching,bud,clonality,connective,form,fruit,fruiting,growth,height,heteromorphism,inflorescence,insertion,interjected,interpetalar,leaflet,length,na,number,odour,orientation,paired,pattern,petiole,placement,plurifoliate,position,present,prickle,pseudostipule,rhizome,scale,shape,size,smell,staman,strongly,structure,symmetry,sympodial,texture,tube,tuber,type,vegetative,xylopodia
452	wfo-0001031252	invalid_json_followup	170	154	100	70	54	0.588	0.2-1.5,0.3-1.1,1-2,1-3,12-20,2-3,2.8-3.6,3-10,3-6,5-8,5-9,5.5-6.5,7-18,absent,acute,anther,apex,articulated,attenuate,axillary,base,berry,brownish,bud,cell,ciliate,clavate,cm,condition,connivent,coriaceous,corolla,covering,cuneate,dark,deep,diameter,distal,drying,elliptic,entire,filament,flower,forked,fresh,fruit,glabrous,globose,green,green-white,greenish,hair-like,half,herb,high,homostylous,interjected,lanceolate,lateral,leaflet,lobe,make,margin,medium,mm,moniliform,mottled,mucilaginous,ovate,ovoid,pedicel,petiole,plant,pore,poricidal,purple,ripe,rotate,rounded,seed,serrate,simple,sometimes,stigma,straight,stripe,style,subtending,terminal,testal,thick,throughout,tip,tube,tuber,unwinged,wall,wet,white,whitish	0.4-3,1.3-1.9,1.75-5.2,16-33,2.5-7,3-5,5-17,5-merou,abaxially,acumen,adaxiall,adaxially,ag,along,alyx,apart,apparently,arranged,axe,bead,blade,capitat,digestion,dorsally,eaf,edge,eed,enzyme,erec,exceeding,flat,folded,geminat,generally,glabrou,hal,honeycomb-shaped,lengthening,light,like,linear,living,long,lower,multiple,necklace,nflorescence,orolla,peduncle,perfect,plurifoliate,removed,ruit,seudostipule,slit,spaced,specimen,stamen,stolon,tall,tamen,tem,tri-,typically,unit,usually,vary,x,yellow,ympodial	'',5-merous,[,``,appressed,arrangement,articulation,bract,branching,breeding,calyx,capitate,characteristic,colour,connective,form,fruiting,growth,hair,height,inflated,inflorescence,insertion,interpetalar,leaf,length,marking,mature,modification,na,number,odour,orientation,ovary,paired,pattern,placement,position,prickle,pseudostipule,scale,shape,spot,staman,stem,symmetry,system,texture,tissue,type,value,zygomorphy,{,}
453	wfo-0001031257	invalid_json_followup	206	192	126	80	66	0.612	-12,-22.5,-5,-6,0.7-1,0.75-2.5,1-1.2,1-1.3,1.1-1.2,1.5-1.7,10-16,11.5-15,2-4.5,3.5-5.7,4-10,5-8.5,7.5-9,8,abundant,aggregate,anther,anthesi,antrorse,apex,ascending,attenuate,basal,base,berry,blue-violet,bud,calyx,campanulate,cell,cm,coarsely,coat,connectival,corolla,cuneate,curved,dark,dentate,diameter,directed,dorsally,edentate,ellipsoidal,embryo,epidermal,erect,filament,flexuous,fruiting,glabrous,glandular,globose,hair-like,herb,herbaceous,hollow,honey-combed,lamina,lateral,leaf,length,light,little,lobe,long,longer,longitudinal,longitudinally,lower,margin,midvein,mm,odorles,opening,outward,ovate,pair,papillate,patent,petiole,pore,poricidal,prolongation,pubescent,purple,rarely,ridged,ring,robust,secondary,seed,serrate,shrub,simple,slightly,slit,small,somewhat,spur-like,stem,stigma,stone,strand,style,subglobose,thickened,thickening,tip,tooth,trichome,tube,unequal,upward,vein,ventrifixed,viscid,wall,white,within,x,yellow	0,0.4,0.5,0.5-0.8,1.5,1.5-2,1/10,2-,3,3.5-,4-4.5,4.5-,5,5-,6-12,6-celled,7-,8-celled,abaxially,accrescen,acuminate,adaxially,ag,bicellular,branch,broad,cotyledon,cuticle,deep,densely,diamete,difoliate,eaf,eed,elliptical,endosperm,finely,foliage,free,geminat,half,head,high,inconspicuous,inserted,like,lon,long-stalked,many-seeded,narrowly,non-glandular,orolla,pericarp,portion,reduced,ree,rest,ruit,saddle-shape,scarce,scarcely,separated,short-stalked,shorter,single-celled,sinus,smooth,solitary,stalk,striate,tem,thecae,time,trans-ovoidal,triangular,unit,vary,verrucate,viscid-pubescen,ympodial	'',3.5-4.5,4.5-12,[,``,accrescent,age,appressed,arrangement,articulation,bract,branching,breeding,broad-based,characteristic,colour,connective,form,fruit,geminate,growth,hair,height,heteromorphism,inflated,inflorescence,insertion,interjected,interpetalar,leaflet,marking,mature,modification,na,needle-like,odour,orientation,ovary,paired,pattern,pedicel,placement,plant,position,prickle,pseudostipule,rhizome,saddle-shaped,scale,shape,size,smell,spot,staman,surface,symmetry,system,texture,tissue,tuber,type,value,vegetative,xylopodia,{,}
454	wfo-0001031270	success	234	108	62	172	46	0.265	+,0.5-1,1-4,10,9-10,accrescent,along,anther,apex,articulated,base,berry,bipinnatifid,bright,calyx,cell,cm,depressed-spherical,difoliate,entire,filament,fruiting,glandular,growth,herb,heterostylous,inflorescence,investing,lateral,leaf,leaf-opposed,length,long,margin,membranous,mm,pedicel,petiole,pinnatifid,pore,poricidal,prickle,red,reflexed,ripe,shallowly,shrub,simple,slender,small,spherical,stellate,stem,strongly,tapering,tightly,tip,tissue,truncate,uniseriate,unit,white	.5,0.4-1.5,1,1-1.2,1-3,1.2-1.6,1.5,1.5-2,1/3,10-12,100,2-2.5,2-20,2-3,2-4,2-7,2.5-3,3-10,3-20,3-5,4-5,5,5-10,5-15,5-6,5-merous,6-17,6-50,7-12,8,>,abaxial,abaxially,acute,adaxial,adaxiall,alyx,anthesi,apart,arme,associated,bark,basal,beginning,blade,brow,brown,c.,capitate,celled,clavate,colored,conical,connivent,consistently,curved,deeply,densely,diameter,differentiated,directed,distal,eed,ellipti,elliptic,equal,erect,few-rayed,flower,free,frui,geminat,glabrous,gland,glandular-pubescent,green,heavily,infructescence,later,leafy,like,live,lobe,lobed,lon,long-styled,longer,loosely,lower,midpoint,midvein,minute,minutely,mixture,multangulate,multiseriate,narrowly,new,nflorescence,obovate,occasionally,often,older,orolla,oung,outline,ovoid,pair,pale,papillo,peduncle,per,pericarp,pitted,plant,portion,prickly,primary,pubescent,rachi,ray,reddish,reniform,rest,rounded,ruit,scar,scattered,secondary,sessile,shallow,shining,short-stalked,short-styled,single,sinuate,size,slightly,sparsely,spreading,stalk,staminat,stigma,straight,straw-colored,style,surface,tall,tamen,tan,terete,testal,thin,thus,trichome,tube,upward,usually,vary,varying,vein,way,well,wice,wid,wide,wing,woody,yellow,yellowish,ympodial,Â½	appressed,articulation,bract,branching,breeding,broad-based,colour,connective,corolla,form,fruit,geminate,hair,heteromorphism,inflated,insertion,interjected,interpetalar,leaflet,marking,mature,modification,na,needle-like,odour,orientation,paired,pattern,placement,position,pseudostipule,rhizome,scale,shape,spot,staman,stone,structure,symmetry,sympodial,system,texture,tuber,type,xylopodia,zygomorphy
455	wfo-0001031283	success	52	48	30	22	18	0.577	-0.25,0.1-0.15,0.4-0.5,0.5-0.7,0.7,2.2-2.8,30-40,acute,apex,base,brown,calyx,cell,cm,diameter,fruit,hair-like,lateral,mm,narrowly,obovate,outgrowth,pale,pleasant,pubescent,shrub,smelling,testa,wall,winged	.7-2.3,appearance,eed,elongating,erect,fide,give,lo,lobe,long,markedly,moore,silky,small,somewhat,sprawling,spreadin,surface,tall,thick,wide,woody	1.7-2.3,colour,form,fruiting,growth,hair,height,leaf,length,odour,plant,seed,shape,spreading,texture,thicknes,type,width
456	wfo-0001031287	success	147	98	46	101	52	0.313	0.5-1.5,4.5-5,anther,apex,attenuate,base,berry,calyx,cm,connective,corolla,dendritic,elliptic,erect,filament,fruiting,glabrous,globose,green,greenish-white,internodal,leaf,lobed,long,lower,margin,minutely,mm,nearly,pedicel,petiole,pore,poricidal,shaped,shoot,short,shrub,simple,stem,surface,tear-drop,tip,trichome,unit,white,winged	.5,0.9-1,1,1-1.2,1-1.3,1-1.5,1-5,1.5-2,1.5-5.5,2-2.5,3-4,3-5,4-5,4-6,5-14,6-10-flowered,6-7,abaxially,acute,adaxially,anthesi,apar,ape,axil,bark,bearing,bi-lobed,branch,conical,coriaceous,dark,deflexed,deltate,densely,dia,difoliate,divergently,eaf,edicel,eed,ellipsoid,elongate,enlarged,exserted,fleshy,free,frui,geminate,knob,lamina,later,lateral,lobe,lon,main,many,membranous,middle,nflorescence,occasionally,older,onto,ovary,ovoid-reniform,pair,pale,papillo,papillose,pitted,planar,plurifoliate,pointed,portion,pubescent,red-papillose,reddish-brow,reflexed,rounded,ruit,scar,sinus,small,somewhat,spaced,stigma,strongly,style,tan,thick,thin,tub,tube,tuft,ud,unevenly,vein,widest,woody,x,ympodial,young	0.5,appressed,articulation,bract,branching,breeding,broad-based,cell,colour,form,fruit,growth,hair,heteromorphism,inflated,inflorescence,insertion,interjected,interpetalar,leaflet,length,marking,mature,modification,na,needle-like,odour,orientation,paired,pattern,placement,position,prickle,pseudostipule,rhizome,scale,shape,smell,spot,staman,stone,structure,symmetry,sympodial,system,texture,tissue,tuber,type,vegetative,xylopodia,zygomorphy
457	wfo-0001031300	success	219	100	57	162	43	0.26	-4,0.2-0.4,0.5-1.5,2-3,2.5-3.2,6-8,anther,apex,articulated,attenuate,base,berry,branched,calyx,cell,chartaceous,cm,connivent,curved,difoliate,elongating,erect,flattened,fruit,fruiting,hair,lateral,leaf,length,lobed,long,lower,margin,mature,maturity,membranous,mm,orange,pale,pedicel,petiole,poricidal,porrect,prickle,red,shrub,simple,spherical,stem,surface,tapering,tip,trichome,uniradiate,unit,white,yellow-orange	-2.2,-5,-6,.5,/4,0-15,0-20,0-3,0-8,0.1,0.1-0.5,0.1-0.6,0.15-0.7,0.2-0.5,0.2-0.7,0.2-1,0.3,0.3-0.6,0.3-1.3,0.5-0.9,0.5-18,0.5-2,0.6-0.8,0.6-1,0.6-1.2,0.7-0.9,0.7-1.2,0.8-1.5,1-2,1-4,1-5,1.2-1.7,1.3-2,1.5-3.5,1/2-3/4,1/3-1/2,1/6-1/4,10-30,2-,2-4,2-5.5,2-6,2.2-2.3,2.2-2.7,3-,3-4,4,4.5-6,5-15,5-merous,abaxially,absent,acute,also,alyx,apar,apart,apically,apparently,ba,bark,blade,brow,brown-green,bulbous,caudat,concolorous,creeping,deltate,densely,diameter,distance,drying,dull,eaf,eed,equal,extending,eye,filament,filiform,flattened-reniform,flower,free,geminat,geniculate,glabrescent,glabrous,gray-green,herbaceous,highly,infructescence,lobe,lon,longer,midpoint,midvein,minute,moderately,naked,near,nflorescence,oblanceolate,oblong,obtuse,older,one,open,orange-brown,orange-green,orolla,oung,outline,pair,peduncle,pendulous,per,perfec,pericarp,pit,portion,prickl,prickly,primary,pubescent,raised,rarely,ray,reduced,rounded,ruit,scar,sessile,side,small,smooth,spaced,sparsely,spreading,stalk,stalked,stellate,stellate-pubescent,style,tamen,terete,tertiary,thin,time,tube,vary,vein,venation,visible,way,weakly,wide,wider,winged,yellow,yellow-green,ympodial	appressed,articulation,bract,branching,broad-based,colour,corolla,form,geminate,growth,heteromorphism,inflated,inflorescence,insertion,interjected,interpetalar,leaflet,marking,na,needle-like,odour,orientation,paired,placement,position,pseudostipule,rhizome,scale,shape,smell,spot,staman,stone,structure,symmetry,sympodial,texture,tissue,tuber,type,vegetative,xylopodia,zygomorphy
458	wfo-0001031310	success	203	160	133	70	27	0.655	.5,0-3,0-4,1-10,1-3,1-6,1.5-4,15-40,2-3,2.5-5.5,2.5-8.5,3-10,4-10,4-12,4.5-4.8,5-7,5.5-21,abaxially,absent,adaxially,along,anther,apart,apex,attenuate,base,berry,blade,blue,blue-purple,borne,broadly,brown,brownish,cell,chartaceous,ciliate,cm,condition,corolla,covering,cuneate,decurrent,diameter,distal,drying,elliptic,end,especially,extremely,filament,flower,forked,fresh,fruit,generally,glabrous,globose,green,green-white,greenish,hair,hair-like,half,herb,high,homostylous,lanceolate,lateral,leaf,leaflet,lengthening,less,light,like,long,make,margin,membranous,midrib,minutely,mm,mottled,mucilaginous,multicellular,narrowly,obtuse,odd-pinnate,ovate-elliptic,ovoid,pair,pale,pedicel,peduncle,petiole,petiolule,pilose,plant,pointed,pore,poricidal,puberulent,pubescent,purple,rotate,seed,simple,singly,size,slightly,slit,small,sometimes,somewhat,sparsely,stem,stigma,straight,streak,style,terminal,testal,thick,throughout,tip,tuber,typically,unwinged,wall,wet,white,whitish,x	0.5-3,1-2,1-5.5,5-6,5-merou,6-7,acumen,acuminate,ag,alyx,apparently,articulated,axe,axillary,bud,caly,connivent,conspicuously,decreasing,digestion,dorsally,eaf,edge,eed,enzyme,erect-decumben,exceeding,flat,folded,geminat,glabrou,gradually,honeycomb-shaped,interjected,larger,living,lobe,lower,nflorescence,orolla,ovate,ovate-lanceolate,perfect,plurifoliate,rachi,removed,rosette-forming,ruit,seudostipule,shortly,spaced,specimen,stamen,ste,stolo,subellipsoi,subrosette-forming,subtending,tall,tamen,tem,tissue,toward,tri-,tube,unit,usually,vary,yellow,ympodial	age,arrangement,articulation,branching,calyx,colour,connective,form,growth,height,inflorescence,length,number,ovary,pilosity,placement,position,presence,present,pseudostipule,shape,spacing,staman,stellate,stolon,subellipsoid,texture
459	wfo-0001031316	success	207	126	74	133	52	0.357	/3,0.5-2,1.5-2,1/3-2/3,4-9,5-8,abaxially,acuminate,acute,anther,apex,apparently,articulated,base,becoming,berry,blue-mauve,branched,bright,broad,calyx,cm,connivent,cream,dark,difoliate,elongating,entire,erect,filament,fruit,fruiting,glabrous,green,hair,lateral,leaf,length,lobed,long,lower,margin,marking,mature,maturity,membranous,minute,mm,obtuse,orange,pale,pedicel,petiole,poricidal,purple,reflexed,shrub,simple,sometimes,sparsely,spherical,stellate,stellate-pubescent,stem,surface,tapering,terminal,tip,trichome,unarmed,unequal,unit,way,young	-2,.1,0.05-0.1,0.05-0.15,0.1-0.2,0.3-1,0.4-0.6,0.4-0.8,0.6-1,0.8-1.2,0.8-1.8,0.9-1.3,1-5,1.2-2.1,1.3-3.5,1.5-,1.5-3.5,1.5-5,1/3-1/2,2-20,2-3,2-4,2.5-8,3-10,3-8,3.5-3.8,3.8-5,4,4-7,5-10,5-15,5-6,5-merous,6-20,8-11,8-12,8-25,abaxial,adaxial,almost,alyx,ame,apar,apically,bark,blade,c.,colored,concolorous,contrast,curved,densely,diameter,discolorous,drying,dull,eaf,eed,eye,fifth,flattened-reniform,flower,foliaceou,four,free,geminat,glabrescent,glabrou,gray,held,herbaceous,infructescence,inward,lobe,long-acuminat,longer,lowermost,midpoint,moderately,multangulate,naked,narrow-deltate,nflorescence,older,one,open,orange-brown,orolla,oung,ovate,pair,peduncle,pendulous,per,perfec,pericarp,porrect,portion,primary,ray,red-brow,red-brown,ruit,scar,sessile,slender,smooth,spaced,spreading,stalk,stalked,stellate-pubescen,strongly,style,tamen,terete,tertiary,time,tube,unarme,usually,variously,vary,vein,venation,visible,white,white-green,whitish,wide,yellow,yellow-green,ympodial	appressed,articulation,bract,branching,breeding,broad-based,cell,colour,connective,corolla,foliaceous,form,geminate,growth,heteromorphism,inflated,inflorescence,insertion,interjected,interpetalar,leaflet,modification,na,needle-like,odour,orientation,paired,pattern,perfect,placement,pore,position,prickle,pseudostipule,rhizome,scale,shape,smell,spot,staman,stone,structure,symmetry,sympodial,system,texture,tissue,tuber,type,vegetative,xylopodia,zygomorphy
460	wfo-0001031333	success	194	122	67	127	55	0.345	0.5,1-1.5,1-4,1.2-2,1/2,2.5-3,3/4,?,acute,adjacent,anther,anthesi,apex,articulated,base,berry,branched,broadly,calyx,cell,cm,ellipsoidal,entire,filament,glabrous,globose,green,growth,immature,inflorescence,lengthening,like,lobed,long,lower,many,margin,membranous,mm,near,nodding,pedicel,pentagonal,perfect,petiole,pore,poricidal,pubescent,rest,simple,slit,sparsely,stellate,stem,surface,terminal,time,tip,trichome,truncate,twining,uniseriate,unit,vine,way,white,x	+,.5,0.1-0.5,1-5,1.5,1.5-1.7,1.5-2,2,2-3,2.7-7,3-4,30-40,5-7,5-8,5-merou,50,7-10,7-9,<,>,abaxially,acuminate,adaxiall,adaxially,ag,almost,alyx,apart,appearing,ark,bilobed,branche,brown,capitate,clustered,collection,composed,conical,crea,cupped,densely,denser,diameter,eaf,eed,elliptic,exserted,flattened,flower,free,fruting,glabrescen,glabrescent,golden,greenish,half,high,ilament,lamina,leaving,less,lobe,m.,matte,mere,minute,minutely,narrowly,new,nflorescence,occasionally,older,orolla,outline,ovate,pair,pale,papillat,peduncle,peg,penden,per,pericarp,pitted,planar,plurifoliat,portion,primary,pubescent-papillate,quadrate,reniform,rhachi,ruit,scar,sinus,slightly,small,somewhat,soon,splitting,ste,stigma,striped,strongly,style,tangled,tem,testal,thickened,thin,trailing,triangular,tube,ud,undersurface,undulation,unequal,unevenly,upper,vary,vein,venation,whitish,woody,yellow,yellowish,ympodial	5-merous,age,appressed,articulation,bract,branching,breeding,broad-based,colour,connective,corolla,form,fruit,fruiting,hair,heteromorphism,inflated,insertion,interjected,interpetalar,leaf,leaflet,length,marking,mature,modification,na,needle-like,odour,orientation,paired,pattern,placement,plurifoliate,position,prickle,pseudostipule,rhizome,scale,shape,smell,spot,staman,stone,structure,symmetry,sympodial,system,texture,tissue,tuber,type,vegetative,xylopodia,zygomorphy
461	wfo-0001031333	success	194	116	88	106	28	0.454	.5,0.5,1-1.5,1-4,1-5-2,2,2.5-3,3-4,50,7-10,>,?,abaxially,acuminate,acute,adaxially,adjacent,anther,apex,bark,base,berry,branched,broadly,brown,calyx,cm,corolla,cream,densely,ellipsoid,elliptic,entire,filament,flattened,fruiting,glabrescent,glabrous,globose,golden,green,greenish,growth,immature,inflorescence,lamina,lengthening,like,long,many,margin,membranous,minute,minutely,mm,narrowly,near,new,ovate,pale,pedicel,peduncle,per,petiole,pitted,pore,poricidal,pubescent,pubescent-papillate,reniform,rotate-stellate,simple,slit,stellate,stem,surface,terminal,testal,time,tip,trichome,truncate,uniseriate,vein,vine,white,whitish,wide	+,0.1-0.5,1-5,1.5,1.5-1.7,1.5-2,1/2,2-3,2.7-7,3,3/4,30-40,5-7,5-8,5-merou,7-9,<,adaxiall,ag,almost,alyx,anthesi,apart,appearing,articulated,bilobed,branche,capitate,cell,clustered,composed,conical,cupped,denser,diameter,eaf,eed,exserted,flower,free,glabrescen,half,high,ilament,leaving,less,lobe,lobed,lower,m.,matte,mere,nflorescence,nodding,occasionally,older,orolla,outline,pair,papillat,peg,penden,perfect,pericarp,planar,plurifoliat,portion,primary,quadrate,rest,rhachi,ruit,scar,sinus,slightly,small,somewhat,soon,spaced,sparsely,splitting,stigma,striped,strongly,style,tangled,thickened,thin,trailing,triangular,tub,tube,twinin,ud,undersurface,undulation,unequal,unevenly,unit,upper,vary,venation,way,woody,yellowish,ympodial	age,appressed,arrangement,articulation,bract,branching,colour,connective,form,fruit,hair,inflated,insertion,leaf,length,marking,maturity,na,number,odour,position,seed,shape,spot,symmetry,texture,type,width
462	wfo-0001031359	success	166	157	108	58	49	0.651	.02,.25,.5,/4,0.5-1,0.5-6,0.75-1,1-4,1.2-1.6,1.2-2.5,1.5-2,1.6-2.8,1.9-2.3,12-21,2.5-3,3-3.5,3.6-8.8,5-angled,5.3-7.5,6-7,anther,anthesi,apart,apex,attenuate,bark,base,beginning,beneath,berry,bi-lobed,brown,calyx,cm,corolla,curled,dark,dia,difoliate,dull,elliptic,filament,flattened-reniform,fruiting,glabrous,globose,green,incrassate,interpetalar,leaf,live,lobed,long,major,margin,membraneous,minor,minutely,mm,narrowly,near,nearly,obovoid,opposite,outline,ovary,paler,papillae,papillose,pedicel,petiole,pit,pitted,planar,plant,pore,poricidal,reflexed,ripe,round,rusty,scar,shaped,shiny,shrub,simple,size,slender,slightly,stem,stigma,style,surface,tan,tapering,tear-drop,tip,trichome,tube,tuft,undulate,uniseriate,unit,way,white,x,yellow,yellow-orange	1.1-1.6,1.3-1.6,5-30-flowered,5-7,acuminate,angle,apiculate,appearing,axil,ba,broadly,deflexed,differing,distal,dried,eaf,edicel,eed,evenly,extending,free,geminat,inflorescenc,internodal,lamina,lateral,lobe,lon,lower,main,middle,nflorescence,occasionally,often,older,one,originating,pair,papillo,portion,ridged,ruit,sinus,somewhat,spaced,specimen,straight,strongly,tall,triangular,tub,ud,vein,white-lenticellat,widest,woody,ympodial,young	abaxial,articulation,bract,branching,breeding,bud,cell,colour,connective,diameter,form,fruit,geminate,growth,hair,height,heteromorphism,inflorescence,insertion,interjected,leaflet,length,marking,modification,na,odour,orientation,pattern,placement,position,prickle,pseudostipule,rhizome,seed,shape,spacing,spot,staman,stone,structure,symmetry,sympodial,system,texture,tissue,tuber,type,white-lenticellate,xylopodia
463	wfo-0001031362	success	138	116	66	72	50	0.478	.2,.5,0.5-1,1-1.5,2-2.5,3-6,?,along,anther,anthesi,apex,attenuate,bark,base,berry,brown,calyx,cell,closely,conical,corolla,dendritic,densely,denser,dia,filament,fruiting,glabrous,globose,golden,internodal,lanceolate,leaf,like,lobed,long,lower,margin,mm,nearly,opposite,orange-red,packed,papillose,pedicel,petiole,pore,pubescent,red,rest,shaped,shrub,simple,sparsely,stem,subshrub,surface,tear-drop,tip,trichome,tube,unit,vein,white,x,young	.3,0.4-0.5,0.7-1,1-1.1,1-3,1-3-flowered,1-4,1.5-2,3-4,abaxially,acute,adaxially,appearance,branch,bushy,cm,eaf,edicel,eed,ellipsoid,erect,exceeding,exserted,flattened,flattened-reniform,free,giving,golden-brow,incrassate,inflorescenc,lamina,lateral,lobe,lon,long-triangular,main,middle,minutely,nflorescence,nodding,older,outline,ovary,overlappin,pair,pale,papillo,pericarp,pitted,planar,plurifoliat,poricidal,portion,pubesent,rectangular,rounded,ruit,scar,shiny,slender,small-capitate,somewhat,spaced,stigma,straight,style,tan,thin,ud,widest,woody,ympodial	abaxial,adaxial,appressed,articulation,bract,branching,broad-based,colour,connective,density,diameter,form,fruit,golden-brown,growth,hair,heteromorphism,inflated,inflorescence,insertion,interjected,interpetalar,leaflet,length,na,needle-like,odour,orientation,paired,pattern,placement,plurifoliate,position,prickle,pseudostipule,rhizome,scale,shape,smell,staman,stone,structure,symmetry,sympodial,texture,tissue,tuber,type,vegetative,xylopodia
464	wfo-0001031400	invalid_json_followup	161	155	92	69	63	0.571	0.25-0.8,0.4-1.7,0.6-1.8,0.7-6,0.8-1.1,1-4,1.2-2,1.5-5,10-11,2-3,2-5,2-9,4-,4-13,4-17,4-6.5,5-12.5,6-23,7-25,7-28,abaxial,apex,apical,apically,base,branched,calyx,cm,connate,corolla,cyme,dark,deeply,dehiscent,diameter,dichasially,distal,filament,flower,forked,globose,green,green-white,hair-like,half,herbaceous,interjected,introrse,lateral,leaf,leaflet,lobe,long,lower,maturing,mm,oblique,odd-pinnate,often,ovoid,pattern,pedicel,peduncle,perennial,perfect,petiole,plant,poricidally,proximal,puberulent,seed,short,side,size,slit,stellate,straight,structure,style,subglabrous,terminal,throughout,tip,tone,tuber-bearing,unit,violet,wall,white,wide,yellow,Â¼	-3,1,1-,2,3-6-foliat,4-7,abaxially,abruptly,absen,acumen,acute,adaxially,apiculate,articulate,cell,covering,cuneate,decurrent,dichasial,digestion,diminishing,dorsally,eaf,ebracteate,edge,eed,emoval,enzyme,exceeding,flat,folded,forming,generally,globo,honeycomb,linear,linear-lanceolate,living,lon,lunat,make,monochasial,mucilaginous,nflorescence,nther,oblong,occasionally,orolla,pair,plan,rachi,reveal,ruit,sessile,seudostipule,specimen,stamen,stigma,stripe,tal,tem,testal,thick,toward,trilobe,typically,vary,without,ympodial	'',3-6-foliate,[,``,absent,anther,appressed,arrangement,articulation,bract,branching,breeding,broad-based,characteristic,colour,connective,form,fruit,fruiting,growth,hair,height,inflated,inflorescence,insertion,interpetalar,length,lunate,margin,marking,mature,modification,na,needle-like,number,odour,orientation,ovary,paired,placement,pore,position,present,prickle,pseudostipule,scale,shape,smell,spot,stem,surface,symmetry,sympodial,system,texture,tissue,trichome,type,value,vegetative,width,{,}
465	wfo-0001031401	success	182	129	86	96	43	0.473	0.6-1.2,1,1-1.5,1-6,1.1-3,1.5-2,1/2,2-2.4,2-5,2.5-4,3.5-4,3/4,5-7,5-9,abaxial,adaxial,anther,apex,attenuate,bark,base,berry,black,branching,brown,calyx,cm,corolla,dark,dendritic,densely,diameter,dichasial,drying,elliptic,filament,fruit,fruiting,globose,golden,golden-yellow,growth,leaf,lobed,mm,narrowly,new,occasionally,pair,pedicel,petiole,plurifoliate,pore,poricidal,prominently,puberulent,pubescent,purplish-black,pyramidal,raised,scar,secondary,shiny,shrub,small,sometimes,somewhat,sparsely,stem,strongly,tapering,terminal,time,tip,tree,tree-like,trichome,unit,usually,vein,violet,way,white,winged,x,yellow	0.5,0.8-1.2,1-1.4,3,5,7-9,8-10,abaxially,acute,adaxially,age,along,anthesi,apical,appearing,axi,basal,becoming,bi-lobed,blade,branch,clearly,conical,deciduous,deflexed,deltoid,denser,differentiated,eaf,ecuador,ecuadorian,edicel,eed,ew,exserted,finely,flattened,flower,fork,free,glabrous,impressed,inserted,lateral,lenticular,less,lobe,long,long-triangular,lower,m.,matted,mesophyll,minutely,monochasia,near,nflorescence,noddin,nodding,node,often,older,outline,ovary,overtopping,papillo,per,pericarp,pitted,planar,portion,pubescen,reddish-brown,rounded,roundish,ruit,shoot,short,sleev,slit-like,specimen,stamen,ste,stigma,style,surface,tall,thin,tub,tube,ud,visible,wide,woody,ympodial,young	bract,breeding,bud,cell,colour,form,hair,height,heteromorphism,inflorescence,interjected,interpetalar,leaflet,length,marking,monochasial,na,odour,orientation,pattern,placement,plant,position,prickle,pseudostipule,rhizome,scale,shape,size,spot,staman,stone,structure,symmetry,sympodial,system,texture,tissue,tuber,type,venation,width,xylopodia
466	wfo-0001031480	success	237	117	75	162	42	0.316	/3,0-5,0.5-2,1-2,5-8,6-8,andromonoecious,anther,apex,articulated,base,berry,branched,branching,bright,calyx,cell,cm,cream,cuneate,curved,densely,difoliate,ellipsoid,elongating,entire,equal,erect,filament,flattened,fruit,fruiting,glabrous,glandular,hair,lateral,leaf,length,lobed,long,lower,margin,marking,mature,maturity,mauve,mm,pale,pedicel,petiole,poricidal,prickle,purple,red,shallowly,shrub,simple,slightly,spherical,spreading,stellate,stellate-pubescent,stem,straight,surface,tapering,terminal,thick-chartaceous,tip,trichome,truncate,unit,way,weakly,young	-0.25,-2,0,0-0.5,0-1,0-2,0-30,0.1,0.1-0.3,0.1-0.4,0.15-0.3,0.2-0.35,0.4,0.4-0.8,0.5-,0.6-0.8,0.7,0.8,0.8-1,1-1.3,1-1.5,1-3,1-4,1.5-2.2,1.7-2.2,1.8-3,1/2,1/3,1/4,1/6-1/5,2-,2-2.7,2-3,2-5,2-6,3,3-10,3-6,3-7,3.5-7,4-5,4-6,5-merous,6-13,6-30,7-8,8-12,abaxial,abaxially,acuminat,acute,adaxial,alyx,apar,apart,apically,apparently,ba,bark,blade,broad-deltate,dark,deltate,diameter,discolorous,distal,distance,drying,dull,eaf,eed,elongate,extending,eye,faint,flattened-reniform,flower,free,geminat,glabrescent,green,hermaphrodite,heterostylous,inconspicuous,infructescence,lobe,long-styled,longer,lowermost,midpoint,midvein,minutely,moderately,naked,near,nflorescence,obtuse,often,older,one,open,orange-brown,orolla,oung,outline,ovate,pair,peduncle,pendulous,per,pericarp,persistent,pit,plant,porrect,portion,prickly,primary,pubescent,raised,ray,red-brow,red-brown,red-green,red-yellow-green,reduced,reticulate,rounded,ruit,scandent,scar,sessile,short-styled,shorter,side,slender,small,smooth,somewhat,spaced,sparsely,stalk,stalked,staminat,style,tamen,terete,tertiary,time,tube,unarme,unarmed,upper,variously,vary,vein,venation,visible,wide,woody,yellow,ympodial	articulation,bract,breeding,broad-based,colour,corolla,form,geminate,growth,heteromorphism,inflorescence,insertion,interjected,interpetalar,leaflet,na,needle-like,odour,orientation,paired,placement,position,present,pseudostipule,rhizome,scale,shape,smell,spot,staman,stone,structure,symmetry,sympodial,system,texture,tissue,tuber,type,vegetative,xylopodia,zygomorphy
467	wfo-0001031483	success	154	143	88	66	55	0.571	.5,/2,0.5,0.5-2,1,1-2,1.2-1.4,1.7-5.5,11-20.5,2-2.5,2-3,3-4,3-8-flowered,6-10,7-10,acuminate,acute,almost,anther,apart,apex,attenuate,base,berry,calyx,clavate,cm,corky,corolla,dia,difoliate,evenly,filament,filiform,flower,fruiting,fusiform,glabrous,green,indistinct,internode,larger,lateral,leaf,less,linear,lobed,long,main,markedly,minutely,mm,oblanceolate,obovate,obovoid,opposite,ovary,ovoid-reniform,pair,pale,papillose,pedicel,petiole,pore,poricidal,scar,shape,shaped,shrub,simple,slightly,spaced,stem,stigma,strongly,style,subshrub,tapering,tear-drop,tip,turbinate,unit,vein,way,white,wing,winged,x	0,1.1-2.5,1/3,2.5-3.2,across,anew,anthesi,ba,bearing,beginning,beneath,blade,ca,caly,continuous,cork,decurrent,deflexed,deltoid,distal,dry,eaf,edicel,eed,end,exserted,free,fresh,geminat,indistinc,lea,lenticellate,lobe,lower,major,minor,nflorescence,oblong,often,orbiculate,paler,papillo,per,planar,pointed,portion,prominent,quite,raised,rounded,ruit,short,short-triangular,slender,somewhat,soon,straight,tall,tan,third,tube,ud,variable,widest,woody,ympodial	appressed,articulation,bract,branching,breeding,bud,cell,colour,connective,form,fruit,geminate,growth,hair,height,heteromorphism,inflated,inflorescence,insertion,interjected,interpetalar,leaflet,length,lenticel,margin,marking,mature,modification,na,odour,orientation,pattern,placement,plant,position,present,prickle,pseudostipule,rhizome,scale,seed,size,spot,staman,stone,structure,symmetry,sympodial,system,texture,tissue,tuber,type,venation,xylopodia
468	wfo-0001031492	success	175	107	58	117	49	0.331	.5,/4,0.7-1.3,1-1.5,2-5,4-4.5,age,anther,apex,attenuate,base,becoming,berry,branching,calyx,cm,conical,corolla,decurrent,densely,echinoid,elliptic,filament,fruit,fruiting,globose,growth,inserted,leaf,lobed,long,lower,medium,mm,narrowly,pedicel,petiole,plurifoliate,pore,poricidal,predominantly,pubescent,purplish-black,shrub,size,sleeve,slit-like,stem,surface,terminal,time,tip,tree,tree-like,trichome,unit,violet,way	0.5,0.9-1.1,08,1-1.3,1.3-2,1.5-1.8,1.5-2.5,10-15,2-10,2-3,20,3-4,3-5,4-10,6-8,8-11,8-9,abaxially,absent,acuminate,acute,adaxially,anthesi,apical,appearing,axe,ba,bark,basal,beneath,bi-lobed,bitter,dark,dbh,deciduous,deltoid,dendritic,denser,diameter,distinguishable,drying,dull,eaf,edicel,eed,erect,ew,exserted,flattened,flower,free,glabrous,golden,grey,juice,lamina,lateral,lenticular,lightly,lobe,m.,minutely,monochasia,nflorescence,nodding,occasionally,older,ovary,overtopping,pair,papillo,per,pericarp,pitted,planar,portion,prominent,pyramidal,rather,reddish-brown,remaining,ruit,scar,scarcely,scattered,secondary,shiny,shoot,short,slightly,sometimes,somewhat,sparsely,stamen,ste,sticky,stigma,strongly,style,sunken,tall,tapering,thin,tub,tube,ud,undersurface,upper,upturned,vein,wide,winged,woody,x,ympodial,young,younger	appressed,articulation,bract,breeding,broad-based,cell,colour,form,hair,heteromorphism,inflated,inflorescence,insertion,interjected,interpetalar,leaflet,length,margin,marking,mature,monochasial,na,needle-like,odour,orientation,pattern,placement,position,prickle,pseudostipule,rhizome,scale,shape,smell,spot,staman,stone,structure,symmetry,sympodial,system,texture,tissue,tuber,type,vegetative,width,xylopodia,zygomorphy
469	wfo-0001031503	invalid_json_followup	142	143	82	60	61	0.577	-10,-15,-30,-7,0.3-3,0.5-1,0.5-4,1-2.5,1-3,1-5,1-7,1.5-2,1.5-3,1.5-8,10-19,2-3,2.5-10,3-4,3-5,3-6,6-7,7-10,acuminate,acute,angled,apart,apex,base,branched,calyx,chartaceous,cm,cuneate,cylindrical,decurrent,deltate,densely,diameter,directed,distally,elliptic,entire,flower,forked,glabrous,globose,hair,lanceolate,lobe,margin,mm,moderately,often,orange,ovate,pedicel,peduncle,petiole,pore,puberulent,pubescent,rachi,radiu,rarely,reddish,ripe,rounded,rugose-pubescent,shrub,simple,slightly,sparsely,stellate,stigma,style,subclavate,truncate,unbranched,unequal,white,x,yellow	-25,-6,1-,1.5-7,1.7-3.5,3-15,5613,6-many-foliat,7-15,abaxially,abruptly,absen,adaxially,aggregate,articulated,axe,ba,blade,cell,connivent,curled,distall,eaf,eed,eglandular,except,fide,gland,long,lower,mostly,narrowed,narrowly,nflorescence,nther,obtuse,occasionally,orolla,perfect,present,ruit,spaced,stalked,stone,subcapitat,tal,tem,time,tip,toward,triangular,tube,uniseriate,unit,usually,vary,vein,venturi,wide,ympodial	'',[,``,abaxial,adaxial,anther,appressed,articulation,b,bract,branching,breeding,characteristic,colour,connective,corolla,direction,filament,form,fruit,fruiting,growth,height,inflated,inflorescence,insertion,interjected,interpetalar,leaf,leaflet,length,marking,mature,modification,na,odour,ovary,paired,pattern,plant,position,prickle,scale,seed,shape,smell,spacing,spot,stem,subcapitate,symmetry,system,texture,tissue,trichome,type,value,vegetative,zygomorphy,{,}
470	wfo-0001031586	success	167	108	59	108	49	0.353	-2,0.1-1,0.5-1,1-1.5,1-2,1.3-5,1.4-2.5,1.5-2,2,3-11,5-6,anther,apex,attenuate,base,calyx,cm,corolla,cream-colored,deltate,dia,elliptic,flower,geminate,glabrous,green,greenish,inflorescence,leaf,lobe,lobed,lower,margin,mm,nearly,opposite,pale,papillate,pedicel,petiole,pore,present,ridged,rounded,shaped,shiny,shrub,simple,size,stem,surface,tear-drop,trichome,tube,uniseriate,unit,white,x,yellow	.25,0.5-0.8,1,1-1.2,2-2.5,5-10,7-10-flowered,abrupt,absent,acute,anthesi,apart,apparently,appearing,bark,becoming,beneath,borne,branch,bright,broadly,bud,campanulate,capitate,closer,completely,conical,cucullate,deflexed,differing,difoliate,distance,drying,eaf,edicel,eed,ellipsoid,exerted,exfoliatin,filament,fleshy,free,fresh,globose,gree,inflorescenc,know,known,later,lateral,leave,long,main,major,material,may,minor,minutely,mucro,near,new,nflorescence,notched,occasionally,older,olive,one,onto,open,ovary,overtopping,pair,paler,papillose,planar,poricidal,portion,prominent,raised,remaining,ruit,scar,shap,shin,slender,small,sometimes,somewhat,soon,spaced,sparsely,stigma,straight,style,swollen,tall,tapering,thick,thickened,tip,truncate,trunk,ud,vein,widely,yellowish,ympodial,young	7-10,articulation,bract,branching,breeding,broad-based,cell,colour,form,fruit,fruiting,growth,hair,height,heteromorphism,insertion,interjected,interpetalar,leaflet,length,mature,na,needle-like,number,odour,orientation,paired,pattern,placement,plant,position,prickle,pseudostipule,rhizome,scale,shape,smell,staman,stone,structure,symmetry,sympodial,system,texture,tissue,tuber,type,vegetative,xylopodia
471	wfo-0001031587	success	142	104	83	59	21	0.585	.5,0.8-1,1-1.5,1.5-2,1.7-2,10-15,12-16,17-30,2-9-celled,2/3,5,6-7,6-8,abaxially,acute,adaxially,anther,apex,attenuate,bark,base,bi-lobed,calyx,clavate,closely,cm,cone,corolla,deflexed,dendritic,densely,elliptic-ovoid,exserted,filament,fleshy,furcate,glabrous,globose,golden-red,included,inflorescence,leaf,lobe,lobed,major,minor,minutely,mm,oblique,occasional,older,ovary,pale,papillate,pedicel,perpendicular,petiole,pore,pubescent,rarely,reddish-grey,scar,shape,shaped,simple,size,soft,somewhat,spaced,stem,stigma,style,tear-drop,thick,thickened,tree,trichome,tube,uniseriate,verrucose,way,x,young	2,2-2.5,3-4,7-9,along,anthesi,apart,axi,broadly,conical,decurrent,deltate,denser,dia,differing,drying,eaf,edicel,eed,elliptic,erect,evenly,fide,free,irregular,know,known,lamina,later,lateral,like,long,loose,lower,lowered,main,middle,mostly,ocasionally,overlappin,pair,papillo,parallel,persisten,poricidal,portion,rect,rest,ruit,steinbach,surface,tall,tip,tub,ud,vein,white,widest,winged	bud,colour,deflexion,diameter,exsertion,form,fruit,growth,hair,height,inclusion,length,na,occasionally,overlapping,papillose,persistent,plant,texture,thicknes,type
472	wfo-0001031589	success	222	102	60	162	42	0.27	-6,0.1-0.5,0.2-0.5,1-5,1/3-1/4,2.8-4,8-14,anther,apex,articulated,attenuate,base,berry,bright,calyx,cell,chartaceous,cm,connivent,cream,difoliate,elongating,equal,erect,filament,flower,fruit,fruiting,green,lateral,leaf,length,lobed,long,margin,marking,maturity,mauve,membranous,mm,narrow-cuneate,pale,pedicel,petiole,poricidal,prickle,shrub,simple,solitary,spherical,stellate-pubescent,straight,surface,tapering,tip,unit,way,white,yellow,young	-0.5,-15,-6.5,.5,/6,0,0-1,0-10,0-3,0-30,0.1,0.15-0.3,0.2-0.4,0.2-3,0.4,0.5-1,0.55-0.7,0.6-1.2,0.7,0.8-2.3,0.9-1.3,0.9-1.6,1,1-1.8,1.2-1.5,1.5-5,1.7-2.5,1.8-2.9,1/3,1/3-1/2,10-30,2-,2-10,2-3.5,2.5-4.5,2.5-6,3-4,3-5,3/4,4-6.5,4/5,5-8,5-merous,6-8,8-30,abaxially,acute,alyx,ame,apart,apically,apparently,bark,blade,broadly,brow,brown-green,c.,caudat,concolorous,dark,deltate,densely,density,diameter,discolorous,distance,drying,dull,eed,elliptic,extending,eye,flattened-reniform,free,geminat,glabrescent,glabrous,gray-green,higher,infructescence,lengt,lobe,lon,long-obovate,longer,lower,mature,midpoint,midvein,moderately,multangulate,naked,narrow,nflorescence,oblong,obovate,occasionally,often,older,orange-brown,orange-green,orolla,oung,outline,pair,part,pendulous,per,perfec,pericarp,pit,plant,porrect,portion,prickl,prickly,primary,raised,ray,reflexed,rounded,ruit,scandent,sessile,shiny,shorter,side,small,smooth,sometimes,somewhat,spaced,sparsely,spreading,stalk,stalked,stellate,stem,stout,style,subentire,subsessile,tamen,terete,tertiary,time,trichome,tube,upper,vary,vein,venation,visible,weakly,whole,wide,winged,woody,yellow-green,yellow-orange,ympodial	articulation,bract,branching,breeding,colour,corolla,form,geminate,growth,hair,heteromorphism,inflorescence,insertion,interjected,interpetalar,leaflet,na,needle-like,odour,orientation,paired,pattern,perfect,placement,position,pseudostipule,rhizome,scale,shape,spot,staman,stone,structure,symmetry,sympodial,system,texture,tissue,tuber,type,xylopodia,zygomorphy
473	wfo-0001031609	invalid_json_followup	154	158	91	63	67	0.591	0.4-3,0.5-3,1-10,1-6,1.3-3,1.5-2,1.5-3,10-25,2,2-,2-3,2.5-4,20-25,3-24,3-5,3-9-lobed,4,4-5,4-6,4.5-60,8-20,acute,apex,around,articulated,base,brownish,calyx,campanulate,cm,connective,connivent,cuneate,dark,deltate,dia,diameter,dilated,directed,distally,ellipsoidal,elliptic,elliptic-ovate,entire,flattened,fleshy,flower,forked,fruit,glabrous,globose,green,inflorescence,laterally,leaf,lobe,lobed,lower,margin,mm,obconical,obovate,obtuse,orange,pedicel,peduncle,petiole,pinnately,pore,puberulent,rachi,radiu,reticulate,ripe,shallowly,shrub,simple,small,stellate,stigma,strongly,style,succulent,tree,triangular,truncate,tube,unbranched,unlobed,x,yellow	.5,/4,0-30,0.5-1,3-foliat,5-25,5/6,abaxially,absen,absent,adaxially,aggregate,ape,apiculate,axe,barely,beyond,bilobe,blade,branch,brow,cell,conspicuous,contiguous,divided,eaf,eed,emerging,equal,exceeding,exserted,glabrou,leaving,long,midrib,minutely,nearly,nflorescence,nther,occasionally,orolla,papillose,pedicellar,point,rounded,ruit,scar,sinus,stamen,stone,succulen,tal,tem,thecae,time,tip,tomento,two,ud,unit,vary,wide,ympodial	'',10-30,[,``,anther,articulation,bilobed,bract,branching,breeding,broad-based,brown,bud,characteristic,colour,corolla,filament,form,fruiting,growth,hair,height,insertion,interjected,interpetalar,leaflet,length,lobing,marking,mature,modification,na,needle-like,number,odour,orientation,ovary,paired,pattern,pellate,placement,plant,position,prickle,pseudostipule,pubescence,reticulation,rhizome,scale,seed,shape,size,spot,stem,succulence,surface,symmetry,system,texture,theca,tissue,tuber,type,value,xylopodia,{,}
474	wfo-0001031615	success	154	140	111	43	29	0.721	.5,0.5,0.5-1,0.8-1,0.9-1.1,1-1.6,1.5,1.5-5,11-15.5,2-3,2-4.2,3.8-6.1,4-6.5,5-20-flowered,5-6,8-10,acuminate,acute,anther,anthesi,apex,attenuate,axil,bark,base,berry,bilobed,brown,calyx,capitate,closely,cm,corolla,decurrent,deep,deflexed,deltoid,dia,difoliate,distal,elliptic,expanded,exserted,filament,fruit,fruiting,furcate,glabrous,glandular,globose,green,incrassate,inflorescence,lateral,leaf,less,lobe,lobed,long,main,major,margin,minor,minutely,mm,nearly,occasionally,older,opposite,ovary,packed,pair,papillose,pedicel,petiole,pitted,pore,poricidal,reflexed,scar,scarcely,shaped,shiny,shrub,simple,size,slender,slightly,small,somewhat,stem,stigma,style,subumbellate,surface,tapering,tear-drop,tip,tree,trichome,tube,tuft,unicellular,uniseriate,unit,urceolate,vein,white,winged,x,young	0,1.3-1.8,6-8,arising,ba,becoming,caly,dark,dark-papillo,differing,eaf,edicel,eed,flattened-reniform,free,geminat,impressed,interpetalar,lamina,lon,lower,maroo,middle,minute,nflorescence,one,overlappin,paler,papillae,per,portion,prominent,ruit,sinus,straight,tall,terminal,thickened,thin,ud,widest,woody,ympodial	appressed,bud,colour,dark-papillose,exsertion,flower,form,geminate,growth,hair,height,inflated,length,marking,maroon,mature,modification,placement,plant,position,present,seed,shape,shine,spot,structure,sympodial,texture,type
475	wfo-0001031618	success	184	133	83	101	50	0.451	-2,0-3,1-1.5,2-3,3-4,4-5,40-60,90-110,acute,anther,apex,axil,base,berry,branch,calyx,capitate,cell,cm,corolla,cuneate,cyme,darker,discoidal,ellipsoid,elliptic,equal,exerted,facetted,filament,finely,glabrous,glandular,green,greyish,hair,lanceolate,lavender-purple,leaf,less,long,marbled,maturity,minute,mm,narrowly,oblong,obovoid,often,ovary,ovoid,pale,pedicel,peduncle,petiole,pinatisect,pore,poricidal,purple,reddish-brown,reticulate,ripe,rotate,rounded,rugose,scorpioid,shrub,simple,somewhat,stem,stigma,stone,stripe,strongly,succulent,surface,tapering,terete,tinged,tip,tissue,unequal,variable	0.5-1.5,1-7,1.5-2,1.5-3.5,10-18,10-lobed,13,2-2.5,3,3-8,5,5-12,acuman,almost,also,anthesi,appearance,appearing,aspect,becoming,beyond,blunt,bluntly,broadly,c.,clonal,cluster,column,conical,covering,cut,developed,dia,eaf,eed,emarginate,enlarged,erect,except,extending,fleshy,floral,flower,fork,forked,frui,general,giving,greatly,gree,growing,habit,half,interacuminal,lasting,lengthening,lobe,lobed,lon,loosely,lower,mauve,may,mid-vein,midrib,nflorescence,occasional,occur,ovate-lanceolate,pal,pedicellate,petal,plurifoliat,point,rarely,rhachi,ruit,sessile,several,shallowly,side,single,sinus,slit,soft-wooded,sometimes,specimen,stout,styl,triangular,tub,ud,unit,vigorous,way,well,x,year,ympodial,young,younger	appressed,articulation,bract,branching,breeding,bud,colour,connective,form,fruit,fruiting,growth,height,heteromorphism,inflated,inflorescence,insertion,interjected,interpetalar,leaflet,length,margin,marking,mature,modification,na,number,odour,orientation,paired,pattern,placement,plant,position,prickle,pseudostipule,rhizome,scale,seed,shape,spot,staman,style,symmetry,system,texture,tube,tuber,type,xylopodia
476	wfo-0001031646	invalid_json_followup	171	159	117	54	42	0.684	-7,-pinnate,.2,.5,0.2-0.8,0.5-2,0.8-1.5,1-1.8,1-10,1.2-2.5,1.5-3.5,1.5-4,15-25,2-10,2-2.5,2-3,2.5-10,20,3.5-4,4-18,4-20,4-5,5,5-6,5-7,5-7.5,7-8,8-15,absent,accrescent,acuminate,acute,anther,apart,apex,apparently,articulated,base,berry,blade,blue,branched,brown,calyx,chartaceous,cm,cuneate,cylindrical,darker,densely,diameter,directed,ellipsoidal,elliptic-lanceolate,entire,filament,flattened,flower,fruit,fruiting,glabrous,globose,green,hair,highly,homostylous,hyaline,immature,interjected,leaf,leaflet,light,lobe,long,margin,maroon,mature,mm,multicellular,oblique,obliquely,oblong,obtuse,ovate-lanceolate,pedicel,peduncle,perfect,petiolule,pore,pubescence,pubescent,rachi,red,rotate-pentagonal,rounded,rugulose,scandent,shortly,shrub,simple,size,slightly,small,smooth,spreading,stem,stigma,style,surface,tawny,tip,tube,uniseriate,vine,violet,x,yellow	1-6,18-38,1962,4-8,4-foliate,5-merou,abaxially,absen,acut,adaxially,aggregate,alyx,apical,axe,ba,basally,cell,ciliat,climbing,connivent,correll,covered,decreasing,distall,eaf,eed,elliptic,equal,fide,geminat,glandular,high,lateral,lower,nflorescence,orolla,ovate-lanceolat,part,petiole,present,pubescen,ruit,seudostipule,spaced,stone,stout,tamen,tem,toward,tree,truncat,unit,vary,ympodial	'',[,``,abaxial,adaxial,arrangement,articulation,bract,branching,breeding,characteristic,ciliate,colour,connective,corolla,distally,form,growth,inflorescence,length,marking,modification,na,ovary,pattern,position,pseudostipule,scale,seed,shape,spacing,spot,staman,stellate,symmetry,system,texture,truncate,type,value,{,}
477	wfo-0001031651	success	201	132	80	121	52	0.398	-2,-3,.7,/3,/5,0-20,0.3-0.8,0.3-1.5,1,1-2,4-6,abaxial,adaxial,anther,apex,apparently,articulated,base,berry,branched,calyx,cell,chartaceous,cm,cordate,densely,difoliate,dull,elliptic,elongating,entire,equal,filament,flattened-reniform,flower,fruit,fruiting,herb,lateral,leaf,length,lobed,long,lower,margin,mature,maturity,mm,obtuse,orange-brown,ovate,pedicel,per,petiole,poricidal,prickle,prickly,purple,red,rounded,shrub,simple,sometimes,spherical,spreading,stellate,stellate-pubescent,stem,subentire,surface,tapering,terminal,tip,trichome,unarmed,unit,way,weakly,white,yellow	-3.5,.1,.6,0.1,0.1-0.15,0.1-0.2,0.1-0.25,0.15-0.2,0.2-0.5,0.3-0.5,0.6-1,0.6-1.3,0.7-1,1-1.7,1-4,1.2-2,1.2-3,1.3-1.6,1.5-2,1/5,1/6-1/4,2-10,2-3,2-3.5,2/3-3/,3-5,4-5,4.5-7,5-merous,abaxially,absent,acuminat,acute,alyx,ame,apar,apart,apically,bark,blade,brown,c.,concolorous,curved,dark,deltate,diameter,discolorous,drying,eaf,eed,erect,eye,faint,filiform,free,geminat,glabrescent,glabrous,gra,gray,herbaceous,infructescence,lanceolate,lobe,longer,midpoint,naked,nflorescence,oblong,older,one,open,orolla,oung,outline,pair,peduncle,pendulous,perfec,pericarp,persistent,pit,porrect,portion,prickl,primary,raised,ray,red-green,reflexed,ruit,scandent,scar,shorter,small,smooth,spaced,stalk,stalked,straight,style,subsessile,tamen,terete,tertiary,thick,thick-stalked,time,toward,tube,unarme,upper,variously,vary,vein,venation,visible,wide,yellow-green,ympodial	articulation,bract,branching,breeding,broad-based,colour,connective,corolla,form,geminate,growth,hair,height,heteromorphism,inflorescence,insertion,interjected,interpetalar,leaflet,marking,modification,na,needle-like,number,odour,orientation,pattern,perfect,placement,plant,pore,position,pseudostipule,rhizome,scale,seed,shape,smell,spot,staman,stone,structure,symmetry,sympodial,system,texture,tissue,tuber,type,vegetative,xylopodia,zygomorphy
478	wfo-0001031656	invalid_json_followup	154	153	100	54	53	0.649	.5,/4,0.5,0.5-1,1-2.5,1.5-2,1.5-5,10-20,2.5-3.5,3-3.5,3-5,4-9,5-ribbed,6-8,acuminate,acute,anther,anthesi,apex,bark,base,berry,calyx,capitate,closely,cm,corolla,densely,dia,drying,ellipsoid,elliptic,enclosing,filament,fleshy,fruit,fruiting,glabrous,globose,green,greyish,known,leaf,lobe,lobed,long,long-acuminate,lower,margin,matte,mature,minor,minutely,mm,oblique,often,older,opposite,ovary,ovate,paler,papillose,pedicel,persistent,petiole,planar,plant,pore,portion,rather,red-papillose,reddish,reflexed,rib,rounded,scar,sessile,shaped,shiny,shrub,size,slightly,somewhat,spaced,stem,stigma,style,surface,tear-drop,terminal,thick,thickened,tip,transversely,upper,way,white,woody,x,young	1-1.5,1-2,1.2-1.5,5-7,also,arising,ba,bright,cork,differing,difoliate,directly,eaf,edicel,eed,erect,extremely,flower,free,geminat,hooded,lateral,live,lon,main,major,middle,minute,nflorescence,node,one,pair,pale,papillo,peelin,poricidal,prominent,proximal,ridged,ruit,specimen,straight,strongly,swollen,tall,top,tube,ud,unit,vein,visible,wide,widest,ympodial	'',[,``,appressed,articulation,bract,branching,breeding,bud,characteristic,colour,connective,corky,density,diameter,form,function,growth,hair,height,inflated,inflorescence,information,insertion,interjected,interpetalar,leaflet,length,marking,modification,na,odour,orientation,paired,pattern,peeling,persistence,placement,position,prickle,scale,seed,shape,spot,symmetry,system,texture,thicknes,tissue,type,value,{,}
479	wfo-0001031667	success	153	140	82	71	58	0.536	0.6-1,0.6-1.5,1-1.5,1-4,1.4-3,1.5-2,10-13,12-35,2-5,2.5-5,3-13,3-5,5-15,5-9,6-10,8-13,8-15,apex,apically,articulate,base,branched,calyx,cell,cm,connate,cordate,corolla,cuneate,cyme,dark,dehiscent,diameter,dichasial,dichasially,distal,filament,flower,generally,globose,green,half,herbaceous,interjected,irregularly,lateral,leaf,leaflet,lobed,long,lower,mm,monochasial,mucilaginous,oblique,odd-pinnate,ovoid,pattern,pedicel,peduncle,perennial,perfect,petiole,pilose,plant,poricidally,proximal,rounded,seed,size,spot,stellate,straight,stripe,style,terminal,tuber-bearing,unit,white,wide,yellow,Â¼	2-3,2-6,3-6-foliat,3-8,4-1.,abaxially,abruptly,acumen,acuminate,acute,adaxially,apical,apiculate,caudate,covering,digestion,diminishing,dorsally,eaf,ebracteate,edge,eed,elliptic-lanceolate,emoval,enzyme,exceeding,flat,folded,forked,globo,green-white,hair-like,honeycomb,introrse,lanceolate,living,lobe,lon,lunat,make,maturing,nflorescence,nther,oblong,often,orolla,pair,petiolate,petiolule,plan,reveal,ruit,sessile,seudostipule,short,slit,specimen,stamen,stigma,tal,tem,testal,thick,throughout,toward,typically,vary,wall,whit,without,ympodial	3-6-foliate,4-10,anther,arrangement,articulation,bract,branching,breeding,broad-based,colour,connective,ebbrate,form,fruit,fruiting,growth,hair,height,heteromorphism,inflorescence,insertion,interpetalar,length,lunate,margin,marking,modification,na,needle-like,number,odour,orientation,ovary,paired,placement,pore,position,prickle,pseudostipule,rhizome,scale,shape,staman,stem,stone,structure,surface,symmetry,sympodial,system,texture,tissue,tuber,type,wet,width,xylopodia,zygomorphy
480	wfo-0001031672	success	157	89	49	108	40	0.312	1-5,1.5-5,4.5-5,9-lobed,abaxially,acuminate,adaxially,apex,base,calyx,cell,chartaceous,cm,connective,cordate,densely,directed,distally,fruit,glandular-puberulent,globose,green,greenish-brown,hair,leaf,margin,mm,narrowly,near,ovate,ovoid,pedicel,petiole,pilose,pore,present,puberulent,simple,sparsely,stellate,stone,subcoriaceous,tree,triangular,truncate,unbranched,unit,whitish,yellow	0,0-2,0.3-0.5,0.5,0.5-1,0.5-1.5,1,1-,1-1.5,1-10,1-2,1.5-2,1.5-2.5,1.5-3.5,10-20,15-20,15-50,2-12,2-28,3-4-foliat,3/4,4,4-34,4/5,5-6,6,absent,acute,aggregate,apart,ape,apiculate,articulated,aublet,axe,basal,beyond,blade,ciliat,cylindrical,diameter,divided,eaf,eed,entire,exceeding,exserted,fide,flattened,fleshy,flower,glabrous,lanceolate,leaving,lobe,lobed,lon,long,lower,mature,membranaceous,midrib,moderately,nflorescence,nther,obtuse,occasionally,often,one,orolla,pedicellar,peduncle,perfect,pilo,pinnately,presen,pubescent,purple,rachi,radiu,remant,represented,rounded,ruit,shorter,sinus,slightly,small,spaced,stamen,stigma,style,tal,tem,thecae,time,tip,toward,truncat,tube,ud,unlobed,vary,white,wide,x,yello,ympodial	3-4-foliate,anther,articulation,berry,bract,branching,breeding,colour,corolla,filament,form,fruiting,growth,height,inflorescence,insertion,length,lobing,marking,modification,na,odour,orientation,placement,plant,position,prickle,pseudostipule,rhizome,shape,spot,structure,symmetry,sympodial,system,texture,tuber,type,xylopodia,zygomorphy
481	wfo-0001031684	success	161	107	57	104	50	0.354	/4,0.4-1.5,0.5-0.7,0.5-0.8,0.75-1,acute,anther,apex,base,berry,branched,calyx,cm,corolla,curly,decurrent,difoliate,elliptic,filament,fruiting,geminate,globose,green,inflorescence,internodal,irregularly,leaf,like,lobed,long,lower,mm,occasionally,opposite,pedicel,petiole,pore,pubescent,reflexed,shaped,shrub,slightly,small,sparsely,stem,surface,tear-drop,tipped,tree,trichome,unifoliate,uniseriate,unit,way,white,winged,x	.25,.5,.75,0.1,0.5-1,0.7-1,1-1.2,1-5,10-100,2,2-9,3-3.5,3-30,4-17,5-7,acuminate,along,anthesi,apar,bark,bearing,beneath,black,borne,causing,clavate,deflexed,densely,denser,dia,differing,drying,eaf,edicel,eed,elongated,except,expanded,exserted,extremely,filiform,flower,free,glabrous,gre,greatly,lateral,less,lobe,lon,long-triangular,main,major,middle,midrib,minor,minutely,nflorescence,obconic,older,one,ovary,ovoid-reniform,pair,pale,papillo,papillose,persistently,pitted,planar,poricidal,portion,present,previously,pulled,raised,reflexe,rest,ruit,scar,short,single,siz,size,slender,soon,spaced,stigma,straight,style,tall,tan,tapering,time,tip,tube,ud,unevenly,varying,vein,widely,widest,ympodial,young	appressed,articulation,bract,branching,breeding,broad-based,cell,colour,form,fruit,growth,hair,heteromorphism,inflated,insertion,interjected,interpetalar,leaflet,length,margin,marking,mature,na,needle-like,odour,orientation,paired,pattern,placement,position,prickle,pseudostipule,rhizome,scale,shape,smell,spot,staman,stone,structure,symmetry,sympodial,system,texture,tissue,tuber,type,vegetative,xylopodia,zygomorphy
482	wfo-0001031695	success	185	176	119	66	57	0.643	0.5-1,0.5-2,1-2,1-3,1-9,1.5-8,10-35,2-3,2.5-5,20-30,3-17,3-19,3-7,30-40,4-10,4-5,4-6,5,5-20,5-7,6-10,6-20,?,abaxially,abruptly,acuminate,adaxially,aggregate,also,apex,apically,basal,base,branched,calyx,campanulate,cell,chartaceous,cm,color,connective,connivent,cordate,cylindrical,dark,deep,densely,diameter,dilated,directed,eglandular,ellipsoidal,entire,flattened,flower,fruit,glabrescent,glabrous,glandular-puberulent,green,greenish,hair,immature,lanceolate,laterally,lavender,leaf,leaving,lilac,lobe,lobed,long,lower,margin,mm,moderately,mottled,narrowly,oblique,oblong,occasionally,ovate,pedicel,pedicellar,peduncle,perfect,petiole,pilose,pilose-hirsute,pore,present,puberulent,puberulent-pubescent,pubescent,purple,purplish,rachi,radiu,remnant,ripe,shrub,simple,slight,slightly,sometimes,somewhat,sparsely,stigma,stone,stripe,style,subcoriaceous,swelling,tree,triangular,unbranched,unknown,x,yellow	1,1.5-2,1/2,1/3,10-,10-15,15-20,2-4,2-5,3-,3-10,4-foliat,6-8,7-,acute,apart,ape,apiculate,articulated,axe,beyond,blade,broadened,capitat,d,divided,eaf,eed,eglandular-pilose,exceeding,exserted,fleshy,glabrate,hard,lateral,lon,midrib,nflorescence,nther,obtuse,often,orolla,ovoid,pilo,pilose-hirsut,presen,rounded,ruit,shorter,sinus,small,spaced,stamen,tal,tem,thecae,time,tip,tomento,tube,unequal,unit,unlobed,vary,wide,ympodial	anther,arrangement,articulation,bract,branching,breeding,broad-based,capitate,colour,corolla,filament,form,growth,height,heteromorphism,inflorescence,insertion,interjected,interpetalar,leaflet,length,marking,mature,modification,na,needle-like,number,odour,orientation,ovary,paired,pattern,placement,plant,position,prickle,pseudostipule,rhizome,scale,seed,shape,size,smell,spot,staman,stem,surface,symmetry,system,texture,theca,tissue,trichome,tuber,type,vegetative,xylopodia
483	wfo-0001031698	success	58	80	34	24	46	0.586	2-2.5,2.5,2.5-3,4-4.5,bark,base,cm,decurrent,difoliate,dull,elliptic,flattened,fruiting,glabrous,green,incrassate,leaf,margin,minutely,mm,pale,paler,papillae,pedicel,pitted,reddish-brown,reniform,shrub,strongly,surface,unit,winged,x,yellowish	'',``,ape,branch,deflexed,dia,eaf,eed,fide,geminat,long,maguire,older,otherwise,persistin,repandly,rugose,stem,stout,tall,wing,woody,ympodial,young	1,anther,apex,branching,breeding,calyx,cell,colour,connective,corolla,diameter,filament,form,fruit,geminate,growth,hair,height,heteromorphism,length,marking,mature,modification,na,orientation,pattern,placement,plant,pore,prickle,pseudostipule,rhizome,seed,shape,size,spot,staman,stone,structure,symmetry,sympodial,system,texture,tuber,type,xylopodia
484	wfo-0001031707	success	178	95	49	129	46	0.275	.5,/4,2-6,4-5,anther,apex,apically,attenuate,axillary,base,basiscopically,berry,calyx,cell,climbing,cm,corolla,enlarged,filament,fleshy,fruiting,globose,green,greenish,leaf,leaflet,lobed,long,margin,mm,oblique,pedicel,petiole,pink,pinnate,pointed,poricidal,sagittate,simple,slightly,somewhat,tip,type,uniseriate,unit,vine,way,white,x	-3,0.5-1,1-1.2,1-1.3,1-1.5,1-3,1.2-1.8,1.2-2,1.5-1.7,1.5-2,1.5-6,1/3,16-20,2,2-10,2-3,2-4,24,3,4-6,5-10-celled,6-7,8-12,80-140,9-15,abaxially,absent,acuminate,acute,adaxially,almost,along,anthesi,apical,axil,basal,bearing,brown,c.,capitate,cateniform,clavat,conical,conspicuously,cucullate,dense,densely,diameter,distal,distinct,drying,eaf,edicel,eed,elliptic,endrophilum,epidermal,erect,exserted,flap-like,flat,flattened,flower,four-lobed,free,glabrous,high,horizonta,inflorescenc,lanceolate,lateral,less,like,lobe,lon,lower,minutely,narrower,narrowly,nflorescence,obovate,occasionally,open,ovary,pair,papillate,penden,per,petiolule,planar,plant,portion,primary,pubescent,quadrate,quite,raised,reddish,regular,rest,round,ruit,scar,scattered,smaller,smooth,spaced,sparsely,stigma,stout,strongly,style,surface,tem,terminal,ternate,thickening,time,trichome,tub,tube,ud,unifoliat,usually,vein,white-lenticellate,widely,woody,ympodial	appressed,articulation,bract,branching,breeding,colour,connective,form,fruit,growth,hair,heteromorphism,inflated,inflorescence,insertion,interjected,interpetalar,length,marking,mature,modification,na,odour,orientation,paired,pattern,placement,pore,position,prickle,pseudostipule,rhizome,scale,shape,spot,staman,stone,structure,symmetry,sympodial,system,texture,tissue,tuber,unifoliate,xylopodia
485	wfo-0001031723	success	228	125	80	148	45	0.351	-5,0.1-0.5,0.2-1,0.4-,1-2.5,1/3-1/2,2-7,2/3-3/4,4-6,anther,apex,articulated,base,berry,branching,calyx,chartaceous,cm,conical,connivent,cuneate,dark,drying,elongating,entire,equal,erect,evenly,filament,fruit,fruiting,green,hair,inflated,lateral,leaf,length,lobed,long,lower,margin,marking,mature,maturity,mauve,mm,moderately,multangulate,pale,pedicel,perpendicular,petiole,poricidal,prickle,primary,recurved,red,reflexed,rounded,secondary,sessile,shrub,simple,sometimes,spherical,stalked,stellate-pubescent,stem,straight,surface,tapering,terminal,tip,trichome,unarmed,unit,way,weakly,white,young	-1.5,-1/2,-15,-16,-2,-6,-6.5,-8,-merous,0,0.05-0.2,0.1-0.2,0.1-0.3,0.15,0.4,0.4-0.9,0.4-1,0.55-0.9,0.6-1,0.7-1,0.8-1.5,1-,1-2,1-3,1-5,1.2-2,1.5-,1.5-10,1.5-2.5,1/4-1/3,1/6-,10-30,15-45,2-,2-3.5,2-5.5,2.5-4.5,2.5-5,2/3,3-10,3-15,4-,4-10,4-11,4-20,4-5,5-40,5-9,8-20,abaxial,abaxially,acuminate,acut,acute,adaxial,alyx,ame,apar,apart,apically,apparently,ba,bark,blade,branched,brow,brown,c.,curved,deltate,densely,diameter,discolorous,dull,eaf,eed,elongated,eye,filiform,finely,flattened-reniform,flower,free,gently,glabrescent,glabrous,gland,gland-tipped,glandular,gray,herbaceous,infructescence,lobe,longer,midpoint,minute,naked,narrow-deltate,near,nflorescence,obtuse,older,one,open,orange,orange-brown,orolla,oung,ovate,pair,peduncle,per,perfec,pericarp,plurifoliat,porrect,portion,prickly,ray,ruit,scar,smooth,spaced,sparsely,spreading,stalk,stellate,strongly,style,subentire,tamen,terete,tertiary,time,tube,unarme,usually,variously,vary,vein,venation,visible,whitish,wide,woody,yellow,yellow-green,ympodial	appressed,articulation,bract,breeding,broad-based,cell,colour,corolla,form,growth,heteromorphism,inflorescence,insertion,interjected,interpetalar,leaflet,na,needle-like,odour,orientation,paired,pattern,perfect,placement,plurifoliate,position,pseudostipule,rhizome,scale,shape,smell,spot,staman,stone,structure,symmetry,sympodial,system,texture,tissue,tuber,type,vegetative,xylopodia,zygomorphy
486	wfo-0001031729	invalid_json_followup	161	148	83	78	65	0.516	-2,0.5-1,0.5-4,0.6-,1-1.5,1-2,1-2.5,1.0-1.3,1.5-2,2-2.5,2-3,2.5-5,3-4,5-6,5-7,abruptly,acuminate,anther,apex,apiculate-deltate,attenuate,base,branch,branched,calyx,cell,cm,conical,corolla,dark,darker,deltate,diameter,elliptic,elongate,filament,flattened,flower,fruit,fruiting,glabrous,globose,green,greenish,later,lobe,lobed,markedly,mm,mottling,nearly,obovate,occasionally,outline,ovary,ovate-reniform,pale,papillae,papillate,pedicel,peduncle,per,petiole,pink,pointed,purplish,quadrate,reddish,scattered,shrub,sinuate,smooth,somewhat,stem,stripe,surface,tan,testa,time,tube,white,x,young	-0.5,-45,..,0.5,1.5,10-20,11-30,12-13,2.5-,3-celled,3.5-4,4.1-16,5-,50,8-9,along,anthesi,apicula,beneath,branc,brittle,brow,c.,cucullate,curve,dry,drying,eaf,edicel,eed,erec,flattened-capitat,glandular,gradually,less,long,lower,membranous,middle,minute,minutely,narrowly,never,nflorescence,noddin,open,outer,pair,papillose,pericarp,planar,plurifoliat,point,primary,regularly,ruit,scar,short,single,single-stemmed,small,stigma,striate,thin,thing,tip,toward,triangular,trichome,tuft,ud,unit,usually,vein,wall,wand-like,widening,ympodial	'',0-0.5,1,5-20,[,``,appressed,arrangement,articulation,bract,branching,breeding,brown,bud,characteristic,colour,connective,curved,erect,form,glabrousnes,growth,hair,height,inflated,inflorescence,insertion,interjected,interpetalar,leaf,leaflet,length,margin,marking,mature,modification,na,nodding,number,odour,orientation,paired,pattern,placement,plant,plurifoliate,pore,position,prickle,pseudostipule,rhizome,scale,seed,shape,spot,symmetry,system,texture,tissue,tuber,type,value,xylopodia,{,}
487	wfo-0001031738	success	231	127	77	154	50	0.333	0.7-1,1.5-4,1/4-1/3,20-200,4,4-6,6-15,andromonoecious,anther,apart,apex,articulated,auriculate,base,berry,branched,calyx,cell,chartaceous,cm,connivent,cordate,curved,elongating,equal,erect,evenly,filament,flattened,frequently,fruit,fruiting,green,lateral,leaf,length,lobed,long,lower,margin,mature,maturity,mm,orange,pale,pedicel,petiole,poricidal,porrect,prickle,prickly,prominent,sessile,shrub,simple,small,sometimes,spaced,spherical,stellate,stem,straight,strongly,surface,tapering,terminal,tip,tree,trichome,truncate,unarmed,unit,weakly,white,yellow,yellow-orange,young	-15,-5,-6,-merous,.5,0,0-2,0-3,0.1-0.25,0.2-0.3,0.25-0.8,0.3-1,0.7-1.1,0.9-2.1,1-1.5,1-1.8,1-3,1-4,1.4-1.7,1.5-,1/,1/2-2/3,1/3,1/3-2/3,1/6-1/4,10-15,15-40,2-,2-4,2.3-3,3-4,3-6,3-7,3.5-3.8,3.5-4.5,4-10,4-5,4-8,5,5-8,7-12,7-12.5,8-10,8-18,abaxial,abaxially,acuminat,acute,adaxial,adaxially,almost,always,alyx,apar,apically,apparently,bark,blade,dark,deltate,densely,diameter,discolorous,distal,distance,drying,dull,eaf,eed,extending,flattened-reniform,flower,free,glabrescent,glabrous,gray,held,hermaphrodite,heterostylous,infructescence,inside,lobe,lobing,long-styled,longer,lowermost,midpoint,midvein,multangulate,narrow-deltate,nflorescence,oblong,obovate,often,older,one,open,orange-brown,orolla,oung,outline,ovate,pair,peduncle,per,pericarp,pit,plant,plurifoliat,poorly,portion,prickl,primary,pubescent,raised,ray,reflexed,resin,rounded,ruit,scar,secondary,short-styled,shorter,side,smooth,sparsely,spreading,stalk,stalked,staminat,stellate-pubescent,sticky,stout,style,tamen,terete,tertiary,time,tube,upper,usually,variously,vary,vein,venation,visible,way,white-brow,wide,woody,yellow-green,yellowish,ympodial	appressed,articulation,bract,branching,breeding,broad-based,colour,connective,corolla,form,growth,hair,heteromorphism,inflated,inflorescence,insertion,interjected,interpetalar,leaflet,marking,modification,na,needle-like,odour,orientation,paired,pattern,placement,plurifoliate,pore,position,pseudostipule,rhizome,scale,shape,smell,spot,staman,stone,structure,symmetry,sympodial,system,texture,tissue,tuber,type,vegetative,xylopodia,zygomorphy
488	wfo-0001031752	invalid_json_followup	172	195	129	43	66	0.75	-10,-100,-44,-47,-6,-pubescent,0.5-1,1,1-2,1-3,1-4,1.5-10.5,1.5-3,1.5-3.5,15-25,15-40,2-2.5,2-3,2-5,20-35,3-4,3-7,3.5-15,3.5-5,5-8,abaxially,acuminate,acute,adaxially,apart,apex,apiculate,basal,base,calyx,chartaceous,ciliate,cm,connective,connivent,cuneate,cylindrical,darker,deltate,densely,diameter,directed,distally,ellipsoidal,elliptic,entire,equal,exceeding,flattened,fleshy,flower,fruit,fusiform,glabrate,glabrescent,glabrous,gland,glandular-puberulent,green,immature,lanceolate,leaving,less,light,linear,lobe,long,lower,margin,mm,moderately,narrowly,near,nearly,oblong,obtuse,often,older,ovate,ovoid,pedicel,pedicellar,peduncle,perfect,petiole,pink,pore,present,puberulent,pubescent,purplish,rachi,radiu,remnant,ripe,rounded,rugose,shrub,simple,slightly,small,sparsely,stalked,stellate,stigma,stripe,style,subcordate,subcoriaceous,swelling,thecae,tip,tomentose,tree,triangular,truncate,tube,unbranched,unit,white,wide,x,yellow,young	-3,0.5-1.5,1-,1-1.5,1.5-2,1.5-2.5,3-11.5,3-4-foliat,5-23,5-6,8-15,9-16,aggregate,ape,articulated,axe,beyond,blade,cell,ciliat,eaf,eed,exserted,glandular-puberulen,lon,membranaceous,nflorescence,nther,olde,orolla,presen,purpl,ruit,spaced,stamen,stone,tal,tem,time,truncat,ud,vary,ympodial	'',3-4-foliate,[,``,abaxial,adaxial,anther,articulation,bract,branching,breeding,broad-based,bud,characteristic,colour,corolla,filament,form,fruiting,growth,hair,height,inflorescence,insertion,interjected,interpetalar,leaf,leaflet,length,marking,modification,na,needle-like,number,odour,orientation,ovary,paired,pattern,plant,position,prickle,purple,scale,seed,shape,size,smell,spacing,spot,stem,structure,surface,symmetry,sympodial,system,texture,theca,tissue,trichome,type,value,vegetative,zygomorphy,{,}
489	wfo-0001031756	success	186	117	65	121	52	0.349	.5,/2,0.5-1,3-15,3-7,accrescent,anther,apart,apex,apparently,articulated,base,berry,branched,calyx,chartaceous,cm,color,connivent,cordate,densely,enclosing,entire,equal,evenly,filament,fruit,fruiting,fully,green,inflated,known,leaf,lobed,long,lower,margin,mature,mauve,mm,pale,pedicel,perpendicular,petiole,poricidal,prickle,shoot,short,shrub,simple,spaced,spherical,stellate,stellate-pubescent,stem,surface,tapering,terminal,tip,trichome,truncate,unit,way,white,young	-1,-5,.1,.8,0,0-2,0-5,0.02-0.2,0.1,0.15-0.25,0.2,0.4-1.6,0.5-1.3,0.6-1.2,0.6-1.6,0.7-1.7,0.8-1,00,1-1.8,1-2,1-3,1-4,1.5-2,1.5-3.5,1.8-2.5,1/2,1/3,10,2-6,3-5,4-5,4.5,5-merous,6-9,7-10,9-14,abaxially,acut,alyx,apar,apically,bark,blade,broad-deltate,concolorous,conical,curved,deltate,diameter,drying,eaf,eed,elongating,erect,eye,finely,flattened-reniform,flower,free,glabrescent,glabrou,glabrous,gray,herbaceous,infructescence,invested,lobe,longer,midpoint,moderately,naked,nflorescence,older,one,open,orange-brown,orolla,oung,ovate,pair,peduncle,pendulous,per,perfec,pericarp,pitted,plurifoliat,porrect,portion,prickl,prickly,primary,ray,red-brown,rounded,ruit,scandent,scar,sessile,shorter,slender,small,smooth,sparsely,spreading,stalk,stalked,straight,style,tamen,terete,time,tube,unarmed,variously,vary,vein,visible,wide,yellow-green,ympodial	appressed,articulation,bract,branching,breeding,broad-based,cell,colour,connective,corolla,form,growth,hair,heteromorphism,inflorescence,insertion,interjected,interpetalar,leaflet,length,marking,modification,na,needle-like,odour,orientation,paired,pattern,perfect,placement,plurifoliate,pore,position,pseudostipule,rhizome,scale,shape,smell,spot,staman,stone,structure,symmetry,sympodial,system,texture,tissue,tuber,type,vegetative,xylopodia,zygomorphy
490	wfo-0001031786	success	209	105	64	145	41	0.306	/3,0-3,0.2-2.5,0.7-1,2-7,6-8,almost,anther,apex,apparently,articulated,base,berry,branched,calyx,cell,chartaceous,cm,connivent,cuneate,curved,deep,elongating,erect,filament,fruit,fruiting,glabrous,herb,lateral,leaf,length,lobed,long,margin,maturity,mauve,membranous,minute,mm,orange,pedicel,petiole,poricidal,prickle,red,reflexed,shrub,simple,sometimes,sparsely,spherical,spreading,stellate,stellate-pubescent,straight,surface,tapering,tip,trichome,truncate,unit,way,white	-5,.4,.5,/2,0,0-2,0-20,0-5,0.1,0.1-0.4,0.2-0.3,0.25-0.5,0.5-1.5,0.7-1.6,0.7-4,0.8,0.8-1.2,1,1-2,1-3,1-4,1-6,1.2-1.6,1.5-1.9,1.5-2.5,1/3-1/2,2-13,2-3,2-8,2.5-3.5,3-4,3-5.5,4-5,5-7,5-merous,8-12,abaxially,acut,acute,alyx,ame,apar,apart,apically,bark,becoming,blade,c.,clavat,concolorous,dark,deltate,densely,diameter,distance,drying,eaf,eed,elliptic,equal,evenly,extending,eye,filiform,flattened,flattened-reniform,flower,free,glabrescent,gray,gray-brow,green,herbaceous,inconspicuous,infructescence,lobe,lon,longer,lower,mature,midpoint,midvein,naked,nflorescence,obtuse,older,one,open,orange-brown,orolla,oung,outline,ovate,pair,pale,peduncle,pendulous,per,perfec,pericarp,pit,plurifoliat,porrect,portion,prickl,prickly,primary,raised,ray,red-brown,rounded,ruit,scandent,scar,sessile,shiny,shorter,side,slightly,small,smooth,spaced,stalk,stalked,stem,stigma,style,tamen,terete,tertiary,thick,time,tube,unarmed,variously,vary,vein,venation,visible,weakly,wide,woody,yellow-orange,ympodial,young	articulation,bract,branching,breeding,colour,connective,corolla,form,growth,hair,heteromorphism,inflorescence,insertion,interjected,interpetalar,leaflet,marking,na,odour,orientation,paired,perfect,placement,plurifoliate,position,pseudostipule,rhizome,scale,shape,spot,staman,stone,structure,symmetry,sympodial,system,texture,tissue,tuber,type,xylopodia
491	wfo-0001031793	invalid_json_followup	188	147	101	87	46	0.537	-4,.5,0,1-1.5,1-2,1-8,1.5-4,10-15,13-20,15-20,2-3,2-5,26,3-8,40,8-11,abundant,accrescent,acuminate,aging,almost,anther,apex,armed,articulated,base,berry,black,branched,broadly,brown,brownish,calyx,capitate,chartaceous,cm,cuneate,densely,diameter,elliptic,evident,extra-axillary,filament,flattened,flower,forked,fruit,fruiting,globose,hair,inflorescence,interpetalar,leaf,lobe,long,many,margin,minutely,mm,mucilaginous,oblique,oblong-lanceolate,orange-yellow,orbicular-ovate,ovate,pedicel,peduncle,per,perfect,petiole,pore,porocidal,prickle,pubescent,rachi,reddish,reticulation,rounded,scarcely,scattered,shallow,shrub,simple,size,small,sparsely,stellate,stellate-pubescent,stem,stigma,style,tip,tissue,tree,trichome,unbranched,well-developed,white,x,yellow,yellow-brown	1,1-3,1.5-2,1/3,1/4,1/5,20,3-4,3/4,4,5-merous,7,absent,acumen,acute,adult,alyx,apparently,aspect,axe,ba,bilobe,blade,branche,broad,central,cut,difoliate,distal,eaf,eed,elongatin,erec,erect,extreme,ferrugineous,geminat,general,glandular,homostylou,larger,linear,lobing,lon,lower,main,maturing,midpoint,midrib,mostly,nflorescence,obtuse,often,older,orolla,porrect,principal,reduced,ruit,rusty,sessile,side,similar,single,sinus,smaller,stellate-pubescen,stipitate,stout,surface,tall,tamen,tem,testa,thickened,triangular,triangular-acuminat,tube,unarmed,unit,upward,usually,uvenile,vary,way,woody,ympodial	'',[,``,appressed,articulation,bilobed,bract,branching,breeding,characteristic,colour,connective,corolla,form,growth,height,inflated,insertion,interjected,juvenile,leaflet,length,marking,mature,modification,na,odour,ovary,paired,pattern,plant,position,scale,seed,shape,smell,spot,symmetry,system,texture,type,value,vegetative,zygomorphy,{,}
492	wfo-0001031829	success	138	127	74	64	53	0.536	.25,.5,0.7-1,1,1-2,1.3-1.5,1.5-2.5,2-4,3-5-flowered,3/4,4-4.5,absent,acute,adaxial,anther,anthesi,apex,base,berry,broadly,calyx,capitate,cm,conical,corolla,crystalline,densely,denser,difoliate,elliptic,epidermi,erect,filament,fruiting,glabrous,globose,green,growth,inflorescence,large-celled,leaf,leathery,lobed,long,margin,minutely,mm,often,opposite,ovary,papillose,pedicel,petiole,pore,poricidal,pubescent,revolute,shaped,shrub,simple,somewhat,sparsely,stigma,style,surface,tear-drop,thick,tip,trichome,tube,uniseriate,unit,way,white	0.5-2.1,1.5-2,1.5-3.5,1.5-4.5,4-8.5,7-10,abaxially,adaxially,along,ape,apiculae,bae,bark,branched,deflexed,dia,differing,drying,eaf,edicel,eed,exserted,free,geminat,glabrat,greenish-brown,immature,known,lateral,like,lobe,lon,lower,main,major,minor,minute,nflorescence,occasionally,older,overlappin,packed,pair,papillo,planar,portion,quadrate,ruit,scar,size,soft,stem,tall,tapering,tub,tuft,ud,vein,waxy,woody,x,yellowish,ympodial,young	0.5,abaxial,appressed,articulation,bract,branching,breeding,cell,colour,connective,diameter,flower,form,fruit,geminate,hair,height,heteromorphism,inflated,insertion,interjected,interpetalar,leaflet,length,marking,mature,modification,na,odour,orientation,paired,pattern,placement,plant,position,presence,prickle,pseudostipule,rhizome,scale,shape,spot,staman,stone,structure,symmetry,sympodial,system,texture,tissue,tuber,type,xylopodia
493	wfo-0001031832	success	232	117	66	166	51	0.284	0.2-1.5,0.7-1.5,0.7-2,2-3.6,3-7,accrescent,anther,apex,apical-lateral,articulated,attenuate,base,becoming,berry,blunt-tipped,branched,bullate,calyx,cm,continued,corolla,due,entire,extend,filament,fruit,fruiting,globose,greenish,growth,hair,introrse,large,lateral,leaf,length,longitudinal,lower,margin,mm,oblong,pale,pedicel,perfect,petiole,plurifoliate,pore,probably,ripe,rotate-stellate,scabrous,shrub,simple,slit,somewhat,stellate-pubescent,stem,surface,terminal,time,tree,unit,violet,white,x,yellow	-8,.5-1,/50-1/10,0-150,0.1-0.3,0.2-0.6,0.3-0.8,0.3-3,0.7-1.6,0.8-1.2,1-12,1.1-2.4,1.2-1.6,1.2-2,1.2-2.5,1.3-4.2,1.5-4,1.7-4,1.8-4,1/2-3/4,14,2-4,2-6,2.5-6.5,2.8-4.8,3-6.5,3.5-7,4-20,4-7,5-21,5.5-10,7-10,8-25,9,abaxially,acuminate,acute,adaxially,ag,anthesi,apart,apice,apparently,axe,axillary,ba,bark,basal,blade,blister,branch,brown,brownish,bud,capitat,chartaceous,closely,conical,connate,dark,decurrent,dehiscing,deltoid,diameter,directed,eaf,eed,evident,exserted,ferrugineous,few-rayed,fleshy,flower,forming,free,glabrescen,glabrescent,glabrous,granular-tomentose,green,half,high,honeycombed,indument,inserted,lackin,lanceolate,line,lobe,lobed,long,long-,longer,m.,main,midvein,minute,mixed,mostly,multangulate,nearly,nflorescence,oblanceolate,obovoid,obtuse,occasionally,older,orbicular,orolla,ovate,partly,peduncle,persistent,pitted,porrect-stellat,porrect-stellate,pubescence,pubescent,rachi,rather,ray,relatively,reniform,reticulate-punctate,rough,ruit,runk,sessile,short-,short-stalked,side,smooth,sometimes,soon,spaced,sparingly,sparse,splitting,stamen,stigma,stipitate-glandular,style,subcampanulate,suborbicular,suture,swelling,tamen,terete,testa,thick,thick-stalked,toward,translucent,tube,unarme,unarmed,usually,vary,vein,way,weakly,whitish,wide,yellowish,ympodial,young	age,appressed,articulation,bract,branching,breeding,broad-based,cell,colour,connective,form,heteromorphism,inflated,inflorescence,insertion,interjected,interpetalar,leaflet,marking,mature,modification,na,needle-like,odour,orientation,paired,pattern,placement,position,prickle,pseudostipule,rhizome,scale,shape,smell,spot,staman,stellate,stone,structure,symmetry,sympodial,system,texture,tissue,trichome,tuber,type,vegetative,xylopodia,zygomorphy
494	wfo-0001031834	invalid_json_followup	150	140	88	62	52	0.587	0.5,0.5-1,0.5-3,0.5-3.5,0.6-1.4,0.8-1,0.8-1.3,0.9-1.4,1,1.5,1.5-4,1.9-6.5,2.9-7,2/3,6-7,6.5-14,accrescent,acuminate,acute,anther,anthesi,apex,apically,attenuate,base,berry,calyx,cm,corolla,deflexed,dia,difoliate,expanded,filament,flattened-reniform,fruit,fruiting,glabrous,globose,green,greenish-yellow,hooked,incrassate,leaf,less,lobe,lobed,long,margin,minor,minute,minutely,mm,opposite,ovary,ovate,pale,papillose,pedicel,petiole,pitted,pore,scabrous,scar,shaped,shrub,simple,slender,slightly,stem,stigma,straight,style,surface,tan,tapering,tear-drop,tip,trichome,tube,uniseriate,unit,way,white,woody,x,yellow,young	.5,1.6-2,across,apar,apiculate,appear,bi-cellular,borne,campanulate,covered,deciduou,deciduous,decurrent,deltoid,depression,eaf,edicel,eed,eye,few-flowered,free,geminat,glabrou,hook,lamina,larger,leaving,like,lon,lower,major,markedly,middle,mound-like,multicellular,naked,nflorescence,often,papillo,persistent,planar,poricidal,portion,proximal,pubescent,ruit,short,small,soon,spaced,sparsely,speck,tall,tufted,ud,unevenly,uni-,upper,usually,vein,widest,ympodial	'',[,``,apart,appressed,articulation,attachment,bract,branching,breeding,bud,characteristic,colour,connective,decurrenct,form,growth,hair,height,inflated,inflorescence,interjected,interpetalar,leaflet,length,marking,mature,modification,na,odour,paired,pattern,plant,position,scale,seed,shape,size,spacing,spot,structure,symmetry,sympodial,system,texture,tissue,type,value,width,zygomorphy,{,}
495	wfo-0001031842	success	161	92	45	116	47	0.28	0.1-0.5,1,1-1.8,2.5-3,acute,anther,apex,attenuate,base,berry,calyx,cm,corolla,cup-shaped,decurrent,deflexed,difoliate,elliptic,filament,fruiting,glabrous,globose,green,leaf,long,margin,mm,onto,opposite,pedicel,petiole,pore,shaped,shiny,shrub,somewhat,tear-drop,terminal,tree,trichome,uniseriate,unit,white,woody,x	.1,.4,.5,.75,0.5-1,0.5-2,0.6-1,0.7-1,1-1.5,1-3.5,1.5-2,10-12,10-20,10-30-flowered,2-10,2-3,2.5-6,3-8,3/4,4.5-6,7-9,9-15,anthesi,apart,axil,ba,bark,bearing,beginning,beneath,bi-lobed,brown,capitate,cusp,dark,deeply,densely,dia,differing,dry,eaf,edicel,eed,ellipsoid,exserte,exsertion,flattened-reniform,free,geminat,incrassate,inflorescenc,irregularly,later,lateral,leaf-opposed,lobe,lobed,lon,lower,main,major,middle,minor,minutely,near,new,nflorescence,often,older,one,ovary,overtopping,pair,pale,paler,papillo,papillose,pitted,poricidal,portion,prominent,pubescent,quadrate,reddish,reddish-resinous,reflexed,ruit,scar,shoot,simple,size,slender,soon,spaced,sparsely,specimen,stem,stigma,straight,strongly,style,surface,tall,tapering,time,tip,tube,tuft,ud,vein,way,widest,yellowish,yellowish-whit,ympodial,young	appressed,articulation,bract,branching,breeding,cell,colour,connective,form,fruit,geminate,growth,hair,heteromorphism,inflated,inflorescence,insertion,interjected,interpetalar,leaflet,length,marking,mature,na,odour,orientation,paired,pattern,placement,position,prickle,pseudostipule,rhizome,scale,shape,spot,staman,stone,structure,symmetry,sympodial,system,texture,tissue,tuber,type,xylopodia
496	wfo-0001031843	invalid_json_followup	245	193	141	104	52	0.576	.5,0-4,0.5-1,0.5-1.5,0.6-1.2,0.7-2,0.8-2,1-7,1.2-2,1.5,1.5-2,1/6-1/4,2-3,2.5,3-4,4-12,6-9,abaxially,accrescent,adaxially,almost,along,anther,anthesi,apically,apparently,appressed,attenuate,bark,basal,base,becoming,berry,black,branch,branched,branching,brown,calyx,canaliculate,capitate,cm,completely,conical,corolla,cupular,curved,dark,deeply,diameter,dilated,discoid,distributed,drying,dull,equal,erect,evenly,filament,fine,finely,flat,fruiting,glabrous,green,honeycomb,leaf,length,liana,lobed,long,longitudinally,main,margin,midvein,mm,multiseriate,network,oblique,oblong,obovate,opening,orange,orange-brown,orange-yellow,pair,part,partly,pattern,pedicel,peduncle,pericarp,petiole,pitted,pore,poricidal,primary,prominent,pubescent,raised,rarely,red,reddish,ridged,scar,seed,shallowly,shiny,shortly,shrub,side,simple,slender,slightly,sometimes,sparsely,spheroidal,stem,stigma,straight,stump,style,surface,terminal,tertiary,thick-chartaceous,thin,tip,trichome,tube,twice,unarmed,unit,vein,venation,violet,visible,white,wider,x,young	.2,.3,.6,0.2-2,0.4-0.5,0.7-1.2,1-2,1.2-2.2,1.8-2.5,1mm,2-4,3-7,45-60Â°,5-10,5-12,acuminate,age,always,alyx,apar,apex,apice,around,articulated,broadly,caudate,clearly,collapsing,cuspidate,delineated,deltoid,dendritic,density,detaching,discolorous,domatia,eaf,eed,ellipsoi,entire,even,eye,fertilisation,flexuous,flower,forming,free,hand,inner,largely,leave,len,lengthening,lignified,like,lobe,loop,looping,lower,m.,much,naked,never,nflorescence,nther,obscure,older,orolla,outline,ovate,papillo,pendulous,perfec,pit,plurifoliat,portion,present,pronounced,protruding,rachi,recurve,reveal,ribbed,rounded,ruit,see,sinus,small,smaller,smooth,soon,spreading,strongly,surfac,tearing,thickened,tuft,ud,variable,vary,weakly,wide,without,ympodial	'',[,``,apart,armament,arrangement,articulation,bract,breeding,characteristic,colour,connective,form,fruit,growth,hair,inflated,inflorescence,interjected,interpetalar,leaflet,lobing,marking,mature,modification,na,number,ovary,papillose,perfect,plurifoliate,position,prominence,recurved,scale,shape,size,spacing,spot,structure,symmetry,sympodial,system,texture,thicknes,tissue,type,value,visibility,zygomorphy,{,}
497	wfo-0001031852	success	155	104	44	111	60	0.284	1-4,4-6,apex,articulate,base,branched,calyx,cell,conical,connate,corolla,dehiscent,dichasially,distal,ebracteate,filament,green,hair-like,half,herbaceous,interjected,leaf,leaflet,light,lower,mm,oblique,odd-pinnate,ovoid,pattern,pedicel,perennial,perfect,petiole,plant,poricidally,proximal,pubescent,seed,stellate,tuber-bearing,unit,white,Â¼	-8,0.1-1,0.5-1.3,0.5-3,1-,1-4.2,1-9,1.3-2.5,1.4-3,1.5-3,12-35,2-3,2-5.5,2.6-9.5,3-4,3-6-foliat,3-9,3.5-10,4-,4-10,4-5,5-15,7-,9-11,abaxially,abruptly,absen,acumen,acuminate,acute,adaxially,apical,apically,apiculate,attenuate,cm,covering,cyme,decurrent,diameter,dichasial,digestion,diminishing,dorsally,eaf,edge,eed,elliptic,elliptic-lanceolate,emoval,enzyme,exceeding,flat,flower,folded,forked,generally,globo,green-white,honeycomb,introrse,lanceolate,lateral,living,lobe,lon,long,lunat,make,maturing,monochasial,mucilaginous,nflorescence,nther,oblong,often,orolla,ovate-elliptic,pair,peduncle,plan,rachi,reveal,ruit,sessile,seudostipule,short,shortly,size,slit,specimen,stamen,stigma,straight,style,tal,tem,terminal,testal,thick,throughou,throughout,toward,typically,vary,wall,white-crea,wide,without,yellow,ympodial	3-6-foliate,absent,anther,apicidally,appressed,articulation,bract,branching,breeding,broad-based,colour,connective,form,fruit,fruiting,growth,hair,heteromorphism,inflated,inflorescence,insertion,interpetalar,length,margin,marking,mature,modification,na,needle-like,odour,orientation,paired,placement,pore,position,present,prickle,pseudostipule,rhizome,scale,shape,smell,spot,staman,stem,stone,structure,surface,symmetry,sympodial,system,texture,tissue,trichome,tuber,type,vegetative,white-cream,xylopodia,zygomorphy
498	wfo-0001031864	success	140	123	97	43	26	0.693	.2,.25,.5,0.2-0.5,0.5-13.5,0.5-4,0.7-0.8,0.8-1,1-1.2,1-1.8,1-2,1-5,1-6.5,1.2-1.5,1.5-10,1.5-2.5,15-60,2-3,2.5-6,3-3.5,3-pinnate,5-9,7.5-8,abaxially,accrescent,acuminate,acute,adaxially,anther,apex,apiculate,base,blade,calyx,chartaceous,ciliate,clavate,cm,cuneate,deltoid,dense,densely,diameter,entire,extra-axillary,filament,fine,flattened,fleshy,flower,fruit,fruiting,glabrous,hair,leaflet,lenticular,like,lobe,long,margin,middle,minutely,mm,near,oblique,ovoid-deltoid,papillose,pedicel,peduncle,petiole,petiolule,pointed,pubescence,pubescent,rachi,rotate,rounded,scattered,short,slender,slightly,sparsely,stem,stigma,style,surface,tip,trichome,truncate,tube,unbranched,unknown,vine,violet,wide-diameter,widely,x	0.4-3,0.6-3.5,0.6-4,1-3,1.5,2,5-15,5-merous,alyx,apar,apical,axe,berry,c.,capitat,color,eaf,eed,emarginate,glabrou,herbaceous,lateral,lon,lower,m.,moderately,nflorescence,nternode,orolla,perfec,plurifoliat,pubescenc,ruit,sand-punctate,spaced,tamen,tem,terrestria,typical,unit,vary,vein,ympodial	abaxial,adaxial,bract,branching,capitate,colour,corolla,form,growth,habit,inflorescence,internode,leaf,length,na,number,ovary,plant,position,seed,shape,size,staman,terrestrial,texture,type
499	wfo-0001031864	success	148	160	116	32	44	0.784	.2,.25,.5,0.4-3,0.5-13.5,0.5-4,0.6-3.5,0.6-4,1-1.2,1-1.8,1-2,1-3,1-5,1-6.5,1.2-1.5,1.5-2.5,15-60,2-3,2.5-6,3-3.5,3-5-celled,3-pinnate,5-15,5-9,7.5-8,abaxially,absent,accrescent,acuminate,acute,adaxially,anther,apart,apex,apical,apiculate,articulated,basally,base,blade,blue-purple,calyx,center,ciliate,clavate,cm,cordate,cuneate,deltoid,dense,densely,diameter,directed,distally,emarginate,entire,extra-axillary,fine,fleshy,flower,fruiting,glabrous,hair,herb,interjected,large,lateral,leaflet,lenticular,lobe,long,longitudinal,margin,minutely,mm,near,node,oblique,oblong,opening,papillose,pedicel,peduncle,perfect,petiolule,plurifoliate,pore,pubescence,pubescent,rachi,rooting,rotate,rounded,scattered,short,simple,slender,slightly,slit,somewhat,sparsely,stigma,style,surface,thick,tip,trailing,truncate,tube,unbranched,uniseriate,unit,unknown,widely,woody,x	1.5,2,5-merou,ag,alyx,apparently,axe,ba,capitat,color,connivent,eaf,eed,equal,etiole,filament,fruit,geminat,lower,m.,nflorescence,orolla,pubescenc,spaced,tamen,tem,terrestrial,vary,weakly,wiry,yellow,ympodial	5-merous,abaxial,adaxial,age,articulation,breeding,capitate,cell,colour,connective,corolla,form,glabrousnes,growth,habit,heteromorphism,inflorescence,leaf,length,marking,modification,na,number,ovary,petiole,plant,position,rhizome,seed,shape,size,spacing,spot,staman,stem,stone,structure,symmetry,sympodial,system,texture,tuber,type,xylopodia
500	wfo-0001031871	invalid_json_followup	185	171	115	70	56	0.622	0.4-2,0.6-1.2,1-2,1.5-11,1.5-2,1.5-2.1,1.6-2.7,2-4,3-10,3.5-4,33-40,36-44,4-6,4-7,5.4-12.3,6-12,6-7,6.5-20.5,7-9,7.5-23,abaxially,adaxially,anther,apex,axillary,base,berry,blade,brownish,bud,cell,chartaceous,clavate,cm,condition,connivent,corolla,covering,dark,deep,diameter,distal,dot,drying,end,filament,flower,forked,fresh,fruit,generally,glabrous,globose,green,green-white,greenish,hair,half,herb,high,homostylous,interjected,lanceolate,lateral,leaflet,lengthening,lobe,long,make,medium,mm,mottled,mucilaginous,narrowly,odd-pinnate,one,ovoid,pair,pedicel,peduncle,petiole,placed,plant,pore,poricidal,purple,ripe,rotate,seed,short,size,slit,stigma,straight,style,subglabrous,subtending,terminal,testal,thick,throughout,tiny,tip,tissue,tube,tuber,typically,usually,wall,wet,white,whitish,wide,winged,x	1.4-2.1,14-22,2-3,2.9-6,3-4,3-5,5-merou,acumen,acute,adaxiall,ag,alyx,apart,apparently,articulated,asymmetric,attenuate,axe,basiscopic,capitat,digestion,dorsally,eaf,edge,eed,elliptic,enzyme,erec,exceeding,flat,folded,geminat,glabrou,hair-like,hal,honeycomb-shaped,linear,living,lower,nflorescence,orbicular,orolla,ovate,perfect,petiolulate,plurifoliate,pubescent,removed,round,rounded,ruit,sessile,seudostipule,side,sometimes,spaced,specimen,stamen,stolo,subequal,subglabrou,symmetric,tall,tamen,tem,tri-,unit,vary,yellow,ympodial	'',[,\u201chair-like\u201d,``,age,appressed,arrangement,articulation,bract,branching,breeding,broad-based,calyx,capitate,characteristic,colour,connective,form,fruiting,growth,height,inflated,inflorescence,insertion,interpetalar,leaf,length,margin,marking,mature,modification,na,odour,ovary,paired,pattern,placement,position,prickle,pseudostipule,scale,shape,smell,spot,staman,stem,stolon,symmetry,system,texture,trichome,type,value,vegetative,{,}
501	wfo-0001031876	success	140	97	49	91	48	0.35	.1,0.5,1-1.5,1-1.6,1.5-2.2,27-35,9-15,acute,anther,apex,base,berry,calyx,cm,corolla,decurrent,elliptic,filament,flower,fruiting,glabrous,globose,granular,green,leaf,less,lightly,lobed,lower,minutely,mm,nearly,oblanceolate,oblique,opposite,pedicel,petiole,pore,shaped,shrub,simple,slightly,stem,tapering,tear-drop,tube,unit,white,winged	.5,0-flowered,0.8-1,1,1-4,3,5,?,across,anthesi,apiculate,arc,arising,ba,bark,bearing,beneath,bright,closely,convergence,corky,cup-like,dia,differing,eaf,edicel,eed,erect,family,free,glabrou,greenish-yellow,immature,irregularity,known,lateral,lenticellat,lobe,long,long-acuminate,main,major,margin,melastomataceae,member,middle,minute,nflorescence,often,otherwise,ovary,overlappin,pair,papillose,parallel,perpendicular,persistent,point,poricidal,portion,present,primary,prominent,raised,recurved,reflexed,resemble,ruit,running,scar,secondary,slender,spaced,stigma,straight,styl,style,tall,time,tip,ud,unifoliat,vein,venation,wide,widest,woody,x,yellow,ympodial,young	0,appressed,bract,branching,broad-based,cell,colour,form,fruit,growth,hair,height,heteromorphism,inflated,inflorescence,interjected,interpetalar,leaflet,length,marking,modification,na,needle-like,number,orientation,placement,plant,position,prickle,pseudostipule,rhizome,scale,shape,spot,staman,stone,structure,surface,symmetry,sympodial,texture,tissue,trichome,tuber,type,unifoliate,width,xylopodia
502	wfo-0001031877	invalid_json	216	155	124	92	31	0.574	+,.5,0.3-,0.3-1,0.3-1.2,0.5,0.6-1.2,1-1.5,1-3,1-3.5,1-4,1.1-,1.5,1.5-1.9,1.8-5,2,2-,2.5,3-6,3.5-4,6-10,6-8,abruptly,acuminate,acute,adaxially,angled,anther,apex,articulated,basal,basally,base,berry,bright,brown,capitate,cell,clavate,cm,connivent,corolla,deltate,diameter,ellipsoid,ellipsoidal,entire,exposed,filament,flattened,flower,fruit,fruiting,furcate,glabrous,globose,greenish,growth,hastate,later,lateral,lengthening,line,lobe,lobed,loosely,margin,mature,minute,minutely,mm,nearly,new,occasionally,outline,pale,pedicel,peduncle,per,perfect,petiole,pitted,plant,plump,pore,poricidal,prominently,purple,red,reddish,reniform,ripe,rounded,scar,scrambler,seed,short,silky,simple,sleeve,slightly,slit,sometimes,somewhat,stellate,stem,stigma,style,surface,terminal,testal,tinged,tip,triangular,trichome,truncate,tube,uniseriate,usually,vine,wall,weak,white,x	.3,0.2,0.5-1,0.8-0.9,1,1.5-2,3-5,5-merou,abaxially,adaxiall,ag,along,alyx,anthesi,apar,apparently,ark,ascending,calyx,conical,deep,deflexed,densely,distal,dried,eaf,eed,enlarged,erect,especially,exserted,eye,fleshy,free,green,ilament,impressed,internal,irregularly,lamina,like,linear,long,long-acuminate,lower,material,midvein,nflorescence,often,older,orolla,pair,papillate,papillo,parallel,part,pericarp,plurifoliat,pointing,portion,primary,pubescence,pubescent,purplish,rectangular,reflexed,rest,ruit,semi-woody,shiny,shorte,sinuate,slender,spaced,sparsely,spreadin,strongly,subshru,tem,thin,twinin,ud,uniformly,unit,upper,vary,vein,visible,woody,yello,ympodial,young	'',5-merous,[,``,age,angle,apart,articulation,bark,branching,bud,characteristic,colour,form,hair,height,inflorescence,leaf,length,number,ovary,papillose,position,shape,size,spacing,type,value,yellow,{,}
503	wfo-0001031880	invalid_json_followup	180	151	109	71	42	0.606	.5,0.5-1,0.7-0.8,1,1-1.3,1-1.5,1-2,2-3,2.5-8,3-3.5,3-4-pluri-foliate,3-foliate,3-lobed,4,5-6,7-9,age,anther,anthesi,apart,base,berry,broadly,brown,calyx,capitate,cell,cm,conical,cordate,corolla,crenate,cup-shaped,curved,dark,densely,diameter,elliptic,enlarged,entire,filament,flattened,fleshy,fruit,fruiting,glabrous,gland,glandular,globose,green,herb,heteromorphic,hollow,inflorescence,internodal,irregularly,leaf,lengthening,lobe,margin,markedly,mature,minutely,mm,narrowly,nodding,orange,ovary,ovate,ovoid,pale,papillose,pedicel,petiole,pitted,pore,poricidal,pubescent,purple,red,reddish,reflexed,scar,shallowly,simple,slightly,slit,spreading,stem,stigma,straight,strongly,style,subshrub,surface,testal,tip,toothed,triangular,trichome,truncate,tube,uniseriate,unit,upward,wall,woody,x,yellow	0.5-2,1.5,2,2-4,2-9,4-8,5,6-9,abaxially,acuminate,acute,adaxially,apex,basal,bearing,becoming,c.,ciliate,color,crowded,eaf,edicel,eed,ellipsoid,erect,exerted,flower,flush,free,gland-tipped,growing,horn,lamina,less,lon,long,longest,lower,maturit,mid-length,middle,near,nflorescence,pair,papillo,peduncle,pericarp,plan,portion,primary,pubescen,rachi,ruit,shortest,single,slender,sometimes,spaced,sparse,sparsely,terminal,thin,ud,unicellula,unlobed,upper,vein,widely,widest,ympodial,â5	'',1.5-5,[,``,appressed,arrangement,bract,branching,breeding,characteristic,colour,connective,form,growth,hair,height,inflated,length,marking,maturity,modification,na,pattern,plant,position,scale,seed,shape,size,spacing,spot,structure,symmetry,sympodial,system,texture,type,unicellular,value,zygomorphy,{,}
504	wfo-0001031881	success	168	110	60	108	50	0.357	0.2-0.6,0.5-0.7,1-1.5,1.5-2.5,1/3,3.5-4,3/4,acute,anther,apex,attenuate,base,beneath,branched,calyx,cm,corolla,densely,difoliate,distal,elliptic,filament,fleshy,fruit,fruiting,glabrous,globose,green,inflorescence,leaf,lobed,long,lower,margin,mm,obovate,opposite,pedicel,petiole,pore,poricidal,pubescent,shape,shaped,shrub,simple,small,sparsely,stem,surface,tear-drop,tip,tree,trichome,uniseriate,unit,usually,way,white,x	.5,0.1-0.5,0.2,0.4-1,0.5-1,1-1.3,1-7,1.2-6,10-12,10-30,2,2-9,3-19,5-6,7-14,absent,along,anthesi,apar,apparent,axil,ba,bark,branch,broadly,brown,bud,campanulate,capitate,constriction,dark,decurrent,deflexed,deltoid,dia,differing,dry,drying,eaf,edicel,eed,either,ellipsoid,erect,evenly,exserted,free,geminat,golden,golden-puberulent,golden-pubescent,greyish-brow,incrassate,inflorescenc,junction,lateral,lightly,like,lobe,lon,main,major,material,maturity,middle,midrib,minor,minute,minutely,nflorescence,occasionally,older,one,orbicular,ovary,ovoid-reniform,pair,papillo,papillose,pitted,planar,portion,puberulen,puberulent,rest,rounded,ruit,scar,size,slender,slightly,somewhat,soon,spaced,stigma,straight,strong,style,tall,tapering,tube,ud,vein,widest,winged,woody,ympodial,young	appressed,articulation,bract,branching,breeding,broad-based,cell,colour,connective,form,geminate,growth,hair,heteromorphism,inflated,insertion,interjected,interpetalar,leaflet,length,marking,mature,modification,na,needle-like,odour,orientation,paired,pattern,placement,position,prickle,pseudostipule,rhizome,scale,smell,spot,staman,stone,structure,symmetry,sympodial,system,texture,tissue,tuber,type,vegetative,xylopodia,zygomorphy
505	wfo-0001031886	invalid_json_followup	169	153	106	63	47	0.627	-1.2,-25,-9,.5,0,0.1,0.5-1,1-1.5,1-4,1.2-2.5,2-2.5,2-3,2-4,2-5,2.0-2.5,3-6,3.0,4,4-15,5-6,5-ridged,6-20,acuminate,anther,anticlinal,apex,attenuate,axillary,basal,base,berry,bright,broadly,brown,calyx,capitate,cell,cm,commonly,completely,conical,corolla,deltate,diameter,distinctly,dry,elliptic,epidermal,filament,fleshy,flower,fruit,fruiting,glabrous,green,greenish,irregular,lanceolate,lateral,leaflet,lobe,long,minutely,mm,near,node,occasionally,open-conical,ovary,ovoid-reniform,papillae,pedicel,per,petiole,petiolule,pinnate,poricidal,portion,projection,raised,reddish,rugose,scattered,seed,shape,shrub,similar,simple,sinuous,somewhat,sparse,specimen,stigma,strongly,style,surface,thickening,tip,triangular,trichome,tube,uniseriate,white,wintergreen,without,x	-4,1.5-2,10-40,2,20-30,5-10,6-8,9-10,abaxially,abruptly,absent,adaxially,along,anthesi,arising,axil,beak,bearing,bud,clavat,eaf,earl,edicel,eed,either,em,equal,erec,exserted,free,half,le,lobed,lower,margin,narrowed,nearly,nflorescence,noddin,oblique,pair,papillate,papillose,primary,purple,rachi,reflexed,ripe,ruit,scar,single,smaller,smelling,terminal,time,tub,ud,unifoliat,unit,usually,vein,woody,ympodial	'',[,``,appressed,arrangement,bract,branching,breeding,characteristic,clavate,colour,connective,feature,form,growth,hair,inflated,inflorescence,interjected,interpetalar,leaf,length,marking,mature,modification,na,nodding,number,odour,orientation,pattern,pore,position,scale,size,smell,spot,stem,symmetry,system,texture,tissue,type,value,vegetative,{,}
506	wfo-0001031895	success	160	99	85	75	14	0.531	-1.5,0.5,0.5-1,1-1.5,1.5-2,1.5-3,1.5-6,2-2.5,2.5-3,3-4,3-8,3.5-6,4-5,4.5-16.5,6-7,6-9,acute,anther,apex,attenuate,base,beneath,berry,bluish,calyx,cell,cm,corolla,dark,densely,diameter,ellipsoid,elliptic,entire,exerted,filament,fleshy,fruiting,glabrous,globose,green,growth,immature,leaf-opposed,leaving,less,lobed,margin,matte,minutely,mm,occasionally,once-branched,ovoid,pair,pale,papillate,pedicel,peduncle,peg,petiole,pitted,poricidal,reniform,revolute,shiny,shrub,simple,sinuate,slightly,small,somewhat,strongly,tan,testal,thick,tip,tree,tube,vein,violet,way,white,x,Â¼-1/2	0.5-2,3-10,4,5,5-6,5-8,age,anthesi,apparently,articulating,bark,blac,broadly,campanulate,capitate,completely,conical,cup-shaped,deltate,drying,eaf,eed,emarginated,enlarging,erec,erect,exfoliating,expand,flower,fragrant,free,glabrou,inflorescenc,intensely,irregular,leafy,lengthening,lobe,lower,new,nflorescence,older,ovary,overlapping,papillat,part,patch,peeling,perfect,pericarp,planar,plurifoliat,pore,portion,primary,reddish,ruit,scar,shoot,short,slender,slit,stem,stigma,stout,straight,style,surface,terminal,thin,tub,ud,unit,woody,ympodial	articulation,bud,colour,form,fruit,inflorescence,leaf,length,position,seed,shape,size,texture,type
507	wfo-0001031897	success	264	113	62	202	51	0.235	.1,.5,0-1,0.1-0.5,5-6,accrescent,almost,anther,apex,apically,apparently,attenuate,base,berry,black,branched,calyx,cell,chartaceous,cm,coriaceous,corolla,cuneate,curved,densely,dilated,drying,entire,epiphyte,filament,fruit,fruiting,glabrous,hair,leaf,lobed,lower,margin,mauve,mm,oblong,orange-brown,ovoid,pedicel,petiole,pore,poricidal,revolute,ridged,shrub,simple,slightly,sparsely,stem,surface,terminal,thick,tip,trichome,unit,white,x	.8,0.15,0.2-0.4,0.4-1.1,0.5-1,0.5-3,0.6,0.8-1.5,0Â°,1,1-1.5,1-2,1-2.5,1.1,1.3-2,1.5,1.5-8,1.7-3,13,2-4,2/3,4-5,462.,6-9,8,abaxial,abaxially,absent,acute,adaxial,adaxially,age,along,alyx,anthesi,apar,appearing,appendage,arising,aristate,articulated,axillary,bark,bendy,boiteau,brachyblast,branch,brown,clavate,clearly,clustered,concolorous,condensed,conical,connate,covering,dark,datum,dehiscing,delineated,dendritic,dense,developed,developing,development,diameter,distributed,divided,domatia,dorsal,dorsifixed,dry,dull,eaf,earliest,ed,elliptic,enlarged,equal,erect,even,evenly,except,extending,eye,faint,filiform,fine,flower,foliaceous,free,green,grey,immature,indistinc,inner,inside,known,lamina,lanceolate,larger,lateral,least,lengthening,light,like,linear,lobe,long,longitudinal,longitudinally,looped,m.,main,margi,membranous,midvein,minute,minutely,multicellular,multiseriate,naked,never,nflorescence,nther,obconical,oblon,obtuse,occasional,occasionally,one,orange,orolla,outside,ovate,overlapping,pair,papillose,part,partly,peduncle,pendulous,perfec,pericarp,persisting,plant,plurifoliat,pointed,portion,primary,prominent,pronounced,protruding,pubescent,raised,rarely,reach,reddish,ribbed,ridge,ruit,scar,secondary,see,seen,shoot,short,side,sinus,slender,smaller,smoot,smooth,sometimes,sparse,stigma,stump,style,subulate,sunk,tearing,terete,tertiary,thin,toward,tube,ud,unarmed,unbranched,unicellular,usually,vary,vein,venation,visible,weakly,well-developed,wide,winged,wrinkle,ympodial,young	appressed,articulation,bract,branching,breeding,broad-based,colour,connective,form,growth,heteromorphism,inflated,inflorescence,insertion,interjected,interpetalar,leaflet,length,marking,mature,modification,na,needle-like,odour,orientation,paired,pattern,perfect,placement,plurifoliate,position,prickle,pseudostipule,rhizome,scale,shape,smell,spot,staman,stone,structure,symmetry,sympodial,system,texture,tissue,tuber,type,vegetative,xylopodia,zygomorphy
508	wfo-0001032157	success	136	108	84	52	24	0.618	.5,0.25,0.5-1,0.6-1,0.75-1,1-3,2-3,2-5,2.2,5-15-flowered,acute,anther,anthesi,apart,bark,base,becoming,beneath,berry,bi-lobed,calyx,cm,completely,corolla,crystalline,decurrent,deflexed,deltoid,dia,dry,elliptic,exserted,filament,fruiting,glabrous,globose,golden,green,incrassate,leaf,less,live,lobe,lobed,long,longitudinal,margin,minor,minutely,mm,nearly,opposite,ovary,ovoid-reniform,paler,papillose,pedicel,peeling,persistent,petiole,pitted,plant,pore,poricidal,reddish,scar,shaped,shiny,shrub,size,slender,slightly,soon,stigma,strip,style,surface,tapering,tear-drop,tip,tube,white,woody,x	.75,1.9-2.2,3-6,5-8,5-9,7-9,9-17,apex,beginning,caly,differing,difoliate,eaf,edicel,eed,evenly,free,frui,geminat,glabrou,inflorescenc,lateral,living,lon,lower,main,major,middle,nflorescence,obscure,older,one,pair,papillo,portion,raised,reflexed,rounded,ruit,simple,spaced,stem,straight,tall,translucen,ud,unit,vein,widest,yellowish,ympodial,young	bud,colour,deflexion,flower,form,fruit,glabrousnes,growth,height,inflorescence,length,marking,modification,na,number,position,seed,shape,spacing,spot,symmetry,texture,type,ye
509	wfo-0001032161	success	146	120	67	79	53	0.459	.5,0.4-1.2,0.8-1,1-3,1.2-1.3,1.4-2,2-7,2.5-3,3.5-4,?,acute,anther,anthesi,apex,area,base,berry,calyx,cm,coriaceous,corolla,dendritic,difoliate,drying,elliptic,filament,fruiting,glabrous,globose,golden,green,inflorescence,internodal,leaf,lobed,margin,merely,minute,minutely,mm,mustard,nearly,opposite,ovary,ovoid-reniform,papillose,pedicel,petiole,pitted,plant,plurifoliate,pore,revolute,shaped,shrub,simple,stigma,style,surface,tear-drop,trichome,tube,uniseriate,unit,white,x,yellow	0.5-1,0.7-4,0.75-1,1-1.5,1-11,2-8-flowered,abaxially,adaxiall,adaxially,apical,ba,bark,beneath,branched,brownish-blac,closely,color,conical,dark,deflexed,delicate,deltate,densely,dia,eaf,edicel,eed,ellipsoid,exserted,filiform,free,giving,hanging,lamina,later,like,lobe,long,lower,many,middle,nflorescence,obovate,occasionally,older,overlappin,pale,pericarp,persistent,poricidal,portion,projection,pubescent,quadrate,reflexed,rest,ruit,scar,shiny,shoot,short,spaced,sparsely,stem,strongly,styl,sulcate,tall,tan,thin,tip,tub,ud,usually,vein,widest,yellowish,ympodial,young	abaxial,adaxial,appressed,articulation,bract,branching,breeding,cell,colour,connective,diameter,form,fruit,growth,hair,height,heteromorphism,inflated,insertion,interjected,interpetalar,leaflet,length,marking,mature,modification,na,odour,orientation,paired,pattern,placement,position,prickle,pseudostipule,rhizome,scale,seed,shape,size,spot,staman,stellate,stone,structure,symmetry,sympodial,system,texture,tissue,tuber,type,xylopodia
510	wfo-0001032165	invalid_json_followup	197	149	99	98	50	0.503	0.1-0.3,0.25-0.5,0.75-1,1-2,1.5-4,2.5-3.5,3-4,3-6,4-6,5-6,8-9,acute,anther,appearing,bark,base,berry,broadly,brown,bud,calyx,capitate,center,closely,cm,corolla,cup-shaped,dark,decurrent,densely,dia,dry,ellipsoid,elliptic,exserted,exsertion,filament,fruiting,glabrous,globose,golden,golden-puberulent,golden-pubescent,green,greyish-brown,inflorescence,later,leaf,lobed,long,margin,markedly,minor,minute,minutely,mm,nearly,node,obovate,occasionally,once-furcate,onto,orbicular,ovary,overlapping,ovoid-reniform,pedicel,petiole,pitted,plant,pore,poricidal,puberulent,purplish,ripe,scar,shape,simple,spaced,specimen,stem,stigma,strongly,style,surface,tear-drop,terminal,time,tinged,tip,tree,trichome,tube,uniseriate,white,winged,woody,x,young	.25,.5,0.1,0.3-1,1-1.2,1-1.5,10-25,2-2.5,3.5-8.5,5-15,5-30-flowered,5-7,5-9.5,abaxial,adaxial,along,anthesi,apex,apparent,ba,beginning,beneath,continued,cucullate,deciduous,deltoid,denser,differing,difoliate,distal,due,dull,eaf,edged,edicel,eed,end,entire,erect,even,expansion,free,geminat,immature,inflorescenc,lateral,less,like,live,lobe,lon,lower,main,major,medial,middle,midrib,near,nflorescence,older,one,opposite,pair,pale,paler,papillo,papillose,planar,portion,presence,prominent,rather,rest,ridge,rounded,ruit,shaepd,single,size,slender,slightly,slow,small,smoot,stout,straight,stripe,swollen,tall,tapering,thickened,tub,ud,unit,vein,widest,yellowish,ympodial	'',5-30,[,``,appressed,articulation,bract,branching,breeding,characteristic,colour,connective,diameter,flower,form,fruit,growth,hair,height,inflated,insertion,interjected,interpetalar,leaflet,length,marking,mature,modification,na,number,odour,paired,pattern,position,scale,seed,shaped,smell,smooth,spot,symmetry,system,texture,tissue,type,value,vegetative,zygomorphy,{,}
511	wfo-0001032167	success	163	117	61	102	56	0.374	0.5-2.5,1-2,1-2-celled,10-35,2-foliate,4-6,abundant,acute,anther,apex,appressed,base,berry,calyx,cell,chartaceous,ciliate,cm,elliptic,elliptic-ovoid,entire,few-,filament,forming,fruit,glabrous,globose,growth,hair,herb,interpetalar,lower,many-branched,margin,membranaceous,mm,moderately,netlike,oblong,obtuse,pedicel,per,petiole,projection,pubescent,purple,raised,rotate,rounded,seed,staman,surface,tissue,twisted,unbranched,unit,usually,wall,white,x,yellow	.5,0.5-1,0.5-1.5,0.75-3,1,1-2.5,1-3,1-5,1-7,1.5,10-20,12-20,2-4,2-7,3-6,3-7,4-10,5-15,7-10,abaxially,absent,adaxiall,adaxially,along,axe,blade,brown,closely,common,connected,cordate,curved,decurrent,dehiscing,dense,densely,denser,diameter,dm,drying,eaf,eed,emarginat,explosively,flat,flattened,flower,frui,geminat,geniculate,growt,held,immature,larger,linear-lanceolate,lobe,long,longer,lowermost,lying,maturing,maturit,mesocarp,near,nearly,new,nfloresence,notch,often,older,one-celled,orolla,peduncle,placenta,pressure,pubescen,rachi,ruit,semitransparent,shorter,slightly,small,smaller,sometimes,sparsely,stamen,stigma,straight,style,tal,tamen,tem,triangular,tube,two-celled,upper,vary,vein,watery,wid,woody,ympodial	arrangement,articulation,bract,branching,breeding,broad-based,colour,connective,corolla,form,fruiting,geminate,heteromorphism,inflated,inflorescence,insertion,interjected,leaf,leaflet,length,marking,mature,modification,na,needle-like,number,odour,orientation,paired,pattern,placement,pore,position,present,prickle,pseudostipule,rhizome,scale,shape,simple,smell,spot,stellate,stem,stone,structure,symmetry,sympodial,system,texture,trichome,tuber,type,vegetative,xylopodia,zygomorphy
512	wfo-0001032176	success	177	128	112	65	16	0.633	.5,0,0.42,0.5-0.7,0.5-1,0.8-1,0.8-6,1-1.2,1-10,1.5-1.6,1.5-2.5,1.5-6,3-3.5,3-7,5-6-celled,6,6-10,7,adaxially,along,anther,anthesi,apex,apical,basal,base,beak,becoming,berry,branched,calyx,cell,cm,conical,copiously,corolla,cucullate,densely,denser,diameter,drying,ellipsoid,elliptic,epidermal,equal,especially,exserted,filiform,fruiting,globose,green,greenish,grey-brown,greyish,herb,lateral,leaf,leaflet,lengthening,like,lobe,lobed,long,minute,mm,nearly,nodding,node,obovate,occasionally,onto,ovoid-reniform,pair,pedicel,per,petiole,pinnate,pore,poricidal,projection,pubescent,quadrate,rachi,reflexed,rest,rooting,rounded,seed,simple,sinuous,size,slightly,slit,smaller,somewhat,soon,sparsely,stem,strongly,terminal,thickening,tip,trichome,truncate,tube,uniseriate,vein,wall,white,winged,without,x	0.5,0.5-0.75,1/2,100,2-3,2.5-10,3-15,3-4,adhering,apart,arising,attaining,attenuate,axil,axillary,capitat,cateniform,containing,creeping,eaf,edicel,eed,fallen,filament,flower,free,glabrous,hangin,inflorescenc,lengt,log,long-papillose,lower,margin,minutely,nflorescence,obtuse,often,open,ovary,pale,papillose,petiolule,portion,ruit,scar,separate,single,spaced,stigma,strait,style,tem,tightly,time,tree,trunk,tub,ud,ultimate,unevenly,unifoliat,unit,whit,ympodial	arrangement,branching,bud,cateniforme,colour,exsertion,form,fruit,growth,inflorescence,length,number,plant,pubescence,shape,winging
513	wfo-0001032187	invalid_json_followup	139	159	84	55	75	0.604	-11,-2.1,-4,-4.2,-5,-9,0.5,0.5-,22,5-merous,9,acuminate,acute,adherent,anther,apex,appressed,aromatic,base,berry,blade,branch,broadly,brown,brownish,cm,corolla,cyme,dark,dull,eglandular,elliptic,entire,equal,erect,filament,forked,glabrescent,globose,green,hair,herb,hooked,leaf,light,lobe,long,many,margin,mature,mm,obovate,occasionally,ovate,pedicel,peduncle,pentagonal,per,persistent,petiolate,petiole,plant,pollen,predominantly,protruding,purple,rarely,simple,soft,sometimes,spreading,stage,stellate,stem,straight,style,sub-glabrous,texture,tinged,triangular,truncate,widest,yellowish,Â±1	0.1â1.4,0.5â1,0.6â1.3,1.1â3.2,1.3â1.8,1.6â2.1,1.8â2,1.8â2.8,100,1â1.7,24.6â26.3,2â9,3.1â3.5,3â3.2,3â4,5â7,7â11,alyx,angular,ape,changing,consisting,di-foliate,dia,eaf,eed,flowered,fully,geminat,granule,hite,hydrated,lower,marked,nflorescence,numerous,penden,perfec,presen,ridge,ruit,running,sclerotic,short,small,sparse,tooth,unit,well,wing,yellow,ympodial,Â±,Âµm,Ã	'',0.1\u20131.4,0.5\u20131,0.6\u20131.3,1.1\u20133.2,1.3\u20131.8,1.6\u20132.1,1.8\u20132,1.8\u20132.8,1\u20131.7,24.6\u201326.3,2\u20139,3.1\u20133.5,3\u20133.2,3\u20134,5\u20137,7\u201311,[,\u00b1,\u00b5m,\u00d7,``,adhesion,arrangement,articulation,bract,branching,breeding,calyx,characteristic,colour,connective,diameter,flower,form,fruit,fruiting,growth,height,inflated,inflorescence,insertion,interjected,interpetalar,leaflet,length,marking,modification,na,number,odour,paired,pattern,perfect,point,pore,position,present,prickle,scale,seed,shape,size,smell,spot,symmetry,system,tissue,type,value,vegetative,white,width,{,}
514	wfo-0001032206	invalid_json_followup	216	152	80	136	72	0.37	-20,accrescent,acute,andromonoecious,anther,apex,articulated,base,berry,branched,calyx,chartaceous,cm,connivent,covering,cream,cuneate,dark,deltate,diameter,equal,filament,flattened-reniform,flower,foliaceous,fruit,fruiting,glabrescent,glabrous,green,heterostylous,lateral,leaf,length,lobed,long,long-styled,margin,marking,mature,maturity,mauve,midvein,mm,moderately,obtuse,orange-brown,ovate,pale,pedicel,peduncle,pendulous,per,petiole,plant,poricidal,prickle,purple,rarely,reflexed,short-styled,shrub,sometimes,spherical,stellate,stellate-pubescent,stem,straight,style,surface,tapering,tip,toward,trichome,truncate,usually,white,woody,yellow,young	-0.8,-2,-5,..,.2,.5,0,0.2,0.2â0.4,0.2â0.5,0.5â1,0.8â1.2,00â200,0â20,0â30,0â5,1,1.1â1.2,1.2â2.2,1.5â2,1.5â2.5,1/3,1/4â1/2,1/4â1/3,1/6,10â80,11â22,1â2,1â2.3,1â3,1â4,2.5â3.3,2.7â3.5,2â2.5,2â3,2â8,3.5â9,30â80,3â4,4.5â5.8,4â6,5-merous,5â15,5â20,5â6,5â8,5â9,6â10,6â15,6â8,7â10,8â20,abaxially,adaxially,alyx,apar,apart,apically,apparently,approximately,armed,bark,blade,bluntly,broad-deltate,brow,clearly,concolorous,curved,discolorous,distal,distance,drying,eaf,eed,elliptic,erect,extending,flattened,free,functionally,gently,green-brown,hermaphroditic,infructescence,lengt,lobe,lobing,longer,lowermost,mal,midpoint,nflorescence,often,older,one,open,orolla,ower,pair,pendent,pericarp,plurifoliat,porrect,portion,primary,ray,scar,secondary,sessile,side,slender,smooth,spaced,sparsely,spreading,stalk,stalked,stout,tamen,tertiary,time,tube,uit,unarmed,ung,unit,variously,vary,vein,venation,visible,weakly,wide,yellow-orange,ympodial	'',0-20,0.5-1.5,0.8-1.2,00-200,1-2,1-2.3,1-3,1.1-1.2,1.2-2.2,1.5-2.5,1/4-1/2,1/4-1/3,10-80,11-22,2-2.5,2-3,2.5-3.3,2.7-3.5,3-4,3.5-9,4.5-5.8,5-15,5-20,5-6,5-9,6-15,8-20,[,``,articulation,bract,branching,breeding,character,characteristic,colour,connective,corolla,form,growth,hair,height,heteromorphism,inflorescence,interjected,interpetalar,leaflet,modification,na,number,odour,ovary,pattern,pore,position,scale,seed,shape,smell,spot,staman,symmetry,system,texture,tissue,type,value,vegetative,width,{,}
515	wfo-0001032209	invalid_json	257	147	122	135	25	0.475	0.5-1,1-2,1-2-celled,1-6,1.5-2,1.5-6,10-13,2,2-3,2-3-lobed,2-5,2/3,20-30,3-7,5-8,acute,along,anther,apex,appearing,basal,base,berry,bilobed,blue,branched,brown,capitate,cell,chartaceous,cm,colour,cordate,coriaceous,corolla,dark,deeply,dendritic,densely,diameter,ecuador,elliptic,entire,evenly,filament,flattened-reniform,fleshy,flower,glabrous,globose,growth,hairy,hastate,inflorescence,lamina,lateral,leaf,leathery,length,lengthening,like,lobed,lower,margin,markedly,metallic,minutely,mm,narrowly,nearly,occasionally,one,ovate,papillate,pedicel,peduncle,per,perfect,pericarp,petiole,pinnately,pinnatifid,pore,poricidal,puberulent,pubescent,purple,red,reddish,rest,ripe,sagittate,several,shiny,simple,slit,sometimes,somewhat,stellate,stem,stigma,style,surface,tapering,terminal,testa,thin,time,tiny,tip,trichome,truncate,uniseriate,upper,vein,vine,violet,w,wall,white,woody,x	-11,-20,-30+,.5,0.3,0.5,1,1-1.5,1.5,1.5-,1.5-2.5,100,12-16,2.5-,3-9,4,4-20,5-merou,6-15,6-8,absent,adaxial,ag,alyx,anthesi,apart,apiculae,apparently,arching,ark,articulated,axi,berr,branch,broadly,bu,calyx,canopy,cast,climbing,conical,connivent,conspicuously,cucullat,deltate,denser,distally,distinct,dried,eaf,early,eed,ellipsoid,enlarged,equal,erect,especially,exerted,finely,flowering,free,fruiting,geminat,giving,glabrescen,groove,hanging,held,hollow,ilament,keeled,large,leaving,less,lobe,long,longer,longest,material,mean,mere,middle,midrib,midvein,minute,mixture,near,new,nflorescence,nipple,often,older,orolla,pair,papillae,papillat,part,particularly,peg,pentagonal,planar,plurifoliate,pointed,portion,primary,probably,pubescence,rhachi,rim,ruit,scar,sleeve,small,spaced,sparser,spreading,stout,tem,testal,third,tightly,tube,twinin,twining,ud,unequal,unit,usually,variable,vary,weight,widest,within,yellow,ympodial	'',2.5-15-20,4-20-30+,5-merous,[,``,age,arrangement,bark,branching,characteristic,form,fruit,glabrescent,number,ovary,position,seed,shape,size,texture,type,value,{,}
516	wfo-0001032232	success	137	133	78	59	55	0.569	.5,0.1,0.5-1,0.6-3,0.8-1,1-3,1.8-2,18.8-27.5,2-2.6,20-100-flowered,3/4,4.8-7.3,5-6,anther,anthesi,apex,attenuate,bark,base,clavate,closely,cm,corolla,dark-papillose,deflexed,elliptic,evenly,filament,filiform,flower,fruiting,glabrous,globose,green,greenish-brown,lateral,leaf,lenticellate,less,light,lightly,lobed,long-acuminate,main,margin,minutely,mm,narrowly,opposite,ovary,ovoid-reniform,packed,pair,pale,papillose,pedicel,petiole,pitted,pore,poricidal,revolute,scar,shaped,shrub,slightly,stem,stigma,style,subshrub,surface,tear-drop,tip,translucent,undulate,unit,vein,way,winged	0.25,0.5,2,?,abruptly,age,ba,becoming,berry,calyx,cup-shaped,decurrent,dia,distally,eaf,edicel,eed,erect,erose,exfoliatin,free,immature,irregular,lobe,long,lower,middle,midrib,minute,nflorescence,node,occasionally,onto,overlappin,paler,papillo,portion,prominent,raised,reflexed,rounded,ruit,short-styled,simple,somewhat,sparsely,straight,tall,ti,tub,tube,ud,umbonate,unifoliat,wide,widening,widest,woody,ympodial	arrangement,articulation,bract,branching,breeding,bud,cell,colour,connective,diameter,form,fruit,growth,hair,height,heteromorphism,inflorescence,insertion,interjected,interpetalar,leaflet,length,marking,mature,modification,na,number,odour,orientation,packing,pattern,placement,plant,position,prickle,pseudostipule,rhizome,scale,seed,shape,spot,staman,stone,structure,symmetry,sympodial,system,texture,tissue,tuber,type,unifoliate,width,winging,xylopodia
517	wfo-0001032233	invalid_json_followup	160	157	93	67	64	0.581	0.3-2,1-1.5,1-2,1.5-2.5,10-15,157,2-15,2-3,2-5.5,2-6,20-100+,25-40,3-15,3-4,3-4.5,3-5,3.5-4,4-7,5-16,5-6,adaxial,adaxially,almost,apex,basal,base,branched,calyx,chartaceous,cm,connective,convex,cordate,coriaceous,cylindrical,dark,densely,diameter,dilated,directed,distally,ellipsoidal,entire,flattened,fleischmann,flower,fruit,glabrescent,glabrous,glandular-puberulent,globose,green,laterally,lobe,longitudinal,margin,mm,moderately,oblong,obtuse,orange,ovate,ovoid,pedicel,peduncle,perfect,petiole,pore,puberulent,pubescent,purple,radiu,shallowly,simple,slightly,somewhat,sparsely,stellate,stigma,stripe,style,subcoriaceous,subpeltiform,tip,tree,triangular,truncate,unbranched,unit,x,yellow,yellow-green,yellow-orange	0-2,1-3,2-4,2.5-4,4-18,4-5,4-foliat,6-25,8-12,abaxially,absen,absent,acuminate,acute,aggregate,apart,ape,articulated,axe,bent,beyond,biglandula,blade,brow,cell,connivent,eaf,eed,equal,especially,exceeding,exserted,fleshy,glabrate,leaving,lon,long,lower,narrowly,nflorescence,nther,orolla,pedicellar,present,projection,puberulen,rachise,remnant,ruit,shorter,small,spaced,stamen,stone,tal,tem,thecae,time,tomento,toward,tube,ud,vary,vein,white,wide,ympodial	'',4-foliate,[,``,abaxial,anther,appressed,articulation,biglandular,bract,branching,breeding,brown,bud,characteristic,colour,corolla,filament,form,fruiting,growth,hair,height,inflated,inflorescence,insertion,interjected,interpetalar,leaf,leaflet,length,marking,mature,modification,na,number,odour,ovary,paired,pattern,plant,position,rachi,scale,seed,shape,size,smell,spacing,spot,stem,structure,symmetry,sympodial,system,texture,theca,tissue,trichome,type,value,vegetative,{,}
518	wfo-0001032259	success	202	127	79	123	48	0.391	.5,0-10,0-20,0.5-0.8,0.8-1.3,0.9-1.2,1.5-4.5,20-60,abaxial,acute,adaxial,almost,anther,apex,apparently,articulated,base,berry,branched,brown,chartaceous,cm,conical,connivent,cordate,cuneate,dark,densely,diameter,difoliate,equal,evenly,filament,flattened,flattened-reniform,flower,fruit,fruiting,geminate,glabrous,green,hair,lateral,leaf,length,lobed,long,lower,margin,mature,maturity,mauve,mm,orange,ovate,pedicel,per,petiole,poricidal,porrect,prickle,recurved,red,sessile,shrub,simple,spherical,stellate,stellate-pubescent,stem,straight,surface,tapering,terminal,tip,trichome,unit,white,young	-4,/3,/4,0,0-2,0-4,0-5,0.1-0.2,0.1-0.3,0.15-0.3,0.45-0.6,0.5-1.5,0.7-1.1,1-1.8,1-2,1-2.5,1/2,1/3,1/4-1/3,1/6-1/5,10-30,15-40,2-2.5,2-4,2-5,2.2-3,3-4,3/,4,4-5,4-6,4-9,5,5-30,5-merous,5.5-8,7-16,7-8,9-22,abaxially,acut,alyx,apar,apart,apically,bark,becoming,blade,broad-deltate,brownish,calyx,deltate,discolorous,distance,drying,dull,eaf,eed,elongating,erect,extending,free,fully,glabrescent,gland,green-brow,infructescence,lobe,longer,midpoint,midvein,minute,moderately,nflorescence,older,one,open,opening,orange-brown,orolla,oung,pair,peduncle,pendulous,perfec,pericarp,portion,prickl,prickly,primary,pubescent,ray,reduced,rounded,ruit,scar,shorter,side,slender,smooth,sometimes,spaced,sparsely,spreading,strongly,style,tamen,terete,tertiary,time,toward,tube,unarmed,vary,vein,venation,visible,way,wide,woody,yellow,yellow-green,ympodial	articulation,bract,branching,breeding,broad-based,cell,colour,connective,corolla,form,growth,heteromorphism,inflorescence,insertion,interjected,interpetalar,leaflet,marking,na,number,odour,orientation,ovary,paired,pattern,perfect,placement,position,pseudostipule,rhizome,scale,seed,shape,smell,spot,staman,stone,structure,symmetry,sympodial,system,texture,tissue,tuber,type,vegetative,xylopodia,zygomorphy
519	wfo-0001032260	success	216	106	57	159	49	0.264	0.5-2,0.7-1.5,6-10,anther,apex,apparently,articulated,base,berry,branched,calyx,cell,chartaceous,cm,connivent,cuneate,curved,deltate,densely,difoliate,equal,erect,filament,flattened,fruit,fruiting,glabrous,lateral,leaf,length,lobed,long,lower,margin,mature,maturity,mauve,mm,pedicel,petiole,poricidal,prickle,purple,red,reflexed,rounded,shrub,simple,spherical,stellate,stellate-pubescent,stem,surface,tapering,terminal,tip,unit	-0.5,-1.5,-10,-3,-8,.1,/5,0-,0-0.5,0-10,0-20,0-5,0-8,0.1,0.1-0.3,0.1-0.4,0.15-0.3,0.2,0.2-0.5,0.4,0.5-0.8,0.5-5,0.6-0.8,0.7,0.8-1.1,1-1.7,1-3,1-5,1-6,1.2-1.7,1.5-4,1/2,1/3,1/3-1/2,1/3-1/5,10-30,2,2-20,2-4,2-5,2.5,2.5-3,2.5-3.5,3-10,3-5,3-8,3-9,4-,5-,5-20,5-merous,6-8,7-15,abaxial,abaxially,acuminat,acuminate,acute,adaxial,alyx,apar,apart,apically,bark,blade,broad-deltate,diameter,discolorous,distance,drying,dull,eaf,eed,elliptic,elongating,extending,eye,flattened-reniform,flower,free,geminat,glabrescent,glabrou,gland,glaucous,globular,gray-brow,green-brown,infructescence,lobe,lon,long-styled,longer,midpoint,midvein,moderately,naked,narrow-ovate,nflorescence,older,one,open,orange-brown,orolla,oung,outline,ovate,pair,pale,peduncle,pendulous,per,perfec,pericarp,pit,porrect,portion,prickl,prickly,primary,pubescent,raised,ray,reduced,ruit,scandent,scar,sessile,shallowly,shorter,side,slender,small,smooth,spaced,sparsely,spreading,stalk,stalked,strongly,style,subentire,tamen,terete,tertiary,time,trichome,tube,variously,vary,vein,venation,visible,way,wide,woody,yellow,yellow-green,ympodial	0-30,appressed,articulation,bract,branching,breeding,colour,connective,corolla,form,geminate,growth,hair,heteromorphism,inflated,inflorescence,insertion,interjected,interpetalar,leaflet,marking,modification,na,needle-like,odour,orientation,paired,pattern,perfect,placement,pore,position,pseudostipule,rhizome,scale,shape,spot,staman,stone,structure,symmetry,sympodial,system,texture,tissue,tuber,type,xylopodia,zygomorphy
520	wfo-0001032264	success	183	99	64	119	35	0.35	.2,.5,0.25-0.75,0.6-2.2,1-1.5,1.5-1.8,4.5-5,acute,anther,apex,apiculate,base,berry,branched,calyx,cell,cm,corolla,dia,difoliate,elliptic,filament,fleshy,fruiting,glabrous,globose,green,hair,inflorescence,leaf,lobed,long,lower,margin,minute,minutely,mm,narrowly,nearly,occasionally,opposite,pedicel,petiole,pore,poricidal,red-papillose,revolute,several,shaped,shrub,simple,stem,surface,tear-drop,time,tip,tree,trichome,tube,uniseriate,unit,white,x,yellowish-brown	0.25-0.5,0.5-1,0.8-10,0.8-4,1.2-2,1.8-3,10-22,2-50-flowered,2-6,3,3-15,3-9,5-9,6-17,acuminate,along,anthesi,apar,appearing,ba,bark,broadly,bud,bullate,cell-layer,closely,cup-like,curling,deciduous,deflexed,densely,differing,dry,eaf,edicel,eed,epidermal,exserted,flattened-reniform,flower,free,geminat,gnarled,greyi,habitat,incrassate,lamina,large,larger,lateral,layer,like,live,lobe,lon,main,major,material,middle,minor,multiseriate,nflorescence,often,older,one,ovary,overlapping,ovoid,pair,pale,papillo,papillose,parallel,peeling,pitted,planar,plant,pointed,portion,primarily,prominent,pubescent,quite,raised,reddish,reddish-tan,rounded-deltoid,ruit,scar,scattered,sheet,sheltered,short,size,slender,small-capitate,small-celled,somewhat,soon,spaced,sparsely,stigma,straight,style,tall,tapering,thick,transversely,trunk,ud,upper,vein,weak,whitish,wide,widest,woody,ympodial,young	articulation,branching,broad-based,colour,form,fruit,geminate,growth,heteromorphism,insertion,length,marking,na,needle-like,odour,orientation,placement,position,prickle,pseudostipule,rhizome,scale,shape,smell,spot,staman,stone,structure,symmetry,sympodial,texture,tuber,type,vegetative,xylopodia
521	wfo-0001032274	invalid_json	192	119	90	102	29	0.469	.5,0,0.5,0.5-0.7,0.5-1,1-1.2,1-1.5,1-3,1.5-2,3-4,3-6,3/4,5-7,<,acuminate,acute,anther,apex,arching,base,berry,brown,capitate,cell,cm,corolla,dendritic,densely,diameter,distal,ellipsoid,entire,filament,flattened-reniform,flower,fruiting,glabrous,globose,growth,inflorescence,lanceolate,leaf,lobe,lobed,margin,minute,minutely,mm,occasionally,once-branched,pale,pedicel,peduncle,per,perfect,petiole,pitted,pore,poricidal,pubescent,purple,red,reddish,ridge,ridged,ripe,rounded,shape,shiny,shrub,simple,size,square,stellate,stem,stigma,strongly,style,suckering,surface,terminal,testal,tip,trichome,truncate,tube,uniseriate,way,white,x	0.15-0.2,0.5-1.5,0.7-1.8,0.9-1,2,2-3.5,2-7,3-10,3-5,5-merou,ag,alyx,anthesi,apiculate,apparently,appearance,ark,articulated,axillary,ba,basal,borne,branch,calyx,clustered,conical,connivent,deltate,eaf,eed,elliptic,exserted,filiform,fleshy,free,geminat,glabrou,green,grey,group,highly,ilament,irregular,lax,lengthening,less,like,long,loosely,lower,markedly,membranous,new,nflorescence,nodding,non-reproductive,obtusely,often,older,one,orolla,pair,papillo,peg,pendan,pericarp,platfor,platform,plurifoliate,portion,primary,puberulent,quadrate,reflexed,reproductive,ruit,scar,shoot,short,sleeve,slit,small,sometimes,somewhat,sparsely,tem,thin,tinged,twinin,two,ud,unit,upper,usually,variable,vary,vein,violet,visible,woody,yellow,ympodial	'',5-merous,[,``,arrangement,articulation,branching,bud,characteristic,colour,form,fruit,hair,height,length,na,number,ovary,pattern,plant,position,seed,symmetry,twining,type,value,ye,{,}
522	wfo-0001032276	success	152	135	95	57	40	0.625	-,.25,.5,0.25-1.5,0.3-1,0.5-0.75,0.5-1,0.8-1,1,1-1.5,1-2,1.8-2,2-2.5,2.5-4,3-3.5,3-6-flowered,5-7,9-18,acute,along,anther,anthesi,apex,attenuate,base,beneath,blade,broadly,brown,calyx,cm,corolla,cup-shaped,dark,deltoid,dia,dry,elliptic,except,filament,filiform,fruiting,geminate,glabrous,globose,green,lamina,leaf,like,lobe,lobed,long,long-pubescent,lower,margin,material,minutely,mm,narrowly,nearly,node,non-reproductive,occasionally,onto,opposite,ovary,ovoid-reniform,pedicel,petiole,pitted,plant,pore,pubescent,rest,shaped,shrub,simple,slender,sparsely,stem,stigma,style,surface,tapering,tear-drop,triangular,trichome,tube,unifoliate,uniseriate,unit,vein,white,winged,x	7-8,apart,ba,bark,capitat,converging,curly-tipped,decurrent,deflexed,densely,eaf,edicel,eed,ellipsoid,evenly,exserted,free,greyish-gree,later,lateral,main,middle,minute,nflorescence,obovoid,older,pair,pale,papillose,perhaps,poricidal,portion,prominent,raise,raised,reflexed,remaining,ruit,scar,short,slightly,somewhat,soon,spaced,straight,straw-colored,strongly,tall,tip,tub,ud,widely,widest,woody,yellow,ympodial,young	articulation,branching,broad-based,capitate,cell,colour,diameter,flower,form,fruit,growth,height,heteromorphism,inflorescence,insertion,length,na,needle-like,number,odour,orientation,placement,position,prickle,pseudostipule,rhizome,seed,shape,size,smell,staman,stone,structure,symmetry,sympodial,texture,tuber,type,vegetative,xylopodia
523	wfo-0001032277	success	163	142	90	73	52	0.552	.5,0.1-0.5,0.2-0.6,0.75-1,0.8-3,1-1.1,1-1.2,1-2,1/2,2-2.5,2-4,3-3.5,5-6,8-9,acute,anther,anthesi,apex,area,base,blunt,branched,bright,calyx,cm,coriaceous,corolla,cup-shaped,densely,elliptic,filament,flattened-reniform,fruit,fruiting,glabrous,globose,green,immature,incrassate,inflorescence,internodal,lax,leaf,lobed,lower,margin,minutely,mm,number,opposite,ovary,pale,paler,papillae,papillose,pedicel,petiole,pitted,pore,poricidal,puberulent,pubescent,revolute,ripe,round,shrub,simple,slender,small,sparsely,spicy-fragrant,stem,stigma,straight,style,surface,tip,translucent,trichome,tube,uniseriate,unit,varying,virgately,way,white,woody,x,yellow,yellowish-tan	1-1.5,1-5,1.5-1.8,10-14,2-6-flowered,3-9,along,apiculate,appear,appearing,auriculate,ba,bark,beneath,berry,blade,closely,deltoid,dia,drooping,dry,eaf,edicel,eed,ellipsoid,erect,exserted,free,geminat,gre,impressed,indentation,lateral,like,lobe,long,main,mature,middle,nflorescence,obscured,occasionally,older,overlapping,pair,partially,portion,prominent,pubescenc,raised,reddish,remaining,rest,rounded,ruit,scar,slende,spaced,specimen,strict,strongly,styl,tall,tapering,truncate,trunk,tub,two,ud,vein,widest,ympodial,young	abaxial,adaxial,bract,branching,breeding,broad-based,cell,colour,diameter,flower,form,fragrance,geminate,growth,hair,height,heteromorphism,interjected,interpetalar,leaflet,length,marking,na,needle-like,odour,orientation,pattern,placement,plant,position,prickle,pseudostipule,rhizome,scale,seed,shape,size,smell,spot,staman,stone,structure,symmetry,sympodial,system,texture,tissue,tuber,type,vegetative,xylopodia,zygomorphy
524	wfo-0001032304	success	249	116	64	185	52	0.257	0.5-4.5,0.9-1.3,1.1-2,2-5,3.2-3.8,accrescent,anther,apex,apical-lateral,apparently,articulated,base,becoming,berry,blunt-tipped,branched,calyx,chartaceous,cm,corolla,entire,filament,fleshy,fruit,fruiting,glabrescent,greenish,growth,hair,introrse,large,lateral,leaf,length,long-attenuate,lower,margin,mm,oblong,pale,pedicel,perfect,petiole,plurifoliate,pore,probably,ripe,rotate-stellate,short-,shrub,simple,small,somewhat,stellate-tomentose,stem,subglobose,time,tree,unit,violet,white,x,yellow,young	-3,.6-1.2,.9-1.4,/20,0-120,0.2-0.3,0.3-1.5,0.5-3,1,1-3.5,1.2-2.3,1.2-3,1.3-2.1,1.5-3.2,1.6-1.9,1.8-4,1/2,1/3-1/2,1/5,1/8,10,18,2-4,2-4.2,2.5-19.5,2/3-3/4,21,3-10,3-15,3-20,3-4.5,3-6,3.2-5.5,4-7.5,44,5-6,5.5-9,7-27,7.5-12,9-13,abaxially,acuminate,acute,adaxially,ag,along,anthesi,apart,appressed-tomentose,ascending,axe,axillary,ba,bark,blackish,blade,branch,broadly,brown,brownish,bud,campanulate,capitat,closely,conical,continued,dark,decurrent,dehiscing,deltoid,dendritic,dendritic-echinoi,dendritic-echinoid,densely,diameter,directed,distal,due,eaf,echinoi,echinoid,elliptic,especially,exserted,extend,few-,few-rayed,flower,free,glabrescen,glabrous,granular-tomentose,green,high,honeycombed,inserted,juvenile,least,lobe,lobed,long,long-,long-stalked,longitudinal,m.,main,many,many-rayed,midvein,mixed,mostly,multangulat,multangulate,nflorescence,obscured,obtuse,occasionally,often,older,opaque,orbicular,orolla,ovat,ovate,ovate-lanceolate,overlapping,partly,peduncle,plant,porrect-stellate,present,pseudo-terminal,pubescent,rachi,rarely,rather,ray,relatively,reniform,reticulate-punctate,ruit,runk,scabridulous,seed,sessile,short,short-stalked,side,slit,spaced,sparingly,spreading,stamen,stigma,strongly,style,suborbicular,sulcate,suture,tamen,terete,testa,thick,thick-stalked,thin,thin-,thin-stalked,tomentose,tomentu,touching,toward,triangular-ovate,tube,unarme,unarmed,usually,vary,vein,velutinous,way,whitish,wide,within,yellowish,ympodial	appressed,articulation,bract,branching,breeding,broad-based,cell,colour,connective,form,heteromorphism,inflated,inflorescence,insertion,interjected,interpetalar,leaflet,marking,mature,modification,na,needle-like,odour,orientation,paired,pattern,placement,position,prickle,pseud-terminal,pseudostipule,rhizome,scale,shape,smell,spot,staman,stellate,stone,structure,surface,symmetry,sympodial,system,texture,tissue,trichome,tuber,type,vegetative,xylopodia,zygomorphy
525	wfo-0001032307	success	153	121	96	57	25	0.627	.5,/3,0.2-0.5,0.4-1.3,1-2,1.5-5,10-20,2-5,2.5-12,2.5-3,2.5-3.5,3.5-4,30,4-8,5-12,5-25-flowered,7-18,abaxial,acute,anther,apex,bark,base,berry,branch,branched,calyx,capitate,cm,corolla,dark,dendritic,densely,ellipsoid,elliptic,elongate,erect,exserted,filament,flattened-reniform,fleshy,fruiting,glabrous,globose,green,growth,incrassate,inflorescence,later,lateral,leaf,lobed,long,many,margin,minute,minutely,mm,ovary,pair,pale,papillae,pedicel,petal,petiole,plant,pore,prominent,pubescent,reddish,reddish-brown,scar,shaped,shrub,small,spaced,sparsely,stem,stigma,strongly,style,surface,tan,tear-drop,terminal,time,tree,tree-like,trichome,truncate,tube,type,unevenly,vein,way,white	1-1.5,1.5-2,?,adaxial,along,anthesi,apar,blade,body,brow,campanulate,christmas-tree-like,congested,deltate,dia,eaf,edicel,eed,either,flat,free,glabrate,immature,inflorescenc,like,lobe,lon,loose,lower,main,middle,new,nflorescence,older,papillo,pitted,planar,plurifoliat,poricidal,portion,rest,ruit,stout,tall,thick,thickened,tip,tub,ud,upper,variable,wide,widest,within,woody,ympodia,young	apart,appressed,branching,brown,bud,colour,connective,diameter,exsertion,flower,form,fruit,hair,height,inflated,length,mature,na,papillose,plurifoliate,position,seed,shape,sympodia,width
526	wfo-0001032308	success	190	144	110	80	34	0.579	1-10,1-2,1.5-2.5,1.8-2.5,2,2-6,3-10,4-7,4-8,6,abaxially,absent,acute,adaxially,anther,apex,axillary,base,broadly,brownish,bud,cell,ciliate,cm,condition,cordate,corolla,covering,cuneate,deep,distal,dorsally,drying,edge,elliptic,filament,flat,flower,folded,forked,fresh,fruit,generally,glabrous,globose,green,green-white,greenish,hair,hair-like,half,interjected,invested,irregular,lanceolate,lateral,leaflet,lengthening,lobed,long,make,margin,medium,minute,minutely,mm,mucilaginous,narrowly,non-glandular,obtuse,odd-pinnate,orbicular,ovate,ovoid,pedicel,peduncle,pentagonal,petiole,plant,plurifoliate,pore,poricidal,puberulent,pubescent,pure,ripe,rounded,seed,shape,short,slightly,slit,substellate,subtending,sympodial,terminal,testal,thick,throughout,tip,tri-,trichome,truncate,typically,unit,usually,wall,wet,white,whitish	0-3,0.2-2.1,0.3-5,0.7-1,0.7-1.2,1.9-3,12-16,2-3,2-4,3-6,3.8-5,4.8-7.7,5-7,5-merou,6-11,8-9,acumen,ag,along,alyx,apart,apparently,articulated,axe,berry,blade,capitat,chartaceous,clavate,connivent,diameter,digestion,dot,eaf,eed,enzyme,especially,exceeding,geminat,glabrou,greatly,hal,homostylous,honeycomb-shaped,larger,leave,like,living,lobe,lower,membranous,midrib,much,nflorescence,often,orolla,pair,perfect,petiolulate,petiolule,removed,ruit,scattered,sessile,seudostipule,spaced,specimen,stamen,ste,stem,stigma,straight,style,tamen,tube,vary,varying,wide,x,yellow	60-100,age,arrangement,articulation,branching,calyx,colour,connective,dioecious,form,fruiting,growth,height,herb,heteromorphism,inflorescence,leaf,length,marking,modification,na,number,position,pseudostipule,reproduction,spacing,spot,staman,stellate,stone,structure,symmetry,texture,zygomorphy
527	wfo-0001032335	success	215	139	100	115	39	0.465	.5,0.2â0.3,0.4,15,16,1â1.5,1â3,2.5â3,2â10,2â5,4â14,5â6,6â19,acuminate,acute,anther,apex,articulated,attenuate,base,berry,branched,branching,bright,c.,calyx,cell,chartaceous,cm,connivent,corolla,densely,diameter,drying,ellipsoidal,elliptic,entire,evenly,filament,fruiting,globose,gold,growth,inflorescence,length,lengthening,like,lobed,long,loosely,lower,many,margin,membranous,mm,moderately,multangulate,narrowly,new,onto,orange,pale,pedicel,peduncle,peltate,perfect,persistent,petiole,plane,plurifoliate,pore,poricidal,porrect,porrect-stellate,pubescent,ray,reddish,ripe,sessile,short-stalked,shrub,simple,slit,small,somewhat,stellate,stem,surface,terminal,time,tip,tree,trichome,unit,upper,varying,way,white,â4,âstellate	'',.2,0,0.05,0.2,0.5,0.5â1,0.9â1,1.5â2,100,100+,10â12,12â15,1â1.2,2â2.5,3361,4â5,4â6-rayed,5-merou,6â6.5,7â10,>,abaxial,abaxially,adaxial,ag,along,alyx,anthesi,apar,appearing,ark,axe,beneath,boh,capitate,center,closely,covered,cup-shaped,deltate,dichasia,discolorous,eaf,eed,elongate,equal,erec,exserted,fide,flattened-reniform,flower,free,fused,glabrous,golden-brow,golden-yellow,gradually,half,ilament,impressed,lamina,less,lobe,markedly,midpoint,minute,minutely,narrowing,near,nflorescence,nodding,older,orolla,pair,papillo,part,per,pericarp,pitted,portion,primary,pubescence,reflexed,regularly,ruit,scar,scurfy,shiny,short,silvery,slightly,sometimes,spaced,sparsely,square,stigma,stout,strongly,stub,style,tal,tem,testal,thin,tube,ud,unevenly,vary,vein,visible,wide,woody,yellow,ympodial	age,articulation,bark,breeding,colour,connective,dichasial,form,fruit,golden-brown,hair,height,heteromorphism,insertion,leaf,marking,na,odour,orientation,placement,plant,position,prickle,pseudostipule,rhizome,shape,spot,staman,stone,structure,symmetry,sympodial,system,texture,tuber,type,width,xylopodia,zygomorphy
528	wfo-0001032337	invalid_json	225	147	119	106	28	0.529	0.4-1.5,0.5-3.5,1-2,1.2-2.8,1.4-2,1.5,2-3.5,2-7,2.3-11.5,3-4,3-8,3.6-5,4-17,4-6,4-9,4.5-14.5,8-10,8-17,9-29,abaxially,adaxially,anther,berry,blade,borne,brownish,canescent,cell,chartaceous,clavate,cm,condition,connivent,corolla,covering,darker,deep,densely,diameter,distal,dot,drying,end,filament,flower,forked,fresh,fruit,generally,glabrous,globose,green,green-white,greenish,hair,hair-like,half,herb,homostylous,lanceolate,lateral,leaf,leaflet,lengthening,light,like,make,membranous,mm,mottled,mucilaginous,odd-pinnate,often,ovoid,pair,pedicel,peduncle,pentagonal,petiole,plant,pore,poricidal,pubescent,purple,ray,ripe,rotate,scattered,seed,short,singly,size,slit,sometimes,sparsely,stem,stigma,straight,style,subglabrous,terminal,testal,thick,throughout,tip,tube,tuber,typically,unwinged,usually,violet,violet-purple,wall,wet,white,whitish,wide,wing,x	0,1,1-10,1-4,1.6-4,10,2,2-14,2-4,2-4.5,2.3-4.8,5-11,5-merou,9-21,acumen,acuminate,acute,ag,along,alyx,apart,apex,apiculate,apparently,articulated,attenuate,axe,axillary,base,basiscopic,broadly,bud,capitat,ciliate,cordate,cuneate,decurrent,digestion,dorsally,eaf,edge,eed,elliptic,enzyme,erec,especially,exceeding,except,flat,folded,frequently,geminat,glabrou,greatly,honeycomb-shaped,interjected,living,lobe,long,lower,margin,middl,midrib,minutely,nflorescence,oblique,obtuse,orbicular,orolla,ovate,paired,perfect,petiolulate,petiolule,plurifoliate,proximal,puberulent,rarely,reduced,removed,rounded,ruit,sessile,seudostipule,side,slightly,small,spaced,specimen,stamen,ste,stolo,subequal,subsessile,subtending,tall,tamen,tem,tertiary,tissue,tri-,unit,unpaired,vary,yellow,ympodial	'',[,``,abaxial,adaxial,age,arrangement,branching,calyx,capitate,characteristic,colour,form,growth,height,inflorescence,length,ovary,presence,pseudostipule,shape,staman,stolon,symmetry,texture,value,{,}
529	wfo-0001032344	success	157	110	58	99	52	0.369	1-4,1.5-6,3-7,3.5-6.5,absent,apex,apical,apically,articulate,base,bluish,branched,calyx,cell,cm,connate,corolla,cuneate,dark,dehiscent,dichasially,distal,dot,filament,globose,green,hair-like,half,herbaceous,interjected,leaf,leaflet,long,medium,mm,oblique,odd-pinnate,pattern,pedicel,perennial,perfect,petiole,plant,poricidally,proximal,puberulent,pubescent,purple,rotate,rotate-pentagonal,scarce,smooth,tuber-bearing,typically,unit,violet,white,Â¼	0.2-0.5,1-1.3,1-3,1.5-4.5,1.6-2.4,10-29,2-2.8,2-3,2.2-4,2.8,3-5,3-6-foliat,3-8.5,3-9,4-11,4-8,5-10,6-15,9.5-21,abaxially,abruptly,acumen,acuminate,acute,adaxially,belo,broadly,covering,cyme,decurrent,diameter,dichasial,digestion,diminishing,dorsally,eaf,ebracteate,edge,eed,elliptical,emoval,enzyme,exceeding,flower,forked,generally,globo,green-white,honeycomb,inrolled,introrse,lateral,layeral,living,lobe,lon,long-attenuate,lower,lunat,make,maturing,monochasial,mucilaginous,nflorescence,nther,often,orolla,ovate,ovoid,pair,peduncle,petiolule,plan,reveal,ruit,seed,sessile,seudostipule,short,size,slit,sometimes,specimen,stamen,stigma,straight,style,tal,tem,terminal,testal,thick,throughout,toward,vary,wall,wide,yellow,ympodial	3-6-foliate,7,anther,appressed,articulation,bract,branching,breeding,colour,connective,form,fruit,fruiting,growth,hair,heteromorphism,inflated,inflorescence,insertion,interpetalar,length,lunate,margin,marking,mature,modification,na,odour,orientation,paired,placement,pore,position,present,prickle,pseudostipule,rhizome,scale,shape,spot,staman,stone,structure,symmetry,sympodial,system,texture,tissue,tuber,type,xylopodia,zygomorphy
530	wfo-0001032354	success	171	109	57	114	52	0.333	1-3,3-4,38/2,40-75,anther,apex,aster,axillary,base,becoming,berry,branch,branched,calyx,cell,colour,corolla,cuneate,filament,fork,glabrous,glandular,globose,green,greenish-ivory,hair,leaf,lower,maturity,mm,narrow,occasionally,oval,ovoid,pebble-shaped,pedicel,pinnatisect,pore,poricidal,rather,rh,rotate,shape,shrub,simple,slit,somewhat,stellate,stem,stone,surface,tip,trichome,unit,unpleasant,violet,wing	0,0-5,0.3,0.5-1,0.8-1,0.8-1.2,1-10,1-2,1-5,10-lobed,2,2-2.5,2.5-3,25,250-400,29,4-6,5-10,5-15,acuminate,acute,almost,angular,anthesi,aspect,axi,bilobed,broadly,brown,c.,campanulate,capitate,cm,coarsely,creating,cut,decurrent,deep,deeply,dia,discoidal,distal,eaf,eed,effect,ellipsoid,except,exerted,facetted,fleshy,flower,general,gre,gree,greyish,halfway,lanceolat,large,lasting,lengthening,linear,lobe,lobed,midrib,minute,minutely,nflorescence,obovate,obovoid,ovary,ovate,pair,pale,pedicellate,peduncle,plurifoliat,puberulent,pubescent,rounded,rugose-reticulate,ruit,secondary,seedling,several,shoot,single,sinus,size,slightly,small,smaller,smel,soft,sparse,spreading,stigma,straight,strongly,style,tall,tub,ud,uniseriate,usually,variable,vein,wide,within,wooded,woody,x,year,ympodial,young	appressed,articulation,bract,branching,breeding,broad-based,connective,decurren,form,fruit,fruiting,growth,heteromorphism,inflated,inflorescence,insertion,interjected,interpetalar,leaflet,length,margin,marking,mature,modification,na,needle-like,odour,orientation,paired,pattern,petiole,placement,plurifoliate,position,prickle,pseudostipule,rhizome,scale,smell,spot,staman,structure,symmetry,sympodial,system,texture,tissue,tuber,type,vegetative,xylopodia,zygomorphy
531	wfo-0001032358	success	216	109	65	151	44	0.301	0.5-3,12-20,2-3,3-4,4-8,anther,apex,base,berry,branched,calyx,cell,cm,cordate,corolla,curved,difoliate,entire,expanding,filament,fruit,fruiting,furcate,geminate,globose,green,growth,inflorescence,internodal,interpetalar,leaf,long,longer,lower,margin,markedly,membranous,mm,pedicel,perfect,persistent,petiole,pore,poricidal,present,prickle,purple,ripening,rotate-stellate,shrub,simple,sinuate,slightly,staman,stellate,stem,strongly,surface,time,trichome,type,unisexual,unit,yellowish,zygomorphic	.1,.2,.3,.4,.5,/2,0,0.2-4,0.6-0.8,0.6-1,0.7-1,1-1.6,1-2,1.3-1.7,1.5-2,1.5-2.5,1/4-1/2,13-20,15-40,2,2-10,2-4,2-5,2.2-7.5,3-10,3.5-13,4-4.5,4-7,4-merous,4.5-5,abaxially,abscissio,acute,adaxially,along,another,anthesi,apart,appearing,armed,away,bark,basal,based,broad,brown,bulbous,capitate,center,cupuliform,densely,diameter,dorsal,drying,eaf,eed,equal,erect,exserted,flattened,flower,free,frui,glabrescen,glabrescent,glabrous,heteromorphic,irregular,irregularly,lamina,left,lengthening,like,linear,lobe,lobed,lowermost,margined,maturity,midpoint,midrib,midvein,minutely,new,nflorescence,nodding,occasionally,often,older,one,orangish,ovate,ovoid,pair,pale,paler,papillat,papillate,part,peduncle,peg,per,pericarp,pitted,planar,porrect,portion,prickly,primary,pubescent,ray,red,reniform,rhachi,ruffly,ruit,scar,sessile,shiny,short,short-stalked,sinus,slit,small,sometimes,somewhat,space,spaced,sparsely,spreading,stigma,style,tan,thick,thin,three,tip,tub,tube,tuberculate,two,ud,unevenly,upper,usually,vein,way,whitish,widely,x,ympodial	appressed,articulation,bract,branching,breeding,broad-based,colour,connective,form,hair,heteromorphism,inflated,insertion,interjected,leaflet,length,marking,mature,modification,na,needle-like,odour,orientation,paired,pattern,placement,position,pseudostipule,rhizome,scale,shape,smell,spot,stone,structure,symmetry,sympodial,system,texture,tissue,tuber,vegetative,xylopodia,zygomorphy
532	wfo-0001032367	invalid_json_followup	231	161	98	133	63	0.424	.4,0.4-0.5,1.2,100-300,2-3-celled,2-4,3-5,3-celled,5-merous,6-8,8,accrescent,acicular,acute,anther,apex,base,berry,branch,broad-based,calyx,capitate,cm,conical,cordate,dark,diameter,erect,filament,flattened-reniform,flower,free,fruiting,geminate,glabrous,gland-tipped,globose,green,greenish,hair,heterostylous,hyaline,immature,inflorescence,lateral,leaf,length,light,lobe,lobed,long,lower,many,margin,maturity,membranous,minutely,mm,mottled,nearly,obtuse,ovary,ovate,pair,pale,pedicel,per,petiole,pore,poricidal,prickle,recurved,red-brown,sessile,shallow,shrub,simple,size,somewhat,spreading,stellate,stem,stigma,straight,style,suborbicular,surface,tapering,tip,triangular,trichome,truncate,unbranched,uniseriate,usually,white,wide,yellow	-3,.2,0-0.3,0.2â0.35,0.4â0.5,0.4â0.6,0.4â1,0.5â0.8,0.5â2,0.6,0.6â0.8,0.7-1.1,0.8,0.8â2,1-2,1-2.1,1â1.5,1â1.8,2,2.2â2.5,2.2â2.8,2.5â3,2â2.5,3.2â4,3â10,3â5,3â6,4,4â6.5,5.5â6.9,5â18,6.8â8.2,7â10,abaxial,abaxially,adaxial,adaxiall,adaxially,also,alyx,anthesi,arme,around,axi,ba,blade,congested,connivent,copious,cream,curved,deciduous,densely,difoliate,directed,distall,eaf,eed,enlarged,entire,equal,expand,fertile,geminat,glandular-puberulent,grading,herbarium,infructescence,lanceolate,largest,layer,least,long-styled,longer,lowermost,major,mesocarp,midpoint,minute,mixed,mixture,moderately,narrowly,nflorescence,often,one,orolla,oung,papillat,peduncle,portion,prickly,puberulent,pubescence,pubescent,rarely,ray,rest,ruit,scarcely,scattered,secondary,short-styled,shorter,similar,slender,small,smaller,sparsely,specimen,spongy,spreadin,staminat,ste,tall,tamen,terete,thick,tightly,time,tooth,tube,twice,unarmed,uniformly,unit,variable,vary,vein,whitish,ympodial,â15,â5	'',0.2-0.35,0.4-1,0.5-2,1-1.8,15,2.2-2.5,3-6,5-18,5.5-6.9,6.8-8.2,7-10,[,``,appressed,armed,arming,articulation,bract,branching,breeding,characteristic,colour,connective,corolla,form,fruit,growth,height,inflated,insertion,interjected,interpetalar,leaflet,marking,mature,modification,na,needle-like,number,odour,orientation,paired,papillate,pattern,placement,plant,position,scale,seed,shape,smell,spot,staman,symmetry,system,texture,tissue,type,value,vegetative,{,}
533	wfo-0001032407	invalid_json	216	140	115	101	25	0.532	0-4,0.4-4,0.5-3,1-10,1-2,1-2.4,1.2-7,1.4-2.7,1.5-2.2,10-19.5,10-27,2-10.5,2.5-10.5,2.5-9,3-15,3.1-13.5,4-11,4-48,4-7,5,5-23,5-30,7-9,8-10,abaxially,adaxially,anther,berry,blade,brownish,cell,chartaceous,ciliate,clavate,cm,coarsely,condition,conical,corolla,covering,dark,densely,diameter,drying,edge,filament,finely,flower,folded,forked,fresh,fruit,glabrous,green,green-white,greenish,hair,hair-like,herb,homostylous,interjected,lanceolate,lateral,leaf,leaflet,lengthening,light,like,lobe,make,margin,medium,membranous,minute,minutely,mm,moniliform,mottled,mucilaginous,odd-pinnate,ovoid,pedicel,peduncle,pentagonal,petiole,plant,pore,poricidal,puberulent,pubescent,purple,rarely,ripe,rotate,seed,simple,size,slit,sparsely,stem,stigma,straight,style,terminal,testal,thick,throughout,tip,tube,tuber,wall,wet,white,whitish,x	0.3-0.6,0.3-8,0.8,0.8-0.3,1-5,12,2-4,30,38,5-merou,6,absent,acumen,acuminate,ag,along,alyx,apart,apex,apparently,arranged,articulated,asymmetrical,attenuate,axe,axillary,base,basiscopic,bead,bud,capitat,commonly,connivent,decreasing,digestion,distal,eaf,eed,elliptic,elongated,enzyme,erec,especially,exceeding,geminat,generally,glabrou,gradually,half,honeycomb-shaped,larger,less,living,long,lower,middle,multiple,narrow,necklace,nflorescence,obtuse,orbicular,orolla,ovate,pair,perfect,petiolule,plurifoliate,proximal,pubescen,ray,removed,round,ruit,secondary,semierect,sessile,seudostipule,side,spaced,specimen,stamen,ste,stolon,subequal,subtending,symmetrical,tall,tamen,tem,tissue,tri-,typically,unit,unwinged,usually,vary,wide,wing,yellow,ympodial	'',[,``,age,arrangement,branching,calyx,capitate,characteristic,colour,form,growth,height,inflorescence,length,ovary,pseudostipule,shape,spacing,staman,texture,value,width,{,}
534	wfo-0001032465	success	233	131	82	151	49	0.352	1-1.5,1/3,2,3-4,4,9,anther,apex,articulated,axi,base,berry,black,branched,calyx,cell,connivent,cordate,coriaceous,corolla,deeply,densely,ellipsoid,filament,filiform,fruiting,glandular-tipped,globose,growth,inflorescence,later,lateral,leaf,leaving,length,lengthening,lobe,lobed,loosely,lower,margin,mature,membranous,minute,mm,pair,paired,pedicel,peg,perfect,petiole,pinnate,pinnatifid,pore,poricidal,pubescent,purplish,ripe,shape,simple,sleeve,slit,sparsely,stellate-rotate,stem,surface,terminal,time,tiny,tip,trichome,truncate,twining,uniseriate,unit,vine,violet,way,white,woody,x,Â½	+,-10,-11,-14,-9,.2,.5,0,0.2,0.5-,0.5-2,1-,1-1.7,1-celled,1.2-1.5,1.5,1.5-1.8,1.5-2,1.5-5,2-2.5,2.5-5.5,25,3-3.5,3-5,3-8,3-9,5,5-7,5-8,5-merou,abaxial,acuminate,acute,ag,alyx,angled,anthesi,apar,apically,appearing,ark,basal,brown,capitate,ciliate,clasping,cm,commonly,conical,de,decreasing,deep,deeper,deltate,diameter,distal,drying,eaf,edge,eed,elliptic,elongate,entire,erect,exserte,flattened,flower,free,fringe,glabrescen,glabrous,gland,glandular,green,greenish,growing,half,ilament,included,irregular,irregularly,janeiro,larger,like,long,minutely,narrowly,new,nflorescence,nodding,occasionally,often,older,orolla,outline,ovate,papillate,papillo,peduncle,pendan,pentagonal,per,pericarp,planar,plurifoliat,portion,primary,puberulent,reddish,reniform,reticulate,revolute,rio,ruit,scar,scattered,seed,shallow,shiny,similar,sinus,size,somewhat,spaced,splitting,stigma,strongly,style,subshrub,tem,testal,thicker,thin,toward,transparent,tube,tuft,twinin,ud,unicellular,upper,usually,variously,vary,varying,vein,wall,widest,yellowish,ympodial,young	5-merous,age,appressed,articulation,bract,branching,breeding,broad-based,colour,connective,form,fruit,hair,heteromorphism,inflated,insertion,interjected,interpetalar,leaflet,marking,modification,na,needle-like,odour,orientation,pattern,placement,plurifoliate,position,prickle,pseudostipule,rhizome,scale,smell,spot,staman,stellate,stone,structure,symmetry,sympodial,system,texture,tissue,tuber,type,vegetative,xylopodia,zygomorphy
535	wfo-0001032494	invalid_json	163	120	90	73	30	0.552	.4,.5,0.6-1,0.75-1,0.8-1,0.9-1.2,1-1.5,1.45-1.5,1.5,1.5-8,1.6-2,1.8-4.5,2.3-2.5,2.5-8,3.4-14.5,3/4,5-40,acuminate,anther,anthesi,apart,apex,attenuate,axil,base,beneath,brown,calyx,clavate,cm,corolla,decurrent,expanded,filament,flattened-reniform,fruit,fruiting,furcate,glabrous,globose,incrassate,leaf,light,lobe,lobed,margin,minor,minutely,mm,narrowly,occasionally,opposite,ovary,ovate,pale,papillae,papillose,pedicel,petiole,pitted,pore,prominent,pubescent,raised,scar,shaped,shrub,simple,size,small,stem,stigma,style,surface,tan,tear-drop,tip,tree,trichome,tube,two-winged,uniseriate,upper,venation,way,white,whitish-green,winged,x,yellow	.1,1.1-1.2,16.5-20.5,2.5,3-4,4-8,5-6.4,8-11,accrescent,appearing,ba,bark,beginning,berry,bullate,deflexed,dia,differing,difoliate,dry,eaf,edicel,eed,equal,evenly,except,exserted,flowered,free,geminat,geminate,greenish-yellow,inflorescenc,lateral,lax,lenticellat,lon,long,lower,main,major,material,middle,nearly,nflorescence,node,orange,ovoid,pair,papillo,planar,poricidal,portion,proximal,quite,revolute,ridge,ruit,slender,slightly,somewhat,spaced,straight,tall,tapering,triangular,ud,unit,vein,widest,woody,ympodial,zig-zag	'',[,],``,branching,characteristic,colour,diameter,flower,form,glabrousnes,growth,height,inflorescence,length,lobing,number,plant,position,seed,shape,spacing,texture,type,value,winging,ye,zig-zagging,{,}
536	wfo-0001032507	invalid_json	206	185	143	63	42	0.694	.2,.5,/4,0.25,0.3,0.5,0.8,1,1.3,1.5â7,10â20,15â20,1â1.5,1â10,2,2.5â4,20â30,3â5,3â7,5â10,5â20,5â8,6,8â15,abaxial,abaxially,absent,acuminate,acute,adaxially,anther,apex,armed,articulated,base,becoming,blue,branched,broadly,brown,bud,calyx,cell,chartaceous,cm,collection,compound,connivent,corolla,cream,curved,deltate,diameter,distally,ellipsoid,elliptic,entire,exserted,fertile,filament,flattened-reniform,flower,flowering,four,fruiting,glabrous,globose,green,hair,herbaceous,herbarium,internode,lateral,leaflet,lengthening,light,lobe,long,major,margin,material,midrib,minutely,mm,narrowly,oblong,occasionally,often,one,ovate,pale,pedicel,peduncle,pentagonal,perennial,pericarp,petiole,pinnate,pinnately,pinnatifid,pistillate,pitted,pore,poricidal,present,prickle,puberulent,pulp,purple,purplish,rachi,rarely,reddish,rotate-pentagonal,rounded,rugose,shape,side,simple,slit,sometimes,staminate,stem,stigma,straight,strongly,style,surface,testal,time,tip,tube,unbranched,variously,vein,vine,way,white,wide,widest,woody,yellowish,Ã	0.7-1.2,1.2-1.7,1.5â2,2.5â6,2â9,4â10,abundant,adaxiall,adjacent,ag,alyx,anthesi,apiculate,berry,blade,campanulate,confluent,deep,distinct,dr.,eaf,eed,either,elongating,equal,fifth,highly,individual,interpetalar,larger,lobed,longer,lower,nearly,nflorescence,observe,orolla,papery,plant,plurifoliat,quadrate,ranging,recurve,regularly,ruit,single,sinus,slender,slightly,spreading,stout,tamen,tear,terminal,tissue,unequal,unit,unlobed,usually,variable,vary,wood,ympodial	'',[,``,age,armament,arrangement,articulation,branching,characteristic,colour,dry,exsertion,form,fruit,growth,hairines,herbaceousnes,inflorescence,leaf,length,lobing,number,observed,orientation,ovary,perenniality,plurifoliate,position,presence,ratio,recurved,seed,size,staman,symmetry,texture,type,value,width,woodines,{,}
537	wfo-0001032523	success	200	96	73	127	23	0.365	-5,.2,/4,0.6-0.7,0.6-0.8,1.5-3,3.5-4,5-20,acuminate,anther,apex,base,berry,branching,calyx,cm,cuneate,curved,discolorous,drying,dull,elliptic,entire,evenly,filament,filiform,flattened-reniform,free,fruit,fruiting,gently,green,inflated,lateral,leaf,length,lobed,long,lower,margin,maturity,mauve,membranous,mm,orange-brown,ovate,per,petiole,poricidal,portion,prickle,primary,red,reflexed,secondary,shrub,simple,sometimes,spherical,stem,straight,strongly,style,subentire,surface,tapering,terminal,tip,tube,way,weakly,yellow,young	-2,.5,0-0.15,0-10,0-12,0-15,0-3,0.1-0.2,0.2,0.2-0.4,0.3-0.5,0.4-1,0.4-1.5,0.5-1,1-1.5,1-2,1-3,1-8,1.3-1.6,1/3-1/2,1/4-1/3,10-50,15-30,2,2-2.4,2-2.5,2-4,2-5.5,2.5-6,2.7-3,3-15,3-4,4-5-merous,4-7,5-12,6-10,6-20,6-8,abaxial,abaxially,acuminat,acute,adaxial,alyx,ame,apar,apart,apically,apparently,articulated,bark,blade,brow,c.,conical,connivent,deltate,diameter,eaf,eed,elongating,equal,erect,flower,glabrescent,glabrou,glabrous,hair,herbaceous,infructescence,lobe,lon,longer,mature,midpoint,minute,moderately,multangulate,narrow-deltate,nflorescence,older,one,open,orange,orolla,oung,pair,pale,pedicel,peduncle,perfec,pericarp,perpendicular,plurifoliat,porrect,prickly,ray,recurved,red-brown,ruit,scandent,scar,sessile,smooth,spaced,sparsely,spreading,stalk,stalked,stellate,stellate-pubescent,tamen,terete,tertiary,time,trichome,unarme,unarmed,unit,variously,vary,vein,venation,visible,wide,woody,ympodial	appressed,broad-based,colour,corolla,form,growth,inflorescence,na,needle-like,number,odour,orientation,placement,position,present,seed,shape,smell,symmetry,texture,type,vegetative,zygomorphy
538	wfo-0001032524	invalid_json_followup	205	170	118	87	52	0.576	1-2,1-2.5,1.5-2,1.5-4,10-35,12-13,14-50,2-5,2.5-8,25-90,4.5-8,5-9,6-13,6-16.5,7-8,abaxially,acumen,adaxially,anther,apex,articulated,axillary,base,berry,blade,brownish,bud,cell,chartaceous,clavate,cm,condition,connivent,corolla,covering,cuneate,densely,diameter,distal,dorsally,drying,edge,filament,flat,flower,folded,forked,fresh,fruit,glabrous,globose,grayish-green,green,green-white,greenish,hair,half,herb,homostylous,interjected,lanceolate,lateral,leaflet,length,lengthening,light,lilac,lower,make,margin,membranous,middle,minutely,mm,moniliform,mucilaginous,multicellular,odd-pinnate,ovoid,pair,pedicel,peduncle,pentagonal,petiole,plant,pore,poricidal,puberulent,pubescent,purple,ripe,rotate,rounded,seed,silky,silvery-white,size,slit,stem,stigma,straight,style,subtending,terminal,testal,thick,throughout,tip,trichome,tube,tuber,typically,unwinged,violet,wall,wet,whitish,x	1-10,120-210,2-3,3-4,3-5,3-8.5,3.5-4.5,4,4-5,4.5-5,5-6,5-merou,50-70,7-35,?,acute,ag,along,alyx,apart,apparently,arranged,ascending,attenuate,axe,bead,capitat,ciliate,different,digestion,eaf,eed,elliptic,enzyme,erec,especially,exceeding,except,geminat,generally,glabrou,greatly,hair-like,hal,head,honeycomb-shaped,like,living,lobe,long,midrib,multiple,narrowly,necklace,nflorescence,non-glandular,obtuse,often,orolla,ovate,perfect,petiolulate,petiolule,plurifoliate,proximal,reduced,removed,ruit,sessile,seudostipule,short,spaced,specimen,stamen,ste,stolon,subequal,tall,tamen,tem,tetralobulate,tri-,unit,usually,vary,yellow,ympodial	'',[,\u201chair-like\u201d,``,age,appressed,arrangement,articulation,bract,branching,breeding,broad-based,calyx,capitate,characteristic,colour,connective,form,fruiting,growth,height,inflated,inflorescence,insertion,interpetalar,leaf,marking,mature,modification,na,odour,ovary,paired,pattern,position,prickle,pseudostipule,scale,shape,smell,spot,staman,surface,symmetry,system,texture,tissue,type,value,vegetative,{,}
539	wfo-0001032532	success	161	98	70	91	28	0.435	0.3-2.5,1-4,1.5-2.6,1.5-4.3,13-52,15-30,2-10,2-13,2-3,2.8-3.6,2.8-9.5,3-10,3.4-12.2,4-5.5,6,6-22,8-38,absent,acumen,apically,branched,cm,conical,connate,corolla,cyme,deep,dehiscent,diameter,dichasially,distal,edge,filament,finely,flat,flower,forked,green,green-white,hair-like,herbaceous,interjected,lateral,leaf,leaflet,light,medium,minute,mm,odd-pinnate,ovoid,pair,pedicel,peduncle,perennial,petiole,plant,poricidally,proximal,pubescent,purple,rotate,seed,straight,style,terminal,tuber-bearing,unit,wall,Â¼	0-.,1-1.5,1.5-3.2,2,2-,3-5,3-6-foliat,3.7-10,4.5,abaxiall,abaxially,acuminate,acute,adaxially,apex,apical,articulate,attenuate,base,calyx,cell,coarsel,covering,cuneate,dichasial,digestion,diminishing,dorsally,eaf,ebracteate,eed,elliptical,emoval,enzyme,exceeding,folded,generally,globo,gradually,half,honeycomb,introrse,living,lobe,lon,long,long-attenuate,lower,lunat,make,maturing,monochasial,mucilaginous,narrowly,nflorescence,nther,oblique,obtuse,often,orolla,ovate,pattern,perfect,petiolule,plan,reveal,rounded,ruit,sessile,seudostipule,short,size,slit,specimen,stamen,stigma,subequal,subsessile,tal,tem,testal,thick,throughou,throughout,tip,toward,typically,vary,wide,yellow,ympodial	0-2,2-5,3-6-foliate,anther,arrangement,articulation,branching,coarsely,colour,form,fruit,growth,height,inflorescence,length,lunate,number,ovary,pore,present,pseudostipule,shape,stem,structure,sympodial,texture,type,width
540	wfo-0001032536	success	254	119	77	177	42	0.303	14-16,2-3,4-9,abruptly,anther,apex,appressed,articulated,base,berry,bright,broad-based,calyx,cell,chartaceous,cm,curved,densely,depressed,difoliate,equal,fading,filament,fruit,fruiting,geminate,globose,growth,heterostylous,inflorescence,interpetalar,juvenile,lateral,leaf,leaf-opposed,length,long,lower,margin,mature,membranous,mm,narrowing,oblique,odor,once-branched,papillate,pedicel,pentagonal,petiole,plant,pore,poricidal,porrect,potato,prickle,prickly,purple,shallowly,simple,slightly,somewhat,sparsely,stellate,stem,surface,tapering,tip,tissue,tree,trichome,truncate,unequal,unit,usually,white,yellow-green	-3,/3,0.5,1,1-2,1-2.5,1.3-2.2,1.5,10,10-20,10-30,10-50,100,13-24,2.5-3,20-22,20-25,20-50,3,3-3.5,3-6,4-6,4-8,5,5-6,5-8,5-merous,5.5-8,7-10,<,>,abaxial,abaxially,acute,adaxial,adaxiall,adaxially,age,almost,along,alyx,angle,anthesi,apar,armed,around,axi,bark,basal-most,berr,blade,bristle,bristly,broadly,brown,capitate,caudat,caudate,clavate,clearly,conical,coriaceous,cu,dark,dbh,deeply,deltate,denser,diameter,directed,diverging,eaf,eed,elliptic,enlarged,entire,evenly,flattened,flower,free,glabrescent,glabrous,glandular,glandular-puberulent,grayish,halfway,hanging,inflorescenc,infructesecnce,irregularly,lamina,leaving,like,lobe,lobed,long-stalked,long-styled,maturity,midpoint,midrib,midvein,minute,minutely,mixed,mixture,multangulate,multiseriate,narrowly,near,new,nflorescence,number,occasionally,occurring,older,olive-green,open,orolla,oung,ovary,papillae,papillat,part,peduncle,per,pericarp,portion,prickl,primary,prominent,protuberance,pubescent,rarely,ray,reddish,reniform,reproductive,rough,ruit,scar,scattered,short-,short-styled,slender,small,smooth,soft,spaced,spreading,stalk,staminate,stellate-pubescent,stigma,strongly,style,tall,tamen,terete,terminal,thick,time,triangular,trunk,tube,unarmed,upward,urceolate,vary,vein,visible,way,wide,wood,woody,yellowish,ympodial,younger	articulation,bract,branching,breeding,colour,connective,corolla,form,hair,heteromorphism,inflated,insertion,interjected,leaflet,marking,modification,na,needle-like,odour,orientation,paired,pattern,placement,position,pseudostipule,rhizome,scale,shape,smell,spot,staman,stone,structure,symmetry,sympodial,system,texture,tuber,type,vegetative,xylopodia,zygomorphy
541	wfo-0001032542	success	161	126	74	87	52	0.46	0.5-1,1-1.3,1-1.5,1-5,1.5-3.5,2-3,2-3.5,2.5-5,3-4,4.5-5,5-8,abaxial,anther,apex,attenuate,bark,base,bluish-green,bright,brown,calyx,capitate,cm,conical,corolla,dark,deflexed,dendritic,densely,difoliate,elliptic,elliptic-obovate,filament,flattened-reniform,fruiting,glabrous,globose,golden,green,growth,inflorescence,leaf,less,lobed,long,margin,minor,mm,opposite,ovary,pedicel,petiole,pore,pubescent,reddish-brown,rounded,shape,shaped,shining,shrub,size,small,somewhat,sparsely,stem,stigma,style,tear-drop,treelet,trichome,tube,unit,wide,yellow-green	.25,.25-0.5,.5,.5-1,/4,0.7-1,1-2,10-15-flowered,10-28,3-5,4-7,4-9.5,abaxially,acuminate,acute,adaxially,along,anthesi,apical,axi,ba,basal,beginning,berry,closely,compact,deltate,di,dia,differing,distal,dry,eaf,edicel,eed,either,erect,exserted,free,geminat,incrassate,inflorescenc,lamina,later,lateral,like,lobe,lon,loose,lower,main,major,minute,minutely,narrowly,near,new,nflorescence,older,overlapping,pair,papillo,persisten,pitted,planar,poricidal,portion,ruit,scar,simple,slender,slightly,spaced,strongly,surface,swollen,tip,triangular,tub,ud,vein,way,woody,x,yellowish,ympodial,young	0.25,adaxial,articulation,bract,branching,breeding,cell,colour,connective,deflexion,diameter,form,fruit,geminate,hair,heteromorphism,insertion,interjected,interpetalar,leaflet,length,marking,mature,modification,na,odour,orientation,paired,pattern,persistence,persistent,placement,position,prickle,pseudostipule,rhizome,scale,seed,spot,staman,stellate,stone,structure,symmetry,sympodial,system,texture,tissue,tuber,type,width,xylopodia
542	wfo-0001032564	success	160	141	80	80	61	0.5	0.3-1,0.75-1,1-1.2,1-1.3,1-1.5,1-2,1.5,2-2.5,4-5,6-7,anther,anthesi,apex,arched,bark,base,becoming,broadly,brown,bud,calyx,clavate,cm,conical,corolla,dark,densely,dry,elliptic,expanded,filiform,flattened,fresh,fruiting,glabrous,globose,golden,green,greenish-white,greyish-red,later,leaf,lobed,long-acuminate,lower,margin,material,minutely,mm,narrowly,nearly,opposite,ovary,ovate,ovoid-reniform,pair,pedicel,petiole,pore,puberulent,ripe,shaped,shrub,slightly,stem,stigma,style,surface,tan,tear-drop,thread-like,trichome,truncate,tube,unifoliate,unit,winged,x,yellowish-green,young	.05,.05-0.1,.1,.5,0.25-0.5,1.3-2.5,4-6-flowered,5.5-9,8-9,along,apar,apart,aspec,ba,beneath,berry,branch,converging,deflexed,deltoid,dia,eaf,edicel,eed,except,exserted,extreme,flower,geminate,giving,glabrate,halfway,lamina,lateral,like,lobe,long,main,member,middle,minute,nflorescence,node,non-reproductive,obovoi,often,older,one,open,papillo,papillose,pitted,planar,point,poricidal,projection,prominent,proximal,raised,reflexed,rounded,ruit,scar,shiny,simple,small,soon,straight,strongly,tall,tapering,time,tiny,tip,ud,uniseriate,vein,widest,woody,ympodial	0.05,0.05-0.1,0.5,2,abaxial,adaxial,articulation,bract,branching,breeding,broad-based,cell,colour,diameter,filament,form,fruit,growth,hair,height,heteromorphism,inflorescence,insertion,interjected,interpetalar,leaflet,length,marking,na,needle-like,obovoid,odour,orientation,paired,pattern,placement,plant,position,present,prickle,pseudostipule,pubescence,rhizome,scale,seed,shape,size,smell,spot,staman,stone,structure,symmetry,sympodial,system,texture,tissue,tuber,type,vegetative,xylopodia
543	wfo-0001032569	success	164	121	76	88	45	0.463	.5,/3,0.5-10,0.8-1,1-1.2,1-1.5,1-2,1.2-5,1.5,1.5-2,1.7-2,2-3,2-4,4-8,5-6,5-60-flowered,7-9,abaxially,adaxially,anther,apex,apparently,base,berry,bilobed,branched,broadly,calyx,cell,cm,conical,corolla,decurrent,dendritic,elliptic,filament,flattened,fleshy,fruiting,glabrous,globose,inflorescence,leaf,lobed,long,lower,minor,minutely,mm,occasionally,onto,opposite,ovary,ovate,pedicel,petiole,pitted,pore,present,reniform,shaped,shrub,simple,size,stem,stigma,stone,style,surface,tear-drop,thick,trichome,tube,way,white,x	1-4,4-18,7-27,acute,along,anthesi,appearing,axi,bark,bearing,brown,bullate,closely,corrugated,dark,deflexed,dense,densely,denser,dia,differing,difoliate,dry,drying,eaf,edicel,eed,ellipsoid,erect,exserted,free,geminate,golden,gra,green,incrassate,irregularly,later,lateral,lea,like,lobe,lon,los,main,major,margin,matted,mature,middle,moderately,nflorescence,obscured,open,otherwise,pair,paler,papillo,papillose,pericar,planar,poricidal,portion,pubecsence,pubescent,rich,ruit,scar,somewhat,spaced,sparsely,splitting,strongly,tall,time,tip,triangular,tub,tuft,ud,unifoliate,unit,vein,waxy,widest,woody,ympodial,young	bract,branching,breeding,broad-based,colour,connective,diameter,flower,form,fruit,growth,hair,height,heteromorphism,interjected,interpetalar,leaflet,length,marking,modification,na,needle-like,number,orientation,pattern,placement,plant,position,prickle,pseudostipule,rhizome,scale,seed,shape,spot,staman,stellate,symmetry,system,texture,tissue,tuber,type,xylopodia,zygomorphy
544	wfo-0001032576	success	229	96	66	163	30	0.288	/5,0.5-1,0.5-4,2-4,2.5-4,4-6.5,anther,apex,base,berry,branched,branching,bright,calyx,cell,chartaceous,cm,conical,cuneate,curved,difoliate,elongating,entire,equal,evenly,filament,flattened,fruit,fruiting,green,hair,herb,lateral,leaf,length,lobed,long,lower,margin,maturity,membranous,mm,moderately,petiole,poricidal,prickle,purple,red,shrub,simple,slightly,sometimes,spherical,spreading,stellate-pubescent,stem,straight,surface,tapering,terminal,tip,trichome,unit,way,white,young	-10,-12,-2,-2/3,/4,0,0-1.5,0-3,0-30,0-5,0.1,0.1-0.15,0.1-0.2,0.1-0.25,0.3-0.5,0.3-0.7,0.5-1.5,0.5-2,0.8-1.2,0.8-1.4,0.8-2,1-3,1-4,1.2-1.8,1.5-2,1.5-2.3,1.5-7.5,1.8-2.5,1/2,1/3,1/3-1/6,2-10,2-3,2-5,2.5-3,3-14,4,4-,4-5-merous,4-6,5-30,6-8,7-8,abaxially,acuminat,acute,alyx,apar,apart,apically,apparently,articulated,ascendant,ba,bark,blade,brow,brown,brown-green,concolorous,deltate,densely,diameter,distance,drying,dull,eaf,eed,ellipsoid,erect,extending,eye,faint,flattened-reniform,flower,free,geminat,glabrescent,glabrous,gland,glandular,globular,gray,herbaceous,infructescence,lanceolate,lobe,longer,mature,midpoint,midvein,minutely,naked,narrow-deltate,narrow-ovate,near,nflorescence,obovate,obtuse,often,older,one,open,orange-brown,orolla,oung,outline,ovate,pair,pale,pedicel,peduncle,per,perfec,pericarp,pit,porrect,portion,prickl,prickly,primary,raised,ray,red-green,reduced,reflexed,reticulate,rounded,ruit,scandent,scar,sessile,shiny,short,shorter,side,slender,small,smooth,spaced,sparsely,stalk,stalked,stellate,style,tamen,tertiary,time,tube,unarmed,upper,usually,variously,vary,vein,venation,visible,wide,woody,yellow,yellow-green,yellow-orange,ympodial	broad-based,colour,corolla,form,geminate,growth,heteromorphism,inflorescence,na,needle-like,odour,orientation,placement,position,pseudostipule,rhizome,scale,shape,smell,staman,stone,structure,symmetry,sympodial,texture,tuber,type,vegetative,xylopodia,zygomorphy
545	wfo-0001032595	success	200	136	88	112	48	0.44	-20,-25,1-3,1-6.5,1.5-5,15-25,2-4,25-40,3-10,3-12,3-4-foliate,4-5,abaxially,acute,also,anther,apex,basal,base,branch,branched,brownish,brownish-purple,calyx,cell,cm,connective,cordate,coriaceous,deeply,densely,dull,eglandular,ellipsoidal,entire,filament,finely,flower,fork,forked,fruit,fruiting,fusiform,geminate,glabrous,greenish,hair,homostylous,lanceolate,leaf-opposed,leaving,lobe,long,lower,margin,mature,mm,moderately,near,oblique,often,ovate,ovoid,pale,pedicel,pedicellar,peduncle,petiole,pilose,pore,puberulent,purple,rachi,rarely,remnant,shrub,simple,small,sparsely,stellate,stone,subcoriaceous,tree,truncate,unbranched,unit,violet,yellow	-pilose,0-,0.5-1,0.5-3.5,1,1-2,1-2.5,1-6,1.5-2,1.5-2.5,1.5-4.5,12-16,15-40,2-3,2.3-24,3-4,3-5,4-25,4-7,5-6,5-merou,6-7,9-14,accrescen,acuminate,adaxially,aggregate,along,alyx,apart,ape,apical,apiculate,articulated,axe,blade,ciliat,connivent,cream,crow,cucullate,deltate,dense,denser,diameter,dilated,directed,distally,eaf,eed,equal,exceeding,flattened,free,gland,glandular,larg,lon,longitudinal,loosely,m.,major,midrib,narrowly,nflorescence,opening,orolla,part,per,perfect,pilo,produced,prominent,pseudohair,pubescent,purplish,reniform,rugulose,ruit,shallow,shorter,side,single,slightly,slit,spaced,spreading,stamen,stigma,strongly,style,swelling,tall,tamen,tem,thecae,time,tip,tomentose,toward,triangular,trunk,tube,two,ud,umbrella-shaped,vary,vein,white,wide,x,ympodial	accrescent,appressed,articulation,bract,branching,broad-based,bud,colour,corolla,form,growth,height,heteromorphism,inflated,inflorescence,interjected,interpetalar,large,leaf,leaflet,length,na,needle-like,odour,orientation,pattern,placement,plant,position,prickle,pseudostipule,rhizome,scale,shape,smell,staman,stem,structure,surface,symmetry,sympodial,texture,tissue,trichome,tuber,type,vegetative,xylopodia
