	coreid	status	nwords_original	nwords_result	nwords_recovered	nwords_omitted	nwords_created	prop_recovered	common_words	original_only	result_only
0	wfo-0001025636	invalid_json_followup	208	104	60	148	44	0.288	0.1-0.3,1-10,1-2,1-3.5,1-5,1-5.5,1.4-3.5,10-45,2.5-6,6.5-10,abaxially,adaxially,anther,apex,blue,broadly,cell,clavate,cm,corolla,covering,diameter,elliptic,filament,flower,fruit,glabrous,globose,green,greenish,herb,lateral,margin,minutely,mm,moderately,mottled,odd-pinnate,ovate,ovoid,pedicel,peduncle,petiole,plant,puberulent,pubescent,purple,rotate,rotate-pentagonal,seed,slightly,stem,stigma,style,subglabrous,testal,thick,wall,whitish,yellow	0-2,0-5,0.1,0.6-2.8,1,1-2.2,1-3,1-4,1.1-6.1,1.7-5.2,1.7-9.2,1.8,2,2-4,2.6-8.3,3-5,3-6,5-merou,9.5-29.5,absent,acumen,acuminate,acute,ag,along,alyx,apart,apparently,articulated,axe,base,berry,blade,brownish,capitat,chartaceous,ciliate,clearly,condition,connivent,contracted,cuneate,decurrent,digestion,distal,dorsally,drying,eaf,edge,eed,end,enzyme,especially,exceeding,except,flat,folded,fresh,geminat,generally,glabrou,greatly,green-white,hair,hair-like,hal,half,high,highly,homostylous,honeycomb-shaped,interjected,lanceolate,larger,leaflet,lengthening,like,living,lobe,long,longer,lower,make,membranous,midrib,minute,mucilaginous,multicellular,near,nflorescence,oblique,obovate,obtuse,often,orbicular,orne,orolla,pair,perfect,petiolulate,petiolule,plurifoliate,pore,poricidal,proximal,reduced,removed,ripe,rosette-forming,rounded,ruit,scale-like,semierec,sessile,seudostipule,short,singly,size,slit,sometimes,spaced,specimen,stamen,ste,stolo,straight,subequal,tall,tamen,tem,terminal,throughout,tip,tri-,truncate,tube,tuber,typically,unequal,unforked,unit,unwinged,uppermost,vary,wet,wide,x,ympodial	'',0.1-1.8,[,\u201chair-like\u201d,``,abaxial,adaxial,arrangement,bark,bud,calyx,capitate,center,characteristic,colour,form,fruiting,growth,height,history,inflorescence,leaf,length,life,na,new,number,ovary,perennial,position,prickle,rachi,reproduction,scar,shape,spacing,staman,surface,texture,trichome,value,width,{,}
1	wfo-0001025637	success	193	119	91	102	28	0.472	0-0.3,0.2-0.9,1-12,1-2,14-38,2-20,2.5-8,2.8-4.2,3-10,3-4,3-5,5-7,abaxially,acuminate,acute,adaxially,along,anther,apex,axillary,base,bead,blue,brownish,bud,cell,clavate,cm,condition,coriaceous,corolla,covering,cuneate,dark,deep,diameter,dot,drying,elliptic,filament,flower,forked,fresh,fruit,glabrescent,glabrous,globose,green,greenish,hair-like,herb,interjected,lanceolate,lateral,leaf,leaflet,light,like,lilac,medium,mm,moniliform,necklace,odd-pinnate,onto,ovoid,pedicel,peduncle,pentagonal,petiole,plant,plurifoliate,rachi,rotate,seed,stigma,stolon,stripe,style,subtending,terminal,testal,thick,tiny,tri-,tuber,unit,wall,white,whitish,yellow	0-27,0.2-0.5,0.3-0.5,0.8-2.6,1-2.5,1-5,1.2-3.5,1.5-5,1.6-2.5,2-3,2-7,3-9,4-6,5-merou,acumen,adaxiall,ag,alyx,apart,apparently,arranged,articulated,attenuate,axe,berry,blade,capitat,connivent,decreasing,decurrent,digestion,distal,dorsally,eaf,edge,eed,enzyme,erec,exceeding,flat,folded,geminat,generally,glabrou,green-white,hair,hal,half,high,homostylous,honeycomb-shaped,lengthening,linear,living,lobe,long,lower,make,mottled,mucilaginous,multiple,nflorescence,orolla,ovate,pair,perfect,petiolulate,petiolule,pore,poricidal,purple,removed,ripe,rounded,ruit,secondary,seudostipule,short,size,slit,sometimes,spaced,specimen,stamen,straight,subequal,symmetric,tall,tamen,tem,throughout,tip,toward,tube,typically,unwinged,usually,vary,wet,wide,x,ympodial	abaxial,adaxial,arrangement,capitate,colour,decurren,form,geminate,growth,height,history,inflorescence,length,life,na,number,ovary,perennial,position,pseudostipule,reproduction,shape,spacing,staman,surface,sympodial,texture,width
2	wfo-0001025639	success	154	100	70	84	30	0.455	1-2,1-3,1-4,2-3.5,2.8-3.2,20-35,4-10,4.5-8.5,5-10,6-8,8-12,8-9,acuminate,acute,apex,apical,base,branched,broadly,cell,cm,corolla,cuneate,cyme,dark,diameter,dichasial,dichasially,distal,ebracteate,elliptic,elliptical,filament,flower,globose,green,green-white,half,herbaceous,honeycomb,interjected,introrse,leaf,leaflet,medium,mm,monochasial,obovate,odd-pinnate,ovate,ovoid,pattern,pedicel,peduncle,perennial,petiole,plant,puberulent,pubescent,rotate,seed,short,slit,stigma,style,terminal,tuber-bearing,violet,white,yellow	10-21,2-3,3-4,3-5,3-6,3-6-foliat,3.5-7,5-1.,5-8,6-12,abaxially,acumen,adaxially,apically,articulate,belo,calyx,connate,covering,dehiscent,digestion,diminishing,dorsally,eaf,edge,eed,emoval,enzyme,exceeding,flat,folded,forked,frequently,generally,globo,gradually,hair-like,lateral,lobe,lon,long,long-attenuate,lower,lunat,make,maturing,mucilaginous,nflorescence,nther,oblique,often,orolla,pair,perfect,petiolule,plan,poricidally,present,produced,proximal,rare,reveal,ruit,seudostipule,size,sometimes,stamen,straight,tal,tem,testal,thick,throughou,throughout,top,toward,truncate,typically,unit,vary,wall,wide,ympodial,¼	5-15,abaxial,adaxial,anther,arrangement,center,colour,form,fruit,growth,height,history,inflorescence,length,life,lunate,na,number,ovary,position,pseudostipule,rachi,reproduction,shape,spacing,staman,surface,texture,width,ye
3	wfo-0001025642	success	149	70	43	106	27	0.289	0.3-0.4,1-2.7,1-3.2,1-4,1.5-2.5,10-20,2-10,5-6,9-12,apex,branched,cell,cm,corolla,diameter,dichasially,distal,filament,flower,globose,green,green-white,half,herbaceous,lanceolate,leaf,mm,mucilaginous,obtuse,odd-pinnate,ovoid,pedicel,peduncle,perennial,petiole,plant,puberulent,seed,stellate,stigma,style,throughout,yellow	1,1-2,1-2.5,1-3,2-3,3,3-5,3-6-foliat,3.5-6,4-7.5,4.5-8,5.5-7,7-11.5,8-13,abaxially,absen,absent,acumen,acuminate,acute,adaxially,apical,apically,apiculate,articulate,attenuate,base,calyx,connate,covering,cyme,dehiscent,dichasial,digestion,diminishing,dorsally,eaf,ebracteate,edge,eed,elliptic,elliptic-lanceolate,emoval,enzyme,exceeding,flat,folded,forked,generally,globo,gradually,hair-like,honeycomb,interjected,introrse,lanceolat,lateral,leaflet,living,lobe,lon,long,lower,lunate,make,maturing,monochasial,nflorescence,nther,oblique,often,orolla,pair,pattern,perfect,plan,poricidally,present,proximal,reveal,ruit,sessile,seudostipule,short,size,slit,specimen,stamen,straight,tal,tem,terminal,testal,thick,throughou,toward,tuber-bearing,typically,unit,vary,wall,whit,wide,without,ympodial,¼	abaxial,adaxial,anther,arrangement,center,colour,form,fruit,growth,height,history,inflorescence,length,life,na,number,ovary,position,rachi,reproduction,shape,spacing,staman,surface,texture,white,width
4	wfo-0001025644	invalid_json_followup	204	114	73	131	41	0.358	1-10,1-2,1.3-2.1,10-11,13-21,2-3,2.5-6,25-50,3-10,4-19,4-6,abaxially,adaxially,anther,apex,axillary,blue,broadly,bud,cell,ciliate,clavate,cm,corolla,covering,denticulate,diameter,elliptic,filament,finely,flower,forked,fruit,glabrous,globose,green,greenish,hair,herb,invested,lateral,like,margin,minutely,mm,multicellular,non-glandular,odd-pinnate,ovate,ovoid,pedicel,peduncle,pentagonal,petiole,plant,puberulent,pubescent,seed,short,stem,stigma,style,subtending,terminal,testal,thick,tinged,trichome,uniseriate,wall,white,whitish,yellow	.3,0-5,0.8-1.5,10,12-28,2,2-4,2.4-4,2.5-11,3-4,3-5,3.3-8.2,4.5-9.5,5-merou,6-7,6.5-13,absent,acumen,acuminate,acute,ag,almost,along,always,alyx,apart,apparently,articulated,attenuate,axe,base,berry,blade,brownish,c.,capitat,chartaceous,condition,connivent,cordate,cuneate,digestion,distal,dorsally,drying,eaf,edge,eed,end,enzyme,erec,especially,exceeding,except,flat,folded,fresh,geminat,generally,glabrou,greatly,green-white,hair-like,half,homostylous,honeycomb-shaped,interjected,lanceolate,leaflet,lengthening,living,lobe,long,lower,make,membranous,middl,midrib,mottled,mucilaginous,nflorescence,oblique,often,one,orbicular,orolla,pair,perfect,petiolule,placed,plurifoliate,pore,poricidal,proximal,purple,rarely,reduced,removed,rounded,ruit,sessile,seudostipule,shallowly,size,slit,spaced,specimen,stamen,ste,stolo,straight,subequal,tall,tamen,tem,throughout,tip,tri-,truncate,tube,tuber,typically,unit,usually,vary,well-developed,wet,wing,winged,x,ympodial	'',[,\u201chair-like\u201d,``,abaxial,adaxial,arrangement,bark,calyx,capitate,center,characteristic,colour,form,fruiting,growth,height,history,inflorescence,leaf,length,life,na,new,number,ovary,perennial,position,prickle,rachi,reproduction,scar,shape,spacing,staman,surface,texture,value,width,{,}
5	wfo-0001025645	success	150	75	49	101	26	0.327	0.3-0.8,1-3.5,1-4,10-11,12-17,15-25,2-4.5,2.5,5-5.5,acute,apex,branched,cell,cm,corolla,cyme,diameter,dichasial,dichasially,distal,ebracteate,elliptic-lanceolate,filament,flower,glabrous,globose,green,green-white,half,herbaceous,lanceolate,leaf,mm,monochasial,odd-pinnate,ovoid,pedicel,peduncle,perennial,petiole,plant,puberulent,rachi,seed,stellate,stigma,style,throughout,yellow	0.5-1,0.8,1-2,10-16,2-3,3-5.5,3-6-foliat,4-12,4-5,4-6,4-7,5,8-10,abaxially,absen,acumen,acuminate,adaxially,apical,apically,articulate,base,calyx,connate,covering,cuneate,decurrent,dehiscent,digestion,diminishing,dorsally,eaf,edge,eed,elliptic,emoval,enzyme,exceeding,flat,folded,forked,generally,globo,gradually,hair-like,honeycomb,interjected,introrse,larger,lateral,leaflet,living,lobe,lon,long,lower,lunat,make,maturing,mucilaginous,mucronate,nflorescence,nther,oblique,oblong,often,orolla,pair,pattern,perfect,plan,poricidally,proximal,reveal,ruit,second,sessile,seudostipule,short,size,slit,specimen,stamen,straight,tal,tem,terminal,testal,thick,throughou,toward,tuber-bearing,typically,unit,vary,wall,whit,wide,without,ympodial,¼	abaxial,adaxial,anther,arrangement,center,colour,form,fruit,growth,height,history,inflorescence,length,life,na,number,ovary,position,reproduction,shape,spacing,staman,surface,texture,white,width
6	wfo-0001025646	success	136	91	63	73	28	0.463	0.25-0.4,0.6-3,0.7-3.5,1-4,1-7,1.1-1.4,2-3,3.2-6,4-10,4-5,7-8,abruptly,acuminate,acute,apex,articulate,base,branched,cm,corolla,cuneate,cyme,diameter,dichasial,dichasially,diminishing,distal,ebracteate,elliptic,filament,flower,fruit,globose,gradually,half,herbaceous,interjected,lateral,leaf,leaflet,mm,monochasial,obovate,odd-pinnate,ovary,ovate,pedicel,peduncle,pentagonal,perennial,petiole,plant,probably,proximal,puberulent,size,stigma,strigose,style,terminal,toward,yellow,¼	0-.,0.5-2.1,0.6-2.3,1.1-4.5,1.2,1.2-7.0,1.5-3,2-4,2.3-9.0,2.5-3,3,3-6-foliat,3.5-7,4-15.5,abaxially,acumen,adaxially,apical,apically,apiculate,attenuate,ature,calyx,caudate,connate,decurrent,dehiscent,dorsally,eaf,edge,eed,exceeding,flat,folded,forked,generally,globo,introrse,like,lobe,lon,long,lower,lunat,maturing,nflorescence,nther,oblique,often,orolla,pair,perfect,petiolule,plan,poricidally,seen,sessile,seudostipule,short,slightly,slit,sometimes,stamen,straight,tal,tem,tuber-bearing,typically,unit,vary,whit,wide,ympodial	0-4,abaxial,adaxial,anther,arrangement,colour,form,growth,height,history,inflorescence,length,life,lunate,na,number,position,pseudostipule,rachi,reproduction,seed,shape,spacing,staman,surface,texture,white,width
7	wfo-0001025647	success	194	93	65	129	28	0.335	0.06-0.24,0.8-3,1-10,1-2,1.2-3,1.4-5,2,2-4,2-5,2.5-3,4-10,5-6,abaxially,adaxially,anther,apex,axillary,blue,cell,clavate,cm,corolla,covering,densely,diameter,elliptic,filament,flower,fruit,glabrous,globose,green,greenish,hair,hair-like,herb,lateral,light,like,linear,minutely,mm,moderately,narrowly,odd-pinnate,ovoid,pedicel,peduncle,petiole,plant,puberulent,pubescent,rotate,scale-like,seed,stem,stigma,style,testal,thick,tuber,unbranched,wall,whitish,yellow	0-4,0.4-1.5,0.6-3,1,1-3,1-5,1.3-2.9,1.5-5,1.5-5.5,2-3,3-6,4-6,5-merou,6.2-11,absent,acumen,acute,ag,along,alyx,apart,apparently,articulated,attenuate,axe,base,berry,blade,borne,broadly,brownish,bud,capitat,chartaceous,ciliate,condition,connivent,decurrent,digestion,distal,dorsally,drying,eaf,edge,eed,end,enzyme,erec,especially,exceeding,except,flat,folded,forming,frequently,fresh,geminat,glabrou,greatly,green-white,hal,half,high,homostylous,honeycomb-shaped,interjected,lanceolate,leaflet,lengthening,living,lobe,long,lower,make,margin,membranous,midrib,mucilaginous,multicellular,near,nflorescence,oblique,obtuse,often,orbicular,orolla,ovate,pair,perfect,petiolulate,plurifoliate,pore,poricidal,proximal,reduced,removed,ripe,rosette,ruit,sessile,seudostipule,short,singly,size,slit,sometimes,spaced,specimen,stamen,ste,stolo,straight,subequal,subtending,tall,tamen,tem,terminal,throughout,tip,tri-,tube,typically,unit,unwinged,vary,wet,x,ympodial	abaxial,adaxial,arrangement,capitate,colour,form,growth,height,history,inflorescence,leaf,length,life,na,number,ovary,perennial,position,pseudostipule,rachi,reproduction,shape,spacing,staman,stolon,surface,texture,width
8	wfo-0001025652	success	156	99	70	86	29	0.449	.3,0.5-1,1-1.5,1.5-2,2-3,2-6,3-3.5,3-5,4-6,4-7,acute,anther,anthesi,apex,bark,base,bilobed,calyx,campanulate,closely,cm,corolla,elliptic,filament,fleshy,flower,fruit,furcate,glabrate,glabrous,green,greyish,growth,leaf,lobed,margin,matte,minutely,mm,nearly,new,occasionally,opposite,ovary,ovoid,ovoid-reniform,pale,paler,pedicel,petiole,pitted,planar,plant,scar,shape,shiny,shrub,simple,small,spaced,stem,stigma,strongly,style,surface,tan,tree,white,winged,x	.5,1,10-20,15-17,15-19,2-5,20-50,3-5-flowered,4,9-11,abruptly,acuminate,appearing,blade,broad,closed,completely,connate,decurrent,densely,dia,differing,difoliate,dry,eaf,edicel,eed,emerge,envelope,free,geminat,greyi,growing,irregular,lateral,like,live,lobe,lon,long,lower,main,major,middle,minor,minute,narrowing,nflorescence,older,one,onto,overlappin,pair,papillae,papillo,papillose,parallel,pinkish-grey,pore,poricidal,portion,rather,red-papillose,ry,shaped,size,soon,specimen,straight,tall,tapering,tear,tear-drop,thick,thicker,tightly,tip,tube,ud,unit,vein,wider,widest,wing,ympodial,young	abaxial,adaxial,arrangement,bud,cell,center,colour,diameter,form,fruiting,height,history,inflorescence,length,life,na,number,overlapping,peduncle,perennial,position,rachi,reproduction,seed,spacing,staman,texture,trichome,width
9	wfo-0001025653	invalid_json_followup	218	96	56	162	40	0.257	.0,.3,.5,.6,.7,.8,.9,1.3,20,anther,apart,apex,bark,brown,bud,calyx,chartaceous,cm,corolla,densely,diameter,extra-axillary,filament,flower,fruit,glabrous,globose,heterostylous,lateral,leaf,least,lobed,long,margin,mm,obtuse,ovate,pedicel,peduncle,petiole,prickle,pubescent,reddish,rhizomatous,short,shrub,simple,sinuate,stellate,stem,stigma,straight,style,surface,truncate,unbranched	.1,.2,0.1,0.13,0.15,0.2–0.4,0.3–0.5,0.3–0.8,0.6–1.6,0.7–1.1,0.8,1.0–1.6,1.1–1.3,1.3–1.8,1.6,1.9–3.3,1–1.5,2.3–3.2,2.5–4.0,2.6,4–6,5-merou,6–8,6–9,7–12,8–11,90°,abaxially,absent,acuminate,adaxiall,adaxially,adnate,aequilateral,ag,alyx,among,anthesi,apical,apparently,appearing,around,articulate,attenuate,axe,ba,base,blade,broad,channeled,clinate,congested,craspedodromous,cylindrical,deltoid,developed,directed,distinct,dry,eaf,edge,eed,either,emerging,entire,erect,extending,ferruginous,fertile,filiform,free,glandular,globolunate,hair,increasing,intact,internode,interpetalar,intersepalar,know,known,lanceolate,layer,less,lobe,lon,longer,low,lower,mature,midpoint,midrib,midvein,minute,much,nflorescence,noticeably,oblique,occasionally,opaque,opposed,orolla,persistent,plurifoliat,pore,porrect,porrect-stellate,portion,potentially,prickl,primary,raised,ray,reduced,remaining,restricted,rigid,rounded,row,ruit,scarcely,secondary,see,seen,sessile,short-stipitate,shorter,shot-stipitate,side,sloughing,sparsely,splitting,spread,stamen,stellae,stellate-pubescent,stipe,stipitate,subcordate,suture,tamen,tem,time,tip,tissue,transparent,truncat,tube,two,ud,unarme,unarmed,vary,vein,well,wide,yellow-ferruginous,ympodia,young,±equal,±erect,×	'',0.6-1.6,5-merous,6-8,[,``,abaxial,adaxial,arrangement,cell,center,characteristic,colour,form,fruiting,growth,height,history,inflorescence,length,life,na,new,number,ovary,plant,position,rachi,reproduction,scar,seed,shape,spacing,staman,texture,trichome,value,width,{,}
10	wfo-0001025654	success	140	90	60	80	30	0.429	1,1-2,15-22,2-2.5,4-5,5-6,5-merous,abaxial,abaxially,absent,acuminate,adaxial,anther,apex,broadly,calyx,chartaceous,cm,diameter,dull,elliptic,filament,flower,fruit,fruiting,glabrous,globose,hooked,inflorescence,leaf,margin,minutely,mm,mostly,pale,pedicel,pedicellate,peduncle,petiole,position,prickle,pubescent,purple,rachi,repand,shallowly,shortly,shrub,simple,slender,slightly,stellate,stem,stigma,straw-coloured,style,sub-axillary,surface,unknown,yellow	0,2,2-foliate,25-30,3/4,4,5,6,7-8,?,abortive,abundant,accrescen,acumen,alyx,ape,apica,apparently,armed,articulated,axe,ba,base,blade,branched,cuneate,eaf,eed,erect,flattened,frequently,geminat,glandular,hair,homostylou,juvenile,lanceolate,larger,later,less,lobe,long,lower,mainly,mature,midvein,minute,narrowed,nflorescence,oblique,often,older,orolla,phase,pore,retrorse,ruit,scarcely,scattered,sessile,several,single,size,smaller,solitary,sparsely,sub-acuminate,tal,tamen,tem,tip,toward,triangular,unarme,unit,unknow,vary,x,ympodial,young	arrangement,bark,bud,cell,center,colour,corolla,form,growth,height,history,length,life,na,new,number,ovary,perennial,plant,red,reproduction,scar,seed,shape,spacing,staman,texture,trichome,unarmed,width
11	wfo-0001025655	invalid_json_followup	226	120	85	141	35	0.376	-3-5-lobed,1-1.2,1-1.5,1-2,1.3-1.5,1.5-2,2,2-3.5,3-5,3-7,4-5,6-7,abaxial,acuminate,anther,apex,articulate,bark,base,beige,brown,calyx,cinereous,clavate,cm,compressed,cordate,cordate-lanceolate,cyme,dark,deeply,diameter,entire,ferruginous,ferruginous-pubescent,filament,flower,fruit,fruiting,glabrescent,glabrous,globose,helicoid,leaf,length,lilac,mm,multiangulate-stellate,oblong-urceolate,parted,pedicel,peduncle,persistently,petiole,plant,prickle,rachi,recurved,reddish,rugose,sessile,shrub,slightly,solitary,stellate,stem,stigma,style,sub-capitate,sub-globose,sub-quadrangular,sub-sessile,subreniform,surface,terete,tomentose,tomentose-velutinous,trichome,velutinous,villous,violet,viscid-velutinous,within,without,yellowish	-8-17,0.3-0.4,0.6-0.8,1-3,1.4-2,11,2-2.5,2-3,2-5-celled,2.5-3,2.5-5-,3-,3-8-flowered,4,4-6,5-6-merous,5-7,6-8,8-10,accrescent,along,alyx,anthesi,armed,asymmetric,attenuate,ba,basal,blade,branch,branched,brow,canaliculate,central,curved,densely,di-,discolorous,distal,dry,eaf,eed,elongate,enlarged,epicarp,equal,erect,exceeding,ferruginous-tomentose,free,functional,fused,geminat,gland,glandular,glandular-stellate,glandular-tipped,gynoeci,held,hirsute-glandular,indument,lanate,leathery,linear-lanceolate,lobe,long,long-exserted,long-stalked,longer,lower,many-celled,maturit,midrib,minutely,mix,monoclinous,mucilaginous,multiangulate,multiseriate,nflorescence,numerous,older,one,orolla,papillo,part,peduncl,perennia,persistent,petiol,porrect-stellate,primary,prolonged,prominent,ranch,ray,reduced,reflexed,rounded,ruit,secondary,sepal,short,similar,slender,small,somewhat,sparsely,splitting,stalk,stalked,stamen,staminate,stellae,stellate-glandular,straight,strongly,subcoriaceous,subsagittate,subterete,surrounded,tall,tamen,time,triangular-lanceolate,trifoliate,tube,unarmed,unbranched,uniseriate,unit,upright,vary,vein,weakly,wide,woolly,ympodial,young,¼,½	'',3-8,[,``,adaxial,arrangement,bud,center,characteristic,colour,corolla,form,growth,height,history,inflorescence,life,margin,na,new,number,ovary,perennial,position,reproduction,scar,seed,shape,spacing,staman,texture,value,width,{,}
12	wfo-0001025656	success	209	133	107	102	26	0.512	-10,0.2-,0.2-0.3,0.2-0.4,0.8-1,1-1.5,1-4,1.5-2,10-,12-15,2.5-5,3,3-12,30-40,4-5,8-9,abaxially,acuminate,acute,adaxially,adult,almost,anther,apart,apex,base,berry,blue,branched,brown,cell,channelled,clavate-truncate,cm,coriaceous,corolla,corymbose,curved,cyme,diameter,elliptic,elliptic-ovate,elongate,entire,erect,evenly,filament,flattened,flower,glabrous,glandular,globose,green,grey,growth,heterostylous,inflorescence,internodal,juvenile,lanate,lobed,lobed-angulate,long-styled,loosely,margin,mature,minutely,mm,new,ochraceous,ovary,ovate,pedicel,peduncle,petiole,plant,porrect,prickle,purple,raised,relatively,reniform,reticulate,rugose,rusty,scandent,scar,short-styled,shrub,simple,slightly,spaced,stellate,stem,stigma,style,subglobose,subreniform,subscandent,surface,tomentose,tomentose-lanate,tomentose-velutinous,trichome,viscid,x,yellow	-14,0.5-0.6,1-2,1.8-2,1/3,10-15,2-2.5,3-3.5,3-7,4-4.5,4-6,5-,6,6-11,8-10,along,anthesi,apical,apically,armed,bark,basal,calyx,chartaceous,congested,cuneate,densely,denser,discolorous,distal,eaf,eed,exserted,flexuous,foliaceous,free,fruiting,gland,gre,hirsute,inflorescenc,lengthening,like,linear-lanceolate,lobe,long,long-stalked,longer,looser,lower,midpoint,midrib,minute,mixed,multangulate,multicellular,near,nflorescence,older,papillat,partially,perfect,pericarp,plurifoliat,pore,poricidal,portion,prickly,pubescence,pubescent,reflexed,rounded,ruit,sessile,several,short-stalked,single,sparse,sparsely,stalk,staminate,straight,subcoriaceous,subtuncate,tall,tapering,testa,time,tip,tube,turbinate,ud,unit,upper,vein,venation,white,whitish,without,wood,ympodial,young	abaxial,adaxial,arrangement,branching,center,colour,form,fruit,height,history,leaf,length,life,na,number,papillate,perennial,position,rachi,reproduction,seed,shape,spacing,staman,texture,width
13	wfo-0001025657	success	239	113	83	156	30	0.347	0.1-0.4,0.2-0.4,0.5-2.5,1-1.6,1-3,1.3-2,1.5-1.8,2-10,2-3.5,2.7-4.3,25-60,3-6,3.2-6,4-4.4,5-14,5-16,6.5-10,8.3-12,abaxially,accrescent,adaxially,anther,apart,berry,bluish,branched,brown,bud,calyx,cm,conical,corolla,dark,deltoid,densely,diameter,dried,elliptic,entire,filament,fleshy,flower,fruit,fruiting,granular,green,lanate-pubescent,leaf,length,margin,mm,narrowly,oblong,ovate,pale,pedicel,peduncle,persistent,petiole,pseudo-terminal,rachi,reticulate-punctate,ripe,shrub,simple,soft,somewhat,stellate,stellate-pubescent,stem,stigma,style,suborbicular,surface,tan,tomentose-pubescent,tomentum,tree,velutinous-pubescent,white,x,yellow,yellowish	-2,/3,1-1.1,1-1.3,1.2-1.5,1.7-1.9,12x,2.2-5.5,2.5-9.3,2/3,3-4,3-4.8,4-4.5,4-7,6-12,6-8,7-27,7-9,7-9.5,8-10.5,acute,ag,also,anthesi,apex,apparently,appearing,ark,around,articulated,ascending,axe,axillary,ba,base,blade,blunt-tipped,branch,broadly,capitat,central,chartaceous,closely,cordate,cylindrical,dendritic-multangulat,dendritic-multangulate,dense,directed,distally,due,eaf,earl,edge,eed,especially,evident,exerted,expanded,exserted,farinose,few-rayed,free,glabrous,glandula,glandular,hair,half,inserted,lanceolate,lateral,lengthening,light,lobe,lobed,long,long-stalked,longitudinal,lower,m.,magnification,main,midrib,minutely,mixed,multangulate,nearly,nflorescence,obtuse,occasional,often,older,open,orbicular,orolla,ovat,ovate-lanceolate,overlapping,part,parted,partly,perfect,persistently,plurifoliate,pore,poricidal,porrect-stellate,present,pubescence,pubescent,ray,reportedly,ruit,scented,semi-ovate,sessile,short,short-,short-stalked,side,slightly,slit,spaced,splitting,stamen,stipitate-glandular,stipitate-multangulate,strongly,subcampanulate,subcoriaceous,suture,tall,tamen,terete,thick-stalked,thickened,thin-stalked,time,tip,tomentose,transparent,tube,two-third,ud,unarme,unarmed,unit,upper,usually,vary,vein,way,weakly,wide,ympodial,young	abaxial,adaxial,arrangement,bark,capitate,cell,center,colour,form,growth,height,history,inflorescence,life,na,new,number,ovary,perennial,plant,position,reproduction,scar,seed,shape,spacing,staman,texture,trichome,width
14	wfo-0001025666	success	217	112	82	135	30	0.378	0-0.7,0.2-0.3,0.3,0.5-1,0.5-1.5,1,1-1.5,1-1.7,1-2,1.5-2.5,2-8,3-7,4-5,6-20,6-7.5,abaxially,acicular,acute,andromonoecious,anther,apart,apex,articulated,base,brown,calyx,center,chartaceous,cm,densely,diameter,elliptical,entire,extra-axillary,filament,finely,flattened,flower,fruit,fruiting,glabrous,globose,green,inflorescence,leaf,length,lobed,margin,mm,moderately,ovate,pale,pedicel,peduncle,perennial,petiole,pinkish,plant,prickle,prostrate,pseudo-racemose,pseudo-umbellate,purple,rachi,reticulate,ridged,shallowly,simple,sparsely,stellate-pubescent,stigma,stoloniferous,straight,style,surface,terete,white,whitish,x,yellow,yellowish,yellowish-green	%,.8,0-5,0.05-0.25,0.2-0.35,0.2-0.8,0.25-0.35,0.25-0.4,0.5-2,1-1.4,1-locular,1.5-1.8,1.5-3.5,1.6-2.3,10-30,14-29,2-3,2-4,2.8-4.5,20-60,21-30,25-65,3-3.5,3-5,3.5-4,4-6,5-6,5-merou,5.5-9.5,7-8,8-12,9-10,9-20,absen,absent,across,adaxially,alyx,armed,attenuate,axe,ba,blade,capitat,confined,connivent,cross-section,cuneate,cylindrical,d.,difoliate,directed,distal,distall,eaf,eed,eglandular,elliptica,exocarp,finger,functional,geminate,gland-tipped,hair,half,heterostylous,incomplete,index,interpetalar,juicy,lamina,lateral,less,lobe,lobing,long,longer,loosely,lower,mature,mesocarp,midpoint,midrib,midvein,minute,moist,narrowly,nflorescence,oblique,obtuse,orolla,part,per,placenta,pore,porrect,presen,present,probably,ray,ruit,septum,sessile,short,shrub,side,slightly,spaced,sparse,stage,stellae,stellate,strongly,tal,tamen,tapered,tem,thick,throughout,time,tissu,tissue,transparent,triangular,tube,unarme,unarmed,unbranched,unit,uvenile,vary,vein,weakly,wide,ympodial	5-merous,abaxial,adaxial,arrangement,bark,bud,capitate,cell,colour,corolla,form,growth,height,history,life,na,new,number,ovary,position,reproduction,scar,seed,shape,spacing,staman,stem,texture,trichome,width
15	wfo-0001025669	invalid_json	216	105	71	145	34	0.329	'',.5,0.1-0.3,1-10,1-2,1-4,1.4-2.5,13-35,2-3,2.2-6.5,3-7,``,abaxially,adaxially,anther,apex,base,blue,broadly,brownish,cell,clavate,cm,condition,corolla,covering,diameter,drying,elliptic,filament,flower,fresh,fruit,glabrous,globose,green,greenish,herb,lateral,minutely,mm,moderately,monochasium,obtuse,odd-pinnate,ovate,ovoid,pedicel,peduncle,petiole,plant,puberulent,pubescent,purple,rarely,ripe,rotate,seed,slightly,stigma,streaked,style,subglabrous,testal,thick,tinged,typically,wall,white,whitish,yellow	0-1,0-5,0-7,0.8-2.4,1,1-2.2,1-3,1.3-4.2,1.6-4.4,2,2-4,2.2-6,2.4-7,3-5,4-6,5-merou,9-24.5,absen,absent,acumen,acuminate,acute,ag,along,alyx,apart,apparently,articulation,axe,berry,blade,capitat,chartaceous,ciliate,clearly,connivent,contracted,cuneate,decurrent,digestion,discussion,distal,distinct,dorsally,eaf,edge,eed,end,enzyme,erec,especially,exceeding,except,extra,flat,flowered,folded,forming,geminat,glabrou,greatly,green-white,hair,hair-like,half,highly,homostylous,honeycomb-shaped,interjected,lanceolate,larger,leaflet,lengthening,like,living,lobe,long,lower,make,margin,membranous,midrib,minute,mottled,mucilaginous,multicellular,near,nflorescence,oblique,obovate,often,one,orbicular,orolla,pair,perfect,petiolulate,petiolule,placed,plurifoliate,pore,poricidal,proximal,reduced,removed,rosette,rounded,ruit,scale-like,see,sessile,seudostipule,short,single,size,slit,sometimes,spaced,species,specimen,stamen,ste,stem,stolo,straight,subequal,tall,tamen,tem,terminal,throughout,tip,tri-,truncate,tube,tuber,unbranched,unequal,unit,unwinged,vary,wet,wide,x,ympodial	'extra,'hair-like,[,],abaxial,adaxial,arrangement,capitate,characteristic,colour,form,growth,height,history,inflorescence,leaf,length,life,na,number,ovary,perennial,position,rachi,reproduction,shape,spacing,staman,surface,texture,value,width,{,}
16	wfo-0001025685	invalid_json_followup	222	157	121	101	36	0.545	-22,/3,/4,0.3-1,0.4-6,1-4,1.5-2,10-15,12-13,2-4,2-5,2-6,2-7,3-10,3-3.5,3-4,4-5,6.5-9,7-8,abaxially,acuminate,acute,adaxially,adult,angulate,anther,apart,apex,apiculate,armed,articulated,bark,basally,base,berry,brown,calyx,chartaceous,clavate,cm,cordiforme,coriaceous,corolla,dark,diameter,discolorous,entire,erect,filament,finely,flattened,flower,flowering,fruiting,glabrous,glandular-viscid,globose,green,growth,heterostylous,internodal,juvenile,lanceolate,like,lobed,long-styled,margin,midpoint,minutely,mm,multicellular,new,orangish,ornamented,ovary,ovate-cordiforme,ovate-elliptic,pedicel,peduncle,petiole,plant,prickle,quadrate,ray,recurved,red,reduced,reniform,reticulate,ripe,scabrous,scandent,sessile,shallowly,short-styled,shrub,simple,size,small,stalked,stellate,stem,stigma,style,subcompressed,subglobose,subscabrous,subtruncate,tapering,time,tomentose-ferruginous,tomentose-floccose,tomentose-scabrous,tomentose-velutinous,tree,trichome,turbinate,velutinous-floccose,way,white,yellowish	-15,-30,0.2-0.3,0.3-0.5,0.45-0.9,0.5-1,1-1.5,1-multicellular,1.4,1.5-2.5,1.8-2.5,2,2-2.2,2-3,3,3.5-10,4-4.5,50,7-18,8-10,<,anthesi,ascendin,basal,branched,caly,channelled,concav,cordate,cuneate,curved,deciduous,deltate,dense,distal,eaf,eed,elongating,exserted,foliaceous,free,glabrescen,glandular,heavily,impressed,larger,lobe,long,lower,minute,mixed,multangulate,nflorescence,oblique,oblong-lanceolate,obverse,older,ovate,papillo,partially,per,perfect,pericarp,persistent,plurifoliat,pore,poricidal,porrect,portion,prickly,puberulent,pubescence,pubescent,raised,reflexed,rest,ruit,scar,slightly,slit,spaced,sparse,sparsely,staminate,straight,subcordate,testa,thick,tip,triangular-lanceolate,truncate,tube,ud,uneven,unit,vein,venation,without,woody,x,ympodial	'',[,``,abaxial,adaxial,arrangement,bud,characteristic,colour,denser,form,fruit,glabrescent,height,history,inflorescence,leaf,length,life,na,number,papillose,perennial,position,rachi,reproduction,seed,shape,spacing,staman,surface,texture,value,width,{,}
17	wfo-0001025688	invalid_json_followup	218	114	61	157	53	0.28	0.5,1,1-celled,1/2,4-lobed,acicular,acute,anther,apex,base,brown,calyx,cm,curved,cylindrical,deeply,diameter,entire,erect,extra-axillary,filament,flower,fruit,fruiting,glabrous,gland-tipped,globose,glutinous,leaf,lobed,margin,mm,nearly,otherwise,ovate,pedicel,peduncle,petiole,pilose,prickle,puberulent,rachi,ripe,shrub,simple,sparsely,stellate,stem,stigma,style,suborbicular,surface,thin-textured,truncate,unbranched,way,white,x,yellow,yellow-green,yellowish-green	0.1,0.1–2,0.2,0.5–2,0.5–3,0.5–3.5,0.6–0.8,0.6–2,0.6–2.4,0.6–4,0.8,0–10,1.3–1.7,1.5–2,1.5–3,1.5–4,14155,15–25,1–1.5,1–1.6,1–1.8,1–2,1–3-celled,1–6-celled,1–8,2-foliate,25,2–3,2–3.5,2–4-celled,2–4–celled,3.2–3.6,3–10,3–4,4,40–75,4–15,4–5-rayed,4–6,4–9,5,59,5°,5–18,6–7,6–8,8–10,8–15,=,abaxially,abruptly,accrescent,adaxiall,adaxially,also,angle,anthesi,armed,ascending,average,axe,blade,branch,coiling,conpsicuously,constricted,contiguou,darker,dense,densely,developing,directed,distall,distally,eaf,eed,enlarged,except,fewer,flattened,flowering,free,fresh,geminate,gland,grading,green,hair,hyaline,lacking,lanceolate,larger,less,lobe,lon,long,lower,major,many,minor,minute,mottling,n,narrowed,narrowly,nee,nflorescence,none,often,one,orolla,per,pericarp,pore,pubescence,rarely,rather,recurved,ruit,scarious,scattered,sessile,short,similar,single,size,slightly,small,sometimes,somewhat,spreading,stellae,stipitate,straight,sulcate,tal,tamen,tapering,tem,thic,thick,thickene,thickened,tip,triangular,truncat,tube,twice,unit,upper,usually,vary,vein,wide,wing,ympodial,±	'',0.1-2,0.5-3,0.5-3.5,0.6-4,1-2,15-25,2-3.5,3-10,3-4,4-6,4-9,6-7,8-15,[,``,abaxial,adaxial,arrangement,bark,bud,cell,center,characteristic,colour,contiguous,corolla,form,growth,height,history,inflorescence,length,life,na,new,number,ovary,perennial,plant,position,reproduction,scar,seed,shape,spacing,staman,texture,trichome,value,width,{,}
18	wfo-0001025694	success	199	113	89	110	24	0.447	0.2–0.3,0.5–1.5,0.5–3,1,10–25,1–3,2.5,20,2–15,2–3.5,2–5-branched,3–5,3–6,4–12,4–15,5-merous,6–10,abaxial,absent,adaxial,androgynoecious,andromonoecious,anther,apart,becoming,brown,chartaceous,cm,dark,densely,diameter,discolorous,drying,elliptic,erect,filament,flower,fruit,glabrous,gland-tipped,globose,green,hair,inflorescence,length,like,long,membranaceous,midpoint,mm,moderately,mottled,multicellular,nearly,often,orange,ovate,pedicel,peduncle,petiole,plant,porrect-stellate,prickle,pubescent,rachi,ray,reniform,roselike,rugose,scandent,shrub,simple,sparsely,specifically,stellate,stellate-pubescent,stem,stigma,still,style,surface,tan,turning,unicellular,white,whitish,yellow,young,×	0.2,0.3–0.6,0.5–1,1.5–2,1.5–3.5,10–15,1991,1–2,1–2.5,2.5–11,25–50,2–3,2–4,4–5,5–10,6–20,8–12,abaxially,absen,accrescent,acute,adaxiall,adaxially,alyx,apex,apical,armed,articulated,asymmetrical,attenuate,axe,ba,base,berry,beyond,blade,calyx,capitat,center,completely,connivent,cordate,covering,cylindrical,eaf,eed,entire,exerted,exserted,flattened,frui,fruiting,functionally,fused,glandular,hermaphroditic,heterostylou,interpetalar,little,lobe,lower,male,margin,matur,midrib,midvein,mixed,multiseriate,narrowly,nflorescence,obtuse,occasionally,opening,orolla,per,pinnate,plurifoliat,pore,recurved,reflexed,ruit,rusty,secondary,short,side,slit,spaced,sparse,spine,stalk,stamen,staminate,swollen,tal,tamen,tem,tip,tissue,triangular,triangular-ovate,tube,uniseriate,unit,vary,vein,venation,walker,whelan,wide,ympodial	arrangement,capitate,colour,corolla,form,growth,height,heterostylous,history,leaf,life,mature,na,number,ovary,perennial,reproduction,seed,shape,spacing,staman,texture,trichome,width
19	wfo-0001025697	success	181	122	93	88	29	0.514	0-14,0.15-0.75,1-1.7,1-2,1.7-8.6,10-26,2-4,25-35,3-10,3-4,3-5,3-6,5.5-11.5,abaxially,acuminate,acute,adaxially,anther,apex,attenuate,axillary,base,blue,brownish,bud,cell,clavate,cm,condition,coriaceous,corolla,covering,dark,decreasing,deep,diameter,drying,elliptic,filament,flower,forked,fresh,fruit,glabrescent,glabrous,globose,green,green-white,greenish,hair,hair-like,herb,interjected,lateral,leaf,leaflet,light,lilac,make,medium,mm,mucilaginous,odd-pinnate,orbicular,ovate,ovoid,pair,pedicel,peduncle,pentagonal,petiole,petiolulate,plant,purple,ripe,rotate,seed,sessile,short,size,stigma,stripe,style,subtending,terminal,testal,thick,throughout,toward,wall,wet,whitish,yellow	-9,0.6-3.5,0.8-2,1-3,1.5-1.8,2-10.5,2-2.6,2-6,3.3-11,4-7.5,5-merou,6.5-13.5,acumen,adaxiall,ag,alyx,apart,apparently,articulated,asymmetric,axe,basiscopic,berry,blade,capitat,connivent,decurrent,digestion,distal,dorsally,eaf,edge,eed,enzyme,erec,exceeding,flat,folded,geminat,generally,glabrou,hal,half,high,homostylous,honeycomb-shaped,lanceolate,lengthening,linear,living,lobe,long,lower,nflorescence,orolla,perfect,plurifoliate,pore,poricidal,rachi,removed,rounded,ruit,seudostipule,side,slightly,slit,spaced,specimen,stamen,straight,subequal,subglabrou,tall,tamen,tem,tip,tissue,tri-,tube,typically,unit,unwinged,usually,vary,wood,x,ympodial	abaxial,adaxial,arrangement,capitate,center,colour,form,growth,height,hermaphroditic,history,inflorescence,length,life,na,number,ovary,perennial,position,pseudostipule,reproduction,scar,shape,spacing,staman,subglabrous,surface,texture,width
20	wfo-0001025699	success	181	118	93	88	25	0.514	1-1.5,1-2,1-2.5,1-3,1.5-2,1/3,10,15-20,2-2.5,2-6,2cm,3-15,4-5,5-winged,8-9,absent,acute,almost,anther,anthesi,apart,apex,bark,base,becoming,berry,branching,brown,calyx,campanulate,capitate,cm,conical,conspicuously,corolla,dark,darker,diameter,dry,ellipsoid,elliptic,entire,erect,filament,flower,fruiting,glabrous,globose,green,grey-brown,growth,immature,inflorescence,irregularly,leaf,leaf-opposed,leafy,lobed,margin,minutely,mm,new,older,ovary,pale,papillose,pedicel,peduncle,petiole,red,reniform,reticulate-pitted,rounded,scar,shoot,short,simple,small,spaced,stem,stigma,strongly,style,surface,tangled,time,tree,trichome,way,white,x,young,½	.2,.5,0.5,1,1.5,2,3-3.5,3-5.5,3-8,499,5-8,5.5-14,abaxially,adaxially,age,apparently,appearing,articulating,attenuate,c.,completely,continuing,corrugate,crystal,cup-shaped,deltate,densely,difoliate,dorsal,drying,eaf,eed,exerted,face,fide,free,glabrou,included,inclusion,inflorescenc,lanceolate,leaving,lengthening,less,lobe,lower,markedly,midrib,narrowly,nflorescence,nodding,one,onto,oxalate,pair,papillat,peg,penden,per,perfect,plurifoliate,pore,poricidal,portion,primary,reddish,rounded-sagittate,ruit,sand,slightly,slit,somewhat,stearn,straight,thickened,tip,triangular,tube,ud,unit,vein,white-spotted,wide,wing,winged,woody,yellow,ympodial	abaxial,adaxial,arrangement,bud,cell,center,colour,form,fruit,height,history,length,life,na,number,plant,position,rachi,reproduction,seed,shape,spacing,staman,texture,width
21	wfo-0001025700	invalid_json_followup	189	122	79	110	43	0.418	0.30-2.0,0.5-2,0.8-2.6,10-40,10.5-12,15-40,2-12,2.5-4,5.3-17.5,5.5-8,abaxially,acumen,adaxially,anther,apex,articulated,attenuate,brownish,bud,cell,chartaceous,clavate,cm,condition,corolla,covering,diameter,distal,dot,drying,elliptic,filament,flower,forked,fresh,fruit,glabrescent,glabrous,globose,green,green-white,greenish,hair,half,herb,high,lateral,leaf,lilac,make,medium,mm,mucilaginous,odd-pinnate,ovate,ovoid,pedicel,peduncle,pentagonal,petiole,plant,purple,ripe,rotate-pentagonal,rounded,seed,short,sometimes,stigma,style,terminal,testal,thick,throughout,wall,wet,white,whitish,yellow	0-16,0.7-2.7,0.8-4,1-2,1-3,1.1-2.3,1.5-2,2-7,3-4,3-8,3.5-10.5,3.7-8.6,4-5,5-15,5-20,5-merou,5.5-18,9-31,acuman,acuminate,acute,ag,alyx,apiculate,apparently,asymmetric,axe,axillary,basal,base,basiscopic,berry,blade,capitat,connivent,considerably,decrease,decreasing,digestion,dorsally,eaf,edge,eed,enzyme,erec,exceeding,except,flat,folded,geminat,generally,glabrou,hair-like,hal,homostylous,honeycomb-shaped,interjected,lanceolate,larger,leaflet,lengthening,light,linear,living,lobe,long,lower,narrowly,nflorescence,orbicular,orolla,pair,par,perfect,petiolulate,plurifoliate,pore,poricidal,proximal,removed,ruit,sessile,seudostipule,side,size,slightly,slit,specimen,stamen,straight,subequal,subglabrou,subtending,tall,tamen,tem,tip,tissue,toward,tri-,tube,typically,unit,unwinged,usually,vary,whose,winged,x,ympodial	'',[,\u201chair-like\u201d,``,abaxial,adaxial,arrangement,bark,calyx,capitate,center,characteristic,colour,form,fruiting,growth,height,history,inflorescence,length,life,margin,na,new,number,ovary,perennial,position,prickle,rachi,reproduction,scar,shape,spacing,staman,stem,surface,texture,trichome,value,width,{,}
22	wfo-0001025702	success	279	94	67	212	27	0.24	.0,0.3–2.2,0.5–0.8,1.2–1.6,1.4–2.8,1.6–2.0,1.7–9.2,1/3,2,2.3,2–14,3.2,4,4.5–5.2,anther,apart,attachment,capitate,chartaceous,cm,congested,corolla,densely,developed,diameter,dry,elliptic,emerging,extra-axillary,filament,flattened-orbicular,flower,fruit,glabrous,globose,homostylous,internode,interpetalar,lanceolate,lateral,lax,mature,mm,moderately,notched,oblong,ovate,pedicel,petiole,point,poorly,pubescent,red,scandent,shrub,stellate,stigma,style,sub-coriaceous,surface,tissue,upper,white,yellow,yellow-tan,×,–6	.1,.3,.5,.7,/2,0.04,0.3–0.4,0.4–2.3,0.5–0.6,0.5–1.3,0.6–0.9,0.6–1.0,0.7–1.4,1.3–1.8,1.3–2.8,1.4–1.6,1.4–2.2,1.6–1.7,1.6–1.8,1.6–2.1,1.6–2.3,1.7,1.7–2.3,1.9,1/4–1/3,2.0–3.2,2.2,2.2–2.9,2.3–6.6,2.3–7.8,2.5,2.6–7,3.6–3.9,4.3,4–16,5-merou,5.2–7.5,5.4,6.6,6.9–10.3,6–10,6–8,abaxially,acuminate,acute,adaxially,adjacent,adnate,aequilateral,ag,alyx,anthesi,apex,apical,apiculate,apparently,appearing,appresse,around,articulate,attenuate,axe,ba,bark,base,based,becoming,berry,blade,branch,broad,broad-based,broadly,brochidodromous,brown,bud,calyx,channeled,completely,cream,cuneate,curved,deciduous,deflexed,deltate,deltoid,dentate,difoliate,directed,distal,distally,distinct,eaf,edge,eed,either,endocarp,entire,exocarp,extending,ferruginous,fertile,filiform,flexed,forked,free,geminat,glandular,glossy,gradually,gree,hair,hooked,hort,increasing,incurved,indistinct,intact,intersepalar,joining,juic,laterally,layer,limp,lobe,lon,long,longer,lower,m.,margin,midpoint,midrib,midvein,minute,nearly,nflorescence,oblique,obtuse,occasionally,opaque,orolla,per,perforated,pore,porrect,portion,potentially,presen,prickle,primary,pseudo-intermarginal,pseudo-peduncle,raised,ray,reddish,reflexed,remaining,retrorse,rounded,row,ruit,scattered,secondary,seen,sessile,shoot,side,simple,sinus,sloughing,smoot,smooth,sometimes,somewhat,soon,sparsely,splitting,spread,stamen,stellae,stellate-pubescent,stem,straight,strongly,suture,tamen,tem,thin,time,tip,toward,transparent,triangular,truncate,tube,two,ud,unarmed,unbranched,vary,vein,wide,yellow-ferruginou,yellow-ferruginous,ympodia,young,±90,±90°,±connivent,±equal,±glabrous	5-merous,abaxial,adaxial,alternate,arrangement,colour,dioecious,form,green,growth,height,history,inflorescence,leaf,length,life,number,ovary,peduncle,perennial,plant,reproduction,seed,shape,spacing,staman,texture
23	wfo-0001025704	success	248	124	98	150	26	0.395	0-3.5,0.5-1.5,0.7-1,1-3.5,1-4,1-6,1.2-3,1.5-3.2,1.5-4.5,3-10,3-6,4-12,4.5-6.5,5-merous,8-17,abaxial,abaxially,acute,adaxial,almost,andromonoecious,anther,apart,apex,articulated,bark,base,branched,calyx,cell,chartaceous,cm,curved,densely,diameter,ellipsoid,erect,evenly,filament,flattened-reniform,flower,fruit,fruiting,glabrescent,glabrous,gray,green,green-yellow,lateral,leaf,length,lobed,margin,maturity,mauve,mm,occasionally,orange,orange-brown,outline,pale,pedicel,peduncle,petiole,pit,plant,prickle,raised,rarely,red-brown,red-green,round,scar,shape,shrub,small,smooth,sometimes,sparsely,spherical,stellate,stellate-pubescent,stem,straight,style,surface,terete,terminal,tree,trichome,unbranched,warty,white,white-gray,yellow,yellow-green,yellowish,young	-10,-2,-3,-5,/6,0,0-100,0-2,0-5,0.1,0.1-0.3,0.1-0.5,0.15-0.8,0.3-0.8,1,1.5-2,1.8-3.5,1/2-4/5,1/4-3/4,1/5,2,2-10,2-3,2-4.5,2-5,2-7,2.5-4.5,2.7-4,3-15,3-5,4-5,5-20,6-12,6-15,8-12,8-15,age,alyx,apar,apically,apiculate,apparently,auriculate,axe,ba,berry,blade,broad-deltate,brow,connivent,cordate,covering,deltate,development,discolorous,distal,distance,drying,eaf,eed,elliptic,elongating,end,equal,extending,flattened,free,half,hermaphrodite,heterostylous,infructescence,irregular,less,lobe,lobing,long,long-styled,longer,lower,lowermost,mature,midpoint,midvein,moderately,multangulate,near,nflorescence,obtuse,often,older,one,open,orolla,oung,ovate,pair,pendulous,per,pericarp,plurifoliat,poricidal,porrect,portion,prickl,prickly,primary,prominent,ray,recurved,reflexed,retaining,rounded,ruit,secondary,sessile,short-styled,shorter,side,slender,somewhat,spaced,spreading,stalk,stalked,staminat,stellate-pubescen,stout,strongly,tamen,tapering,tertiary,throughout,time,tip,truncate,tube,unarmed,unit,upper,variously,vary,vein,venation,visible,way,wide,widening,woody,ympodial,×	arrangement,brown,bud,center,colour,corolla,form,growth,height,history,inflorescence,life,na,new,number,ovary,perennial,plurifoliate,position,reproduction,seed,spacing,staman,stigma,texture,width
24	wfo-0001025714	invalid_json_followup	249	111	53	196	58	0.213	abaxially,accrescent,acute,anther,apex,broadly,calyx,cm,decidedly,diameter,erect,extra-axillary,filament,flattened,flower,fruit,fruiting,glabrous,glandular-pubescent,globose,light,lobed,margin,minutely,mm,orbicular,ovary,ovate,pedicel,peduncle,petiole,pilose,prickle,pubescent,rachi,rounded,shrub,simple,slender,stellate,stem,stigma,stipitate-glandular,straight,style,subreniform,tan,terete,unbranched,white,x,yellow,yellowish	%,-5,-rayed,.2,0.1–0.8,0.2–0.8,0.5,0.5–0.6,0.5–1.3,0.5–2,0.8,0–0.4,1,1.2–2.4,1.3–3,1.5–2,1.5–2.5,1.5–3.5,1.6–2.3,1.8–,1/3,100,10–11,13,15,15–25,1–2,1–4,2,2-foliate,2.2–3,2.5,2.5–3.8,2.8,2–3,2–4-celled,2–7,2–8,3.7–5,3–16,3–9,4–18,4–6,5,5.9–7.5,50,5–25,5–6.5,6.2–6.8,6–16,7–18,7–8.5,8–13,9.2–10,9–22,>,absent,acicular,adaxiall,adaxially,additional,always,anthesi,apart,appearing,armed,around,articulated,ascending,asia,attenuate,axe,ba,base,berry,blade,branch,capitat,caudate-tipped,completely,concealing,covering,curved,cylindrical,differing,dilated,dimorphic,directed,distall,eaf,eed,enlarged,entire-margined,fertile,few-branched,few-rayed,forward,free,frui,geminat,glabrou,gland,gland-tipped,gland–tipped,hair,half,halfway,herbarium,horizontally,hyaline,immediately,increasingly,lacking,larger,latter,less,lobe,lobing,long,longer,longest,lower,lowermost,mainly,major,male,many-rayed,maturity,midrib,minor,minute,mixed,multangulate,narrowly,nearly,nflorescence,numerous,obtuse,often,one,orolla,pair,per,perhaps,plane,pointing,pore,predominating,pubescence,rare,rarely,recurved,reflexed,ruit,scarcely,scattered,sessile,short,shorter,similar,single,size,slightly,small,smaller,sometimes,spaced,sparse,specimen,spine,spreading,stellae,stipitate,stouter,subcordate,subglabrous,tal,tamen,tem,thin-textured,time,toward,triangular,truncate,tube,unequal,unit,upper,usually,various,vary,way,wide,ympodial,–1.25,–7–9	'',0-0.4,0-0.8,0.1-0.8,0.5-0.6,0.5-2,1-2,1.3-3,1.5-3.5,1.6-2.3,10-11,2-7,2-8,3-9,3.7-5,5.9-7.5,6.2-6.8,9-22,[,``,abaxial,adaxial,arrangement,bark,bud,capitate,cell,center,characteristic,colour,corolla,form,growth,height,history,inflorescence,leaf,length,life,na,new,number,perennial,plant,position,reproduction,scar,seed,shape,spacing,staman,surface,texture,trichome,value,width,{,}
25	wfo-0001025726	success	158	94	65	93	29	0.411	-10,-5,0.5,0.5-1.5,1-1.5,1-2.5,1-3,10-15,2.5,20-40,3-10,3-5,4-10,6-8,acuminate,anther,apex,branched,brown,calyx,campanulate,chartaceous,cm,diameter,elliptic,filament,flattened,flower,foveolate,fruit,glabrous,globose,green,internode,light,mm,oblong,ovate,pedicel,peduncle,perennial,petiole,prickle,puberulent,purple,rachi,rarely,recurved,rounded,rugose,shape,slender,spreading,stellate,stigma,strongly,style,subwoody,surface,terminal,variable,white,woody,x,yellow	-16,0-1,0.2,0.2-0.3,1,2-,2-3,3-4,4,5,6-12,7-9,abaxially,accrescen,acute,adaxiall,adaxially,adjacent,ag,alyx,anthesi,armed,articulated,axe,ba,base,becoming,blade,broadly,clustered,compound,confluent,connivent,dr.,eaf,eed,elongating,entire,equal,fertile,fruiting,geminat,hair,imparipinnately,lateral,leaflet,lengthening,lobe,lobed,long,major,margin,midrib,narrowly,nflorescence,oblon,occasionally,often,orolla,pinnate,pinnatifid,plurifoliate,pore,poricidal,present,ranging,recurve,ruit,scandent,side,simple,size,slit,stout,straight,swollen,tamen,tem,terminally,time,tip,truncat,tube,ud,unbranched,unit,usually,variously,vary,vein,vin,wide,ympodial	abaxial,adaxial,arrangement,bud,colour,corolla,dry,form,growth,height,history,inflorescence,leaf,length,life,na,number,ovary,plant,position,reproduction,seed,spacing,staman,stem,texture,truncate,vine,width
26	wfo-0001025729	invalid_json_followup	177	127	90	87	37	0.508	.5,/4,0.25-0.5,0.7-1.2,1-1.5,1-5,1.1-1.5,1.2-1.8,1.75,4-5,abaxial,abaxially,abrupt,acute,adaxially,anther,apex,appearing,axil,bark,basal,base,bright,bud,calyx,cm,corolla,covering,cyathiform,densely,dia,dirty,elliptic,f,filament,flattened-reniform,fleshy,fruiting,furcate,glabrous,globose,green,greenish-yellow,greyish-brown,growing,lamina,lateral,leaf,live,lobed,long,main,margin,minutely,mm,occasionally,often,opposite,ovary,overtopping,pale,papillose,pedicel,petiole,pit,pitted,plant,scar,shiny,simple,sparsely,stem,stigma,style,surface,tapering,terminal,tip,tree,treelet,trichome,tube,tuft,uniseriate,vein,way,white,widening,x,yellow	-20,1.5-2,2,2-3.5,20,3-6,4-8,5-50-flowered,6-8,7-8,9-17,along,anthesi,apar,apical,apiculate,berry,black,blackish,branched,bristly,covered,dark,deflexed,deltoid,denser,diam,differing,difoliate,drying,eaf,edicel,eed,enclosed,expanded,free,geminat,gently,glabrou,incrassate,lat,like,lobe,lon,lower,m.,mainly,major,member,middle,minor,minute,nflorescence,oblique,older,one,overlapping,pair,papillo,partially,pore,poricidal,portion,prominent,pubescent,quite,raised,reflexed,ripening,rounded,ruit,shaped,short,size,stout,straight,tall,tear-drop,touching,tub,ud,unit,usually,widest,woody,ympodial,young	'',4-20,5-50,[,``,adaxial,apart,arrangement,characteristic,colour,diameter,flower,form,fruit,growth,height,history,inflorescence,length,life,na,new,number,peduncle,position,prickle,rachi,reproduction,seed,shape,spacing,staman,texture,value,width,{,}
27	wfo-0001025737	invalid_json_followup	220	124	66	154	58	0.3	1.5,2,5-merous,abaxially,adaxially,anther,apart,apex,attenuate,bright,cm,densely,diameter,entire,extra-axillary,filament,flattened-reniform,flower,fruit,glabrous,globose,greenish,growth,interpetalar,lance-ovoid,lateral,light,lighter-colored,long,loosely,margin,minutely,mm,narrow,orange,ovate,ovate-lanceolate,pale,pedicel,peduncle,petiole,pitted,prickle,rarely,reflexed,seed,shiny,shrub,simple,slender,stellate,stellate-tomentose,stem,stigma,straight,style,surface,tinge,tissue,tomentose,triangular-attenuate,usually,violet,white,whitish,yellow	-branched,0.2–0.3,0.3–0.7,0.3–2,0.6,0.6–0.9,0.7–1.3,0.8–1.1,0.9–1.1,1.4–1.8,1.5-2,1.5–2,1.5–3,1.5–5,1.5–6.5,1.7–2.2,10,10–12,1–,1–1.2,1–1.5,2.5–3,2.5–4.5,25–50,2–3,3,3.5–5,3.5–8,3–10,44599,47092,4–11,4–6,5,51,5–6,7–8,8–10,8–16,9-10,95,absent,accrescen,acute,adaxiall,age,alyx,angularly-cordate,apical,apparently,appressed-tomentose,armed,articulated,axe,ba,base,becoming,blade,branch,broad-based,capitat,deeply,difoliate,directed,distall,eaf,eed,except,fertile,filiform,finely,free,geminat,glabrou,gland-tipped,green,hair,high,homostylous,immature,internode,juicy,juvenile,like,linear-attenuate,linear-lanceolate,lobe,lobed,lon,long-stipitate,lower,major,midpoint,midvein,midzone,minute,mixed,near,nee,nflorescence,northern,numerous,oblong,obtuse,odorle,orolla,part,per,perfect,persistently,pore,porrect,principal,range,ray,rounded,ruit,scarcely,sessile,shallowly,short-,short-stipitate,shorter,side,sinus,southern,spaced,sparsely,splitting,ste,stellae,stellate-pubescent,stipe,straigh,tamen,tem,thick-chartaceous,time,tomento,tube,turning,ud,unarmed,vary,vein,vigorous,wide,x,ympodia,×,–14,–20,–3,–4	'',0.3\u20130.7,0.3\u20132,0.7\u20131.3,0.8\u20131.1,0.9\u20131.1,1.5\u20132,1.5\u20133,1.5\u20135,10\u201312,1\u20131.5,2.5\u20134.5,25\u201350,3.5\u20138,5\u20136,7\u20138,[,\u00d7,\u20134,``,abaxial,adaxial,arrangement,bark,bud,calyx,capitate,cell,center,characteristic,colour,corolla,form,fruiting,height,history,inflorescence,leaf,length,life,na,new,number,ovary,plant,position,rachi,reproduction,scar,shape,spacing,staman,texture,trichome,value,width,{,}
28	wfo-0001025741	success	231	114	88	143	26	0.381	0.5–0.8,0.5–3,1.7–2,1.8–2.1,11–14,12–15,1–4,2.5–8,2–7.5,3–10,4–6,5–17,6.5–9,8–15+,abaxial,acuminate,acute,adaxial,andromonoecious,anther,apart,apex,bark,broad-based,brown,chartaceous,cm,dark,densely,diameter,fading,filament,flattened,flower,fruit,glabrous,globose,golden-tan,green,hair,half,inflorescence,juicy,lanceolate,leaf,length,light,lighter,lobed,lustrous,maturity,mm,moderately,multangulate,once-branched,orange,outline,ovate,pedicel,peduncle,petiole,plant,prickle,pubescent,rachi,reniform,rotate-stellate,rugose,sessile,short-cylindrical,short-stalked,simple,sparse,stellate,stigma,strongly,style,surface,tan,tree,unbranched,violet,white,yellow,×,–20,–30,–8	.2,.5,0-0.1,0–0.1,1.1–2,1.2–1.5,10–35,15–45,1–2,1–2.5,2.5–3,2.5–3.5,20–23,29–36,2–3,2–3.2,2–4,30–120,3–6,4–5,4–7,5-merous,5–6,6–7,8–18,abaxially,abundant,abundantly,adaxially,along,alyx,andromonoeciou,anthesi,armed,articulated,axe,ba,base,becoming,berry,blade,calyx,capitat,column,congested,connivent,covered,cuneate,curved,cylindrical,db,deltate,deltoid,difoliate,directed,distall,dry,eaf,eed,eglandular,either,emergent,entire,equal,extraaxillary,flowering,free,fresh,frui,fruiting,functionally,geminat,glandular,hermaphroditic,heterstylous,included,inflated,interpetalar,knobby,like,lobe,lon,long,long-stalked,lower,major,margin,membranaceous,midpoint,midvein,multiseriate,nearly,nflorescence,oblique,one,orange-tan,orolla,part,pericarp,pore,porrect-stellate,present,ray,remaining,ruit,runk,shallowly,sharp,shiny,short,side,small,somewhat,spaced,sparsely,stalk,stalked,staminate,stellate-pubescent,stem,stout,straight,subtending,tamen,tapered,thi,thin,time,tissue,tube,tuft,unarmed,unit,vary,vein,wide,within,ympodial,young,–12,–28,–39,–6	arrangement,capitate,cell,center,colour,corolla,form,growth,height,history,life,na,new,number,ovary,perennial,reproduction,scar,seed,shape,spacing,staman,texture,trichome,trunk,width
29	wfo-0001025743	invalid_json_followup	157	108	64	93	44	0.408	0.1-0.3,0.15-0.3,0.3-0.5,0.4-0.8,0.5-0.9,0.9-2.6,1.2-4,12-17,2-3,4-8,4.5-5.5,5-10,6-10,6-7,8-10,acicular,andromonoecious,apart,apex,broadly,calyx,chartaceous,cm,cylindrical,deeply,deltate,diameter,extra-axillary,finger,flower,fruit,fruiting,glabrous,gland-tipped,globose,green,hair,herbaceous,inflorescence,length,lobed,longer,margin,mm,obtuse,ovate,pale,pedicel,peduncle,petiole,plant,prickle,prostrate,resprouter,simple,spaced,sprawling,stellate,style,time,unbranched,white,wide,yellow	%,.5,0-15,0-6,0.3-0.6,0.4-0.5,0.9-1.2,1,1-6,1.3-1.8,11-25,2-4,2-4.5,2.3-5,2.8-3.5,3-13,3-4,3-6,3.5-5.5,30-80,5-20,5-merou,6-20,9-18,abaxially,absen,absent,adaxiall,adaxially,adult,alyx,armed,articulated,axe,ba,base,blade,branche,brown,cordate,cuneate,decimetre,dense,directed,distall,eaf,eed,functional,grey,half,heterostylous,index,lamina,lateral,less,lobe,lobing,lon,long,lower,mature,mid-point,midvein,minute,nflorescence,nther,oblique,onl,orolla,part,per,pore,presen,present,ruit,short,side,stage,straight,strongly,tal,tem,thick,throughout,tube,unit,unknow,uvenile,vary,vein,x,yellowish-gree,ympodial	'',5-merous,[,``,abaxial,adaxial,anther,arrangement,bark,bud,cell,center,characteristic,colour,corolla,filament,form,growth,height,history,leaf,life,na,new,number,ovary,position,rachi,reproduction,scar,seed,shape,spacing,staman,stem,stigma,surface,texture,trichome,value,width,yellowish-green,{,}
30	wfo-0001025749	invalid_json_followup	217	125	90	127	35	0.415	-12,0.1-0.3,0.2-1.5,0.3-1.5,0.5-0.8,0.5-0.9,0.5-3,0.8-0.9,1-10,1-13,1-2,1-9,2-10,2.5-6,5-10,5-merous,abaxial,acute,adaxial,anther,apart,apex,apparently,bark,berry,calyx,chartaceous,cm,curved,dark,densely,diameter,dull,filament,flattened,flattened-reniform,flower,fruit,fruiting,gently,glabrescent,glabrous,gray,green-brown,lateral,leaf,length,light,lobed,margin,maturity,mauve,mm,moderately,narrow-deltate,orange-brown,orange-red,orbicular,ovate,pale,pedicel,peduncle,petiole,porrect,prickle,prickly,red-brown,rounded,scar,sessile,shrub,smooth,sometimes,sparsely,spherical,stalked,stellate,stellate-pubescent,stem,straight,straw-yellow,style,surface,terete,trichome,white,yellow,yellow-green,yellow-orange,yellowish	-1,.5,/5,0-10,0-3,0-5,0-6,0-8,0.1,0.1-0.2,0.1-0.4,0.2,0.4-0.7,0.5,0.5-1.3,0.6-4.5,1,1-3,1-6,1-8.5,1.5,1.5-2,1.5-2.5,1/4-1/3,1/5-1/2,2-2.5,2/3,3-20,3-5,4-8,5-,5-20,6-8,abaxially,acuminat,adaxially,adnate,almost,alyx,apar,apically,articulated,base,blade,branched,broad-deltate,concolorous,cuneate,difoliate,discolorous,distance,drying,eaf,eed,elongating,equal,erect,extending,filiform,free,geminat,herbaceous,indistinct,infructescence,lobe,lon,long,long-ovate,longer,lower,magnification,markedly,mature,midpoint,midvein,narrow-ovate,nflorescence,oblong,obtuse,occasionally,older,one,open,orange-brow,orolla,oung,pair,pendulous,per,perfec,pericarp,poricidal,portion,prickl,primary,procumbent,purple,rarely,ray,recurved,reduced,ruit,shorter,side,spaced,spreading,stalk,strongly,tamen,tapering,tertiary,time,tip,toward,tube,unit,usually,variously,vary,vein,venation,visible,way,wide,without,ympodial,½-2/	'',[,``,arrangement,bud,center,character,characteristic,colour,corolla,form,growth,height,history,inflorescence,life,na,new,number,ovary,perennial,plant,position,rachi,reproduction,seed,shape,spacing,staman,stigma,texture,value,width,{,}
31	wfo-0001025754	invalid_json_followup	164	116	76	88	40	0.463	.5,0.5-1,0.5-1.5,1,1-3,1.5,1.5-3,10-20,4-6,5-15,absent,along,anther,apex,blade,brown,calyx,center,chartaceous,ciliate,cm,cordiform,denser,diameter,dm,drying,edge,entire,erect,filament,fine,flat,flower,fruit,glabrous,glandular,globose,hair,herb,immature,leaf,long,lying,margin,maturing,membranaceous,mixed,mm,moderately,nearly,parallel,pedicel,peduncle,petiole,pubescent,rachi,radiating,raised,ridge,rotate,running,semitransparent,shallow,small,solitary,sparsely,stem,stigma,straight,style,surface,unbranched,vein,white,x,yellow	-celled,0.1-0.2,1-2,1-3.5,1.5-4,10-35,2-4,2-5-celled,2-7,2-foliate,3-10,3-5,3-6,4,5-12,abaxially,abundant,acuminate,acute,adaxiall,adaxially,asymmetrical,axe,barely,base,berry,beyond,branch,connected,cordate,decumbent,decurrent,dehiscing,densely,dried,eaf,eed,eglandular,emarginat,equal,explosively,exserted,geminat,held,interpetalar,leaving,like,linear-lanceolate,lobe,lower,main,material,maturit,mesocarp,much-branched,nfloresence,notch,oblong,often,orolla,palmately,penden,per,placenta,pressure,probably,pubescen,ruit,short,slightly,sometimes,stamen,swollen,tal,tamen,tem,tissue,triangular,truncate,tube,unit,upright,vary,visible,watery,wid,woody,ympodial	'',[,``,abaxial,adaxial,arrangement,bark,bud,characteristic,colour,corolla,form,fruiting,geminate,growth,height,history,inflorescence,length,life,na,new,number,ovary,perennial,plant,position,prickle,reproduction,scar,seed,shape,spacing,staman,texture,trichome,value,width,{,}
32	wfo-0001025760	invalid_json_followup	210	122	86	124	36	0.41	-10,-6,.5,0-0.5,0.1,0.3-1,0.45-0.9,0.5-2,0.8-1.8,1-1.8,1-2,1-4,1.5,2.3-4,3.5-17,abaxial,abaxially,acute,adaxial,almost,annual,anther,apex,bark,black,calyx,chartaceous,cm,cream,curved,dark,diameter,dull,elliptic,filament,flattened-reniform,flower,fruit,fruiting,gently,glabrescent,glabrous,green,herb,lateral,leaf,length,lobed,margin,marking,maturity,membranous,mm,moderately,orange,orange-brown,ovate,pale,pedicel,peduncle,perennial,petiole,porrect,red-brown,scar,sessile,shape,shrub,smooth,sometimes,spherical,stalked,stellate,stellate-pubescent,stem,style,subentire,surface,trichome,unbranched,variously,weakly,white,yellow,yellow-green,young	-12,-3,-5,/3,0-100,0.1-0.2,0.15-0.3,0.2-0.35,0.4-0.8,0.5-1.5,0.7-2.5,1,1-,1.5-2.5,1.5-4.5,1.5-5,1/4,1/4-1/2,1/4-1/3,1/5,2-2.5,2-3,2.1-3.5,2.5-10,2.5-8,2/3,3,3-6,3.5-9,5-10-merous,5-18,8-10,acut,alyx,apar,apically,apparently,articulated,base,berry,blade,broad-deltate,brow,concolorous,connivent,cultivar,cuneate,deltate,difoliate,discolorous,distance,drying,eaf,eed,elongating,equal,erect,extending,free,geminat,geminate,hair,infructescence,lengt,lobe,long,longer,lower,mature,midpoint,midvein,minute,nflorescence,often,older,one,open,orolla,oung,pair,pendulous,per,perfec,pericarp,poricidal,portion,primary,ray,recurved,reflexe,rounded,ruit,shorter,side,simple,slender,spaced,spreading,stalk,stellate-pubescen,stout,straight,tamen,tapering,terete,tertiary,thick-stalked,time,tip,tube,unarme,unarmed,unit,upper,usually,various,vary,vein,venation,visible,way,wide,woody,ympodial	'',[,``,apart,arrangement,brown,bud,center,characteristic,colour,corolla,form,growth,height,history,inflorescence,life,na,new,number,ovary,plant,position,prickle,rachi,reflexed,reproduction,seed,spacing,staman,stigma,texture,value,width,{,}
33	wfo-0001025782	invalid_json_followup	200	112	78	122	34	0.39	0-5,0.1-0.15,0.1-0.25,0.4-0.6,0.55-0.75,0.9-1.3,1-1.7,1-2.5,1-4,1.2-6,1.3-1.6,1.5-3,2-3,2-7,4,4-4.5,5-merous,abaxial,acuminate,adaxial,andromonoecious,anther,apex,apically,bark,brown,calyx,chartaceous,climbing,cm,conical,curved,diameter,dull,elliptic,evenly,filament,flattened,flattened-reniform,flower,fruit,fruiting,gently,glabrescent,glabrous,green,green-brown,lateral,leaf,length,lobed,margin,membranous,mm,moderately,orange-brown,pedicel,peduncle,petiole,plant,porrect,prickle,scar,sessile,shrub,sparsely,spherical,stellate-pubescent,stem,style,surface,terete,trichome,unbranched,weakly,white,yellow,yellow-green	-2,.5,0-10,0.1-0.2,0.3-1,0.5-1,1,1-2,1/4-1/2,1/4-1/3,1/6,10-13,2-10,2-2.5,2-5,2.5-3.5,2/3-3/4,20,3-4,3-5,4.5-9,5-20,5-6.5,5-8,5.5-6,6-14,6-8,abaxially,acuminat,also,alyx,apar,apart,apparently,articulated,base,berry,blade,concolorous,connivent,cuneate,deltate,densely,difoliate,discolorous,distal,distance,drying,eaf,eed,elongated,elongating,equal,extending,free,geminat,geminate,hair,hermaphrodite,heterostylous,infructescence,lengt,less,lobe,long,long-styled,longer,lower,lowermost,mature,maturity,midpoint,midvein,minute,nflorescence,occasionally,older,one,open,orolla,oung,pair,pendulous,per,pericarp,poricidal,portion,prickl,prickly,primary,ray,red-brow,reduced,ruit,short-styled,shorter,side,simple,smooth,spaced,spreading,staminat,stellate,stout,straight,tamen,tapering,tertiary,time,tip,toward,tube,unit,vary,vein,venation,visible,way,wide,woody,ympodial,young	'',[,``,arrangement,bud,center,character,characteristic,colour,corolla,form,growth,height,history,inflorescence,life,na,new,number,ovary,perennial,position,red-brown,reproduction,seed,shape,spacing,staman,stigma,texture,value,width,{,}
34	wfo-0001025783	invalid_json_followup	179	132	96	83	36	0.536	.5,0.5,0.5-1,0.5-1.5,1-1.2,1-1.5,1-3,2,2-3+,2-5,7-10,abaxially,acute,anther,apart,apex,axil,base,berry,branched,brown,bud,c.,calyx,cluster,cm,confined,conical,corolla,dendritic,densely,diameter,ellipsoid,elliptic,entire,erect,filiform,flattened,flexuous,flower,fruiting,glabrous,globose,green,greyish,growth,lateral,lax,less,lobed,long,margin,midrib,minutely,mm,narrowly,near,new,nodding,number,pale,pedicel,peduncle,petiole,pitted,primary,pubescent,purple,reniform,ripe,sagittate,scar,shiny,shoot,short,shrub,simple,somewhat,sparsely,stellate,stem,stigma,style,surface,terminal,thin,time,trichome,tuft,uniseriate,vein,vine,violet,way,weak,woody	0.8-3.5,1.8-2,2-6.5,3-4,5,5-merou,<,abaxiall,adaxiall,adaxially,along,alyx,anthesi,ape,ark,articulated,branching,cell,completely,coriaceous,eaf,eed,expanded,exposed,exserted,fleshy,free,glabrou,groove,hromosome,ilament,inserted,keeled,known,lobe,long/tall,lower,mature,midvein,minute,mmm,nflorescence,obscured,obtuse,occasionally,older,orolla,outlin,pair,penden,pentagonal,perfect,pericarp,plurifoliat,point,portion,possibly,revolute,ruit,scarious,see,sleeve,slightly,sometimes,spaced,sparse,strongly,suture,testal,transparent,triangular,truncate,tube,twinin,type,ud,unit,upper,vary,wide,within,yellowish,ympodial	'',3,[,``,abaxial,adaxial,arrangement,bark,characteristic,colour,filament,form,fruit,height,history,inflorescence,leaf,length,life,na,ovary,perennial,plant,position,prickle,rachi,reproduction,seed,shape,spacing,staman,texture,value,width,{,}
35	wfo-0001025784	invalid_json_followup	241	122	72	169	50	0.299	-3,.5,0.2-0.3,0.5,1-5,3.5,abaxially,acicular,acute,anther,apart,apex,black,calyx,cell,cm,curved,cylindrical,diameter,enlarged,extra-axillary,filament,flattened,flower,fruit,fruiting,glabrous,glandular-pubescent,globose,green,greenish,greenish-yellow,irregularly,lanceolate,leaf,lobed,margin,mm,narrowly,nearly,ovate,pedicel,peduncle,petiole,pilose,prickle,pubescent,purple,rachi,rounded,shallowly,shrub,simple,smooth,somewhat,sparsely,stellate,stem,stigma,style,subreniform,surface,thin-textured,triangular,truncate,unbranched,white,x,yellow,yellow-brown,yellow-green,–8	.2–0.4,0.2,0.2–1.1,0.3–0.5,0.4–2.5,0.5–1.8,0.5–2,0.5–3,0.6–0.8,0.7,0.8–1.1,0.8–1.2,0.9–1.2,0.9–1.4,1,1.2,1.2–2.5,1.3–1.8,1.6–2.2,1/3,10,10–15,15075,1709,1–,1–3,1–5,2,2-foliate,2.5–3.3,2/3,2–2.5,2–3,2–4,2–5-celled,2–7,3–4,3–4-rayed,4.5–5.5,5,5–6,6,6.5–8,6.5–8.5,=,accrescent,adaxiall,adaxially,also,always,anthesi,articulated,asplund,ba,base,becoming,blade,branched,brazil,ciliate,completely,conical,directed,distall,drying,eaf,eed,enclosing,especially,et,exceeding,fertile,fide,free,frui,geminat,glabrescent,glabrou,gland,gland-tipped,hair,hyaline,insolated,irwin,lobe,long,longitudinal,lower,lowest,major,male,many,midpoint,midrib,minute,minutely,moderately,mostly,mottled,much,n,nflorescence,numerous,obtuse,offset,one,orolla,pair,per,pore,pubescence,raised,rarely,ray,recurved,reflexed,reported,ripe,rudimentary,ruit,second,sessile,sharp,short,side,similar,slightly,small,sometimes,spaced,spiny,sprawling,spreading-pilose,stamen,ste,stellae,stipitate,stout,straight,subcapitat,subcordate,tal,tamen,tem,thick,thicker,time,tip,toward,tube,unarmed,unequal,unit,upper,usually,variously,vary,vein,way,wid,wide,widest,without,ympodial,young,–2,–4,–5.5,–9	'',.2-0.4,0.5-3,0.8-1.2,0.9-1.2,0.9-1.4,10-15,2-3,2-7,3-4,4.5-5.5,5-6,[,``,abaxial,adaxial,arrangement,bark,bud,center,characteristic,colour,corolla,form,growth,height,history,inflorescence,length,life,na,new,number,ovary,perennial,plant,position,reproduction,scar,seed,shape,spacing,staman,subcapitate,texture,trichome,value,width,{,}
36	wfo-0001025788	success	158	92	65	93	27	0.411	0.5-2,1-4,1-5,15-30,2-3,2.8-9.5,4-5.5,5-8,8-38,acute,apex,articulate,blue,branched,cell,cm,conical,corolla,covering,cyme,deep,diameter,dichasial,dichasially,distal,ebracteate,elliptical,filament,finely,flower,forked,green,green-white,hair-like,half,herbaceous,lateral,leaf,medium,mm,monochasial,narrowly,obtuse,odd-pinnate,ovate,ovoid,pedicel,peduncle,perennial,petiole,plant,proximal,pubescent,purple,rotate,seed,stigma,style,testal,thick,throughout,tip,wall,yellow,¼	-8,0-6,1.8-2.7,1.8-3.9,10-24,14-48,2-10,2-13,2-5,2m,3-,3-6-foliat,4-3.,4.5-10.1,4.5-12.5,6-7,6.2-12.5,abaxiall,abaxially,acumen,acuminate,adaxially,apical,apically,attenuate,base,calyx,connate,cuneate,dehiscent,digestion,diminishing,dorsally,eaf,edge,eed,emoval,enzyme,exceeding,flat,folded,generally,globo,gradually,honeycomb,interjected,introrse,leaflet,living,lobe,lon,long,long-attenuate,lower,lunat,make,maturing,mucilaginous,nflorescence,nther,oblique,often,orolla,pair,pattern,perfect,petiolule,plan,poricidally,reveal,rounded,ruit,sessile,seudostipule,short,size,slit,specimen,stamen,straight,subequal,subsessile,tal,tem,terminal,throughou,toward,tuber-bearing,typically,unit,vary,wide,ympodial	abaxial,adaxial,anther,arrangement,center,colour,form,fruit,globose,growth,height,history,inflorescence,length,life,na,number,ovary,position,rachi,reproduction,shape,spacing,staman,surface,texture,width
37	wfo-0001025792	invalid_json_followup	203	113	71	132	42	0.35	0.4-0.7,1-10,1-2,1-3,10-15,2.5-3.5,21-28,4-6,5,5-10,7.5-8,9-12,abaxially,adaxially,anther,apex,auriculate,blue-mauve,blue-purple,brownish,bud,cell,cm,condition,corolla,covering,densely,diameter,drying,elliptic,filament,flower,forked,fresh,fruit,glabrous,globose,green,greenish,herb,lanceolate,lateral,margin,mauve,minute,minutely,mm,odd-pinnate,ovoid,pedicel,peduncle,petiole,plant,puberulent,pubescent,purple,rachi,rotate-pentagonal,seed,stem,stigma,streak,style,terminal,testal,thick,tinged,wall,white,whitish,yellow	1-4,2-11,2-3,2-3.5,2.5-4,3-4,3-5,3.5-6,4-12,4.5-7,5-6,5-9,5-merou,7-10,8-10,acumen,acuminate,acute,ag,along,alyx,apart,apparently,articulated,articulation,axe,axillary,base,basiscopic,berry,blade,broadly,capitat,chartaceous,ciliate,connivent,dark,decurrent,developing,digestion,distal,distinct,distinctly,dorsally,eaf,edge,eed,enzyme,especially,exceeding,except,flat,folded,geminat,generally,glabrou,greatly,green-white,hair,hair-like,hal,half,high,homostylous,honeycomb-shaped,indistinct,interjected,leaflet,lengthening,like,living,lobe,long,lower,make,membranous,midrib,mottle,mucilaginous,narrow,narrowly,nflorescence,oblique,often,onto,orolla,pair,papillose,perfect,petiolulate,plurifoliate,pore,poricidal,proximal,reduced,removed,ripe,rounded,ruit,semi-erec,semi-rosette,sessile,seudostipule,short,shortly,side,size,slightly,slit,spaced,specimen,stamen,ste,straight,sub-rosette,subequal,subtending,tall,tamen,tem,throughout,tip,tri-,tube,unit,usually,vary,wet,wing,x,ympodial,young	'',[,\u201chair-like\u201d,``,abaxial,adaxial,arrangement,bark,calyx,capitate,center,characteristic,colour,form,fruiting,growth,height,history,inflorescence,leaf,length,life,na,new,number,ovary,perennial,position,prickle,pseudostipule,reproduction,scar,shape,spacing,staman,surface,texture,trichome,value,width,{,}
38	wfo-0001025804	success	155	99	64	91	35	0.413	0.5-1,1-1.5,1-3,1.2-1.5,1.4-1.7,10-20,3-4.5,3.5-12,6-8,acute,anther,apex,attenuate,bark,base,bilobed,calyx,cm,conical,corolla,cream,dark,deflexed,difoliate,ellipsoid,elliptic,erect,filament,flattened,flower,fruiting,glabrous,globose,green,incrassate,internodal,leaf,light,lobed,margin,minutely,mm,nearly,obovate,occasionally,opposite,ovary,paler,papillose,pedicel,pitted,plurifoliate,reddish-brown,reniform,scar,shrub,somewhat,stem,stigma,style,surface,white,whitish-green,x	.25,.5,1.5-2,11-20,16-35,2-2.5,2.5-4,4-10,5,7-10,?,abaxially,adaxially,age,anthesi,apar,ape,apiculate,ba,berry,branched,c.,clavate,covered,cucullate,decurrent,densely,dia,differing,drying,eaf,edicel,eed,exserted,fleshy,free,geminat,glandular,later,lateral,lengthening,lobe,long,lower,main,major,many,mere,middle,minor,minute,near,nflorescence,often,older,onto,pair,papillae,papillat,papillate,planar,pore,poricidal,portion,projection,red,red-papillose,reddish-brow,regularly,rim,ruit,sessile,size,slit,spaced,strongly,tall,thick,time,tip,tub,tube,ud,unit,vein,widest,wing,winged,woody,ympodial,young	abaxial,adaxial,apart,arrangement,bud,cell,center,colour,diameter,form,fruit,geminate,growth,height,history,inflorescence,length,life,na,new,number,peduncle,perennial,petiole,plant,position,rachi,reproduction,seed,shape,spacing,staman,texture,trichome,width
39	wfo-0001025813	invalid_json	197	117	84	113	33	0.426	'',1-10,1-2,1-4,1.5-1.8,15-30,3-3.5,3-4,3-7,6-7,``,abaxially,adaxially,along,anther,apex,articulated,base,berry,blue,broadly,brownish,cell,ciliate,cm,condition,corolla,covering,dark,densely,diameter,distal,drying,elliptic,especially,filament,flower,fresh,fruit,glabrous,globose,green,green-white,greenish,hair,herb,lateral,light,make,margin,midrib,minutely,mm,monochasium,mucilaginous,obtuse,odd-pinnate,ovoid,pedicel,peduncle,petiole,pilose,plant,puberulent,pubescent,rachi,rarely,rotate,seed,stem,stigma,style,suborbicular,testal,thick,throughout,tip,typically,violet,wall,wet,white,whitish,yellow	0-2,0.7-1.7,1-1.5,1.2-4.5,1.3-7,1.5-2,1.5-6.5,2-3,2-4,2-5,3-5,3-6,5-18.5,5-6,5-merou,absent,acumen,acuminate,acute,ag,alyx,apart,apparently,axe,blade,borne,chartaceous,connivent,contracted,cuneate,decreasing,decurrent,digestion,discussion,distinct,dorsally,eaf,edge,eed,end,enzyme,exceeding,extra,flat,folded,geminat,glabrou,hair-like,half,highly,homostylous,honeycomb-shaped,interjected,lanceolate,larger,leaflet,lengthening,like,living,lobe,long,longer,lower,membranous,minute,near,nflorescence,often,orbicular,orolla,ovate,ovoi,pair,perfect,petiolulate,plurifoliate,pore,poricidal,removed,rosette-formin,ruit,see,sessile,seudostipule,short,single-flowered,singly,size,slit,sometimes,spaced,species,specimen,stamen,ste,stolo,straight,strongly,tamen,tem,terminal,thir,toward,tri-,tube,tuber,unforked,unit,unwinged,vary,vein,x,ympodial	'extra,'hair-like,[,],abaxial,adaxial,arrangement,characteristic,colour,form,growth,height,history,inflorescence,leaf,length,life,na,number,ovary,perennial,position,reproduction,shape,spacing,staman,surface,texture,third,value,width,{,}
40	wfo-0001025817	invalid_json_followup	238	135	80	158	55	0.336	1-1.6,10,abaxially,acuminate,anther,apart,apex,asymmetric,base,bifurcate,black,broad-based,broadly,brown,calyx,chartaceous,cm,dark,deeper,densely,diameter,dull,entire,eventually,extra-axillary,filament,flower,fruit,fruiting,glabrate,glabrous,globose,green,lanceolate,larger,laterally,leaf,lenticular,margin,minutely,mm,moderate,near,occasionally,ovate,pale,pedicel,peduncle,pedunculate,persistently,petiole,pitted,prickle,pubescent,purple,rachi,rarely,ripe,short,shrub,simple,sinuate–repand,sized,small,stellate,stem,stigma,stout,style,surface,time,tree,turning,unequally,violet,white,white-stellate,woolly,yellow,×	0.5–0.7,0.6–0.8,0.8–1.5,0–1.6,1.5–2.5,1.7-2.1,1.8–2.3,1.8–3,10–16,10–35,12–16,1–3,1–5,2–2.9,2–3,2–5,2–6.5,2–8,3.2–8,3.5–6,3–,3–13,3–6,3–8,4–5.5,4–6,4–7,5-merou,5–20,5–6,6–13,7–9,8–14,8–21,absent,accrescen,acute,adaxially,age,along,although,alyx,amount,apiculate,apparently,armed,articulated,asymmetrically,axe,ba,berry,bicolorous,blade,branch,branched,campanulate,capitat,central,compresse,conical,deciduous,deltoid,dense,developing,difoliate,directed,distall,distally,eaf,eed,exceeding,except,expanded,expansion,fertile,fewer,filiform,flowering,forming,free,geminat,glabrou,high,impressed,interpetalar,juvenile,lacking,large,lateral,like,linear-lanceolate,lobe,long,low,lower,major,midpoint,midvein,minute,much,nerve,nflorescence,numerous,oblong,obtuse,often,one,orolla,overlapping,persistent,pinnatifi,pore,portion,present,prickly,principal,pubescence,racemose,rayed,reaching,recognizable,rounded,row,ruit,sessile,single,sinus,slender,slightly,sometimes,soon,spaced,sparse,spreading,stalked,stellae,strongly,tamen,tapering,tissue,tomentose,trunk,tube,ultimate,unarmed,underside,unit,usually,variously,vary,vein,velvety,weakly,well,wide,without,ympodial,young	'',0-1.6,1.5-2.5,2-2.9,2-5,2-8,3-13,3-8,3.2-8,4-5.5,4-7,5-20,5-merous,7-9,[,``,abaxial,adaxial,arrangement,bark,bud,capitate,cell,center,characteristic,colour,compressed,corolla,form,growth,height,history,inflorescence,length,life,na,new,number,ovary,perennial,plant,position,reproduction,scar,seed,shape,spacing,staman,texture,trichome,unknown,value,width,{,}
41	wfo-0001025825	success	187	117	90	97	27	0.481	0-0.21,0.4-1,0.5-10.4,0.9-2,1-2,1-5.5,10-24,14-85,2-3.7,22-86,3-10,3-5,3.7-6.5,4-8,5-10,6-10,abaxially,acuminate,acute,adaxially,anther,apex,axillary,back,base,berry,brownish,bud,cell,clavate,cm,condition,coriaceous,corolla,covering,cuneate,dark,diameter,drying,elliptic,filament,flower,forked,fresh,fruit,glabrescent,glabrous,green,greenish,hair,hair-like,herb,honeycomb-shaped,interjected,lateral,leaf,leaflet,light,lilac,lobe,medium,mm,odd-pinnate,orbicular,ovate,ovoid,pedicel,peduncle,pentagonal,petiole,plant,rachi,rotate-pentagonal,seed,shiny,short,size,stigma,streak,style,subtending,terminal,testal,thick,wall,white,whitish,wing,x,yellow	0.4-3,0.5-0.8,0.7-2.2,0.9-4,1-3,1.1-1.4,10.5-26,2-5,3-8.5,4-9,5-7,5-merou,6.6-14,acumen,adaxiall,ag,alyx,apart,apparently,articulated,asymmetric,attenuate,axe,basiscopic,blade,capitat,connivent,decreasing,decurrent,digestion,distal,dorsally,eaf,edge,eed,enzyme,erec,exceeding,flat,folded,geminat,generally,glabrou,green-white,hal,half,high,homostylous,increasing,lanceolate,lengthening,living,long,lower,make,middle,mucilaginous,nflorescence,orolla,pair,perfect,petiolulate,plurifoliate,pore,poricidal,removed,rounded,ruit,sessile,seudostipule,side,slightly,slit,smaller,spaced,specimen,stamen,straight,subequal,subglabrou,tall,tamen,tem,throughout,tip,tissue,toward,tri-,tube,unit,unwinged,usually,vary,wet,wide,winged,ympodial	abaxial,adaxial,arrangement,capitate,center,colour,form,growth,height,history,inflorescence,length,life,na,number,ovary,perennial,position,pseudostipule,reproduction,shape,spacing,staman,subglabrous,surface,texture,width
42	wfo-0001025835	success	297	143	118	179	25	0.397	.1,/4,0.2-2,0.5-2.8,0.6-1.3,0.65-0.8,0.7-3,1-1.5,1-2.5,1-4,1-8,1-9,1.2-2,1.5-3,2.5-3,3-7,3.5-4,4,4-5,6,abaxially,accrescent,adaxial,almost,always,anther,apart,apex,apparently,armed,bark,becoming,berry,black,branched,bright,brown,calyx,cell,clavate,cm,corolla,curved,diameter,drying,dull,elongating,erect,evenly,filament,finely,flattened,flattened-reniform,flower,fruit,fruiting,glabrescent,glabrous,globose,green,green-brown,greenish,irregular,lateral,leaf,length,lobed,long,maturity,mauve,mm,moderately,older,orange-brown,orange-translucent,outline,ovate,ovoid,pale,pedicel,peduncle,petiole,pit,porrect,prickle,rachi,raised,red,ribbed,ridged,sessile,shiny,shortly,shrub,side,significantly,simple,slender,small,smooth,sparsely,stalked,stellate,stellate-pubescent,stem,stigma,straight,straw-yellow,style,surface,terete,thin,trichome,white,yellow,yellow-orange,yellowish,young	.3,0.05-0.1,0.1,0.1-0.2,0.5,0.5-0.7,0.5-1,0.7-1.8,1,1-2,1-3,1-5,1-7,1.2-1.8,1.5-1.8,1.5-2,1.5-3.5,1/2,1/3,1/3-3/4,1/4-1/2,1/4-1/3,1/4-2/3,2-6,2.2-2.5,2.5-3.5,20,3-5,3-6,30-45°,4-8,5,5-20,5-merou,6-8,7-9.5,8,9-11,acuminate,acute,adaxially,ag,alyx,apar,apically,apiculate,articulated,axe,base,beyond,blade,branche,broad-based,broad-deltate,chartaceous,concolorous,covering,cupular,dark,deep,deltate,developed,development,difoliate,distance,divided,dorsal,eaf,eed,equal,exserted,extending,faint,finger-hair,flat,foliaceous,free,geminat,gently,gre,infructescence,irregula,lamina,lengthening,less,lobe,lobing,long-deltate,longer,longitudinal,lower,margin,mature,midpoint,midvein,minute,mostly,network,nflorescence,obconical,oblong,obtuse,occasional,often,one,open,opening,orange,orolla,oung,ovoi,pair,papillae,papillo,part,pendulous,per,perfect,pericarp,point,pore,poricidal,portion,primary,pronounced,rarely,ray,reduced,reflexed,regular,rest,rounded,ruit,scar,secondarily,secondary,shallow,short,shorter,sinus,slightly,slit,sometimes,somewhat,spaced,spherical,spreading,stalk,stump,tamen,tapering,terminal,tertiary,throughout,time,tip,toward,translucent,trifoliate,tube,ud,unarmed,unequal,unit,upper,usually,variously,vary,vein,venation,visible,weakly,wide,widest,wing,woody,x,ympodial,×	5-merous,abaxial,arrangement,branching,bud,colour,form,grey,growth,height,inflorescence,moderate,na,number,ovary,papillose,plant,position,reproduction,seed,shape,spacing,staman,texture,width
43	wfo-0001025838	invalid_json_followup	217	144	110	107	34	0.507	0.5-1,0.7-2,1-1.2,1-1.5,1.5-2.5,1.5-3.5,1.5-5,1.8-2,10-60,2-5,2/3,4-15,4.5-5.5,6.5-7,adaxial,anther,apart,apex,attenuate,base,berry,black,branched,brown,calyx,capitate,clavate,cm,corolla,cup-shaped,dark,dendritic,dense,densely,diameter,elliptic,entire,erect,filament,flattened,fleshy,flower,fruit,fruiting,glabrous,globose,greenish,growth,inflorescence,lamina,lanceolate,lateral,leaf,like,lobed,long,many,margin,membranous,minutely,mm,narrowly,new,nodding,occasionally,often,onto,ovoid,pale,pedicel,peduncle,petiole,pitted,pointed,pubescent,purple,reddish,reniform,revolute,ripe,scar,seed,shiny,shrub,simple,slender,slightly,sometimes,sparsely,stellate,stem,stigma,style,surface,terminal,thin,time,tinged,tree,trichome,tuft,turbinate,uniseriate,vein,way,white,winged,x,yellow,¾	-20,.5,0.5,1.2-5,1.5-1.7,1.5-2,10-15,2-2.5,2.5-3,20-40,3.5-,5,5-merou,6-15,abruptly,acuminate,adaxially,ag,along,alyx,anthesi,apiculate,appearing,archin,ark,articulated,axil,basall,branch,broad,cell,clustered,connivent,cucullate,decurrent,denser,disintegrating,drying,eaf,eed,ellipsoidal,exserted,extending,free,glabrescent,hairy,ilament,inserted,insertion,irregularly,keeled,lengthening,less,lobe,loosely,lower,m.,midrib,minute,mostly,narrowing,never,nflorescence,older,orolla,pair,papillat,papillo,per,perfect,pericarp,platform,plurifoliat,point,pore,poricidal,portion,primary,quadrate,ruit,shin,short,sinus,sleeve,slit,small,spaced,spreading,square,strongly,tall,tem,testal,thi,tip,tube,twinin,ud,unit,upper,vary,wall,weight,wing,woody,yellowish,ympodial	'',5-merous,[,``,abaxial,arrangement,bark,basally,bud,characteristic,colour,form,height,history,length,life,na,number,ovary,papillose,perennial,plant,position,prickle,rachi,reproduction,shape,spacing,staman,texture,value,width,{,}
44	wfo-0001025845	invalid_json_followup	180	111	72	108	39	0.4	0.3-0.5,0.4-1.5,0.5-11,0.5-2.5,1-4.5,1.5-2,1.5-7,3-13,4-5,4-6,5-6,6-6.5,acuminate,adaxial,anther,apart,apex,articulated,base,branch,brown,calyx,cell,chartaceous,cm,corolla,diameter,ellipsoidal,entire,extra-axillary,filament,flattened,flower,fork,fruit,glabrous,greenish,herb,leaf,light,lobed,located,margin,membranaceous,minutely,mm,near,orange,ovate,ovoid,patch,pedicel,peduncle,petiole,pinnately,puberulent,rachi,rotate-stellate,rugose-verrucate,sand-punctate,shrub,simple,sparsely,stigma,style,truncate,unbranched,veiny,white,x,yellow,yellowish	.5,1,1-1.8,1-2,1.5,1.5-13,1.5-2.5,2,2-15,2-3,2-5-lobed,2.5-4,3,3-4,3-6,3-foliat,6-9,7-10,abaxially,abundantly,acute,adaxially,aggregate,along,apiculate,around,ascending,axe,ba,blade,channe,compressed,connivent,cuneate,cylindrical,dark,decurrent,deltate,diamete,directed,distall,distally,divided,eaf,eed,eglandular,elliptic,especially,free,glabrou,green,inserted,lateral,laterally,lobe,long,longitudinal,lower,major,mesocarp,midrib,narrowly,nearly,nflorescence,obovate,obtuse,often,orolla,part,perfect,pore,pubescent,purple,radiu,rarely,rounded,ruit,sagittate,shorter,side,sinus,small,spaced,stone,stripe,strongly,subcordate,tal,tamen,tapered,tem,terminal,thecae,thick,tightly,time,tip,tomento,triangular,truncat,tube,unit,unlobed,vary,vein,wide,ympodial,youn	'',[,``,abaxial,arrangement,bark,bud,center,characteristic,colour,form,fruiting,growth,height,history,inflorescence,length,life,na,new,number,ovary,plant,position,prickle,reproduction,scar,seed,shape,spacing,staman,stem,surface,texture,trichome,value,width,{,}
45	wfo-0001025850	invalid_json_followup	197	144	107	90	37	0.543	.5,0.5,0.5-1,0.5-3,0.6-1,1,1-1.5,1.5,2-12,2-6.5,30,6-7,abaxial,acute,along,anther,anthesi,apex,base,berry,branched,broadly,brown,calyx,capitate,cell,cm,corolla,cyathiform,densely,denser,diameter,divaricate,ellipsoid,elliptic,entire,erect,filament,flattened,flower,fruiting,glabrous,glandular,globose,green,growth,inflorescence,irregularly,later,lateral,lax,lobed,many,margin,minute,minutely,mm,narrowly,nearly,new,nodding,openly,orange,outline,pale,papillate-puberulent,pedicel,peduncle,perfect,petiole,pinnatifid,pitted,pubescent,reddish,reniform,rhomboid,ripe,rounded,scar,scattered,shallowly,shiny,shrub,simple,sinuate,slender,spaced,spreading,stellate,stem,stigma,style,surface,tan,terminal,testal,thin,time,tip,trichome,uniseriate,vine,white,woody,x,yellow,young	-5,-7,.8,0.5-,1-3,1-celled,1.5-5,15-20,2,3-4,4-5,5-7,5-merou,ag,alyx,apar,apparently,ark,articulated,axi,basal,connivent,cupped,deciduous,deflexed,deltate,divided,drying,eaf,eed,elongate,em,exserted,extending,fleshy,free,geminat,glabrou,gland,half,halfway,ilament,lamina,leaving,lengthening,less,lobe,long,loosely,lower,membranous,midrib,nflorescence,node,occasionally,often,older,orolla,pair,papillo,peg,per,planar,plurifoliate,pore,poricidal,portion,primary,puberulen,ruit,sinus,sleeve,slightly,slit,small,sometimes,soon,splitting,spreadin,strongly,surfac,tiny,truncate,tube,twinin,ud,unit,vary,vein,ympodial	'',5-merous,[,``,adaxial,apart,arrangement,bark,bud,characteristic,colour,form,fruit,height,history,leaf,length,life,na,number,ovary,perennial,plant,position,prickle,puberulent,rachi,reproduction,seed,shape,spacing,staman,texture,value,width,{,}
46	wfo-0001025856	success	185	104	58	127	46	0.314	2,acuminate,anther,apex,branched,brown,bud,calyx,campanulate,chartaceous,cm,compound,corolla,diameter,ellipsoid,elliptic,entire,filament,flattened-reniform,flower,foveolate,fruiting,glabrescent,glabrous,globose,green,herbaceous,lateral,light,long,margin,mm,oblong,orange,pedicel,peduncle,perennial,petiole,pinnately,pointed,prickle,rachi,recurved,rugose,slender,somewhat,spreading,stellate,stigma,streak,strongly,style,subwoody,surface,terminal,uniformly,white,yellow	.4,/4,0,0.3-1,0.3–0.5,0.5,1-3,1.5–2,10–,10–15,15–20,1–,1–1.5,1–2,1–5,2.5–4,20,20–30,20–35,2–,2–4,3,3-10,3–4,3–5,4–,4–10,4–6,5–,5–10,5–15,5–7,6–12,abaxially,acute,adaxially,ag,always,alyx,anthesi,apiculate,armed,articulated,axe,base,becoming,berry,blade,c.,calcium,commonly,connivent,corresponding,crystal,cuneate,densely,difoliate,dr.,eaf,eed,equal,exserted,fifth,four,geminat,glabrou,internode,larger,leaflet,lengthening,lobe,lobed,long-styled,longer,lower,major,narrowly,nearly,nflorescence,oblique,often,one,opposite,orolla,outline,oxalate,pair,papillat,pericarp,petiolulate,petiolule,plurifoliate,pore,poricidal,present,rarely,recurve,rounded,ruit,side,slightly,slit,soon,stout,straight,subopposite,subwood,tamen,tem,throughout,time,tip,triangular,truncat,tub,tube,unequal,unit,usually,vary,vein,vin,way,wide,widest,ympodial,×	1-5,10,10-15,10-30,2-15,2-4,2.5-4,20-35,4-10,5-10,5-7,abaxial,adaxial,arrangement,bark,cell,center,colour,dry,form,fruit,growth,height,history,inflorescence,leaf,length,life,na,new,number,ovary,plant,position,reproduction,scar,seed,shape,spacing,staman,stem,texture,trichome,truncate,vine,width
47	wfo-0001025872	success	160	100	70	90	30	0.438	.5,0.25-0.5,0.5-1,0.6-1,1-2,1.2-1.6,2-5,4-4.5,6-8,anther,apart,apex,apically,bark,becoming,branched,bright,broadly,brownish,calyx,capitate,cm,corolla,crinkled,crowded,cup-shaped,dark,deeply,densely,elliptic,filament,flattened,flattened-reniform,fleshy,flower,fruiting,glabrous,globose,green,junction,later,lateral,leaf,lobed,main,margin,midrib,mm,narrowly,ovary,pedicel,petiole,pitted,plant,pubescent,revolute,rounded,shrub,simple,stem,stigma,style,surface,terminal,thick,trichome,uniseriate,vein,white,young	.1,0.5,1,1-1.3,1-1.5,1.2-1.5,1.7-3,10-25-flowered,2-2.5,2/3,3.5-4,4.5-13,6-10,acute,along,anthesi,auriculate,ba,base,beginning,beneath,berry,blade,coriaceous,decurrent,deflexed,dense,dia,dry,eaf,edicel,eed,exserted,free,glandular-resinous,grayish-brow,greenish-tan,incrassate,inflorescenc,irregularly,live,lobe,lon,long,lower,material,minutely,nflorescence,occasionally,often,older,onto,opposite,pair,paler,papillae,papillo,papillose,planar,plurifoliat,pore,poricidal,portion,prominent,red-papillose,rounded-triangular,ruit,scar,several,shaped,somewhat,soon,spaced,specimen,straight,tall,tapering,tear-drop,thickened,time,tip,tub,tube,ud,unit,visible,way,woody,x,ympodial	10-25,abaxial,adaxial,arrangement,bud,colour,diameter,form,fruit,grayish-brown,growth,height,history,inflorescence,length,life,na,number,peduncle,perennial,plurifoliate,position,rachi,reproduction,seed,shape,spacing,staman,texture,width
48	wfo-0001025875	success	205	106	77	128	29	0.376	0.1-1.1,0.3-2,0.4-0.7,0.8-1.8,1.2-1.8,2.4-2.8,3-6,4.5-6.5,5-10,5-9,7-10,8-11,acicular,acute,andromonoecious,anther,apart,apex,basal,calyx,chartaceous,cm,cylindrical,dark,deeply,densely,diameter,entire,erect,extra-axillary,filament,flower,fruit,fruiting,glabrous,globose,green,inflorescence,lanceolate,leaf,length,lobe,lobed,longer,margin,mm,oblate,obtuse,pale,pedicel,peduncle,perennial,petiole,plant,porrect,prickle,pseudo-racemose,purple,rhizomatous,rotate,shallowly,shrub,simple,sparsely,stellate-pubescent,stigma,straight,streak,style,surface,time,truncate,weakly,white,wide,yellow,yellowish	%,.05,0-0.1,0-0.5,0-1.5,0-5,0.1-0.2,0.2-0.45,0.25-0.4,0.3-0.4,0.4-0.5,0.5-1,0.5-1.3,0.5-6,0.7-0.8,0.8-0.9,0.9-1.4,1-10,1-2,1-3,1-7,1.1-1.6,1.5-2.5,1.5-6,15-25,2-locular,2.3-3,2.5-4.5,3-5,4-10,5-11,5-14,5-15,5-merou,6-13,7-14,7-8,8-14,9-13,?,abaxially,absen,absent,accrescent,across,adaxiall,adaxially,adult,alyx,anvil-shape,articulated,attenuate,axe,ba,base,blade,branchlet,cross-section,cuneate,decimetre,deltate,directed,distally,dm,eaf,eed,eglandular,exocarp,finger,functional,geminat,gland-tipped,grey,hair,half,hastate,heterostylous,juicy,juvenile,lamina,lateral,less,linear,long,lower,mature,mesocarp,mid-point,midpoint,midvein,minute,moist,narrowly,nflorescence,oblique,orolla,pair,part,per,placenta,plurifoliate,pore,possibly,present,ray,ruit,sessile,short,spaced,stalk,stalked,stellae,stellate,tal,tamen,tem,thick,throughout,transparent,tube,unarme,unarmed,unbranched,unit,upper,vary,x,ympodial	abaxial,adaxial,arrangement,bark,bud,cell,center,colour,corolla,form,growth,height,history,life,na,new,number,ovary,position,reproduction,scar,seed,shape,spacing,staman,stem,texture,trichome,width
49	wfo-0001025888	invalid_json_followup	256	121	73	183	48	0.285	.5,.6,1.5,2.1,2.6,3.2,3.8,5,abaxially,acute,adaxially,alveolate,anther,apart,apex,area,attachment,bud,calyx,central,chartaceous,cm,corolla,deltoid,densely,diameter,dry,entire,extra-axillary,filament,flattened-orbicular,flower,fruit,glabrous,globose,gradually,homostylous,increasing,lateral,leaf,little,long,margin,mm,moderately,nearly,notched,orange-red,ovate,pedicel,peduncle,petiole,point,pubescent,red,shrub,simple,sinuate,small,stellate,stellate-pubescent,stigma,straight,style,surface,swelling,tree,white,yellow,yellow-tan,±glabrous,±smooth,×	.05,.3,.4,0.04,0.1,0.2,0.3–0.5,0.4,0.4–0.6,0.4–0.7,0.5–0.7,0.6–1.2,0.7–0.8,0.7–1.5,0.8,0.8–1.0,0.9–1.1,0.9–1.2,0.9–1.3,1.0–1.8,1.2–2.3,1.4–1.8,1.5–1.9,1.5–2.0,1.5–2.1,1.5–4.0,1.7–2.1,1.8–2.3,1.8–3.5,1.9–2.2,1.9–3.4,1/2–2/3,1/3,2.2,2.5–2.6,2.7–3.0,3,3.0–11.1,3.1–4.2,3/4,4.2–5.5,4–8,4–9,5-merou,5.5–11.1,5–7,6–10,7.1–9.1,8.1–17.1,9.5,90°,across,adnate,along,alyx,anthesi,apiculate,apparently,appearing,appresse,arching,articulate,axe,ba,base,berry,blade,branch,branching,broad,brochidodromous,capitat,channeled,clinate,congested,cuneate,dehiscen,denser,dentate,development,difoliate,distal,distinct,eaf,eed,either,emerging,endocarp,exocarp,fertile,filiform,flexed,free,geminat,glabrescent,glandular,hair,hooked,internode,interpetalar,intersepalar,juic,lamina,less,lobe,lon,longer,longitudinally,lower,major,many,mature,middle,midpoint,midrib,midvein,minor,minute,nflorescence,oblique,oblong,opaque,orolla,per,poorly-developed,porrect,portion,potentially,pubescen,pubescence,raised,ray,reflexed,restricted,rigid,rounded,row,ruit,scattered,sessile,shinny,short-stipitate,shorter,side,sinus,smoot,sometimes,spaced,sparsely,splitting,spread,spreading,stellae,stipe,tamen,tardily,tem,thin,though,time,tip,tissue,truncate,tube,two,typically,ud,unarmed,unbranched,vary,vein,weakly,well,wide,yellow-ferruginous,ympodia,young,±90°,±aequilateral,±equal,±erect,±overlapping,±straight	'',0.7-0.8,0.9-1.2,1.5-2.0,1.5-4.0,2.5-2.6,3.0-11.1,5-merous,[,``,abaxial,adaxial,arrangement,bark,capitate,center,characteristic,colour,form,fruiting,growth,height,history,inflorescence,length,life,na,new,number,ovary,perennial,plant,position,prickle,rachi,reproduction,scar,seed,shape,spacing,staman,stem,texture,trichome,value,width,{,}
50	wfo-0001025892	invalid_json_followup	170	102	59	111	43	0.347	0.2-0.4,0.3-0.8,1-2,1.5-5,2.8-3,4.5-7.5,5-17,7-15,8-11.5,absent,anther,apex,articulated,base,calyx,chartaceous,cm,densely,diameter,entire,extra-axillary,flower,fruit,fruiting,globose,grey-green,herbaceous,inflorescence,lanceolate,leaf-opposed,length,linear,long,margin,mm,narrowly,oblate,obtuse,pale,pedicel,peduncle,petiole,prickle,pseudo-racemose,purple,resprouter,simple,solitary,stellate,stellate-pubescent,stem,sticky-glandular,stigma,straight,style,unbranched,white,yellow,yellowish-green	%,.3,0-0.1,0-0.3,0-1,0-10,0.05-0.1,0.1-0.2,0.2-0.5,0.2-0.8,0.3-0.5,0.3-0.7,0.4-0.6,0.4-0.8,0.7-0.9,0.8-1.1,10-17,2-7,2-locular,2.5-4,2.5-6,4-merou,5-7,6-10,8-10,8-11,8-13,9-18,abaxially,absen,adaxiall,adaxially,alyx,apart,axe,ba,blade,broad-based,connivent,cross-section,cuneate,curved,cylindrical,d.,deltate,dense,directed,distall,distributed,dult,eaf,eed,eglandular,erect,exocarp,finger,geminat,glabrous,gland-tipped,glandular,grey,hair,half,juicy,lamina,lateral,less,lobe,longer,lower,mature,mesocarp,mid-point,midpoint,minute,moist,nflorescence,oblique,orolla,papillae,part,per,perfect,placenta,pore,porrect,present,ray,ruit,sessil,sessile,short,spaced,stage,stalk,stellae,tal,tamen,thick,throughout,time,triangular,truncat,tube,unarmed,unit,uvenile,vary,wide,x,ympodial	'',4-merous,[,``,abaxial,adaxial,arrangement,bark,bud,cell,center,characteristic,colour,corolla,filament,form,growth,height,history,leaf,life,na,new,number,ovary,perennial,plant,position,rachi,reproduction,scar,seed,shape,spacing,staman,surface,texture,trichome,truncate,value,width,{,}
51	wfo-0001025893	invalid_json_followup	157	120	82	75	38	0.522	.4,.5,0.5-1.5,0.8-1,1-4,1.5-2,2-2.5,3-5,5-6,accrescent,along,anther,apex,barely,bark,base,beneath,bi-lobed,branched,brownish-green,calyx,capitate,closely,cm,corolla,decurrent,dia,ellipsoid,elliptic,faintly,filament,flower,fruit,fruiting,glabrous,globose,golden-puberulent,green,greyish,internodal,leaf,lobed,long,long-acuminate,longitudinally,margin,minutely,mm,narrowly,nearly,obovate,occasionally,opposite,ovary,overlapping,ovoid-reniform,pale,papillose,pedicel,petiole,pitted,scar,shrub,slender,slightly,sometimes,spaced,stem,stigma,style,surface,tapering,trichome,tube,unicellular,vein,visible,white,winged,woody,x,yellowish	.25,1-1.2,1-1.5,1-2.5,1.5-1.7,11-20,2-3,6-10,anthesi,attenuate,bank,bearing,beginning,berry,blade,broadly,cup-shaped,deflexed,deltoid,densely,difoliate,dry,eaf,early,eed,erect,even,exserted,free,geminate,glabrate,gravelly,growing,impressed,inflorescenc,lateral,lobe,lon,lower,main,many,material,middle,nflorescence,older,pair,papillo,planar,plurifoliat,pore,poricidal,portion,puberulent,red-papillose,reflexed,river,rocky,ruit,sandy,shaped,specimen,straight,stream,striat,tall,tear-drop,thickened,time,tip,ud,unit,usually,widest,ympodial,young	'',[,``,abaxial,adaxial,arrangement,bud,center,characteristic,colour,diameter,form,growth,height,history,inflorescence,length,life,na,new,number,peduncle,perennial,plant,position,prickle,rachi,reproduction,seed,shape,spacing,staman,striate,texture,value,width,{,}
52	wfo-0001025896	invalid_json_followup	146	105	60	86	45	0.411	0.5,0.5-2,1-25,1-6.5,1-8,1.5-9,2-2.5,2.5-14,4-6,5-15,6-10,abaxial,acuminate,angled,apart,apex,brownish,calyx,cell,chartaceous,cm,densely,diameter,eglandular,elliptic-ovate,entire,flower,forked,fruit,glabrous,globose,greenish,hair,margin,membranaceous,mm,nearly,orange,ovate,pale,pedicel,peduncle,petiole,pubescent,purple,rachi,red,rotate-stellate,rugose,shrub,simple,smooth,stem,stigma,style,surface,unbranched,white,x,yellow	-3,-30,.5-2.5,1-1.5,1-3,1.5-2,10-15,10-25,2-14,2.5-5,4,4-12,4-23,4-5,5-7,6-13,7-,7743,abaxially,absen,acosta,acute,adaxiall,adaxially,aggregate,also,articulated,axe,ba,base,blade,branched,connivent,constricted,cuneate,cylindrical,deltate,dendritically,directed,distall,eaf,eed,especially,gland,inflated,like,lobe,long,lower,many-foliat,moderately,near,nflorescence,nther,obtuse,occasionally,often,orolla,perfect,pore,present,puberulent,pubescen,radiu,ripe,ruit,short-stalked,solí,spaced,sparsely,stalked,stone,subcordate,tal,tem,time,tip,triangular-ovate,triangular-subulate,truncat,tube,unit,vary,vein,wide,ympodial	'',2-3,6-30,[,``,adaxial,anther,arrangement,bark,bud,center,characteristic,colour,corolla,filament,form,fruiting,growth,height,history,inflorescence,leaf,length,life,na,new,number,ovary,perennial,plant,position,prickle,reproduction,scar,seed,shape,spacing,staman,texture,trichome,truncate,value,width,{,}
53	wfo-0001025902	invalid_json_followup	211	117	82	129	35	0.389	.2,0.1-0.5,0.5-2.5,1-1.5,1.5-3,11-15,2.5-4,3-10,4-13,5-6,8-15,abaxially,acute,anther,apex,bark,becoming,black,calyx,clavate,cm,conical,corolla,densely,diameter,dull,ellipsoid,entire,filament,flattened-reniform,flower,fruiting,glabrous,globose,green,growth,inflorescence,lanceolate,lateral,leaf,leaf-opposed,length,linear,low,margin,minutely,mm,new,ovary,pale,papillose,pedicel,peduncle,petiole,pitted,pubescent,ridged,rotate-stellate,rounded,scar,scrambling,simple,slender,sometimes,stem,stigma,strongly,style,surface,tangled,tapering,terminal,trichome,uniseriate,vegetation,vine,violet,whitish,woody,x,yellow,yellowish	.5,/2,0.5-2,1-1.2,1.2-1.5,1.5,1.5-2,1/3,1983,2-6,4,4-5,4-6,40,5-merou,8-10,8-9,>,absent,accompanied,adaxially,ag,aid,along,always,alyx,anthesi,apar,ark,articulated,attenuate,axi,base,beginning,berr,berry,branch,branched,branching,broadly,c.,cabrera,cell,chartaceous,circular,climbin,completely,connivent,deciduou,deltate,eaf,eed,either,except,exfoliatin,exserted,fide,fleshy,free,geminat,ilament,leaving,lengthening,less,lobe,lobed,long,loosely,lower,markedly,mature,midvei,minute,nflorescence,obscured,occasionally,often,older,one,orolla,pair,papillat,peg,pendant,per,perfect,pericarp,planar,plurifoliate,pore,poricidal,portion,primary,prominent,revolute,ruit,scattered,semi-aquati,semi-circular,shallow,sleeve,slit,small,somewhat,soon,spaced,sparsely,spreading,tem,testal,thin,time,tip,tube,twining,ud,ultimate,unit,usually,vary,vein,water,way,weak,weight,widely,wing,ympodial,½	'',5-merous,[,``,abaxial,adaxial,apart,arrangement,bud,center,characteristic,colour,form,fruit,height,history,life,na,number,p,perennial,plant,position,prickle,rachi,reproduction,seed,shape,spacing,staman,texture,value,width,{,}
54	wfo-0001025906	success	188	113	89	99	24	0.473	0.1-2,0.20-0.60,1-2,1.6-12.4,16-51,2-4.4,3-10,3-5,4-12,4-7,5-7,8.5-12.5,abaxially,acute,adaxially,anther,apex,axillary,base,blue,brownish,bud,cell,clavate,cm,condition,coriaceous,corolla,covering,cuneate,dark,diameter,drying,filament,flower,forked,fresh,fruit,glabrous,globose,green,green-white,greenish,hair,hair-like,herb,interjected,lanceolate,lateral,leaf,leaflet,light,lilac,linear,make,mm,mucilaginous,obtuse,odd-pinnate,ovoid,pedicel,peduncle,pentagonal,petiole,plant,pubescent,purple,rachi,ripe,rotate,seed,shiny,short,slightly,stigma,stripe,style,subglabrous,subtending,terminal,testal,thick,throughout,wall,wet,white,whitish,width,yellow	0-14,0.15-0.6,0.2-0.6,1-3,1-6,1.1-2,1.8-4.8,2-6,2.6-5.2,4-10,4-5,5-6,5-merou,5.2-9,8-16,acumen,adaxiall,ag,alyx,apart,apparently,articulated,axe,berry,blade,capitat,connivent,decreasing,decurrency,decurrent,delimited,digestion,diminishing,distal,dorsally,eaf,edge,eed,enzyme,erec,exceeding,falcate,first,flat,folded,geminat,generally,glabrou,hal,half,high,homostylous,honeycomb-shaped,lengthening,living,lobe,long,lower,next,nflorescence,orolla,pair,perfect,plurifoliate,pore,poricidal,removed,ruit,second,sessile,seudostipule,size,slit,smaller,spaced,sparsely,specimen,stamen,straight,sub-glabrous,subequal,subglabrou,tall,tamen,tem,third,tip,toward,tri-,tube,typically,unit,unwinged,usually,vary,well,wood,x,ympodial	abaxial,adaxial,arrangement,capitate,colour,form,growth,height,history,inflorescence,length,life,na,number,ovary,perennial,position,pseudostipule,reproduction,shape,spacing,staman,surface,texture
55	wfo-0001025907	invalid_json_followup	148	97	57	91	40	0.385	-4,.5,.5-1,1-3,1-5,1.5-2,2,4-5,acuminate,acute,anther,apex,axil,axillary,brown,calyx,cell,cm,conical,densely,diameter,elliptic,filament,flattened,flower,fruit,fruiting,glabrous,globose,green,greenish,growth,lobed,margin,mm,new,obovate,ovary,ovoid-reniform,pedicel,per,petiole,plant,pubescent,round,rugose,scar,scattered,seed,shrub,simple,slender,stigma,style,surface,trichome,uniseriate	.05,0,0-60,0.8-1.8,1,1-1.2,1-2.3,1.5-2.2,10-15,12-45,2-3.5,2-8,2/3,3-,3-4,3/2,5-15,absent,along,anthesi,anthesis5-7,anticlinal,appearing,attenuate,base,beak,bearing,berry,breaking,c,clavat,conspicuously,deciduous,eaf,edicel,eed,epidermal,erec,free,highly,included,iquito,irregular,isolated,lamina,lobe,lon,long,lower,minutely,near,nearly,nflorescence,occasionally,open,pair,papillate,papillose,population,poricidal,portion,primary,projection,raised,red-papillate,reflexed,remaining,ruit,single-stemmed,sinuous,size,soon,sparsely,tal,tem,thickening,time,tip,truncate,tub,tube,ud,unifoliat,unit,variable,vein,white,white-lenticellate,without,x,ympodial	'',0.05,5-7,[,``,abaxial,adaxial,arrangement,bark,bud,center,characteristic,clavate,colour,corolla,form,height,history,inflorescence,leaf,length,life,na,number,peduncle,perennial,position,prickle,rachi,reproduction,shape,spacing,staman,stem,texture,unifoliate,value,width,{,}
56	wfo-0001026203	success	197	94	60	137	34	0.305	0.06-0.86,0.38-11.3,0.4-3,1-2,2-4.9,2-43,3-10,3-11,3-5,3.2-23,7-47,abaxially,adaxially,anther,apex,blue,bud,cell,clavate,cm,coriaceous,corolla,dark,deep,diameter,elliptic,filament,flower,forked,fruit,glabrescent,glabrous,globose,green,greenish,hair,herb,leaf,light,lilac,medium,mm,mucilaginous,odd-pinnate,ovate,ovoid,pedicel,peduncle,pentagonal,petiole,plant,rachi,rotate,seed,short,stigma,style,terminal,whitish,yellow	0-39,0-7,0.3-11,0.3-6,0.5-2.3,0.5-3.2,0.7-2.6,1-13,1-4,1-5,1-9,1.1-7.9,1.2-5.5,2-10,2-5,2-8.5,2.2-13.3,3.2-22,5-merou,acumen,acuminate,acute,ag,along,alyx,apart,apparently,arranged,articulated,asymmetric,attenuate,axe,axillary,base,basiscopic,bead,berry,blade,brownish,capitat,condition,connivent,covering,decreasing,decurrent,digestion,distal,dorsally,drying,eaf,edge,eed,enzyme,erect,exceeding,flat,folded,fresh,geminat,generally,glabrescen,glabrou,green-white,hair-like,hal,half,high,homostylous,honeycomb-shaped,interjected,lanceolate,lateral,leaflet,lengthening,like,linear,living,lobe,long,lower,make,middle,moniliform,multiple,necklace,nflorescence,orbicular,orolla,pair,perfect,plurifoliate,pore,poricidal,removed,ripe,rosett,rounded,ruit,sessile,seudostipule,side,size,slightly,slit,sometimes,spaced,specimen,stamen,stolon,straight,stripe,subequal,subglabrous,subtending,tall,tamen,tem,testal,thick,throughout,tip,tissue,toward,tri-,tube,tuber,typically,unit,unwinged,usually,vary,wall,wet,white,wide,x,ympodial	abaxial,adaxial,arrangement,bark,calyx,capitate,center,colour,form,fruiting,growth,height,history,inflorescence,length,life,margin,na,new,number,ovary,perennial,position,prickle,reproduction,scar,shape,spacing,staman,stem,surface,texture,trichome,width
57	wfo-0001026205	invalid_json_followup	165	105	67	98	38	0.406	0.3-2,1,1-3,1.5,15-20,5-7.5,5-merous,5.5-6,7-9,absent,acuminate,acute,adaxially,anther,apex,calyx,cm,cream,deeply,densely,diameter,divided,elliptic,entire,extra-axillary,filament,flattened,flower,fruit,fruiting,glabrous,globose,growth,leaf,margin,minutely,mm,new,pedicel,peduncle,petiole,porrect-stellate,prickle,pubescent,purple,rachi,seed,sessile,short,shortly,shrub,simple,slender,slightly,sparsely,stellate,stellate-pubescent,stem,stigma,straight,strongly,style,surface,trichome,violet,white,yellow	-14,-2.5,-6,.5,.5-2,0.5-,0.75-1,1-1.5,1-2,1-6,2-14,2-3,3,3/4,30-35,4,8,abaxially,accrescen,alyx,apical,apparently,armed,around,articulated,attenuate,axe,ba,base,blade,chartaceous,cuneate,difoliate,distinct,eaf,eed,enlarged,erect,exceeding,extror,four,geminat,glandular,globo,hair,homostylous,including,lateral,linear-lanceolate,lobe,long,lower,major,maturing,midpoint,minor,minute,nflorescence,node,oblique,often,orolla,perfec,pore,porrect,proximally,rare,rarely,ray,ruit,scarcely,similar,size,small,smaller,solitary,sparse,stellat,stellate-pubescen,summit,tall,tamen,tem,thickened,third,tip,toward,tube,unarme,unarmed,unit,usually,vary,wide,wing,x,ympodial,zigza	'',0.5-2.5,2,[,``,abaxial,adaxial,arrangement,bark,bud,cell,center,characteristic,colour,corolla,form,height,history,inflorescence,length,life,na,number,ovary,plant,position,red,reproduction,scar,shape,spacing,staman,texture,value,width,zigzag,{,}
58	wfo-0001026208	invalid_json_followup	214	128	94	120	34	0.439	-10,-3,0.1-0.25,0.5-1.2,0.6-0.8,0.7-2,0.8-1.5,1-4,1-5,2,2-20,2-4,2.5-5,2.5-6,3.5-5,5,5-22,5-merous,abaxial,acuminate,acute,adaxial,anther,apart,apex,bark,base,berry,bright,brown,calyx,cm,conical,curved,dark,densely,diameter,dull,elliptic,erect,evenly,filament,flattened,flattened-reniform,flower,fruit,fruiting,glabrescent,glabrous,gray-greenish,green,green-brown,lateral,leaf,length,lobed,long,margin,maturity,mauve,mm,moderately,orange,orange-brown,ovate,pale,pedicel,peduncle,petiole,porrect,prickle,pubescent,recurved,red,scar,sessile,shrub,sometimes,sparsely,spherical,stalked,stellate-pubescent,stem,straight,straw-yellow,style,surface,terete,terminal,trichome,white,wide,yellow,young	-1/2,-5,.5,/3,0,0-20,0-4,0-5,0-8,0.1,0.1-0.2,0.1-0.3,0.5-0.8,0.6-0.9,0.8-1.3,1-2,1.5,1.5-2.5,1.8-2.3,1.8-2.5,1/3,1/4-1/3,1/4-1/6,11-25,2-3,3-30,3-5,3-6,3/,4-7,4-9,5-,5-17,6-22,6-8,abaxially,acut,alyx,apar,apically,apparently,articulated,becoming,blade,branched,broad-deltate,chartaceous,connivent,cuneate,deltate,difoliate,discolorous,distance,drying,eaf,eed,elongated,elongating,equal,extending,free,geminat,geminate,infructescence,lobe,longer,lower,mature,membranous,midpoint,midvein,nflorescence,older,one,open,orolla,oung,pair,pendulous,per,perfec,pericarp,poricidal,portion,prickly,primary,ray,red-brow,rounded,ruit,shorter,side,slender,smooth,somewhat,spaced,spreading,stalk,stellate,stout,subentire,tamen,tapering,tertiary,time,tip,toward,tube,unarme,unarmed,unit,usually,variously,vary,vein,venation,visible,way,woody,ympodial	'',[,``,arrangement,bud,characteristic,colour,corolla,form,growth,height,history,inflorescence,life,na,new,number,ovary,perennial,plant,position,rachi,red-brown,reproduction,seed,shape,spacing,staman,stigma,texture,value,width,{,}
59	wfo-0001026215	success	150	100	66	84	34	0.44	-3,0.05,1-3,1.5,2-3,3/4,4-5,7-8,acuminate,anther,apex,axillary,base,berry,brown,calyx,cell,clavate,cm,completely,conical,corolla,densely,diameter,elliptic,filament,flattened-round,flower,fruit,fruiting,glabrous,globose,green,greenish,herb,horizontal,kink,length,less,lobed,marked,markedly,mm,nearly,occasionally,often,ovary,ovoid-reniform,papillate,pedicel,petiole,purple,rugose,scar,seed,shrub,simple,stem,stigma,strongly,style,surface,way,white,winged,x	.05,.5,0,0.5-1,1,1.5-2,1.5-2.2,13-35,15-2,18-20,2,2-3.5,2-4,4-15,abaxially,abruptly,absent,along,anthesi,anticlinal,ape,axil,beak,bifi,broadly,conspicuously,continually,deltate,eaf,edicel,eed,enlarged,entire,epidermal,erect,exserted,free,highly,internode,irregular,lobe,long,lower,minutely,narrowing,nflorescence,noddin,nodding,onto,pair,papillae,papillat,per,poricidal,portion,primary,projection,raised,red-papillose,reflexed,rounded,ruit,shortsympodial,single-stemmed,sinuous,small,ste,tal,tem,thickening,time,tip,tub,tube,ud,unifoliat,unit,usually,vein,white-lenticellate,white-pubescent,wide,wing,without	abaxial,adaxial,arrangement,bark,bifid,bud,center,colour,form,growth,height,history,inflorescence,leaf,life,margin,na,new,number,peduncle,perennial,plant,position,prickle,rachi,reproduction,shape,spacing,staman,tall,texture,trichome,unifoliate,width
60	wfo-0001026220	success	158	93	48	110	45	0.304	/3,0.3-1.5,1.0-1.8,1.3-1.7,2.5-3.5,4-12,annual,anther,back,band,blade,brown,calyx,cm,dark,essentially,foveolate,glabrous,glaucescent,herb,internodal,leaf,long,minutely,often,ovate,pentagonal,pentagonal-stellae,petal,petiole,pigment,pinnatifid,plant,prickle,purple,red,reddish,reticulately,ridged,spherical,stellate-pubescent,stem,straight,suffused,surface,terminally,thrice,yellow	.3-2.8,.5,0.2,1,1.5-2.5,10-20,4-10,5-10,50-90,6-10,7-11-flowere,8-12,accrescent,across,acute,along,alyx,anthesi,ape,armed,base,bearded,becoming,berry,campanulate,closely,coarsely,conspicuous,developing,dia,difoliate,divided,dry,dryin,eaf,eed,flattened-ovo,foliaceous,geminat,glandular,hair,heteromorphic,interpetalar,invested,lacking,lanceolate,large,later,latter,lobe,lon,main,many,maturity,mm,mostly,much,near,nearly,nflorescence,obtuse,one,orolla,per,persistent,persisting,pinnatisect,plicate,portion,prickly,proximal,ray,reduced,ruit,scattered,second,short,shorter,side,similar,simple,slende,somewhat,spaced,splitting,stellae,stellate,surrounding,tall,tamen,tightly,tigma,tissue,tub,tube,twice,tyle,ultimate,unexpande,unit,upon,vary,vein,ventral,well-developed,widely,year,yello,ympodial,young	7-11-flowered,abaxial,adaxial,apex,arrangement,bud,cell,center,colour,corolla,diameter,filament,flattened-ovoid,flower,form,fruit,fruiting,growth,height,history,inflorescence,length,life,margin,na,new,number,ovary,pedicel,peduncle,perennial,position,rachi,reproduction,scar,seed,shape,spacing,staman,stigma,style,texture,trichome,unexpanded,width
61	wfo-0001026227	success	150	76	52	98	24	0.347	.3,.8,0,0-1,0-1.5,0.1-0.7,0.3-2.2,1-4,3-6,5-merous,acicular,apart,apex,base,chartaceous,cm,cuneate,densely,diameter,elliptical,entire,flower,fruit,globose,green,grey,herbaceous,inflorescence,leaf-opposed,length,lobed,margin,mm,moderately,obtuse,ovate,pale,pedicel,peduncle,petiole,prickle,pseudo-racemose,resprouter,shallowly,simple,solitary,sparsely,stellate,stellate-pubescent,thick,unbranched,yellow	%,0-0.1,0-3,0.25-0.4,0.3-0.4,0.3-0.5,0.3-0.6,0.3-0.9,0.4-1.4,0.5-1,0.9-1.2,1,1-1.3,1.5-4,1.6-2,10-15,15-20,17-55,2-10,2-2.5,2-3,2.5-3,3-7.5,5-30,6-8,7-8,abaxially,absen,absent,across,adaxially,armed,articulated,axe,ba,blade,calyx,chartaceou,d.,deltate,distributed,eaf,eed,eglandular,finger,fruiting,gland-tipped,gree,hair,half,index,lamina,lateral,lobe,lobing,lon,long,longer,lower,mature,mid-point,midpoint,midvein,nflorescence,oblique,orolla,part,per,porrect,present,ray,ruit,sessile,short,side,spaced,sprawling,stage,stalk,stellae,stigma,straight,style,tal,tamen,tem,throughout,time,transparent,tube,unit,unknow,uvenile,vary,wide,x,yellowish,ympodial	abaxial,adaxial,arrangement,color,corolla,form,growth,height,history,leaf,life,number,perennial,plant,position,reproduction,seed,shape,spacing,stem,surface,texture,unknown,width
62	wfo-0001026229	success	299	120	80	219	40	0.268	1,5,abaxial,abaxially,adaxial,anther,base,berry,black,broadly,brown,calyx,clavate,cm,cordate,corolla,covered,cyme,dark,densely,diameter,elliptic,elongated,entire,flattened,flower,fruit,glabrescent,glabrous,globose,golden,green,growth,hirsute,immature,inflorescence,internodal,irregular,lateral,leaf,lobed,long-stalked,margin,mature,membranaceous,mm,moderately,narrowly,new,ovate,ovate-elliptic,pale,pedicel,peduncle,petiole,pit,porrect-stellate,pubescent,purple,rachi,reniform,shiny,short-,shrub,simple,slightly,sparsely,stellate,stem,stigma,style,subopposite,surface,terminal,trichome,unbranched,white,yellow,yellowish-white,¾	0.1–1.47,0.2–0.8,0.35,0.3–0.9,0.3–1.2,0.4,0.8–1.2,0.8–2,0.9,0.9–4.3,1-celled,1.2–4.8,1.3–1.5,1.3–1.7,1.4,1.7–11.8,1.7–2.3,1.8,1.8–5.5,1.9–2.5,1/3,13,1–1.4,1–2,1–4,2,2.3–3.4,2.8–4,2–3,2–3-celled,2–4-celled,3,35,3–4,3–5,4.5–6.5,4–6,5-merou,5–9,6–15,6–7,6–8,8.6–12,8–10,9–31,accrescent,acuminate,acute,adaxiall,adaxially,ag,almost,also,always,alyx,anthesi,apex,ark,articulated,associated,asymmetric,attenuate-caudate,axe,ba,barely,beneath,blade,branch,branching,broken,camptodromous,capitate,celled,central,changing,commentary,commonly,completely,concentrated,connivent,creating,cuneate,cylindrical,deltoid,develope,developed,differing,directed,discolorous,di­,dried,drying,eaf,eed,eglandular,ellipsoidal,even,faces,few-rayed,found,free,frequently,fresh,fully,geminate,gland,glandular,glandular-capitate,hair,head,hispid,hyaline,ilament,impressed,included,insertion,introrsely,involute,lamina,lanceolate,larger,less,like,lobe,long,longer,longitudinal,lower,mainly,material,maturit,midpoint,midri,midvein,minute,mixed,much,multangulate,multangulate-stellate,multiseriate,narrow-ovate,near,nearly,nflorescence,oblong,often,old,older,one,open,opening,orientation,orolla,other,oung,pair,paired,papillose,pedunculate,per,perfect,pink,plurifoliate,point,poorly,pore,poricidal,portion,primary,purplish,ra,raised,rarely,ray,remnant,revolute,rounded,ruit,secondary,see,sessile,shin,short-stalked,shorter,size,slit,small,smaller,solitary,sometimes,somewhat,spread,spreadin,spreading,stalk,strongly,subsessile,supported,surfac,three,tree,trifoliate,tube,tuft,type,ud,unequal,unit,upper,usually,vary,vein,venation,vestiture,visible,weakly,whitish-green,wide,ympodial	0.1-1.47,0.3-1.2,0.35-4.3,0.9-4.3,1.3-1.7,1.8-5.5,1.9-2.5,2.8-4,5-merous,6-15,6-7,8-10,8.6-12,arrangement,bark,bud,center,colour,filament,form,fruiting,height,history,length,life,na,number,ovary,perennial,plant,position,prickle,reproduction,scar,seed,shape,spacing,staman,texture,width
63	wfo-0001026230	success	144	89	57	87	32	0.396	.25,.5,.8,0.3-1.5,0.9-2,1-1.4,2-4,3-4,acuminate,anther,apart,apex,area,bark,base,bud,calyx,cm,corolla,elliptic,erect,filament,fruit,fruiting,glabrous,globose,green,grey,leaf,lobed,margin,minutely,mm,nearly,opposite,ovary,ovoid,papillose,pedicel,petiole,rusty-papillose,scar,shrub,simple,slender,small,stem,stigma,style,surface,tapering,tree,tube,unknown,white,woody,x	0.5-3,0.75-1,1-1.5,1-4,1.1-1.8,1.8-2.3,1.9-4.1,12.6-20.8,2-5,4.6-9.3,5-10,5-20-flowered,acute,anisomorphic,anisophyllou,anthesi,apiculate,appears,back,beginning,beneath,berry,broadly,clavate,clu,completely,cordate,coroll,deflexed,deltoid,dia,difoliate,distal,eaf,edicel,eed,enclosing,evenly,except,free,geminate,immature,inflorescenc,large,lateral,lobe,lon,long,long-acuminate,long-triangular,lower,main,major,middle,minor,nflorescence,obtuse,older,orbicular,pair,pointed,pore,poricidal,portion,raised,reflexed,rounded,ruit,shaped,sinus,slightly,spaced,straight,strongly,tall,tear-drop,thickened,tip,ud,umbonate,unit,vein,white-lenticellat,widest,winged,ympodial,young	5-20,abaxial,adaxial,arrangement,cell,center,colour,diameter,flower,form,growth,height,history,inflorescence,length,life,na,new,number,peduncle,plant,position,rachi,reproduction,seed,shape,spacing,staman,texture,trichome,white-lenticellate,width
64	wfo-0001026233	invalid_json_followup	165	99	55	110	44	0.333	-1,-1.9,-5.5,-50,.75,0.7-0.8,0.8-1.55,1.2-2.7,3.5-4.5,5-30,6,acute,annual,anther,antrorse,apex,calyx,campanulate,capitate,cm,densely,diameter,elliptic,entire,filament,fruiting,globose,herb,herbaceous,leaf,less,lilac,margin,mm,moderately,non-glandular,ovate,pale,papery-scarious,petiole,pinnatisect,pubescent,seed,simple,sparsely,stigma,style,subglobose,surface,trans-ovoidal,trichome,unifoliate,uniseriate,x,yellow	-3.8,-8.1,.25,0.3,0.5,0.7-,0.8-1.3,0.8-4,1,1-,1.1,1.5,1/2,2,2-,2.1,2.3-7,2.4-3.5,2.6,2/3,3.2-3.7,3.2-4.7,4-,5-6.2,abundant,accrescent,ag,annular,articulated,ascending,basal,base,bearing,berry,broadly,coat,conspicuous,cuneate-attenuate,curved,cylindrical,difoliat,dimorphic,eaf,eed,ellipsoidal,embryo,evident,few-,glabrous,hair,hig,interlobular,investing,lamina,larger,lobe,lobed,long,longitudinal,longitudinally,lower,membrane,minutely,multicellular,narrowly,near,obtuse,occasionally,opening,orolla,other,outer,ovule,partially,pinnatipartite,pore,poricidal,portion,present,protuberance,pubescen,ree,reticulate,ridged,rounded,ruit,scarcely,seede,serrate,shorter,slender,slightly,slit,small,smaller,striate,strongly,styl,tem,tip,tube,tuberculate,unequal,unit,vary,venatio,verrucose,wider,winged,ympodial	'',[,``,abaxial,adaxial,arrangement,bark,bud,cell,center,characteristic,colour,corolla,difoliate,flower,form,fruit,growth,height,history,inflorescence,length,life,na,new,number,ovary,pedicel,peduncle,plant,position,prickle,rachi,reproduction,scar,shape,spacing,staman,stem,texture,value,width,{,}
65	wfo-0001026241	invalid_json_followup	220	129	84	136	45	0.382	109,abaxially,adaxially,anther,apex,appearing,appears,articulated,berry,black,brittle,brown,calyx,capitate,cell,cm,conical,corolla,covered,cup,densely,depressed-globose,dry,entire,erect,erose,et,filament,flower,foliose,fruit,fruiting,galiano,glandular-pubescent,globose,herb,inflorescence,internodal,irregularly,leaf,lobed,margin,mm,open,orangish,outline,ovary,ovate,ovoid,pedicel,peduncle,perennial,petiole,pinnatifid,pitted,pubescent,pulp,rachi,remain,reniform,seed,shallowly,shiny,simple,sinuate,slightly,somewhat,stellate,stem,stigma,stout,style,subshrub,surface,taproot,ternate,triangular,trichome,truncate,tuberculate,uniseriate,white,woody,x	.2,.3,.5,0.1–0.15,0.2–,0.3–,0.3–0.4,0.3–0.6,0.3–1,0.5,0.5–0.7,0.5–0.8,0.5–1,0.7–1.1,1-,1-celled,1.2–1.5,1.2–2,1.5–1.7,1.5–2.5,1.5–3.5,1.9–2.1,1/3–1/2,10-20,1–,1–1.1,1–1.4,1–1.5,1–2,2-flowered,2.5–3,2–2.1,2–3,3,3-,30–50,3–3.1,4-,4.5–5,5,5-celled,5-merous,6,always,anthesi,apical,attenuate,ba,basal,base,basiscopically,beak,branching,broader,campanulate,center,connecting,cordate,curved,curving,darker,decurrent,deflexe,dehiscing,deltate,denser,dia,difoliate,discrete,drying,dwarf,eaf,eglandular,elliptic,enclosed,equal,extended,foliat,free,geminate,glabrous,gland,glandular,intially,larger,lateral,leaflet,like,lobe,lon,long,longitudinal,main,midvein,mixture,much,near,nflorescence,oblique,one,onto,papillat,papillate,per,perfect,pericarp,pore,portion,prolonged,pubescen,robust,ruit,slit,small,smaller,sometimes,spatulate,stamen,strongly,succulent,sulcate,terminal,testa,thick,thickened,tip,tissue,tube,ud,unit,usually,vein,way,wide,wing,ympodial	'',0.3-1,0.5-0.7,1-1.1,1-1.5,1-2,1.5-1.7,2,2-2.1,2-3,2.5-3,30-50,4.5-5,[,``,abaxial,adaxial,arrangement,bark,bud,characteristic,colour,diameter,form,growth,height,history,length,life,na,new,number,plant,position,prickle,reproduction,scar,shape,spacing,staman,texture,value,width,{,}
66	wfo-0001026242	success	210	109	77	133	32	0.367	-1.5,0-2,0.05-0.2,0.4-0.5,0.4-2,0.5-1,0.7-1.3,1-1.5,1-2.5,1.5-4,10-20,2-5,2.5-4.5,4-10,4-5-merous,abaxial,acute,anther,apart,apex,bark,berry,branched,bright,calyx,cm,deltate,densely,diameter,dull,erect,evenly,filament,flattened,flattened-reniform,flower,fruit,fruiting,glabrescent,glabrous,green,lateral,leaf,length,lobed,margin,maturity,membranous,mm,moderately,multangulate,orange-brown,pale,pale-brown,pedicel,peduncle,petiole,prickle,recurved,red,red-brown,reflexed,scar,sessile,shrub,sparsely,spherical,stellate-pubescent,stem,straight,style,surface,terete,trichome,white,yellow,young	-0.9,-2,-5,-6,/4,0,0.1,0.3-0.5,0.35-,0.4-0.55,0.5,0.5-0.7,0.55-0.9,0.7,1-3,1.2-2,1.5-3,1/2,1/5-1/3,1/6-1/4,10-,2-2.5,2.5-2.8,3-6.5,30-80,4-13,4.5-5.5,5-,5-18,5-7,6.5-8,7-17,8-20,abaxially,acut,almost,alyx,ame,apar,apically,apparently,articulated,base,blade,broad-deltate,c.,concolorous,connivent,cuneate,curved,difoliate,distance,drying,eaf,eed,elliptic,elongating,equal,extending,eye,filiform,free,geminat,glabrou,glandular,green-gra,hair,infructescence,irregularly,largely,lobe,long,longer,lower,mature,midpoint,midvein,minute,naked,narrow-deltate,nflorescence,obtuse,occasionally,older,one,open,orolla,oung,pair,per,perfec,pericarp,poricidal,porrect,portion,prickl,prickly,primary,ray,rounded,ruit,shorte,shorter,side,simple,smooth,sometimes,spaced,spreading,stalk,stalked,stellate,subentire,tamen,tapering,tertiary,time,tip,tube,unarme,unarmed,unit,upper,variously,vary,vein,venation,visible,way,weakly,wide,woody,ympodial	0.35-0.55-0.9,adaxial,arrangement,bud,cell,center,colour,corolla,form,green-gray,growth,height,history,inflorescence,life,na,new,number,ovary,perennial,plant,position,reproduction,seed,shape,spacing,staman,stelate-pubescent,stigma,texture,unknown,width
67	wfo-0001026259	invalid_json_followup	233	132	92	141	40	0.395	.8,1.5,2-ridged,6,abaxial,abaxially,acuminate,acute,adaxial,anther,apex,appressed,base,berry,broadly,brown,calyx,central,cm,concave-reniform,conical-ellipsoid,corolla,cream-coloured,cylindrical,diameter,ellipsoid,entire,filament,fleshy,flower,fruit,fruiting,glabrous,globose,green,green-orange,halfway,herb,inflorescence,internodal,lateral,leaf,length,less,lilac,live,lobed,margin,membranous,minutely,mm,nearly,once-branched,ovary,ovate-lanceolate,pale,papillate,pedicel,peduncle,petiole,plant,pubescent,purple-coloured,rachi,rarely,ripe,scar,shiny,shrub,simple,slightly,smooth,somewhat,sparsely,spreading,star,stellate,stem,stigma,straight,style,surface,tightly,translucent,trichome,turning,uniseriate,white,winged,yellow,yellow-green,young	.1,.7,0.1–0.2,0.2–0.4,0.3–1.2,0.4–0.6,0.5,0.5–0.6,0.7–0.9,0404,0–2,1,1-celled,1.0–1.2,1.0–3.3,1.2–8.4,1.4–4.0,1.5–2.0,11–22,12–24,1m,1–2,1–2-celled,1–3-celled,2/3,2–17,2–3-celled,3.0–3.4,35–45,4–5,5-merous,5–14,5–7-celled,7–10,8–11,?,adaxially,affected,age,anthesi,apar,arising,becoming,beyond,branch,branched,branching,cell,close,coloured,cone,congested,decurrent,dehiscing,deltate,densely,difoliate,drop,eaf,eed,elongating,end,especially,et,exerted,free,geminat,gradually,growt,hilum,individual,knapp,larger,leave,lengthening,like,lobe,lon,long,longer,lower,lowermost,much,narrower,narrowly,near,nflorescence,node,occasionally,often,one,outline,pair,pathogen,pentagonal,per,perfect,pericarp,pore,poricidal,portion,positioned,primary,purple,purple-black,recurving,reduced,reflexed,relatively,remaining,rounded,ruit,short,shorter,similar,slit,sometimes,spaced,splitting,stone,stout,strongly,sub-laterally,tall,tapering,tem,testal,thick,tinged,tip,together,toward,tube,two,ud,unit,vein,wide,woody,ympodial,–15	'',0-2,0.1-0.2,0.2-0.4,0.3-1.2,1-3-celled,1.0-1.2,1.0-3.3,1.4-4.0,12-24,3.0-3.4,5-14,[,``,arrangement,bark,bud,characteristic,colour,form,growth,height,history,life,na,new,number,perennial,position,prickle,reproduction,seed,shape,spacing,staman,texture,value,width,{,}
68	wfo-0001026262	success	179	110	81	98	29	0.453	0.2-0.6,0.25-0.5,0.5-1,0.5-1.5,0.8-1.4,1-2,1-5,1.5,10-15,2-5,3,3-10,3-6,4-10,4-6,7-13,7-9,abaxial,absent,acute,adaxial,anther,apex,brown,calyx,chartaceous,cm,cylindrical,dark,densely,diameter,extra-axillary,filament,filiform,flower,fruit,fruiting,glabrous,globose,green,immature,leaf,light,lobed,mature,mm,moderately,mottling,nearly,netlike,orange,ovate,pedicel,peduncle,petiole,pit,porrect-stellate,prickle,pubescent,rachi,raised,reniform,ridge,roselike,scandent,separated,shrub,simple,stellate,stem,stigma,style,surface,tan,triangular,unbranched,unlobed,vine,white,x,yellow	0.5,0.5-1mm,0.75-1.5,1,1-.,1.5-2,2-2.5,2-3,30,4-15,4-7,4-8,5-8,5-merou,abaxially,absen,accrescent,adaxiall,adaxially,alyx,apar,apical,apparently,armed,asymmetrical,attenuate,axe,base,berry,beyond,blade,connivent,contiguous,cordate,difoliate,directed,discolorous,distal,eaf,eed,either,em,end,expanded,exserted,frui,geminate,glabrou,gree,hair,interpetelar,intorsel,lacking,like,lobe,long,lower,major,midpoint,midrib,midvein,multicellular,multiseriate,narrowly,nflorescence,obscure,obtuse,occasionally,often,orolla,pair,per,perfect,pore,ray,recurved,ruit,rusty,secondary,side,slightly,spaced,sparsely,stalk,stamen,ste,tamen,tapering,tissue,tube,unarmed,unequa,unicellular,unit,vary,vein,wide,ympodial	1-4,5-merous,apart,arrangement,bark,bud,colour,corolla,form,growth,height,history,inflorescence,length,life,margin,na,number,ovary,plant,position,reproduction,seed,shape,spacing,staman,texture,trichome,width
69	wfo-0001026267	invalid_json_followup	162	112	72	90	40	0.444	.25,0.6-1.7,0.7-1.1,1-1.2,1-2.6,2.5-3,3-15,5-7,acuminate,acute,anther,apex,bark,base,bright,calyx,closely,cm,corolla,densely,drying,filament,flattened-reniform,fruiting,glabrous,globose,green,greenish-white,greyish-green,lavender,leaf,lobed,margin,minutely,mm,narrowly,nearly,occasionally,often,opposite,ovary,ovate,overlapping,pale,papillose,pedicel,petiole,pitted,pubescent,ripening,rough,scar,scattered,shrub,simple,slender,small,spaced,sparsely,stem,stigma,style,surface,tan,tapering,tinge,tree,trichome,tube,uniseriate,white,yellow-green	.5,0.1-1,0.5-1,1-1.5,1-4,1.5-2,1.5-2.3,20-30-flowered,3-6.1,3.2-8.6,4-8,8-10,8.5-15,anthesi,attenuate,axil,ba,beginning,beneath,berry,blackish,body,broadly,crateriform,cuneate,decurrent,deflexed,depressed,dia,differing,difoliate,distally,distinct,eaf,edicel,eed,except,exerted,free,geminat,hard,incrassate,inflorescenc,larger,lateral,lobe,lon,long,longinflorescence,lower,main,major,maturity,middle,minor,older,one,pair,papillo,pitting,pore,poricidal,portion,quickly,raised,reflexed,remaining,ruit,scarious,shaped,size,slightly,softening,soon,straight,tall,tear-drop,tip,triangular,tuft,ud,unit,vein,widest,wing,winged,woody,x,ympodial,young	'',20-30,[,``,abaxial,adaxial,arrangement,bud,cell,center,characteristic,colour,diameter,flower,form,fruit,growth,height,history,inflorescence,length,life,na,new,number,peduncle,plant,position,prickle,rachi,reproduction,seed,shape,spacing,staman,texture,value,width,{,}
70	wfo-0001026272	invalid_json_followup	182	119	86	96	33	0.473	1,1-1.5,12-15,2-2.5,2-3,2-7,20,4-5,5-8,7-8,abaxial,anther,apiculate,bark,brown,calyx,clavate,cm,corolla,corymbose,cream-colored,cyme,diameter,elliptic,filament,flattened,flower,form,fruiting,glabrous,glandular,globose,green,growth,heterostylous,inflorescence,internodal,lanceolate,lobed,mm,new,obelliptic,ovary,ovoid,pedicel,peduncle,petiole,pitted,poricidal,porrect,prickle,pubescent,reddish,reniform,reticulately,rugose,scabrous,scandent,scar,sessile,shrub,simple,slightly,somewhat,spaced,stellate,stem,stigma,style,sub-sessile,subconical,subglobose,surface,tapering,terete,thick,tip,trichome,turbinate,unarmed,unevenly,velutinous,viscid-pubescent,white,x,yellowish	0.2-0.3,1-1/5,1-2,1-2-celled,1.2-1.5,1.5-2,1/3,20-30,3-4,3-5,3.5-4,6-8,7-10,abaxially,adaxially,age,anthesi,apex,armed,articulated,basal,base,berry,beyond,branched,celled,coriaceous,densely,denser,discolorous,distal,eaf,eed,epidermi,erect,exserted,free,fused,lengthening,like,lobe,long,long-styled,lower,many,midpoin,midpoint,minute,mixed,multangulate,multicellular,nflorescence,numerous,oblong,older,partially,pendant,per,perfect,pericarp,plurifoliat,pore,porrect-stellate,portion,prickly,pubescence,quarter,rachi,raise,recurved,reduced,ruit,rusty,short-styled,slit,sparse,sparsely,stalked,staminate,subcoriaceous,subtruncat,testa,time,triangular-lanceolate,tube,ud,unarme,unicellular,unit,upper,venation,visible,way,woody,ympodial,¾	'',[,``,adaxial,arrangement,bud,cell,center,characteristic,colour,fruit,height,history,leaf,length,life,margin,na,number,plant,position,raised,reproduction,seed,shape,spacing,staman,subtruncate,texture,value,width,{,}
71	wfo-0001026279	success	248	111	82	166	29	0.331	0.8-2.3,0.9-1.8,1-10,1-3.5,1.1-1.9,1.9-3.2,11.5-19.7,3-4,3.1-4.2,3.4-5.2,9-22,accrescent,adaxially,anther,apex,attenuate,black,branched,brown,bud,calyx,capitate,cm,conical,corolla,dark,deltoid,diameter,drying,elliptic,entire,filament,flower,fruit,fruiting,glabrescent,globose,granular,grayish,grayish-green,green,lanceolate,lavender,leaf,length,lilac,many,margin,mm,multangulate-pubescent,narrowly,obovate,orbicular,pale,pedicel,peduncle,petiole,plant,porrect-stellate,pseudo-terminal,rachi,reticulate-punctate,scabridulous,scabrous,shrub,simple,slowly,somewhat,stellate,stem,stigma,style,suborbicular,surface,time,tomentose-pubescent,tree,white,whitish,yellow,yellowish,yellowish-tan	-11.4,-2.9,-34.3,-4,-5.9,/14-1/8,0.2-0.4,0.25-0.4,0.9-1,1-1.4,1.1-1.6,1.5-1.8,1.5-3,1.7-2.3,1.9-3,1/2,14-27,2.4-3.2,2.5-3.2,2.6-4.8,2/3,3.1-3.6,3.5-7.8,3.8-5.1,4-7.5,5-200,5-8,8,8-11,8.5-10.5,abaxially,acuminate,acute,adaxiall,ag,anthesi,apart,apparently,appearing,appressed,ark,around,articulated,axe,axillary,ba,base,berry,blade,blunt-tipped,branch,chartaceous,closely,completely,covering,cuneate,cylindrical,dendritic-echinoi,dendritic-echinoid,dense,directed,distally,due,eaf,earl,echinoi,echinoid,edge,eed,elongated,enveloping,equal,evident,exerted,expanded,farinose,few-rayed,fleshy,free,glabrescen,glabrous,hair,half,immature,inserted,lateral,lengthening,lobe,lobed,long,long-stalked,longer,longitudinal,longitudinall,lower,m.,main,mature,midrib,minute,mixed,multangulate,multiseriate,nflorescence,oblong,occasional,occasionally,often,older,open,orolla,ovate-lanceolate,overlapping,partly,perfect,plurifoliate,pore,poricidal,present,prominent,pubescence,rounded,ruit,scattered,secondary,semi-ovate,sessile,short,short-,short-decurrent,short-stalked,side,slightly,slit,spaced,splitting,stalk,stamen,subcampanulate,subcoriaceous,subsessile,sulcate,suture,tall,tamen,tertiary,thickened,thin,thin-stalked,tip,tomentose,tube,ud,unarme,unarmed,unit,unwinged,upper,usually,vary,vein,way,wide,x,ympodial,young	75-200,abaxial,adaxial,arrangement,bark,cell,center,colour,form,growth,height,history,inflorescence,life,na,new,number,ovary,perennial,position,reproduction,scar,seed,shape,spacing,staman,texture,trichome,width
72	wfo-0001026292	success	190	114	89	101	25	0.468	-13,0.25-0.5,0.5-1,0.5-2,0.75-1.25,1-1.5,1-3,1-5,1.5,1.5-8,10-15,12-16,2-6,2.5-3.5,20-25,3-8,3-9,5-10,absent,acute,adaxial,anther,apex,armed,base,brown,bud,calyx,chartaceous,cm,dark,diameter,distally,expanded,extra-axillary,filament,filiform,flower,fruit,fruiting,glabrous,globose,green,immature,leaf,lobed,long,many,margin,mature,mm,moderately,nearly,netlike,obtuse,orange,orange-red,ovate,pedicel,peduncle,petiole,pit,prickle,pubescent,rachi,raised,recurved,reniform,ridge,roselike,separated,shrub,simple,slightly,small,sparsely,stellate,stem,stigma,style,surface,tan,triangular,unbranched,white,whitish,wide,x,yellow	0.5,0.5-1.5,1-2.5,1-8,1.5-2,1.5-2.5,1/3,13-17,2-3,2-4,3-15,3-5,30-40,4-8,5-merou,abaxially,absen,accrescent,adaxiall,adaxially,alyx,apar,apical,apparently,asymmetrical,attenuate,axe,berry,beyond,blade,connivent,cordate,curved,cut,cylindrical,densely,difoliate,directed,discolorous,distal,eaf,eed,either,end,exserted,flattened,frui,geminate,glabrou,gree,hair,introrsel,lanceolate,less,like,lobe,lon,lower,major,midpoint,midrib,midvein,multicellular,multiseriate,nflorescence,obscure,occasionally,often,orolla,pair,per,perfect,pore,porrect-stellate,ray,reflexed,ruit,scandent,secondary,side,sinus,spaced,spreading,stalk,stamen,swollen,tamen,tapering,tem,thin-skinned,tube,unarmed,unequa,unicellular,unit,upward,vary,vegetatio,vein,way,ympodial	5-merous,abaxial,apart,arrangement,colour,corolla,form,growth,height,history,inflorescence,length,life,na,number,ovary,plant,position,reproduction,seed,shape,spacing,staman,texture,width
73	wfo-0001026298	invalid_json_followup	192	114	79	113	35	0.411	0.1-0.3,0.2-4,0.25-0.5,0.3-2,0.4-1,0.5-3,0.6-1.5,1-1.5,1.5-4,2850,3-6,acuminate,acute,along,anther,apex,appressed,area,bark,beneath,broadened,calyx,closely,cm,corky,corolla,elliptic,fide,filament,flower,fruiting,glabrous,globose,green,greyish,haught,inflorescence,leaf,length,lobed,long-styled,margin,midrib,minutely,mm,obovate,opposite,ovary,overlapping,ovoid-reniform,pale,papillose,pedicel,petiole,pitted,plant,puberulent,rather,red,rhizomatous,rough,scar,shape,short-styled,shrub,simple,sometimes,spaced,stem,stigma,style,surface,tapering,tip,treelet,trichome,uniseriate,white,yellowish-tan	.5,0.5-2,0.75-1,0.8-2,1.4-6,1.5-2.5,1.5-9,2-3,3-4,3/4,4-13,5-30-flowered,7-12,8-28,american,anthesi,appearing,auriculate,ba,base,bearing,beginning,berry,blade,bu,caudate,central,conical,costa,deflexed,deltoid,densely,dia,differing,difoliate,distal,dry,eaf,edicel,eed,ellipsoid,erect,even,exsertion,free,geminat,glabrate,golden,impressed,inflorescenc,later,lateral,lobe,locality,lon,long,long-triangular,lower,main,major,material,middle,minor,minute,nflorescence,oblique,occasionally,often,older,one,orbicular,pair,papillo,peelin,planar,pore,poricidal,portion,prominent,rarely,reddish,reflexed,rest,rican,rounded,ruit,scattered,shaped,shorter,single,size,slender,somewhat,straight,tall,tear-drop,thick,third,time,tube,two,ud,unicellular,unit,variable,varying,vein,way,widest,woody,x,ympodial,young	'',5-30,[,``,abaxial,adaxial,arrangement,bud,center,characteristic,colour,diameter,form,fruit,growth,height,history,life,na,new,number,peduncle,peeling,position,prickle,rachi,reproduction,seed,spacing,staman,texture,value,width,{,}
74	wfo-0001026299	invalid_json_followup	239	123	88	151	35	0.368	-3.5,0.2-0.25,0.25-0.5,0.4-0.5,0.5,0.5-2.5,0.8-1,0.9-1,1,1.1-1.7,1.5-,1.8-2,3.5-10,5-20,6-20,almost,along,anther,apex,articulated,beneath,broadly,brown,calyx,capitate,cm,conical,corolla,crenate-serrate,dark,densely,diameter,distal,elliptic,entire,filament,flower,fruit,fruiting,glabrous,glandular,globose,green,hair-like,half,herb,imparipinnate,inflorescence,interrupted,investing,irregularly,leaf,less,lobed,loosely,margin,middle,minutely,mm,obovate,outgrowth,ovary,pale,pedicel,peduncle,pentagonal,perennial,petiole,pubescent,rachi,regularly,short,simple,sparsely,spreading,stem,stigma,stripe,style,surface,tall,tip,trichome,uniseriate,vein,velvety,white,yellow	--,-0.8,-1,-10,-2.5,-5,.5,0-8,0.1-0.2,0.1-0.25,0.1-0.4,0.1-0.5,0.15-0.2,0.2-1,0.3-0.4,0.4-2,0.5-0.6,0.5-0.7,0.5-1,0.6-2,0.7-3.5,0.8-0.9,1-1.4,1-celled,1.2-1.6,1.2-5,1.5-2.3,2-4,2-6,2-foliate,2-locular,2.2-3.2,2.5,2.5-7,25,3-,5,5-15,7-12,abaxially,absent,abundant,acroscopically,acute,adaxially,angled,anthesi,apical,appearance,appendage,approximately,axi,basal,base,basiscopically,berr,bract,bracteate,cell,change,chota,column,could,crenat,decurrent,developed,diamete,eaf,ebracteate,edicel,eed,eglandular,erect,exserted,give,gree,hal,head,interjected,intermixed,internode,jequetepeque,lacking,lanceolate,larger,lateral,leaflet,like,lobe,lon,long,long-acuminate,longer,lower,marañón,maturity,minute,mixture,multicellular,narrowly,nearly,nflorescence,node,oblique,occasionally,often,pair,patent,petiolule,population,present,primary,prostrate,pseudostipule,pubescence,purple,reflexed,rest,ruit,scarcely,scattered,secondary,sessile,silky,size,sparse,staminal,sterile,stout,straight,tem,terminal,tertiary,testa,thick,toward,truncate,tube,ud,unicellular,unit,usually,valley,variously,wall,way,weak-walled,wide,winged,woody,ympodial	'',[,``,abaxial,adaxial,arrangement,bark,berry,bud,center,characteristic,colour,form,growth,height,history,length,life,na,new,number,plant,position,prickle,reproduction,scar,seed,shape,spacing,staman,texture,value,width,{,}
75	wfo-0001026305	success	135	99	65	70	34	0.481	.25,0.2-1,0.25-0.5,0.5-2,0.6-1,0.7-1,1-1.5,2-2.5,5-7,6-9,abaxial,abaxially,acute,adaxially,anther,apex,area,bark,calyx,closely,cm,congested,conical,corolla,deflexed,dendritic,densely,elliptic,filament,fruiting,glabrous,globose,green,greenish-white,leaf,leaf-opposed,lobed,margin,minute,minutely,mm,ovary,ovoid-reniform,pale,papillose,pedicel,petiole,pitted,pubescent,rounded,scar,shining,shrub,simple,slender,spaced,sparsely,stem,stigma,style,surface,tan,trichome,unifoliate,x	/4,1.3-1.5,2-6-flowered,2.5-3,3-8.5,4-4.5,7-16,7-9,along,anthesi,apical,attenuate,ba,base,beige-tan,berry,dark,deltate,dia,difoliate,drying,eaf,edicel,eed,exserted,free,geminat,glabrate,interlocking,knob-like,lamina,lateral,like,lobe,lon,long,lower,main,middle,midrib,nflorescence,occasionally,older,overlappin,pair,planar,pore,poricidal,portion,projection,reddish-brow,ruit,scattered,shaped,strongly,styl,tall,tear-drop,tip,tub,tube,ud,unit,vein,visible,way,widest,woody,ympodial,young	2-6,adaxial,arrangement,bud,cell,center,colour,diameter,flower,form,fruit,growth,height,history,inflorescence,length,life,na,new,number,overlapping,peduncle,perennial,plant,position,rachi,reddish-brown,reproduction,seed,shape,spacing,staman,texture,width
76	wfo-0001026307	invalid_json_followup	193	122	78	115	44	0.404	5-merous,9,abaxial,abaxially,acute-acuminate,adaxial,anther,apex,appressed,berry,black,broadly,calyx,central,clavate,cm,corolla,densely,diameter,ellipsoid,entire,eye,filament,flattened-reniform,flower,fruit,fruiting,glabrous,glandular,globose,green,growth,herb,internodal,lateral,length,lobed,margin,membranous,minutely,mm,new,ovary,ovate,paler,pedicel,peduncle,petiole,pubescent,purple,purple-yellow,ripe,scar,shallowly,shape,shrub,simple,spaced,sparsely,spreading,stellate,stem,stigma,straight,style,surface,tinged,trichome,turning,undulate,unevenly,uniseriate,variable,vigorous,weak-stemmed,white,yellow,yellow-green	.0–1.2,.3,.5,.5–4.0,.6,.8,0.2–0.5,0.2–1.5,0.4,0.5–0.6,0.5–0.7,0.5–5.0,0.6,0.8–0.9,0.8–2,0.8–5,1.0–1.2,1.0–1.5,1.0–2.0,1.0–2.4,1.0–2.5,1–3-celled,1–6-celled,2.0,2.0–3.0,2.0–3.5,2.6–13,2/3,3.0–4.0,3.5–7.0,35–45,3–8,3–8-celled,4–5.7,5–7,8–12,acute,adaxially,age,angled,anthesi,apar,articulated,base,becoming,beyond,cell,cone,cuneate,cylindrical,decurrent,difoliate,eaf,eed,end,exerted,facing,free,geminat,gradually,hilum,later,lengthening,like,lobe,long,longer,lower,middle,narrower,narrowing,nflorescence,one,outline,pair,papillat,pentagonal,per,perfect,pore,poricidal,portion,positioned,primary,recurved,reflexe,reflexed,restricted,ruit,shallow,shorter,side,slightly,slit,ste,stone,strongly,sub-laterally,tal,tem,testal,three,tip,toward,translucent,triangular,tube,two,ud,unequal,unit,upper,vein,wide,ympodial	'',0.2\u20131.5,0.5\u20130.7,0.5\u20135.0,0.8\u20132,1.0\u20131.2,1.0\u20132.4,1.0\u20132.5,2.0\u20133.5,3.0\u20134.0,3\u20138,4\u20135.7,8\u201312,[,``,apart,arrangement,bark,bud,center,characteristic,colour,form,height,history,inflorescence,leaf,life,na,number,papillate,plant,position,prickle,rachi,reproduction,seed,spacing,staman,texture,value,width,{,}
77	wfo-0001026317	invalid_json_followup	169	121	89	80	32	0.527	/4,0.25-1,0.3-1.2,0.5-0.6,0.5-1,0.8-1,1-1.2,2-2.5,2-4,2.5-10,4-5,50-200,acuminate,acute,anther,anthesi,apex,bark,base,branched,bright,brown,calyx,capitate,clonal,closely,cm,conical,corolla,dark,dendritic,densely,diameter,distally,elliptic,entire,erect,filament,flattened,flower,fruiting,glabrous,globose,growth,inflorescence,internodal,lobed,many,margin,minutely,mm,narrowly,new,nodding,orange,ovary,packed,pale,papillate,pedicel,peduncle,perfect,petiole,pitted,plane,plant,pubescent,pulp,rachi,red,reniform,scar,shiny,shrub,simple,sparsely,stem,sticky,stigma,style,surface,terminal,thin,time,trichome,uniseriate,way,white,yellowish	.5,0.5,0.5-0.8,0.6-,0.7-0.9,1-1.5,1-5.7,10-12,2-,3,3-3.5,3-foliate,3.5-15,6-8,6x,?,abaxially,absent,adaxially,age,apart,apically,approximately,attenuate,berry,correlated,deltate,dense,drying,eaf,eed,em,erec,essentially,exerted,extremely,found,free,geminat,halfwa,lamina,lengthening,less,like,lobe,longer,lower,maturity,nflorescence,occasionally,often,pair,papillat,per,pericarp,planar,population,pore,poricidal,portion,primary,pubescen,pubescence,reflexed,ruit,slightly,slit,straight,swollen,tip,toward,triangular,tube,ud,unit,variable,vein,woody,x,ympodial	'',2,[,``,abaxial,adaxial,arrangement,bud,cell,center,characteristic,colour,form,fruit,height,history,leaf,length,life,na,number,position,reproduction,seed,shape,spacing,staman,texture,value,width,{,}
78	wfo-0001026321	invalid_json_followup	213	111	73	140	38	0.343	0-0.2,0.1-0.4,0.5-0.6,1-4,1.2-3.5,2-5,3-10,3-4,4.5-6,7-9,8-20,accrescent,acicular,adaxial,adaxially,andromonoecious,anther,apex,bisexual,broadly,calyx,chartaceous,cm,densely,diameter,entire,extra-axillary,flower,fruit,fruiting,glabrous,globose,green,greenish-white,grey-green,herbaceous,inflorescence,leaf,leaf-opposed,length,lobed,long,margin,mm,obtuse,orbicular,ovate,pale,pedicel,peduncle,petiole,plant,prickle,prostrate,pseudo-racemose,rachi,resprouter,shallowly,simple,solitary,sprawling,stellate,stellate-pubescent,stigma,style,surface,thick,throughout,unbranched,weakly,white,yellow,yellowish-green	%,.5,0-0.1,0-0.25,0-0.3,0-2,0-3.5,0.1-0.2,0.1-0.3,0.3-0.6,0.4-0.6,0.4-0.7,0.6-0.9,1-1.2,1-1.5,1-2,1-3,1-5,1-locular,1.2-1.7,1.5-3,10-17,2-3,2-4,2-5.5,2-7,2.5-5.5,2.7-3.1,20-40,3.5-8.5,30-65,4-,4.5,5-25,5-merou,50-100,6-10,6-11,7-10,8-11,abaxially,absent,across,adaxiall,adult,also,alyx,apart,armed,articulated,ascending,attenuate,axe,ba,base,blade,branchlet,brown,capitat,central,connivent,cordate,cross-section,cylindrical,decimetre,deltate,directed,distall,eaf,eed,eglandular,elliptica,exocarp,finger,frui,functional,gland-tipped,glandular,glandular-puberulent,hair,half,halfway,heterostylous,hig,incomplete,juicy,juvenile,lanceolate,lateral,less,lobe,longer,lower,mature,mesocarp,mid-point,midpoint,midrib,midvein,minute,moderately,moist,nflorescence,oblique,orolla,pair,part,per,placenta,pore,porrect,present,ray,rostrate,ruit,rusty,septum,sessile,shallowly-lobed,short,side,spaced,sparse,stalk,stellae,straight,tamen,tem,time,transparent,tube,unarme,unarmed,unit,unknow,upper,vary,wide,x,ympodial	'',[,``,abaxial,arrangement,bark,bud,capitate,cell,center,characteristic,colour,corolla,elliptical,filament,form,growth,height,history,life,na,new,number,ovary,position,reproduction,scar,seed,shape,spacing,staman,stem,texture,trichome,value,width,{,}
79	wfo-0001026325	invalid_json_followup	216	143	93	123	50	0.431	.2,0.5,2,3,3.5,5-merous,abaxially,absent,acute,adaxially,andromonoecious,anther,apart,apex,armed,articulated,base,blue-violet,bud,calyx,chartaceous,cm,darker,densely,diameter,ellipsoid,elliptic,extra-axillary,few-branched,filament,finely,flattened-reniform,flower,forked,foveolate,fruit,fruiting,glabrous,green,hair,herb,heteromorphic,inflorescence,lanceolate,leaf,lenticular,less,light,linear,lobed,margin,maturity,mm,moderately,mottling,oblong,obtuse,ovate-elliptic,ovoid,pale,pedicel,peduncle,perennial,petiole,prickle,pubescent,rotate-stellate,sessile,shallowly,simple,sinuate,sometimes,sparsely,stellate,stellate-pentagonal,stellate-pubescent,stem,stigma,straight,style,subentire,subglobose-ovoid,surface,tapered,unarmed,unbranched,usually,weakly,white,yellow,yellow-orange,young,×	0.15–0.4,0.3,0.5–1.5,0.5–5,0.6–1.8,1,1.1–2,1.2–1.8,1.2–2,1.2–2.2,1.2–2.5,1.3–2.5,1.5,1.5–2.3,1.7–3.5,1.8–2.5,10–12,10–20,12–16,1–1.5,1–2,1–2.5,1–5,1–6,2-,2.5–4,2–10,2–4,2–5,2–6,3-foliate,3.3,4,4–7,4–8,5,5–9,6.5–15,7–10,7–8.5,accrescent,acuminate,adaxiall,alyx,appearing,axe,berry,blade,c.,capitat,caudate,central,completely,connivent,covering,cuneate,curved,cylindrical,deltate,directed,directly,discolorous,distal,distall,downward,eaf,eed,emerging,exserted,formed,functionally,geminat,hermaphorditi,hermaphroditic,lateral,like,lobe,lon,long,long-stuled,lower,lowermost,major,malae,narrowly,nflorescence,node,often,one,orolla,outline,per,plurifoliate,pointed,pore,producing,proximal,ray,rind,root,ruit,shoot,short-styled,side,somewhat,spaced,staminate,subtruncate,swelling,tall,tamen,tem,toug,triangular,tube,tuber-like,unequal,unit,upright,vary,vein,ympodial,–3	'',0.15-0.4,0.5-1.5,0.5-5,0.6-1.8,1-1.5,1-2,1-2.5,1-6,1.2-2,1.7-3.5,10-12,2-4,7-8.5,[,``,abaxial,adaxial,arrangement,bark,capitate,characteristic,colour,corolla,form,growth,height,history,length,life,na,new,number,ovary,pedic,plant,position,rachi,reproduction,scar,seed,shape,spacing,staman,texture,trichome,value,width,{,}
80	wfo-0001026335	invalid_json_followup	157	119	79	78	40	0.503	.5,0.1-0.3,0.25-0.5,0.5-1,0.6-1,1-2,1-4,1.5-2,10-20,10-30,2,2-3,2-4,5-15,5-7,abaxially,accrescent,acuminate,adaxially,anther,apart,apex,branched,calyx,chartaceous,cm,dense,densely,diameter,elliptic,elliptic-ovate,entire,erect,especially,filament,flattened,flower,forked,fruit,fruiting,glabrescent,glabrous,globose,green,hair,leaf,leaf-opposed,like,margin,mm,multangulate,pedicel,peduncle,petiole,probably,pubescence,pubescent,rachi,reticulate,ripe,scattered,sessile,shrub,simple,slightly,stellate,stellate-pubescent,stem,stigma,style,surface,tip,toward,unripe,white,whitish,x,yellow,yellowish	.5-3.5,0.8-1.3,1,1-1.5,1-3,1.5-4,2-7.5,3-18,3-5,4-5,5-,7-8,acute,adaxiall,ag,apparently,articulated,axe,ba,base,blade,capitat,connivent,covering,cuneate,curved,cylindrical,deltate,directed,distally,eaf,eed,equal,frui,geminate,glandula,glandular,held,lanceolate,large,lobe,long,longitudinal,lower,many-foliate,midpoint,moderately,much,nflorescence,oblong,often,opening,orolla,paired,perfect,pore,ray,rounded,ruit,slit,smaller,sometimes,spaced,ste,straight,subtending,tal,tamen,tem,time,tube,unit,uprigh,usually,vary,vein,wide,ympodial	'',[,``,abaxial,adaxial,arrangement,bark,bud,capitate,center,characteristic,colour,corolla,form,growth,height,history,inflorescence,length,life,na,new,number,ovary,perennial,plant,position,prickle,reproduction,scar,seed,shape,spacing,staman,texture,trichome,value,width,{,}
81	wfo-0001026342	success	280	95	65	215	30	0.232	0.06,0.08,2.0,2.1,4.7,acute,anther,apart,apex,attachment,bark,brown,cancellate,chartaceous,cm,corolla,densely,diameter,entire,erect,extra-axillary,filament,flattened-orbicular,flattened-reniform,flower,fruit,glabrous,glandular,globose,hair,homostylous,inflorescence,internode,lateral,leaf,length,long,margin,midvein,mm,notched,oval,ovate,pedicel,peduncle,petiole,point,pubescent,ray,red,reddish,shrub,simple,stellate,stigma,stipe,style,surface,unbranched,white,yellow,yellow-tan,±densely,±evenly,±glabrous	.3,.4–3.0,.6,.9,0.07,0.3–0.5,0.3–0.6,0.3–0.9,0.4–0.6,0.6–1.3,0.6–2.8,0.7–1.4,0.7–1.6,0.7–1.8,0.8,0.8–1.1,0.8–1.2,0.8–1.5,0.9–1.3,1.1–1.5,1.1–3.7,1.2,1.3–1.8,1.5–2.1,1.5–2.3,1.7–2.6,1.8–2.2,1.9–2.9,1/2–2/3,1/3,2.0–7.6,2.1–3.3,2.1–3.7,2.5,2.5–3.8,2.8–4.9,2.9,3.1–13.7,3.2–3.7,3.6–4.6,4602,5-merou,5.1–6.6,5.2–7.7,5–8,6–12,7.7–11.2,7–8,8,8.5–9.5,8–13,9.5–14.2,90°,abaxially,absent,acuminate,adaxial,adaxially,adnate,aequilateral,ag,along,alyx,anthesi,apical,apparently,appearing,arching,around,articulate,attenuate,axe,ba,base,becoming,bent,berry,blade,borne,branch,broad,brochidodromous,bud,calyx,capitat,caudate,channeled,climate,clinate,congested,connivent,deciduous,deltoid,dentate,development,difoliate,directed,distal,dorsally,dry,edge,eed,either,emerging,endocarp,exocarp,extending,fertile,filiform,flexed,free,geminat,glossy,gradually,immature,increasing,individually,intact,interpetalar,intersepalar,juic,laxly,layer,less,lobe,lon,longer,lower,many,markedly,mature,mckee,midpoint,midrib,minute,moderate,moderately,nearly,nflorescence,oblique,oblong,observed,occasionally,one,orolla,ove,per,perforated,pore,porrect,porrect-stellate,portion,potentially,pubescence,raised,reflexe,remaining,rigid,rounded,row,ruit,seen,sessile,short-stipitate,shorter,side,sinus,slightly,sloughing,smoot,soon,spaced,sparsely,speciman,splitting,spread,stamen,stellae,stellate-pubescent,stem,straight,suture,tamen,tardily,tem,thin,time,tip,tissue,toward,translucent,transparent,trifurcating,truncate,tube,two,typically,ud,unarmed,upper,various,vary,vein,weakly,well-developed,wide,yellow-ferruginous,ympodia,young,±90°,±equal,×,–0.9,–19.0,–31.0	0.3-0.9,0.6-2.8,0.8-1.1,0.8-1.5,1.3-1.8,1.5-2.1,1.9-2.9,3.2-3.7,5-merous,5.2-7.7,6-12,7.7-11.2,9.5-14.2,arrangement,capitate,colour,form,growth,height,na,number,ovary,plant,position,seed,shape,spacing,staman,stella,texture
82	wfo-0001026343	success	221	107	81	140	26	0.367	-1.5,-4,0-4,0.05-0.2,0.05-0.5,0.2-0.7,0.45-1,0.5-1.5,1-4,1.3-1.7,2-3,2-3.2,2-6,2.5-8,5-10,5-merous,7-12,abaxial,adaxial,andromonoecious,anther,apart,bark,berry,branched,calyx,chartaceous,cm,cream,curved,dark,densely,diameter,dull,elliptic,filament,flattened,flattened-reniform,flower,fruit,fruiting,glabrescent,glabrous,green,leaf,length,lobed,margin,marking,maturity,mauve,mm,moderately,orange,orange-brown,pale,pedicel,peduncle,petiole,plant,porrect,prickle,purple,reddish,scar,sessile,shrub,small,sparsely,spherical,stalked,stellate,stellate-pubescent,stem,style,surface,terete,tree,trichome,yellow,young	-1,-15,-3.5,-7,.5,/2,/5,0,0-10,0-2,0-40,0-5,0.1-0.2,0.15,0.2,0.2-0.3,0.3,0.5,0.8-1.5,1-2,1-3,1.5-2,1.5-2.5,1.8-2.2,1.8-3,1/,1/3,1/4-2/3,1/5,10-30,2-4,2-5,2-8,2.2-3.2,3-4,3-5,3.5-4.5,5.5-9,6-9,7-14,7-8,7-9,abaxially,acuminat,acute,alyx,apar,apex,apically,apparently,articulated,base,blade,broadly,brow,concolorous,connivent,cuneate,deltate,distal,distance,drying,eed,elongating,equal,erect,extending,faint,free,green-brown,hermaphrodite,heterostylous,infructescence,lateral,less,lobe,lobing,lon,long,long-styled,longer,lower,lowermost,mature,midpoint,midvein,multangulate,narrow-deltate,nflorescence,obtuse,older,one,open,orolla,oung,ovate,pair,pendulous,per,pericarp,plurifoliat,poricidal,portion,prickl,prickly,primary,ray,reduced,reflexed,rounded,ruit,secondary,short-styled,side,smooth,sometimes,spaced,spreading,stalk,staminat,stout,tamen,tapering,tertiary,time,tip,tube,unarmed,unit,upper,variously,vary,vein,venation,visible,way,weakly,wide,woody,ympodial	5.5,arrangement,brown,bud,cell,center,colour,corolla,form,growth,height,history,inflorescence,life,na,new,ovary,perennial,reproduction,seed,shape,spacing,staman,stigma,texture,width
83	wfo-0001026351	success	199	115	88	111	27	0.442	0.5-1,0.5-1.0,0.5-1mm,1-1.5,1-3,1-4,10-15,15-50,2-3.5,2-4,2-5,3-10,3-6,4-7,4-9,8-15,abaxial,abaxially,acute,adaxial,andromonoecious,anther,apex,base,branched,brown,bud,calyx,chartaceous,cm,commonly,coriaceous,corolla,dark,densely,diameter,entire,extra-axillary,filament,filiform,flattened,flower,fruit,fruiting,geminate,glabrous,globose,green,immature,leaf,length,lobed,long,margin,mature,mm,moderately,nearly,occasionally,orange,orange-red,ovary,ovate,pale,pedicel,peduncle,petiole,plant,prickle,pubescent,purple,rachi,recurved,reniform,seed,stellate,stem,stigma,style,subcoriaceous,surface,tan,unbranched,vine,white,wide,x,yellow	0.25-0.5,0.5,0.5-1.5,0.75-1.0,1-.,1-2,1-2.5,10-18,12-16,3-9,4-6,40-80,5-15,5-merou,6-10,6-8,absent,accrescent,adaxially,alyx,apar,apical,apparently,armed,asymmetrical,attenuate,axe,berry,beyond,blade,branch,connivent,cordate,cylindrical,difoliate,directed,discolorous,distally,distinct,eaf,eed,either,em,exserted,exseted,forming,frui,functionally,glabrou,gree,hair,hermaphroditic,heteromorphic,introrsel,leathery,like,lobe,long-styled,lower,major,male,midpoint,midrib,midvein,multicellular,multiseriate,narrowly,nflorescence,obtuse,occasional,often,orane,orolla,outer,pair,per,pore,porrect-stellate,proximally,ray,red,revolute,roselike,ruit,scrambling,short-,side,simple,siz,slightly,spaced,sparsely,spreading,stalk,stamen,ste,stellare,straight,surfac,swellin,tamen,tapering,triangular,tube,unarmed,unequal,unicellular,unit,vary,vein,ympodial	1-6,5-merous,apart,arrangement,bark,cell,center,colour,form,growth,height,history,inflorescence,life,na,new,number,perennial,position,reproduction,scar,shape,spacing,staman,texture,trichome,width
84	wfo-0001026352	invalid_json_followup	209	116	83	126	33	0.397	.5,0.5-0.8,0.5-1.5,0.5-3,0.7-2,1-10,1-2-celled,1.2-1.7,1.5,12-60,3-15,4-4.5,5-6,abaxially,acuminate,acute,anther,apart,apex,bark,berry,blue,brown,calyx,capitate-truncate,chartaceous,cm,conical,corolla,densely,diameter,ellipsoid,entire,evenly,filament,flattened,flower,fruiting,glabrous,globose,green,greenish,growth,inflorescence,irregularly,leafy,length,margin,membranous,minutely,mm,narrowly,new,ovate,pale,pedicel,peduncle,petiole,pink,pubescent,rachi,reniform,scar,shiny,shoot,short,simple,spaced,stellate,stem,stigma,style,surface,terminal,thin,trichome,tuberculate,uniseriate,unspecified,vine,white,woody,yellowish	.3,0.5,0.5-1,0.6-,0.9-1,1-,1-1.5,1.5-2,1.5-4.6,10+,2,2-3-celled,3.5-9,5-merou,6-7,7-9,<,?,adaxiall,ag,almost,alyx,angle,anthesi,antrorsely,apparently,appearance,arising,articulated,articulation,axi,basal,base,bending,branch,branching,broadly,cell,cordate,curved,deciduous,deltate,denser,discolorous,eaf,eed,eventually,expanded,exserted,few-celled,free,giving,half,heigh,herbarium,ilament,immature,impressed,inflorescenc,junction,lamina,large,largest,leave,leaving,lengthening,like,lobe,lobed,long,lower,many,mature,near,nearly,nflorescence,older,orolla,outline,pair,papillate,papillo,peg,per,perfect,pericarp,plurifoliat,point,pore,poricidal,portion,primary,principal,reflexed,rest,revolute,right,ruit,seen,shallowly,sleeve,slit,small,sparser,specimen,spreadin,spreading,straw-colored,strongly,tem,third,time,tip,truncate,tub,tube,ud,unit,upper,vary,vein,violet,weak,wide,widest,ympodial	'',5-merous,[,``,abaxial,adaxial,arrangement,bud,center,characteristic,colour,form,fruit,height,history,leaf,life,na,number,ovary,plant,position,prickle,reproduction,seed,shape,spacing,staman,texture,value,width,{,}
85	wfo-0001026352	invalid_json_followup	214	122	90	124	32	0.421	.5,0.5-0.8,0.5-1.5,0.5-3,0.7-2,1-10,1-2-celled,1.2-1.7,1.5,12-60,3-15,4-4.5,5-6,abaxially,acuminate,acute,adaxially,anther,antrorsely,apart,apex,base,berry,blue,brown,calyx,capitate-truncate,chartaceous,cm,conical,corolla,curved,densely,diameter,ellipsoid,entire,evenly,filament,flattened-reniform,flower,form,fruiting,glabrous,globose,green,greenish,growth,inflorescence,irregularly,leaf,leafy,length,lobed,margin,membranous,minutely,mm,narrowly,nearly,new,ovate,pale,pedicel,peduncle,petiole,pink,pubescent,rachi,scar,shiny,shoot,short,simple,spaced,stellate,stem,stigma,style,surface,terminal,trichome,tuberculate,uniseriate,unspecified,vine,white,woody,x,yellow,yellowish	.3,0.5,0.5-1,0.6-,0.9-1,1-,1-1.5,1.5-2,1.5-4.6,10+,2,2-3-celled,3.5-9,5-merou,6-7,7-9,<,?,ag,almost,alyx,angle,anthesi,apparently,appearance,arising,ark,articulated,articulation,axi,basal,bending,branch,branching,broadly,cell,connivent,cordate,deciduous,deltate,denser,discolorous,eaf,eed,eventually,expanded,exserted,few-celled,free,geminat,giving,half,heigh,herbarium,ilament,immature,impressed,inflorescenc,junction,lamina,large,largest,leaving,lengthening,like,lobe,long,lower,many,mature,near,nflorescence,older,orolla,outline,pair,papillate,papillo,peg,per,perfect,pericarp,plurifoliate,point,pore,poricidal,portion,primary,principal,reflexed,rest,revolute,right,ruit,seen,shallowly,sleeve,slit,small,sparser,speciman,specimen,spreadin,spreading,straw-colored,strongly,tem,thin,third,time,tip,truncate,tub,tube,twining,ud,unit,upper,vary,vein,violet,weak,widest,ympodial	'',5-merous,[,``,abaxial,adaxial,arrangement,bark,bud,center,characteristic,colour,fruit,height,history,life,na,number,ovary,plant,position,prickle,reproduction,seed,shape,spacing,staman,texture,value,width,{,}
86	wfo-0001026357	success	206	117	90	116	27	0.437	0.1-0.3,0.2-0.7,0.4-1.6,0.6-1.5,0.8-1.2,0.9-1.2,1-6,1.5-2.5,2-2.8,2-6,3.9-6.2,30-68,4-6,4-7,5,5.8-13.6,7-15,abaxially,adaxially,anther,apart,apex,articulated,asymmetrically,bark,base,branched,brown,calyx,chartaceous,cm,conical,corolla,dark,densely,diameter,ellipsoid,elliptic,ferrugineous-pubescent,filament,flower,foveolate,fruit,fruiting,glabrous,globose,green,hair,immature,lanceolate,leaf,length,long-attenuate,many,mature,mm,multangulate-pubescent,narrowly,nearly,oblanceolate,obovoid,ovate,ovate-lanceolate,pale,pedicel,peduncle,persistently,petiole,porrect-stellate,pubescent,rachi,scabrous,several,shrub,simple,small,smooth,sparsely,stellate,stellate-pubescent,stelliform,stem,stigma,style,tan,time,tree,white,x,yellow	0.11-0.29,0.8-1,1-1.2,1.1-1.7,1.4-2,1.5-2.2,1.5-2.8,1.7-2.9,1/2,10-11,10-17,2-3,2-3.3,2.3-4.2,2.5-3.3,4-5,6-7.5,7-10,absen,accrescent,acute,adaxiall,ag,along,anthesi,apparently,around,axillary,ba,berry,blade,blunt-tipped,branch,capitat,closely,completely,conspicuous,coriaceous,covering,cylindrical,decurrent,directed,distally,eaf,edge,eed,entire,enveloping,exserted,farinose,fleshy,free,granular,half,hig,inserted,large,lateral,lengthening,line,lobe,lobed,long,lower,m.,main,margin,midrib,minute,mostly,multangulat,multangulate,nflorescence,oblong,obtuse,older,orolla,perfect,plurifoliate,pore,poricidal,porrect-stellat,revolute,rough,ruit,runk,semi-ovate,sessile,short-stalked,side,slightly,slit,somewhat,spaced,sparse,stellate-pubescen,stellate-tomentose,suture,tamen,terete,testa,thick-stalked,tip,tomentose-pubescent,touching,tube,ud,unit,vary,vein,way,weakly,whitish,within,ympodial,young	abaxial,adaxial,arrangement,bud,capitate,colour,form,growth,height,history,inflorescence,life,na,number,ovary,perennial,plant,position,reproduction,seed,shape,spacing,staman,surface,texture,trunk,width
87	wfo-0001026367	invalid_json_followup	216	135	82	134	53	0.38	1.2-1.6,abaxial,abaxially,acicular,acuminate,adaxial,adaxially,anther,apart,apex,articulated,asymmetric,base,black-brown,blue,broadly,center,cm,colored,densely,diameter,dried,entire,eventually,filament,finely,flower,fruit,glabrate,globose,green,growth,homostylous,immature,initially,internode,irregularly,lance,later,lateral,lavender,leaf,lenticular,lighter,lobed,longer,loosely,margin,minutely,mm,ovate,overtopped,ovoid,pedicel,peduncle,pentagonal,petiole,pitted,plump,prickle,pubescent,rotate,shallowly,shrub,simple,sinuately,slightly,soon,sparsely,stellate,stellate-pubescent,stellate-tomentose,stem,stigma,style,surface,tan,terminal,tomentose,turning,usually,yellow	.5,0.2–0.5,0.4–0.6,0.4–0.7,0.5–0.7,0.7–1.5,1.8–2.5,10,10–15,10–18,15-20,15–30,1–2,1–3,2.5–4,2–3,2–3.5,2–4,2–4.5,2–5-branched,3–4,3–6,3–7,5-merou,5–7.5,5–9,6–8,7-9.7,7–11,8–10,acute,adaxiall,age,along,alyx,apparently,armed,ascending,attenuate,axe,ba,blade,branch,branched,capitat,caudate,close,closely,cordate,deeply,deltoid,dense,denser,directed,distally,eaf,eed,erect,farinose,filiform,geminat,glabrous,hair,high,interpetalar,interwoven,larger,like,little,lobe,lon,long,looser,lower,maturit,midpoint,midvei,midvein,midzone,mostly,much,narrowly,near,nflorescence,oblong,often,orolla,perfect,plurifoliate,pore,porrect,principal,pubescence,ray,rounded,ruit,sessile,short,shorter,side,similar,sinus,small,somewhat,some­what,spaced,splitting,spreadin,spreading,spreadingly,stalk,stalked,ste,stellae,tamen,tawny,tem,thick-chartaceous,time,tip,tissue,tomento,triangular,tube,ud,unarmed,vary,vein,weakly,well-developed,wide,ympodia,×,–20	'',0.5-0.7,1-2,1-3,10-18,15-30,2-3,2-4.5,2-5-branched,3-6,3-7,5-7.5,5-9,8-10,[,\u00d7,``,arrangement,bark,bud,calyx,capitate,characteristic,colour,corolla,form,fruiting,height,history,inflorescence,length,life,maturity,na,new,number,ovary,perennial,plant,position,rachi,reproduction,scar,seed,shape,spacing,staman,texture,trichome,value,width,{,}
88	wfo-0001026377	success	155	97	62	93	35	0.4	0.5,1,12,2,2-3,2.5,3-5,4,5-6,5-7,5-merous,7,7-7.5,8-13,abaxially,acute,andromonoecious,anther,apex,articulated,base,bright,broadly,brownish,cell,chartaceous,cm,densely,extra-axillary,filament,flower,forked,hermaphroditic,internode,leaf,margin,mm,ovate,pale,pedicel,peduncle,petiole,plant,polished,prickle,prickly,pubescent,purple,rachi,shrub,simple,staminate,stellate,stellate-pubescent,stem,stigma,style,surface,triangular,unbranched,unequal,x	-8,0,1/5-1/4,16,3,3-,30,abaxiall,abundant,abundantly,acumen,adaxially,along,apica,armed,axe,ba,belo,blade,branched,broad,calyx,central,cut,distall,distinctly,eaf,eed,ending,ermaphroditic,fresh,geminat,hair,hermaphrodite,heterostylous,lateral,like,linear,lobe,lon,long,lower,main,mainly,midpoint,midrib,minor,narrow,nflorescence,oblique,often,orolla,pore,porrect,prickl,proximal,ray,reduced,repand,retrorse,rounded,ruit,scattered,seen,shallow,sharp,short,side,single,sinus,smaller,sparsely,stipe,stou,straggly,straight,structure,subcordate,subsagittate,tamen,taminate,tapered,tem,tipped,transition,tube,unknow,unknown,vary,vein,vestigia,way,ympodial	11,20,3-8,abaxial,adaxial,arrangement,bud,center,colour,corolla,diameter,form,fruit,growth,height,history,inflorescence,length,life,na,new,number,ovary,perennial,position,reproduction,scar,seed,shape,spacing,staman,texture,trichome,vestigial,width
89	wfo-0001026379	success	219	115	83	136	32	0.379	-4.5,0.2-0.4,0.7-1,0.7-2.5,0.8-1.2,1-1.7,1-10,1-2,1.5-2.3,1.9-3.4,13,2-7,2.6-3.7,4.1-7,5.3-10.2,8-15,8.3-10,acute,anther,apart,apex,attenuate,bark,branched,brown,calyx,cm,conical,corolla,dark,densely,diameter,dried,echinoid,echinoid-pubescent,ellipsoid,filament,finely,flower,fruit,fruiting,globose,gray-brown,growth,leaf,length,many,minutely,mm,multangulate,multangulate-pubescent,nearly,obovate,ovate,pale,pedicel,peduncle,persistently,petiole,pitted,plant,porrect-stellate,rachi,reniform,rich,scabrous,shrub,simple,small,stellate,stellate-pubescent,stelliform,stem,stigma,style,time,tomentose-pubescent,tree,velutinous-pubescent,violet,whitish,x,yellow	0.2-0.38,0.9-1.2,1-3.7,1.3-2.1,1.7-4.9,1.8-2.6,1.8-3.2,1.8-5,1/2,2-2.8,2.4-5.1,2.9-4,2/3,3-11,3/4,4-5,50-450,6-10.6,8-13,8-29,9-14,abaxially,accrescent,adaxiall,adaxially,ag,along,anthesi,apparently,around,articulated,axillary,ba,basal,base,berry,blade,blunt-tipped,branch,capitat,chartaceous,closely,completely,covering,cylindrical,dendritic-echinoid,directed,distal,distally,eaf,echinoi,edge,eed,entire,enveloping,evident,farinose,few-rayed,fleshy,free,glabrous,granular,grayish,hair,hig,included,inserted,lacking,large,lateral,lengthening,line,lobe,lobed,long,long-attenuate,lower,m.,main,margin,mature,midrib,minute,mostly,multangulat,nflorescence,oblong,obtuse,often,older,orolla,ovate-lanceolate,partly,perfect,plurifoliate,pore,poricidal,present,pubescen,rather,recent,ruit,runk,scattered,semi-ovate,sessile,short-stalked,side,size,slit,sometimes,somewhat,spaced,sparse,stellate-,stellate-tomentose,suture,tamen,terete,testa,thin,tip,translucent,tube,ud,uneven,unit,upper,usually,vary,vein,vestigial,way,whitish-brown,ympodial,young	150-450,abaxial,adaxial,arrangement,bud,capitate,cell,center,colour,form,height,history,inflorescence,life,na,new,number,ovary,perennial,position,pubescent,reproduction,scar,seed,shape,spacing,staman,surface,texture,trichome,trunk,width
90	wfo-0001026388	invalid_json	264	126	75	189	51	0.284	0.2-0.6,1.5-2,1.6,1.8,45,8.5,?,abaxially,acicular,adaxially,anther,apex,attenuate,base,bilobed,brown,calyx,cm,corolla,deeply,diameter,dilated,distinctly,erect,extra-axillary,filament,flower,fruit,glabrous,globose,glutinous,green,leaf,length,life,light,lobed,long,margin,minutely,mm,moderately,ovate,pedicel,peduncle,petiole,pilose,plant,prickle,rachi,ripe,scattered,sessile,shallowly,shape,shrub,simple,sometimes,somewhat,sparsely,stellae,stellate,stem,stigma,straight,style,suborbicular,surface,thin-textured,truncate,unbranched,wide,x,yellow-orange,yellowish	.2,.5,.7,0.15,0.2–1,0.2–2,0.4–1,0.5–1.7,0.5–2,0.5–4,0.8–1.5,0.8–2.5,1-2,1.4,1.4–1.6,1.5–2.2,1.5–3.5,108,10–20,12,1–2,1–2.5,1–6,2-foliate,2.5–4,20–,25,2–4,2–4-celled,2–9,3,3.2–3.7,4–10,4–5-rayed,4–6-celled,5,5–12,5–20,6,65–145,6–11,6–7,8-13,=,abundant,acuminate,acute,adaxiall,always,angle,apar,apiculate,apparent,appearance,armed,ascending,becoming,blade,bleaching,branch,bright,ciliate,closely,color,conduplicate,confined,covering,cylindrical,dense,developing,directed,distall,divided,division,dried,eaf,eed,enlarged,entire,especially,exceeding,except,exclusive,exserted,first,flowering,folded,forward,free,geminat,geminate,giving,gland,glistening,golden,grading,greenish,hair,halfway,hyaline,inserted,inside,lanceolate,larger,lateral,least,less,lighter,lobe,lon,lower,major,midrib,minute,mostly,much,n,nearly,nflorescence,oblique,often,one,orolla,otherwise,outside,ovate-apiculate,pair,papillat,par,per,plane,pointing,pore,pressing,probably,purple-colored,ranging,rarely,recurved,reflexed,reported,rip,ruit,scarious,sideway,similar,single,sinuate,sinus,size,slightly,small,smaller,spaced,spreading,stamen,stipitate,straw,strongly,sunlight,tal,tamen,tem,thickened,tip,triangular,tube,turning,twice,twisted,two,unarmed,unicellular,unit,upper,usually,various,variously,vary,vein,viewed,white,whole,wing,yellow,yellow-green,ympodial,±,–8	'',0.2-1,0.2-2,0.4-1,0.5-1.7,0.5-2,0.5-4,0.8-2.5,10-20,2-9,4-10,4-5-rayed,5-12,6-7,[,],``,abaxial,adaxial,apart,arrangement,bark,bud,cell,center,characteristic,colour,form,fruiting,growth,height,history,inflorescence,na,new,number,ovary,papillate,perennial,position,reproduction,scar,seed,spacing,staman,texture,trichome,value,width,{,}
91	wfo-0001026397	success	202	120	89	113	31	0.441	0.5-1,0.5-1.5,1-2,1-3,1-9,10-14,10-20,13-18,2-10,2-5,2.5,3-4,5-15,5-8,8-20,absent,adaxial,andromonoecious,anther,brown,bud,calyx,chartaceous,cm,coriaceous,cylindrical,dark,densely,diameter,entire,extra-axillary,filament,flower,fruit,fruiting,functionally,glabrous,globose,green,hermaphroditic,immature,leaf,line,lobed,long,male,many,margin,mature,mm,moderately,nearly,netlike,occasional,orange,ovate,pedicel,peduncle,petiole,pit,plant,porrect-stellate,prickle,pubescent,purple,rachi,raised,red,reniform,ridge,roselike,separated,simple,small,sparsely,stellate,stem,stigma,style,surface,tan,triangular,unbranched,vine,white,whitish,woody,x,yellow	1,1-.,1-2.5,1-6,1.5,1.5-3,1.5-3.5,12-15,12-16,2-2.5,3-3.5,3-5,3-9,4-16,4-8,5,5-merou,50-100,6-10,abaxially,absen,accrescent,acute,adaxially,alyx,anthesi,apar,apex,apical,armed,asymmetrical,attenuate,axe,base,berry,beyond,blade,connivent,cordate,difoliate,directed,discolorous,eaf,eed,either,em,expanding,exserted,filiform,flattened,frui,geminate,glabrou,glandular,greatly,gree,greem,hair,heteromorphic,introrsel,leathery,like,lobe,long-styled,lower,major,midpoint,midrib,midvein,multicellular,multiseriate,narrowly,nflorescence,obscure,obtuse,often,older,orolla,pair,per,pore,present,ray,recurved,reflexed,ruit,rusty,secondary,short-and,side,siz,slightly,spaced,spreading,stalk,stamen,ste,straight,tamen,tapering,thick,tube,unarmed,unequal,unicellular,unit,usually,vary,vein,weakly,wide,ympodial,young	1-4,abaxial,apart,arrangement,bark,cell,center,colour,corolla,form,growth,height,history,inflorescence,length,life,na,new,number,ovary,perennial,position,reproduction,scar,seed,shape,spacing,staman,texture,trichome,width
92	wfo-0001026400	success	187	106	80	107	26	0.428	0.2-0.8,0.4-1,0.5-1.2,1-10,1-2,12-27,3.4-4.8,30-55,5-7,6-15,6.5-20,9-13,abaxially,adaxially,anther,apex,axillary,blue,brownish,bud,cell,clavate,cm,condition,corolla,covering,dark,deep,diameter,drying,elliptic,filament,flower,forked,fresh,fruit,glabrescent,glabrous,globose,green,green-white,greenish,hair,hair-like,herb,lateral,leaf,light,lilac,make,mm,mucilaginous,odd-pinnate,ovate,ovoid,pedicel,peduncle,pentagonal,petiole,plant,purple,ripe,rounded,seed,semi-stellate,short,stigma,stripe,style,subtending,terminal,testal,thick,throughout,tip,wall,wet,white,whitish,yellow	0.5-1,0.7-1.1,1.3-2.6,1.7-2.2,10-18,10-28,13-30,2-6,2-8,2.4-5.9,3-6,3.5-5.9,4-7,5-merou,6-13,8-12,acumen,acuminate,acute,adaxiall,ag,alyx,apart,apparently,articulated,asymmetric,attenuate,axe,base,basiscopic,berry,blade,capitat,connivent,coriaceous,decreasing,decurrent,digestion,distal,dorsally,eaf,edge,eed,enzyme,erec,exceeding,finely,flat,folded,geminat,generally,glabrou,gree,hal,half,high,homostylous,honeycomb-shaped,interjected,lanceolate,leaflet,lengthening,linear,living,lobe,long,lower,moderately,nflorescence,orbicular,orolla,pair,perfect,petiolulate,plurifoliate,pore,poricidal,puberulent,pubescent,removed,ruit,sessile,seudostipule,side,simple,size,slightly,slit,spaced,specimen,stamen,straight,subequal,tall,tamen,tem,tissue,toward,tri-,tube,typically,unit,unwinged,usually,vary,x,ympodial	abaxial,adaxial,arrangement,capitate,colour,form,growth,height,history,inflorescence,length,life,na,number,ovary,perennial,position,pseudostipule,rachi,reproduction,shape,spacing,staman,surface,texture,width
93	wfo-0001026406	invalid_json_followup	219	125	90	129	35	0.411	.2,.5,0-3,0.3-0.5,0.4-0.9,0.5-1.5,0.5-2.5,1-2,1.5-5,1.8-2.4,1/4,1/4-1/2,2-3,2-6,2.5-8,3-10.5,5-25,5-8,5-merous,6.5-7,abaxial,adaxial,andromonoecious,anther,apart,bark,base,berry,branched,calyx,cm,cream,curved,dark,densely,diameter,dirty-whitish,erect,filament,flattened-reniform,flower,fruit,fruiting,gently,glabrous,green,herb,lateral,leaf,length,lobed,long-styled,margin,marking,maturity,mauve,midvein,mm,orange-brown,pale,pedicel,peduncle,pendent,petiole,plant,porrect,prickle,purple,red-brown,reflexed,scar,sessile,short-styled,shrub,spherical,stalked,stellate,stellate-pubescent,stem,straight,style,surface,terminal,trichome,upper,velvety,way,white,yellow,young	-1,0,0-30,0-5,0.3,0.3-0.7,0.4-0.8,0.5,0.8,00-200,1,1.3-1.5,1.5-2,1/,1/3,1/4-1/3,10-30,12-19,2-2.7,2.9-3.2,20-60,3-4,3.2-3.8,30-60,5,5-50,5-6,5-7,6-12,6-15,7-10,7-8,7-9,9-15,abaxially,acute,adaxially,alyx,ame,apar,apex,apically,apparently,articulated,blade,broad-deltate,c.,chartaceous,conical,connivent,cordate,deltate,discolorous,distal,distance,drying,eaf,eed,elongated,elongating,equal,extending,flattened,foliaceous,free,fully,hermaphrodite,heterostylous,infructescence,least,lobe,lon,long,longer,lower,lowermost,mature,midpoint,moderately,nflorescence,oblong,obtuse,older,one,open,opening,orolla,oung,ovate,pair,pendulous,per,pericarp,plurifoliat,poricidal,portion,prickl,prickly,primary,ray,rounded,ruit,side,smooth,sometimes,spaced,sparsely,spreading,stalk,staminat,stout,tamen,tapering,terete,tertiary,time,tip,tube,unit,variously,vary,vein,venation,visible,weakly,wide,woody,yellow-brow,ympodial	'',[,``,arrangement,bud,cell,center,characteristic,colour,corolla,form,growth,height,history,inflorescence,life,na,new,number,ovary,perennial,plurifoliate,position,rachi,reproduction,seed,shape,spacing,staman,texture,value,width,yellow-brown,{,}
94	wfo-0001026407	invalid_json_followup	221	140	103	118	37	0.466	+,.5,/3,0.5-0.6,0.5-2,1,1-10,1.2-1.5,1.5-1.7,2-2.5,20-40,3.5,4-5,5,5-10,7-8,abaxially,acute,adaxially,anther,apart,apex,appearing,base,becoming,berry,black,broadly,brown,brownish,calyx,capitate,chartaceous,cm,conical,corolla,deep,dendritic,dense,densely,diameter,ellipsoid,elliptic,entire,evenly,filament,flattened-reniform,fleshy,flower,fruiting,glabrous,globose,golden,growth,inflorescence,internodal,irregularly,lateral,lax,lobed,long,margin,membranous,minutely,mm,narrowly,new,occasionally,pale,papillate,pedicel,peduncle,perfect,petiole,pitted,pubescence,pubescent,purple,purplish,reddish,ripe,scar,shiny,short,shrub,simple,slightly,spaced,sparsely,stellate,stem,stigma,stout,style,surface,terminal,trichome,vine,violet,way,woody,x,yellow	-11,-6,0.5,0.5-1,0.9-3,1-1.2,1.3,1.5-2,1.5-7,2.5-3,20-30,3.5-5.5,5-7,5-merou,7-10,ag,aid,along,always,alyx,anthesi,area,ark,around,articulated,axi,basal,beneath,berr,blunt,branch,branched,cell,clear,climbin,congested,connivent,deltate,denser,discolorous,eaf,eed,erect,exserted,free,geminat,glabrescen,glabrou,golden-pubescent,ilament,interpetalar,lamina,leafy,leaving,lengthening,like,lobe,loosely,lower,many,markedly,midvein,mixture,near,nflorescence,numerous,oblique,obscured,often,older,open,orolla,outline,pair,paler,papillat,pedice,peg,pentagonal,per,pericarp,persistent,planar,plurifoliate,pore,poricidal,portion,primary,pubescenc,revolute,ruit,sinus,sleeve,slit,small,sparser,spreading,stiff,strongly,tangled,tem,testal,thin,time,tip,transition,truncate,tube,twining,ud,undulate,unit,upper,usually,vary,vein,weak,ympodial	'',5-merous,[,``,abaxial,adaxial,arrangement,bark,bud,characteristic,colour,form,fruit,glabrescent,height,history,leaf,length,life,na,number,ovary,perennial,plant,position,prickle,rachi,reproduction,seed,shape,spacing,staman,texture,value,width,{,}
95	wfo-0001026422	success	273	106	67	206	39	0.245	.0,3.5,56,6.8,8.4,acuminate,acute,alveolate,anther,apart,apex,bark,bent,bud,calyx,capitate,chartaceous,cm,corolla,densely,diameter,dry,elliptic,entire,evenly,extra-axillary,filament,flattened-irregular,flattened-reniform,flower,fruit,glabrous,globose,gray-brown,green,homostylous,lanceolate,lateral,length,long,margin,mm,moderately,observed,occasionally,ovate,pedicel,peduncle,petiole,pubescent,red-brown,shrub,simple,sinuate,sparsely,stellate,stem,stigma,straight,style,surface,typically,white,yellow,yellow-tan,yellowish-green,±congested	.04,.3,.6,.7,.9,/3,0.04,0.06,0.08,0.1–0.5,0.2,0.2–0.4,0.3–0.5,0.3–0.7,0.4–1.3,0.4–2.4,0.6–0.9,0.6–1.1,0.6–2.0,0.7–0.8,0.7–1.6,0.8,0.9–1.5,0.9–1.9,0.9–7.5,1.0,1.0–1.9,1.1–1.4,1.2–2.8,1.3–2.2,1.6–1.9,1.6–2.2,1.7–2.4,1.8–2.2,1.8–2.3,1/2–2/3,1/3,1/3–2/3,10,13.2–27.8,1–3,2.0–3.2,2.2–14.0,2.8–4.2,3.5–4.5,3.8–4.8,4.7,4–8,5-merou,5.0,5.8–7.4,5.8–8.3,5–7,6–8,7.6,7.7–9.2,7.8–26.9,abaxially,absent,adaxially,adnate,aequilateral,ag,alyx,anthesi,apical,apiculate,apparently,appearing,appresse,around,articulate,attenuate,axe,ba,basal,base,becoming,berry,blade,borne,branch,branching,broad,brochidodromous,channeled,cream,cuneate,darker,deciduous,deltoid,dentate,development,difoliate,directed,distal,distally,distinct,eaf,edge,eed,either,emerging,endocarp,erect,especially,exocarp,extending,fertile,filiform,free,geminat,glandular,glossy,gradually,gree,hair,immature,increasing,individually,intact,internode,interpetalar,intersepalar,juic,layer,light,lobe,lon,longer,lower,many,many-flowered,mature,midpoint,midrib,midvein,minute,much,nearly,nflorescence,oblique,oblong,orolla,ove,per,perforated,pore,porrect,porrect-stellae,portion,potentially,presumably,pubescence,raised,ray,reflexed,remaining,rigid,rounded,row,ruit,scarcely,sessile,short-stipitate,side,sinus,sloughing,smoot,soon,splitting,spreading,stamen,stellae,stellate-pubescent,stipe,stripe,suture,tamen,tardily,tem,thin,time,tip,tissue,translucent,transparent,truncate,tube,two,ud,unarmed,unbranched,upper,various,vary,vein,weakly,well-developed,wide,yellow-ferruginous,ympodia,young,±erect,×,–5	0.4-2.4,0.6-2.0,1.0-1.9,1.3-2.2,13.2-27.8,3.5-4.5,5-merous,5.8-7.4,7.8-26.9,abaxial,adaxial,arrangement,colour,form,fruiting,growth,height,history,inflorescence,leaf,life,na,new,number,ovary,perennial,plant,position,prickle,rachi,reproduction,scar,seed,shape,spacing,staman,texture,trichome,width
96	wfo-0001026424	success	138	82	40	98	42	0.29	1-1.5,1.5-2,10,15,3-4,acuminate,acute,angular,apex,axil,blush-violet,broadly,calyx,campanulate,cell,cm,corolla,cyme,ellipsoid,elliptic,flower,fork,glabrous,glandular,hair,leaf,minute,mm,obovate,pedicel,peduncle,petiole,pinnatisect,rachi,rotate-stellate,rounded,scorpioid,shrub,simple,stem	-25,-3.5,-4,0.75-1.5,1,1-,1-10,1-2,10-15,12-60,15-30,2,3-11,637/1,8-,acuman,acumen,age,anthesi,aspect,ba,base,becoming,blunt,bluntly,broad,clonal,close,common,conspicuous,cuneate,cut,dia,distinct,downard,eaf,erect,exceeding,except,exerted,facetted,facing,floral,forked,general,gree,growing,interacuminal,lacking,lanceolate,lanceolate-elliptic,larger,lasting,lavender,line,lobe,lobed,lon,long,lower,midvein,nflorescence,oblique,often,part,pedicellate,plurifoliat,point,raised,rarely,rh,second,several,shallowly,short,sinus,slightly,soft-wooded,soon,stone,straggly,time,tip,tissue,toward,triangular,tub,ud,unit,unwinged,usually,violet,within,woody,x,year,ympodial,young	1-4,abaxial,adaxial,anther,arrangement,bark,bud,center,colour,diameter,filament,form,fruit,fruiting,green,growth,height,history,inflorescence,length,life,margin,na,new,number,ovary,perennial,plant,position,prickle,reproduction,scar,seed,shape,spacing,staman,stigma,style,surface,texture,trichome,width
97	wfo-0001026440	success	181	104	74	107	30	0.409	1-5,1.1-1.5,1.5-2.1,1.8-4.5,14-30,2.9-4.4,3-7,3-8,3.9-6.5,7-14,9,abaxially,acute,adaxially,anther,apex,bark,branched,broadly,brown,calyx,chartaceous,closely,cm,conical,corolla,diameter,elliptic,filament,flower,fruiting,globose,green,greenish-yellow,hair,leaf,length,lobed,many,minute,minutely,mm,multangulate-pubescent,obovate,obovoid-oblong,obtuse,ovate,pale,pedicel,peduncle,persistently,petiole,pitted,porrect-stellate,reniform,scabrous,short-acuminate,shrub,simple,small,spaced,sparse,stellate,stem,stigma,style,time,tomentose,tomentose-pubescent,tree,truncate,turning,white,yellow	0-15,1.1-1.4,1.3-1.7,1.9-3.7,1/2,1/2-2/3,2-2.8,2-4,3-5,3/4,4-12,5-7,accrescent,adaxiall,ag,along,always,anthesi,apparently,appressed,articulated,axillary,ba,basal,base,berry,blade,blunt-tipped,bract-like,branch,branche,capitat,dendritic-echinoid,dense,developed,dichotomy,directed,distal,distally,eaf,echinoi,echinoid,eed,entire,first,fleshy,free,granular,high,included,inserted,large,lengthening,lobe,long,long-attenuate,lower,m.,margin,mostly,multangulat,multangulate,nearly,nflorescence,oblong,obscure,often,older,openly,orolla,pair,perfect,plurifoliate,pore,poricidal,pubescen,rather,ripe,ruit,runk,semi-ovate,sessile,short-stalked,size,slit,sometimes,somewhat,stellate-pubescent,suture,tamen,terete,testa,thick,thin,tip,tomentum,translucent,tube,ud,uneven,unit,usually,vary,way,x,ympodial,young	abaxial,adaxial,arrangement,bud,capitate,colour,form,fruit,growth,height,history,inflorescence,life,na,number,ovary,perennial,plant,position,pubescent,rachi,reproduction,seed,shape,spacing,staman,surface,texture,trunk,width
98	wfo-0001026441	success	197	121	93	104	28	0.472	0-2,0.3-0.7,0.5-1.5,0.8,1-10,1-2,1.5-2.5,10-14,15-20,2-2.5,2-5.5,2-8,4-6,4.5-6.5,5,5-10.5,6-15,7-8,abaxially,adaxially,anther,apex,articulated,berry,brownish,cell,chartaceous,cm,condition,conical,corolla,covering,diameter,drying,elliptic-lanceolate,end,filament,flower,forked,fresh,fruit,glabrous,green,greenish,hair,hair-like,herb,interjected,lateral,leaf,leaflet,light,like,long,minute,minutely,mm,narrow,obtuse,odd-pinnate,one,orbicular,ovate,ovoid,pale,pedicel,peduncle,petiole,petiolule,placed,plant,puberulent,pubescent,ripe,rotate,rounded,seed,sparsely,stem,stigma,straight,style,terminal,testal,thick,tuber,typically,usually,violet,wall,whitish,wing,yellow	.5,0.4-3,1-1.5,1.5-2,10,3-5,4-8,4-8.5,5-merou,7-20,9-14,absent,acumen,acuminate,ag,alyx,apart,apparently,attenuate,axe,axillary,base,blade,bud,capitat,ciliate,connivent,decreasing,digestion,distal,dorsally,eaf,edge,eed,enzyme,equal,erec,especially,exceeding,flat,folded,fourt,geminat,generally,glabrou,gradually,green-white,half,homostylous,honeycomb-shaped,internal,lanceolate,larger,lengthening,living,lobe,lower,make,margin,middle,mottled,mucilaginous,nflorescence,orolla,pair,perfect,plurifoliate,pore,poricidal,purple,removed,ruit,secondary,semierect,seudostipule,short,size,slightly,slit,spaced,specimen,stamen,star,ste,stolo,subequal,subsessile,subtending,symmetrical,tall,tamen,tem,throughout,tip,toward,tri-,tube,unit,vary,wet,white,wide,x,ympodial	abaxial,adaxial,arrangement,capitate,colour,form,growth,height,history,inflorescence,length,life,na,number,ovary,perennial,placement,position,pseudostipule,rachi,reproduction,shape,spacing,staman,stolon,surface,texture,width
99	wfo-0001026453	invalid_json_followup	211	128	97	114	31	0.46	0.1-2.7,0.5,0.5-1,0.8-1.1,1,1-2,1.5-2,15,30,4m,5.5-8,7-9,<,adaxial,almost,anther,apart,apex,bark,base,bright,brown,calyx,capitate,cm,conical,corolla,densely,diameter,distally,elliptic,entire,filament,filiform,flattened,flower,fruiting,glabrescent,glabrous,globose,grayish,growth,inflorescence,irregularly,lateral,leaf,length,linear,lobed,long,margin,maturity,minutely,mm,narrowly,nearly,new,occasionally,opposite,pale,pedicel,peduncle,perfect,petiole,pitted,porrect,prickle,pubescent,red,reddish,reniform,scar,scattered,sessile,shallowly,shiny,shrub,simple,small,sometimes,sparsely,stellate,stem,stigma,straight,style,surface,tan,tapering,thin,tree,trichome,violet,weak,white,x,yellowish	.5,0.45-5.5,0.5-0.7,1-1.2,1-1.5,1.9-21.3,10-20,2,2-2.5,5-32,6-10,6-8,6376,abaxially,aberrant,absent,acuminate,acute,adaxially,along,anthesi,armed,articulated,attenuate,axi,basal,based,beneath,bent,berry,branched,broad,cell,deflexed,deltate-triangular,dense,denser,directed,distall,eaf,easily,eed,enlarged,enmeshing,equal,evenly,exceeding,exserted,free,hanging,howard,internode,lamina,lengthening,less,like,lobe,lower,midpoint,midrib,midvein,nflorescence,oblique,often,older,one,open,orange,outline,pair,papillo,parallel,per,pericarp,plurifoliat,pore,poricidal,portion,primary,pubescence,ray,rest,rounded,ruit,shorter,side,sinuate,slightly,slit,smaller,somewhat,sorter,spaced,sparse,sparser,spreading,strongly,surfac,tangled,testal,time,tip,triangular,trunk,tube,ud,unarmed,unit,upper,usually,vein,visible,within,ympodial	'',[,``,abaxial,arrangement,bud,characteristic,colour,form,fruit,height,history,life,na,number,ovary,ped,perennial,plant,position,rachi,reproduction,seed,shape,spacing,staman,texture,value,width,{,}
100	wfo-0001026460	invalid_json_followup	131	99	58	73	41	0.443	.5,0.5-1.5,1-1.5,1.5-2,1/2,10-15,6-7,7-9,acute-acuminate,anther,apex,branched,brown,calyx,capitate,closely,cm,completely,corolla,dark,distal,elliptic,filament,filiform,floccose,flower,fruiting,glabrous,globose,green,greenish,inflorescence,leaf,lobed,membraneous,minutely,mm,opposite,ovary,ovoid-reniform,pale,papillose,pedicel,pitted,puberulent,scar,shrub,simple,spaced,stem,stigma,style,subshrub,surface,tiny,trichome,white,yellow	.1,13.5-21,2-2.5,2.5-3,4.5-5,5,513,6-9,8-10,abaxially,acut,adaxially,anthesi,axi,base,becoming,berry,conical,deflexed,deltate,dia,do,drying,eaf,edicel,eed,erect,fide,free,frui,inflorescenc,internodal,less,like,lobe,long,long-exserted,lower,major,middle,nearly,nflorescence,often,older,pair,papillo,pore,poricidal,portion,reddish,reddish-brow,reflexed,ruit,santo,shaped,slightly,somewhat,soon,tall,tapering,tear-drop,tip,tub,tube,ud,unifoliat,unit,vein,widest,woody,x,ympodial,young	'',[,``,abaxial,adaxial,arrangement,bark,bud,cell,center,characteristic,colour,diameter,form,fruit,growth,height,history,length,life,margin,na,new,number,peduncle,petiole,plant,position,prickle,rachi,reproduction,seed,shape,spacing,staman,texture,unifoliate,value,width,{,}
101	wfo-0001026485	success	188	109	81	107	28	0.431	-22,-35,.25,1-10,1-2,1-2.5,1-4,1.5-5,10-25,2,2-3,20-30,3-25,3-6,3.5-7,6-9,abaxially,acute,adaxially,andromonoecious,anther,apart,apex,articulated,attenuate,base,bright,brown,chartaceous,cm,compound,diameter,filament,flattened,flower,forked,foveolate,fruit,glabrous,globose,greenish-white,inflorescence,leaf,light,margin,mm,obovoid,opposite,orange,ovate,pair,pedicel,peduncle,perennial,petiole,plant,prickle,puberulent,pubescent,pyriform,rachi,rarely,recurved,scar,simple,slightly,sparsely,stellate,stigma,straight,strongly,style,surface,swollen,tapering,thickened,trichome,truncate,unbranched,x,yellow	-1.5,0.25-1,1.5,10-20,2-4,2-6,2.3-5,2.5-5,20-40,20-50,3-4,3-7,4-9,4.5-9,45,5-20,5-7,5-merou,6-10,7-15,abaxiall,absen,accrescen,aggregate,alyx,appearing,armed,axe,blade,broadly,calyx,congested,connivent,cylindrical,developing,difoliate,directed,distall,dr.,eaf,eed,elliptic,elongating,entire,even,fertile,fruiting,geminat,glabrou,heterostylous,hollow,imparipinnate,internode,lanceolate,lateral,leaflet,leaving,like,lobe,long,long-attenuate,lower,lowermost,major,midvein,narrowly,nearly,nflorescence,oblique,occasionally,one,orolla,per,pore,recurve,reflexed,ripe,robust,rugose,ruit,scandent,side,small,sometimes,spaced,speciman,spreading,subcoriaceous,subopposite,tamen,tem,time,tip,tissue,tone-cell,toward,triangular,truncat,tube,unit,usually,vary,vein,vin,wide,winged,ympodial	5-merous,abaxial,adaxial,arrangement,cell,center,colour,corolla,form,growth,height,history,length,life,na,new,number,ovary,position,reproduction,seed,shape,spacing,staman,stem,texture,vine,width
102	wfo-0001026489	invalid_json_followup	153	105	62	91	43	0.405	0.05-0.1,0.5-2,0.8-1.2,0.8-1.3,1.5-5,2-5,2.5-4,5-6,acute,along,anther,apex,area,axil,bark,beneath,broadly,brown,calyx,closely,cm,corolla,cup-shaped,dark,elliptic,filament,flattened,flattened-reniform,fleshy,fruiting,glabrous,globose,green,leaf,lobed,margin,minutely,mm,opposite,ovary,pedicel,perpendicular,petiole,pitted,pubescent,scar,shiny,shrub,simple,spaced,stem,stigma,style,surface,tapering,tip,trichome,uniseriate,vein,white,whitish,widened	.3,0.25-0.5,0.5,0.5-0.75,0.5-1,0.6-1.4,0.8-3.7,1-1.5,1.3-3,2-3,2-4,2-8-flowered,2.5-13,2/3,8-13,anthesi,appearing,ba,base,berry,branched,deflexed,deltoid,densely,dia,differing,difoliate,dry,eaf,edicel,eed,erect,exserted,extending,free,geminat,gra,incrassate,lamina,later,lateral,lobe,lon,long,lower,main,major,middle,minor,nflorescence,occasionally,often,older,one,overlappin,pair,paler,papillo,papillose,parallel,planar,pore,poricidal,portion,prominent,red-papillose,rhachi,ruit,shaped,size,slender,somewhat,soon,specimen,straight,strongly,tall,tear-drop,terminal,thickened,tub,tube,ud,unit,usually,way,widest,woody,x,ympodial,young	'',0.3,2-8,[,``,abaxial,adaxial,arrangement,bud,center,characteristic,colour,diameter,flower,form,fruit,gray,growth,height,history,inflorescence,length,life,na,new,number,overlapping,peduncle,perennial,plant,position,prickle,rachi,reproduction,seed,shape,spacing,staman,texture,value,width,{,}
103	wfo-0001026490	success	272	130	93	179	37	0.342	1.5,3,6,7-pinnate,abaxially,adaxially,along,anther,anthesi,apart,apex,axillary,branched,brown,chartaceous,cm,contiguously,corolla,crisped,darker,densely,diameter,distally,eglandular,ellipsoidal,expanded,extra-axillary,filament,flat,flattened,flower,fruit,glabrous,green,immature,inflorescence,lacking,leaf,length,lenticular,light,lobe,main,mature,medium,midvein,mm,moderately,mottled,multicellular,nearly,obtusely,orange,pedicel,peduncle,pentagonal,petiole,pointed,pubescent,punctate,rachi,reflexed,rounded,sand,seed,shape,shoot,short,simple,slightly,smooth,sometimes,somewhat,sparsely,spur,stem,stigma,striping,strongly,style,surface,tawny,teardrop-shaped,terminal,tip,transparent,trichome,unbranched,vine,violet,white,yellow,×	.5,0.1–0.2,0.1–2.5,0.2–1,0.2–1.5,0.3–3.5,0.4–0.8,0.5–1,0.5–1.5,0.5–3.5,0.5–8,0.7–3,0.8–1.5,0.8–12,1.2–8,1.5–2,1.5–3.5,1.5–5,1.8–2.2,1.9,10–20,1–1.2,1–15,1–2.5,1–3,1–8,2,2.5–3.5,2–2.5,2–4,2–6,2–8,3–4.2,3–4.5,3–5,3–5-pinnate,3–8,4.6,4–4.5,4–5,5-merous,5–7,7,7–15,=,[,],absent,accrescent,acuminate,acute,ag,alyx,apical,apicall,apparently,around,articulated,axe,ba,base,becoming,blade,bract,bracteate,broadly,calyx,capitat,cauline,ciliate,climbing,commonly,completely,connivent,cordate,covered,cylindrical,decreasing,directed,distal,eaf,eed,elliptic,entire,equal,exceeding,free,fruiting,fused,geminat,ground,incurved,interjected,irregularly,large,lateral,latrorse-introrse,leaflet,lobed,long,longitudinal,lower,lowermost,lunate,margin,markedly,match,mean,mean=,middle,minute,near,nflorescence,node,obliqu,oblique,obliquely,oblon,oblong,obtuse,occasionally,one,opening,orolla,ovate,ovate-lanceolate,pair,papillose,part,per,perfec,perfect,petiolule,plurifoliate,pore,present,pseudostipule,pubescen,pubescence,pur,radial,reniform,resulting,revolute,rooting,ruit,seudostipule,shorter,similar,size,slender,slit,smaller,spaced,stamen,striation,tamen,tem,thickened,toward,trailing,trichomessympodial,truncate,tube,typically,undulate,unit,vary,vegetation,wide,wing,woody,yellowish-tan,youn,½,–4,–4.5,–8,–9.5	0.1-0.2,0.1-2.5,0.5-1,0.5-1.5,0.8-1.5,1-1.2,1-3,1-8,1.5-3.5,10-20,3-4.5,4.5,5-7,7-15,abaxial,adaxial,arrangement,capitate,colour,form,growth,height,history,life,na,number,ovary,perennial,plant,position,reproduction,spacing,staman,sympodial,texture,width,young
104	wfo-0001026491	invalid_json_followup	165	119	72	93	47	0.436	.5,1,1.5-2.5,10-50,2-celled,2.5-3.5,3,3-pinnate,5-6,5-8,abaxially,acuminate,acute,adaxially,anther,apex,appressed,base,branched,central,cm,crinkly,deep,diameter,elliptic-lanceolate,entire,filament,flower,glistening,globose,green,hair,highly,inflorescence,lanceolate,leaf,less,light,margin,mm,often,ovate-elliptic,ovoid,pale,pedicel,peduncle,petiole,porrect-incurved,pubescent,purple,rachi,rotate-pentagonal,rotate-substellate,rounded,row,sharp,shortly,shrub,simple,slender,spotted,stigma,straight,strigose,strong,suborbicular-ovate,surface,tawny,uniseriate,white,whitish,yellow	1-2,1.5-2,1.5-3.5,1.7,1977,2-3,2-4,5-merou,6-8,7-8,abaxiall,absent,alyx,anderson,apparently,articulated,averaging,axe,ba,bayonet,bent,berry,blade,bract,branching,broadly,capitat,cellular-papillose,cellular-pilose,connivent,conspicuously,cuneate,deciduous,deltoid,densely,directed,distall,eaf,eed,equal,first,geminat,greatly,growing,homostylous,interjected,lateral,leaflet,lobe,long,lower,lunulat,mean,middle,minutely,near,nflorescence,oblong-elliptic,obtuse,orolla,ovate,perfect,pilose,plurifoliate,point,pore,poricidal,present,rarely,readily,reduced,ruit,scandent,seudostipule,similar,small,strigo,strongly,subacute,tal,tamen,tem,terminal,tightly,tip,tube,tyle,unit,upright,usually,ventral,x,ympodial	'','bayonet,[,``,abaxial,adaxial,arrangement,bark,bud,calyx,capitate,cell,center,characteristic,colour,corolla,distally,form,fruit,fruiting,growth,height,history,length,life,na,new,number,ovary,perennial,plant,position,prickle,reproduction,scar,seed,shape,spacing,staman,stem,style,texture,trichome,value,width,{,}
105	wfo-0001026501	invalid_json_followup	195	124	89	106	35	0.456	.5,.6,/3,0-1,0.1,0.2-1.8,0.27-0.7,0.5-0.9,0.5-1,0.9-2.2,1-2,1-2.5,3-9,3.5-4,4-5,5-merous,?,abaxially,acicular,acute,anther,apart,apex,articulated,bark,base,berry,brown,brown-green,calyx,cm,densely,diameter,dull,elliptic,entire,erect,filament,flattened-reniform,flower,fruit,fruiting,glabrous,gray,green,leaf,length,light,lobed,long,margin,mauve,mm,moderately,orange-brown,orbicular,ovate,pale,pedicel,peduncle,petiole,porrect,prickle,prickly,reddish,rounded,scandent,scar,shoot,short,shrub,simple,sparsely,spherical,stalked,stellate-pubescent,stem,straight,style,surface,terete,terminal,trichome,variously,way,white,wide,yellow,yellow-green	-1.7,-3,.1,.35,.7,0,0-2,0.05-0.3,0.5,0.5-0.6,0.6-1,0.6-1.1,0.6-2,1,1.8-2.2,1/2-2/3,1/4,1/6-1/2,2-10,2.5-4,2.8-3,3-4,3-5,4-7,6-9,7-9,almost,alyx,apar,apically,apparently,becoming,blade,borne,branched,chartaceous,color,concolorous,cuneate,curved,deltate,discolorous,drying,eaf,eed,elongated,elongating,equal,eye,filiform,filiform-acuminat,flattened,free,glabrou,infructescence,known,lobe,longer,lower,mature,midpoint,naked,nflorescence,often,older,one,open,orolla,oung,pair,pendulous,per,perfec,pericarp,plurifoliat,poricidal,portion,prickl,primary,ray,ruit,sessile,shorter,slender,small,smooth,sometimes,somewhat,spaced,spreading,stalk,stellate,subsessile,tamen,tapering,time,tip,tube,unarme,unarmed,unit,upper,vary,vein,visible,ympodial	'',[,``,abaxial,adaxial,arrangement,bud,center,characteristic,colour,corolla,form,growth,height,history,inflorescence,life,na,new,number,ovary,plant,position,rachi,reproduction,seed,shape,spacing,staman,stigma,texture,value,width,{,}
106	wfo-0001026503	invalid_json_followup	269	129	81	188	48	0.301	0.7,3,5,5.0,8.2,acute,anther,apart,apex,arching,attachment,bark,brown,bud,calyx,capitate,central,chartaceous,cm,corolla,depression,diameter,distal,dry,entire,extra-axillary,filament,flattened-orbicular,flattened-reniform,flower,fruit,glabrous,glandular,globose,gradually,green,homostylous,increasing,lanceolate,lateral,leaf,lobe,long,many,margin,mature,mm,moderately,notched,oblong,outline,oval,ovate,pedicel,peduncle,petiole,point,portion,pubescent,red,red-brown,reddish,rotate-stellate,shallow,short,shrub,simple,sinuate,small,sparsely,stem,stigma,style,subacute,surface,tree,unarmed,white,yellow,yellow-tan,±smooth	.3,.5,.6,.9,0.03,0.3–,0.3–0.6,0.4–1.2,0.6–0.7,0.6–1.0,0.7–3.7,0.8–1.1,0.8–1.7,0.8–3.5,1.0–1.5,1.0–1.6,1.0–3.5,1.1–1.4,1.3,1.3–1.6,1.3–3.7,1.4–1.7,1.4–2.3,1.5–1.8,1.5–2.0,1.5–2.5,1.7,1.9–5.5,1/3,1/3–1/2,1/4–1/3,2.2–2.5,2.2–2.8,2.2–6.3,2.3–2.6,2.6–2.9,22,2–3,3.0–4.5,4.0–12.0,4.7,4.8,4.9–5.8,5-merou,6.0,6.9–10.3,7–10,9.0–1.0,90°,abaxially,acuminate,adaxially,adnate,aequilateral,ag,always,alyx,anthesi,apical,apiculate,apparently,appearing,around,articulate,attenuate,axe,ba,base,becoming,bent,berry,blade,branch,branching,brochidodromous,channeled,deltoid,dentate,developed,development,difoliate,directed,distally,eaf,edge,eed,eglandular,either,emerging,endocarp,exocarp,extending,fertile,filiform,flattened,flexed,free,geminat,glabrou,glossy,gree,hair,intact,internode,interpetalar,intersepalar,irregularly,juic,lackin,lacking,layer,lon,lower,lying,major,midrib,midvein,minor,minute,moderate,near,nearly,nflorescence,oblique,obviously,ocasionally,occasionally,opaque,orolla,pale,per,perforated,pore,potentially,present,pubescence,raised,reflexe,remaining,rigid,rounded,row,ruit,scarcely,scattered,shortly,side,sinus,slightly,sloughing,smoot,spaced,sparse,splitting,spread,spreading,stamen,stellate,stipitate,straight,suture,tamen,tem,thin,though,time,tip,tissue,transparent,truncate,tube,two,ud,upper,usually,vary,vein,weakly,well,wide,without,yellow-ferruginous,yellowish,ympodia,young,±equal,±straight,×	'',0.7-3.7,1.0-3.5,1.1-1.4,1.3-1.6,1.4-1.7,1.4-2.3,1/4-1/3,2.2-2.5,2.2-6.3,3.0-4.5,5-merous,[,``,abaxial,adaxial,arrangement,characteristic,colour,form,fruiting,growth,height,history,inflorescence,length,life,na,new,number,ovary,perennial,plant,position,prickle,rachi,reproduction,scar,seed,shape,spacing,staman,texture,trichome,value,width,{,}
107	wfo-0001026513	success	138	81	52	86	29	0.377	.25,0.8-2,1-1.5,1-3,2-2.2,3-5,4-5,6-8,acute,anther,apex,area,bark,closely,cm,corolla,deflexed,elliptic,erect,filament,flower,fruit,fruiting,glabrous,globose,green,hirsute,lanceolate,leaf,lobed,long-styled,minute,minutely,mm,opposite,ovary,pale,papillose,pedicel,petiole,plant,shrub,simple,slender,small,spaced,stigma,style,surface,treelet,white,woody	.1,.3,.75,/3,2-5,3-6-flowered,7-9,8-16,anthesi,apiculate,ba,base,berry,broadly,caly,calyx,completely,darkish,decurrent,delicate,deltoid,dia,differentiated,dry,eaf,edicel,eed,except,exserted,free,gre,immature,known,lateral,leave,less,live,lobe,long,longer,lower,main,mature,middle,much,nflorescence,obscure,older,overlappin,pair,pore,poricidal,portion,prominent,raised,reflexed,rest,ruit,scar,shaped,shiny,short-styled,somewhat,soon,specimen,stem,straight,styl,tall,tear-drop,tip,trichome,tube,ud,undersurface,unifoliat,uniseriate,unit,vein,venation,way,wide,widest,x,ympodial,young	3-6,abaxial,adaxial,arrangement,bud,colour,diameter,form,grey,growth,height,history,inflorescence,length,life,na,number,overlapping,peduncle,position,rachi,reproduction,seed,shape,spacing,staman,texture,unifoliate,width
108	wfo-0001026529	invalid_json_followup	219	123	83	136	40	0.379	0.3-1,0.5-4.5,1-10,1-2,1.1-2.5,11-14,12-22,120-210,3-9.5,5-15,5-9,?,abaxially,acuminate,adaxially,anther,apex,blue,brownish,bud,cell,chartaceous,clavate,cm,condition,corolla,covering,creamy,dark,deep,diameter,drying,elliptic,faintly,filament,flower,forked,fresh,fruit,glabrous,globose,green,greenish,herb,lateral,length,light,lilac,margin,medium,membranous,minutely,mm,moderately,odd-pinnate,ovate,ovoid,pedicel,peduncle,pentagonal,petiole,plant,puberulent,pubescent,pure,rarely,ripe,seed,shape,slightly,stem,stigma,style,substellate,terminal,testal,thick,trichome,wall,white,whitish,yellow,yellowish	0-25,1,1-3,1-4.5,1.5-2.5,1.5-4,10,10-28,2,2-5,2-7.5,20-60,3-12,3-5,3-6,4-8,5-17,5-merou,50-70,6-20,600-950,acumen,acute,ag,along,alyx,apart,apparently,articulated,attenuate,axe,axillary,base,berry,blade,broadly,capitat,ciliate,connivent,cordate,densely,digestion,distal,dorsally,dot,eaf,edge,eed,enzyme,erec,especially,exceeding,except,flat,folded,geminat,generally,glabrou,gland,glandular,greatly,gree,green-white,hair,hair-like,hal,half,head,homostylous,honeycomb-shaped,interjected,lanceolate,leaflet,lengthening,like,living,lobe,long,longer,lower,lunate,make,midrib,mucilaginous,narrowly,nflorescence,non-glandular,oblique,often,orbicular,orolla,pair,perfect,petiolulate,petiolule,plurifoliate,pore,poricidal,proximal,reduced,removed,rounded,ruit,scattered,sessile,seudostipule,short,size,slit,spaced,specimen,stamen,ste,straight,subequal,subsessile,subtending,tall,tamen,tem,tetralobulate,throughout,tip,tri-,tube,typically,unit,unwinged,usually,vary,varying,wet,wide,wing,x,ympodial	'',[,\u201chair-like\u201d,``,abaxial,adaxial,arrangement,bark,calyx,capitate,center,characteristic,colour,form,fruiting,growth,height,hermaphroditic,history,inflorescence,leaf,life,na,new,number,ovary,perennial,position,prickle,rachi,reproduction,scar,spacing,staman,surface,texture,value,width,{,}
109	wfo-0001026534	success	150	91	53	97	38	0.353	0.5-1,1.5-9,10-20,10-50,2-2.5,2-7,2-8,2.5-15,3-10,3-25,5-6,acuminate,apex,articulated,calyx,cell,chartaceous,cm,densely,diameter,ellipsoidal,entire,flattened,fleshy,flower,fruit,glabrous,margin,mm,orange,ovate,ovoid,pale,pedicel,peduncle,perfect,petiole,pinkish,puberulent,pubescent,purple,rachi,red,simple,stellate,stigma,style,subcoriaceous,tree,truncate,white,x,yellow	-1.5,1-2,1-2.5,1-3,1.5-6,10-15,15-50,2-3,2.5-4,3-,3-4,3-5,3.5-4,4-10,4-foliat,4.5-5,6-35,7-12,7-40,abaxially,absent,acute,adaxially,aggregate,apart,ape,apiculate,auriculate,axe,basal,base,beyond,blade,branched,bright,connective,connivent,cordate,cylindrical,darker,deltate,directed,distally,eaf,eed,eglandular,equal,exserted,glandular,hair,lanceolate,leaving,lemon-yello,lobe,lon,long,longitudinal,lower,m.,moderately,narrowly,nflorescence,nther,obtuse,often,orolla,pedicellar,pore,presen,puberulen,radiu,remnant,ruit,shorter,slightly,small,spaced,sparsely,stamen,stone,stripe,tal,tem,thecae,time,tip,tomento,triangular,truncat,tube,ud,unbranched,unit,vary,vein,wide,ympodial	abaxial,adaxial,anther,arrangement,bark,bud,center,colour,corolla,filament,form,fruiting,growth,height,history,inflorescence,leaf,length,life,na,new,number,ovary,perennial,plant,position,prickle,reproduction,scar,seed,shape,spacing,staman,stem,surface,texture,trichome,width
110	wfo-0001026535	invalid_json_followup	248	150	114	134	36	0.46	.5,0.1-0.2,0.7-1.5,1-2,1-3,1-5,1.2-2,2-5,3.5-4,7-8,abaxial,age,almost,along,anther,apex,apically,bark,base,becoming,berry,black,brachyblast,branch,brown,calyx,chartaceous,clavate,clustered,cm,concolorous,condensed,conical,corolla,cupular,dark,dendritic,dendritic-pubescent,dense,developed,diameter,dilated,discolorous,distributed,dorsal,dry,drying,elliptic,elongated,entire,evenly,except,filament,flexuous,flower,fruit,fruiting,glabrous,green-brown,inside,leaf,length,liana,like,lobed,margin,membranous,minutely,mm,mostly,number,obovate,older,orange-brown,outside,ovate,ovoid,partly,pedicel,peduncle,petiole,plant,prominent,pubescent,rachi,rarely,ridged,scar,short,shrub,side,smooth,spaced,sparsely,stem,stigma,stump,style,surface,terminal,thin,tissue,trichome,unevenly,unlignified,violet,weakly,white,wide,widely,x,yellowish,young,youngest	.1,.2,.4,.8,0-0.5,0.15,0.2,0.2-0.3,0.2-1.5,0.5-1,1,1.3,1.5-2,1.5-3,1/2-2/3,1/3,2-3,2.5,3,3-4.5,3-5,4-15,5-10,5-7,5°,abaxially,absent,accrescent,acute,adaxially,alternate,alyx,anthesi,apar,apparently,area,around,articulated,branched,branching,broadly,clearly,cuneate,cup,curved,deeply,delineate,delineated,deltoid,detaching,developing,divided,domatia,eaf,eed,ellipsoi,equal,eye,fertilisation,fine,flat,forming,free,frui,increasing,known,leave,lengthening,linear,lobe,lon,long,loop,loose,lower,m.,main,marginal,midvein,minute,much,naked,network,nflorescence,nther,oblong,obscure,orolla,pair,papillo,pendulous,perfec,pericarp,plurifoliat,pointed,pore,poricidal,portion,primary,protruding,raised,ray,reaching,rounded,ruit,secondary,see,simple,sinus,slender,slightly,smaller,soon,spreading,tearing,terete,tertiary,tip,toward,translucent,truncate,tube,tufted,two,ud,unarmed,uneven,unit,vary,vein,venation,visible,wider,ympodial	'',0-2.5,1.5,[,``,adaxial,apart,arrangement,bud,cell,center,characteristic,colour,ellipsoid,form,growth,height,history,inflorescence,life,na,new,ovary,papillose,position,prickle,reproduction,seed,shape,spacing,staman,texture,value,width,{,}
111	wfo-0001026538	invalid_json_followup	226	118	81	145	37	0.358	-5.8,0.3-1.5,0.8-1.2,0.8-2.2,1-3,1.2-2.6,1.7-2.5,2-5,3.2-4.8,3.5-4.6,3.5-5.8,6-13,6.7-,8.1-14.8,[,abaxially,acuminate,acute,adaxially,anther,apart,apex,bark,black,branched,broadly,brown,brown-black,bud,calyx,cm,corolla,deltoid,diameter,drying,elliptic,entire,filament,flower,fruit,fruiting,glabrous,globose,gray,green,leaf,length,many,margin,mm,obovate,ovate,pale,pedicel,peduncle,petiole,porrect-stellate,pseudo-terminal,pubescent,rachi,reticulate-punctate,scabridulous,short,shrub,simple,small,stellate,stem,stigma,style,subcampanulate,subconical,suborbicular,surface,time,tomentose-pubescent,tree,white,yellow,yellowish,yellowish-tan	-3.5,.5-3,/15-1/9,0-160,0.1-0.3,0.4-,0.6-0.8,0.8-1.5,0.9-1.2,1-1.9,1-2.5,1.2-1.4,1.2-1.5,1.3-2.8,1.4-2.6,1.4-3,1.5-2.5mm,1.8-4.6,1/2,12-21.5,2-3.5,2.1-3.2,2.1-3.4,3-4,3.7-5.8,4-8,5,6.3-8.9,8-10,],accrescent,adaxiall,ag,along,anthesi,apparently,appearing,around,articulated,axe,axillary,ba,base,berry,blade,blunt-tipped,branch,capitat,chartaceous,closely,completely,constricted,covering,cylindrical,decurrent,dense,densely,directed,distally,due,eaf,edge,eed,enveloping,exserted,farinose,fleshy,free,frui,glabrescen,glabrou,hair,inserted,lackin,lanceolate,lateral,lengthening,lobe,lobed,long,long-attenuate,long-stalked,longer,longitudinal,lower,main,measured,midrib,mixed,mostly,multangulate,nearly,nflorescence,obscured,obtuse,occasionally,older,orolla,ovate-lanceolate,overlapping,perfect,plurifoliate,pore,poricidal,porrect-stellat,pubescence,rarely,rather,ruit,runk,semi-ovate,sessile,short-stalked,side,slightly,slit,sometimes,somewhat,soon,spaced,stamen,suture,tall,tamen,terete,thick,thickened,thin-textured,tip,tomentu,touching,tube,ud,unarme,unarmed,unit,usually,vary,vein,way,weakly,wide,x,ympodial,young	'',0.4-1.5,60-160,``,abaxial,adaxial,arrangement,capitate,center,characteristic,colour,form,growth,height,history,inflorescence,life,na,new,number,ovary,perennial,plant,position,prickle,reproduction,scar,seed,shape,spacing,staman,texture,trichome,value,width,{,}
112	wfo-0001026539	invalid_json_followup	194	115	70	124	45	0.361	0,0.2,1-1.5,2-4-celled,abaxially,adaxially,anther,apex,berry,branched,brown,bud,calyx,campanulate,clustered,cm,corolla,creamy,diameter,ellipsoid,entire,filament,flattened-reniform,flower,fruit,glabrous,globose,growth,height,lance-elliptic,lateral,leaf,margin,minutely,mm,narrowly,oblanceolate,occasionally,orange,pedicel,peduncle,perennial,petiole,pilosulose,pitted,pointed,prickle,rachi,recurved,red,rugose,simple,sinuate,slender,staman,stellate,stem,stigma,stout,strongly,style,surface,terminal,trichome,usually,vine,white,woody,yellow,×	-6,.5,0.25,0.3-0.5,0.5,0.9,1,1-2-celled,1.5–2,10–15,10–28,15–20,1–2,2,2.5,2.5–4,20,20–35,2–2.5,2–3,2–4,2–5,3,30,3–5,4–6,5,5.5,5–,5–10,6–15,absent,acuminate,acute,ag,always,alyx,anthesi,apiculate,approximately,armed,articulated,axe,ba,basal,base,becoming,blade,broadly,capitat,cell,chartaceous,connivent,cucullate,deltate,densely,dr.,eaf,early,eed,elongate,elongating,equal,exserted,four,glabrou,hair,hooked,ine,interpetalar,larger,lengthening,lobe,lobed,long,long-attenuate,long-styled,longer,lower,major,midrib,nearly,nflorescence,often,one,orolla,pair,pericarp,pore,poricidal,present,puberulent,pubescent,pustulate,recurve,robust,rounded,ruit,sessil,shallow,shoot,short,side,slightly,slit,somewhat,spreading,straight,subwoody,tamen,tapering,terminally,time,tip,tissue,triangular,tub,tube,unequal,vary,vein,wide,winged,young	'',1.5-2,10-15,15-20,2-4,2-5,2.5-4,20-35,30-20,4-6,5-10,6-15,[,``,abaxial,adaxial,arrangement,bark,capitate,center,characteristic,colour,dry,form,fruiting,history,inflorescence,length,life,na,new,number,ovary,plant,position,reproduction,scar,seed,shape,spacing,texture,value,width,{,}
113	wfo-0001026604	invalid_json_followup	192	130	100	92	30	0.521	.4,0.8-0.9,1.2-1.7,1.5-9,10-30,2-2.3,2-2.5,2.3-3.5,4-4.5,50-100,?,aid,along,anther,anthesi,apart,apex,bark,base,berry,brown,c.,calyx,capitate,climbing,cm,conical,cordate,corolla,cupped,dark,densely,diameter,ellipsoid,entire,flattened,flexuous,flower,fruit,fruiting,glabrous,globose,growth,inflated,later,leaf-opposed,liana,lobed,margin,midrib,minute,minutely,mm,narrowly,new,nodding,ovary,ovate,overall,ovoid,pale,papillose,pedicel,peduncle,perfect,petiole,pitted,planar,pubescent,purple,red,reddish,reniform,ripe,scar,shape,shiny,shrub,simple,slender,slightly,somewhat,spaced,stellate,stem,stigma,style,support,surface,terminal,thin,trichome,twisting,uniseriate,vining,violet,way,widely,woody,x	.5,.75,0,0.1,0.4-0.6,0.8-1,1-1.2,1.1-1.3,1.5-2,3-3.5,3-5,3.5-4,4.5-7,5,5-7,<,absent,acuminate,age,always,appearing,articulated,articulation,atop,basal,branching,brow,cell,clearly,comical,cucullate,deflexed,differentiated,distal,distinct,drying,due,eaf,eed,elongate,expanding,exserted,filament,free,leaving,lengthening,lobe,lower,mere,nflorescence,oblique,occasionally,older,outline,pair,papillo,part,particularly,peg,per,pericarp,plurifoliat,poin,point,pore,poricidal,portion,primary,quarter,receptacle-like,rim,ruit,series,sinuate,slit,stout,strongly,structure,swolle,testal,time,tip,truncate,tub,tube,ud,undulation,unit,upper,vein,ympodial,½	'',[,``,abaxial,adaxial,arrangement,bud,characteristic,colour,form,height,history,inflorescence,leaf,length,life,na,number,perennial,plant,position,rachi,reproduction,seed,spacing,texture,value,width,{,}
114	wfo-0001026606	success	213	117	76	137	41	0.357	0.4-0.8,0.5-1.6,1.3-1.9,1.7-2.1,2.4-3.6,3-6,abaxial,abaxially,adaxial,almost,apart,apex,asymmetric,base,based,berry,black,broad,broadly,chartaceous,cm,coarsely,compressed,diameter,expanded,extra-axillary,filament,flower,fruit,glabrate,glabrous,globose,golden,internode,laterally,lenticular,margin,midpoint,minutely,mm,obsolete,ovate,pedicel,peduncle,pentagonal,peripherally,petiole,pitted,prickle,puberulent,pubescent,rachi,ray,recurved,ripe,scabrous,shrub,simple,slightly,small,spreading,stellate,stellate-pubescent,stelliform,stem,stigma,style,surface,tan,toothed,tree,white,wider,woolly,x,yellow	0.5–0.8,1.4-2.1,10–20,12-17,12.5-22.5,15–20,15–25,1–1.5,1–3,2-3,2–2.5,2–4,3-4.6,3–10,3–4,3–5,3–6,4.2-5.2,4–20,4–7,5-merou,5.8-7.2,5–15,6–7,6–8,7.3-9.7,7–12,8–10,abaxiall,absent,acute,adaxially,along,alyx,an¬ther,apiculate,apparently,armed,articulated,asymmetrically,axe,ba,band,blade,blunt-tipped,branched,capitat,central,closely,concentrated,cordate,cylindrical,densely,developed,difoliate,directed,distally,eaf,eed,entire,eventually,forming,geminat,glabrou,hair,homostylous,initially,interpetalar,lanceolate,larger,lateral,lighter,linear,lobe,lon,long,low,lower,main,midvein,moderately,much,nearly,nerve,nflorescence,obtuse,occasionally,often,of¬ten,older,open,orolla,perfect,persistently,pore,present,prickly,pubescen,pubescence,rarely,rayed,reduced,rounded,ruit,scar,scattered,sessile,short,shortly,sometimes,spaced,sparingly,sparsely,stellae,stout,subentire,tall,tamen,tapering,tem,thick,thickened,three,tissue,truncate,tube,unarmed,usually,vary,vein,warty,weakly,wide,widely,yello,ympodia,young	10-20,15-20,2-4,3-10,3-4,3-5,4-20,5-15,6-7,6-8,7-12,8-10,anther,arrangement,bud,calyx,capitate,colour,corolla,form,fruiting,growth,height,history,inflorescence,leaf,length,life,na,number,ovary,perennial,plant,position,reproduction,seed,shape,spacing,staman,texture,width
115	wfo-0001026607	invalid_json_followup	204	106	66	138	40	0.324	0.1-0.3,0.8-3.4,0.8-4.5,0.8-5,1-10,1-2,1-8,10-30,2-10,2.5-3.8,4-6,6-10,abaxially,adaxially,anther,apex,bud,cell,chartaceous,clavate,cm,corolla,covering,deep,diameter,elliptic,filament,finely,flower,forked,fruit,glabrous,globose,green,greenish,herb,lateral,leaf,margin,medium,membranous,minutely,mm,moderately,odd-pinnate,ovate,ovoid,pedicel,peduncle,pentagonal,petiole,plant,puberulent,pubescent,rachi,seed,stem,stigma,style,terminal,testal,thick,violet,wall,whitish,yellow	0-3,0-4,0.3-1.8,0.5-5.8,1-3.8,1-5,1.5-4,2-2.5,2-3,2.4-5.8,2.7-19,3-8,4-10,5,5-merou,5.8-19.8,absent,acumen,acute,ag,along,alyx,apart,apparently,articulated,attenuate,axe,axillary,base,basiscopic,berry,blade,brownish,capitat,ciliate,clearly,coarse,condition,connivent,decreasing,decurrent,digestion,distal,dorsally,dot,drying,eaf,edge,eed,enzyme,especially,exceeding,flat,folded,forming,fresh,geminat,generally,glabrou,greatly,gree,green-white,hair,hair-like,hal,half,high,homostylous,honeycomb,interjected,lanceolate,larger,leaflet,lengthening,like,living,lobe,long,lower,make,marked,midrib,minute,much,mucilaginous,nflorescence,obtuse,often,orbicular,orolla,pair,perfect,petiolulate,plurifoliate,pore,poricidal,present,rarely,removed,ripe,rosette,rounded,ruit,scattered,semierec,sessile,seudostipule,shaped,short,side,simple,size,slit,sometimes,spaced,specimen,stamen,ste,straight,subtending,tall,tamen,tem,throughout,tip,toward,tri-,tube,typically,unit,unwinged,usually,vary,wet,white,without,x,ympodial	'',[,\u201chair-like\u201d,``,abaxial,adaxial,arrangement,bark,calyx,capitate,center,characteristic,colour,form,fruiting,growth,height,history,inflorescence,length,life,na,new,number,ovary,perennial,position,prickle,reproduction,scar,shape,spacing,staman,surface,texture,trichome,value,width,{,}
116	wfo-0001026613	success	159	90	63	96	27	0.396	0.6,1-10,1-2,2.3-8,2.5-2.8,3-10,3-5,5,5-6,6-12,8-18,8.5-10,8.5-9,abaxially,acuminate,adaxially,anther,apex,articulated,base,berry,chartaceous,cm,cordate,corolla,decreasing,densely,diameter,distal,filament,flower,forked,fruit,glabrous,greatly,green,herb,larger,lateral,leaf,leaflet,m-1.2,membranous,minute,minutely,mm,odd-pinnate,ovate,pedicel,peduncle,petiole,petiolule,plant,puberulent,pubescent,purple,rotate-pentagonal,size,stigma,style,terminal,toward,yellow	0.5-1,1.5-4,11-19.5,2-7.5,4-5,4.5-8.5,5-7,5-merou,5.5-7,6-8,6.2-9.5,9.5-13.5,absent,acumen,ag,along,alyx,apart,apparently,attenuate,axe,axillary,blade,borne,bud,capitat,ciliate,conical,connivent,dorsally,eaf,edge,eed,end,erec,especially,flat,folded,geminat,generally,hair,hal,half,homostylous,immature,interjected,lanceolate,lengthening,like,lobe,long,lower,margin,mature,middle,midrib,mottled,nflorescence,orolla,pair,perfect,plurifoliate,pore,poricidal,proximal,pubescen,ruit,secondary,semierect,seudostipule,singly,slit,spaced,sparsely,ste,stem,stolo,subequal,subtending,symmetrical,tall,tamen,tem,tip,tri-,tube,tuber,typically,unit,unknow,unknown,unwinged,usually,vary,x,ympodial	abaxial,adaxial,arrangement,capitate,colour,form,growth,height,history,inflorescence,length,life,na,number,ovary,perennial,position,pseudostipule,rachi,reproduction,seed,shape,spacing,staman,surface,texture,width
117	wfo-0001026614	success	200	124	82	118	42	0.41	0.4-0.7,1.3-1.8,2.2-5.5,2.5,3.2-5.2,4-7,abaxially,absent,acuminate,acute,adaxially,anther,apex,articulated,base,berry,black,broad-based,brown,calyx,campanulate,chartaceous,clavate,cm,dark,densely,diameter,dried,evenly,expanded,extra-axillary,filament,flattened-reniform,flower,foveolate,fruit,fruiting,glabrous,globose,golden,hair,internode,interpetalar,leaf,long,midpoint,minutely,mm,mottled,nearly,orange,orange-red,ovate,ovoid,pedicel,peduncle,petiole,prickle,pubescent,rachi,ray,ripe,rotate-pentagonal,shrub,simple,slightly,sometimes,somewhat,sparsely,spreading,stellate,stellate-pubescent,stem,stigma,style,surface,tissue,white,x,yellow,yellowish,–5	.8,0.2,0.2–0.3,0.5,0.5–2,1-,1.5–2,11-15,15–30,1–2,1–3,1–5,2.2,2.5–3,20–25,2–4,2–4-branched,2–6.5,3-foliate,3–10,4.5–11,4.5–5.5,5,5-merou,5.3-8.2,50,6.4-8.4,6–8,7.2-9.8,8–10,9–16,>,across,adaxiall,alyx,apart,apparently,armed,axe,ba,blade,blunt-tipped,capitat,closely,commonly,concentrated,cylindrical,denser,developed,directed,distally,eaf,eed,entire,erect,especially,fleshy,geminate,glabrescent,gland-tipped,globo,homostylous,irregularly,lanceolate-attenuate,lateral,less,linear,lobe,lobed,lon,lower,margin,midvein,minute,nflorescence,oblique,obtuse,often,orolla,ovate-lanceolate,pair,per,perfect,pore,pubescence,rarely,reflexed,repand,rounded,ruit,scattered,sessile,shallowly,shin,side,similar,smaller,soon,spaced,stellae,tall,tamen,tapering,tem,time,tissu,tube,ud,unarme,unarmed,usually,vary,vein,weakly,well,wide,ympodia,young	0.2-0.3,0.5-2,0.5-3,1-2,1-3,1-5,15-30,2.5-3,3-10,4.5-5.5,6-8,8-10,9-16,abaxial,absence,adaxial,arrangement,bud,capitate,colour,corolla,form,growth,height,history,inflorescence,length,life,na,number,ovary,perennial,plant,position,reproduction,seed,shape,shiny,spacing,staman,texture,width
118	wfo-0001026632	success	108	82	53	55	29	0.491	.5,0,1-2,1.5,10-12,3-4,abaxially,acuminate,adaxially,anther,apex,base,broadly,cm,condensed,cyme,densely,diameter,divided,elliptic,exposed,extra-axillary,filament,flattened,flower,hair,halfway,height,leaf,lobe,long,minute,mm,moderately,ovate,pedicel,peduncle,petiole,prickle,pubescent,reddish-brown,scarcely,short,shrub,simple,stellate,stellate-pubescent,stigma,straight,style,toward,unknown,young	5-merou,6,7,abundantly,acumen,acute,alyx,armed,ba,blade,bu,capitat,cell,central,commonly,developed,eaf,eed,equal,erect,geminat,glandular,interacuminal,lamina,lanceolat,lateral,less,little,lon,lower,margin,nflorescence,orolla,porrect-stellate,prickly,prominent,ray,rounded,ruit,sessile,shallow,sinus,structure,tamen,tem,tissue,triangular,truncate,tube,unarme,unknow,vary,well,x,ympodial	abaxial,adaxial,arrangement,bud,capitate,colour,corolla,form,fruit,growth,history,inflorescence,length,life,na,number,ovary,plant,position,rachi,reproduction,seed,shape,spacing,staman,surface,texture,unarmed,width
119	wfo-0001026642	invalid_json_followup	193	108	58	135	50	0.301	0.5,abaxial,abaxially,annual,anther,apex,axillary,bipinnate,black,blade,blue,branched,brown,calyx,cell,clavate,cm,dark,diameter,filament,flattened,flower,fruit,glabrous,globose,green-purple,herb,indumentum,lavender,leaf,length,lilac,long,mm,moderately,multicellular,number,obtuse,ovate,pale,pedicel,peduncle,pentagonal,perennial,petiole,pinnate,pitted,pubescent,shallowly,simple,sparsely,stigma,style,subglabrous,surface,uniseriate,violet,yellow	.05,.1,.8,0.1,0.1–0.3,0.2,0.25,0.4,0.4–2.2,0.5–,0.5–0.7,0.5–1.7,0.5–2.0,0.5–3.5,0.6,0.6–1.0,0.75–1.0,0.75–2.0,0.7–1.6,0.8–1.2,1.0,1.0–2.0,1.2–1.7,1.2–2.0,1.2–3.5,1.2–6.2,1.6–8.0,1.9–3.0,12–30,1–10,1–3,2.0–4.0,2.5–3.5,2.5–4.0,2.8–3.0,3.0–5.1,3–5,4.0–6.0,4–7,5,5.0–7.0,50–100,6,<,acute,adaxiall,adaxially,ag,along,anthesi,apart,appressed,articulated,axe,ba,base,borne,chartaceous,circular,connivent,cylindrical,decreasing,decumbent,densely,denser,divided,eaf,eed,either,elliptic,equal,erect,fleshy,geminat,glabrescen,gland,glandular,hair,half,lobe,lon,longitudinal,lower,m.,narrow,nflorescence,oblong,occasionally,often,opening,orolla,pair,perfect,pinnae,pore,poricidal,present,primary,probably,rapidly,rounded,ruit,secondary,sessile,shoot,side,slit,sometimes,spaced,stone,straight,tal,tamen,tem,time,tip,tube,unicellular,unifoliate,unit,usually,vary,vein,white,wide,wing,woody,x,ympodial,–1.2,–11.0,–2.0,–4.5,–6,–7	'',0.4-2.2,0.5-3.5,0.75-2.0,1-10,1-3,1.2-3.5,12-30,2.8-3.0,3.0-5.1,5.0-7.0,50-100,[,``,adaxial,arrangement,bark,bud,center,characteristic,colour,corolla,form,fruiting,growth,height,history,inflorescence,life,margin,na,new,ovary,plant,position,prickle,rachi,reproduction,scar,seed,shape,spacing,staman,stem,texture,trichome,value,width,{,}
120	wfo-0001026651	invalid_json_followup	222	128	84	138	44	0.378	-celled,1,1.8,2.8,3,4,8,acuminate,acute,anther,antrorse,apex,appressed,arcuate,articulated,base,berry,brown,calyx,capitate,chartaceous,cyme,dark,densely,diameter,dull,entire,erect,exfoliating,filament,flattened,flexuous,flower,fruit,glabrescent,glabrous,globose,green,herb,lanceolate,lateral,leaf,length,light,margin,matte,membranaceous,mm,moderate,moderately,narrowly-elliptic,new,normally,ovate-deltate,ovate-reniform,pedicel,peduncle,perfect,petiole,plant,pubescent,revolute,seed,shape,shrub,simple,slightly,sometimes,stellate,stem,stigma,style,sub-opposite,surface,terminal,translucent,trichome,unbranched,undulate,uniseriate,white,woody,yellow,young	0.2–1.3,0.35–2.6,0.9–3,1–2,2.2–10,2–11.5,2–13,2–3,2–3.3,2–4,2–4.5,2–8,3-plurifoliate,3–5,3–7,4–6,4–7.8,5-merou,6–10,6–14,abaxially,absent,accrescent,adaxiall,adaxially,along,alyx,anisophyllous,antror,antrorsely,apar,ark,asymmetric,attenuate,axi,beneath,beyond,branch,broadly,brochidodromous,brownish-green,capitat,cell,ciliate,circular,cm,connivent,cordate,cylindrical,decumbent,decurrent,differing,directed,discolorous,drying,eaf,eed,elliptic,emarginate,equal,exserted,eye,frui,geminate,geniculate,glabrou,glandular,growt,hair,head,highly,hilum,hollow,impressed,introrsely,less,like,lobe,long,longitudinal,lower,lying,major,markedly,midrib,minor,mostly,much-branched,multicellular,naked,nflorescence,oblong-ellipsoid,obtuse,older,one,onto,opening,orolla,ovate-lanceolate,parallel,pedunculate,per,pore,poricidal,prominent,pubescence,reduce,region,ripe,rounded,ruit,secondary,shiny,similar,single-celled,size,slit,small,smaller,spaced,stalk,stamen,straight,subapical,tall,tamen,tem,turning,unit,upper,usually,vary,vein,venation,visible,wide,ympodial,×	'',1-2,2-13,2-3,2-8,2.2-10,3-7,4-6,5-merous,6-10,[,``,abaxial,adaxial,apart,arrangement,bark,bud,center,characteristic,colour,corolla,form,fruiting,growth,height,history,inflorescence,life,na,number,ovary,position,prickle,rachi,reproduction,scar,spacing,staman,texture,value,width,{,}
121	wfo-0001026656	invalid_json_followup	211	143	102	109	41	0.483	0.3-3,1-10,1-2,1-3.8,1.1-8.1,20-60,4-13,4-8,5-18,5-35,9-11,abaxially,adaxially,along,anther,apart,apex,articulated,blue,broadly,brownish,bud,capitate,cell,chartaceous,ciliate,cm,condition,corolla,covering,dark,densely,diameter,distal,dot,drying,elliptic,especially,filament,flower,forked,fresh,fruit,generally,glabrous,glaucous,globose,green,green-white,greenish,greenish-yellow,hair,herb,lanceolate,lateral,light,like,make,margin,membranous,midvein,minutely,mm,moderately,mucilaginous,narrowly,occasionally,odd-pinnate,often,ovate,ovoid,pedicel,peduncle,pentagonal,petiole,plant,puberulent,pubescent,purple,rachi,rotate-pentagonal,scattered,seed,sometimes,somewhat,star,stem,stigma,style,subglabrous,terminal,testal,thick,throughout,tinged,tip,violet,wall,wet,white,whitish,yellow	0-4,0.3-4.2,0.4-6.5,0.7-10.5,0.9-13,1,1-1.8,1-4,1-5,1.5-7,10,2-6,2-8,2.5-17,4-10,5,5-merou,5.5-27,absent,acumen,acuminate,acute,ag,alyx,attenuate,base,bearing,blade,borne,clavat,connate,connivent,cuneate,curved,decurrent,digestion,dorsally,eaf,edge,eed,end,enzyme,erec,exceeding,flat,folded,geminat,greatly,hair-like,half,homostylous,honeycomb-shaped,interjected,larger,leaflet,lengthening,living,lobe,long,lower,lunate,middl,mottled,nflorescence,non-glandular,oblique,orolla,pair,petiolulate,petiolule,plurifoliate,pore,poricidal,pubescen,ranging,removed,ruit,scale-like,seudostipule,short,singly,slightly,slit,spaced,specimen,stamen,ste,stolo,straight,subequal,subtending,symmetrical,tall,tamen,tem,tertiary,therefore,tri-,truncate,tube,tuber,typically,unit,unwinged,vary,wide,wing,without,ympodial	'',[,\u201chair-like\u201d,``,abaxial,adaxial,arrangement,bark,calyx,characteristic,clavate,colour,form,fruiting,growth,height,history,inflorescence,leaf,length,life,middle,na,new,number,ovary,perennial,position,prickle,reproduction,scar,shape,spacing,staman,surface,texture,trichome,value,width,{,}
122	wfo-0001026663	success	251	120	91	160	29	0.363	-2.9,0.2-0.6,0.4-2.2,0.9-1.5,1,1-3.2,1-5,1.1-2.1,1.2-2,1.4-3.1,2-12,2.9-5,3.8-5.7,31,4.7-25.9,8-17,abaxially,acuminate,adaxially,along,angled,anther,apart,apex,bark,becoming,branch,branched,brown,bud,calyx,chartaceous,cm,conical,corolla,dark,diameter,drying,elongated,entire,filament,flower,fruit,glabrescent,globose,granular,green,greenish-brown,grooved,immature,leaf,length,less,light,longitudinally,many,margin,mm,ovate-lanceolate,pale,pedicel,peduncle,persistent,petiole,pseudo-terminal,pubescent,rachi,rich,scabrous,short,shrub,simple,small,sparsely,stellate,stigma,style,subcampanulate,subglobose,terete,time,tip,tomentose,tomentose-pubescent,tree,vein,violet,white,whitish,x,yellow	-15,-8,-9.7,.5-2.5,/25-1/15,/3,0-160,0.3-0.8,1-2.5,1.1,1.4-2.6,1.6-2.3,1.9-2.6,1/2,1/3,1/4-1/2,10-26,10.3-13.2,12-14,2.1-2.6,2.5-3.7,2.8-5.3,2/3,24-45,3-5,3.5-5,4.5-5.7,5-8,5.5-,5.5-8.8,7.5-9,accrescent,acute,adaxiall,ag,anthesi,apparently,appressed,around,articulated,ascending,attenuate,axe,axillary,base,berry,blade,blunt-tipped,broadly,capitat,closely,completely,constricted,covering,cylindrical,densely,directed,distally,distributed,eaf,echinoi,echinoid,echinoid-pubescent,edge,eed,enveloping,especially,evident,exserted,farinose,flared,fleshy,free,fruiting,glabrescen,glabrous,granular-tomentose,hair,inserted,lanceolate,lateral,lengthening,line,lined,lobe,lobed,long,long-stalke,long-stalked,longer,longitudinal,lower,m.,main,matur,midrib,midvein,minute,multangulate,multangulate-pubescent,nearly,nflorescence,obtuse,occasional,occuring,older,opening,openly,orolla,ovate,ovate-lanceolat,perfect,plurifoliate,pore,poricidal,porrect-stellate,present,pubescence,rather,ray,ridged,robust,ruit,runk,sessile,short-stalked,side,slightly,slit,sometimes,somewhat,soon,spaced,stalk,stalked,stamen,stem,strongly,subcoriaceous,subglabrous,suture,tall,tamen,tangled,thick,thin,tomentum,touching,tube,ud,unarme,unarmed,unit,upper,usually,vary,way,wide,ympodial,young	5.5-9,70-160,abaxial,adaxial,arrangement,capitate,colour,form,growth,height,history,inflorescence,life,mature,na,number,ovary,perennial,plant,position,reproduction,seed,shape,spacing,staman,surface,texture,trunk,width
123	wfo-0001026686	success	196	87	60	136	27	0.306	0.6-0.9,1-10,1-2,1.5-7,10-28,2.4-3.6,3-4,5,5-8,6.5-12.7,7-9,8-14,abaxially,adaxially,anther,apex,articulated,berry,cell,chartaceous,cm,conical,corolla,densely,diameter,filament,flower,forked,fruit,glabrous,green,greenish,herb,honeycomb-shaped,leaf,light,long,minute,minutely,mm,mucilaginous,odd-pinnate,ovoid,pedicel,peduncle,petiole,plant,puberulent,pubescent,purple-violet,rotate-stellate,seed,size,sparsely,stigma,style,terminal,tuber,whitish,yellow	.4,0.2-0.5,1,1-2.5,1.2-3.4,1.2-3.6,1.7-2.5,2-10,2-9,2.5-8,3-5,3.7-8,4-6,5-16.5,5-merou,8-10,8-27,absent,acumen,acuminate,ag,along,alyx,apart,apparently,axe,axillary,base,blade,borne,brownish,bud,capitat,ciliate,condition,connivent,covering,decreasing,digestion,distal,dorsally,drying,eaf,edge,eed,elliptic-lanceolate,end,enzyme,equal,erec,especially,exceeding,flat,folded,fresh,geminat,generally,glabrou,gradually,green-white,hair,hair-like,half,homostylous,interjected,lanceolate,larger,lateral,leaflet,lengthening,like,living,lobe,lower,make,margin,middle,midrib,mottled,nflorescence,obtuse,often,orbicular,orolla,ovate,pair,perfect,petiolule,plurifoliate,pore,poricidal,pubescen,purple,removed,ripe,round,ruit,secondary,semierect,seudostipule,singly,slightly,slit,spaced,specimen,stamen,star,ste,stolo,straight,stripe,subequal,subsessile,subtending,symmetrical,tall,tamen,tem,testal,thick,throughout,tip,toward,tri-,tube,typically,unit,usually,vary,wall,wet,white,wide,wing,x,ympodial	abaxial,adaxial,arrangement,capitate,center,colour,form,growth,height,history,inflorescence,length,life,na,number,ovary,perennial,position,pseudostipule,rachi,reproduction,shape,spacing,staman,surface,texture,width
124	wfo-0001026695	success	128	86	55	73	31	0.43	0.6-8,1-2,1-4,1.6,11-14,2,2-6,2.5-5.2,2.5-7,4,6-12,6-7,6-8,6.5-13,acute,apex,articulate,base,branched,cm,corolla,cyme,diameter,dichasial,dichasially,distal,ebracteate,filament,flower,glabrescent,half,herbaceous,leaf,leaflet,mm,monochasial,oblique,odd-pinnate,ovate,ovate-lanceolate,pedicel,peduncle,perennial,petiole,plant,proximal,pubescent,short-acuminate,simple,stellate,stigma,style,terminal,yellow,¼	1-1.5,2-3,2.5-3,3-4,3-6-foliat,3-8,4-5,4-5.5,8-16,8-17.5,abaxially,absen,acumen,acuminate,adaxially,apical,apically,calyx,compound,connate,cordate,cuneate,decurrent,dehiscent,dorsally,eaf,edge,eed,exceeding,flat,folded,forked,generally,globo,interjected,introrse,lateral,lobe,lon,long,lower,lunat,maturing,nflorescence,nther,often,one,orolla,pair,perfect,plan,poricidally,rounded,ruit,sessile,seudostipule,short,slit,stamen,straight,tal,tem,triangular,tuber-bearing,typically,unit,unknow,unknown,vary,whit,wide,without,ympodial	abaxial,adaxial,anther,arrangement,colour,decurren,form,fruit,globose,growth,height,history,inflorescence,length,life,lunate,na,number,ovary,position,pseudostipule,rachi,reproduction,seed,shape,spacing,staman,surface,texture,white,width
125	wfo-0001026696	success	139	89	65	74	24	0.468	0.3-4.5,0.8-7,1,1.3-2.1,2-3,3-17,3-3.5,5-35,9,abaxially,adaxially,articulate,base,branched,broadly,cell,cm,corolla,covering,cyme,densely,diameter,dichasial,dichasially,distal,ebracteate,flower,forked,globose,green,green-white,hair-like,half,herbaceous,honeycomb,lanceolate,lateral,light,linear,long,mm,monochasial,mucilaginous,odd-pinnate,ovate,ovoid,pattern,pedicel,peduncle,perennial,petiole,plant,proximal,pubescent,seed,stellate,stigma,style,testal,thick,throughout,wall,white-cream,yellow,¼	0.9-7.2,1-1.3,1-4,1.5-3,2-17,3-6,3-6-foliat,3-8.5,4-16,acumen,acute,apex,apical,apically,apiculate,calyx,connate,cuneate,decurrent,dehiscent,digestion,dorsally,eaf,edge,eed,emoval,entire,enzyme,exceeding,filament,flat,folded,generally,globo,introrse,light-yello,living,lobe,lon,lower,lunat,make,margin,maturing,nflorescence,nther,oblong,obtuse,often,orolla,perfect,plan,poricidally,reveal,rounded,ruit,seudostipule,short,simple,sinuate,slit,specimen,stamen,straight,tal,tem,throughou,tuber-bearing,typically,unit,vary,wide,without,ympodial	anther,arrangement,color,form,fruit,growth,height,history,inflorescence,leaf,length,life,light-yellow,na,number,ovary,position,reproduction,shape,size,spacing,surface,texture,wet
126	wfo-0001026706	invalid_json_followup	232	126	90	142	36	0.388	-3.1,-4.4,-6.1,0-240,0.2-0.3,0.2-0.5,0.6-2.2,0.8-1.5,0.8-2.8,0.9-2,1-2.2,1-5,1.5-3,2.9-6,3-4.6,4,4.5-5.5,5-6.5,5.3-6.4,6.1-,7-16,9.8-15.4,abaxially,accrescent,acute,adaxially,anther,apart,apex,articulated,attenuate,bark,base,branched,brown,bud,calyx,cm,corolla,dark,diameter,entire,filament,flower,fruit,fruiting,glabrate,globose,golden,green,leaf,length,many,margin,mm,oblong,ovate,ovate-elliptic,ovate-lanceolate,pale,pedicel,peduncle,petiole,porrect-stellate,pseudo-terminal,pubescent,rachi,reticulate-punctate,shrub,simple,small,sparsely,stellate,stem,stigma,style,subconical,subglobose,suborbicular,surface,tall,time,tomentose-pubescent,tree,velutinous,white,whitish,x,yellow,yellowish-tan	-5.5,.5,/14-1/6,0.8-1.2,0.9-1.9,1.1-4,1/2-2/3,10-15,12,14-32,2.2-3.3,2.3-3.8,2.5-3,2.7-4,2/3-3/4,3.1-3.8,3.6-5.7,4.2-12,6-10,6-8,8-14,adaxiall,ag,anthesi,apparently,appearing,around,axe,axillary,ba,becoming,berry,blade,blunt-tipped,branch,capitat,chartaceous,closely,completely,coriaceous,covering,crisped,cuneate,cylindrical,dendritic-echinoid,dendritic-multangulate,densely,directed,distally,eaf,edge,eed,enveloping,exserted,farinose,fleshy,fourth,free,furfuraceou,glabrous,grayish,hair,herbarium,indument,inserted,lackin,lacking,lanceolate,lateral,lengthening,lobe,lobed,long,long-stalked,longitudinal,lower,m.,main,matted,midrib,minute,mixed,multangulat,multangulate,nearly,nflorescence,obscured,obtuse,occasionally,often,older,orolla,perfect,persistent,plurifoliate,pore,poricidal,pubescence,rather,reddish,ruit,runk,semi-ovate,sessile,short-,short-stalked,side,slightly,slit,softly,somewhat,soon,spaced,specimen,splitting,stalked,stamen,strongly,subcampanulate,sulcate,suture,tamen,thin-walled,tip,tomentu,touching,translucent,transparent,tube,ud,unarme,unarmed,unevenly,unit,upper,vary,vein,wavy,way,wide,ympodial,young	'',[,``,abaxial,adaxial,arrangement,capitate,center,characteristic,colour,form,growth,height,history,inflorescence,life,na,new,number,ovary,perennial,plant,position,prickle,reproduction,scar,seed,shape,spacing,staman,texture,trichome,value,width,{,}
127	wfo-0001026707	invalid_json_followup	196	126	88	108	38	0.449	.5,/3,0.05-0.15,0.5-1,0.5-3,0.6-0.7,0.7-1.4,1-5,1.6-2,2.5-6,3-4,3-4.5,3-8,4,5-10,8-15,?,abaxially,acute,anther,apart,apex,articulated,bark,base,berry,branched,broadly,calyx,clustered,cm,densely,diameter,entire,erect,filament,flattened-reniform,flower,foliaceous,fruit,fruiting,glabrescent,glabrous,gray,green,lateral,leaf,length,lobed,long,margin,mauve,mm,moderately,narrow-deltate,narrow-oblong,orange-brown,pedicel,peduncle,petiole,porrect-lepidote,prickle,pubescent,red-brown,rounded,scar,sessile,shrub,small,sometimes,sparsely,spherical,stalked,stellate-pubescent,stem,straight,style,surface,terete,terminal,tip,tree,trichome,variously,way,white,wide,yellow-green	-1/3,-3,-5,.8,0,0-20,0.05,0.1-0.2,0.3-0.8,0.6-0.8,0.7-1,0.7-1.5,1-1.7,1-3,1.5-1.8,1/3,1/3-1/2,1/3-3/4,1/4-1/3,1/8-1/4,11-16,2-10,2-2.3,2-6,2.5-3,2.5-4,3-7,5-25,5-7,5-8,5-merous,alyx,apar,apically,apparently,attenuate,blade,branche,broad-deltate,chartaceous,color,concolorous,connivent,curved,cuspidat,decurrent,discolorous,drying,eaf,eed,elongating,equal,eye,free,fused,gently,glabrou,inflated,infructescence,juvenil,known,less,lobe,longer,lower,mature,midpoint,naked,nflorescence,obtuse,older,one,open,orolla,oung,per,perfec,pericarp,plurifoliat,poricidal,porrect,portion,prickly,ray,reflexed,ruit,shorter,simple,slender,smooth,spaced,spreading,stalk,stellate,stout,tamen,tapering,time,tube,unarmed,unit,upper,vary,venation,visible,weakly,ympodial,¼	'',[,``,abaxial,adaxial,arrangement,branch,bud,center,characteristic,colour,corolla,form,growth,height,history,inflorescence,life,na,new,number,ovary,perennial,plant,position,rachi,reproduction,seed,shape,spacing,staman,stigma,texture,unknown,value,width,{,}
128	wfo-0001026711	success	210	131	101	109	30	0.481	-5,.8,0,0-0.2,0-6,0.15,0.3-1,0.5-1.5,0.7-1.4,0.75-1,0.8,1.5-2.2,1/2-2/3,1/3,1/4,1/4-1/3,2-3.5,2-6,3-5,3.5-5.2,5-merous,abaxially,acicular,anther,apart,apex,apically,bark,base,berry,branched,calyx,cell,cm,densely,diameter,distance,dull,elongating,erect,evenly,extending,filament,flattened-reniform,flower,fruit,fruiting,glabrous,green,lateral,leaf,length,less,lobed,long,margin,mature,maturity,mauve,midvein,mm,moderately,occasionally,orange,orange-brown,outline,pale,pedicel,peduncle,petiole,pit,porrect,prickle,prickly,purple,raised,red,rounded,scar,shallowly,shrub,small,smooth,spherical,stellate-pubescent,stem,straight,style,surface,terete,terminal,trichome,unarmed,uniform,upper,way,weakly,wide,yellow,yellow-green,young	-15,-2,-6,-7,.2,.5,0-25,0-4,0.1,0.2-0.3,0.7-,0.7-0.9,0.8-2.2,0.9-1.1,0.9-1.5,1-,1-2,1-30,1.5-,1.7-4,1/,2-2.2,2-2.5,2-4,2.1-2.5,3-4,3-4.5,3-7,4-8,4.5-7,7-8,acuminat,acute,alyx,ame,apar,apparently,articulated,blade,brow,c.,concolorous,connivent,cuneate,curved,deltate,difoliate,discolorous,drying,eaf,eed,elliptic,equal,faint,free,geminat,infructescence,lobe,longer,lower,midpoint,narrow-deltate,nflorescence,obtuse,older,one,open,orolla,oung,pair,pendulous,per,perfec,pericarp,perpendicular,poricidal,portion,prickl,primary,ray,reduced,reflexed,ruit,sessile,shorter,side,slender,sometimes,somewhat,spaced,spreading,stalk,stalked,stellate,tamen,tapering,tertiary,thick-chartaceous,time,tip,tube,unit,variously,vary,vein,venation,visible,woody,ympodial	.2-0.3,abaxial,adaxial,alternate,arrangement,brown,bud,center,colour,corolla,form,growth,height,history,inflorescence,life,na,new,number,ovary,perennial,plant,position,reproduction,seed,shape,spacing,staman,texture,width
129	wfo-0001026717	invalid_json_followup	207	107	65	142	42	0.314	0.6-1.5,1-10,1-2,13-28,15-34,2.5-4.5,2.5-5.5,3-6,3.3-11,5-11,5-13.5,abaxially,acuminate,adaxially,anther,apex,bud,cell,chartaceous,cm,conical,corolla,covering,dark,diameter,elliptic,filament,flower,forked,fruit,glabrous,green,greenish,herb,lanceolate,lateral,leaf,light,margin,medium,membranous,minutely,mm,odd-pinnate,ovoid,pedicel,peduncle,pentagonal,petiole,plant,puberulent,pubescent,purple,rotate,seed,sparsely,stigma,style,terminal,testal,thick,violet,wall,whitish,yellow	0.3-0.6,0.3-2.5,0.3-5,0.8,1-2.5,1-3,1.3-2.5,1.4-2.2,1.8-3,14-22,2.2-5,3-4,3-5,4-6,4-8,4-9,5,5-6,5-merou,5.3-9,7-11,acumen,ag,along,alyx,apart,apparently,articulated,attenuate,axe,axillary,base,berry,blade,borne,brownish,capitat,ciliate,condition,connivent,darker,decreasing,decurrent,digestion,distal,dorsally,drying,eaf,edge,eed,end,enzyme,equal,erec,especially,exceeding,flat,folded,fresh,geminat,generally,glabrou,gradually,green-white,hair,hair-like,half,homostylous,honeycomb-shaped,interjected,larger,leaflet,lengthening,like,living,lobe,long,lower,make,middle,midrib,minute,mottled,mucilaginous,narrow,nflorescence,obtuse,often,one-quarte,orbicular,orolla,ovate,pair,perfect,petiolule,plurifoliate,pore,poricidal,present,pubescen,removed,ripe,round,ruit,secondary,semierect,sessile,seudostipule,singly,size,slightly,slit,spaced,specimen,stamen,ste,stolo,straight,stripe,subequal,subglabrous,subsessile,subtending,symmetrical,tall,tamen,tem,throughout,tip,toward,tri-,tube,tuber,typically,unit,usually,vary,wet,wide,wing,x,ympodial	'',[,\u201chair-like\u201d,``,abaxial,adaxial,arrangement,bark,calyx,capitate,center,characteristic,colour,form,fruiting,growth,height,history,inflorescence,length,life,na,new,number,ovary,perennial,position,prickle,rachi,reproduction,scar,shape,spacing,staman,stem,surface,texture,trichome,value,width,{,}
130	wfo-0001026725	invalid_json_followup	166	107	67	99	40	0.404	.3,.5,0.7-1.2,1-1.2,1-4.5,1-5,1.5,1.6-2,5-6,accrescent,acute,anther,apart,apex,bark,beneath,black,bluish,broadly,calyx,capitate,cm,corolla,cup-shaped,dark,ellipsoid,elliptic,filament,flattened-reniform,fruit,fruiting,glabrous,globose,green,greenish-white,leaf,lobed,margin,minutely,mm,opposite,ovary,ovate,ovoid,pedicel,petiole,pitted,planar,pubescent,reddish-brown,reflexed,rounded,scar,shrub,simple,slender,slightly,stem,stigma,style,surface,tapering,trichome,tuft,uniseriate,white,x	/4,0.2,1-1.5,1.2-1.7,1.5-2,1/2,2,2.2-4,3.5-4,3.6-7.7,5-20-flowered,5-5.5,8-18.6,8-9,anthesi,attenuate,axil,base,becoming,berry,brownish-papillose,character,crackin,deflexed,dia,differing,difoliate,dry,drying,eaf,edicel,eed,evenly,extremely,free,geminat,geographically,glandular-papillose,incrassate,inflorescenc,interpetalar,large,lateral,less,lobe,lon,long,lower,main,major,margine,material,middle,minor,nflorescence,occasionally,often,older,one,onto,open,pair,pale,paler,papillo,papillose,pore,poricidal,portion,prominent,proximal,ruit,scarious,shaped,short,sinus,size,spaced,split,straight,stretching,subshrub,tall,tan,tear-drop,tip,triangular,tube,ud,unit,upper,varying,vein,way,widest,winged,woody,ympodial,young	'',5-20,[,``,abaxial,adaxial,arrangement,bud,cell,center,characteristic,colour,diameter,flower,form,growth,height,history,inflorescence,length,life,na,new,number,peduncle,perennial,plant,position,prickle,rachi,reproduction,seed,shape,spacing,staman,texture,value,width,{,}
131	wfo-0001026733	invalid_json_followup	188	109	62	126	47	0.33	-11,-13,-7,0.5-2,0.5-4,1-7,1.5-14,10-20,2-2.5,2-6,3-7,4-5,5-8,acuminate,apex,articulated,calyx,cell,chartaceous,cm,densely,diameter,eglandular-pilose,ellipsoidal,elliptic-ovate,entire,flattened,flower,forked,fruit,fusiform,glabrate,glandular-,green,greyish,immature,longitudinal,margin,membranaceous,mm,ovate,ovoid,pedicel,peduncle,petiole,pilose,pubescent-pilose,rachi,simple,stellate,stigma,stripe,style,submarginally,tree,truncate,unbranched,villous,white,white-puberulent,yellow,yellowish	-1,-14,-15,-2,-4,-8,.5-3,0.3-0.5,0.3-2,0.5,0.5-1,1,1-1.5,1-2,1-3,1.5-2,1.5-2.5,15-,2-3,2-4,2.5-7.5,20-50,25-40,3-15,3-3.5,3-4-foliat,4,4-23,4.5-5,7-10,8-12,abaxially,acute,acute-acuminate,adaxially,aggregate,apart,ape,axe,basal,base,beyond,blade,capitat,ciliat,color,connective,connivent,cordate,curled,cylindrical,deltate,dense,dia,directed,distally,eaf,eed,eglandular-pubescent,eglandular-villous,equal,especially,exceeding,exserted,glabrous,gland-tipped,glandula,glandular-puberulent,glandular-tomentose,hair,hirsute,lanceolate,leaving,linear-triangular,lobe,lon,long,lower,midrib,moderately,narrowly,near,nflorescence,nther,oblique,orolla,ovum,pedicellar,perfect,pore,present,pubescent,pubescent-pilo,radiu,remnant,ripe,round,ruit,shining,shorter,slightly,small,smooth,sometimes,spaced,sparsely,stamen,stone,swelling,tal,tem,thecae,time,toward,triangular,tube,ud,unit,unknow,unknown,usually,vary,vein,wide,x,ympodial	'',15-50,[,``,abaxial,adaxial,anther,arrangement,bark,bud,capitate,center,characteristic,colour,corolla,filament,form,fruiting,growth,height,history,inflorescence,leaf,length,life,na,new,number,ovary,perennial,plant,position,prickle,reproduction,scar,seed,shape,spacing,staman,stem,surface,texture,trichome,value,width,{,}
132	wfo-0001026734	invalid_json_followup	266	139	95	171	44	0.357	0.3,0.5,1,3,abaxial,abaxially,absent,accrescent,acuminate,adaxial,anther,apex,articulated,barely,base,berry,bright,broadly,brown,calyx,chartaceous,clavate,closely,cm,congested,corolla,cylindrical,cyme,dense,densely,diameter,downward,due,elliptic,entire,flattened,flower,fruit,glabrous,globose,gray,green,growth,held,immature,internodal,irregular,lateral,leaf,length,lobed,long-attenuate,margin,maturity,membranaceous,mm,moderately,new,ovary,ovate,pale,pedicel,peduncle,perfect,petiole,pit,plane,porrect-stellate,pubescent,purple,rachi,reniform,scandent,sessile,shape,shiny,short-stalked,shrub,simple,slightly,spaced,sparsely,stellate,stem,stigma,style,subopposite,surface,trichome,unbranched,vestiture,visible,white,yellow,yellowish	0.1,0.2,0.6,0.7–0.9,0.7–1,0.8–1,1.6–2,1.6–2.5,1.8–2.2,1.8–3,1/4,1–1.2,1–3,2.2–7,2.3–5,2.5–3,2–2.4,2–3,3.2–3.8,3–4,3–4-celled,3–8,4–6,4–7,4–8,4–9,5-merou,5–9,8,acute,adaxiall,adaxially,ag,also,always,alyx,anthesi,apical,apice,archin,ark,associated,asymmetric,axi,becoming,beneat,beneath,blade,branch,branched,caly,camptodromous,capitate,celled,central,commonly,connivent,covered,covering,cuneate,dark,denser,differing,directed,discolorous,distally,dried,drying,eaf,eed,eglandular,emergent,erect,f.,fewer,flat,foliate,forked,found,free,frequently,geminate,glabrescen,glabrescent,glandular,hair,ilament,initially,introrsely,j,lamina,lanceolate,large,less,lobe,long,longer,longitudinal,lower,lying,material,mature,maturit,midpoint,midri,minute,mostly,much,multiseriate,narrow,near,nflorescence,normally,oblong,obovate,observed,obtuse,often,old,older,one,one-celled,opening,orolla,other,oung,pair,paired,papillose,pointing,pore,poricidal,porrect,portion,pubescence,purplish,raised,rarely,ray,rayed,reaching,rounded,ruit,secondary,shorter,size,slit,smaller,sometimes,sparse,spread,spreading,stalk,still,subsessile,surfac,terminal,tube,tuft,ud,unequal,uniseriate,unit,upward,vary,vein,venation,whole,wide,ympodial,¾	'',0.8-1,1-1.2,1.6-2,1.8-3,2.3-5,2.5-3,3-8,3/4,5-9,5-merous,[,``,arching,arrangement,bark,bud,cell,center,characteristic,colour,filament,form,fruiting,height,history,inflorescence,life,na,number,perennial,plant,position,prickle,reproduction,scar,seed,spacing,staman,texture,value,width,{,}
133	wfo-0001026739	success	197	101	75	122	26	0.381	0.25-0.94,0.4-5,1-10,1-2,10-60,16-54,2.5-13.5,2.6-4.8,3.2-17.5,4-8,6-13,abaxially,acumen,adaxially,anther,apex,attenuate,brownish,cell,clavate,cm,coriaceous,corolla,covering,dark,densely,diameter,drying,filament,flower,forked,fruit,glabrous,globose,green,greenish,hair,hair-like,herb,lateral,leaf,light,margin,mm,moniliform,oblanceolate,odd-pinnate,ovate,ovoid,pedicel,peduncle,pentagonal,petal,petiole,plant,pubescent,purple,rotate,rounded,seed,sessile,sometimes,stigma,stripe,style,sub-glabrous,terminal,testal,thick,tuber,wall,white,whitish,yellow,yellowish	0-0.34,0-38,0.5-1.2,1-3,1.2-2.1,1.4-3.5,2-4,2-5.3,2-6,2-9,2.7-6.9,3-4,3.8-8.5,5-merou,5.6-13.1,6.6-18,7-9,abaxiall,acuminate,acute,ag,along,alyx,apart,apparently,arranged,articulated,asymmetric,axe,axillary,base,basiscopic,bead,berry,blade,brown,bud,capitat,condition,connivent,decreasing,digestion,distal,dorsally,eaf,edge,eed,enzyme,erec,exceeding,flat,folded,fresh,geminat,generally,glabrou,green-white,hal,half,high,homostylous,honeycomb-shaped,interjected,lanceolate,larger,leaflet,lengthening,like,linear,living,lobe,long,lower,make,mucilaginous,multiple,necklace,nflorescence,orbicular,orolla,pair,perfect,plurifoliate,pore,poricidal,removed,rest,ripe,ruit,seudostipule,short,side,simple,size,slit,spaced,specimen,stamen,stem,stolon,straight,subequal,subtending,tall,tamen,tem,throughout,tip,tissue,toward,tri-,tube,typically,unit,usually,vary,wet,wide,wing,winged,x,ympodial	abaxial,adaxial,arrangement,capitate,colour,form,growth,height,history,inflorescence,length,life,na,number,ovary,perennial,position,pseudostipule,rachi,reproduction,shape,spacing,staman,surface,texture,width
134	wfo-0001026740	invalid_json_followup	171	103	59	112	44	0.345	1-10,1-12,1-5,10-20,10-30,2-3,2.5-27,2.5-6,3-15,5-8,6-10,acuminate,acute,apex,branched,calyx,cell,cm,curled,densely,diameter,eglandular,ellipsoidal,elliptic,entire,flattened,flower,fruit,glabrous,greenish,hair,margin,mm,moderately,ovate,ovoid,pedicel,peduncle,petiole,pilose,puberulent,pubescent,purple,rachi,reticulate,scar,simple,sparsely,stellate,stigma,style,tomentose,tree,truncate,unbranched,violet,white-puberulent,whitish,yellow	-17,-2,0-10,0.5-1,1-2,1-3,1-4,2-4,2.5-3,2.5-4.5,20-50,3-3.5,3-5,3-foliat,3.5-40,4-5,4.5-10,5-40,8-19,abaxially,absen,absent,acute-acuminate,adaxially,aggregate,also,apart,ape,apiculate,articulated,axe,basal,base,beyond,blade,browni,ciliate,connective,connivent,cordate,corky,cylindrical,darker,deltate,directed,distally,eaf,eed,equal,especially,exceeding,exserted,fleshy,glabrate,glandular-puberulent,immature,lanceolate,leaving,lobe,lon,long,lower,mature,narrowly,near,nearly,nflorescence,nther,oblong,obtuse,often,orange,orolla,pedicellar,perfect,pilo,pore,present,radiu,rarely,remnant,ruit,sessile,shorter,slightly,small,sometimes,spaced,stamen,stone,stripe,subcoriaceous,swelling,tal,tems,thecae,time,toward,triangular,truncat,tube,ud,unit,unlobed,vary,vein,villous,wide,woody,x,ympodial,young	'',[,``,abaxial,adaxial,anther,arrangement,bark,bud,center,characteristic,colour,corolla,filament,form,fruiting,growth,height,history,inflorescence,leaf,length,life,na,new,number,ovary,perennial,plant,position,prickle,reproduction,seed,shape,spacing,staman,stem,surface,texture,trichome,value,width,{,}
135	wfo-0001026752	invalid_json_followup	169	121	75	94	46	0.444	-25,-50,1-12,1-5,1-6,1.5-12,10-20,15-35,2-2.5,3-18,3-4,4-5,abaxially,abruptly,adaxially,also,apart,apex,articulated,base,black,branched,calyx,campanulate,cm,coriaceous,darker,densely,diameter,ellipsoidal,elliptic-oblong,elliptic-ovate,entire,flattened,fleshy,flower,forked,fruit,glabrous,globose,green,greenish-brown,immature,margin,mm,moderately,near,nearly,ovoid,papillose,pedicel,peduncle,petiole,pilose,possibly,pubescent,pubescent-pilose,purplish,rachi,rarely,ripe,short-acuminate,simple,stellate,stigma,stripe,style,tree,truncate,unbranched,vein,violet,white,whitish,yellow	-3,-4,0-,1,1-1.5,1-2,1-3,1.5-2,1.5-2.5,2,2-3,2-4,2.5-20,2.5-5,20-30,3,3-5,3-foliat,3.5-4,4-45,7-15,8-16,absent,acute,aggregate,ape,apiculate,axe,basal,beyond,blade,capitat,cell,chartaceous,connective,connivent,cordate,cuneate,cylindrical,deltate,dilated,directed,distally,eaf,eed,equal,exceeding,exserted,finely,hair,lanceolate,laterally,leaving,less,lobe,lon,long,lower,narrowly,nflorescence,nther,obtuse,orolla,pedicellar,perfect,pilo,pore,presence,present,radiu,rather,remnant,ruit,slightly,small,somewhat,spaced,stamen,stone,tal,tem,thecae,time,tomento,triangular,tube,ud,unit,unknow,vary,wide,x,yello,ympodial	'',[,``,abaxial,adaxial,anther,arrangement,bark,bud,capitate,center,characteristic,colour,corolla,filament,form,fruiting,growth,height,history,inflorescence,leaf,length,life,na,new,number,ovary,perennial,plant,position,prickle,reproduction,scar,seed,shape,spacing,staman,stem,surface,texture,trichome,value,width,{,}
136	wfo-0001026754	invalid_json_followup	176	124	87	89	37	0.494	-6+,0.5,0.5-1,0.9-1.1,1,1-,1.5-3,1/2,10,2,2-2.5,2-3,2/3,30+,5,5-lobed,9,abaxially,acute,along,anther,anthesi,apex,base,berry,broadly,calyx,clavate,cm,conical,corolla,deeply,dendritic,densely,diameter,ellipsoid,elliptic,entire,filament,flower,glabrous,globose,growth,inflorescence,irregularly,lamina,later,lateral,leaf,lobed,long,margin,membranous,minute,minutely,mm,mostly,narrowly,new,pedicel,peduncle,petiole,pubescent,scandent,scar,simple,slender,spaced,sparsely,spreading,stellate-rotate,stem,stigma,style,surface,terminal,transparent,trichome,uniseriate,vein,vine,way,white,woody,x,yellow,yellowish	.5,198.,2-4,2.5-3.5,3-4-celled,4-5,5-merou,5.5-9,7-9,9-11,adaxially,ag,alyx,apar,apparently,ark,articulated,asymmetric,axi,basal,branched,brow,cabrera,complete,connivent,cucullat,denser,distal,divided,eaf,ed,especially,exerted,extending,fide,free,half,halfway,ilament,leaving,lengthening,like,lobe,loosely,lower,many,mature,midvein,mixture,nflorescence,oblique,older,orolla,outline,pair,papillo,peg,perfect,pinnate,planar,plurifoliat,pore,poricidal,portion,primary,puberulent,ruit,seen,sleeve,slit,small,sometimes,splitting,tangled,tem,time,tip,truncate,tub,tube,twinin,twining,ud,unit,upper,vary,weak,within,ympodial	'',5-merous,[,``,abaxial,adaxial,apart,arrangement,bark,brown,bud,characteristic,colour,form,fruit,fruiting,height,history,length,life,na,number,ovary,plant,position,prickle,rachi,reproduction,seed,shape,spacing,staman,texture,value,width,{,}
137	wfo-0001026756	success	147	98	69	78	29	0.469	.25,0-7-1.2,0.5-1,0.5-3,1-1.5,1.5-10,1.5-2,1.8-3,3-4,5-10,abaxial,acute,along,anther,apex,bark,base,bilobed,broadly,brown,calyx,closely,cm,conical,corolla,dark,dendritic,densely,difoliate,elliptic,erect,filament,fruiting,glabrous,globose,green,hard,lax,leaf,lobed,minutely,mm,nearly,opposite,ovary,ovate,ovoid-reniform,pale,pedicel,petiole,pinkish-white,pitted,pubescent,shape,shrub,simple,spaced,sparsely,stem,stigma,style,surface,thick,tree,trichome,unifoliate,vein,white,woody	.5,0.25-0.5,1-2,1.5-1.7,1.5-3,3.5-8.5,5-10-flowered,5-5.5,6-10,6-16,abaxially,adaxially,anthesi,apiculate,attenuate,ba,berry,corresponding,deflexed,deltate,denser,dia,differing,distal,eaf,edicel,eed,exserted,fleshy,free,geminat,glabrescent,grayish-brow,inflorescenc,irregular,lamina,lateral,like,lobe,long,lower,main,major,middle,minor,nflorescence,occasionally,older,overlappin,pair,papillo,perhaps,pericarp,planar,pore,poricidal,portion,present,pubescence,rest,ruit,scar,shaped,somewhat,soon,strongly,tall,tear-drop,tip,tub,tube,ud,uniseriate,unit,wide,widest,ympodial,young	adaxial,arrangement,bud,colour,diameter,flower,form,fruit,geminate,grayish-brown,growth,height,history,inflorescence,length,life,na,number,overlapping,peduncle,plant,position,rachi,reproduction,seed,spacing,staman,texture,width
138	wfo-0001026777	invalid_json_followup	168	107	69	99	38	0.411	.5,0.25-0.5,0.5-1.5,0.5-5,1-1.3,1-1.5,1-10,1-4,1.2-1.8,3-3.5,5-7,acuminate,acute,anther,apart,apex,base,beneath,blue,brown,calyx,capitate,cm,corolla,cup,deflexed,elliptic,fide,filament,filiform,flattened,flattened-reniform,flexuous,fruiting,glabrous,globose,green,growth,irregularly,leaf,lobed,long,margin,mm,narrowly,nearly,new,opposite,ovary,pedicel,petiole,pubescent,russet,scar,seed,shaped,shiny,shrub,smooth,sparsely,stem,stigma,style,surface,trichome,tuft,uniseriate,vellozo,white	.25,/3,0.5-1,0.9-3,1-2,1.5-3,1.5-5,2-4,2-4.5,2-5,4-8,5-14,5-50-flowered,anthesi,apiculate,axil,ba,beginning,berry,body,branching,campanulate,cell,decurrent,dense,dia,differing,difoliate,distal,eaf,edicel,eed,end,exserted,free,geminat,glabrate,greyi,hyaline,incrassate,inflorescenc,lateral,like,lobe,lon,lower,main,major,matted,middle,minor,minutely,near,nflorescence,occasionally,often,older,one,onto,outline,overtopping,pair,papillo,papillose,pitted,planar,pore,poricidal,portion,prominent,quadrate-deltoid,quite,rest,ruit,sinuate,size,slightly,somewhat,soon,spaced,straight,tall,tapering,tear-drop,testa,thread-like,tip,tube,ud,unit,vein,wall,way,widest,woody,x,yellowish,ympodial,young	'',5-50,[,``,abaxial,adaxial,arrangement,bark,bud,center,characteristic,colour,diameter,flower,form,fruit,height,history,inflorescence,length,life,na,number,peduncle,perennial,plant,position,prickle,rachi,reproduction,shape,spacing,staman,texture,value,width,{,}
139	wfo-0001026782	invalid_json_followup	206	132	89	117	43	0.432	-10,-4,0.5-1,0.5-2,0–1,0–10,1,1-1.5,1.3,1.5,10–15,15,2-5,2–4,7,8-10,abaxially,accrescent,acicular,acute,adaxially,annual,anther,anthesi,apex,base,blue,bluish,brown,calyx,cm,dark,darker,diameter,enclosing,filament,finely,flower,fruit,fruiting,glabrous,globose,green,greenish,herb,immature,irregularly,length,light,like,lilac,margin,maturity,mm,mottling,much-branched,obtuse,ovate,pair,partially,pedicel,peduncle,petiole,porrect-stellate,prickle,pubescence,purple,pustulate,rachi,reniform,rotate-campanulate,simple,somewhat,spreading,stellate-tomentose,stem,stigma,straight,style,surface,tomentose,unbranched,white,woody,x,yellow,yellowish-brown,–5,–6	-5,0.5,1.4–2,1.5–2.5,1.8–3,1/3–1/2,1–3,1–5,2,2-foliate,3,3-4,3.5–8.5,3–12,4,4–10-rayed,4–13,4–6-rayed,4–9,5,6,6-7,abundant,abundantly,adaxiall,additional,apiculate,armed,articulate,axe,becoming,berr,blade,clavat,clustered,coarse,commonly,cordate,curved,dehiscent,deltoid,densely,dilated,divided,eaf,eed,exceeding,except,fertile,geminat,glabrou,gland-tipped,gradually,hair,internode,interpetalar,larger,lobe,lon,long,lower,lowermost,main,male,midpoint,midrib,minute,much,narrowly,nearly,nflorescence,numerous,often,one,orolla,perfect,pore,pubescent,radiu,rarely,ray,ruit,sessile,shallow,short,shorter,slightly,small,smaller,sparsely,stalk,staminate,ste,stellae,stellate,stellate-pubescent,stipitate,strongly,tall,tamen,tapered,tem,terminal,thick-stalked,thin-textured,tip,tissue,tooth,triangular,tube,two,upper,upward,vary,vein,way,ympodia	'',1-3,1-5,[,``,abaxial,adaxial,arrangement,bark,berry,bud,cell,center,characteristic,clavate,colour,corolla,form,growth,height,history,inflorescence,leaf,life,lobed,na,new,number,ovary,plant,position,reproduction,scar,seed,shape,spacing,staman,texture,trichome,value,width,{,}
140	wfo-0001026788	success	291	129	92	199	37	0.316	.0,0.6–1.9,1.0–1.5,1.2–1.6,1.2–1.7,1.3–1.8,1.7–1.9,1/3,2.0,3,3.8,3.8–4.9,4,4.0,6.4,7.8–11.0,alveolate,anther,apart,attachment,bark,branching,broadly,brown,bud,calyx,chartaceous,cm,corolla,densely,developed,diameter,dry,entire,erect,extra-axillary,filament,flattened-orbicular,flattened-reniform,flower,fruit,glabrous,globose,homostylous,internode,interpetalar,lanceolate,lateral,leaf,long,margin,mature,mm,moderately,notched,orange,oval,ovate,pedicel,peduncle,petiole,point,prickle,pubescent,reddish,scandent,scarcely,shrub,sinuate,slightly,small,spaced,sparsely,stellate,stellate-pubescent,stem,stigma,style,subcoriaceous,surface,time,tissue,tree,triangular,unbranched,upper,well,white,yellow,yellow-ferruginous,yellow-tan,×	.04,.05,.3,/3,0.2–0.3,0.3–0.4,0.3–0.5,0.4–0.6,0.4–0.7,0.5–0.7,0.5–0.8,0.6–1.0,0.6–1.3,0.8–1.1,0.8–1.8,0.9–1.2,0.9–1.3,0.9–2.0,0–,1.0–2.0,1.1–1.3,1.3–1.6,1.3–2.5,1.4–2.2,1.5–1.9,1.5–2.2,1.7,1/4–1/3,10.8,1–3,2.1–2.9,2.5–11.0,2.7–5.7,2.8–3.1,2.9–4.0,2/3,2/3s,2–3,3.0,3.4,4.6–6.0,4–7,4–8,5,5-merou,7.0–8.9,8,8.3–10.9,8.5,90°,abaxially,absent,acuminate,acute,adaxially,adjacent,adnate,aequilateral,ag,alyx,anthesi,apex,apical,apparently,appearing,appressed,around,articulate,attenuate,axe,ba,basal,base,based,becoming,berry,blade,branch,broad,broad-based,brochidodromous,capitat,channeled,clinate,connivent,curved,deciduous,deflexed,deltoid,dentate,development,difoliate,directed,distal,distally,distinct,distinctly,eaf,edge,eed,either,emerging,evenly,exocarp,extending,fertile,filiform,flat,flexed,free,geminat,glandular,glossy,gradually,hair,hort,increasing,incurved,intact,intersepalar,juic,layer,laying,less,lobe,lobed,lon,longer,lower,many,markedly,midpoint,midrib,midvein,minute,nearly,nflorescence,oblique,occasionally,opaque,orolla,per,perforated,pore,porrect,porrect-stellate,portion,potentially,presen,primary,proximal,raised,ray,reflexe,remaining,restricted,retrorse,rigid,rounded,row,ruit,scattered,sessile,shoot,side,sigmoid,simple,sinus,sloughing,smoot,sometimes,somewhat,soon,splitting,spread,stamen,stellae,straight,suture,swelling,tamen,tem,thin,transparent,tube,two,ud,unarmed,vary,vein,weakly,wide,yellow-ferruginou,ympodia,young,±90°,±dense,±equal,±glabrous	0–2.5–11.0,5-merous,abaxial,adaxial,alternate,arrangement,capitate,cell,center,colour,dioecious,form,fruiting,green,greyish,growth,height,hirsute,history,inflorescence,length,life,na,new,ovary,perennial,plant,position,reproduction,scar,seed,shape,spacing,staman,texture,trichome,width
141	wfo-0001026790	invalid_json_followup	236	131	97	139	34	0.411	-11,-3,-4,0-10,0-5,0.2-0.4,0.2-1.5,0.2-2,0.5-4,0.7-3,1,1-1.5,1/4,1/4-1/2,2-11,2-3,2-7,2.5-4.5,6.5-9,7-20,abaxially,acute,andromonoecious,anther,apart,apex,bark,base,berry,branched,brown-green,calyx,cm,conical,cream,curved,dark,deltate,densely,diameter,dull,elliptic,erect,filament,flattened,flattened-reniform,flower,fruit,fruiting,glabrous,green,green-brown,lanceolate,lateral,leaf,length,lobed,margin,marking,maturity,mauve,mm,moderately,narrow-deltate,near,orange-brown,ovate,pale,pedicel,peduncle,petiole,plant,porrect,prickle,red-brown,rounded,scar,sessile,shrub,sometimes,sparsely,spherical,stalked,stellate,stellate-pubescent,stem,straight,style,surface,terete,terminal,trichome,upper,way,yellow,yellow-green,young	-1/2,-1/3,-10,-19,-2,-40,-6,-merous,0,0-150,0-20,0-30,0.2,0.2-0.6,0.5-2,0.6-10,0.7-1.5,0.8,1-2,1-3,1.5,1.5-2.5,1.5-3,1.5-4,1.5-5,1.8-4,1.9-2.6,1/2-3/,1/5-1/3,1/6-1/4,2,2-,2-30,2-5,2.7-3.2,3.5-17,4-,4-11,4-7,4-9,5,5-10,5-9,6-12,6-8,7-12,7-13,7-15,acuminat,adaxially,alyx,ame,apar,apically,apparently,articulated,becoming,blade,broad-deltate,c.,chartaceous,concolorous,connivent,cordate,discolorous,distance,drying,eaf,eed,elongated,elongating,entire,equal,extending,free,gently,glandular,hair,heterostylous,inflorescenc,infructescence,lobe,long,long-styled,longer,lower,mature,midpoint,midvein,minute,nflorescence,obtuse,older,one,open,orolla,oung,pair,pendulous,per,pericarp,plurifoliat,poricidal,portion,prickly,primary,ray,red-brow,reduced,reflexed,ruit,short-styled,side,simple,smooth,spaced,spreading,stalk,stout,tamen,tapering,tertiary,time,tip,toward,tube,unarme,unarmed,unit,usually,variously,vary,vein,venation,visible,weakly,wide,woody,ympodial	'',[,``,abaxial,adaxial,arrangement,bud,center,characteristic,colour,corolla,form,growth,height,history,inflorescence,life,na,new,ovary,perennial,plurifoliate,position,reproduction,seed,shape,spacing,staman,stigma,texture,value,width,{,}
142	wfo-0001026818	invalid_json_followup	252	126	91	161	35	0.361	-15,-3,-4.5,0-1,0-1.5,0.3-2.5,0.5-1,0.5-2.5,0.7-2,1.8-3.5,2.5-4,5-12,5-15,5-20,6.5-9.5,7-15,8-11,abaxially,adaxially,anther,apart,apex,articulated,base,branched,broadly,calyx,campanulate,closely,cm,coarsely,densely,dentate,diameter,elliptic,elliptic-ovate,erect,extra-axillary,felty-pubescent,filament,flower,fruit,fruiting,glabrous,globose,hair,inflorescence,leaf-opposed,length,lenticular,like,long,margin,minutely,mm,orange,orange-red,outline,pedicel,peduncle,perennial,perfect,petiole,pitted,prickle,pubescent,rachi,reniform-ovate,ripe,sessile,simple,spaced,spreading-hirsute,spreadingly,stellae,stellate,stellate-pubescent,stem,stigma,style,surface,tan,thickened,thin-textured,trichome,truncate,unbranched,variable,white,x,yellow	-1.5,-2,-2.5,-7,0.1-0.3,0.3-0.8,0.3-1,0.5-1.5,1,1-4,1.5-,1/3,2,2-15,2-3,2-4,2-4.5,2-foliate,2.5-5,2.7-4,3-5,4-10,4-6,4-7,5-11,5-9,6-10,7-30,7-50,8-15,abrupt,abundant,accrescent,acute,acute-,adaxiall,along,always,apparent,ascending,attenuate,average,axe,ba,becoming,blade,broad-based,capitat,capitate-glandular,cast,cauline,class,commonly,compresse,connivent,cordate,covering,cream,cylindrical,deltoid,density,depressed-deltoid,directed,distal,distall,distinct,eaf,eed,elongate,entire,equaling,especially,essentially,female-sterile,foliar,frui,geminate,grading,inserted,interlobal,lanceolate,large-leaved,larger,largest,lateral,laterally,less,lignescent,lobe,longest,lower,major,maturit,mesocarp,middle,midpoint,midrib,mixture,mostly,multiseriate,nearly,nflorescence,numerous,oblique,obtuse,obtuse-,occasionally,often,one,orolla,oung,ovate,ovate-lanceolate,per,persistent,pore,prickly,principal,prominent,pubescence,purplish,radiu,ray,round-tipped,ruit,scattered,shallowly,short,shorter,side,similar,sinus,size,smaller,sometimes,somewhat,sparse,sparsely,spreading,stalk,stalked,ste,stipitate,tal,tamen,termination,time,tooth-like,transition,tube,two,unarmed,unit,usually,vary,vein,vivo,weakly,wide,yellowish,ympodial	'',[,``,abaxial,adaxial,arrangement,bark,bud,capitate,characteristic,colour,corolla,form,growth,height,history,leaf,life,na,new,number,ovary,plant,position,reproduction,scar,seed,shape,spacing,staman,texture,value,width,{,}
143	wfo-0001026819	invalid_json_followup	218	140	100	118	40	0.459	0.5-1.5,1-10,1-2,1.5-10,2.5-5,3-120,3-18,3-20,4-7,5-30,6-11,abaxially,adaxially,along,anther,apex,articulated,blue,broadly,brownish,bud,capitate,cell,chartaceous,ciliate,cm,condition,corolla,covering,dark,densely,diameter,distal,dot,drying,elliptic,especially,filament,flower,forked,fresh,fruit,glabrous,glaucous,globose,green,green-white,greenish,hair,herb,lanceolate,lateral,light,like,make,margin,membranous,middle,midvein,minutely,mm,moderately,mucilaginous,narrowly,odd-pinnate,ovate,ovoid,pedicel,peduncle,pentagonal,petiole,plant,puberulent,pubescent,purple,rachi,rotate-pentagonal,scattered,seed,slightly,sometimes,somewhat,stem,stigma,stripe,style,subglabrous,terminal,testal,thick,throughout,tinged,tip,usually,violet,wall,wet,white,whitish,yellow	0-27,0.3-4.7,1-2.3,1-5,1.2-36,1.5-12,1.5-3.0,1.5-3.3,1.5-3.5,1.6-3.5,10,10-26,2-5,2-6,3-35,3-38,4,4-10,5-merou,7,absent,acumen,acuminate,acute,ag,alyx,apart,ascending,attenuate,base,bearing,blade,borne,clavat,connate,connivent,cuneate,curved,decurrent,digestion,dorsally,eaf,edge,eed,end,enzyme,erec,exceeding,flat,folded,geminat,generally,glabrou,greatly,greenish-yellow,hair-like,half,homostylous,honeycomb-shaped,interjected,larger,leaflet,lengthening,living,lobe,long,lower,lunate,mottled,nflorescence,non-glandular,oblique,often,orolla,pair,pedice,petiolule,plurifoliate,pore,poricidal,ranging,removed,ruit,scale-like,seudostipule,short,singly,slit,spaced,specimen,stamen,star,ste,stolo,straight,subequal,suborbicular,subrosette,subtending,symmetrical,tall,tamen,tem,tertiary,therefore,tri-,truncate,tube,tuber,typically,unit,unwinged,vary,wide,wing,within,without,ympodial	'',[,\u201chair-like\u201d,``,abaxial,adaxial,arrangement,bark,calyx,characteristic,clavate,colour,form,fruiting,growth,height,history,inflorescence,leaf,length,life,na,new,number,ovary,perennial,position,prickle,reproduction,scar,shape,spacing,staman,surface,texture,trichome,value,width,{,}
144	wfo-0001026821	invalid_json_followup	204	124	79	125	45	0.387	.2,0.3-1.2,0.3-2.5,0.4-1.5,0.7-1.8,0.8-1,1-1.5,1-20,1-5,10-15,2-3.5,2.5-18,3-branched,4-4.5,5-10,5-12,5-20,abaxially,adaxial,adaxially,anther,apart,apex,appressed,auriculate,broadly,brown,chartaceous,cm,dark,diameter,due,ellipsoidal,elliptic,filament,flattened,flower,forked,fruit,gglobose,glabrous,green,herb,lanceolate,lateral,leaf-opposed,length,light,margin,mature,mm,obliquely,odd-pinnate,pale,pedicel,peduncle,petiole,pilose,pubescent,rachi,rarely,remnant,reniform,slender,small,sparsely,stellate,stigma,stripe,style,subglabrous,substellate,surface,thickening,unbranched,wall,white,x,yellow	/3,0-20,0.2-1.5,0.5-1.2,0.5-3.5,1-2,1-3,1.2-1.5,1.5-2.5,17,1977,2-15,2-6,2-celled,3-11,3-18,3-6,3-7,3-celled,5-34,5-merou,acuminate,acut,ag,alyx,anderson,angular,apical,apically,apiculate,articulated,axe,ba,basal,base,bayonet,berry,blade,bract,cell,ciliat,cordate,cuneate,deltate,directed,distal,distally,eaf,eed,equal,especially,exceeding,frequent,fused,geminat,glabrou,gland-tipped,greatly,hair,homostylous,incurved,interjected,interstaminal,large,leaflet,lobe,long,long-attenuate,longitudinal,lower,lowermost,many,mean,membrane,membranous,minute,minutely,moderately,much,narrowly,nflorescence,oblique,oblong,obtuse,occasional,occasionally,one-celled,opening,orolla,pair,paired,per,perfect,petiolule,plurifoliate,pore,present,pseudostipular,puberulent,pubescen,reduced,rounded,ruit,scandent,seudostipule,short,slightly,slit,smaller,somewhat,spaced,stamen,subtended,tamen,tem,terminal,time,tri-,truncat,tube,unit,vary,wide,winged,ympodial	'',10-20,[,\u201cpuberulent\u201d,``,abaxial,acute,arrangement,bark,bud,calyx,characteristic,colour,corolla,form,fruiting,growth,height,history,inflorescence,leaf,life,na,new,number,ovary,perennial,plant,position,prickle,pseudostipule,reproduction,scar,seed,shape,spacing,staman,stem,texture,trichome,truncate,value,width,{,}
145	wfo-0001026827	invalid_json_followup	143	114	79	64	35	0.552	/3,0.2-0.5,0.4-0.6,0.5-2,0.6-1,1-1.1,1-1.5,1-2,1.3-1.6,1.5-2,2-2.2,2-4,5-6,abaxially,and/or,anther,anthesi,apart,apex,arachnoid,bark,base,branched,calyx,clavate,cm,conical,corolla,dendritic,dense,densely,diameter,distally,ellipsoid,erect,especially,filament,flower,glabrescent,glabrous,growth,inflorescence,internodal,lanceolate,leaf,less,like,lobed,margin,mm,narrowly,new,nodding,oblanceolate,ovary,papillate,pedicel,peduncle,petiole,plane,pubescent,rachi,reddish,revolute,scar,shrub,simple,sinus,sparsely,stem,stigma,stout,style,surface,trichome,uniseriate,way,white,x	.5,1-,1-2.1,2-2.5,3-9,7-9,?,acute,adaxiall,age,appearing,attenuate,branch,broadly,crowded,deciduou,deltate,dry,drying,eaf,exerted,fleshy,free,irregularly,know,known,lamina,lengthening,lobe,lower,minutely,near,nflorescence,ot,pair,paler,papillat,perfect,planar,plurifoliat,pore,poricidal,portion,primary,slender,slit,small,soon,straight,strongly,surfac,terminal,thick,thickened,third,tip,tub,tube,ud,unit,upper,vein,widest,ympodial	'',[,``,abaxial,adaxial,adaxially,arrangement,bud,center,characteristic,colour,form,fruit,fruiting,height,history,length,life,na,number,perennial,plant,position,prickle,reproduction,seed,shape,spacing,staman,texture,unknown,value,width,{,}
146	wfo-0001026830	success	198	100	74	124	26	0.374	0.3-1.3,0.4-1,0.5-1.0,1-10,1-11,1-2,10-57,2.5-5,4-7,4.5-17.5,6-13,7-18,abaxially,adaxially,anther,apex,brownish,cell,clavate,cm,condition,coriaceous,corolla,covering,deep,diameter,drying,elliptic,filament,finely,flower,forked,fresh,fruit,glabrescent,glabrous,globose,green,greenish,hair-like,herb,lateral,leaf,light,medium,mm,moderately,moniliform,odd-pinnate,ovate,ovoid,pedicel,peduncle,pentagonal,petiole,plant,puberulent,pubescent,purple,rotate,seed,stigma,stripe,style,subglabrous,terminal,testal,thick,tuber,wall,white,whitish,yellow,yellowish	0-10,0.5-1.2,0.9-1.9,1.1-2.7,1.4-4,1.5-4,2-4,2-6,2.5-4.4,2.7-8,3.5-8.5,4-10,4-14.5,4.4-14.5,5-11,5-merou,acumen,acuminate,acute,adaxiall,ag,along,alyx,apart,apparently,arranged,articulated,asymmetric,attenuate,axe,axillary,base,basiscopic,bead,berry,blade,brown,bud,capitat,ciliate,connivent,decreasing,digestion,distal,dorsally,eaf,edge,eed,enzyme,erec,exceeding,flat,folded,geminat,generally,glabrou,green-white,hair,hal,half,high,homostylous,honeycomb,interjected,lanceolate,leaflet,lengthening,like,linear,living,lobe,long,lower,make,margin,mucilaginous,multiple,necklace,nflorescence,orbicular,orolla,pair,perfect,petiolulate,plurifoliate,pore,poricidal,removed,ripe,rounded,ruit,sessile,seudostipule,shaped,short,side,simple,size,slit,spaced,specimen,stamen,stolon,straight,subequal,subglabrou,subtending,tall,tamen,tem,throughout,tip,tissue,toward,tri-,tube,typically,unit,unwinged,usually,vary,wet,x,ympodial	abaxial,adaxial,arrangement,capitate,colour,form,growth,height,history,inflorescence,length,life,na,number,ovary,perennial,position,pseudostipule,rachi,reproduction,shape,spacing,staman,surface,texture,width
147	wfo-0001026831	invalid_json_followup	207	130	94	113	36	0.454	-5,.5,0-6,0.1,0.2-0.4,0.2-1,0.3-0.65,0.5-1.2,0.6,1-2,1-2.2,1-2.5,1-4,1-6,1/3,3-5,3-6,5-merous,abaxially,acute,anther,apex,apparently,articulated,bark,base,berry,bright,calyx,cell,chartaceous,cm,cream,curved,dark,densely,diameter,dull,elliptic,erect,filament,flattened-reniform,flower,fruit,fruiting,glabrescent,glabrous,gray-brown,green,lateral,leaf,length,less,lobed,margin,marking,maturity,mauve,membranous,mm,moderately,orange,orange-brown,outline,pale,pedicel,peduncle,petiole,porrect,prickle,raised,red-brown,rounded,scandent,scar,shiny,shrub,smooth,sometimes,sparsely,spherical,stellate-pubescent,stem,style,subsessile,surface,terete,trichome,upper,white,white-gray,yellow,yellow-green,young	-0.25,-6.5,-9,/4,0-10,0-20,0-3,0.1-0.2,0.1-0.25,0.15-0.25,0.3-0.6,0.6-2,0.65-1,0.7-1.1,0.7-2,1-10,1-3,1.2-2,1.5-2.5,1/3-1/,1/3-2/3,1/5-1/4,2-2.5,2-3,2-4,2.3-2.9,2.5-4.5,3.5-10,7-10,7-8,alyx,apar,apart,apically,attenuate,blade,branched,broad-deltate,brow,caudat,concolorous,connivent,deltate,difoliate,distance,drying,eaf,eed,elongating,equal,extending,eye,free,fully,geminat,herbaceous,infructescence,lobe,long,longer,lower,mature,midpoint,midvein,multangulate,naked,narrow-cuneate,nflorescence,oblong,occasionally,older,one,open,opening,orolla,oung,ovate,pair,pendulous,per,perfec,pericarp,poricidal,portion,prickl,prickly,primary,ray,reduced,ruit,sessile,shorter,side,slender,spaced,spreading,stalk,stellate,tamen,tapering,tertiary,time,tip,tube,unit,usually,vary,vein,venation,visible,way,wide,ympodial	'',[,``,abaxial,adaxial,arrangement,brown,bud,center,characteristic,colour,corolla,form,growth,height,history,inflorescence,life,new,number,ovary,perennial,perfect,plant,reproduction,seed,shape,spacing,staman,stigma,texture,unknown,value,width,{,}
148	wfo-0001026841	success	139	91	55	84	36	0.396	0.25-0.3,0.5-1,0.5-2,0.75-1,0.8-1,0.8-3,1.5,1.5-2,3.5-5,4-8,6-8,acute,anther,apart,apex,bark,bi-lobed,broadly,calyx,clavate,cm,conical,corolla,curly-tipped,elliptic,filament,filiform,fruiting,glabrous,globose,green,inflorescence,leaf,lobed,margin,minutely,mm,opposite,ovary,papillose,pedicel,petiole,pubescent,scar,shining,shrub,simple,sparsely,stem,stigma,style,trichome,uniseriate,white,x	.25,.5,/4,0.05,0.25-0.5,0.5-0.75,0.6-1,2-2.5,3-6.5,5-8-flowered,7-9,9.2-18,along,anthesi,arch,axi,ba,base,beneath,berry,coroll,decurrent,deflexed,deltoid,dia,eaf,edicel,eed,ellipsoid,exsertion,free,glabrate,greyish-gree,hyaline,immature,joined,known,later,lateral,like,lobe,lon,long,lower,main,middle,nflorescence,older,pair,paler,papillo,pore,poricidal,portion,prominent,raised,reddish,reflexed,rest,ruit,series,shaped,slender,slightly,spaced,straight,tall,tapering,tear-drop,terminal,thickened,tip,tube,ud,unevenly,unifoliat,unit,vein,way,widest,winged,woody,ympodial,young	0.5,5-8,abaxial,adaxial,arrangement,bud,cell,center,colour,diameter,flower,form,fruit,greyish-green,growth,height,history,length,life,na,new,number,peduncle,perennial,plant,position,rachi,reproduction,seed,shape,spacing,staman,surface,texture,unifoliate,width
149	wfo-0001026849	success	180	123	99	81	24	0.55	0-10,0.5-1,1,1-1.5,1-2,1.5-2.5,11,2-3,38/2,5,5-10,637/2,7-8,acute,adult,anther,apex,aspect,aster,axil,base,brown,calyx,capitate,cell,cm,colour,conical,corolla,cyme,developed,discoidal,distinctly,ellipsoid,entire,erect,expanded,facetted,filament,floral,flower,fork,free,fruiting,general,glabrous,glandular,globose,globular,green,grey-brown,growth,hair,inflorescence,lavender,leaf,linear-lanceolate,lobe,long-cuneate,loosely,margin,minute,minutely,mm,oblong,oblong-lanceolate,ovary,pale,pedicel,peduncle,petiole,poricidal,pruinose,purple,reproducing,reticulate,rh,rhachi,rotate,rounded,sea,seed,shallow,short-lived,shrub,simple,slightly,stem,stigma,stone,stout,style,surface,tip,undulate,vegetatively,violet,well,young	-50,1-6,1.75-2,100-130,2,30-,40,80-,adherent,amongst,appearing,australian,berry,composed,conspicuous,curved,cut,deflexed,dia,distinct,eed,emarginate,enlarge,exceeding,except,exerted,filled,flesh,flowered,granule,greater,gree,half,interacuminal,large,leave,lengthening,less,little,lon,long,lower,mature,maturity,mid-vein,native,nflorescence,occasionally,often,pal,pedicellate,petal,plurifoliat,pore,preparation,rarely,relatively,ruit,ruiting,shed,sinus,slende,slit,soft-wooded,solanum,solitary,sometimes,somewhat,soon,stony,thus,tissue,tub,tube,ud,unarmed,unit,uvenile,way,x,ympodial	arrangement,bud,diameter,enlarged,form,fruit,height,history,juvenile,length,life,na,number,plant,plurifoliate,position,reproduction,shape,size,slender,spacing,texture,trichome,width
150	wfo-0001026851	invalid_json_followup	267	129	83	184	46	0.311	.8,1-7,10-15,2,5,5-merous,abaxial,acute,adaxial,andromonoecious,anther,apex,armed,base,berry,bilobed,bright,broadly,calyx,capitate,circular,cm,dark,diameter,evenly,fading,filament,flattened,flower,fruit,fruiting,glabrous,globose,glossy,greenish,hair,heavily,hyaline,inside,irregularly,lateral,leaf,less,light,lighter,lobed,margin,matte,membranous,mm,orange,outside,ovate,pedicel,peduncle,petiole,pilose,plant,prickle,pubescent,reflexed,scar,shrub,simple,slightly,sparsely,stellate,stem,straight,straw-colored,style,suborbicular,surface,terete,tip,triangular,trichome,unbranched,uniform,white,winged,yellow,yellowish	-2,-celled,.4,0.3–1,0.8–1.5,0–1,1,1.5,1.5–2,1.5–2.8,15,175–415,1979,1–4.5,1–7,2.2–3.6,2.5–4,2/3,2–10,2–3,2–3.5,300,3–3.6,3–5,4-5,4–5-celled,4–6,4–6-celled,5–6.5,5–7-celled,6–11,7–12,8–10.5,8–15,=,abaxiall,abundant,acicular,almost,alyx,apar,appearing,articulated,average,ba,becoming,blade,branched,c.,ciliate,coarse,coarsely,coil,complete,connivent,conspicuous,conspicuously,cordate,curve,densely,dentate,difoliate,directed,distall,distally,dot,eaf,eed,elongating,endocarp,enlarged,entire,equal,exceeding,except,eye,fertile,fide,fine,flexuous,free,geminat,gland,grading,gradually,green,heterostylous,infructescence,lacking,large,larger,lenticel,little,live,lobe,long,long-styled,lower,major,making,merely,midrib,minor,minute,minutely,moderately,mostly,much,n,naked,narrowly,near,nearly,nee,nflorescence,occasionally,often,one,orolla,otherwise,oung,pair,papillo,pattern,per,pericarp,pore,poricidal,portion,preserved,prickly,pubescence,recurved,rest,ruit,sap,scanden,scant,scarious,scattered,sessile,shiny,short-styled,similar,size,slender,small,smaller,sometimes,somewhat,spaced,specimen,speckled,spongy,sprawling,spreading,stamen,staminat,stipitate,stipitate-glandular,tall,tamen,tapering,tasteles,thick,thickened,tooth,tough,tube,twice,unarmed,unit,usually,vary,vein,visible,watery,way,well,wide,wing,ympodial,–13,–2	'',0-1,0.3-1,1.5-2,1.5-2.8,13,2-10,2.4,4-5-celled,5-6.5,[,``,apart,arrangement,bark,bud,center,characteristic,colour,corolla,form,geminate,growth,height,history,inflorescence,length,life,na,new,number,ovary,perennial,position,rachi,reproduction,seed,shape,spacing,staman,stigma,texture,value,width,{,}
151	wfo-0001026858	success	153	89	61	92	28	0.399	0.8,1-11.5,1-4,1.3-1.5,1.5-4,3-4,4-24,6-10,6-7,abaxially,acute,adaxially,apex,articulate,branched,cell,cm,corolla,cyme,diameter,dichasial,dichasially,distal,dorsally,ebracteate,filament,flat,flower,folded,glabrescent,glabrous,globose,green,green-white,half,herbaceous,leaf,light,mm,monochasial,mucilaginous,obtuse,odd-pinnate,ovate,ovate-lanceolate,ovoid,pedicel,peduncle,perennial,petiole,plant,proximal,rounded,seed,shiny,stellate,stigma,style,throughout,yellow,¼	-30,-4,0-.,0.5,0.8-1,1-,1-10,1-5,2-2.5,2-3,2-4,2.5-3,3-,3-6-foliat,4.5-10.5,5-15,6-18,abruptly,acumen,apical,apically,base,calyx,connate,cordate,covering,cuneate,dehiscent,digestion,diminishing,eaf,edge,eed,emoval,enzyme,exceeding,forked,generally,globo,hair-like,honeycomb,interjected,introrse,lateral,leaflet,living,lobe,lon,long,lower,lunat,make,maturing,minute,mucronate,nflorescence,nther,oblique,oblong,often,orolla,pair,pattern,perfect,plan,poricidally,reveal,ruit,seudostipule,short,size,slightly,slit,specimen,stamen,straight,tal,tem,testal,thick,throughou,toward,triangular,tuber-bearing,typically,unit,vary,wall,white-crea,wide,without,ympodial	abaxial,adaxial,anther,arrangement,center,colour,form,fruit,growth,height,history,inflorescence,length,life,na,number,ovary,position,rachi,reproduction,shape,spacing,staman,surface,texture,wet,white-cream,width
152	wfo-0001026870	success	206	114	85	121	29	0.413	.5,0.05-0.15,0.5-1,0.7-1.4,1-11,1.4-1.8,10-14,12-28,2-3,2-3.5,2-6,3-12,4-5,9.5-12,acicular,adaxially,anther,apart,black,broad-based,brownish,calyx,chartaceous,cm,deeply,densely,diameter,dioecious,elliptical,erect,extra-axillary,female,filament,finely,flattened,flower,forked,fruit,fruiting,glabrous,globose,grey,grey-green,inflorescence,length,lobed,longer,male,margin,mm,ovate,ovate-reniform,pedicel,peduncle,perennial,petiole,plant,porrect,prickle,pseudo-racemose,purple,reticulate,rhizomatous,ridged,rotate,rotate-stellate,rusty,shrub,simple,solitary,stellate-pubescent,stem,stigma,straight,style,surface,terete,throughout,time,unbranched,unknown,white,wide,yellow,yellowish	%,.05,0,0-0.1,0-1,0.2-0.35,0.2-1.2,0.25-0.4,0.25-0.5,0.3-0.4,0.4-0.8,0.7-2,1,1-4,1-5,1.5-2,1.9-3,11-14,140-600,15-25,18-30,2-5,2-7,2-foliate,2.5-12,3-10,3-5,300-600,4-7,4-9,5-7.5,5-merou,6-70,7-11,7-8,abaxially,absent,abundant,accrescent,acute,adaxiall,alyx,apex,armed,articulated,ascending,axe,ba,basal,base,blade,broadly,brown,color,cuneate,cylindrical,d.,deltate,diamete,directed,distal,distall,distributed,dult,eaf,eed,eglandular,enclosing,finger,functional,geminat,glabrou,gland-tipped,hair,heterostylous,index,interpetalar,lamina,lanceolate,lateral,lobe,lobing,lon,long,lower,mature,midpoint,midvein,minute,nflorescence,oblique,obtuse,orolla,part,per,pore,presen,present,probably,ray,ruit,sessile,short,side,spaced,stage,stalk,stellae,tal,tamen,thick,tissue,triangular,tube,unit,unknow,uvenile,vary,vein,x,ympodial	abaxial,adaxial,arrangement,bark,bud,cell,center,colour,corolla,form,growth,height,history,leaf,life,na,new,number,ovary,position,reproduction,scar,seed,shape,spacing,staman,texture,trichome,width
153	wfo-0001026874	invalid_json_followup	222	144	91	131	53	0.41	.3,.5,0-1,0.5,1.5,15-20,2,anther,apex,asymmetric,base,based,broad,broadly,calyx,cm,colored,compressed,dark,densely,diameter,drying,entire,filament,filiform,flower,foveolate,fruit,fruiting,glabrate,glabrous,glandular,globose,green,growth,hair,lance,lanceolate,lanceoloid,laterally,leaf,length,lenticular,lighter,like,long,margin,mm,near,new,often,orange,ovate,ovoid,pedicel,peduncle,petiole,pinnatifid,point,prickle,pubescent,rachi,recurved,reddish,repand,ripe,scabrous,shiny,shrub,similar,simple,slender,somewhat,sparse,sparsely,stellate,stellate-pentagonal,stem,stigma,style,surface,tan,thin-textured,upon,usually,vestiture,weakly,white,widest,x,yellow	0,0.2–0.6,1.5–2.5,1.5–4,1.5–5,12–20,1–,1–3,2-foliate,2–2.5,2–3,2–4,2–5,2–6,2–several-branched,3-5,4.5,4–7.5,5.5,5.5–7.5,5–15,6-7,6–12,6–9,8-12,8–20,9.5–11.5,abaxially,absent,across,acuminate,acute,adaxiall,adaxially,along,apar,apical,attenuate,axe,basally,berry,beset,blade,capitate,caudate,clavat,connivent,deltoid,dense,depressed,developed,eaf,eed,erect,except,finely,flowering,geminat,generally,glabrou,gland,glandular-pubescent,hermaphroditic,internode,interpetalar,juvenile,lanceolat,larger,lateral,lobe,lon,lower,main,major,midpoint,midrib,midvein,minute,moderately,narrowly,nflorescence,obtuse,orolla,per,perfect,pore,portion,present,prickly,prominently,pubescen,pubescence,reduced,rounded,ruit,scattered,sessile,short,side,slightly,small,sometimes,spaced,spreading,stalked,stellae,stellate-tomentose,straight,subulate,swollen,tall,tamen,tem,tip,tipped,tissue,tooth,truncate,tube,ud,unarmed,variable,vary,varying,vein,warty,widely,yello,ympodia,–5,–many	'',--,1-,1-3,1.5-4,1.5-5,12-20,2-3,2-6,2-several-branched,5,5-15,5.5-7.5,6-12,9.5-11.5,[,``,abaxial,adaxial,apart,arrangement,bark,bud,cell,center,characteristic,clavate,colour,corolla,form,height,history,inflorescence,life,many,na,number,ovary,perennial,plant,position,reproduction,scar,seed,shape,spacing,staman,texture,trichome,value,width,{,}
154	wfo-0001026895	invalid_json_followup	166	123	85	81	38	0.512	0.5-1,0.5-1.2,0.5-1.5,0.5-2,0.8-1,1-1.5,1.4-2.1,2-2.3,2/3,4.5-5,abaxial,acute,adaxial,along,anther,apex,apically,bark,base,broadly,brown,calyx,capitate,closely,cm,conical,corolla,dark,dendritic,drying,ellipsoid,elliptic,filament,filiform,flattened,fruiting,glabrous,globose,green,hard,incrassate,internodal,lamina,leaf,lobed,margin,minutely,mm,mustard,narrowly,obovate,often,ovary,pale,pedicel,petiole,pitted,pointed,pubescent,reddish,reniform,scar,scattered,shape,shrub,shrublet,simple,small,spaced,sparsely,stem,stigma,style,surface,swollen,tan,toothed,trichome,uniseriate,vein,way,white,woody,x,yellow	.5,0-0.5,1-5,1.5-2,2-2.5,2-3,2.5-3.2,3-12,5-6,5-8-flowered,anthesi,apical,appearing,attenuate,ba,berry,borne,broad,campanulate,contracted,deflexed,deltoid,denser,dia,differing,difoliate,eaf,edicel,eed,elongate,erect,free,geminat,glabrate,lateral,like,lobe,lon,long,long-exserted,lower,main,major,middle,minor,minute,nflorescence,older,overlappin,pair,papillo,pericarp,pore,poricidal,portion,present,projection,reddish-brow,ruit,shaped,shoot,short,side,size,somewhat,soon,swollen-based,tall,tear-drop,thin,tip,tub,tube,tuft,type,ud,unit,usually,widest,ympodial,young	'',5-8,[,``,alternate,arrangement,bud,characteristic,colour,diameter,flower,form,fruit,growth,height,history,inflorescence,length,life,na,new,number,overlapping,peduncle,plant,position,prickle,rachi,reddish-brown,reproduction,seed,spacing,staman,texture,value,width,{,}
155	wfo-0001026905	success	204	118	91	113	27	0.446	-1.5,.5,0.15,0.4,0.4-1,0.5-1.5,0.6-0.7,0.9-1.3,1-2.5,1-6,1/2-3/4,2.5-3.5,5-merous,abaxially,anther,apex,bark,base,berry,branched,calyx,cell,chartaceous,cm,cream,curved,dark,densely,diameter,discolorous,drying,dull,filament,flattened-reniform,flower,fruit,fruiting,glabrous,gray-green,green,inflorescence,lateral,leaf,length,lobed,long,margin,marking,maturity,mauve,mm,moderately,oblong,orange,orange-brown,outline,ovate,pale,pedicel,petiole,pit,porrect,prickle,raised,red,rounded,scar,sessile,shallowly,shrub,small,smooth,sometimes,sparsely,spherical,stalked,stellate-pubescent,stem,straight,style,subentire,surface,trichome,usually,way,weakly,white,wide,yellow,yellow-green,young	-10,-2,-2/3,-3,-4,.2,0,0-2,0-20,0-25,0.1,0.2-0.3,0.2-0.5,0.3-0.4,0.4-0.9,0.5-0.7,0.7-1.4,0.75-1.1,1,1-2,1-20,1-3.7,1-4,1.9-2.5,1/3,1/4,1/5-1/3,2-3,2.5-2.9,2/3-3/,3-5,3-8,5-6,6-8,7-8,acuminat,acute,alyx,ame,apar,apart,apically,apparently,articulated,attenuate,blade,brow,c.,connivent,deltate,difoliate,distance,eaf,eed,elongating,equal,erect,extending,eye,free,geminat,infructescence,lobe,longer,lower,mature,midpoint,midvein,naked,older,one,open,orolla,oung,pair,peduncle,pendulous,per,perfec,pericarp,poricidal,portion,prickl,prickly,primary,ray,reduced,ruit,shorter,side,slender,somewhat,spaced,spreading,stalk,stellate,tamen,tapering,terete,tertiary,time,tip,tube,unarmed,unit,upper,variously,vary,vein,venation,visible,woody,ympodial	abaxial,adaxial,alternate,arrangement,brown,bud,center,colour,corolla,form,growth,height,history,life,new,ovary,perennial,plant,position,reproduction,seed,shape,staman,stigma,texture,unknown,width
156	wfo-0001026923	invalid_json_followup	177	117	80	97	37	0.452	.1-0.3,.5,0-5,0.25-0.5,0.5-1,0.6-0.8,1,1.5-4,2,2-2.5,2-6,20-50,3-5,5-10,5-15,5-9,abaxially,accrescent,acuminate,adaxially,anther,apart,apex,black,branched,brown,calyx,center,chartaceous,cm,densely,diameter,elliptic,elliptic-ovate,entire,erect,filament,flattened,flower,forked,fruit,fruiting,glabrescent,glabrous,globose,green,leaf,leaf-opposed,light,margin,mm,moderately,orange,pedicel,peduncle,petiole,possibly,pubescent,purple,rachi,red,ripening,rugulose,sessile,shrub,simple,slightly,small,sparsely,stellate,stem,stigma,strongly,style,surface,tree,trichome,white,x,yellow	-5,0.5,0.8-1,1-1.5,1-3,1-4,1-7,1.5-2,10,2-3,3-4,4-18,4-5-,5-6,absent,acute,adaxiall,ag,apparently,articulated,axe,ba,base,blade,capitat,connivent,covering,cuneate,curved,cylindrical,deltate,denser,directed,distally,eaf,eed,eglandular,equal,frui,fused,geminate,gland-tippe,glandular,hair,held,intermediate,lanceolate,large,lateral,like,lobe,long,longitudinal,lower,many-foliate,midpoint,midvein,much,multangulate,nearly,nflorescence,oblong,opening,orolla,paired,peltate,perfect,pore,pubescence,ray,relatively,rounded,ruit,scale,short,slit,smaller,sometimes,somewhat,spaced,ste,straight,subtending,tal,tamen,tem,time,tip,tube,unit,uprigh,usually,vary,whitish,wide,yellowish,ympodial	'',[,``,abaxial,adaxial,arrangement,bark,bud,capitate,characteristic,colour,corolla,form,growth,height,history,inflorescence,length,life,na,new,number,ovary,plant,position,prickle,reproduction,scar,seed,shape,spacing,staman,texture,value,width,{,}
157	wfo-0001026924	success	190	98	65	125	33	0.342	-4,0-2.3,0.2-0.4,0.5-1.5,0.5-6,0.8-2.6,1-6,10-13,4-7,4.3-6.2,5-7,8-9,acicular,anther,brown,calyx,chartaceous,cm,densely,diameter,drab,drying,entire,extra-axillary,finally,flower,fruit,fruiting,glabrous,globose,green,grey,grey-green,herbaceous,inflorescence,length,light,lobed,margin,minutely,mm,ovate,pale,pedicel,peduncle,petiole,prickle,pseudo-racemose,purple,rachi,resprouter,rusty,shallowly,simple,stellate,stellate-pubescent,stem,stigma,style,surface,truncate,undulate,white,yellow,yellowish	%,0-0.2,0-1.5,0-2,0.05-0.1,0.05-0.2,0.1-0.3,0.4-0.5,0.5-0.6,0.5-0.7,0.5-0.8,0.7-1.1,0.7-1.2,0.8-1.2,0.9-1.3,1-1.5,1-4,1.1-4.2,17-40,2-,2-2.5,2-4,2-foliate,2.8-8.5,3,3-6,5,5-merou,6-8,7-10,7-8,abaxially,absen,absent,accrescent,across,acute,adaxiall,adaxially,alyx,apart,apex,apparently,appearance,axe,base,blade,capitat,connivent,cordate,cuneate,curved,cylindrical,d.,directed,distall,distally,distributed,dult,eaf,eed,eglandular,erect,finger,first,geminat,glabrou,gland-tipped,hair,half,lamina,lanceolate,lateral,less,lobe,long,longer,lower,markedly,mature,mid-poin,midpoint,minute,narrowly,nflorescence,oblique,obtuse,orolla,part,per,perfect,pore,porrect,present,raisin-like,ray,rostrate,ruit,short,slightly,spaced,sparsely,stage,stalk,stellae,straight,tal,tamen,thick,thicker,thicknes,throughout,time,triangular,tube,unarme,unarmed,unbranched,unit,unknow,uvenile,vary,wide,x,ympodial	abaxial,adaxial,arrangement,bark,bud,capitate,cell,center,colour,corolla,filament,form,growth,height,history,leaf,life,na,new,number,ovary,plant,position,reproduction,scar,seed,shape,spacing,staman,texture,trichome,unknown,width
158	wfo-0001026925	invalid_json_followup	215	122	84	131	38	0.391	0.1-0.3,0.5-1.5,0.5-4,0.7-1.8,0.9-1.8,1-1.3,1-1.4,1-25,1-3.5,1.5-4.5,1.8-2.5,2-5,2.4-3,3-7,4-10,5-6,5-merous,6-8,acute,andromonoecious,anther,apart,apex,apparently,bark,berry,calyx,cm,cream,dark,deltate,diameter,erect,filament,flattened,flattened-reniform,flower,fruit,fruiting,glabrescent,glabrous,green,green-brown,lateral,leaf,length,lobed,long-styled,margin,marking,mature,mauve,mm,moderately,orange-brown,pale,pedicel,peduncle,pendent,petiole,plant,porrect,prickle,red-brown,reflexed,scar,sessile,short-styled,shrub,sparsely,spherical,stalked,stellate,stellate-pubescent,stem,style,surface,terete,terminal,trichome,white,yellow,yellow-orange,young	-2,.5,/6,0,0-10,0-20,0-5,0-7,0.1,0.1-0.2,0.2,00-200,1-3,1-4,1.5-2,1.5-2.5,1.8-2,1/3,1/3-1/2,1/4-2/3,1/6-1/3,2-4,2.4-2.6,2.5-6,2/,3-20,4-14,4-5,4-7,5-8,5.5-10,6-10,6-17,7-12,abaxially,acuminat,alyx,ame,apar,apically,articulated,attenuate,base,blade,branched,broad-deltate,brow,c.,chartaceous,concolorous,connivent,curved,distal,distance,drying,eaf,eed,elliptic,elongating,equal,extending,free,gently,hair,hermaphrodite,heterostylous,infructescence,lobe,lobing,long,longer,lower,lowermost,maturity,membranous,midpoint,midvein,minute,narrow-deltate,nflorescence,oblong,older,one,open,orolla,oung,ovate,pair,pendulous,per,pericarp,plurifoliat,poricidal,portion,prickl,prickly,primary,rarely,ray,reduced,rounded,ruit,secondary,side,simple,smooth,sometimes,spaced,spreading,stalk,staminat,stout,straight,tamen,tapering,tertiary,time,tip,translucent,tube,unarmed,unit,upper,vary,vein,venation,visible,way,wide,woody,ympodial	'',/,[,``,abaxial,adaxial,arrangement,brown,bud,center,characteristic,colour,corolla,form,growth,height,history,inflorescence,life,na,new,number,ovary,perennial,plurifoliate,position,rachi,reproduction,seed,shape,spacing,staman,stigma,texture,value,width,{,}
159	wfo-0001026946	invalid_json_followup	205	112	70	135	42	0.341	0-5,0.5-2,1-10,1-2,1.6-3.7,12-23,2-15,2.5-10.5,5-7,8-15,8-25,abaxially,acuminate,acute,adaxially,anther,apex,bud,cell,chartaceous,clavate,cm,corolla,covering,creamy,deeply,densely,diameter,elliptic,filament,flower,forked,fruit,glabrous,globose,green,greenish,herb,lateral,margin,membranous,minutely,mm,odd-pinnate,ovate,ovoid,pedicel,peduncle,pentagonal,petiole,plant,puberulent,pure,purple,seed,short-pubescent,slightly,stellate,stem,stigma,streak,style,terminal,testal,thick,wall,white,whitish,yellow,yellow-white	0-20,0.9-3.5,0.9-4.3,1,1-4,1.5-2,10-39,2,2-5,2.7-9,3-20,3-5,3-6,3.5-10,4-7,4.1-9.4,5-merou,6-24,acumen,ag,along,alyx,apart,apparently,articulation,attenuate,axe,axillary,base,berry,blade,borne,broadly,brownish,capitat,ciliate,condition,connivent,digestion,distal,dorsally,dot,drying,eaf,edge,eed,end,enzyme,erec,especially,exceeding,except,extremely,flat,folded,fresh,geminat,generally,glabrou,greatly,green-white,hair,hair-like,half,homostylous,honeycomb-shaped,interjected,lanceolate,leaflet,lengthening,like,living,lobe,long,lower,make,midrib,mottled,mucilaginous,narrowly,nflorescence,oblique,often,orbicular,orolla,pair,perfect,petiolulate,petiolule,plurifoliate,pore,poricidal,proximal,pubescen,pubescent,reduced,removed,ripe,rounded,ruit,scattered,sessile,seudostipule,short,singly,size,slit,spaced,specimen,stamen,ste,stolo,straight,subequal,subtending,tall,tamen,tem,thir,throughout,tip,tri-,truncate,tube,tuber,typically,unit,unwinged,usually,variable,vary,wet,wing,x,ympodial	'',[,\u201chair-like\u201d,``,abaxial,adaxial,arrangement,bark,calyx,capitate,center,characteristic,colour,form,fruiting,growth,height,history,inflorescence,leaf,length,life,na,new,number,ovary,perennial,position,prickle,rachi,reproduction,scar,shape,spacing,staman,surface,texture,trichome,value,width,{,}
160	wfo-0001026962	invalid_json_followup	205	135	100	105	35	0.488	.05,0.3-0.7,0.8-1,1-1.5,1-3,1-4.5,1.5-2,1.5-5,10-12,10-20,2-2.5,2-6,2/3-3/4,4-5,6-7,abaxially,abrupt,adaxially,anther,anthesi,bark,base,broadly,bud,calyx,closely,cm,corolla,darker,deltate,densely,denser,diameter,dry,elliptic,entire,evenly,except,filament,flattened-reniform,flower,fruit,fruiting,glabrous,globose,green,incrassate,inflorescence,internodal,leaf,lobed,long,margin,material,minutely,mm,narrowly,occasionally,often,opposite,ovate-lanceolate,overlapping,packed,pale,papillose,pedicel,peduncle,pendent,petiole,pitted,pubescent,purplish,rachi,reflexed,shrub,simple,slender,small,sometimes,somewhat,stellate,stem,stigma,style,surface,tapering,tinged,tree,triangular,trichome,tube,unbranched,uniseriate,vein,way,white,woody,x,yellow,yellowish	.5,0,0.5,0.5-0.8,0.5-1,0.5-1.5,1,1-1.2,1-2,1-6,1.5-17,1.5-3,15-22,2-5,3-3.5,3-6,9-12,9-17,abruptly,accrescent,acute,ag,alyx,apex,apparently,appearing,arising,articulated,axe,basebud,becoming,beneath,blade,brittle,capitat,cell,chartaceous,composed,connivent,constricted,cucullat,cylindrical,deflexed,differing,difoliate,dimorphic,eaf,eed,elongate,exerted,free,geminat,glabrate,glabrou,ilament,later,lateral,like,lobe,longitudinal,main,major,minor,nflorescence,obconic,oblong,obovoid,older,one,opening,orolla,oung,outline,pair,paten,perfect,pore,portion,prominent,pubescen,raised,remaining,rest,rounded,rounder,ruit,sagittate,shaped,size,slightly,slit,soon,straight,tal,tear-drop,tip,tooth,trunk,unarmed,unifoliate,unit,vary,whit,ympodial,young	'',[,``,abaxial,adaxial,arrangement,capitate,center,characteristic,colour,form,growth,height,history,length,life,na,new,number,ovary,perennial,plant,position,prickle,reproduction,scar,seed,shape,spacing,staman,texture,value,width,{,}
161	wfo-0001026963	invalid_json_followup	151	112	76	75	36	0.503	-5,.4,.5,0.2-0.6,0.5,1-1.5,1-2,1.2-1.5,1.5-6,2-2.5,2-4.5,3-5-rayed,4,6-7,abaxially,acicular,anther,apex,apical,bark,calyx,capitate,closely,cm,conical,corolla,cup-shaped,dark,deep,diameter,ellipsoid,elliptic,filament,flower,glabrous,growth,herb,heterostylous,inflorescence,internodal,lobed,long-styled,margin,minute,minutely,mm,new,nodding,ovary,ovate,pedicel,peduncle,petiole,porrect,prickle,pubescent,reddish,scar,sessile,shallowly,short-styled,simple,spaced,sparsely,stellate,stem,stigma,style,subshrub,surface,tooth,trichome,truncate,white,x,yellowish	0.5-0.6,0.8-3,1.1-1.4,1.5-4.5,3-5,4-5,5-6,<,abruptly,absent,acute,anthesi,armed,articulated,base,brow,c.,clustered,coriaceous,creeping,curved,densely,eaf,eed,elongate,elongating,free,included,inflorescenc,know,known,like,lobe,long,long-triangular,lower,markedly,mature,membranous,midpoint,nflorescence,node,oblique,older,outline,pair,papillo,per,plurifoliat,pore,poricidal,portion,prickly,primary,prominent,ray,reflexed,rooting,rootstock,ruit,scattered,side,slit,small,sometimes,tapering,tip,tube,ud,unarmed,unit,vein,way,woody,ympodial	'',/,[,``,abaxial,adaxial,arrangement,brown,bud,characteristic,colour,form,fruit,fruiting,height,history,leaf,length,life,na,number,papillose,perennial,plant,position,rachi,reproduction,seed,shape,spacing,staman,texture,value,width,{,}
162	wfo-0001026964	success	128	90	58	70	32	0.453	.5,0.5,0.5-1,10-30,2-2.5,3-5,7-8,acuminate,acute,along,anther,apex,axillary,base,calyx,cm,conical,corolla,diameter,elliptic,filament,filiform,flower,fruiting,glabrous,globose,green,greenish,herb,lobed,minutely,mm,nearly,obovate,ovary,papillate,pedicel,petiole,pinnate,pubescent,purple,rachi,rugose,scar,shape,simple,slender,smooth,somewhat,sparsely,stigma,style,surface,trichome,uniseriate,vein,x,yellow	.2,0,1-1.2,1-2.5,10,2-4,3.5-7,4.5-8.5,?,anthesi,attenuate,basal,beak,bearing,berry,capitat,conspicuously,differentiated,distinct,eaf,edicel,equal,erec,exserted,fleshy,free,glabrou,horizontal,immature,known,lateral,leaflet,lenticellate,lightly,line,lobe,long,long-attenuate,lower,margin,nflorescence,noddin,often,one,onto,open,ot,pair,petiolule,poricidal,portion,primary,purpli,reflexed,ruit,side,size,small,tal,tem,terminal,time,tip,tub,tube,ud,unifoliat,unit,winged,ympodial	abaxial,adaxial,arrangement,bud,capitate,cell,center,colour,form,fruit,growth,height,history,inflorescence,leaf,length,life,na,new,number,peduncle,perennial,plant,position,purplish,reproduction,seed,spacing,staman,stem,texture,width
163	wfo-0001026965	invalid_json_followup	157	108	63	94	45	0.401	-2.5,0.5-1.5,0.7-1.1,0.7-1.5,1.1-1.65,1.7-2,3.5-9,6.4-12,abundant,acute,anther,antrorse,apex,broadly,calyx,campanulate,capitate,cm,diameter,elliptic,elliptical,evident,filament,flexuose,fruiting,globose,herb,long,longitudinally,margin,mm,narrowly,non-glandular,obovate,outer,ovate,pale,papery-scarious,papillose,petiole,pinnatifid,pinnatipartite,prostrate,pubescent,reticulate,ridged,seed,simple,stem,stigma,style,subglobose,surface,trans-ovoidal,trichome,tuberculate,uniseriate,venation,violet,white,winged,x,yellow	.3,.5,.6,0.2,0.4,0.5-,0.6-1.1,0.6-2,0.7-1,0.8-1.25,1.3-2,1.5-2,1.5-4,1.9-2.4,2.5-4,2/3,25,3-,3-4,3.5-6.2,5-15,8-17,abaxially,accrescent,adaxially,ag,appressed,articulated,basal,base,berry,c.,coat,coiled,connectival,covering,cuneate-attenuate,cylindrical,difoliat,dorsal,eaf,eed,eglandular,ellipsoidal,embryo,exserted,glabrous,glandular,herbaceous,hig,latitudinally,lobe,longer,longitudinal,lower,mixed,multi-seeded,noticeable,opening,opposite,orolla,ovat,pair,papillae,partially,pore,poricidal,portion,procumbent,prolongation,ree,rounded,ruit,segment,short,similar,slightly,slit,small,smooth,straight,striate,strongly,styl,tem,time,tip,tube,unequal,unifoliate,unit,vary,wider,ympodial	'',0.6,3-15,[,``,abaxial,adaxial,arrangement,bark,bud,center,characteristic,colour,corolla,flower,form,fruit,growth,height,history,inflorescence,leaf,length,life,na,new,number,ovary,pedicel,peduncle,perennial,plant,position,prickle,rachi,reproduction,scar,shape,spacing,staman,texture,value,width,{,}
164	wfo-0001026981	invalid_json_followup	252	154	119	133	35	0.472	-0.8,-2.5,-35,.2,0.3-0.5,0.3.6,0.45-1.3,0.5-0.3,0.5-30,0.6-2,1-2,1-3.3,1.8-2.8,1/3,11,2-3-branched,4,4-celled,7.5,abaxially,abundant,accrescent,acute,adaxially,adpressed,along,anther,apex,appearance,appressed,articulated,articulation,base,beak,brown,calyx,capitate,cell,cm,conical,corolla,dark,densely,diameter,distal,entire,filament,flower,fruit,fruiting,giving,glabrescent,glandular,globose,green,hair-like,head,herb,imparipinnate,interrupted,irregularly,lateral,leaf,like,lime,lobed,margin,maturity,minutely,mixed,mm,much,multicellular,narrowly,obovate,occasionally,orange,orbicular,outgrowth,ovary,ovate,pale,patent,pedicel,peduncle,pentagonal,perennial,petiole,plant,pronounced,pubescent,rachi,robust,shaggy,silky,simple,slender,smaller,sometimes,sparsely,sparser,stem,stigma,style,surface,tangled,testa,tightly,transparent,trichome,uni-,uniseriate,variously,velvety,viny,wall,winged,without,yellow	-0.4,-14,-2,-4,-8,.2-0.2,0-5,0.05-0.1,0.1-0.2,0.1-0.3,0.15-0.2,0.2,0.2-0.4,0.2-2,0.25-0.4,0.4-0.5,0.4-0.7,0.4-2,0.5,0.6-1.4,0.7-0.8,0.8-1.2,0.8-6,0.9-1.4,0.9-1.5,1,1-2-cellular,1-3,1-3-celled,1-4,1.5-2.0,1.5-5,1.5-8.5,196.,2-3,2-locular,3-foliate,3.5-14,4-8,6-10,<,absen,absent,academy,amongst,angled,anthesi,apical,appendage,asymmetric,axi,basiscopically,bay,becoming,bract,bracteole-like,citrus-like,coastal,column,composed,cone,cordate,d,deltate,eaf,ebracteate,edicel,eed,erect,exserted,gree,half,halfway,included,initially,interjected,internode,jointles,larger,later,leaflet,less,linear,lobe,lon,long,lower,mainly,nflorescence,pair,per,petiolule,population,present,primary,procumbent,proximal,pseudostipule,pubescence,reflexed,rick,rounded,ruit,scen,secondary,see,sessile,several,shaped,short,shorter,specimen,spreadin,staminal,sterile,straight,strong,tem,terminal,tertiary,thick,tub,tube,type,unicellular,unit,upto,usually,villous,wide,ympodial,‘,’	'',[,``,abaxial,adaxial,arrangement,bark,bud,characteristic,colour,form,growth,height,history,inflorescence,length,life,na,new,number,ped,position,prickle,reproduction,scar,seed,shape,spacing,spreading,staman,texture,value,width,{,}
165	wfo-0001026987	success	214	109	77	137	32	0.36	0-1,0.4-0.7,0.4-1,0.5-2,0.5-2.5,1-3,1-4,1.5-2,2-7,3.5-5,4-6,4-7,5.5-7,6-20,acute,anther,apart,apex,bent,calyx,chartaceous,cm,curved,deltate,densely,diameter,entire,erect,extra-axillary,filament,flower,fruit,fruiting,glabrous,globose,green,homostylous,inflorescence,leaf,length,lilac,lobed,longer,margin,mm,obtuse,often,ovate,pale,pedicel,peduncle,perennial,petiole,prickle,purple,rachi,red,rhizomatous,shallowly,shrub,simple,sparsely,stellate,stellate-pubescent,stigma,straight,style,surface,thin,time,triangular,twisted,unbranched,white,wide,yellow,yellowish	%,0-0.1,0-0.2,0-10,0-4,0.05-0.1,0.2-0.4,0.2-0.5,0.2-1,0.25-0.4,0.4-0.5,0.5-0.7,0.5-1,0.7-0.8,0.7-1,0.7-1.5,1-11,1-2,1.1-2.6,1.1-6,1.4-3,15-35,2-5,2.5-11,2.5-6.5,3.5-3.8,4.5-6,5-10,5-8,5-merou,7-10,8-10,8-11.5,8-12,8-13,abaxially,absen,absent,abundant,accrescent,across,adaxiall,adaxially,adult,alyx,articulated,ascending,axe,ba,basal,base,berry,blade,branch,branche,broad-based,capitat,connivent,cordate,cuneate,cylindrical,decimetre,deflexed,directed,distall,distributed,dm,eaf,eed,eglandular,finger,gland-tipped,glandular,glandular-hairy,grey,hair,half,hastate,interpetalar,juicy,juvenile,lacking,lamina,lanceolate,lateral,less,lobe,long,loosely,lower,mature,mesocarp,mid-point,midpoint,minute,narrowly,nflorescence,oblique,orolla,pair,part,per,perfect,pore,porrect,present,ray,ruit,scarcely,sessile,shallowly-lobed,short,slightly,spaced,sparse,stalk,stellae,succulen,summit,tal,tamen,tem,thick,thickened,throughout,tissue,toward,tube,unarme,unarmed,unit,unknow,upper,upward,vary,x,ympodial	5-merous,abaxial,adaxial,arrangement,bark,bud,capitate,cell,center,colour,corolla,form,growth,height,history,life,na,new,number,ovary,plant,position,reproduction,scar,seed,shape,spacing,staman,stem,texture,trichome,width
166	wfo-0001026992	invalid_json_followup	243	141	103	140	38	0.424	0.6-1.5,1-4,1.2-1.7,1.4-1.6,1.5-3.4,1.7-4.3,2-10,2-5.6,2.6-4.6,2.8-4.7,3-4,5.3-12.1,6-10,8-14,abaxial,abaxially,accrescent,acuminate,acute,adaxially,angled,anther,apart,apex,articulated,attenuate,bark,base,branched,broadly,brown,calyx,chartaceous,cm,corolla,dark,deltoid,densely,diameter,drying,echinoid,elliptic,entire,filament,flower,fruit,fruiting,glabrous,globose,granular-tomentose,greenish,grooved,hair,homostylous,lance-ovate,leaf,length,less,longitudinally,many,margin,mm,moderately,multangulate,nearly,oblong,orange-tan,ovate,pedicel,peduncle,petiole,plant,porrect-stellate,pubescent,rachi,reniform,reticulate-punctate,ripe,scabridulous-,sessile,short,shrub,simple,small,stellate,stem,stigma,stout-stalked,style,subglobose,surface,tan,terete,terminal,time,tomentose,tree,velutinous,violet,white,whitish,yellow,yellowish	-2.5,/7,0.2-0.5,0.25-0.45,0.5-1.2,0.8-3.4,00-170,1.2-1.4,1.3-2.6,1.3-4.3,1.4-1.9,1.7-1.9,1.7-2.4,1/2,10-12,12-33,2.3-3.3,2.8-4.6,3.3-5.5,3.3-5.6,4-8,5-15,5-merou,8,8-11,abruptly,adaxiall,ag,along,alyx,anthesi,apparently,appressed,approximately,around,axe,axillary,ba,berry,blade,blunt-tipped,branch,capitat,completely,coriaceous,covering,crown,cylindrical,directed,distally,eaf,echinoi,edge,eed,enveloping,equal,evident,exserted,farinose,flat-topped,fleshy,forming,free,geminate,glabrescen,high,immature,inserted,lacking,lanceolate,lateral,lengthening,line,lobe,lobed,long,long-stalked,longitudinal,lower,m.,main,mature,maturity,midrib,minute,mostly,nflorescence,obtuse,occasional,occasionally,often,older,orolla,ovate-lanceolate,overlapping,perfect,plurifoliate,pore,poricidal,pubescence,rare,rather,ruit,runk,semi-ovate,short-,short-stalked,shorter,side,size,slit,sometimes,somewhat,spaced,sparingly,split,spreading,stalked,stamen,subcampanulate,suture,tamen,thin-textured,tip,tube,ud,unarme,unarmed,unequal,unit,usually,vary,vein,way,weakly,wide,x,ympodial,young,½	'',100-170,5-merous,[,``,adaxial,arrangement,bud,capitate,characteristic,colour,form,glabrescent,growth,height,history,inflorescence,life,na,new,number,ovary,perennial,position,prickle,reproduction,scar,seed,shape,spacing,sparing,staman,texture,trichome,value,width,{,}
167	wfo-0001026994	success	266	114	89	177	25	0.335	-30,0.5,0.5-0.7,0.5-0.8,0.5-2,1,1-1.4,1-1.6,2-2.6,20-50,4,4-15,6-20,abaxially,acuminate,acute,anther,apex,beneath,berry,bifurcate,branched,bright,broadly,brown,calyx,capitate,cm,conical,corolla,crenate,dark,darker,deeply,densely,diameter,elliptic,filament,flower,fruit,fruiting,globose,grayish,green,greenish,hair-like,herb,imparipinnate,inflorescence,interrupted,investing,irregularly,leaf,less,lobed,loosely,margin,medial,midvein,mm,moderately,narrowly,obovate,outgrowth,ovary,paler,pedicel,peduncle,perennial,petiole,pubescent,purple,rachi,regularly,rotate-stellate,simple,sparsely,spreading,stem,stigma,stripe,style,surface,trichome,uniseriate,usually,velvety,white,yellow	-0.7,-10,-20,-foliate,.2,.5,0.05-0.1,0.05-0.2,0.1,0.1-0.2,0.1-0.3,0.15-0.2,0.2-0.4,0.2-0.5,0.25,0.3-0.4,0.4-0.5,0.4-1.2,0.5-0.6,0.5-0.9,0.5-1.2,0.5-1.3,0.7-2.5,0.9-1.2,0.9-1.3,1-1.2,1-1.5,1-2,1.2-1.6,1.2-3.5,1.4-2.1,10-20,12-,2,2-,2-4,2-5-locular,2.2-3.2,2.5-6.5,3,3-branched,4-celled,5,5-,5-7,7-13,8,8-12,absent,abundant,acroscopically,additional,adpressed,along,also,amongst,andscattered,anthesi,apical,apically,appearance,appendage,articulate,articulation,basal,basally,base,basiscopically,becoming,bent,bifurcation,bract,bracteate,broader,cell,celled,column,crenat,crowded,decreasing,decumbent,decurrent,developed,distal,eaf,ebracteate,edicel,eed,eglandular,erect,especially,essentially,exserted,fewer,giving,glabrous,glandular,gree,habitat,hal,half,halfway,head,interjected,internode,lamina,lanceolate,large,larger,largest,lateral,leaflet,leave,like,lobe,locule,lon,long,lower,markedly,minutely,much,narrower,narrowing,nearly,nflorescence,node,oblique,occasionally,often,pair,papillate,petiolule,present,primary,pseudostipule,puberulent,rarely,reflexed,ripe,robust,rocky,secondary,sessile,set,shaggy,short,silky,sinus,size,slightly,sometimes,specimen,spreadin,staminal,sterile,straight,tall,tem,terminal,tertiary,testa,thick,tip,toward,tube,ud,unicellular,unit,wall,weak-walled,well,wide,winged,woody,ympodial,young	abaxial,adaxial,arrangement,bark,bud,colour,form,growth,height,history,length,life,na,new,number,plant,position,prickle,reproduction,seed,shape,spacing,staman,texture,width
168	wfo-0001026996	success	188	101	72	116	29	0.383	0.6-1,1-2,1.8-4.4,14-33,15-28,3-10,3-5,3.3-6,4.5-10.5,5-8,6-8,abaxially,acumen,adaxially,anther,apex,articulated,attenuate,blue,brownish,cell,clavate,cm,condition,coriaceous,corolla,covering,dark,deep,diameter,drying,elliptic,filament,flower,forked,fresh,fruit,glabrous,globose,green,greenish,hair-like,herb,homostylous,lateral,leaf,lilac,medium,mm,odd-pinnate,ovate,ovoid,pedicel,peduncle,pentagonal,petiole,petiolulate,plant,rotate,rounded,seed,slightly,stigma,stripe,style,terminal,testal,thick,wall,white,whitish,yellow	0-6,0.9-2.7,1-3,1-4,1-5,1.2-1.8,1.3-7.7,2-3,3-7,3.8-14.1,4-4.4,4-8,5-merou,6.9-10.9,8.7-18.6,abaxiall,acuminate,acute,ag,along,alyx,apart,apparently,arranged,asymmetric,axe,axillary,base,basiscopic,bead,berry,blade,bud,capitat,connivent,considerably,decreasing,digestion,distal,dorsally,eaf,edge,eed,enzyme,erec,exceeding,flat,folded,geminat,generally,glabrou,green-white,half,honeycomb-shaped,interjected,lanceolate,larger,leaflet,lengthening,like,linear,living,lobe,long,lower,make,middl,moniliform,mottled,mucilaginous,multiple,necklace,nflorescence,orbicular,orolla,pair,perfect,plurifoliate,pore,poricidal,purple,removed,ripe,ruit,sessile,seudostipule,side,size,slit,sometimes,spaced,specimen,stamen,stolon,straight,subglabrou,subtending,symmetric,tall,tamen,tem,throughout,tip,tissue,toward,tri-,tube,tuber,typically,unit,unwinged,usually,vary,wet,x,ympodial	5-merous,abaxial,adaxial,arrangement,capitate,colour,form,growth,height,history,inflorescence,length,life,middle,na,number,ovary,perennial,position,pseudostipule,rachi,reproduction,shape,spacing,staman,subglabrous,surface,texture,width
169	wfo-0001027009	success	226	122	94	132	28	0.416	0-0.3,0.1-0.2,0.4-1,0.5-2,0.8-2.1,1-9,10-15,2-3,3-3.5,3.3-3.6,4-6.5,5-23,5-merous,7-11,7-12.5,acicular,acute,adaxially,andromonoecious,anther,apart,apex,ascending,attenuate,black,broad-based,brown,calyx,capitate,chartaceous,cm,deeply,densely,diameter,dimorphic,elliptical,erect,extra-axillary,filament,flower,fruit,fruiting,glabrous,glandular,globose,green,grey,grey-green,hair,inflorescence,length,lobed,longer,margin,markedly,minutely,mm,obtuse,ovate,pale,pedicel,peduncle,perennial,petiole,plant,porrect,prickle,pseudo-racemose,purple,reticulate,rhizomatous,ridged,ripe,rotate,shallowly,shrub,simple,slightly,stellate-pubescent,stem,stigma,straight,style,surface,terete,throughout,time,unbranched,white,wide,x,yellow,yellowish,yellowish-green	%,0-0.2,0-0.5,0-1.2,0-1.5,0-15,0-5,0-8,0.15-0.3,0.7-0.9,0.7-1,0.7-1.3,0.8-1.2,0.8-1.3,1-1.5,1-1.8,1-2,1-2.5,1-3,1-5,1.3-2.2,1.4-4,1.6-3.5,10-20,2-4,2-6,2-foliate,2.3-3,20-30,23-48,3-10,3-5,35-400,4-9.5,40-125,5,5-7,6-8,6-9,6.5-11,7-8,abaxially,absent,abundant,accrescent,adaxiall,alyx,armed,articulated,axe,ba,basal,base,bilobe,bisexual,blade,broadly,connivent,cuneate,curved,cylindrical,d.,deflexed,deltate,directed,distal,distall,distributed,dult,eaf,eed,eglandular,entire,finger,functional,geminate,gland-tipped,half,heterostylous,incised,index,interpetalar,juic,lamina,lanceolate,larger,lateral,lobe,lobing,lon,long,lower,male,mature,mesocarp,midpoint,midvein,minute,moist,nflorescence,oblique,orolla,part,per,pore,presen,present,pricklie,probably,rarely,ray,ruit,short,side,spaced,stage,stalk,stellae,strongly,tal,tamen,thick,tip,tissue,tube,unarmed,unit,unknow,uvenile,vary,vein,ympodial	arrangement,bark,bilobed,bud,cell,center,colour,corolla,form,growth,height,history,leaf,life,na,new,number,ovary,position,reproduction,scar,seed,shape,spacing,staman,texture,trichome,width
170	wfo-0001027010	invalid_json_followup	198	105	63	135	42	0.318	0.4-5.1,0.5-1.5,1-2,10-60,14-46,2.1-4.3,2.2-12.9,3-10,3-5,4-12,4-8,abaxially,acuminate,acute,adaxially,anther,apex,articulated,brownish,bud,cell,clavate,cm,coriaceous,corolla,deep,diameter,drying,elliptic,filament,flower,forked,fruit,glabrescent,glabrous,green,greenish,herb,leaf,light,mm,mucilaginous,occasionally,odd-pinnate,ovate,ovoid,pedicel,peduncle,pentagonal,petiole,plant,purple,rotate,scabrous,seed,stigma,stripe,style,terminal,wet,white,whitish,yellow	0-2,0-2.5,0-3,1-10,1-4,1-7,1.2-1.7,1.2-1.9,1.4-6.9,2-6,2-9.4,2.1-15.3,3-6,3-8,3.5-13.6,4.4-29,4.9-31,5-13,5-14,5-merou,acumen,adaxiall,ag,along,alyx,apart,apparently,arranged,asymmetric,attenuate,axe,axillary,base,basiscopic,bead,blade,capitat,coloration,condition,connivent,covering,decreasing,digestion,distal,dorsally,eaf,edge,eed,enzyme,erec,exceeding,flat,folded,fresh,geminat,generally,glabrescen,glabrou,green-white,hair,hair-like,hal,half,high,homostylous,honeycomb-shaped,interjected,lanceolate,larger,lateral,leaflet,lengthening,like,living,lobe,long,lower,make,moniliform,multiple,narrow,necklace,nflorescence,orbicular,orolla,pair,perfect,petiolulate,plurifoliate,pore,poricidal,present,removed,ripe,rounded,ruit,scabrou,sessile,seudostipule,short,side,size,slightly,slit,sometimes,spaced,specimen,spot,stamen,stolon,straight,subequal,subtending,tall,tamen,tem,testal,thick,throughout,tip,tissue,toward,tri-,tube,tuber,typically,unit,usually,vary,wall,wide,wing,winged,x,ympodial	'',[,``,abaxial,adaxial,arrangement,bark,calyx,capitate,center,characteristic,colour,form,fruiting,growth,height,history,inflorescence,length,life,margin,na,new,number,ovary,perennial,position,prickle,rachi,reproduction,scar,shape,spacing,staman,stem,surface,texture,trichome,value,width,{,}
171	wfo-0001027019	success	142	95	62	80	33	0.437	0-0.5,0.5-1,1-1.5,1.5-2,1.5-3,2-8,4-5,abaxial,acute,anther,apex,bark,branched,bright,calyx,capitate,cm,corolla,cyathiform,densely,filament,flattened,fleshy,fruiting,glabrous,globose,golden,green,inflorescence,leaf,lobed,minutely,mm,obovate,opposite,ovary,overlapping,ovoid-reniform,pale,pedicel,petiole,pitted,plant,pubescent,scar,shrub,small,somewhat,spaced,sparsely,stem,stigma,style,surface,tan,tapering,tree,trichome,waxy,white,winged,x	.5,/4,1-2,1/2,10,10-40-flowered,12-30,2-3,2-5,4-8.5,7-14,abaxially,abruptly,adaxially,along,anthesi,apparent,attenuate,ba,base,berry,constriction,deflexed,deltoid,dia,difoliate,distal,eaf,edicel,eed,ellipsoid,elliptic,erect,even,exserted,free,geminat,glabrate,inflorescenc,largely,later,like,live,lobe,lon,long,lower,major,midrib,minor,narrowed,nflorescence,older,onto,papillo,papillose,planar,pore,poricidal,portion,reddish-brow,rest,ruit,shaped,straight,strongly,tall,tear-drop,third,tip,tub,tube,ud,unit,way,widest,wing,woody,ympodial,young	10-40,adaxial,alternate,arrangement,bud,cell,center,colour,dense,diameter,flower,form,fruit,growth,height,history,length,life,na,new,number,peduncle,perennial,position,rachi,reddish-brown,reproduction,seed,shape,spacing,staman,texture,width
172	wfo-0001027030	invalid_json_followup	234	118	82	152	36	0.35	-11,-15,.5,0.2,0.2-0.3,0.6-0.7,0.7-1,0.8-0.9,0.8-1,1,1-3,1.6-2,2-7,abaxial,acute,anther,apex,articulated,base,berry,branched,bright,brown,calyx,capitate,cell,cm,conical,corolla,crenate,dark,deeply,densely,diameter,distal,elliptic,entire,filament,flower,fruit,fruiting,globose,green,hair-like,half,herb,imparipinnate,inflorescence,interrupted,interspersed,investing,like,long,loosely,margin,minutely,mm,narrowly,obovate,outgrowth,ovary,pale,paler,papillate,pedicel,peduncle,perennial,petiole,pubescent,rotate-stellate,simple,soft,sometimes,sparsely,stem,stigma,style,surface,trichome,uniseriate,velvety,yellow	.2,0-4,0.05-0.1,0.1-0.7,0.1-0.9,0.15-0.2,0.2-1,0.3-,0.3-0.5,0.3-0.7,0.4-0.5,0.4-0.8,0.4-1.5,0.5,0.5-,0.5-0.7,0.5-0.8,0.5-1,0.6-0.8,0.6-1.8,0.9-1.1,1-,1-1.2,1-1.3,1-3.4,1.2-1.6,1.5-,2-,2-3,2-4,2-4.8,2-6,2-foliate,2-locular,2.2-3.2,3-4-celled,3-8,3-9,4-celled,5-12,8-celled,abaxially,absent,abundant,acuminate,adaxially,adpressed,angled,anthesi,apical,appearance,appendage,articulation,axi,basal,basiscopically,beneath,beyond,bract,column,crenat,crenation,darker,decurrent,deeper,denser,diamete,due,eaf,edicel,eed,eglandular,evenly,exserted,extremely,giving,gland,glandular,grayish,gree,growt,hal,halfway,interjected,internode,irregularly,lamina,lanceolate,larger,lateral,leaflet,less,lobe,lon,longer,lower,multicellular,near,nflorescence,node,oblique,occasionally,often,pair,petiolule,present,primary,pseudostipule,pubescence,reflexed,robust,ruit,secondary,sessile,silky,similar,size,slender,slightly,small,smaller,somewhat,spread,spreadin,spreading,staminal,sterile,straight,stripe,tall,tem,terminal,tertiary,testa,thick,tiny,trailing,truncate,tube,ud,unicellular,unit,usually,vein,wall,weak,white,wide,winged,woody,ympodial,young	'',1-4,2-9,[,``,adaxial,arrangement,bark,bud,center,characteristic,colour,form,growth,height,history,leaf,length,life,na,new,number,plant,position,prickle,reproduction,scar,seed,shape,spacing,staman,texture,value,width,{,}
173	wfo-0001027035	success	199	121	97	102	24	0.487	0-36,0.1-0.9,0.3-2.3,0.4-12.8,0.8-4.2,1-2,1.7-8,1.8-5.2,10-80,2-38,2-7,3-10,3-5,4-18.5,acuminate,acute,along,anther,apex,axillary,base,bead,blue,brownish,bud,cell,clavate,cm,coloration,completely,condition,corolla,covering,decreasing,deep,diameter,drying,elliptic,filament,flower,forked,fresh,fruit,glabrescent,glabrous,globose,green,green-white,greenish,hair-like,herb,interjected,lateral,leaf,leaflet,light,like,lilac,make,medium,mm,moniliform,mucilaginous,necklace,odd-pinnate,orbicular,ovate,ovoid,pair,pedicel,peduncle,pentagonal,petiole,plant,purple,ripe,rotate,seed,shape,size,sometimes,stigma,stolon,stripe,style,subtending,terminal,testal,thick,throughout,toward,tuber,usually,wall,wet,whitish,yellow	0-7,0.5-3.4,0.5-5,0.5-7,0.8-3,0.9-3.1,1-3,1-3.4,1-8,1.5-5.9,2.8-10.3,4-18,4.9-23.5,5-merou,abaxially,acumen,adaxiall,adaxially,ag,alyx,apart,apparently,arranged,articulated,asymmetric,attenuate,axe,basiscopic,blade,capitat,connivent,digestion,distal,dorsally,eaf,edge,eed,enzyme,erec,exceeding,flat,folded,geminat,generally,glabrescen,glabrou,hair,hal,half,high,homostylous,honeycomb,lanceolate,larger,lengthening,living,lobe,long,lower,multiple,nflorescence,orolla,perfect,petiolulate,plurifoliate,pore,poricidal,present,removed,rounded,ruit,second,sessile,seudostipule,shaped,short,side,slightly,slit,smaller,spaced,specimen,stamen,straight,subequal,subglabrous,tall,tamen,tem,tip,tissue,tri-,tube,typically,unit,unwinged,variable,vary,white,wide,x,ympodial	abaxial,adaxial,arrangement,capitate,colour,form,growth,height,history,inflorescence,length,life,na,number,ovary,perennial,position,rachi,reproduction,spacing,staman,surface,texture,width
174	wfo-0001027050	invalid_json_followup	244	135	102	142	33	0.418	-12,-9,/3,0.1-0.3,0.3-1.5,0.5-3,1-2,1.5-6,10-13.5,15-50+,2-4,2-5,2-8,2.5-3,5,5-7,5-9,5-merous,abaxial,acuminate,acute,adaxial,anther,apex,bark,base,branched,broad-based,brown,calyx,capitate,chartaceous,closely,cm,coarsely,conical,curved,deeply,densely,diameter,drying,entire,ferruginous,filament,flattened-reniform,flower,fruit,fruiting,glabrous,green,growth,inflorescence,lateral,leaf,leaf-opposed,length,lobed,long,margin,minutely,mm,moderately,often,pale,pedicel,peduncle,pericarp,petiole,plant,prickle,pubescent,ripe,scar,sessile,several,shallowly,shiny,shrub,slightly,small,spaced,spherical,stellate,stellate-pubescent,stem,stigma,straight,style,surface,terete,time,toothed,touching,tree,trichome,unbranched,way,white,whitish,wide,yellow,yellowish-green	.2,.5,0-0.2,0-3,0.1-3,0.2-0.5,0.2-1,0.8,0.9-2.1,1,1-1.5,1.5-2,12-15,2-2.5,2-3,3-5,4-20,4-8,5-10,5-6,50,6-8,7-30+,8-26,abaxially,absen,absent,abundant,adaxiall,adult,alyx,andromonoeciou,apar,arme,articulated,axe,basal,berry,blade,branch,broad,broadly,brow,connivent,cordate,cuneate,difoliate,directed,distal,distall,distally,eaf,eed,eglandular,elliptic,equal,erec,erect,except,flattened,free,geminat,glandular-puberulent,hair,half,heterostylous,infructescence,inside,interpetalar,juicy,juvenile,lanceolate,larger,least,less,like,lobe,long-styled,longer,lower,markedly,mature,mid-way,midpoint,midrib,midvein,minute,moist,mucilaginous,multiseriate,narrowly,near,nflorescence,numerous,oblique,obtuse,occasionally,older,orolla,oung,ovate,ovate-lanceolate,papillat,per,pore,poricidal,porrect,portion,present,pricklier,prickly,ray,rest,rounded,ruit,scattered,secondary,short-stalked,short-styled,shorter,side,somewhat,sparsely,stalk,stalked,tall,tamen,thicker,tip,tissue,triangular,truncate,tube,unarmed,unit,usually,vary,weakly,woody,ympodial,young,younger	'',[,``,alternate,apart,armed,arrangement,bud,characteristic,colour,corolla,form,height,history,life,na,new,number,ovary,papillate,perennial,position,rachi,reproduction,seed,shape,spacing,staman,texture,value,width,{,}
175	wfo-0001027050	invalid_json_followup	234	127	93	141	34	0.397	0.5-1,0.5-3,1-2,1-5,1.5-2,1.5-6,10-13.5,15-50+,2-10,2-4,2-5,2-8,2.5-3,3-15,5,5-7,5-9,5-merous,accrescent,andromonoecious,anther,apart,apex,base,branched,broad-based,broadly,brown,calyx,chartaceous,cm,coarsely,contiguous,curved,densely,diameter,drying,elliptic,entire,extra-axillary,ferruginous,filament,flattened,flower,forked,fruit,fruiting,glabrous,glandular-puberulent,globose,green,growth,inflorescence,leaf,leaf-opposed,length,lobed,margin,minutely,mm,moderately,nearly,often,ovate,pale,pedicel,peduncle,petiole,pitted,plant,prickle,rachi,shallowly,shrub,simple,slightly,small,spaced,stellate,stellate-pubescent,stem,stigma,straight,style,surface,toothed,tree,unbranched,white,whitish,x,yellow,yellowish-green	.2,0-0.2,0-0.5,0-1,0-3,0.1-3,0.2-0.6,0.2-1,0.3-0.6,0.4-1,0.5-0.8,0.8,1-1.5,10-30,11-21,12-15,14-20,16-40,2-2.5,2-3,2-3-locular,2-6,2-foliate,23-40+,3-5,4-19,4-40,4-8,5-10,5-6,6-8,7-30+,8-26,8-40+,abaxially,absen,absent,abundant,across,acuminate,acute,adaxiall,adaxially,adult,anvil-shape,armed,articulated,axe,ba,blade,branche,capitat,connivent,cordate,cross-section,cuneate,cylindrical,deeply,directed,distall,distally,distributed,eaf,eed,eglandular,erect,except,exocarp,functional,geminat,hair,half,held,interpetalar,juicy,juvenile,lanceolate,lateral,less,like,lobe,long,longer,lower,markedly,mature,mesocarp,midpoint,midvein,minute,moist,mucilaginous,multiseriate,narrowly,nflorescence,oblique,obtuse,orolla,ovate-lanceolate,pair,per,pinnatifid,placenta,pore,porrect,present,ray,rounded,ruit,scattered,sessile,shorter,side,somewhat,sparsely,stalk,stalked,stellae,tal,tamen,tem,thick,thicker,throughout,time,tip,tissue,triangular,truncate,tube,unarme,unarmed,unit,upper,upright,usually,vary,weakly,wide,ympodial,younger	'',[,``,abaxial,adaxial,arrangement,bark,bud,capitate,center,characteristic,colour,corolla,form,height,history,life,na,new,number,ovary,position,reproduction,scar,seed,shape,spacing,staman,texture,trichome,value,width,{,}
176	wfo-0001027067	success	228	113	83	145	30	0.364	0-1.8,0-6,0-7,0.3-1,0.5-2,0.8-1,1.7-3.3,2-10,2-3,3-6,4-5.5,6-10,7-16,abaxial,accrescent,acicular,acute,adaxially,anther,apex,articulated,base,black,broadly,brown,calyx,chartaceous,cm,dark,deeply,densely,diameter,extra-axillary,filament,flattened,flower,fruit,fruiting,glabrous,globose,green,hair,inflorescence,leaf,length,lobed,margin,mm,obtuse,ovate,pale,pedicel,peduncle,perennial,petiole,plant,prickle,pseudo-racemose,purple,rachi,rhizomatous,rotate,scattered,shrub,simple,slightly,somewhat,sparsely,stellate,stellate-pubescent,stem,stigma,straight,streak,style,thick,throughout,truncate,twisted,white,yellow,yellowish,yellowish-green	%,.05,0-0.1,0-0.2,0-0.5,0-12,0.2-0.4,0.35-0.5,0.4-0.5,0.4-0.7,0.5-1,0.5-1.5,0.9-2.5,1-2,1-4,1-7,1.2-1.4,1.4-2.5,1.5-2,1.7-2.8,11-16,11-20,13-65,15-27,15-60,2-4.5,2-7,2-foliate,2-locular,2.5-3.8,2.5-4,2.7-5,2.9-3.7,20-45,20-50,20-65,3-10,3-4,3-5,3.5-5.5,3.5-9,4-9,5-12.5,5-6,5-9.5,5-merou,5.5-12.5,6-7,6-8,7-11,7-8,8-14,abaxially,absent,abundant,across,adaxiall,adult,alyx,andromonoecious,apart,armed,attenuate,axe,ba,bilobe,blade,broad-based,connivent,cuneate,curved,cylindrical,decimetr,directed,distall,dult,eaf,eed,eglandular,erect,exocarp,finally,finger,firm,functional,geminate,gland-tipped,grey,half,heterostylous,hig,index,interpetalar,juic,juvenile,lanceolate,lateral,less,lobe,lobing,lon,long,longer,lower,mature,mesocarp,mid-point,midpoint,midvein,minute,moist,nflorescence,oblique,orolla,papery,part,per,pink,pore,porrect,presen,present,ray,ruit,sessile,short,side,skin,spaced,sprawling,stalk,stellae,tamen,time,tissue,transparent,tube,unbranched,unit,vary,vein,weakly,wide,x,ympodial	5-merous,adaxial,arrangement,bark,bilobed,bud,cell,center,colour,corolla,form,growth,height,history,life,na,new,number,ovary,position,reproduction,scar,seed,shape,spacing,staman,surface,texture,trichome,width
177	wfo-0001027069	success	200	141	114	86	27	0.57	0-4,0.15-0.8,0.2-3,0.5-1.5,0.5-5.5,0.8-3.3,1-10,1-2.5,1-7.7,1.5-6,10-25,2-6,2.5-12,3-11,3.5-6,4-9,7-10,abaxially,acuminate,acute,adaxially,along,anther,apex,axillary,base,blotch,broadly,brown,brownish,bud,cell,chartaceous,ciliate,cm,condition,corolla,covering,darker,decreasing,diameter,drying,elliptic,elliptical-conical,especially,filament,flower,forked,fresh,fruit,glabrescent,glabrous,green,green-white,greenish,hair,hair-like,herb,honeycomb-shaped,interjected,lanceolate,lateral,leaflet,light,like,make,margin,membranous,midrib,minutely,mm,mucilaginous,narrowly,obtuse,odd-pinnate,ovate,ovoid,pair,pedicel,peduncle,petiole,plant,puberulent,pubescent,purple,rachi,rare,rarely,seed,short,simple,size,sparsely,stellate,stem,stigma,stripe,style,subequal,subtending,terminal,testal,thick,throughout,tip,toward,typically,unequal,vertical,wall,wet,white,whitish,yellow	0.5-5,1-2,1-5,1.5-12,1.5-3,1.5-5,2-5,3-19,4-8,5-merou,acumen,ag,alyx,apart,apparently,articulated,axe,berry,blade,borne,capitat,connivent,cordate,cuneate,decurrent,digestion,distal,dorsally,eaf,edge,eed,end,enzyme,erect,exceeding,flat,folded,geminat,generally,glabrou,half,homostylous,lax,lengthening,linear,living,lobe,long,lower,middl,nflorescence,orolla,perfect,petiolule,plurifoliate,pore,poricidal,pubescen,removed,ruit,seudostipule,singly,slightly,slit,sometimes,spaced,specimen,stamen,ste,stolo,straight,tall,talle,tamen,tem,tri-,truncate,tube,tuber,unit,unwinged,usually,vary,wide,x,ympodial	abaxial,adaxial,arrangement,capitate,colour,form,frequency,growth,height,history,inflorescence,leaf,length,life,na,number,ovary,perennial,position,pseudostipule,reproduction,shape,spacing,staman,surface,texture,width
178	wfo-0001027091	success	142	103	65	77	38	0.458	.3,0.7,1-1.6,1.1-1.6,1/2-2/3,2.5-3.5,3-8,3-9,5-11,6-10,9-13,accrescent,annual,anther,armed,blade,blue,bristly,broadly,brown,calyx,capitate-glandular,cauline,cm,dark,densely,dm,glabrous,glandular,green,hair,herb,internodal,lenticular,lobe,long,longer,low,mm,mostly,obtuse,occasionally,oriented,ovate,pedicel,petiole,pinnatifid,prickly,radially,reticulately,ridge,rounded,simple,sparsely,spherical,stellate-pentagonal,stem,surface,terete,twice,undulate,uniseriate,vestiture,violet,wrinkled	0.8,1.8-2.6,2.3-2.9,30-60,4-10,6-10-flowere,8.5-11.5,across,acute-tipped,along,alyx,anthesi,arcuate,base,beneath,berry,branched,campanulate,deltoid,developing,dia,difoliate,divided,dry,eaf,eed,enveloped,extended,few-rayed,fully,geminat,gland,high,invested,linear-lanceolate,lon,main,maturity,narrowly,near,nflorescence,orolla,per,pinnatisect,ruit,scattered,sessile,short,short-stipitate,slende,sometimes,somewhat,splitting,spreadingly,ste,stellae,strait,suffused,tamen,tapering,taprooted,terminally,tightly,tigma,tub,tube,tyle,unexpande,unit,usually,variously,vary,vein,wholly,yello,ympodial,younger	6-10-flowered,abaxial,adaxial,apex,arrangement,colour,corolla,diameter,filament,flower,form,fruit,fruiting,growth,height,history,inflorescence,leaf,length,life,na,number,ovary,peduncle,plant,position,rachi,reproduction,seed,shape,spacing,staman,stigma,style,texture,unexpanded,width,yellow
179	wfo-0001027102	success	167	100	74	93	26	0.443	.5,0.2-2,0.5-1,0.5-2,1-1.5,1-2.5,1-4,1-6,1.5-2,10-20,15-35,3,3-4,4-5,abaxially,acuminate,acute,adaxial,adaxially,anther,apart,apex,base,chartaceous,ciliate,cm,cuneate,curved,densely,diameter,difoliate,elliptic,entire,filament,flattened,flower,forked,fruit,glabrous,globose,hair,lanceolate,leaf,leaf-opposed,long-tapered,margin,mm,moderately,narrowly,orange,pedicel,peduncle,petiole,pubescent,rachi,rarely,ripe,rugulose,shrub,simple,slender,somewhat,stellate,stem,stigma,style,surface,truncate,unbranched,unit,white,x,yellow,yellow-brown	.5-6,0.5,0.5-3,1-2,1-3,15,2-2.5,2-3,3-12,3-5,4-7,5-12,<,absen,absent,accrescent,acuman,adaxiall,ag,aggregate,almost,alyx,appearance,articulated,axe,ba,blade,broad,broadly,calyx,cell,channe,congested,connivent,corky,cylindrical,deltate,differing,dimorphic,directed,distally,eaf,eed,few-,free,fruiting,geminat,giving,ilament,lobe,long,longitudinal,m.,major,minor,multiseriate,nflorescence,oblong,obtuse,often,one,opening,orolla,ovate,per,perfect,pore,portion,roughened,ruit,short,size,slit,small,spaced,sparsely,stone,straight,subcoriaceous,tal,tem,time,tip,tomentose,triangular,truncat,tube,unarme,usually,vary,wide,ympodial,young	abaxial,arrangement,colour,corolla,form,geminate,growth,height,history,inflorescence,length,life,na,number,ovary,perennial,plant,position,reproduction,seed,shape,spacing,sympodial,texture,trichome,width
180	wfo-0001027104	invalid_json_followup	141	104	59	82	45	0.418	0.15-0.35,1-3,1-4,1.2-6,1.5-2.3,10-15,3-5.5,4-15,6-7.5,acuminate,acute,apex,articulate,branched,calyx,cell,cm,corolla,covering,cyme,diameter,dichasial,dichasially,distal,ebracteate,filament,finely,flower,globose,green,green-white,half,herbaceous,lateral,mm,monochasial,odd-pinnate,ovate,ovoid,pedicel,peduncle,perennial,petiole,plant,proximal,pubescent,seed,stellate,stigma,style,testal,thick,throughout,tone,wall,white,yellow,yellow-green,¼	0.5-0.8,1-1.5,1.5-4.2,2-3,2-6,2.2-5,3-6-foliat,5-15,abaxially,acumen,adaxially,apical,apically,attenuate,base,condition,connate,cordate,dehiscent,digestion,dorsally,eaf,edge,eed,emoval,enzyme,epiphyti,epiphytic-like,exceeding,flat,folded,forked,generally,globo,growing,hair-like,honeycomb,introrse,linear,living,lobe,lon,long,lower,make,maturing,mos,mucilaginous,mucronate,narrowly,nflorescence,nther,often,orolla,ovat,pattern,perfect,plan,poricidally,rarely,reveal,ruit,seudostipule,short,simple,slit,specimen,stamen,straight,tall,tem,terrestrial,throughou,truncate,tuber-bearing,typically,unit,vary,viole,wide,without,ympodial	'',[,\u201chair-like\u201d,``,abaxial,adaxial,anther,arrangement,bark,bud,center,characteristic,colour,form,fruit,fruiting,growth,height,history,inflorescence,leaf,length,life,margin,na,new,number,ovary,position,prickle,rachi,reproduction,scar,shape,spacing,staman,stem,surface,texture,trichome,value,violet,width,{,}
181	wfo-0001027114	invalid_json_followup	154	101	60	94	41	0.39	-2,.5,1-1.1,1-1.5,1-2,1.5-2,2-3,20-40,3-4,3-7,6-8,abaxial,acute,adaxially,along,anther,apex,bark,branched,calyx,capitate,cm,conical,corolla,dark,dendritic,elliptic,filament,flattened-reniform,fruiting,glabrous,globose,green,inflorescence,leaf,lobed,long,main,margin,minutely,mm,opposite,ovary,pedicel,petiole,pitted,pubescent,reddish,reddish-brown,scar,shoot-terminal,shrub,stem,stigma,style,surface,tapering,trichome,vein,white	-17,-30,0.5-1,1-1.2,1.5-1.7,1/2,13-21,2-2.5,5,6-9,7-10,7-9,abaxially,alternating,anthesi,apar,appearing,axillary,ba,base,berry,bushy,closely,commonly,deltate,densely,dia,differing,difoliate,drying,due,eaf,edicel,eed,erect,exserted,flowered,free,geminate,glabrou,growt,halfway,inflorescenc,investing,lamina,lateral,like,lobe,lon,lower,major,many,minor,minute,nflorescence,occasionally,older,opening,pair,papillo,planar,plurifoliate,pore,poricidal,portion,projection,rapid,rest,ruit,scattered,several,shoot,simple,size,slit,soft,spaced,tall,thickened,time,tip,triangular,tub,tube,ud,unevenly,uniseriate,unit,way,wide,woody,yellowish,ympodial,young	'',0.5,[,``,alternate,apart,arrangement,bud,cell,center,characteristic,colour,diameter,flower,form,fruit,growth,height,history,length,life,na,new,number,papillose,peduncle,perennial,plant,position,prickle,rachi,reproduction,seed,shape,spacing,staman,texture,value,width,{,}
182	wfo-0001027117	invalid_json_followup	235	130	92	143	38	0.391	0-5,0.1,0.1-0.7,0.5,0.5-1.5,0.6-0.9,0.7-1.5,1-2,1-4,1.5-2.3,10-20,2-3,2-8,3-15,4.5-6.5,5-merous,abaxially,accrescent,acicular,acute,almost,anther,apex,articulated,bark,base,berry,black,brown,calyx,cell,cm,dark,densely,diameter,enclosing,erect,evenly,filament,fine,flattened-reniform,flower,fruit,fruiting,glabrescent,glabrous,green,herb,lateral,leaf,length,less,lobed,margin,mature,maturity,mauve,mm,moderately,outline,pale,pedicel,peduncle,perpendicular,petiole,pit,porrect,prickle,raised,red-brown,rounded,scar,sessile,shallowly,shiny,small,smooth,sparsely,spherical,stalked,staman,stellate,stellate-pubescent,stem,straight,style,surface,terete,trichome,yellow,yellow-green,young	-1.5,-11,-12,-2.8,-3/4,.5,/3,0-10,0-15,0-20,0-25,0-40,0.1-,0.15-0.25,0.15-0.35,0.2,0.2-0.45,0.7-0.9,0.7-1.3,0.8-,1-6,1.2,1.5-,1.5-6.5,1.7-2.5,1.8-2.5,1/,1/3,1/4,1/8-1/2,2-6,2.3-2.8,25-100,3-10,3-6,4-6.5,4-7,4-8,4.5-8,5-11,5-14,6-10,6-9,7-,8,alyx,ame,apar,apart,apically,apparently,attenuate,beyond,blade,branched,brittle,c.,chartaceous,concolorous,connivent,cordate,curved,deltate,discolorous,distance,drying,eaf,eed,elongating,extending,fifth,four,free,gently,gra,herbarium,infructescence,irregularly,lobe,lon,long,long-acuminat,longer,lower,membranous,midpoint,midvein,narrow-deltate,narrow-elliptic,narrow-lanceolate,nflorescence,oblong,obovate,older,one,open,orolla,oung,ovate,pair,pendulous,per,perfec,pericarp,plurifoliat,poricidal,portion,prickl,prickly,primary,ray,reduced,reflexed,ruit,shorter,side,sometimes,spaced,specimen,spreading,stalk,tamen,tapering,tearing,tertiary,time,tip,tissue,translucent,tube,unequal,unit,upper,variously,vary,vein,venation,visible,way,weakly,wide,woody,ympodial	'',[,``,abaxial,adaxial,arrangement,bud,center,characteristic,colour,corolla,form,gray,growth,height,history,inflorescence,life,na,new,number,ovary,perennial,perfect,plant,plurifoliate,position,rachi,reproduction,seed,shape,spacing,stigma,texture,value,width,{,}
183	wfo-0001027123	invalid_json_followup	181	123	90	91	33	0.497	-10,-20,0.5,0.8-1.3,1,1-1.2,1-1.5,1.5-2,2-2.6,2-5.5,2-lobed,2.5-4,2.5-6,3-15,5-6,abaxial,acute,adaxial,adaxially,anther,apex,bark,branched,bright,brown,calyx,clavate,cm,commonly,conical,coriaceous,corolla,cup-shaped,dark,dendritic,densely,diameter,elliptic,exerted,filament,flattened,flower,fruiting,glabrous,globose,green,inflorescence,leaf,less,loosely,margin,mauve-purple,minutely,mm,narrowly,ovary,papillate,pedicel,peduncle,petiole,pitted,pubescent,reddish,reniform,revolute,scar,shining,shiny,simple,soon,spaced,sparsely,stellate,stem,stigma,stoutish,strongly,style,subshrub,surface,terminal,thick,trichome,tube,turned,violet,white,widely,x,young	.3,.5,0.3-1.6cm,0.5-0.8,0.7-3.5,0.9-1.3,2-2.2,2-2.5,2-3,2.5-10.4,3-4,4-5,4-6,5-10,along,anthesi,appearing,attenuate,axe,axi,base,broadly,campanulate,cell,completely,constricted,darker,deltate,denser,drying,eaf,edge,eed,enlarged,erect,fide,free,glandular,inserted,lamina,lax,lewi,like,lobe,lobed,lon,long,loose,lower,midvein,minute,monopodia,nflorescence,nodding,older,outline,pair,papillae,perfect,perhaps,petal,planar,plurifoliate,portion,primary,prominent,scatted,scattered,shin,shinin,short,sinuate,sleeve,slightly,sometimes,straight,testal,time,tip,trailing,tub,ud,unit,upper,usually,vein,warty,way,wood,ympodial,¾	'',0.3-1.6,[,``,arrangement,bud,characteristic,colour,form,fruit,growth,height,history,length,life,na,new,number,perennial,plant,position,prickle,rachi,reproduction,seed,shape,spacing,staman,texture,value,width,{,}
184	wfo-0001027125	success	155	87	54	101	33	0.348	0,0.5,1,abaxially,adaxially,anther,anthesi,apex,armed,blue,branched,brown,clavate,cm,coriaceous,corolla,diameter,ellipsoid,elliptic,elongating,filament,flattened,fleshy,flower,foveolate,fruit,glabrous,globose,green,light,mm,mostly,narrowly,oblong,pedicel,peduncle,petiole,prickle,rachi,recurved,rugose,simple,slender,somewhat,spreading,stigma,strongly,style,surface,terminal,thick,vine,yellow,×	.5,/4,0.3,0.3-0.6,0.8,1.2-2,10–,10–15,12,12–17,1–,25–50,3,3–,3–10,3–5,3–7,4,4–6,5,50,5–10,5–7,6,6–,6–9,?,absent,acuminate,acute,ag,alyx,apiculate,articulated,axe,ba,base,becoming,bilobe,blade,bud,calyx,campanulate,clustered,completely,connivent,cucullat,deeply,dr.,eaf,eed,entire,equal,exserted,internode,lateral,lengthening,lobe,lobed,long,long-styled,lower,major,margin,middle,midrib,minutely,nflorescence,orolla,papillate,plurifoliat,pore,poricidal,recurve,robust,rounded,ruit,side,slit,stellate,stem,stout,subwoody,tamen,terminally,thickened,time,tip,triangular,truncate,tube,unit,vary,vein,way,wide,widest,woody,ympodial,youn,–9	1-3-7,10-15,10-25-50,3-5,3-5-10,4-6,abaxial,adaxial,arrangement,bilobed,colour,dry,form,growth,height,history,inflorescence,leaf,length,life,na,number,ovary,perennial,plant,position,reproduction,seed,shape,spacing,staman,texture,width
185	wfo-0001027131	success	186	96	65	121	31	0.349	0.7-2.5,0.9-2.5,1-1.5,1-4,1.5-3.3,12-20,2-5,4-10,5.5-6.5,9.5-11.5,abaxially,adaxially,andromonoecious,anther,apex,black,brown,calyx,cm,cordate,dark,densely,diameter,entire,erect,extra-axillary,flower,fruit,fruiting,globose,green,grey,inflorescence,length,margin,mm,obtuse,ovate,pale,pedicel,peduncle,perennial,petiole,plant,prickle,pseudo-racemose,purple,rhizomatous,ridged,rotate,rusty,shrub,simple,stellate-pubescent,stem,straight,streak,style,terete,thick,weakly,white,yellow,yellowish,yellowish-green	%,.05,.7,0-0.1,0-0.3,0-2,0-3,0-5,0.2-2.2,0.4-0.8,0.4-1,0.5-0.8,0.5-1,1-1.2,1-2,1-3,1.4-2,1.7-3.5,17-35,2.3-2.7,2.6-3,3-4,3-9,4-7,4-8,4-locular,4.5-8.5,5-merou,7-11,7-8,7-9,absen,absent,across,acute,adaxiall,alyx,anvil-shape,apart,articulated,ascending,attenuate,axe,ba,base,blade,broad-based,chartaceous,circular,cross-section,cylindrical,d.,directed,distall,distally,distributed,dult,eaf,eed,eglandular,elliptical,exocarp,finger,functional,geminat,gland-tipped,hair,half,heterostylous,hig,juicy,lamina,lateral,less,lobe,long,longer,lower,markedly,mature,mesocarp,mid-point,midpoint,minute,moist,nflorescence,oblique,onl,orolla,part,per,placenta,plurifoliate,pore,porrect,possibly,present,ray,ruit,short,spaced,stage,stalk,stalked,stellae,tamen,thicker,thicknes,throughout,time,tube,unarme,unarmed,unbranched,unit,unknow,uvenile,vary,wide,x,ympodial	arrangement,bark,bud,cell,center,colour,corolla,filament,form,growth,height,history,leaf,life,na,new,number,ovary,position,rachi,reproduction,scar,seed,shape,spacing,staman,stigma,surface,texture,trichome,width
186	wfo-0001027146	success	213	114	84	129	30	0.394	0.3-2.2,1-10,1-2,1-9.5,13-36,2-4.2,3.3-6.1,4-12.5,4-38,6-10,6-17.5,abaxially,adaxially,anther,apex,apparently,articulated,attenuate,brownish,cell,clavate,cm,coarsely,condition,conical,corolla,covering,dark,deep,diameter,drying,edge,elliptic,especially,filament,finely,flat,flower,forked,fresh,fruit,glabrous,green,green-white,greenish,hair-like,herb,lateral,leaf,medium,minute,minutely,mm,moniliform,odd-pinnate,ovate,ovoid,pedicel,peduncle,pentagonal,perfect,petiole,plant,puberulent,pubescent,purple,ripe,rotate,seed,stigma,style,terminal,testal,thick,throughout,tinged,tip,tuber,violet,wall,wet,white,whitish,yellow	0-11,0.5-3.2,0.6-3.3,0.7-2.4,0.8,0.8-3.1,0.8-5.8,1-2.5,1.9-10,10,2-12.2,2-13,2-5,3.5-22,4-11,4-8,5-merou,6,6.5-52,acumen,acuminate,ag,along,alyx,apart,arranged,asymmetrical,axe,axillary,base,basiscopic,bead,berry,blade,bud,capitat,chartaceous,ciliate,commonly,connivent,darker,decreasing,digestion,distal,dorsally,eaf,eed,enzyme,erec,exceeding,folded,fourt,fourth,geminat,generally,glabrou,gradually,hair,half,homostylous,honeycomb-shaped,interjected,lanceolate,leaflet,lengthening,like,living,lobe,long,lower,make,margin,membranous,midrib,mottled,mucilaginous,multiple,necklace,nflorescence,orbicular,orolla,pair,petiolule,plurifoliate,pore,poricidal,proximal,rarely,ray,removed,ruit,secondary,semierect,sessile,seudostipule,side,simple,size,slit,sometimes,spaced,specimen,stamen,ste,stem,stolon,straight,subequal,subglabrou,subglabrous,subsessile,subtending,symmetrical,tall,tamen,tem,tissue,toward,tri-,tube,typically,unit,unwinged,usually,vary,wide,wing,x,ympodial	0-10,0-6,abaxial,adaxial,arrangement,capitate,ciliation,colour,form,growth,height,history,inflorescence,length,life,mucilaginousnes,na,number,ovary,perennial,position,pseudostipule,rachi,reproduction,shape,spacing,staman,surface,texture,width
187	wfo-0001027154	success	215	111	71	144	40	0.33	.5,0.2,0.4-0.5,1-1.3,2-6,26,anther,apart,apex,attenuate,calyx,chartaceous,clavate,cm,densely,diameter,extra-axillary,filament,flattened,flower,foveolate,fruit,fruiting,globose,green,highly,immature,leaf,length,margin,mature,minutely,mm,outline,ovate,pedicel,peduncle,petiole,plant,prickle,pubescent,rachi,recurved,reflexed,reniform,rotate-pentagonal,rounded,sessile,shape,shrub,simple,slightly,sometimes,stellae,stellate-tomentose,stem,stigma,straight,style,sulcate,surface,tan,tardily,tomentose,unknown,variable,white,x,yellow,yellowish,–4	-15,-16,.2,.6,0,0.3–0.6,1.5–2.5,1.5–3,1.9,17–19,1–2,2,2.5-5,2.9,23,2–2.5,2–4,3-7,35,3–10,4.5–5,4.5–8,4–8,5,6–8,6–9-rayed,7.5-11,7–20,8,8-11,abaxially,absent,accrescent,acute,adaxiall,adaxially,ag,alyx,ample,armed,articulated,axe,ba,basal,base,berry,blade,branch,branched,broad,broad-based,capitat,color,connivent,curved,cylindrical,deltate,difoliate,directed,distally,eaf,eed,entire,evidently,except,ferruginous,finer,flowering,free,geminat,glabrescen,glabrous,hair,ilament,interpetalar,irregularly,juvenile,lanceolate,larger,less,lighter,like,linear,lobe,lobed,lognitudinal,long,m.,major,midpoint,midrib,minute,mostly,much,near,nearly,nflorescence,normally,oblique,often,older,opening,orolla,paler,part,per,perfect,pinnately,pore,rarely,ray,reaching,repand,ruit,shiny,side,sinus,size,slit,smaller,spaced,sprout,ste,stipe,stipitate,stout,tal,tem,third,three,tissue,truncate,tube,unarme,unarmed,underside,uniform,unit,usually,vary,vein,within,ympodial,young	1-2,1.5-2.5,1.5-3,10,17-19,2-2.5,2-4,4-8,4.5-5,abaxial,adaxial,arrangement,bark,bud,capitate,cell,center,colour,corolla,form,glabrescent,growth,height,history,inflorescence,life,na,new,number,ovary,perennial,position,reproduction,scar,seed,spacing,staman,texture,trichome,width
188	wfo-0001027157	invalid_json_followup	207	122	80	127	42	0.386	0.15-0.3,0.9-2.8,1,1-10,1-2,1.5-6.5,10-30,2,2-15,2-3,3-12,4-5,9-12,abaxially,adaxially,anther,apex,articulated,broadly,brownish,bud,cell,chartaceous,clavate,cm,condition,conical,cordate,corolla,covering,decurrent,deeply,diameter,drying,elliptic,filament,flower,forked,fresh,fruit,glabrous,green,greenish,herb,homostylous,lateral,leaf,margin,membranous,minutely,mm,oblique,odd-pinnate,ovate,ovoid,pedicel,peduncle,petiole,plant,puberulent,pubescent,ripe,rounded,seed,slightly,sometimes,stellate,stem,stigma,style,subsessile,terminal,testal,thick,tinged,violet,wall,white,whitish,yellow	0-3,0.7-2,1-3,1-3.8,1-6,2-2.5,2-5,2.3-4,2.5-3,3-7,3.3-7.8,3.8-8.3,5-merou,6.5-14.5,absent,acumen,acuminate,acute,ag,along,alyx,among,apart,apparently,attenuate,axe,axillary,base,berry,blade,capitat,ciliate,connivent,cuneate,decreasing,densely,digestion,distal,dorsally,eaf,edge,eed,end,enzyme,erec,especially,exceeding,flat,folded,geminat,generally,glabrou,grassland,greatly,green-white,hair,hair-like,half,honeycomb-shaped,interjected,lanceolate,leaflet,lengthening,like,living,lobe,long,low-growing,lower,make,markedly,middl,midrib,mucilaginous,narrowly,nflorescence,obtuse,one,orbicular,orolla,pair,perfect,petiolulate,petiolule,placed,plurifoliate,pore,poricidal,rarely,removed,ruit,semi-rosette,sessile,seudostipule,shady,short,situation,size,slit,spaced,specimen,stamen,ste,stolo,straight,subtending,sunny,tall,tamen,tem,throughout,tip,toward,tri-,tube,tuber,typically,unequal,unit,unwinged,usually,vary,wet,wide,woodland,x,ympodial	'',5-merous,[,\u201chair-like\u201d,``,abaxial,adaxial,arrangement,bark,calyx,capitate,center,characteristic,colour,form,fruiting,growth,height,history,inflorescence,length,life,na,new,number,ovary,perennial,position,prickle,rachi,reproduction,scar,shape,spacing,staman,surface,texture,trichome,value,width,{,}
189	wfo-0001027184	success	219	93	67	152	26	0.306	.3,.5,.7,0-0.2,0.2-0.4,0.4-2,0.5-2,0.8,abaxially,anther,articulated,axillary,base,blue,brown,chartaceous,cm,covered,diameter,elliptic,epidermal,extension,filament,flattened,fleshy,flower,fruit,glabrous,globose,hairlike,herbaceous,imparipinnate,leaf,light,membranous,meter,minutely,mm,narrowly,orange,ovate,pedicel,peduncle,petiole,pilose,prominently,puberulent,pubescent,rachi,red,reticulate,ripe,several,shape,slightly,sparsely,stellate,stigma,style,surface,tip,unbranched,vine,wall,white,x,yellow	.8,0-,0.4–0.9,0.8–1.6,0–3,1-2,1.5,1.5-5,1.8–3.5,13–18,19,1–2,1–2.5,1–4,2,2.8–4.1,2–4-celled,3-4-,3-foliolate,3.5–8,3–,3–4-celled,4,4–12,5,5-7,7,9,absent,accrescent,acute,adaxiall,adaxially,adventitious,ag,along,always,alyx,apart,apex,appressed,axe,axi,ba,basal,blade,borne,bract-like,branch,broad,broadly,calyx,cell,clavat,cluster,connivent,cordat,cylindrical,densely,directed,eaf,eed,entire,especially,fasciculate,foliaceous,free,fruiting,geminat,generally,glabrescent,glabrou,grading,hair,half,ilament,introrsely,lanceolate,larger,largest,lateral,leaflet,leafy,least,less,like,lobe,long,longitudinal,lower,m.,margin,midrib,mostly,much,nearly,nflorescence,node,oblong,obtuse,often,older,opening,opposite,orolla,ower,per,petiolule,plurifoliate,pore,portion,prominent,pseudostipule,raised,rarely,revolute,root,ruit,scarcely,secondary,shoot,short,simple,size,slit,small,soft-woody,somewhat,spaced,stem,straight,subopposite,sulcate,terminal,tertiary,tightly,tree,truncate,trunk,tube,unarme,unequal,uniform,unit,usually,vary,vein,visible,weak,ympodial,young,–9	0-3,1-4,13-18,abaxial,adaxial,arrangement,clavate,colour,corolla,form,growth,height,history,inflorescence,length,life,na,number,ovary,perennial,plant,position,reproduction,seed,spacing,texture
190	wfo-0001027186	invalid_json_followup	168	126	93	75	33	0.554	0.5-1,1-2.5,1.4-1.6,1.5-2,2-6,2-lobed,3.5-4,30-40,4-9,5-10,6-7,abaxial,abaxially,acute,adaxially,always,anther,apart,apex,attenuate,axil,bark,berry,brown,calyx,clavate,cm,conical,corolla,dark,dendritic,densely,denser,diameter,dry,ellipsoid,elliptic,entire,filament,filiform,flower,fruit,fruiting,glabrescent,glabrous,globose,golden,green,growth,lamina,lobed,loose,margin,maturity,minutely,mm,narrowly,new,occasionally,ovary,ovoid,pale,pedicel,peduncle,petiole,pitted,plane,pubescent,rachi,reddish,reniform,scar,scattered,seed,shiny,simple,slightly,sparsely,spreading,stem,stigma,style,surface,terminal,tip,tree,trichome,uniseriate,variably,vein,white,woody,yellow	-6,.4,.5,1-1.5,1.5,1.5-2.5,1.6-5,15,2.5-3,3-4,4-15,9-10,?,age,anthesi,apparently,base,branch,branched,broadly,dbh,deflexed,deltate,denditic,eaf,enlarging,exerted,free,immature,incrassat,irregularly,keeled,lengthening,less,like,lobe,longer,lower,m.,midrib,much,nflorescence,pair,papillat,papillate,pendent,perfect,pericarp,planar,plurifoliat,pointed,pore,poridical,portion,primary,pubescen,rough,ruit,short,slit,small,soon,spaced,stalk,straight,strongly,time,treelet,tub,tube,ud,unit,way,x,ympodial	'',0.5,1,[,``,adaxial,arrangement,bud,cell,center,characteristic,colour,form,height,history,inflorescence,leaf,length,life,na,number,perennial,plant,position,reproduction,shape,spacing,staman,texture,value,width,{,}
191	wfo-0001027187	invalid_json_followup	224	122	74	150	48	0.33	0.6,1.2,5-merous,7,accrescent,anther,apex,blue,broadly,bud,calyx,cm,completely,covering,darker,decumbent,deltoid-ovate,densely,diameter,erect,extra-axillary,filament,finely,flattened-reniform,flower,forked,foveolate,fruit,fruiting,glabrous,globose,green,hair,herb,hermaphroditic,irregularly,leaf,lenticular,light,lobed,margin,maturity,mm,moderately,mottling,obtuse,pedicel,peduncle,perennial,petiole,prickle,pubescent,rotate-stellate,rounded,serrate,sessile,shallowly,short-stalked,simple,sky,sparsely,stellate,stellate-pubescent,stem,stigma,straight,strongly,style,subglobose,surface,tapered,unbranched,yellow,young	.5,0,0.05–0.1,0.15–0.4,0.2,0.3–1,0.4,0.5,0.5–1,0.5–1.5,0.8–2,1,1-celled,1.0,1.5–3.5,12,13–18,1–1.5,1–1.8,1–2,1–3,1–3-celled,2,2-,2.5–4,2.5–6,2–2.5,2–3,2–5,2–7,3-foliate,3.2,3.5–10,3–10,3–10.5,3–6,3–7,4,4.5–8,4–5,5,5.4,5.5,5–10,5–11,5–15,5–6,5–8,6,6–8,7–12,7–15,9,abaxially,acute,acute-acuminate,adaxiall,adaxially,alyx,andromonoecious,apart,armed,articulated,axe,base,berry,blade,branched,capitat,central,chartaceous,connivent,continuum,cordate,cuneate,cylindrical,deflexed,deltate,deltate-lanceolate,directed,distal,distall,downward,eaf,eed,equal,exserted,geminat,glandular-puberulent,grading,lanceolate,lateral,like,lobe,lon,long,long-stalked,lower,major,minutely,morphology,narrowly,nflorescence,node,offset,often,one,open,orolla,outline,perfect,plurifoliate,pore,prickle-like,producing,proximal,rarely,ray,rind,root,rooting,ruit,showing,side,sinus,small,sometimes,spaced,spreading,stalk,staminate,stout,subequal,subsessile,tall,tamen,tem,toug,triangular,truncate,tube,unequal,unit,usually,vary,vein,weakly,wide,ympodial,×	'',0.5-1.5,0.8-2,1.5-3.5,2-3,2-7,3-10,3-7,3.5-10,5-15,7-12,7-15,[,``,abaxial,adaxial,arrangement,bark,capitate,characteristic,colour,corolla,form,growth,height,history,inflorescence,length,life,na,new,number,ovary,plant,position,rachi,reproduction,scar,seed,shape,spacing,staman,texture,trichome,value,width,{,}
192	wfo-0001027198	invalid_json_followup	191	133	95	96	38	0.497	.4,.5,0.05-1.0,0.5-0.75,0.8-1,1-1.5,1-10,1.5-10,3/4,5-6,abruptly,acuminate,acute,anther,apart,apex,axil,base,beneath,broadening,bushy,calyx,channeled,clavate,cm,corolla,cyathiform,decurrent,dendritic,dia,elliptic,entire,eye,filament,flower,fruiting,furcate,glabrous,globose,golden,green,inflorescence,invisible,leaf,like,lobed,long,many,margin,medium,minute,minutely,mm,naked,nearly,obovate,often,opposite,ovary,ovoid,ovoid-reniform,pale,paler,pedicel,petiole,pitted,plant,puberulent,pubescent,rest,scar,shining,short,shrub,simple,size,slender,slightly,small,stem,stigma,style,styled,surface,tannish-yellow,time,tree,trichome,tube,two,uniseriate,vein,way,white,x	0.5-1,0.7-1,1-5,1.5-2,10-11,11-20,2-5.5,4-9,5-120-flowered,7.5-9,always,anthesi,attenuate,ba,beginning,berry,caly,closely,complex,constriction,corky,corresponding,deltoid,densely,differing,difoliate,dry,eaf,edge,edicel,eed,erect,evenly,exserted,extremely,female,found,free,geminat,glabrate,impressed,inflorescenc,large,lateral,live,lobe,lon,lower,main,major,male,meet,middle,minor,nflorescence,older,overlapping,papillo,papillose,pendan,planar,pore,poricidal,portion,pubescence,rather,reddi,reflexed,rounded,ruit,sessile,set,shaped,soon,spaced,speciman,specimen,straight,strong,tall,tear-drop,testae,thickened,thin,tip,top,type,ud,undersurface,unit,usually,widest,woody,yellowish,ympodial,young	'',5-120,[,``,abaxial,adaxial,arrangement,bark,bud,characteristic,colour,diameter,form,fruit,growth,height,history,length,life,na,new,number,pedic,peduncle,perennial,position,prickle,rachi,reproduction,seed,shape,spacing,staman,texture,value,width,{,}
193	wfo-0001027200	success	139	95	63	76	32	0.453	0.05-0.25,0.25-0.5,0.6-1,1-1.4,1-1.5,1.5-5,3-3.5,6-8,acute,anther,apex,bark,base,beneath,broadly,brown,calyx,capitate,cm,conical,corolla,dark,deeply,densely,elliptic,filament,fruiting,glabrous,globose,golden,green,grey-brown,inflorescence,leaf,lobe,lobed,margin,minutely,mm,nearly,ovary,ovoid-reniform,papillose,pedicel,petiole,pitted,prominent,puberulent,shrub,small,sparsely,stem,stigma,style,surface,tip,tree,trichome,unifoliate,vein,white,x,yellowish	0.5-0.75,0.5-1,0.7-2.5,1.2-1.5,1.5-2,1.6-6,2-3,2.5-3,3.5-6,8-15,9-11,across,anthesi,aspec,ba,berry,branch,branche,converging,decurrent,deflexed,deltoid,dia,differing,eaf,eed,except,flattened,free,geminate,giving,horizontally,impressed,lateral,lightly,like,lon,long,lower,main,major,middle,minor,minute,near,node,non-reproductive,occasionally,older,onto,papillo,planar,pore,poricidal,portion,reflexed,rest,ruit,shaped,size,slightly,sparse,spreading,straight,tall,tear-drop,tube,unicellular,uniseriate,unit,widened,widest,winged,woody,ympodial,young	abaxial,adaxial,arrangement,bud,cell,center,colour,diameter,flower,form,fruit,growth,height,history,length,life,na,new,number,peduncle,perennial,plant,position,rachi,reproduction,scar,seed,shape,spacing,staman,texture,width
194	wfo-0001027204	invalid_json_followup	154	113	69	85	44	0.448	-40,.5-1,0.5-4,1-10,1-14,1-3.5,1.5-3.5,1.5-9,2-2.5,3-20,5-30,5-9,6-10,acuminate,acute,adaxial,angled,apex,branched,brown,calyx,cell,chartaceous,cm,dense,diameter,distally,elliptic,entire,expanded,flower,forked,fruit,glabrate,glabrous,globose,greenish,margin,membranaceous,mm,moderately,nearly,orange,pedicel,peduncle,perfect,petiole,pink,pseudohair,pubescent,pubescent-pilose,purplish,rachi,reddish,rugose,scar,shrub,simple,stellate,stellate-campanulate,stigma,style,twice,unbranched,violet,white,x,yellow,yellowish	-4.5,-8,.8-2,1,1-7,1.5-6.5,15-35,2-4,2-5,2-8,3-5,4-5-foliat,4-6,5-19,6-12,8-15,abaxially,absen,adaxially,aggregate,along,apart,articulated,axe,base,blade,channe,connivent,cuneate,cylindrical,decurrent,densely,denser,directed,distall,eaf,eed,eglandular,especially,except,glandular,hair,lanceolate,leaving,lobe,lon,long,lower,midrib,narrowed,narrowly,near,nflorescence,nther,obtuse,often,orolla,ovate,peg,pore,present,puberulent,pubescen,radiu,ripe,ruit,short,spaced,sparsely,stone,subacute,subcoriaceous,tal,tem,time,tip,triangular,triangular-deltate,truncat,tube,unit,vary,wide,x1-2,ympodial	'',[,``,abaxial,anther,arrangement,bark,bud,center,characteristic,colour,corolla,filament,form,fruiting,growth,height,history,inflorescence,leaf,length,life,na,new,number,ovary,perennial,plant,position,prickle,reproduction,seed,shape,spacing,staman,stem,surface,texture,trichome,truncate,value,width,{,}
195	wfo-0001027213	success	231	117	86	145	31	0.372	-19,-230,-3.3,-4.5,0-2.5,0.2-0.4,0.2-0.5,0.7-2.3,0.8-1.8,1-2,1-5,1.2-2.5,12.3-16.3,2-5,2.9-3.8,2.9-4.8,4-9.5,5.7-6.2,8-24,abaxially,accrescent,acute,adaxially,anther,apart,apex,branched,broadly,brown,calyx,cell,cm,conical,corolla,dark,deltoid,diameter,drying,elliptic,entire,filament,flower,fruit,fruiting,glabrescent,glabrous,globose,grayish-brown,green,leaf,length,many,margin,mm,oblanceolate,obovate,orbicular,pale,pedicel,peduncle,petiole,pseudo-terminal,pubescent,rachi,reniform,reticulate-punctate,scabrous,short-attenuate,shrub,simple,sometimes,stellate,stem,stigma,style,surface,time,tomentose,tree,violet,white,whitish-green,x,yellow,yellow-green,yellow-tan	/10,0-160,1.1-1.7,1.2-1.6,1.2-1.7,1.3-2.2,1.7-3.6,1.7-3.9,1.8-2.8,1.8-3.2,1/2-2/3,10-24,2.4-4.7,2.5-5.1,2/3,3.5-5,3.5-8,4.2-5.9,5-7.5,5-8,5-merou,8.2-10.5,9-13,acuminate,ag,along,alyx,anthesi,apparently,ark,around,articulated,attenuate,axe,axillary,ba,basal,base,blade,blunt-tipped,branch,capitat,completely,covering,cuneate,cylindrical,decurrent,directed,distally,eaf,early,edge,eed,enveloping,epidermal,eventually,exserted,farinose,few-rayed,free,glabrescen,granular,group,hair,high,homostylous,immature,inserted,lackin,lanceolate,lateral,lengthening,lobe,lobed,long,long-,long-stalked,longitudinal,lower,m.,main,midrib,mixed,moderately,mostly,multangulat,multangulate,nearly,nflorescence,obscured,obtuse,often,older,orolla,ovate,ovate-lanceolate,partly,perfect,plurifoliate,pore,poricidal,porrect-stellat,porrect-stellate,prominent,pubescence,rather,relatively,ruit,sessile,short,short-,short-stalked,side,slit,somewhat,spaced,sparsely,stamen,subcampanulate,suture,tamen,terete,thick,thick-stalked,thin-stalked,ti,tip,tomentose-pubescent,tomentu,touching,tube,ud,unarme,unarmed,unit,unwinged,vary,vein,vestigial-rayed,way,whitish,wide,yellowish,ympodial,young	90-160,abaxial,adaxial,arrangement,bark,bud,capitate,center,colour,form,growth,height,history,inflorescence,life,na,new,number,ovary,perennial,plant,position,reproduction,scar,seed,shape,spacing,staman,texture,trichome,width
196	wfo-0001027214	invalid_json_followup	181	103	68	113	35	0.376	.25,0.3-1.5,0.5-0.8,0.7-2.5,1-1.5,10-13,2,2-9,3-6,abaxially,adaxially,anther,apex,base,calyx,cell,cm,conical,corolla,densely,diameter,elliptic,filament,finely,flattened-round,flower,fruit,fruiting,glabrous,globose,green,greenish,height,herb,inflorescence,length,lobed,long-acuminate,long-conical,margin,minutely,mm,nearly,nodding,obovate,occasionally,once-branched,ovary,papillate,pedicel,petiole,pinnate,pointed,pubescent,rachi,rugose,scar,scattered,seed,sharply,simple,stigma,style,surface,tip,trichome,uniseriate,white	-20,-38,-9,..,.5,0,0-16,0.25,0.3-1.7,0.5-1,0.7-2,0.8-1,1-2.8,1.2-3,1.5,1.5-1.8,1.5-6,10-,12-17,15-25,3-,4-5,5-6,6-,6-12,7-12,8-9,absent,acuminate,acute,along,anthesi,anticlinal,apical,basal,berry,broadly,capitat,climbing,composed,conspicuously,decurrent,deltate,dr.,drying,eaf,edicel,eed,epidermal,erect,exserted,extending,free,groove,grown,horizontal,inflorescenc,irregular,lamina,lanceolate,lateral,leaflet,less,like,lobe,lon,long,lower,markedly,midrib,narrowly,nflorescence,noddin,oblique,often,onto,open,opposite,pair,paired,papilla,per,perfectly,petiolule,poricidal,portion,projection,reflexed,rest,rugosity,ruit,scrambling,sinuous,smaller,somewhat,tem,terminal,thickening,time,triangular,truncate,tub,tube,ud,unevenly,unifoliat,unit,vein,white-lenticellate,whitish,without,x,ympodial	'',[,``,abaxial,adaxial,arrangement,bark,bud,capitate,center,characteristic,colour,form,growth,history,leaf,life,na,new,number,peduncle,perennial,plant,position,prickle,reproduction,shape,spacing,staman,stem,texture,value,width,{,}
197	wfo-0001027219	success	143	105	75	68	30	0.524	.5,/4,0.3,0.4-0.6,0.5-0.8,1-15,1-3,1.5-2,2,2-2.5,2-4,6-8,acuminate,acute,anther,apex,bark,base,berry,bright,broadly,brown,calyx,capitate,closely,cm,conical,corolla,densely,diameter,elliptic,entire,erect,filament,flower,fruiting,glabrescent,glabrous,globose,green,greyish,growth,leaf-opposed,lobed,long-conical,long-styled,margin,mm,new,ovary,pale,papillose-pubescent,pedicel,peduncle,petiole,pubescent,purple,scar,shrub,simple,somewhat,spaced,stem,stigma,stout,style,surface,tip,trichome,uniseriate,violet,way,white,woody,–1/3	0.5,1,1-2,1.5-2.5,2-3,2-3.5,3-5,3-6,7-8,absent,age,anthesi,axillary,berr,c.,completely,cup-shaped,deltate,drying,eaf,edge,eed,exerte,exfoliatin,free,glabrou,hard,heterostylous,known,lengthening,less,lobe,lower,maturity,minutely,nflorescence,overlappin,pair,papillo,pendent,pericarp,planar,plurifoliat,pointed,pore,poricidal,portion,primary,ruit,sharply,shoot,short,short-styled,slightly,slit,sometimes,soon,terminal,thickened,tube,tuft,ud,unit,vein,weight,x,yellowish,ympodial	abaxial,adaxial,arrangement,bud,cell,center,colour,dense,exfoliating,form,fruit,height,history,inflorescence,leaf,length,life,na,number,overlapping,plant,position,rachi,reproduction,seed,shape,spacing,staman,texture,width
198	wfo-0001027221	success	261	113	70	191	43	0.268	-9.5,0.3-0.6,1,1-4,1.4-2,2.2-3.2,25-30,4,abaxial,acute,andromonoecious,anther,apart,apex,attenuate,berry,blue,branched,bright,bud,calyx,chartaceous,clavate,cm,densely,diameter,extra-axillary,filament,flattened-reniform,flower,fruit,fruiting,glabrous,glandular-pubescent,globose,intensity,leaf,light,margin,minutely,mm,orange,outline,ovate,pale,pedicel,peduncle,peripherally,petiole,pitted,plant,prickle,rachi,shrub,simple,sparsely,stellate,stellate-tomentose,stem,stigma,straight,style,sulcate,surface,triangular-caudate,unbranched,variable,violet,x,yellow	.5,0,0.4,0.4–0.6,0.5–2,0.8–1,1.5-2,1.6–2,11-17,11–14,13–16,14–17,1–2,2,2.5–2.8,2.5–5,2.9–3.6,2/3,2–2.5,2–3,2–5,3.1-4.8,3–6,4.5–11,4–8-rayed,5-8,5-merou,6-8,6.5–7,8.5–18,9,abaxiall,abaxially,acicular,actually,acutely,adaxially,along,also,always,alyx,ample,apparent,apparently,appear,armed,aromatic,articulated,ba,base,becoming,blade,blunt-tipped,broad-based,capitat,caudate,central,closely,common,contrasting,coroll,curved,cylindrical,darker,deeply,delicate,dense,development,difoliate,directed,discrete,distally,eaf,eed,entire,equal,eventually,evidently,exceeding,expanded,fewer,frequently,fresh,geminat,glabrescent,gland,hair,half,herbarium,hermaphrodite,homostylous,interpetalar,juic,lanceolate,lateral,least,like,likely,lobe,lobed,long,lower,main,major,material,microscope,midpoint,midrib,midvein,minor,mostly,much,nearly,nerve,nflorescence,obtuse,often,older,orolla,ovate-oblong,ovate-triangular,pair,paired,per,perfect,perhaps,persistently,plurifoliate,pore,predominately,probably,rarely,ray,reflexed,repand,rounded,ruit,sessile,short-stalked,side,similar,sinus,size,slightly,smaller,sometimes,somewhat,soon,source,spaced,specimen,splitting,sprout,stalk,stalked,stamen,stellae,stellate-pubescent,subcordate,tal,tapered,tem,thick-textured,thickened,time,tip,tissue,tomentose,toward,tube,unarmed,underside,unequal,unit,unpleasantly,usually,vary,vein,viscid,viscidity,way,weakly,white,wide,ympodial,youn,young,–11.5,–15,–3,–4	0.5-2,1-2,1.6-2,11-14,11.5,13-16,2-2.5,2-3,2-5,2.5-5,3-6,5-merous,6.5-7,adaxial,arrangement,bark,capitate,cell,center,colour,corolla,form,growth,height,history,inflorescence,length,life,na,new,number,ovary,perennial,position,reproduction,scar,seed,shape,spacing,staman,texture,trichome,width
199	wfo-0001027223	invalid_json_followup	189	126	83	106	43	0.439	0.19-0.75,1-2,1.8-3.5,16-41,3-10,3-5,3-5.2,3.7-9.3,5-8,9-15,9-35,abaxially,adaxially,anther,apex,articulated,attenuate,axillary,brownish,bud,cell,clavate,cm,condition,conical,corolla,covering,deep,densely,diameter,distal,dot,drying,elliptic,filament,flower,forked,fresh,fruit,glabrous,green,green-white,greenish,hair,half,herb,hyaline,lanceolate,lateral,leaf,light,long,make,middle,mm,mucilaginous,odd-pinnate,ovoid,pedicel,peduncle,pentagonal,petiole,plant,pubescent,purple,ripe,rotate,rounded,seed,sometimes,stigma,stripe,style,subtending,terminal,testal,thick,throughout,wall,wet,white,whitish,yellow	.5,0.3-1.2,1-3,1.3-2,1.5-3.5,2-4,2-7,3-11,3.5-4,3.5-6,3.5-7,4-6,5-10,5-21,5-merou,5.9-12.2,9-22,acumen,acuminate,adaxiall,ag,alyx,apart,apparently,asymmetric,axe,base,basiscopic,berry,blade,capitat,connivent,decreasing,digestion,dorsally,eaf,edge,eed,end,enzyme,erec,exceeding,flat,folded,geminat,generally,glabrou,hair-like,hal,homostylous,honeycomb-shaped,interjected,larger,leaflet,lengthening,like,living,lobe,lower,nflorescence,one,orbicular,orolla,ovate,pair,perfect,petiolulate,placed,plurifoliate,pore,poricidal,present,removed,ruit,sessile,seudostipule,short,shortly,side,size,slightly,slit,spaced,specimen,stamen,ste,stolo,straight,subequal,tall,tamen,tem,tip,tissue,toward,tri-,tube,tuber,typically,unit,unwinged,usually,vary,wide,x,ympodial	'',[,\u201chair-like\u201d,``,abaxial,adaxial,arrangement,bark,calyx,capitate,center,characteristic,colour,form,fruiting,growth,height,history,inflorescence,length,life,margin,na,new,number,ovary,perennial,position,prickle,rachi,reproduction,scar,shape,spacing,staman,stem,surface,texture,trichome,value,width,{,}
200	wfo-0001027229	success	206	94	60	146	34	0.291	0.1-3,1-1.5,1-8,1.5-3,1.8-2.7,2-10,3-6,3.5-5,3.5-6,4-7,5-6,accrescent,acicular,acute,adaxially,anther,apex,broadly,calyx,chartaceous,cm,densely,diameter,extra-axillary,filament,flower,fruit,fruiting,glabrous,globose,green,herbaceous,inflorescence,length,lilac,lobed,margin,minutely,mm,ovate,pale,pedicel,peduncle,pentagonal,petiole,prickle,rachi,reniform,resprouter,reticulate,shallowly,simple,sparsely,stellate,stellate-pubescent,stigma,style,surface,tan,yellow	%,0-0.1,0-0.2,0-8,0.1-0.3,0.1-0.6,0.1-1,0.1-1.4,0.2-0.4,0.2-1.7,0.2-2,0.5-0.7,0.5-0.9,0.5-3,0.6-0.7,0.6-1,1-2,1-6,1-7,1.1-1.2,1.3-1.7,1.5-2.5,12-17,2-4,2-5,2-foliate,2-locular,2.5-6,20-65,25-35,30-145,30-300,4-10,4-5,4-6,40-55,5-15,5-9,5-merou,7-11,8-12,8.5-12,abaxially,absen,absent,abundant,across,adaxiall,adult,alyx,apart,armed,articulated,attenuate,axe,ba,base,blade,branche,capitat,circular,cordate,cross-section,cylindrical,decimetre,directed,distall,eaf,eed,eglandular,elliptica,erect,especially,exceeding,exocarp,finger,flattened,geminat,gland-tipped,glandular,hair,homostylous,index,interpetalar,juicy,lamina,lanceolate,lateral,lobe,lobing,lon,long,longer,lower,mature,mesocarp,mid-point,midpoint,midvein,minute,moderately,moist,nflorescence,oblique,obtuse,orolla,part,per,perfect,placenta,pore,porrect,presen,present,prostrate,pseudo-racemose,ray,ruit,short,side,spaced,sprawling,stage,stalk,stalked,stellae,straight,tal,tamen,tem,thick,throughout,time,tissue,toward,transparent,triangular,tube,unbranched,unit,uvenile,vary,vein,wide,x,ympodial	abaxial,adaxial,arrangement,bark,bud,capitate,cell,center,colour,corolla,form,growth,height,history,leaf,life,na,new,number,ovary,perennial,plant,position,pseudoracemose,reproduction,scar,seed,shape,staman,stem,texture,trichome,vegetative,width
201	wfo-0001027232	success	195	107	74	121	33	0.379	0.3-0.4,0.7-1.5,1-10,1.8-3.9,14-30,2-3.4,4-10,4-5.5,4-8,4.5-6.5,5-8,5-merous,7-9,acicular,acute,adaxially,anther,apex,black,bluntly,broadly,brown,calyx,chartaceous,cm,deeply,diameter,discoid,erect,extra-axillary,filament,flattened,flower,forked,fruit,fruiting,glabrous,globose,green,inflorescence,irregularly,length,lilac,lobed,long,margin,minutely,mm,orbicular,outline,ovate,pale,pedicel,peduncle,perennial,petiole,prickle,purple,reticulate,rhizomatous,shrub,simple,sparsely,stellate,stellate-pubescent,stigma,straight,style,surface,thick,throughout,triangular,unbranched,yellow	%,0-0.1,0-7,0.15-0.3,0.25-0.4,0.3-0.45,0.3-0.5,0.4-0.8,0.45-0.6,0.5-0.8,0.6-0.9,0.7-1.3,0.8-3.2,0.9-7.5,1-locular,1.1-1.5,1.5-2.5,1.5-3,10-30,14-18,15-100,2-25,2.1-2.8,2.5-3,25-35,3-5,3-9,3.5-10,350-800,4-6,5-11.5,6-8,abaxially,absen,absent,accrescent,across,adaxiall,adult,apart,apparen,armed,articulated,axe,ba,base,blade,branche,capitat,confined,cordate,cylindrical,decimetre,deltate,directed,distall,distributed,eaf,eed,eglandular,exocarp,finger,gland-tipped,hair,half,incomplete,index,juicy,lamina,lancolate,lateral,less,lobe,lobing,longer,lower,mature,mesocarp,mid-point,midpoint,midrib,midvein,minute,moderately,nflorescence,oblique,obtuse,orolla,part,per,perfect,placenta,pore,porrect,present,ray,rostrate,ruit,septum,sessile,short,side,spaced,sparse,stalk,stellae,succulent,tal,tamen,tem,time,transparent,tube,unarme,unit,unknow,vary,vein,wide,x,ympodial	abaxial,adaxial,arrangement,bark,bud,capitate,cell,center,colour,corolla,form,growth,height,history,leaf,life,na,new,number,ovary,plant,position,reproduction,scar,seed,shape,spacing,staman,stem,texture,trichome,unknown,width
202	wfo-0001027234	invalid_json_followup	206	144	109	97	35	0.529	-0.15,-2,-6,.5,0-4,0.05-0.1,0.1-2,0.15,0.2-1.3,0.3-1,0.5-3,0.8-0.9,0.9-1.6,1,1-2,1-4,1.5-4,1/4-1/3,2/3-4/5,3-5,4-5-merous,absent,acute,almost,anther,apart,apex,apparently,bark,base,berry,beyond,black,brown,calyx,cell,cm,concolorous,curved,dark,diameter,drying,elongating,entire,erect,filament,filiform,flattened-reniform,flower,fruit,fruiting,glabrescent,glabrous,gray,green,herb,lateral,leaf,length,lobed,long,margin,mature,maturity,mauve,membranous,mm,multangulate,near,orbicular,outline,ovate,pale,pedicel,peduncle,petiole,pit,prickle,prickly,protruding,purple,raised,red,reflexed,rounded,scandent,scattered,sessile,shrub,simple,slightly,smooth,sometimes,sparsely,spherical,stalked,stellate,stellate-pubescent,stem,straight,style,surface,terete,trichome,unarmed,way,wide,yellow,yellowish	-1.5,-3,-3.5,0-20,0.1,0.3-0.4,0.5-0.7,0.5-2,0.6-0.8,0.7-1.3,0.7-1.5,1.2-2,1.5-2.2,1.5-3.5,1.8-3,1/3,12-18,2-4,3-10,3-6.5,8-15,8-16,abaxially,acuminat,alyx,apar,apically,articulated,attenuate,blac,blade,branched,broad-deltate,cordate,deltate,difoliate,dot,eaf,eed,equal,eye,free,geminat,glabrou,glan,gland,globular,herbaceous,infructescence,lobe,longer,lower,midpoint,moderately,naked,narrowly,nflorescence,oblong,obtuse,older,one,open,orolla,oung,pair,pendulous,per,perfec,pericarp,perpendicular,poricidal,porrect,portion,primary,ray,reduced,ruit,scar,shorter,spaced,spreading,stalk,tamen,tapering,tertiary,time,tip,tube,unarme,unit,vary,vein,venation,visible,white,winged,ympodial	'',[,``,abaxial,adaxial,arrangement,bud,characteristic,colour,corolla,form,growth,height,history,inflorescence,life,na,new,number,ovary,perfect,plant,position,rachi,reproduction,seed,shape,spacing,staman,stigma,texture,value,width,{,}
203	wfo-0001027235	invalid_json_followup	189	123	73	116	50	0.386	1,35,5,abaxial,abaxially,acicular,adaxial,adaxially,anther,apart,apex,black,brown,calyx,chartaceous,chocolate-brown,cm,deeply,diameter,difoliate,extra-axillary,filament,flower,fruit,fruiting,glabrous,globose,green,hair,herb,irregularly,leaf,length,like,lobe,lobed,margin,midvein,mm,moderately,multicellular,narrowly,obtuse,pedicel,peduncle,petiole,pinnatifid,pinnatisect,prickle,pubescent,rachi,raised,reniform,ridge,rotate-stellate,rounded,shallowly,simple,sparsely,stellate,stem,stigma,style,surface,tan,triangular,turning,unbranched,undulate,uniseriate,white,yellow,zygomorphic	.5,0.5,1.2,1.5,10,11,12,13,14,18,2,2.5,3,30,4,40,5-merous,6,8,9,?,absent,abundant,accrescent,acute,alternating,alyx,armed,articulated,asymmetrical,axe,ba,base,berry,blade,burr-like,c.,completely,cordate,covering,creating,curved,cylindrical,densely,dimorphic,directed,distally,dry,drying,eaf,eed,enantiostylou,four,geminate,glabrou,gland-tipped,interpetalar,introrsely,invested,larger,left-handed,linear-lanceolate,lon,long,longitudinal,lower,lowermost,maturity,midpoint,midrib,multiseriate,nearly,nflorescence,occasional,occasionally,often,one,opening,opposite,orolla,pair,per,pinnate,pore,prickly,ray,right,ruit,secondary,side,slightly,slit,spaced,stalk,ste,straight,strongly,tamen,tapering,tearing,tem,tightly,tissue,tube,unequa,unicellular,unit,upper,upward,usually,vary,vein,venation,wid,ympodial,×	'',0.5-3,1-2,10-14,10-18,2-2.5,2-3,2-4,4-10,5-8,6-12,8-12,9-11,[,``,arrangement,bark,bud,cell,center,characteristic,colour,corolla,enantiostylous,form,growth,height,history,inflorescence,life,na,new,number,ovary,perennial,plant,position,reproduction,scar,seed,shape,spacing,staman,texture,trichome,value,wide,width,{,}
204	wfo-0001027236	invalid_json_followup	199	140	109	90	31	0.548	-4.5,-5,1,1-2,1-2.5,1-3,10,10-20,2-2.5,2-3,2-5,2-6,3-3.5,3-8,4-5,5-6,8-10,abaxially,acute,adaxially,anther,anthesi,apex,bark,becoming,berry,blue,branched,brown,calyx,chartaceous,clavate-truncate,closely,cm,cordate,corolla,dark,diameter,erect,filament,flattened,flower,foveolate,fruit,fruiting,glabrescent,glabrous,glandular,globose,green,growth,heterostylous,internodal,length,light,like,lobe,lobed-angulate,long-styled,margin,mixed,mm,new,ochraceous,older,ovary,ovate-cordate,ovate-turbinate,pedicel,peduncle,petiole,plant,porrect,prickle,prickly,pubescent,reniform,reticulate,ripe,runcinate,rusty,scandent,scar,sessile,short-styled,shrub,simple,smooth,sparsely,stellate,stem,stigma,style,subcoriaceous,subglobose,suborbicular,surface,trichome,unevenly,velutinous,villous,violet,viscid,woody,woolly,x,yellow,yellow-orange,young	-82,/6,0.2-0.3,0.6-0.7,1-1.5,1.2-1.5,1.5-2,2-,2.5-,3-4,30-50,5-,5-8,5-9,7-14,armed,articulated,asymmetric,basal,base,brow,caly,compressed,densely,discolorous,distal,eaf,eed,eglandular,exserted,free,fused,gland-tipped,glandular-hirsute,lanceolate,lateral,lengthening,lobed,long,lower,middle,midpoint,minute,minutely,multangulate,nearly,nflorescence,obverse,papillo,partially,per,perfect,pericarp,plurifoliat,pore,poricidal,portion,pubescence,raise,ray,recurved,reflexe,rounded,ruit,slightly,slit,somewhat,space,stalked,staminate,stellate-glandular,stellate-pilose,striped,subsagittate,tall,tapering,terete,testa,tiny,tip,tube,ud,unarmed,unit,upper,villous-glandular,viscid-tomentose,ympodial,¼,½	'',[,``,abaxial,adaxial,arrangement,bud,characteristic,colour,form,height,history,inflorescence,leaf,life,na,number,perennial,position,rachi,reproduction,seed,shape,spaced,spacing,staman,texture,value,width,{,}
205	wfo-0001027237	success	122	88	57	65	31	0.467	.5,/4,1.5-2.5,3-3.5,6-11,6-8,8,anther,apart,base,berry,black,branched,brown,clavate,cm,corolla,cucullate,dark,deflexed,drying,ellipsoid,filament,flattened,glabrous,globose,green,greenish-white,inflorescence,internodal,later,leaf,lobed,many,margin,minutely,mm,ovary,paler,papillose,pedicel,pitted,regularly,reniform,shining,shrub,small,stigma,style,surface,tapering,time,tip,tree,way,white,x	0.5-1,1-1.2,1.5-2,2-3,3-4,30-100-flowered,5,anthesi,apiculae,apiculate,appearing,ba,bark,blac,branc,broadly,calyx,completely,cup-shaped,deltoid,dia,difoliate,edicel,eed,erect,exsertion,free,fruiting,geminate,greyi,lobe,long,lower,nflorescence,occasionally,older,papillate,papillo,part,plurifoliat,pore,poricidal,portion,reflexed,regulary,ruit,scar,shaped,slender,spaced,stem,straight,tall,tear-drop,terminal,tube,ud,unit,upper,usually,widely,woody,x.,ympodial,young	30-100,abaxial,adaxial,alternate,apex,arrangement,colour,diameter,flower,form,fruit,growth,height,history,length,life,na,number,peduncle,perennial,petiole,plant,position,rachi,reproduction,seed,shape,spacing,staman,texture,width
206	wfo-0001027238	invalid_json_followup	204	122	82	122	40	0.402	-25,.3,0-0.7,0-1,0-1.5,0.3-0.8,0.5-1,1-1.5,1.5-3,1.5-4,15-30,3-6,5-15,6-15,abaxially,accrescent,acuminate,acute,anther,apex,black,brown,calyx,chartaceous,cm,contiguous,dark,densely,diameter,elliptic,elliptic-ovate,entire,extra-axillary,filament,flower,fruit,fruiting,glabrescent,glabrous,globose,green,greenish,homostylous,lavender,leaf,light,margin,membranaceous,minutely,mm,multangulate,nearly,new,outline,pale,pedicel,peduncle,petiole,pitted,porrect-stellate,pubescent,purple,rachi,reniform,sessile,shiny,short-stalked,shrub,simple,small,sparsely,stellate,stellate-pubescent,stem,stigma,style,surface,tree,unbranched,white,x,yellow	-5,.5,0.3-0.5,0.3-1,0.3-5,0.5-16,0.5-2,1-2,1.5-7,10,2-3,2-4,3-4,3-5,4-,4-10,4-16,4-5,4-8,5-7,5-merou,6-8,adaxiall,adaxially,ag,alyx,apparently,articulated,axe,ba,base,berry,blade,branch,capitat,connivent,covering,cuneate,cylindrical,deltate,differentiated,directed,discolorous,distally,eaf,eed,equal,flattened,fleshy,foliaceous,fork,free,frui,geminate,gland,gland-tipped,growt,hair,interpetalar,introrsely,juic,large,lighter,like,lobe,long,longitudinal,lower,major,midpoint,minor,mixed,narrowly,near,nflorescence,oblique,oblong,obtuse,often,one,opening,orolla,paired,part,perfect,pericarp,plurifoliate,pore,ray,ripe,rounded,ruit,scandent,side,similar,slit,sometimes,somewhat,sparse,sprawling,ste,straight,strongly,subtending,tamen,tem,time,tip,tissue,toward,triangular,tube,unarme,unequal,unit,vary,vein,whitish,wide,without,yellowish,ympodial	'',5-merous,[,``,abaxial,adaxial,arrangement,bark,bud,capitate,center,characteristic,colour,corolla,form,growth,height,history,inflorescence,length,life,na,number,ovary,perennial,plant,position,prickle,reproduction,scar,seed,shape,spacing,staman,texture,trichome,value,width,{,}
207	wfo-0001027242	success	238	102	73	165	29	0.307	0.25-0.5,0.3-1.1,0.6-3,1.5,1.5-2,12-16,3-6,4-5.5,5.5-7,acicular,anther,base,calyx,chartaceous,cm,cylindrical,densely,diameter,entire,extra-axillary,filament,flattened,flower,fruit,fruiting,glabrous,globose,green,inflorescence,leaf,length,light,lobed,longer,margin,minutely,mm,moderately,nearly,orange,ovate,pale,pedicel,perennial,petiole,pink,plant,prickle,pseudo-racemose,pseudo-umbellate,purple,red,reticulate,rhizomatous,shallowly,shrub,simple,smooth,stellate,stellate-pubescent,stigma,straight,style,subcoriaceous,surface,time,toward,white,whitish,wide,x,yellow,yellowish	%,.05,.2,0-0.7,0-1.5,0-15,0-20,0-5,0.15-0.25,0.2-0.7,0.2-1,0.3-0.5,0.5-1,0.6-0.9,0.7-1.2,1-1.2,1-1.5,1-2,1-2.5,1-locular,1.5-3,1.9-5,10-22,15-25,2,2-2.9,2-3,2.5-3,2.8-3.7,3-12,3-4.5,3-7,3.5-4.5,4-30,4-7,4.5-10.5,4.5-11,5-merou,6-14,6-21,6-7,6-8,7-8,8-15,9-11,abaxially,absen,absent,accrescent,across,acute,adaxially,adult,alyx,andromonoecious,apart,apex,apparen,articulated,axe,ba,blade,bract-like,branch,branche,capitat,confined,connivent,contiguous,cuneate,deltate,directed,distall,dm,eaf,eed,erect,exocarp,finger,forked,geminate,gland-tipped,hair,half,heterostylous,incomplete,index,interpetalar,juicy,juvenile,lamina,lateral,less,lobe,lobing,long,loosely,lower,mature,mesocarp,mid-point,midpoint,midrib,midvein,minute,mixed,much,narrowly,nflorescence,oblique,obtuse,occasionally,often,one,orolla,pair,part,peduncle,per,perfect,placenta,plurifoliate,pore,porrect,present,rachi,ray,rooting,rostrate,rounde,ruit,septum,sessile,short,side,slightly,smaller,spaced,sparse,sparsely,sprawling,stellae,strongly,succulent,tall,tamen,tapered,tem,thick,throughout,tip,tissu,tissue,triangular,tube,unarme,unarmed,unbranched,unit,upper,usually,vary,vein,weakly,ympodial	5-merous,abaxial,adaxial,arrangement,bark,bud,capitate,cell,center,colour,corolla,form,growth,height,history,life,na,new,ovary,position,reproduction,scar,seed,shape,staman,stem,texture,trichome,width
208	wfo-0001027244	success	294	111	84	210	27	0.286	-12,-2,-3.2,0.15-0.2,0.2-1,0.45-0.6,0.5,0.7-1.5,0.9-1.7,1,1.1-1.3,1.5-2,1.5-2.4,2.1-8,4-12,5-9-celled,8-16,anther,apex,articulated,base,branched,broadly,brown,calyx,capitate,cm,conical,corolla,crenate,dark,densely,dentate,diameter,distal,elliptic,extremely,filament,flower,fruit,fruiting,glandular,globose,green,greenish,hair-like,half,herb,imparipinnate,inflorescence,interrupted,irregularly,length,lobed,margin,middle,mm,obovate,orbicular,outgrowth,ovary,patent,pedicel,peduncle,perennial,petiole,pubescent,rachi,rotate-stellate,simple,sparsely,stem,stigma,style,surface,trichome,uniseriate,usually,variable,velvety,vivid,white,woody,yellow	-1.2,.5,0-,0.02-,0.04-,0.05,0.05-1,0.07-0.15,0.1-,0.1-0.3,0.1-0.5,0.1-0.6,0.2,0.2-,0.25-0.4,0.3,0.3-0.4,0.3-0.5,0.3-0.6,0.3-0.8,0.4-,0.4-0.6,0.4-1,0.5-0.8,0.5-1,0.6-0.9,0.6-09,0.7-1,0.7-2,0.7-3,0.8-1.2,0.9-1.3,1-2-celled,1-2.5,1-3.5,1-celled,1.2-1.6,1.5-2.1,1.5-6.5,1.7-3.0,1/2,2-,2-4,2-4-celled,2-9,2-foliate,2-locular,3-5,3.5-13,3/4,4-celled,5-,5-10,7-12,8-celled,abaxially,absent,abundance,abundant,acroscopically,acuminate,acute,adaxially,adpressed,alfway,along,also,always,amongst,angled,anthesi,apical,apparently,appearance,appendage,arequipa,around,articulatio,articulation,axi,basal,berr,berry,bifurcate,bract,bracteate,c.,cage,cell,column,common,cordate,curved,deciduous,decumbent,decurrent,deeper,deltate,dense,density,developed,diamete,eaf,edicel,eed,eglandular,either,elliptical,erect,exserted,flushed,forming,general,giving,glabrescent,glabrous,gland,gree,halfway,head,hyaline,interjected,internode,investing,lamina,lanceolate,larger,largest,lateral,leaflet,leave,like,lobe,lobing,lon,long,longer,lower,midvein,minute,mixed,mixture,multicellular,narrowly,near,node,oblique,occasionally,often,onto,pair,papillate-pubescent,petiolule,population,present,primary,pseudostipule,purple,reflexed,rest,ripe,rounded,ruit,scattered,secondary,sessile,shaggy,short,shorter,silky,sinus,size,slender,small,sometimes,somewhat,sparse,sparser,spreading,staminal,sterile,stout,straight,stripe,strongly,tall,tem,terminal,tertiary,testa,thick,tiny,tip,tipped,toward,truncate,tube,two,ud,undulate,unicellular,unit,united,upper,variety,vein,wall,wide,winged,ympodial	abaxial,adaxial,arrangement,bark,bud,cage-like,colour,form,growth,height,history,leaf,life,na,new,number,plant,position,prickle,reproduction,scar,seed,shape,spacing,staman,texture,width
209	wfo-0001027248	invalid_json_followup	158	117	76	82	41	0.481	.5,0.5-1,0.5-2.5,0.7-1.2,1-2,1-5,3-4,3-7,6.5-8,abaxial,abaxially,acute,adaxially,anther,apex,arachnoid,arachnoid-pubescent,area,bark,base,beneath,broadened,broadly,brown,brownish,calyx,closely,cm,conical,corolla,dark,difoliate,dirty,elliptic,erect,filament,fruit,fruiting,geminate,glabrous,globose,green,leaf,lobed,margin,merely,minutely,mm,nearly,occasionally,opposite,ovary,ovoid-reniform,pale,patch,pedicel,petiole,pitted,pubescence,pubescent,scar,scattered,shrub,simple,small,spaced,sparsely,stem,stigma,style,surface,top,tree,trichome,unifoliate,white	0,1-1.5,1-3,2-2.5,2-4.5,3-7-flowered,3.5-4,4-8,5-5.5,6-13,7-9,along,anthesi,ape,appearing,arachnoid-pubescen,beige,berry,brownish-gra,deflexed,deltate,densely,denser,dia,differing,eaf,edicel,eed,ellipsoid,exserted,felty,fleshy,free,glabrescent,grayish-green,impressed,lamina,later,lateral,lightly,lobe,long,lower,main,major,minor,nflorescence,node,older,overlappin,pair,papillo,papillose,per,planar,pore,poricidal,portion,present,ruit,shaped,shoot,size,somewhat,soon,specimen,strongly,tall,tear-drop,thick,tip,tub,tube,ud,unit,vein,wid,wide,winged,woody,ympodial,young	'',[,``,adaxial,arrangement,brownish-gray,bud,cell,center,characteristic,colour,dense,diameter,flower,form,growth,height,history,inflorescence,length,life,na,new,number,overlapping,peduncle,perennial,plant,position,prickle,rachi,reproduction,seed,shape,spacing,staman,texture,value,width,{,}
210	wfo-0001027258	invalid_json_followup	178	108	70	108	38	0.393	.5,0.6-2,0.9-1.3,1-1.5,1.5-1.6,3-4,4-5,4.5-5,6-8,abaxially,acuminate,acute,adaxially,anther,apex,attenuate,bark,calyx,capitate,cm,corolla,ellipsoid,elliptic,evenly,exserted,filament,flattened-reniform,fruit,fruiting,glabrous,globose,green,greenish-yellow,internodal,leaf,length,lobed,margin,minutely,mm,occasionally,opposite,ovary,ovate,pale,papillose,pedicel,petiole,pitted,pubescent,reddish,scar,shrub,simple,slender,spaced,sparsely,stem,stigma,strongly,style,surface,swollen,treelet,trichome,tuft,uniseriate,white,x,yellowish-tan	.25,/4,0.25-0.5,0.5-1,1-2.3,1-4,1.2-2,2-2.5,2.5-8,3-6,3.5-4,5-10-flowered,7-13,7-9,abruptly,age,along,anthesi,apar,apical,apiculae,axil,ba,base,beneath,berry,broadly,crystal,darker,decurrent,deflexed,deltate,dense,densely,deposit,dia,differing,difoliate,dissecting,drying,eaf,edicel,eed,enlarge,entire,extending,fide,fragrant,free,geminat,glabrou,incrassate,lamina,large,lateral,lengthening,lenticel,lobe,long,lower,main,major,microscope,middle,minor,minute,nee,nflorescence,often,older,onto,pair,papillo,planar,pore,poricidal,portion,projection,prominent,red-papillose,ruit,sand,scattered,size,slightly,slit,small,speck,straight,sweetly,tall,tiny,tip,tub,tube,ud,unit,urceolate,vein,visible,way,widening,widest,winged,woody,yellowish,ympodial,young	'',5-10,[,``,abaxial,adaxial,apart,arrangement,bud,center,characteristic,colour,diameter,flower,form,growth,height,history,inflorescence,life,na,new,number,peduncle,plant,position,prickle,rachi,reproduction,seed,shape,spacing,staman,texture,value,width,{,}
211	wfo-0001027260	success	176	100	61	115	39	0.347	-17,-60,0.25-1,0.5-3,1.5-13,1.5-2,10-25,2-18,3-10,3-4.5,3-6,4.5-14,5-merous,6-20,acuminate,apex,articulated,branched,cell,chartaceous,clavate,cm,densely,diameter,ellipsoidal,elliptic-ovate,entire,flattened,flower,fruit,glabrous,globose,greenish,margin,membranaceous,mm,moderately,ovate,pedicel,peduncle,petiole,pilose,pink,puberulent,pubescent,purple,rachi,shrub,simple,small,stellate,stigma,style,tree,truncate,unbranched,white,x,yellow,yellow-green,yellowish	-2,-7,0.5-1,0.5-6.5,0.75-1,0.8-2,1-,1-2,1-3,1-4,1-6,1-7,15-30,2-,2-10,2-2.5,2.5-14,2.5-3.5,3-,3-11,3.5-25,4-25,4-32,4-5-foliat,4-6,5-,5-25,5-40,abaxially,absent,acute,acute-,adaxially,age,aggregate,also,alyx,apart,ape,axe,basal,base,berry,beyond,blade,connective,connivent,cordate,cylindrical,darker,diamete,directed,distally,eaf,eed,eglandular,elliptic,equal,exceeding,exserted,fading,glabrate,hair,lanceolate,lavender,leaving,lobe,lon,long,longitudinal,lower,narrowly,nearly,nflorescence,nther,obtuse,often,orolla,pedicellar,perfec,perfect,pilo,pore,presen,puberulent-pubescen,puberulent-pubescent,pubescent-pilose,radiu,remnant,ruit,shorter,slightly,spaced,sparsely,stamen,stone,stripe,strongly,subcoriaceous,tal,tapered,tem,thecae,time,tomento,triangular,tube,ud,unit,usually,vary,vein,wide,yellow-orang,ympodial	15-40,abaxial,adaxial,anther,arrangement,bark,bud,calyx,center,colour,corolla,filament,form,fruiting,growth,height,history,inflorescence,leaf,length,life,na,new,number,ovary,plant,position,prickle,reproduction,scar,seed,shape,spacing,staman,stem,surface,texture,trichome,width
212	wfo-0001027265	success	159	89	57	102	32	0.358	.2,.3,0.2-0.4,0.5,0.5-1,1-3,1.2-2,2,2-3,20-30,acute,anther,apex,base,berry,chartaceous,cm,diameter,extra-axillary,filament,flattened-reniform,flower,fruit,glabrous,globose,hair,herb,hermaphroditic,leaf-opposed,light,minutely,mm,nearly,orange,ovate-lanceolate,pedicel,peduncle,petiole,pitted,puberulent,pubescent,purple,rachi,recurved,red,rotate-stellate,seed,simple,sparsely,stigma,style,subcoriaceous,surface,weak,white,x,yellow	-2.5,.5,0.1–2,0.5–0.6,1-1.3,1-2.5,1.2-1.3,1.2–1.4,1.5-2.5,1.5–1.8,1.5–2,1.5–4,2-,2-4,2/3,2–2.5,2–3,3-,3-lobed,30–50,4-5,4.5–8,4–6,4–7-branched,5-merou,58409,abaxially,accrescent,adaxiall,adaxially,alyx,apart,apparently,articulated,axe,ba,blade,broad,calyx,capitat,ciliate,connivent,covering,croat,cylindrical,dehiscent,eaf,eed,entire,erect,foliate,frui,fruiting,geminat,granule,juic,larger,lobe,lon,long,long-attenuate,longitudinall,low,lower,margin,mesocarp,near,nflorescence,node,numerous,oblong,obtuse,orolla,paired,partially,pore,present,prominent,rarely,ripe,rooting,ruit,scarcely,sclerotic,slightly,sometimes,somewhat,spaced,tall,tamen,tem,time,tip,triangular,tube,unit,usually,vary,white-puberulent,wide,winged,ympodial	0.1-2,1.5-2,2-2.5,30-50,abaxial,adaxial,arrangement,capitate,colour,corolla,form,growth,height,history,inflorescence,leaf,length,life,na,number,ovary,perennial,plant,position,reproduction,shape,spacing,staman,stem,texture,trichome,width
213	wfo-0001027265	success	156	94	60	96	34	0.385	.2,0.2-0.4,0.5,0.5-1,1-3,1.2-1.3,1.2-2,2,2-3,20-30,acute,anther,apart,apex,base,calyx,chartaceous,cm,diameter,entire,extra-axillary,filament,flattened-reniform,flower,fruit,fruiting,glabrous,globose,herb,hermaphroditic,leaf-opposed,light,margin,minutely,mm,nearly,orange,ovate-lanceolate,pedicel,peduncle,petiole,pitted,puberulent,pubescent,purple,rachi,recurved,red,rotate-stellate,seed,simple,sparsely,stigma,style,subcoriaceous,surface,triangular,white,x,yellow	-2.5,.3,.5,0.1–2,0.5–0.6,1-1.3,1-2.5,1.2–1.4,1.5-2.5,1.5–1.8,1.5–2,1.5–4,2-,2-4,2/3,2–2.5,2–3,3-,3-lobed,30–50,4-5,4.5–8,4–6,4–7-branched,5-merou,58409,abaxially,accrescent,adaxiall,adaxially,alyx,apparently,articulated,axe,ba,blade,broad,capitat,ciliate,connivent,covering,croat,cylindrical,dehiscent,eaf,eed,erect,foliate,frui,geminat,granule,hair,juic,larger,lobe,lon,long,long-attenuate,longitudinall,low,lower,mesocarp,near,nflorescence,node,numerous,oblong,obtuse,orolla,paired,partially,pore,prominent,rarely,ripe,rooting,ruit,scarcely,sclerotic,slightly,sometimes,somewhat,spaced,tall,tamen,tem,time,tip,tube,unit,vary,weak,white-puberulent,wide,winged,ympodial	0.1-2,0.5-0.6,1.5-2,2-2.5,30-50,4-7-branched,abaxial,adaxial,arrangement,bud,capitate,colour,corolla,form,growth,height,history,inflorescence,leaf,length,life,na,number,ovary,perennial,plant,position,reproduction,shape,spacing,staman,stem,texture,width
214	wfo-0001027276	success	219	101	72	147	29	0.329	1,1.5,10,2,5-merous,6,80,acute,alternate,anther,apex,bifid,black-green,broadly,brown,calyx,clonal,cm,conspicuously,corolla,cyme,dark,dense,diameter,drying,entire,filament,fine,flower,fruit,glabrous,globular,green,growth,inflorescence,lanceolate,least,length,lighter,linear,lobed,long,margin,minutely,mm,new,ovary,pedicel,petiole,plant,porrect-stellate,prickle,purple,rarely,reticulate,rotate,scabrous,short,slightly,stalked,staman,stellate,stellate-pubescent,stem,stigma,straight,style,subshrub,surface,trichome,wavy,wide	-22,.5,0,0.5,0.5–1,1.2–1.5,1.5–2,1–1.5,1–2,2–5,2–6,4–5,4–9,5,5–10,5–12mm,5–7,7,9–12,absent,acuman,acumen,ale,along,alyx,anthesi,apparently,armed,around,aspect,ba,base,becoming,beneath,berry,beyond,boht,borne,branche,c.,caly,central,cone,covered,densely,detaching,different,dioeciou,drop,eaf,eduncle,eed,ending,erect,even,eventually,except,expanding,exserted,extending,falling,female,filiform,following,functionally,fused,gra,gray-green,growt,hermaphrodite,inaperturate,including,indumentum,ingle,largest,lobe,lon,loose,lower,mostly,mout,near,newer,next,oblong-lanceolate,older,open,opening,orphologically,petal,plurifoliat,pollen,poricidal,prickly,producing,proportion,ra,red-tinged,remaining,resprout,retained,rickle,ruit,ruiting,scarcely-rooted,scattered,seaso,shed,shor,side,slender,small,solitary,somewhat,sparsely,splitting,stamen,staminate,stellate-funnelform,stigmatic,stolon,successively,surrounding,suture,taminate,tapered,tapering,tem,tending,throughout,time,tip,toward,type,unarme,underground,unequal,unit,verall,vestigial,widened,without,woody,yellow-green,ympodial,×,–	-,1-1.5,1.5-2,2-5,5-12mm,5-7,abaxial,adaxial,arrangement,bark,bud,cell,center,colour,dioecious,form,fruiting,height,history,leaf,life,na,reproduction,scar,seed,shape,texture,unarmed,width
215	wfo-0001027284	success	172	95	67	105	28	0.39	.3,0.1–0.5,0.1–2,0.2–,1.2–1.5,1.5–2,1–1.5,1–3,2–16,3–4,4,4–12,4–6,5-merous,9–18,abaxially,acuminate,adaxially,anther,apex,axillary,branched,brownish,cm,diameter,elliptic,extra-axillary,filament,flattened-reniform,flower,fruit,glabrous,globose,green,inflorescence,long,maturity,minutely,mm,near,nearly,orangish,ovate,ovoid,pale,pedicel,peduncle,petiole,pubescent,rachi,rarely,reticulate-rugulose,scandent,shortly,shrub,simple,sparsely,stellate,stem-terminal,stigma,style,surface,tan,unbranched,vine,white,x	0.7–0.9,0.7–1,1.5–2.5,1.5–5.5,1.5–8,1.8–2,1–2,2.5–3,2.5–3.5,2–2.2,3.5–14,5–7,5–8,accrescent,acute,alyx,anthesi,axe,base,berry,blade,branch,c.,calyx,capitat,ciliat,climbing,conspicuous,contiguousl,cordate,cylindrical,deflected,deltoid,densely,distally,eaf,eed,enlarged,entire,fine,flattened,fleshy,fruiting,glabrescen,glabrou,gradually,herbaceous,immature,leafy,lobe,lower,m.,margin,midvein,nflorescence,nternode,oblique,one,orolla,pair,pendulou,perfec,pink,pinnate,planar,plurifoliate,pointed,prominent,pubescence,reduced,rounded,ruit,sand-punctat,sand-punctate,scar,secondary,seen,side,size,slightly,sometimes,somewhat,soon,spaced,spreading,tamen,tem,thickened,thickly,time,tip,toward,tree,truncate,tube,understory,unifoliat,unit,vary,vein,venation,weakly,wide,woody,ympodial	abaxial,adaxial,arrangement,capitate,colour,contiguously,corolla,form,growth,height,history,leaf,length,life,na,number,ovary,perennial,perfect,plant,position,reproduction,seed,shape,spacing,staman,texture,width
216	wfo-0001027289	success	194	104	71	123	33	0.366	0.3-1,0.5-1.4,0.8-2.6,1-5,1.1-1.5,10.5-12.5,12-17,4-11,5.5-7.5,7-13,abaxially,acicular,adaxially,andromonoecious,anther,articulated,bark,base,black,broadly,brown,calyx,chartaceous,circular,cm,cylindrical,densely,diameter,entire,erect,flower,fruit,fruiting,furrowed,glabrous,globose,green,grey,inflorescence,leaf-opposed,length,lobed,long,margin,midpoint,mm,ovate,pedicel,peduncle,perennial,petiole,pink,plant,prickle,pseudo-racemose,purple,rhizomatous,shallowly,shrub,simple,solitary,stellate,stellate-pubescent,straight,style,thick,unbranched,white,yellow,yellowish,yellowish-green	%,.05,0-0.7,0-1,0-3,0.05-0.1,0.25-0.7,0.3-0.9,0.4-0.8,0.5-0.7,1,1-2,1.2-2.5,1.3-1.5,1.4-1.8,1.5-2,1.5-2.3,1.5-3.5,10-16,16-35,2-foliate,2.4-3,2.5-2.8,3.5-5,3.5-7.5,30-160,4-7,4-locular,5-merou,6-8,6-9,7-10,7-8,absen,absent,accrescent,across,acute,adaxiall,alyx,apart,apex,ascending,axe,ba,blade,connivent,cordate,cork,cross-section,deltate,directed,distall,distally,distributed,dm,eaf,eed,eglandular,elliptica,exocarp,finger,functional,geminate,glabrou,gland-tipped,hair,half,heterostylous,juicy,lamina,lanceolate,lateral,less,lobe,longer,lower,markedly,mature,mesocarp,mid-point,minute,moist,nflorescence,oblique,obtuse,orolla,part,per,placenta,pore,porrect,present,probably,ray,ruit,rusty,short,spaced,stage,stalk,stalked,stellae,strongly,tal,tamen,tem,thicker,thicknes,throughout,time,transparent,tube,unarme,unarmed,unit,unknow,uvenile,vary,weakly,wide,x,ympodial	abaxial,adaxial,arrangement,bud,cell,center,colour,corky,corolla,elliptical,filament,form,growth,height,history,leaf,life,na,new,ovary,position,reproduction,scar,seed,shape,spacing,staman,stem,stigma,surface,texture,trichome,width
217	wfo-0001027290	success	165	75	44	121	31	0.267	.8,0.3-0.5,1.1-4.4,2-11,8-10,acicular,anther,apex,broadly,calyx,cm,densely,diameter,entire,extra-axillary,fruit,fruiting,glabrous,globose,green,grey-green,inflorescence,length,lobed,margin,mm,obtuse,ovate,pedicel,perennial,petiole,prickle,pseudo-racemose,purple,shallowly,shrub,simple,sparsely,stellate-pubescent,style,unknown,yellow,yellowish,yellowish-green	%,0-0.7,0-1,0-2.5,0-3,0.05-0.25,0.1-0.9,0.2-0.4,0.7-0.9,0.7-1.2,0.8-1.2,0.9-1.2,1-1.7,1-2,1-5,1.4-1.6,1.5-1.8,1.5-2,1.6-1.8,11-15,180-420,2-6,2.8-5.5,20-45,3-35,3-5,3-6,3.5-5,4-6,5-20,5-9.5,5-merou,50-70,6-8,7-8,8-9,abaxially,absent,across,adaxiall,adaxially,alyx,apart,armed,articulated,ascending,attenuate,axe,ba,base,blade,chartaceous,cordate,cylindrical,d.,directed,distall,distributed,eaf,eed,eglandular,erect,finger,flower,functional,gland-tipped,hair,half,juic,lamina,lateral,lobe,lon,long,longer,lower,mature,mesocarp,mid-point,midpoint,midvein,minute,moist,nflorescence,oblique,onl,orolla,part,peduncle,per,pore,porrect,presen,present,ray,rhizomatous,ruit,rusty,short,spaced,stage,stalk,stellae,straight,tal,tamen,tem,thick,throughout,time,tube,unbranched,unit,unknow,uvenile,vary,vein,white,wide,x,ympodial	abaxial,adaxial,arrangement,bark,bud,cell,center,colour,corolla,filament,form,growth,height,history,leaf,life,new,ovary,plant,position,reproduction,scar,seed,shape,staman,stem,stigma,surface,texture,trichome,width
218	wfo-0001027299	invalid_json_followup	237	139	82	155	57	0.346	25-30,abaxial,abaxially,acuminate,anther,apart,apex,ascending,asymmetric,base,bristle-like,calyx,campanulate,cm,delicate,densely,developed,diameter,elongating,erect,expanded,filament,flower,fruit,fruiting,glabrous,globose,hair,hirsute,inflorescence,intense,internode,lanceolate,lateral,leaf,length,lenticular,margin,midpoint,minutely,mm,orange,ovate,ovoid,pedicel,peduncle,pentagonal,petiole,pitted,plump,prickle,pubescent,purplish,racemose,ray,reniform,repand,rotate,short,short-stalked,shrub,simple,slightly,spreading,stellae,stellate,stellate-pubescent,stellate-tomentose,stem,stigma,stipitate-stellate,style,sun,surface,tan,undulate,violet,weakly,well,woolly,yellow,young	.5,0.2–3,0.3–0.8,0.5–1.5,0.8–1,0.8–1.2,0–10,1.2–1.5,1.3–1.7,1.5,1.5–3,1.5–4,11–17,15,15–19,1–2,1–3.5,1–4,2.5–4,2.5–5,2.7,2–13,2–2.7,3–3.5,4.5–13,4–10,5,5-merou,5.2,5–10,5–12,6,6–10,6–8,6–9,7–11,7–9,8–13,8–20,9–25,accrescent,acicular,adaxially,along,alyx,apiculate,apparently,appearing,articulated,axe,barely,becoming,blade,branch,branched,bristle,broadly,c.,cauline,common,composed,conduplicate,contiguous,cordate,coriaceous,deciduou,deltate,deltoid,dense,densest,directed,distall,distally,eaf,eed,entire,equalling,erry,exceeding,falcate,filiform,geminat,glabrou,initially,intergrading,intervening,interwoven,like,linear,lobe,long,long-stalked,lower,maturit,midvein,midzone,mixed,narrowly,nearly,nflorescence,obtuse,often,one,orolla,overtopped,perfect,plurifoliate,pore,prickly,principal,pubescence,rachise,rarely,reaching,ripe,secondary,shorter,side,similar,slender,smaller,sometimes,somewhat,some­what,soon,spaced,sparse,spreadingly,stalk,stalked,straight,styl,tall,tamen,tapering,tardily,tem,terminal,thick-textured,tippe,truncate,tube,ud,ultimate,unarme,unarmed,usually,vary,varying,vein,wooll,ympodia,×,–7,–9	'',0-10,0.3-0.8,0.8-1,1-2,1-3.5,1-4,1.3-1.7,1.5-3,1.5-4,11-17,2-13,2.5-4,5-10,5-12,7,7-11,7-9,8-13,8-20,9,[,``,adaxial,arrangement,bark,bud,characteristic,colour,corolla,form,growth,height,history,life,maturity,na,new,number,ovary,plant,position,rachi,reproduction,scar,seed,shape,spacing,staman,texture,tipped,trichome,value,width,x,{,}
219	wfo-0001027302	invalid_json_followup	188	120	86	102	34	0.457	0.4-5,0.5-1,0.6-1,1-1.3,1-1.5,1-2,1.2-2.5,10-20,2,2-6,2.2,3.5-5,3/4,7/8,abaxial,acuminate,acute,adaxial,anther,apex,appearing,bark,base,bright,brownish-yellow,calyx,capitate,clavate,cm,conical,corolla,crispate,dendritic,densely,diameter,elliptic,filament,fine,flat-topped,flattened,flower,fruiting,glabrous,globose,growth,later,lateral,leaf,length,lenticular,lobed,margin,minutely,mm,narrowly,ovary,ovate,pale,pericarp,petiole,pitted,plant,plurifoliate,puberulent,pubescent,pyramidal,red,reddish-brown,scar,scattered,shrub,simple,small,stem,stigma,style,surface,tapering,terminal,thin,tree,trichome,undulate,violet,way,young	.5,0.5,0.8-1,1,1-3,1.2-1.6,1.5-2,10,2-3,2.7-7.5,5-7,6-12,7,abaxially,adaxially,age,along,anthesi,apical,ba,basal,becoming,berry,blade,branching,broader,cordate,cultivation,decurrent,deflexed,deltoid,denser,dichasia,discussion,eaf,edicel,eed,entire,especially,ew,exserted,free,growing,inserted,juvenile,larger,lax,less,like,lobe,lon,long,long-triangular,lower,m.,main,monochasial,nflorescence,nodding,occasionally,older,otherwise,overtopping,pair,papillo,pedicle,per,planar,pore,poridical,portion,prominent,reflexed,ruit,scrambling,secondary,see,shade,shin,shoot,sleeve,slit-like,somewhat,sparsely,stamen,strongly,tall,time,tiny,tip,truncate,tub,tube,ud,unit,usually,vein,wide,winged,woody,x,ympodial	'',[,``,arrangement,bud,characteristic,colour,dense,form,fruit,green,height,history,inflorescence,life,na,new,number,pedicel,peduncle,perennial,position,prickle,rachi,reproduction,seed,shape,spacing,staman,texture,value,width,{,}
220	wfo-0001027310	invalid_json_followup	215	133	97	118	36	0.451	/3,0.05,0.6-1,0.7-2,1-1.2,1-1.7,1-6,1.5-5,2-10,2-3.1,20-60,4-10,4-9,4.5-5.5,5-20,5-merous,8-10,abaxial,acute,adaxial,andromonoecious,anther,apex,bark,base,berry,branched,branching,broadly,calyx,chartaceous,cm,dark,deltate,densely,diameter,entire,erect,evenly,filament,flattened-reniform,flower,foliaceous,fruit,fruiting,glabrescent,glabrous,glaucous,gray,green,green-brown,lanceolate,lateral,leaf,length,less,lobed,long,margin,maturity,mauve,minutely,mm,moderately,orange-brown,pale,pedicel,peduncle,petiole,pitted,plant,porrect-lepidote,prickle,primary,pubescent,purple,red,scar,secondary,sessile,shallowly,shrub,sparsely,spherical,stellate,stellate-pubescent,stem,style,surface,terete,terminal,tree,trichome,unarmed,way,yellow,young	-2.2,-20,.8,0,0-20,0-5,0.05-0.15,0.1,0.1-0.2,0.15-0.3,0.9-0.17,1.1-1.5,1.5-2.2,1/10-1/6,1/3-1/2,1/3-3/4,11-16,2-4,2-5,2.2-2.5,2.8-3,2/3,22-30,3-15,4.5-7,5-10,5-7,6-8,7-10,9-13,abaxially,acut,alyx,apar,apart,apically,apparently,articulated,blade,connivent,cuneate,curved,discolorous,distal,drying,eaf,eed,elongating,equal,faint,flattened,free,fused,gently,glabrou,hair,hermaphrodite,heterostylous,inflated,infructescence,lobe,long-styled,longer,lower,lowermost,mature,midpoint,nflorescence,older,one,open,orolla,oung,pair,pendulous,per,pericarp,plurifoliat,poricidal,porrect,portion,prickly,ray,reddi,reflexed,rounded,ruit,short-styled,shorter,simple,smooth,sometimes,spaced,sparse,spreading,stalk,stalked,staminat,stout,straight,strongly,tamen,tapering,tertiary,time,tip,toward,truncate,tube,unarme,unit,vary,vein,venation,visible,wide,woody,ympodial	'',[,``,arrangement,bud,cell,center,characteristic,colour,corolla,form,growth,height,history,inflorescence,life,na,new,number,ovary,perennial,plurifoliate,position,rachi,reddish,reproduction,seed,shape,spacing,staman,stigma,texture,value,width,{,}
221	wfo-0001027313	success	173	104	63	110	41	0.364	.7,1.5,4,50,abaxially,adaxially,anther,apex,atenuate,broadbased,cm,densely,diameter,dull,filament,flower,fruit,glabrous,globose,green,hair,high,internode,interpetalar,lanceolate,lateral,leaf,little,loosely,minutely,mm,narrowly,ovate,ovoid,pedicel,peduncle,persistently,petiole,pitted,prickle,purplish,shrub,simple,small,sparse,stellate,stellate-tomentose,stem,stigma,style,surface,thick-chartaceous,tissue,tomentose,tree,unarmed,violet,weak,whitish,whitish-tomentose,yellow,yellowish,×	.5,0.15,0.1–0.3,0.5–0.6,0.8–1,1.2–1.3,1.2–1.4,1.5–2,1–1.3,1–2,1–4,2–3-branched,2–4.5,2–8.5,3–3.5,3–4,3–5.5,3–9,4.5–5,5,5-merou,5.5–16,5.5–7,5–6,6–11,6–8,acute,adaxiall,along,alyx,apar,apical,apparently,articulated,attenuate,axe,base,blade,branch,branched,capitat,cordate,dbh,difoliate,directed,distall,eaf,eed,entire,filiform,finely,geminat,half,homostylous,immature,irregularly,like,lobe,lon,long,lower,margin,maturing,midpoint,midvein,minute,much,nearly,nflorescence,obtuse,orolla,perfect,pore,porrect,principal,rarely,ray,ruit,scar,sessile-stellate,short-stalked,short-stipitate,shorter,side,similar,sinuate,sinus,slender,sometimes,splitting,stalk,stellae,stellate-pubescent,stellate-tomento,tamen,tem,time,triangular,tube,ud,unarme,undulate,usually,vary,vein,vigorous,wide,ympodia,–12,–3	0.5,0.8-1,1-1.3,1-4,1.2-1.3,1.2-1.4,2-3-branched,2-8.5,3-5.5,4.5-5,5-merous,5.5-7,6-11,abaxial,adaxial,apart,arrangement,bud,capitate,colour,corolla,form,growth,height,history,inflorescence,length,life,na,number,ovary,plant,position,rachi,reproduction,seed,shape,spacing,staman,texture,width
222	wfo-0001027315	invalid_json_followup	217	117	85	132	32	0.392	0.15-0.2,0.2-0.5,0.3-0.6,0.3-1,0.4-0.7,0.5,0.6-0.7,0.6-0.8,1.5-2,2,2-2.5,2-5,3-7,acute,anther,apex,armed,bark,blue-green,brown,calyx,capitate,cm,conical,corolla,densely,diameter,dioecious,ellipsoid,elliptic,entire,filament,filiform,flattened,flower,fruiting,glabrous,globose,greyish-white,growth,inflorescence,internodal,length,lepidote,margin,minutely,mm,new,ovary,packed,pale,paler,pedicel,peduncle,pentagonal,petiole,pitted,plant,porrect,prickle,pubescent,purple,reddish,reniform,ripe,scar,scattered,shiny,shrub,simple,somewhat,stellate,stem,stigma,straight,style,surface,thin,tightly,trichome,unarmed,unisexual,white,yellowish,young	.15,.5,.5x,.9,0.2,0.25-0.4,0.3-0.5,0.6-0.6,0365,1-1.3,1-1.5,1-2,1.3-3,1.5-1.7,1.5-3,10-20,2-7.5,2/3,3,3-3.5,3-5,5-7,8,<,?,abaxially,adaxially,age,almost,along,anthesi,arching,articulated,base,berry,broad-based,consisting,correlated,dark,deltate,dense,difoliate,discolorous,drying,eaf,echinoid,eed,ekman,especially,exerted,female,fide,free,fused,geminat,glabrescen,globular,half,hangin,highly,immature,impressed,lamina,lengthening,like,lobe,lobed,long,lower,male,marginal,markedly,midpoint,midrib,minute,mixture,nflorescence,oblique,obscuring,occasionally,often,older,overlappin,pair,papillo,per,pericarp,pistillate,plan,planar,pore,poricidal,portion,present,pricklines,primary,prominent,ray,rest,rhachi,rounded,ruit,sessile,shoot,short,short-stalked,shorter,similar,slit,smaller,solitary,sparse,sparsely,stalked,staminate,stellate-lepidote,strongly,throughout,tip,tube,ud,unit,vein,venation,vestigial,visible,way,without,woody,x,ympodial,½	'',1,[,``,abaxial,arrangement,bud,center,characteristic,colour,form,fruit,glabrescent,height,history,leaf,life,na,number,perennial,position,rachi,reproduction,seed,shape,spacing,staman,texture,value,width,{,}
223	wfo-0001027317	success	144	96	62	82	34	0.431	.25,0.1-0.2,0.4-1.5,0.5-1,1,1-1.5,1-2,1.4-1.6,3-3.5,4.5-5,?,abaxial,acuminate,acute,anther,apex,apically,bark,bilobed,broadly,calyx,closely,cm,conical,corolla,densely,ellipsoid,elliptic,erect,filament,filiform,fruit,fruiting,glabrous,globose,green,leaf,lobed,margin,mm,offset,opposite,ovary,pale,pedicel,petiole,pointed,pubescent,scar,shrub,simple,slightly,spaced,sparsely,stem,stigma,style,surface,trichome,uniseriate,white,x	.5,0.3-1,0.5-3,0.8-3.5,1-5,1.5-2,2-3-flowered,2-9,7-9,adaxially,along,anthesi,apical,arch,ba,base,beneath,berry,cucullate,deciduous,deflexed,deltoid,dia,differing,difoliate,drying,eaf,edicel,eed,elongated,expanded,free,geminat,golden,greyish-whit,immature,inflorescenc,joined,known,lateral,like,lobe,lon,long,long-exserted,lower,main,major,mature,minor,minute,minutely,nearly,nflorescence,older,overlappin,pair,papillo,papillose,pore,poricidal,portion,projection,prominent,reflexed,rest,ruit,series,shaped,size,soon,strongly,tall,tear-drop,tip,tub,tube,ud,vein,woody,ympodia,young	2-3,adaxial,alternate,arrangement,bud,cell,center,colour,diameter,flower,form,greyish-white,growth,height,history,inflorescence,length,life,na,new,number,overlapping,peduncle,perennial,plant,position,rachi,reproduction,seed,shape,spacing,staman,texture,width
224	wfo-0001027323	success	175	99	68	107	31	0.389	/3,0.5-1,1-1.5,1.2-1.5,2-3,2-6,2.5-3,5-7,acute,adaxial,anther,apex,area,attenuate,bark,base,berry,broadened,bud,calyx,closely,cm,corolla,densely,elliptic,erose,filament,fleshy,flower,fruit,fruiting,furcate,glabrous,globose,grey,leaf,lobed,margin,minutely,mm,occasionally,opposite,ovary,overlapping,ovoid,ovoid-reniform,papillose,pedicel,petiole,pinkish-grey,pitted,plant,red-papillose,reddish-grey,scar,spaced,stem,stigma,style,surface,tan,thin,tip,treelet,way,white,winged,x	.75,1-2,10-15,14-21,20-45,3-5,5-20-flowered,6-11,7-9,along,anthesi,apparent,appearing,arising,asymmetric,ba,campanulate,character,closed,cork,decurrent,deflexed,dia,differing,difoliate,dried,dry,eaf,edicel,eed,elongate,entire,erect,exserted,five-pointed,flopping,free,geminat,glabrate,growing,held,higher,hood,hooded,immature,interpetalar,lateral,like,live,lobe,lon,long,long-triangular-deltoid,lower,main,major,matte,mature,measured,middle,minor,nflorescence,older,one,onto,pair,papillae,papillo,partially,persistent,planar,pore,poricidal,portion,prominent,proximal,rather,rest,ridge,ruit,secondary,seen,shaped,sinus,size,slightly,small,smoot,soon,specimen,straight,tall,tear-drop,thickened,tiny,trunk,tube,two,ud,unit,upper,vein,visible,widest,woody,ympodial,young	5-20,abaxial,alternate,arrangement,cell,center,colour,diameter,form,growth,height,history,inflorescence,length,life,na,new,number,peduncle,perennial,position,rachi,reproduction,seed,shape,smooth,spacing,staman,texture,trichome,width
225	wfo-0001027340	invalid_json_followup	189	109	67	122	42	0.354	0.5-0.9,1-10,1-2,16-22,2-4,3.5-5,5-11,5-6,7-8,8-14,8-9.5,abaxially,adaxially,anther,apex,axillary,bud,cell,chartaceous,cm,cordate,corolla,covering,dark,diameter,elliptic,filament,flower,forked,fruit,glabrous,globose,green,greenish,herb,lateral,lilac-purple,margin,membranous,minutely,mm,odd-pinnate,ovate,ovoid,pedicel,peduncle,petiole,plant,puberulent,pubescent,purple,rotate,rounded,seed,sparsely,stem,stigma,style,subtending,terminal,testal,thick,tinged,truncate,wall,whitish,yellow	1-3,1.5-2.7,10-16,2-3,2-3.5,2.5-4.5,2.7-4.5,3-4,3.5-9,4-6,4-7.5,5-merou,6-8.5,7-18,abruptly,absent,acumen,acuminate,ag,along,alyx,apart,apparently,articulated,articulation,auriculate,axe,base,berry,blade,brownish,capitat,ciliate,condition,connivent,decreasing,developing,digestion,distal,distinct,dorsally,drying,eaf,edge,eed,enzyme,especially,exceeding,flat,folded,fresh,geminat,generally,glabrou,green-white,hair,hair-like,hal,half,high,homostylous,honeycomb-shaped,indistinct,interjected,lanceolate,leaflet,lengthening,like,living,lobe,long,lower,make,midrib,minute,mucilaginous,narrow,narrowed,nflorescence,orolla,pair,papillose,perfect,petiolulate,plurifoliate,pointed,pore,poricidal,purpl,removed,ripe,ruit,semi-erec,semi-rosette,sessile,seudostipule,short,shortly,size,slightly,slit,spaced,specimen,splotched,stamen,ste,straight,tall,tamen,tem,throughout,tip,tri-,tube,unit,usually,vary,wet,wing,x,ympodial,young	'',[,\u201chair-like\u201d,``,abaxial,adaxial,arrangement,bark,calyx,capitate,center,characteristic,colour,form,fruiting,growth,height,history,inflorescence,leaf,length,life,na,new,number,ovary,perennial,position,prickle,rachi,reproduction,scar,shape,spacing,staman,surface,texture,trichome,value,width,{,}
226	wfo-0001027354	invalid_json_followup	166	109	77	89	32	0.464	0.5-2,0.7-1.3,1-1.5,1-7,1.5-1.8,1.5-2,10-20,3.4-4,4-10,5-7,abaxial,abaxially,acute,adaxial,anther,apex,appearing,bark,bi-lobed,branch,branching,calyx,cm,conical,corolla,dark,dendritic,densely,diameter,elliptic,filament,flattened,flower,fork,fruit,fruiting,globose,golden,growth,later,lateral,leaf,length,lenticular,lobed,loosely,minutely,mm,narrowly,occasionally,ovary,pedicel,pericarp,petiole,pitted,plurifoliate,pubescent,purplish-black,pyramidal,reddish-brown,scar,shrub,small,sparsely,stem,stigma,style,surface,tapering,terminal,thin,tiny,tree,tree-like,trichome,violet,white	.5,0,0.5,1,1-1.2,1.7-5,10,2.5-3.5,3-4,3/4,6.5-13,8-12,absent,age,along,anthesi,apical,ba,basal,base,becoming,belo,berry,blade,covered,deltoid,denser,dichasia,drying,eaf,edicel,eed,entire,erect,ew,exserted,free,glabrate,glabrous,inserted,less,like,lobe,long,loose,lower,m.,monochasial,mostly,near,nflorescence,nodding,older,pair,papillo,per,planar,pore,poricidal,portion,pubescen,raised,ruit,secondary,side,simple,sleeve,slightly,slit-like,somewhat,stamen,strongly,tall,thecalyx,time,tip,tub,tube,type,ud,unit,vein,way,wide,winged,woody,x,ympodial,young	'',[,``,arrangement,bud,center,characteristic,colour,form,height,history,inflorescence,life,margin,na,new,number,peduncle,plant,position,prickle,rachi,reproduction,seed,shape,spacing,staman,texture,value,width,{,}
227	wfo-0001027359	invalid_json_followup	224	147	111	113	36	0.496	-2,-3,.1,.5,/3,/4,0,0-9,0.1-1.5,0.3-1.2,0.5-1,0.5-2,1-1.2,1-5,1.2-1.5,1.5-2,2.5-3.5,3-10,4-,5-6.5,5-merous,6-8,abaxially,acute,anther,apex,bark,base,berry,branched,bright,calyx,cell,chartaceous,cm,dark,deltate,densely,diameter,dull,elongating,entire,erect,filament,filiform,flattened,flattened-reniform,flower,fruit,fruiting,glabrescent,glabrous,gray,green,lateral,leaf,length,lobed,margin,mature,maturity,membranous,minutely,mm,moderately,near,occasional,orange-brown,outline,ovate,ovoid,pale,pedicel,peduncle,petiole,pit,porrect,prickle,prickly,purple,rachi,raised,red,reflexed,reticulate,scandent,scar,shallowly,shrub,simple,small,smooth,sometimes,sparsely,spherical,stalked,stellate,stellate-pubescent,stem,stump,style,surface,terete,terminal,trichome,unarmed,undulate,way,white,yellow,yellow-brown	-0.25,-20,-4,-7,-9,.2,0-2,0-3,0-5,0.1,0.1-0.2,0.3-0.5,0.5,0.6-0.8,0.6-1,1-2,1-3,1-4,1.2-2,1.5-2.5,1.8-3.2,1/5-1/4,2-10,2-3,2-4,2.5-5.5,4-5,5-,7-8,acut,alyx,apar,apart,apically,apparently,articulated,ba,blade,brow,concolorous,coroll,cream,cuneate,curved,difoliate,distinctive,drying,eaf,eed,elongate,equal,eye,free,geminat,herbaceous,infructescence,less,like,lobe,long,longer,lower,marking,midpoint,naked,narrow-deltate,narrow-ovate,nflorescence,obtuse,often,older,one,open,orolla,oung,pair,per,perfec,pericarp,poricidal,portion,primary,rarely,ray,ruit,sessile,shorter,slender,slightly,spaced,spreading,stalk,tamen,tapering,tertiary,time,tinge,tip,tube,ud,unarme,unit,usually,variously,vary,vein,venation,visible,weakly,wide,woody,ympodial,young	'',[,``,abaxial,adaxial,arrangement,brown,bud,center,characteristic,colour,corolla,form,growth,height,history,inflorescence,life,na,new,number,ovary,perennial,plant,position,reproduction,seed,shape,spacing,staman,stigma,texture,value,width,{,}
228	wfo-0001027365	success	233	117	73	160	44	0.313	5-merous,abaxial,adaxial,andromonoecious,anther,apparently,articulated,bark,base,blue,branched,broadly,brown,calyx,capitate,chartaceous,cm,dark,densely,diameter,elliptic,entire,extraaxillary,filament,flower,fruit,fruiting,glabrous,globose,golden-tan,green,inflorescence,juicy,lanceolate,leaf,length,light,lighter,margin,mm,multangulate,multangulate-stellate,obtuse,orange,outline,pedicel,peduncle,petiole,plant,prickle,pubescent,rachi,reniform,repand,rotate-stellate,rugose,shallowly,simple,slightly,sparsely,stellate,stem,stigma,stout,style,subcoriaceous,surface,tan,tree,truncate,unbranched,violet,yellow	.1,.1–0.3,.2,.5,0,0.1–0.3,0.2–0.5,0–0.03,0–0.1,1,1.1–1.4,1.5–1.8,10–15,11–14,14–15,15–30,1–1.9,1–4,2,2.2–2.3,2.3–4.2,2.5–4.5,2.6–3,2.8,2–,2–5,3,3–10,3–3.5,3–3.9,4.5–5,4–4.5,4–5,5–5.5,5–8,6–7.5,7–1,7–15,8–15,8–9,abaxially,absent,acuminate,acute,adaxially,ag,along,alyx,andromonoeciou,anthesi,apart,apex,axe,ba,becoming,berry,bilobe,blade,broad-based,central,column,congested,connivent,cuneate,curved,cylindrical,db,difoliate,directed,discolorous,distally,dried,eaf,eed,eglandular,either,emergent,equal,flattened,flowering,free,fresh,frui,functionally,geminat,glandular,hair,half,hermaphroditic,heterstylous,included,inflated,interpetalar,knobby,like,lobe,lobed,long,longitudinal,lower,major,maturity,membranaceous,midpoint,midvein,moderate,moderately,mostly,mpodial,multiseriate,multiseriate-stalked,nearly,nflorescence,oblique,often,one,opening,orolla,part,pericarp,pore,porrect-stellate,portion,pronounced,ray,reduced-stellate,reflexed,ruit,runk,sessile,sharp,shiny,short-stalked,side,slit,somewhat,spaced,stalk,stalked,staminate,stellate-pubescent,straight,strongly,subtending,tamen,tapered,thi,time,tissue,tube,unarmed,unit,vary,vein,wide,within,young,×,–2,–20	0.1-0.3,1-4,1.5-1.8,10-15,13,14-15,2-5,2.3-4.2,2.5,2.5-4.5,20,3-10,4-5,4.5,4.5-5,8-15,arrangement,bilobed,bud,cell,center,colour,corolla,form,growth,height,history,life,na,new,number,ovary,perennial,position,reproduction,scar,seed,shape,spacing,staman,texture,trichome,trunk,width
229	wfo-0001027366	success	136	87	53	83	34	0.39	0.5-1,0.7-1,1-2,1-3,11-21,2-2.5,4-5,5-7,6-19,acute,anther,apex,bark,bright,broadly,brown,capitate,closely,cm,corolla,dark,drying,elliptic,filament,glabrous,globose,golden,green,greenish-white,internodal,leaf,lobed,minutely,mm,opposite,orbicular,ovary,ovoid,ovoid-reniform,packed,pale,pedicel,petiole,pitted,scar,shining,shrub,simple,sometimes,somewhat,stigma,style,surface	.5,/2,/4,0.25-0.5,1-1.5,1.5-2,3-10-flowered,3-9,4-4.5,603,abaxially,adaxially,anthesi,ape,axe,ba,base,berry,calyx,conical,conspicuously,deflexed,deltate,dia,eaf,edicel,eed,erect,et,except,exserted,fide,free,fruiting,lamina,lateral,less,lobe,lon,long,long-triangular,lower,main,margin,middle,nflorescence,older,overlappin,pair,papillo,papillose,parallel,planar,pointed,pore,poridical,portion,ramo,reddish,rounded,ruit,secondary,shaped,stem,straight,tall,tear-drop,tip,trichome,tub,tube,ud,unifoliat,unit,vein,venation,way,wide,widest,woody,yellowish-gre,ympodial,young	3-10,abaxial,adaxial,arrangement,bud,cell,center,colour,diameter,flower,form,fruit,growth,hair,height,history,inflorescence,length,life,na,number,peduncle,plant,position,rachi,reproduction,seed,shape,spacing,staman,texture,unifoliate,width,yellowish-grey
230	wfo-0001027368	invalid_json_followup	145	106	58	87	48	0.4	-15,-20,-5,.5,0.3-2.5,0.5-3.5,0.5-5,1-2,1.5-2,3,4-6,5-15,5-6,acuminate,acute,apart,apex,calyx,cell,chartaceous,cm,densely,diameter,ellipsiodal,elliptic,elliptic-ovate,entire,forked,glabrous,globose,lanceolate,lenticular,margin,mm,narrowly,nearly,otherwise,ovoid-fusiform,pedicel,peduncle,petiole,puberulent,pubescent,purple,rachi,shrub,simple,sparsely,stellate,stigma,style,subcoriaceous,truncate,unbranched,unknown,white,x,yellow	-10,-2,0.8-2,1-15-flower,1-6,1.5-2.5,2,2-2.5,2-3,2-4,2-9,3-12.5,4-many-foliat,5-10,8-13,abaxially,abruptly,absen,adaxiall,adaxially,aggregate,also,articulated,axe,ba,base,blade,branched,color,connivent,contiguous,cuneate,cylindrical,darker,decurrent,deltate,dendritically,denser,directed,distally,eaf,eed,except,gland,hair,lighter,lobe,long,long-stalked,lower,midvein,moderately,narrowed,nflorescence,nther,oblong,obtuse,occasionally,often,orolla,pore,pubescen,radiu,ray,ruit,small,sometimes,spaced,stalked,star,stone,subcapitat,subhastate,tal,tem,terminal,three,time,tip,triangular,tube,unit,usually,vary,vein,wide,ympodial	'',1-15,[,``,abaxial,adaxial,anther,arrangement,bark,bud,center,characteristic,colour,corolla,filament,flower,form,fruit,fruiting,growth,height,history,inflorescence,leaf,length,life,na,new,number,ovary,plant,position,prickle,reproduction,scar,seed,shape,spacing,staman,stem,subcapitate,surface,texture,trichome,value,width,{,}
231	wfo-0001027369	invalid_json_followup	191	115	78	113	37	0.408	-1,-10,.5,/4,0-1,0.1-0.3,0.2-0.5,0.5-0.8,0.6-0.8,1-2.5,1.5-2,2-4,2-5,4-8,5-merous,anther,apart,apex,articulated,bark,base,berry,branched,calyx,cm,densely,diameter,elongating,erect,filament,flower,fruit,fruiting,glabrous,glaucous,green,lateral,leaf,length,lobed,long,margin,mature,mauve,membranous,mm,orbicular,pale,pedicel,peduncle,petiole,porrect,prickle,prickly,reflexed,reniform,rounded,scandent,scar,sessile,shrub,simple,slightly,smooth,sparsely,spherical,stalked,stellate,stellate-pubescent,stem,straight,style,surface,terete,terminal,trichome,way,yellow	-11,-2,.1,.4,.7,0,0-15,0-3,0-5,0-6,0.05-0.15,0.1,0.1-0.2,0.25-0.4,0.3-1.5,0.5,0.5-1.5,1-,1-2,1-3,1-4,1.2-2.5,1.2-3,1/3,2-3,3,3-10,3-4,4-5,5,7-15,abaxially,acut,almost,alyx,ame,apar,apically,apparently,blade,broad-deltate,c.,color,concolorous,cordate,curved,deltate,difoliate,distance,drying,eaf,eed,equal,extending,eye,filiform,free,geminat,glabrou,gra,hair,herbaceous,infructescence,know,known,lanceolate,less,lobe,lon,lower,midpoint,midvein,moderately,multangulate,naked,narrowly,nflorescence,older,one,open,orolla,oung,pendulous,per,perfec,pericarp,perpendicular,poricidal,portion,prickl,ray,ruit,side,slender,spaced,spreading,stalk,strongly,tamen,tapering,time,tip,tube,unarmed,unequal,unit,vary,venation,visible,wide,wider,winged,ympodial	'',-5.5,0.1-1.5,[,``,abaxial,adaxial,arrangement,bud,characteristic,colour,corolla,form,gray,growth,height,history,inflorescence,life,na,new,number,ovary,plant,position,rachi,reproduction,seed,shape,spacing,staman,stigma,texture,value,width,{,}
232	wfo-0001027378	invalid_json_followup	149	105	53	96	52	0.356	.2,5-8,abaxially,acuminate,adaxial,adaxially,anther,apex,blue,broadly,calyx,chartaceous,cm,diameter,extra-axillary,filament,fleshy,flower,fruit,fruiting,glabrous,herbaceous,leaf,light,margin,membranous,minutely,mm,ovate,ovoid,papillose,pedicel,peduncle,pentagonal,petiole,pubescent,rachi,revolute,rotate-stellate,simple,slender,somewhat,sparsely,stem,stigma,style,terrestrial,trichome,unbranched,unknown,vine,white,x	0.5–1,0.7–1,0.8–2.5,1.2–1.5,1.2–1.8,1.5–1.8,1.5–8,15–35,1–1.5,1–3,2.3–5,2.5–7,2–11,2–2.2,2–2.5,3–4.5,3–5,3–6,4–6,4–9,5-merous,5–10,5–13,5–7,6–10,6–7,acute,alyx,apar,apicall,axe,base,berry,blade,c.,capitat,ciliate,clavate,climbin,color,cordate,cylindrical,deeply,deltoid,densely,eaf,eed,flattened,glabrou,hair,hair-tipped,half,lanceolate,like,lobe,lon,long,longer,lower,m.,markedly,moderately,narrowly,nflorescence,nternode,obscure,often,orolla,palmate,perfec,plurifoliat,pointed,primary,rounded,ruit,sand-punctat,sand-punctate,scattered,short,side,slightly,small,spaced,tamen,tem,tip,tooth,tube,unit,unknow,vary,vein,venation,wide,widely,ympodial	'',0.5-1,0.7-1,0.8-2.5,1.5-1.8,15-35,2-11,2-2.2,2.5-7,3-6,4-6,5-13,[,``,abaxial,arrangement,bark,bud,capitate,cell,center,characteristic,climbing,colour,corolla,form,growth,height,history,inflorescence,length,life,na,new,number,ovary,perfect,plant,position,prickle,reproduction,scar,seed,shape,spacing,staman,surface,texture,value,width,{,}
233	wfo-0001027378	invalid_json_followup	141	101	59	82	42	0.418	.2,0.7-1,0.8-2.5,1.5-1.8,15-35,2-11,2-2.2,2-4,2.5-7,3-6,4-6,5-13,5-8,acuminate,anther,apart,apex,blue,broadly,calyx,chartaceous,climbing,cm,diameter,extra-axillary,filament,fleshy,flower,fruit,fruiting,glabrous,herb,leaf,light,margin,minutely,mm,multicellular,ovate,pedicel,peduncle,perfect,petiole,pubescent,rachi,revolute,rotate-pentagonal,simple,slender,somewhat,sparsely,stigma,style,terrestrial,unbranched,unknown,white,x,yellow	1-1.5,1-3,1.2-1.5,1.5-8,2.3-5,3-4.5,3-5,4-9,5-merou,6-10,6-7,abaxially,acute,adaxially,ag,alyx,apicall,apparently,articulated,axe,ba,basally,base,blade,capitat,ciliate,clavate,connivent,cordate,cylindrical,deeply,deltoid,densely,directed,distally,eaf,eed,equal,geminat,hair,hair-tipped,lanceolate,large,lobe,long,longer,longitudinal,lower,moderately,narrowly,nflorescence,node,oblong,obscure,often,opening,orolla,plurifoliate,pore,pubescen,rooting,rounded,scattered,short,slightly,slit,small,spaced,tamen,tem,tip,tooth,trailing,tube,unit,unknow,vary,vein,weakly,wide,widely,ympodial	'',[,``,abaxial,adaxial,arrangement,bark,bud,capitate,cell,center,characteristic,colour,corolla,form,growth,height,history,inflorescence,length,life,na,new,number,ovary,plant,position,prickle,reproduction,scar,seed,shape,spacing,staman,stem,surface,texture,trichome,value,width,{,}
234	wfo-0001027380	success	134	90	63	71	27	0.47	.5,2-3,2-3.5,30-35,4-6.5,5,5-merous,?,abaxially,acuminate,adaxially,anther,apex,bark,base,berry,broadly,chartaceous,cm,conical,deeply,diameter,distally,extra-axillary,filament,flattened,flower,forked,fruit,glabrous,globose,greenish-brown,homostylous,hooked,leaf,minute,minutely,mm,orange-red,ovate-lanceolate,paler,pedicel,peduncle,petiole,prickle,pubescent,rachi,red,reticulate,shrub,simple,slender,slightly,small,smooth,sparsely,stellate,stigma,style,thickening,tree,unbranched,white	0,1-1.5,11-17,1136.,2.5-3,3-4,5-8,9-10,accrescen,adaxiall,almost,alyx,apparently,armed,articulated,axe,ba,blade,brown,calyx,capitat,developed,drying,eaf,eed,entire,erect,fruiting,geminate,hair,hartley,len,lobe,lon,long,loose,lower,margin,mpodial,nflorescence,oblique,occasionally,open,orolla,oung,pair,perfec,perfect,primary,rip,rounded,ruit,scarcely,scattered,scramblin,shallow,somewhat,sparse,stem,structure,tall,tamen,testa,triangular,truncate,unarmed,unknown,vary,vein,visible,x	abaxial,adaxial,arrangement,capitate,colour,corolla,form,growth,height,history,inflorescence,length,life,na,number,ovary,plant,position,reproduction,seed,shape,spacing,staman,surface,texture,trichome,width
235	wfo-0001027381	success	262	120	92	170	28	0.351	.3,.8,0-1,0-1.5,0.2,0.5-0.6,0.5-1,1-2,1-2.5,1.5-4,2-3,3.5-4,4-5,5-11,almost,anther,apex,bark,blackish,brown,calyx,capitate,clavate,cm,cream,dark,diameter,distributed,drying,dull,elliptic,erect,evenly,filament,filiform,flower,fruit,fruiting,glabrous,globose,green,grey,inconspicuous,lateral,leaf,length,less,light,lobed,margin,marking,maturity,mauve,mm,obconical,oblong,obtuse,orange,orange-green,ovate,pale,pedicel,peduncle,perfect,petiole,plant,porrect,prickle,rachi,rounded,scar,sessile,shiny,shrub,simple,slender,smooth,stellate,stellate-pubescent,stem,stigma,striate,stump,style,surface,thin,trichome,white,yellow,yellow-green,yellowish,young	.4,/5,0.1,0.3-0.5,0.4-0.6,0.5,0.5-0.7,0.6-0.7,0°,1-1.5,1/3-1/2,1/4-1/3,2,2-2.5,2-4,2-6,3-4,3-5,3-7.5,4-8,5-8,5-merou,7-8,8-10,abaxially,absent,accrescent,acute,adaxially,age,along,alyx,angle,apically,apparently,area,articulated,attachment,base,berry,blade,branch,branched,chartaceous,clearly,concolorous,cordate,covering,curved,delineated,deltoid,densely,density,difoliate,dilated,distance,divided,eaf,eed,ellipsoi,elongated,elongating,epidermi,equal,even,exserted,extending,eye,faint,fertile,flat,flattened,free,geminat,gland,greyi,higher,indumentum,infructescence,irregula,known,lamina,lanceolate,lengthening,like,lobe,long,long-deltoid,longer,longitudinal,lower,main,mature,midpoint,midvein,minute,mostly,naked,never,nflorescence,oblique,obscuring,often,orolla,pair,papillose,part,pendulous,per,pericarp,point,pore,poricidal,portion,present,primary,prominently,protruding,puffy,raised,rarely,ray,reduced,region,rest,right,ruit,shallow,side,sinus,size,slightly,slit,small,smoot,sometimes,sparse,sparsely,spreading,stalk,straight,surrounded,tamen,tapering,terminal,tertiary,time,tip,tissue,translucent,truncate,tube,ud,unarme,unarmed,unit,usually,variable,variously,vary,vein,venation,visibl,visible,wide,widening,without,woody,x,ympodial	5-merous,abaxial,adaxial,arrangement,bud,cell,center,colour,corolla,ellipsoid,form,greyish,growth,height,history,inflorescence,life,na,new,ovary,perennial,position,reproduction,seed,shape,staman,texture,width
236	wfo-0001027384	success	155	97	65	90	32	0.419	.5,0.4-1.1,0.9-1,1-3,1-4,1.5-2,3/4,5-5.5,7.5-8,anther,apart,bark,base,brown,bud,calyx,capitate,clavate,cm,corolla,deep,ellipsoid,filament,flattened-reniform,glabrous,globose,green,hard,herbarium,later,leaf,lobed,long,minutely,mm,mustard,narrowly,obovate,opposite,ovary,pale,papillose,pedicel,petiole,pitted,pseudo-terminal,reddish-purple,scar,shining,shrub,simple,slender,small,specimen,stigma,style,sulcate,surface,tapering,tree,tube,way,white,yellow,young	.25,.75,/3,0.5-1,1-1.3,1-1.5,2.5-6.5,3-3.5,3-4,4-7,5-15-flowered,7-14,abov,acute,anothe,anthesi,apex,ba,beginning,beneath,berry,breaking,broadly,closely,cuneate,dia,difoliate,distal,drying,eaf,edicel,eed,equal,erect,free,fruiting,geminate,incrassate,inflorescenc,lateral,lobe,long-exserted,lower,main,margin,member,middle,nflorescence,occasionally,older,overlapping,pair,paler,papillo,peeling,planar,pore,poricidal,portion,prominent,rarely,rounded,ruit,section,shaped,siz,spaced,stem,straight,subcoriaceous-fleshy,tall,tear-drop,thick,tip,transverse,triangular,trichome,tub,tuft,ud,uniseriate,unit,vein,widely,widest,without,woody,x,yellowish,ympodial	5-15,abaxial,adaxial,alternate,arrangement,cell,center,colour,diameter,flower,form,fruit,growth,height,history,inflorescence,length,life,na,number,peduncle,perennial,plant,position,rachi,reproduction,seed,shape,spacing,staman,texture,width
237	wfo-0001027389	success	154	96	63	91	33	0.409	.1,.5,0.25-0.3,0.5-1.5,0.6-1,1-1.5,1-2,3-3.5,5-7,anther,apart,apex,bark,broadening,broadly,brown,bud,calyx,cm,conical,corolla,dark,elliptic,erect,filament,filiform,fruiting,glabrous,globose,green,hispidulous,inflorescence,leaf,lobed,margin,minutely,mm,opposite,ovary,ovate,ovoid-reniform,papillose,pedicel,petiole,pitted,puberulent,reddish-golden,scar,shrub,slight,sparsely,stem,stigma,style,surface,thread-like,top,trichome,truncate,uniseriate,white,winged,yellowish	.25,0.25-0.5,0.5-0.75,1,1.8-1.9,11-14,2-2.5,3-4.5,4-5-flowered,7-8,acuminate,acute,along,anthesi,ba,base,beneath,berry,decurrent,deflexed,deltoid,dia,dry,eaf,edicel,eed,ellipsoid,evenly,except,expanded,exserted,foetid,foliage,free,geminate,lateral,like,lobe,lon,long,lower,main,making,material,middle,nearly,nflorescence,node,non-reproductive,obovoi,occasionally,often,older,one,pair,paler,papillo,pore,poricidal,portion,prominent,prominently,proximal,raise,raised,reflexed,rest,ruit,shaped,shin,side,simple,slender,slightly,soon,spaced,straight,tall,tapering,tear-drop,tip,tube,ud,unifoliat,unit,vein,widest,woody,x,ympodial,young	4-5,abaxial,adaxial,arrangement,cell,center,colour,diameter,flower,form,fruit,growth,height,history,length,life,na,new,number,peduncle,perennial,plant,position,rachi,reproduction,seed,shape,shiny,spacing,staman,texture,unifoliate,width
238	wfo-0001027395	success	153	106	73	80	33	0.477	.25,.5,0.25-0.5,1-1.5,1-5,1.1-1.5,1.5-1.9,2-3,3.5-4,acute,anther,apex,bark,base,beneath,berry,black,calyx,capitate,closely,cm,corolla,densely,drying,exfoliating,filament,fleshy,fruit,fruiting,glabrous,globose,green,large,leaf,lobed,margin,minutely,mm,narrowly,nearly,obovate,occasionally,once-furcate,opposite,ovary,overlapping,ovoid,papillose,pedicel,petiole,piece,primary,pubescent,restricted,robust,scar,secondary,shrub,simple,small,somewhat,spaced,stem,stigma,style,thick,transverse,trichome,uniseriate,vein,white,woody,x	0.6-1.1,0.75-1,1-2,1.5-2.5,1.6-2.9,10-20-flowered,11-15,12.5-17.3,2.2-7,4-6,5-6.5,8,anthesi,apically,apiculate,attenuate,becoming,beginning,caly,conical,constricted,cucullate,decurrent,deflexed,deltoid,depressed,dia,differing,difoliate,eaf,edicel,eed,enlarging,erect,exserted,free,geminat,immature,imperceptibly,inflorescenc,known,lateral,lobe,lon,long,lower,main,major,midrib,minor,nflorescence,older,pair,papillo,partially,planar,pointed,pore,poricidal,portion,raised,ruit,rusty-papillate,shaped,shining,shiny,size,straight,tall,tapering,tear-drop,thickened,tip,tube,ud,unit,within,without,ympodial,young	10-20,abaxial,adaxial,arrangement,bud,cell,center,colour,diameter,flower,form,growth,height,history,inflorescence,length,life,na,new,number,peduncle,perennial,plant,position,rachi,reproduction,seed,shape,spacing,staman,surface,texture,width
239	wfo-0001027396	success	244	103	80	164	23	0.328	0-3,0-4,0.5-1,0.5-1.5,0.8-1.3,2-3,2-7,3-9,3.5-6,4-7,5-10,6.5-7.5,abaxial,abaxially,acute,adaxial,almost,andromonoecious,anther,apart,apex,bark,black,brown,chartaceous,cm,cream,dark,densely,diameter,elliptic,elongate,erect,filament,flattened,flattened-reniform,flower,fruit,glabrescent,glabrous,green,herb,lateral,leaf,length,lobed,margin,marking,maturity,mauve,mm,moderately,obtuse,orange,pale,pedicel,peduncle,perpendicular,petiole,plant,prickle,pubescent,purple,rotate,shrub,simple,sometimes,somewhat,sparsely,spherical,stellate-pubescent,stem,straight,style,surface,unbranched,white,yellow,yellowish,young	-2,-5,-6,/3,0-100,0-30,0-5,0.1-0.5,0.1-1,0.4-0.7,0.5-2,0.5-2.5,0.7-2.5,0.8,1,1-4,1.2-2,1.5-3,1.5-3.5,1.8-3,1/2-2/3,1/3,1/4-1/3,1/6,10-15,10-25,10-30,10-35,12-25,15-40,2-3.5,2.5-4,2.8-4.5,20-100,3-,4,4-5,4-6,5-20,5-30,5-50,5-8,5-merous,5.5-7.5,6-20,7-10,7-15,8-20,alyx,ame,apar,apically,apparently,articulated,attenuate,ba,base,berry,blade,broad,broad-deltate,bulbous,c.,calyx,concolorous,connivent,cuneate,curved,decurrent,deltate,difoliate,discolorous,distal,distance,drying,eaf,eed,elongating,equal,extending,extensive,fewer,free,fruiting,fully,geminat,glandular,gray-brow,hair,hermaphrodite,heterostylous,infructescence,less,lignified,lobe,lobing,lon,long,long-acuminat,long-styled,longer,lower,lowermost,mature,midpoint,midvein,near,nflorescence,often,older,one,open,opening,orolla,oung,pair,pendulous,per,pericarp,poricidal,porrect,portion,prickl,prickly,primary,ray,red-brown,reflexed,ruit,scar,secondary,sessile,short-styled,side,smooth,spaced,spreading,stalk,stalked,staminat,stout,tamen,tapering,tearing,terete,tertiary,time,tip,trichome,tube,unarmed,unit,upper,usually,variously,vary,vein,venation,visible,way,wide,woody,yellow-green,ympodial	arrangement,colour,corolla,form,gray-brown,growth,height,history,inflorescence,life,na,number,ovary,perennial,position,reproduction,seed,shape,spacing,staman,stigma,texture,width
240	wfo-0001027416	invalid_json_followup	137	100	48	89	52	0.35	.5,0.2-0.4,0.5-1.0,1.3-2.0,3-7,4-7,4-8,5.5-8.5,accrescent,annual,anther,apically,blue,broadly,brown,calyx,capitate,capitate-glandular,cm,dark,dm,foveolate,glabrous,green,herb,internodal,lenticular,minutely,mm,ovary,ovate,pedicel,pentagonal-stellate,prickle,prickly,slender,smooth,spherical,stem,straight,strigulose,terete,uniseriate,villous,violet,viscid-villous,weakly,yellow	0.3-0.5,1.0,1.5-2.0,1/2-2/3,2.6-3.0,4.0-5.5,5-10,5-9-flowere,8-10,across,acute,along,alyx,anthesi,appearance,base,beneath,berry,blade,borne,branching,campanulate,cauline,deltoid,developing,dia,difoliate,divided,dry,eaf,eed,enveloped,erect,externally,few-rayed,fine,geminat,gland,hair,heteromorphic,incurved,invested,lanceolate,linear,lobe,lon,long,main,maturity,much-dissected,narrowly,nflorescence,often,orolla,otherwise,pinnatifid,quantity,reticulately,ruit,scattered,sessile,short,short-stipitate,simple,slende,slightly,somewhat,splitting,spreading,stellae,strait,tall,tamen,taprooted,thrice,tightly,tigma,tub,tube,twice,tyle,ultimate,unit,usually,varying,vein,wholly,wrinkled,ympodial	'',5-9,[,``,abaxial,adaxial,apex,arrangement,bark,bud,cell,center,characteristic,colour,corolla,diameter,filament,flower,form,fruit,fruiting,growth,height,history,inflorescence,leaf,length,life,margin,na,new,number,peduncle,petiole,plant,position,rachi,reproduction,scar,seed,shape,spacing,staman,stigma,style,surface,texture,trichome,value,width,{,}
241	wfo-0001027432	invalid_json_followup	215	137	105	110	32	0.488	0.1,0.3-0.4,0.3-1.0,0.5-1,1-1.5,1-3,1.4-2,1.5-,2-2.5,2-3-lobed,3,3-10,3-5,3-6,3-7,30,5-10,6-7,8-10,abaxially,acicular,acute,anther,apart,apex,bark,base,berry,branching,brownish,c.,calyx,chartaceous,clavate,cm,conical,corolla,densely,diameter,eglandular,filament,flower,fruit,fruiting,glabrescent,glabrous,glandular,glandular-pubescent,globose,green,greenish,growth,heterostylous,irregularly,leaf,light,lobed,many,margin,maturing,mm,mucilaginous,multangulate,new,ochraceous,ovary,ovate,ovate-elliptic,pedicel,peduncle,perfect,petiole,plant,porrect,prickle,pubescent,reniform,reticulate,sessile,shrub,simple,sparsely,stellate,stem,stigma,stipitate,style,sub-coriaceous,subglobose,surface,tan,terete,terminal,time,tomentose,trichome,velutinous,villose,way,white,woody,x,yellow,yellowish,young	-1.5,.5,0.2-0.3,0.3-3.5,0.5-0.1,0.8-1.0,1-multicellular,1.5-2,1/3,1/4,10-22,20-30,3-4,3.5-4.5,4-5,4.5-,6-10,7-,8-16,adaxially,angulate,apical,armed,articulate,attenuate,basal,blade,branched,brow,campanulate,confined,coriaceous,cream,curved,cuspidate,distal,eaf,eed,entire,epidermi,erect,especially,exserte,ferruginous,fewer,flattened,free,hirsute,juvenile,laterally,leave,lengthening,like,linear-lanceolate,lobe,long,long-styled,lower,many-celled,midpoint,minute,much,multiangulate,near,nflorescence,older,one,partially,per,pericarp,plurifoliat,pore,poricidal,porrect-stellate,portion,prickly,prominent,puberulent,raise,rarely,ray,recurved,ruit,scabrous,short-styled,similar,slightly,somewhat,spaced,staminate,stellate-pubescen,stellate-pubescent,stellate-tomentose,straight,subsessile,tapering,testa,thick,tip,tomentose-floccose,tomentose-scabrous,tube,ud,unarmed,unevenly,unicellular,unit,upper,visible,ympodial	'',[,``,abaxial,adaxial,arrangement,brown,bud,characteristic,colour,form,height,history,inflorescence,length,life,na,number,perennial,position,rachi,reproduction,scar,seed,shape,spacing,staman,texture,value,width,{,}
242	wfo-0001027437	success	193	115	88	105	27	0.456	0,1-1.5,1-2,1-3,1-4,2-2.5,2-4.5,2.5,30,4-5,5-12,6-8,abaxially,acuminate,acute,anther,apex,bark,base,beige,berry,brown,calyx,clavate,cm,corolla,corymbose,cyme,dark,densely,diameter,elliptic,entire,erect,filament,flower,fruit,fruiting,glandular-viscous,globose,green,growth,internodal,lateral,lenticulate,linear-lanceolate,lobed,margin,mixed,mm,new,oblanceolate,ovary,ovate,pedicel,peduncle,petiole,porrect,prickle,pubescent,reticulate,rugose,rusty,scabrous,scar,sessile,shrub,spaced,sparse,sparsely,stalked,stellate,stellate-rotate,stem,stigma,style,subreniform,subspherical,surface,terete,tomentose,trichome,unevenly,velutinous,white,within,woody,yellow	0.2-0.4,0.4-0.5,1,1.2-1.5,2-2.5mm,2-3,2-several,2.8-6,4,4-4.5,5-6,7-17,adaxially,anthesi,antrorse,armed,articulated,attenuate,basal,beneath,branched,chartaceous,compressed,cordate,curved,decurrent,diamete,discolorous,distal,eaf,eed,egalndular,elongate,erec,exceeding,free,glabrous,glandular,heterostylous,hirsute,impressed,inserted,laterally,leaving,lengthening,like,lobe,long,long-styled,lower,middle,midpoint,minute,mixture,near,nerve,nflorescence,oblong,older,one,partially,perfect,pericarp,plurifoliat,pore,poricidal,portion,prickly,prominent,puberulent,pubescence,raise,ray,recurved,reddish,reduced,reflexed,ruit,scarce,short-styled,simple,slightly,slit,staminate,stipitate,straight,strongly,subcampanulate,tall,testa,thick,three,time,tinge,tip,triangular-lanceolate,tube,ud,unarmed,unicellular,unit,upper,venation,x,ympodial	abaxial,adaxial,arrangement,bud,cell,center,colour,form,height,history,inflorescence,leaf,length,life,na,number,plant,plurifoliate,position,rachi,reproduction,seed,shape,spacing,staman,texture,width
243	wfo-0001027447	success	197	92	69	128	23	0.35	0-0.4,0-2.5,0.5-1.7,0.6-1,1-2.5,13-18,17-28,3-4.5,3.5-4.5,4-8,4-9,5-13,5-8,acicular,acuminate,acute,andromonoecious,anther,apart,apex,base,chartaceous,cm,cuneate,densely,diameter,elliptical,entire,erect,extra-axillary,flower,fruit,globose,green,inflorescence,leaf,length,lobed,longer,margin,mm,moderately,obtuse,ovate,pale,pedicel,peduncle,perennial,petiole,plant,prickle,pseudo-racemose,red,rhizomatous,shallowly,shrub,simple,sparsely,stellate,stellate-pubescent,straight,style,surface,time,unbranched,weakly,white,wide,yellow	%,.25,0-0.5,0-1,0-10,0-4,0.15-0.25,0.2-0.6,0.2-1,0.25-0.3,0.25-0.5,0.4-0.6,0.6-0.8,1-1.4,1-10,1-2,1-locular,1.2-1.7,1.3-1.7,1.5-3,10-20,2.1-3.2,2.3-5,2.5-4,25-30,3-6,3.8-4.3,4-6,5-merou,6-10,7-10,7-14,7-14.5,7-8,8-13,abaxially,absen,absent,across,adaxiall,adaxially,adult,alyx,articulated,axe,ba,blade,branch,branche,brown,calyx,confined,cross-section,cylindrical,decimetre,directed,distall,distally,dm,eaf,eed,eglandular,elliptica,exocarp,finger,fruiting,functional,glabrous,gland-tipped,hair,half,heterostylous,incomplete,index,juicy,juvenile,lamina,lateral,less,lobe,lobing,long,lower,markedly,mature,mesocarp,midpoint,midrib,midvein,minute,nflorescence,oblique,orolla,pair,part,per,placenta,pore,porrect,present,pubescence,ray,rostrate,ruit,septum,sessile,short,side,spaced,stellae,succulent,tal,tamen,tem,thick,thicker,throughout,transparent,tube,unarme,unarmed,unit,unknow,upper,vary,vein,x,ympodial	abaxial,adaxial,arrangement,colour,corolla,filament,form,growth,height,history,life,na,number,ovary,position,reproduction,seed,shape,spacing,staman,stigma,texture,width
244	wfo-0001027449	invalid_json_followup	160	110	70	90	40	0.438	.4,0.5-1,0.8-1.5,0.9-1.1,1.4-1.5,2-4,3-3.5,5-6,acute,anther,apex,area,axil,bark,beneath,brown,bud,calyx,closely,cm,corolla,dark,densely,elliptic,filament,fruit,fruiting,glabrous,globose,green,inflorescence,lateral,leaf,lobed,main,minutely,mm,narrowly,often,opposite,ovary,overlapping,ovoid-reniform,packed,pale,papillose,pedicel,persistent,petiole,pitted,pointed,pubescent,red-papillose,scar,shrub,simple,small,sparsely,stem,stigma,style,surface,tree,trichome,tuft,uniseriate,vein,white,woody,x	.5,.75,/3,0.5-1.5,1.2-1.5,1.5-2.5,10-15-flowered,2-3,3,3-7,4-6,8-15,acuminate,anthesi,appearing,arising,around,base,becoming,beginning,berry,cup,deciduous,deflexed,dense,density,dia,differing,difoliate,dry,eaf,edicel,eed,ellipsoid,erect,exserted,extreme,forming,free,frui,geminat,glabrate,inflorescenc,lamina,later,like,lobe,lon,long,long-acuminate,long-triangular,lower,major,material,minor,nflorescence,obconic,oblique,older,one,orangish,pair,pore,poricidal,portion,prominent,raised,reddish-brow,reflexed,rest,ruit,shaped,size,slender,soon,sparse,straight,styl,tall,tapering,tear-drop,tip,trunk,tube,ud,unit,varying,way,ympodial,young	'',10-15,[,``,abaxial,adaxial,alternate,arrangement,cell,center,characteristic,colour,diameter,flower,form,growth,height,history,length,life,margin,na,new,number,peduncle,plant,position,prickle,rachi,reddish-brown,reproduction,seed,shape,spacing,staman,texture,value,width,{,}
245	wfo-0001027452	invalid_json_followup	152	110	70	82	40	0.461	.5,0.5-1,0.5-1.5,0.5-2,1,1-3,1-5,1.5,1.5-3,10-20,2-foliate,4,4-6,5-12,absent,acute,along,anther,apex,blade,brown,calyx,cell,center,chartaceous,cm,denser,diameter,dm,drying,elliptic,elliptic-ovoid,entire,filament,flat,flower,fruit,glabrous,globose,hair,herb,immature,long,lying,margin,maturing,membranaceous,mm,moderately,nearly,new,one-,pedicel,peduncle,petiole,pubescent,rachi,rotate,seed,semitransparent,sparsely,stigma,straight,style,two-celled,unbranched,vein,white,x,yellow	0.5-2.5,1-2,1-4.5,2-4,2-6,3-6,3-9,5-20,abaxially,abundant,adaxiall,adaxially,axe,base,berry,beyond,branched,celled,ciliate,connected,cordate,decurrent,dehiscing,densely,eaf,eed,emarginat,equal,explosively,exserted,frui,geminat,growt,held,interpetalar,large,linear-lanceolate,lobe,lower,maturit,mesocarp,nfloresence,notched,oblong,obtuse,often,orolla,outer,parallel,per,perpendicular,placenta,pressure,pubescen,raised,ridge,rounded,ruit,running,short,significantly,single,slightly,smaller,smoother,sometimes,stamen,swollen,tal,tamen,tem,tissue,triangular,tube,unit,usually,vary,wall,watery,wid,woody,ympodial	'',[,``,abaxial,adaxial,arrangement,bark,bud,characteristic,colour,corolla,form,fruiting,growth,height,history,inflorescence,leaf,length,life,na,number,ovary,perennial,plant,position,prickle,reproduction,scar,shape,spacing,staman,stem,surface,texture,trichome,value,width,{,}
246	wfo-0001027471	success	165	120	96	69	24	0.582	.5,/4,0.1-0.2,0.2-0.4,0.2-0.5,0.5-0.6,0.5-1.5,0.9-1,1-1.5,2-2.5,2-3,2-lobed,4-5,anther,anthesi,appressed,ascending,bark,base,berry,bifid,brittle,calyx,closely,cm,conical,corolla,densely,desnsely,diameter,elliptic,entire,erect,especially,filament,flattened,flower,fruiting,furcate-dendritic,glabrous,globose,growth,herb,inflorescence,internodal,leaf,leaf-opposed,less,like,lobed,margin,maturity,minutely,mm,new,nodding,open-conical,ovary,ovate,overlapping,pale,pedicel,peduncle,petiole,pitted,plane,pubescent,pubscent,rachi,red-orange,reniform,scar,shape,shrub,similar,simple,slender,small,somewhat,spaced,sparsely,stem,stigma,style,subshrub,surface,tan,thin,tip,trichome,uniseriate,vein,way,white,x,yellowish	0.4-1,0.5,0.5-0.7,0.7-0.9,1-1.2,1-1.6,1.4-3,1.5-2,3-4,3-7,6-7,abaxially,acute,adaxially,age,along,apex,branched,c.,deltate,dendritic,differing,difoliate,distant,drying,eaf,eed,erec,free,geminate,included,lamina,lengthening,lobe,long-triangular,lower,major,midvein,minor,mixture,nflorescence,node,occasionally,orbicular,pair,papillat,perfect,pericarp,petal,planar,pore,poridical,portion,primary,reflexed,ruit,scattered,size,slightly,slit,straight,thickened,trifoliat,tube,ud,unit,usually,woody,ympodial	abaxial,adaxial,arrangement,bud,cell,center,colour,form,fruit,height,hermaphroditic,history,length,life,na,number,plant,position,reproduction,seed,spacing,staman,texture,width
247	wfo-0001027473	success	138	93	59	79	34	0.428	0.5-1,0.8-1,1-1.5,1.3-2,1.8-2,3.5-5,?,abaxially,acute,along,anther,apex,bark,brown,calyx,clavate,cm,conical,corolla,dendritic,densely,di-,erect,filament,flattened-reniform,fruiting,globose,green,incrassate,leaf,lobed,margin,minutely,mm,obovate,occasionally,ovary,pale,pedicel,petiole,pitted,pointed,pubescent,rootstock,rusty,shape,shrub,somewhat,sparsely,stem,stigma,style,subshrub,surface,trichome,trifoliate,vein,white,woody	.25,/2,0.25-0.5,1-2,1.5-2,1/3,2-2.5,2.5-3,4.5-13,5,6-9,8.5-37,absen,adaxially,anthesi,ape,apparently,base,berry,deccurent,decurrent,deep,deflexed,denser,dia,differing,drying,eaf,eed,empty,free,geminat,giving,glabrous,later,lateral,less,like,lobe,long,long-triangular,lower,main,major,middle,minor,minute,near,older,overall,pair,papillo,planar,pore,poricidal,portion,pubesent,ruit,sac,sessile,shaped,sterile,strongly,tall,tear-drop,thick,tip,tube,unit,usually,way,wide,widest,wing,winged,yellowish,yellowish-brow,ympodial,young	0.25,abaxial,absent,adaxial,arrangement,bud,cell,center,colour,diameter,flower,form,fruit,growth,height,history,inflorescence,length,life,na,new,number,peduncle,plant,position,rachi,reproduction,scar,seed,spacing,staman,texture,width,yellowish-brown
248	wfo-0001027483	success	164	100	74	90	26	0.451	0.2-1.9,0.6,1-4,1.5-2.6,1.5-3,2-4.5,3-15,5-10,5-6,abaxially,adaxially,apex,articulate,branched,cell,cm,coarsely,corolla,covering,cyme,diameter,dichasial,dichasially,distal,dot,ebracteate,elliptical,filament,finely,flower,globose,green,green-white,hair-like,half,herbaceous,interpetiolar,lateral,leaf,light,lighter,medium,mm,monochasial,odd-pinnate,ovate,ovoid,pedicel,peduncle,perennial,petiole,plant,proximal,pubescent,purple,rachi,ray,rotate,seed,smooth,sometimes,stigma,style,testal,thick,throughout,tuber-bearing,uniform,violet,violet-purple,wall,white,yellow,¼	0-1.,1,1-2,1-2.5,1-5,1.2-2.5,1.5-10,2,2-3,2-4,3-6,3-6-foliat,3.5-20,4.5-8,acumen,acute,apical,apically,basal,base,calyx,connate,cuneate,decurrent,dehiscent,digestion,diminishing,dorsally,eaf,edge,eed,emoval,enzyme,erec,exceeding,flat,folded,forked,generally,globo,gradually,honeycomb,interjected,introrse,leaflet,living,lobe,lon,long,lower,lunat,make,maturing,minute,mucilaginous,nflorescence,nther,obtuse,often,orolla,pair,pattern,perfect,petiolule,plan,poricidally,reveal,rosette,rounded,ruit,sessile,seudostipule,short,size,slit,specimen,stamen,straight,subsessile,tall,tem,terminal,tissu,toward,typically,unit,vary,varying,wide,ympodial	abaxial,adaxial,anther,arrangement,center,colour,form,fruit,growth,height,history,inflorescence,length,life,na,number,ovary,position,reproduction,shape,spacing,staman,surface,texture,tissue,width
249	wfo-0001027503	invalid_json_followup	197	113	80	117	33	0.406	.5,0.4-0.7,0.5,0.5-0.6,0.5-0.7,0.8-1,1,1-3,20-40,4,acute,along,anther,apex,bark,beige,bluntly,branched,broad-based,calyx,clavate,cm,conical,corolla,densely,diameter,dioecious,echinoid,ellipsoid,elliptic,entire,erect,filament,flower,foliose,fruit,fruiting,glabrous,globose,greenish,grey,growth,inflorescence,internodal,large,leaf,margin,midrib,mm,narrowly,new,ovary,packed,pale,pedicel,peduncle,petiole,plant,prickle,pubescent,scar,shiny,shrub,small,sparsely,stellate,stem,stigma,straight,style,surface,tan,thin,tightly,tree,trichome,unisexual,white,x,yellowish	0.15-0.2,0.2,0.6-0.7,0.9-1.2,1-1.2,1.1-1.5,1.2-2.5,10,2-3,2.5-3,2.5-5.5,549,8-11,<,abaxially,adaxially,age,almost,anthesi,armed,articulated,base,beneath,berr,berry,broadly,common,consisting,coriaceous,deflexed,deltate,dense,distally,due,eaf,eed,elongate,enclosing,expanding,female,fide,free,glabrescen,greatly,included,juvenile,known,lamina,lanceolate,lengthening,lepidote,less,like,likely,lobe,lobed,long,lower,male,minutely,mixture,nearly,nflorescence,occasionally,often,older,overlappin,pair,papillo,partially,peguero,pericarp,pistillate,planar,plurifoliat,pore,poricidal,porrect,portion,prickly,primary,prominent,pubescence,ray,rest,rhachi,ripe,rounded,rudimentary,ruit,seen,shoot,short,similar,simple,slit,solitary,somewhat,staminate,stout,thick,time,tiny,tip,truncate,tube,tubular,ud,unarme,unarmed,underside,unit,vein,visible,without,ympodial,½	'',[,``,abaxial,adaxial,arrangement,bud,cell,center,characteristic,colour,form,glabrescent,height,history,length,life,na,number,perennial,plurifoliate,position,rachi,reproduction,seed,shape,spacing,staman,texture,value,width,{,}
250	wfo-0001027506	success	215	120	94	121	26	0.437	/2,/6,0-10,0.5-1.5,0.5-6,0.7-1.3,0.8-1.5,1-4,1.2-1.5,2-3.2,2.5-8,3-10,3-5,5-10,5-merous,6-13,abaxially,andromonoecious,anther,apart,apparently,bark,base,becoming,berry,brown,calyx,cell,cm,cream,curved,dark,densely,diameter,elongating,entire,erect,filament,fine,flattened,flattened-reniform,flower,fruit,fruiting,glabrescent,glabrous,green,lateral,leaf,length,lobed,long,margin,marking,mature,maturity,mauve,mm,moderately,occasionally,orange,orange-brown,outline,ovate,pale,pedicel,peduncle,petiole,pit,plant,prickle,purple,raised,reddish,scar,shrub,simple,small,smooth,spherical,stellate,stellate-pubescent,stem,style,subentire,surface,terete,terminal,tree,trichome,way,yellow,yellow-green,young	-0.35,-1,-20,-3,-7,-7.5,.2,.5,0,0-2,0-6,0-60,0.1-,0.1-0.3,0.2,0.2-0.3,0.25,1-2,1-3,1.5-2.2,1.8,1/3,1/6-1/4,10-40,2.2-3.5,2.5-5,3-6,3.5-5,5-7,6.5-10,7-8,7-9,8-10,9-13,acuminat,acuminate,acute,alyx,ame,apar,apex,apically,articulated,blade,branched,brow,c.,chartaceous,concolorous,connivent,cordate,cuneate,distal,dry,drying,eaf,eed,equal,free,hard,hermaphrodite,heterostylous,infructescence,lengt,lobe,long-styled,longer,lower,lowermost,midpoint,multangulate,narrow-deltate,nflorescence,older,one,open,orolla,oung,pair,pendulous,per,pericarp,plurifoliat,poricidal,porrect,portion,prickl,prickly,primary,ray,reduced,reflexed,ruit,sessile,short-styled,sometimes,spaced,spreading,stalk,stalked,staminat,stout,tamen,tapering,tertiary,time,tip,truncate,tube,twice,unarmed,unit,upper,variously,vary,vein,venation,visible,wide,woody,ympodial	abaxial,adaxial,arrangement,bud,center,colour,corolla,form,growth,height,history,inflorescence,life,na,new,number,ovary,perennial,reproduction,seed,shape,spacing,staman,stigma,texture,width
251	wfo-0001027510	success	195	84	61	134	23	0.313	.5,0-0.4,0-0.5,0.4-0.9,0.9-3.4,1-3,1.5-2,2-2.2,2.5-3,4-5.5,4-9,6-7.5,9-12,absent,anther,articulated,base,broadly,capitate,chartaceous,cm,contiguous,densely,diameter,erect,extra-axillary,filament,flower,fruit,globose,green,homostylous,inflorescence,leaf,length,minutely,mm,nearly,ovate,pale,pedicel,peduncle,perennial,petiole,purple,rachi,red,reticulate,rhizomatous,rotate-stellate,shrub,simple,stellate-pubescent,stigma,style,succulent,surface,unbranched,usually,x,yellow	%,.7,0-0.9,0-2,0-5,0.1-0.3,0.2-0.4,0.5-0.6,0.5-1.1,0.7-1.5,0.7-1.6,0.8-1.8,1-2,1-locular,1.5-2.5,1.5-3,1.5-4,1.6-2,10-12,10-13,10-15,17-35,2-3,2-5,2-foliate,2.6-5.5,2.6-6,3-5,3-6,4-5,4-6,4-8,5-10,5-merou,6,6-13,6-8,abaxially,absen,abundant,accrescent,across,acute,adaxially,adult,alyx,apart,apex,apparen,axe,ba,blade,calyx,connivent,cordate,cylindrical,deltate,directed,distall,distributed,eaf,eed,eglandular,elliptic,entire,exceeding,finger,forke,fruiting,geminat,glabrous,gland-tipped,grey,hair,incomplete,interpetalar,juicy,juvenile,lamina,lanceolate,lateral,leafy,lobe,lobed,long,lower,margin,mature,mesocarp,midpoint,minute,nflorescence,oblique,obtuse,orolla,pair,part,per,perfect,placenta,pore,porrect,prickle,pseudo-umbellate,pubescent,ray,ruit,septum,sessile,shallowly,short,soliary,spaced,stalk,stellae,stellate,tal,tamen,tem,thick,throughout,time,tissu,tissue,transparent,tube,unarme,unarmed,unit,upper,vary,wide,without,ympodial	5-merous,abaxial,adaxial,arrangement,colour,corolla,forked,form,growth,height,history,life,na,number,ovary,plant,position,reproduction,seed,shape,spacing,staman,texture
252	wfo-0001027536	success	200	117	87	113	30	0.435	-15,0.4-2.0,1-1.5,1-2,2-,2-10,2-2.5,2-3,2-5,20,3-5,3-forked,4-10,5-10,5-6,5-7,8-10,acute,adaxially,anther,apart,apex,brown,calyx,chartaceous,cm,compressed,dark,densely,depressed-globose,diameter,dry,eglandular,elliptic,entire,epicarp,ferruginous,ferruginous-tomentose,filament,fine,flower,fruit,fruiting,glandular,globose,hair,inflorescence,laterally,leaf,leathery,lenticular,lower,margin,mm,mostly,multiseriate-stalked,oblanceolate,ornamentation,pedicel,peduncle,perennial,persistently,petiole,prickle,pubescent,rachi,reddish,reticulated,shrub,similar,simple,slender,stellate,stem,stigma,style,subcampanulate,subreniform,surface,terete,tomentose,trichome,velutinous,white,x,yellow,yellowish	-3,1.5-2,2-4,3-3.5,3-4,30-50,4,4-12,4-5,4-8,8-,abaxially,accrescent,adaxiall,alyx,ape,apical,apiculate,armed,articulated,asymmetric,axe,ba,basal,base,berry,bicolored,bisexua,blade,branch,branched,clavate-truncat,connivent,curved,decurrent,distal,eaf,eed,enlarged,equal,erect,exceeding,fleshy,free,glabrous,gland-tipped,glandular-stellate,gynoecia,held,impressed,introrse,like,linear-lanceolate,lobe,long,longer,many-foliat,maturit,midpoint,mixed,multiseriate,nflorescence,one,opening,orolla,part,per,perfect,persistent,pore,primary,prominent,recurved,reduced,reflexed,ruit,sessile,short,single,slightly,small,somewhat,spaced,sparsely,splitting,stalk,stamen,staminate,straight,subcoriaceous,subulate,surrounded,tal,tamen,tem,thick,time,tip,tube,unarme,unarmed,unbranched,unisexual,unit,upper,upright,usually,vary,vein,villose,wide,ympodial,zygomorphic	abaxial,adaxial,arrangement,bark,bisexual,bud,cell,center,clavate-truncate,colour,corolla,form,growth,height,history,length,life,na,new,number,ovary,plant,reproduction,scar,seed,shape,spacing,staman,texture,width
253	wfo-0001027538	success	137	82	43	94	39	0.314	.5,.9,0-1.5,0.1-0.2,0.4-0.85,0.5-1.5,2-4,4-5,acicular,adaxially,anther,apart,apex,attenuate,calyx,cm,cordate,densely,diameter,entire,extra-axillary,flower,fruit,fruiting,glabrous,grey-green,inflorescence,length,margin,mm,obtuse,ovate,pedicel,peduncle,petiole,prickle,prostrate,simple,stellate,stellate-pubescent,unbranched,yellow,yellowish	%,0-0.1,0-2,0.05-0.15,0.3-0.4,0.3-0.45,0.4-0.5,0.5,0.5-1,0.6-1,0.9-1,0.9-1.2,0.9-1.8,1,1-4,1.5-3.5,1.9-2.4,20-25,5-merou,7-12,8,8-13,?,abaxially,absen,absent,across,acute,adaxiall,alyx,armed,articulated,axe,ba,base,blade,brown,chartaceous,directed,distall,distributed,eaf,eed,eglandular,finger,gland-tipped,globo,hair,half,lamina,lateral,less,lobe,lon,long,lower,mature,mid-point,midpoint,midvein,minute,nflorescence,oblique,orolla,part,per,pore,porrect,present,ray,ruit,rusty,sessile,short,shru,spaced,stage,stalk,stellae,straight,tamen,tem,thick,throughout,time,tube,unarmed,unit,unknow,unknown,uvenile,wide,x,ympodial	5-merous,abaxial,adaxial,arrangement,bark,bud,cell,center,colour,corolla,filament,form,globose,growth,height,history,leaf,life,na,new,number,ovary,plant,position,rachi,reproduction,scar,seed,shape,shrub,spacing,staman,stem,stigma,style,surface,texture,trichome,width
254	wfo-0001027548	invalid_json_followup	216	123	85	131	38	0.394	0.3-1.2,0.5-2,1,1-1.5,1-10,1-2.5,10-50,4-8,6-9,acuminate,acute,almost,anther,apart,apex,berry,black,brown,calyx,capitate,cell,cm,conical,corolla,dark,dendritic,densely,depressed-elliptic,diameter,dull,ellipsoid,elliptic,entire,filament,flattened-reniform,flexuous,flower,fruiting,glabrous,globose,green,growth,immature,inflorescence,irregularly,leaf,lilac,lobed,loose,margin,matte,membranous,minutely,mm,narrowly,new,pale,papillate,pedicel,peduncle,petiole,pitted,pubescent,rachi,reddish,ripe,scar,scattered,simple,slender,spaced,sparsely,stellate,stem,stigma,style,surface,terminal,tinged,trichome,vine,white,woody,x,yellow	-11.5,.3,0.2,0.5,1-3.5,1.2,1.5,1.5-2,1.5-2.5,10-12,3-7,4-6,4.5,5-merou,7-10,8-9,abaxiall,adaxially,ag,along,also,although,alyx,anthesi,apical,apparently,appearing,area,ark,articulated,articulation,attenuate,axi,basal,base,beneath,bent,branch,branched,branching,bu,c.,connivent,darker,deflexe,deltate,denser,drying,eaf,early,eed,elongate,em,exserted,extending,free,geminat,glabrescen,glandular,half,herbarium,ilament,lamina,leaving,lengthening,less,like,lobe,lon,long,long-styled,loosely,lower,many,minute,mixed,near,nflorescence,occasionally,older,orolla,outline,pair,papillae,papillo,per,perfect,pericarp,planar,plurifoliate,point,pore,poricidal,portion,primary,prominent,puberulent,rectangular,revolute,ruit,size,slit,small,sometimes,somewhat,sparse,specimen,spreading,strongly,swollen,tapering,testal,thickened,thin,time,tiny,tip,transparent,tube,twinin,type,ud,uniseriate,unit,upper,usually,vary,vein,warty,way,ympodial	'',1.2-2.5,8,[,``,abaxial,adaxial,arrangement,bark,bud,center,character,characteristic,colour,form,fruit,glabrescent,height,history,length,life,na,number,ovary,perennial,plant,position,prickle,reproduction,seed,shape,spacing,staman,texture,value,width,{,}
255	wfo-0001027581	invalid_json_followup	200	120	77	123	43	0.385	100+,abaxial,acute,adaxial,anther,anthesi,apex,axe,base,berry,branched,broadly,brown,c.,calyx,clavate,cm,corolla,dark,densely,diameter,echinoid,elliptic,entire,evenly,filament,flattened-reniform,flower,fruiting,globose,golden,green,growth,inflorescence,leaf,length,like,lobed,many,margin,minutely,mm,moderately,multangulate,multiseriate,new,nodding,pedicel,peduncle,petiole,pitted,plane,pubescent,purple,reddish,ripe,scar,sessile,short-stalked,shrub,simple,small,stalk,stellate,stem,stigma,stout,style,surface,terminal,time,tree,trichome,undersurface,unevenly,way,yellow	0.2–0.3,0.3,0.3–1,0.5–1,0.5–1.5,1,1.2–1.5,1.3–1.5,1.5,1.5–2,1.5–3,10,10–16,12,12–30,15–20,1–1.5,1–3-rayed,2.5–3,200,3.5–4.5,3–3.5,4.5–16,4–8,5-merou,6–7,7–10,7–9,8,8–10,9–11,9–9.5,>,abaxially,ag,along,alyx,apar,ark,articulated,beneath,branching,brow,bulbous,clearly,closely,connivent,cup-shaped,deltate,dichasia,discolorous,distally,drying,eaf,eed,ellipsoidal,erec,exserted,free,glabrescent,glabrous,gradually,greyish,ilament,lamina,largest,lengthening,less,lobe,long,longest,loosely,lower,midvei,minute,mixed,narrowing,near,nflorescence,older,orolla,pair,papillo,part,per,perfect,pericarp,plurifoliate,pore,poricidal,porrect-stellate,portion,primary,ray,reflexed,rhachi,ruit,scarcely,shiny,size,slit,smaller,spaced,sparsely,spreading,tall,tem,thin,tip,tube,ud,unit,upper,vary,varying,vein,visible,weak,whit,wide,woody,yellowish,ympodial	'',0.5-1,1-3-rayed,1.3-1.5,1.5-3,15-20,2.5-3,3-3.5,4-8,5-merous,7-10,7-9,9-9.5,[,``,apart,arrangement,bark,bud,characteristic,colour,form,fruit,height,history,life,na,number,ovary,plant,position,prickle,rachi,reproduction,seed,shape,spacing,staman,texture,value,width,{,}
256	wfo-0001027584	success	144	99	68	76	31	0.472	-2,0.5-1.5,0.9-1,0.9-2.5,1.5-2,2,2-10,3,3-.,4-7,acuminate,anther,apex,bark,base,branched,calyx,cell,cm,conical,corolla,darker,densely,diameter,ellipsoid,elliptic,filament,flattened,flower,four,fruit,fruiting,glabrous,green,herb,lamina,lobed,margin,minutely,mm,nearly,ovary,ovate,pale,papillate,pedicel,peduncle,petiole,reddish,reniform,scar,scattered,shrub,sinuate,smooth,sparsely,stem,stigma,stripe,style,suffruticose,surface,tan,time,tip,trichome,uniseriate,white	-16,..,.5,0.5-1,1-1.2,1.2-1.4,1.5-8,1.6-1.9,10-15,100,11.5-45,2.5-3,4-6,4.5-20,7-10,8-9,abruptly,absent,anthesi,apical,attenuate,becoming,beginning,beneath,branch,brittle,broadly,brow,c.,capitat,cucullate,deflexe,deltate,dry,eaf,edicel,eed,erec,irregular,lobe,long,lower,markedly,narrowly,nflorescence,open,outer,outline,pair,per,pericarp,planar,plurifoliat,pointed,present,primary,regularly,ruit,single,single-stemmed,small,sparse,striate,testal,thickening,thin,triangular,tube,tuft,ud,unit,vein,wall,without,x,ympdoial	1,abaxial,adaxial,arrangement,brown,bud,capitate,center,colour,form,growth,height,history,inflorescence,leaf,length,life,na,new,number,plant,plurifoliate,position,rachi,reproduction,seed,shape,spacing,staman,texture,width
257	wfo-0001027585	success	217	107	75	142	32	0.346	0-1,0-2,1,1-4,12-23,2-3,2-5,29-40,3-4,5-17,5-8,7-10,acuminate,acute,anther,apex,articulated,base,broad-based,calyx,chartaceous,cm,curved,cylindrical,densely,diameter,elliptic,entire,erect,extra-axillary,flattened,flower,fruit,fruiting,glabrous,globose,green,inflorescence,leaf,length,lilac,lobed,longer,margin,mm,oblate,ovate,pale,pedicel,peduncle,perennial,petiole,plant,prickle,rachi,rhizomatous,ripe,shallowly,shrub,simple,sparsely,sprawling,stellate,stellate-pubescent,stigma,style,surface,time,unbranched,unripe,vine,white,wide,yellow,yellowish	%,.05,0,0-0.5,0-15,0-4,0.15-0.25,0.2-0.3,0.2-0.4,0.25-0.35,0.5-1,0.6-0.9,0.7-4.5,0.9-1.8,1-3,1.9-2.5,10-25,11-15,13-18,15-20,15-30,2-6,2-foliate,2-locular,2.3-2.8,22-25,3-3.5,3-7,3.8-4.2,4-8,4.5-20,5-7,5-merou,6-7,6-8,7-14.5,7-9,8-10,8-14,abaxially,absen,absent,accrescent,acicular,across,adaxiall,adaxially,adult,alyx,andromonoecious,anvil-shape,apart,axe,ba,blade,branch,branche,brown,capitat,confined,connivent,cross-section,cuneate,decimetre,deltate,directed,distall,distributed,dm,eaf,eed,eglandular,exocarp,finger,functional,geminat,gland-tipped,hair,half,heterostylous,interpetalar,juicy,juvenile,lamina,lanceolate,lateral,less,lobe,long,loosely,lower,mature,mesocarp,mid-point,midpoint,midrib,midvein,minute,moist,narrowly,nflorescence,oblique,orolla,pair,part,per,placenta,pore,porrect,present,pubescent,purple,ray,rounded,ruit,scarcely,sessile,short,side,spaced,sparse,stalked,stellae,straight,tal,tamen,tem,thick,throughout,tissue,transparent,triangular,tube,unarme,unarmed,unit,upper,vary,vein,weakly,x,ympodial	5-merous,abaxial,adaxial,arrangement,bark,bud,capitate,cell,center,colour,corolla,filament,form,growth,height,history,life,na,new,number,ovary,position,reproduction,scar,seed,shape,spacing,staman,stem,texture,trichome,width
258	wfo-0001027594	success	168	91	53	115	38	0.315	0.3-1.2,0.7-1,1-2,1.5-2,3-4,4-5,acute,anther,apex,bark,brown,calyx,capitate,closely,cm,corolla,dark,filament,flattened-reniform,fruiting,glabrous,globose,green,hard,lavendar,leaf,lobed,margin,maroon,minutely,mm,oblanceolate,opposite,ovary,pale,pedicel,petiole,pitted,scar,seed,shrub,simple,spaced,stem,stigma,style,surface,tapering,trichome,uniseriate,white,winged,yellow-tan	.1,.2,.5,0.6-1.4,0.7-1.2,0.9-2.5,1,10-15,2-2.2,2-3,2-5,2.5,2.5-4,3/4,4.7-6.8,5-20-flowered,across,age,anthesi,attenuate,ba,base,becoming,berry,bi-lobed,body,branch,bright,constriction,curved,decurrent,deltoid,dia,difoliate,distal,eaf,edicel,eed,elliptic,erect,especially,extending,fleshy,free,geminat,geminate,glandular,immature,incrassate,interpetalar,junction,lateral,lenticellat,less,lobe,locule,lon,long,lower,main,major,middle,minor,minute,nflorescence,non-reproductive,oblong,obovate,obovoid,occasionally,often,older,one,orange,ovate,overlappin,pair,paler,papillo,papillose,pore,poricidal,portion,prominent,puberulent,raised,reflexed,reproductive,ripe,rounded,ruit,shaped,shoot,sinus,slender,slightly,small,straggly,straight,tall,tear-drop,thin,tinged,tip,tube,two,ud,unit,vein,way,widest,woody,x,ympodial,young	0.1,0.5,5,5-20,abaxial,adaxial,arrangement,bud,cell,center,colour,diameter,flower,form,fruit,growth,height,hirsute,history,inflorescence,length,lenticellate,life,na,new,number,peduncle,perennial,plant,position,prickle,rachi,reproduction,shape,spacing,staman,texture,width
259	wfo-0001027600	invalid_json_followup	185	139	95	90	44	0.514	-10,0.5-1.5,1-14,1-2,1-4,1-5,1.5-2,10-,10-20,15-25,2-11,2-3,2-4,2-4.5,2-5,3-15,3-5,3-5-lobed,abaxially,acuminate,adaxial,adaxially,along,apart,apex,apical,articulated,base,calyx,campanulate,cm,collection,concave,densely,diameter,ellipsoidal,entire,especially,except,fading,flattened,flower,forked,fruit,glabrescent,glabrous,gland,glandular-puberulent,greenish-white,leaf,leaving,lobed,long,main,margin,mature,midrib,minutely,mm,oblong,occasionally,older,orange,ovoid,papillose,pedicel,pedicellar,peduncle,petiole,pilose,pinnately,puberulence,puberulent,pubescent,purple,purplish,rachi,rarely,remnant,simple,sparsely,stigma,style,subcoriaceous,surface,tree,two,unbranched,unlobed,vein,white,x,yellow,yellow-green,young	-3,0.5-1,1,1.5-2.5,1/2-3/4,2-18,2-3.5,2-6,2.5-21,2.5-6,20-30,3-6,4-6,4-foliat,5-13,8-17,abruptly,absen,absent,acute,adpressed,aggregate,ape,apiculate,axe,basal,beyond,blade,brow,cell,channe,connective,cordate,coriaceous,cream,cuneate,deltate,dilated,directed,distally,divided,eaf,eed,elliptic,exceeding,exserted,fleshy,laterally,lobe,lon,lower,moderately,narrowed,nflorescence,nther,obconical,obtuse,orolla,ovate,perfect,pilo,pore,puberulen,radiu,rounded,ruit,shorter,sinus,slightly,small,somewhat,spaced,stamen,stone,strongly,tal,tem,thecae,time,tip,tomento,triangular,truncate,tube,ud,unit,vary,wide,yellowish,ympodial	'',[,``,abaxial,anther,arrangement,bark,bud,channel,characteristic,colour,corolla,filament,form,fruiting,green,growth,height,history,inflorescence,length,life,na,new,number,ovary,perennial,plant,position,prickle,reproduction,scar,seed,shape,spacing,staman,stem,texture,tomentose,trichome,value,width,{,}
260	wfo-0001027601	invalid_json_followup	204	118	81	123	37	0.397	0-3,0.4-2,0.5-2,1.5-2,10-16,13-25,2-15,2-6,2.5-6,7-20,acicular,adaxially,andromonoecious,angularly,anther,apex,articulated,base,brown,buff,calyx,chartaceous,cm,congested,contiguous,cuneate,densely,diameter,ellipsoidal,elliptical,entire,erect,extra-axillary,filament,flattened,flower,fruit,fruiting,glabrous,globose,green,inflorescence,leaf-opposed,length,lilac,lobed,longer,margin,mm,nearly,ovate,pale,pedicel,peduncle,perennial,petiole,plant,prickle,pseudo-racemose,rachi,red,reniform,reticulate,rhizomatous,shallowly,short,shrub,simple,sparsely,stellate,stellate-pubescent,stigma,straight,style,surface,time,unbranched,white,wide,yellow,yellowish	%,.05,0-0.1,0-10,0-7,0.1-0.5,0.2-0.4,0.2-0.8,0.25-0.4,0.3-0.5,0.4-0.5,0.5-0.8,0.5-1,0.5-1.5,1-1.3,1-1.4,1-2,1-locular,1.6-5,2.3-4.3,2.5-3,2.6-4,3-5,3-6,3-7,3-foliate,4-10,5-merou,6-8,7-18,7-8,8-9,abaxially,absen,absent,accrescent,across,acuminate,acute,adaxiall,adult,alyx,apart,apparen,around,axe,ba,blade,branche,capitat,confined,connivent,cylindrical,decimetre,deltate,directed,distall,eaf,eed,eglandular,exocarp,finger,functional,geminate,gland-tipped,hair,half,heterostylous,incomplete,index,juicy,lamina,lanceolate,lateral,less,lobe,lobing,long,lower,mature,mesocarp,midpoint,midrib,midvein,minute,narrow,nflorescence,oblique,obtuse,orolla,outer,part,per,placenta,pore,porrect,present,ray,ruit,septum,sessile,side,spaced,stalk,stellae,strongly,succulent,tal,tamen,tem,thick,throughout,toward,tube,unarme,unarmed,unit,vary,vein,weakly,wing,x,ympodial	'',5-merous,[,``,abaxial,adaxial,arrangement,bud,capitate,center,characteristic,colour,corolla,form,growth,height,history,leaf,life,na,new,number,ovary,position,reproduction,scar,seed,shape,spacing,staman,stem,texture,trichome,value,width,{,}
261	wfo-0001027606	success	192	95	64	128	31	0.333	0-0.2,0.3-0.8,0.3-1.2,0.5-0.75,0.5-1,1-1.5,1-2,1-5,1-7,2-4,2-5,2.5-4,4-6.5,6-8,acicular,acute,anther,apex,broadly,brown,calyx,chartaceous,cm,deeply,diameter,entire,extra-axillary,filament,flower,fruit,fruiting,glabrous,globose,green,grey,inflorescence,leaf,length,lilac,lobed,margin,mm,obtuse,ovate,pale,pedicel,peduncle,perennial,petiole,pinkish,prickle,pseudo-racemose,rachi,red,reniform,rostrate,shrub,simple,stellate,stigma,style,surface,x,yellow	%,-10,0-1.5,0-4,0.2-0.3,0.2-2.5,0.2-4,0.4-0.5,0.7-0.9,1,1-2.5,1-locular,1.5-2.9,10-19,12-25,2,2-,2-3,2-5.5,2-7,3-10,3-4,3-4.1,3-foliate,4-11,5-merou,5.5-7,6-9,7-10,7-22,9-13,abaxially,absen,absent,accrescent,adaxiall,adaxially,adult,alyx,apart,apparen,apparently,articulated,axe,ba,base,blade,branch,branche,branched,cuneate,cylindrical,depression,directed,distall,distally,dm,eaf,eed,erect,exocarp,finger,flattened,geminat,gland-tipped,hair,half,incomplete,index,juicy,juvenile,lamina,lanceolate,less,lobe,lobing,long,longer,lower,markedly,mature,mesocarp,mid-point,midpoint,midvein,minute,narrowly,nflorescence,oblique,occasionally,orolla,pair,part,per,perfect,placenta,pore,present,pubescence,rhizomatous,ruit,scarcely,septum,short,side,spaced,straight,succulent,tal,tamen,tem,thick,thicker,throughout,time,triangular,truncat,tube,unarme,unarmed,unbranched,unit,upper,usually,vary,vein,wide,ympodial	abaxial,adaxial,arrangement,bark,bud,cell,center,colour,corolla,form,growth,height,history,life,na,new,number,ovary,plant,position,reproduction,scar,seed,shape,spacing,staman,stem,texture,trichome,truncate,width
262	wfo-0001027607	success	167	93	62	105	31	0.371	.1,.25,.5,0.8-1,1-4,2-3,2-4,3-3.5,8-9,anther,arching,bark,branch,brown,calyx,cm,corky,corolla,curling,dark,densely,elliptic,filament,filiform,flattened,fruiting,glabrate,glabrous,globose,green,leaf,lobed,minutely,mm,narrowly,obovoid,opposite,ovary,ovoid-reniform,papillose,pedicel,petiole,pitted,plant,pubescent,raised,reddish-brown,shrub,simple,slender,stem,stigma,style,surface,tan,treelet,trichome,uniseriate,white,winged,yellowish,zig-zag	0.25-0.5,0.5,0.5-1,1,1.2-1.5,1.5-3,2-2.5,2.5-3,3/4,4-10-flowered,5-10,5-7,acuminate,acute,age,anthesi,apar,apex,area,aspect,ba,basal,base,becoming,berry,branche,decurrent,deflexed,deltoid,dia,dry,eaf,edicel,eed,ellipsoid,elongate,erect,evenly,except,exserted,f,free,geminate,gently,giving,golden,lamina,lateral,lenticellat,less,like,lobe,lon,long,lower,m.,main,material,middle,midrib,minute,narrow,nflorescence,non-reproductive,occasionally,older,pagoda-like,pair,pore,poricidal,portion,present,prominent,rarely,reflexed,ruit,scar,shaped,short,slight,slightly,small,soon,spaced,straight,strongly,styl,tall,tapering,tear-drop,tip,tub,tube,ud,unifoliate,unit,vein,way,widened,widening,widest,woody,x,ympodial,young	4-10,abaxial,adaxial,apart,arrangement,bud,colour,diameter,flower,form,fruit,growth,height,hirsute,history,inflorescence,length,life,na,number,peduncle,perennial,position,rachi,reproduction,seed,shape,spacing,staman,texture,width
263	wfo-0001027613	invalid_json_followup	238	128	92	146	36	0.387	.5,0.1-0.6,0.1-0.7,0.2-1.6,1-10,1-7,1.5-2,12-15,15-28,2-2.5,2-5,2-5.6,3-4,4-5,5-18,5-6,9-10.5,abundant,accrescent,acicular,and/or,andromonoecious,anther,apex,base,broadly,brown,calyx,campanulate,chartaceous,circular,cm,cordate,corolla,dark,densely,diameter,extra-axillary,filament,flower,fruit,fruiting,glabrous,gland-tipped,glandular,globose,green,hair,herbaceous,inflorescence,length,lilac,lobed,margin,minutely,mm,moderately,nearly,obtuse,ovate,pale,pedicel,peduncle,petiole,plant,prickle,prostrate,pubescent,purple,rachi,reniform,resprouter,reticulate,rotate,shallowly,short,simple,somewhat,sparsely,sprawling,stellate,stellate-pubescent,stigma,streak,style,surface,tan,unbranched,weakly,x,yellow,yellowish-green	%,0-0.1,0.3-0.4,0.3-1,0.4-0.5,0.4-1,0.4-1.2,0.4-1.5,0.5-0.6,0.5-0.7,0.7-1.5,0.8-1.7,1-1.5,1-1.7,1-2,1.2-1.4,1.2-2,1.3-1.8,1.5-3,10-17,15-100,2-2.2,2-3,2-7,2-8,2-foliate,2-locular,2.3-2.6,20-50,3-5,3-6,30-100,36-70,4-7,4-8,4.5-9.5,5,5-8,5-merou,6-12.5,7-12,7-8,80-180,9-17,abaxially,absen,absent,across,acute,adaxially,adult,alyx,anvil-shape,apart,armed,articulated,attenuate,axe,ba,bitter,blade,branche,capitat,clear,connivent,contiguous,cross-section,curved,cylindrical,decimetre,deltate,directed,distall,distally,distributed,eaf,eed,eglandular,exocarp,finger,flattened,functional,geminat,half,heterostylous,index,inserted,interpetalar,juicy,lamina,lateral,less,lobe,lobing,lon,lonf,long,longer,lower,markedly,mature,mesocarp,mid-point,midpoint,midvein,minute,moist,nflorescence,oblique,orolla,part,per,placenta,pore,porrect,presen,present,ray,ruit,sessile,side,spaced,stage,stalk,stalked,stellae,straight,tal,tamen,tem,thick,thicker,throughout,time,tissu,tissue,transparent,triangular,tube,unit,uvenile,vary,vein,watery,wide,ympodial	'',[,``,abaxial,adaxial,arrangement,bark,bud,capitate,center,characteristic,colour,form,growth,height,history,leaf,life,na,new,number,ovary,position,reproduction,scar,seed,shape,spacing,staman,stem,texture,trichome,value,width,{,}
264	wfo-0001027618	invalid_json_followup	202	120	76	126	44	0.376	1-13,1-14,1-23,1-5,1.4-4,2-11,2-11.5,3-30,3-5,4,5-7.5,5-merous,6-40,8-16,8-35,abaxially,adaxially,apart,apex,articulated,base,branched,bud,campanulate,capitate,chartaceous,cm,compound,densely,diameter,ellipsoidal,entire,fleshy,flower,fruit,fusiform,glabrous,globose,greenish,leaf,length,margin,minutely,mm,moderately,near,obtuse,orange,papillose,pedicel,peduncle,per,perfect,petiole,pinnately,puberulent,puberulent-pubescent,pubescent,pubescent-pilose,purple,rachi,reticulate,shrub,simple,stigma,style,sympodial,tomentose,tree,truncate,unbranched,unit,urceolate,white,width,yellow	-10,-pubescent,0-10,0.5,0.5-1,0.5-6,1,1-,1-1.5,1-3,1-9,1.5-13,1.5-3,1.5-7,1.5-8.5,11-16,11-22,11-pinnate,12-27,15-30,15-35,2-12,2-27,2-5,2-8.5,2-9,2.5-6,3-18,3-7,3-7-pinnate,3.5-6,4-8,5-18,5-20,5-30,5.5-12,6-25,7-25,acuminat,acut,acute,aggregate,also,alyx,ape,ascending,axe,basal,beyond,blade,cell,connective,cordate,cuneate,cylindrical,darker,deltate,dia,diamete,dilated,directed,distally,eaf,eed,elliptic,elliptic-ovate,exceeding,exserted,lateral,laterally,leaflet,leaving,less,lobe,lon,long,longitudinal,lower,membranaceous,mesocarp,nflorescence,nther,oblong,obovate,obtu,often,orolla,ovate,pedicellar,perfec,petiolule,pilo,pilose,pore,presen,puberulent-pilo,radiu,ranch,ratio,remnant,ripe,rown,ruit,runk,shallowly,shorter,slightly,small,sometimes,somewhat,spaced,sparsely,spreading,stamen,stone,stripe,tal,terminal,thecae,triangular,tube,uni,vary,wide,without,x	'',[,``,abaxial,acuminate,adaxial,anther,arrangement,bark,calyx,center,characteristic,colour,corolla,filament,form,fruiting,growth,height,history,inflorescence,life,na,new,number,ovary,perennial,plant,position,prickle,puberulent-pilose,reproduction,scar,seed,shape,spacing,staman,stem,surface,texture,trichome,value,{,}
265	wfo-0001027622	success	203	105	78	125	27	0.384	0-14,0-16,0.3-10,1-10,1.5-3.5,1.5-4.2,1.6-4.5,2-25,2.5-3.5,3-4.5,3.5-11,4-9.5,5-11,6-17,6-7,8-20,abaxially,adaxially,anther,apex,blue,blue-purple,broadly,brownish,cell,clavate,cm,condition,corolla,covering,diameter,drying,elliptic,elliptical,filament,flower,forked,fresh,fruit,glabrescent,glabrous,globose,green,greenish,hair-like,herb,interjected,lateral,leaflet,light,minutely,mm,narrowly,odd-pinnate,ovate,ovoid,pale,pedicel,peduncle,pentagonal,petiole,plant,puberulent,pubescent,seed,size,stellate,stigma,style,subglabrous,terminal,testal,thick,tuber,wall,whitish,x,yellow	.5,1,1-2,1/,12-23,2-3,2-6,3-16,3-4,4-5,5-merou,8-16,acumen,acuminate,acute,ag,along,alyx,apart,apparently,articulated,axe,axillary,base,berry,blade,borne,bud,capitat,chartaceous,ciliate,connivent,decumben,different,digestion,distal,dorsally,eaf,edge,eed,end,enzyme,erect,especially,exceeding,except,flat,folded,geminat,generally,glabrou,greatly,green-white,hair,half,homostylous,honeycomb-shaped,lanceolate,lengthening,like,living,lobe,long,lower,make,margin,membranous,middle,midrib,mottled,mucilaginous,nflorescence,oblique,often,orolla,ovate-lanceolate,pair,perfect,petal,petiolule,plurifoliate,population,pore,poricidal,proximal,purple,reduced,removed,rounded,ruit,seudostipule,shortly,singly,slightly,slit,sometimes,spaced,specimen,stamen,star,ste,stem,stolo,straight,striped,subequal,subtending,tall,tamen,tem,throughout,tip,tri-,truncate,tube,typically,unit,unwinged,usually,vary,varying,wet,wide,wing,ympodial	abaxial,adaxial,arrangement,capitate,colour,form,growth,height,history,inflorescence,leaf,length,life,na,number,ovary,perennial,position,pseudostipule,rachi,reproduction,shape,spacing,staman,surface,texture,width
266	wfo-0001027624	success	189	99	74	115	25	0.392	0.3-1,0.5-1.5,1-2,1.1-8.4,2-20,2.4-4.8,3-10,3-5,4-15.2,4-8,5-9,9-41,acumen,anther,apex,axillary,brownish,bud,cell,clavate,cm,condition,corolla,covering,deep,densely,diameter,drying,elliptic,filament,flower,forked,fresh,fruit,glabrous,globose,green,greenish,hair,hair-like,herb,lanceolate,lateral,leaf,light,like,mm,moniliform,odd-pinnate,ovoid,pedicel,peduncle,pentagonal,petiole,plant,pubescent,purple,rachi,rotate,seed,short,sometimes,stigma,style,subtending,terminal,testal,thick,tuber,usually,wall,white,whitish,yellow	0-3,0-7,0.1-0.9,0.4-3,0.8-5.6,1-3,1-5,1.2-2.6,1.3-2.9,1.5-6.6,2-5,2-7,2.9-12,3-11,3-4,4-7,5-merou,6-18.5,abaxially,acuman,acuminate,acute,adaxially,ag,along,alyx,apart,apparently,arranged,articulated,axe,base,bead,berry,blade,capitat,connivent,considerably,cuneate,decreasing,decumben,decurrent,digestion,distal,dorsally,eaf,edge,eed,entirely,enzyme,erect,exceeding,flat,folded,geminat,glabrou,green-white,half,homostylous,honeycomb-shaped,interjected,larger,leaflet,leave,lengthening,living,lobe,long,lower,make,middl,mottled,mucilaginous,multiple,necklace,nflorescence,onto,orbicular,orolla,ovate,pair,perfect,plurifoliate,pore,poricidal,present,removed,ruit,sessile,seudostipule,size,slightly,slit,spaced,specimen,stamen,stolon,straight,tall,tamen,tem,throughout,tip,toward,tri-,tube,typically,unit,unwinged,vary,wet,wide,widely,x,ympodial	abaxial,adaxial,arrangement,capitate,colour,form,growth,height,history,inflorescence,length,life,na,number,ovary,perennial,position,pseudostipule,reproduction,shape,spacing,staman,surface,texture,width
267	wfo-0001027626	success	152	107	60	92	47	0.395	.3,.5,0.5-1,1,8,acuminate,along,anther,apex,arrangement,calyx,center,chartaceous,cm,cordate,coriaceous,diameter,distichous,distinct,elliptical,entire,extra-axillary,filament,fleshy,flower,frequently,fruit,fruiting,glabrous,greenish-white,leaf-opposed,liana,line,margin,membranous,mm,moderately,nearly,ovate,pedicel,peduncle,petiole,possibly,pubescent,rachi,scar,shrub,slender,somewhat,spindle-shaped,stellate,stigma,style,terminal,trichome,unbranched,unknown,white,wiry-woody,x	0.1–0.2,0.2–0.6,0.5–1,0.7–1,0.7–2.8,1.3–4.5,1.5–2,1.5–8,13–14,14–116,2–3,2–49,2–5,3–4,3–4.5,3–5,3–55,4.4–11,4–6,5-merous,5–6,9–18,abaxially,accrescen,acute,adaxially,alyx,apar,axe,base,berry,blade,broadly,c.,capitat,ciliat,clavate,climbing,color,densely,distant,eaf,eed,glabrou,immature,lamina,lanceolate,lobe,long,lower,m.,maturity,midvein,minutely,mor,nflorescence,nternode,oblique,orolla,pair,perfec,petal,pinnate,plurifoliat,pointed,reflexed,rounded,ruit,sand-punctat,sand-punctate,scandent,secondary,seen,shortly,side,simple,spaced,sparsely,ste,tamen,tem,time,tip,truncate,tube,two,unit,vary,vein,venation,wide,ympodial	0.1-0.2,0.2-0.6,0.7-1,1.5-8,13-14,14-116,2-49,2-5,3-4,3-55,5-6,abaxial,adaxial,apart,bark,bud,capitate,cell,colour,corolla,form,green,growth,height,history,inflorescence,leaf,length,life,na,new,number,ovary,perennial,perfect,plant,position,prickle,reproduction,seed,shape,spacing,staman,stem,surface,texture,width
268	wfo-0001027627	invalid_json_followup	245	141	90	155	51	0.367	.1,.5,5-angled,abaxially,adaxially,ampliate,anther,apart,apex,band,base,based,bifurcate,borne,branched,broad,broadly,brown,bud,calyx,cm,corolla,densely,diameter,distally,entire,erect,extensively,extra-axillary,filament,flattened-reniform,flower,fruit,glabrescent,glabrous,globose,green,half,internode,interpetalar,lateral,lavender,leaf,lighter,linear-lanceolate,loosely,lower,margin,middle,minutely,mm,narrow,narrowly,near,occasionally,ovary,ovate,ovoid,pedicel,peduncle,petiole,pitted,prickle,pubescent,purple,shallowly,shrub,simple,sinuate,small,sometimes,somewhat,sparsely,stellate,stellate-tomentose,stem,stigma,style,subeaqually,surface,tardily,tissue,tomentose,tree,unequally,usually,velvety,violet,yellow,×	0.05–0.25,0.1–1,0.3,0.4,0.6–1,0–,1.5,1.5–2,1.5–2.5,1.8–2.5,11–14,12–25,13–17,1–1.5,1–5,2,2.5–4,2–15,2–4,2–5,2–6,3.5,3–3.5,3–6,4–,4–12,5-merou,5–7,6–,6–15,7–10,7–15,9,9–13,9–15,abundant,accrescent,across,acuminate,along,alyx,apparently,articulated,ascending,axe,ba,becoming,berry,blade,branch,briefly,c.,capitat,caudate,central,chartaceous,contiguous,cordate,dense,difoliate,distal,eaf,eed,evident,except,exposed,fertile,filiform,flowering,free,geminat,grayish,growt,hair,high,homostylous,interwoven,juvenile,larger,like,line,linear,lobe,long,longer,major,midpoint,midvein,minor,minute,mostly,much,nearly,nflorescence,numerous,oblong,obtuse,often,paired,par,portion,present,principal,prominently,pubescence,ray,recurved,reduced,rounded,ruit,scattered,short,shorter,side,single,sinus,slender,smaller,spaced,sparse,splitting,spreading,stalk,stalked,stellae,stellate-pubescent,stellate-tomento,stellate-velvety,stemmed,stipe,stout,tamen,tapering,tawny,thick,thickened,time,tip,triangular,trunk,tube,ud,unarmed,vein,visible,weakly,wide,yello,ympodia,young,zone,×1.5–1.7,–2.5,–30,–5	'',0-2-15,1-5,1.5-2,13-17,2-4,2-5,2-6,2.5-4,30,5,6-15,7-10,7-15,9-13,[,``,abaxial,adaxial,arrangement,bark,capitate,characteristic,colour,form,fruiting,growth,height,history,inflorescence,length,life,na,new,number,perennial,plant,position,rachi,reproduction,scar,seed,shape,spacing,staman,texture,trichome,value,width,{,}
269	wfo-0001027630	invalid_json_followup	149	102	59	90	43	0.396	0.5-1,0.5-1.2,0.5-2,1-5,1.5-2,4-6,8-9,anther,apart,apex,bark,calyx,ciliate,climbing,cm,corolla,erose,filament,fruit,fruiting,glabrate,glabrous,globose,golden,green,hirsute,internodal,irregularly,lanceolate,leaf,linear,lobed,long-acuminate,margin,minutely,mm,occasionally,opposite,ovary,papillose,partially,pedicel,petiole,puberulent,pubescent,scar,shaped,shrub,simple,sparsely,stem,stigma,style,tapering,trichome,uniseriate,white,winged,yellowish	.1,.2,.5,0.05-0.1,1-1.5,1.4-1.7,2-3,2-6-flowered,3/4,5.5-11.2,6-10,acute,also,anthesi,arising,base,beginning,berry,blunt,branchlet,broadly,de,decurrent,deflexed,deltoid,densely,dia,distinguishable,eaf,edicel,eed,elongat,except,extreme,free,globo,immature,indistinct,inflorescenc,knob-like,known,lateral,lobe,lon,long,lower,main,middle,midrib,near,nflorescence,novo,older,pair,paler,pore,poricidal,portion,prominent,proximal,raised,reflexed,rest,rounded,ruit,seen,slender,spaced,straight,strongly,swollen,tall,tear-drop,terminal,thickened,ti,tip,tube,ud,ultimate,unifoliat,unit,vein,way,wide,widest,wing,x,ympodial,young	'',0.1,2-6,[,``,abaxial,adaxial,arrangement,bud,cell,center,characteristic,colour,diameter,flower,form,growth,height,history,inflorescence,length,life,na,new,number,peduncle,perennial,plant,position,prickle,rachi,reproduction,seed,shape,spacing,staman,surface,texture,unifoliate,value,width,{,}
270	wfo-0001027646	success	166	88	53	113	35	0.319	0-0.1,0.1-0.25,0.2-1.1,1-2,1-3,2-6,6-7,acicular,acuminate,acute,adaxially,anther,apart,apex,calyx,chartaceous,cm,densely,diameter,entire,erect,extra-axillary,flattened,flower,fruit,fruiting,glabrous,globose,green,inflorescence,length,margin,mm,ovate,pale,pedicel,peduncle,perennial,petiole,prickle,pseudo-umbellate,red,reniform,rhizomatous,shrub,simple,solitary,stellate,stellate-pubescent,style,unbranched,yellow,yellowish	%,.4,0-0.2,0-1,0-10,0-2,0.15-0.25,0.4-0.5,0.4-0.6,0.5-0.6,0.6-0.7,0.7-1.2,0.7-1.5,0.7-2,1,1-6,1-locular,10-18,15-20,2-4,2-foliate,2.1-3.2,3.5-4,4-11,5-10,5-merou,6-13,6-8,abaxially,absen,absent,across,adaxiall,adult,alyx,articulated,axe,ba,base,blade,branche,brown,confined,cuneate,cylindrical,directed,distall,dm,eaf,eed,eglandular,finger,functional,geminat,gland-tipped,grey,hair,half,incomplete,juicy,lamina,lateral,less,lobe,long,longer,lower,mature,mesocarp,midpoint,midrib,midvein,minute,moderately,multiradiate,nflorescence,oblique,obtuse,onl,orolla,part,per,pore,porrect,present,probably,ray,ruit,septum,short,spaced,sparsely,stage,stalk,stellae,straight,succulen,tal,tamen,tem,thick,throughout,time,transparent,unarme,unarmed,unit,unknow,uvenile,vary,wide,x,ympodial	abaxial,adaxial,arrangement,bark,bud,cell,center,colour,corolla,filament,form,growth,height,history,leaf,life,na,new,number,ovary,plant,position,rachi,reproduction,scar,seed,shape,spacing,staman,stem,stigma,surface,texture,trichome,width
271	wfo-0001027661	invalid_json_followup	222	126	91	131	35	0.41	+,-10,0.5,0.5-2,1-1.5,1-5,1.5,1.5-2,4-15,4.5-6,40,5-9,6-12,8-10,acuminate,acute,anther,apart,apex,bright,broadly,calyx,capitate,cm,conical,corolla,deeply,dendritic,densely,diameter,ellipsoid,entire,extremely,filament,flattened,flower,fruiting,glabrous,globose,grey,growth,herbaceous,irregularly,lamina,lateral,leaf,leaf-opposed,lobed,margin,minutely,mm,moderately,new,pale,papillate,pedicel,peduncle,petiole,pinnatifid,pitted,pubescent,purple,rachi,red,reniform,scar,shape,shiny,simple,slender,sparsely,stellate,stem,stigma,style,surface,tan,terminal,ternately,thin,trichome,turbinate,uniseriate,variable,vein,vine,violet,white,woody,yellow,yellowish	0.5-,0.6-1.1,0.6-1.5,1-,1-7,1.2-6,1.3,2,2.5-3,2.5-7,30,4-8-celled,5-merou,6-8,6-9,<,>,abaxially,adaxiall,ag,along,alyx,anthesi,ark,articulate,axi,basal,base,berry,branch,branched,cell,column,commonly,connivent,cordate,creeping,denser,density,eaf,eed,elliptic,even,free,fused,gre,green,ground,hue,ilament,leaving,lengthening,like,lobe,long,long-exserted,lower,many,markedly,membraneous,minute,mixture,narrowing,near,nflorescence,occasionally,often,older,open,orolla,outline,ovate,pair,papillat,papillo,peg,pentagonal,per,perfect,pericarp,plurifoliat,pointed,pore,poricidal,portion,primary,prominent,pubescen,pubescence,purplish,rarely,reflexed,ripe,ruit,short,single,sinus,size,sleeve,slit,small,spaced,spot,spreadin,spreading,strongly,swollen,tangled,tem,testa,tightly,time,tip,trailing,triangular,truncate,tube,two,type,ud,underground,unieriate,unit,upper,usually,vary,way,wide,ympodial,zig-za,¾	'',0.5-7,5-merous,[,``,abaxial,adaxial,arrangement,bark,bud,characteristic,colour,form,fruit,height,history,inflorescence,length,life,na,number,ovary,plant,position,prickle,reproduction,seed,shaped,spacing,staman,texture,value,width,{,}
272	wfo-0001027714	invalid_json_followup	251	138	106	145	32	0.422	+,.5,/3,0.5,0.5-0.7,1-1.6,1-2,1.5-5,14-16,2-,2.5-4,3-3.5,4.5-5,5,5-10,7-20,80,abaxial,acuminate,adaxial,anther,apex,basal,base,berry,branched,bright,brown,calyx,capitate,cm,corky,corolla,cucullate,deep,densely,diameter,elliptic,entire,filament,flattened,flower,fruit,fruiting,glabrate,glabrous,globose,growth,immature,inflated,inflorescence,irregularly,juicy,lateral,leaf,lobe,lobed,long,many,margin,mature,minutely,mm,new,obovate,ovary,pair,pale,papillate,pedicel,peduncle,petiole,pitted,pubescent,purple,red,reddish,reniform,ripe,scar,seed,shiny,simple,slender,small,spaced,stellate-rotate,stem,stigma,style,surface,tangled,terminal,thin,time,tip,trichome,uniseriate,vine,violet,way,weak,woody,x,yellow,yellowish	0,0.4,0.6-0.7,0.9-1.5,1,1-,1-1.5,1.5-2,1.5-2.5,1.5-3,2-2.5,2-8,2.5-,2373.,4-10,4-5,5-6,5-merou,6-7,<,abaxially,acute,adaxially,age,aid,almost,along,alyx,angle,anthesi,apar,apice,appearance,ark,around,articulated,axi,canop,cell,channelled,climbin,confined,conical,connected,connivent,cordate,creating,cupped,deflexed,dendritic,denser,drying,eaf,eed,ellipsoid,elongate,enlarged,especially,exserted,fide,fleshy,free,furcate,giving,glabrou,groove,hairy,hanging,ilament,individual,lamina,large,leaving,lengthening,like,lon,longer,loosely,lower,marginal,mere,minute,mpodial,nee,nflorescence,nodding,occasionally,often,older,orolla,otherwise,outline,papillo,peg,per,perfect,pericarp,petal,petiolule,pinnatifid,plat,plurifoliat,pore,poricidal,portion,primary,prominent,pubescence,reaching,rectangular,rim,ruit,showy,similar,sleeve,slightly,slit,somewhat,sparsely,spreading,strongly,tem,testa,testal,thecae,thick,thickened,third,tiny,tooth,truncate,tube,twining,ud,uniformly,unit,upper,usually,vein,visible,wall,weight,widest,wing,younger	'',[,``,apart,arrangement,bark,bud,characteristic,colour,form,height,history,length,life,na,number,papillose,perennial,plant,plate,position,prickle,rachi,reproduction,shape,spacing,staman,texture,value,width,{,}
273	wfo-0001027719	success	172	84	56	116	28	0.326	0-7,0.15-0.4,0.3-0.5,0.6-2.8,1-3,4-5,5-6,6-10,7-11,8-13,acicular,acute,adaxially,andromonoecious,anther,apex,base,broadly,brown,chartaceous,cm,cuneate,densely,diameter,extra-axillary,flower,fruit,globose,green,greenish-white,herbaceous,inflorescence,length,lilac,lobed,mm,obtuse,ovate,pale,pedicel,peduncle,petiole,plant,prickle,pseudo-racemose,resprouter,shallowly,simple,solitary,sparsely,stellate-pubescent,stem,strongly,style,unbranched,yellow	%,.25,0-0.15,0-0.2,0-1,0-20,0.25-0.4,0.25-0.6,0.3-0.7,0.4-1.7,0.6-0.8,0.8-1,0.9-1.1,1-1.5,1-2,1.1-2,1.6-1.9,10-24,13-20,13-25,2-2.3,3-5,3-7,3-7.5,30-70,4-6,4-7,4.5-12.5,5-8,5-merou,6-8,abaxially,absent,across,adaxiall,alyx,apart,armed,articulated,attenuate,axe,ba,blade,calyx,d.,difoliate,directed,distall,distributed,dult,eaf,eed,eglandular,entire,erect,exocarp,finger,fruiting,functional,geminat,gland-tipped,hair,half,heterostylous,hig,juic,lamina,lateral,less,lobe,long,longer,lower,margin,mature,mesocarp,mid-point,midpoint,midvein,minute,moist,nflorescence,oblique,orolla,part,per,pore,porrect,presen,present,ray,ruit,sessile,short,spaced,sprawling,stage,stalk,stellae,stellate,straight,tamen,thick,throughout,time,tube,unarme,unit,unknow,uvenile,vary,vein,white,wide,x,ympodial	5-merous,abaxial,adaxial,arrangement,colour,corolla,filament,form,growth,height,history,leaf,life,na,number,ovary,position,reproduction,seed,shape,spacing,staman,stigma,surface,texture,trichome,unknown,width
274	wfo-0001027720	success	184	92	65	119	27	0.353	0.5-0.8,0.5-1,1-1.5,1-2,1-3.5,15-25,2-3,2-4,2-branched,4-5.5,4-7,7-8,acute,anther,apex,brown,calyx,chartaceous,cm,diameter,distally,elliptic,entire,erect,extra-axillary,filament,flattened,flower,fruit,fruiting,glabrous,globose,green,inflorescence,leaf,length,lilac,margin,markedly,mm,notched,ovate,pale,pedicel,peduncle,perennial,petiole,prickle,pubescent,rachi,red,rhizomatous,shrub,simple,slightly,sparsely,stellate,stellate-pubescent,stigma,straight,style,subreniform,surface,thicker,yellow	%,.25-0.3,0,0-15,0.15-0.25,0.25-0.35,0.3-5,0.4-0.7,0.4-0.8,0.6-1.2,0.8-1,1-locular,1.5-2,13-23,13-35,2-7,2-foliate,2.8-3.1,23-35,3-13,4-,4.3-15,4.3-7.5,5-merous,6,7-10,7-9,8-11,8-16,9-15,abaxially,absen,absent,adaxiall,adaxially,adult,alyx,apparently,articulated,axe,ba,base,berry,blade,capitat,confined,connivent,cuneate,cylindrical,deltate,densely,directed,distall,eaf,eed,eglandular,finger,geminat,gland-tipped,hair,half,hig,homostylous,incomplete,intepetalar,juicy,juvenile,lamina,lanceolate,lateral,less,lobe,long,loosely,lower,mature,mesocarp,mid-point,midpoint,midrib,minute,narrowly,nflorescence,oblique,orolla,part,per,perfec,perfect,pore,porrect,present,ray,ruit,scarce,septum,sessile,short,stellae,succulen,tamen,tem,thick,time,tissue,toward,triangular,tube,unarme,unarmed,unit,upper,vary,white,wide,without,x,yellowi,ympodial	abaxial,adaxial,arrangement,bark,bud,capitate,colour,corolla,form,growth,height,history,life,na,number,ovary,plant,position,reproduction,seed,shape,staman,stem,texture,trichome,width,yellowish
275	wfo-0001027720	success	272	102	76	196	26	0.279	0,0.8–1.3,0.8–1.9,1.5–3.3,1.5–9.0,1.8–2.0,2.0,2–3,3.7–5.7,4.0–12.6,5.1–18.6,6.5–9.5,acuminate,acute,anther,apex,attachment,bilobed,cancellate,capitate,cm,conical,corolla,cream,developed,diameter,elliptic,extra-axillary,filament,flattened-irregular,flattened-orbicular,flattened-reniform,flower,fruit,glabrous,globose,growth,homostylous,interpetalar,lateral,lavender,leaf,long,mm,notched,orange,ovate,pedicel,peduncle,petiole,point,poorly,red,short,shrub,simple,slightly,small,stellae,stellate,stigma,straight,style,subacute,subcoriaceous,surface,tall,tissue,tree,violet,wide,yellow,yellow-ferruginous,yellow-tan,×,–4	.0,.04,.2,.3,.5,.9,0.1–0.6,0.2–0.4,0.3–0.4,0.7–0.9,0.7–1.1,0.7–1.2,0.8–2.0,0.9,1.4–1.9,1.5–1.7,1.5–2.0,1.5–2.5,1.7–1.8,1.7–2.0,1.7–2.5,1.9–2.2,1/2,1/3,1/3–1/2,10.0,10.8–18.2,12–16,13.0,19.7–30.0,2.5,2.5–2.8,2.5–2.9,3.2,3.6,3.9,4.0–18.0,4–5-merou,6–8,8.0,8.0–11.9,8.2–10.5,8.5–9.4,9.5–16.0,abaxially,adaxially,adnate,aequilateral,alyx,anthesi,apical,apiculate,apparently,appearing,armed,articulated,attenuate,axe,ba,base,becoming,berry,blade,branch,broad,broad-based,brochidodromous,bud,calyx,channel,channeled,colore,concave,congested,connivent,crisped,curved,deciduous,dehiscence,densely,dentate,difoliate,distally,dorsally,dry,eaf,eed,either,emerging,endocarp,entire,erect,especially,exocarp,fertile,filiform,free,geminat,glandular,glossy,gradually,hair,heavily,hooked,inclined,increasing,internode,intersepalar,juic,juvenile,lamina,large,least,like,line,lobe,lon,longer,lower,m.,major,margin,mature,midpoint,midrib,midvein,minor,minute,moderately,narrowly,nearly,nflorescence,oblique,oblong,occasionally,often,orolla,part,per,perforate,pore,porrect,porrect-stellate,portion,potentially,presumably,prickle,proximal,pubescent,raised,ray,reflexed,rigid,rip,row,ruit,scattered,sessile,shorter,side,sinus,soon,sparsely,splitting,spread,stamen,stellate-pubescen,stellate-pubescent,stem,suture,tamen,tem,thin,time,tip,toward,translucent,triangular,truncate,tube,twice-branched,two,ud,unarmed,upper,vary,vein,wavy,way,weakly,white,yellow-ferruginou,ympodia,young,youngest,±equal	4–5-merous,abaxial,adaxial,arrangement,colored,colour,form,height,history,inflorescence,length,life,na,number,ovary,perennial,plant,position,rachi,reproduction,seed,shape,spacing,staman,texture,width
276	wfo-0001027735	success	166	84	47	119	37	0.283	.75,0-5,1.3-3.5,1.7-3.5,10-14,12-15,3-8,5-5.8,8-11,acicular,anther,apex,calyx,chartaceous,cm,diameter,extra-axillary,flower,fruit,fruiting,green,inflorescence,length,lobed,margin,mm,moderately,obtuse,ovate,pale,pedicel,peduncle,perennial,petiole,prickle,pseudo-racemose,rotate-stellate,shallowly,shrub,simple,sparsely,stellate,stellate-pubescent,straight,style,white,yellow	%,.7,0-0.1,0-1,0-4,0.15-0.2,0.25-0.5,0.3-0.6,0.4-0.8,0.5-0.8,0.5-3,1,1-2,1.3-1.6,1.9-2.2,11-17,2-2.5,2-3.5,2-8,2.5-3,20-35,25-50,3.5-5,30-50,4-5,4-6,4-8,5,5-merou,7-10.5,9-12,abaxially,absent,abundant,across,acuminate,acute,adaxially,adult,alyx,apart,armed,articulated,attenuate,axe,ba,base,blade,branche,brown,directed,distall,distributed,dm,eaf,eed,eglandular,erect,finger,geminat,glabrou,gland-tipped,globo,hair,half,index,lamina,lateral,less,lobe,lobing,long,longer,lower,mature,mid-point,midpoint,midvein,minute,nflorescence,oblique,orolla,part,per,pinkish,pore,porrect,presen,present,purpl,ray,rhizomatous,ruit,sessile,short,side,spaced,sparse,stage,stalk,stellae,tal,tamen,tem,thick,throughout,time,transparent,tube,unarme,unbranched,unctional,unit,unknow,uvenile,vein,wide,x,ympodial	abaxial,adaxial,arrangement,bark,bud,cell,center,colour,corolla,filament,form,globose,growth,height,history,leaf,life,na,new,number,ovary,plant,position,purple,rachi,reproduction,scar,seed,shape,spacing,staman,stem,stigma,surface,texture,trichome,width
277	wfo-0001027742	success	239	112	81	158	31	0.339	-20,-8,0.1-0.5,0.5-5,1-2,1-5,1-8,2-3,2-5,2.5-5,3-9,3.5-10,4-6,4-lobed,7-10,accrescent,acicular,acute,adaxially,annual,anther,apex,black,broadly,brown,calyx,cm,densely,depressed,diameter,drying,entire,especially,extra-axillary,filament,finally,flower,fruit,fruiting,glabrous,globose,grey-green,inflorescence,ivory-green,length,lilac,lobed,margin,minutely,mm,moderately,ovate,ovate-lancelate,pale,pedicel,peduncle,perennial,petiole,prickle,pseudo-racemose,purple,rachi,reticulate,shallowly,shrub,simple,somewhat,square,stellate-pentagonal,stellate-pubescent,stem,stigma,straight,style,surface,toward,truncate,white,yellow,yellowish,yellowish-green	%,-13,-9,0-0.2,0-0.8,0-1.1,0-12,0-3.5,0-9,0.05-0.1,0.1-0.4,0.4-0.8,0.6-0.8,0.6-0.9,0.7-0.9,0.8-1.8,1-,1-1.1,1-1.2,1-1.5,1-1.8,1-3,1-4,1.7-2,10-18,10-20,2-,2-2.3,2-2.5,2-5.5,2-6,2-foliate,200-660,25-55,3-4,3-5,3-6,3.5-9.5,4-locular,5-12,5-merou,60-300,7-8,7-9,9-14,abaxially,absent,abundant,adaxiall,alyx,anthesi,anvil-shape,apart,armed,articulated,attenuate,axe,ba,base,bent,blade,broad,capitat,chartaceous,cone,connivent,cordate,cross-section,curved,cylindrical,decimetr,directed,distall,distally,distributed,dult,eaf,eed,eglandular,enclosing,erect,exceeding,exocarp,finger,geminat,gland-tipped,hair,homostylous,index,interpetalar,juicy,lamina,lanceolate,lateral,lobe,lobing,lon,long,longer,loosely,lower,markedly,mature,mesocarp,mid-point,midpoint,midvein,minute,moist,nflorescence,oblique,obtuse,one,orolla,outside,part,per,perfect,placenta,pore,porrect,presen,present,prostrate,ray,rhizomatous,rostrate,rounded,ruit,rusty,short,side,slightly,spaced,stage,stalk,stalked,stellae,strongly,tal,tamen,thick,thicker,thicknes,throughout,time,tip,tissue,tube,unbranched,unit,unknow,uvenile,vary,vein,wide,x,ympodial	abaxial,adaxial,arrangement,bark,bud,capitate,cell,center,colour,corolla,form,growth,height,history,leaf,life,na,new,number,ovary,plant,position,reproduction,scar,seed,shape,spacing,staman,texture,trichome,width
278	wfo-0001027757	invalid_json_followup	186	113	63	123	50	0.339	0.5,0.6,abaxially,acute,adaxially,anther,anthesi,apart,apex,articulated,axillary,base,blue,brown,calyx,campanulate,chartaceous,clavate,cm,colour,dark,deeply,diameter,erect,filament,flattened,flower,fruit,glabrous,globose,irregularly,leaf,lilac,lobed,long,margin,mm,moderately,multicellular,oblong,obtuse,occasionally,ovate,pale,pedicel,peduncle,perennial,petiole,pitted,pubescent,regularly,rotate,shrub,simple,sparsely,stigma,style,surface,uniseriate,unknown,violet,woody,yellow	0.2,0.2–0.3,0.3–2.0,0.6–1.0,0.7,0–1.4,1.0–1.1,1.0–2.5,1.2–4.0,1.5–1.6,1.5–2.5,1.6–2.4,1.9–2.7,12,1–1.5,1–11,1–2,1–3,2,2.5,2.5–4,2.5–5.5,2.5–7,2–,2–10,3–12,3–5,4–9,5,5–,60–100,6–9,7–8,8–16,absen,accrescent,adaxiall,ag,along,apical,arising,axe,ba,basal,blade,borne,branching,cell,concave,connivent,convex,cylindrical,decurrent,densely,directed,distally,eaf,eed,elliptic,entire,equal,erose,fleshy,geminat,glabrescen,glabrou,hair,lanceolate,leafy,lobe,lon,longitudinal,lower,m.,narrowly,nflorescence,often,opening,opposed,orolla,pair,perfect,plurifoliate,pore,poricidal,primary,probably,rootstock,ruit,secondary,serrate,shoot,side,slit,smaller,sometimes,spaced,stone,straight,tall,tamen,tem,thic,thickened,time,tip,toward,tube,unbranched,unicellular,unit,vary,white,wide,x,ympodial,–19,–2.7,–3.2,–4.0,–5.5,–6,–9	'',0-1.4,1-11,1.5-2.5,2-10,2.5-4,2.5-5.5,3-12,4-9,60-100,8-16,[,``,abaxial,adaxial,arrangement,bark,bud,center,characteristic,corolla,form,fruiting,growth,height,history,inflorescence,length,life,na,new,number,ovary,plant,position,prickle,rachi,reproduction,scar,seed,shape,spacing,staman,stem,texture,trichome,value,width,{,}
279	wfo-0001027765	invalid_json_followup	167	110	68	99	42	0.407	-44,0.8,1-11.5,1-4,10-13,2-2.5,2-3,2.5-4.2,20-30,3-20,5-6,abaxial,apex,branched,calyx,cell,cm,cordate,corolla,covering,cyme,diameter,dichasial,dichasially,distal,ebracteate,filament,flower,forked,glandular,globose,green,green-white,hair,half,herbaceous,lateral,leaf,light,mm,monochasial,oblique,odd-pinnate,ovate,ovate-lanceolate,ovoid,pedicel,peduncle,perennial,petiole,pilose,plant,rounded,seed,simple,slightly,stellate,stigma,style,testal,thick,throughout,tone,truncate,violet,wall,white,yellow	-30,-4,0-.,1,1-,1-10,1-2,1-5,1.5-6,2-4,2.5-4,3-,3-12,3-6-foliat,5,5-15,5-8,7-20,abaxially,abruptly,acumen,acuminate,acute,apical,apically,apiculate,articulate,base,connate,cuneate,dehiscent,digestion,diminishing,dorsally,eaf,edge,eed,elliptic,elliptic-lanceolate,emoval,enzyme,exceeding,flat,folded,generally,globo,hair-like,honeycomb,interjected,introrse,leaflet,living,lobe,lon,long,lower,lunat,make,maturing,mucilaginous,nflorescence,nther,obtuse,often,orolla,ovate-elliptic,pair,pattern,perfect,petiolate,petiolule,plan,poricidally,proximal,reveal,ruit,sessile,seudostipule,short,side,size,slit,specimen,stamen,straight,tal,tem,terminal,throughou,tip,toward,tuber-bearing,typically,unit,vary,wide,without,ympodial,¼	'',[,\u201chair-like\u201d,``,adaxial,anther,arrangement,bark,bud,center,characteristic,colour,form,fruit,fruiting,growth,height,history,inflorescence,length,life,margin,na,new,number,ovary,position,prickle,rachi,reproduction,scar,shape,spacing,staman,stem,surface,texture,trichome,value,width,{,}
280	wfo-0001027767	success	184	124	98	86	26	0.533	1,1-1.5,1-2,1.0-2,1.5-1.8,1.5-2,10-20,15-25,2-3,2.6-3,3,3.5-5,30-many-flowered,4-5,5-6,5-7,5-8,5-merous,7-8,abaxial,acute,anther,apex,attenuate,beige,bicolorous,branch,brown,calyx,campanulate,clavate,cm,coriaceous,cyme,dark,dark-green,deeply,diameter,equal,erect-branched,ferruginous,filament,flower,fruit,fruiting,glabrous,globose,helicoid,indument,lanuginose,leaf,long,minutely,mm,oblanceolate,oblong-lanceolate,oval-elliptic,parted,pedicel,peduncle,persistently,petiole,plant,porrect-stellate,prickle,rachi,recurved,reniform,rugose,sessile,shiny,short,shrub,similar,solitary,stellate,stem,stigma,style,sub-conic,sub-globose,sub-sessile,sub-truncate,subreniform,terete,terminal,thick,tomentose,trichome,unarmed,villous,viscid-glandular,viscid-villous,white,wide,winged,within,yellowish	0.3-0.5,10-12,2-2.5,3-6-branched,4-many-celled,8-9,accrescent,across,along,alyx,anthesi,armed,articulate,attenuat,base,blade,central,curved,distal,eaf,eed,enlarged,entire,epicarp,exceeding,floral,free,geminat,glandular,glandular-stalke,glandular-stalked,glandular-stellate,gynoeci,hirsute-glandular,irregularly,lobe,lobed,long-exserted,longer,lower,many-celled,midrib,multiangulate,nflorescence,numerous,orolla,papillo,part,peduncl,pendent,perennia,perfect,persistent,plurifoliate,primary,prominent,pubescent,ranch,ray,reduced,reflexed,ruit,secondary,small,somewhat,sparse,sparsely,stalked,stamen,staminate,straight,subcoriaceous,surfac,surrounded,tall,tamen,tube,uniseriate,unit,vary,vein,withi,without,yellow,ympodial,young	adaxial,arrangement,color,corolla,form,growth,height,history,inflorescence,length,life,na,number,ovary,papillose,perennial,position,reproduction,seed,shape,size,spacing,staman,surface,texture,width
281	wfo-0001027768	success	214	111	81	133	30	0.379	.5,0-0.1,0.1-0.3,0.1-0.4,0.25-1,1-2.5,1.5-2,3-15,4-5,6-12,6-6.5,absent,acicular,anther,black,brown,calyx,chartaceous,cm,contiguous,dark,deltate,densely,diameter,elliptical,entire,filament,flattened,fruit,fruiting,glabrous,gland-tipped,globose,green,greenish-white,grey,grey-green,hair,inflorescence,leaf,leaf-opposed,length,light,margin,minutely,mm,nearly,pale,pear-shaped,pedicel,peduncle,perennial,petiole,prickle,pubescent,purple,rachi,reddish,reticulate,rhizomatous,sessile,short,shrub,smooth,solitary,sparsely,stellate,stellate-pubescent,stigma,straight,streak,style,subcoriaceous,surface,toward,turning,violet,white,x,yellow,yellowish	%,0,0-0.2,0-0.3,0-2,0.15-0.25,0.15-0.3,0.2-0.3,0.3-0.6,0.3-0.7,0.3-1.5,0.5-1.5,0.5-3.4,0.6-0.9,0.6-1.5,1,1-2,1.2-1.4,1.2-1.8,1.2-3.4,1.7-2.6,10-15,11-14,15-50,18-35,2-2.5,2-7,2-locular,2.9-3.7,3,3-4.5,4-,5-7,5-merou,6-15,7-10,8-10,8-12,8-16,abaxiallly,abaxially,accrescent,across,adaxiall,adaxially,adult,alyx,apart,apex,articulated,attenuate,axe,ba,base,blade,branchlet,capitat,confined,connivent,cuneate,curved,cylindrical,difoliate,directed,distall,distributed,dm,eaf,eed,eglandular,erect,exocarp,finger,flower,geminat,half,hig,juicy,juvenile,lamina,lanceolate,lateral,less,lobe,long,longer,loosely,lower,mature,mesocarp,mid-point,midpoint,midrib,midvein,minute,moist,narrowly,nflorescence,oblique,obtuse,orolla,part,per,perfect,placenta,pore,porrect,present,pseudo-racemose,ray,ruit,semi-circula,simple,somewhat,spaced,spongy,sprawling,stellae,tamen,tem,thick,throughout,time,triangular,tube,unarme,unarmed,unbranched,unit,vary,wide,winged,ympodial	abaxial,adaxial,arrangement,bark,bud,capitate,cell,center,colour,corolla,form,growth,height,history,life,na,new,ovary,plant,position,reproduction,scar,seed,shape,spacing,staman,stem,texture,trichome,width
282	wfo-0001027770	invalid_json_followup	242	134	98	144	36	0.405	0.1-0.3,0.2-2,0.5-1,0.5-2,0.8-1.5,0.8-2.5,1-3,2,2-6,2.5-3,2/3,3,3-5,4,4-6,5-merous,6,6-10,7,7-15,anther,apex,apically,apparently,bark,base,berry,brown,calyx,clavate,cm,concolorous,dark,densely,diameter,dilated,elliptic,entire,filament,filiform,flattened,flower,fruit,fruiting,glabrous,globose,gray,herbaceous,lateral,leaf,length,lobed,margin,mature,mm,narrowly,obtuse,orange,orange-brown,ovoid,pale,pedicel,peduncle,petiole,plant,porrect,prickle,prominent,pubescent,red,reflexed,reniform,rounded,scar,sessile,shallowly,simple,smooth,spherical,spreading,stellate,stellate-pubescent,stem,stigma,straight,stump,style,subsessile,surface,tapering,terete,terminal,thin,trichome,violet,white,woody,yellow	0-45°,0.1-0.15,0.15,0.3,0.3-2,0.5,0.6-1.2,1-2,1-2.5,1-5,1.5,1.5-2,1/2-1/6,10-14,12,12-14,16,2-3,2-4,20,3-4,3-6,4-7,4-8,5-30,50,9,abaxially,acute,adaxially,ag,almost,alyx,anthesi,apart,armed,articulated,blade,branching,c.,cuneate,cuspidate,deltate,dense,difoliate,distance,drying,eaf,eed,elongating,equal,erect,extending,eye,flat,free,geminat,green,horizontal,infructescence,irregular,lanceolate,lengthening,less,like,lobe,lon,long,longer,lower,markedly,maturity,midpoint,midvein,mostly,naked,nflorescence,oblique,obscured,often,older,orolla,oung,ovate,pair,papillate,papillo,pendulous,per,perfect,pericarp,pore,poricidal,portion,present,prickly,primary,pubescenc,raised,rare,rarely,ray,reduced,reduced-multangulat,ruit,short-styled,side,slightly,small,sometimes,somewhat,spaced,sparse,sparsely,stalk,staminat,stolon,tall,tamen,tertiary,throughout,time,tip,toward,tube,unarme,unarmed,underground,uniform,unit,usually,variously,vary,vein,venation,visibl,visible,way,white-green,wide,yellow-green,ympodial,young,½	'',20-50,[,``,abaxial,adaxial,arrangement,bud,center,characteristic,colour,corolla,form,growth,height,history,inflorescence,life,na,new,number,ovary,papillose,perennial,position,rachi,reproduction,seed,shape,spacing,staman,texture,value,width,{,}
283	wfo-0001027807	success	116	93	60	56	33	0.517	0-0.2,0.1-1,0.2-0.9,2-5,2-6,apex,bark,berry,brown,bud,closely,cm,diameter,dry,elliptic,flattened,flower,fruiting,glabrous,globose,gray,grayish,green,growth,internodal,lanceolate,leaf,leaf-opposed,margin,material,minutely,narrowly,new,occasionally,overlapping,pale,papillate,pedicel,peduncle,petiole,pitted,plane,rachi,reddish,reniform,reproductive,revolute,scar,shoot,shrub,simple,slender,slightly,small,spaced,sparsely,stem,surface,tree,winged	.5,0.2-0.3,0.3-0.4,0.9-1,0.9-2.5,1-1.5,15-30,3.5-9,abaxially,acuminate,acute,adaxially,almost,attenuate,barely,base,brittle,decurrent,deflexe,deflexed,difoliate,drying,eaf,eed,ellipti,geminat,know,known,maturity,midrib,mm,nflorescence,older,ot,pair,paler,papillae,parallel,primary,prominent,reddi,ruit,seemingly,somewhat,thickened,ud,unifoliate,unit,usually,vein,visible,white,x,yellowish,ympodial,young	abaxial,adaxial,anther,arrangement,calyx,cell,center,colour,corolla,filament,form,fruit,height,history,inflorescence,length,life,na,number,ovary,plant,position,prickle,reproduction,seed,shape,spacing,staman,stigma,style,texture,trichome,width
284	wfo-0001027808	success	178	90	56	122	34	0.315	.5,0.6-1.2,1-2,1.6-3,12-18,2-4,23-28,5.5-6.5,7-10,9-14,acuminate,acute,andromonoecious,anther,apex,articulated,base,broadly,calyx,chartaceous,cm,curved,densely,diameter,extra-axillary,flower,fruit,fruiting,globose,green,inflorescence,lavender,length,lobed,margin,mm,ovate,pale,pedicel,peduncle,perennial,petiole,plant,prickle,pseudo-racemose,shallowly,simple,sparsely,stellate,stellate-pubescent,stigma,style,vine,white,yellow,yellowish	%,.2,.7,0-0.1,0-7,0.05-0.2,0.2-0.3,0.2-0.35,0.25-0.35,0.3-0.6,0.4-0.8,0.4-1,0.5-0.6,0.5-1,0.5-3,0.6-1.4,1,1-1.3,1.1-1.3,1.4-1.8,1.9-2.4,15-30,2-foliate,2.5-3.5,2.5-4,20-30,3-11,40-120,5-7,5-7.5,5-merou,6-8,7-8,70-90,8-12,abaxially,absent,acicular,across,adaxiall,adaxially,alyx,apart,armed,axe,ba,blade,broad-based,brown,capitat,cuneate,d.,deltate,directed,distall,distributed,eaf,eed,eglandular,finger,functional,geminat,gland-tipped,hair,half,heterostylous,index,lamina,lateral,less,lobe,lobing,long,longer,lower,mature,mid-point,midpoint,midvein,minute,nflorescence,oblique,orang,orolla,part,per,pore,porrect,presen,present,purple,ray,rostrate,ruit,sessile,short,side,spaced,sprawling,stage,stalk,stellae,straight,tal,tamen,tem,thick,throughout,time,tube,unarme,unarmed,unbranched,unit,unknow,uvenile,vary,vein,weakly,wide,x,ympodial	abaxial,adaxial,arrangement,bark,bud,capitate,cell,center,colour,corolla,filament,form,growth,height,history,leaf,life,na,new,number,orange,ovary,position,reproduction,scar,seed,shape,spacing,staman,stem,surface,texture,trichome,width
285	wfo-0001027816	invalid_json_followup	187	134	98	89	36	0.524	.5,0.2,0.5-1,0.6-0.8,0.7-1,1,1-1.5,1-3,1-4,1.5-2,2-4,2/3,4-5,5-30,<,acuminate,acute,almost,along,anther,apex,base,becoming,berry,bluish,branched,brown,calyx,capitate,cm,confined,conical,corolla,dark,dense,densely,diameter,ellipsoid,entire,erect,filament,filiform,flattened,flower,fruiting,glabrous,globose,growth,inflorescence,lanceolate,lateral,leaf,less,like,linear,lobed,margin,minutely,mm,new,orange,patent,pedicel,peduncle,perfect,petiole,pitted,plant,pubescent,purple,reddish,reniform,ripe,several,shiny,shrub,simple,slightly,sparse,sparsely,stellate,stem,stigma,style,surface,terminal,thin,time,tip,trichome,uniformly,uniseriate,variable,vein,way,x,yellowish,½	..,0.5,0.5-2,1-1,1.2-2,1.8-6,12-14,2-2.5,3-3.5,3.5-4,5-merou,6-9,ag,alyx,anthesi,apar,ark,articulated,attenuate,axi,cell,connivent,cupped,drying,eaf,eed,em,exserted,fleshy,free,gland-tipped,glandular,half,ilament,irregularly,leaving,lengthening,lobe,loosely,lower,m.,markedly,minute,nflorescence,nodding,occasionally,often,older,orolla,pair,papillo,peg,per,perhaps,pericarp,plurifoliat,pore,poricidal,portion,primary,prominen,pubescen,rectangular,red,rounded,ruit,scar,sleeve,slit,small,sometimes,somewhat,spaced,spreadin,spreading,square,testal,triangular,tube,twinin,ud,ultimate,unit,upper,usually,vary,viscous,woody,ympodial	'',[,``,abaxial,adaxial,apart,arrangement,bark,bud,ca,characteristic,colour,form,fruit,green,height,history,length,life,na,number,ovary,perennial,position,prickle,rachi,reproduction,seed,shape,spacing,staman,texture,value,width,{,}
286	wfo-0001027819	success	199	120	90	109	30	0.452	-100,1,1-,1-2,1.5-2,10-20,10-50,12-21,16-25,2-,2-15,20-35,20-40,22-35,3-40,3-5-lobed,4,4-10,4-15,4-25,5-merous,8-10,9-12,abaxially,acute,adaxially,apart,apex,apical,articulated,base,branched,cm,concave,densely,diameter,ellipsoidal,especially,fading,finely,fleshy,flower,forked,fruit,glabrous,globose,green,leaf,length,lobed,margin,mm,moderately,narrowly,near,oblong,pedicel,peduncle,per,perfect,petiole,pinnately,probably,protuberance,puberulent,purple,purplish,rachi,rarely,ratio,rugose,simple,sparsely,stellate,stigma,style,subcoriaceous,sympodial,tree,two,umbrella-shaped,unbranched,unit,unknown,unlobed,whitish,width,x,yellow,young	0.5-1,1-5,15-22,2,2-3,20-25,25-35,3-5,4-5,5,5-6,aggregate,also,alyx,ape,apiculat,axe,ba,basal,beyond,blade,cell,ciliate,color,connective,cordate,cuneate,cylindrical,deeply,denser,dia,diamete,dilated,directed,distally,divided,eaf,eed,eglandular,eglandular-pilose,elliptic,elliptic-ovate,entire,equal,exceeding,except,exserted,hair,halfway,leaving,lobe,lon,long,lower,main,mesocarp,midrib,narrow,nflorescence,nther,oblique,obtu,obtuse,occasionally,often,orolla,ovate,pedicellar,perfec,pilose,pore,present,prominent,puberulen,puberulence,radiu,ranch,remnant,ripe,rounded,rown,ruit,runk,shallowly,short-acuminat,shorter,sinus,slightly,small,sometimes,spaced,stamen,stone,strongly,swelling,tal,thecae,toward,triangular,truncate,tube,ud,uni,usually,vary,vein,villous,wide,without	abaxial,adaxial,anther,arrangement,bud,colour,corolla,crown,filament,form,growth,height,history,inflorescence,life,na,number,ovary,perennial,plant,position,reproduction,seed,shape,short-acuminate,spacing,staman,surface,texture,trunk
287	wfo-0001027829	invalid_json_followup	197	139	104	93	35	0.528	.5,0.1-0.8,0.6-0.9,1,1-1.5,1-3,1.5,1.7-2,12,30,5,5.5-6,6-6.5,abaxially,anther,apex,bark,base,berry,black,bright,brown,calyx,cell,clavate,cm,conical,corolla,dense,densely,denser,diameter,elliptic,elongate,entire,erect,evenly,filament,filiform,flattened,flower,fruiting,glabrous,gland-tipped,globose,growth,inflorescence,larger,lateral,length,lobed,long,margin,midpoint,minute,minutely,mixed,mm,narrowly,nearly,new,often,orange,ovary,pair,pale,pedicel,peduncle,petiole,pitted,porect,porrect,prickle,pubescent,rectangular,reddish,regular,reniform,ripe,scar,sessile,shiny,short-stalked,shrub,simple,sinuate,small,somewhat,spaced,sparsely,stellate,stem,stigma,straight,style,surface,tan,tapering,testal,thin,tree,trichome,white,yellowish	.1,0.5,0.6-0.7,0.7,0.7-0.8,1-,1.5-2,1.5-2.5,1/3,10-20,2,20-31,3-7,4-6,5-18,5-8,8-10,acuminate,acute,adaxially,along,anthesi,apar,armed,articulated,axi,beneath,bent,commonly,directed,distally,drying,eaf,eed,enmeshing,equal,exceeding,exserted,free,glabrescen,hang,like,lobe,lower,midrib,midvein,mixture,multicellular,nflorescence,nodding,oblique,older,one,open,papillat,per,perfect,pericarp,plurifoliat,pointed,pore,poricidal,portion,primary,prominent,pubescence,ray,reflexed,ruit,scattered,sharply,short,shorter,side,strongly,tangled,time,tip,triangular,truncate,tube,twice,ud,un,unarmed,unit,upper,usually,vein,weak,within,x,ympodial	'',0.5-1,[,``,abaxial,adaxial,apart,arrangement,bud,characteristic,colour,form,fruit,glabrescent,height,hermaphroditic,history,leaf,life,na,number,perennial,plant,position,rachi,reproduction,seed,shape,spacing,staman,texture,value,width,{,}
288	wfo-0001027834	invalid_json_followup	236	121	85	151	36	0.36	-6.1,0-110,0.2-0.3,0.2-0.4,0.2-0.6,0.5-2,1-1.6,1-1.9,1-10,1.1-1.8,1.6-2.7,2-8,2.3-3.4,4-5.2,5-20,5-merous,6.9-18.1,abaxial,abaxially,accrescent,acute,adaxial,anther,apex,articulated,bark,base,branched,brown,bud,calyx,cm,corolla,deltoid,diameter,echinoid,entire,filament,finely,flower,fruit,fruiting,globose,granular-tomentose,gray,leaf,lenticular,light,margin,mm,multangulate,ovate,ovate-elliptic,pedicel,peduncle,persistent,petiole,rachi,reticulate-punctate,ripe,scabridulous,scar,semi-spherical,sessile,short-stalked,shrub,simple,small,soft,stellate,stem,stigma,style,surface,tomentum,tree,trichome,turbinoid,velutinous-tomentose,white,whitish-tomentose,x,yellow,yellowish-tan,yellowish-tomentose	.5-3,0.4-1.1,0.9-1.8,1-2.5,1.1-1.6,1.4-2,1.8-4.9,1/2,10-25,2-3.8,2.2-4.3,2.4-6.2,2.7-7.3,2.9-4.2,25,3-15,3-4.3,4-6,4.8-6.9,5.1-8,9-11.9,9-13,absent,acuminate,adaxially,ag,alyx,angled,anthesi,apar,apical,around,attenuate,axillary,ba,becoming,berry,blade,blunt-tipped,branch,branching,capitat,closely,completely,concentrated,connivent,coriaceous,covering,crown,cylindrical,dendritic-echinoi,dendritic-echinoid,densely,dichasia,directed,discolorous,distally,drying,eaf,echinoi,edge,eed,ellipsoid,enclosing,enveloping,equal,erec,exserted,farinose,flat-topped,fleshy,forming,glabrescent,glabrous,grooved,hair,high,included,inserted,lengthening,less,lobe,lobed,long,long-stalked,longitudinal,longitudinally,lower,many,mostly,multangulat,near,nflorescence,numerous,obovate,obscured,obtuse,older,orbicular,orolla,ovate-lanceolate,pair,perfec,plurifoliate,pore,poricidal,porrect-stellate,primary,pseudo-terminal,pubescence,pubescent,rarely,ray,rounded,ruit,runk,semi-ovate,short,slit,sometimes,somewhat,spaced,sparsely,spreading,stalked,stamen,stellate-pubescent,subcampanulate,subcoriaceous,suture,tamen,though,time,tip,tomentose,tomentu,toward,tube,ud,unarme,unit,usually,vary,vein,villous,way,whitish,wide,yellowish,ympodial,young	'',[,``,apart,arrangement,capitate,center,characteristic,colour,form,growth,height,history,inflorescence,length,life,na,new,number,ovary,perennial,perfect,plant,position,prickle,pseudoterminally,reproduction,seed,shape,spacing,staman,texture,value,width,{,}
289	wfo-0001027843	invalid_json_followup	154	97	57	97	40	0.37	0.5-0.75,0.5-1,0.8-3.5,1-1.3,1-1.5,1.2-1.5,2-2.5,5-6,6-9,acute,along,anther,apart,apex,bark,broadly,calyx,clavate,cm,conical,corolla,densely,erose,filament,flower,fruiting,glabrous,globose,green,irregularly,leaf,lobed,margin,mm,opposite,ovary,ovate,pedicel,petiole,pubescent,scar,shape,shaped,shrub,slender,sparsely,stem,stigma,style,surface,tapering,trichome,uniseriate,vein,white,winged,x	.5,.75,/3,1-1.2,1.2-2.5,2-4,3-15-flowered,3-6,6-13,anthesi,apiculate,ba,base,bearing,becoming,beginning,beneath,berry,coroll,curly,deflexed,deltoid,denser,dia,differing,difoliate,distally,eaf,edicel,eed,ellipsoid,exsertion,free,geminat,glabrate,hairy,impressed,known,lamina,larger,later,lateral,like,lobe,lon,long,long-acuminate,lower,main,major,middle,minor,minutely,near,nearly,nflorescence,occasionally,older,one,orbicular,pair,papillo,papillose,pleated,pore,poricidal,portion,prominent,proximal,reddish-gre,reflexed,rounded,ruit,simple,sinus,size,slightly,somewhat,spaced,sparser,stiff,straight,strongly,tall,tear-drop,time,tip,tipped,tube,two,ud,unit,way,widest,woody,ympodial,young	'',3-15,[,``,abaxial,adaxial,arrangement,bud,cell,center,characteristic,colour,diameter,form,fruit,growth,height,history,inflorescence,length,life,na,new,number,peduncle,perennial,plant,position,prickle,rachi,reddish-grey,reproduction,seed,spacing,staman,texture,value,width,{,}
290	wfo-0001027847	invalid_json_followup	219	129	97	122	32	0.443	-2.5,-5,-6,/3,0-2,0.2,0.4-1,0.5-1,0.8-1.2,1-2,1.5-2,1.5-5,2-2.8,2-4,2.5-3.5,5-6,5.5-8,abaxially,anther,apart,apex,apically,apparently,bark,base,berry,branched,calyx,cm,deltate,densely,diameter,dull,elliptic,elongating,erect,evenly,filament,finely,flattened,flattened-reniform,flower,fruit,fruiting,glabrescent,glabrous,gray,green,lateral,leaf,length,lobed,long,margin,mature,maturity,mauve,mm,moderately,orange,orange-brown,ovate,pedicel,peduncle,perpendicular,petiole,pitted,porrect,prickle,purple,red,red-brown,reddish,retrorse,rounded,scandent,scar,seed,sessile,shrub,simple,smooth,sparsely,spherical,stalked,stellate-pubescent,stem,style,surface,terete,terminal,trichome,way,white,wide,yellow,young	-0.8,-2,-3,-4,.35,.7,/2,0,0-7,0.1-0.4,0.15-0.2,0.5,0.8,0.8-0.9,1,1-2.5,1.5-2.5,1.9-2.3,1/2,1/4,1/6-1/3,2-3,2-5,2.2-3,2/,3-15,3-5,3-6,3.5-6,4-5-merous,5-25,6-11,6-8,7-10,acute,almost,alyx,ame,apar,articulated,blade,broadly,brow,c.,chartaceous,connivent,cordate,curved,dimorphic,discolorous,distance,drying,eaf,edge,eed,equal,extending,faint,filiform,filiform-acuminat,free,geminate,increasing,infructescence,lobe,lon,longer,lower,middle,midpoint,midvein,minor,narrow-deltate,nflorescence,older,one,open,orbicular,orolla,oung,pair,pendulous,per,perfec,pericarp,pit,plurifoliat,poricidal,portion,prickl,prickly,primary,ray,ruit,side,size,slender,sometimes,spaced,spreading,stalk,stellate,straight,strongly,tamen,tapering,tertiary,time,tip,toward,tube,unarmed,unit,upper,usually,variously,vary,vein,venation,visible,weakly,ympodial	'',[,``,abaxial,adaxial,arrangement,brown,bud,characteristic,colour,corolla,form,growth,height,inflorescence,na,new,number,ovary,plant,position,rachi,reproduction,shape,spacing,staman,stigma,texture,value,width,{,}
291	wfo-0001027850	invalid_json_followup	221	152	119	102	33	0.538	-10,-4,-5,-6,0.5-1,0.6-1,1-3,1-4,1.5-2,2-2.5,2-3,2-4,2-5,3-6,3-7,4-5,6-7,8-10,abaxially,acuminate,acute,adaxially,adult,almost,anther,apart,apex,bark,base,berry,blue,branched,brown,calyx,clavate,cm,corolla,dark,diameter,elliptic,entire,erect,expanding,filament,flattened,flower,flowering,fruiting,glabrescent,glabrous,glandular,globose,green,growth,heterostylous,inflorescence,internodal,juvenile,laxly,length,like,lobed,lobed-angulate,long-styled,loosely,margin,mature,minute,minutely,mixture,mm,new,obovate,ornamented,ovary,ovate-lanceolate,pedicel,peduncle,petiole,plant,porrect,prickle,pubescence,purple,raised,reddish,reniform,reticulate,rugose,rusty-pubescent,scabrous,scandent,scar,sessile,short-styled,shrub,simple,slightly,spaced,stellate,stem,stigma,style,subglobose,subreniform,subsessile,subtruncate,surface,time,tomentose,trichome,turbinate,unevenly,velutinous,whitish,woody,x,yellow,yellowish	-22,0.2-0.5,0.3-0.35,1,1-1.5,1-2,1-multicellular,2-6,2.5-3,3-4,3.5-13,4-6,50,6-10,7-18,<,>,angled,anthesi,armed,articulated,basal,brow,caly,cell,channelled,charataceous,coriaceous,curved,discolorous,distal,dry,eaf,eed,eglandular,enclosed,foliaceous,free,hirsute,impressed,leaving,lengthening,linear,lobe,long,longer,lower,material,midpoint,mixed,multicellular,nflorescence,obliqu,oblong,oblong-lanceolate,obverse,occasionally,older,one,papillo,partially,per,perfect,pericarp,persistent,plurifoliat,pore,poricidal,portion,prickly,prominent,pubescent,reduced,reflexed,rest,rounded,ruit,rusty,sagittate,single,slit,sparse,sparsely,stalked,staminate,stellate-apiculate,straight,strongly,tall,tapered,testa,tip,triangular-lanceolate,tube,ud,unit,upper,vein,venation,wood,ympodial,¼	'',[,``,abaxial,adaxial,arrangement,bud,characteristic,colour,form,fruit,height,history,leaf,life,na,number,oblique,papillose,perennial,position,rachi,reproduction,seed,shape,spacing,staman,texture,tomente,value,width,{,}
292	wfo-0001027864	invalid_json_followup	222	117	78	144	39	0.351	0.1-0.4,0.25-0.5,0.4-1.4,1-2,1-3,1-4,1.4-4,1.5-8,3-6,3.5-5,4,5-9,6-7,accrescent,acicular,anther,apex,broad-based,brown,calyx,chartaceous,cm,deflexed,densely,diameter,ellipsoidal,entire,extra-axillary,filament,finely,flower,fruit,fruiting,glabrous,globose,green,grey,grey-green,hair,herbaceous,inflorescence,lanceolate,length,lilac,linear,lobed,margin,mm,nearly,pale,pedicel,peduncle,petiole,prickle,purple,rachi,reniform,resprouter,reticulate,ridged,scattered,shallowly,simple,slightly,smooth,stellate,stellate-pubescent,stem,stigma,straight,style,surface,terete,white,x,yellow,yellowish,yellowish-green	%,0-0.1,0-0.2,0-100,0-2,0-3,0.05-0.4,0.3-1,0.4-0.7,0.5-0.7,0.5-0.8,0.5-1,0.6-0.7,0.7-0.9,0.7-1,0.7-1.4,0.9-1.1,1-1.1,1-1.3,1-1.5,1-3.5,1.2-1.5,13-20,2-3,2-foliate,2-locular,2.5-3,3-10,3-4,3-4.2,3-5,3-5.5,3.8-14,4-,5-merou,6-12,6-8,6-9,7-10,7-20,8-12,8-13,8-14,abaxially,absen,absent,abundant,acute,adaxially,alyx,anvil-shape,apart,articulated,attenuate,axe,ba,base,blade,capitat,connivent,cross-section,cuneate,curved,cylindrical,decimetr,deltate,directed,distall,distributed,dult,eaf,eed,eglandular,erect,exocarp,finger,flattened,geminate,gland-tipped,half,homostylous,index,interpetalar,juicy,lamina,lateral,less,lobe,lobing,lon,long,longer,loosely,lower,mature,mesocarp,mid-point,midpoint,minute,moderately,moist,nflorescence,oblique,oblong,obtuse,orolla,part,per,perfect,placenta,pore,porrect,present,pseudo-racemose,ray,rostrate,ruit,rusty-brown,sessile,short,side,spaced,sprawling,stage,stalk,stalked,stellae,tal,tamen,tapered,thick,throughout,time,tip,tissu,tissue,tube,unarmed,unbranched,unit,uvenile,vary,wide,ympodial	'',[,``,abaxial,adaxial,arrangement,bark,bud,capitate,center,characteristic,colour,corolla,form,growth,height,history,leaf,life,na,new,number,ovary,perennial,plant,position,pseudoracemose,reproduction,scar,seed,shape,spacing,staman,texture,trichome,value,width,{,}
293	wfo-0001027872	invalid_json_followup	190	125	85	105	40	0.447	1,1-4,1-8,10,12-35,15,2-3,2.2-3.5,20,5-7,6-20,8-11,apex,articulate,b,base,branched,cell,celled,cm,commonly,covering,cyme,deep,densely,diameter,dichasial,dichasially,distal,ebracteate,elliptic,filament,flower,forked,four-celled,glabrescent,gland,glandular,glandular-pubescent,globose,gray-green,green,green-white,half,herbaceous,homogeneously,lanceolate,lateral,light,longer,make,mm,moderately,monochasial,mucilaginous,narrowly,odd-pinnate,ovate,ovoid,pedicel,peduncle,perennial,plant,purple,rarely,rhizomatous,rhizome,rotate,seed,semi-lunate,shape,short,single,slightly,stigma,style,testal,thick,tip,type,typically,usually,wall,yellow,yellowish-green	0.5,1-1.2,1.0-1.3,1.5-4,2,2.8,3-6-foliat,35,4-6,5-10,5-8,5-lobed,abaxially,acumen,acuminate,acute,adaxially,angular,apical,apically,apiculate,ba,basal,becoming,ca,calyx,caudate,clasping,connate,cordate,cuneate,decreasing,dehiscent,digestion,eaf,eed,emoval,enzyme,erect,exceeding,externally,generally,globo,hair-like,honeycomb,interjected,introrse,leaflet,living,lobe,lon,long,lower,maturing,middle,mottled,nearly,nflorescence,nther,obliquely,oblong,often,orolla,pair,pattern,pentagonal,perfect,petiolate,petiolulate,petiolule,poricidally,puberulent,pubescent,purpl,reduced,reveal,rotate-,rounded,ruit,sessile,seudostipule,size,slit,sometimes,somewhat,specimen,stamen,ste,straight,subequal,symmetrically,tem,terete,terminal,tinged,trailing,unbranched,uniformly,unit,vary,viole,wid,wide,wider,ympodial	'',[,\u201chair-like\u201,],``,abaxial,adaxial,anther,arrangement,characteristic,colour,corolla,form,fruit,growth,height,history,inflorescence,leaf,length,life,na,number,ovary,petiole,position,pseudostipule,rachi,reproduction,rotate-pentagonal,spacing,staman,surface,texture,value,violet,wet,width,{,}
294	wfo-0001027880	success	185	111	86	99	25	0.465	-3.5,.25,0.3-3,0.5-1.5,0.5-5,0.6-1.5,0.8-1.5,1-14,1-15,1-2,1-3,10-15,2-3,2-80,4-10,4-6,8,acute,along,anther,apart,apex,apiculate,base,chartaceous,clavate,cm,contiguously,cordate,densely,diameter,distichous,distinct,entire,epiphytic,extra-axillary,filament,flower,fruit,glabrous,globose,greenish,inflorescence,internode,leaf,leaf-opposed,line,longer,margin,mm,multicellular,nearly,oblong-ovate,occasionally,ovate,ovoid,pedicel,peduncle,perfect,petiole,pink,pubescent,purple,rachi,red-brown,ripe,rounded,rugulose,shrub,simple,slender,somewhat,stellate,stigma,style,surface,tan,truncate,typically,unbranched,undulate,uniseriate,vine,white,x,yellow	-3,0.6-1,1-2.5,1.5-2,1.5-3,2/,3-4,5-11,5-8,5-merou,abaxially,absen,accrescen,acuminate,adaxially,ag,aggregate,alyx,apparently,articulated,axe,ba,blade,branch,branching,calyx,cell,ciliat,conical,connivent,coriaceous,curled,cylindrical,deltate,dense,diminishing,directed,discolorous,distally,distinctly,eaf,eed,equal,flattened,fruiting,geminat,green,growing,hair,increasing,lobe,long,longitudinal,lower,midvein,minutely,nflorescence,node,oblique,oblong,often,opening,orolla,pair,pale,papillose,plurifoliate,point,pore,pubescen,reddish,revolute,rooting,ruit,scar,secondary,size,slightly,slit,sometimes,spaced,sparsely,ste,stone,tamen,tem,thickened,time,tip,trailing,tree,trunk,tube,unit,usually,vary,vein,wide,ympodial	abaxial,adaxial,arrangement,colour,corolla,form,growth,height,history,length,life,na,number,ovary,plant,position,reproduction,seed,shape,spacing,staman,stem,texture,trichome,width
295	wfo-0001027880	success	170	128	97	73	31	0.571	.25,0.2-0.5,0.5,0.6–1.5,0.8–1.5,1.5–3,10–15,1–14,1–15,1–2,2-80,2–3,4–10,4–6,5-merous,8,abaxially,absent,acuminate,acute,adaxially,along,anther,apex,apiculate,arrangement,bluish-purple,calyx,chartaceous,cm,conical,contiguously,coriaceous,densely,diameter,distichous,distinct,entire,extra-axillary,filament,flattened,flower,fruit,fruiting,glabrous,globose,green,greenish,hair,leaf,leaf-opposed,line,long,longer,margin,membranous,midvein,mm,mottled,nearly,oblong-ovate,occasionally,ovate,ovoid,pale,pedicel,peduncle,petiole,pink,pubescent,rachi,red,reddish-brown,revolute,rounded,rugulose,sand-punctate,shrubby,slender,slightly,sometimes,somewhat,sparsely,stellate,stigma,style,surface,tan,trichome,truncate,typically,unbranched,undulate,vine,white,woody,x	0.3–3,0.5–1.5,0.5–5,0.6–1,1.5–2,1–2.5,1–3,2/3,3–4,5–11,5–8,accrescen,alyx,apar,axe,base,berry,blade,c.,capitat,ciliat,clavate,climbing,cordate,curled,cylindrical,deltate,dense,discolored,distinctly,eaf,eed,lanceolate,lobe,lower,m.,minutely,nflorescence,nternode,oblique,often,orolla,pair,papillose,perfec,pinnate,plurifoliat,reddish,rip,ruit,sand-punctat,scar,secondary,simple,spaced,ste,tamen,tem,thickened,time,tip,tree,trunk,tube,uniseriate,unit,vary,vegetatio,vein,venation,wide,ympodial,–3.5	abaxial,adaxial,apart,bark,bud,capitate,colour,corolla,form,growth,height,history,inflorescence,length,life,na,number,ovary,perfect,plant,position,prickle,reproduction,ripe,seed,shape,spacing,staman,stem,texture,width
296	wfo-0001027881	invalid_json_followup	215	121	69	146	52	0.321	-3,acute,almost,anther,apex,attenuate,berry,blackish,calyx,chartaceous,ciliate,cm,contiguous,cordiform,diameter,drying,entire,erect,extra-axillary,filament,flattened,flower,fruit,giving,glabrous,glandular,globose,greenish,groove,hair,herb,immature,impression,lateral,leaf,light-brown,margin,maturity,membranaceous,mm,moderately,netlike,ovate-elliptic,parallel,pedicel,peduncle,petiole,projection,pubescent,rachi,raised,reniform,rotate,seed,sessile,short,simple,sparsely,staman,stem,stigma,style,subopposite,surface,translucent,unbranched,white,yellow,×	.3–0.5,0.5–2.2,0.8–1.5,1-celled,1.3–2,1.8–2.9,10–25,1–2,1–2-celled,1–2.5,1–2.6,1–3,1–3-celled,1–4,2.5–3.6,20–40,2–4,2–6,2–7,4–6,4–9.5,5,5-merous,6–10,7–14,7–9,8,abaxially,absent,abundant,accrescent,acuminate,adaxiall,adaxially,alyx,appressed,articulated,asymmetric,axe,ba,barely,base,blade,bulge,camptodromous,capitat,case,central,closely,commonly,connected,connivent,cordate,curved,cylindrical,decurrent,dehiscing,densely,denser,difoliate,directed,dorsally,eaf,ed,eglandular,emarginate,emerging,equal,exceeding,exclusively,explosively,eye,few-,fewer,forming,frequent,geminate,half,held,hollow,interpetalar,introrsely,larger,less,like,lobe,long,longer,longitudinal,lower,mainly,many-branched,maturit,mesocarp,mixed,much,multicelled,multicellular,naked,near,nflorescence,normally,one,opening,orolla,other,pair,part,per,perfec,placenta,pore,pressure,primary,prominent,pubescence,ruit,secondary,side,similar,size,slightly,slit,small,smaller,solitary,sometimes,stalk,stamen,subapically,tal,tamen,tem,tissue,triangular,tube,two,unit,vary,vein,venation,visible,watery,winged,woody,ympodial	'',0.3-0.5,0.5-2.2,1-2,1-2.5,1-4,1.3-2,2-7,20-40,4-6,6-10,7-14,7-9,[,``,abaxial,adaxial,arrangement,bark,bud,capitate,center,characteristic,colour,corolla,form,fruiting,growth,height,herbaceous,history,inflorescence,length,life,na,new,number,ovary,perennial,plant,position,prickle,reproduction,scar,shape,spacing,texture,trichome,value,width,{,}
297	wfo-0001027882	success	184	135	111	73	24	0.603	0.5-1,1-5,1.5-2,1.5-2.2,1.5-6,10-40,2-6,2-lobed,2.1-2.6,3-4,3.5-5,6-9,9-13,acuminate,anther,apart,apex,appearing,attenuate,bark,base,berry,branch,branched,broadly,brown,c.,calyx,clavate,cm,completely,conical,corolla,cucullate,dark,dense,densely,diameter,drying,elliptic,entire,erect,filament,flattened,flower,fork,fusiform,glabrous,globose,green,growth,hairy,hollow,hooked,inflorescence,irregularly,leaf-opposed,less,lobe,lobed,margin,maturity,minutely,mm,new,occasionally,ovary,ovoid,pair,pale,papillate,pedicel,peduncle,petiole,pitted,plane,pointed,primary,rachi,reddish,reniform,scar,shiny,shrub,simple,small,sometimes,spaced,sparse,sparsely,stem,sticky,stigma,stout,strongly,style,surface,swollen,time,tip,tree,trichome,tuft,uniseriate,usually,vein,way,white,x,yellow,yellowish	.25,.5,0.1,06a,1,1-1.5,1.5-,1.6-2.2,10-25,2-3,2.5-3,3.2-6,3.5-4,4-5,7-,abaxially,absent,adaxially,age,along,anthesi,apparently,axil,branching,caly,deltate,difoliate,dry,eaf,eed,et,exerted,fide,free,fruiting,geminat,glabrou,junction,kallunki,lamina,lengthening,lower,markedly,midrib,nflorescence,nodding,papillat,paulo,penden,perfect,planar,population,pore,poricidal,portion,pulp,rarely,red-papillat,ruit,shattering,slender,slit,specimen,straight,structurally,sweet-scented,são,thickened,tube,ud,unit,woody,ympodial	0.1-1,1.5-4,abaxial,adaxial,arrangement,bud,colour,form,fruit,height,history,leaf,length,life,na,number,perennial,plant,position,red-papillate,reproduction,seed,shape,texture
298	wfo-0001027889	success	151	101	66	85	35	0.437	0.5-1,0.5-11,1-3,1.5,10-12,10-30,3-4,3-8,3-9,abaxially,acute-acuminate,adaxially,apex,articulated,base,calyx,cell,chartaceous,cm,color,densely,diameter,eglandular-pubescent,elliptic,entire,finely,flower,fruit,glabrous,glandular-,green,greenish,immature,length,light,margin,mm,moderately,ovate,ovoid,pedicel,peduncle,perfect,petiole,probably,puberulent,puberulent-pubescent,rachi,ripe,shrub,simple,sparsely,stellate,stigma,style,subcordate,subcoriaceous,tomentose,tree,truncate,unbranched,unknown,violet,white,x,yellowish	-2.5,-pubescent,.5,.5-2,0,0.7-2,1,1-10,1-3.5,1.5-2,10-20,2-20,2-3,4-foliat,5-10,acuminate,acute,aggregate,apart,ape,apiculate,axe,basal,beyond,blade,capitat,connective,connivent,cylindrical,darker,deltate,dilated,directed,distally,eaf,eed,eglandular-puberulent,equal,exceeding,exserted,extending,introrse,laterally,leaving,lobe,lon,long,longitudinal,lower,narrow,nflorescence,nther,oblong,orolla,pedicellar,pore,presen,present,puberulen,puberulent-pubescen,radiu,remnant,ruit,slightly,small,somewhat,spaced,stamen,stone,stripe,swelling,tal,tem,thecae,time,tip,tomento,triangular,tube,ud,unit,vary,wide,yello,ympodial	1-2.5,abaxial,adaxial,anther,arrangement,bark,bud,capitate,center,corolla,form,fruiting,growth,height,history,inflorescence,leaf,life,na,new,number,ovary,perennial,plant,prickle,reproduction,scar,seed,shape,spacing,stem,surface,texture,trichome,width
299	wfo-0001027900	success	227	105	77	150	28	0.339	0.2–0.5,1.5–1.8,14–15,18–22,1–3,1–4,2.8,2–8,3.5–4.5,3–5,3–9.5,4–10,5-merous,8–15,abaxial,adaxial,andromonoecious,anther,bark,blue,broad-based,brown,calyx,capitate,cm,coriaceous,deeply,densely,diameter,entire,extraaxillary,filament,flower,fruit,fruiting,globose,green,grey-brown,inflorescence,lanceolate,leaf,length,light,lighter,likely,margin,maturity,mm,moderately,pedicel,peduncle,petiole,plant,powdery,prickle,pubescent,rachi,reddish-dark,repand,rotate-stellate,roughened,shrub,simple,slightly,small,smooth,stellate,stem,stigma,style,surface,tree,unbranched,violet,yellow,×,–4	.1,.1–0.2,.1–0.3,.5,0,0.1–0.3,0.2–0.4,0–0.1,16–19,16–23,1–,2,2–3,3,3.5–4,3–8,5–,5–10,5–6,5–7.5,6–8.2,7–10,7–10+,7–15,7–17,7–8,9–25,abaxially,absent,abundant,abundantly,accrescent,acute,adaxially,age,alyx,anthesi,apart,apex,armed,articulated,axe,ba,base,becoming,beneath,berry,bilobe,blade,congested,connective,connivent,cordate,curved,cylindrical,db,deltate,difoliate,directed,discolorous,distally,dried,eaf,eed,either,enclosing,equal,falcate,flowering,free,fresh,frui,functionally,geminat,glabrous,glandular,golden-tan,hair,half,hermaphroditic,heterstylou,interpetalar,like,lobe,lobed,long,long-stalked,longitudinal,lower,major,membranaceous,midpoint,midvein,mixed,multangulate,multangulate-stellate,multiseriate,multiseriate-stalked,nearly,nflorescence,oblique,obtuse,often,older,one,opening,orolla,part,pore,porrect-stellate,pronounced,pubescence,ray,reflexed,ruit,runk,sessile,sharp,short,short-stalked,side,slit,spaced,sparsely,stalk,stalked,staminate,stellate-pubescen,stellate-pubescent,stout,strongly,subtending,tamen,tan,tapered,thickened,time,tissue,tube,unarmed,unit,unknown,vary,vein,vestigial,wide,ympodial,young,–5,–6.2	13,arrangement,bilobed,bud,cell,center,colour,corolla,form,growth,height,history,life,na,new,number,ovary,position,reproduction,scar,seed,shape,spacing,staman,texture,trichome,trunk,width
300	wfo-0001027901	invalid_json_followup	156	118	79	77	39	0.506	.25,.5,0.3-1.2,0.8-1,1-2.5,2.5-3,3-5,4-5,abaxial,abaxially,acuminate,acute,adaxially,anther,apex,area,bark,base,berry,bright,broadened,brown,calyx,closely,cm,conical,corolla,dark,direction,dry,ellipsoid,elliptic,filament,fresh,fruiting,glabrous,globose,green,immature,inflorescence,later,leaf,lobe,lobed,material,minutely,mm,nearly,opposite,oriented,ovary,ovoid-reniform,papillose,pedicel,petiole,pitted,pubescent,ripe,scar,shape,shiny,shrub,simple,single,slender,spaced,sparsely,stem,stigma,style,surface,tip,translucent,trichome,uniseriate,white,x,yellow,young	0.5-1,0.8-2,0.9-2.3,1-1.5,1-2,1.5-1.8,1.8-4.5,4-10-flowered,4.7-12,6-7,?,anthesi,attenuate,ba,beneath,brow,curled,deflexed,densely,dia,differing,difoliate,drying,eaf,edicel,eed,exserted,firm,fleshy,free,geminat,imbedded,keeled,lateral,like,lon,long,lower,main,major,matrix,middle,midrib,minor,nflorescence,older,orbicular,overlappin,pair,papillo,planar,pore,poricidal,portion,prominently,reddish,reflexed,rest,rounded,ruit,shaped,size,straight,strongly,swollen,tall,tear-drop,triangular,tub,tube,ud,unit,usually,vein,widest,woody,ympodial	'',4-10,[,``,adaxial,arrangement,bud,center,characteristic,colour,diameter,flower,form,fruit,growth,height,history,length,life,margin,na,new,number,overlapping,peduncle,perennial,plant,position,prickle,rachi,reproduction,seed,spacing,staman,texture,value,width,{,}
301	wfo-0001027902	success	128	84	54	74	30	0.422	-2.5,0.5-1,10-20,2-12,2-15,2-8,2-9,20-50,3-5,4-5,5-20,7-9,acute,angled,apart,apex,articulated,base,branched,chartaceous,cm,densely,diameter,flower,forked,fruit,globose,margin,mm,moderately,ovate,pedicel,peduncle,petiole,puberulent,pubescent,purple,purplish,rachi,reticulate,shrub,simple,small,stellate,stigma,style,subcoriaceous,tree,truncate,unknown,usually,whitish,x,yellow	1-1.5,1-2,1-6,1.5-3,10-15,15-30,2,2-3,3-4,3-foliat,4-25,6-37,8-13,abaxially,absen,acuminate,adaxiall,adaxially,aggregate,axe,blade,calyx,cell,color,connivent,cordate,cylindrical,deeply,directed,distall,distally,eaf,eed,eglandular,entire,glabrous,glandular,hair,inflated,leaving,like,lobe,lon,long,lower,narrowly,nearly,nflorescence,nther,obtuse,orolla,pedicellar,pore,pubescen,radiu,remnant,ripe,ruit,spaced,sparsely,ste,stone,tal,tem,time,tip,triangular,truncat,tube,unbranched,unit,vary,wide,ympodial	abaxial,adaxial,anther,arrangement,center,colour,corolla,filament,form,growth,height,history,inflorescence,leaf,length,life,na,number,ovary,perennial,plant,position,reproduction,seed,shape,spacing,staman,surface,texture,width
302	wfo-0001027920	success	228	113	82	146	31	0.36	0.1-0.5,0.5-1,1-2,1-4,1.4-2.5,1.5-3,12-25,2-5,2-7,2-8,20-40,3-5,3.5-4,4-11,7-11,7-18,8-12,acicular,almost,anther,apart,base,black,bristly,broadly,brown,calyx,campanulate,cm,coarsely,dark,deltoid,densely,dentate,diameter,ellipsoidal,extra-axillary,flower,fruit,hair,hirsute,indument,inflorescence,leaf,length,lenticular,margin,minutely,mm,narrowly,oblong,obovoid,orange,outline,ovate,pedicel,peduncle,perennial,persistently,petiole,pitted,prickle,prickly,pubescent,rachi,ripe,simple,singled-stemmed,small,stellate,stellate-pubescent,stem,stigma,style,surface,thin-textured,tree,trichome,unbranched,white,x,yellow	-25,-3,.1-1.4,0.1-0.2,0.2-0.8,1-2.5,1/5-1/3,11-28,12-18,17-25,2-,2-foliate,25-45,3.5-4.5,4-10,4-6,4-7,4-locular,4.5-7,5-7,8-18,8-30,abaxially,acute,acute-,acute-tipped,adaxiall,adaxially,along,apex,appressed,approximately,articulated,ascending,attenuate,axe,ba,basally,blade,bristle-like,bristly-hirsute,broad-based,bulbou,capitat,cauline,class,close,concealed,concentrated,connivent,cylindrical,depressed-deltoid,descending,directed,distal,distall,distinct,divergently,eaf,eed,elongate,enlarging,entire,equaling,erect,female-sterile,few-branched,flesh,frui,geminat,glabrous,green,inserted,interlobal,intermixed,lanceolate,large,larger,lateral,less,lignescent,lobe,locule,long,long-stalked,longitudinal,lower,major,midpoint,minute,much,multiseriate,nearly,nflorescence,obtuse,obtuse-tipped,occasionally,often,one,orolla,ovate-lanceolate,pair,per,persistent,pore,principal,proliferation,radiu,ray,receptacular,recurved,rigid,ruit,scattered,section,sessile,short,side,similar,sinus,smaller,spaced,sparse,spreading,stalk,stalked,stella,stellae,swollen,tal,tamen,tawny,tem,termination,time,truncate,tube,two,unit,usually,vary,vein,vestitur,weakly,wide,ympodial	abaxial,adaxial,arrangement,bark,bud,capitate,cell,center,colour,corolla,filament,form,fruiting,growth,height,history,life,na,new,number,ovary,plant,position,reproduction,scar,seed,shape,spacing,staman,texture,width
303	wfo-0001027929	invalid_json_followup	193	114	71	122	43	0.368	1,1-10,1-4,10,2-3,2.0-3.0,3.5-5,4-30,4-5,6-15,along,apex,branched,calyx,cell,center,cm,corolla,covering,cyme,dark,deep,diameter,dichasial,dichasially,distal,ebracteate,elliptic,except,filament,flower,forked,glabrous,globose,green,green-white,hair,hair-like,half,herbaceous,lanceolate,lateral,mm,monochasial,narrowly,occasional,odd-pinnate,ovate,ovoid,pedicel,peduncle,perennial,plant,puberulent,purple,rhizomatous,rotate,seed,shape,sometimes,spot,stigma,style,testal,thick,tinged,vein,violet,violet-blue,wall,yellow	0.2-0.9,1-8,1.0-1.3,1.5-4,15,2,20,3-6-foliat,35,4-6,5-10,5-6,5-lobed,abaxially,acumen,acuminate,acute,adaxially,angular,apical,apically,apiculate,articulate,ba,basal,base,becoming,beyond,caudate,cente,clasping,coat,color,connate,cordate,cuneate,darker-violet-blue,decreasing,dehiscent,digestion,eaf,eed,embryo,emoval,enzyme,erect,exceeding,formed,generally,globo,honeycomb,included,interjected,introrse,leaflet,light,living,lobe,lon,long,lower,make,maturing,middle,mostly,mucilaginous,nearly,nflorescence,nther,obliquely,oblong,often,orolla,pair,pattern,pentagonal,perfect,petiolate,petiolulate,petiolule,poricidally,purpl,radiating,rarely,reduced,reveal,rhizome,rotate-,rounded,ruit,semi-lunate,sessile,seudostipule,short,size,slightly,slit,somewhat,specimen,stamen,star,ste,straight,subequal,symmetrically,tem,terete,terminal,tip,trailing,typically,unbranched,unit,usually,vary,visible,white,wid,wide,wider,without,ympodial	'',[,``,abaxial,adaxial,anther,arrangement,bark,bud,characteristic,colour,form,fruit,fruiting,growth,height,history,inflorescence,leaf,length,life,margin,na,new,number,ovary,petiole,position,prickle,rachi,reproduction,rotate-pentagonal,scar,spacing,staman,stem,surface,texture,trichome,value,width,{,}
304	wfo-0001027930	success	210	107	76	134	31	0.362	-2,0-0.5,0-0.7,0-2,0.2-0.4,0.4-1,0.4-1.5,2-10,2-2.5,3-3.6,3.5-5.5,4.5-6.5,6-13,9-13,acicular,andromonoecious,anther,articulated,basal,base,calyx,chartaceous,cm,densely,diameter,entire,erect,extra-axillary,filament,flower,fruit,fruiting,glabrous,gland-tipped,globose,green,hair,inflorescence,leaf,length,lilac,linear,linear-hastate,lobe,longer,margin,mm,obtuse,pale,pedicel,peduncle,perennial,perfect,petiole,plant,prickle,rachi,red,rhizomatous,scattered,short,shrub,simple,sparsely,stellate,stellate-pubescent,stigma,straight,style,time,unbranched,white,wide,x,yellow,yellowish	%,.1,.4,0,0-0.8,0-1,0-4,0.05-0.7,0.2-0.7,0.2-1.2,0.25-0.35,0.25-0.4,0.3-0.5,0.4-0.8,0.5-0.6,0.5-1,0.6-0.9,0.7-1.5,0.8-1.2,1-2,1-4,1-locular,13-16,15-60,2-3,2-6,2-9,2-foliate,3-12,3-7.5,4-,4-8,5-merou,6-12,6-8,7-12,7-8,8-20,9-26,abaxially,absen,absent,across,acute,adaxiall,adaxially,adult,alyx,and/or,apart,apex,apparen,axe,ba,blade,branch,branche,brown,capitat,confined,connivent,cuneate,cylindrical,decimetre,deltate,directed,distall,distributed,dm,eaf,eed,eglandular,exocarp,finger,functional,geminat,grey,half,hastate,heterostylous,homo-,incomplete,interpetalar,juicy,juvenile,lamina,lanceolate,lateral,less,long,loosely,lower,mature,mesocarp,mid-point,midpoint,midrib,midvein,minute,moderately,narrowly,nflorescence,oblique,orolla,part,per,placenta,pore,porrect,present,ray,rostrate,ruit,septum,sessile,spaced,sparse,stellae,strongly,succulent,tal,tamen,tem,thick,throughout,tissue,triangular,tube,unarme,unarmed,unit,vary,weakly,ympodial	abaxial,adaxial,arrangement,bark,bud,capitate,cell,center,colour,corolla,form,growth,height,history,life,na,new,number,ovary,position,reproduction,scar,seed,shape,spacing,staman,stem,surface,texture,trichome,width
305	wfo-0001027943	success	208	126	94	114	32	0.452	-4,0.2-2,0.5-1,0.5-1.5,0.5-4,0.5-6,1-1.5,1-3,1-4,1-5,2-10,2-2.5,2-3,2-3-lobed,2-4,3-15,4-20,4-7,5-9,7-10,abaxially,adaxially,andromonoecious,anther,apex,broad-based,brown,brownish,calyx,cm,coarsely,densely,diameter,elliptic,elliptic-ovate,entire,extra-axillary,ferruginous,filament,flattened,flower,forked,fruit,fruiting,glabrescent,glabrous,glandular,globose,green,inflorescence,leaf,lobe,margin,mature,membanaceous,midline,minutely,mm,moderately,nearly,outline,pedicel,peduncle,petiole,plant,prickle,pubescent,rachi,rarely,reniform,ripe,rugulose,shallowly,shrub,simple,smooth,sparsely,stellate,stellate-pubescent,stem,stigma,strongly,style,surface,tan,truncate,turning,unarmed,unbranched,white,whitish,x,yellow,young	-1.5,.1,.5,0,0.3-0.5,0.8-1.5,1.5-3,10-15,2-14,3-20,3-8,4-6,5-8,5-merou,6-.,7-15,accrescent,acute,ag,alyx,apart,armed,articulated,axe,ba,base,berry,blade,broad,capitat,chartaceous,connivent,covering,curved,cylindrical,difoliate,directed,distally,eaf,eed,equal,erect,free,frui,geminat,gland-tipped,hair,half,heterostylous,homo-,initially,interpetalar,interspersed,interwoven,like,linear-acuminate,linear-apiculate,long,longitudinal,lower,major,midpoint,midrib,narrowly,nflorescence,numerous,oblique,obtuse,often,opening,orolla,part,perfect,pericarp,pore,porrect-stellate,ray,recurved,reflexed,rounded,ruit,sessile,short,short-stalked,side,sinus,slightly,slit,small,somewhat,spaced,sparse,splitting,staminate,straight,subtending,tamen,tapered,tem,thi,time,tip,tissu,tissue,toward,triangular,tube,unarme,unit,vary,vein,wide,woody,ympodial	5-merous,abaxial,adaxial,arrangement,bark,bud,capitate,cell,center,colour,corolla,form,growth,height,history,length,life,na,new,number,ovary,perennial,position,reproduction,scar,seed,shape,spacing,staman,texture,trichome,width
306	wfo-0001027944	success	175	92	55	120	37	0.314	0-0.3,0.1-0.2,0.4-0.8,1-2,3-4.5,3-5,4-7,5-7,7-20,acicular,acute,anther,apex,calyx,chartaceous,cm,densely,diameter,entire,erect,extra-axillary,flower,fruit,fruiting,glabrous,globose,green,inflorescence,lanceolate,lavender,length,lobed,margin,mm,ovate,pale,pedicel,peduncle,perennial,petiole,prickle,pseudo-racemose,red,rhizomatous,rusty,shallowly,shrub,simple,stellate,stellate-pubescent,stigma,style,unbranched,yellow,yellowish	%,.8,0-4,0.2-0.3,0.2-0.4,0.25-0.4,0.3-0.4,0.4-0.5,0.5-0.8,0.5-1,0.5-1.2,0.9-1.2,1-1.2,1-3,1-locular,1.5-2,13-16,15-23,2-3,2-4.5,2-6,2-foliate,2.5-5.2,3-20,3-3.5,3-4,3-7,5-merou,7-8,7.5-14,abaxially,absen,absent,across,adaxiall,adaxially,adult,alyx,apart,apparen,articulated,axe,ba,base,blade,branche,brown,capitat,confined,cuneate,cylindrical,deltate,directed,distall,dm,eaf,eed,eglandular,exocarp,finger,geminat,gland-tipped,hair,half,incomplete,index,juicy,lamina,lateral,less,lobe,lobing,long,longer,lower,mature,mesocarp,mid-point,midpoint,midrib,minute,nflorescence,oblique,obtuse,orolla,part,per,perfect,placenta,pore,porrect,present,ray,ruit,septum,sessile,short,side,spaced,stage,stellae,straight,succulent,tal,tamen,tem,thick,throughout,time,tube,unarme,unarmed,unit,unknow,uvenile,vary,white,wide,x,ympodial	5-merous,abaxial,adaxial,arrangement,bark,bud,capitate,cell,center,colour,corolla,filament,form,growth,height,history,leaf,life,na,new,number,ovary,plant,position,rachi,reproduction,scar,seed,shape,spacing,staman,stem,surface,texture,trichome,unknown,width
307	wfo-0001027948	invalid_json_followup	186	99	56	130	43	0.301	0.5-2,1-1.2,1.3-1.8,1.5-4.5,3.7-4,7.5-10,abaxially,abundant,acuminate,adaxially,anther,apex,calyx,campanulate,cell,cm,corolla,diameter,elliptical,filament,fruiting,glandular,globose,herb,hollow,leaf,length,light,long-stalked,margin,midvein,mm,narrowly,non-glandular,ovate,ovoid,patent,petiole,pubescence,pubescent,purple,secondary,seed,serrulate,simple,slightly,stem,stigma,style,sub-shrub,tip,trichome,vein,violet,viscid-pubescent,x	-15,-16,-6,.5,0-,0.4,0.5-0.7,0.6,0.8-,1-2,1.2-2.2,1.6,1/10,10-14,13,14,2-,2.2-,2.5-,3-8.2,3.2-5.2,3.5,5,5-,6-celled,7,7-15,8-celled,accrescen,ag,aggregate,antrorse,ape,articulate,attenuate,ature,basal,base,berry,bicellular,branch,c.,connectival,crushed,cuticle,dark,delicate,diamete,difoliate,directed,dorsally,eaf,edentate,ellipsoidal,erect,finely,flexuous,fragrance,free,generally,glabrous,head,herbaceous,hig,ill-smelling,inconspicuous,inserted,lamina,lobe,long,longer,longitudinal,longitudinally,lower,many-,narrow,near,occasionally,odorles,opening,orolla,pair,papillate,pericarp,pore,poricidal,portion,prolongation,reduced,ree,ridged,ruit,saddle-shape,scarce,scarcely,seeded,seen,separated,short-stalked,shorter,single-celled,sinus,slit,small,smooth,solitary,spur-like,stalk,stone,straight,striat,striate,sub-opposite,tem,thecae,thickened,time,tooth,triangular,tube,twice,unequal,unit,upward,vary,ventrifixed,verrucate,ympodial,¼,½	'',[,``,abaxial,accrescent,adaxial,arrangement,bark,bud,center,characteristic,colour,flower,form,fruit,growth,height,history,inflorescence,life,na,new,number,ovary,pedicel,peduncle,perennial,plant,position,prickle,rachi,reproduction,saddle-shaped,scar,shape,spacing,staman,surface,texture,value,width,{,}
308	wfo-0001027961	invalid_json_followup	177	129	92	85	37	0.52	0.25-0.5,0.5-1,1-1.5,1-5,1-9,10-50,2-2.5,2.3-2.5,3-3.5,4.5-5,8-10,?,abaxially,anther,apex,axil,base,berry,branched,c.,calyx,clavate,cm,corolla,curling,densely,diameter,distributed,elliptic,entire,fading,filament,flower,fruiting,fusiform,glabrous,globose,green,growth,immature,inflorescence,irregularly,lamina,lateral,lobed,many,margin,maturity,membranous,midrib,mm,new,obovate,occasionally,one,other,pedicel,peduncle,petiole,pinnatifid,present,probably,pubescent,purple,reddish,rotate-stellate,scar,shiny,simple,slender,spaced,sparsely,stem,stigma,style,surface,terminal,time,triangular,trichome,tuft,twining,uniseriate,vein,vine,violet,way,white,white-pubescent,woody,x,yellow	.5,0.25,0.9-1,1,1-3,1-4,2.5-9,5-8,5-merou,6-9,7-9,<,acute,adaxiall,adaxially,age,always,alyx,anthesi,apar,ark,articulated,asymmetric,broadly,brow,clear,conical,connivent,cordate,deltate,eaf,early,eed,ellipsoid,equalling,exserted,free,geminat,ilament,lengthening,lobe,lon,long,loosely,lower,mature,minute,minutely,nflorescence,observed,often,older,orolla,pair,papillo,pendan,perfect,pericarp,pinched,planar,plurifoliate,pore,poricidal,portion,primary,pubescen,ruit,sleeve,slightly,slit,small,spreading,tem,thin,tip,transition,truncate,tube,twinin,ud,unequal,unit,upper,vary,ympodial	'',0.5,[,``,abaxial,adaxial,apart,arrangement,bark,brown,bud,characteristic,colour,form,fruit,height,history,leaf,length,life,na,number,ovary,plant,position,prickle,rachi,reproduction,seed,shape,spacing,staman,texture,value,width,{,}
309	wfo-0001027965	invalid_json_followup	265	146	110	155	36	0.415	.7,.9,0.1-0.2,1.2,1.5-2,1/4-1/3,2-2.5,2-3.5,2-4,3.5,abaxial,acuminate,acute,adaxial,almost,along,anther,apex,armed,bark,berry,branch,branched,brown,brown-green,calyx,capitate,chartaceous,clavate,clustered,cm,corolla,covered,cupular,curved,densely,development,diameter,discolorous,distributed,drying,dull,entire,evenly,fasciculate,filament,filiform,finely,flattened,flower,fruit,fruiting,glabrous,green,grey-brown,indumentum,inside,lateral,leaf,length,liana,lobed,long,maturity,mixture,mm,obconical,oblong,orange,orange-brown,outside,ovate,pale,pedicel,peduncle,petiole,pitted,porrect,prickle,pubescent,rachi,red-brown,reniform,rounded,scar,sessile,shiny,shrub,small,smooth,somewhat,spheroidal,stalked,stellate,stellate-pubescent,stem,stigma,straight,stump,style,surface,terete,throughout,tip,toward,translucent,trichome,white,wrinkled,x	-2,.1,.2,.25,.3,.5,/3,0.15,0.15-0.3,0.2,0.3,0.4,0.4-0.5,0.5,0.5-3,0.6-0.9,0.8-1.6,0°,1,1-2,1-8,1.5-2.5,1.5-3.2,1/3-1/4,1/3-2/3,2-3,2.2-2.6,2.8-3.3,3.5-10,4-7,4-merou,4.5,6-9,7-8,abaxially,absent,accrescent,acicular,adaxially,adjacent,age,alternate,alyx,ame,anthesi,apar,ape,apically,apparently,articulated,base,becoming,beneath,c.,canaliculate,cordate,deltoid,dense,density,detaching,divided,dry,eaf,early,eed,ellipsoi,elongated,equal,erect,even,except,extending,fairly,fissure,flat,flexuous,forming,free,glabrescent,increasing,leave,lengt,lengthening,less,like,lobe,loop,lower,m.,main,mature,midpoint,midvein,minor,nflorescence,nther,oblique,occasional,often,orolla,pair,papillose,patch,pendulous,perfect,pericarp,pit,plurifoliat,pore,poricidal,portion,present,primary,protruding,raised,ray,reduced,regular,remnant,ridged,ruit,series,short,simple,sinus,sometimes,sparse,sparsely,spreading,stalk,strongly,tapering,tearing,tertiary,thin,transverse,tube,ud,unarme,unarmed,underneath,unequal,uneven,unit,usually,variable,vary,vein,venation,visible,wide,widening,ympodial,young,youngest	'',0-0.4,0.5-1.6,4-merous,[,``,arrangement,bud,cell,center,characteristic,colour,ellipsoid,form,growth,height,history,inflorescence,life,margin,na,new,ovary,perennial,plant,position,reproduction,seed,shape,spacing,staman,texture,value,width,{,}
310	wfo-0001027966	success	207	87	59	148	28	0.285	1-10,1-2,1-4.2,1-5,10,10-30,2.2-2.9,3-4,40-80,5-10,5-6,5-9.5,abaxially,adaxially,anther,apex,blue-violet,chartaceous,cm,conical,corolla,densely,diameter,elliptic,filament,flower,forked,fruit,glabrous,green,greenish,hair,herb,leaf,light,like,medium,membranous,minute,mm,moniliform,odd-pinnate,ovate,ovoid,pedicel,peduncle,pentagonal,petiole,plant,pubescent,purple,rotate,seed,stem,stigma,terminal,tuber,whitish,yellow	0.4-0.5,0.7-3,0.8,0.8-2.5,1-1.8,1-3,1.2-4.5,1.3-2.2,1.5-3,1.5-5.2,2.5-10.5,2.8-9,3-5,3-7,4,5-merou,5.5-14,6-11,absent,acumen,acuminate,ag,along,alyx,apart,apparently,arranged,articulated,asymmetrical,attenuate,axe,axillary,base,basiscopic,bead,berry,blade,brownish,bud,capitat,cell,ciliate,commonly,condition,connivent,covering,decreasing,digestion,distal,dorsally,drying,eaf,edge,eed,enzyme,erec,especially,exceeding,flat,folded,fresh,geminat,generally,glabrou,gradually,green-white,hair-like,half,homostylous,honeycomb-shaped,interjected,lanceolate,larger,lateral,leaflet,lengthening,less,living,lobe,long,lower,make,margin,middle,mottled,mucilaginous,multiple,narrow,necklace,nflorescence,orbicular,orolla,pair,pale,perfect,petiolule,plurifoliate,pore,poricidal,proximal,rarely,ray,removed,ripe,ruit,secondary,semierect,sessile,seudostipule,shorter,side,size,slightly,slit,somewhat,spaced,sparsely,specimen,stamen,ste,stolon,straight,subequal,subsessile,subtending,symmetrical,tall,tamen,tem,testal,thick,throughout,tip,tissue,tri-,tube,tyle,typically,unit,usually,violet,wall,wet,white,wide,wing,x,ympodial	abaxial,adaxial,arrangement,capitate,center,colour,form,growth,height,history,inflorescence,length,life,na,number,ovary,perennial,position,pseudostipule,rachi,reproduction,shape,spacing,staman,style,surface,texture,width
311	wfo-0001027978	invalid_json_followup	197	134	99	98	35	0.503	0.2-0.5,0.5-1,1-1.5,1-2,1-3,1-6,1.5-2.5,10-14,2-3,2.5-5.5,3-5,3-6,4-10,4-6,5-8,6,7-10,7-9,abaxial,absent,acute,adaxial,andromonoecious,anther,apex,becoming,brown,calyx,chartaceous,cm,cylindrical,dark,densely,diameter,entire,extra-axillary,filament,flower,fruit,fruiting,functionally,glabrous,globose,green,hair,hermaphroditic,immature,initially,leaf,length,lilac,lobe,lobed,male,many,margin,mature,mm,moderately,narrowly,nearly,netlike,obtuse,orange,orange-red,ovary,ovate,pedicel,peduncle,per,petiole,pit,plant,porrect-stellate,prickle,pubescent,rachi,raised,recurved,ridge,round,scattered,separated,shrub,side,simple,small,stellate,stem,stigma,style,surface,tan,triangular,unbranched,white,wide,x,yellow	0.5-1x,1,1.5,1/6,11,2-2.5,2.5-3,20-40,4-5,4-8,6-10,8-12,abaxially,absen,accrescent,adaxially,along,alyx,andormonoeciou,apar,apical,apparently,armed,asymmetrical,attenuate,axe,base,berry,beyond,blade,connivent,cordate,cut,difoliate,directed,discolorous,distal,eaf,eed,either,end,except,exserted,filiform,flattened,frui,geminate,glabrou,gree,heteromorphic,introrsel,less,like,long,lower,major,midpoint,midrib,midvei,midvein,multicellular,multiseriate,nflorescence,occasionally,often,orolla,pair,pore,proximal,ray,reflexed,roselike,ruit,scandent,short,sinus,slightly,spaced,sparsely,stalk,stamen,staminate,ste,straight,tamen,tapering,tem,thin-skinned,tube,unarmed,unequa,unicellular,unit,vary,vegetatio,vein,way,ympodial	'',[,``,apart,arrangement,bark,bud,cell,center,characteristic,colour,corolla,form,growth,height,history,inflorescence,life,na,new,number,perennial,position,reproduction,scar,seed,shape,spacing,staman,texture,trichome,value,width,{,}
312	wfo-0001027997	invalid_json_followup	174	111	70	104	41	0.402	.1,.2,.5,0.1-0.7,0.1-0.8,0.2-2,0.9-1,1-4,1.5-1.7,acute,anther,apex,bark,becoming,bi-lobed,black,bright,calyx,cm,corky,corolla,dense,densely,denser,dirty,dry,filament,fruiting,glabrous,globose,green,greenish-yellow,inflorescence,leaf,live,lobed,margin,minutely,mm,obovate,opposite,ovary,ovoid-reniform,pale,pedicel,petiole,pitted,plant,pubescent,raised,ripe,scar,scattered,shrub,simple,small,soft,sparsely,specimen,stem,stigma,style,surface,tan,tapering,tree,trichome,uniseriate,vein,white	.6,1,1-2,1.5-1.8,1.5-2,10-20-flowered,10-23,2,3.5-10,7-10,7/8,abaxially,along,anthesi,apar,attenuate,auriculate,ba,base,beneath,berry,blade,breaking,brittle,consisting,decurrent,deflexed,deltoid,dia,distal,eaf,edicel,eed,entire,erect,even,evenly,exserted,free,glabrate,impressed,inflorescenc,keel,keeled,later,lateral,like,living,lobe,long,long-acuminate-triangular,long-ellipsoid,lower,main,middle,nflorescence,occasionally,often,old,older,onto,ovoid,pair,papillose,partially,planar,pore,poricidal,portion,prominent,pubesent,reddish-brown,remaining,rest,ribbed,ruit,sessile,shaped,short,slender,slightly,somewhat,soon,spaced,straight,strongly,tall,tear-drop,tip,trunk,tube,ud,ultimately,unifoliat,unit,vasculature,way,widest,wing,winged,woody,x,ympodial,young	'',10-20,[,``,abaxial,adaxial,apart,arrangement,bud,cell,center,characteristic,colour,diameter,flower,form,fruit,growth,height,history,length,life,na,new,number,peduncle,perennial,position,prickle,rachi,reproduction,seed,shape,spacing,staman,texture,unifoliate,value,width,{,}
313	wfo-0001028014	success	222	122	94	128	28	0.423	-15,-2.5,/5,0.2-0.4,0.2-1,0.2-1.6,0.5-1,0.5-1.5,0.7-1,0.9-1.2,1-3,1-4,1.3-2.4,2-20,2-6.5,3-10,4.5-7,5-merous,abaxially,almost,anther,apart,apex,articulated,bark,base,berry,black,branched,brown,brown-green,calyx,cell,cm,curved,densely,diameter,erect,filament,flattened,flattened-reniform,flower,fruit,fruiting,glabrous,gray,gray-green,lateral,leaf,length,lobed,margin,maturity,mauve,mm,moderately,obtuse,occasionally,orange,outline,ovate,pale,pedicel,peduncle,petiole,pit,prickle,purple,raised,red,reflexed,rough,rounded,scandent,scar,seed,shiny,shrub,simple,smooth,spherical,stellate-pubescent,stem,straight,strongly,style,surface,terminal,trichome,visibly,way,weakly,yellow,yellow-green	-0.5,-1,-1/2,-10,-3,-4,-5,-6,.5,0,0.1-0.2,0.15,0.15-0.3,0.2,0.25,0.3-0.4,0.5,0.5-2,0.5-3,0.6-0.9,0.7-1.6,1-,1-10,1-2,1.5,1.5-2,1.8-3,1/4,1/4-2/3,2,2-3,2-4.5,2.5-4,4-10,6-10,6-11,acuminat,alyx,ame,apar,apically,apparently,around,blade,broad-deltate,c.,chartaceous,concolorous,connivent,cordate,decurrent,deltate,difoliate,discolorous,distance,drying,eaf,edge,eed,elongating,equal,extending,eye,free,geminat,glabrescent,glabrou,gland,globular,herbaceous,infructescence,lobe,lon,long,longer,lower,mature,membranous,midpoint,midvein,naked,nflorescence,older,one,open,orange-gra,orolla,oung,outer,pair,pendulous,per,perfec,pericarp,poricidal,porrect,portion,prickl,prickly,primary,ray,reduced,ruit,sessile,shorter,side,slender,sometimes,spaced,spreading,stalk,stalked,stellate,tamen,tapering,terete,tertiary,time,tip,tube,unit,vary,vein,venation,visible,wide,winged,ympodial	abaxial,adaxial,arrangement,bud,center,colour,corolla,form,growth,height,history,inflorescence,life,na,new,number,orange-gray,ovary,perennial,plant,position,reproduction,shape,spacing,staman,stigma,texture,width
314	wfo-0001028017	invalid_json_followup	158	116	67	91	49	0.424	0.3-1,1-10,1-3,1.5-2,15-35,2-4,2.5-5,3-12,3-14,5-7,6-8,acute,apex,articulated,base,brown,calyx,cell,chartaceous,clavate,cm,densely,diameter,eglandular-puberulent,eglandular-pubescent,ellipsoidal,elliptic,entire,flattened,flower,forked,fruit,fusiform,glabrous,glandular-,glandular-puberulent,green,greenish,immature,margin,mm,moderately,narrowly,near,ovate,ovoid,pedicel,peduncle,petiole,purplish,rachi,rarely,ripe,short-acuminate,simple,sparsely,stellate,stellate-campanulate,stigma,style,subcoriaceous,tree,truncate,unbranched,white,x,yellow	-2.5,1,1-2,10-22,13-40,15-50-flower,2,2-3,3,3-4,3-foliat,40-50,5,5-9,6-7,9-11,abaxially,absen,absent,acuminate,adaxially,aggregate,apart,ape,apiculate,axe,basal,beyond,blade,ciliat,connective,connivent,cream,cuneate,cylindrical,directed,distally,eaf,eed,eglandular,exceeding,exserted,fleshy,glandular,hair,introrse,lanceolate,leaving,lobe,lon,long,lower,nflorescence,nther,oblique,obtuse,orolla,pedicellar,perfect,pointed,pore,puberulen,pubescent,purple,radiu,remnant,ruit,shorter,slightly,small,sometimes,spaced,stamen,stone,tal,tan,tem,thecae,time,tip,tomentose,triangular,truncat,tube,ud,unit,vary,vein,wide,without,ympodial	'',1-2.5,15-50,[,``,abaxial,adaxial,anther,arrangement,bark,bud,center,characteristic,colour,corolla,filament,form,fruiting,growth,height,hermaphroditic,history,inflorescence,leaf,length,life,na,new,number,ovary,perennial,plant,position,prickle,puberulent,reproduction,scar,seed,shape,spacing,staman,stem,surface,texture,trichome,value,width,{,}
315	wfo-0001028025	success	182	100	64	118	36	0.352	.8,0,0.1-2.2,0.4-3,1.6-3.5,12-17,16-23,2-2.3,2-6,2.5-4,4-10,5-,6-,7-13,9-14,acicular,adaxially,anther,apart,apex,broad-based,calyx,chartaceous,cm,cordate,diameter,erect,extra-axillary,flower,fruit,fruiting,glabrous,globose,green,inflorescence,lavender,length,lobed,long,margin,mm,moderately,obtuse,ovate,pale,pedicel,peduncle,perennial,petiole,prickle,pseudo-racemose,rhizomatous,shallowly,shrub,simple,sparsely,stellate,stellate-pubescent,stem,style,unbranched,white,yellow,yellowish-green	%,0-0.5,0-11,0.15-0.25,0.2-0.3,0.2-0.7,0.3-0.8,0.3-1,0.5-0.7,0.9-1.2,1-1.4,1-8,1.1-1.4,1.4-2.2,1.5-7,1.9-2.4,10-140,11-18,13-21,2-locular,3-5,3-6,3.5-4.5,4-8,5-11,5-20,5-7,50-90,6.5-10,7-8,7-9,abaxially,absen,absent,across,acute,adaxiall,alyx,anvil-shape,armed,articulated,attenuate,axe,ba,base,blade,brown,cross-section,cylindrical,d.,directed,distall,distributed,dult,eaf,eed,eglandular,exocarp,finger,gland-tipped,hair,half,hig,index,juicy,lamina,lateral,less,lobe,lobing,lon,longer,lower,mature,merou,mesocarp,mid-point,midpoint,midvein,minute,moist,nflorescence,oblique,onl,orolla,part,per,perfect,placenta,pore,porrect,present,ray,ridged,ruit,sessile,short,side,spaced,stage,stalked,stellae,straight,tamen,thick,throughout,time,transparent,tube,unarmed,unit,unknow,uvenile,vary,vein,wide,x,ympodial	abaxial,adaxial,arrangement,bark,bud,cell,center,colour,corolla,filament,form,growth,height,history,leaf,life,merous,na,new,number,ovary,plant,position,rachi,reproduction,scar,seed,shape,spacing,staman,stigma,surface,texture,trichome,unknown,width
316	wfo-0001028033	success	157	113	72	85	41	0.459	.6,50,abaxially,along,anther,apex,ascending,attenuate,base,becoming,brown,calyx,cell,chartaceous,ciliate,cm,cyme,darker,decurrent,deeply,densely,diameter,elliptic,entire,filament,flower,fruit,glabrescent,glabrous,green,greenish,growth,herb,hispid-pubescent,lateral,length,light,like,lobed,long,margin,membranaceous,mm,nearly,new,pedicel,perfect,petiole,pubescence,pubescent,rhizomatous,sessile,shiny,shrub,simple,slightly,solitary,sparsely,spreading,stellate,stem,stigma,style,surface,trichome,unbranched,upright,vein,white,wide,woody,yellow	1.4–1.8,1.5,1–4,1–5,2–3,2–4,2–foliate,3,3–11,3–4,3–5,4–12,4–5,5-merou,5–7,6–12,acuminate,acute,adaxiall,adaxially,alyx,anthesi,ark,blade,branch,brochidodromous,capitat,connivent,contiguou,cordate,cylindrical,denser,directed,discolorous,drying,eaf,eed,emarginate,equal,eye,few-branched,florescence,geminat,high,introrsely,know,known,linear-lanceolate,lobe,longitudinal,lower,mainly,midrib,naked,oblong,older,onto,opening,order,orolla,ovate-lanceolate,pore,poricidal,prominent,prostrat,recurved,ruit,secondary,shin,shorter,slit,straight,strongly,subapical,tamen,tem,tube,uniseriate,unit,unknown,vary,venation,visible,ympodial,×	1-4,1.4-1.8,2-4,3-5,4-12,4-5,5-merous,6-12,abaxial,adaxial,arrangement,bark,bud,capitate,center,colour,contiguous,corolla,form,fruiting,height,history,inflorescence,leaf,life,na,number,ovary,peduncle,plant,position,prostrate,rachi,reproduction,scar,seed,shape,spacing,staman,texture,width
317	wfo-0001028035	invalid_json_followup	172	101	56	116	45	0.326	1,1.3-1.8,1.5,1/4-1/3,3,3-6,4.2-5.5,5-10,7-10-flowered,accrescent,annual,anther,blade,bristly,brown,calyx,capitate,cm,dark,dark-based,diameter,erect,felty,flattened-ovoid,flower,foveolate,fruit,glabrous,herb,internodal,leaf,long,minutely,mm,numerous,oblong,often,ovate,pedicel,pentagonal,petiole,pinnatifid,prickle,reticulately,seed,slightly,spherical,stellate,stellate-pubescent,stem,stout,surface,twice,undulate,wrinkled,yellow	2,2.5-3.1,2.5-4,2/3,3.7-4.2,4-8,5,50-90,6-13,7-10,9-13,acicular,across,almost,along,alyx,ample,anthesi,apically,armed,base,berry,bristle,broad,broad-based,broadly,campanulate,cauline,closely,confluent,congested,da,deep,densely,developing,dia,difoliate,distinct,divided,dry,eaf,exceeding,externall,flattened,geminat,hardly,hilum,incurved,interpetalar,invested,lanceolate,lobe,lon,long-rayed,m.,main,markedly,maturity,midpoint,n,narrowly,nflorescence,notch,noticeably,one,orolla,other,per,pigmentation,plicate,prickly,prominent,purple,ray,reaching,recurved,red,rounded,ruit,scattered,short,shorter,slende,sometimes,somewhat,spaced,splitting,spreading,stalk,stellae,stellate-wooll,styl,suffused,sunken,symmetrically,tall,tamen,tapering,taprooted,terminal,tightly,tigma,tissue,tub,tube,tyle,ultimate,unit,upper,usually,vary,vein,well,wide,yello,ympodial	'',[,``,abaxial,adaxial,apex,arrangement,bark,bud,cell,center,characteristic,colour,corolla,filament,form,fruiting,growth,height,history,inflorescence,length,life,margin,na,new,number,ovary,peduncle,plant,position,rachi,reproduction,scar,shape,spacing,staman,stigma,style,texture,trichome,value,width,{,}
318	wfo-0001028044	invalid_json_followup	195	109	69	126	40	0.354	.9,0.3,0.4-0.5,1.2-1.4,1.3-2.2,1.4-1.6,1.5-2,19-22,2-3,2.8-3.3,20-21,3-4,3-6,50,6.5-7.2,abaxial,anther,apex,attenuate,black,branched,bud,calyx,cm,corolla,creamy,dark,diameter,drying,entire,filament,flower,fruit,fruiting,globose,green,greenish,leaf,length,many,margin,mm,obovate-elliptic,pale,pedicel,peduncle,petiole,porrect-stellate,pubescent,rachi,rough-granular,seed,shrub,simple,sparse,sparsely,stellate,stigma,style,subcampanulate,surface,terete,thin-textured,time,tomentose,white,x,yellow,yellow-brown	-3.5,-5,.6,1/3-1/2,11-13,11-16,16,2-4,2.7-4,3.4-4.3,3.5-4.6,31-46,4-5,5-merou,6-8,7.5-9,9.5-13,abaxially,accrescent,acute,adaxiall,adaxially,ag,along,alyx,anthesi,apart,around,articulated,ature,axe,axillary,base,becoming,berry,blade,blunt-tipped,branch,brown,bulbous-based,capitat,closely,concentrated,connivent,cylindrical,decurrent,dendritic,directed,distally,eaf,edge,except,exserted,few-rayed,fleshy,frui,geminate,glabrate,glabrescen,glabrous,hair,high,homostylous,immature,lackin,lateral,lengthening,lobe,lobed,long,long-attenuate,long-stalked,longitudinal,lower,main,midrib,moderately,mostly,much,multangulat,multangulate,nearly,nflorescence,oblong,obscured,obtuse,occur,orolla,ovate-lanceolate,plurifoliate,pore,poricidal,presumably,rather,resorption,ruit,runk,semi-obtuse,side,slender,slit,somewhat,spaced,stalked,stamen,suture,tamen,thick,thick-stalked,tip,tissue,tomentu,tube,unarme,unbranched,unit,unknown,vary,vein,way,weakly,wide,winged,yellowish,ympodial,young	'',0.6,[,``,adaxial,arrangement,bark,capitate,cell,center,character,characteristic,colour,form,glabrescent,growth,height,history,inflorescence,life,na,new,number,ovary,perennial,plant,position,prickle,reproduction,scar,shape,spacing,staman,stem,texture,trichome,value,width,{,}
319	wfo-0001028046	invalid_json_followup	186	123	94	92	29	0.505	0.2-0.3,0.3-0.5,0.5-1,1-1.5,1-7,12-13,2-3,2.5-3,20,3-12,4-5,8-9,abaxially,acute,anther,apex,approximately,attenuate,bark,berry,blue,brown,calyx,clavate,cm,compressed,corolla,cylindrical,dark-brown,densely,diameter,elliptic,entire,erect,filament,flattened,flower,fruiting,glandular,globose,grayish,green,growth,inflorescence,leaf,length,like,lilac,long-styled,margin,mm,new,obovate,opposite,ovary,ovoid,pedicel,peduncle,petiole,porrect,prickle,prickly,prominent,pubescent,red,reniform,rest,rusty,rusty-red,scabrous,scar,short-styled,shrub,simple,slightly,spaced,sparse,sparsely,stalked,stellate,stem,stigma,style,sub,subglobose,subhirsute,subscandent,surface,tomentose,trichome,truncate,unevenly,x,yellow	0.4-0.5,1-1.3,1-multicellular,1.2-1.5,1.5-2,10,10-15,13-38,2-4,5-18,6-7,acuminate,adaxially,anthesi,armed,articulated,basal,base,c.,campanulate,chartaceous,coriaceous,decurrent,deflexe,denser,difoliat,distal,eaf,eed,exserted,foliaceous,foveolate,free,glabrescent,glabrous,gland-tipped,half,heterostylous,lanceolate-subulate,large,lengthening,lightly,lobe,lobed,long,lower,midpoint,minute,minutely,mixed,multangulate,multicellular,nearly,nflorescence,obverse,occasionally,older,papillo,per,perfect,pericarp,pore,poricidal,portion,pubescence,raise,ray,reduced,reflexed,rigid,ruit,sessile,slit,somewhat,staminate,subcordate,subsessile,tall,tapering,testa,thick,tip,tomentose-scabrous,tube,ud,unarmed,unicellular,unit,upper,winged,ympodial,¼	'',[,``,abaxial,adaxial,arrangement,bud,characteristic,colour,form,fruit,height,history,life,na,number,plant,position,rachi,reproduction,seed,shape,spacing,staman,texture,value,width,{,}
320	wfo-0001028059	success	221	119	90	131	29	0.407	-4.5,0-1.2,0-2,0.5-0.7,0.5-1.3,1,1-3,1.5-2,15,2-10,2-3,2.5-2.6,2.5-3.5,3-10,4.5-7,5-9,8.5-10,9-12,accrescent,acicular,acuminate,acute,adaxially,andromonoecious,anther,apex,articulated,bark,base,brown,brownish,calyx,chartaceous,cm,contiguous,corky,densely,diameter,elliptic,entire,erect,filament,flower,fruit,fruiting,furrowed,glabrous,glandular,globose,green,hair,inflorescence,leaf,leaf-opposed,length,lilac,longer,margin,mm,nearly,oblate,ovate,pale,pedicel,peduncle,perennial,petiole,plant,prickle,pseudo-racemose,purple,rachi,rhizomatous,shrub,simple,somewhat,sparsely,stellate,stellate-pubescent,straight,style,surface,time,toward,unbranched,weakly,wide,x,yellow,yellowish-green	%,.4,0-0.2,0-0.3,0-15,0-7,0.1-0.3,0.1-0.6,0.1-0.7,0.4-0.7,0.4-0.8,0.4-0.9,0.5-0.8,0.6-0.8,0.6-1,1-1.5,1-2,1.1-12,1.1-4.5,1.5-2.1,1.5-3.5,2-2.6,2-5,2-foliate,2-locular,2.1-2.7,2.5-12,3-11.5,3-17,4-10,4-7,4-8,5-7,5-merou,6-17,60-90,8-18,9-17,abaxially,absen,absent,across,adaxiall,adult,alyx,anvil-shape,apart,ascending,attenuate,axe,ba,blade,branch,branche,connivent,cross-section,cuneate,cylindrical,decimetre,deltate,directed,distall,distributed,dm,eaf,eed,eglandular,exocarp,finger,functional,geminat,gland-tipped,half,heterostylous,interpetalar,juicy,juvenile,lamina,lateral,less,lobe,lobed,long,loosely,lower,mature,mesocarp,mid-point,midpoint,midvein,minute,moderately,moist,nflorescence,oblique,oblong,obtuse,often,orolla,pair,part,per,placenta,pore,porrect,present,ray,ruit,rusty,shallowly,short,spaced,sparse,stalk,stalked,stellae,tal,tamen,tem,thick,throughout,tissue,transparent,tube,unarme,unarmed,unit,upper,vary,yellowish,ympodial	abaxial,adaxial,arrangement,bud,cell,center,colour,corolla,form,growth,height,history,life,na,new,number,ovary,position,reproduction,scar,seed,shape,spacing,staman,stem,stigma,texture,trichome,width
321	wfo-0001028067	success	139	87	58	81	29	0.417	-30,0.5-1,0.5-2,1-10,1-11,1-7,1.5-2.5,10-25,2-2.5,3-7,5-7,6-12,6-18,7-11-compound,7-9,acuminate,acute,apart,apex,articulated,base,cell,chartaceous,cm,dark,diameter,elliptic-fusiform,elliptic-ovate,flattened,flower,fruit,glabrous,leaf,mm,moderately,pedicel,peduncle,petiole,pink,pinnately,puberulent,purple,rachi,rarely,shrub,simple,slightly,sparsely,stellate,stigma,strongly,style,tomentulose,truncate,unbranched,unknown,x,yellow	0.5-1.5,1,1-2,1-3,2,2-3,2.5-3,3-17,3-4,3-5,4-foliat,7-20,8-13,abaxially,adaxiall,adaxially,aggregate,along,axe,basiscopically,blade,calyx,color,compound,connivent,cuneate,cylindrical,decurrent,directed,distall,eaf,eed,entire,especially,glabrou,hair,lateral,leaflet,leaving,lobe,lon,long,lower,margin,midrib,narrowly,nearly,nflorescence,nther,obtuse,often,orolla,pedicellar,per,pore,puberulen,radiu,remnant,ripe,ruit,several,smal,spaced,stone,subcoriaceous,tal,tem,time,tip,triangular,triangular-deltate,truncat,tube,unequal,unit,upper,usually,vary,wide,ympodial,zigzag	abaxial,adaxial,anther,arrangement,center,colour,corolla,filament,form,growth,height,history,inflorescence,length,life,na,number,ovary,perennial,plant,position,reproduction,seed,shape,spacing,staman,surface,texture,width
322	wfo-0001028069	invalid_json_followup	253	125	91	162	34	0.36	.1,0.1-0.3,0.3-0.45,0.4-0.8,0.5-1.8,0.5-2,0.6-4,1-2.7,1-3.5,1.4,1.6-3.2,10,12,2-3-branched,3,abaxially,abundant,accrescent,along,anther,apex,articulated,bright,brown,calyx,cell,cm,conical,corolla,deep,deeply,densely,diameter,eglandular,filament,flower,fruit,fruiting,glabrescent,glandular,globose,green,hair-like,herb,imparipinnate,interrupted,lateral,leaf,length,like,lime,lobed,long,margin,midvein,minute,mm,multicellular,obovate,occasionally,orange,outgrowth,ovary,ovate,pale,patent,pedicel,peduncle,pentagonal,perennial,petiole,plant,pubescent,robust,simple,slender,stem,stigma,style,surface,tangled,testa,transparent,trichome,unicellular,uniseriate,viny,wall,weak,wide,yellow	-0.4,-30,-6,.1-0.2,.2,.5,0.05-0.1,0.1-0.15,0.1-0.2,0.1-0.5,0.1-0.6,0.2-0.3,0.2-0.5,0.3,0.3-0.4,0.3-0.6,0.3-0.7,0.3-1,0.4,0.4-0.5,0.4-1,0.5,0.5-0.7,0.6-1.1,0.7-1,0.7-1.3,0.7-1.5,0.8-1.2,1-2-celled,1-4.5,1.5-2.0,1.5-3.5,10-12,10-30,2-17,2-4,2-7,2-locular,3-,3-foliate,4-celled,5-22,5-25,6-,<,absen,acute,adjacent,adpressed,alternate,always,among,anthesi,apical,appearance,appendage,appressed,axi,ba,basal,base,basioscopically,becoming,berry,bilaterally,bract,bracteole-like,citru,column,composed,cone-shaped,cordate,cuneate,curving,decurrent,dense,due,eaf,ebracteate,edicel,eed,erect,exserted,forming,fusion,giving,gland,gland-tippe,gland-tipped,glandular-villous,gree,half,halfway,head,included,initially,interjected,internode,larger,later,leaflet,less,linear,lobe,lon,longer,longest,lower,maturity,middl,minutely,narrowly,nflorescence,oblique,often,one,pair,per,petiolule,population,present,primary,procumbent,pseudostipule,pubescence,quaternary,rarely,reflexed,rounded,ruit,scarcely,scent,secondary,sessile,several,shaggy,short,shorter,silky,single-celled,size,smaller,somewhat,staminal,sterile,straight,strong,subopposite,symmetric,tem,terminal,tertiary,thick,tightly,toward,tube,ud,unit,usually,varying,winged,ympodial	'',[,``,abaxial,adaxial,arrangement,bark,bud,characteristic,colour,form,growth,height,history,inflorescence,life,middle,na,new,number,position,prickle,rachi,reproduction,scar,seed,shape,spacing,staman,texture,value,width,{,}
323	wfo-0001028070	success	185	98	66	119	32	0.357	0-0.4,0-2,0.15-0.4,0.2-0.3,0.3-0.4,0.5-1.5,3-8,3.5-4,4-5.5,4-6,4-9,5-9,7-11,8-9.5,acicular,acute,andromonoecious,anther,apart,apex,base,calyx,chartaceous,cm,cuneate,dark,densely,diameter,entire,erect,extra-axillary,flower,fruit,fruiting,globose,green,inflorescence,lavender,length,linear,long,margin,mm,obtuse,pale,pedicel,peduncle,perennial,petiole,plant,prickle,pseudo-racemose,pseudo-umbellate,rhizomatous,shrub,simple,sparsely,stellate,stellate-pubescent,stem,stigma,streak,style,thick,white,yellow	%,.05,0-0.1,0-0.15,0-6,0.25-0.35,0.3-0.6,0.35-0.5,0.4-0.5,0.4-0.6,0.4-0.8,0.5-0.9,0.5-1,0.6-1.4,0.7-1.3,1-1.5,1-2,1-4,1-locular,1.5-2.5,1.5-7,10-40,3-7,4-7,5-7,5-merou,7-8,8-13,8-9,8.5-17,abaxially,absen,absent,accrescent,across,adaxiall,adaxially,alyx,articulated,axe,ba,blade,brown,connivent,cross-section,cylindrical,d.,deltate,directed,distall,distributed,dult,eaf,eed,eglandular,exocarp,finger,functional,geminat,gland-tipped,hair,half,heterostylous,hig,incomplete,juicy,lamina,lanceolate,lateral,less,lobe,longer,lower,mature,mesocarp,mid-point,midpoint,midvein,minute,moderately,moist,nflorescence,oblique,orolla,part,per,placenta,pore,porrect,present,purple,ray,ruit,rusty,semi-circula,septum,sessile,short,spaced,stage,stalk,stellae,straight,tamen,throughout,time,truncat,tube,unarme,unarmed,unbranched,unit,unknow,uvenile,vary,weakly,wide,x,ympodial	5-merous,abaxial,adaxial,arrangement,bud,cell,center,colour,corolla,filament,form,growth,height,history,leaf,life,na,new,number,ovary,position,reproduction,scar,seed,shape,spacing,staman,surface,texture,trichome,truncate,width
324	wfo-0001028075	invalid_json_followup	196	114	72	124	42	0.367	1-10,1.5-2.5,10-35,2-4.5,5-12,5-17,5-7,5-9,7-30,8-12,abaxially,acuminate,acute,adaxially,anther,apex,axillary,broadly,brownish,bud,cell,chartaceous,ciliate,cm,condition,corolla,covering,dark,diameter,drying,elliptic-lanceolate,filament,flower,forked,fresh,fruit,glabrescent,glabrous,globose,green,greenish,herb,lateral,leaf,light,margin,membranous,minutely,mm,obtuse,odd-pinnate,ovate,ovate-elliptic,ovoid,pedicel,peduncle,pentagonal,petiole,plant,puberulent,rotate,seed,stigma,style,subtending,terminal,testal,thick,wall,white,whitish,yellow	.5,1-2,1-2.7,1-3,1.5-7,1.6-2.7,2-3,2-6,2.5-10,3-11,3-23.5,4-12,4-7,5-14,5-8,5-merou,7-13,absent,acuman,acumen,ag,along,alyx,apart,apparently,articulated,axe,base,berry,blade,borne,capitat,connivent,cuneate,decreasing,differentiated,digestion,distal,distally,distinctively,dorsally,dot,eaf,edge,eed,end,enzyme,erec,especially,exceeding,flat,folded,geminat,generally,glabrescen,green-white,hair-like,half,homostylous,honeycomb-shaped,interjected,lanceolate,larger,leaflet,lengthening,ligulate,living,lobe,long,lower,make,middl,midrib,much,mucilaginous,narrow,nflorescence,oblique,often,orolla,pair,pale,perfect,petiolule,plurifoliate,pore,poricidal,purple,reflexed,removed,rounded,ruit,scattered,seudostipule,singly,size,slightly,slit,sometimes,spaced,specimen,stamen,star,stolo,straight,subcordate,tall,tamen,tem,throughout,tip,toward,tri-,tube,tuber,typically,unit,usually,vary,wet,wide,wing,x,ympodial	'',[,\u201chair-like\u201d,``,abaxial,adaxial,arrangement,bark,calyx,capitate,center,characteristic,colour,form,fruiting,growth,height,history,inflorescence,length,life,na,new,number,ovary,perennial,position,prickle,rachi,reproduction,scar,shape,spacing,staman,stem,surface,texture,trichome,value,width,{,}
325	wfo-0001028076	success	195	93	66	129	27	0.338	.5,1-10,1-2,12-22,2-12,2-5.4,2.2-2.6,2.5-4,4-5,5-20,7-8,abaxially,adaxially,anther,apex,articulated,brownish,cell,cm,condition,conical,corolla,covering,densely,diameter,drying,elliptic,filament,flower,forked,fresh,fruit,glabrous,green,greenish,hair-like,herb,honeycomb-shaped,lateral,leaf,less,light,medium,mm,odd-pinnate,ovate,ovoid,pedicel,peduncle,pentagonal,petiole,plant,proximal,pubescent,purple,ripe,rotate,seed,stigma,style,terminal,testal,thick,wall,whitish,yellow	0.4-0.5,0.5,1-1.3,1-3,1.2-2.2,1.8-2.2,110,13-14,2-3,2.2-3.7,2.5-3,2.6-3.8,4.5-7,5,5-6,5-6.5,5-merou,?,absent,acumen,acuminate,ag,alyx,apart,apparently,attenuate,axe,axillary,base,berry,blade,borne,bud,capitat,chartaceous,ciliate,connivent,decreasing,digestion,distal,dorsally,eaf,edge,eed,end,enzyme,erec,especially,exceeding,flat,folded,geminat,generally,glabrou,gradually,green-white,hair,half,homostylous,interjected,lanceolate,larger,leaflet,lengthening,like,living,lobe,long,lower,make,margin,membranous,minute,mucilaginous,nflorescence,obtuse,orolla,pair,perfect,petiolule,plurifoliate,pore,poricidal,pubescen,rarely,ray,removed,round,ruit,secondary,semierect,sessile,seudostipule,singly,size,slightly,slit,spaced,specimen,stamen,ste,stem,stolo,straight,subequal,subsessile,subtending,symmetrical,tall,tamen,tem,thir,throughout,tip,toward,tri-,tube,tuber,typically,unit,unwinged,usually,vary,wet,white,wide,wing,x,ympodial	abaxial,adaxial,arrangement,capitate,center,colour,form,growth,height,history,inflorescence,length,life,na,number,ovary,perennial,position,rachi,reproduction,shape,spacing,staman,surface,texture,third,width
326	wfo-0001028080	success	187	111	81	106	30	0.433	0.2-1.5,0.25-0.5,0.5-1.5,0.5-2,0.5-3,1,1-1.5,1-2,1-3,2-10,2-2.5,2-5,20-30,5-6,5-merous,6-7,8-10,abaxially,acute,adaxially,andromonoecious,anther,apex,articulated,bark,base,brown,brownish,calyx,chartaceous,clavate,cm,densely,diameter,ellipsoidal,entire,extra-axillary,filament,flattened,flower,form,fruit,fruiting,glabrous,glandular,green,hair,leaf-opposed,long,margin,mm,moderately,needle-like,outline,ovate,ovoid,pedicel,peduncle,petiole,plant,prickle,puberulent,pubescent,rachi,reniform,rugulose,scandent,shrub,simple,sparsely,stellate,stellate-pubescent,stem,stigma,style,surface,unbranched,white,white-pubescent,x,yellow	1.5-2,1.5-5,2-3,2-8,2.5-3,2.5-9,3-4,30-40,4-6,5-12,absent,accrescen,acuminate,adaxiall,alyx,andromonoeciou,apart,armed,axe,ba,berry,blade,branch,capitat,connivent,cylindrical,directed,distally,eaf,eed,eglandular,equal,fine,fissure,formed,free,geminat,gradually,hermaphroditic,heteromorphic,interpetalar,lanceolate,lateral,like,linear-lanceolate,lobe,long-,long-stalked,longitudinal,lower,lowering,major,midpoint,midvein,multangulate,narrowly,nflorescence,opening,orolla,part,pendent,perfect,pericarp,persistent,plurifoliate,pore,porrect-stellate,projection,ray,recurved,ruit,sessile,short-,short-stalked,short-styled,shorter,side,slit,small,sometimes,spaced,staminate,stellate-multangulate,straight,strongly,subcordate,tall,tamen,tapered,thi,time,tissue,triangular,truncate,tube,unarmed,unequal,unit,vary,vein,vertical,weakly,whitish,wide,without,ympodial	abaxial,adaxial,arrangement,bud,capitate,cell,center,colour,corolla,growth,height,history,inflorescence,leaf,length,life,na,new,number,ovary,position,reproduction,scar,seed,shape,spacing,staman,texture,trichome,width
327	wfo-0001028105	success	150	97	62	88	35	0.413	.1,.5,0.3-1.5,0.5-2,0.6-1,1-1.2,1-1.5,1.5-1.8,1.5-2,2-2.2,3.5-4,abaxially,acuminate,adaxially,anther,apex,bark,bilobed,calyx,clavate,cm,conical,corolla,dark,dense,ellipsoid,elliptic,filament,filiform,flattened-reniform,fruiting,glabrous,globose,green,leaf,lobed,minutely,mm,olive-green,opposite,ovary,pale,papillose,pedicel,petiole,pitted,pubescent,reddish-brown,scar,shrub,simple,slightly,small,stem,stigma,style,surface,tree,trichome,tuft,uniseriate,white	.4,0.5,0.5-1,1-2.5,1.5,1.5-4.5,2,2-5,3-5-celled,3-6,5-7-flowered,6-7,9.5-15,acute,anthesi,apar,apical,attenuate,axi,axil,ba,base,berry,deflexed,dia,differing,difoliate,distinct,drying,eaf,edicel,eed,erect,evenly,exserted,free,geminat,glandular,greenish-yello,incrassate,lamina,lateral,like,lobe,lon,long,lower,main,major,margin,middle,minor,nearly,nflorescence,occasionally,older,pair,papillo,planar,pore,poricidal,portion,projection,quadrate,reflexed,ruit,scattered,shaped,size,spaced,sparsely,spreading,straight,strongly,tall,tear-drop,tip,tub,tube,ud,unit,vein,widest,woody,x,yellowish,ympodial,young	5-7,abaxial,adaxial,apart,arrangement,bud,cell,center,colour,diameter,flower,form,fruit,greenish-yellow,growth,height,history,inflorescence,length,life,na,new,number,peduncle,perennial,plant,position,rachi,reproduction,seed,shape,spacing,staman,texture,width
328	wfo-0001028109	invalid_json_followup	205	138	102	103	36	0.498	-20,0.05-0.2,0.4-0.8,0.4-1.5,0.45-0.65,0.8-1.5,1.5-10,1.5-5.5,2-4,2.5-3,2.5-5,2/3-3/4,20-60,3-7,30-150,4-5-merous,5-13,abaxial,abaxially,acuminate,acute,adaxial,almost,anther,apart,apex,apparently,articulated,bark,base,berry,bright,calyx,chartaceous,cm,curved,deltate,densely,diameter,discolorous,drying,dull,elliptic,entire,erect,evenly,filament,flattened-reniform,flower,fruit,fruiting,glabrescent,glabrous,gray-green,green,green-brown,lateral,leaf,length,light,lobed,margin,maturity,mauve,mm,moderately,multangulate,occasionally,orange-brown,pedicel,peduncle,petiole,prickle,prickly,recurved,red,red-brown,scar,shrub,simple,small,sometimes,spherical,stalked,stellate,stellate-pubescent,stem,straight,strongly,style,surface,terete,terminal,tree,trichome,unarmed,usually,way,weakly,white,yellow,young	-4,-7,.5,/3,0.05-0.15,0.1,0.1-0.2,0.3,0.5-1.2,0.5-2.5,0.6-0.8,0.7,0.8-1.6,1.5-2.5,1/8-1/4,10-25,10-30,12-40,15-100,2-15,2.3-2.9,3-,3.5-6,3/4,4-13,5-30,8-12,8-15,8-25,acut,alyx,ame,apar,apically,blade,branching,brow,c.,connivent,cuneate,dimorphic,eaf,eed,elongating,equal,free,fully,geminate,gently,glabrou,infructescence,lobe,long,long-styled,longer,lower,mature,midpoint,minor,nflorescence,obtuse,older,one,open,opening,orolla,oung,pair,per,perfec,pericarp,perpendicular,plurifoliat,poricidal,porrect,portion,prickl,primary,ray,reflexed,ruit,secondary,sessile,slender,smooth,spaced,spreading,stalk,tamen,tapering,tertiary,time,tip,tube,unarme,unit,vary,vein,venation,visible,wide,woody,ympodial	'',[,``,arrangement,brown,bud,cell,center,characteristic,colour,corolla,form,growth,height,history,inflorescence,life,na,new,number,ovary,perfect,plant,position,rachi,reproduction,seed,shape,spacing,staman,stigma,texture,value,width,{,}
329	wfo-0001028115	invalid_json_followup	165	96	53	112	43	0.321	-1.1,-2.5,0.6-0.7,0.7-0.8,1.1-1.8,2-3.2,5-15,6-10,abundant,acute,anther,antrorse,apex,blue,calyx,campanulate,capitate,cm,diameter,ellipsoidal,elliptical,filament,fruiting,glabrescent,globose,herb,length,light,margin,mm,moderately,narrowly,non-glandular,ovate,pale,papery-scarious,petiole,pinnatipartite,prostrate,pubescent,seed,simple,slender,stem,stigma,style,trans-ovoidal,trichome,tuberculate,violet,width,x,yellow	-5.2,.2,.6,0.2-0.3,0.42,0.5,0.8-,1-2.4,1-3,1.3-1.8,1.4-1.7,1.7-2.2,1.8-3.5,12-13.5,2-,2.5-,3-4.5,3-5,3-6.5,4.7-,5-8.5,7-7.5,9-17,abaxially,accrescent,acuminat,adaxially,ag,alternate,amply,annular,articulate,attenuate,basal,base,berry,blade,coat,connectival,curved,difoliat,dorsal,eaf,eed,embryo,entire,especially,evident,exceeding,glabrous,glandular,growing,half,herbaceous,hig,inflated,linear,lobe,long,longer,longitudinal,longitudinally,lower,mixed,much,multi-seeded,near,nerve,oblong,one,opening,opposite,orolla,pair,papillo,pinnatifid,pinnatisect,pore,poricidal,portion,prolongation,rarely,ree,reticulate,ridged,ruit,scarce,segment,similar,slightly,slit,small,smooth,sometimes,strongly,styl,subsessil,tem,time,tip,triangular,tube,unequal,unifoliate,uniseriate,unit,vary,venation,wide,wider,winged,ympodial	'',[,``,abaxial,adaxial,arrangement,bark,bud,cell,center,characteristic,colour,corolla,flower,form,fruit,growth,height,history,inflorescence,leaf,life,na,new,number,ovary,pedicel,peduncle,perennial,plant,position,prickle,rachi,reproduction,scar,shape,spacing,staman,surface,texture,value,{,}
330	wfo-0001028131	invalid_json_followup	208	120	85	123	35	0.409	-1.2,.5,0-0.6,0.05-0.2,0.3-0.7,0.5-1.1,0.8-1,0.8-1.1,1-4,1-5,1.5-3,1.5-5,1/4-2/3,2-5,5-6.5,abaxial,adaxial,anther,apex,bark,calyx,cell,chartaceous,cm,cream,curved,dark,diameter,dull,erect,filament,flattened,flattened-reniform,flower,fruit,fruiting,glabrescent,glabrous,green,herb,lateral,leaf,length,lobed,margin,marking,mature,mauve,membranous,mm,moderately,narrow-obovate,narrow-ovate,orange,orange-brown,outline,pale,pale-brown,pedicel,peduncle,petiole,pit,porrect,prickle,purple,raised,red,reflexed,scar,sessile,shiny,simple,small,smooth,sparsely,spherical,stellate-pubescent,stem,style,surface,terete,trichome,yellow,yellow-green,young	.1,/5,0-2,0-3,0-30,0-4,0.1-0.15,0.1-0.3,0.2-1.5,0.4-0.8,0.7-1.1,1-10,1-3,1.8-2,1.8-2.2,1/5,2-2.8,2-4,2-6.5,2/3,3-6,4-6,5-8,5-merous,6-7,7-8,abaxially,absent,acuminat,alyx,apar,apart,apically,apparently,articulated,attenuate,base,berry,blade,branched,broad-deltate,concolorous,connivent,deltate,densely,difoliate,distance,drying,eaf,eed,elongating,epidermi,equal,extending,eye,filiform,free,geminat,gland,infructescence,lanceolate,lengt,like,lobe,long,longer,lower,maturity,midpoint,midvein,naked,nflorescence,oblong,obtuse,often,older,one,open,orolla,oung,pair,pale-gra,pendulous,per,perfec,pericarp,poricidal,portion,prickl,prickly,primary,ray,reduced,rounded,ruit,sessil,shorter,side,sometimes,spaced,spreading,stellate,straight,strongly,sunk,tamen,tapering,tertiary,time,tip,tube,unarme,unarmed,unit,upper,vary,vein,venation,visible,way,wide,woody,ympodial	'',[,``,arrangement,bud,characteristic,colour,corolla,form,growth,height,history,inflorescence,life,na,new,number,ovary,pale-gray,perennial,plant,position,rachi,reproduction,seed,shape,spacing,staman,stigma,texture,unknown,value,width,{,}
331	wfo-0001028147	success	185	113	66	119	47	0.357	acuminate,anther,apex,base,branched,brown,calyx,campanulate,cell,chartaceous,cm,corolla,cuneate,decurrent,diameter,entire,filament,flattened-reniform,flower,fruiting,glabrous,globose,green,herbaceous,internode,lateral,light,lobed,major,margin,minutely,mm,narrowly,oblong,orange,ovate,ovoid,pale,pedicel,peduncle,pentagonal,petiole,pitted,prickle,rachi,recurved,seed,shape,side,simple,slender,somewhat,spine,stellate,stem,stigma,style,surface,terminal,vein,vine,white,woody,yellow,yellow-green,yellowish-orange	.5,0.25,0.5,0.6,1.5–2,1.5–5.5,1.6–2.3,10–15,15–20,1–2,1–4,1–5,2–4,2–7,2–8,3-5,3.5–4.5,3.5–9,3–4,3–6,4-5,5–10,5–12,6–9,7–10,abaxially,absent,acute,adaxially,ag,alyx,anthesi,appearing,armed,articulated,axe,becoming,berry,blade,break,broadly,bud,connivent,dark,deciduous,deltate,dr.,dry,eaf,eed,ellipsoid,elongate,elongating,equal,except,exserted,fifth,five,four,hairy,immature,interpetalar,lanceolate,larger,lengthening,lobe,long,long-styled,longer,lower,mature,midrib,mottled,nearly,nflorescence,often,one,orange-red,orolla,outer,paired,pericarp,plurifoliat,pore,poricidal,puberulent,pulp,rarely,recurve,robust,rugose,ruit,season,seen,shallowly,short-styled,slightly,slit,spreading,stout,straight,subcaudate,tamen,testal,time,tip,tissue,truncat,tube,turning,unequal,unit,vary,wall,wide,wood,x,ympodial,×	0.25-0.6,1-2,1-4,1-5,10-15,2,2-4,2-7,2-8,3-6,5-10,5-12,6-9,7-10,abaxial,adaxial,armament,arrangement,center,color,dioecious,form,fruit,greyish,growth,hair,height,hirsute,history,inflorescence,leaf,length,life,na,new,number,ovary,perennial,plant,position,reproduction,scar,staman,texture,trichome,truncate,width
332	wfo-0001028148	success	157	91	62	95	29	0.395	.5-4,0.25-0.5,1-15,1-3.5,1.5,12-15,2,2-7,2.5-4,20-50,3.5-9,5-7,acute,angled,apart,apex,articulated,base,blue-black,branched,chartaceous,cm,dark,decurrent,diameter,elliptic,entire,flower,fruit,glaucous,globose,less,margin,midrib,minute,mm,narrowly,orange,pedicel,peduncle,petiole,pink,plicate,purple,rachi,rhizomatous,ridge,rotate-stellate,scalloped,shrub,simple,slender,smooth,stigma,style,surface,tapered,treelet,violet,whitish,x,yellow	-6,0.5-1.5,0.6-3.5,0.75-2,1.5-2.5,10-30,15,2-3,3.5-4,4-10,4.5-10,5,5-10,5-20,5-8,6-18,abaxially,absen,adaxially,aggregate,apiculate,axe,ba,blade,broadly,calyx,cell,central,connivent,cylindrical,deltate,densely,directed,distal,distall,eaf,eed,especially,except,fleshy,fresh,glabrous,hair,highly,light-colored,lobe,long,lower,many-foliat,margi,material,mature,moderately,nflorescence,nther,obtuse,often,orolla,ovate,part,perfect,plicae,pore,puberulence,puberulent,puberulent-pubescent,radiu,rarely,ripe,ruit,slightly,smoot,sometimes,spaced,sparse,star,stone,succulent,tal,tem,thickened,time,tip,triangular,truncat,tube,unbranched,unit,usually,vary,white,wide,winge,ympodial,young	abaxial,adaxial,anther,arrangement,colour,corolla,filament,form,glaucrous,growth,height,history,inflorescence,leaf,length,life,na,number,ovary,plant,position,reproduction,seed,shape,spacing,staman,texture,truncate,width
333	wfo-0001028161	success	124	86	48	76	38	0.387	0.1-0.25,1-1.5,2-9,3-7,4-5,acuminate,acute,along,apex,bark,branched,brown,calyx,cell,closely,corolla,dendritic,densely,denser,elliptic,fruiting,globose,green,lanceolate,leaf,margin,minutely,mm,narrowly,opposite,ovoid-reniform,pale,pedicel,petiole,pitted,pubescent,reddish-brown,scar,shape,shrub,simple,spaced,stem,surface,tapering,thin,trichome,vein	.5,0.25-0.5,0.7-1.7,1-1.3,1-2,1-2.3,1.5-4.5,1/3,2-5-flowered,2.5-3,3-4,6-9,7.5-12,9-11,abaxially,adaxially,anthesi,arising,attenuate,ba,base,berry,branch,cm,congested,consisting,deflexed,dia,differing,difoliate,distal,eaf,edicel,eed,exserted,geminat,glabrescen,incrassate,inflorescenc,later,lateral,like,lon,long,main,major,middle,minor,nflorescence,obovoid,often,older,orbicular,outline,overlappin,pair,probably,pubescence,rest,rounded,ruit,short,sinuate,size,somewhat,sparsely,strongly,tall,tan,tub,ud,unit,widest,x,ympodial,young	2-5,abaxial,adaxial,anther,arrangement,bud,center,colour,diameter,filament,flower,form,fruit,growth,height,history,inflorescence,length,life,na,new,number,ovary,overlapping,peduncle,perennial,plant,position,prickle,rachi,reproduction,seed,spacing,staman,stigma,style,texture,width
334	wfo-0001028164	invalid_json_followup	197	140	102	95	38	0.518	-1,/4,0.05-1.5,0.4-0.8,0.5-0.8,0.5-1,0.9-1.6,1,1-1.5,1-4.5,2.5-4,2.5-4.5,3-17,4-5-merous,8-15,abaxial,abaxially,acuminate,acute,almost,anther,apex,apparently,articulated,bark,base,berry,branched,bright,calyx,cm,curved,dark,densely,diameter,dull,elliptic,entire,erect,evenly,filament,filiform,flattened-reniform,flower,fruit,fruiting,glabrescent,glabrous,gray,green,hair,lateral,leaf,length,less,lobed,margin,maturity,mauve,membranous,midvein,minute,mm,moderately,multangulate,obtuse,orange-brown,pale,pedicel,peduncle,petiole,porrect,recurved,red,red-brown,scar,sessile,shallowly,shrub,simple,sometimes,sparsely,spherical,stalked,stellate,stellate-pubescent,stem,straight,style,surface,terete,terminal,tip,trichome,unarmed,undulate,variously,way,white,yellow,yellow-green,young	-14,-6,-8,0-20,0.05-0.2,0.1,0.3-0.8,0.7-1.1,0.8-1.5,1.5-2.5,1.8-2.5,1/3,1/6-1/4,12-20,2-2.5,2.8-4,3-7,3.6-4.8,4-13,4-7,4-8,6-8,8-17,alyx,ame,apar,apically,attenuate,blade,c.,concolorous,connivent,deltate,difoliate,drying,eaf,eed,elongating,equal,eye,free,geminat,glabrescen,glabrou,glandular,infructescence,lobe,long,long-acuminat,longer,lower,mature,midpoint,naked,narrow-deltate,nflorescence,often,older,one,open,orolla,oung,pair,per,perfec,pericarp,poricidal,portion,primary,ray,reflexe,ruit,shorte,shorter,side,smooth,spaced,spreading,stalk,tamen,tapering,tertiary,time,tube,unarme,unit,upper,vary,vein,venation,visible,wide,woody,yellow-gra,ympodial	'',[,``,adaxial,apart,arrangement,bud,characteristic,colour,corolla,form,growth,height,history,inflorescence,life,na,new,number,ovary,perennial,perfect,plant,position,prickle,rachi,reproduction,seed,shape,spacing,staman,stigma,texture,value,width,yellow-gray,{,}
335	wfo-0001028180	success	147	98	67	80	31	0.456	.05,.5,1-1.5,1-1.8,1-3,2-3,4.5-5,5-6,7,acute,along,anther,apex,bark,calyx,capitate,closely,cm,conical,corolla,dark,darker,densely,elliptic,elongate,erect,falcate,filament,fruiting,glabrous,globose,gold,golden,green,lateral,leaf,lobed,main,margin,midrib,minutely,mm,opposite,ovary,ovoid-reniform,pale,papillose,pedicel,petiole,pinkish-white,pitted,pubescent,shiny,simple,spaced,stem,stigma,style,surface,tan,tree,trichome,uniseriate,vein,white,x,yellow-gray	/2,0.7-1,1-1.2,1.5-5,15-28,2-2.2,2.5-3,20-30-flowered,3-10,3-4,5-8,8-10,abaxially,adaxially,anthesi,attenuate,ba,base,beginning,berry,c.,cucullate,deflexed,deltate,dia,differing,difoliate,distinctly,drying,eaf,eed,fleshy,four-angled,free,geminat,glabrat,irregularly,know,larger,leathery,lobe,lon,long,lower,major,minor,nearly,nflorescence,obscure,older,onto,overlappin,pair,planar,pore,poricidal,portion,puberulent,ruit,scar,shaped,size,small,somewhat,sparsely,straight,styl,tall,tear-drop,thick,tip,tube,ud,underside,unit,way,winged,woody,ympodial,young	20-30,abaxial,adaxial,arrangement,bud,colour,diameter,flower,form,fruit,glabrate,growth,height,history,inflorescence,length,life,na,number,peduncle,perennial,plant,position,rachi,reproduction,seed,shape,spacing,staman,texture,width
336	wfo-0001028182	success	150	84	55	95	29	0.367	0.5-1,0.8-1,0.9-1,1-1.5,2-2.5,2-6.5,3-5,5-15-flowered,along,anther,bark,base,beneath,capitate,cm,corolla,ellipsoid,filiform,flower,glabrous,globose,hemiepiphyte,inflorescence,internodal,later,leaf,lobed,midrib,minutely,mm,narrowly,nearly,obovoid,opposite,ovary,ovate,papillose,pedicel,petiole,poricidal,pubescent,scar,shiny,shrub,simple,sparsely,stigma,style,surface,tip,trichome,uniseriate,white,x,young	.5,0-90,0.1-0.2,0.5,0.5-0.6,2,3,4-6,5-ribbed,6-9,anthesi,apart,apex,apiculae,apiculate,arching,axi,bending,black,blade,branch,brown,calyx,ciliate,conical,cordate,deflexed,deltoid,densely,dia,dry,eaf,edicel,eed,evenly,except,extreme,filament,free,gre,keeled,know,known,lateral,lax,less,like,lobe,long,long-acuminate,lower,main,margin,material,minute,nflorescence,older,pair,papillo,planar,pore,portion,present,prominent,proximal,purplish,reflexed,rib,rounded,ruit,sca,shaped,slender,slightly,somewhat,spaced,sparser,specimen,spindly,stem,still,strongly,tapering,tear-drop,third,time,truncate,tube,ud,unifoliat,unit,vein,widest,ympodial,zig-zag	abaxial,adaxial,arrangement,bud,colour,diameter,form,fruit,green,grey,greyish,growth,hair,height,hirsute,history,length,life,na,number,perennial,plant,position,reproduction,seed,shape,texture,unifoliate,width
337	wfo-0001028183	invalid_json_followup	237	139	104	133	35	0.439	-10,-5.3,0.2-0.3,0.2-0.5,0.5,0.5-2.5,0.7-2,0.8-1.4,0.8-3.1,1.1-1.8,1.7-2.7,2-4.2,2-5,2.8-4.2,3.2-,3.5-6.6,4.6-6.4,5.2-6.2,50-400,6.6-20,7.5-23,abaxial,abaxially,adaxially,along,anther,apart,apex,attenuate,axi,bark,branched,brown,bud,calyx,capitate,central,cm,corolla,dark,deltoid,diameter,drying,dull,elliptic,elongated,entire,filament,flower,fruit,fruiting,glabrescent,glabrous,globose,granular-punctate,hair,half,lanceolate,leaf,long,many,margin,mm,narrowly,obovoid,orangish-tan,overlapping,pedicel,peduncle,petiole,porrect-stellate,pseudoterminal,pubescent,purple,rachi,rarely,reportedly,reticulate-punctate,ripe,scabrous,shrub,simple,small,soon,spaced,spherical,stellate,stem,stigma,streak,style,sub-lenticular,subcampanulate,surface,tan,time,touching,tree,upper,violet,white,x,yellow,yellowish	.5-3,0.1,0.1-0.2,0.1-0.4,0.1-0.9,0.2-0.4,0.6,0.7-1.2,1.2-1.4,1.3-1.4,1.3-1.7,1.4-2.8,1.5-3.4,1.6-2.3,1.9-3.7,1/3-1/2,10-15,11-30,2.2-5.7,2.5-4.1,2.6-4.4,4.5-9,5-8,5-8.5,8-9.1,9-13,accrescent,acute,ag,alyx,anthesi,apparently,around,articulated,axillary,base,berry,blade,blunt-tipped,branch,cell,chartaceous,closely,cuneate,cylindrical,dendritic-multangulate,directed,distally,distantly,eaf,earl,edge,eed,epidermal,especially,evident,except,exserted,farinose,few-rayed,free,glabrescen,group,high,inserted,lackin,lateral,lengthening,lobe,lobed,lon,long-decurrent,longitudinal,lower,m.,main,midrib,multangulate,nearly,nflorescence,oblong,older,open,orolla,ovate-lanceolate,perfec,plurifoliate,pore,poricidal,porrect-stellat,present,prominent,pubescence,relatively,ruit,runk,sessile,short,short-,side,slit,somewhat,sparingly,sparse,splitting,stage,stalk,stamen,stipitate-glandular,stout,strongly,suture,tamen,terete,thick,thin,thin-textured,tip,tomentose,translucent,tube,ud,unarme,unit,usually,vary,vein,way,whitish,wide,yellowish-tomentose,ympodial,young	'',[,``,adaxial,arrangement,characteristic,colour,form,growth,height,history,inflorescence,length,life,na,new,number,ovary,perennial,plant,position,prickle,reproduction,scar,seed,shape,spacing,sparely,staman,texture,trichome,value,width,{,}
338	wfo-0001028226	success	185	99	65	120	34	0.351	0-0.1,0.15-0.3,0.15-0.45,1-2,15-27,2.5-9,3.5-4.5,5.5-8.5,9-14,9-15,accrescent,acicular,adaxially,andromonoecious,anther,apex,articulated,base,calyx,chartaceous,cm,cylindrical,deeply,densely,diameter,elliptical,extra-axillary,flower,fruit,fruiting,glabrous,globose,green,herbaceous,inflorescence,lavender,leaf-opposed,length,lobed,margin,mm,obtuse,ovate,pale,pedicel,peduncle,petiole,plant,prickle,prostrate,pseudo-umbellate,resprouter,shallowly,simple,solitary,somewhat,sparsely,sprawling,stellate,stellate-pubescent,straight,strongly,style,unbranched,yellow	%,.5,0-1,0-2,0.1-0.3,0.2-0.3,0.25-0.4,0.25-0.5,0.3-0.7,0.3-1,0.4-0.6,0.4-0.7,0.5-1,0.5-1.2,0.6-1.3,0.7-0.9,1,1-3,1-5,1.2-2.6,1.5-3,1.5-5,1.6-2.4,10-16,10-45,13-22,18-50,2-3,2-5,2-5.5,2.5-3,2.7-3.2,5-8,5-merou,6-8,7-8,abaxially,absen,absent,across,adaxiall,adult,alyx,apart,apparently,armed,axe,ba,blade,branche,brown,confined,cuneate,deltate,directed,distall,distributed,dm,eaf,eed,eglandular,finger,functional,geminat,gland-tipped,hair,half,heterostylous,index,juic,lamina,lateral,less,lobe,lobing,lon,long,longer,lower,mature,mesocarp,midpoint,midrib,midvein,minute,moderately,moist,nflorescence,oblique,onl,orolla,part,per,plurifoliate,pore,porrect,present,ray,rostrate,ruit,sessile,short,side,spaced,stage,stellae,tal,tamen,tem,thick,throughout,time,transparent,tube,unit,uvenile,vary,wide,x,ympodial	5-merous,abaxial,adaxial,arrangement,bark,bud,cell,center,colour,corolla,filament,form,growth,height,history,leaf,life,na,new,number,ovary,position,reproduction,scar,seed,shape,spacing,staman,stem,stigma,surface,texture,trichome,width
339	wfo-0001028227	invalid_json_followup	236	138	101	135	37	0.428	-6.2,0.2,0.2-0.3,0.2-0.4,0.2-0.5,0.7-2.1,0.8-1.4,0.9-1.4,1-4.2,1.1-3.1,1.2-2,1.3-4,2-12,3-4.9,3.7-7,4.8-7.6,6-16,6.7-15,8.5-22,abaxial,abaxially,accrescent,acuminate,adaxially,along,anther,apart,apex,attenuate,bark,branched,brown,brownish,bud,calyx,cm,corolla,dark,deltoid,diameter,drying,echinoid,elliptic,elongate,entire,farinose,filament,fleshy,flower,fruit,fruiting,glabrous,globose,granular-tomentose,gray,grayish,green,hair,leaf,long,many,margin,midvein,mm,multangulate,oblong-lanceolate,orangish-tan,orbicular,pale,pedicel,peduncle,petiole,porrect-stellate,pseudoterminal,pubescence,purple,quarter,rachi,reticulate-punctate,ripe,scabridulous,sessile,shrub,simple,stalk,stellate,stem,stigma,style,sublenticular,subspherical,surface,thin,time,tomentose,tree,upper,velutinous,violet,x,yellow	-2/3,.5-4,0-250,0.1,0.3,0.4,0.5,0.8,0.9,0.9-1.2,1,1-1.7,1-2.5,1.4,1.4-2.6,1.5-2.3,1.7-2.8,1.9,1.9-4.2,1.9-5.8,1/2,1/2-3/4,10,10-24,11-15,2-3.8,2.5-7.8,2.6-5.9,2.9-4.7,3.7-6.3,4-13,5-7.5,8.1-18,acute,ag,age,alyx,anthesi,apparently,appressed,around,articulated,axillary,base,becoming,berry,blade,blunt-tippe,blunt-tipped,branch,c.,closely,cuneate,cylindrical,decurrent,dendritic-echinoid,directed,distally,eaf,early,echinoi,edge,eed,ength,exserted,free,glabrescent,high,inserted,lacking,lanceolate,lateral,lengthening,less,lobe,lobed,lon,longitudinal,lower,m.,main,midrib,mostly,nflorescence,oblong,obscured,obtuse,occasionally,often,older,orolla,ovate-lanceolate,ovate-orbicula,overlapping,perfec,plurifoliate,pore,poricidal,present,prominent,pubescent,relatively,rounded,ruit,runk,side,slightly,slit,somewhat,spaced,sparsely,stamen,stout,subcampanulate,sulcate,suture,tamen,thick,thicker,tip,tomentu,touching,tube,ud,unarme,unit,usually,vary,vein,way,well,wide,yellowish,ympodial,young	'',60-250,[,``,adaxial,arrangement,cell,center,characteristic,colour,form,growth,height,history,inflorescence,length,life,na,new,number,ovary,perennial,perfect,plant,prickle,reproduction,scar,seed,shape,spacing,staman,texture,trichome,value,width,{,}
340	wfo-0001028228	success	143	106	72	71	34	0.503	.5,0.1-1.7,1.1-1.2,1.2-1.8,1.5-2,2-8,3/4,6-7,abruptly,acute,age,anther,apex,area,bark,base,becoming,brown,calyx,campanulate,closely,cm,corolla,dark,deflexed,dry,elliptic,filament,fruiting,glabrous,globose,green,greenish-yellow,leaf,lobe,lobed,long,margin,material,minute,minutely,mm,narrowing,obovate,opposite,ovary,overlapping,ovoid,ovoid-reniform,pale,papillose,pedicel,petiole,reticulate,rounded,scar,shining,shrub,simple,small,spaced,stem,stigma,style,surface,thickened,tip,tree,tube,way,white,young	0.75,1-1.5,1.1-2.5,1.8-3.4,10-30-flowered,2,2-5,2.1-4.2,2.8-6.5,6-8,7.5-12.5,anthesi,ba,beginning,beneath,berry,caly,clavate,coriaceous,deltoid,dia,difoliate,distal,eaf,edicel,eed,erect,exserted,fragrant,free,geminat,impressed,inflorescenc,lateral,lon,lower,main,major,middle,minor,nflorescence,occasionally,older,pair,planar,pore,poricidal,portion,prominent,ruit,shaped,shinin,slender,slightly,straight,styl,sweetly,tall,tapering,tear-drop,terminal,thick-margined,ud,unit,usually,vein,weight,widest,woody,x,ympodial	10-30,abaxial,adaxial,arrangement,bud,cell,center,colour,diameter,flower,form,fruit,growth,height,history,inflorescence,length,life,na,new,number,peduncle,perennial,plant,position,rachi,reproduction,seed,shape,spacing,staman,texture,trichome,width
341	wfo-0001028234	success	155	88	58	97	30	0.374	/3,0.25-0.5,1-2.5,1.0-1.8,3-10,4-10,5-11,across,annual,anther,armed,basally,blade,blue-tinged,broadly,brown,calyx,campanulate,capitate,cm,dark,density,dm,erect,glabrous,gland,green,hair,internodal,leaf,linear-lanceolate,long,mm,ovate,petiole,pinnatifid,plump,prickle,prickly,purple,purplish-tinged,radially,ridged,sessile,short-stipitate,simple,spherical,stellate,stem,strait,subulate,taprooted,tube,unexpanded,unicellular,uniseriate,varying,white	/2,0.15-0.35,0.5-1.0,15-30,2.6.3.2,3.5-7,5-20-flowere,520,8-11,accrescent,acro,acute,along,alyx,and,anthesi,around,base,beneath,berry,black,branched,caly,capitate-glandular,cauline,central,closely,deltoid,developing,dia,difoliate,dissected,divergently,divided,dry,eaf,earliest,eed,enveloped,extended,few-rayed,fleshy,fully,geminat,herb,heteromorphic,high,invested,largest,later,lobe,lon,main,many,margin,marking,maturity,mostly,narrowly,nflorescence,occasionally,often,one,orolla,pedicel,per,persisting,reduced,ruit,scattered,second,short,slende,somewhat,spaced,splitting,starlike,ste,stellae,stipitate,stout,tamen,thrice,tightly,tigma,triangular,tub,twice,tyle,ultimate,unit,vary,vein,wholly,year,yello,ympodial	5-20-flowered,abaxial,adaxial,arrangement,colour,corolla,diameter,filament,flower,form,fruit,growth,height,history,inflorescence,length,life,na,number,ovary,plant,position,reproduction,seed,shape,staman,stigma,style,surface,texture
342	wfo-0001028250	invalid_json_followup	256	110	68	188	42	0.266	0.3–3.9,0.5–1.0,0.5–1.3,1,1.0–1.6,1.1–1.6,1.2–6.3,1.8,2.3–2.5,2.3–5.1,2.7,5.0,5.8–6.6,95,acute,anther,apart,apex,attachment,branched,bud,calyx,chartaceous,cm,corolla,deltate,densely,diameter,entire,extra-axillary,filament,flattened-orbicular,flower,fruit,glabrous,globose,homostylous,lateral,leaf,lobed,margin,mm,new,notched,oblong,ovate,pedicel,peduncle,petiole,point,pubescent,red,shrub,simple,sinuate,small,stellate,stigma,straight,style,surface,tree,unarmed,white,yellow,yellow-tan,±smooth,–3	.2,.3,.4,.7,.8,0.08,0.13,0.17,0.2–0.6,0.3–0.5,0.3–0.6,0.4–0.8,0.6–0.7,0.7–0.8,0.8–1.0,0.8–1.3,0.9–1.3,1.0–2.0,1.2–1.7,1.3–1.6,1.3–2.0,1.5,1.5–3.4,1.6–1.8,1.7,1.7–2.5,1.8–2.2,1.9–2.2,1/3,1/4–3/4,12.5,1–3,2.1,2.2–2.9,2.8,3.9–12.2,4–11,4–6,4–8,5-merou,5.1–6.2,5.7–7.7,6–10,8.3–18.0,90°,abaxially,adaxially,adnate,aequilateral,alyx,anthesi,apical,apically,apiculate,apparently,appearing,appressed,articulate,axe,ba,base,berry,blade,branch,broad,brochidodromous,caudate,channeled,climate,clinate,congested,continuing,cuneate,curved,dentate,depression,development,difoliate,directed,disc-shape,distinct,dry,eaf,edge,eed,egandular,either,emerging,endocarp,entir,erect,evenly,exocarp,fertile,filiform,free,frui,geminate,glabrescent,glandular,glossy,growt,hair,hooked,increasing,internode,interpetalar,intersepalar,juic,lanceolate,large,less,lobe,lon,long,longer,lower,major,mature,midpoint,midrib,midvein,minor,minute,moderately,nearly,nflorescence,oblique,occasionally,opaque,orolla,overlapping,per,poorly-developed,pore,porrect,portion,potentially,raised,ray,restricted,rigid,rounded,row,ruit,sessile,shallow,short-stipitate,shorter,side,sinus,smoot,sparsely,split,splitting,spread,spreading,stamen,stella,stellae,stellate-pubescent,stipe,suture,tamen,tardily,tem,thin,time,tip,tissue,toward,truncate,tube,two,typically,ud,upper,upright,vary,vein,weakly,wide,yellow-ferruginous,ympodia,young,±equal,×,–1.6	'',5-merous,[,``,abaxial,adaxial,arrangement,bark,cell,center,characteristic,colour,disc-shaped,form,fruiting,growth,height,history,inflorescence,length,life,na,number,ovary,perennial,plant,position,prickle,rachi,reproduction,scar,seed,shape,spacing,staman,stem,texture,trichome,value,width,{,}
343	wfo-0001028263	success	156	91	63	93	28	0.404	0.25,1-3,1-4,11-23,2.6,3.4,6,8-14,9,abaxially,adaxially,apex,articulate,branched,broadly,cell,cm,conical,corolla,cyme,darker,deep,diameter,dichasial,dichasially,distal,ebracteate,elliptical,filament,flower,green,green-white,hair-like,half,herbaceous,lateral,leaf,light,medium,mm,monochasial,odd-pinnate,ovate,ovoid,pedicel,peduncle,perennial,petiole,plant,proximal,puberulent,pubescent,rotate,seed,stigma,strigose,style,testal,throughout,violet,wall,yellow,¼	1-2,11-13,14-44,2,2-3,2-4,3,3-6-foliat,3.5-4.2,4,4-5,5-7,5-7.5,6-8,8-1.,abaxiall,acumen,acuminate,acute,apical,apically,atenuate,base,calyx,connate,cordate,covering,cuneate,dehiscent,digestion,diminishing,dorsally,eaf,edge,eed,emoval,enzyme,equal,exceeding,first,flat,folded,forked,generally,globo,gradually,honeycomb,interjected,introrse,leaflet,living,lobe,lon,long,lower,lunat,make,maturing,mucilaginous,nflorescence,nther,oblique,often,orolla,pair,pattern,perfect,plan,poricidally,reveal,ruit,sessile,seudostipule,short,size,slit,specimen,stamen,straight,tal,tem,terminal,thick,throughou,toward,truncate,tuber-bearing,two,typically,unit,vary,wide,ympodial	abaxial,adaxial,anther,arrangement,center,colour,form,fruit,globose,growth,height,history,inflorescence,length,life,na,number,ovary,position,rachi,reproduction,shape,spacing,staman,surface,texture,trichome,width
344	wfo-0001028273	invalid_json_followup	225	123	96	129	27	0.427	-2,.5,0,0.4-0.5,0.5-1,0.6-0.8,1,2,2.3-3,2.5-6,4-10,4-11,4-7-lobed,6-8,abaxial,abaxially,acicular,acute,adaxial,adaxially,anther,apart,apex,bark,base,berry,brown,calyx,cm,conical,coriaceous,corolla,densely,diameter,elliptic,filament,flattened,flower,fruit,fruiting,glabrous,globose,greyish,growth,height,heterostylous,holly-like,inflorescence,leaf,lobed,long-stalked,long-styled,margin,minutely,mm,mucronate,new,orange,ovary,ovate,pedicel,peduncle,petiole,pitted,prickle,prickly,puberulent,pubescent,rachi,reddish,reniform,scar,shallowly,shiny,short,shrub,simple,sparsely,stellate,stellate-pubescent,stem,stigma,stout,style,styled,surface,terminal,toothed,trichome,truncate,unknown,urceolate,way,white,x,½-2/3	-8,0.1,0.2,0.4,0.4-1,0.5,0.6-1,1-1.5,1-2,1-4,1.2,1.5-,1.5-2,2-3,2-6,2.5-,2.6-5,3-5,30,4,4-7,4-8.5,5-8,<,>,?,abruptly,absent,age,alfway,along,also,anthesi,armed,articulated,basal,beneath,branched,broad-based,c.,cell,closer,color,deep,dense,discolorous,distall,eaf,eed,equalling,erect,evenly,exfoliatin,exserted,free,impressed,known,less,like,linear,lobe,lon,long,long-triangular,longer,lower,major,markedly,midpoint,midvein,minute,mixture,multangulate,multiseriate,nflorescence,nodding,occasionally,often,older,pair,papillae,per,pericarp,persisting,planar,plurifoliat,poricidal,porrect,portion,primary,pubescence,ray,rest,rim,ruit,scattered,sessile,shorter,sinuate,size,slightly,small,smaller,sometimes,spaced,sparse,splitting,spreading-campanulate,stalk,stalked,straight,tapering,terminating,testal,time,tip,together,tooth,truncat,tube,ud,unicellular,unit,variable,vein,widely,woody,yellow,ympodial	'',[,``,arrangement,bud,center,characteristic,colour,exfoliating,form,history,length,life,na,number,plant,position,reproduction,seed,shape,spacing,staman,texture,value,width,{,}
345	wfo-0001028278	success	219	110	79	140	31	0.361	0.4-2.1,0.5-0.75,0.5-2.5,0.8-3,1,1-10,1-5,1.5,2-3,3-7,4-,4.5-6,6-11,7-12,accrescent,acute,andromonoecious,anther,apex,articulated,base,broadly,brown,calyx,chartaceous,cm,densely,diameter,ellipsoidal,entire,extra-axillary,filament,flattened,flower,fruit,fruiting,glabrous,green,grey-green,inflorescence,leaf,length,light,lobed,margin,mm,obtuse,ovate,pale,pedicel,peduncle,perennial,perfect,petiole,pink,prickle,pseudo-racemose,purple,rachi,red,reniform,rhizomatous,rugose,shallowly,shape,shrub,simple,somewhat,stellate,stellate-pubescent,stigma,style,surface,truncate,unbranched,weakly,white,x,yellow	%,.5,0-0.15,0-0.7,0-1,0-3,0.1-0.25,0.1-0.5,0.2-0.3,0.45-0.7,0.5-0.9,0.5-1.5,0.7-1,0.7-1.2,0.8-1.3,0.8-2,1-1.2,1-2,1-3,1-4,1-locular,1.2-1.6,1.4-1.9,1.5-2,1.5-3,11-15,17-30,2,2-4,2.2-7,2.5-3,2.5-9,2.7-2.9,3-4,3-5,4,4-12,4-5,5-10,5-11,5-merou,6-8,7-10,7-15,7-8,8-10,abaxially,absen,absent,across,adaxially,adult,alyx,apart,apparen,ascending,axe,ba,bilobe,blade,connivent,cordate,cylindrical,dense,difoliate,directed,distall,eaf,eed,elliptic,erect,exceeding,exocarp,finger,functional,geminat,gland-tipped,glandular,hair,heterostylous,incomplete,index,interpetalar,juicy,juvenile,lamina,lanceolate,lateral,leave,lobe,lobing,long,lower,mature,mesocarp,mid-point,midpoint,midrib,minute,nflorescence,oblique,orolla,pair,part,per,placenta,pore,porrect,present,ray,ruit,septum,shallowly-lobed,short,side,spaced,sparse,sparsely,stalk,stellae,succulent,tal,tamen,tem,thick,throughout,time,tissu,tissue,transparent,triangular,tube,unarme,unarmed,unit,upper,vary,wide,without,ympodial	5-merous,abaxial,adaxial,arrangement,bark,bilobed,bud,cell,center,colour,corolla,form,growth,height,history,life,na,new,number,ovary,plant,position,reproduction,scar,seed,spacing,staman,stem,texture,trichome,width
346	wfo-0001028280	success	87	74	31	56	43	0.356	.5,1-2,2-3,acuminate,almost,apex,bark,ciliate,closely,dark,elliptic,fruiting,glabrous,globose,green,lanceolate,leaf,margin,minutely,mm,narrowly,new,opposite,pedicel,petiole,scar,shrub,simple,spaced,stem,surface	0.7-1,1-2-flowered,1.5-2.7,2-2.5,6-9,7-8,anthesi,ape,arching,attenuate,axil,base,berry,branch,brow,cm,completely,decurrent,dia,eaf,eed,flattened,immature,know,known,lateral,lon,long,lower,main,middle,nflorescence,older,onto,pair,papillae,pendant,present,rounded,ruit,sessil,small,somewhat,tall,tip,ud,ultimate,unifoliat,unit,vein,widest,winged,woody,x,ympodial,young	abaxial,adaxial,anther,arrangement,brown,bud,calyx,cell,center,colour,corolla,diameter,filament,flower,form,fruit,growth,height,history,inflorescence,length,life,na,number,ovary,peduncle,perennial,plant,position,prickle,rachi,reproduction,seed,sessile,shape,spacing,staman,stigma,style,texture,trichome,unifoliate,width
347	wfo-0001028281	invalid_json_followup	267	115	81	186	34	0.303	-3,-45,-5,0.3-1,0.5-1,0.75-1,1.1-1.4,10-30,2-4,20-30,6,abaxial,acuminate,acute,adaxial,anther,apex,broadly,brown,calyx,capitate,cell,cm,conical,corolla,dark,deep,densely,diameter,doubly,elliptic,elongate,filament,flower,form,fruit,fruiting,globose,golden,green,hair-like,imparipinnate,inflorescence,interrupted,leaf,long,margin,mm,narrowly,obovate,once-branched,outgrowth,ovary,ovate,pale,paler,patent,pedicel,peduncle,petiole,pubescent,rachi,regularly,rotate,serrate,shrub,small,smooth,sometimes,sparsely,stem,stigma,stripe,style,surface,transparent,trichome,uniseriate,vine,wall,yellow	+,-0.9,-1,-10,-20,-36,-7,-8,.2,.4,.5,0.05-0.4,0.1-0.15,0.15-0.2,0.2-0.3,0.2-0.5,0.2-0.7,0.3-0.5,0.5-,0.5-0.6,0.5-0.7,0.5-1.1,0.5-1.2,0.7-,0.7-1.2,0.7-2.5,0.8-1,1,1-,1-1.5,1-3,1-5,1.0-1.6,1.1-2.4,1.2-1.5,1.2-1.6,1.4-4,1.5-2,1.5-6,1.7-2.5,10-18,2-13,2-4-celled,2-6.5,2-locular,2.1-3.0,2.5-,3-16,3-5,3-8.5,3-foliate,5-8-celled,6-15,7-30,abaxially,absent,almost,alternate,anthesi,apical,appearance,appendage,appressed,arising,articulation,autogamous,axi,base,basiscopically,bent,berr,blade,bract,bracteate,branching,column,composed,covering,darker,decreasing,decurrent,developed,distal,dry,eaf,edicel,eed,eglandular,either,elongate-triangular,enclosing,entire,exerted,exserted,extended,fragile,free,generally,giving,glabrous,gland,glandular,gree,hal,half,halfway,head,included,interjected,internode,large,largest,lateral,leaflet,less,like,lobe,lon,longest,lower,material,medial,midvein,minute,mixture,multi-celled,multi-cellular,multicellular,nflorescence,node,oblique,occasionally,opposite,orbicular,other,pair,petiolule,point,population,portion,present,primarily,primary,probably,proximal,pseudostipule,rest,ruit,secondary,serrat,sessile,set,shorter,silky,size,smaller,sparser,sprawling,staminal,sterile,stiff,straight,strongly,subopposite,tem,terminal,tertiary,testa,thick,thin,three,tip,toward,tube,type,ud,unicellular,unit,usually,vein,weak,weak-walled,well,wide,winged,ympodial	'',1-2,2.5-6-15,[,``,arrangement,bark,bud,center,characteristic,colour,growth,height,history,length,life,na,new,number,perennial,plant,position,prickle,reproduction,scar,seed,shape,spacing,staman,texture,value,width,{,}
348	wfo-0001028294	success	222	104	72	150	32	0.324	0-1,0.5-0.6,0.5-2,1,1-2.5,1.5-3.5,1.5-7,1.9-7,2-2.5,2-3,4.5-6,5-12,8-10,8-18,acuminate,acute,andromonoecious,anther,apex,broad-based,broadly,calyx,chartaceous,cm,curved,densely,diameter,entire,extra-axillary,flower,fruit,fruiting,glabrous,globose,green,grey-green,inflorescence,leaf,length,lilac,lobed,long,longer,margin,mm,ovate,pale,pedicel,peduncle,perennial,petiole,plant,prickle,rachi,repand,shallowly,simple,sparsely,stellate,stellate-pubescent,stigma,straight,style,surface,time,unbranched,vine,white,wide,yellow,yellowish,yellowish-green	%,0-0.2,0-0.4,0-10,0-6,0.1-0.15,0.2-0.3,0.25-0.4,0.25-0.5,0.3-0.4,0.3-0.5,0.5-1,0.7-1.2,0.7-1.5,0.8-1,0.8-1.2,1-2,1-3.5,1-6,1.3-1.5,1.7-2.4,11-15,11-22,17-25,18-22,18-40,2-3.5,2-5,2-foliate,2-locular,2.5-7,30-40,4-6,4-8,5-13,5-8,5-merou,50-100,50-140,6-8,7-10,7-8,9-13,9-15,abaxially,absent,accrescent,across,adaxiall,adaxially,adult,alyx,anvil-shape,apart,armed,articulated,ascending,axe,ba,base,blade,branch,branche,brown,capitat,connivent,cordate,cross-section,cuneate,cylindrical,decimetre,deltate,directed,distall,distally,distributed,dm,eaf,eed,eglandular,elliptic,erect,exocarp,finger,functional,geminat,gland-tipped,grey,hair,half,heterostylous,juicy,juvenile,lamina,lanceolate,lateral,less,lobe,loosely,lower,markedly,mature,mesocarp,mid-point,midpoint,midvein,minute,moist,nflorescence,oblique,obtuse,orolla,pair,part,per,placenta,pore,porrect,presen,present,ray,ruit,rusty,scattered,scrambling,semi-circular,sessile,short,slightly,spaced,stalk,stalked,stellae,tal,tamen,tem,thick,thicker,throughout,toward,tube,unarme,unarmed,unit,upper,vary,vein,weakly,x,ympodial	5-merous,abaxial,adaxial,arrangement,bark,bud,capitate,cell,center,colour,corolla,filament,form,growth,height,history,life,na,new,number,ovary,position,reproduction,scar,seed,shape,spacing,staman,stem,texture,trichome,width
349	wfo-0001028298	success	188	111	81	107	30	0.431	.5,0.5-1,0.6-0.7,0.7-1,0.8-1.7,1-1.5,1-4,10-11,2-3,2-7,2.5-3,4-5,5-8,8-11,abaxially,absent,accrescent,acute,adaxially,anther,apex,articulated,base,calyx,cm,contiguous,cordate,densely,diameter,entire,erect,extra-axillary,filament,flower,fruit,fruiting,glabrous,globose,grey-green,inflorescence,interpetalar,leaf,length,lilac,lobed,long,margin,midpoint,mm,moderately,nearly,obtuse,ovate,pale,pedicel,peduncle,perennial,petiole,rachi,red,reniform,reticulate,rhizomatous,rotate-stellate,sessile,shallowly,shrub,simple,stellate-pubescent,stigma,style,surface,thick,throughout,tissue,truncate,unbranched,white,x,yellow,yellowish	%,0-0.1,0.1-0.2,0.15-0.3,0.2-0.4,0.25-0.4,0.3-0.4,0.3-0.5,0.4-0.5,0.4-0.65,1-2,1-3,1-locular,1.5-2,1.5-3.5,1.9-2.5,17-25,2-foliate,2.2-2.5,3-5,3-7,4-9,4.5-8,5-6,5-7,5-merou,6-8,7-12,7-8,9-10,absen,across,acuminate,adult,alyx,apart,apparen,axe,ba,blade,broadly,brown,capitat,chartaceous,connivent,cylindrical,deltate,directed,distall,distributed,eaf,eed,eglandular,elliptic,exceeding,exocarp,finger,geminat,gland-tipped,hair,incomplete,juicy,juvenile,lamina,lanceolate,lateral,lobe,lower,mature,mesocarp,minute,nflorescence,oblique,orolla,part,per,perfect,placenta,pore,porrect,present,prickle,probably,pseudo-umbellate,ray,ruit,septum,short,soliary,somewhat,spaced,stalk,stellae,succulent,tal,tamen,tem,time,tissu,transparent,tube,unarme,unarmed,unit,vary,wide,ympodial	5-merous,abaxial,adaxial,arrangement,bud,capitate,cell,center,colour,corolla,form,growth,height,history,life,na,new,ovary,plant,position,reproduction,scar,seed,shape,spacing,staman,stem,texture,trichome,width
350	wfo-0001028317	invalid_json_followup	204	135	100	104	35	0.49	-1.5,/5,0-1,0.1-0.3,0.3-1,0.5-3.5,0.6-1.2,0.6-1.5,0.8-1.1,1-1.3,1-3,1-4,1.4-2,3-5,4-5-merous,5-8,abaxially,absent,almost,anther,apart,apex,articulated,bark,base,berry,branched,bright,brown,calyx,chartaceous,cm,concolorous,cream,cuneate,curved,dark,densely,diameter,drying,dull,erect,filament,filiform,flattened-reniform,flower,fruit,fruiting,glabrous,gray,green,herb,lanceolate,lateral,leaf,length,lobed,margin,marking,maturity,mauve,mm,moderately,obtuse,orange-brown,ovate,pale,pedicel,peduncle,petiole,porrect,prickle,purple,red,reflexed,scar,sessile,shrub,simple,sometimes,sparsely,spherical,stalked,stellate-pubescent,stem,straight,style,subsessile,surface,terete,terminal,tip,toward,trichome,variously,way,white,yellow,yellow-green,young	-5,0,0-5,0.1,0.1-0.25,0.1-0.4,0.3-0.4,0.6-0.8,0.8-2.5,1.1-1.9,1.8-2.5,1/,1/3-1/4,1/4-2/3,1/5,2-2.8,2-4,2-4.5,2.5-6.5,2.8-3.3,2/3,3-10,3-4,4-6,4-8,6-10,acuminat,acute,alyx,apar,apically,apparently,blade,broad-deltate,brow,deltate,difoliate,distance,eaf,eed,elongating,equal,extending,eye,free,geminat,hair,herbaceous,infructescence,lobe,long,longer,lower,mature,midpoint,midvein,minute,naked,nflorescence,oblong,older,one,open,orolla,oung,pair,pendulous,per,perfec,pericarp,poricidal,portion,prickl,prickly,primary,ray,reduced,rounded,ruit,scandent,shorter,side,smooth,spaced,spreading,stalk,stellate,tamen,tapering,tertiary,time,translucent,truncate,tube,unarme,unarmed,unit,upper,vary,vein,venation,visible,wide,ympodial	'',[,``,abaxial,adaxial,arrangement,bud,characteristic,colour,corolla,form,growth,height,history,inflorescence,life,na,new,number,ovary,perennial,plant,position,rachi,reproduction,seed,shape,spacing,staman,stigma,texture,value,width,{,}
351	wfo-0001028323	invalid_json_followup	164	129	93	71	36	0.567	-2,0.2-0.5,0.2-1,0.4-1.3,0.5,0.6-1,1-1.5,1-2,1.5-2.5,2-3,3,3-6,3.5-4,7.5-9,along,anther,apart,apex,appressed,articulated,attenuate,bark,base,blue-green,brown,calyx,cm,conical,corolla,cup-shaped,dark,dendritic,densely,diameter,ellipsoid,elliptic,entire,erect,fading,filament,fleshy,flower,fruiting,glabrescent,glabrous,globose,grey,growth,inflorescence,leaf-opposed,lobed,longer,main,margin,maturity,minutely,mm,new,occasionally,ovary,ovoid,pale,papillose,pedicel,peduncle,peg,perfect,petiole,pitted,pubescent,reddish,remaining,revolute,scar,scattered,shiny,shrub,simple,small,soft,somewhat,sparely,sparsely,stem,stigma,style,surface,trichome,uniseriate,vein,violet,white,x	0.5-1,0.8,0.9-1.2,1,1-1.2,1.1-4.5,1.5,2-9,3-5,5-6,abaxially,abscissio,absent,acute,anthesi,apparently,ba,berry,c.,capiatate,cell,coriaceous,deltate,drying,eaf,eed,free,glabrescen,included,internodal,lanceolate,lengthening,less,like,lobe,lower,minute,nflorescence,ovate,pair,papillat,pericarp,planar,plurifoliat,pore,poricidal,portion,primary,proceed,rounded,ruit,shoot,short,sinus,sometimes,soon,splitting,straight,tearing,testal,thick,thin,tip,tube,tuft,ud,unit,wall,way,woody,ympodial	'',[,``,abaxial,abscission,adaxial,arrangement,bud,capitate,characteristic,colour,dense,form,fruit,height,history,leaf,length,life,na,number,perennial,plant,position,prickle,rachi,reproduction,seed,shape,spacing,staman,texture,value,width,{,}
352	wfo-0001028328	invalid_json_followup	215	131	93	122	38	0.433	-15,0-4,0.2-0.5,0.5-1,1,1-1.5,1-2,1-6,1-7,2-10,2-4,2-4-lobed,2-9,3-4,5-10,5-7,50,abaxially,acuminate,acute,andromonoecious,anther,apart,apex,apparently,branched,brown,calyx,chartaceous,cm,coarsely,dark,densely,diameter,elliptic,elliptic-ovate,entire,extra-axillary,filament,flattened,flower,forked,fruit,fruiting,glabrous,globose,green,inflorescence,leaf,leaf-opposed,light,lighter,lobed,long,margin,membanaceous,minutely,mm,moderately,nearly,outline,pedicel,peduncle,petiole,plant,prickle,rachi,reniform,ripe,rugulose,sessile,shallowly,sharp,shiny,short-stalked,simple,small,smooth,somewhat,stellate,stellate-pubescent,stem,stigma,straight,strongly,style,subcoriaceous,surface,tree,truncate,white,x,yellow	.2,.5-2,0-0.3,1.5-2,14,15-20,16-30,2-2.5,2-3,2.5-3,20-30,20-35,4-7,5-merou,6-18,6-8,7-.,7-10,7-14,7-30,7-9,8-18,absent,abundantly,accrescent,adaxiall,adaxially,ag,alyx,apiculate,armed,articulated,axe,ba,base,berry,blade,broad-based,capitat,compressed,congested,connivent,covering,cylindrical,differentiated,difoliate,directed,discolorous,distally,eaf,eed,equal,except,ferruginous,flowering,free,frui,geminat,hair,half,heterostylous,highly,interpetalar,juvenile,leave,like,lobe,longitudinal,lower,major,midpoint,minor,multangulate,narrowly,nflorescence,oblique,obtuse,often,one,opening,orolla,paired,part,perfect,perhaps,pericarp,pore,porrect,pubescent,ray,reflexed,rounded,ruit,runk,short,side,slightly,slit,spaced,sparse,stalk,staminate,subcuneate,subtending,tamen,tapered,thi,time,tip,tissue,tomentose,triangular,tube,tubevery,unarmed,unit,vary,vein,whitish,wide,ympodial,young	'',5-merous,[,``,abaxial,adaxial,arrangement,bark,bud,capitate,center,characteristic,colour,corolla,form,growth,height,history,length,life,na,new,number,ovary,perennial,position,reproduction,scar,seed,shape,spacing,staman,texture,trichome,value,width,{,}
353	wfo-0001028329	invalid_json_followup	215	134	91	124	43	0.423	0.2-0.3,0.8-1.4,0.9-1.3,1-6,1.5-8,12,2-3,3-8,4-15,5-10,6-8,7-19,abaxially,acuminate,acute,adaxially,angled,anther,apart,apex,articulated,asperous,bark,base,branch,branched,brown,bud,calyx,cm,conical,corolla,deltoid,dendritic-echinoid,diameter,echinoid,entire,filament,finely,flower,fruit,granular,granular-tomentose,gray,green,grooved,growth,hair,honeycombed,leaf,length,longitudinally,margin,minutely,mm,moderately,mostly,orbicular,ovate,ovate-elliptic,pale,pedicel,peduncle,petiole,pubescent,rachi,reniform,reticulate-punctate,ripe,sessile,short-stalked,shrub,simple,small,sparsely,stellate-rotate,stem,stigma,style,subglobose,suborbicular,tomentose,toward,tree,turning,velutinous,white,whitish,x,yellow,yellowish	.5-3,.75-2,.75-5.75,/10-3/10,0-100,0.8-1.1,1.0-1.4,1.1-2.5,1.3-1.8,1.3-2,1.5-2.3,1.5-2.75,1.5-3.5,10-34,2-4,2.2-3.9,2.6-5,2.75-4.5,3-14,3.75-7,3/4,4-5,6-11,6-9,absen,ag,anthesi,apical-lateral,apparently,axe,axillary,ba,becoming,berry,blade,blunt-tipped,chartaceous,closely,continued,cylindrical,dehiscing,dendritic-echinoi,dichotomously,distantly,distinct,due,eaf,eed,fleshy,free,glabrescen,glabrous,high,inserted,introrse,large,lateral,lengthening,lobe,lobed,long,long-attenuate,lower,main,midvein,multangulat,multangulate,nflorescence,obelliptic,oblong,obovate,obscured,obtuse,occasional,older,orolla,perfect,plurifoliate,pore,porrect-stellate,present,pseudo-terminal,rather,receptacle,relatively,ruit,runk,sessil,several,short-,side,slightly,slit,sometimes,spaced,sparse,stalked,stellat,stellate,stellate-pubescent,stelliform,subcapitat,suture,swollen,tamen,testa,thick,thickened,thin,time,tomentu,touching,tube,unarme,unarmed,unit,usually,vary,vein,vestigial,way,wide,ympodial,young	'',0.5-3,20-100,[,``,abaxial,adaxial,angle,arrangement,cell,center,characteristic,colour,form,fruiting,glabrescent,height,history,inflorescence,life,na,new,number,ovary,perennial,plant,position,pseudoterminally,reproduction,scar,seed,shape,spacing,staman,subcapitate,surface,texture,trichome,trunk,value,width,{,}
354	wfo-0001028337	success	195	109	83	112	26	0.426	-6,.5,0,0.05-1,0.3-0.5,0.4-0.8,0.7-1,1-1.8,1-2,1-3,1.5-4,2-4,4-5,5-8,5-merous,8-10,abaxial,adaxial,anther,apart,apex,bark,branched,calyx,chartaceous,cm,conical,dark,densely,diameter,entire,erect,evenly,filament,flattened-reniform,flower,fruit,fruiting,glabrescent,glabrous,glaucous,gray,gray-brown,green,green-brown,inflorescence,lateral,leaf,length,lobed,margin,marking,mauve,minutely,mm,moderately,narrow-oblong,orange-brown,pale,pedicel,peduncle,petiole,pitted,porrect-lepidote,prickle,reddish,rounded,scar,sessile,shallowly,shrub,simple,smooth,spherical,stellate,stellate-pubescent,stem,style,surface,terete,terminal,trichome,white	-2,-2.5,-4,.8,/3,0.05-0.15,0.1-0.3,0.4-0.7,0.7-0.9,1,1.5-3,1.8-2,1/2,1/3-2/3,1/4-1/3,1/8-1/4,11-16,15-50,2-2.2,3-4,5-25,5-6,6-7,8-14,abaxially,acut,alyx,apar,ape,apically,apparently,articulated,base,berry,blade,color,connivent,cuneate,curved,deltate,discolorous,drying,eaf,eed,elongating,equal,eye,free,fused,gently,glabrou,hair,infructescence,juvenil,juvenile,known,lobe,long,long-styled,longer,lower,mature,midpoint,naked,nflorescence,occasionally,older,one,open,orolla,oung,per,perfect,pericarp,plurifoliat,poricidal,porrect,portion,prickly,primary,ray,reflexed,ruit,shoot,short,short-styled,shorter,slender,small,spaced,sparse,staminate,stout,straight,strongly,tamen,tapering,time,tip,toward,tube,unarme,unarmed,unit,usually,vary,vein,visible,way,wide,ympodial,young	arrangement,bud,cell,center,colour,corolla,form,growth,height,history,life,na,new,number,ovary,perennial,plant,position,reproduction,seed,shape,spacing,staman,stigma,texture,width
355	wfo-0001028339	invalid_json_followup	195	138	101	94	37	0.518	.5,0.05-0.1,1-2,1-5,1.1-1.4,1.2-1.5,1.5-2,1.7-3.2,3.5-4,5-7,8182,acuminate,acute,anther,apex,appearance,appressed,bark,base,beneath,berry,blue,brown,bud,calyx,capitate,closely,cm,corolla,covered,cup-shaped,dark,decurrent,densely,dia,dried,dry,evenly,filament,flattened,floccose,flower,fruiting,glabrate,glabrous,globose,greyish-brown,growth,irregular,leaf,like,little,lobed,long,margin,minutely,mm,mustard,nearly,opposite,ovary,ovate,ovoid-reniform,papillate,papillose,pedicel,petiole,pitted,pulp,red-brown,scar,schwarz,shrub,simple,slender,slightly,small,somewhat,spaced,sparsely,specimen,stem,stigma,style,surface,tapering,texture,tip,tree,trichome,tube,uniseriate,urceolate,vein,white,white-speckled,winged,woody,yellow,yellowish,young	0.8-1.2,1-1.2,1-1.5,1.5,10-30-flowered,10.2-18.5,2.5-5,3.4-5.5,43191,5-angled,5.8-7.9,7-11,8-10,across,almost,anthesi,appearing,attenuate,becoming,broadly,carinate,carpel,connate,crystalline,cuneate,deflexed,differing,difoliate,distinctly,eaf,edicel,eed,enclosed,epidermi,erect,exserted,fide,filiform,first,free,frui,geminat,grainy,large-celled,later,lateral,leave,lobe,lon,long-triangular,lower,main,major,middle,minor,nee,nflorescence,oblique,obscure,occasionally,older,one,overlappin,ovoid,papery,planar,pore,poricidal,portion,proximal,reflexed,ruit,secondary,septum,shaped,shining,size,speckled,straight,strong,strongly,tall,tear-drop,tightly,tub,ud,unit,venation,white-lenticellat,white-papillo,wide,widest,x,ympodial	'',10-30,[,``,abaxial,adaxial,arrangement,center,characteristic,colour,diameter,form,fruit,height,history,inflorescence,length,life,na,new,number,peduncle,perennial,plant,position,rachi,reproduction,seed,shape,spacing,staman,value,white-lenticellate,white-papillose,width,{,}
356	wfo-0001028351	invalid_json_followup	175	120	73	102	47	0.417	.2,.8,0,0.2,0.5,40,5.0,abaxially,acute,adaxially,along,annual,anther,anthesi,apart,apex,articulated,base,blue,brown,calyx,capitate,clavate,cm,colour,densely,diameter,erect,filament,flattened,flower,fruit,glabrous,glandular,globose,green,hair,herb,leaf,like,lobed,long,margin,midvein,mm,moderately,multicellular,number,opposed,ovate,pale,pedicel,peduncle,pentagonal,perennial,petiole,pitted,pubescent,regularly,shallowly,shiny,simple,slender,stem,stigma,style,surface,unicellular,uniseriate,unknown,velutinous,white,x	.8–1.0,0.1,0.6,0–,1.0–,1.0–1.6,1.0–2.0,1.0–2.5,1.4–1.5,1.5–4.0,1.6–,10,2,2.0–2.5,2.0–5.0,2.1–3.5,2/3,2–2.5,2–4,3,3.4–5.0,3–4,4,5,5.0–5.5,5.5–10.5,5–7,6.5–8.5,6–12,8–15,absent,adaxiall,ag,apical,axe,ba,basal,becoming,blade,branching,cell,chartaceous,connivent,convex,cylindrical,directed,distally,eaf,eed,equal,fleshy,geminat,indumentum,lamin,lanceolate,lobe,lon,longitudinal,lower,m.,narrowly,nfloresence,oblong,obtuse,occasionally,opening,orolla,pair,perfect,plurifoliate,pore,present,probably,ruit,serrate,shaped,side,slit,smaller,spaced,sparsely,stone,straight,tal,tamen,tardily,teardrop,tem,time,truncate,tube,unbranched,unit,vary,wide,wing,winged,woody,ympodial,young,–,–3.0	'',1.0\u20132.0,1.0\u20132.5,1\u00a,2.0\u20132.5,2\u20134,5.0\u20135.5,5\u20137,8\u201315,[,\u20133.0,``,abaxial,adaxial,arrangement,bark,bud,characteristic,corolla,form,fruiting,growth,height,history,inflorescence,lamina,length,life,na,new,ovary,plant,position,prickle,rachi,reproduction,scar,seed,shape,spacing,staman,texture,trichome,value,width,{,}
357	wfo-0001028353	invalid_json_followup	177	143	108	69	35	0.61	/3,0.2-0.4,0.5,1,1.4-2,2,2-3,2-4,3,3-5,4-7,6-8,abaxially,accrescent,acute,along,anther,apart,apex,becoming,beneath,bluntly,bright,calyx,campanulate,capitate,cell,centre,ciliate,cm,coarsely,conical,corolla,cup-shaped,dark,deep,deeply,densely,diameter,ellipsoid,elliptic,erect,filament,fleshy,flower,fracturing,fruiting,glabrous,globose,green,greenish,herb,hollow,honey-comb,internodal,leaf,less,like,lobe,long,margin,midrib,minute,minutely,mm,nodding,often,ovary,ovoid,pale,papery,papillate,papillose,pedicel,peduncle,petiole,pitted,plant,plump,principal,pubescent,purple,rhomboid,ripe,scattered,short,simple,slender,somewhat,sparsely,stem,stigma,straight,style,surface,tan,testal,thin,tip,toothed,trichome,truncate,uniseriate,vein,wall,way,x,yellow	.5,0.5-,0.9-1.2,1-2,1-4,1.5-2,1.5-5,7,8-10,age,anthesi,area,base,berry,clasping,cordate,curved,decreasing,decumben,difoliate,distally,dry,drying,eaf,edicel,eed,emarginated,exerted,free,frui,geminat,gree,growing,heteromorphic,horn,horned,inserted,lengthening,lon,lower,m.,material,nflorescence,open,outline,pair,pericarp,point,pore,poricidal,portion,primary,reddish,ruit,scar,sessil,sessile,shallow,size,sleeve,slightly,slit,strongly,toward,tube,ud,unit,wrinkled,ympodial	'',[,``,abaxial,adaxial,arrangement,bark,bud,characteristic,colour,form,fruit,growth,height,history,inflorescence,length,life,na,new,number,perennial,position,prickle,rachi,reproduction,seed,shape,spacing,staman,texture,value,width,{,}
358	wfo-0001028367	invalid_json_followup	178	107	57	121	50	0.32	0.5,1.5,60,anther,apex,black,blue,branched,brown,calyx,cell,chartaceous,cm,colour,dark,densely,diameter,filament,flattened,flower,fruit,glabrous,globose,grey-green,leaf,lobed,margin,mm,multicellular,oblong,opposed,ovate,pale,pedicel,peduncle,pentagonal,perennial,petiole,pubescent,purple,regularly,shiny,shrub,simple,stigma,style,surface,texture,tomentose,unicellular,uniseriate,unknown,white,width,woody,x,yellow	0.2,0.2–0.4,0.4–2.3,0.5–3,0.8–0.9,1,1.0–1.8,1.2–3.0,1.3–9.0,1.4–2.0,1.5–1.7,1–,1–1.5,1–2,2.0–4.2,2.0–4.5,2.8–3.1,2–10,2–3,3.5–6.9,3–3.5,3–5,4–10,4–7,5,5–5.8,5–6,6.5–8.5,6–8,6–9,7–15,8.5–9.5,8–17,8–23,abaxially,absen,accrescent,adaxiall,adaxially,ag,anthesi,apart,apical,arising,articulated,axe,ba,basal,base,blade,concave,connivent,cuneate,cylindrical,deeply,diamete,directed,eaf,eed,equal,erect,geminat,glabrescen,hair,half,lanceolate,laterally,lobe,lon,long,longer,longitudinal,lower,marking,moderately,narrowly,nflorescence,obliquely,obtuse,opening,orolla,pair,perfect,pitted,pore,poricidal,primary,probably,rounded,ruit,secondary,shorter,side,slit,smaller,spaced,stone,straight,strongly,tal,tamen,tapering,tem,three,time,tip,toward,tube,two,unequal,unifoliate,unit,usually,vary,wide,ympodial,–10.0,–25,–5.0,–5.5,–7	'',0.2-0.4,1-2,1.3-9.0,2.8-3.1,25,4-10,4-7,6-8,6.5-8.5,8-17,8.5-9.5,[,``,abaxial,absent,adaxial,arrangement,bark,bud,center,characteristic,corolla,form,fruiting,growth,height,history,inflorescence,length,life,na,new,number,ovary,plant,position,prickle,rachi,reproduction,scar,seed,shape,spacing,staman,stem,trichome,value,{,}
359	wfo-0001028370	invalid_json_followup	147	110	59	88	51	0.401	0.2-0.4,1.0-1.7,1.5-2.2,1/2-2/3,2-4,2-8,3-5,3-7,3.5-5.0,4-10,acicular,annual,anther,armed,blade,blue,broadly,brown,bud,calyx,capitate,cm,coarsely,dark,deltoid,dm,eglandular,foveolate,glabrous,gland-tipped,glandular,green,herb,internodal,lanceolate,lenticular,long,minutely,mm,obovoid,obtuse,ovate,pentagonal,petiole,pinnatifid,prickle,prickly,purple-tinged,ridged,rounded,seed,simple,spherical,stem,subulate,terete,violet,viscid,yellow	-0.6,/3,0.8,2.5-2.9,4-11,40-70,5-9-flowere,9-12,accrescent,acro,across,along,alyx,ample,anthesi,attenuate,ature,base,beneath,berry,branched,broad,campanulate,densely,developing,dia,difoliate,distinct,divided,dry,eaf,extended,few-rayed,fully,geminat,gland,hair,hardly,high,incurved,interpetalar,invested,lobe,lon,main,markedly,maturity,narrowly,near,nflorescence,oblong,often,one,orolla,per,pinnatisect,plicat,ruit,scattered,sessile,short,short-stipitate,slende,slightly,somewhat,sparsely,splitting,spreadingly,stellae,strait,surrounding,tamen,taprooted,terminal,tightly,tigma,tissue,tub,tube,twice,tyle,ultimate,unti,usually,variously,vary,vein,ympodial	'',5-9,[,``,abaxial,adaxial,apex,arrangement,bark,cell,center,characteristic,colour,corolla,diameter,filament,flower,form,fruit,fruiting,growth,height,history,inflorescence,leaf,length,life,margin,na,new,number,ovary,pedicel,peduncle,plant,position,rachi,reproduction,scar,shape,spacing,staman,stigma,style,surface,texture,trichome,value,width,{,}
360	wfo-0001028390	success	147	83	52	95	31	0.354	-10,0,0.5,0.5-1,0.5-1.5,0.5-2.5,1-2.5,1-5,1.5-2,1.5-3.5,10-15,5-7,7-8,acute,angled,apart,apex,chartaceous,cm,densely,diameter,elliptic,felty-pubescent,flower,forked,glabrous,globose,mm,orange,ovate,pedicel,peduncle,perfect,petiole,pseudohair,pubescent,rachi,rarely,shrub,simple,sparsely,stellate,stigma,style,subcoriaceous,truncate,unbranched,violet,white,white-pubescent,x,yellow	.5-3.3,1,1-3,1.5-5.5,2,2.5,3-4,3-5,4-11,4-5,6-many-foliat,7,9,abaxially,absen,adaxiall,adaxially,aggregate,apiculate,articulated,axe,base,blade,branched,calyx,cell,connivent,cuneate,curled,cylindrical,deltate,dendritically,dendritically-branched,dense,directed,distall,divided,eaf,eed,eglandular,entire,gland,hair,lanceolate,leaving,less,like,lobe,lon,long,lower,margin,midvein,mixed,moderately,mostly,narrowly,near,nflorescence,nther,obtuse,occasionally,often,orolla,peg,pore,presen,puberulent,pubescen,radiu,ripe,ruit,scar,short,slightly,small,spaced,stalked,ste,stone,subcapitat,subclavate,subcordate,tal,tem,time,tip,triangular,tube,unequally,unit,usually,vary,wide,ympodial	abaxial,adaxial,anther,arrangement,color,corolla,filament,form,fruit,growth,height,history,inflorescence,leaf,length,life,na,number,ovary,perennial,plant,position,reproduction,seed,shape,spacing,staman,subcapitate,surface,texture,width
361	wfo-0001028399	success	273	101	64	209	37	0.234	.8,5.0,9.1,9.8,abaxially,acute,adaxially,age,anther,apart,apex,arching,attachment,base,chartaceous,cm,corolla,densely,diameter,dry,elliptic,extra-axillary,filament,flattened-orbicular,flattened-reniform,flower,fruit,glabrous,globose,gradually,increasing,lateral,leaf,length,long,mature,mm,moderately,notched,orange,ovate,pedicel,peduncle,petiole,point,position,probably,pubescent,red,reticulate,scattered,short,shrub,simple,spaced,sparse,stellate,stigma,style,surface,toward,well,yellow-tan,young	.3,.4,.5,.5–2.4,/3,0.04,0.06,0.13,0.2–0.3,0.3–0.4,0.3–0.5,0.3–0.6,0.4–0.5,0.4–0.6,0.4–0.7,0.4–0.9,0.5–1.1,0.5–1.3,0.7–1.0,0.7–2.3,0.8–2.5,0.9–1.9,1.0–5.5,1.1–1.4,1.1–1.7,1.2–1.5,1.2–1.7,1.2–2.0,1.3–2.0,1.4–2.4,1.5–2.1,1.6–2.3,1.6–2.5,1.7–2.7,1/2–2/3,1/3–1/2,1/4–1/3,2.0–3.9,2.2–2.6,2.2–2.8,2.2–2.9,2.4–3.2,2.5–11.2,2.8–3.0,3.1–3.8,3.2–3.8,3.4–3.6,4.0–5.4,4.2,4.3,4.4,5,5-merou,5.2–17.8,5.4,5–8,5–9,6.0–6.6,7.0,7–11,8–120,absent,adnate,aequilateral,alyx,anthe,anthesi,apiculate,apparently,appearing,appressed,articulate,attenuate,axe,ba,bark,basal,based,becoming,berry,blade,branch,branching,broad,broad-based,brochidodromous,brown,bud,calyx,capitat,channeled,cunate,deciduous,dehiscent,deltoid,dentate,developed,difoliate,distal,distinct,eaf,eed,either,emerging,entire,erect,exocarp,extending,fertile,filiform,flexed,free,geminat,glandular,glossy,hair,heterostylous,incurved,internodal,internode,interpetalar,intersepalar,juic,lanceolate,large,layer,lobe,lobed,lon,longer,longitudinally,lower,major,many,margin,midpoint,midrib,midvein,minor,minute,narrowly,nearly,nflorescence,oblique,oblong,orolla,per,porrect,porrect-stellate,portion,potentially,prickle,primary,raised,ray,red-orang,reddish,reflexe,restricted,ridge,rigid,rounded,row,ruit,secondary,sessile,shorter,side,sinuate,sinus,slit,sloughing,somewhat,soon,splitting,spread,spreading,stamen,stellae,stellate-pubescent,stem,stipe,stipitate,straight,tamen,tem,thin,time,tip,tissue,translucent,transparent,triangular,truncate,tube,two,ud,unarmed,upper,various,vary,vein,weakly,wide,yellow-ferruginous,ympodia,±90°,±equal,×	0.5-1.3,0.7-2.3,1.0-5.5,1.1-1.4,1.2-1.7,1.2-2.0,1.5-2.1,1.6-2.5,2.2-2.9,5-merous,60-100,8-120,abaxial,adaxial,arrangement,capitate,colour,dioecious,form,green,growth,height,history,inflorescence,life,na,number,ovary,perennial,plant,rachi,reproduction,seed,shape,spacing,staman,texture
362	wfo-0001028405	success	149	76	49	100	27	0.329	0.4-0.5,1-4,1-9,1.5-6.5,10-11,2,3-20,4-6,8-15,acute,apex,branched,cell,cm,conical,corolla,cyme,diameter,dichasial,dichasially,distal,ebracteate,elliptic-lanceolate,filament,flower,green,green-white,half,herbaceous,lanceolate,leaf,mm,monochasial,mucilaginous,odd-pinnate,ovoid,pedicel,peduncle,perennial,petiole,plant,puberulent,rachi,seed,stellate,stigma,style,throughout,yellow	0.5-3,1.3-8,2-2.5,2-3,2-4,3-4,3-6-foliat,3.5-10,3.5-6.5,4-11.5,6-7,7-14.5,9-15,abaxially,absen,acumen,adaxially,apical,apically,apiculate,articulate,attenuate,base,calyx,connate,covering,decurrent,dehiscent,digestion,diminishing,dorsally,eaf,edge,eed,elliptic,emoval,enzyme,exceeding,flat,folded,forked,generally,globo,gradually,hair-like,honeycomb,interjected,introrse,lateral,leaflet,living,lobe,lon,long,lower,lunat,make,maturing,nflorescence,nther,oblique,oblong,often,orolla,ovate-elliptic,pair,pattern,perfect,plan,poricidally,proximal,reveal,ruit,seudostipule,short,short-acuminate,short-petiolate,size,slit,specimen,stamen,straight,subsessile,tal,tem,terminal,testal,thick,throughou,toward,tuber-bearing,typically,unit,vary,wall,whit,wide,without,ympodial,¼	abaxial,adaxial,anther,arrangement,center,colour,form,fruit,globose,growth,height,history,inflorescence,length,life,na,number,ovary,position,reproduction,shape,spacing,staman,surface,texture,white,width
363	wfo-0001028424	success	253	116	91	162	25	0.36	-3,-9,0-0.5,0-1,0.3-0.7,0.5,0.7-2,1,2-3,3,3-12,3-6,3-8,4-12,5-15,5.5-10,abaxially,acicular,adaxially,anther,apart,apex,base,broadly,cm,deeply,deltoid-orbicular,densely,diameter,extra-axillary,felty,filament,flexuous,flower,fruit,glabrous,globose,hair,inflorescence,inserted,leaf-opposed,length,lenticular,less,light,like,long,minutely,mm,narrower,occasionally,orange,outline,ovate,ovate-lanceolate,pedicel,peduncle,pentagonal-stellate,perennial,persistently,petiole,pitted,prickle,pubescent,rachi,ripe,sessile,simple,slender,somewhat,spreading-hirsute,stellae,stellate,stellate-puberulent,stellate-pubescent,stem,stigma,style,suffrutescent,surface,tan,thin-textured,trichome,truncate,unbranched,weakly,white,white-pubescent,wide,x,yellow	-0.8,-1.2,-28,0.1-0.2,0.15-0.4,0.2-0.35,0.2-0.7,0.3-0.6,1-3,1-7,1.5-2.5,1.8-3,1/3-1/2,10-16,12,12-19,2,2-2.5,2-4,2-foliate,3-16,3-5,3-7,4-5,4-6,4-7,5-10,5-22,5-8,8-15,8-25,accrescent,acute,acute-,adaxiall,almost,along,and/or,articulated,ascending,attenuate,axe,ba,blade,branched,broad-based,broader,calyx,campanulate,capitat,capitate-glandular,cauline,closely,coarsely,commonly,connivent,conspicuously,convex,covering,curved,cylindrical,deltoid,dense,dentate,depressed-deltoid,diffusely,directed,distal,distally,distributed,divergently,diverging,eaf,eed,elongate,elongate-lanceolate,entire,equaling,exceeding,female-sterile,fruiting,geminat,gland-tipped,glandular,interlobal,larger,lateral,laterall,lobe,longer,lower,major,margin,midpoint,midrib,mixture,mostly,much,multiple-stemmed,multiseriate,nflorescence,numerous,obsolete,obtuse,obtuse-,often,orolla,per,perfect,pore,prickly,principal,puberulent,radiu,rarely,ray,recurved,reduced,reflexe,resembling,round-tipped,ruit,scattered,section,short,short-styled,shorter,side,similar,single-,sinus,size,small,smaller,sometimes,spaced,sparsely,species,stalk,stalked,ste,stout,strongly,subcordate,tal,tamen,tem,termination,thickened,time,tip,tube,typically,unarmed,unit,upward,usually,variable,vary,vein,widely,ympodial	abaxial,adaxial,arrangement,capitate,colour,corolla,form,green,growth,height,history,leaf,life,na,number,ovary,plant,position,reproduction,seed,shape,spacing,staman,texture,width
364	wfo-0001028429	success	162	115	84	78	31	0.519	0.2-0.4,1-2.5,1-4,1.5-3,10-11,2-3,2.5-12,2.5-4,2.5-7.5,2.7-3.6,4-14,6-18,6-28,7-7,abaxially,acuminate,acute,adaxially,apex,base,branched,broadly,cell,cm,cordate,corolla,cuneate,cyme,darker,diameter,dichasial,dichasially,distal,ebracteate,elliptical,filament,flower,forked,glabrescent,glabrous,globose,green,green-white,greenish,hair,hair-like,half,herbaceous,interjected,lateral,leaf,leaflet,light,medium,mm,monochasial,mucilaginous,narrowly,oblique,obovate,odd-pinnate,ovate,ovoid,pedicel,peduncle,pentagonal,perennial,petiole,petiolule,plant,rotate,scattered,seed,slightly,spot,stigma,style,terminal,throughout,tuber-bearing,violet,wall,white,yellow	0.8-1.2,0.9-2.3,1.5-4,10-27,10.5-21,2-1.,2-4,2-8,3-6,3-6-foliat,5-12,abaxiall,acumen,apical,apically,articulate,calyx,connate,covering,dehiscent,digestion,diminishing,dorsally,eaf,edge,eed,emoval,enzyme,especially,exceeding,flat,folded,generally,globo,gradually,honeycomb,introrse,living,lobe,lon,long,long-attenuate,lower,lunat,make,maturing,nflorescence,nther,often,orolla,pair,pattern,perfect,plan,poricidally,proximal,reveal,ruit,seudostipule,short,size,slit,specimen,stamen,straight,tal,tem,testal,thick,throughou,toward,typically,unit,vary,vein,wide,ympodial,¼	2-19,abaxial,adaxial,anther,arrangement,center,colour,form,fruit,growth,height,history,inflorescence,length,life,lunate,na,number,ovary,position,present,pseudostipule,rachi,reproduction,shape,spacing,staman,surface,texture,width,ye
365	wfo-0001028436	success	150	92	63	87	29	0.42	.5,0.2-0.4,0.5-1,1-3,1.5-2,10-20,2.5-3,4,5-10,5-8,7,8-12,absent,acute,anther,apex,brown,calyx,cell,center,chartaceous,diameter,dm,dried,edge,elliptic,entire,filament,fine,flower,fruit,fruiting,glabrous,globose,leaf,linear,margin,membranaceous,mm,moderately,nearly,parallel,pedicel,peduncle,petiole,pubescent,rachi,radiating,raised,ridge,rotate,running,shallow,shrub,stem,stigma,style,surface,taproot,unbranched,unifoliate,white,x	0.5,0.8-1.5,1-2,1-2-celled,1.5,1.5-2.5,1st,2-3,2-4,2nd,5-12,5-15,abaxially,abundant,adaxiall,adaxially,along,apically,appearance,appearing,axe,base,berry,beyond,blade,ciliate,cm,connected,cordat,decurrent,deflated,dehiscent,difficult,due,eaf,eed,evaluat,explosively,exserted,flat,frui,geniculate,glabrescen,hair,interpetalar,lengt,like,linear-lancolate,lobe,long,lower,lying,much-branched,nflorescence,notch,oblong,often,older,orolla,oung,per,placenta,pointing,presence,pubescen,reaching,rhizomatous,ruit,small,sparsely,stamen,structure,swollen,tal,tamen,tear,thick,tissue,triangular,tube,two-celled,unit,vary,wid,woody,wrinkled,ympodial	abaxial,adaxial,arrangement,bark,bud,colour,corolla,form,growth,height,history,inflorescence,length,life,na,number,ovary,perennial,plant,position,prickle,reproduction,seed,shape,spacing,staman,texture,trichome,width
366	wfo-0001028465	success	159	110	78	81	32	0.491	0.75,1-4,1.5-2.9,11-23,2-6,2-9.3,2.4-2.8,3-8,4-8,4.5-5.5,8-10,9-19,acuminate,acute,apex,articulate,base,branched,broadly,cell,cm,corolla,covering,cuneate,cyme,diameter,dichasial,dichasially,distal,ebracteate,elliptical,filament,flower,globose,green,green-white,hair-like,half,herbaceous,honeycomb,interjected,interpetalar,lateral,leaf,leaflet,medium,mm,monochasial,mucilaginous,odd-pinnate,ovoid,pattern,pedicel,peduncle,perennial,petiole,plant,proximal,puberulent,pubescent,purple,rachi,rotate,seed,spot,stigma,strigose,style,terminal,testal,thick,throughout,tuber-bearing,unit,wall,white,yellow,¼	1-2,1.2-2,10,10-24,2,2-3,2-4,2.5-4,3-4,3-5,3-6-foliat,3.8-7,4-1.,5-7,7-15,abaxially,acumen,adaxially,apical,apically,attenuate,calyx,connate,decurrent,dehiscent,digestion,diminishing,dorsally,eaf,edge,eed,emoval,enzyme,equal,exceeding,first,flat,folded,forked,generally,globo,gradually,introrse,living,lobe,lon,long,lower,lunat,make,maturing,nflorescence,nther,oblique,often,orolla,pair,perfect,petiolule,plan,poricidally,rarely,reveal,ruit,sessile,seudostipule,short,size,slit,specimen,stamen,straight,tal,tem,tissu,toward,two,typically,vary,wide,ympodial	3-6-foliate,4-18,abaxial,adaxial,anther,arrangement,colour,form,fruit,growth,height,history,inflorescence,length,life,lunate,na,number,ovary,position,present,pseudostipule,reproduction,shape,spacing,staman,surface,sympodial,texture,tissue,width,ye
367	wfo-0001028468	success	255	115	83	172	32	0.325	-5.5,.3-0.4,0.2-0.3,0.4-4,0.5-3,0.5-8,0.6-1.2,0.7-2.5,1.2-1.5,16,5-9,6-9,accrescent,acute,anther,apart,apex,berry,blue,brown,bud,calyx,chartaceous,clavate,cm,corolla,dark,densely,diameter,ellipsoid,extra-axillary,filament,flattened,flower,foveate,fruit,fruiting,glabrous,gray,green,greenish,length,light,lobed,margin,mm,moderately,narrowly,oblique,oblong-conical,orange,orangish,ovoid,pale,pedicel,peduncle,petiole,purple,rachi,reticulate,rhombic,rotate-stellate,shallowly,shrub,simple,somewhat,sparsely,stellate-pubescent,stem,stigma,style,subcapitate,subelliptic,subglobose,sublenticular,subreniform,subshrub,surface,terete,unbranched,x,yellow,yellowish	-1.3,-10,-3,-4,-7,.1-0.2,.1-0.3,.1-0.4,.2,.2-0.4,.3,.5,.5-1.5,.5-1.6,.6-1,/10-1/5,/4-1/3,0.05,0.1,0.2-0.6,0.2-1.5,0.4-1,0.5-2,0.5-3.3,0.5-3.5,0.6-2,0.8-3.5,1,1.3-2,1.5-2.2,1.5-3.1,1.6,1/3-1/2,1/5-1/2,2,2-9,2.2-3,2.5-4,2.8-4.1,2/3-3/4,20,3-4,4-6,4-9,5-21,6-10,abaxially,acuminate,adaxially,along,appressed,ark,armed,articulated,attenuate,axe,base,becoming,beyond,blade,broad-based,broadly,bu,c.,campanulate,cauline,central,commonly,compresse,compressed,connivent,d.,decreasing,density,directed,distal,distally,distantly,dry,eaf,eed,equal,exserted,geminat,glabrescent,gradually,hair,half,increasing,inserted,interpetalar,introrsel,lamin,lateral,laterally,lobe,long,longer,lower,m.,main,midpoint,midvein,minutely,mixed,mostly,multangulat,multangulate,nflorescence,oblong-lanceolate,obtuse,occasionally,older,orolla,ovate,overlapping,pair,papillo,per,perfect,pore,porrect-stellate,prickle,proximal,pubescence,pubescent,ray,recurved,reduced,relatively,ruit,sessile,short,short-,short-stalked,side,similar,similarly,slightly,spaced,specimen,stalk,stamen,stelliform,straight,subacuminate,subchartaceous,subcuneate,subsessile,tal,tamen,testa,thick,thick-stalked,thicknes,time,tissue,touching,toward,triangular,tube,unarmed,unifoliate,unit,upper,usually,vary,vein,way,wide,ympodial,young	0-1.3,0.5-1.5,4-10,abaxial,adaxial,arrangement,bark,cell,center,colour,form,growth,height,history,inflorescence,leaf,life,na,new,number,ovary,plant,position,reproduction,scar,seed,shape,spacing,staman,texture,trichome,width
368	wfo-0001028470	success	185	89	54	131	35	0.292	0.25-0.75,1-12.3,1-2,12-44,2.1-3.9,3-10,3-5,3.5-16,4-7,6-33,anther,apex,bud,cell,chartaceous,clavate,cm,corolla,dark,deep,diameter,dot,elliptic,filament,flower,forked,fruit,glabrous,green,greenish,hair-like,herb,leaf,light,medium,mm,mucilaginous,odd-pinnate,ovate,ovoid,pedicel,peduncle,pentagonal,petiole,plant,rounded,seed,stigma,style,substellate,terminal,white,whitish,yellow	0-18,0.9-2.2,0.9-2.3,1-3,1.5-2.8,1.6-3.2,11.8-21,2-10,2-5,2-7,2-8,3.2-5.5,3.5-7,4-6,5-merou,5.5-11.6,abaxially,acumen,acute,adaxiall,adaxially,ag,alyx,apart,apparently,articulated,asymmetric,attenuate,axe,axillary,base,basiscopic,berry,blade,brownish,capitat,condition,connivent,covering,decreasing,digestion,distal,dorsally,drying,eaf,edge,eed,end,enzyme,erec,exceeding,flat,folded,fresh,geminat,generally,glabrescent,glabrou,green-white,hair,hal,half,high,homostylous,honeycomb-shaped,interjected,lanceolate,lateral,leaflet,lengthening,living,lobe,long,lower,make,mottled,nflorescence,one,orbicular,orolla,pair,perfect,petiolulate,placed,plurifoliate,pore,poricidal,pubescent,purple,removed,ripe,ruit,scarce,sessile,seudostipule,short,side,size,slit,sometimes,spaced,specimen,stamen,stolo,straight,subequal,subglabrou,subtending,tall,tamen,tem,testal,thick,throughout,tip,tissue,toward,tri-,tube,tuber,typically,unit,unwinged,usually,vary,wall,wet,wide,wing,x,ympodial	abaxial,adaxial,arrangement,bark,calyx,capitate,center,colour,form,fruiting,growth,height,history,inflorescence,length,life,margin,na,new,number,ovary,perennial,position,prickle,rachi,reproduction,scar,shape,spacing,staman,stem,surface,texture,trichome,width
369	wfo-0001028476	invalid_json_followup	246	126	92	154	34	0.374	-1,-6,0.15-0.2,0.2-0.5,0.4-0.6,0.4-1.5,0.5,0.8-1.2,0.8-1.6,1,1-2-celled,1-4,1.1-1.6,1.8-2.5,5-15,8-30,abaxially,acuminate,acute,anther,apex,articulated,bifurcate,branched,bright,brown,calyx,capitate,cell,cm,conical,corolla,dark,deeply,diameter,distal,elliptic,filament,flower,fruit,fruiting,globose,green,hair-like,half,herb,imparipinnate,inflorescence,interrupted,irregularly,lateral,leaf,less,lobed,long,margin,minutely,mm,narrowly,obovate,outgrowth,ovary,pale,pedicel,peduncle,perennial,petiole,pubescent,purple,rachi,regularly,scattered,simple,sparsely,spreading,stellate,stem,stigma,stripe,style,surface,tall,testa,trichome,uniformly,uniseriate,usually,wall,weak-walled,wide,woody,yellow	-16,-20,-8,.05-0.1,.5,0-,0-0.5,0.1-0.15,0.1-0.4,0.15-0.4,0.2-0.3,0.2-0.6,0.25-0.4,0.25-0.5,0.3-0.4,0.3-0.5,0.3-0.7,0.3-1.2,0.4-0.5,0.5-0.6,0.5-1.7,0.7-2.5,1-1.2,1-1.4,1-1.5,1-2,1-6,1-celled,1.1-1.5,1.2-2.5,12-30,2,2-6,2-foliate,2-locular,2.4-3,3-12,3-7,3-foliate,3.5-13,4-celled,6-,7-10,absent,abundant,acroscopically,age,almost,along,also,alternate,anthesi,ape,apical,appearance,appendage,axi,basal,base,basiscopically,becoming,bifurcation,bract,bracteate,column,curved,decurrent,diamete,eaf,ebracteate,edicel,eed,elongate,entire,especially,exserted,first,fortaleza,give,glabrescent,glandular,gradually,gree,hal,head,hyaline,incurved,interjected,internode,lanceolate,largest,leaflet,like,lobe,lon,lower,main,maturity,midvein,minute,mixed,nflorescence,node,numerous,oblique,occasionally,often,pair,petiolule,population,present,primary,prominent,pseudostipule,puberulent,pubescence,rarely,recurve,reflexed,rest,rounded,ruit,río,secondary,sessile,set,short,silky,sinus,slightly,smaller,sprawling,staminal,sterile,stiff,straight,subopposite,tem,terminal,tertiary,thick,tip,toward,truncate,tube,ud,unicellular,unit,unpaired,vein,white,wid,winged,ympodial	'',6-30,[,``,abaxial,adaxial,arrangement,bark,bud,characteristic,colour,form,growth,height,history,length,life,na,new,number,plant,position,prickle,reproduction,scar,seed,shape,spacing,staman,texture,value,width,{,}
370	wfo-0001028478	invalid_json_followup	267	138	92	175	46	0.345	.2,.8,0.0,2,3.4,abaxially,adaxially,anther,apart,apex,attachment,bark,base,bilobed,brown,bud,calyx,cm,corolla,deeply,densely,developed,diameter,distal,dry,elliptic,entire,filament,flattened-orbicular,flower,fruit,glabrous,glandular,globose,gradually,hair,increasing,interpetalar,lanceolate,leaf,length,long,margin,mature,minute,mm,moderately,nearly,notched,obtuse,orange-red,ovate,pedicel,peduncle,petiole,pitted,point,poorly,porrect,prickle,pubescent,reddish,scattered,shallowly,shoot,short,shrub,simple,sinuate,slightly,spaced,sparsely,stellae,stellate,stellate-pubescent,stem,stigma,stipitate,straight,style,sub-coriaceous,suborbicular,surface,terminal,tissue,toward,unbranched,well,white,yellow,yellow-tan,young	.0,.04,.3,.5,.9,0.1,0.2,0.2–0.4,0.3–0.4,0.3–0.5,0.4,0.4–0.5,0.5–0.6,0.5–0.8,0.5–0.9,0.6–1.3,0.9–1.1,1.0–1.3,1.0–1.5,1.1–1.6,1.3–1.6,1.4–2.3,1.4–4.4,1.5–2.4,1.5–4,1.8–2.0,1/2–1/3,2.0–11.0,2.1–2.3,2.2–4.0,2.3,2.5,3.3–4.9,3–6,4,4.6,4.6–7.0,4.8,4–6,4–7,5-merou,5.5–6.6,7,7.7–9.2,acuminate,adjacent,adnate,aequilateral,ag,alyx,anthesi,apical,apparently,appearing,appresse,around,articulate,attenuate,axe,ba,based,berry,blade,borne,broad,broad-based,broadly,brochidodromous,capitat,channeled,clinate,connivent,deciduous,deflexed,deltate,development,difoliate,directed,distally,distinct,distinctly,eaf,edge,eed,either,emerging,endocarp,erect,exocarp,extending,fertile,filiform,flexed,free,geminat,glossy,hort,incurved,individually,internode,intersepalar,juic,lateral,layer,lobe,lobed,lon,longer,lower,markedly,midpoint,midrib,midvein,nflorescence,oblique,oblong,occasionally,opaque,orolla,per,perforated,pore,porrect-stellate,portion,potentially,presen,probably,raised,ray,retrorse,rigid,rounded,row,ruit,seen,sessile,side,sigmoid,sinus,sloughing,smoot,somewhat,soon,spatulate,splitting,spread,stamen,stipe,strongly,sub-cordate,suture,tamen,tem,thin,time,tip,transparent,triangular,truncate,tube,two,typically,ud,unarmed,various,vary,vein,wide,yellow-ferruginou,ympodia,±45°,±90°,±equal,×,–10	'',1.0-1.5,1.1-1.6,1.3-1.6,1.4-2.3,1/2-1/3,2.0-11.0,3-6,4.6-7.0,5-merous,7.7-9.2,[,``,abaxial,adaxial,arrangement,capitate,characteristic,colour,form,fruiting,growth,height,history,inflorescence,life,na,new,number,ovary,perennial,plant,position,rachi,reproduction,scar,seed,shape,spacing,staman,texture,trichome,value,width,{,}
371	wfo-0001028481	success	194	119	96	98	23	0.495	.1,.5,0-2,0.15,0.6-1,0°,1-4,1.8-2.5,3-4,3-6,8,acuminate,almost,along,anther,apex,apically,apparently,articulated,attenuate,bark,base,branch,branched,brown,chartaceous,clavate,cm,colour,conical,corolla,cuneate,dendritic,dendritic-pubescent,diameter,dilated,discolorous,distributed,dry,drying,elliptic,entire,evenly,flaking,flexuous,flower,glabrous,green,leaf,length,less,liana,like,lobed,long,longitudinally,main,margin,midvein,mm,oblong,occasional,often,orange-brown,pair,pedicel,peduncle,petiole,primary,pubescent,rachi,ray,reddish,ribbed,ridged,shortly,shrub,side,slender,sparsely,stem,stigma,style,surface,terminal,tertiary,thickly,trichome,unarmed,unknown,vein,venation,visible,white,yellowish,young	.3,0.1-0.2,0.5-1,1-1.4,1-2,1-3,1.5,1.5-2,1/2-2/3,2-3,2.5-3,3,3-3.5,3-4.5,5.5-7.5,abaxially,absent,acute,adaxially,age,alyx,anthesi,apar,canaliculate,clearly,close,cupular,deeply,delineated,deltoid,density,different,divided,domatia,dorsifixed,eaf,eed,ellipsoi,equal,erect,except,extending,extent,eye,faint,filament,flat,free,increasing,know,known,lamina,lengthening,linear,lobe,lon,long-acuminate,longer,lower,m.,mostly,naked,narrowly,nflorescence,nther,oblique,orolla,ovate,perfec,plurifoliat,pore,poricidal,portion,protruding,raised,ruit,scar,see,simple,sinus,size,small,smoot,smoothly,spreading,stump,tearing,tip,together,toward,tube,ud,uneven,unit,vary,wide,x,ympodial	abaxial,adaxial,angle,arrangement,branching,bud,ellipsoid,form,fruit,growth,inflorescence,na,number,ovary,perfect,position,ribbing,seed,shape,smooth,spacing,texture,width
372	wfo-0001028482	success	224	97	75	149	22	0.335	.1,0.5-1,0.5-5,00,1-11,1-2,1-4,1.1-5,10,2-3,2-celled,3-4,4-5,6-50,acuminate,acute,anther,apex,bark,bilobed,bright,brownish,capitate,closely,cm,coriaceous,corolla,creamy,cymose,diameter,distinct,elliptic,emarginate,exfoliating,filament,flattened-reniform,flower,fruit,glabrous,glandular,globose,green,growth,internodal,leaf-opposed,lobed,minutely,mm,obovate,ovary,pale,pedicel,peduncle,pentamerous,petiole,pitted,pubescent,row,simple,small,spaced,stigma,style,subglobose,subpyramidal,surface,tan,tree,trichome,two,white,x,yellow,yellowish,µm	.5,/3,0,0.2,0.5,0.7-1.1,1-1.5,1.2-1.6,1.5-2,1.5-3,3-12,5-25,7-14,abaxially,adaxially,age,alternate,angled,anthesi,apiculae,ascending,asymmetric,basal,base,becoming,berr,berry,bifid,bifurcate,branched,broadly,brochiodromous,bud,calyx,campanulate,channeled,chartaceous,circinate,constriction,corky,corrugated,cucullate,curved,deciduous,deflexed,deltate,densely,diffusely,difoliate,discolorous,distally,dry,drying,eaf,eed,ellipsoid,embryo,enlarged,entire,exerted,expanding,fleshy,free,fresh,fruiting,geminat,glabrou,golden,grayish,halfway,hard,heterostylous,impressed,incrassate,individual,investing,irregular,keeled,lengthening,less,lobe,long,lower,margin,markedly,materia,material,maturity,midrib,midvein,minute,new,nflorescence,nodding,occasionally,olive,overlappin,pair,papillat,per,pericarp,petal,pore,poricidal,portion,primary,reddish,revolute,ruit,scandent,scar,shaped,shiny,short,size,slightly,slit,sometimes,somewhat,soon,sparsely,stem,stout,straight,subcoriaceous,tear-drop,tightly,tiny,tip,transparent,transversely,truncate,tub,tube,tuberculate,tuft,twice,ud,unifoliate,uniseriate,unit,usually,vegetative,vein,venation,way,woody,ympodial,young	abaxial,adaxial,arrangement,colour,form,height,history,inflorescence,leaf,length,life,na,number,perennial,plant,position,reproduction,seed,shape,spacing,staman,texture
373	wfo-0001028487	success	195	115	88	107	27	0.451	0.3-0.7,0.9-3,1-2,10-4.3,10-41,15-28,2.5-3.5,3-10,3-19,3-5,5-6,abaxially,adaxially,anther,apex,asymmetric,attenuate,axillary,basiscopic,berry,brownish,bud,cell,central,clavate,cm,condition,coriaceous,corolla,covering,dark,deep,diameter,drying,elliptic,filament,flower,forked,fresh,fruit,glabrescent,glabrous,green,green-white,greenish,hair,hair-like,herb,lateral,leaf,light,make,medium,mm,moniliform,mucilaginous,odd-pinnate,ovate,ovoid,pedicel,peduncle,pentagonal,petiole,plant,purple,ripe,rounded,scabrous,scarce,seed,short,side,star,stigma,style,substellate,subtending,terminal,testal,thick,throughout,tissue,tuber,wall,wet,white,whitish,yellow	0-9,0.4-1.5,1-3,1-3.2,1.1-1.5,1.4-1.7,1.7-7,2-4,2-4.8,2-6,3-4,3.4-7.8,4-7,4.6-13.6,5-merou,7.8-16.4,acumen,acuminate,acute,adaxiall,ag,along,alyx,apart,apparently,arranged,articulated,axe,base,bead,blade,capitat,connivent,considerably,decreasing,digestion,distal,dorsally,eaf,edge,eed,enzyme,erec,exceeding,flat,folded,geminat,generally,glabrou,hal,half,high,homostylous,honeycomb-shaped,interjected,lanceolate,leaflet,lengthening,like,living,lobe,long,lower,multiple,narrow,necklace,nflorescence,orbicular,orolla,pair,perfect,petiolulate,plurifoliate,pore,poricidal,removed,ruit,second,sessile,seudostipule,size,slit,smaller,sometimes,spaced,specimen,stamen,stolon,straight,subequal,subglabrou,tall,tamen,tem,tip,toward,tri-,tube,typically,unit,unwinged,usually,vary,wide,wing,x,ympodial	abaxial,adaxial,arrangement,capitate,colour,form,growth,height,history,inflorescence,length,life,na,number,ovary,perennial,position,pseudostipule,rachi,reproduction,shape,spacing,staman,subglabrous,surface,texture,width
374	wfo-0001028489	invalid_json_followup	224	129	92	132	37	0.411	-10,-2.5,-4,0-3,0.2-0.6,0.3-0.5,0.3-1,0.3-1.2,0.5-1,0.5-1.1,0.5-1.5,1-3,1-6,1.5-4,2-6,3.5-6,4-13,abaxially,acicular,acute,anther,apex,articulated,bark,base,berry,calyx,chartaceous,cm,cream,dark,densely,diameter,dull,elliptic,erect,filament,flattened-reniform,flower,fruit,fruiting,glabrous,gray,green,lateral,leaf,length,lobed,margin,marking,maturity,mauve,membranous,mm,moderately,obtuse,orange,orange-brown,orange-green,ovate,pale,pedicel,peduncle,perpendicular,petiole,porrect,prickle,purple,red-brown,scar,sessile,shiny,shrub,simple,smooth,sometimes,sparsely,spherical,stellate,stellate-pubescent,stem,straight,style,subsessile,surface,terete,trichome,white,yellow,yellow-green,yellow-orange,young	-0.6,-5,-6,/4,0-10,0-15,0-20,0-50,0.1,0.1-0.6,0.2,0.2-,0.2-0.4,0.2-0.5,0.2-0.7,0.3-0.7,0.4-0.8,0.5-0.8,0.6-1.2,0.7-3,1-4,1-7,1.5-3,1.8-2.2,1.8-4,1.8-5.5,1/3,1/3-1/2,1/4-1/2,2-3,2-4,2.1-3,3-7,4-10,4-8,5-25,5-8,5-merous,7.5,alyx,apar,apart,apically,apparently,ba,beyond,blade,branched,broad-deltate,caudat,cell,concolorous,connivent,cordate,cuneate,curved,deltate,difoliate,distance,drying,eaf,eed,elongating,equal,extending,eye,free,geminat,hair,herbaceous,infructescence,less,lobe,lon,long,longer,lower,mature,midpoint,midvein,minute,naked,nflorescence,occasionally,often,older,one,open,orolla,oung,outline,pair,pendulous,per,perfec,pericarp,poricidal,portion,prickly,primary,protruding,raised,ray,rounded,ruit,side,slender,spaced,spreading,stalk,tamen,tapering,tertiary,time,tip,toward,truncate,tube,unarme,unarmed,unit,upper,vary,vein,venation,visible,way,weakly,white-gra,wide,woody,ympodial	'',[,``,abaxial,adaxial,arrangement,bud,characteristic,colour,corolla,form,growth,height,history,inflorescence,life,na,new,number,ovary,perennial,plant,position,rachi,reproduction,seed,shape,spacing,staman,stigma,texture,unknown,value,white-gray,width,{,}
375	wfo-0001028492	success	130	93	58	72	35	0.446	0.2-2,0.5-1,1-2.5,1-4,1-5,1.5-2.5,1.5-6,2-2.5,2.5-9,3,5-15,5-8,6-11,acute,angled,apart,apex,base,blade,chartaceous,cm,colored,dark,diameter,elliptic-ovate,entire,forked,fruit,glabrous,globose,herb,margin,mm,pedicel,peduncle,petiole,pubescent,purple,rachi,rarely,reticulate,ripe,rounded,scar,shrub,simple,spaced,stellate,stigma,style,subcordate,unbranched,unevenly,unit,unknown,white-punctate,whitish,x	-5-foliat,1.5-3,1.75-3.5,15-20,2-3,2-4,2-5,3-6,4,5-25-flower,6-12,8-15,abaxially,absen,adaxially,aggregate,apiculate,articulated,axe,axi,calyx,cell,ciliolate,color,connivent,containing,crystal,cylindrical,deltate,directed,distall,eaf,eed,except,glabrou,hair,irregularly,leaving,lobe,long,lower,narrowly,nflorescence,nther,obtuse,orolla,pore,punctate,radiu,ruit,san,sand-punctate,somewhat,sparse,splitting,stone,subcoriaceous,succulent,tal,tem,time,tip,triangular,triangular-ovate,truncat,tube,vary,veiny,white,wide,x1-3,ympodial	1-3,4-5-foliate,5-25,abaxial,adaxial,anther,arrangement,colour,corolla,filament,flower,form,growth,height,history,inflorescence,leaf,length,life,na,number,ovary,perennial,plant,position,reproduction,seed,shape,spacing,staman,surface,sympodial,texture,truncate,width
376	wfo-0001028501	success	195	136	108	87	28	0.554	0-3.2,0.3-0.7,1-2,1.8-10.7,13-41,2.8-18,2.8-4.9,3-10,3-5,4-8,8-34,abaxially,acuminate,acute,adaxially,along,anther,apex,axillary,base,bead,brownish,bud,cell,clavate,cm,condition,considerably,coriaceous,corolla,covering,dark,decreasing,decurrent,diameter,distal,drying,elliptic,filament,flower,forked,fresh,fruit,glabrescent,glabrous,green,green-white,greenish,hair,hair-like,herb,interjected,larger,lateral,leaf,leaflet,light,like,make,medium,mm,moniliform,mucilaginous,narrowly,necklace,odd-pinnate,onto,orbicular,ovate,ovoid,pair,pedicel,peduncle,petiole,plant,plurifoliate,present,pyriform,rachi,ripe,rotate,scarce,seed,sessile,short,simple,size,sometimes,spot,stigma,stolon,style,subtending,terminal,testal,thick,throughout,toward,tri-,tuber,typically,unit,usually,wall,wet,white,whitish,yellow	0-3,0-4,0.3-3.3,0.6-5.8,0.8-1.6,0.8-1.7,1,1-3,1-8,2-4,2-5,3-7,3.1-10.4,3.1-12,4.8-18,5-merou,6.6-21.1,8-10,acumen,adaxiall,ag,alyx,apart,apparently,arranged,articulated,attenuate,axe,berry,blade,broadly,capitat,connivent,digestion,dorsally,eaf,edge,eed,enzyme,erec,exceeding,flat,folded,geminat,generally,glabrou,hal,half,high,homostylous,honeycomb-shaped,lanceolate,lengthening,linear,living,lobe,long,lower,mottled,multiple,narrow,nflorescence,orolla,perfect,pore,poricidal,purple,removed,ruit,seudostipule,slit,spaced,specimen,stamen,straight,subglabrou,tall,tamen,tem,tip,tube,unwinged,vary,wide,wing,x,ympodial	abaxial,adaxial,arrangement,capitate,colour,form,geminate,growth,height,history,inflorescence,length,life,na,number,ovary,perennial,position,pseudostipule,reproduction,shape,spacing,staman,subglabrous,surface,sympodial,texture,width
377	wfo-0001028502	invalid_json_followup	158	110	69	89	41	0.437	0.5-1,1-2,1.5-2,1.5-2.5,1.6-2.4,2-4,2-7,2-8,3.5-4,5-15,abaxial,abaxially,acute,adaxially,anther,apex,bark,beige,brown,calyx,campanulate,clavate,cm,congested,corolla,dark,dendritic,densely,elliptic,filament,flat,flattened-reniform,fleshy,flower,fruiting,glabrous,globose,inflorescence,later,lateral,leaf,lobed,long,margin,minutely,mm,ovary,papillose,pedicel,petiole,pitted,pubescent,reddish-brown,scar,seed,shining,shrub,small,spaced,stem,stigma,style,surface,terminal,tree,trichome,unevenly,white,woody	.5,/2,1.5-3,1.5-6,2-2.5,2-5,3.5-15,5-6,6-8,?,age,along,anthesi,apar,ba,base,blade,body,branch,branched,cazalet,christmas-tree-like,closely,cone,constricted,deltate,denser,dia,eaf,edicel,eed,erect,exserted,fawn,fide,free,glabrat,heteromorphic,impressed,included,incrassate,inflorescenc,lengthening,light,like,lobe,lon,long-styled,lower,main,matted,middle,narrower,nflorescence,obovate,often,older,packed,pair,papillo,planar,plurifoliat,pore,poricidal,portion,prominent,rest,ruit,scattered,short-styled,slit,structure,tall,thick,time,tip,tree-like,tub,tube,ud,unclear,vein,warty,way,wide,widest,within,ympodia,young	'',4-6,[,``,adaxial,apart,arrangement,bud,cell,center,characteristic,colour,dense,diameter,form,fruit,glabrate,growth,height,history,length,life,na,new,number,peduncle,perennial,plant,plurifoliate,position,prickle,rachi,reproduction,shape,spacing,staman,texture,value,width,{,}
378	wfo-0001028505	success	168	96	67	101	29	0.399	.01,.3,.5,0.8-1,0.8-1.5,1-3,acuminate,acute,anther,apex,bark,base,black,bright,broadly,bud,calyx,cm,conical,corolla,distinct,dried,drying,erect,filament,fruiting,gently,glabrous,globose,green,grey,leaf,lobed,margin,material,minutely,mm,narrowly,opposite,ovary,ovate,ovoid-reniform,pair,pale,papillose,pedicel,petiole,pitted,plant,pubescent,purple,scar,seed,shape,shrub,simple,stem,stigma,style,surface,tan,tapering,trichome,unicellular,uniseriate,white,yellowish	.1,/3,0.25-0.5,1,1.2-2.5,1/3,10-14-flowered,10-15,2,2.5-4.5,3-5,3.5-5,7-8,anthesi,aspect,ba,barely,basal,beneath,berry,blade,body,branch,characteristic,darker,deciduous,decurrent,deflexed,delicate,deltoid,dia,differentiated,differing,difoliate,distance,dry,eaf,edicel,eed,elliptic,expanded,exserted,exsertion,f,flattened,free,geminat,greatly,incrassate,lateral,live,lobe,lon,long,lower,m.,main,major,materia,member,minor,minute,nflorescence,obovoid,obvious,older,overlapping,pore,poricidal,portion,prominent,proximal,reflexed,rounded,ruit,shaped,short,size,slightly,somewhat,soon,specimen,straight,strongly,tall,tear-drop,tip,touching,truncate,tube,ud,unit,usually,vein,way,whit,widest,woody,x,ympodial,young	10-14,abaxial,adaxial,arrangement,cell,center,colour,diameter,flower,form,fruit,growth,height,history,inflorescence,length,life,na,new,number,peduncle,perennial,position,rachi,reproduction,spacing,staman,texture,width
379	wfo-0001028513	success	240	132	104	136	28	0.433	-17,-6,.3-0.5,0.1-0.15,0.5-0.6,0.5-2,1-2.5,1-3,1-4,15-40,2-4,2-5,3-4,30,4-8,5-10,7-11,8-11,8-15,abaxially,adaxially,anther,apart,articulated,attenuate,base,bristly,broadly,brown,bud,calyx,campanulate,close,cm,coarsely,commonly,connivent,densely,dentate,diameter,ellipsoidal,extra-axillary,filament,flexible,flower,fruit,fruiting,globose,inflorescence,lavender,leaf,length,lenticular,less,light,linear-lanceolate,long,margin,mm,often,orange,outline,ovate,ovate-lanceolate,pair,pedicel,peduncle,perennial,petiole,pitted,prickle,prickly,pubescent,purple,rachi,reaching,recurved,rigid,ripe,rust-colored,scabrous,silvery-gray,simple,small,soft,somewhat,sparsely,stellate,stellate-pubescent,stigma,style,surface,texture,thin-textured,tree,trichome,unbranched,usually,variable,weakly,white,wide,x,yellow	-0.7,-0.8,-5,.1-1.3,.2,/3,0-0.4,0.1-0.4,0.2-0.8,0.3-0.5,1,1-2,1.5-5,1/5-1/3,2,2-4.5,2-6,2-foliate,2.75-3.25,20-35,25-45,3-4.5,3.5-4,4-6,4-locular,4.5-6,5-6,5-9,8-16,8-25,9-11,accrescent,acute,acute-,acute-tipped,adaxiall,along,apex,apiculate,appearing,appressed,approaching,approximately,armed,axe,ba,berr,blade,broad,broad-based,capitat,cauline,closely,compresse,cylindrical,deciduous,deltoid,depressed-deltoid,directed,distal,distall,doubling,eaf,eed,enclosing,entire,erect,exceeding,female-sterile,geminat,glabrous,hair,horizontal,inserted,interlobal,large,larger,lateral,laterally,lignescent,lobe,lower,major,many,mature,midpoint,minute,near,nflorescence,numerous,obtuse,obtuse-,one,oriented,orolla,partially,per,pericarp,persisting,plane,pore,present,prickl,principal,radiu,rarely,ray,round-tipped,rounded,ruit,scattered,sessile,short,short-stalked,side,sinus,siz,smaller,spaced,stalk,stellae,subcordate,tal,tamen,tem,termination,time,tooth-like,truncate,tube,unarmed,underdeveloped,unit,vary,vein,ympodial	abaxial,adaxial,arrangement,bark,capitate,cell,center,colour,corolla,form,growth,height,history,life,na,new,number,ovary,plant,position,reproduction,scar,seed,shape,spacing,staman,stem,width
380	wfo-0001028524	success	236	107	76	160	31	0.322	0.3-0.8,0.5-3.5,0.6-1.4,1.5-1.6,2-6,2.5-3.4,3-15,3-4.3,3.3-4,4-6,4-8,8-13,9-14,anther,apex,bark,brown,bud,calyx,cm,conical,corolla,cream,dark,deltoid,diameter,echinoid,entire,filament,flower,fruit,fruiting,glabrescent,granular-tomentose,gray,green,greenish,growth,honeycombed,lanceolate,leaf,length,lobed,margin,mm,multangulate,orbicular,ovate,pale,pedicel,peduncle,petiole,plurifoliate,probably,pseudo-terminal,rachi,reniform,reticulate-punctate,scabridulous,simple,slightly,stellate,stem,stigma,style,subglobose,suborbicular,sulcate,terete,tomentose,tree,velutinous,x,yellow,yellowish,yellowish-green	-2.7,-3,.5-1,/10-3/10,0-150,0.3,1-5,1.1-1.2,1.2-1.3,1.5-3,1.8-2.5,1/3-2/3,10-20,11,2-3.8,2.5-3.8,2.5-4,2.8-3.5,3-10,3.4-3.6,4.3-6,6-7,6-9,7-10,7-11,abaxially,accrescent,acuminate,acute,adaxially,ag,along,anthesi,apart,apical-lateral,apparently,articulated,ascending,axe,axillary,ba,base,becoming,berry,blade,blunt-tipped,branch,branched,capitat,chartaceous,closely,continued,dehiscing,densely,distal,dm,due,eaf,echinoi,eed,elliptic,exserted,extend,ferrugineous,few-,few-rayed,first,fleshy,free,glabrescen,glabrous,hair,half,high,indument,inserted,interpetalar,introrse,lacking,lanceolat,large,late,later,lateral,lobe,long,longitudinal,lower,m.,main,many-rayed,matted,midvei,midvein,mixed,nearly,nflorescence,oblong,obscured,obtuse,often,older,orolla,ovate-lanceolate,overlapping,partly,perfect,persistent,pore,porrect-stellate,present,prominent,pubescent,rather,ray,relatively,ripe,rounded,ruit,runk,sessile,short,short-stalked,side,slit,small,somewhat,spaced,sparingly,sparsely,stalked,stamen,stelliform,stout-stalked,strongly,subcoriaceous,suture,tamen,testa,thick,thick-stalked,thin,thin-stalked,time,tissue,tomentu,touching,translucent,tube,unarme,unarmed,unit,usually,vary,vein,warty,way,wide,ympodial,young	30-150,abaxial,adaxial,arrangement,capitate,cell,center,colour,form,height,history,inflorescence,life,na,new,number,ovary,perennial,plant,position,prickle,reproduction,scar,seed,shape,spacing,staman,surface,texture,trichome,width
381	wfo-0001028525	invalid_json_followup	257	147	114	143	33	0.444	.25,0.2-0.3,0.5,0.5-1.5,0.5-2.5,1-2,1-4,1.1-1.7,1/3-3/4,10,10-13,2,2-2.5,3,3-7,4,4-5,6,7-13,acuminate,acute,almost,anther,anthesi,apart,apex,apically,bark,base,black,branch,branched,brown,calyx,capitate,chartaceous,clavate,cm,conical,corolla,dark,dendritic,developed,diameter,dilated,drying,elongated,entire,erect,filament,flattened,flexuous,flower,form,frequently,fruit,fruiting,glabrescent,glabrous,green-brown,grey,inside,lateral,leaf,liana,light,lobed,long,longitudinally,lumpy,margin,mature,mauve,membranous,mm,multicellular-dendritic,obconical,obscuring,orange-brown,outside,ovate,ovoid,partly,pedicel,peduncle,petiole,puberulous,pubescent,pyriform,rachi,red-brown,ridged,scar,scattered,shrub,simple,slender,small,sparsely,spheroidal,stem,stigma,stump,style,surface,terete,terminal,thin,trichome,unarmed,well-developed,whitish,wide,x	.4,0.2-0.6,0°,1-1.5,1-2.5,1.2-1.6,1.5,1.5-3,1mm,2-3,2.5-5,3-5,4-15,4-7,7,7.5,accrescent,age,along,alternate,alyx,apar,apice,apparently,around,articulated,attenuate,axil,becoming,berry,brachyblast,branching,broadly,centre,clearly,clum,clustered,cordate,cup,curved,deeply,delineated,deltoid,dendritic-pubescent,densely,density,detaching,developing,discolorous,divided,domatia-like,dorsal,dorsifixed,eaf,eed,ellipsoi,equal,eye,fertilisation,fewer,fine,flat,flexible,formed,forming,free,frui,increasing,known,lamina,laterally,leave,lengthening,less,like,linear,lobe,longer,loop,loose,lower,m.,main,midvein,minute,much,naked,narrowly,nflorescence,nther,oblong,often,one,orolla,overlapping,pair,pendulous,perfec,pericarp,plurifoliat,pore,poricidal,portion,primary,prominent,protruding,ray,rounded,ruit,sessile,side,sinus,size,slightly,smaller,smoot,smooth,sometimes,somewhat,soon,spreading,stripe,structure,tangling,tearing,tertiary,thick,tip,toward,truncate,tube,ud,uneven,unit,vary,vein,venation,visible,weakly,white,wider,ympodial,young	'',[,``,abaxial,adaxial,arrangement,bud,characteristic,colour,ellipsoid,growth,height,history,inflorescence,length,life,na,new,number,ovary,plant,position,prickle,reproduction,seed,shape,spacing,staman,texture,value,width,{,}
382	wfo-0001028528	invalid_json_followup	155	123	85	70	38	0.548	.5,0.9-1.2,2-4,2.5-3,3/4,4-6,6-10,8-9,abaxial,acute,adaxial,adaxially,along,anther,anthesi,apex,apical,bark,basal,base,bi-lobed,blackish,branch,calyx,cm,conical,corolla,decurrent,dendritic,densely,denser,diameter,elliptic,filament,flattened,flower,fork,fruiting,glabrous,globose,growth,later,leaf,lobed,margin,midvein,minutely,mm,mucronate,narrowly,nodding,obovate,occasionally,outline,ovary,pedicel,pericarp,petal,petiole,pitted,plurifoliate,pubescent,pyramidal,reddish-brown,revolute,round,scar,shiny,short,shrub,somewhat,sparsely,stem,stigma,strongly,style,surface,tapering,terminal,thin,trichome,vein,violet,way,winged	1-2,1.1-1.2,1.5,1.8-2,2-3,3.5-4,3.5-6,4-5,6-7,?,absent,acuminate,age,attenuate,ba,becoming,berry,branching,coriaceous,dichasia,eaf,edicel,eed,erect,ew,except,exserted,free,glabrat,glandular,immature,impressed,inserted,leave,like,lobe,long,lower,m.,minute,nflorescence,older,pair,papillo,per,planar,pore,poricidal,portion,prominent,ruit,secondary,sleeve,slit-like,stamen,ste,tall,time,tip,triangular,tub,tube,ud,unit,white,wide,woody,x,ympodial,young	'',2,4.5,[,``,arrangement,bud,characteristic,colour,form,fruit,glabrate,green,height,history,inflorescence,length,life,na,new,number,papillose,peduncle,perennial,plant,position,prickle,rachi,reproduction,seed,shape,spacing,staman,texture,value,width,{,}
383	wfo-0001028529	success	164	89	61	103	28	0.372	0.1,0.5-2,0.8-1.3,1-1.2,1-1.5,2.5-3,5-6,acuminate,anther,apart,apex,bark,bluish,brown,bud,capitate,cast,cm,corolla,dark,filament,flower,furcate,glabrous,globose,green,hyaline,internodal,lanceolate,leaf,less,lobed,metallic,minutely,mm,narrowly,nearly,oblanceolate,occasionally,opposite,ovary,ovoid-reniform,paler,papillose,pedicel,petiole,pitted,scar,shape,shrub,simple,smooth,somewhat,stigma,style,subshrub,surface,tapering,white,winged,yellowish	.2,0.5,0.8-3,0.8-3.2,1,1.5,2/3,3-40-flowered,3-5,6-9,7-8,8-14,across,acute,age,anthesi,apiculate,attenuate,base,becoming,beginning,beneath,berry,calyx,close,cork,course,decurrent,deflexe,deltoid,dia,distal,eaf,edicel,eed,ellipsoi,elliptic,erect,evenly,exfoliating,exserted,free,fruiting,growing,heterostylous,hrub,immature,indistinct,inflorescenc,lateral,lenticellat,linear,lobe,lon,long,lower,main,major,middle,minor,minute,much,nflorescence,older,one,pair,papillae,papillo,planar,pore,poricidal,portion,present,prominent,range,reflexed,river,ruit,scattered,shaped,short,size,slender,slightly,small,soon,spaced,species,stem,straight,tall,tear-drop,tip,tube,ud,umbonate,variable,vein,way,widest,woody,x,young	3-40,abaxial,adaxial,alternate,arrangement,colour,diameter,form,fruit,growth,height,history,inflorescence,length,lenticellate,life,na,number,peduncle,plant,position,rachi,reproduction,seed,spacing,staman,texture,width
384	wfo-0001028532	success	186	84	57	129	27	0.306	0.2-1,1-2,1-3,1.3-8.7,15-36,17-42,2.2-4.2,3-10,3-5,4-7,5-9,5.5-15,acuminate,acute,anther,apex,chartaceous,clavate,cm,corolla,dark,deep,diameter,filament,flower,forked,fruit,glabrous,globose,green,green-white,greenish,herb,honeycomb-shaped,leaf,medium,mm,moniliform,mucilaginous,odd-pinnate,ovate,ovate-lanceolate,ovoid,pedicel,peduncle,pentagonal,petiole,plant,rotate,seed,stigma,style,terminal,tuber,white,whitish,yellow	0-19,1-1.6,1-1.7,1-5,1.4-1.6,2-3,2-6,2-8,3-7,3.3-4.4,3.9-5,5-merou,6.5-9.2,7.5-15.2,abaxiall,abaxially,acumen,adaxially,ag,along,alyx,apart,apparently,arranged,articulated,asymmetric,attenuate,axe,axillary,base,basiscopic,bead,berry,blade,brownish,bud,capitat,cell,condition,connivent,covering,decreasing,digestion,distal,dorsally,drying,eaf,edge,eed,enzyme,erec,exceeding,flat,folded,fresh,geminat,generally,glabrou,hair-like,half,homostylous,interjected,lanceolate,larger,lateral,leaflet,lengthening,like,linear,living,lobe,long,lower,make,middl,mottled,multiple,necklace,nflorescence,orbicular,orolla,pair,perfect,petiolulate,plurifoliate,pore,poricidal,purple,removed,ripe,rounded,ruit,second,sessile,seudostipule,side,size,slightly,slit,sometimes,spaced,specimen,spot,stamen,stolon,straight,subequal,subtending,symmetric,tall,tamen,tem,testal,thick,throughout,tip,tissue,toward,tri-,tube,typically,unit,unwinged,usually,vary,wall,wet,x,ympodial	abaxial,adaxial,arrangement,capitate,center,colour,form,growth,height,history,inflorescence,length,life,na,number,ovary,perennial,position,pseudostipule,rachi,reproduction,shape,spacing,staman,surface,texture,width
385	wfo-0001028546	success	239	115	84	155	31	0.351	0-1,0.5-0.75,0.5-2,1-2,1-3.5,1-7,1.1-2.2,1.5-1.75,1.5-2,1.5-6,10-14,2-3.5,4-13,4.5-6,7-24,7.5-10,accrescent,acicular,andromonoecious,anther,brown,calyx,capitate,chartaceous,cm,cylindrical,diameter,ellipsoidal,elliptical,erect,extra-axillary,filament,finely,flattened,flower,fruit,fruiting,glabrous,globose,green,inflorescence,leaf,length,lobed,longer,margin,mm,moderately,ovate,pale,pedicel,peduncle,pendent,perennial,petiole,pinkish,plant,prickle,pseudo-racemose,purple,rachi,red,reticulate,rhizomatous,rotate,shallowly,shrub,simple,slightly,somewhat,sparsely,stellate,stellate-pubescent,stigma,straight,style,surface,tan,time,unbranched,white,wide,x,yellow	%,0-0.1,0-0.5,0-18,0-9,0.15-0.25,0.3-0.5,0.3-1,0.4-0.5,0.5-1,0.5-1.3,0.5-1.5,0.6-2,0.8-1.4,1-3,1-4,1-locular,1.1-1.8,10-22,100-150,11-12,120-400,16-24,2-,2-4,2-9,2.3-2.7,2.5-3,2.6-3.4,26-38,3-,3-11,3-4,3-5,3-7,3.5-19,3.5-7.5,4-8,4-9,5-10,5-55,5-8,5-merou,6-10,8-15,8-40,9-16,9.5-19,9.5-24,abaxially,absen,absent,across,acuminate,acute,adaxially,adult,also,alyx,ample,apart,apex,apparen,articulated,attenuate,axe,ba,base,bilobe,blade,branch,branche,connivent,cuneate,deeply,directed,distall,distally,distributed,dm,eaf,eed,eglandular,exocarp,finger,foliate,functional,geminat,gland-tipped,hair,half,heterostylous,incomplete,index,interpetalar,juicy,juvenile,lamina,lanceolate,lateral,less,lobe,lobing,long,lower,main,markedly,mature,mesocarp,mid-point,midpoint,midvein,minute,nflorescence,oblique,obtuse,often,orolla,pair,part,per,placenta,pore,porrect,present,ray,ruit,septum,sessile,short,side,spaced,stalk,stellae,succulent,tal,tamen,tem,thick,thicker,thicknes,throughout,tissu,tissue,triangular,tube,unarme,unarmed,unit,upper,usually,vary,vein,weakly,ympodial	5-merous,abaxial,adaxial,arrangement,bark,bilobed,bud,cell,center,colour,corolla,form,growth,height,history,life,na,new,number,ovary,position,reproduction,scar,seed,shape,spacing,staman,stem,texture,trichome,width
386	wfo-0001028547	invalid_json_followup	224	134	100	124	34	0.446	-3,.2,.5,.7,.8,/2,/5,0-1,0.8-1,1-2.5,1.7-2,10-12,2-4,2-6,3-5,5-merous,abaxial,abaxially,absent,acute,adaxial,anther,apart,apex,appearing,articulated,bark,base,berry,branched,bright,calyx,cell,cm,curved,densely,diameter,dull,elongating,entire,erect,filament,flattened-reniform,flower,fruit,fruiting,glabrescent,glabrous,inflorescence,lateral,leaf,length,lobed,long,long-acuminate,margin,mature,maturity,mauve,mm,moderately,orange,orange-brown,outline,ovate,pedicel,peduncle,petiole,pit,porrect,prickle,purple,raised,red,reddish,reflexed,scar,shallowly,shrub,simple,small,smooth,sometimes,somewhat,spherical,stellate,stellate-pubescent,stem,straight,style,subsessile,surface,terete,terminal,trichome,villous,way,yellow,yellow-green,yellow-orange	-1/2,-13,-6,0,0-10,0-15,0-2,0-30,0-5,0.05-0.15,0.1-0.2,0.15,0.2-0.35,0.3-0.4,0.5-,0.7-1,1-2,1-4,1-5,1.2-1.4,1.5-2.5,1/3,1/5-1/4,2-1.5,2-2.5,2.5-2.8,2.8-3.2,3.5-4.5,4-5,4-6,6-8,7-10,7-9,alyx,apar,ape,apically,apparently,blade,branching,bulbous,chartaceous,conical,connivent,cream,cuneate,dark,deltate,discolorous,distance,drying,eaf,eed,elongate,equal,extending,faint,flattened,free,gently,glabrou,gray-brow,green,infructescence,lobe,lon,long-styled,longer,lower,marking,midpoint,midvein,narrow-deltate,nflorescence,oblong,occasionally,often,older,one,open,orolla,oung,pair,pale,pendulous,per,perfect,pericarp,plurifoliat,poricidal,portion,prickl,prickly,primary,ray,rounded,ruit,scandent,sessile,short-styled,side,slender,spaced,spreading,stalk,stalked,staminate,tamen,tapering,tertiary,thin-acuminat,time,tip,truncate,tube,unit,usually,vary,vein,venation,wide,woody,ympodial,young	'',.15,[,``,arrangement,bud,characteristic,colour,corolla,form,gray-brown,growth,height,history,life,na,new,number,ovary,perennial,plant,position,rachi,reproduction,seed,shape,spacing,staman,stigma,texture,value,width,{,}
387	wfo-0001028548	invalid_json_followup	266	115	68	198	47	0.256	.4,.7,.8,.9,0,3.1,4.9,5.6,acuminate,anther,apart,apex,area,attachment,bark,brown,bud,calyx,central,chartaceous,cm,corolla,densely,developed,diameter,dry,entire,filament,flattened-orbicular,flower,fruit,glabrous,globose,growth,heterostylous,lanceolate,lateral,leaf,length,long,margin,mm,nearly,notched,ovate,pedicel,peduncle,petiole,pitted,point,poorly,probably,pubescent,reddish,short,shrub,simple,smooth,stellate,stem,stigma,straight,style,surface,unknown,wave,white,yellow	.2,.6,.8–2.4,/3,0.06,0.3–0.8,0.4,0.4–0.5,0.4–0.6,0.4–0.7,0.6,0.7–0.8,0.7–1.7,0.8–1.2,0.8–1.9,0.8–2.0,0.8–2.9,0.9–1.2,1.0–4.1,1.1–1.2,1.1–1.4,1.1–1.5,1.3–1.6,1.4–2.3,1.6–2.7,1.7–2.1,1/3,1/3–1/2,2.0,2.2–2.8,2.3,2.4–2.7,2.8,3.1–3.8,3.6–8.1,3.7–4.0,3.8–4.6,4,4–8,5-merou,5.5–6.6,6.4–19.8,6–10,6–9,90°,abaxially,absent,acute,adaxially,adnate,aequilateral,ag,alyx,anthesi,apical,apiculate,apparently,appearing,arching,around,articulate,attenuate,axe,ba,base,berry,blade,branch,branching,broad,brochidodromous,capitat,channeled,clinate,color,congested,cuneate,deciduous,deltoid,dentate,development,difolate,directed,distal,distinct,eaf,edge,eed,either,elliptic,emerging,endocarp,erect,exocarp,extending,extra-axillary,fertile,filiform,flexed,free,geminat,glandular,glossy,gradually,hair,increasing,incurved,intact,internode,interpetalar,intersepalar,juic,juvenile,large,layer,less,lobe,lobed,lon,longer,lower,major,many,mature,midpoint,midrib,midvein,minor,minute,moderately,nflorescence,oblique,oblong,occasionally,opaque,orolla,per,pore,porrect,porrect-stellate,portion,potentially,pubescenc,raised,ray,reflexe,remaining,rigid,rounded,row,scarcely,seen,sessile,short-stipitate,shorter,shortly,side,sinus,sloughing,smoot,somewhat,soon,sparsely,splitting,spread,spreading,stamen,stellae,stellate-pubescent,stipe,suture,swelling,tamen,tem,thin,time,tip,tissue,transparent,truncate,tube,two,ud,unarmed,unbranched,upper,various,vary,vein,weakly,wide,yellow-ferruginous,ympodia,young,±90°,±equal,±glabrous,×	'',0.7-0.8,0.8-1.9,0.8-2.9,0.9-1.2,1.0-4.1,1.1-1.2,1.1-1.5,2.2-2.8,5-merous,[,``,abaxial,adaxial,arrangement,capitate,center,characteristic,colour,form,fruiting,height,history,inflorescence,life,na,new,number,ovary,perennial,plant,position,prickle,rachi,reproduction,scar,seed,shape,spacing,staman,texture,trichome,value,width,x,{,}
388	wfo-0001028551	success	243	117	75	168	42	0.309	.0,.6,.8,0,2,2.5,acuminate,alveolate,anther,apart,apex,attachment,broad-based,bud,calyx,chartaceous,cm,conical,corolla,dark,deltate,diameter,dry,elliptic,entire,extra-axillary,filament,flattened-suborbicular,flower,forking,fruit,glabrous,glandular,globose,green,hair,interpetalar,lanceolate,lateral,leaf,lilac,margin,maturing,mm,narrowly,nearly,notched,oblong,pedicel,petiole,point,poorly-developed,prickle,red,shrub,simple,slender,smooth,somewhat,stellate,stigma,straight,style,subcoriaceous,tan,tissue,tree,triangular,unbranched,violet,wavy,white,yellow,±globose,×	.06,.1,.3–0.5,.5,0.4–0.5,0.5–0.6,0.7–1.0,0.7–2.3,0.8–1.4,1.0,1.0–1.5,1.0–1.6,1.1,1.1–1.4,1.1–2.2,1.3,1.4–2.0,1.5–1.8,1.5–1.9,1.6–1.7,1.7,1.7–2.6,1.8–2.5,1/3,2.0–2.6,2.0–3.5,2.0–3.7,2.2–3.4,2.2–5.2,2.2–7.5,2.3–3.4,2.75–4.0,3/4,4.2–5.9,4.5–7.0,4–6-merou,5–11,7.5–10.5,8.0–11.4,8.0–12.0,8.5–20.5,9.0,abaxially,adaxially,adnate,aequilateral,almost,alyx,anthesi,apical,apiculate,apparently,appearing,area,armed,articulated,attenuate,axe,ba,base,becoming,berry,blade,branch,brochidodromous,capitat,caudate,central,channeled,closely,connivent,continuing,cuneate,dehiscence,densely,dentate,development,difoliate,distally,distinctly,dorsally,eaf,eed,either,endocarp,enlargement,entir,equal,exocarp,fertile,filiform,free,frui,geminat,glabrou,gradually,homostylous,immature,inclined,increasing,internode,juic,lacking,large,line,lobe,lobed,lon,long,longer,lower,major,markedly,mature,midrib,midvein,minor,minute,nflorescence,numerous,oblique,occasionally,orolla,outline,pore,porrect,portion,potentially,prominent,pseudo-peduncle,pubescent,ripe,row,ruit,scattered,shiny,side,sinus,spaced,split,splitting,spread,stamen,stellae,stellate-pubescent,suture,tamen,tem,thin,time,tip,toward,tube,two,typically,ud,unarme,unarmed,upper,vary,vein,weakly,wide,yellow-ferruginou,ympodia,young,±appressed,–4.8	0.7-2.3,1.1-1.4,1.4-2.0,1.6-1.7,2.0-3.5,4.2-5.9,abaxial,adaxial,arrangement,bark,capitate,cell,center,colour,form,fruiting,growth,height,history,inflorescence,length,life,na,new,number,ovary,peduncle,plant,position,rachi,reproduction,scar,seed,shape,spacing,staman,stem,surface,texture,trichome,width,yellow-ferruginous
389	wfo-0001028558	success	224	116	88	136	28	0.393	/6,0.4-1.5,0.5-0.9,0.5-2,0.8-1.5,1-1.3,1-4,1-9,1.5-2.3,1.5-6,1/3-1/2,1/4,2-5,2.4-3,3-8,3-9,4.2-7,6-7.5,acute,almost,andromonoecious,anther,apart,apex,bark,base,branched,calyx,chartaceous,cm,conical,cream,curved,dark,densely,diameter,dull,elongating,entire,filament,flattened,flattened-reniform,fruit,fruiting,glabrescent,glabrous,green,herb,leaf,length,lobed,long,long-styled,margin,marking,mature,maturity,mauve,mm,often,orange-brown,ovate,pale,pedicel,peduncle,petiole,plant,prickle,rounded,scar,short-styled,shrub,simple,spherical,stellate,stellate-pubescent,stem,straight,style,surface,terete,trichome,upper,way,wide,yellow,yellowish,young	-2,-5,.5,0-10,0-30,0-4,0-5,0.1,0.1-0.3,0.1-0.4,0.15-0.5,0.2,0.6,00-200,1,1-3,1.3-1.8,1.5-2.5,1.5-3,1.8-2.3,1/3,1/4-1/3,15-60,2.2-2.8,2.5-3.5,2.5-5,3-,3-50,3/,4,4-15,4.5-8,5-10,5-60,5-7,5-merous,6-10,6-20,6-22,6-9,7-10,8-12,abaxially,adaxially,alyx,ame,apar,apically,apparently,articulated,berry,blade,broad-deltate,c.,clearly,concolorous,connivent,cordate,deltate,discolorous,distal,distance,drying,eaf,eed,elongated,equal,erect,extending,flower,free,gently,gra,hermaphrodite,heterostylous,infructescence,lateral,least,lobe,longer,lower,lowermost,midpoint,midvein,moderately,multangulate,narrow-deltate,nflorescence,obtu,older,one,open,orolla,oung,pair,pendent,pendulous,per,pericarp,plurifoliat,poricidal,porrect,portion,prickl,prickly,primary,ray,reflexed,ruit,sessile,side,smooth,spaced,sparsely,spreading,stalk,stalked,staminat,stout,tamen,tapering,terminal,tertiary,time,tip,tube,unarmed,unit,variously,vary,vein,venation,visible,weakly,woody,ympodial	/,abaxial,adaxial,arrangement,bud,cell,center,colour,corolla,form,gray,growth,height,history,inflorescence,life,na,new,ovary,pellate-pubescent,perennial,reproduction,seed,shape,spacing,staman,texture,width
390	wfo-0001028571	success	230	119	69	161	50	0.3	0.4,2,2.5,absent,accrescent,acute,anther,apex,base,broadly,brown,calyx,cell,cm,dark,diameter,elongated,entire,erect,extra-axillary,filament,finely,flattened,flower,fruit,fruiting,gland-tipped,glandular-puberulent,globose,highly,length,light,lobe,lobed,margin,minutely,mm,nearly,ovate,pair,pale,pedicel,peduncle,petiole,prickle,pubescent,rachi,rounded,shallow,shrub,similar,simple,somewhat,sparsely,spreading,stellate,stem,stigma,straight,style,surface,terete,thin-textured,tip,unbranched,undulate,white,x,yellow	'',.1,.2,.5,/3,0.2–0.4,0.3–0.4,0.3–0.6,0.4–0.8,0.5–1,0.6–0.8,0.6–1.4,0.75–4,0.9–1.7,0–,1,1.1-1.4,1.5–2.4,1.7–2.6,1/2,1/3,10–21,11–12,12,13–25,18,1–1.4,1–1.5,1–2,1–5,2-foliate,2.5–15,2–10,2–3.4,3,3.4–3.7,3.5–16,3–13,3–5-celled,3–7.5,3–8,4-rayed,40–80,4–10,4–15,5,5.2–9.2,5–15,5–8,62,7–16,8–12,8–14,8–15,9,=,``,abaxially,acicular,adaxially,almost,also,apical,average,axe,ba,bacca,blade,capitat,compressed,contiguou,cordate,cover,curved,cylindrical,dense,densely,differing,dilated,dimorphic,directed,distall,divided,eaf,eed,enlarged,especially,exclusively,extreme,fertile,fewer,free,geminat,geminate,glabrou,gland,glaziou,hair,half,hyaline,interlocking,lanceolate,larger,linear,long,longer,longest,lower,lutea,marginal,matura,maturing,merely,minute,multangulate,n,narrowly,near,nflorescence,one,orolla,p,per,perhaps,pore,proportion,pubescence,ray,recurved,ruit,scattered,sessile,size,slender,small,smaller,stellae,stipitate,stout,summit,surrounded,tal,tamen,tem,time,tomentose,triangular,tube,unarmed,unit,usually,variable,vary,varying,vestigial,visible,wide,wing,ympodial,–1.6,–19	0.2-0.4,0.3-0.4,0.3-0.6,0.75-4,0.9-1.7,1-1.4,1-2,1-5,1.7-2.6,10-21,11-12,13-25,3-8,4-15,5.2-9.2,8-15,abaxial,adaxial,arrangement,bark,bud,capitate,center,colour,contiguous,corolla,form,glabrous,growth,height,history,inflorescence,leaf,life,na,new,number,ovary,perennial,plant,position,reproduction,scar,seed,shape,spacing,staman,texture,trichome,width
391	wfo-0001028583	success	294	117	82	212	35	0.279	.0,.5,.9,0,0.13,4,acute,anther,apex,bark,bent,branching,brown,bud,capitate,central,chartaceous,cm,corolla,deeply,densely,developed,diameter,dry,evenly,extra-axillary,ferruginous,filament,flattened-reniform,flower,fruit,glabrous,globose,green,heterostylous,interpetalar,lateral,leaf,lightly,lobed,long,margin,mature,mm,oblong,orange,ovate,pedicel,peduncle,petiole,pitted,poorly,porrect,portion,pubescent,purple,red,red-brown,reddish,short,shot,shrub,simple,sinuate,stellae,stellate,stellate-pubescent,stigma,stipitate,straight,style,subacute,subcoriaceous,surface,time,tissue,unbranched,vein,white,yellow,yellow-ferruginous,±90°	.2,.6,0.01,0.06,0.08,0.2–0.6,0.3–0.6,0.4,0.4–0.6,0.6,0.6–0.9,0.6–1.0,0.6–1.3,0.6–2.2,0.8–1.2,0.8–1.4,0.8–1.5,0.9–1.3,0.9–1.5,1.0–1.2,1.0–2.1,1.1–7.7,1.2–1.9,1.4,1.4–1.5,1.4–1.9,1.4–4.7,1.5–2.4,1.5–3.1,1.8–2.3,1.9–2.6,1.9–3.2,1/2,1/3,1/3–1/2,2.0,2.2–3.1,2.3,2.3–6.8,2.5–2.9,2.6,2.6–3.7,2.6–4.8,2/3,3.1–4.0,3.2–6.2,3.5–3.8,4.3,4–8,5-merou,5.1–15.4,5.2,5.2–6.3,5.7,5–9,6.3,6.5–16.0,6.9–9.2,6–8,7.0–1.4,abaxially,absent,adaxially,adnate,aequilateral,ag,alyx,anthesi,apart,ape,apical,apparently,appearing,appressed,around,articulate,attenuate,axe,ba,basal,base,based,berry,blade,borne,branch,broad,calyx,channeled,congested,craspedodromous,cuneate,deciduous,deltate,deltoid,dentate,difoliate,directed,distal,distinct,eaf,edge,eed,either,emerging,endocarp,erect,exocarp,extending,fertile,filiform,flexed,free,geminate,glandular,glossy,gradually,gree,hair,immature,immediately,increasing,incurved,individually,intact,internode,intersepalar,juic,lanceolate,large,layer,lobe,lon,longer,lower,major,many,midpoint,midrib,midvein,minor,minute,moderately,narrowly,nearly,nflorescence,oblique,occasionally,opaque,orolla,per,perforated,pore,porrect-stellate,potentially,present,prickle,primary,pubescence,raised,ray,red-orang,reflexed,remaining,restricted,ridge,rigid,rounded,row,ruit,scattered,secondary,semicraspedodromous,sessile,several,shorter,side,sinus,slightly,sloughing,somewhat,spaced,sparsely,splitting,spread,spreading,stamen,stem,stipe,suture,tamen,tardily,tem,thin,tip,toward,transparent,triangular,truncate,tube,two,ud,unarmed,upper,vary,well,wide,ympodia,young,±equal,±erect,×	0.8-1.2,1.0-2.1,1.1-7.7,1.4-1.9,1.4-4.7,1.8-2.3,5-merous,6.5-16.0,7.0-14.0,abaxial,adaxial,arrangement,colour,form,growth,height,history,inflorescence,length,life,na,number,ovary,perennial,plant,position,rachi,reproduction,seed,shape,spacing,staman,stipule,texture,width
392	wfo-0001028587	success	178	101	71	107	30	0.399	.5,0.3,0.3-1,0.7-1.2,0.8-1.8,1-1.3,1-4,6-8,8-10,acuminate,acute,anther,apex,bark,base,becoming,brown,calyx,closely,cm,corolla,cup,densely,ellipsoid,filament,flower,fruit,fruiting,geminate,glabrous,globose,green,greenish-white,leaf,length,lobed,minutely,mm,nearly,obovate,obovoid,often,open,opposite,ovary,ovate,ovoid-reniform,papillose,pedicel,petiole,pitted,pubescent,pubesent,scar,scattered,seed,shrub,simple,slender,spaced,sparsely,stem,stiff,stigma,style,surface,thin,trichome,unicellular,uniseriate,white	.4,.75,0,0.5,0.5-1,0.8-1.6,0.8-2.9,1-1.5,1-2,1.3-5.1,1/4,2-5,2.1-6.9,2.5,3-8,6.5-17.7,8-10-flowered,abruptly,accrescent,across,anthesi,baseflower,berry,ca,chartaceou,coat,cracking,deflexed,degree,dia,different,difoliate,distal,drying,eaf,edicel,eed,erect,forming,free,geminat,impressed,keeled,lamina,lateral,layer,like,lobe,lon,long,long-styled,lower,main,major,middle,midrib,minor,minute,narrowing,nflorescence,obe,occasionally,older,outer,overlappin,pair,paler,papillo,peeling,per,persistent,pore,poricidal,portion,puberulent,pubescence,reflexed,ruit,short,slightly,slit-like,straight,straw-colored,subumbellate,tall,terminal,thickened,tip,transversel,triangular,tube,two,type,ud,umbonate,unit,upon,upper,usually,variable,vein,wide,widest,woody,x,ympodial,young	abaxial,adaxial,arrangement,bud,cell,center,chartaceous,colour,diameter,form,growth,height,history,inflorescence,life,na,new,number,overlapping,peduncle,perennial,plant,position,rachi,reproduction,shape,spacing,staman,texture,width
393	wfo-0001028594	invalid_json_followup	142	111	74	68	37	0.521	.5,0.3-1.0,0.8-1.8,1-1.2,1.5-9,12,12-14,2,3-4,3-6,abaxially,acuminate,anther,apex,axillary,black,bottle-shaped,calyx,cm,conical,corolla,densely,diameter,drying,elliptic,especially,filament,flattened-reniform,flower,fruit,fruiting,glabrous,globose,green,hair-like,herb,immature,inflorescence,leaf,length,long,margin,maturity,minute,minutely,mm,orange-brown,ovary,ovate,pedicel,pendent,petiole,planar,projection,pubescent,purple,rectangular,reddish,reflexed,regular,rounded,scar,simple,slightly,smooth,somewhat,sparsely,stigma,style,surface,trichome,uniseriate,violet,x	0-100,1-1.3,1-1.5,1-2,1-3,3-9,5-6,6-20,6-7,acute,adaxially,along,anthesi,axil,base,bearing,becoming,berry,capitat,cell,climbing,denser,eaf,edicel,eed,ellipsoid,epidermal,exserted,floo,forest,free,glabrat,inflorescenc,lax,like,lobe,lon,lower,nflorescence,noddin,obtuse,often,open,pair,papillate,per,portion,primary,quit,rest,ruit,scattered,side,soft,spreading,strait,strongly,tem,time,tip,trailing,tub,tube,ud,unifoliat,unit,vein,ympodial	'',[,``,abaxial,adaxial,arrangement,bark,bud,capitate,center,characteristic,colour,form,growth,height,history,life,na,new,number,peduncle,perennial,plant,position,prickle,rachi,reproduction,seed,shape,spacing,staman,stem,texture,value,width,{,}
394	wfo-0001028660	invalid_json_followup	204	102	61	143	41	0.299	0.5-2.8,0.5-5.5,0.9-2.5,1-10,1-2,1.5-2.8,2-11,2-9,3-30,3-9,4-6,7-10,abaxially,adaxially,anther,apex,blue,bud,clavate,cm,corolla,diameter,elliptic,entirely,filament,flower,forked,fruit,glabrous,globose,green,greenish,herb,linear,margin,minutely,mm,mucilaginous,narrowly,odd-pinnate,ovoid,pedicel,peduncle,pentagonal,petiole,plant,puberulent,pubescent,purple,rotate,seed,stem,stigma,style,substellate,terminal,tinged,tuber,white,whitish,yellow	0-5,0.1-0.3,0.2-1.1,0.3-1.1,0.7-4.2,0.8-1,1.5-4,1.5-7.6,2-5,2-6,20,3-5,3-7,3.8-13,5-8,5-merou,6,absent,acumen,acute,ag,along,alyx,apart,apparently,articulated,attenuate,axe,axillary,base,berry,blade,borne,broadly,brownish,capitat,cell,chartaceous,ciliate,condition,connivent,covering,decumbent,decurrent,densely,digestion,distal,dorsally,dot,drying,eaf,edge,eed,end,enzyme,erec,especially,exceeding,except,flat,folded,fresh,geminat,generally,glabrou,greatly,green-white,hair,hair-like,half,homostylous,honeycomb-shaped,interjected,lanceolate,lateral,leaflet,lengthening,less,like,living,lobe,long,lower,make,membranous,middl,midrib,nflorescence,oblique,obtuse,often,orbicular,orolla,ovate,pair,perfect,petiolulate,petiolule,plurifoliate,pore,poricidal,proximal,rarely,reduced,removed,ripe,ruit,scabrous,scattered,sessile,seudostipule,short,singly,size,slit,spaced,sparsely,specimen,stamen,ste,stolo,straight,subequal,subtending,sunny,tall,tamen,tem,testal,thick,throughout,tip,tri-,tube,typically,unit,unwinged,usually,vary,wall,wet,x,ympodial	'',[,``,abaxial,adaxial,arrangement,bark,calyx,capitate,characteristic,colour,form,fruiting,growth,height,history,inflorescence,leaf,length,life,na,new,number,ovary,perennial,position,prickle,pseudostipule,rachi,reproduction,scar,shape,spacing,staman,surface,texture,trichome,value,width,{,}
395	wfo-0001028666	invalid_json_followup	159	110	68	91	42	0.428	0-2,0.3-0.6,0.4-0.8,0.7-0.8,1-2,3-4.5,4-5,5-11,7-11,7-9,abaxially,absent,accrescent,adaxially,anther,apex,articulated,base,calyx,chartaceous,cm,cordate,densely,diameter,ellipsoidal,entire,erect,extra-axillary,flower,fruit,fruiting,glabrous,gland-tipped,grey-green,hair,inflorescence,lanceolate,lavender,length,long,margin,mm,moderately,obtuse,ovate,pale,pedicel,peduncle,perennial,petiole,prickle,purple,red,rhizomatous,scattered,short,shrub,simple,stellate,stellate-pubescent,stigma,style,thick,throughout,unbranched,white,yellow,yellowish	%,0-0.1,0.05-0.1,0.1-0.15,0.2-0.25,0.2-0.3,0.25-0.4,0.3-0.45,0.8-2,1,1-1.5,1-locular,11-19,2.2-2.3,2.5-5,2.5-7,2.6-4.2,3-4,3-6,4-5-merou,4-5.5,7-8,absen,across,acute,adaxiall,alyx,apart,apparen,axe,ba,blade,brown,capitat,connivent,cylindrical,directed,distall,distributed,eaf,eed,eglandular,elliptic,exceeding,exocarp,finger,incomplete,juicy,lamina,lateral,lobe,lower,mature,mesocarp,midpoint,minute,nflorescence,oblique,orolla,part,per,perfect,placenta,pore,porrect,pseudo-umbellate,pubescent,ray,ruit,septum,sessile,solitary,somewhat,spaced,stalk,stellae,succulent,tal,tamen,tem,time,transparent,tube,unarme,unarmed,unit,unknow,vary,wide,x,ympodial	'',[,``,abaxial,adaxial,arrangement,bark,bud,capitate,cell,center,characteristic,colour,corolla,filament,form,growth,height,history,leaf,life,na,new,number,ovary,plant,position,rachi,reproduction,scar,seed,shape,spacing,staman,stem,surface,texture,trichome,value,width,{,}
396	wfo-0001028667	success	129	89	58	71	31	0.45	-2.6,0.4-0.7,0.7-4,1-1.5,1-6,1.3-2,5-20,acute,apex,axillary,branched,calyx,cell,cm,completely,corolla,creamy,diameter,dry,ellipsoid,elliptic,entire,exfoliating,flattened,flower,fruiting,glabrous,growth,inflorescence,irregularly,leaf,margin,minutely,narrowly,new,pale,pedicel,peduncle,petiole,pitted,reniform,scar,shiny,shoot,short,simple,slender,spaced,stem,straw-colored,surface,terminal,twice,vine,white,woody,wrinkling,yellow	.5,1-2-1.5,1-4.5,3,3-11,5,5-merou,8-10,aid,alyx,anthesi,apar,appearing,ark,around,articulated,base,berry,branch,climbin,climbing,clustered,conical,coriaceous,curling,deciduous,discolorous,eaf,eed,exfoliatin,exserted,fide,fragrant,like,lobe,long,lower,mentz,midrib,mm,nflorescence,occasionally,older,orolla,other,outer,papilla,papillat,pendan,per,perfect,plurifoliat,primary,revolute,sleeve,slightly,small,soon,strongly,support,tem,tip,triangular,tube,twining,ud,unit,vein,visible,x,ympodial	abaxial,adaxial,anther,arrangement,bark,bud,center,colour,filament,form,fruit,height,history,length,life,na,number,ovary,plant,position,rachi,reproduction,seed,shape,spacing,staman,stigma,style,texture,trichome,width
397	wfo-0001028672	success	207	114	84	123	30	0.406	.5,0-13,0.5-0.7,0.5-1,0.5-1.2,0.5-5,0.7-3,0.8-1,1-2,1-3,1.8-2.5,1/4,2.5-3.5,3-8,9-15,abaxially,almost,andromonoecious,anther,apart,bark,berry,black,branched,calyx,cm,connivent,cream,dark,diameter,erect,filament,flattened,flattened-reniform,flower,fruit,fruiting,glabrescent,glabrous,gray,green,lateral,leaf,length,lobed,long,lower,margin,marking,maturity,mauve,mm,moderately,orange-brown,ovate,pale,pedicel,peduncle,petiole,plant,poricidal,prickle,reflexed,rotate,scar,shrub,simple,sparsely,spherical,stellate-pubescent,stem,straight,style,surface,tapering,terete,terminal,tip,trichome,upper,yellow,yellow-green,yellow-orange,young	-6,-merous,/4,0,0-15,0-150,0-5,0.2,0.2-0.4,0.2-0.7,0.3-1,1,1.3-8,1.5-2.2,1.5-3,1.8-2.2,1/,1/4-1/3,2-10,2-20,2-3,2-30,2.4-2.8,2.5-12,3-5,4-6,4-8,5,5-10,5-8,6-12,acut,acute,adaxially,alyx,ame,apar,apex,apically,apparently,articulated,base,blade,broad,broad-deltate,brow,c.,chartaceous,concolorous,deltate,difoliate,discolorous,distal,distance,drying,eaf,eed,elongated,elongating,equal,extending,free,geminat,hair,hermaphrodite,heterostylous,infructescence,lobe,long-styled,longer,lowermost,mature,midpoint,midvein,minute,nflorescence,obtuse,older,one,open,orolla,oung,pair,pendulous,per,pericarp,porrect,portion,prickl,prickly,primary,ray,rounded,ruit,sessile,short-styled,side,smooth,sometimes,spaced,spreading,stalk,stalked,staminat,tamen,tertiary,time,translucent,truncate,tube,unarmed,unit,usually,variously,vary,vein,venation,visible,way,weakly,wide,woody,ympodial	1/2,abaxial,adaxial,arrangement,brown,bud,cell,center,colour,corolla,form,growth,height,history,inflorescence,life,na,new,number,ovary,perennial,position,reproduction,seed,shape,spacing,staman,stigma,texture,width
398	wfo-0001028674	invalid_json_followup	196	129	97	99	32	0.495	0.1,0.5-0.8,0.7-1,1-2,1-3,1.5-3,10-15,10-30,2-2.5,2-3,2-5.5,3-11,3-4-lobed,5-7,abaxially,acuminate,acute,adaxial,angulate,anther,apex,apiculate,bark,base,branching,brown,c.,calyx,campanulate,chartaceous,cm,conical,corolla,cream,dark,densely,diameter,elliptic,entire,filament,flattened,flower,fruit,fruiting,glabrescent,glabrous,glandular,glandular-pubescent,globose,green,greenish,growth,heterostylous,leaf,leaf-opposed,lenticular,lobed,margin,maturing,mm,new,ovary,pedicel,peduncle,petiole,plant,prickle,reddish,reniform,reticulate,scar,scattered,shrub,simple,slightly,sparsely,stellate,stellate-pubescent,stem,stigma,style,subcapitate,subglobose,surface,terete,time,tomentose,trichome,variegated,way,white,whitish,woody,x,yellow,yellowish,young	-1,0.2-0.25,0.2-0.3,0.5-0.7,0.7-1.0,1-1.5,1/3,1/4,2.5-3,3-10,3-3.5,4-4.2,4-5,5-6,8-10,adaxially,armed,articulate,attenuate,basal,berry,blade,branched,brow,caly,confined,coriaceous,curved,directed,distal,distally,eaf,eed,eglandular,erec,erect,especially,exserted,face,fewer,free,glandular-puberulent,hirsute,juvenile,larger,lateral,laterally,leave,lengthening,like,linear-lanceolate,lobe,long-styled,lower,midpoint,minute,much,mucilaginous,nflorescence,ochraceous,older,one,partially,perfect,pericarp,plurifoliat,pore,poricidal,porrect,portion,prickly,pubescent,raise,ray,recurved,reduced,rounded,ruit,rusty,sessile,shallowly,short-styled,similar,staminate,stellate-tomentose,straight,subsessile,tapering,testa,thick,tip,triangular-lanceolate,tube,ud,unarmed,unicellular,unit,upper,ympodial	'',[,``,abaxial,arrangement,bud,center,characteristic,colour,dense,form,height,history,inflorescence,length,life,na,number,perennial,position,rachi,raised,reproduction,seed,shape,spacing,staman,texture,value,width,{,}
399	wfo-0001028680	invalid_json_followup	236	146	93	143	53	0.394	.0,.3,.5,.8,0.9,1,1.2,abaxially,adaxially,anther,apex,apiculate,appearing,attachment,bark,base,based,broad,brown,calyx,cm,coriaceous,corolla,deltoid,developed,diameter,distal,dry,elliptic,entire,extra-axillary,fast,filament,flattened-orbicular,flattened-reniform,flower,fruit,glabrous,globose,gradually,growth,hair,homostylous,increasing,interpetalar,lanceolate,lateral,lobe,long,margin,mature,mm,nearly,notched,obtuse,occasionally,ovate,pedicel,petiole,pitted,point,poorly,porrect,prickle,pubescent,rachi,reddish,retrorse,scattered,sessile,shoot,short,shrub,simple,sinuate,slightly,sparsely,stellae,stellate,stem,stigma,style,surface,terminal,tip,tissue,toward,truncate,unbranched,white,yellow,yellow-tan,young	.2,0.2–0.3,0.3–2.1,0.4,0.5–0.8,0.5–2.3,0.9–1.0,0.9–1.2,1.1,1.1–6.5,1.2–2.2,1.4–1.8,1.6–2.5,1.7–2.1,1.7–2.2,1.9–2.4,1/2,1/3,1/4–1/3,1–2,2.1–3.0,2.2–2.5,2.2–3.0,2–3,3.2–3.5,3.8–4.6,4.3–5.9,4–5,4–5-merou,5.2–7.2,6–8,?,acuminate,adnate,aequilateral,ag,alyx,anthesi,apical,apparently,appresse,around,articulate,attenuate,ba,berry,blade,borne,brochidodromous,capitat,channeled,connivent,dentate,development,directed,distally,distinct,eaf,edge,eed,either,emerging,endocarp,exocarp,extending,fertile,filiform,flexed,free,glandular,glossy,hort,individually,intact,internode,intersepalar,isolated,juic,layer,limp,lon,longer,lower,many,markedly,middle,midpoint,midrib,midvein,minute,nflorescence,opaque,orolla,per,perforated,plurifoliate,pore,portion,potentially,presen,raised,ray,remaining,revolute,rounded,ruit,see,shorter,shortly,side,sinus,sloughing,sometimes,splitting,spread,stamen,straight,sub-cordate,suture,tamen,tem,thin,time,transparent,tube,typically,ud,unarmed,vary,vein,weakly,wide,yellow-ferruginou,ympodia,±90°,±absent,±equal,±glabrous,±straight,×,–1.75,–3,–6	'',0.3\u20132.1,0.9\u20131.0,1.7\u20132.1,1.7\u20132.2,1/4\u20131/3,1\u20132,2.1\u20133.0,3.8\u20134.6,4\u20135-merous,[,\u00b1absent,\u00d7,\u20131.75,\u20133,``,abaxial,adaxial,arrangement,bud,capitate,center,characteristic,colour,form,fruiting,height,history,inflorescence,leaf,length,life,na,new,number,ovary,peduncle,perennial,plant,position,reproduction,scar,seed,shape,spacing,staman,texture,trichome,value,width,yellow-ferruginous,{,}
400	wfo-0001028688	success	137	97	67	70	30	0.489	.5,0.4-1,0.5,0.5-0.75,0.5-1,0.5-1.5,0.9-1,1-5,1.1-1.2,2-3,5-6,acuminate,along,anther,apex,area,bark,base,beneath,calyx,cm,corolla,curl-tipped,deltoid,densest,dia,elliptic,filament,furcate,glabrous,globose,golden,lanceolate,leaf,lobed,mm,near,nearly,occasionally,opposite,ovary,overtopping,papillose,pedicel,petiole,pilose,pore,poricidal,pubescent,reddish-brown,shaped,shiny,shoot,shrub,slender,sparsely,stem,stigma,style,tapering,tear-drop,tip,trichome,tube,vein,white,wide	1-1.5,1-1.8,1-3,1.4-2.8,2.2-4.8,5-11,across,acute,anthesi,apar,bi-cellular,branch,clavate,deciduous,decreasing,deflexed,densely,differing,difoliate,eaf,edicel,eed,exfoliatin,exserted,free,geminat,interpetalar,irregularly,know,known,like,lobe,lon,long,lower,major,markedly,membraneous,middle,minor,minutely,nflorescence,often,older,paler,planar,portion,proximal,ruit,scar,sinus,size,slightly,soon,spaced,straight,styl,tall,terminal,thickened,thin,tub,ud,uniseriate,unit,usually,widest,x,ympodial,young	abaxial,adaxial,apart,arrangement,bud,colour,diameter,flower,form,fruit,growth,height,history,inflorescence,length,life,na,number,peduncle,plant,position,rachi,reproduction,seed,shape,spacing,staman,surface,texture,width
401	wfo-0001028690	success	191	99	65	126	34	0.34	0-0.5,0.3-2.5,0.8-2,1-7,2-7,4-7,4-9,8-9,9-13,accrescent,acute,andromonoecious,anther,apex,calyx,chartaceous,cm,densely,diameter,entire,erect,extra-axillary,flower,fruit,fruiting,glabrous,globose,green,grey-green,inflorescence,lanceolate,leaf,length,lobed,longer,margin,mm,moderately,ovate,pale,pedicel,peduncle,perennial,petiole,plant,prickle,pseudo-racemose,pseudo-umbellate,purple,rhizomatous,shallowly,shrub,simple,somewhat,sparsely,stellate-pubescent,stigma,straight,style,surface,time,weakly,white,wide,yellow	%,.3,0-0.1,0-0.2,0-5,0-7,0.05-0.1,0.1-0.2,0.15-0.25,0.2-0.6,0.25-0.4,0.3-0.5,0.3-0.7,0.4-0.6,0.5-0.8,0.5-1,0.5-6,0.8-1,1-2,1-5,1.3-6.5,1.5-1.7,2-3,2-locular,2.1-4.5,2.3-2.8,3-4.5,30-50,4-10,4-5.5.5,4.5-16.5,5-6,5-merou,5.5-6,6-8,7-10,7-30,7-8,9.5-14,abaxially,absen,absent,across,adaxiall,adaxially,adult,alyx,apart,articulated,ascending,attenuate,axe,ba,base,blade,branch,branche,broad-based,capitat,connivent,cross-section,cuneate,cylindrical,directed,distall,distributed,dm,eaf,eed,eglandular,exocarp,finger,functional,geminat,gland-tipped,hair,half,heterostylous,juicy,juvenile,lamina,lateral,less,linea,lobe,long,lower,mature,mesocarp,mid-point,midpoint,minute,moist,nflorescence,oblique,obtuse,orolla,pair,part,per,placenta,pore,porrect,present,ray,ruit,sessile,short,spaced,stalk,stellae,stellate,tal,tamen,tem,thick,throughout,tube,unarme,unarmed,unbranched,unit,upper,vary,x,ympodial	4-5.5,5-merous,abaxial,adaxial,arrangement,bark,bud,capitate,cell,center,colour,corolla,filament,form,growth,height,history,life,linear,na,new,number,ovary,position,reproduction,scar,seed,shape,spacing,staman,stem,texture,trichome,width
402	wfo-0001028696	invalid_json_followup	224	113	60	164	53	0.268	abaxially,acicular,acuminate,adaxially,anther,apex,asymmetric,blue,broadly,calyx,cm,coarsely,diameter,entire,filament,finely,flower,fruit,fruiting,glabrous,gland-tipped,glandular,globose,hair,hirsute,lavender,length,lenticular,lobed,margin,mm,orange,ovate,ovoid,pedicel,peduncle,petiole,pilose,pitted,plump,prickle,reniform,repand,rotate-pentagonal,shiny,shrub,simple,sinuate,stellate,stellate-hirsute,stellate-pubescent,stem,stigma,style,subterminal,surface,tan,trichome,woolly,yellow	.5,0.8–,1.5–4,12–20,15–17,15–30,1–2,1–4,1–6,2.4,2.5,2.8–3.5,2–2.3,2–5,2–7,3.5–5.5,3–5,3–6.5,4–5,4–7,5,5-merou,5–15,6–13,6–8,7–8,7–9,8–13,8–20,9–10,9–12,accrescent,adaxiall,along,alyx,ample,anthesi,apart,apparently,armed,articulated,ascending,attenuate,axe,ba,base,bifi,blade,borne,branch,branched,bristle,bristle-like,bristly,chartaceous,color,connivent,cordate,deltoid,densely,density,developed,difoliate,directed,distally,diverse,drie,eaf,eed,elongate,erect,geminat,glabrou,gland,homostylous,intergrading,intermixed,internode,interpetalar,known,lamina,larger,lateral,like,linear-caudate,linear-lanceolate,lobe,lon,long,long-stipitate,longitudinally,lower,mature,middle,midpoint,midvein,midzone,moderately,narrowly,near,nflorescence,numerous,oblong,obtuse,occasionally,often,one,orolla,overtopped,per,perfect,pericarp,pore,prickly,principal,prominent,pubescence,pubescent,ray,reflexed,resembling,ruit,scattered,sessile,several-celled,short,short-,shorter,side,slender,slightly,small,smaller,sometimes,somewhat,soon,spaced,sparser,splitting,spreading,stalked,stellae,stellate-pilose,tall,tamen,tem,tippe,tipped,tissue,toothed,truncate,tube,ud,ultimate,vary,varying,vein,weakly,well,wide,widely,ympodia,young,×	'',0.5,1,1-6,1.5-4,12-20,15-30,2-2.3,2-7,3.5-5.5,5-15,7-8,9-10,9-12,[,``,abaxial,adaxial,arrangement,bark,bifid,bud,cell,center,characteristic,colour,corolla,form,growth,height,history,inflorescence,leaf,life,na,new,number,ovary,plant,position,rachi,reproduction,scar,seed,shape,spacing,staman,texture,value,width,x,{,}
403	wfo-0001028698	success	166	93	66	100	27	0.398	0.3-0.75,1-4,1-9.8,1.9-4,13-25,2-10,3-17,5-6,8-10,apex,articulate,branched,broadly,cell,cm,conical,corolla,cyme,dark,diameter,dichasial,dichasially,distal,dot,ebracteate,ellipsoid,elliptical,filament,flat,flower,green,green-white,half,herbaceous,leaf,light,medium,mm,monochasial,mucilaginous,oblique,odd-pinnate,ovate,ovoid,pedicel,peduncle,pentagonal,perennial,petiole,plant,proximal,puberulent,pubescent,rachi,raised,rotate,seed,smooth,stigma,strigose,style,throughout,violet,white,yellow,¼	0-1.,1-2,1.8-5,2-3,2-4,3-5,3-6-foliat,3.5,4-14,5-15,5-8,6,6-13,6-27,9-35,abaxiall,abaxially,acumen,acuminate,acute,adaxially,apical,apically,base,calyx,commonly,connate,covering,cuneate,darker,decurrent,dehiscent,digestion,diminishing,dorsally,eaf,edge,eed,emoval,enzyme,equal,exceeding,first,folded,forked,generally,globo,gradually,hair-like,honeycomb,interjected,introrse,lateral,leaflet,living,lobe,lon,long,long-attenuate,lower,lunat,make,maturing,minute,nflorescence,nther,often,orolla,pair,pattern,perfect,petiolule,plan,poricidally,rarely,reveal,ruit,sessile,seudostipule,short,size,slit,specimen,stamen,straight,tal,tem,terminal,testal,thick,toward,tuber-bearing,two,typically,unit,usually,vary,wall,wide,ympodial	abaxial,adaxial,anther,arrangement,center,colour,form,fruit,globose,growth,height,history,inflorescence,length,life,na,number,ovary,position,reproduction,shape,spacing,staman,surface,texture,wet,width
404	wfo-0001028716	success	145	77	46	99	31	0.317	.5,0.5,0.6-1.9,0.75,1-2,2.5-8,7-8,8-9,acuminate,anther,apart,apex,bark,brown,cm,corolla,dark,ellipsoid,filament,filiform,fruit,glabrous,glandular,hirsute,leaf,less,lobed,minutely,mm,opposite,ovary,ovate,papillose,pedicel,petiole,puberulent,pubescent,shape,shrub,simple,sparsely,style,trichome,uniseriate,white,x	.2,1.9-5.5,10-40-flowered,11-16.4,2-4,2.2-7.9,3.6-8.8,5-6,9-10,across,anisophyllou,anthesi,appearing,asymmetric,ba,base,becoming,beginning,beneath,bi-cellular,branched,calyx,cuneate,decurrent,deflexed,dia,differing,difoliate,eaf,edicel,eed,elliptic,evenly,except,fertilization,fifth,free,geminate,inflorescenc,intermediate,know,known,lateral,lengthening,lenticellat,like,lobe,lon,long,long-triangular,lower,main,major,markedly,middle,minor,much,nearly,nflorescence,node,often,older,one,orbicular,pair,pointed,pore,poricidal,portion,prominent,proximal,raised,reflexed,remaining,rounded,ruit,scar,shaped,size,slightly,spaced,stem,stigm,straight,strongly,tall,tear-drop,tip,triangular,truncate,tube,two,ud,unit,vein,widening,widest,ympodial,young	10-40,abaxial,adaxial,arrangement,bud,colour,diameter,flower,form,growth,height,history,inflorescence,length,lenticellate,life,na,number,peduncle,perennial,plant,position,rachi,reproduction,seed,spacing,staman,stigma,surface,texture,width
405	wfo-0001028723	success	211	107	77	134	30	0.365	-1.5,0.2,0.8-1,1,1-1.8,1-2.2,1-2.5,10-16,2-2.7,3.5-4,4,4-5,5,abaxial,acute,almost,anther,apex,apically,bark,base,brachyblast,branch,calyx,capitate,clustered,cm,conical,corolla,dark,dendritic,diameter,dilated,drying,elliptic,entire,filament,flexuous,flower,glabrous,green,leaf,length,less,liana,lobed,long,longitudinally,margin,membranous,middle,mm,obconical,obovate,occasional,orange-brown,overlapping,pedicel,peduncle,petiole,rachi,ridged,scar,shrub,simple,small,stem,stigma,stump,style,surface,terminal,trichome,white,widely,wrinkled,x	.3,.5,0-0.5,0.8-2,0°,1-1.5,1/3-1/2,1/5-1/3,10-15,2-2.5,2-4,2.5,3-4,5-6,5-7,abaxially,adaxially,age,alternate,alyx,another,anthesi,apar,apice,apparently,articulated,becoming,branched,branching,broadly,brown,clearly,common,concolorous,curved,decurrent,delineated,deltoid,densely,density,developed,divided,domatia,dorsifixed,eaf,eed,ellipsoi,equal,except,ey,faint,fine,flat,formed,free,frequent,gradual,increasing,inner,junction,know,known,lengthening,like,lobe,long-attenuate,lower,m.,main,midvein,minutely,mostly,much,multiply,naked,narrowly,nflorescence,nther,oblong,obtuse,one,orolla,outer,ovate,pair,pale,papillo,perfec,plurifoliat,poorly,pore,poricidal,portion,primary,prominent,protruding,pubescent,raised,ray,region,regular,ruit,separated,short,side,sinus,slender,smaller,smooth,sparsely,spreading,surrounding,tearing,tertiary,tip,tissu,toward,transition,tube,tuft,ud,unarmed,uneven,unevenly,unit,vary,vein,venation,visible,wide,yellow,ympodial,young,youngest	adaxial,apart,arrangement,bud,cell,center,colour,dense,ellipsoid,form,fruit,fruiting,growth,height,history,inflorescence,life,na,new,number,ovary,plant,position,reproduction,seed,shape,spacing,staman,texture,width
406	wfo-0001028725	invalid_json_followup	197	143	111	86	32	0.563	-10,0.1-0.2,0.2-0.5,0.6-1,1.5-1.7,1.5-2,1.5-4,10-12,2.5-3,2.5-8,3-6,4-5,5-10,7-8,acicular,acute,adaxially,anther,apex,bark,base,berry,brown,bud,calyx,chartaceous,clavate-truncate,closely,cm,cordate,corolla,curved,densely,depressed,diameter,elliptic-ovate,elongate,entire,filament,finely,flattened,flower,fruiting,glabrescent,glabrous,gland-tipped,glandular,glandular-pubescent,glandular-tomentose,globose,green,greyish,growth,inconspicuous,inflorescence,internodal,leaf,leathery,lobed,long-styled,margin,midpoint,minutely,mm,moderately,nearly,new,ovary,ovate,pedicel,peduncle,persistently,petiole,prickle,pubescent,ray,reduced,reniform,repand-angular,reticulate,rusty,rusty-brown,rusty-tomentose,scar,sessile,short-styled,short-talked,shrub,simple,size,slender,slightly,stellate,stem,stigma,style,surface,terete,terminal,tomentose,trichome,turbinate,undulate,unevenly,varying,velutinous,violet,viscid,x,yellow,yellowish	.1,0.3-0.4,1-1.5,1-2,1.2-1.5,1/4,2,3-4,3-plurifoliat,4-12,4-6-celled,4-locular,7,abaxially,anthesi,armed,articulated,basal,clearly,connate,denser,discolorous,distal,eaf,eed,eglandular,enlarged,exserted,free,glandular-villose,greatly,heterostylous,lanceolate-subulate,lengthening,like,linear-lanceolate,lobe,long,longer,lower,midrib,minute,mixed,multicellular,nflorescence,oblique,obverse,older,papillo,perfect,pericarp,pore,poricidal,porrect,portion,prickly,pubescence,recurved,reflexe,reflexed,rest,rounded,ruit,similar,slit,small,somewhat,space,sparsely,stalked,staminate,stellate-tomentose,straight,strongly,tall,tapering,testa,tip,tube,ud,unarmed,unit,upper,vein,whit,ympodial	'',[,``,abaxial,adaxial,arrangement,characteristic,colour,form,fruit,height,history,length,life,na,number,papillose,plant,position,rachi,reproduction,seed,shape,spaced,spacing,staman,texture,value,white,width,{,}
407	wfo-0001028736	success	180	114	91	89	23	0.506	0.5,0.5-1.5,0.5-1mm,0.5-2,1,1-2,1-3,10-15,2-4,2-5,3-8,3.5-5,4-6,5-10,5-15,abaxially,absent,acute,anther,apex,base,brown,chartaceous,cm,created,cylindrical,dark,densely,diameter,discolorous,extra-axillary,filament,filiform,flower,fruit,glabrous,globose,green,hair,immature,leaf,length,light,like,lobe,lobed,many,mature,midpoint,mm,moderately,mottled,multicellular,nearly,netlike,obtuse,orange,pedicel,peduncle,per,petiole,pit,porrect-stellate,prickle,pubescent,rachi,raised,ray,red,reniform,rhombic,ridge,roselike,shrub,side,simple,slightly,small,sparsely,stellate,stem,stigma,style,surface,unbranched,unicellular,unlobed,white,x,yellow,yellow-white	0.2-0.4,0.5-1,1-1.5,1.5,1.5-3,1/6,2-7,3-5,3-6,4-12,4-9,40-70,5-merou,6-13x3-8,6-8,accrescent,adaxiall,adaxially,alyx,apar,apical,apparently,armed,attenuate,axe,berry,beyond,blade,calyx,connivent,contiguous,cordate,cut,decurrent,difoliate,directed,eaf,eed,either,exserted,flattened,frui,fruiting,geminate,glabrou,glandular,gree,introsel,less,long,lower,m.,major,midrib,midvein,multiseriate,narrowly,nflorescence,occasional,occasionally,onto,orolla,pair,perfect,pore,purple,recurved,ruit,scanden,sinus,spaced,stalk,stamen,ste,tamen,tapering,tem,thin-skinned,triangular,tube,unarmed,unequa,uniseriate,unit,vary,vein,way,wide,ympodial	abaxial,adaxial,apart,arrangement,colour,corolla,form,growth,height,history,inflorescence,life,na,number,ovary,plant,position,reproduction,seed,shape,spacing,staman,texture
408	wfo-0001028737	success	151	78	52	99	26	0.344	0.2-0.5,1-4,1-6,1.5-3.5,12-14,16-30,2.8-3.5,4-10,6,acute,apex,articulate,branched,cell,cm,corolla,cyme,diameter,dichasial,dichasially,distal,ebracteate,elliptic-lanceolate,filament,flower,glandular,globose,green,green-white,half,herbaceous,lanceolate,leaf,mm,monochasial,mucilaginous,odd-pinnate,ovoid,pedicel,peduncle,perennial,petiole,plant,proximal,rachi,seed,stellate,stigma,style,throughout,yellow,¼	0.7-2,1,1-2.5,10,2-3,2-5,3-4,3-5,3-6-foliat,4-6.5,4-9,5-6,7-15,abaxially,absen,acumen,acuminate,adaxially,apical,apically,apiculate,attenuate,base,calyx,caudate,connate,covering,decurrent,dehiscent,digestion,diminishing,dorsally,eaf,edge,eed,emoval,enzyme,exceeding,flat,folded,forked,generally,glabrescent,globo,gradually,hair-like,honeycomb,interjected,introrse,larger,lateral,leaflet,living,lobe,lon,long,lower,make,maturing,nflorescence,nther,oblique,oblong,often,orolla,pair,pattern,perfect,pinnatifi,plan,poricidally,reveal,ruit,second,sessile,seudostipule,short,size,slit,specimen,stamen,straight,strongly,tal,tem,terminal,testal,thick,throughou,toward,tuber-bearing,typically,unit,vary,wall,whit,wide,without,ympodial	abaxial,adaxial,anther,arrangement,center,colour,form,fruit,growth,height,history,inflorescence,length,life,na,number,ovary,position,reproduction,shape,spacing,staman,surface,texture,white,width
409	wfo-0001028773	success	169	85	53	116	32	0.314	0-0.2,0.15-0.3,0.9-2.8,1-2,3-4.5,4-7,5-6.5,6-11,accrescent,adaxially,anther,apex,broadly,calyx,cm,densely,diameter,entire,erect,extra-axillary,flower,fruit,fruiting,glabrous,globose,green,greenish-white,inflorescence,leaf,length,lilac,margin,mm,obtuse,ovate,pale,pedicel,peduncle,perennial,petiole,prickle,red,rhizomatous,rotate,rotate-stellate,shrub,simple,stellate-pubescent,style,surface,unbranched,white,yellow	%,.7,0-1,0.1-0.2,0.15-0.25,0.15-0.35,0.3-0.4,0.3-0.5,0.3-0.6,0.4-0.5,0.5-0.58,0.8-0.9,1-3,1-4.3,1-locular,1.4-2,10-16,2,2-5,2-6,2-foliate,2.2-2.8,3-5,3.3-3.8,30-55,4-6.5,4.5-5.5,5-merou,7-8,7-9,abaxially,absen,absent,across,adaxiall,adult,alyx,apart,apparen,articulated,axe,ba,base,blade,brown,chartaceous,cordate,directed,distall,distributed,eaf,eed,eglandular,elliptic,exceeding,exocarp,finger,geminate,gland-tipped,glandular,grey,hair,homostylous,incomplete,juicy,juvenile,lamina,lateral,lobe,lobed,long,lower,mature,mesocarp,midpoint,minute,nflorescence,oblique,onl,orolla,pair,part,per,perfect,placenta,pore,porrect,probably,pseudo-racemose,ray,ruit,rusty,septum,sessile,shallowly,short,solitary,spaced,stellae,succulent,tal,tamen,tem,thick,throughout,time,tube,unarme,unarmed,unit,upper,vary,wide,without,x,ympodial	abaxial,adaxial,arrangement,bark,bud,cell,center,colour,corolla,filament,form,growth,height,history,life,na,new,number,ovary,plant,position,reproduction,scar,seed,shape,spacing,staman,stem,stigma,texture,trichome,width
410	wfo-0001028774	success	141	83	46	95	37	0.326	0.4-0.7,1.4-1.8,1/2-2/3,10-20,2.5-4.0,3-5,4-8,8-12,anther,appearance,blade,bright,broadly,chocolate-brown,cm,dm,elongate,erect,foveolate,glabrous,grayish-green,herbage,internodal,lenticular,long,minutely,mm,otherwise,ovate,pentagonal-stellate,perennial,petiole,pinnatifid,prickle,smooth,spherical,spreading,stellate,stellate-pubescent,stem,strait-yellow,surface,velvety-farinaceous,vestiture,yellow,zygomorphic	0.5-0.8,12-20-rayed,2.5-3.5,2.7-3.3,3-7,3-8,30-60,5-9,6-10-flowere,9-12,accrescent,acro,almost,along,alyx,annually,anthesi,arcuate,armed,base,beneath,berry,broad,calyx,campanulate,closely,deeply,density,developing,dia,difoliate,distinctive,divided,dry,eaf,eed,emerging,extended,externally,fine,fully,geminat,giving,hair,herb,hetermorphic,invested,irregular,least,lengt,linear-lanceolate,lobe,lon,lowermost,margin,maturity,merely,midvein,nflorescence,numerous,often,orolla,per,prickly,rounded,ruit,scattered,separated,short,short-stipitate,slende,somewhat,spaced,splitting,stellate-woolly,stout,straight,surrounding,tall,tamen,thick,tightly,tigma,tub,tube,tyle,unarmed,undulate,unexpande,unit,vary,varying,weakly,woody,ympodial	6-10,abaxial,adaxial,apex,arrangement,colour,corolla,diameter,filament,flower,form,fruit,growth,height,history,inflorescence,leaf,length,life,na,number,ovary,pedicel,peduncle,plant,position,rachi,reproduction,seed,shape,spacing,staman,stigma,style,texture,unexpanded,width
411	wfo-0001028777	success	205	113	85	120	28	0.415	-10,.5,0-2,0.2,0.4-0.8,0.5-1.3,0.7-1.2,1,1-3,1.5-3,1.5-4,1.8-2.5,1/4,3.5-5,3/4-4/5,4-5-merous,4.5-8,abaxially,anther,apex,bark,base,berry,branched,calyx,cm,dark,diameter,elongating,entire,filament,flattened-reniform,flower,fruit,fruiting,glabrescent,glabrous,green,inflorescence,leaf,length,less,lobed,long,margin,marking,mature,maturity,mauve,mm,moderately,obovate,orange,orange-brown,ovate,pale,pedicel,peduncle,petiole,porrect,red-brown,reflexed,scar,sessile,shoot,short,shrub,simple,small,smooth,spherical,stalked,stellate-pubescent,stem,style,surface,terete,terminal,tree,trichome,unarmed,way,white,yellow-green,young	-12,-2.5,-3,-4,.8,.9,0-30,0.1-0.2,0.1-0.3,0.6-1,0.7-1.3,0.8-1,0.8-2.2,1-2,1-2.5,1.5,1/4-1/2,2-,2.5,2.5-3,2.5-5,3,6-10,7-11,8,8-15,acuminat,acute,alyx,ame,apar,ape,apically,articulated,attenuate,blade,briefly,c.,chartaceous,concolorous,connivent,curved,deciduou,deltate,discolorous,drying,eaf,eed,equal,erect,faint,free,glabrescen,green-brown,infructescence,lengt,lobe,long-styled,longer,lower,midpoint,minute,multangulate,narrow-deltate,nflorescence,occasionally,older,one,open,orolla,oung,pair,per,perfect,pericarp,plurifoliat,poricidal,portion,present,primary,ray,recurved,reflexe,retuse,rounded,ruit,short-styled,shorte,shorter,sometimes,somewhat,soon,spaced,sparsely,spreading,stalk,staminate,stellate,stout,strongly,tamen,tapering,tertiary,time,tip,truncate,tube,unarme,unit,usually,variously,vary,vein,venation,visible,whole,wide,wider,woody,ympodial	abaxial,adaxial,apart,arrangement,bud,cell,center,colour,corolla,form,growth,height,history,life,na,new,number,ovary,perennial,plant,position,reproduction,seed,shape,spacing,staman,texture,width
412	wfo-0001028788	success	189	93	62	127	31	0.328	0.4-1.3,0.6-1.2,0.7-1.8,0.8-1.1,2-3,2-5,3-10,4.5-6.5,6-10,8-10,acicular,acute,andromonoecious,anther,apex,black,broad-based,brown,calyx,cm,cylindrical,dark,densely,diameter,entire,extra-axillary,flower,fruit,fruiting,globose,green,grey,grey-green,inflorescence,lanceolate,length,lilac,margin,mm,ovate,pale,pedicel,peduncle,perennial,petiole,plant,prickle,pseudo-racemose,purple,rusty,shrub,simple,stellate,stellate-pubescent,stem,straight,streak,style,thick,yellow,yellowish,yellowish-green	%,0-0.3,0-0.4,0-10,0-3.5,0.05-0.1,0.1-0.4,0.15-0.4,0.2-0.4,0.3-0.5,0.5-1,0.7-1.3,0.7-1.4,0.8-1.5,0.8=2.5,1,1-1.5,1-10,1-2,1.1-2.3,1.4-1.6,10-14,10-20,2.3-3.6,2.5-3.5,2.5-4.5,2.5-8.5,4-locular,5-15,5-merou,6-14,6-8,7-10,7-9,8-11,abaxially,absen,absent,across,adaxiall,adaxially,alyx,anvil-shape,apart,articulated,ascending,attenuate,axe,ba,base,blade,chartaceous,cordate,cross-section,decimetr,directed,distall,distally,distributed,dult,eaf,eed,eglandular,erect,exocarp,finger,functional,gland-tipped,hair,half,heterostylous,hig,juicy,lamina,lateral,less,lobe,long,longer,lower,markedly,mature,mesocarp,mid-point,midpoint,minute,moist,multiradiate,nflorescence,oblique,obtuse,onl,orolla,part,per,placenta,pore,porrect,present,ray,rhizomatous,rostrate,ruit,sessile,short,spaced,stage,stalk,stalked,stellae,tamen,thicker,throughout,time,tube,unarme,unarmed,unbranched,unit,unknow,uvenile,vary,weakly,white,wide,x,ympodial	abaxial,adaxial,arrangement,bark,bud,cell,center,colour,corolla,filament,form,growth,height,history,leaf,life,na,new,number,ovary,position,reproduction,scar,seed,shape,staman,stigma,surface,texture,trichome,width
413	wfo-0001028791	invalid_json_followup	257	105	70	187	35	0.272	+,0.05-0.2,0.2-0.3,0.4-0.6,0.4-0.65,0.8-1.3,1-1.5,1-2,1-3-celled,1.8-3.3,10,100,2-7,20-to,5-15,9-30,anther,apex,articulated,broadly,brown,calyx,capitate,cm,conical,corolla,dark,diameter,elliptic,entire,filament,flower,fruit,fruiting,glabrous,globose,green,hair-like,imparipinnate,interrupted,leaf,liana,margin,middle,mm,near,obovate,occasionally,outgrowth,ovary,pale,paler,pedicel,peduncle,petiole,plant,pubescent,rachi,seed,slightly,stellate,stem,stigma,style,surface,trichome,vine,white,woody,yellow	-0.6,-1.5,-9,.5,0-6,0.05,0.2-0.4,0.2-0.8,0.25-0.3,0.3-0.4,0.3-0.5,0.3-0.6,0.3-0.8,0.4-0.5,0.4-1.1,0.45-0.55,0.5,0.6-0.8,0.6-0.9,0.7-1.5,0.8-1,1-2-celled,1-3,1-celled,1.5-,1.5-2,1.6-4.5,1.7-2.1,2-3,2-3.5,2-7-celled,2-locular,2.5-4.5,2.8-3.0,3-,3-4,4-11.5,4-15,4-5+,4-celled,5-,5-10,5-22,5-plurifoliate,50-80,8-10-celled,9-35,abaxially,absen,absent,abundant,acuminate,acute,adaxially,addition,ag,along,anthesi,apical,appearance,appendage,articulation,basal,base,basiscopically,beneath,berr,border,branched,breaking,bullate,cell,clambering,colo.,column,consistently,darker,deciduous,deltate,densely,densest,developed,dichotomously,eaf,ebracteate,edicel,eed,eglandular,elongating,enlarged,even,exserted,extended,free,give,glabrescent,glandular,gree,grow,growing,half,halfway,head,interjected,internode,lamina,large,lateral,leaflet,leaving,less,like,lobe,lon,long,lower,many,midvein,minutely,mixture,much,multicellular,nflorescence,oblique,often,pair,papillate,per,petiolule,poorly,present,primary,protuberance,pseudostipule,pubescence,reflexed,rest,rough,round,ruit,sandpapery,scandent,secondary,sessile,short,shorter,silky,simple,single,small,smaller,sometimes,somewhat,sparse,sparsely,spreading,stamen,staminal,sterile,stiff,straight,tal,tem,terminal,tertiary,testa,thick,thickened,time,tip,touch,transparent,truncate,tube,ud,unicellular,uniseriate,unit,upper,usually,vegetation,vein,wall,wide,winged,ympodial,–1-2-celled	'',[,``,abaxial,adaxial,arrangement,bark,bud,center,characteristic,colour,dense,form,growth,height,history,inflorescence,length,life,na,new,number,perennial,position,prickle,reproduction,scar,shape,spacing,staman,texture,value,width,{,}
414	wfo-0001028798	invalid_json_followup	214	115	76	138	39	0.355	0-1,0.2-0.4,0.5-2,0.9-1.2,1-4.5,1-6,1.1-2,1.5-1.8,10,2-7,3-5,3.3-5.6,3.8-4.2,4-5.4,5-8,7-8,accrescent,acute,anther,apart,apex,articulated,base,bud,calyx,chartaceous,cm,conical,corolla,diameter,dm,entire,filament,flower,fruit,fruiting,granular,green,greenish,growth,lanceolate,large,leaf,length,margin,mixed,mm,oblanceolate,oblong,orbicular,pale,pedicel,peduncle,petiole,porrect-stellate,probably,pseudo-terminal,rachi,ripe,rotate-stellate,rough,sessile,short,short-stalked,shrub,simple,somewhat,stem,stigma,style,subcoriaceous,subglobose,tomentose,x,yellow,yellowish	.5-5,0-60,1-3,1/2-2/3,1/20,15-19,2-3,2-3.75,2-6,2.4-4.4,2.5-3.5,2.6-4,2/3,3-4,5.25-7.5,6-10,6-8,8-18,8.5-13,abaxially,acuminate,adaxially,ag,anthesi,apical-lateral,apparently,attenuate,axe,axillary,ba,becoming,berry,blade,blunt-tipped,boat-shaped,branch,branched,capitat,continued,curved,cylindrical,decurrent,dehiscing,densely,distal,downward,due,eaf,echinoi,echinoid,eed,exserted,extend,fleshy,free,glabrous,granular-tomentose,hair,hal,high,included,inserted,introrse,irregularly,lacking,lateral,less,lined,lobe,lobed,long,longitudinal,lower,m.,main,many,midvein,minutely,multangulat,multangulate,nearly,nflorescence,oblanceolat,obovate,obscured,obtuse,often,orolla,oung,ovate-lanceolate,overlapping,perfect,persistent,persistently,plurifoliate,pore,present,prominent,pubescent,quite,rather,ray,rough-granular,ruit,semi-ovate,side,slightly,slit,small,spaced,sparingly,splitting,stalked,stamen,stellate-pubescent,strongly,subcampanulate,sulcate,suture,tamen,thick,time,tip,tomentu,tomentum,toward,translucent,tube,unarme,unarmed,unit,unknow,vary,vein,velutinous,way,wide,ympodial	'',10-60,[,``,abaxial,adaxial,arrangement,bark,capitate,cell,center,characteristic,colour,form,height,history,inflorescence,life,na,new,number,ovary,perennial,plant,position,prickle,reproduction,scar,seed,shape,spacing,staman,surface,texture,trichome,value,width,{,}
415	wfo-0001028803	success	204	128	103	101	25	0.505	.5,0.5,0.5–1,10,12–14,14–20,1–1.5,1–2,1–3,1–3.5,2–10,2–3,4–10,4–7,5,5-merous,5–8,8–12,8–14,abaxial,actinomorphic,adaxial,andromonoecious,anther,apart,appearing,armed,base,berry,branch,branched,brown,bud,calyx,chartaceous,cm,curved,densely,diameter,due,entire,erect,extra-axillary,field,filament,flower,fruit,fruiting,functionally,glabrous,globose,green,hair,herbarium,hermaphroditic,leaf,length,liana,light,like,lobed,long,main,male,margin,midvein,mm,moderately,nearly,often,ovate,pedicel,peduncle,petiole,plant,prickle,pubescent,purple,rachi,recurved,reniform,scandent,sheet,shrub,simple,slightly,small,sparsely,stellate,stellate-pubescent,stem,stigma,style,surface,tan,tomentose,tree,triangular,violet,white,yellow,zygomorphic,×	0.5–3,1,1–1.2,2,2–3.5,2–4,3–10,3–4,3–6,6–10,75-120,8-12,absent,acute,ag,alyx,anthesi,apex,apical,apparently,articulated,asymmetrical,attenuate,axe,ba,bearing,becoming,blade,connivent,cordate,cupular,curve,curving,cylindrical,darker,developed,difoliate,distal,downward,eaf,early,eed,elongated,em,end,exceeding,flowering,geminate,glabrou,glandular,held,infructescenc,lacking,late,lobe,longitudinal,midpoint,midrib,multiseriate,narrowly,nflorescence,obtuse,occasional,older,opening,orolla,ower,pair,per,pinnate,pore,proximally,ray,rounded,ruit,secondary,side,slit,spaced,splitting,spreading,stalk,ste,surfac,tamen,tapering,triangula,typically,unarmed,unequa,unit,upright,upward,usually,vary,vein,venation,weakly,wid,ympodial,young	1‒1.2,1–20,arrangement,bark,colour,corolla,form,growth,height,history,inflorescence,life,na,number,ovary,perennial,position,reproduction,seed,shape,spacing,staman,texture,wide,width
416	wfo-0001028815	invalid_json_followup	196	121	80	116	41	0.408	0.4-0.8,1-10,1-2,10-15,2-4,22-35,3-4,3-5,5-6,6-8,7-16,abaxially,adaxially,along,anther,apex,axillary,broadly,brownish,bud,cell,cm,condition,corolla,covering,dark,diameter,drying,elliptic,especially,filament,flower,forked,fresh,fruit,glabrous,globose,green,green-white,greenish,herb,lateral,lilac-purple,make,margin,medium,midrib,minutely,mm,mucilaginous,odd-pinnate,ovate,ovoid,pedicel,peduncle,petiole,plant,puberulent,pubescent,purple,rachi,red-purple,ripe,rotate,rugose,seed,sparsely,stem,stigma,style,subtending,terminal,testal,thick,throughout,tinged,wall,wet,whitish,yellow	0.5-1,1-3.5,1-4,1-5,14-28,2-4.5,2-9,2.5-6.5,3-7,4-10,5-7,5-merou,6-10,acumen,acute,ag,alyx,apart,apparently,articulated,articulation,auriculate,axe,base,basiscopic,berry,blade,capitat,chartaceous,ciliate,connivent,cuneate,decreasing,decurrent,developing,digestion,distal,distinct,dorsally,eaf,edge,eed,elliptic-lanceolate,enzyme,exceeding,flat,folded,geminat,generally,glabrou,hair,hair-like,hal,half,high,homostylous,honeycomb-shaped,indistinct,interjected,lanceolate,leaflet,lengthening,like,living,lobe,long,lower,membranous,narrowly,nflorescence,obtuse,onto,orolla,pair,papillose,perfect,petiolulate,plurifoliate,pointed,pore,poricidal,purpl,removed,rounded,ruit,semi-erec,semi-rosette,sessile,seudostipule,short,side,size,slightly,slit,spaced,specimen,splotched,stamen,ste,straight,tall,tamen,tem,terminated,tip,tri-,triangular-lanceolate,tube,unit,unwinged,usually,vary,winged,x,ympodial,young	'',[,\u201chair-like\u201d,``,abaxial,adaxial,arrangement,bark,calyx,capitate,center,characteristic,colour,form,fruiting,growth,height,history,inflorescence,leaf,length,life,na,new,number,ovary,perennial,position,prickle,reproduction,scar,shape,spacing,staman,surface,texture,trichome,value,width,{,}
417	wfo-0001028876	success	127	90	57	70	33	0.449	.5,0.4-1,0.5-2,1-2,1.5-2,2-2.3,3-5,4-5,5-6,abaxial,acute,adaxially,along,anther,apex,bark,brown,calyx,capitate,closely,cm,corolla,dark,dendritic,densely,ellipsoid,elliptic,filament,flower,glabrous,internodal,leaf,lobed,midrib,mm,opposite,ovary,papillose,pedicel,petiole,pubescent,scar,shining,shrub,simple,slender,small,spaced,sparsely,stem,stigma,style,subshrub,surface,trichome,white,x	/4,1.5-3,3-8,4-8,abaxially,anthesi,attenuate,base,branched,conical,dia,difoliate,drying,eaf,edicel,eed,free,geminat,glabrat,golden,hroughout,included,inflorescenc,know,known,lamina,lateral,leave,like,lobe,long,long-triangular,lower,main,middle,minutely,nflorescence,nodding,occasionally,older,overlappin,pair,papillae,papillo,planar,pore,poricidal,portion,reddish,rest,rounded,ruti,sagittate,shaped,speciman,straight,tall,tear-drop,tip,tub,tube,type,ud,uniseriate,unit,vein,way,widest,ympodial,young	adaxial,arrangement,bud,cell,center,colour,diameter,form,fruit,fruiting,glabrate,growth,height,history,inflorescence,length,life,margin,na,new,number,overlapping,peduncle,plant,position,rachi,reproduction,seed,shape,spacing,staman,texture,width
418	wfo-0001028883	invalid_json_followup	207	117	73	134	44	0.353	1,2,4,50,6,absent,acute,anther,antrorse,apex,articulated,base,berry,calyx,capitate,cell,chartaceous,cm,concolorous,coriaceous,cyme,dark,deltate,diameter,drying,dull,elliptic,entire,filament,flower,fruit,glabrescent,glabrous,glandular,globose,green,greenish,growth,herb,lateral,leaf,length,light,margin,membranaceous,mm,narrowly,new,normally,pedicel,peduncle,petiole,pubescent,rachi,rarely,reniform,ripe,seed,simple,slightly,stellate,stem,stigma,style,subopposite,surface,trichome,unbranched,undulate,uniseriate,white,whitish,yellow	0.3–0.6,0.4–1.2,0.5–2,0.6,1.5–7,1–2,1–6,2–3,2–5,3–5,4–6,5,5-merou,6–10,6–12,abaxially,accrescent,acuminate,adaxiall,adaxially,almost,along,alyx,antrorsely,apar,arched,ark,ascending,attenuate,axi,becoming,blade,branch,brochidodromous,brow,capitat,ciliate,circular,common,completely,connivent,curved,cylindrical,decurrent,densely,differing,directed,eaf,eed,elliptic-ovate,emarginate,equal,erect,exfoliating,eye,flattened,frui,geminate,geniculat,glabrou,head,hilum,hollow,impressed,introrsely,less,like,lobe,long,longitudinal,lower,lying,midrib,minor,moderately,multicellular,naked,nflorescence,notably,oblong,obtuse,often,older,onto,opening,orolla,ovate-lanceolate,parallel,pendan,per,perfect,plurifoliate,pore,poricidal,present,primarily,prominent,pubescence,region,rounded,ruit,secondary,sessile,shap,shiny,shrub,similar,single,single-celled,size,slit,small,sometimes,spaced,sparse,sparsely,spreading,stalk,straight,subapical,subsessile,swollen,tall,tamen,tem,unit,vary,vein,venation,visible,wide,woody,ympodial,×	'',1-2,1-6,2-5,3-5,4-6,5-merous,6-10,6-12,[,``,abaxial,adaxial,apart,arrangement,bark,bud,center,characteristic,colour,corolla,form,fruiting,height,history,inflorescence,life,na,number,ovary,perennial,plant,position,prickle,reproduction,scar,shape,spacing,staman,texture,value,width,{,}
419	wfo-0001028885	invalid_json_followup	214	108	77	137	31	0.36	0.5-1,0.5-5,0.7-2,1-1.2,1-2,1.5-3.5,10-20,2-2.5,2.3-2.5,3.5-4.5,7-8,9-11,abaxial,acute,adaxial,anther,apart,apex,berry,black,brown,calyx,capitate,cm,corolla,cup-shaped,dark,densely,diameter,ellipsoid,elliptic,entire,erect,filament,flower,fruiting,glabrous,globose,growth,height,inflorescence,irregularly,lanceolate,lateral,leaf,lobed,margin,mm,multicellular,narrowly,new,nodding,pedicel,peduncle,petiole,plant,pubescent,purple,reddish,scandent,scar,shiny,shrub,simple,slender,spaced,sparsely,stellate,stem,stigma,style,surface,terminal,trichome,uniseriate,vine,woody	-1,.5,0.3-0.5,1-1.5,1-3,1.5-1.7,2,2-,2.5-3.5,2/3,3-5,3.5-8.5,4-5,5-merou,7-9,9-12,?,adaxially,ag,along,alyx,anthesi,apiculate,apparently,archin,ark,articulated,attenuate,basal,base,blackish,branch,branched,broadly,cell,collapsing,connivent,dark-pigmented,decurrent,deltate,dendriti,distal,dried,drying,eaf,eed,exserted,extending,fleshy,free,furcate,glabrescent,glabrou,glandular,golden,gradually,groove,groupe,ilament,immature,inserted,known,lamina,leaving,lengthening,less,like,live,lobe,long,loosely,lower,material,midvein,minute,minutely,mostly,narrowing,nflorescence,noddin,occasionally,often,older,orolla,pair,papillo,part,peg,perfect,pericarp,pigmentation,plurifoliat,pore,poricidal,portion,primary,quarter,recorded,retaining,revolute,rhachi,ripe,ruit,scattered,shin,short,sleeve,slightly,slit,small,smaller,sometimes,spheroidal,spreading,strongly,tangled,tem,thin,third,time,tip,tube,twinin,ud,unit,upper,usually,vary,vein,wall,way,weak,weak-walled,wide,winged,ympodial,¾	'',5-merous,[,``,arrangement,bark,bud,center,characteristic,colour,form,fruit,history,length,life,na,number,ovary,position,prickle,rachi,reproduction,seed,shape,spacing,staman,texture,value,width,{,}
420	wfo-0001028888	success	207	104	76	131	28	0.367	0-3.5,0.15-0.5,1-10,1-2,10-25,2.3-7,2.5-3.3,4-25,5-10,5-7,6-11,8-11,abaxially,adaxially,anther,apex,articulated,axillary,broadly,brownish,bud,cell,clavate,cm,condition,corolla,covering,diameter,drying,elliptic,filament,flower,forked,fresh,fruit,glabrous,globose,green,greenish,hair,hair-like,herb,lateral,like,middle,minutely,mm,odd-pinnate,ovate,ovoid,pedicel,peduncle,pentagonal,petiole,plant,puberulent,pubescent,ripe,seed,sparsely,stem,stigma,streak,style,subglabrous,substellate,subtending,terminal,testal,thick,tuber,violet,wall,white,whitish,yellow	0-5,0-7,1,1-1.5,1-3,1.5-4,12.5-25,2-5,2-6,2.3-5,3-4,3-5,3.6-12.5,3.8-8.3,4-7,5-merou,8-13.5,acumen,acuminate,acute,ag,along,alyx,apart,apiculate,apparently,axe,base,berry,blade,capitat,center,central,chartaceous,ciliate,connivent,covered,cuneate,digestion,distal,dorsally,dot,eaf,edge,eed,end,enzyme,erec,especially,exceeding,except,flat,folded,geminat,generally,glabrou,glaucous,greatly,green-white,hal,half,homostylous,honeycomb-shaped,interjected,lanceolate,leaflet,lengthening,less,living,lobe,long,low,lower,make,margin,membranous,midrib,mottled,mucilaginous,nflorescence,oblique,often,one,orbicular,orolla,pair,perfect,petiolulate,petiolule,placed,plurifoliate,pore,poricidal,proximal,purple,reduced,removed,rounded,ruit,scattered,sessile,seudostipule,short,size,slightly,slit,sometimes,spaced,specimen,stamen,ste,stolo,straight,subequal,tall,tamen,tem,throughout,tip,tri-,truncate,tube,typically,unit,unwinged,usually,vary,wet,wing,x,ympodial	abaxial,adaxial,arrangement,capitate,colour,form,growth,height,history,inflorescence,leaf,length,life,na,number,ovary,perennial,position,pseudostipule,rachi,reproduction,shape,spacing,staman,stolon,surface,texture,width
421	wfo-0001028905	invalid_json_followup	210	124	85	125	39	0.405	-5,1,1-3,1.5-3,10,3-4,3-5,4,5,5-15,6-9,acuminate,anther,apex,appressed,axil,bilobed,blunt,bluntly,broadly,brown,bud,calyx,capitate,cell,cm,concentrically,conical,corolla,cyme,deep,deeply,distinctly,ellipsoid,enlarged,filament,first,flower,fork,form,fruiting,glabrous,glandular,green,hair,lasting,later,leaf,line,margin,minute,mm,narrowly,obovoid,orange-yellow,ovary,ovate,ovoid,paling,pedicel,peduncle,petiole,pinnatisect,plant,purple-blue,reddish,reticulate,rotate,rounded,rugose,scorpioid,several,shortly,shrub,simple,soft-wooded,sparse,stem,stigma,style,succulent,surface,x,year,yellow	-20,-3.5,-4,-9,1-,1.5,1.5-2,10-15,10-20,15-30,2,2-2.5,2-3,2.5-3,200-300,38/1-38/2,40-60,5-,7,acuman,acumen,adult,age,almost,also,appearing,aspect,aster,base,becoming,berry,broad,close,completely,continued,covering,cuneate,developed,dia,distance,eaf,eed,emarginate,entire,equal,even,exceeding,except,exerted,facetted,firming,floral,forked,free,frui,general,glabrescent,growing,herbarium,inadequate,interacuminal,intermediate,lanceolate,lengthening,less,lobe,lobed,lobing,lon,long,lower,main,may,midrib,mucronate,nflorescence,oblong,occur,often,pair,papillo,pedicellate,plurifoliat,pore,poricidal,purpli,range,rarely,reaching,readily,rh,rhachi,ripe,ruit,ruiting,scarious,seedling,shed,short,show,showy,sinus,size,slende,slit,smaller,soon,specimen,spreading,stone,straggly,suffused,tall,tip,tissue,tub,tube,ud,unit,usually,variable,violet,well,ympodial,young	'',[,``,abaxial,adaxial,arrangement,bark,center,characteristic,colour,diameter,fruit,growth,height,history,inflorescence,length,life,na,new,number,papillose,plurifoliate,position,prickle,rachi,reproduction,scar,seed,shape,slender,spacing,staman,texture,trichome,value,width,{,}
422	wfo-0001028916	success	212	112	81	131	31	0.382	0.2-0.4,0.5-3.2,0.5-5,1-2,1-4.6,1-7,1.5-3,2-12,2-5,3.5-4.5,5-10,5-7.5,7-18,accrescent,acicular,adaxially,andromonoecious,anther,apex,broad-based,brown,calyx,chartaceous,cm,deeply,densely,depressed-globose,diameter,ellipsoidal,elliptical,extra-axillary,filament,flower,fruit,fruiting,glabrous,globose,green,grey,hair,herbaceous,inflorescence,later,length,light,lilac,lobed,marbled,margin,minutely,mm,obtuse,ovate,pale,pedicel,peduncle,petiole,pitted,plant,prickle,prostrate,purple,rachi,resprouter,rotate,rotate-pentagonal,simple,somewhat,sparsely,sprawling,stellate,stellate-pubescent,stigma,straight,style,surface,throughout,unbranched,weakly,white,yellow	%,-8,0-0.4,0-0.5,0-2,0.05-0.1,0.2-0.3,0.25-0.3,0.25-0.35,0.3-0.4,0.4-0.8,0.4-1.3,0.5-3,0.5-3.5,0.9-1.1,1-1.5,1-3,1-4,1.5-2.5,1.8-2.2,10-16,14-21,15-25,2.5-5,3-4,3-5,35-50,35-55,4-,4-8,5-12,5-35,5-9,5-merou,6-20,7-10,7-8,8-10,8-9,abaxially,absen,absent,abundant,across,adaxiall,adult,alyx,apart,armed,articulated,axe,ba,base,blade,branche,broadly,connivent,cuneate,cut,cylindrical,decimetre,deflexed,deltate,directed,distall,distributed,eaf,eed,eglandular,finger,functional,gland-tipped,half,heterostylous,index,interpetalar,lamina,lateral,less,lobe,lobing,lon,long,longer,loosely,lower,mature,mesocarp,midpoint,midvein,minute,moderately,nflorescence,notably,oblique,oblong-attenuate,orolla,part,per,pore,porrect,presen,present,ray,ruit,sessile,shallowly,short,side,spaced,stage,stellae,succulen,tal,tamen,tem,thick,time,tissue,triangular,truncat,tube,unit,unknow,uvenile,vary,vein,wide,winged,x,ympodial	abaxial,adaxial,arrangement,bark,bud,cell,center,colour,corolla,form,growth,height,history,leaf,life,na,new,number,ovary,position,reproduction,scar,seed,shape,spacing,staman,stem,texture,trichome,truncate,width
423	wfo-0001028920	success	152	119	84	68	35	0.553	.5,0.2-1,0.5-1,0.8-1.1,1-1.2,1-1.5,1-3,3-3.5,6-6.5,abaxially,acuminate,acute,adaxially,anther,apex,arachnoid-pubescent,area,attenuate,axil,bark,base,broadly,brown,calyx,closely,cm,congested,conical,corolla,dark,deflexed,dendritic,densely,difoliate,ellipsoid,elliptic,erect,filament,flower,fruiting,glabrous,globose,green,later,lateral,leaf,lightly,lobed,long-styled,main,minutely,mm,nearly,obovate,obovoid,occasionally,opposite,ovary,ovoid-reniform,papillose,pedicel,petiole,pitted,pubescent,scar,shape,short-styled,shrub,simple,small,spaced,sparsely,stem,stigma,style,surface,tapering,tree,trichome,unifoliate,uniseriate,vein,white,winged	.25,1-2.4,1.5-2,2-2.5,2-7,3-15-flowered,3-4,5-9,6-15,anthesi,arachnoid,ba,berry,brownish,cucullate,decurrent,deltate,dense,dia,differing,eaf,edicel,eed,exserted,felty,fleshy,free,geminat,glabrate,gray-brow,lobe,lon,long,lower,major,middle,minor,nflorescence,older,overlappin,pair,planar,pore,poricidal,portion,present,pubescence,ruit,shaped,size,somewhat,soon,strongly,styl,tall,tear-drop,thick,tip,tub,tube,tuft,ud,unit,widest,woody,x,ympodial,young	3-15,abaxial,adaxial,arrangement,bud,cell,center,colour,diameter,form,fruit,geminate,gray-brown,growth,height,history,inflorescence,length,life,margin,na,new,number,overlapping,peduncle,perennial,plant,position,rachi,reproduction,seed,spacing,staman,texture,width
424	wfo-0001028929	invalid_json_followup	210	140	105	105	35	0.5	.5,.7,.9,/5,0-10,0-3,0.1,0.2-0.8,0.4-0.8,0.5-2,0.7-2,1,2-3,2-4,2-6,2-9,2/3-3/4,5-6,5-merous,8-10,abaxial,abaxially,acicular,acute,adaxial,anther,apart,apex,apparently,articulated,bark,base,berry,calyx,cell,chartaceous,cm,concolorous,densely,diameter,discolorous,drying,dull,elliptic,elongating,erect,filament,flattened-reniform,flower,foliaceous,fruit,fruiting,glabrescent,glabrous,inflorescence,lateral,leaf,length,lobed,long,margin,mature,maturity,minutely,mm,obovate,obtuse,orange-brown,outline,pale,patch,pedicel,peduncle,perpendicular,petiole,pit,porrect,prickle,raised,red,red-brown,red-green,reticulate,scar,sessile,shrub,simple,small,smooth,sometimes,spherical,stalked,stellate-pubescent,stem,straight,style,surface,terete,trichome,variously,way,white,wide,yellow,yellow-green	-2,-2/3,0,0-1,0-20,0.15-0.3,0.2-0.3,0.2-0.4,0.3-0.6,0.5-1.5,0.7-1,0.8-1,1-1.1,1-3,1.5-2.4,1/2,1/4-1/3,2.2-2.3,2.5-4,2.7-3,3-20,3-4,4-6,5-25,5-7.5,6-8,7-9,alyx,apar,ape,apically,blade,branched,connivent,cuneate,curved,difoliate,distance,eaf,eed,equal,extending,free,geminat,gently,glabrou,gra,hair,infructescence,lobe,lon,long-styled,longer,lower,midpoint,midvein,minute,narrow-deltate,narrow-ovate,nflorescence,oblong,obtu,occasionally,older,one,open,orolla,oung,pair,pendulous,per,perfect,pericarp,poricidal,portion,prickl,prickly,primary,ray,rounded,ruit,short-styled,side,slender,spaced,spreading,stalk,staminate,stellate,subsessile,tamen,tapering,tertiary,time,tip,tube,unarmed,unit,usually,vary,vein,venation,visible,woody,ympodial	'',[,``,arrangement,bud,center,character,characteristic,colour,corolla,form,gray,growth,height,history,life,na,new,number,ovary,perennial,plant,position,rachi,reproduction,seed,shape,spacing,staman,stigma,texture,value,width,{,}
425	wfo-0001028934	success	177	130	96	81	34	0.542	0.5-0.75,0.5-1,0.5-1.5,0.5-2,1-2,1-3,1.5,1.5-2.5,10-30,2-3,5-10,5-15,5-6,6-9,abaxially,acute,adaxially,anther,apex,attenuate,base,beyond,brown,bud,calyx,chartaceous,cm,connivent,created,cylindrical,dark,densely,diameter,discolorous,exserted,extra-axillary,filament,flattened,flower,fruit,fruiting,glabrous,globose,green,hair,immature,leaf,light,like,lobed,long,many,margin,mature,midpoint,mm,moderately,narrowly,nearly,netlike,orange,ovate,pedicel,peduncle,perfect,petiole,pit,porrect-stellate,prickle,pubescent,rachi,raised,red,reniform,ridge,roselike,simple,slightly,small,spreading,stamen,stellate,stem,stigma,style,surface,tan,tapering,triangular,unbranched,unlobed,vine,white,wide,x,yellow	0.5,1,1-.,1.5-2,15-25,2-2.5,2-4,3-5,3-6,3-7,5-8,5-merou,6-7,8-14,absent,accrescent,adaxiall,alyx,apar,apical,apparently,armed,asymmetrical,axe,berry,blade,cordate,difoliate,directed,distally,eaf,eed,either,em,expanded,filiform,frui,geminate,glabrou,gree,introrsel,lanceolate,leathery,lobe,lower,m.,major,midrib,midvein,multicellular,multiseriate,nflorescence,obscure,obtuse,often,orolla,pair,per,pirckle,pore,ray,recurved,reflexed,ruit,secondary,side,skinned,spaced,stalk,ste,tamen,thin,tube,unarmed,unequa,unicellular,unit,vary,vein,x1-3,ympodial	1-4,5-merous,abaxial,adaxial,apart,arrangement,bark,cell,center,colour,corolla,form,growth,height,history,inflorescence,length,life,na,new,number,ovary,perennial,plant,position,reproduction,scar,seed,shape,spacing,staman,texture,trichome,width
426	wfo-0001028944	invalid_json_followup	212	138	101	111	37	0.476	0.5-0.75,0.5-1,0.5-1.5,0.8-5,1-1.5,1-2,1-3,1-3-lobed,1-4,1-5,1.5-7,10-20,2-2.5,2.5-10,2.5-4,20-50,4-6,5-10,6-15,6-8,abaxially,acute,adaxially,anther,apart,apex,articulated,base,branched,bright,broad,broad-based,brown,brownish,calyx,chartaceous,cm,coarsely,dark,densely,diameter,elliptic,entire,extra-axillary,ferruginous,filament,flower,forked,fruit,fruiting,glabrescent,glabrous,globose,green,growth,homostylous,leaf,light,linear-acuminate,long,long-stalked,margin,mature,mm,multangulate,narrowly,nearly,outline,ovate,pedicel,peduncle,petiole,porrect-stellate,prickle,pubescent,purple,rachi,reniform,ripe,rotate-stellate,shallowly,shrub,simple,small,smooth,stellate,stellate-pubescent,stem,stigma,style,surface,tip,tree,triangular,unbranched,white,white-pubescent,whitish,x,yellow,young	.5-2.5,0.75-1.25,0.8-1.5,2-15,2-3,3-4,4-5,4-8,5-25,5-merou,6-7,7-17,8-10,8-13,abundant,accrescent,ag,alyx,apparently,armed,axe,ba,berry,blade,capitat,connivent,cordate,covering,cuneate,curved,cylindrical,deltate,denser,difoliate,directed,discolorous,distally,divided,eaf,eed,equal,erect,especially,flattened,free,frui,geminate,glabrou,hair,halfway,highly,interpetalar,lanceolate,like,lobe,longitudinal,lower,main,major,membanaceous,midpoint,midrib,moderately,mucilaginou,nflorescence,numerous,oblique,obtuse,occasionally,often,opening,orolla,part,perfect,pericarp,pore,ray,recurved,rounded,ruit,sessile,short-,short-stalked,shorter,side,slightly,slit,sometimes,spaced,sparse,sparsely,stalk,straight,strongly,subtending,tal,tamen,tapered,tem,thin,time,tissue,toward,tube,unarmed,unit,vary,vein,wide,yellowish,ympodial	'',5-merous,[,``,abaxial,adaxial,arrangement,bark,bud,capitate,characteristic,colour,corolla,form,height,history,inflorescence,length,life,na,new,number,ovary,plant,position,reproduction,scar,seed,shape,spacing,staman,texture,trichome,value,width,{,}
427	wfo-0001028963	success	197	125	96	101	29	0.487	/2,0-0.4,0-2,0.1-0.25,0.3-0.6,0.3-1,0.45-0.6,0.6-1,0.9-1.5,1-4,1/5,2-3,2-4,3-4.5,3.5-4.2,4-10,abaxially,acute,anther,apex,apparently,articulated,bark,base,berry,bright,broad-deltate,brown,calyx,cell,cm,connivent,densely,diameter,dull,entire,erect,evenly,filament,flattened-reniform,flower,fruiting,glabrescent,glabrous,gray-green,green,herb,inflorescence,lanceolate,lateral,leaf,length,light,lobed,margin,maturity,mauve,mm,moderately,narrow-elliptic,obtuse,orange,outline,pale,pedicel,peduncle,petiole,pit,poricidal,porrect,purple,raised,red,scar,sessile,shrub,simple,small,smooth,spherical,stalked,stellate-pubescent,stem,style,surface,tapering,terete,terminal,tip,trichome,unarmed,unbranched,upper,way,yellow-orange,young	.5,0.1,0.1-0.2,0.15-0.3,0.3-0.7,0.3-1.5,0.6-0.9,0.8-1.8,1.5-2,1/,1/4-1/3,1/6,2-2.3,2-5,2-9,2.4-2.8,4-8,5-25,5-merous,6-10,7-8,alyx,apar,ape,apically,attenuate,becoming,blade,chartaceous,concolorous,curved,cuspidat,deltate,difoliate,discolorous,drying,eaf,eed,elongating,equal,eye,free,frui,geminat,gra,herbaceous,infructescence,less,lobe,long,long-styled,longer,lower,mature,midpoint,naked,narrow-cuneate,narrowly,nflorescence,occasionally,older,one,open,orolla,oung,pair,pendulous,per,perfect,pericarp,portion,primary,ray,ruit,short-styled,shorter,slender,slightly,spaced,spreading,stalk,staminate,stellate,straight,subsessile,tamen,tertiary,time,tube,unarme,unit,usually,variously,vary,vein,venation,visible,wide,winged,woody,ympodial	abaxial,adaxial,arrangement,bud,center,colour,corolla,form,fruit,gray,growth,height,history,life,na,new,number,ovary,perennial,plant,position,prickle,reproduction,seed,shape,spacing,staman,texture,width
428	wfo-0001028971	invalid_json_followup	225	136	102	123	34	0.453	-0.8,.1-0.2,0.1-0.4,0.2-0.5,0.25-0.6,0.25-1.25,0.3-0.6,0.4-0.9,0.4-1.5,1-2,1.5-2.2,10-15,2.5-3.5,3-14,3-6,4-9,5-10,6-16,6-8.5,abaxially,acute,acute-,adaxially,anther,apart,apex,appearance,articulated,base,branched,broad-based,broadly,calyx,campanulate,cm,coarsely,compressed,deltoid,densely,dentate,diameter,elongate-deltoid,erect,essentially,extra-axillary,farinaceous,felty-pubescent,filament,flower,form,fruit,glabrous,globose,hair,inflorescence,laterally,leaf,length,lenticular,lobe,margin,minutely,mixture,mm,narrowly,often,orange,outline,ovate,pedicel,peduncle,perennial,petiole,pitted,prickle,pubescent,rachi,reniform-ovate,round-tipped,sericeous,sessile,short,short-stalked,simple,spreading-hirsute,spreadingly,stellae,stellate,stellate-pubescent,stem,stigma,stipitate,style,surface,tan,thin-textured,trichome,usually,variable,white,x,yellow	-1.4,0.1-0.5,0.8-2.5,05-2.5,1-5,1.5-4,1.75-2.5,1/5-1/2,15-30,2-5,2-foliate,2.2-3.5,2.5-4.5,2.5-5,20-35,3-5,4-5,5-15,5-8,6-9,7-16,adaxiall,along,also,appearing,armed,ascending,attenuate,axe,ba,bearing,becoming,blade,capitat,cauline,close,connivent,cylindrical,delicate,directed,distal,distall,eaf,eed,elongate,entire,felty,female-sterile,frequently,geminat,grading,growt,inserted,interlobal,invested,lanceolate,largest,later,lateral,least,lignescent,like,linear-lanceolate,lon,long,longer,longest,lower,major,manifestly,maturit,midpoint,midrib,minute,much,multiseriate,nflorescence,numerous,obtuse,occasionally,one,orolla,other,ovate-apiculate,ovate-lanceolate,pair,per,persistent,pore,prickly,principal,ray,reduced,ripe,ruit,scattered,shorter,side,similar,sinus,smaller,sometimes,spaced,sparse,stalk,ste,tal,tamen,tem,termination,time,tooth-like,truncate,tube,unbranched,underdeveloped,unit,variously,vary,vein,well-developed,wide,ympodial	'',[,``,abaxial,adaxial,arrangement,bark,bud,capitate,characteristic,colour,corolla,fruiting,growth,height,history,life,na,new,number,ovary,plant,position,reproduction,scar,seed,shape,spacing,staman,texture,value,width,{,}
429	wfo-0001028975	success	163	108	75	88	33	0.46	.5,0.1-1,1-3,1-5,1.2-1.5,1.5-2,3-3.5,6-6.5,8-9,acute,along,anther,apart,apex,area,bark,base,beneath,broad,brown,calyx,cm,conical,conically,corky,corolla,cup-shaped,dark,densely,denser,elliptic,filament,fruit,fruiting,glabrous,globose,golden,green,leaf,length,lobed,long,margin,minutely,mm,nearly,once-furcate,opposite,ovary,ovoid-reniform,pedicel,petiole,pitted,pubescent,raised,scar,shiny,short,shrub,simple,slender,small,sparsely,stem,stigma,style,surface,tapering,tip,tree,trichome,tube,uniseriate,vein,white	.2,0.5-1,1,1.5-1.8,2.2-6,3-10-flowered,3-6.5,5-ribbed,5.5-10,7.5-15,?,acuminate,anthesi,appearing,berry,closely,decurrent,deflexed,dia,differing,difoliate,eaf,edicel,eed,entire,epidermi,equal,erect,exserted,extension,free,geminat,hyaline,immature,large-celled,late,lateral,like,lobe,lon,lower,main,mainly,major,member,mere,middle,minor,narrowly,nflorescence,obscured,occasionally,older,one,pair,papillo,pore,poricidal,portion,prominent,pubescenc,reddi,reflexed,remaining,rib,ruit,shaped,sinus,size,slightly,somewhat,spaced,straight,strongly,tall,tear-drop,triangular,tub,ud,unit,upper,varying,wide,widest,woody,x,ympodial,young	3-10,9,abaxial,adaxial,arrangement,bud,cell,center,colour,diameter,flower,form,growth,height,history,inflorescence,life,na,new,number,peduncle,plant,position,rachi,reddish,reproduction,seed,shape,sightly,spacing,staman,texture,width
430	wfo-0001028980	invalid_json_followup	168	107	69	99	38	0.411	.5,0.5-1.5,1.2-1.8,1.5-1.8,1.5-2,1.5-6,4-5,5-6,6,acute,anther,apart,apex,bark,black,calyx,capitate,cm,coarsely,corky,corolla,elliptic,expanded,filament,flattened-reniform,fleshy,fruiting,furcate,globose,green,lamina,leaf,margin,minutely,mm,opposite,ovary,ovate,ovoid,paler,pedicel,peduncle,petiole,pitted,planar,pubescent,reddish,reflexed,scar,seed,shining,shrub,simple,slightly,small,sparsely,stem,stigma,style,surface,tall,thick,tree,trichome,uniseriate,white,woody,x,yellowish	.1,.75,/3,1-1.2,1.2-3,2.5,2.5-5,20-25-flowered,3-4,3/4,5-8,6-8,7-12,acuminate,along,anthesi,axil,basal,base,beginning,beneath,berry,broadly,clearly,conical,cucullate,deflexed,deltoid,densely,dia,differentiated,differing,difoliate,dry,drying,eaf,edicel,eed,exserted,extending,f,free,frui,geminat,glabrate,glabrous,glandular,impressed,incrassate,inflorescenc,lateral,lenticellat,like,lobe,lobed,lon,long,lower,m.,main,major,material,member,middle,minor,nflorescence,occasionally,older,one,pair,pale,papillose,pit,pore,poricidal,portion,prominent,ruit,scarious,shaped,sharply,size,soon,speciman,strongly,tapering,tear-drop,ti,tip,tube,type,ud,unit,usually,vein,way,widest,ympodial,young	'',20-25,[,``,abaxial,adaxial,arrangement,bud,cell,center,characteristic,colour,diameter,flower,form,fruit,growth,height,history,inflorescence,length,life,na,new,number,plant,position,prickle,rachi,reproduction,shape,spacing,staman,texture,value,width,{,}
431	wfo-0001028982	success	213	123	92	121	31	0.432	.5,0-0.2,0.3-0.6,0.4-1.1,1-1.5,1-2,1.5-2,1.5-2.5,13-18,3-4.5,4-,4-6,5-9,8-18,abaxially,absent,acicular,adaxially,angled,anther,articulated,attemuate,base,calyx,chartaceous,cm,connivent,contiguous,diameter,entire,erect,extra-axillary,filament,flower,fruit,fruiting,glabrous,gland-tipped,globose,green,hair,homostylous,inflorescence,interpetalar,lanceolate,leaf,length,lilac,linear-hastate,lobe,lobed,longer,loosely,margin,mm,moderately,narrowly,nearly,pale,pedicel,peduncle,perennial,petiole,prickle,pseudo-umbellate,rachi,red,reniform,rhizomatous,rugose,scattered,shallowly,shape,short,shrub,simple,solitary,sparsely,stellate,stellate-pubescent,stigma,straight,style,surface,tan,time,tissue,truncate,unbranched,wide,x,yellow	%,.3,0-2.5,0-3,0.2-0.3,0.2-0.4,0.25-0.5,0.3-0.7,0.3-0.8,0.3-2,0.35-0.5,0.4-0.65,0.5-0.6,0.5-1,0.5-1.3,0.8-1.5,0.8-2.5,1,1-3,1-locular,1.5-3,1.5-4.5,1.6-2.3,14-24,15-30,2-6,2.5-4.5,35-50,4-5,4-7,4.5-7.5,5-6,5-merou,6-8,8-16,9-16,absen,accrescent,across,acute,adult,alyx,apart,apex,apparen,armed,axe,ba,basal,blade,branch,branche,capitat,confined,cuneate,cylindrical,decimetre,deeply,directed,distall,distributed,dm,eaf,eed,eglandular,exocarp,finger,geminat,half,hastate,hig,incomplete,juicy,juvenile,lamina,lateral,less,long,lower,mature,mesocarp,mid-point,midpoint,midrib,midvein,minute,nflorescence,oblique,obtuse,orolla,overall,pair,part,per,perfect,placenta,pore,porrect,present,ray,ruit,septum,sessile,spaced,sparse,stellae,succulent,tamen,tem,thick,throughout,tissu,transparent,triangular,tube,unarme,unarmed,unit,upper,vary,ympodial	5-merous,abaxial,adaxial,arrangement,axillary,bark,bud,capitate,cell,center,colour,corolla,form,growth,height,history,life,na,new,ovary,plant,position,reproduction,scar,seed,spacing,staman,stem,texture,trichome,width
432	wfo-0001028984	invalid_json_followup	180	137	93	87	44	0.517	-14,-6,-65,0.5-,1,1-,1-6,1-9,1.2-4,1.5,10-20,15-35,2-,2-2.5,2-3,2-4,20-40,3-10,3-26,4-30,4-5,4-6,abaxially,acuminate,adaxially,age,apart,apex,apical,articulated,base,calyx,campanulate,chartaceous,cm,concave,densely,diameter,dilated,distally,eglandular,ellipsoid-fusiform,entire,especially,flower,forked,fruit,glabrous,gland,glandular-puberulent,greenish,leaving,long,margin,minutely,mm,moderately,obconical,ovate,ovoid,pale,papillose,pedicel,pedicellar,peduncle,petiole,pilose,puberulent,puberulent-pubescent,pubescent-pilose,purple,rachi,rarely,remnant,shrub,simple,small,spaced,sparsely,stigma,strongly,style,subcoriaceous,tomentose,toward,tree,turning,two,unbranched,unknown,violet,x,yellow	-2,-2.5,-3,-9,1-1.7,1-2,1-2.5,12-20,2,2-16,3-28,3-6,4-6.3,4-7,4-foliat,5,5-10,7-14,8-15,abruptly,absen,acute,adpressed,aggregate,almost,also,ape,axe,basal,blade,broad,broadly,cell,color,connective,cordate,directed,eaf,eed,equalling,exceeding,fleshy,globose,hair,lanceolate,laterally,lobe,lon,longer,lower,narrowed,near,nflorescence,nther,obtuse,often,orolla,perfect,pilo,pore,possibly,presence,present,pubescent-pilo,radiu,ripe,ruit,shorter,slightly,stamen,stone,swelling,tal,tem,thecae,time,tip,tomento,triangular,truncate,tube,ud,unit,unknow,vary,wide,ympodial	'',[,``,abaxial,adaxial,anther,arrangement,bark,bud,center,characteristic,colour,corolla,filament,form,fruiting,growth,height,history,inflorescence,leaf,length,life,na,new,number,ovary,plant,position,prickle,reproduction,scar,seed,shape,spacing,staman,stem,surface,texture,trichome,value,width,{,}
433	wfo-0001028997	success	136	105	75	61	30	0.551	.5,0.5-0.7,0.5-1.5,0.8-1.1,1-1.2,1-1.5,20-50-flowered,3-4,4-10,5-6,abaxially,acute,adaxially,anther,apex,appearing,area,bark,base,branched,broadened,calyx,cm,conical,corolla,difoliate,dry,drying,elliptic-obovate,erect,filament,filiform,flattened-reniform,fruiting,glabrous,globose,golden,green,height,leaf,lobed,long,many,matte,merely,minutely,mm,mustard,nearly,opposite,ovary,pale,papillose,pedicel,pericarp,petiole,pitted,scar,shiny,shrub,spaced,stem,stigma,style,surface,tan,terminal,thick,time,trifoliate,unevenly,unknown,white,x,yellow	0.5-1,2-2.5,2-3.5,3.3.5,4-4.5,4-angled,6-10,6-7,anthesi,apar,attenuate,ba,berry,coriaceous,cucullate,deflexed,dia,eaf,edicel,eed,elliptic,exserted,fragrant,free,geminat,glabrou,greenish-brow,incrassate,later,lateral,lobe,lon,lower,main,margin,middle,nflorescence,older,pair,partially,pore,poricidal,portion,quadrate,revolute,ruit,shaped,specimen,strongly,styl,tear-drop,thickened,tip,tub,tube,ud,vein,widest,woody,ympodia,young	abaxial,adaxial,apart,arrangement,bud,colour,diameter,flower,form,fruit,greenish-brown,growth,history,inflorescence,length,life,na,number,peduncle,plant,position,rachi,reproduction,seed,shape,spacing,staman,sympodia,texture,width
434	wfo-0001029003	success	207	128	99	108	29	0.478	0.5,1-10,1-2,1.2-2.5,11-32,13-36,2.5-10,3,4-8,5,5-10.5,5-12.5,7-9,abaxially,acuminate,adaxially,anther,apex,articulated,axillary,berry,blue-violet,brownish,bud,cell,chartaceous,ciliate,cm,condition,conical,corolla,covering,diameter,drying,elliptic,end,filament,flower,forked,fourth,fresh,fruit,glabrous,green,green-white,greenish,hair,hair-like,herb,highly,honeycomb-shaped,lanceolate,lateral,leaf,leaflet,light,like,margin,medium,membranous,middle,minute,mm,obtuse,odd-pinnate,one,ovoid,pale,pedicel,peduncle,pentagonal,petiole,pigmentation,placed,plant,proximal,pubescent,purple,ripe,rotate,rounded,seed,sometimes,sparsely,stem,stigma,style,subcapitate,subtending,terminal,testal,thick,throughout,tuber,typically,violet,wall,whitish,yellow	0-6,0.3-0.5,0.4-3,1,1-2.5,1-3,1-5,1.2-1.9,1.5-2.3,12.2-30,2-6,2.5-7.5,3-20,3-5,3.5-7.5,5-merou,7-15.5,9-14,absent,acumen,ag,alyx,apart,apparently,attenuate,axe,base,blade,capitat,connivent,decreasing,digestion,distal,dorsally,eaf,edge,eed,elongated,enzyme,equal,erec,especially,exceeding,flat,folded,geminat,generally,glabrou,gradually,hal,half,homostylous,interjected,larger,lengthening,living,lobe,long,lower,make,mottled,mucilaginous,nflorescence,orbicular,orolla,ovate,pair,perfect,petiolule,plurifoliate,pore,poricidal,prostrate,rarely,ray,removed,ruit,secondary,sessile,seudostipule,size,slightly,slit,spaced,specimen,stamen,ste,stolo,straight,subequal,subglabrous,symmetrical,tall,tamen,tem,tip,toward,tri-,tube,unit,usually,vary,wet,white,wide,wing,x,ympodial	abaxial,adaxial,arrangement,capitate,center,colour,form,growth,height,history,inflorescence,length,life,na,number,ovary,perennial,placement,position,pseudostipule,rachi,reproduction,shape,spacing,staman,stolon,surface,texture,width
435	wfo-0001029006	invalid_json_followup	217	161	122	95	39	0.562	-+,0.2,0.4-2.5,0.5,0.5-4,1,1-1.5,1.8-2.2,10,2-3,2-6,3.5-4,5,50,7-8,<,>,abaxially,acuminate,acute,adaxial,along,anther,anthesi,apex,area,axil,base,berry,bilobed,blackish,branched,c.,calyx,cell,chartaceous,cm,corolla,dense,diameter,ellipsoid,elliptic,entire,extending,filament,filiform,flattened,flower,fruiting,glabrous,globose,green,groove,growth,inflated,inflorescence,irregularly,lamina,later,lateral,lobed,long,many,margin,membranous,midrib,minutely,mm,narrowly,new,nodding,occasionally,often,pale,papillate,pedicel,peduncle,pentagonal,perfect,petiole,pinnatifid,pitted,puberulent,pubescent,purple,purplish,reddish,reniform,ripe,rotate-stellate,shiny,simple,somewhat,spaced,sparsely,spreading,stem,stigma,strongly,style,surface,tan,terminal,testal,thin,time,tiny,tip,trichome,tuft,uniseriate,usually,variously,vein,vine,violet,way,white,woody,x,young,zig-zag	.5,0.5-2,1-4,1-5,1.2-1.5,1/3,10-20,2.5,4-6,5-6,5-merou,7-9,adaxiall,ag,age,alyx,apar,ark,articulated,asymmetrical,axi,basal,beyond,black,bright,broadest,clavat,conical,connivent,deeply,deltate,depending,drying,eaf,eed,elongate,exserted,free,growing,ilament,intramarginal,irregular,keeled,leaving,lengthening,lobe,loosely,lower,markedly,minute,nearly,nflorescence,oblique,obvious,older,one,orolla,pair,part,peg,pendan,per,pericarp,planar,plurifoliat,pore,poricidal,portion,primary,puberulen,reaching,ruit,sagittate,scar,size,sleeve,slit,small,smaller,sometimes,strong,sunligh,tem,truncate,tube,twinin,twining,ud,unit,upper,variable,vary,widest,within,ympodial	'',5-merous,[,``,abaxial,adaxially,apart,arrangement,bark,bud,characteristic,clavate,colour,form,fruit,height,history,leaf,length,life,na,number,ovary,perennial,plant,position,prickle,rachi,reproduction,seed,shape,spacing,staman,texture,u00bd,value,width,{,}
436	wfo-0001029021	invalid_json_followup	161	114	81	80	33	0.503	0.8-1,1-2,1.1-1.3,1.5-2,1.5-3,1.8-2,2,3/4,5.5-6,8-10,abaxial,abaxially,acute,adaxial,along,anther,apex,bark,base,bi-lobed,black,broadly,calyx,cm,conical,corolla,darker,decurrent,dendritic,densely,diameter,elliptic,filament,flattened,flower,fruit,fruiting,glabrate,glabrous,globose,grey-brown,growth,lamina,leaf,lenticular,lobed,long,loose,loosely,margin,minutely,mm,ovary,ovate,pedicel,pericarp,petiole,pitted,plurifoliate,pubescent,purple,reddish-brown,revolute,scar,shiny,shrub,sparsely,stem,stigma,strongly,style,surface,tapering,terminal,thin,tiny,trichome,vein,violet,way,winged	0.5-1,0.8-1.2,0.8-2.1,1-1.5,1-3.4,1-4,2-2.5,3,3-6,3.5,absent,adaxially,age,anthesi,apical,appearing,axi,ba,basal,becoming,berry,blade,branching,caudate,coriaceous,deciduous,deflexed,denser,eaf,edicel,eed,ew,exserted,fleshy,free,im.,impressed,inserted,later,lateral,lax,lobe,long-triangular,lower,m.,monochasia,nflorescence,nodding,older,outline,overtopping,pair,papillo,per,planar,pore,poricidal,portion,prominently,raised,ruit,scattered,secondary,shoot,simple,sleeve,slit-like,stamen,ste,time,tip,tub,tube,ud,unit,wide,woody,x,ympodial,young	'',[,``,arrangement,bud,characteristic,colour,form,height,history,inflorescence,length,life,na,new,number,papillose,peduncle,perennial,plant,position,prickle,rachi,reproduction,seed,shape,spacing,staman,texture,value,width,{,}
437	wfo-0001029031	invalid_json_followup	213	141	106	107	35	0.498	-11.4,-12.3,-8,.1-0.3,.5-1.2,0-5,0.1-0.5,0.5-1.5,0.5-4,0.6-1.2,1-1.5,1-5,1-9.4,2-3,2.5-5.5,20-150,3-10,5-17,abaxially,accrescent,acuminate,acute,adaxially,angle,anther,apart,apex,becoming,black,bluish,branched,brown,calyx,capitate,chartaceous,cm,corolla,densely,diameter,elliptic,elliptic-ovate,entire,erect,filament,flattened,flower,forked,fruit,fruiting,glabrescent,glabrous,globose,green,hair,held,immature,lateral,leaf,leaf-opposed,length,light,like,margin,mm,obtuse,occasionally,orange,outline,pedicel,peduncle,peltate,peltate-stellate,petiole,possibly,pseudoterminal,pubescent,rachi,rarely,reniform,ripening,rugulose,sessile,short-stalked,shrub,silvery,simple,slightly,small,sparsely,stellate,stellate-pubescent,stem,stigma,strongly,style,suborbicular,surface,tree,trichome,unbranched,usually,white,whitish,x,yellow,yellowish	-3.6,0.5,0.7-1.1,1-2,1-2.5,1-2.6,1-3,1.3-3.3,1.5-2.8,1.5-3.5,1.8-2.7,1.8-4,1/3,10,13.5,2-10.7,2-3.3,2-5,2.5-5.6,4-5-,4-7.5,6-12,6-21,absent,adaxiall,ag,apexacute,apparently,around,articulated,axe,ba,base,berry,bilobe,blade,center,connivent,covering,cuneate,curved,cylindrical,deltate,denser,directed,distally,eaf,edge,eed,eglandula,eglandular,equal,farinose,fleshy,frui,fused,geminate,impressed,inserted,lanceolate,large,least,lobe,long,longitudinal,lower,major,many-foliate,midpoint,midvein,nearly,nflorescence,oblong,opening,orolla,paired,perfect,pore,porrect-stellate,prominent,pubescen,pubescence,ray,rounded,ruit,short,side,slit,smaller,sometimes,somewhat,spaced,ste,straight,subtending,tall,tamen,tem,time,tip,tube,unarme,unit,vary,vein,wide,ympodial	'',[,``,abaxial,adaxial,arrangement,bark,bilobed,bud,characteristic,colour,form,growth,height,history,inflorescence,life,na,new,number,ovary,plant,position,prickle,reproduction,scar,seed,shape,spacing,staman,texture,value,width,{,}
438	wfo-0001029047	success	168	100	72	96	28	0.429	.5,0.1-0.5,0.5-2,0.7-1,0.7-3,1-4,1.25,3-5,4-5,6-7,acute,anther,apex,arching,bark,base,beneath,broadly,brown,bud,campanulate,cm,corolla,elliptic,evenly,filament,filiform,flower,glabrous,globose,green,herbarium,leaf,lobed,midrib,minutely,mm,mustard,nearly,opposite,ovary,ovate,ovoid-reniform,papillose,part,pedicel,petiole,pitted,principal,pubescent,reddish-brown,scar,shape,shining,shrub,simple,slender,smooth,soft,spaced,specimen,stem,stigma,style,surface,tapering,trichome,uniseriate,vein,white,x,yellow	'',.25,0-2,0.05-0.5,0.1-0.75,0.3-1.9,0.5-1,1,1-1.2,10-11,2.1-2.6,2.5,3.6-8.5,5-20-flowered,5-9,8365,9.5-19.6,``,across,acuminate,amd,anisophyllou,anthesi,aspec,ba,back,bearing,beginning,berry,branch,calyx,deflexed,deltoid,dia,differing,difoliate,distinctly,eaf,edicel,eed,flattened,free,fruiting,geminate,giving,glabrou,herb,impressed,inflorescenc,kruckoff,lateral,lenticellate,like,lobe,lon,long,lower,main,major,margin,markedly,middle,minor,much-branched,nflorescence,occasionally,older,orbicular,pale,pically,pore,poricidal,portion,prominent,reflexed,rounded,ruit,shaped,shorter,smaller,somewhat,sparsely,strongly,styl,tall,tear-drop,thread-like,time,tip,tube,ud,unit,widest,woody,ympodial,young	5-20,abaxial,adaxial,arrangement,colour,diameter,form,fruit,growth,height,history,inflorescence,length,life,na,new,number,peduncle,perennial,plant,position,rachi,reproduction,seed,spacing,staman,texture,width
439	wfo-0001029048	invalid_json_followup	162	103	62	100	41	0.383	.01,.5,0.5,0.5-1.7,1,1-2,1-8,1.5-2,11,3-4,3-7,5-8,acuminate,anther,apex,bicellular,bright,calyx,cm,corolla,elliptic,filament,filiform,flower,fruiting,glabrous,globose,green,greenish-white,greenish-yellow,hanging,hispidulous,leaf,less,lobed,margin,minutely,mm,opposite,ovary,ovoid-reniform,pale,papillose,pedicel,petiole,pitted,puberulent,scar,shrub,slightly,small-capitate,stem,stigma,style,surface,tan,thread-like,trichome,uni-,unifoliate,winged,x	.2,/3,0.5-1,0.8-1,14,2,25,26,3.5-4,4-6,8-10,9-15,angle,another,anthesi,apar,apparent,arching,attenuate,basal,base,bearing,becoming,beneath,berry,blade,branch,broadly,conical,decurrent,dia,eaf,edicel,eed,elongated,except,expanded,f,free,geminate,glabrate,golden,greatly,greenish-yello,incrassate,lateral,like,live,lobe,long,lower,main,matte,middle,midrib,minute,much,nflorescence,node,non-reproductive,obovoid,obtuse,older,one,pair,papillo,parallel,planar,pore,poricidal,portion,reflexed,right,ripe,rounded,ruit,shaped,sharply,slender,somewhat,spaced,specimen,straight,tall,tapering,tear-drop,time,tip,translucent,tube,ud,unevenly,unit,vein,way,widely,widest,ympodial,young,zig-zag	'',[,``,abaxial,adaxial,apart,arrangement,bark,bud,cell,center,characteristic,colour,diameter,form,fruit,growth,height,history,inflorescence,length,life,na,new,number,peduncle,perennial,plant,position,prickle,rachi,reproduction,seed,shape,spacing,staman,texture,value,width,{,}
440	wfo-0001029053	invalid_json_followup	275	150	98	177	52	0.356	1.5,1/3,21,3.5,4.9,abaxially,across,acuminate,acute,adaxially,along,anther,apart,apex,attachment,bark,base,becoming,bent,blade,bud,calyx,cm,congested,corolla,densely,diameter,distal,distally,dry,emerging,entire,extra-axillary,filament,flattened-oval,flower,fruit,glabrous,glandular,glandular-pubescent,globose,gradually,hair,heterostylous,increasing,internode,interpetalar,lanceolate,lateral,length,long,main,margin,mature,minute,mm,moderately,notched,oblong,orange,ovate,overlapping,pedicel,peduncle,petiole,point,porrect,probably,pubescence,pubescent,red,sessile,short,short-stipitate,shrub,simple,smooth,sometimes,stellae,stellate,stellate-pubescent,stem,stigma,straight,style,subopposite,surface,tissue,twice-branched,unbranched,upper,vein,well-developed,white,yellow,yellow-tan,young,±90°	.04,.3,.7,.9,0.1,0.2,0.2–0.6,0.3–0.4,0.3–0.7,0.4–0.8,0.5–0.6,0.5–1.1,0.6–1.3,0.7–1.0,0.7–1.1,0.7–1.2,0.7–1.3,0.7–1.7,0.7–3.4,0.8–1.0,0.8–1.2,1.0–1.6,1.1–1.3,1.3–2.0,1.4–2.0,1.5–2.5,1.5–2.7,1.6–9.2,1.7–1.8,1/2–2/3,1/3–1/2,2.0–2.3,2.0–2.8,2.1–2.4,2.1–3.8,2.4–2.8,2.4–5.1,2.5,3.5–7.2,4.5–6.2,5-merou,5.4–7.1,5–8,6.6,6.8–15.2,6–12,7.1–9.7,7–8,8,8.0–14.5,8.5–15.8,90°,accrescent,adnate,aequilateral,ag,alyx,anthesi,apical,apiculate,apparently,appearing,appressed,around,articulate,attenuate,axe,ba,basal,beneath,berry,borne,branch,broad,brochidodromous,capitat,caudate,channeled,clinate,coat,criss-cros,deciduous,deltoid,dentate,development,difoliate,directed,distinct,eaf,edge,eed,either,endocarp,erect,exocarp,extending,fertile,filiform,free,geminat,glossy,individually,intact,intersepalar,juic,lacking,layer,less,lobe,lon,longer,lower,many,markedly,midpoint,midrib,midvein,much,nearly,nflorescence,oblique,opaque,ove,pattern,per,perforated,pore,portion,potentially,raised,ray,remaining,revealing,rigid,rounded,row,ruit,seen,semisucculent,shorter,side,sinus,slightly,sloughing,smoot,soon,spaced,sparsely,splitting,spread,spreading,stamen,stipe,suture,tamen,tem,thin,time,tip,transparent,truncate,tube,two,ud,unarmed,unit,various,vary,weakly,well,wide,yellow-ferruginous,ympodial,±equal,±glabrous,×,–10	'',0.7-1.2,0.7-1.3,0.7-1.7,1.1-1.3,1.4-2.0,1/2-2/3,2.0-2.8,2.4-2.8,2.4-5.1,5-merous,5.4-7.1,6.8-15.2,8.0-14.5,8.5-15.8,[,``,abaxial,adaxial,arrangement,capitate,characteristic,colour,form,fruiting,growth,height,history,inflorescence,leaf,life,na,new,number,ovary,perennial,plant,position,prickle,rachi,reproduction,scar,seed,shape,spacing,staman,texture,trichome,value,width,{,}
441	wfo-0001029055	success	169	102	74	95	28	0.438	0.4-1.5,1-4,1-5,1.8-3.5,14-50,4-6,5-24,5.5-9,8-9,apex,articulate,branched,cell,cm,corolla,covered,covering,cyme,dark,densely,diameter,dichasial,dichasially,distal,dorsally,ebracteate,elliptical,filament,flat,flower,folded,gland,green,green-white,hair,hair-like,half,herbaceous,lateral,leaf,longitudional,mm,monochasial,odd-pinnate,outline,ovate,ovoid,pedicel,peduncle,pentagonal,perennial,petiole,pilose,plant,proximal,pubescent,purple,rotate,seed,short,short-stalked,sometimes,spreading,stigma,stripe,style,testal,thick,throughout,triangular,type,wall,yellow,¼	1-2.6,1.6-3.5,1.7-2.2,2-1.,2-3,2-4,2.2-3,2.5-8,3,3-10,3-6,3-6-foliat,4-10,4-7,6-14,9-22,abaxially,acumen,acuminate,acute,adaxially,apical,apically,attenuate,base,calyx,connate,cordate,cuneate,decurrent,dehiscent,digestion,diminishing,eaf,edge,eed,elliptcal,emoval,enzyme,exceeding,first,forked,generally,globo,honeycomb,interjected,introrse,leaflet,living,lobe,lon,long,long-attenuate,longer,lower,lunat,make,maturing,mucilaginous,near,nflorescence,nther,oblique,often,orolla,pair,pattern,perfect,plan,poricidally,rarely,reveal,ruit,second,sessile,seudostipule,short-petiolate,size,slit,specimen,stamen,straight,tal,tem,terminal,time,toward,tuber-bearing,typically,unit,vary,whit,wide,widest,ympodial	abaxial,adaxial,anther,arrangement,center,colour,form,fruit,globose,growth,height,history,inflorescence,length,life,na,number,ovary,position,rachi,reproduction,shape,spacing,staman,surface,texture,white,width
442	wfo-0001029056	invalid_json_followup	140	104	51	89	53	0.364	.2,.5,1/3-1/2,3-5-lobed,3-5-rayed,3-6,5-9,7-10,annual,anther,blade,broadly,calyx,capitate,cm,coarsely,densely,dentate,developing,dm,externally,glabrous,glandular,green,hair,herb,invested,irregularly,length,long,mm,often,ovate,petiole,pinnately,prickle,purplish,scattered,sessile,simple,stellate,stellate-pubescent,stem,subulate,surface,terete,tightly,tube,uniseriate,white,yellow	-5,0,0.3-0.5,0.7-1.0,4,6-10,6-8-flowere,across,acute,along,also,alyx,ample,anthesi,attenuate,basally,base,black,branched,campanulate,cauline,central,consisting,dia,difoliate,divided,eaf,eed,elongated,erect,externall,flanking,geminat,gland,intermixed,internod,know,known,lacking,large,linear-lanceolate,lobe,lon,lower,major,marking,midpoint,much,nflorescence,numerous,obtuse,occasional,one,orolla,present,prickly,ray,reduced,ruit,separated,sharply,short-stipitate,shorte,side,slende,slender,somewhat,sparse,spreading,starlike,stellae,strait,strongly,swollen,tall,tamen,taprooted,terminally,tigma,tip,tub,tyle,unit,upturned,vary,vein,vestiture,villous,ympodial	'',3-5,6-8-flowered,[,``,abaxial,adaxial,apex,arrangement,bark,bud,cell,center,characteristic,colour,corolla,diameter,filament,flower,form,fruit,fruiting,growth,height,history,inflorescence,internoda,leaf,life,margin,na,new,number,ovary,pedicel,peduncle,plant,position,rachi,reproduction,scar,seed,shape,spacing,staman,stigma,style,texture,trichome,value,width,{,}
443	wfo-0001029059	invalid_json_followup	199	125	85	114	40	0.427	.5,0.1-0.5,0.5-1,1-3,1-4,1-6,1.2-3,1.3-1.7,1.5-2.8,3.5-6,7-9,acute,along,anther,apex,bark,base,branched,bud,calyx,clavate,cm,corolla,deep,dense,densely,dia,dirty,elliptic,extremely,filament,flattened-reniform,fruiting,glabrous,globose,hispidulous,inflorescence,leaf,lobed,long,major,margin,minute,minutely,mm,nearly,occasionally,opposite,orange,orangish-yellow,ovary,pair,pale,papillose,pedicel,petiole,pitted,pubescence,pubescent,purplish,ripe,scar,shape,shrub,simple,slender,small,sparse,stem,stigma,style,surface,tapering,tinge,tree,trichome,tube,underside,uniseriate,variable,vein,waxy,white,yellowish-green,yellowish-tan	0.1-1,0.2,0.2-0.5,0.5,1-1.2,1-1.5,1.5-2,10-19,2.5,3-3.5,3-6.5,3.5-8,4-10.5,5,5-15-flowered,6-10,anisophyllou,anthesi,apar,ape,apiculae,apiculate,arising,beneath,berry,bout,closely,coiba,connivent,cordate,covered,cuneate,de,deflexed,deltoid,differing,difoliate,eaf,edicel,eed,ellipsoid,expanded,exserted,extending,foetid,free,geminate,glabrate,greatly,impressed,incrassate,interpetalar,isla,lamina,lateral,lobe,lon,longest,lower,main,member,membranous,middle,minor,narrowly,nflorescence,oblique,often,older,one,orbiculate,paler,panama,papillo,partially,planar,pointed,population,pore,poricidal,portion,prominent,reddish-gre,rest,rounded,ruit,shallowly,shaped,sinus,size,somewhat,soon,spaced,specimen,straight,tall,tear-drop,terminal,thickened,ti,tightly,tip,triangular,ud,unicellular,unit,usually,wide,widest,woody,x,yellowish,ympodial,young	'',5-15,[,``,abaxial,adaxial,alternate,apart,arrangement,center,characteristic,colour,diameter,flower,form,fruit,growth,height,history,length,life,na,new,number,peduncle,perennial,plant,position,prickle,rachi,reddish-grey,reproduction,seed,spacing,staman,texture,value,width,{,}
444	wfo-0001029065	success	202	106	84	118	22	0.416	0.5-1,0.5-1.5,0.5-4,1,1-2.5,1-6,10-20,2,2-3,2-4,2-5,3-7,4-8,5-15,7-10,abaxial,abaxially,absent,acute,adaxial,andromonoecious,anther,apex,base,brown,chartaceous,cm,contiguous,cylindrical,dark,densely,diameter,extra-axillary,filament,flower,fruit,functionally,glabrous,globose,green,green-brown,hermaphroditic,immature,leaf,light,lobed,male,many,mature,mm,moderately,nearly,netlike,orange,ovary,ovate,pedicel,peduncle,petiole,pit,plant,porrect-stellate,prickle,pubescent,rachi,raised,red,reniform,ridge,roselike,separated,simple,small,spaced,sparsely,stigma,style,surface,unbranched,vine,white,woody,x,yellow	0.2-0.4,0.5,0.5-1mm,1-2,1-3,1-5,1.,1.5-2,1.5-2.5,1.5-3,1/3,2-15,2-2.5,2-ranke,3-6,30-60,4-7,5,5-10,5-7,8,8-12,8-20,accrescent,adaxiall,adaxially,alyx,apar,apical,armed,asymmetrical,attenuate,axe,berry,beyond,blade,calyx,charteacous,connivent,cordate,cut,difoliate,directed,discolorous,eaf,eed,either,em,exserted,flattened,frui,fruiting,geminate,generally,glabrou,glandular,gree,hair,heteromorphic,introsel,leathery,less,like,lobe,long,long-styeld,lower,m.,major,margin,merou,midpoint,midrib,midvein,multicellular,multiseriate,narrowly,nflorescence,obtuse,often,older,orolla,pair,per,pore,ray,recurved,ruit,sessile,short-styled,side,sinus,slightly,stalk,stamen,staminate,stellate,stem,straight,strongly,tamen,tapering,triangular,tube,unarmed,unequa,unicellular,uniseriate,unit,unlobed,usually,vary,vein,way,wide,ympodial,young,¼	10,apart,arrangement,colour,corolla,form,growth,height,history,inflorescence,length,life,number,perennial,position,reproduction,seed,shape,spacing,staman,texture,trichome
445	wfo-0001029072	invalid_json_followup	235	132	98	137	34	0.417	0.1-0.4,0.4-0.9,0.5-2,0.5-3,0.8-1.5,1-1.2,1-1.5,1-25,1.5-2.6,1/3,1/4-1/2,12-19,2-5,2-7,2-8,2.5-3.5,3-5,3-8,4.2-6.5,5-10,5-7,abaxial,abaxially,acute,adaxial,andromonoecious,anther,apart,apex,bark,base,berry,branched,bright,calyx,chartaceous,cm,conical,cream,curved,dark,densely,diameter,dirty,dull,erect,filament,flattened,flattened-reniform,flower,fruit,fruiting,glabrous,green,green-brown,herb,lateral,leaf,length,lobed,long-styled,margin,marking,maturity,mauve,mm,orange-brown,ovate,pale,pedicel,peduncle,pendent,petiole,plant,porrect,prickle,reflexed,rounded,scar,short-styled,shrub,simple,sparsely,spherical,stalked,stellate,stellate-pubescent,stem,style,surface,terminal,trichome,upper,way,white,whitish,yellow,young	-1/2,-15,-2.5,.5,/6,0,0-2,0-20,0-4,0-8,0.2-0.3,0.2-0.4,0.3,0.7,0.8,00-200,1,1-3,1.5-2.5,1.5-3.2,1/4-1/3,2-10,2.2-2.5,2.2-3.2,2.5-3.8,2.5-4.5,20-50,3-10,3-20,3-50,3.5-6,3/,4-,4-10,4.5-9,5-50,5-9,5-merous,7-10,7-15,8-20,8-27,adaxially,alyx,ame,angled,apar,apically,apparently,articulated,blade,broad-deltate,broadly,c.,clearly,connivent,cordate,cuneate,deltate,discolorous,distal,distance,drying,eaf,eed,elongated,elongating,equal,extending,free,gently,gra,hermaphrodite,heterostylous,infructescence,least,lobe,long,longer,longitudinal,lower,lowermost,mature,midpoint,midvein,moderately,multangulate,narrow-deltate,nflorescence,obtu,older,one,open,orolla,oung,pair,pendulous,per,pericarp,plurifoliat,poricidal,portion,prickl,prickly,primary,raised,ray,ridge,ruit,sessile,side,smooth,sometimes,spaced,spreading,stalk,staminat,stout,straight,strongly,tamen,tapering,tertiary,time,tip,tube,unarmed,unit,variously,vary,vein,venation,visible,weakly,wide,woody,ympodial	'',/,[,``,arrangement,bud,characteristic,colour,corolla,form,gray,growth,height,history,inflorescence,life,na,new,number,ovary,perennial,position,rachi,reproduction,seed,shape,spacing,staman,stigma,texture,value,width,{,}
446	wfo-0001029073	invalid_json_followup	211	135	102	109	33	0.483	.5,0.3-1,0.5-1,0.6-2,1-1.5,1-3,1.5-2,10-16,2,2-3,2-4,4-5,5-merous,7-10,8-14,acute,adaxially,anther,apart,apex,bark,beneath,berry,broad-based,brown,calyx,cm,conical,corolla,curved,dark,darker,dense,densely,diameter,elliptic,entire,filament,flattened,flower,fruiting,glabrous,globose,growth,hooked,inflorescence,internodal,interpetalar,lanceolate,leaf,length,lobed,long,margin,maturity,minutely,mm,narrowly,new,occasionally,orange,pale,paler,papillose,pedicel,peduncle,petiole,porrect,prickle,prickly,pubescent,purple,reniform,reticulate,scar,sessile,shallowly,shiny,short-stalked,shrub,simple,sinuate,somewhat,sparsely,stellate,stem,stigma,straight,strongly,style,surface,tan,tapering,thin,tip,tissue,trichome,truncate,unarmed,unequally,x,yellowish	.7,0.5,0.6-0.7,1-1.2,1-2.5,1.1-1.5,1.2-1.6,10-15,2/3,3.5-9,4-6,5-6,5-8,6-9,abaxially,acuminate,along,another,anthesi,armed,articulated,away,awn-like,ba,basal,base,cell,chartaceous,cream,difoliate,dimorphic,discolorous,drying,eaf,eed,enlarged,equal,erect,except,exserted,four,free,frui,geminat,golden,gre,lamina,lengthening,like,linear,lobe,long-styled,lower,midpoint,midvein,mixture,multangulate,nflorescence,nodding,oblique,older,one,opposite,pair,per,perfect,pericarp,planar,plurifoliate,pore,poricidal,portion,primary,pubescence,ray,rectangular,ruit,short,shorter,slightly,slit,sometimes,spaced,splitting,styled,testal,three,ti,triangular,tube,two,ud,underside,unequal,unisexual,unit,upper,upward,vein,visible,wall,way,whitish,wide,woody,yellow,ympodial,zygomorphic,½	'',0.7,[,``,abaxial,adaxial,arrangement,bud,center,characteristic,colour,form,fruit,grey,height,history,life,na,number,ovary,plant,position,rachi,reproduction,seed,shape,spacing,staman,texture,value,width,{,}
447	wfo-0001029074	invalid_json_followup	174	123	89	85	34	0.511	.1,0.2-1,0.3-0.8,0.5-1,0.5-1.2,0.7-0.8,1-1.5,1-2,1.4-1.8,1.5-2,11,3-6,3.5-5,abaxially,acute,adaxially,anther,apart,apex,apparently,bark,base,berry,black,broadly,calyx,capitate,cm,conical,corolla,densely,diameter,ellipsoid,entire,filament,flattened,flower,fruiting,glabrous,globose,green,grey,growth,herb,immature,internodal,leaf,less,lobed,margin,minutely,mixture,mm,new,opposite,ovary,ovate,pale,pedicel,peduncle,petiole,pitted,pubescent,pulp,purplish,reniform,ripening,rounded,scar,sessile,simple,sparsely,stalked,stellate,stellate-pubescent,stem,stigma,style,subshrub,surface,thin,trichome,uniformly,watery,way,white,x,yellowish,¾	.5,0,0.3-0.4,0.7-0.95,1,1-,1-1.2,1.5-4,2-2.3,2-4,2-5,2-7,3-,5-6,5-7,absent,age,almost,along,anthesi,appearing,articulation,basa,cuneate,deflexed,denser,eaf,eed,exerted,expanding,free,frui,glabrescen,lacking,lengthening,lignescent,like,lobe,longest,lower,markedly,midpoint,midvein,nflorescence,obscuring,often,older,pair,papillat,per,perfect,pericarp,petal,planar,plurifoliat,pore,poricidal,portion,primary,prominent,ray,reflexed,ruit,sagittate,scattered,slit,small,somewhat,stalk,strongly,swollen,tip,triangular,truncate,tub,tube,ud,underside,uniseriate,unit,usually,vein,woody,yellow,ympodial	'',[,``,abaxial,adaxial,arrangement,bud,center,characteristic,colour,form,fruit,glabrescent,height,history,inflorescence,length,life,na,number,plant,position,prickle,rachi,reproduction,seed,shape,spacing,staman,texture,value,width,{,}
448	wfo-0001029075	success	217	106	79	138	27	0.364	0.8-1.5,1-10,1-2,10-20,2-5,2.5-3,30-60,4-10,4.5-6.5,5-10,6-12,8-9,abaxially,adaxially,anther,apex,attenuate-acuminate,brownish,canescent,cell,cm,condition,corolla,covering,dark,densely,diameter,dot,drying,elliptic-lanceolate,filament,flecked,flower,forked,fresh,fruit,glabrous,glandular-puberulent,gray-green,green,greenish,hair-like,herb,lanceolate,lateral,leaf,minutely,mm,narrowly,odd-pinnate,ovoid,pedicel,peduncle,pentagonal,petiole,plant,pointed,puberulent,pubescent,rachi,seed,short,size,small,stigma,style,subobtuse,substellate,terminal,testal,thick,tuber,wall,white,whitish,whitish-gray,yellow,yellow-green,yellowish-white	.3,.5,0-3,0-8,0.5-0.8,0.8-1.2,1-2.5,1-3,2-4,2.7-4.2,4-14,4-5,4-7,5-8,5-8.5,5-merou,7-17,7-9,abruptly,acumen,ag,along,alyx,apart,apparently,articulated,atypically,axe,axillary,base,berry,blade,broadly,brown,bud,ciliate,clavifor,connivent,cuneate,decreasing,decurrent,digestion,distal,dorsally,eaf,edge,eed,end,enzyme,erect,erect-ascendin,especially,etota,exceeding,flat,folded,geminat,generally,glabrescent,glabrou,glandular-pilose,gradually,greatly,green-white,hair,half,homostylous,honeycomb-shaped,interjected,larger,leaflet,lengthening,light,like,living,lobe,long,long-spatulate,lower,make,margin,middl,midrib,mucilaginous,narrowed,nflorescence,orbicular,orne,orolla,ovate,pair,perfect,petal,petiolulate,petiolule,plurifoliate,pore,poricidal,purple,removed,rounded,ruit,sec,sessile,seudostipule,singly,slightly,slit,sometimes,spaced,specimen,stamen,ste,stem,stolo,straight,subequal,subquadrate,subtending,tall,tamen,tem,throughout,tip,toward,tri-,tube,typically,unit,unwinged,upper,usually,vary,wet,wide,woody,x,ympodial	abaxial,adaxial,arrangement,center,claviform,colour,form,growth,height,history,inflorescence,length,life,na,number,ovary,perennial,position,pseudostipule,reproduction,shape,spacing,staman,stolon,surface,texture,width
449	wfo-0001029084	success	192	86	59	133	27	0.307	.5,1-10,1-2,10-50,2-3.5,3.5-7.5,4-17,4-7,4.5-6.5,5,7-9,8-23,abaxially,acuminate,adaxially,anther,apex,chartaceous,cm,conical,corolla,diameter,filament,flower,forked,fruit,glabrous,green,green-white,greenish,herb,honeycomb-shaped,leaf,light,lilac,minute,minutely,mm,moniliform,odd-pinnate,ovate-lanceolate,ovoid,pedicel,peduncle,petiole,plant,puberulent,pubescent,purple,rotate,seed,sparsely,stigma,style,subglabrous,terminal,tuber,whitish,yellow	0.8-2,0.8-2.1,1-3,1-4,1.1-2.2,1.5-2.5,2-4,2-5,3-6,3.5-8,4.5-10,5-7,5-merou,6-13,absent,acumen,ag,along,alyx,apart,apparently,arranged,articulated,axe,axillary,base,bead,berry,blade,brownish,bud,capitat,cell,ciliate,condition,connivent,covering,darker,decreasing,digestion,distal,dorsally,drying,eaf,edge,eed,enzyme,especially,exceeding,flat,folded,fresh,geminat,generally,glabrou,gradually,hair-like,half,homostylous,interjected,interpetalar,lanceolate,larger,lateral,leaflet,lengthening,like,living,lobe,lon,long,lower,make,margin,middle,midrib,mottled,mucilaginous,multiple,narrow,necklace,nflorescence,obtuse,orolla,pair,perfect,petiolule,pilose,plurifoliate,pore,poricidal,proximal,ray,removed,ripe,ruit,secondary,semierec,seudostipule,size,slit,spaced,specimen,stamen,stolon,subequal,subglabrou,subsessile,subtending,symmetrical,tall,tamen,tem,testal,thick,thir,throughout,tip,tissue,toward,tri-,tube,typically,unit,unwinged,usually,vary,wall,wet,wide,wing,x,ympodial	abaxial,adaxial,arrangement,capitate,center,colour,form,growth,height,history,inflorescence,length,life,na,number,ovary,perennial,position,pseudostipule,rachi,reproduction,shape,spacing,staman,surface,texture,width
450	wfo-0001029087	success	226	104	73	153	31	0.323	0-0.5,0-14,0.1-2,0.3-0.8,0.5-0.75,0.5-2.3,0.7-2.2,1-1.5,1.5-1.75,11-20,2-3,2-7,3-8,3.5-5.5,8-12,accrescent,acicular,andromonoecious,anther,calyx,chartaceous,cm,dark,densely,diameter,entire,extra-axillary,filament,finely,flattened,flower,fruit,fruiting,glabrous,globose,green,grey-green,herbaceous,inflorescence,lanceolate,leaf,length,margin,mm,moderately,ovate,pale,pedicel,peduncle,pendent,petiole,plant,prickle,pseudo-racemose,purple,rachi,resprouter,reticulate,rhizomatous,rotate,rotate-stellate,simple,slightly,stellate-pubescent,stigma,streak,style,surface,weakly,white,x,yellow,yellowish	%,.05,.5,0-0.1,0-2,0-6,0-7,0.2-0.6,0.25-0.4,0.3-0.4,0.3-0.45,0.3-0.5,0.35-0.45,0.5-1,0.7-0.9,0.9-1.7,0.9-8,1-3,1-3.5,1-4,1-6,1.3-1.6,1.4-1.7,10-30,16-20,2-,2-locular,2.5-4,2.7-2.9,3,3-5,3-7,3-foliate,4.5-8,4.5-8.5,5-15,5-merou,6-7,6-8,6.5-13,7-10.5,7-8,7-9,8-20,8-30,8-9,9-15,abaxially,absen,absent,across,acute,adaxially,adult,alyx,ample,anvil-shape,apart,apex,articulated,attenuate,axe,ba,base,blade,branchlet,broadly,capitat,connivent,cross-section,cylindrical,deeply,deltate,directed,distall,distributed,dm,eaf,eed,eglandular,erect,exocarp,finger,functional,geminat,gland-tipped,grey,hair,half,heterostylous,interpetalar,juicy,juvenile,lamina,lateral,less,lobe,lobed,long,longer,lower,mature,mesocarp,mid-point,midpoint,midvein,minute,moist,narrowly,nflorescence,oblique,obtuse,orolla,pair,part,per,placenta,pore,porrect,present,proximal,ray,ruit,rusty,sessile,shallowly,short,spaced,sparsely,stalk,stalked,stellae,stellate,straight,tal,tamen,tem,thick,throughout,time,tissu,tissue,transparent,triangular,tube,unarme,unarmed,unbranched,unit,upper,vary,wide,ympodial	abaxial,adaxial,arrangement,bark,bud,capitate,cell,center,colour,corolla,form,growth,height,history,life,na,new,number,ovary,perennial,position,reproduction,scar,seed,shape,spacing,staman,stem,texture,trichome,width
451	wfo-0001029088	success	149	109	75	74	34	0.503	.2,.3,0.1,0.9–1.5,1.3–4.5,1.5–2,15–25,1–1.6,25–30,2–2.5,2–3,3–16,4–8,5,5-merous,<,abaxially,acuminate,adaxially,anther,apex,bronze-brown,calyx,capitate,climbing,cm,densely,diameter,entire,extra-axillary,filament,flower,fruit,fruiting,glabrous,greenish-brown,hair,herbaceous,immature,leaf,lenticular,light,margin,mature,membranous,minutely,mm,near,obtuse,ovoid-rhomboid,papillose,pedicel,peduncle,petiole,pubescent,purplish,rachi,reddish-brown,rounded,rugose,shortly,simple,slender,somewhat,sparsely,stellate,stigma,style,surface,terrestrial,tip,unbranched,vine,white,x	0.6–3.2,1.5–3,1–1.2,1–1.5,1–3,2-lobe,2.5–20,2.5–4.2,3.5–7,3.5–8,5–8,6-10,accrescent,acute,alyx,apar,apicall,axe,base,berry,blade,c.,ciliate,cordate,cylindrical,eaf,eed,emarginate,flattened,flavor,fleshy,fragrant,glabrou,groun,half,heavy,juicy,lanceolate,lobe,long,lower,m.,moderately,narrowly,nflorescence,nternode,orolla,palmate,perfec,plurifoliat,primary,revolute,ruit,sand-punctate,scent,slightly,spaced,stout,straight,strongly,swee,sweet,tamen,tem,truncate,truncate-acuminat,tube,unit,vary,vein,venation,wider,ympodial,–7	2-lobed,abaxial,adaxial,apart,arrangement,bud,cell,center,colour,corolla,form,growth,height,history,inflorescence,length,life,na,new,number,ovary,perfect,plant,position,reproduction,scar,seed,shape,spacing,staman,stem,texture,trichome,width
452	wfo-0001029089	invalid_json_followup	177	134	96	81	38	0.542	.5,.75,/4,0.1-0.25,0.8-1,1-1.5,1.5-2,1.5-6,4.5-5,5-9,6-7,abrupt,acute,along,anther,apart,apex,axil,bark,base,beneath,berry,bilobed,branched,bud,calyx,campanulate,caniculate,cm,completely,corolla,covered,covering,dark,densely,dia,drying,either,elliptic,enclosed,entire,filament,flattened-reniform,fruiting,furcate,glabrous,globose,golden,green,lamina,leaf,lobed,margin,minutely,mm,occasionally,opposite,otherwise,ovary,papillose,pedicel,petiole,pitted,primary,pubescent,purplish,reddish-grey,resinous,rounded,scar,shiny,shrub,simple,small,smooth,somewhat,stem,stigma,style,surface,tan,tapering,tip,tree,trichome,tube,underside,uniseriate,usually,varnish,vein,way,white,widening,x,young	0.5-0.6,0.5-1,0.8-1.2,1,1/2,10-25,2.5-3.5,5-10,5-20-flowered,5-6,8-9,anthesi,apiculate,ba,beginning,closely,cracking,decurrent,deflexed,differing,difoliate,eaf,edicel,eed,erect,expand,exserted,free,geminat,glabrou,impressed,incrassate,inflorescenc,later,lateral,like,lobe,lon,long,lower,main,major,material,member,middle,minor,nflorescence,obovoid,older,one,overlapping,pair,papillo,part,peeling,persistent,pinkish,planar,pore,poricidal,portion,prominent,resinou,rounded-deltoid,ruit,secretion,shaped,size,slightly,spaced,still,straight,tall,tear-drop,tub,ud,unit,varnished,widest,woody,ympodial	'',5-20,[,``,abaxial,adaxial,arrangement,characteristic,colour,diameter,flower,form,fruit,growth,height,history,inflorescence,length,life,na,new,number,peduncle,perennial,plant,position,prickle,rachi,reproduction,seed,shape,spacing,staman,texture,value,width,{,}
453	wfo-0001029091	invalid_json_followup	212	118	77	135	41	0.363	-4,-4.5,1-2,1.5-,10,2-3,2.5-,3-4,4,7-8,acuminate,acute,anther,apex,axil,broadly,buff,calyx,campanulate,capitate,cell,cm,colour,corolla,cyme,discoidal,ellipsoid,elliptic,filament,flattened,flower,flushed,fork,fruiting,glandular,globose,globular,grey,intense,irregular,irregularly,larger,lavender,leaf,light,minutely,mm,obovate,ochre-yellow,ovate,overlain,ovoid,pale,pattern,pedicel,peduncle,pentagonal,petiole,pubescent,rachi,reddish-purple,relatively,reticulate-concentric,ridge,ridged,shrub,simple,slender,slightly,speckled,stellate-rotate,stem,stigma,style,surface,transverse,violet-purple	-1,-15,0.3-,0.5-0.8,0.5-1,1,1-10,1.5-2,10-20,10-toothed,15-40,170-210,2-12,2-2.5,20-30,3,3-,3-11-lobed,46/1,5,5-7,635/1,age,appearing,aromatic,articulated,articulation,aspect,ba,base,becoming,berry,blunt,bluntly,brownish,clonal,close,common,conspicuous,cuneate,cut,dark,deeply,develop,developed,dia,downward,eed,effect,emarginated,erect,exceeding,exerted,floral,forked,fresh,general,giving,gree,growing,hair,half,interacuminal,juvenile,lacking,lasting,later,lateral,lavende,lengthening,line,linear,linear-lanceolate,lobe,long,long-triangular,lower,may,mid-vein,mineral,narrowly,nflorescence,oblong,obscure,occasionally,ower,pedicellate,petiol,petiolate,plurifoliat,point,pore,poricidal,raised,readily,rh,ripe,rounded,ruit,scarcely,separate,several,shallowly,shed,shortly,sigmoid,sinus,slit,soft,soft-wooded,soon,sparsely,stone,straggly,subulate,succulent,swollen,tall,tip,tissue,toward,triangular,tub,ud,unit,upper,usually,violet,well,winged,without,woody,x,year,ympodial	'',[,``,abaxial,adaxial,arrangement,bark,bud,center,characteristic,diameter,form,fruit,green,growth,height,history,inflorescence,length,life,margin,na,new,number,ovary,perennial,plant,position,prickle,reproduction,scar,seed,shape,spacing,staman,texture,trichome,value,width,{,}
454	wfo-0001029101	invalid_json_followup	233	147	114	119	33	0.489	.5,/3,/4,0-100,0-2,0.1-0.4,0.4-1.5,0.5-1,0.7-,0.8-3.5,1-3,1-8,1.3-2,1.5-2,1.5-2.5,2.5-6,3-7,4-12,5-7,5-merous,8-15,abaxial,abaxially,adaxial,andromonoecious,anther,apart,apex,apparently,articulated,bark,base,berry,brown-green,calyx,cell,chartaceous,cm,concolorous,cream,dark,darker,diameter,discolorous,drying,dull,elliptic,elongating,erect,filament,flattened,flattened-reniform,flower,fruit,fruiting,glabrescent,glabrous,green,lateral,leaf,length,lobed,long,long-styled,margin,marking,mature,maturity,mauve,mm,moderately,narrow-deltate,obovate,obtuse,orange-brown,outline,ovate,pale,pedicel,peduncle,petiole,pit,plant,porrect,prickle,raised,reflexed,rounded,scar,sessile,short-styled,shrub,simple,small,smooth,sometimes,sparsely,spherical,stalked,stellate,stellate-pubescent,stem,straight,style,surface,terete,trichome,variously,way,wide,yellow,yellow-green,yellow-orange,young	-15,-3,0-20,0-5,0-8,0.1,0.1-0.5,0.1-0.7,0.1-1,0.2,00-200,1,1-1.5,1-4,1.3-2.6,1.4-2.2,1.7,1.8-3,1/5-1/4,10-14,10-20,2-,2-20,2-6,2.5-3.5,2.8-3.3,2/3-3/4,3-,3-10,3-4,30-100,4-7,5-,5-20,5-6,5-8,5-9,5.5-8,6-8,7-13,acute,almost,always,alyx,apar,apically,blade,branched,broad-deltate,connivent,cuneate,deltate,distal,distance,eaf,eed,equal,extending,free,green-brow,hermaphrodite,heterostylous,infructescence,lengt,like,lobe,lon,longer,lower,lowermost,midpoint,midvein,multangulate,nflorescence,oblong,often,older,one,open,orolla,oung,pair,pendulous,per,pericarp,plurifoliat,poricidal,portion,present,prickl,prickly,primary,rarely,ray,reduced,rounde,ruit,secondary,side,spaced,spreading,stalk,staminat,suborbicular,tamen,tapering,tertiary,thick,time,tip,tube,unit,vary,vein,venation,visible,well-developed,woody,ympodial	'',[,``,arrangement,bud,characteristic,colour,corolla,form,green-brown,growth,height,history,inflorescence,life,na,new,number,ovary,perennial,position,rachi,reproduction,seed,shape,spacing,staman,stigma,texture,value,width,{,}
455	wfo-0001029106	invalid_json_followup	200	135	101	99	34	0.505	.5,/3,0-0.3,0.1,0.2-1,0.25-0.7,0.5-0.9,0.5-2.5,1-5,2-6,2-8,3-25,3-4,4-6,5-14,5-merous,abaxially,anther,apart,apex,apparently,articulated,bark,base,berry,calyx,cell,cm,concolorous,curved,densely,diameter,discolorous,drying,elliptic,elongating,erect,filament,flattened-reniform,flower,fruit,fruiting,gently,glabrescent,glabrous,lateral,leaf,length,light,lobed,long,margin,mature,maturity,mauve,membranous,mm,orange,orange-brown,orbicular,outline,ovate,pale,pedicel,peduncle,petiole,pit,porrect,prickle,raised,red,reflexed,rounded,scandent,scar,sessile,shiny,shrub,simple,small,smooth,sometimes,spaced,sparsely,spherical,stalked,stellate-pubescent,stem,straight,style,subentire,surface,terete,trichome,variously,way,weakly,white,wide,yellow-orange,yellowish-green	-6,.1,0,0-10,0-2,0-20,0-5,0-6,0.2-0.4,0.5,0.5-0.8,0.5-1,0.9-1.2,1-1.6,1-2,1.5-1.8,1.5-2,1.5-3.5,1/4,1/5-1/4,2-3.5,2-4,2-5.5,2.2-3,2/,3-3.5,4-8,5-8,6-8,acuminat,acute,alyx,ame,apar,apically,appearing,blade,branched,c.,cuneate,deltate,distance,eaf,eed,equal,extending,eye,flattened,free,infructescence,lobe,lon,longer,lower,midpoint,midvein,naked,nflorescence,obtuse,older,one,open,orange-brow,orolla,oung,pair,pendulous,per,perfec,pericarp,plurifoliat,poricidal,portion,prickl,prickly,primary,ray,shallow,shorter,side,size,slender,spreading,stalk,stellate,tamen,tapering,tertiary,time,tip,tube,uit,unit,vary,vein,venation,visible,woody,ympodial	'',[,``,abaxial,adaxial,arrangement,bud,characteristic,colour,corolla,form,growth,height,history,inflorescence,life,na,new,number,ovary,plant,position,rachi,reproduction,seed,shape,spacing,staman,stigma,texture,value,width,{,}
456	wfo-0001029112	success	190	84	57	133	27	0.3	1-10,1-2,10-17,10-21,2-3.5,2.5-4.5,2.6-3,2.7-5.7,20,3.5-4.5,3.5-7,5,acuminate,anther,apex,articulated,cm,conical,corolla,densely,diameter,elliptic-lanceolate,filament,flower,forked,fruit,glabrous,green,green-white,greenish,herb,honeycomb-shaped,leaf,light,minute,mm,moniliform,mucilaginous,odd-pinnate,ovate,ovoid,pale,pedicel,peduncle,petiole,plant,pubescent,rotate,seed,slightly,stigma,style,terminal,tuber,violet,whitish,yellow	0-2,0.5,0.9-1.7,1-3,1-4,1.4-2.5,1.5-1.8,1.5-2,2.7-3.5,2.7-4.2,3-4,3-5,3-6,3-7,5-8,5-merou,6.5-5.5,9.5-13,abaxially,acumen,adaxially,ag,along,alyx,apart,apparently,arranged,axe,axillary,base,bead,berry,blade,brownish,bud,capitat,cell,chartaceous,ciliate,condition,connivent,covering,decreasing,digestion,distal,dorsally,drying,eaf,edge,eed,enzyme,equal,especially,exceeding,flat,folded,fresh,geminat,generally,glabrou,gradually,hair,hair-like,half,homostylous,interjected,lanceolate,larger,lateral,leaflet,lengthening,like,living,lobe,long,lower,make,margin,middle,mottled,multiple,narrow,necklace,nflorescence,obtuse,orolla,pair,perfect,petiolule,plurifoliate,pore,poricidal,present,pubescen,purple,ray,removed,ripe,ruit,secondary,semierec,seudostipule,size,slit,spaced,specimen,stamen,ste,stolon,subequal,subtending,symmetrical,tall,tamen,tem,testal,thick,thir,throughout,tip,toward,tri-,tube,typically,unit,usually,vary,wall,wet,wide,wing,x,ympodial	abaxial,adaxial,arrangement,capitate,center,colour,form,growth,height,history,inflorescence,length,life,na,number,ovary,perennial,position,pseudostipule,rachi,reproduction,shape,spacing,staman,surface,texture,width
457	wfo-0001029120	invalid_json_followup	168	102	61	107	41	0.363	0.1-0.5,0.7-1,1.1-1.5,1.1-2,3-3.5,6-8,acuminate,anther,apart,apex,bark,base,beneath,bud,calyx,cm,corolla,dark,densely,erose,filament,fleshy,glabrous,globose,golden,greenish-brown,hirsute,internodal,leaf,lobed,margin,minutely,mm,narrowly,nearly,opposite,ovary,ovate,pale,paler,pedicel,peduncle,petiole,pubescent,rest,scar,shrub,simple,slender,sparsely,stem,stigma,style,surface,trichome,unifoliate,uniseriate,vein,white,yellow,yellow-green	.05,.5,.75,/2,0.5-1.5,1-1.5,2.5-3.5,2.6-7,5-10-flowered,5-8,6.5-16.5,8511,abrupt,acute,anthesi,basal,beginning,black,bullate,cell,decurrent,deflexed,dia,difoliate,dry,drying,eaf,edicel,eed,epidermi,especially,evenly,f,fide,free,geminat,inflorescenc,infloresence,know,known,lanceolate,large,larger,later,lateral,lehmann,like,lobe,lon,long,long-triangular,lower,main,middle,midrib,minor,narrow,narrower,nflorescence,occasionally,often,older,outer,pair,papillose,peduncl,petaloid,point,pore,poricidal,portion,present,prominently,proximal,raised,reproductive,ruit,scattered,shaped,slightly,spaced,specimen,speckle,straight,sympodial,tall,tapering,tear-drop,terminal,thickened,tip,tub,tube,ud,unbranched,unit,upper,urceolate,venation,way,white-papillo,wide,widening,widest,x,ympodial,young	'',5-10,[,``,abaxial,adaxial,arrangement,center,characteristic,colour,decument,diameter,flower,form,fruit,fruiting,growth,height,history,inflorescence,length,life,na,new,number,perennial,plant,position,prickle,rachi,reproduction,seed,shape,spacing,staman,texture,value,white-papillose,width,{,}
458	wfo-0001029121	success	161	87	60	101	27	0.373	0.2-2,1-4,1-5,15-30,2-3,2-3-celled,3.8-11,4-5.5,5-8,8-16,apex,blue,branched,cell,cm,conical,corolla,covering,cyme,deep,diameter,dichasial,dichasially,distal,ebracteate,elliptical,filament,flower,glabrous,green,green-white,hair,hair-like,half,herbaceous,lateral,leaf,medium,mm,monochasial,narrowly,odd-pinnate,ovate,ovoid,pedicel,peduncle,perennial,petiole,plant,purple,rotate,scattered,seed,short,stigma,style,testal,thick,wall,yellow	-6,0,0-2,1.1-3.9,1.2-2.5,1.2-3.3,10,2-,2-10,2-13,3-5,3-6-foliat,3.6-9,4-10,4.5-10.0,5-20,9-33,abaxiall,abaxially,acumen,acuminate,acute,adaxially,apical,apically,articulate,attenuate,base,calyx,commonly,connate,cuneate,dehiscent,digestion,diminishing,dorsally,eaf,edge,eed,emoval,enzyme,exceeding,flat,folded,forked,generally,globo,gradually,honeycomb,interjected,introrse,leaflet,living,lobe,lon,long,lower,lunat,make,maturing,mucilaginous,nflorescence,nther,oblique,obtuse,often,orolla,pair,pattern,perfect,petiolule,plan,poricidally,proximal,rarely,reveal,rounded,ruit,sessile,seudostipule,short-attenuate,size,slit,specimen,stamen,straight,subequal,tal,tem,terminal,throughou,throughout,tip,toward,tuber-bearing,typically,unit,vary,wide,ympodial,¼	abaxial,adaxial,anther,arrangement,center,colour,form,fruit,globose,growth,height,history,inflorescence,length,life,na,number,ovary,position,rachi,reproduction,shape,spacing,staman,surface,texture,width
459	wfo-0001029125	invalid_json_followup	197	128	84	113	44	0.426	1,5-merous,6,abaxial,abaxially,acuminate,adaxial,along,anther,anthesi,apex,appressed,base,berry,black,brownish,calyx,central,closely,cm,concave-reniform,conical,corolla,densely,diameter,entire,filament,flower,fruit,fruiting,glabrous,globose,green,herb,internodal,lateral,leaf,live,margin,maturity,maximum,minutely,mm,occasionally,orange,ovary,ovate-lanceolate,pale,papillate,pedicel,peduncle,petiole,plant,pubescent,purple,purple-tinged,purplish,ridged,ripe,scar,seed,shiny,simple,small,spaced,sparsely,spreading,star,stellate,stem,stigma,straight,style,subshrub,surface,terete,toward,trichome,turning,uniseriate,vein,white,woody,yellow	.0–3.5,.1,.1–1.4,.2,.4,.5–2.0,.6,0.5,0.5–0.6,0.5–1.0,0.8–0.9,0.9,1.0–1.2,1.0–1.5,1.0–4.0,1.5–2.0,1.5–3.0,1.7-,1.8–3.5,1–2-celled,2.5–12.0,2/3,20–100,2–3-celled,2–4,3.0–3.4,3.5–4,35–45,3–5,3–5-celled,4–8,5–6,6–7,acute,adaxially,age,apar,apparently,arising,articulated,attenuate,ba,beyond,branching,cell,cone,cuneate,delicate,deltate,difoliate,eaf,eed,ellipsoid,end,especially,exerted,free,geminat,growt,hilum,later,lengthening,like,lobe,lobed,lon,long,lower,narrower,nearly,nflorescence,oblique,often,one,outline,pair,pentagonal,per,perfect,place,pore,poricidal,portion,positioned,primary,reflexe,reflexed,ruit,scattered,shorter,single,slightly,slit,stemmed,stone,strongly,sub-lateral,tall,tem,testal,tinged,tip,traingular,tube,ud,unequal,unit,usually,whitewith,wide,ympodial,young,¼	'',0.2,0.5-0.6,0.5-1.0,1-2-celled,1.0-1.2,1.0-1.5,1.5-3.0,1.7-3.4,1.8-3.5,20-100,3-5,3.5-4,5-6,[,``,apart,arrangement,bark,bud,characteristic,colour,form,growth,height,history,inflorescence,length,life,na,new,number,position,prickle,rachi,reproduction,shape,spacing,staman,texture,value,width,{,}
460	wfo-0001029138	success	170	88	53	117	35	0.312	0.15-0.3,1-5,2.4-5.5,20-30,3-4,3.5-4.5,3.5-6.7,4-6,6-6.5,7-10,acicular,adaxially,anther,broad-based,broadly,brown,calyx,chartaceous,cm,densely,diameter,entire,extra-axillary,flower,fruit,fruiting,glabrous,green,grey-green,inflorescence,length,margin,mm,oblate,ovate,pedicel,peduncle,perennial,petiole,prickle,prostrate,pseudo-racemose,purple,rhizomatous,rotate,shrub,simple,stellate-pubescent,stem,straight,style,yellow,yellowish	%,0,0-0.1,0-0.6,0-1.5,0-5,0.25-0.5,0.5-0.9,0.6-0.7,0.6-0.8,0.6-1.1,0.8-1.5,0.9-1.2,1-1.5,1-1.8,1-2,1-2.5,1.6-2.1,1.7-4,2-foliate,2-locular,2.5-3.5,20-100,3-8,3-80,5-8,5-merou,6-10,6-8,65-115,7-8,abaxially,absen,absent,accrescent,acute,adaxiall,alyx,apart,apex,apparently,armed,articulated,axe,ba,base,blade,cuneate,cylindrical,d.,deltate,directed,distall,distally,distributed,dult,eaf,eed,eglandular,enclosing,finger,functional,geminat,glabrou,gland-tipped,hair,juic,lamina,lateral,lobe,lon,long,longer,lower,markedly,mature,mesocarp,mid-point,midpoint,midvein,minute,moist,nflorescence,oblique,obtuse,orolla,part,per,pore,porrect,present,ray,ruit,rusty,short,spaced,sparsely,stage,stalk,stellae,tal,tamen,thick,thicker,thicknes,throughout,time,tube,unbranched,unit,unknow,unknown,uvenile,vary,wide,x,ympodial	5-merous,abaxial,adaxial,arrangement,bark,bud,cell,center,colour,corolla,filament,form,growth,height,history,leaf,life,na,new,number,ovary,plant,position,rachi,reproduction,scar,seed,shape,spacing,staman,stigma,surface,texture,trichome,width
461	wfo-0001029150	success	177	116	72	105	44	0.407	0.3,0.3-0.5,0.8-1,15,5-merous,across,adaxially,anther,branched,calyx,canopy,climbing,cm,conical,diameter,ellipsoidal,elliptical,enlarged,entire,extra-axillary,filament,flower,fruit,fruiting,glabrous,leaf,light,long,margin,membranaceous,midvein,minutely,mm,moderately,nearly,opposed,ovate,pale,pedicel,peduncle,petiole,pinkish-white,pubescent,rachi,rarely,rounded-deltoid,rugose,sand-punctate,scar,simple,slender,slightly,small,sparsely,stellate,stem,stigma,strong,style,surface,tan,teardrop-shaped,tree,trichome,understory,vegetation,vein,vine,white,wiry,woody,x	.5,0.3–0.5,0.5–1.1,0.8–1,0.8–1.5,0.8–3.5,1.2–1.5,1.5,1.5–2,1.5–2.2,1–1.5,1–11,1–2,1–5,1–6,2.5–3,2.5–5,2.5–8,2–10,2–2.5,2–3,3-5,3–10,3–4,3–50,6,7–8,8-shaped,9–12,abaxially,accrescent,acute,adaxiall,alyx,apar,apex,apicall,apically,apiculate,attenuate,axe,base,berry,blade,c.,capitat,ciliate,color,cros,cylindrical,delicate,distant,dried,eaf,eed,except,flattened,fleshy,flush,glabrou,inconspicuous,lamina,lanceolate,larger,living,lobe,lon,lower,m.,material,mor,nflorescence,nternode,oblique,older,orolla,pair,perfec,pinnate,plurifoliat,pointed,reaching,rounded,ruit,secondary,section,shortly,side,somewhat,spaced,specimen,tamen,tem,thick,thickened,time,tip,translucent,truncate,tube,unit,vary,venation,wide,ympodial	0.8-1.5,1-11,1-5,1-6,1.2-1.5,1.5-2.2,2-10,2.5-3,3-10,3-50,9-12,abaxial,apart,arrangement,bark,bud,capitate,cell,center,colour,corolla,form,growth,height,history,inflorescence,internode,length,life,na,new,number,ovary,perfect,plant,position,prickle,reproduction,seed,shape,spacing,staman,texture,width
462	wfo-0001029151	success	197	115	85	112	30	0.431	-10,0.2-0.6,0.25-0.5,0.5-1,1-1.5,1-2,1-5,10-15,2-15,2-2.5,2-3,2-6,2-8,3.5-5,4.5-5,5-10,5-7,8-10,8-15,abaxially,accrescent,acicular,acute,adaxial,adaxially,annual,anther,apart,apex,brown,calyx,close,cm,dark,densely,diameter,elliptic,entire,filament,flattened,flower,forked,fruit,fruiting,glabrous,globose,green,herb,leaf,leaf-opposed,margin,minute,minutely,mm,multangulate,narrowly,oblong,ovate,pedicel,peduncle,petiole,porrect,prickle,pubescent,purple,rachi,rarely,reniform,reticulate,silvery,simple,stellate,stem,stigma,straight,style,surface,truncate,unbranched,undulate,white,whitish,x,yellow,yellowish	0-0.5,0.1-0.3,1-2.5,1-6,1.5-2,1.5-3,1.5-6,15-20,2-4,4-10,5,5-8,6-10,7-10,7-9,8,abundantly,acro,acumen,apparently,armed,articulated,axe,ba,base,blade,capitat,chartaceous,completely,cone,connivent,covered,covering,curved,cylindrical,deflexed,developed,difoliate,directed,discolorous,distall,downward,eaf,eed,eglandular,equal,frui,geminat,hair,held,high,interpetalar,juic,juvenile,larger,lateral,like,lobe,lon,long,loosely,lower,main,markedly,mesocarp,midpoint,midrib,moderately,moist,nearly,nflorescence,oblique,obtuse,orolla,outside,pale,perfect,pore,prickly,probably,ray,rounded,ruit,scarcely,shallow,shorter,side,small,spaced,sparse,sparsely,sparser,spiny,sprawling,stalk,stellate-pubescent,subcordate,tamen,tem,time,tissu,tissue,triangular,tube,unarmed,unit,usually,vary,vein,vigorous,wide,ympodial	abaxial,arrangement,bark,bud,capitate,cell,center,colour,corolla,form,growth,height,history,inflorescence,length,life,na,new,number,ovary,plant,position,scar,seed,shape,spacing,staman,texture,trichome,width
463	wfo-0001029152	success	197	108	79	118	29	0.401	0.5-1,0.9-1.3,1-4,1.1-1.3,2-5,2.5-3,acuminate,acute,anther,apex,appressed,area,bark,base,broadened,brown,bud,calyx,closely,cm,corolla,dark,deep,densely,dry,elliptic,filament,floccose,flower,fruit,fruiting,glabrous,globose,green,greyish-red,hyaline,inflorescence,leaf,lightly,lobed,margin,material,minutely,mm,nearly,obovate,often,opposite,ovary,overlapping,ovoid-reniform,pale,papillose,pedicel,petiole,pitted,plant,red,red-floccose,scar,shape,shiny,shrub,simple,slender,small,spaced,stem,stigma,style,surface,tapering,tip,tree,trichome,tube,weak,white,winged	.1,.5,0.25-0.5,0.75-1,0.8-1,1,1-1.5,1-2,1-3,1.5-1.7,1.5-2,2-2.5,2-3,2-4,3-5,3-8-flowered,4-6,6-8,61-25,8.5-16,anthesi,appearanc,appearing,attenuate,ba,beginning,beneath,berry,blade,branch,broadly,citronella,completely,conical,corky,cuneate,deciduous,decurrent,deflexed,deltoid,dia,differing,difoliate,distal,eaf,edicel,eed,ellipsoi,enclosing,erect,et,exsertion,fide,flattened,fragrance,free,geminat,giving,held,inflorescenc,keeled,large-lenticellate,late,lateral,live,lobe,lon,long,long-styled,longer,lower,main,major,middle,midrib,minor,nflorescence,older,one,pair,per,planar,plane,pore,poricidal,portion,prominent,prominently,quite,reddish,reddish-floccose,reflexed,reminiscent,rounded,ruit,shaped,short-styled,single,size,slightly,somewhat,soon,straight,styl,tall,tear-drop,terminal,third,tillett,ud,unit,usually,vein,widest,woody,x,ympodial,young	0.1,1.5-6,3-8,abaxial,adaxial,arrangement,cell,center,colour,diameter,form,growth,height,history,length,life,na,new,number,peduncle,perennial,position,rachi,reproduction,seed,spacing,staman,texture,width
464	wfo-0001029156	success	65	61	45	20	16	0.692	0.5,1.5-2,10-12,4-6,6,6-8,<,almost,bark,berry,cell,center,cm,completely,deeply,diameter,exfoliating,flattened,fruiting,glabrous,golden,growth,liana,minute,minutely,mm,multiseriate,new,pale,pedicel,per,pitted,rectangular,reniform,rib-like,seed,shiny,sinuate,stem,surface,tan,thickening,trichome,vine,woody	-3,1,2,apex,apparently,eed,epiphytic,fide,lateral,long,margin,markedly,nee,noddin,occasionally,older,shreddy,testal,wall,wide	2-3,arrangement,colour,form,height,history,length,life,na,nodding,number,plant,reproduction,shape,texture,width
465	wfo-0001029156	success	65	59	42	23	17	0.646	0.5,1.5-2,10-12,<,almost,berry,cell,center,cm,completely,deeply,diameter,exfoliating,flattened,fruiting,glabrous,golden,growth,liana,markedly,minute,minutely,mm,multiseriate,new,pale,pedicel,per,pitted,rectangular,reniform,rib-like,seed,shiny,sinuate,stem,surface,tan,thickening,trichome,vine,woody	-3,1,2,4-6,6-8,apex,apparently,ark,eed,em,epiphytic,fide,lateral,lon,margin,nee,noddin,occasionally,older,shreddy,testal,wall,x	2-3,6,bark,colour,form,height,history,length,life,na,nodding,number,plant,reproduction,shape,texture,width
466	wfo-0001029160	invalid_json_followup	150	118	63	87	55	0.42	/2,0.5,0.7,1.3-1.6,1.3-1.8,2-7,3-8,4-8,6-8,6.5-8.6,acicular,annual,anther,blade,bristly,broadly,brown,calyx,capitate,cm,dark,dia,dm,eglandular,few-rayed,glabrous,gland,hair,herb,including,internodal,less,long,mm,mostly,narrowly,occasionally,often,ovate,ovoid,petiole,pinnatifid,plump,prickle,prickly,purple,radially,ridged,scattered,sessile,short-stipitate,sometimes,spherical,stellae,stellate,stem,strait,thrice,tinged,twice,vestiture,whitish-tinged,yellow	0.35-0.50,1.11.4,1.8-2.2,20-40,3.0-3.5,4.5-6.0,5-13,5.6-7.5,6-10-flowered,accrescent,acro,across,acute,adjacent,also,alyx,among,anthesi,appearance,armed,base,beneath,berry,branched,campanulate,deep,deltoi,developing,difoliate,divergently,divided,dry,eaf,eed,enveloped,erect,exceeding,extende,finer,fully,geminat,giving,heteromorphic,hilum,incurved,invested,linear-lanceolate,lobe,lon,lowermost,main,many,maturity,much,much-dissected,nflorescence,notch,one,orolla,pair,ruit,shorter,shortest,size,slende,somewhat,splitting,spreading,stout,straigh,sunken,tall,tamen,terminally,three,tightly,tigma,tub,tube,tyle,ultimate,unit,uppermost,vary,vein,wholly,ympodial	'',6-10,[,``,abaxial,adaxial,apex,arrangement,bark,bud,cell,center,character,characteristic,colour,corolla,deltoid,diameter,filament,flower,form,fruit,fruiting,growth,height,history,inflorescence,leaf,length,life,margin,na,new,number,ovary,pedicel,peduncle,plant,position,rachi,reproduction,scar,seed,shape,spacing,staman,stigma,style,surface,texture,trichome,value,width,{,}
467	wfo-0001029163	success	149	93	58	91	35	0.389	-25,0.3-2.5,0.5-1,10-,2,2-18,2-6,2.5-3,20-30,3-14,4-20,5-12,5-8,7-9,abaxial,acuminate,acute,apex,calyx,cell,chartaceous,cm,densely,diameter,elliptic,elliptic-ovate,entire,flower,fruit,glabrous,globose,herb,lenticular,margin,mm,pedicel,peduncle,perennial,petiole,pseudohair,puberulent,puberulent-pubescent,purple,rachi,shrub,simple,stellate,stem,stigma,style,subcoriaceous,surface,unbranched,unknown,white,whitish,x,yellow	-4,-9,1,1-2,1.5-2,1.5-2.5,1.5-3,13-18,2-3,2-7,3-4,3-5,4-5-foliat,4-6,4.5-23,9-15,abaxially,absen,adaxiall,adaxially,aggregate,apart,articulated,axe,band,base,blade,color,connivent,cuneate,cylindrical,decurrent,deltate,denser,directed,distall,distally,eaf,eed,eglandular,free,glandular,hair,lanceolate,leaving,like,lobe,lon,long,lower,moderately,narrowed,narrowly,nearly,nflorescence,nther,obtuse,orolla,papillose,pedicellar,pore,projection,puberulent-pubescen,pubescence,radiu,remnant,ripe,roughened,ruit,scale-like,slightly,small,sometimes,spaced,sparsely,stalked,stone,subapical,tal,tem,thickened,time,tip,triangular,truncat,tube,unit,vary,vein,wide,ympodial	adaxial,anther,arrangement,bark,bud,center,colour,corolla,filament,form,fruiting,growth,height,history,inflorescence,leaf,length,life,na,new,number,ovary,plant,position,prickle,reproduction,scar,seed,shape,spacing,staman,texture,trichome,truncate,width
468	wfo-0001029171	success	137	88	56	81	32	0.409	-,-10,-15,0.5,1-3,1-4.5,1-5,1.5-2,10-25,2-3,3.5-6.5,4-10,5-8,7-9,acuminate,acute,angled,apart,apex,branched,chartaceous,cm,dendritically,densely,diameter,elliptic,flower,forked,fruit,glabrous,globose,mm,moderately,orange,ovate-elliptic,pedicel,peduncle,petiole,pubescent,purple,rachi,rarely,red,ripe,rugose,shrub,simple,smooth,sometimes,stellate,stigma,style,unbranched,white,x,yellow	1.5-7.5,10-35,11-20,3-4,3.5-18,4-5,5-6,6-,8-17,abaxially,abruptly,absen,adaxially,aggregate,also,and/or,articulated,axe,ba,base,blade,calyx,cell,connivent,cuneate,cylindrical,decurrent,deltate,dense,directed,distall,eaf,eed,eglandular,entire,except,gland,glandula,glandular,hair,lanceolate,like,lobe,long,lower,many-foliat,margin,midrib,narrowed,narrowly,near,nearly,nflorescence,nther,obtuse,often,orolla,perfect,pore,puberulent,radiu,ruit,shoot,short-stalked,slightly,spaced,sparsely,ste,stone,tal,tem,time,tip,triangular,truncat,tube,unit,usually,vary,wide,ympodial	abaxial,adaxial,anther,arrangement,colour,corolla,filament,form,growth,height,history,inflorescence,leaf,length,life,na,number,ovary,perennial,plant,position,reproduction,seed,shape,spacing,staman,stem,surface,texture,trichome,truncate,width
469	wfo-0001029215	invalid_json_followup	49	74	18	31	56	0.367	0.3-0.5,0.5-0.7,0.5-2.5,1,brown,calyx,cell,cm,diameter,fruit,hair-like,herb,mm,obovate,pubescent,smelling,strong,surface	-1.8-2.3,.2,2.3-2.9,appearance,border,coarse,eed,elongating,entire,fide,give,lateral,lobe,long,markedly,narrowly,outgrowth,round,shrub,silky,small,spreadin,tall,testa,thick,wall,weigend,wide,winged,woody,xyledecor	'',0.2,[,``,abaxial,adaxial,anther,apex,arrangement,bark,bud,center,characteristic,colour,corolla,filament,flower,form,fruiting,growth,height,history,inflorescence,leaf,length,life,margin,na,new,number,ovary,pedicel,peduncle,perennial,petiole,plant,position,prickle,rachi,reproduction,scar,seed,shape,spacing,spreading,staman,stem,stigma,style,texture,thicknes,trichome,value,width,{,}
470	wfo-0001029216	invalid_json_followup	243	118	80	163	38	0.329	0.2-0.25,0.4-0.5,0.5,0.5-1.5,0.6-1,1-1.2,1-2,1.2-6,10,3,4,accrescent,acute,annual,anther,apex,articulated,attenuate,biennial,bright,brown,calyx,capitate,cell,cm,conical,corolla,crenate,deep,dentate,diameter,distal,elliptic,filament,fruit,fruiting,glabrescent,globose,green,hair-like,herb,imparipinnate,inflorescence,interrupted,lanceolate,length,less,long,margin,minute,mm,multicellular,narrowly,obovate,orange,outgrowth,ovary,ovate,pale,pedicel,peduncle,pentagonal,perennial,petiole,plant,pubescent,red,shape,simple,somewhat,sparsely,stem,stigma,strongly,style,surface,trichome,unicellular,uniseriate,yellow	+,-0.5,-10,-5,.5,.8-1,0.1-0.3,0.1-0.5,0.1-0.6,0.1-0.8,0.2-0.3,0.2-0.4,0.2-0.8,0.3-0.4,0.3-0.5,0.3-2,0.4,0.5-0.8,0.5-2,0.6-0.8,0.8-2.5,1-3,1-4,1-6,1.5-2.3,1.5-2.5,1.5-3,1/,10-,10-14,2,2-4.5,2-locular,2.5-3.3,20-35,3-,3-4,3-5,3-7,3-foliate,5,5-15-flower,6-10,7-10,<,absen,absent,acroscopically,adpressed,allogamous,always,and/or,angeld,anthesi,apical,appearance,appendage,articulation,axi,basal,base,basiscopically,becoming,branch,cente,column,composed,cone,cordate,cultivar,decurrent,deeply,eaf,edicel,eed,entire,erect,exserted,extending,facultatively,fasciated,fruited,giving,gland-tipped,glandular,gree,half,halfway,included,initially,interjected,internode,large,larger,later,lateral,leaflet,like,linear,lobe,lobulate,lon,longer,lower,mainly,maturity,minutely,mixture,multilocular,near,nflorescence,numerous,oblique,often,one,pair,particularly,petiolule,population,present,primary,procumbent,pseudostipule,rarely,reflexe,ruit,scen,secondary,sessile,shaggy,shaped,short,silky,sometimes,sparse,spreading,staminal,sterile,straight,strong,tangled,tem,terminal,tertiary,testa,thick,thickening,tip,total,toward,truncate,tube,ud,unit,usually,variety,varying,villous,viny,wall,wide,winged,ympodial	'',0.8-1,1/3,5-15,[,``,abaxial,adaxial,arrangement,bark,bud,center,characteristic,colour,flower,form,growth,height,history,leaf,life,na,new,number,position,prickle,rachi,reflexed,reproduction,scar,seed,spacing,staman,texture,value,width,{,}
471	wfo-0001029226	invalid_json_followup	206	132	97	109	35	0.471	-9,1-1.5,1-3,10-40+,2-6,2-9,2.5-10,3-3.5,4,5-7,7-11,8-13,acuminate,acute,anther,apart,apex,base,berry,black,blue,branched,bright,calyx,capitate,cm,conical,cordate,corolla,dark,densely,diameter,ellipsoid,entire,filament,flattened,flexuous,flower,fruiting,glabrescent,glabrous,globose,growth,herbaceous,irregularly,lateral,lavender,leaf,like,lobed,long,lyrate,many,margin,minutely,mm,new,open,pale,pedicel,peduncle,perfect,petiole,pinnatifid,pitted,pubescent,red,reniform,ripe,scar,seed,shiny,short-glandular,shrub,simple,slender,spaced,spreading,stellate,stem,stigma,style,surface,tan,terminal,time,translucent,trichome,uniformly,uniseriate,vine,way,weak,white,woody,yellowish,¾	-7,.5,.75,0-1,0.5,0.5-5,1-2,1-celled,2,2-3,3-6,30,4-6,5-merou,>,ag,alyx,anthesi,apparently,ark,articulated,ba,basal,breaking,cell,completely,congested,connivent,decurrent,deltate,distall,divided,dry,eaf,eed,elongate,enation,exserted,free,gland,glandular,green,hairy,ilament,juice,lengthening,lobe,longer,loosely,lower,material,mature,membranous,mere,minute,nflorescence,occasionally,often,older,one,orolla,overtopping,pair,papillat,papillate,papillo,per,pinnate,plurifoliat,pore,poricidal,portion,primary,reflexed,remainin,rim,ruit,sagittate,scarlet,shorter,sleeve,slit,small,sometimes,sparsely,spot,sprawling,spreadin,staining,strongly,tangled,tem,testal,thin,third,tip,truncate,tube,twinin,ud,unit,usually,vary,vein,wall,wide,widest,winged,ympodial	'',[,``,abaxial,adaxial,arrangement,bark,bud,center,characteristic,colour,form,fruit,height,history,inflorescence,length,life,na,number,ovary,papillose,plant,position,prickle,rachi,reproduction,shape,spacing,staman,texture,value,width,{,}
472	wfo-0001029234	success	204	103	70	134	33	0.343	0-2,0.1-0.5,0.3-0.9,0.5-1,0.5-2,0.5-5,0.9-2.1,1-1.5,1-10,3-5,3-8,5.5-7,7-10,9-24,acicular,acute,anther,apex,articulated,base,calyx,capitate,chartaceous,cm,diameter,entire,erect,filament,flattened,flower,fruit,fruiting,glabrous,globose,green,inflorescence,lanceolate,leaf-opposed,length,longer,margin,mm,narrowly,pale,pedicel,peduncle,perennial,petiole,prickle,pseudo-racemose,pubescent,purple,rachi,red,rhizomatous,rotate-stellate,rugose,shrub,simple,sparsely,stellate,stigma,straight,style,surface,time,unbranched,wide,x,yellow	%,0-0.1,0-1,0-2.5,0-3,0-4,0-6,0.15-0.3,0.2-0.3,0.4-0.5,0.4-0.7,0.5-1.5,0.6-0.8,0.8-1.1,1-4,1-locular,1.1-1.5,1.5-2,1.5-2.5,11-23,18-24,2-2.5,2-3,2-6,20-,3-3.7,3-7,4-,4-7.5,4-8,4.7-7,5-9.5,5-merou,7-11,abaxially,absen,absent,accrescent,across,adaxiall,adaxially,adult,alyx,apart,apparen,attenuate,axe,ba,bilobe,blade,branche,brown,confined,connivent,cuneate,cylindrical,dense,directed,distall,distally,dm,eaf,eed,eglandular,exocarp,few-,finger,geminat,gland-tipped,glandular-puberulent,hair,half,incomplete,juicy,lamina,lateral,less,lobe,long,loosely,lower,markedly,mature,mesocarp,mid-point,midpoint,midrib,midvein,minute,moderately,nflorescence,oblique,orolla,ovate,part,per,perfect,placenta,plurifoliate,pore,porrect,present,ray,ruit,seeded,septum,sessile,short,spaced,sparse,stage,stalk,stellae,stellate-pubescent,succulent,tal,tamen,tem,thick,thicker,thicknes,throughout,tip,toward,triangular,tube,unarme,unarmed,unit,unknow,uvenile,vary,white,ympodial	abaxial,adaxial,arrangement,bark,bilobed,bud,cell,center,colour,corolla,form,growth,height,history,leaf,life,na,new,number,ovary,plant,position,reproduction,scar,seed,shape,spacing,staman,stem,texture,trichome,unknown,width
473	wfo-0001029236	invalid_json_followup	159	111	77	82	34	0.484	.5,0.2-1,0.45-0.5,0.5,1-1.5,1-2,1.4-1.7,1/2,2-5,abaxially,adaxial,anther,anthesi,apex,apical,apically,bark,basal,base,calyx,cm,conical,coriaceous,corolla,cupulate,dendritic,densely,diameter,elliptic,except,filament,flattened,fleshy,flower,fruit,fruiting,glabrous,globose,grey-brown,growth,leaf,lenticular,lobed,margin,midvein,minutely,mm,narrowly,obscurely,ovary,pale,pedicel,pericarp,petiole,pitted,pointed,pubescent,purplish,purplish-black,reddish-brown,revolute,scar,shiny,shrub,slightly,sparsely,stem,stigma,strongly,style,surface,tapering,terminal,thin,trichome,violet,way	0.2-0.7,0.5-1.5,0.9-2.3,2-4,3,6-9,absent,age,apparently,appearing,axi,ba,becoming,berry,bi-lobe,branch,branching,branchlet,broadly,compact,completely,decurrent,deflexed,deltate,dichasial,eaf,edicel,eed,erect,ew,exserted,free,inserted,later,lateral,less,lobe,long,lower,m.,many,middle,near,nflorescence,nodding,obscure,occasionally,older,overtopping,packe,per,persistent,plurifoliate,pore,poricidal,portion,prominent,ruit,scattered,secondary,shoot,short,simple,sleeve,slit-like,stamen,tall,time,tip,trongly,tub,tube,ud,unit,usually,venation,wide,winged,woody,x,ympodial,young	'',[,``,abaxial,arrangement,bi-lobed,bud,characteristic,colour,form,height,history,inflorescence,length,life,na,new,number,peduncle,perennial,plant,position,prickle,rachi,reproduction,seed,shape,spacing,staman,texture,value,width,{,}
474	wfo-0001029244	success	233	118	88	145	30	0.378	0-0.5,0-2,0-2.5,1-1.5,1-4,1.4-6,2-12,2-3,4-5.5,4.7-5,5-7,6-12,7-12,7-30,accrescent,acicular,acuminate,acute,adaxially,andromonoecious,anther,apex,articulated,base,calyx,chartaceous,cm,contiguous,cylindrical,densely,diameter,elliptic,entire,erect,especially,extra-axillary,filament,flower,fruit,fruiting,globose,green,inflorescence,leaf,length,lilac,lobed,longer,margin,minutely,mm,moderately,nearly,obovate,occasionally,orange,ovate,pale,pedicel,peduncle,perennial,petiole,plant,prickle,purple,rachi,red,reniform,rhizomatous,rugose,scarcely,shallowly,shrub,simple,sparsely,stellate,stellate-pubescent,stigma,straight,style,surface,thick,time,toward,unbranched,weakly,wide,yellow	%,0-0.2,0-0.3,0-1,0-16,0-55,0-80,0-9,0.15-0.25,0.2-0.25,0.2-0.3,0.2-0.5,0.25-0.4,0.4-0.7,0.5-2,0.8-5,1-2,1.1-1.8,1.5-2.5,1.8-3.5,10-18,100-150,12-25,2-4,2-foliate,2-locular,2.1-3.2,2.5-3.6,22-31,3-10,3-5,3-7,3-7.5,3-8,4-7,5-10,5-merou,6-8,6-9,7-10,7-9,8-10,9-16,9-25,90-200,abaxially,absen,absent,across,adaxiall,adult,alyx,anvil-shape,apart,apiculate,axe,ba,blade,branch,branche,brown,capitat,confined,connivent,cross-section,cuneate,decimetre,deltate,directed,distall,distally,distributed,dm,eaf,eed,eglandular,exocarp,finger,flattened,functional,geminat,gland-tipped,hair,half,hetereostylous,juicy,juvenile,lamina,lanceolate,lateral,less,lobe,long,loosely,lower,markedly,mature,mesocarp,mid-point,midpoint,midrib,midvein,minute,moist,narrowly,nflorescence,oblique,obtuse,orolla,pair,part,per,placenta,pore,porrect,present,ray,rostrate,ruit,rusty,sessile,short,side,sometimes,spaced,stalked,stellae,summit,tal,tamen,tem,thicker,throughout,tip,transparent,triangular,tube,unarme,unarmed,unit,upper,vary,vein,x,ympodial	abaxial,adaxial,arrangement,bark,bud,capitate,cell,center,colour,corolla,form,growth,height,history,life,na,new,number,ovary,position,reproduction,scar,seed,shape,spacing,staman,stem,texture,trichome,width
475	wfo-0001029246	invalid_json_followup	209	114	79	130	35	0.378	-1.5,0.1-0.3,0.1-0.4,0.3-0.8,0.5,0.7-1.3,0.7-2,0.8-1.1,1-4,1.5-2.3,1.5-2.5,1.5-6,2,3-5,3.5-5,5-merous,8-16,abaxial,adaxial,anther,apart,apex,bark,berry,calyx,chartaceous,cm,diameter,dull,elliptic,entire,erect,filament,flattened-reniform,flower,fruit,fruiting,glabrescent,glabrous,lateral,leaf,length,less,lobed,margin,mauve,mm,moderately,narrow-deltate,orange-brown,orange-red,pale,pedicel,peduncle,petiole,porrect,prickle,procumbent,pubescent,recurved,scar,sessile,shrub,simple,smooth,sparsely,spherical,stellate,stellate-pubescent,stem,straight,style,surface,terete,trichome,unbranched,white,yellow,yellow-orange	-1,-4,/5,0,0-15,0-5,0.15-0.3,0.2-1.5,0.3-0.5,0.5-1.5,0.7-1.5,0.8-3,0.9-1.3,1-1.5,1-1.8,1-10,1-3,1-5,1-8,1.2-2,1.7-6,1.8-3,1/10-1/5,1/3,2-3,2-3.5,2-5,2.5-3.2,2.8-4,2/3,2/3-3/,3-20,4-6,5-,5-20,6-10,6-8,7-12,abaxially,acuminat,acuminate,acute,almost,alyx,apar,apically,apparently,articulated,base,blade,broad-deltate,c.,concolorous,connivent,cuneate,curved,deltate,densely,discolorous,distance,drying,eaf,eed,elongating,equal,extending,eye,flattened,free,infructescence,lobe,lon,long,longer,lower,mature,maturity,midpoint,midvein,naked,narrow-ovate,nflorescence,oblong,obtuse,older,one,open,orange-brow,orolla,oung,pair,pendulous,per,perfec,pericarp,plurifoliat,poricidal,portion,prickl,prickly,primary,purple,ray,rounded,ruit,side,sometimes,spaced,spreading,stout,strongly,tamen,tapering,tertiary,time,tip,tube,unarmed,unit,upper,usually,vary,vein,venation,visible,way,wide,woody,ympodial,¼	'',[,``,arrangement,bud,center,character,characteristic,colour,corolla,form,growth,height,history,inflorescence,life,na,new,number,ovary,perennial,plant,position,rachi,reproduction,seed,shape,spacing,staman,stigma,texture,value,width,{,}
476	wfo-0001029263	success	211	112	83	128	29	0.393	0-2.5,0-5,0.3-1,0.5-1.5,0.6-1.5,1,1-10,1-7,1.2-2.5,2-3,3-5,3.5-5,30-60,4-7,5-merous,almost,andromonoecious,anther,bark,berry,black,calyx,cell,chartaceous,cm,corolla,cream,cultivar,dark,deep,deltate,diameter,dull,elliptic,entire,evenly,filament,flattened-reniform,flower,fruit,fruiting,glabrous,green,herb,lateral,leaf,length,lobed,long-styled,margin,marking,maturity,mauve,mm,orange,orange-brown,outline,pale,pedicel,peduncle,petiole,pit,plant,purple,raised,red-brown,rotate,scar,short-styled,simple,small,smooth,spherical,stem,style,surface,terete,trichome,unbranched,usually,white,yellow,young	-2,0-100,0.5-1,1-4,1/2,1/3-2/3,1/3-3/4,1/4-1/3,1/6,10-20,10-35,12-35,2-4,2.2-3.2,2.8-3.8,4-10,4-6,5-10,5-8,6-20,6-30,7-10,acute,alyx,apar,apex,apically,apparently,articulated,attenuate,ba,base,becoming,blade,broad,broad-deltate,concolorous,connivent,cuneate,curved,decurren,difoliate,distal,distance,drying,eaf,eed,elongating,equal,erect,extending,extensive,foliaceou,free,fully,geminat,glabrescent,glandular,hair,hermaphrodite,heterostylous,infructescence,less,lobe,lobing,long,long-acuminat,longer,lower,lowermost,mature,midvein,minute,near,nflorescence,obtuse,often,older,one,onl,open,opening,orolla,oung,ovoi,pair,part,pendulous,per,pericarp,poricidal,portion,primary,reddi,reflexed,rounded,ruit,secondary,side,sometimes,spaced,sparsely,spreading,staminat,stellate-pubescent,stout,straight,tamen,tapering,tearing,tertiary,time,tip,tube,ud,unarme,unarmed,unit,upper,vary,vein,venation,visible,way,wide,wider,woody,ympodial	/,abaxial,adaxial,apart,arrangement,bud,center,colour,form,growth,height,history,inflorescence,life,na,new,number,ovary,ovoid,perennial,position,reddish,reproduction,seed,shape,spacing,staman,texture,width
477	wfo-0001029286	invalid_json_followup	224	126	92	132	34	0.411	0-0.5,0.8,1-1.5,1-2,1.5-2,1.5-4,1.5-8,15-50,2.5-3,4.5-7,5-6,6-9,7-10,abaxial,abaxially,acute,adaxially,almost,anther,apart,apex,apically,apiculate,bark,base,branch,branched,branching,brown,capitate,chartaceous,clustered,cm,conical,corolla,dendritic,diameter,dilated,distributed,drying,faint,filament,flat,flexuous,flower,glabrescent,glabrous,green,grey,inside,leaf,length,liana,light,lilac,lobed,long,mauve,membranous,midvein,minutely,mm,multicellular,oblong,obovate,outside,pedicel,peduncle,petiole,primary,prominent,rachi,raised,scar,slender,smooth,sparsely,spreading,stem,stigma,stump,style,surface,terminal,tertiary,tip,trichome,unarmed,vein,venation,x,yellowish	.4,.5,0.1,0.15-0.4,0.4-1.2,0.6-1.2,0°,1/8,2-3,3-4,4-5,4-6,4.5,5,6-8,abscising,age,along,altered,alyx,another,anthesi,apar,apice,apparently,arising,around,articulated,articulation,attenuate,axil,becoming,broadly,canaliculate,clearly,closer,concave,concolorous,crenulate,curved,cuspidate,delineated,deltoid,density,domatia,eaf,eed,entire,equal,except,extending,fertilization,formed,forming,free,fresh,globo,hair,increasing,inflorescenc,isolated,junction,know,known,lamina,lengthening,less,lobe,lower,m.,main,margi,margin,mas,meeting,middle,much,narrowly,nflorescence,nther,obconical,occasional,often,one,orolla,ovate,pair,papillo,perfec,plurifoliat,pore,poricidal,portion,protruding,rarely,regular,rounded,ruit,separated,shallowly,side,simple,smaller,sometimes,somewhat,soon,specimen,stretchy,tangled,tearing,terete,textur,thick,thickened,thinner,time,tissue,together,toward,translucent,translucent-violet,tube,tuft,ud,uneven,unit,vary,visible,wide,widely,ympodial,young	'',0\u00b0,[,``,adaxial,arrangement,bud,calyx,center,characteristic,colour,form,fruit,fruiting,globose,growth,inflorescence,na,new,number,ovary,papillose,position,prickle,seed,shape,spacing,staman,texture,true,value,width,{,}
478	wfo-0001029289	success	292	141	116	176	25	0.397	.05,.5,0.4-1.1,0.4-2,1-2,1-4,1.5-5,100,15-45,2-3,2.5,2.5-4,25,5-20,6-12,8,adaxial,almost,along,anther,apex,apically,bark,base,berry,black,branch,brown,calyx,canaliculate,capitate,chartaceous,clavate,cm,conical,corolla,covering,cupular,curved,deeply,dendritic,development,diameter,dilated,distributed,drying,entire,erect,evenly,filament,finely,flattened,flower,fruiting,glabrescent,glabrous,globose,green,honeycomb,inside,leaf,length,liana,lobed,longitudinally,margin,maturity,mm,obconical,oblong,obovate,orange,outside,pale,pattern,pedicel,peduncle,petiole,pili,pitted,prominent,puberulous,pubescent,rachi,rarely,reddish,reniform,ridged,scar,seed,shape,simple,smooth,sparse,spheroidal,stem,stigma,straight,stump,sturdy,style,surface,terete,terminal,thick,thin-coriaceous,trichome,undulate,unicellular,violet,white,widely,x,yellow,yellowish,young	.2,0-2,0.15-0.25,0.2-1.5,0.4-1,0.5,0.5-0.7,0.5-1,0.5-1.2,1-1.2,1-2.5,1.2,1.5-2,1.5-4,1/6-1/3,12,15,1mm,3,3-7,4-9,4.5,5-12,60-90°,abaxially,accrescent,acuminate,acute,adaxially,age,always,alyx,anthesi,apar,apice,apparently,appendage,arachnoid,arising,aristate,around,articulated,articulation,attenuate,becoming,boundary,branched,branching,broadly,clear,clearly,close,collapsing,complex-dendritic,complexity,concolorous,crenulate,cuneate,cuspidate,delineated,deltoid,dense,detaching,developing,discolorous,domatia,dorsally,eaf,eed,ellipsoi,elongated,equal,eye,faint,fertilisation,flexuous,forming,found,free,hair,half,hard,indumentum,inner,irregular,lamina,leave,lengthening,less,light-coloured,line,linear,lobe,long,loop,lower,m.,main,margi,may,middle,midvein,minute,minutely,mixture,multicellular,naked,narrowly,nflorescence,nther,often,one,orolla,outer,outline,pair,papillae,papillo,papillose,pendulous,perfec,pericarp,pit,plurifoliat,point,pointed,pore,poricidal,portion,primary,pronounced,protruding,raised,reveal,rising,rounded,ruit,see,shallow,shallowly,shiny,short,side,sinus,size,slightly,sometimes,somewhat,soon,sparsely,spreading,strongly,sunken,tearing,tertiary,thickened,thin,time,tip,together,toward,truncate,tube,tuft,ud,unarmed,unit,usually,variable,various,vary,vein,venation,visible,wide,ympodial	abaxial,arrangement,bud,colour,dioecious,ellipsoid,form,fruit,growth,height,history,inflorescence,life,na,new,number,ovary,perennial,plant,prickle,reproduction,spacing,staman,texture,width
479	wfo-0001029295	invalid_json_followup	191	122	88	103	34	0.461	0.5,0.7-1,1,1-1.5,2,2-3,5-6,<,abaxial,acuminate,acute,along,anther,apex,bark,calyx,capitate,cell,closely,cm,corolla,diameter,drying,ellipsoid,elliptic,entire,filament,flower,fruit,fruiting,glabrescent,glabrous,globose,green,grey,height,herb,internodal,known,lateral,leaf,length,lobed,long,margin,membranous,midrib,minute,minutely,mm,obtusely,ovary,ovoid,pale,papillate,pedicel,peduncle,pentagonal,petiole,pitted,pubescent,purple,red,reniform,rhomboidal,ripe,scar,scattered,shallowly,shrub,simple,sinuate,small,spaced,sparsely,stem,stigma,style,surface,tan,thin,trichome,uniseriate,whitish,wiry,woody,x,yellowish	-5,-9,.5,0,1.2-3.5,2-4,2.5-3.5,2.5-6,2/3,3/4,4-4.5,4-5-celled,4-6,4-merous,6-8,?,anthesi,apparently,appearing,articulated,attenuate,base,become,berry,continuous,crystal,cup-shaped,dark,deciduous,defined,defoliate,dense,distal,eaf,eed,elongate,erect,essentially,exserted,fide,free,geminat,glabrou,half,irregular,lamina,lengthen,lobe,lobe-lik,lower,narrowly,nflorescence,nodding,older,opening,orientation,outline,pair,papillat,peduncl,peelin,per,perfect,pericarp,pointed,pore,portion,primary,prolonged,puberulent,rim,rooting,rounded,ruit,sand,seen,sessile,short,slightly,slit,soon,splitting,sprawling,strongly,testal,tip,tissue,top,tube,ud,unarmed,undulation,unifoliate,unit,upper,urban,usually,vein,way,widest,wing,ympodial,young	'',[,``,adaxial,arrangement,bud,center,characteristic,colour,form,growth,history,inflorescence,life,na,new,number,peeling,perennial,plant,position,prickle,rachi,reproduction,seed,shape,spacing,staman,texture,unknown,value,width,{,}
480	wfo-0001029299	invalid_json_followup	201	133	89	112	44	0.443	0.5-1.5,1-10,1-2,10-16,10-21,2.3-3.3,3,3-4.5,3-7.5,4-16,5-15,7-8,abaxially,acuminate,acute,adaxially,along,anther,apart,apex,articulated,axillary,broadly,brownish,bud,cell,ciliate,clavate,cm,condition,corolla,covering,diameter,drying,elliptic,especially,filament,flower,forked,fresh,fruit,glabrous,glandular,green,green-white,greenish,herb,invested,lateral,leaf,make,margin,medium,midrib,minutely,mm,moderately,mottled,mucilaginous,multicellular,non-glandular,odd-pinnate,ovate,ovoid,pedicel,peduncle,pentagonal,petiole,plant,puberulent,pubescent,purple,rotate,seed,slightly,stem,stigma,style,subtending,terminal,testal,thick,throughout,trichome,wall,wet,white,whitish,yellow	0-3,0-5,1-4,1.6-5,16-28.6,2-4,3-12,3-13,3-5,3.5-7.5,4-10,5-merou,6-5-15.3,8.5-19,acumen,ag,alyx,apparently,attenuate,axe,base,blade,borne,capitat,chartaceous,connate,cordate,cuneate,decreasing,decurrent,dense,digestion,distal,dorsally,eaf,edge,eed,end,enzyme,erec,exceeding,flat,folded,geminat,generally,grading,gradually,hair,hair-like,half,homostylous,honeycomb-shaped,interjected,lanceolate,leaflet,lengthening,like,living,lobe,long,lower,membranous,middl,nflorescence,oblique,orbicular,orolla,pair,perfect,petiolulate,petiolule,plurifoliate,pore,poricidal,pubescence,removed,rounded,ruit,sessile,seudostipule,shallowly,short,singly,size,slit,spaced,specimen,spreading,stamen,ste,stolo,straight,subsessile,tall,tamen,tem,tip,tissue,toward,tri-,truncate,tube,tuber,typically,unit,unknow,usually,vary,wide,wing,x,ympodial	'',5-merous,[,\u201chair-like\u201d,``,abaxial,adaxial,arrangement,bark,calyx,capitate,center,characteristic,colour,erect,form,fruiting,growth,height,history,inflorescence,length,life,middle,na,new,number,ovary,perennial,position,prickle,rachi,reproduction,scar,shape,spacing,staman,surface,texture,unknown,value,width,{,}
481	wfo-0001029308	success	221	114	83	138	31	0.376	0.2-1.5,1-5,1.5-4,19-30,2-5,2-6,2.5-3,3.5-4.5,4-15,4-5,6-18,7-10,7-8,acicular,acuminate,acute,andromonoecious,anther,apex,broad-based,brown,calyx,chartaceous,cm,deltate,densely,diameter,eglandular,elliptical,entire,extra-axillary,flattened,flower,fruit,fruiting,furrowed,glabrous,globose,green,inflorescence,leaf,length,lilac,lobed,longer,margin,minutely,mm,moderately,ovate,pale,pedicel,peduncle,perennial,petiole,plant,prickle,purple,rachi,reticulate,rhizomatous,rotate-stellate,rusty,seed,shallowly,shrub,simple,sparsely,stellate,stellate-pubescent,stigma,straight,style,surface,thickened,time,toward,unbranched,weakly,wide,yellow,yellowish,yellowish-green	%,0-10,0-25,0-4.5,0.05-0.3,0.2-0.3,0.25-0.3,0.25-0.35,0.25-0.4,0.25-1,0.4-0.7,1,1-4,1.2-2.5,1.5-2.5,1.5-2.7,1.5-3,1.5-5.5,168,1981,2-foliate,2-locular,2.2-2.7,2.7-3.1,20-40,3-4,3-6,30-50,4-6,4-8,4.3-15,4.5-6,5-merou,6-11,6-8,8-19,9-18,9.5-28,abaxially,absen,absent,across,adaxiall,adaxially,adult,alyx,anvil-shape,apart,articulated,axe,ba,base,blade,branch,branche,broadly,capitat,confined,connivent,counted,cross-section,cuneate,cylindrical,decimetre,directed,distall,distributed,dm,eaf,eed,elliptic,erect,exocarp,finger,functional,geminat,gland-tipped,hair,half,heterostylous,interpetalar,juicy,juvenile,lamina,lanceolate,lateral,less,lobe,long,loosely,lower,margi,mature,mesocarp,mid-point,midpoint,midrib,midvein,minute,moist,nearly,nflorescence,oblique,one,orolla,pair,part,per,placenta,pore,porrect,present,ray,ruit,sessile,short,side,spaced,stalked,star,stellae,tal,tamen,tem,thick,throughout,tissue,triangular,tube,unarme,unarmed,unit,upper,vary,vein,x,ymon,ympodial	5-merous,abaxial,adaxial,arrangement,bark,bud,capitate,cell,center,colour,corolla,filament,form,growth,height,history,life,na,new,number,ovary,position,reproduction,scar,shape,spacing,staman,stem,texture,trichome,width
482	wfo-0001029310	invalid_json_followup	216	125	88	128	37	0.407	.5,0.1-0.2,0.2-0.8,0.6-1.1,1-1.5,1-4,1.2-1.5,1.8-3,2-3.5,2-4,2.5-6,3-4,4-10,45-60,5-10,5-12,5-6,5-merous,accrescent,acute,andromonoecious,anther,apart,apex,bark,base,berry,branched,brown,calyx,cm,conical,dark,deltate,diameter,dull,elliptic,erect,filament,flattened-reniform,flower,fruit,fruiting,glabrescent,glabrous,gray,herb,inflated,lateral,leaf,length,lobed,long,long-styled,margin,maturity,mauve,membranous,mm,orange-green,ornately,pedicel,peduncle,pendent,petiole,pinnatifid,plant,porrect,prickle,scar,sessile,short-styled,shrub,smooth,spherical,spreading,stalked,stellate,stem,straight,strongly,style,surface,terete,trichome,variously,wide,yellow	-16,-25,.1,.6,/4,/6,0-20,0-5,0.2-0.3,0.5,0.5-3,00,1,1-2,1/,10,10-13,10-15,10-20,15-20,2/3-3/4,20-40,20-60,200-500,3-5,3.5,4-8,5,5-20,5-30,5-7,5-8,6-8,7-12,7-13,8,abaxially,alyx,ame,apar,apically,apparently,articulated,beyond,blade,c.,concolorous,connivent,cordate,difoliate,distal,distance,drying,eaf,eed,elongating,enclosing,equal,extending,filifor,free,geminat,gently,hair,hermaphrodite,heterostylous,infructescence,lobe,lobing,lon,longer,lower,lowermost,mature,midpoint,midvein,minute,moderately,narrow-deltate,nflorescence,older,one,open,orolla,oung,pair,pendulous,per,pericarp,perpendicular,poricidal,portion,prickl,prickly,primary,ray,recurved,red-brow,retrorse,ruit,secondary,shorter,side,simple,sometimes,spaced,sparsely,stalk,staminat,stellate-pubescent,stout,tamen,tapering,tertiary,time,tip,tissue,toward,truncate,tube,unit,vary,vein,venation,visible,way,woody,ympodial	'',/,[,``,abaxial,adaxial,arrangement,bud,center,characteristic,colour,corolla,form,growth,height,history,inflorescence,life,na,new,number,ovary,perennial,position,rachi,red-brown,reproduction,seed,shape,spacing,staman,stigma,texture,value,width,{,}
483	wfo-0001029317	invalid_json_followup	151	111	71	80	40	0.47	.5,0.5,0.8-1,1,1-1.5,2-3,7-8,8-9,acuminate,anther,apex,area,base,broadly,bud,ca,calyx,channeled,closely,cm,corolla,cup-like,densely,denser,filament,fruiting,glabrous,globose,grayish,inflorescence,leaf,like,lobed,long,margin,minutely,mm,narrowly,nearly,opposite,ovary,ovate,overlapping,paler,papillose,pedicel,petiole,probably,pubescent,rachi,rest,scar,shrub,simple,slender,slightly,soft,spaced,sparsely,stem,stigma,style,tapering,thickened,tip,trichome,tube,uniseriate,vein,white,x	0.25,0.5-0.75,0.5-1,1.5-3.5,10-16,10-30-flowered,11-14,2.5-5,6-8,6.5-11,along,anthesi,apar,attenuate,barely,beneath,brow,deciduou,deflexed,deltoid,dia,differing,difoliate,dry,eaf,edicel,eed,ellipsoi,epidermi,erect,exserted,extreme,free,frui,geminate,glabrate,immature,known,lateral,lobe,lon,lower,main,major,middle,minor,nflorescence,occasionally,often,older,one,otherwise,ovoid,pair,pore,poricidal,portion,prominent,proximal,raised,reflexed,remaining,rounded,ruit,shaped,size,soon,specimen,straight,styl,tall,tear-drop,tuft,ud,unit,visible,widest,yellowish,ympodial,young	'',10-30,[,``,abaxial,adaxial,arrangement,bark,brown,center,characteristic,colour,diameter,flower,form,fruit,growth,height,history,length,life,na,new,number,peduncle,perennial,plant,position,prickle,reproduction,seed,shape,spacing,staman,surface,texture,value,width,{,}
484	wfo-0001029332	invalid_json_followup	197	133	98	99	35	0.497	/3,0,0-0.5,0.1-0.2,0.5-1,1-1.5,1-3,1-4,1.3-1.5,1.5-2,10-30,2,2-2.5,2-4,2.8-3.7,2/3-3/4,3-4,4-10,5-merous,8.5-9.5,abaxial,abaxially,adaxial,andromonoecious,anther,apex,apically,articulated,bark,base,berry,broad-deltate,calyx,chartaceous,cm,conical,connivent,curved,densely,diameter,elongating,erect,filament,flattened,flattened-reniform,flower,fruit,fruiting,glabrescent,glabrous,lateral,leaf,length,lobed,long,lower,margin,mature,maturity,mauve,mm,moderately,orange-brown,ovate,pale,pedicel,peduncle,petiole,plant,poricidal,porrect,prickle,rounded,scandent,scar,shrub,simple,slender,smooth,spherical,spreading,stellate,stellate-pubescent,stem,style,subsessile,surface,tapering,terete,terminal,tip,trichome,unbranched,way,weakly,yellow,yellow-green,yellow-orange	-5,.5,0-100,0-2,0-20,0-4,0-5,0.1,0.15-0.2,0.15-0.25,0.8-1,1-2,1/2,1/3,1/4,1/4-1/3,2.5-3.5,2/,3-6,3.5-5,4-15,5-6,5-8,6-8,alyx,apar,apart,apparently,becoming,blade,concolorous,cordate,difoliate,distal,distance,drying,eaf,eed,equal,extending,free,geminat,gland,globular,grayi,herbaceous,hermaphrodite,heterostylous,infructescence,less,lobe,long-acuminat,long-styled,longer,lowermost,midpoint,midvein,narrow-deltate,nflorescence,often,older,one,open,orolla,oung,pair,pendulous,per,pericarp,portion,prickl,prickly,primary,pubescent,ray,reduced,ruit,sessile,short-styled,shorter,side,spaced,stalk,stalked,staminat,tamen,tertiary,time,tube,unit,upper,variously,vary,vein,venation,visible,wide,woody,ympodial	'',2/3,[,``,arrangement,bud,cell,center,characteristic,colour,corolla,form,grayish,growth,height,history,inflorescence,life,na,new,number,ovary,perennial,position,reproduction,seed,shape,spacing,staman,stigma,texture,value,width,{,}
485	wfo-0001029333	invalid_json_followup	155	103	64	91	39	0.413	.25,0.5-1,0.7-1,1-1.2,1-1.5,1-15,1-7,1.5-3,2-2.5,5-6,abaxial,along,anther,apex,bark,broadly,calyx,clavate,cm,conical,corolla,dendritic,dendritic-pubescent,densely,elliptic-obovate,filament,flattened-reniform,flower,fruiting,glabrous,globose,green,leaf,lobed,long-styled,main,margin,minutely,mm,obovate,opposite,ovary,pale,pedicel,petiole,pitted,pubescent,reddish-brown,rounded,scar,shape,shining,short-styled,shrub,simple,slender,spaced,sparsely,stem,stigma,style,surface,trichome,vein	.5,/4,0.5,1-2,1-3,1.5-2,1.5-2.5,10-15-flowered,100,17-26,3-7,3-7.5,8-15,9-13,abaxially,acuminate,acute,adaxially,anisophyllou,anthesi,auriculate,ba,base,beige,beneath,berry,contracted,deflexed,denser,dia,differing,difoliate,dry,eaf,edicel,eed,erect,exserted,free,fresh,geminate,golden,heteromorphic,incrassate,inflorescenc,lateral,like,lobe,lon,long,lower,major,minor,nflorescence,occasionally,older,orbicular,overlappin,pair,paler,papillo,planar,pore,poricidal,portion,present,pubescence,rest,ruit,sessile,shaped,size,small,somewhat,strongly,tall,tear-drop,time,tip,tree,triangular,truncate,tube,type,ud,unit,way,wide,woody,ympodial,young	'',10-15,[,``,adaxial,arrangement,bud,cell,center,character,characteristic,colour,diameter,form,fruit,growth,height,history,inflorescence,length,life,na,new,number,peduncle,perennial,plant,position,prickle,rachi,reproduction,seed,spacing,staman,texture,value,width,{,}
486	wfo-0001029334	invalid_json_followup	211	110	68	143	42	0.322	0.15-0.3,1-10,1-2,1.3-4.5,1.5-6,1.8-2.9,2-8,4-5.5,5-10,8-30,9-12,abaxially,adaxially,almost,anther,apex,brownish,bud,cell,chartaceous,clavate,cm,condition,corolla,covering,diameter,drying,filament,flower,forked,fresh,fruit,glabrous,globose,green,greenish,herb,lateral,margin,membranous,minutely,mm,odd-pinnate,orbicular,ovate,ovoid,pedicel,peduncle,petiole,plant,puberulent,pubescent,pure,ripe,seed,stellate,stem,stigma,style,terminal,testal,thick,tinged,violet,wall,white,whitish,yellow	.2,0-4,1,1-3,1-6,1.5-3.9,2,2-2.5,2-4,2-5,2.5-3,3-5,3-7,3.2-5.8,3.3-6.5,4-8.5,5-merou,7.5-15.5,absent,acumen,acute,ag,along,alyx,among,apart,apparently,articulated,attenuate,axe,axillary,base,berry,blade,borne,broadly,capitat,ciliate,connivent,cordate,cuneate,decreasing,decurrent,densely,digestion,distal,dorsally,eaf,edge,eed,elliptic,end,enzyme,erect,especially,exceeding,except,flat,folded,geminat,generally,glabrou,gradually,grassland,greatly,green-white,hair,hair-like,half,homostylous,honeycomb-shaped,interjected,lanceolate,leaflet,lengthening,like,living,lobe,long,low-growin,lower,make,middl,midrib,mucilaginous,narrowly,nflorescence,oblique,obtuse,often,orolla,pair,perfect,petiolulate,petiolule,plurifoliate,pore,poricidal,proximal,rarely,reduced,removed,rounded,ruit,semi-rosette,sessile,seudostipule,shady,short,singly,situation,size,slightly,slit,spaced,specimen,stamen,ste,stolo,straight,subequal,subsessile,subtending,sunny,tall,tamen,tem,throughout,tip,toward,tri-,tube,tuber,typically,unit,unwinged,usually,vary,wet,wide,woodland,x,ympodial	'',[,\u201chair-like\u201d,``,abaxial,adaxial,arrangement,bark,calyx,capitate,center,characteristic,colour,form,fruiting,growth,height,history,inflorescence,leaf,length,life,na,new,number,ovary,perennial,position,prickle,rachi,reproduction,scar,shape,spacing,staman,surface,texture,trichome,value,width,{,}
487	wfo-0001029340	invalid_json_followup	286	114	70	216	44	0.245	'',1-2,10,2,5-merous,``,abaxial,absent,acute,adaxial,anther,apex,bluish,bright,brown,calyx,capitate,cm,conical,curved,depressed-spherical,diameter,filament,flattened-reniform,flower,foveolate,fruit,fruiting,glabrous,glandular-puberulent,green,heterostylous,lateral,leaf,lobed,margin,minutely,mm,orange-yellow,pale,pedicel,peduncle,petiole,pilose,prickle,prickly,purple,recurved,shiny,shrub,simple,soft,soft-pilose,spherical,spreading,spreading-pilose,stellate,stem,stigma,straight,style,suborbicular,surface,terete,tinged,tough,trichome,unbranched,yellow,yellowish	-celled,.05,.2,.2–1.6,0,0.15–0.6,0.2–0.5,0.4,0.5,0.5–2,0.5–2.5,0.8–3.2,0–,1,1.2–2.0,1.2–2.2,1.4–1.8,1.5-3,1/2,1/4,100,13–15,1–,1–1.2,1–2,1–2-celled,2.5,20,2–10,2–2.2,2–3,2–3.2,2–5-celled,2–8,3,3.5–5.5,3–3.5,3–5-celled,3–5.3,3–6-celled,3–7,4,4–4.5,4–8,5,5°,5–12,8–12.5,8–17,9–20,>,abaxially,abruptly,acicular,age,almost,alyx,angle,anthesi,apical,apicall,armed,around,articulated,ba,basal,base,becoming,berry,bilobed,blade,branched,broad-based,coarse,column,compressed,concentrated,connivent,cordate,curving,cylindrical,darker,densely,developin,difoliate,directed,duller,eaf,eed,elongate,embedded,equal,evenly,exceeding,exceptionally,expanded,expanding,extending,falling,fertile,free,frui,geminat,geminate,gland,gland-tipped,glandular,grading,gradually,greater,greenish,hair,held,hyaline,infructescence,irregularly,lanceolate,larger,largest,less,light,like,linea,lobe,lon,long,long-styled,lower,lowermost,main,major,many,mature,maturity,mesocarp,midpoint,midrib,minute,mixture,mostly,much,narrowed,narrowly,near,nearly,nflorescence,nipple,occasionally,often,one,orange,orolla,oung,ovoid,pair,papillat,per,pericarp,perpendicular,pore,poricidal,portion,pulp,rarely,ray,reflexed,ruit,secondary,senescent,sessile,sharp,short,short-styled,shorter,shrivelling,similar,single,size,slightly,small,smaller,smooth,somewhat,soon,sparsely,spongy,ste,stipitate,stipitate-glandular,stout,strongly,tall,tamen,tapering,thin,thin-textured,tip,tooth,triangular,tube,twice,two,unarme,unarmed,uniseriate,unit,usually,variously,vary,vein,viciously,way,white,whole,wide,ympodial	0.5-2,0.5-2.5,1-1.2,12,2-10,2-3.2,5-12,8-12.5,[,arrangement,bark,bud,cell,center,characteristic,colour,corolla,dense,form,growth,height,history,inflorescence,length,life,na,new,number,ovary,perennial,plant,position,rachi,reproduction,scar,seed,shape,spacing,staman,texture,value,width,{,}
488	wfo-0001029344	invalid_json_followup	147	113	70	77	43	0.476	0.4-1,0.5-1,0.5-1.5,1,1-5,1.5,1.5-3,1.5-4,10-20,4-6,5-15,absent,along,anther,apex,blade,brown,calyx,center,chartaceous,cm,denser,diameter,dm,drying,edge,elliptic,elliptic-ovoid,entire,filament,fine,flat,flower,fruit,glabrous,globose,herb,immature,long,lying,margin,maturing,membranaceous,mm,moderately,nearly,obtuse,parallel,pedicel,peduncle,petiole,pubescent,rachi,radiating,raised,rhizomatous,ridge,rotate,running,semitransparent,shallow,sparsely,stigma,straight,style,surface,vein,white,x,yellow	.5,0.5-3,1-2,1-3,1-6,10-35,2-3,2-3-celled,2-4,2-7,3-10,5-12,abaxially,abundant,acute,adaxiall,adaxially,axe,base,berry,beyond,ciliate,connected,cordate,decurrent,dehiscing,densely,difoliate,eaf,eed,emarginat,equal,explosively,exserted,frui,geminat,hair,held,interpetalar,lacking,linear-lanceolate,lobe,lower,maturit,mesocarp,nflorescence,notch,oblong,obvious,often,one-,orolla,per,placenta,pressure,pubescen,rounded,ruit,short,slightly,sometimes,stamen,swollen,tal,tamen,tem,tissue,triangular,tube,two-celled,unbranched,unit,vary,watery,wid,woody,ympodial	'',2.5,[,``,abaxial,adaxial,arrangement,bark,bud,cell,characteristic,colour,corolla,form,fruiting,geminate,growth,height,history,inflorescence,leaf,length,life,na,new,number,ovary,plant,position,prickle,reproduction,scar,seed,shape,spacing,staman,stem,texture,trichome,value,width,{,}
489	wfo-0001029363	invalid_json_followup	152	119	80	72	39	0.526	/4,0.1-0.5,0.2-1.1,0.5-1,1-1.2,2-6,3-7,6-7,acuminate,acute,anther,apex,axil,bark,base,becoming,beneath,bi-lobed,bud,calyx,capitate,closely,cm,corolla,cup-shaped,deep,densely,edge,elliptic,filament,fruit,fruiting,glabrous,globose,green,greyish,lateral,leaf,lobed,main,margin,maroon,meeting,minutely,mm,narrowly,occasionally,opposite,ovary,overlapping,pale,paler,papillose,pedicel,petiole,pubescent,scar,shiny,shrub,simple,slender,small,spaced,sparsely,stem,stigma,style,surface,tapering,thickened,tip,tree,trichome,tube,tuft,uniseriate,vein,way,white,yellowish	.25,.75,0-0.1,0.5,1,1.5-1.7,1.5-3.5,4-11,5-7-flowered,6-8,7-10,anthesi,ba,beginning,berry,coroll,deflexed,deltoid,dia,drying,eaf,edicel,eed,erect,except,exsertion,free,immature,inflorescenc,internodal,known,lamina,larger,later,lobe,lon,long,lower,mature,middle,minute,much,near,nflorescence,obtuse,often,older,pair,papillo,pore,poricidal,portion,prominent,reflexed,ruit,slit-like,somewhat,sparse,straight,tall,terminal,ud,unifoliat,unit,upon,usually,white-papillose,wide,widest,woody,ympodial,young	'',5-7,[,``,abaxial,adaxial,arrangement,cell,center,characteristic,colour,diameter,flower,form,growth,height,history,inflorescence,length,life,na,new,number,peduncle,perennial,plant,position,rachi,reproduction,seed,shape,spacing,staman,texture,unifoliate,value,width,{,}
490	wfo-0001029364	invalid_json_followup	153	103	61	92	42	0.399	-2,-6,0.2-0.5,1-,1-3,1-4,1-5,1.5-2,2-6,5-9,8-15,abaxially,acuminate,adaxially,anther,apart,apex,articulated,base,calyx,cell,center,chartaceous,cm,corolla,cream,diameter,elliptic,entire,extra-axillary,filament,flower,fruit,glabrous,globose,green,greenish,herb,margin,membranaceous,minutely,mm,nearly,pedicel,peduncle,petiole,puberulent,rachi,short-tomentose,shrub,simple,sparsely,spot,stellate,stigma,style,unbranched,unknown,white,x,yellow	-3,.5,1,10-27,191.,2,2-,2-foliat,3-4,4-12,4-9,5-,5-11,6-8,7-9,8-10,?,according,acute,aggregate,around,axe,ba,bitter,blade,blue,color,connivent,cuneate,curled,cylindrical,darker,deep,directed,distall,distally,eaf,ed,fide,finger,free,gland-tipped,glandular-puberulen,hair,immature,inserted,lobe,long,lower,major,mesocarp,moderately,narrowly,nflorescence,obtuse,orolla,ovate,part,perfect,pore,presence,present,puberulen,pubescent,radiu,ripe,ruit,rusby,sagittate,shallow,shorter,side,small,spaced,stone,strongly,tal,tamen,tapered,tem,thecae,tightly,time,tomento,triangular,truncat,tube,unit,vary,vein,wide,ympodial	'',[,``,abaxial,adaxial,arrangement,bark,bud,characteristic,colour,form,fruiting,growth,height,history,inflorescence,leaf,length,life,na,new,number,ovary,perennial,plant,position,prickle,reproduction,scar,seed,shape,spacing,staman,stem,surface,texture,trichome,truncate,value,width,{,}
491	wfo-0001029368	success	139	89	55	84	34	0.396	0.5-2,1.5-1.6,1.5-3,1.5-4,2-5,2.5-4,5-6,acuminate,along,anther,apex,bark,broadly,calyx,capitate,closely,cm,corolla,deflexed,densely,elliptic,erect,filament,flower,fruit,fruiting,glabrous,globose,green,herb,inflorescence,internodal,leaf,margin,midrib,minutely,mm,obtuse,opposite,ovary,papillose,pedicel,petiole,puberulent,scar,shrub,simple,somewhat,spaced,stem,stigma,style,trichome,uniseriate,white	.2,.25,.5,0,0.9-1,1.5-2,11-13,16-25,?,abaxially,acute,adaxially,anthesi,apparently,base,bearing,berry,bitter,borne,breaking,brow,coarse,conical,crumpled,cup,dia,distal,eaf,edicel,eed,exserted,few-branched,fide,flattened,free,golden,half,indistinct,inflorescenc,known,lamina,lanceolate,lateral,leaving,like,lobe,long,lower,main,margi,middle,minute,nflorescence,non-flower,older,one,overlappin,pair,papillo,parallel,pore,poricidal,portion,reflexed,rest,ruit,shaped,straight,strongly,tall,tear-drop,tip,tube,ud,unifoliat,unit,upper,vein,widest,winged,woody,x,ympodial,young	0.25,0.5,abaxial,adaxial,arrangement,brown,bud,cell,center,colour,diameter,form,growth,height,history,length,life,na,new,number,peduncle,perennial,plant,position,rachi,reproduction,seed,shape,spacing,staman,surface,texture,unifoliate,width
492	wfo-0001029370	invalid_json_followup	224	136	102	122	34	0.455	-32,.3,0-35,0.1-0.15,0.5-1,0.5-2.2,1-2,1-3,1-4,1.5-6,1.8-2.5,1/4-1/3,15-30,3-4,3.5-8,5-12,5-merous,5.5-7,6-15,abaxial,abaxially,adaxial,almost,andromonoecious,anther,apex,articulated,bark,base,berry,branched,broad-deltate,calyx,chartaceous,cm,cream,curved,dark,densely,diameter,erect,filament,fine,flattened-reniform,flower,fruit,fruiting,glabrescent,glabrous,green,greenish,herb,leaf,length,lobed,long-styled,margin,marking,mature,mauve,mm,moderately,multangulate,obtuse,orange,orange-brown,ornate,ovate,pale,pattern,pedicel,peduncle,petiole,plant,prickle,red-brown,reticulate,rotate,rounded,scar,sessile,shiny,short-styled,shrub,simple,slightly,smooth,sometimes,spherical,stalked,stellate-pubescent,stem,straight,style,surface,terete,trichome,way,white,whitish,yellow,young	-20,.1,.5,/4,0-10,0-100,0-3,0.1,0.2,0.3,1,1.8-2.8,1/3-1/2,10-17,10-40,10-50,12-17,2-10,2-20,2-3,2-6,2.5-3.5,3.5-4,3/,4-6,4-7,4-9,5-10,7-11,7-13,8-14,8-20,8-23,acut,alyx,ame,apar,apart,apically,apparently,basal,blade,c.,clearly,conical,connivent,cordate,discolorous,distal,distance,drying,eaf,eed,elongate,elongating,equal,extending,fewer,flattened,free,fully,gently,hermaphrodite,heterostylous,infructescence,lateral,lobe,long,longer,lower,lowermost,maturity,midpoint,midvein,mixture,nflorescence,often,older,one,open,opening,orolla,oung,overlapping,pair,pendulous,per,pericarp,perpendicular,plurifoliat,poricidal,porrect,portion,prickl,prickly,primary,ray,ruit,side,spaced,spreading,stalk,staminat,stout,strongly,tamen,tapering,tertiary,time,tip,tube,unarmed,unit,variously,vary,vein,venation,visible,white-gra,wide,woody,ympodial	'',/,[,``,arrangement,bud,cell,center,characteristic,colour,corolla,form,growth,height,history,inflorescence,life,na,new,number,ovary,perennial,reproduction,seed,shape,spacing,staman,stigma,texture,value,white-gray,width,{,}
493	wfo-0001029373	invalid_json_followup	199	111	69	130	42	0.347	.5,5-merous,abaxial,adaxial,anther,apex,appressed,bark,bayonet,berry,bud,calyx,clavate,cm,conical,corolla,curved,densely,diameter,ellipsoid,entire,filament,flattened-reniform,flower,fruit,fruiting,glabrous,globose,green,grey-brown,growth,herb,internodal,lateral,leaf,margin,minutely,mm,moderately,new,ovary,ovate-lanceolate,pedicel,peduncle,pentagonal,petiole,pitted,plant,pubescent,rounded,scar,shallowly,shape,simple,spreading,stellate,stem,stigma,straight,style,surface,terete,tip,trailing,trichome,white,yellow,yellow-green,yellowish	.0–1.2,.2,.3,.5–2.0,0.3–0.5,0.4–1.6,0.5–1.2,0.5–1.8,0.6–0.7,1.0–1.2,1.0–1.6,1.2–1.5,1.3–2.2,1.4–3.5,1.5–2.0,1.5–2.5,1.5–2.7,1.8–2.0,1.8–2.3,180°,2-celled,2.0–2.5,2.7–3.0,20–30,2–4-celled,3,3.5–4.0,30–40,3–5,4–5,4–6,5,5–6,6.8,8–9,abaxially,accrescent,acuminate,acute,adaxially,age,anthesi,apar,appearanc,arising,articulated,basal,base,beyond,broadly,capped,cell,cone,deltate,developing,distal,eaf,eed,elongate,enclosed,enclosing,exerted,finger,free,fully,geminat,glandular-tipped,hair,half,halfway,hilum,immature,individual,laterally,lengthening,less,like,live,lobe,lobed,lon,long,lower,mature,mesocarp,middle,minute,mouth,nflorescence,node,obtuse,older,outline,pair,papillate,per,perfect,plurifoliate,pore,poricidal,portion,positioned,primary,reflexed,resembling,root,ruit,seen,seudostipule,short,slightly,slit,smoot,spaced,still,tall,tem,testal,thicker-walled,tub,tube,ud,uniseriate,unit,upper,vein,wide,woody,ympodial,–5	'',.0-1.2,0.4-1.6,0.5-1.2,0.6-0.7,1.2-1.5,1.5-2.7,2.7-3.0,20-30,3-5,3.5-4.0,5-6,8-9,[,``,apart,arrangement,center,characteristic,colour,form,height,history,inflorescence,length,life,na,number,perennial,position,prickle,rachi,reproduction,seed,smooth,spacing,staman,texture,value,width,{,}
494	wfo-0001029402	success	113	78	49	64	29	0.434	0.5-1,0.5-2,1-2.5,15-30,2,2-10,2-3,4-6,4-7,4-8,5-25,6-16,7-8,7-9,8-15,abaxial,acute,apex,articulated,base,blade,branched,chartaceous,ciliolate,cm,diameter,elliptic,flower,glabrous,long,margin,mm,narrowly,pedicel,peduncle,petiole,rachi,shrub,simple,stellate,stigma,style,surface,tapered,time,unknown,violet,wide,x	11-17,3-4,3-5,3-6,7-11,abaxially,acuminate,adaxially,apart,axe,band,calyx,color,connivent,cylindrical,deltate,denser,directed,distall,eaf,eed,fleshy,forked,free,glabrate,glabrou,hair,inrolled,lanceolate,leaving,lobe,lower,many-foliat,moderately,narrowed,nearly,nflorescence,nther,often,orolla,papillose,pore,pubescence,pubescent,rachise,radiu,roughened,ruit,scale-like,scar,somewhat,spaced,sparsely,tal,tem,thickened,tip,triangular,truncat,tube,unit,unknow,vary,ympodial	adaxial,anther,arrangement,colour,corolla,filament,form,fruit,growth,height,history,inflorescence,leaf,length,life,na,number,ovary,perennial,plant,position,reproduction,seed,shape,spacing,staman,texture,truncate,width
495	wfo-0001029404	invalid_json_followup	154	120	74	80	46	0.481	-10,0.5-1,1,1-4,2,2-3,2-8,2.5-22,20-35,3-4,5-10,5-20,5-6,6-8,abaxially,acuminate,adaxially,anther,apart,apex,articulated,base,branched,calyx,cell,center,cm,cream,darker,densely,diameter,eglandular,ellipsoidal,entire,flattened,flower,fruit,glabrous,glandular,hair,leaving,less,light,long,margin,mm,moderately,orange,ovate,ovoid,pedicel,pedicellar,peduncle,petiole,pink,puberulent,pubescent,purple,rachi,remnant,shrub,simple,star,stellate,stigma,style,subcoriaceous,toward,tree,unbranched,vein,white,x,yellow	-1.5,-3,-5,0-60-flower,1.5-2,15-25,2-4,2-5,2.5-3,3-5,3-8.5,4-foliat,5-24,6-9,6.5-34,8-12,absent,acute,aggregate,ape,apiculate,auriculate,axe,basal,beyond,blade,chartaceous,connective,connivent,cordate,cylindrical,dark,deltate,directed,distally,eaf,eed,exserted,fleshy,glandular-puberulen,green,lanceolate,lemon,lobe,lon,longitudinal,lower,mottling,narrowly,nflorescence,nther,obtuse,orang,orolla,perfect,pore,presen,radiu,ripe,ruit,shorter,slightly,small,somewhat,spaced,sparsely,stone,tal,tem,thecae,time,tomento,triangular,truncat,tube,ud,unit,vary,wide,ympodial	'',20-60,[,``,abaxial,adaxial,arrangement,bark,bud,characteristic,colour,corolla,filament,form,fruiting,growth,height,history,inflorescence,leaf,length,life,na,new,number,ovary,perennial,plant,position,prickle,reproduction,scar,seed,shape,spacing,staman,stem,surface,texture,tomentose,trichome,truncate,value,width,{,}
496	wfo-0001029406	success	136	96	62	74	34	0.456	0.5-1,0.6-1,0.7-1.5,1-10,1-2,1.5-2.2,1.5-2.5,4-6,acute,along,anther,apex,arachnoid,arachnoid-pubescent,bark,broadly,brown,brownish,calyx,clavate,cm,conical,corolla,dark,elliptic,felt-like,filament,fruiting,glabrous,globose,grayish-brown,green,greenish-white,leaf,lobed,main,margin,matted,minutely,mm,occasionally,ovary,ovoid,ovoid-reniform,pedicel,petiole,pitted,pubescent,shiny,shrub,slightly,small,stem,stigma,style,surface,tree,trichome,vein,waxy,white,woody	.5,0.3-1,1-1.5,1.5-5,2,2-11,2-3,2.5-3.5,28,3-9,30,4-18,7-12,abaxially,adaxially,anthesi,ba,base,berry,bullate,conspicuously,deciduous,deflexed,deltate,densely,dia,differing,difoliate,dry,eaf,eed,free,geminat,grayish-green,impressed,large,lateral,lenticel,lilac,lobe,lon,long,lower,major,maturity,middle,minor,nearly,often,older,pair,pale,papillo,papillose,planar,pointed,population,pore,poricidal,portion,ruit,shaped,size,soon,tall,tear-drop,tinge,tip,tube,unit,wide,widest,ympodial,young	abaxial,adaxial,alternate,arrangement,bud,cell,center,colour,diameter,flower,form,fruit,growth,height,history,inflorescence,length,life,na,new,number,peduncle,perennial,plant,position,rachi,reproduction,scar,seed,shape,spacing,staman,texture,width
497	wfo-0001029407	success	208	127	99	109	28	0.476	-6,.5,/3,0.1-0.25,0.4-0.7,0.5-0.7,0.5-1.5,0.5-2,1-1.4,1-2,1-3,1-4,2-4,3-4,3-6,5-merous,6-20,abaxial,abaxially,acute,adaxial,anther,apart,apex,apically,articulated,bark,base,berry,bright-red,calyx,cm,curved,dark,deltate,densely,diameter,dull,entire,erect,evenly,filament,flattened,flattened-reniform,flower,fruit,fruiting,glabrescent,glabrous,gray-greenish,green,green-brown,lateral,leaf,length,lobe,lobed,long,margin,maturity,mauve,mm,moderately,obtuse,occasionally,orange,orange-brown,ovate,pale,pedicel,peduncle,petiole,porrect,prickle,pubescent,rarely,rounded,scar,sessile,shrub,simple,smooth,sparsely,spherical,stalked,stellate-pubescent,stem,straw-yellow,style,surface,terete,trichome,unbranched,way,white,wide,yellow,yellow-green,young	-10,-2,-25,-4,-7,0,0-15,0-2,0-4,0-5,0.1-0.2,0.15-0.4,0.2-0.3,0.4-1,0.6,0.6-0.9,0.7-1.2,1,1-4.5,1.5,1.8-2.5,1/3,1/3-1/2,1/5,1/8-1/5,2-3,2-5,2.5-3,3.5-4.5,4-15,4-9,4.5-6,5-7,6-13,7-8,acut,almost,alyx,apar,apparently,blade,brow,chartaceous,connivent,cuneate,difoliate,discolorous,drying,eaf,eed,elliptic,elongating,equal,free,geminat,geminate,infructescence,lengt,longer,lower,mature,midpoint,nflorescence,older,one,open,orolla,oung,pair,pendulous,per,perfec,pericarp,poricidal,portion,prickl,prickly,primary,ray,recurved,reflexed,ruit,shorter,side,slender,sometimes,spaced,spreading,stalk,stellate,stout,straight,strongly,tamen,tapering,tertiary,thick,time,tip,tube,unit,upper,vary,vein,venation,visible,weakly,woody,ympodial	arrangement,brown,bud,cell,center,colour,corolla,form,growth,height,history,inflorescence,life,na,new,number,ovary,perennial,plant,position,reproduction,seed,shape,spacing,staman,stigma,texture,width
498	wfo-0001029408	invalid_json_followup	244	136	98	146	38	0.402	0.2-0.3,0.3-5,0.5-2.5,0.7-1.2,0.9-1.6,1-8,1.1-1.5,1.8-3.5,1/2-3/4,2-12,2-5,2.2-3.7,3.5-5,4-20,5-24,5-6.5,abaxially,adaxially,anther,bark,base,becoming,broadly,brown,bud,calyx,clavate,cm,conical,corolla,dark,deltoid,diameter,echinoid,elliptic,entire,filament,flower,fruit,fruiting,globose,gray,green,growth,hair,honeycombed,lanate,lateral,leaf,length,lilac,lobed,long-stalked,margin,mixed,mm,mostly,multangulate,oblong,orbicular,ovate,pale,pedicel,peduncle,perfect,persistent,petiole,plurifoliate,porrect-stellate,pseudo-terminal,purplish,rachi,rarely,reniform,reticulate-punctate,ripe,rotate-stellate,sessile,short-,short-stalked,shrub,simple,small,stem,stigma,style,suborbicular,terete,tomentose,tree,turbinate,velutinous,way,white,whitish,x,yellow,yellowish	-1.5,-10.5,-4.5,.2-3.5,/10,0,0-100,0.9-1.3,1.4-1.9,1.5-3,1.6-2.8,1.7-2.4,1/2,1/4,11-31,2-3.5,2-4,2.5-7,2/3,3-5,4-14,4-7.5,5-6,5-8,5-merou,7-12,accrescent,acuminate,acute,adaxiall,ag,alyx,anthesi,apart,apex,apical-lateral,articulated,axe,axillary,ba,barely,berry,blade,blunt-tipped,branch,branched,capitat,chartaceous,continued,cuneate,decurrent,dehiscing,dendritic-echinoi,dendritic-multangulate,densely,develope,directed,distal,distall,due,eaf,echinoi,eed,exserted,extend,faintly,few-rayed,fleshy,free,glabrous,high,homostylous,indument,inserted,interpetalar,introrse,lacking,lanceolate,large,lobe,long,long-,long-attenuate,longitudinal,lower,m.,main,many,midvein,moderately,near,nearly,nflorescence,obscured,obtuse,often,older,orolla,ovate-lanceolate,overlapping,part,partly,pore,present,pubescent,rather,ray,relatively,ribbed,ruit,runk,short-attenuate,side,slightly,slit,sometimes,spaced,stamen,stelliform,subcampanulate,subovate,suture,tamen,testa,thick,thick-stalked,thick-textured,thin-stalked,time,tissue,tomentu,tomentum,top,touching,toward,tube,unarme,unarmed,unit,usually,vary,vein,well,wide,ympodial,young	'',20-100,[,``,abaxial,adaxial,arrangement,capitate,cell,center,characteristic,colour,form,height,history,inflorescence,life,na,new,number,ovary,perennial,plant,position,prickle,reproduction,scar,seed,shape,spacing,staman,surface,texture,trichome,value,width,{,}
499	wfo-0001029417	invalid_json_followup	213	135	93	120	42	0.437	0.2-0.6,0.7-3,1-10,1-2,1.3-8,1.5-8,2.5-10,2.8-3.5,4-7,5-15,8-9,abaxially,adaxially,along,anther,apex,axillary,blue,broadly,brownish,bud,cell,chartaceous,clavate,cm,coarsely,condition,corolla,covering,dark,deep,diameter,drying,erect,especially,filament,flower,forked,fresh,fruit,glabrous,globose,green,green-white,greenish,herb,lateral,make,margin,medium,membranous,midrib,minutely,mm,moderately,mucilaginous,narrowly,non-glandular,odd-pinnate,orbicular,ovate,ovoid,pedicel,peduncle,pentagonal,petiole,pilose,plant,puberulent,pubescent,purple,rarely,ripe,rotate,seed,slightly,sometimes,stem,stigma,style,subtending,terminal,testal,thick,throughout,tinged,trichome,typically,violet,wall,wet,whitish,yellow	.5,0-7,0.4-8,1,1-1.5,1-4,1-8,1.5-1.8,1.5-10,12,2-4,3-14,3-5,5-merou,6-11,8-15,acumen,acuminate,acute,ag,alyx,apart,apiculate,apparently,articulated,attenuate,axe,base,basiscopic,berry,blade,borne,capitat,central,ciliate,connivent,decreasing,decurrent,digestion,distal,dorsally,dot,eaf,edge,eed,end,enzyme,erec,exceeding,flat,folded,geminat,generally,glabrou,greatly,hair,hair-like,hal,half,homostylous,honeycomb-shaped,interjected,lanceolate,leaflet,lengthening,like,linear,living,lobe,long,lower,lunate,minute,nflorescence,often,orolla,pair,perfect,petiolulate,plurifoliate,pore,poricidal,rapidly,removed,rounded,ruit,scattered,sessile,seudostipule,short,short-petiolulate,side,singly,size,slit,spaced,specimen,stamen,star,ste,stolo,straight,subequal,tall,tamen,tem,tip,tri-,tube,tuber,unit,unwinged,usually,vary,white,wide,widely,wing,x,ympodial	'',[,\u201chair-like\u201d,``,abaxial,adaxial,arrangement,bark,calyx,capitate,center,character,characteristic,colour,form,fruiting,growth,height,history,inflorescence,leaf,length,life,na,new,number,ovary,perennial,position,prickle,rachi,reproduction,scar,shape,spacing,staman,surface,texture,value,width,{,}
500	wfo-0001029437	invalid_json_followup	198	136	103	95	33	0.52	-10,0.5-1,1,1-2,1-3,1.5-2,10-12,2-3,2.5-3.5,3-5,3-7,4-5,7-10,abaxially,anther,apex,bark,beige,berry,blue,branched,brownish,calyx,clavate-truncate,cm,corolla,cylindrical,dark-green,densely,diameter,elliptic,elliptic-lanceolate,entire,erect,filament,flattened,flower,fruiting,glabrescent,glandular,globose,golden,green,greyish,growth,heterostylous,inflorescence,internodal,irregularly,lamina,leaf,lobed-angulate,long-styled,loose,margin,maturity,mm,new,orange,ovary,ovate,ovate-elliptic,ovoid,packed,pedicel,peduncle,persistently,petiole,plant,porrect,prickle,pubescent,recurved,reniform,reticulate,rusty,scar,sessile,short-styled,shrub,simple,spaced,stalked,stellate,stem,stigma,style,subcordate,subglobose,suborbicular,subscabrous,subscandent,surface,tomentose,trichome,unevenly,velutinous,villous,violet,visible,woody,x,yellow	.5,1-1.5,1/3,2.5-5,3-3.5,30-50,5-9,6-8,9-13,acicular,acute,adaxially,anthesi,antrorse,apar,apical,armed,articulated,axi,basal,base,brow,c.,chartaceous,compressed,cordate,coriaceous,distal,eaf,eed,eglandular,enclosed,except,free,glabrous,gland,hirsute,juvenile,leaving,lengthening,like,linear-oblong,lobe,lobed,long,lower,membranous,midpoint,minute,minutely,multangulate,multicellular,near,nearly,nflorescence,oblong,oblong-lanceolate,obverse,older,papillo,per,perfect,pericarp,plurifoliat,pore,poricidal,portion,prickly,pubescence,rest,rotate,rounded,ruit,similar,slit,sparsely,staminate,stellate-pubescent,subulate,tall,tapering,testa,thick,tip,triangular,tube,ud,unarmed,unicellular,unit,upper,whitish,without,ympodial,¼	'',[,``,abaxial,adaxial,apart,arrangement,brown,bud,center,characteristic,colour,form,fruit,height,history,length,life,na,number,perennial,position,rachi,reproduction,seed,shape,spacing,staman,texture,value,width,{,}
501	wfo-0001029440	success	218	122	96	122	26	0.44	0.3-1,0.9-1,1-1.2,1-1.5,2-2.5,2-4,2-6,4-6,4-6-forked,5-merous,6.5-8,8-10,abaxial,acicular,anther,apex,armed,articulate,bark,base,beige,brown,calyx,canaliculate,clavate,cm,cyme,dark,dark-green,deciduous,deeply,diameter,enlarged,entire,ferruginous,filament,finely,flower,free,fruit,fruiting,glabrescent,glabrous,glandular-pubescent,glandular-stellate,glandular-tipped,globose,lanate,leaf,leathery,length,long,minutely,mm,oblong-elliptic,oval-elliptic,papillose,part,parted,pedicel,peduncle,perennial,petiole,plant,porrect-stellate,prickle,reddish,reticulated,rugose,scabrous,sessile,shiny,shrub,similar,small,solitary,sparse,stalked,stellate,stellate-glandular,stem,stigma,style,sub-terete,sub-truncate,subcampanulate,subreniform,surface,terete,terminal,touch,trichome,velutinous,white,within,yellowish	-10,0.2-0.3,0.5-0.6,1,1-2,1-2-celled,1-nerved,1.5-2,2,2-3,2.5-7,20,30,4-5,4-8,5-15,5-5.5,5-6,9-10,9-12,<,>,accrescent,across,acute,adpressed,along,alyx,anthesi,ape,apical,basal,bicolorous,blade,branch,brow,caly,central,compressed,coriaceous,curved,distal,eaf,eed,elongate,enclosed,epicarp,equal,erect,exceeding,exserted,floral,functional,fused,geminat,gynoeci,held,indument,lanceolate-attenuate,leaving,lobe,lobed,longer,lower,midrib,mucilaginous,nflorescence,numerous,oblong-lanceolate,obver,older,orolla,partially,peg,perfect,persistent,petiol,plurifoliate,pore,primary,prominent,rachi,rarely,ray,recurved,reduced,reflexed,rounded,ruit,secondary,sepal,short,slender,somewhat,sparsely,stamen,staminate,stiff,straight,strigose,strongly,sub-coriaceous,subsagittate,surfac,tall,tamen,testa,tomentose,tri-,triangular,tube,unarmed,unit,upright,vary,vein,wide,without,ympodial,young,¼,¾	adaxial,arrangement,bud,cell,center,colour,corolla,form,growth,height,history,inflorescence,life,margin,na,new,ovary,recurrved,reproduction,scar,seed,shape,spacing,staman,texture,width
502	wfo-0001029461	invalid_json_followup	217	129	92	125	37	0.424	-1.5,-3,-4.5,.5,0.1,0.6-1,0.8,1-1.6,1-6,2-2.8,2-3,3-20,4.5-7,5-10,5-merous,almost,andromonoecious,anther,apex,bark,becoming,berry,black,broad-deltate,brown,calyx,cell,chartaceous,cm,curved,dark,densely,diameter,dull,elliptic,erect,evenly,filament,fine,flattened,flattened-reniform,flower,fruit,fruiting,glabrescent,glabrous,green,leaf,length,lobed,margin,maturity,mauve,mm,moderately,orange,outline,ovate,pedicel,petiole,pit,plant,porrect,prickle,raised,reddish,rounded,sessile,shiny,shrub,simple,slightly,small,smooth,sometimes,sparsely,spherical,stalked,staman,stellate,stellate-pubescent,stem,straight,style,subentire,surface,terete,trichome,weakly,yellow,young,zygomorphic	-14,-2,-3.2,-3/4,-4,-5,0,0.1-0.25,0.15-0.25,0.7-1,0.8-1.5,1-,1-2,1-3,1-4,1.2-1.7,1.2-1.8,1.3-2.2,1.5-,1.5-2,1/3,1/3-2/3,1/4,1/4-1/2,2-2.4,2-4,2.5-3,3-6,4-10,4-6.5,4-7,4.7-7.2,5-25,7-10,7-12,8-9,abaxially,acuminat,alyx,ame,apart,apically,attenuate,base,blade,breaking,brittle,c.,concolorous,cuneate,discolorous,distal,distance,drying,eaf,eed,elongating,extending,faint,fifth,four,free,gra,hermaphrodite,heterostylous,infructescence,lengt,lobe,long,long-styled,longer,lower,lowermost,mature,midpoint,midvein,oblong,obovate,obtuse,older,orolla,oung,pair,pendulous,per,pericarp,plurifoliat,poricidal,portion,prickl,prickly,primary,ray,reduced,reflexed,ruit,shallow,short-styled,shorter,side,slender,spaced,spreading,stalk,staminat,strongly,tamen,tertiary,time,tip,tube,unarme,unarmed,unequal,unit,upper,variously,vary,vein,venation,visible,way,wide,woody,ympodial	'',[,``,abaxial,adaxial,arrangement,bud,center,characteristic,colour,corolla,form,gray,growth,height,history,inflorescence,life,na,new,number,ovary,peduncle,perennial,position,rachi,reproduction,scar,seed,shape,spacing,stigma,texture,value,width,{,}
503	wfo-0001029462	success	166	124	93	73	31	0.56	-30,0.5-1,0.5-2,1,1-2,1-6,1.5-2,2-3,2-6.5,2.5-3.5,3-27,3-4,3-5,3-6,3-7,4-20,5-30,6-9,7-19,7-8,8-9,abaxially,abruptly,acuminate,acute,adaxially,apex,articulated,base,broad,calyx,campanulate,chartaceous,ciliate,cm,connective,connivent,constricted,cylindrical,dark,densely,diameter,ellipsoidal,elliptic,entire,flattened,flower,fruit,glabrous,green,hair,lanceolate,light,lobe,long,longitudinal,margin,membranaceous,minutely,mm,moderately,obtuse,occasionally,ovate,ovoid,pedicel,peduncle,perfect,petiole,puberulent,pubescent,pubescent-pilose,purplish,rachi,radiu,reticulate,simple,sparsely,stigma,stripe,style,thecae,tip,tomentose,tree,triangular,truncate,tube,unbranched,white,wide,x,yellow	-2,-4,-5,1-,1-3,1.5,1.5-3,1.5-7,10-,10-22,15-25,2.5-5.5,20-35,3,3-18,4-15,4-foliat,absent,aggregate,apart,ape,axe,basal,beyond,blade,cell,cuneate,curled,dentate,directed,eaf,eed,eglandular,equal,exceeding,exserted,laterally,leaving,lon,lower,m.,narrowly,near,nflorescence,nther,often,orolla,oval,pedicellar,pore,pubescent-pilo,purpl,remnant,rounded,ruit,shorter,slightly,small,smooth,somewhat,spaced,stamen,stellate-,stone,tal,tem,time,truncat,ud,unit,vary,without,ympodial	1-15,10-25,abaxial,adaxial,anther,arrangement,bud,colour,corolla,form,growth,height,history,inflorescence,leaf,length,life,na,number,ovary,perennial,plant,reproduction,seed,shape,spacing,stellate-campanulate,stem,surface,texture,width
504	wfo-0001029464	success	235	120	96	139	24	0.409	.9,0-80,0.2-0.5,0.2-0.7,0.5,0.5-2,0.8-2,1-10,1-3,12-50,2-3,2-3.5,2.4-4,2.5-5,3-5,4-8-merous,5.5-6,5.5-7.5,6-15,abaxial,acicular,acute,adaxial,andromonoecious,annual,anther,apart,apex,bark,black,branched,brown,calyx,chartaceous,cm,cup-shaped,curved,dark,diameter,ellipsoid,filament,flattened-reniform,flower,fruit,fruiting,glabrescent,glabrous,glaucous,globular,green,green-brown,herb,lateral,leaf,length,less,lobed,long-styled,margin,mauve,mm,moderately,mottled,oblong,orange-brown,ovate,ovoid,pedicel,peduncle,petiole,pink,plant,porrect,prickle,purple,red-brown,scar,sessile,short-styled,simple,sometimes,stalked,stellate,stellate-pubescent,stem,straight,striped,style,surface,terete,terminal,trichome,variously,white,yellow-green,yellow-orange	-2/3,-3,-30,-5,0,0-2,0.2,0.3-0.7,0.3-1,00-200,1,1-8,1.2-3,1.5-2,1/,1/4,1/4-1/2,1/4-1/3,10-15,10-23,10-40,10-50,2,2-4,2.2-2.5,2.5-8,2.9-3.2,3-20,3-7,3.5-5,4-7,4-8,5-17,5-8,7-10,8-13,8-15,9-15,abaxially,alyx,ame,apar,apically,apparently,around,articulated,base,berry,blade,broad,broad-deltate,brow,c.,connivent,cordate,cultivar,deltate,difoliate,discolorous,distal,distance,drying,eaf,eed,elongated,elongating,equal,erect,extending,free,fully,geminat,hair,hermaphrodite,heterostylous,infructescence,lobe,long,long-acuminat,longer,lower,lowermost,maroon,mature,maturity,midpoint,midvein,minute,narrow-deltate,nflorescence,obtuse,occasionally,often,older,one,open,opening,orolla,oung,pair,pendent,pendulous,per,pericarp,poricidal,portion,prickl,prickly,primary,ray,rounded,ruit,side,smooth,spaced,sparsely,spreading,stalk,staminat,tamen,tapering,tertiary,time,tip,translucent,tube,unarmed,unit,upper,usually,vary,vein,venation,visible,way,wide,woody,ympodial,young	/,arrangement,bud,cell,center,colour,corolla,form,growth,height,history,inflorescence,life,na,new,ovary,position,reproduction,seed,shape,spacing,staman,texture,width
505	wfo-0001029505	success	169	95	61	108	34	0.361	.1,0-0.3,0.5-1.1,1-6,2-7,4.5-5.5,5.5-7,6-18,7-12,8-10,acicular,adaxially,andromonoecious,anther,apex,calyx,chartaceous,cm,densely,diameter,elliptical,entire,extra-axillary,flower,fruit,fruiting,glabrous,globose,green,inflorescence,length,longer,margin,mm,obtuse,ovate,pale,pedicel,peduncle,perennial,petiole,plant,prickle,prostrate,pseudo-racemose,red,rotate-stellate,simple,solitary,stellate,stellate-pubescent,stoloniferous,straight,style,time,unbranched,weakly,white,wide,yellow,yellowish	%,.05,0-10,0-3,0-3.5,0.15-0.2,0.15-0.25,0.2-0.3,0.3-0.5,0.8-1,1-1.2,1-3,1-locular,1.5-2.2,2-4,2-5,2.4-3.2,2.7-4,22-25,5-7.5,5-merou,6-8,7-20,7-8,abaxially,absen,absent,across,adaxiall,adult,alyx,apart,articulated,axe,ba,base,blade,branche,brown,confined,cross-section,cuneateor,cylindrical,decimetre,deltate,directed,distall,eaf,eed,elliptic,elliptica,exocarp,finger,functional,gland-tipped,hair,half,heterostylous,incomplete,juicy,lamina,lateral,less,lobe,long,lower,mature,mesocarp,midpoint,midrib,midvein,minute,moderately,moist,nflorescence,oblique,onl,orolla,part,per,placenta,pore,porrect,present,ray,ruit,semi-circular,septum,sessile,short,shrub,spaced,sparsely,stellae,tal,tamen,tem,thick,throughout,transparent,tube,unarme,unarmed,unit,unknow,vary,x,ympodial	0.05,abaxial,adaxial,arrangement,bark,bud,cell,center,colour,corolla,filament,form,growth,height,history,leaf,life,na,new,number,ovary,position,reproduction,scar,seed,shape,spacing,staman,stem,stigma,surface,texture,trichome,width
506	wfo-0001029524	invalid_json_followup	212	157	120	92	37	0.566	-5,-6,-8,0.1-0.3,0.7-0.8,1-,1-1.5,1-3,1.2-1.5,2-,2-2.5,2-4,25,3-8,4-4.5,4-6,6-7,7-9,abaxially,acicular,acuminate,acute,adaxially,adult,angulate,anther,apex,bark,base,beige,berry,brown,calyx,cm,congested,corolla,corymbose,cyme,decumbent,densely,diameter,eglandular,entire,filament,flattened,flexuous,flower,fruiting,glabrous,glandular,globose,green,grey,growth,heterostylous,internodal,lanate,light,lobed,long,long-styled,margin,maturity,mixture,mm,new,oblong,oblong-lanceolate,occasionally,ovary,ovate,ovate-elliptic,ovate-lanceolate,pedicel,peduncle,petiole,plant,porrect,prickle,prickly,recurved,reniform,reticulate,rugose,rusty,scar,sessile,short-styled,shrub,slightly,spaced,sparsely,stalked,stellate,stellate-pubescent,stem,stigma,style,sub-cordate,suborbicular,subscabrous,subspherical,surface,tiny,tomentose,trichome,turbinate,unarmed,unevenly,velvety,villous,viscid,way,white,woody,x,yellow,yellow-green,yellowish,¾	.5,0.2-0.3,0.9-1.2,1-2,1.5-2,10,12-25,2-3,3-,3-3.5,4-7,5-15,6,9-10,anthesi,articulated,basal,branched,campanulate,cell,channelled,clavate-truncat,discolorous,distal,distall,doubling,eaf,eed,elongating,erec,erect,exceeding,exserted,filamentous,flowering,foliaceous,free,glabrescen,glandular-hirsute,impressed,leaving,like,linear-oblong,lobe,long-stalked,loosely,lower,m.,membranous,midpoint,minute,multicellular,nflorescence,numerous,oblique,obtuse,obverse,older,one,partially,perfect,pericarp,plurifoliat,pore,poricidal,portion,pubescence,pubescent,rounded,ruit,single,size,slit,somewhat,staminate,stellate-pilose,subbsessile,subcordate,subcoriaceous,tall,tapering,testa,time,tip,triangular-lanceolate,tube,ud,unit,upper,vein,venation,ympodial	'',[,``,abaxial,adaxial,arrangement,bud,characteristic,clavate-truncate,colour,dist,distally,form,fruit,glabrescent,height,history,inflorescence,leaf,length,life,na,number,perennial,plurifoliate,position,rachi,reproduction,seed,shape,spacing,staman,texture,value,width,{,}
507	wfo-0001029546	success	203	118	85	118	33	0.419	0.3-1,1-10,1-2,1-4.5,1.5-6.2,2.2-2.8,3-8,4-10,5-18,5-8,7-10,8-17,abaxially,adaxially,anther,apart,axillary,blue,broadly,brownish,bud,cell,clavate,cm,condition,corolla,covered,covering,densely,diameter,drying,elliptic,filament,flower,forked,fresh,fruit,glabrous,globose,green,greenish,hair,hair-like,herb,lateral,leaf,like,minutely,mm,nearly,non-glandular,odd-pinnate,orbicular,ovate,ovoid,pedicel,peduncle,pentagonal,petiole,plant,pubescent,rachi,rarely,ripe,rotate-pentagonal,seed,short,simple,slightly,soft,sometimes,stem,stigma,style,subtending,terminal,testal,thick,tinged,trichome,wall,white,whitish,x,yellow	0-2,1-3.2,1-5,1.5-2,1.6-6.5,2-4,2-9,3.5-5,4.5-12.5,4.5-7,5,5-10,5-merou,6.3-19.5,8,8-19.5,absent,acumen,acuminate,acute,adaxiall,ag,alyx,apex,apiculate,apparently,articulated,attenuate,axe,base,berry,blade,capitat,chartaceous,connivent,cordate,curved,decreasing,decumben,decurrent,digestion,distal,dorsally,dot,eaf,edge,eed,elliptical,enzyme,erect,exceeding,flat,folded,frequently,geminat,generally,glabrou,glandular,greatly,green-white,half,homostylous,honeycomb-shaped,interjected,lanceolate,leaflet,lengthening,living,lobe,long,longer,lower,lunate,make,membranous,middl,mottle,mucilaginous,nflorescence,oblique,often,pair,perfect,petiolule,plurifoliate,pore,poricidal,purple,regular,removed,ruit,sessile,seudostipule,size,slit,spaced,specimen,stamen,ste,straight,subequal,tall,tamen,tem,throughout,tip,tri-,truncate,tube,typically,unit,unwinged,usually,vary,wet,wide,wing,ympodial	abaxial,adaxial,arrangement,bark,calyx,capitate,center,colour,form,fruiting,growth,height,hermaphroditic,history,inflorescence,length,life,margin,na,new,number,ovary,perennial,position,prickle,reproduction,scar,shape,spacing,staman,surface,texture,width
508	wfo-0001029552	invalid_json_followup	161	123	84	77	39	0.522	.5,0.6-1,1-1.3,1-1.5,1-3,1-5,1.5-2,12,2.5-3,abaxial,abruptly,acuminate,acute,along,anther,apex,area,bark,base,branched,broadened,calyx,closely,cm,conical,contracted,corolla,deflexed,dendritic,densely,elliptic,erect,filament,flattened-reniform,flower,fruiting,glabrous,globose,green,incrassate,inflorescence,later,leaf,lobed,long-styled,main,margin,minutely,mm,nearly,occasionally,opposite,orbicular,ovary,pale,paler,pedicel,petiole,pitted,pubescent,scar,scattered,shape,shining,short-styled,shrub,simple,slender,small,spaced,sparsely,stem,stigma,style,surface,tan,tip,tree,tree-like,trichome,vein,white,yellowish,young	.25,0.1-0.5,0.5,1-2,1.5-6.5,10-20,2-2.5,2-9,5-10-flowered,5.5-8,6-9,abaxially,adaxially,anthesi,berry,broadly,clavate,decurrent,deltate,denser,dia,differing,difoliate,drying,eaf,edicel,eed,exserted,free,geminat,greyish-brow,heteromorphic,inflorescenc,lamina,lateral,like,lobe,lon,long,lower,major,middle,minor,minute,nflorescence,older,onto,overlappin,pair,papillo,persistent,planar,pore,poricidal,portion,present,reflexed,rest,rounded,ruit,shaped,size,slightly,somewhat,strongly,swollen,tall,tear-drop,tub,tube,ud,unit,wide,widest,woody,x,ympodial	'',5-10,[,``,adaxial,alternate,arrangement,bud,center,characteristic,colour,diameter,form,fruit,greyish-brown,growth,height,history,length,life,na,new,number,overlapping,peduncle,perennial,plant,position,prickle,rachi,reproduction,seed,spacing,staman,texture,value,width,{,}
509	wfo-0001029558	invalid_json_followup	184	126	94	90	32	0.511	.5,0.05-0.1,0.1-0.2,0.1-0.9,0.4,0.5,1-1.1,1-1.5,1-3,1.5-2,2-4,6-10,6-9,abaxially,anther,apex,bark,base,branched,calyx,capitate,closely,cm,conical,corolla,densely,diameter,divaricately,ellipsoid,entire,filament,filiform,flattened,flower,fruiting,geminate,globose,growth,inflorescence,interlocking,internodal,later,leaf,like,lobed,margin,mere,minutely,mixture,mm,narrowly,nearly,new,obovate,obspathulate,obtuse,ovary,overlapping,pale,pedicel,peduncle,petiole,pitted,porrect,prickle,prickly,pubescent,ray,red,reddish,reniform,rhombic,rounded,scar,sessile,shape,shiny,short-stalked,shrub,simple,spaced,sparsely,stellate,stem,stigma,straight,style,surface,tan,thin,trichome,white,widening,x	0.1-,0.15-0.2,0.2-,0.3-0.5,0.4-0.6,0.4-1.1,0.5-2,1,1-4,10-16,2,2-3,2.5-3.5,4-merous,<,?,acute,adaxially,along,anthesi,armed,articulated,bearing,berry,cell,deflexe,difoliate,eaf,easily,eed,elliptic,elongate,enclosed,equal,erect,free,geminat,glabrescent,glabrous,gre,highly,hyaline,including,larger,leave,lengthening,lobe,long,long-triangular,lower,midpoint,midvein,nflorescence,node,occasionally,older,pair,paired,papillo,per,perfect,pericarp,planar,pore,poricidal,portion,primary,rest,rhachi,ruit,shorter,sinus,size,slit,small,square,stalked,tapering,testal,tiny,tip,tube,ud,unit,upper,usually,vein,visible,wall,ympodial	'',[,``,abaxial,adaxial,arrangement,bud,center,characteristic,colour,form,fruit,grey,height,history,length,life,na,number,perennial,plant,position,rachi,reproduction,seed,spacing,staman,texture,value,width,{,}
510	wfo-0001029569	success	265	94	53	212	41	0.2	130,2,3.2,8.1,abaxially,acuminate,adaxially,anther,apex,bark,bud,calyx,chartaceous,cm,corolla,densely,diameter,dry,elliptic,entire,evenly,filament,flattened-reniform,flower,fruit,glabrous,globose,lateral,length,margin,mature,mm,orange,ovate,pedicel,peduncle,petiole,pubescent,red,reticulate,shrub,simple,sinuate,stellate,stellate-pubescent,stem,stigma,straight,style,surface,white,yellow,yellow-tan	.0,.2,.3,.4,.9,/2,/3,0.03,0.05,0.1,0.2,0.2–0.5,0.3–0.5,0.4–0.6,0.5–0.8,0.6–0.8,0.6–0.9,0.7–0.9,0.8–1.0,0.9,0.9–1.3,0.9–1.4,0.9–2.0,1.0–1.3,1.3–1.8,1.4–2.4,1.5–1.7,1.6,1.6–4.5,1.7–2.3,1.8–2.5,1/2–2/3,1/3,14.6–16.5,2.0–3.2,2.3–3.0,2.3–4.4,3.2–3.8,3.4–3.7,4.0,4.5,4.9,4–6,5-merou,5.0,5.1,5.3–16.6,5.7–6.6,6.3–18.5,6.8–7.8,6–12,6–8,7.4–9.1,7–10,90°,across,adnate,aequilateral,ag,along,alyx,anthesi,apart,apical,apiculate,apparently,appearing,around,articulate,attenuate,axe,ba,basal,base,becoming,berry,blade,branch,branching,broad,brochidodromous,capitat,channeled,clinate,cuneate,deciduous,dentate,development,difoliate,directed,distal,distally,distinct,eaf,edge,eed,either,emerging,endocarp,exocarp,extending,extra-axillary,fertile,filiform,flexed,free,geminat,glandular,glossy,gradually,hair,homostylous,increasing,intact,internode,interpetalar,intersepalar,juic,lacking,lamina,layer,less,light,lobe,lon,long,longer,lower,many,middle,midpoint,midrib,midvein,minute,moderately,nearly,nflorescence,oblique,oblong,orolla,ove,per,perforated,pore,porrect,porrect-stellate,portion,potentially,probably,raised,ray,reduced,reflexe,remaining,restricted,rigid,rounded,row,ruit,scarcely,sessile,short,short-stipitate,shorter,side,sinus,sloughing,smoot,spaced,sparsely,splitting,spread,spreading,stamen,stellae,stipe,stipitate,suture,tamen,tardily,tem,terete,thin,time,tip,tissue,toward,translucent,transparent,triangular,truncate,tube,two,ud,unarmed,unit,upper,various,vary,vein,weakly,well,well-developed,wide,yellow-ferruginous,ympodial,young,±90°,±equal,±glabrous,±well,×	0.9-1.3,0.9-1.4,0.9-2.0,1.0-1.3,1.5-1.7,14.6-16.5,3.2-3.8,5.7-6.6,6.3-18.5,abaxial,adaxial,arrangement,capitate,center,colour,form,fruiting,growth,height,history,inflorescence,leaf,life,na,new,number,ovary,perennial,plant,position,prickle,rachi,reproduction,scar,seed,shape,spacing,staman,texture,trichome,width
511	wfo-0001029584	invalid_json_followup	180	127	84	96	43	0.467	1,1-2,1-6,1.5-6.5,2-3,3-10,3-5,4-15,4.5-11.5,6-7,8-15,abaxially,acuminate,acute,adaxially,anther,apart,apex,articulated,axillary,brownish,bud,cell,clavate,cm,condition,coriaceous,corolla,covering,dark,densely,diameter,drying,elliptic,filament,flower,forked,fresh,fruit,glabrescent,glabrous,green,green-white,greenish,hair,half,herb,lateral,leaf,light,make,margin,middle,mm,mucilaginous,odd-pinnate,ovate,ovoid,pedicel,peduncle,pentagonal,petiole,plant,proximal,pubescent,purple,seed,short,simple,stigma,style,substellate,subtending,tall,terminal,testal,thick,throughout,usually,wall,wet,white,whitish,yellow	0-30,1-3,16.2-33,2-4,2.4-6.3,3-7,4-14,4-5,5-merou,5.3-13.3,6.1-9.4,7-14,9.7-23.4,9.8-17,acumen,ag,alyx,apparently,asymmetric,attenuate,axe,base,basiscopic,blade,borne,capitat,connivent,considerably,decreasing,dense,digestion,distal,dorsally,eaf,edge,eed,end,enzyme,erry,finer,flat,folded,geminat,generally,hair-like,hal,homostylous,honeycomb-shaped,interjected,larger,leaflet,lengthening,linear,living,lobe,long,lower,nflorescence,oblong-lanceolate,orbicular,orolla,pair,perfect,petiolulate,plurifoliate,pore,poricidal,present,removed,second,semi-erec,sessile,seudostipule,side,singly,size,slit,spaced,specimen,stolo,straight,tamen,tem,tip,tissue,toward,tri-,tube,tuber,typically,unit,unknow,unwinged,vary,x,ympodial	'',[,\u201chair-like\u201d,``,abaxial,adaxial,arrangement,bark,calyx,capitate,center,characteristic,colour,form,fruiting,growth,height,history,inflorescence,length,life,na,new,number,ovary,perennial,position,prickle,rachi,reproduction,scar,shape,spacing,staman,stem,surface,texture,trichome,unknown,value,width,{,}
512	wfo-0001029592	success	207	101	68	139	33	0.329	0.5-1.5,0.5-1.8,1-10,1-3,1.1-2.8,2-3-branched,2.1-4,3-6,3.5-5.5,6.5-8.5,7-10,7-25,8-10,acicular,acute,adaxially,anther,apart,apex,attenuate,black,brown,calyx,chartaceous,cm,deltate,densely,diameter,entire,erect,extra-axillary,flower,fruit,fruiting,glabrous,globose,green,hemispherical,homostylous,inflorescence,leaf,length,lobed,margin,mm,moderately,ovate,pedicel,peduncle,perennial,petiole,porrect,prickle,purple,rhizomatous,ridged,shallowly,shrub,simple,stellate,stellate-pubescent,straight,style,surface,terete,unbranched,white,yellow	%,.05,.4,0,0-0.1,0-0.15,0-0.3,0-3.5,0.1-0.2,0.25-0.5,0.25-0.7,0.3-0.6,0.4-0.7,0.5-0.8,0.5-1,0.8-0.9,0.8-1.2,0.8-1.5,1-1.5,1-1.9,1-8,1-locular,1.5,1.5-3,1.8-2.4,1.8-6.5,1.8-8,14-20,18-30,2-10,2-3.5,2-foliate,240-1400,3-4,4-8,5-8,5-merou,5.5-10.5,5.5-11.5,6-8,7-17,7-9,8,8-20,abaxially,absent,across,adaxiall,adult,alyx,apparen,apparently,armed,articulated,axe,ba,base,blade,branch,branche,cordate,decimetre,deeply,depression,directed,distall,distally,distributed,dm,eaf,eed,eglandular,exocarp,finger,geminat,gland-tipped,hair,half,incomplete,index,juicy,juvenile,lamina,lateral,less,lobe,lobing,long,longer,lower,markedly,mature,mesocarp,mid-point,midpoint,midvein,minute,nflorescence,oblique,obtuse,orolla,pair,part,per,perfect,placenta,pore,presen,present,ray,ruit,septum,sessile,short,side,spaced,sparse,sparsely,stalk,stellae,succulent,tal,tamen,tem,thick,thicker,thicknes,throughout,time,transparent,tube,unarme,unit,upper,vary,vein,wide,x,ympodial	5-merous,abaxial,adaxial,arrangement,bark,bud,cell,center,colour,corolla,filament,form,growth,height,history,life,na,new,number,ovary,plant,position,reproduction,scar,seed,shape,spacing,staman,stem,stigma,texture,trichome,width
513	wfo-0001029593	invalid_json_followup	181	99	61	120	38	0.337	0.5-1,0.5-5,1,1-1.5,1-2,3-4,4-6,5-10,5-15,acuminate,acute,anther,apex,axillary,broadly,brown,calyx,capitate,cell,cm,conical,densely,diameter,elliptic,filament,filiform,flower,fruit,fruiting,glabrous,globose,green,irregular,lamina,leaf,mm,obovate,ovary,ovoid-reniform,pedicel,petiole,pinnate,plant,pubescent,rachi,scar,seed,shape,shrub,simple,sinuous,slightly,smooth,sparsely,stigma,style,surface,trichome,uniseriate,vein,woody	-10,0.05,0.8-1,0.8-1.2,1-1.2,1-8,1.6-2.3,10-50,100,2,2-14,2-3,2-5,2.3,2.3-3.0,3.5-8,35-60,7-25,7.5-15,9-15,abaxially,abruptly,adaxially,age,always,anthesi,anticlinal,apically,arising,attenuate,axil,basal,base,basiscopically,bearing,berry,cateniform,clavat,colony,cone,decurrent,deltate,dry,drying,eaf,edicel,eed,enlarged,entire,epidermal,exserted,extremely,free,glabrescent,growing,half,hollow,included,large,lateral,leaflet,lobe,long,lower,markedly,minutely,much,narrowing,nflorescence,noddin,oblique,occasionally,often,once-branched,onto,open,opposite,pair,papillose,per,perfectly,petiolule,place,pointed,poricidal,portion,primary,projection,pubescen,pubescence,purple,rarely,reflecting,rest,ruit,short-styled,similar,single-stemmed,small,smaller,somewhat,tall,tem,terminal,thickening,tip,tub,tube,ud,unifoliat,unit,usually,variable,white,white-lenticellate,wider,winged,without,x,ympodial	'',[,``,abaxial,adaxial,arrangement,bark,bud,center,characteristic,clavate,colour,corolla,form,growth,height,history,inflorescence,length,life,margin,na,new,nodding,number,peduncle,perennial,position,prickle,reproduction,spacing,staman,stem,texture,value,width,{,}
514	wfo-0001029601	success	187	119	90	97	29	0.481	0-37,0.2-0.8,0.5-5.8,1-2,1-3,1-53,2-12,2-7,2.3-5.9,3-10,3-5,5-41,6-10,6.8-14.5,abaxially,adaxially,anther,articulated,axillary,base,brownish,bud,cell,clavate,cm,condition,coriaceous,corolla,covering,dark,decreasing,diameter,dot,drying,elliptic,filament,flower,forked,fresh,fruit,glabrous,globose,green,green-white,greenish,hair-like,herb,interjected,larger,lateral,leaf,leaflet,light,make,middle,mm,mucilaginous,odd-pinnate,orbicular,ovate,ovoid,pair,pedicel,peduncle,pentagonal,petiole,plant,puberulent,ripe,rotate,seed,sessile,size,slightly,small,stigma,style,subequal,subtending,terminal,testal,thick,throughout,toward,usually,wall,wet,white,whitish,yellow	0.5-8,1-4,1.1-2.7,1.2-2.3,1.7-6.5,2,2-3,2-9,2.2-4.5,2.8-10.5,3-7,4-13.5,5-merou,6.6-22,abaxiall,acumen,acuminate,acute,ag,alyx,apart,apex,apparently,asymmetric,attenuate,axe,basiscopic,berry,blade,borne,capitat,connivent,digestion,distal,dorsally,eaf,edge,eed,end,enzyme,erec,exceeding,flat,folded,geminat,generally,glabrescent,glabrou,hair,half,homostylous,honeycomb-shaped,lanceolate,lengthening,linear,living,lobe,long,lower,middl,narrow,nflorescence,orolla,perfect,petiolulate,plurifoliate,pore,poricidal,removed,rounded,ruit,seudostipule,short,side,singly,slit,spaced,specimen,stamen,stolo,straight,subglabrou,tall,tamen,tem,tip,tissue,tri-,tube,tuber,typically,unit,unwinged,vary,wing,x,ympodial	abaxial,adaxial,arrangement,capitate,center,colour,form,growth,height,herbaceous,history,inflorescence,length,life,na,number,ovary,perennial,position,pseudostipule,reproduction,scar,shape,spacing,staman,subglabrous,surface,texture,width
515	wfo-0001029606	invalid_json_followup	179	114	79	100	35	0.441	.5,0.2-0.5,0.4-0.5,0.5-1,1,1.5-2,15,2-2.5,3,4.5-5,7-9,abaxially,acute,adaxially,anther,apex,bark,berry,bilobed,broadly,brown,brownish,calyx,cell,closely,cm,coriaceous,corolla,densely,diameter,ellipsoidal,elliptic,entire,filament,flattened,flower,form,fruiting,glabrous,globose,growth,inflorescence,internodal,leaf,lobed,long-styled,margin,minutely,mm,multangulate,narrowly,new,oblong,once-branched,orbicular,pedicel,peduncle,petiole,prickle,pubescent,reddish,reniform,revolute,scar,shiny,shrub,simple,stellate,stem,stigma,straight,style,surface,terminal,thin,trichome,white,woody,x	/2,0.5,1.5-3,1.5-3.5,1.8-2.5,2-3,3-9,4-5,4-6,4-8,5,5-6,7,aciculate,acuminate,along,anthesi,apparently,arching,armed,articulated,base,beneath,color,deciduous,defoliate,dense,eaf,eed,elongate,elongation,equalling,erect,especially,exerted,free,geminat,gre,herbarium,heterostylous,impressed,inshort-styled,known,lengthening,like,lobe,long,long-stalked,lower,m.,many,marginal,midpoint,midrib,mixture,multiseriate,nflorescence,nodding,older,pair,papillat,per,pericarp,pore,poricidal,porrect,portion,primary,prominent,pubescence,ray,red,redder,ruit,rusty,sessile,slightly,slit,sometimes,soon,space,specimen,stalk,stalked,stellate-pubescent,straggling,strongly,tapering,testal,tip,triangular,tube,ud,unit,urceolate,usually,vein,way,yellowish,ympodial	'',[,``,abaxial,adaxial,arrangement,bud,center,characteristic,colour,fruit,grey,height,history,length,life,na,number,ovary,perennial,plant,position,rachi,reproduction,seed,shape,short-styled,spaced,spacing,staman,texture,value,width,{,}
516	wfo-0001029619	invalid_json_followup	188	125	88	100	37	0.468	0.25-0.75,0.5-1.5,0.5-2,1-2,1-2.5,1-3,1-3.5,1.5-2,10-12,2-3,3-4,3-8,4-6,5-20,6,7,abaxially,acute,anther,apart,apex,base,brown,bud,calyx,cm,dark,densely,diameter,extra-axillary,filament,flower,fruit,fruiting,geminate,glabrous,globose,green,hair,immature,leaf,leaf-opposed,length,like,lobe,lobed,many,margin,mature,mm,moderately,nearly,netlike,obtuse,orange,ovate,pedicel,peduncle,per,petiole,pit,porrect-stellate,prickle,pubescent,rachi,raised,reniform,ridge,roselike,rusty,scandent,separated,shrub,side,small,stellate,stem,stigma,style,surface,tan,triangular,unbranched,unlobed,white,whitish,x,yellow	0.5-1,1,1-.,1-1.5,1-5,2,2-11,2-5,25-40,5-merou,6-10,6-8,7-10,7-12,8-12,absent,accrescent,adaxiall,adaxially,alyx,andromonoecy,apar,apical,apparently,appearing,armed,attenuate,axe,berry,beyond,blade,chartaceous,clavat,connivent,contiguous,cordate,cut,cylindrical,difoliate,directed,discolorous,eaf,eed,either,elongated,em,exserted,flattedned,frui,glabrou,gland-tipped,glandular,implying,introrsel,less,long,lower,m.,major,midpoint,midrib,midvein,multicellular,multiseriate,narrowly,nflorescence,occasionally,often,orolla,pair,perfect,pore,ray,recurved,reduced,ruit,simple,sinus,slightly,spaced,sparse,sparsely,spreading,stalk,stamen,ste,tamen,tapering,tube,unarmed,unequa,unicellular,unit,usually,vary,vein,way,wide,ympodial,¼	'',5-merous,[,``,abaxial,adaxial,arrangement,bark,center,characteristic,clavate,colour,corolla,form,growth,height,history,inflorescence,life,na,new,number,ovary,plant,position,reproduction,scar,seed,shape,spacing,staman,texture,trichome,value,width,{,}
517	wfo-0001029621	invalid_json_followup	165	115	73	92	42	0.442	.1,0.5-0.75,0.5-1.5,0.7-1.1,0.8-4.5,1-1.5,1.5-2,1.5-5,3.5-4.5,6-20,7-9,accrescent,acute,anther,apex,appressed,area,bark,becoming,brown,calyx,cm,corolla,dark,dry,ellipsoid,filament,fleshy,fruit,fruiting,glabrous,globose,green,irregularly,lanceolate,later,lateral,leaf,live,lobed,long,margin,material,merely,minutely,mm,oblanceolate,ovary,ovoid-reniform,pale,papillate,pedicel,pitted,plant,scar,shrub,spaced,stem,stigma,style,surface,tan,tapering,terminal,trichome,uniseriate,white,whorl-like,widened,woody,x,yellow,yellowish	0.5-1,0.5-1.2,0.8-1,1-2,1.5-2.5,1/3,2.5-3,2/3,3-3.5,5-20-flowered,6-8,along,anthesi,apar,appearing,attenuate,base,beneath,berry,borne,branched,caudate,cluster,completely,constricted,course,cup-shaped,decurrent,deltoid,densely,dia,distal,eaf,edicel,eed,elongate,enclosed,erect,exsertio,free,geminate,glabrate,late,like,lobe,lon,lower,main,many,middle,nflorescence,occasionally,often,older,onto,pair,papillo,papillose,planar,plurifoliat,pore,poricidal,portion,prominent,puberulent,quite,rarely,reddish,reddish-gre,ripe,river,ruit,sessile,shaped,shiny,small,somewhat,ste,straight,tall,tear-drop,thick,time,tip,tube,ud,unit,vein,way,widest,ympodial,young	'',5-20,[,``,abaxial,adaxial,apart,arrangement,bud,cell,center,characteristic,colour,diameter,flower,form,growth,height,history,inflorescence,length,life,na,new,number,peduncle,perennial,petiole,position,prickle,rachi,reddish-grey,reproduction,seed,shape,spacing,staman,texture,value,width,{,}
518	wfo-0001029622	invalid_json_followup	182	111	75	107	36	0.412	.1,.5,0.5-1,0.8-1,1.5,2.5-3,3-4,30-35,4-6.5,abaxially,acute,adaxially,anther,apex,axil,bark,base,brown,bud,calyx,chartaceous,cm,corolla,deflexed,diameter,elliptic,entire,filament,flower,fruit,fruiting,glabrous,globose,green,inflorescence,interlaced,internodal,leaf,lobed,long-acuminate,long-triangular,margin,mm,narrowly,occasionally,opposite,ovate,pedicel,peduncle,petiole,rachi,reddish,rounded,scar,shiny,shrub,simple,single,slender,somewhat,stellate,stem,stigma,style,tapering,thin,tip,trichome,tube,tuft,uniseriate,vein,white,x,yellow	.2,/3,0.3,0.5,0.5-0.7,0.6-0.9,1-1.2,1-1.5,1-2.7,1-4,2-11,2-4,2-5,3-5,40,45-50,5-6,7-11,absent,accrescent,ag,alyx,anthesi,apparently,appearing,arising,attenuate,axe,beneath,blade,capitat,connivent,consisting,cylindrical,deciduous,differing,difoliate,dimorphic,eaf,eed,elongate,except,free,geminate,glabrou,ilament,immature,included,jointed,known,lamina,lateral,less,lobe,long,longitudinal,m.,main,major,mature,measured,midrib,minor,minute,minutely,nflorescence,obconic,oblong,often,older,one,onto,opening,orolla,oung,ovate-lanceolate,pair,papillose,pendent,pore,portion,present,probably,raised,reflexed,remaining,ruit,sagittate,second,shaped,size,slende,slightly,slit,straight,tal,tear-drop,thus,ud,unarme,unifoliat,unit,vary,way,within,ympodial,young	'',1,[,``,abaxial,adaxial,arrangement,capitate,center,characteristic,colour,form,growth,height,history,length,life,na,new,number,ovary,perennial,plant,position,prickle,reproduction,seed,shape,spacing,staman,surface,texture,value,width,{,}
519	wfo-0001029625	invalid_json_followup	168	97	60	108	37	0.357	..,0.5-1.3,1-1.5,1-2,1.2-1.6,3-,3-3.5,4-4,4-9,5,5-6,5-8,abaxial,anther,bark,calyx,cell,cm,conical,corolla,darker,diameter,elliptic,filament,flattened,flower,four,fruit,fruiting,globose,green,greenish,growth,herb,inflorescence,lobed,long,margin,mm,new,ovary,ovate-reniform,pale,papillate,pedicel,peduncle,pointed,pubescent,reddish,scar,smooth,stem,stigma,stripe,style,surface,tan,trichome,uniseriate,white	-15,.1-0.2,.5,0.5-1,0.5-2,0.5-2mm,0.8-1.4,0.8-1.8,1-3,100,2,2.5-.,3,3-3,4-10,4-5-celled,4-7-celled,5-10,6-9,8-13,9-25,along,anthesi,apical,base,beneath,branc,branch,branched,brittle,brow,capitat,cel,cucullate,deflexe,deflexed,deltate,densely,denser,distinct,dry,eaf,edicel,eed,erect,frui,glabrescent,glabrous,gland,gland-tipped,glandular,hyaline,lamina,later,lighter,like,lobe,lower,markedly,middle,midline,minute,mixed,narrowly,nearly,nflorescence,occasionally,open,outer,outline,pair,per,pericarp,planar,plurifoliat,point,primary,purplish,rarely,regularly,ruit,scattered,shrub,single,single-stemmed,sinuate,slightly,small,sparsely,striate,strongly,testa,thin,time,tinged,tip,triangular,tube,tuft,ud,unit,vein,wall,weight,without,x,ympodial,young	'',[,``,adaxial,apex,arrangement,brown,bud,capitate,center,characteristic,colour,form,height,history,leaf,length,life,na,number,perennial,petiole,plant,plurifoliate,position,prickle,rachi,reproduction,seed,shape,spacing,staman,texture,value,width,{,}
520	wfo-0001029630	invalid_json_followup	286	134	101	185	33	0.353	0-5,0.5-1.5,0.5-4.5,0.6-0.8,1-3,1.5-2,1/3,12-17,2.5-3,3.5-5,5,5-9,6-8,7-10,abaxial,acuminate,acute,almost,anther,apart,apex,apparently,armed,bark,berry,branched,calyx,capitate,cell,clavate,climber,cm,corolla,cupular,dark,deltoid,densely,diameter,distance,distributed,drying,ellpsoid,entire,evenly,filament,flattened,flattened-reniform,flower,fruit,fruiting,glabrous,glaucous,globose,green-brown,grey-brown,leaf,length,lobed,margin,maturity,mauve,midvein,mm,orange,orange-brown,outline,ovate,ovoid,pale,pedicel,peduncle,petiole,pit,porrect,prickle,purple,rachi,raised,red-brown,scar,shiny,small,smooth,somewhat,stellate,stellate-pubescent,stem,stigma,stump,style,suborbicular,surface,terete,terminal,trichome,weakly,white,white-translucent,yellow,yellow-brown,yellow-green	.1,.15,.5,.7,.8,/2,/6,0,0-10,0-8,0.1-0.2,0.15-0.3,0.2-0.3,0.2-0.4,0.2-0.7,0.3-0.5,0.4,0.5,0.5-1,0.5-2,1,1.2-1.5,1.5-4,1/3-1/5,1/3-2/3,10-30,12-15,2-6,2.5,2.5-6,3-10,4-5,4-8,45-60°,5-20,5-merou,8,8-9,abaxially,accrescent,across,adaxially,age,along,always,alyx,apar,apically,area,articulated,ascendant,attachment,base,beyond,blade,brachyblast,branch,broadly,brown,chartaceous,clearly,coroll,cuneate,curved,delineated,development,difoliate,discolorous,divided,downward,dull-yellow,eaf,eed,elliptic,elongating,equal,exserted,extending,eye,fertile,finely,flat,free,geminat,glabrescent,greyi,hooked,infructescence,irregula,lateral,lengthening,less,lighter,like,lobe,lon,long,longer,longitudinal,lower,main,mature,midpoint,mostly,naked,narrow-ovate,nflorescence,oblique,often,orolla,pair,papillo,papillose,patchily,pendulous,per,perfect,pericarp,point,pore,poricidal,portion,primary,prominently,ray,recurved,reduced,reflexe,relatively,rest,robust,rounded,ruit,secondary,shorter,side,simple,sinus,slender,slit,sometimes,spaced,sparsely,species,spherical,spreading,stalk,stalked,stout,straight,strong,strongly,sunk,tamen,tapering,tertiary,thicker,thin,throughout,time,tip,toward,translucent,tube,ud,undulate,unequal,unequal-deltoid,uniform,unit,usually,variously,vary,vein,venation,visibl,visible,visibly,wide,widest,woody,yellow-translucent,ympodial,young,×	'',.2-0.3,.2-0.4,.3-0.5,5-merous,[,``,adaxial,arrangement,bud,center,characteristic,colour,form,greyish,growth,height,inflorescence,na,new,ovary,plant,position,reproduction,seed,shape,spacing,staman,texture,value,width,{,}
521	wfo-0001029632	invalid_json_followup	202	132	71	131	61	0.351	.5,0.2,0.5,abaxial,abaxially,acute,along,anther,anthesi,apart,apex,arising,articulated,associated,base,black,branching,brown,calyx,clavate,cm,dark,deeply,densely,diameter,elliptic,filament,flattened,flower,fruit,glabrous,globose,green,hair,herb,leaf,like,lilac,lobed,margin,midrib,midway,mm,multicellular,ovate,pale,pedicel,peduncle,pentagonal,perennial,petiole,pitted,pubescent,purple,simple,slender,sometimes,sparsely,stigma,style,subentire,surface,unbranched,unicellular,uniseriate,vein,violet,white,whitish,x,yellow	.0,0.3–2.0,0.4–1.0,0.5–0.7,0.5–1.4,0.6–1.1,0.7,0.8–,0.8–1.0,0.8–1.5,0.8–2.2,0.9,0–1.5,1,1.0–1.5,1.0–2.0,1.0–3.5,1.0–6.0,1.1–,1.2,1.2–1.4,1.2–2.5,1.5–,1.5–2.6,1.7–8.5,10–30,11–25,2,2.0–11.5,2.0–2.2,2.7–3.5,2–3,3.5–5.0,3–8,4.5–6.0,4–8,5,5.5–9.5,5–10,6–13,7.5–13,75,absent,adaxiall,adaxially,ag,angular,appressed,axe,ba,blade,caudex,cell,chartaceous,connivent,cylindrical,decurrent,eaf,eed,elongate,equal,especially,geminat,indistinct,lamin,lobe,lon,long,longitudinal,lower,m.,marking,midvein,moderately,nflorescence,oblong,obtuse,occasionally,often,opening,orolla,pair,particularly,perfect,pore,poricidal,present,prostrate,purplish,rapidly,rarely,ruit,scandent,semi-succulent,shaped,side,slit,spaced,spheroidal,stone,straight,subterranean,succulent,swollen,tall,tamen,tear-drop,tem,time,tip,tube,unifoliate,unit,vary,wide,wing,ympodial,–1.4,–10,–11.0,–11.5,–13.5,–15,–19.0,–2.0,–2.2,–4.0,–4.5,–40,–5.2,–50	'',-10,-11.5,-15,-19.0,-2.0,-4.5,-5.2,-50,0-1.5,0.5-1.4,1.0-1.5,1.5-,1.5-2.6,10-30,11-25,2.0-11.5,2.7-3.5,3-8,4-8,5-10,[,``,adaxial,arrangement,bark,bud,characteristic,colour,corolla,form,fruiting,growth,height,history,inflorescence,lamina,length,life,na,new,number,ovary,particular,plant,position,prickle,rachi,reproduction,scar,seed,shape,spacing,staman,stem,texture,trichome,value,width,{,}
522	wfo-0001029645	invalid_json_followup	160	111	68	92	43	0.425	0.2-0.5,0.3-0.5,0.5-2.5,0.5-7,1-1.5,1-4,2.5-4,3-10,3-15,3-7,3.5-4,337,750,acuminate,anther,apex,base,blue,brown,calyx,cell,chartaceous,cm,corolla,diameter,entire,et,extra-axillary,fide,filament,flattened,flower,fruit,glabrous,globose,green,greenish,herb,kayap,line,margin,membranaceous,minutely,mm,ovate,ovate-elliptic,pedicel,peduncle,petiole,puberulent,purple,rachi,red,rotate-stellate,rugose-verrucate,simple,smith,sparsely,stigma,style,triangular,truncate,unbranched,white,wide,x,yellow,±	-1,.5-1,1,1-2,1.3-7,1.5,1.5-2,2-3-foliat,2-4,2.5-17,4-5,4-8,5,5-8,6-12,7-12,?,abaxially,abundantly,acute,adaxially,aggregate,along,apart,around,articulated,axe,ba,blade,connivent,cuneate,cylindrical,decurrent,deltate,directed,distall,distally,eaf,eed,except,finger,free,glabrou,gland-tipped,hair,immature,inserted,knapp,lobe,long,lower,major,mesocarp,moderately,nearly,nflorescence,obtuse,orolla,part,perfect,pore,puberulen,radiu,rarely,ruit,sagittate,sand-punctate,short,short-tomentose,shorter,shru,side,small,spaced,stone,strongly,subcordate,tal,tamen,tapered,tem,thecae,tightly,time,tomento,truncat,tube,unit,vary,vein,veiny,ympodial	'',0.5-1,[,``,abaxial,adaxial,arrangement,bark,bud,center,characteristic,colour,form,fruiting,growth,height,history,inflorescence,leaf,length,life,na,new,number,ovary,plant,position,prickle,reproduction,scar,seed,shape,shrub,spacing,staman,stem,surface,texture,trichome,value,width,{,}
523	wfo-0001029646	success	141	88	61	80	27	0.433	0.1-0.6,0.7-2.2,1-4,1.5-2,10-15,4-5.5,6-8,7-15,acuminate,acute,apex,articulate,branched,cell,cm,corolla,covering,cyme,diameter,dichasial,dichasially,distal,ebracteate,elliptic,filament,finely,flower,globose,green,green-white,hair-like,half,herbaceous,lateral,leaf,mm,monochasial,narrowly,ovate,ovoid,pedicel,peduncle,perennial,petiole,plant,proximal,pubescent,seed,simple,stellate,stigma,style,testal,thick,throughout,tone,wall,white,yellow,yellow-green,¼	0.5,0.5-0.8,1.5-4.9,2-3,3-14,3-6-foliat,5-15,abaxially,acumen,adaxially,apical,apically,attenuate,base,calyx,commonly,dehiscent,digestion,dorsally,eaf,edge,eed,emoval,enzyme,epiphytic,equaling,flat,folded,forked,free,generally,globo,ground,growing,honeycomb,introrse,linear,living,lobe,lon,long,lower,make,maturing,mos,mould,mucilaginous,mucronate,nflorescence,nther,oak,often,orolla,ovat,pattern,perfect,pine,plan,poricidally,rarely,reveal,ruit,seudostipule,short,slit,specimen,stamen,straight,tall,tem,throughou,tree,tuber-bearing,typically,unit,vary,viole,wide,without,ympodial	abaxial,adaxial,anther,arrangement,center,colour,form,fruit,growth,height,history,inflorescence,length,life,na,number,ovary,position,rachi,reproduction,shape,spacing,staman,surface,texture,violet,width
524	wfo-0001029652	invalid_json_followup	160	112	73	87	39	0.456	.5,0.5-4,0.75-1,0.8-1,1,1-3,1.5-2,2,2.5-3,3/4,4-4.5,abaxially,adaxially,along,anther,apex,arching,bark,base,calyx,cm,corolla,curling,deflexed,elliptic-ovate,filament,filiform,flower,fruiting,glabrous,globose,golden,green,greenish-white,hard,leaf,lobed,long-acuminate,long-styled,margin,maturity,minutely,mm,narrowly,occasionally,opposite,ovary,ovoid-reniform,pale,papillose,pedicel,petiole,pitted,pubescent,reddish-brown,scar,short-styled,shrub,simple,slender,stem,stigma,style,surface,tan,tip,trichome,undulate,uniseriate,vein,way,white,x	.25,.3,0.5-1,1-2,2-2.5,2-4,25,3.5-4,6-15,7-9,anthesi,apar,ape,apical,arch,attenuate,ba,bearing,berry,broadly,cone,conical,deciduous,deltate,denser,dia,differing,difoliate,drying,eaf,edicel,eed,evenly,exserted,free,geminat,golden-red,heteromorphic,hispid,included,joining,lamina,lateral,like,lobe,lon,long,lower,main,major,middle,midrib,minor,minute,near,nflorescence,older,pair,papillo,pericarp,pore,poricidal,portion,projection,reflexed,ruit,series,shaped,size,slende,slightly,soon,spaced,sparsely,swollen,tall,tear-drop,thickened,time,tub,tube,ud,unit,widest,within,ympodial,young	'',[,``,abaxial,adaxial,apart,arrangement,bud,center,characteristic,colour,diameter,form,fruit,growth,height,history,inflorescence,length,life,na,new,number,peduncle,perennial,plant,position,prickle,rachi,reproduction,seed,shape,spacing,staman,texture,value,width,{,}
525	wfo-0001029662	success	181	97	66	115	31	0.365	.3,.5,0.5,1,15,20,2–3-celled,4-rayed,5-6,7-14,abaxially,acicular,adaxially,andromonecious,anther,apart,chartaceous,cm,diameter,extra-axillary,filament,flower,fruit,glabrous,hair,half,herb,leaf,like,lobed,mm,nearly,oblong-ovoid,opposite,ovate,pedicel,peduncle,petiole,pilose,plant,prickle,pubescent,rachi,recurved,sessile,shape,simple,small,somewhat,sparsely,stellae,stellate,stellate-pentagonal,stem,stigma,straight,style,thickened,tomentose,unbranched,unknown,vine,way,white,x,yellow	0.7–1,0.7–3,1.4,1.5,1.7–3.5,12,1–3.5,2,2-,2–3,3-foliate,3.2,3.5,3.5–6,3–4,4–5,5–7.5,6-7,9–11,absent,accrescent,adaxiall,ag,apex,armed,articulated,axe,ba,base,blade,calyx,campanulate,capitat,caudate,color,connivent,creeping,curve,cylindrical,directed,distally,eaf,eed,equal,erect,expanded,fertile,fragrant,free,fruiting,geminat,glabrou,ilament,immature,including,lateral,less,lightly,linear-tapered,lobe,long,longitudinal,lower,lowest,m.,major,margin,midpoint,minute,nflorescence,node,oblong-ovate,obtuse,offset,one,opening,orolla,per,perhaps,pore,portion,probably,ray,reflexed,repand,ripe,rooting,rounded,ruit,shallowly,shorter,side,size,slender,slightly,slit,spaced,striaght,subcordate,tal,tem,tip,triangular,truncate,tube,two,unarmed,unequal,uniform,unit,vary,vein,wide,widely,ympodial	0.7-1,0.7-3,1.7-3.5,3-4,4-5,9-11,abaxial,adaxial,arrangement,capitate,colour,corolla,form,growth,height,history,inflorescence,length,life,na,number,ovary,perennial,position,reproduction,seed,spacing,surface,texture,trichome,width
526	wfo-0001029673	invalid_json_followup	159	120	86	73	34	0.541	0.5-1,0.7-1.1,0.75-1,1-10,1-2,1-5,1.5-2,2-2.5,2-3,4-6,5-25,abaxial,abaxially,acuminate,acute,adaxial,adaxially,anther,anthesi,apex,apical,appearing,bark,basal,base,black,branch,broadly,calyx,clavate,cm,corolla,deep,dendritic,densely,diameter,elliptic,filament,flower,fork,fruit,fruiting,glabrous,globose,greyish-yellow,growth,later,lateral,leaf,length,lenticular,minutely,mm,narrowly,occasionally,ovary,overtopping,pedicel,pericarp,petal,petiole,pitted,planar,pubescent,purple,pyramidal,reddish-brown,reflexed,scar,shoot,shrub,slightly,small,sparsely,stem,stigma,style,surface,tapering,terminal,thin,tree,trichome,vein,violet,winged	.5,0.8-1,1.2-3.5,1.5-1.8,10-20,2-4,2.5,3-5,3/4,5.5-15,absent,accrescent,age,along,becoming,berry,blade,branching,conical,decurrent,deflexed,deltoid,denser,dichasia,eaf,edicel,eed,ew,exserted,free,greyish,greyish-yello,individual,inserted,lamina,like,lobe,lon,long,longer,lower,m.,monochasial,nflorescence,nodding,older,pair,papillo,plurifoliate,pore,poricidal,portion,prominent,ruit,secondary,sleeve,slit-like,somewhat,stamen,strongly,tall,time,tip,triangular,tub,tube,ud,unit,wide,woody,x,ympodial,young	'',[,``,arrangement,bud,center,characteristic,colour,form,height,history,inflorescence,life,margin,na,new,number,papillose,peduncle,perennial,plant,position,prickle,rachi,reproduction,seed,shape,spacing,staman,texture,value,width,{,}
527	wfo-0001029680	invalid_json_followup	212	125	72	140	53	0.34	0.1,0.6,50,abaxially,adaxially,annual,anther,anthesi,apart,apex,articulated,axillary,base,bipinnate,blue,branched,brown,calyx,clavate,cm,densely,diameter,filament,flattened,fleshy,flower,fruit,glabrous,globose,green,herb,leaf,length,light,long,margin,mm,moderately,multicellular,obovate,pale,pedicel,peduncle,pentagonal,petiole,pinnate,pitted,pubescent,purple,rarely,red,ripe,rotate,shallowly,shoot,simple,sometimes,sparsely,stem,stigma,style,subglabrous,surface,terminal,time,tripinnate,turning,uniseriate,violet,white,x,yellow	.0,0.4,0.5–1.5,0.6–1.2,0.6–2.0,0.9–1.0,1,1.0,1.0–1.1,1.0–1.5,1.0–1.8,1.1–1.2,1.4–2.5,1.4–7.5,1.5,1.6–2.7,1.7–7,1.8–3.8,10,11–16,11–25,12,1–2,1–3,1–6,1–8,2.2–4.2,2–20,3.0–4.2,3.3–5.5,3–22,3–6,4.0–16,4.0–6.5,4.5–20,4.5–7.0,4–10,4–30,5,5.5–8.5,5–11,7–10,8–32,absen,acute,adaxiall,ag,along,appressed,arequipa,arranged,asymmetrically,axe,ba,becoming,beyond,blade,borne,cell,connivent,cylindrical,decreasing,decurrent,difoliate,divided,eaf,eed,entire,equal,erect,extending,flange,forming,geminat,hair,indistinct,irregularly,lobe,lon,longitudinal,lower,m.,midrib,narrow,nflorescence,node,oblong,obtuse,occasionally,often,opening,orolla,ovate,pair,parallel,pendant,perfect,pinnae,plurifoliate,pore,poricidal,primary,prostrate,rapidly,ruit,running,secondary,shaped,side,size,spaced,specimen,split,stone,straight,tacna,tal,tamen,tear-drop,tem,tertiary,tip,tube,unicellular,unit,usually,vary,wide,wing,winge,winged,woody,ympodial,–10,–12.5,–19,–3,–3.2,–46,–48	'',0.6-1.2,1-2,1.0-1.5,1.7-7,11-16,11-25,12.5,3,3.0-4.2,4-10,4.5-20,4.5-7.0,5-11,8-32,[,``,abaxial,adaxial,arrangement,bark,bud,center,characteristic,colour,corolla,form,fruiting,growth,height,history,inflorescence,life,na,new,number,ovary,plant,position,prickle,rachi,reproduction,scar,seed,shape,spacing,staman,texture,trichome,value,width,{,}
528	wfo-0001029685	invalid_json_followup	288	132	99	189	33	0.344	.5,0.1-0.3,0.5-1.5,1-2,1-4,1-5,1-7,1.3-1.5,1.5-5,1.5-6,10-20,2-3,3-7,3.5-4,4-10,4-9,5.5-7,acute,anther,apex,armed,bark,berry,branched,bright,brown,calyx,cell,clavate,cm,corolla,cupular,curved,dark,densely,diameter,drying,erect,filament,finely,flattened-reniform,flower,fruit,fruiting,glabrous,globose,irregular,lateral,leaf,length,lobed,margin,maturity,mauve,mixture,mm,obconical,orange,orange-brown,orange-translucent,outline,ovate,ovoid,pedicel,peduncle,petiole,pit,porrect,prickle,pubescent,rachi,raised,rarely,red-brown,ridged,scar,sessile,shiny,shrub,simple,slightly,small,smooth,sparsely,stalked,stellate,stellate-pubescent,stem,stigma,straight,strongly,stump,style,surface,thin,trichome,unbranched,yellow,yellow-green	.2,.4,.8,/3,0-15,0.1,0.1-0.2,0.2,0.2-0.8,0.5,0.5-1,0.7-1.5,0.7-1.8,1-1.3,1.5,1/2-2/3,1/3,1/3-2/3,1/3-4/5,1/6-1/3,10,2-6,2.1-3,2.5-3,2.5-3.7,20,3,3-20,3-5,3-6,3.5,3.5-16,3/4-1/2,30-60°,4,4-7,4.5-6,5,5-11,5-20,5-merou,6-8,6.5-9,abaxially,accrescent,adaxially,age,almost,alyx,apar,apart,apically,apparently,articulated,axe,base,beyond,black,blade,breaking,brittle,broad-deltate,chartaceous,clearly,clump,covering,cuneate,deep,deltate,dense,development,difoliate,discolorous,distance,divided,dorsal,downward,eaf,eed,elongating,equal,exserted,extending,faint,filiform,finger-hair,flat,flattened,free,geminat,glabrescent,grey-brow,growing,inflated,infructescence,irregula,lengthening,less,lobe,long,long-acuminate,long-deltate,longer,longitudinal,lower,mature,midpoint,midvein,minute,moderately,much,nflorescence,oblique,obovate,often,older,one,open,opening,orolla,oung,ovoi,pair,papillae,papillo,partly,patch,per,perfect,pericarp,persisting,point,pore,poricidal,portion,primary,pronounced,ray,reduced,reflexed,regular,rest,ri,robust,rounded,ruit,secondary,side,sinus,slender,slit,sometimes,somewhat,spaced,specimen,spherical,spreading,stalk,stout,tamen,tapering,terete,terminal,tertiary,thick,throughout,time,tip,toward,translucent,truncate,tube,ud,unarmed,unit,upper,usually,variously,vary,vein,venation,visible,well-developed,wide,widest,woody,x1.5-2,ympodial,×	'',5-merous,[,``,abaxial,adaxial,arrangement,bud,center,characteristic,colour,form,grey-brown,growth,height,inflorescence,na,new,number,ovary,papillose,plant,position,reproduction,seed,shape,spacing,staman,texture,value,width,{,}
529	wfo-0001029691	success	223	108	77	146	31	0.345	0.2-0.4,0.4-0.5,1-5,1-6,1.2-1.7,1.7-2.7,11-14,13-20,18-23,2-3,2.5-8,3-4,6-10,6.5-8.5,8-14,accrescent,acicular,adaxially,andromonoecious,anther,broadly,calyx,chartaceous,cm,densely,diameter,entire,extra-axillary,filament,flower,fruit,fruiting,glabrous,globose,green,herbaceous,inflorescence,length,lilac,lobed,longer,margin,minutely,mm,orbicular,ovate,pale,pedicel,peduncle,petiole,plant,prickle,prostrate,rachi,resprouter,reticulate,rotate,shallowly,shape,simple,slightly,sparsely,sprawling,stellate,stellate-pubescent,stigma,straight,style,surface,thick,time,unbranched,weakly,white,wide,yellow,yellowish-green	%,-8,0-0.1,0-6,0.25-0.45,0.3-0.45,0.3-0.7,0.3-1.4,0.5-0.7,0.5-0.8,0.5-1,0.8-1.2,0.8-1.6,0.8-2.5,1-1.1,1-2,1-locular,1.1-2.1,1.4-2,1.5-4,1.6-2.1,10,100-400,13-18,13-25,140-320,2.5-4,3-6,3-7,3.3-3.5,36-50,4-8,40-250,5-,5-8,5-merou,5.5-9,6-8,6.5-10,abaxially,absen,absent,abundant,across,acute,adaxiall,adult,alyx,apart,apex,armed,articulated,attenuate,axe,ba,base,blade,branche,brown,bursting,cone,connivent,cross-section,cuneate,curved,cylindrical,decimetre,directed,distall,eaf,eed,eglandular,elliptica,equalling,exocarp,finger,functional,gland-tipped,hair,half,heterostylous,included,incomplete,index,interpetalar,juicy,lamina,lanceolate,lateral,less,lobe,lobing,lon,long,lower,mature,maturity,mesocarp,mid-point,midpoint,midvein,minute,moderately,moist,nflorescence,oblique,obtuse,orolla,part,per,petal,placenta,pore,porrect,presen,present,ray,readily,rounded,ruit,septum,sessile,short,side,spaced,stage,stalk,stellae,summit,tal,tamen,tem,throughout,tip,tissue,toward,transparent,truncat,tube,unit,unknow,uvenile,vary,vein,x,ympodial	abaxial,adaxial,arrangement,bark,bud,cell,center,colour,corolla,elliptical,form,growth,height,history,leaf,life,na,new,number,ovary,position,reproduction,scar,seed,spacing,staman,stem,texture,trichome,truncate,width
530	wfo-0001029704	invalid_json_followup	146	113	71	75	42	0.486	0-1.5,1,1.5,1.5-2.5,1.5-3,2-3,3-4-celled,3-5,4,7-10,acuminate,acute,also,anther,apex,blue,branch,broadly,brown,calyx,cell,cm,conical,corolla,dark,ellipsoid,extra-axillary,few-flowered,filament,flower,fork,fruiting,glabrous,globose,green,leaf,less,minute,minutely,mm,mottled,obovate,obovoid,occasionally,one,ovary,pedicel,peduncle,petiole,pinnatisect,pubescent,purple,record,reddish,reticulate,rounded,shoot,shrub,simple,stellate,stigma,striped,style,subdiscoidal,surface,trichome,twig,variable,vein,white,young	-17,-3,.5,0.5,1-2,1-4,10-14,1000-1200,140-185,15-25,2-2.5,2-5,4-7,5,7-,9-20,acuman,along,anthesi,apparently,aspect,axi,base,berry,c.,composed,cunate,cuneate,cut,deeply,deflexed,dia,diam,eaf,eed,enlarged,erect,especially,exerted,flowering,gradually,halfway,lanceolate,lengthening,lobe,lobed,long,lower,midrib,moderately,nflorescence,plurifoliat,pore,poricidal,ruit,short,single,sinus,slit,sombre,sprawling,stone,stout,straight,subglobo,swollen,tip,tub,tube,ud,unit,variously,within,x,ympodial	'',[,``,abaxial,adaxial,arrangement,bark,bud,center,characteristic,colour,diameter,form,fruit,growth,height,history,inflorescence,length,life,margin,na,new,number,perennial,plant,position,prickle,rachi,reproduction,scar,seed,shape,spacing,staman,stem,subglobose,texture,value,width,{,}
531	wfo-0001029727	success	260	101	81	179	20	0.312	-3,/3,0-2,0-4,0.1-5,0.4-1,0.5-3,1-1.2,1-4,1.6-3,1/3-1/2,2.5-5.5,3-7,4.5-,5.5-7,abaxial,abaxially,acuminate,acute,adaxial,anther,apart,apex,apparently,bark,berry,calyx,chartaceous,clavate,climber,cm,corolla,cupular,curved,densely,diameter,erect,ferrugineous,finely,flattened-reniform,glabrous,lateral,leaf,length,lobed,long,margin,mauve,mm,moderately,obconical,oblong,orange-brown,ovate,pedicel,peduncle,perfect,petiole,pitted,porrect,prickle,red-brown,scandent,scar,seed,sessile,shallowly,shape,shrub,stalked,stellate-pubescent,stem,stigma,straight,style,subentire,surface,terete,terminal,trichome,variously	-1/3,-10,.5,0-15,0-20,0-30,0-40,0-5,0-8,0.15-0.2,0.15-0.3,0.2,0.2-0.5,0.2-2.5,0.3,0.4,0.5,0.5-1.2,0.7-0.9,0.7-1,1,1-,1-2,1.2-2,1.5-2.3,1.5-2.5,1.5-3,1.5-5.5,1/2-2/3,1/4,1/8-1/5,2-5,2.5,2.5-3.2,2.8-4,3-11,3-6,3/,4-7,4-merou,4-merous,4.5,5-12,5-8,5-9,6-11,7-10,acicular,age,almost,along,alternate,alyx,ame,anthesi,apar,apically,articulated,base,blade,branched,bristle,brown,c.,colourles,connivent,cordate,covered,darker,deltate,deltoid,developing,different,dimorphic,discolorous,divided,drying,eaf,edge,eed,elongating,equal,except,extending,filament,filiform,filiform-acuminat,fissure,flower,free,geminate,increasing,inside,lengthening,less,like,lobe,lon,longer,lower,m.,mature,middle,midpoint,midvein,minor,minutely,mixture,narrow-deltate,nflorescence,nther,occasional,older,one,open,orolla,oung,outside,pair,papillo,papillose,per,perfec,pit,plurifoliat,pore,poricidal,portion,prickl,prickly,primary,protruding,pubescent,raised,rarely,ray,red-brow,reddish,reduced,regular,rounded,series,short,simple,sinus,size,smooth,sometimes,spaced,spreading,stalk,stellate,strongly,tamen,tapering,tearing,tertiary,time,tip,toward,translucent,transverse,tube,unarmed,uneven,unit,upper,variable,vary,vein,venation,violet,visible,way,wide,x,yellowish,ympodial,young	arrangement,bud,cell,center,colour,form,fruit,fruiting,growth,height,inflorescence,na,new,ovary,plant,position,reproduction,spacing,texture,width
532	wfo-0001029728	success	238	109	68	170	41	0.286	0.5-1.5,abaxially,abundantly,accrescent,acute,anther,anthesi,apex,broadly,brownish,bud,calyx,cell,cm,diameter,early,erect,extra-axillary,filament,flattened-reniform,flower,fruit,fruiting,glabrous,glandular,glandular-pilose,globose,golden,green,late,leaf,length,light,lobed,margin,mature,maturity,minutely,mm,narrowly,nearly,ovate,pedicel,peduncle,petiole,pilose,pitted,prickle,pubescent,rachi,shallowly,shrub,simple,stellate,stem,stigma,style,suborbicular,surface,tan,terete,thin-textured,triangular,unbranched,white,x,yellow,yellowish	.6,0.2,0.3,0.3–0.4,0.4–2,0.5–0.9,0.6–1.5,0.7–1.2,0.8,0.8–1.6,0.8–2.5,0–0.5,1.2–2.3,1.5–2,1.6,1.7–2.5,1/3,11,12–20,1–,1–2,1–2-celled,2,2-foliate,2.4–3.6,2.7-3.1,2.8,200-310,260,2–3,2–4,2–4-celled,3,3.4–4.5,3.5–5.5,3–18,3–5,4,4.5-5.5,4–10,4–14cm,4–15,4–6-rayed,5,6.2–8.1,7,7-10,7–12,7–14,7–15,8–10.5,9,=,absent,acicular,adaxiall,adaxially,admixture,armed,around,ascending,auxiliary,axe,base,becoming,blade,branche,capitat,column,compressed,contiguou,curled,curved,cylindrical,densely,differing,dimorphic,directed,distall,eaf,eed,enlarged,exceeding,fallen,fertile,fewer,free,frui,geminate,generally,glabrou,gland-tipped,grading,hair,half,horizontally,hyaline,intermixed,lanceolate,larger,least,lobe,long,longer,lower,lowermost,main,major,many,midpoint,minute,mixed,much,n,nflorescence,numerous,obtuse,often,one,orolla,pair,per,plane,pore,pubescence,ray,recurved,reflexed,relatively,ruit,scarcely,scattered,sessile,short-pilose,shorter,similar,similarly,single-stemmed,size,slender,slightly,small,smaller,sparsely,spine,spreading,stellae,stout,straight,subcordate,tall,tamen,tem,terminal,tip,triangular-lanceolate,truncate,tube,undulate,unit,usually,various,vary,vein,wid,wide,withered,ympodial,–4,–5	0-0.5,0.3-0.4,0.6-1.5,1.2-2.3,1.7-2.5,12-20,2-4,4-10,6.2-8.1,7-12,abaxial,adaxial,arrangement,bark,capitate,center,colour,contiguous,corolla,form,growth,height,history,inflorescence,life,na,new,number,ovary,perennial,plant,position,reproduction,scar,seed,shape,spacing,staman,texture,trichome,width
533	wfo-0001029731	invalid_json_followup	246	113	77	169	36	0.313	.5,0.1-0.8,1-2,1-2.5,1.5-2.5,2-6,3-10,4,4-9,7-11,8-9,acquiring,acuminate,acute,almost,along,anther,apex,apically,bark,base,black,branch,brown,calyx,clavate,cm,conical,corolla,diameter,dilated,distributed,elliptic,entire,epiphyte,erect,evenly,filament,flower,fruit,fruiting,glabrous,lateral,leaf,liana,linear,lobed,long-ellipsoid,longitudinally,margin,mauve,mm,obconical,oblong,obovate,pedicel,peduncle,petiole,prominent,pyriform,rachi,ridged,scar,slender,stem,stigma,stump,style,surface,terminal,thick,toward,trichome,white,widely,woody,yellow-green	.6,0.05,0.25-0.3,1,1-1.5,1.5,1.5-3,1/3,10-20,1994,2,2-3,2.5,2.5-4.5,3,3-4,31,4-5,6,6-7,abaxially,accrescent,adaxially,age,alyx,anthesi,apar,apparently,arcy,articulated,basal,basally,beak,becoming,berry,boundary,branched,branching,broadly,bumpy,clearly,concolorous,connate,coriaceous,crinkled,cuneate,darker,delimited,delineated,deltoid,dense,development,different,domatia,dorsal,dorsifixed,dry,drying,dull,eaf,early,elongating,enlarge,equal,even,exserted,faint,filiform,fine,finely,flaring,flattened,fleshy,free,ground,hair,iscoid,lamina,large,later,lengthening,less,like,lobe,lon,long,longitudinal,lower,main,mature,maturity,midvein,much,narrowly,nflorescence,nther,obtuse,occasionally,often,orange-brown,orolla,pair,papillae,papillose,part,pendulous,perfec,pericarp,persisting,plurifoliat,pore,poricidal,portion,primary,protruding,raised,rakotozafy,rarely,reflexed,reported,revolute,ribbed,ridge,rounded,ruit,see,several,shallowly,shorter,simple,sinus,slightly,small,smaller,smoot,sometimes,sparsely,straight,stretched,succulent,sunk,tearing,thickened,thinner,though,time,tip,tub,tube,tuft,ud,unit,usually,vary,vein,venation,ventral,visibl,visible,well-developed,wide,wing,winged,wrinkling,x,yellow,ympodial,young,’	'',[,``,abaxial,adaxial,arrangement,bud,cell,center,characteristic,colour,form,growth,height,history,inflorescence,length,life,na,new,number,ovary,perennial,plant,position,prickle,reproduction,seed,shape,spacing,staman,texture,value,width,{,}
534	wfo-0001029741	success	137	90	63	74	27	0.46	.5,1-1.5,1-3.5,1.1-1.3,1.5-4,1.5-6,3,?,accrescent,acute,age,anther,apex,base,becoming,calyx,capitate,closely,cm,corolla,dark,elliptic,filament,flower,fruit,fruiting,furcate,glabrous,globose,green,growth,inflorescence,leaf,lenticellate,lighter,lobed,long,minutely,mm,nearly,new,opposite,ovary,ovate,overlapping,papillose,pedicel,petiole,shrub,slender,slightly,spaced,stem,stigma,style,tapering,tree,tube,variable,weak,white,woody,x	.4,0.5-1.5,0.8-3.5,0.9-1.2,1.5,10-50-flowered,2-2.5,2.2-9,2.5-7.8,9.5-22.5,anthesi,apiculate,attenuate,berry,black,branched,ca,caly,completely,deflexed,deltoid,dia,differing,difoliate,divisio,dry,drying,eaf,early,edicel,eed,erect,exserted,free,geminat,glabrou,immature,known,lateral,lobe,lon,lower,main,major,middle,minor,nflorescence,pair,papillo,planar,pore,poricidal,portion,produced,prominent,proximal,quite,raised,reddish-brown,ruit,scar,shaped,size,straight,tall,tear-drop,tip,ud,unit,usually,vein,widest,wood,ympodial	1.4,10-50,abaxial,adaxial,arrangement,bud,colour,diameter,form,height,history,length,life,na,number,peduncle,plant,position,rachi,reproduction,seed,shape,spacing,staman,surface,texture,width
535	wfo-0001029744	invalid_json_followup	113	100	53	60	47	0.469	0.3-0.6,0.5-1,2-4,5-8,50,abaxially,adaxially,apart,apex,bark,branch,calyx,cm,deltate,dendritic,densely,elliptic,entire,flattened,flexuous,form,fruit,glabrous,golden,lanceolate,leaf,long-acuminate,margin,minutely,mm,narrowly,oblanceolate,opposite,ovoid-reniform,pale,pedicel,petiole,pitted,pubescent,revolute,scar,shape,shrub,simple,single-celled,slightly,stem,surface,thin,trichome,unifoliate,uniseriate,white	1,1.5,1.5-3.2,2,7-15,8-10-flowered,8-11,acute,along,base,beginning,blunt,brow,denser,difoliate,distinct,eaf,eed,examined,extreme,fide,geminate,glabrescent,incrassate,inflorescenc,lamina,leave,lobe,looping,lower,major,marginal,mature,minor,nflorescence,node,non-reproductive,oblique,occasionally,older,pair,primary,pubescence,see,similar,small,smaller,smith,sometimes,somewhat,spaced,thee,tip,ud,unicellular,unit,vein,x,ympodial,young	'',3,8-10,[,``,abaxial,adaxial,anther,arrangement,brown,bud,cell,center,characteristic,colour,corolla,diameter,filament,flower,fruiting,growth,height,history,inflorescence,length,life,na,new,number,ovary,peduncle,perennial,plant,position,prickle,rachi,reproduction,seed,spacing,staman,stigma,style,texture,value,width,{,}
536	wfo-0001029746	invalid_json_followup	179	121	85	94	36	0.475	0.3-2,0.5-1,0.7-1,1,1-1.3,1-1.5,2-8,3-4,3-6,8-11,acuminate,acute,anther,apart,apex,berry,blackish,brown,calyx,capitate,centre,ciliate,cm,conical,corolla,dark,darker,densely,diameter,ellipsoid,enlarged,entire,erect,filament,flattened,flower,fruit,fruiting,gland-tipped,glandular,globose,greenish,herb,inflorescence,internodal,leaf,lobe,margin,minutely,mm,nodding,orange,ovary,ovate,ovoid,pale,papillose,pedicel,peduncle,petiole,pitted,principal,pubescent,purple,rachi,red,reddish,reflexed,scar,shallowly,simple,slender,slightly,somewhat,stem,stigma,style,subshrub,surface,thin,tip,triangular,trichome,vein,x	.5,1.2-1.5,1.5,2,2-2.5,2-4,2-7,3,3-4-pluri-foliate,3-4.5,4-9,6,6-7,8-10,abaxially,adaxially,age,anthesi,base,bearing,becoming,broadly,c.,cell,color,cordate,crenate,crowded,cup-shaped,curved,eaf,edicel,eed,elliptic,exerted,fleshy,flush,free,glabrous,growing,heteromorphic,hollow,horn,irregularly,lamina,lengthening,less,lon,long,longer,longest,lower,markedly,mature,maturit,mid-length,mixed,narrowly,near,nflorescence,occasionally,pair,papillo,pericarp,plan,pore,poricidal,portion,primary,pubescen,ruit,shortest,single,slit,spaced,sparse,sparsely,spreading,straight,strongly,testal,third,tube,ud,uniseriate,unit,upper,upward,wall,widely,widest,woody,ympodial,–3	'',1.5-3,[,``,abaxial,adaxial,arrangement,bark,bud,center,characteristic,colour,dense,form,growth,height,history,length,life,na,new,number,perennial,plant,position,prickle,reproduction,seed,shape,spacing,staman,texture,value,width,{,}
537	wfo-0001029751	success	158	88	54	104	34	0.342	1.2,1.7,3,5-merous,acicular,anther,apex,broad-based,capitate,clavate,cm,corolla,deltoid,diameter,eglandular,enlarged,extra-axillary,fruit,geminate,glandular,globose,globose-ellipsoid,hair,leaf,length,membranaceous,mm,moderately,orbicular,outside,ovary,pedicel,peduncle,petiole,prickle,pubescent,recurved,scorpioid,shrub,simple,solitary,sometimes,sparsely,spreading,stellate,stigma,straight,style,surface,toward,trichome,upper,white,yellow	.5,0.6–1.6,1,1.3–2.6,1.8–4,10–11,10–19,12–14,1–2,1–3,2,2.2–2.5,2.5–5,2–3,2–4-celled,2–5,3–9,4,4.5–6,5–10,5–25-flowered,6,8–9,9–18,also,apical,armed,attenuate,base,blade,broadly,calyx,celled,central,compressed,covered,cuneate,di-,diam,eaf,eed,elongate,equal,geminat,glabrous,gree,immature,inner,lanceolate,lateral,linear,linear-lanceolate,little,lobe,lon,long,longer,lower,midpoint,midvein,needlelike,nflorescence,one,opening,pair,pedunculate,perfect,planar,pore,prickly,ray,ripe,ruit,sessile,shallow,short,short-stalked,shorter,size,small,smaller,somewhat,stalked,subcordate,subtended,tal,tem,tooth,triangular,trifoliate,truncate,twice,unarmed,unbranched,unequal,unit,usually,variegated,whitish,wide,winged,ympodial,±,×	1-3,1.8-4,10-11,2-4-celled,2.2-2.5,3-25,3-9,8-9,abaxial,adaxial,arrangement,colour,filament,flower,form,green,growth,height,history,inflorescence,life,na,number,perennial,plant,position,rachi,reproduction,seed,shape,spacing,staman,texture,width
538	wfo-0001029758	success	261	92	69	192	23	0.264	.2,.5,1.0–3.4,1.2–1.9,1.3–1.7,1.8,10.3–14.5,2.8–2.9,7.6,7–17,anther,apart,apex,appearing,attachment,black,capitate,chartaceous,cm,cordate,corolla,dark,deltoid,densely,diameter,dry,evenly,extra-axillary,filament,flattened-orbicular,flattened-reniform,flower,fruit,glabrous,globose,green,lateral,length,mature,mm,nearly,notched,obtuse,orbicular,oval,ovate,pedicel,peduncle,petiole,point,prostrate,pubescent,purple,red-brown,reticulate,shrub,simple,spaced,stellate,stigma,style,sub-coriaceous,surface,unarmed,vein,well,white,yellow,yellow-brown	.3,/4,0.2,0.4–1.2,0.5–0.7,0.6–0.9,0.7–0.8,0.7–1.3,0.8–1.1,0.8–1.3,0.9–1.0,0.9–1.2,0.9–1.5,1.1–1.5,1.1–1.8,1.2–1.4,1.7–2.8,1.9–2.6,1.9–2.7,1/3,1/4–1/3,2.1–6.2,2.2–2.9,2.3–3.3,2.3–6.4,2.8–4.2,3.1–3.8,3.2–3.5,3.5–4.8,3.6,4.1–6.3,4.3–4.8,4.3–6.2,4–6,5-merou,5.7–7.8,5.8,7–9,8.0–33.1,8–11,abaxially,absent,acuminate,adaxially,adnate,aequilateral,ag,alyx,anthesi,apical,apparently,appresse,arching,arcuate,around,articulate,attenuate,axe,ba,basal,base,bent,berry,blade,broad,brochidodromous,bud,bulge,calyx,channeled,cream,curved,cylindrical,dentate,development,directed,directly,distal,distally,distinct,eaf,edge,eed,either,emerging,endocarp,entire,equal,erect,exocarp,extending,fertile,filiform,flexed,free,geminat,glossy,gradually,gree,heterostylous,immature,increasing,intact,internode,interpetalar,intersepalar,juic,lanceolate,layer,least,lobe,lobed,lon,long,longer,lower,many,margin,markedly,midpoint,midrib,midvein,minute,moderately,nflorescence,observed,occasionally,often,opaque,orolla,ove,per,perforated,persistent,petalar,pore,porrect,portion,potentially,presumably,raised,ray,remaining,ridge,rigid,rounded,row,ruit,short,short-stipitate,shorter,side,sinus,sloughing,splitting,spread,spreading,stamen,stellae,stellate-pubescent,stem,stipe,stipitate,straight,suture,tamen,tem,tetrafoliate,thin,though,tip,tissue,toward,transparent,trifoliate,tube,two,ud,unbranched,unit,various,vary,weakly,well-developed,wide,yellow-ferruginous,ympodial,young,±90°,±a,¼,×	5-merous,abaxial,adaxial,arrangement,colour,dioecious,form,growth,height,history,inflorescence,leaf,life,number,ovary,perennial,plant,reproduction,seed,shape,spacing,staman,texture
539	wfo-0001029769	invalid_json_followup	142	100	57	85	43	0.401	.5,0.5-1.5,1-3,1.5-2.5,4-5,5-8,6-17,7-8,acuminate,anther,apex,bark,brown,calyx,capitate,cm,conical,corolla,curl-tipped,cyathiform,dark,densely,elliptic,filament,filiform,flower,fruiting,glabrous,globose,green,internodal,leaf,lobed,margin,minutely,mm,opposite,ovary,ovoid-reniform,papillose,pedicel,petiole,pitted,pubescent,scar,shrub,simple,smooth,somewhat,sparsely,stem,stigma,style,surface,swollen,trichome,white	.25,1-1.2,1.5-2,2.5-3,2.5-8,3.5-4,30-60-flowered,4,8-9,8.5-17,abaxially,acute,adaxially,along,anthesi,apar,ape,archin,ba,base,bearing,berry,branch,brochidodromu,cerro,deflexed,deltoid,dia,eaf,edicel,eed,exserted,free,fresh,golden,hen,horizontally,inglé,lateral,less,like,lobe,lon,long,lower,main,midrib,nearly,nflorescence,older,onto,pair,papillo,pore,poricidal,portion,puberulent,reflexed,ried,ruit,scattered,shaped,spaced,straight,tall,tear-drop,three,time,tip,tub,tube,two,ud,unevenly,unifoliat,uniseriate,unit,vein,wide,widely,winged,woody,x,ympodial,young	'',30-60,[,``,abaxial,adaxial,apart,arrangement,bud,cell,center,characteristic,colour,dense,diameter,form,fruit,growth,height,history,inflorescence,length,life,na,new,number,peduncle,perennial,plant,position,prickle,rachi,reproduction,seed,shape,spacing,staman,texture,unifoliate,value,width,{,}
540	wfo-0001029771	invalid_json_followup	196	112	74	122	38	0.378	.5,0-0.5,0.3-0.6,0.4-1.4,1-1.5,1-2,1-5,2-3,3-4,4-7,5.5-8,6-11,absent,accrescent,acute,anther,apex,articulated,base,calyx,chartaceous,cm,contiguous,densely,diameter,entire,extra-axillary,filament,flower,fruit,fruiting,glabrous,gland-tipped,globose,green,grey-green,hair,inflorescence,leaf,length,lilac,margin,mm,nearly,obtuse,ovate,pale,pedicel,peduncle,perennial,petiole,prickle,pseudo-umbellate,purple,rachi,red,reniform,reticulate,rhizomatous,rotate,rotate-stellate,scattered,short,shrub,simple,somewhat,stellate-pubescent,stigma,style,surface,unbranched,x,yellow,yellowish	%,0-0.25,0-0.6,0-3,0-4,0-5,0.05-0.15,0.1-0.3,0.2-0.25,0.2-0.4,0.3-1,0.4-0.7,0.4-1,0.45-0.9,0.5-0.7,0.5-1.2,0.7-1.2,0.7-1.8,0.8-1.2,0.9-1,1,1-locular,1.2-2.8,1.8-3,15-35,2,2-2.3,2-3-foliate,2.5-10,2.5-7,4-,4.5-12,5-10,5-9,5-merou,7-10,7-8,abaxially,absen,across,adaxially,adult,alyx,apart,apparen,axe,ba,blade,branch,capitat,connivent,cordate,curved,cylindrical,deltate,directed,distall,distributed,dm,eaf,eed,eglandular,elliptic,erect,exceeding,exocarp,finger,geminate,grey,incomplete,interpetalar,juicy,juvenile,lamina,lanceolate,lateral,lobe,lon,long,lower,mature,mesocarp,mid-point,midpoint,minute,nflorescence,oblique,orolla,part,per,perfect,placenta,pore,porrect,present,pubescent,ray,ruit,septum,slightly,spaced,stalk,stellae,straight,succulent,tal,tamen,tem,thick,throughout,time,tissu,tissue,tube,unarme,unarmed,unit,upper,vary,white,wide,ympodial	'',[,``,abaxial,adaxial,arrangement,bark,bud,capitate,cell,center,characteristic,colour,corolla,form,growth,height,history,life,na,new,number,ovary,plant,position,reproduction,scar,seed,shape,spacing,staman,stem,texture,trichome,value,width,{,}
541	wfo-0001029775	success	54	54	34	20	20	0.63	0.25-1.5,0.5-4,2-6,2-8,3-4,4-5.5,6-16,alveolate,brown,cm,diameter,flattened,glabrous,globose,hollow,internode,light,margin,mm,orange,perennial,prickle,puberulent,sparsely,straight,strongly,subshrub,surface,thickened,trichome,unbranched,unifoliate,vine,yellow	absen,aggregate,base,ecuador,eed,long,recurve,ripe,robust,ruit,shin,stigma,tal,tem,tone-cell,truncat,unit,wide,x,ympodial	arrangement,color,form,fruit,growth,height,history,leaf,length,life,na,plant,recurved,reproduction,seed,shape,stem,texture,thicknes,width
542	wfo-0001029780	success	204	94	62	142	32	0.304	1-10,1-2,120-210,15-22,15-45,2-2.8,2-3.5,2-5.5,3.5-7.3,4-6,5-7,8-12,?,abaxially,adaxially,anther,apex,articulated,bud,cell,cm,cordate,corolla,dark,densely,diameter,filament,flower,forked,fruit,glabrous,globose,green,greenish,herb,invested,length,margin,minutely,mm,mucilaginous,odd-pinnate,ovate,ovoid,pedicel,peduncle,petiole,plant,puberulent,pubescent,rotate,seed,stem,stigma,streak,stripe,style,terminal,trichome,white,whitish,yellow	1-1.2,1.4-1.9,1.5-2,11-24,2-12,2-2.5,2.4-4.2,20-60,3,3-6,4.5-6,5-merou,5.5,5.5-13,50-70,600-950,absent,acumen,acute,ag,along,alyx,apart,apparently,attenuate,axe,axillary,base,berry,blade,borne,brownish,capitat,chartaceous,ciliate,condition,connivent,covering,cuneate,decumbent,digestion,distal,dorsally,drying,eaf,edge,eed,end,enzyme,erec,especially,exceeding,except,flat,folded,fresh,geminat,generally,glabrou,gland,glandular,greatly,green-white,hair,hair-like,hal,half,head,high,homostylous,honeycomb-shaped,interjected,lanceolate,lateral,leaflet,lengthening,like,living,lobe,long,longer,lower,make,membranous,midrib,minute,nflorescence,non-glandular,obtuse,often,orbicular,orolla,pair,pale,perfect,petiolulate,petiolule,pinkish,plurifoliate,pore,poricidal,proximal,rarely,reduced,removed,ripe,ruit,sessile,seudostipule,short,singly,size,slit,spaced,specimen,stamen,ste,stolo,straight,subequal,subtending,tall,tamen,tem,testal,tetralobulate,thick,throughout,tip,tri-,truncate,tube,tuber,typically,unit,unwinged,usually,vary,wall,wet,x,ympodial	abaxial,adaxial,arrangement,bark,calyx,capitate,center,colour,form,fruiting,growth,height,history,inflorescence,leaf,life,na,new,number,ovary,perennial,position,prickle,rachi,reproduction,scar,shape,spacing,staman,surface,texture,width
543	wfo-0001029784	invalid_json_followup	237	127	92	145	35	0.388	-12,.5,0.2-0.3,0.25-0.3,0.3-0.5,0.4-0.45,0.5-1.5,0.6-1,0.9-1.2,1-1.2,1-4,2,5-10,abaxial,acute,angled,anther,anthesi,apex,articulated,berry,broadly,brown,calyx,capitate,cell,cm,conical,corolla,crenate-serrate,dark,densely,diameter,distal,distributed,due,eglandular,elliptic,enclosing,evenly,filament,flower,fruit,fruiting,globose,golden,green,hair-like,half,herb,imparipinnate,inflorescence,interrupted,lamina,like,loosely,margin,mm,narrowly,obovate,outgrowth,ovary,pale,paler,pedicel,peduncle,pentagonal,perennial,petiole,plant,pubescence,pubescent,reflexed,simple,soft,somewhat,sparsely,stem,stigma,straight,stripe,strongly,style,surface,trailing,trichome,uniseriate,unseriate,vein,velvety,white,yellow	-5,.1,.2,0-4,0.1-,0.1-0.15,0.1-0.5,0.2,0.2-,0.2-0.5,0.3-0.35,0.3-0.4,0.3-1,0.4-,0.4-0.5,0.4-0.6,0.5,0.5-,0.7-1.2,1,1-,1-1.1,1-1.5,1-2,1-2-celled,1.0-1.3,1.2-2.5,1.5-,1.7-2.6,1/3,2-,2-2.5,2-3-celled,2-4,2-4.5,2-foliate,2-locular,2.5-3.5,2/3,3-,3-5,5-14,5-8,abaxially,absent,abundant,acuminate,adaxially,adpressed,along,apical,appearance,appendage,arising,articulation,axi,basal,base,basicopically,beneath,bract,column,crenation,decurrent,deeper,developed,eaf,edicel,eed,entire,exserted,giving,glabrescent,glabrous,glandular,gree,hal,halfway,head,included,interjected,internode,interspersed,irregularly,lanceolate,larger,lateral,leaflet,live,lobe,lon,long,long-acuminate,lower,markedly,maturing,mostly,multicellular,nflorescence,node,northern,occasionally,often,orbicular,pair,patent,petiolule,population,present,primary,proximal,pseudostipule,rarely,ripe,robust,ruit,scattered,secondary,sessile,silky,smaller,sometimes,sparse,spreadin,staminal,sterile,stout,tem,terminal,tertiary,testa,thick,truncate,tube,ud,undulate,unicellular,unit,usually,wall,wide,winged,woody,x,ympodial	'',2-14,[,``,adaxial,arrangement,bark,bud,center,characteristic,colour,form,growth,height,history,leaf,length,life,na,new,number,position,prickle,rachi,reproduction,scar,seed,shape,spacing,staman,texture,value,width,{,}
544	wfo-0001029785	success	223	123	96	127	27	0.43	0.1-0.5,1-10,1-2,1.2-3.2,1.5-3.6,1.8-3.5,10-26,3-8,3.5-5,5-9,6,8-11,abaxially,adaxially,along,anther,apex,axillary,broadly,brownish,bud,cell,chartaceous,clavate,cm,commonly,condition,corolla,covering,dark,darker,denser,diameter,drying,elliptic,especially,filament,flower,forked,fresh,fruit,glabrous,globose,green,green-white,greenish,hair,hair-like,herb,lateral,leaf,like,long,make,margin,membranous,midrib,minutely,mm,mucilaginous,obovate,odd-pinnate,outer,ovate,ovoid,pedicel,peduncle,pentagonal,petiole,plant,puberulent,pubescent,purple,purple-tinged,ripe,rotate,rounded,scale-like,seed,slightly,sparsely,stem,stigma,style,subtending,terminal,testal,thick,throughout,tuber,vein,violet,wall,wet,whitish,yellow	0-2,0-3,0.3-2.2,0.4-4.9,0.8-1,1-1.2,1-5,1.8-7,2-4,3-4,3-6,3.8-7.2,4-10.5,5-16,5-merou,absent,acumen,acute,ag,alyx,apart,apparently,articulation,attenuate,axe,base,berry,blade,borne,capitat,connivent,cordate,cuneate,decreasing,decumbent,digestion,distal,dorsally,eaf,edge,eed,end,enzyme,erec,exceeding,flat,folded,geminat,generally,glabrou,greatly,half,homostylous,honeycomb-shaped,interjected,invested,lanceolate,larger,leaflet,lengthening,living,lobe,lower,markedly,medium,middle,minute,mottled,much,multiple-celled,nflorescence,non-glandular,oblique,obtuse,one-quarte,orbicular,orolla,pair,pale,perfect,petiolulate,petiolule,plurifoliate,point,pore,poricidal,present,quite,rarely,removed,ruit,sessile,seudostipule,shallowly,short,singly,size,slit,sometimes,spaced,specimen,stamen,ste,stolo,straight,stripe,subglabrous,tall,tamen,tem,tip,toward,tri-,truncate,tube,typically,unbranched,unequal,unit,unwinged,usually,variable,vary,white,wide,x,ympodial	abaxial,adaxial,arrangement,capitate,center,colour,form,growth,height,history,inflorescence,length,life,na,number,ovary,perennial,position,pseudostipule,rachi,reproduction,shape,spacing,staman,surface,texture,width
545	wfo-0001029788	invalid_json_followup	194	98	56	138	42	0.289	1-10,1-2,1.2-2,12-15,2-2.5,2-4,25-30,3.5-6,4-5,6.5-7,abaxially,adaxially,anther,apex,articulated,berry,bud,cell,chartaceous,cm,conical,corolla,densely,diameter,filament,flower,forked,glabrous,green,green-white,greenish,herb,honeycomb-shaped,leaf,light,long,margin,minutely,mm,odd-pinnate,ovoid,pedicel,peduncle,petiole,plant,puberulent,pubescent,rotate,seed,sparsely,stigma,style,terminal,violet,whitish,yellow	.4,.7,0-5,0.5,0.7-2,1.5-2,2.4-5.5,3-4,4,4-6,4.5-5,5,5-13,5-merou,6,7-21,absent,acumen,acuminate,ag,along,alyx,apart,asymmetrical,attenuate,axe,axillary,base,basiscopic,blade,borne,brownish,c.,capitat,ciliate,commonly,condition,connivent,covering,decreasing,digestion,distal,dorsally,drying,eaf,edge,eed,elliptic,elliptic-lanceolate,end,enzyme,equal,erec,especially,flat,folded,fresh,geminat,generally,glabrou,gradually,hair-like,hal,half,homostylous,increasing,interjected,lanceolate,larger,lateral,leaflet,lengthening,living,lobe,lon,lower,make,middle,midrib,minute,mottled,mucilaginous,narrow,nflorescence,orbicular,orolla,pair,petiolule,pilo,plurifoliate,pore,poricidal,purple,ray,removed,ripe,ruit,secondary,semierect,sessile,seudostipule,side,singly,size,slightly,slit,spaced,specimen,stolo,straight,subequal,subsessile,subtending,symmetrical,tall,tamen,tem,testal,thick,throughout,tip,tissue,toward,tri-,tube,tuber,typically,unit,unwinged,usually,vary,wall,wet,white,wide,wing,x,ympodial	'',[,``,abaxial,adaxial,arrangement,bark,calyx,capitate,center,characteristic,colour,form,fruit,fruiting,growth,height,history,inflorescence,length,life,na,new,number,ovary,perennial,position,prickle,rachi,reproduction,scar,shape,spacing,staman,stem,surface,texture,trichome,value,width,{,}
546	wfo-0001029789	invalid_json_followup	167	99	57	110	42	0.341	0.2-0.5,1-10,1-3,2-25,2-6.5,2.7-4.7,3-8.5,4-13,5-7,7-21,8-9,abaxially,adaxially,anther,apex,attenuate,axillary,blue,broadly,bud,clavate,cm,corolla,diameter,filament,flower,forked,fruit,glabrous,green,herb,leaf,light,lilac,minutely,mm,narrowly,odd-pinnate,ovary,ovate,pedicel,peduncle,pentagonal,petiole,plant,pubescent,rachi,rotate,sparsely,sterile,stigma,style,subglabrous,subtending,terminal,white,yellow	0-2,0.5-2.8,0.8-3.5,1-2,1.5-2,1.7-8.5,1.8-6.5,12,2-3,2-6,3-5,4-10,5-merou,6,6-7,7-16.6,acumen,acuminate,acute,adaxiall,ag,alyx,apart,apparently,articulated,axe,base,basiscopic,blade,capitat,chartaceous,connivent,dark,decreasing,decurrent,distal,dorsally,eaf,edge,eed,erec,exceeding,flat,folded,formed,geminat,generally,greatly,hair,hal,half,homostylous,interjected,lanceolate,lant,lateral,leaflet,lengthening,like,linear,lobe,long,long-attenuate,lower,lunate,maturing,membranous,minute,mottled,never,nflorescence,orbicular,orolla,pair,perfect,petiolulate,plurifoliate,pore,poricidal,pubescen,purpl,rarely,sessile,seudostipule,short,side,simple,size,slightly,slit,spaced,stamen,star,ste,straight,subequal,tall,tamen,tem,tinged,tip,toward,tri-,tube,typically,unit,usually,vary,x,ympodial	'',[,``,abaxial,adaxial,arrangement,bark,calyx,capitate,cell,center,characteristic,colour,form,fruiting,growth,height,history,inflorescence,length,life,margin,na,new,number,perennial,position,prickle,reproduction,scar,seed,shape,spacing,staman,stem,surface,texture,trichome,value,width,{,}
547	wfo-0001029810	invalid_json_followup	149	126	86	63	40	0.577	.25,.5,0.5-3,1-1.3,1-1.5,1-10,1.1-2.3,1.5-3,3-3.5,5-6,acuminate,acute,adaxially,along,anther,apex,apically,arachnoid,bark,base,brown,calyx,capitate,closely,cm,compact,compressed,conical,corolla,dark,dendritic,densely,dia,ellipsoid,elliptic,filament,fruiting,glabrous,globose,green,inflorescence,internodal,later,leaf,like,lobed,margin,minutely,mm,narrowly,nearly,occasionally,opposite,ovary,ovoid-reniform,pale,papillose,pedicel,petiole,pitted,pointed,pubescent,reddish-brown,rest,scar,shining,shrub,simple,slender,small,spaced,sparsely,stem,stigma,style,surface,tan,tapering,tip,tree,trichome,tube,vein,white,yellowish,young	0.5-1,1-2,1-3,2-3,2-5,2.5-3,3-4,3-6,4-10,5-15-flowered,5-16,8-12,abaxially,anthesi,ape,attenuate,berry,congested,deflexed,deltate,differing,difoliate,drying,eaf,edicel,eed,exserted,fleshy,free,geminat,glabrou,large,lateral,lenticel,less,lobe,lon,long,lower,main,major,middle,minor,nflorescence,older,overlappin,papillo,planar,pore,poricidal,portion,ruit,shaped,size,tall,tear-drop,tub,ud,unit,wide,widest,woody,ympodial	'',5-15,[,``,abaxial,adaxial,arrangement,bud,center,characteristic,colour,diameter,flower,form,fruit,growth,height,history,length,life,na,new,number,overlapping,peduncle,perennial,plant,position,prickle,rachi,reproduction,seed,shape,spacing,staman,texture,value,width,{,}
548	wfo-0001029811	success	225	106	83	142	23	0.369	-3,-6,-merous,0-35,0.1-0.4,0.3-1,0.3-1.5,0.5-2,1-3,1.3-1.7,1.5-6,15-23,3-5.5,3-7,4.5-5,5,5-9,7-9,8-12,abaxial,acicular,adaxial,andromonoecious,anther,apart,bark,berry,brown,calyx,cell,chartaceous,cm,cream,dark,diameter,filament,flattened-reniform,flower,fruit,fruiting,glabrous,green,herb,leaf,length,lobed,margin,marking,maturity,mauve,mm,moderately,narrow-deltate,orange-brown,outline,ovate,pale,pedicel,peduncle,petiole,pit,plant,porrect,prickle,raised,scandent,scar,sessile,shrub,simple,small,smooth,spherical,stellate,stellate-pubescent,stem,style,surface,terete,trichome,unbranched,yellow,young	.5,/3,0,0-30,0.1-0.3,0.2,0.2-0.6,0.8-1.5,1,1-1.5,1-2.5,1.5-2.5,1/,1/2-2/3,1/3,1/3-2/3,10-22,13-20,15-50,2-2.5,2-5,2-5.5,2.5-3,2.8-3.2,20-100,3-5,3.5-4.5,4-8,5-11,5-17,5-40,6-12,7-18,8-18,abaxially,alyx,apar,apex,apically,apparently,articulated,base,blade,broad-deltate,connivent,cordate,cuneate,densely,discolorous,distal,distance,drying,eaf,eed,elongate,elongating,equal,erect,extending,eye,faint,fewer,flattened,free,glandular,green-brow,hair,hermaphrodite,heterostylous,inflated,infructescence,lateral,less,lobe,lobing,long,long-acuminat,long-styled,longer,lower,lowermost,mature,midpoint,midvein,minute,multangulate,naked,nflorescence,obtuse,often,older,one,open,orolla,oung,pair,pendulous,per,pericarp,perpendicular,plurifoliat,poricidal,portion,prickl,prickly,primary,ray,ruit,secondary,short,short-styled,shorter,side,slightly,sometimes,spaced,sparsely,spreading,stalk,stalked,staminat,stout,straight,tamen,tapering,tertiary,time,tip,tube,unarmed,unit,upper,usually,vary,vein,venation,visible,way,wide,woody,yellow-green,ympodial	arrangement,bud,center,colour,corolla,form,green-brown,growth,height,history,inflorescence,life,na,new,number,ovary,reproduction,seed,shape,spacing,staman,texture,width
549	wfo-0001029938	success	179	109	82	97	27	0.458	0.7-1.2,1-1.5,1-4,1.5-2,10-20,2.5-3,3-7,3/4,4,6-8,abaxially,accrescent,acute,anther,apex,appearing,bark,base,becoming,berry,black,bright,calyx,capitate,clavate,cm,corolla,dendritic,densely,diameter,elliptic,filament,fine,flattened,flower,fruit,fruiting,glabrous,globose,greenish,grey,growth,later,lateral,leaf,length,lenticular,lobe,long,margin,maturity,minutely,mm,narrowly,occasionally,ovary,pedicel,petiole,pitted,plane,plant,pubescent,pyramidal,red,reddish-brown,scar,shrub,small,somewhat,sparsely,stem,stigma,style,surface,tapering,terminal,tree,trichome,violet,way,white,woody	.5,0,0.5,0.7-1,1,1-2.5,1-3,1.2-1.5,1.5-2.5,1/2,12,12-15,2-2.5,5,6-9,8-10,absent,adaxially,along,anthesi,apical,ba,basal,blade,branching,broader,conical,deciduous,deflexed,deltoid,denser,dichasia,discussion,drying,eaf,edicel,eed,elliptical,entire,ew,exserted,free,glabrate,glabrou,growing,horizontal,inserted,larger,lon,long-triangular,lower,m.,monochasial,near,nflorescence,older,overtopping,pair,papillo,parallel,per,perhaps,pericarp,planar,plurifoliate,pore,poricidal,portion,prominent,raised,ruit,secondary,see,shade,shoot,sleeve,slit-like,soon,specimen,stamen,strongly,tall,thin,time,tip,tub,tube,ud,unit,upon,upper,vein,wide,winged,x,ympodial,young	abaxial,adaxial,arrangement,bud,cell,center,colour,form,height,history,inflorescence,life,na,new,number,papillose,peduncle,perennial,position,rachi,reproduction,seed,shape,spacing,staman,texture,width
550	wfo-0001029945	success	211	98	71	140	27	0.336	0-0.6,1-1.3,1.3-3.5,1.5-4,10-17,15-24,2.1-3.3,3-9,4-5.5,4-9,6-10,9-10,abaxial,acicular,acute,adaxial,adaxially,anther,apex,broad-based,broadly,calyx,chartaceous,cm,cylindrical,dark,deeply,densely,diameter,extra-axillary,filament,flower,fruit,fruiting,glabrous,globose,green,inflorescence,leaf,length,lobed,longer,margin,mm,ovate,pale,pedicel,peduncle,perennial,petiole,plant,prickle,pseudo-racemose,purple,rhizomatous,rotate,shallowly,shrub,simple,stellate-pubescent,stem,stigma,straight,streak,style,surface,time,white,wide,yellow,yellowish	%,.05,0,0-0.3,0-0.5,0-1,0-10,0-2,0.15-0.25,0.2-0.3,0.35-0.45,0.4-0.5,0.4-0.7,0.5,0.7-1.2,0.8-1,1-1.5,1-3,1-8,1.2-1.6,1.4-2.7,1.7-4,1.8-2.4,17-26,2-30,2-4,2-5,2-locular,2.5-2.8,3-17,3-5,3-6,4-10,4-7,5-8,5-merou,5.5-17,6-7,6-8,7-14,7-24,7-9,9-24,abaxially,absen,absent,accrescent,across,adaxiall,adult,alyx,andromonoecious,anvil-shape,apart,armed,articulated,attenuate,ba,base,blade,connivent,cordate,cross-section,d.,directed,distall,distally,dult,eaf,eed,eglandular,erect,exocarp,finger,functional,geminate,gland-tipped,grey,hair,half,heterostylous,hig,index,juicy,juvenile,lanceolate,lateral,less,lobe,lobing,lon,long,lower,markedly,mature,mesocarp,mid-point,midpoint,midvein,minute,mixed,moist,nflorescence,oblique,obtuse,orolla,pair,part,per,placenta,pore,porrect,present,ray,ruit,sessile,short,side,sparsely,stalk,stalked,stellae,stellate,tamen,thick,thicker,throughout,transparent,triangular,truncat,tube,unarmed,unbranched,unit,upper,vary,vein,weakly,x,ympodial	arrangement,bark,bud,cell,center,colour,corolla,form,growth,height,history,life,na,new,number,ovary,position,reproduction,scar,seed,shape,spacing,staman,texture,trichome,truncate,width
551	wfo-0001029968	success	299	117	94	205	23	0.314	0.1-0.25,0.25-0.3,0.4,0.7-2,0.8-1.2,1.5-2.5,1.5-3,1/4-1/3,2.5-3.5,4,4-8,6-8,acuminate,anther,apex,apically,bark,berry,black,branched,brown,calyx,capitate,chartaceous,clavate,clustered,cm,corolla,cupular,curved,dark,deltoid,densely,diameter,dilated,drying,entire,fasciculate,filament,finely,flattened,flattened-reniform,flower,fruit,fruiting,glabrous,gray,grey-green,greyish,inflorescence,inside,lateral,leaf,length,margin,mixture,mm,obconical,oblong,orange,orange-brown,outside,ovate,ovoid,pale,paler,pedicel,peduncle,petiole,pitted,porrect,prickle,pubescent,rachi,red,reddish,rounded,seed,shiny,shrub,smooth,spheroidal,stellate,stellate-pubescent,stem,stigma,straight,style,surface,terete,terminal,translucent,trichome,x	-2,-3,.2,.25,.5,.7,/3,0,0.15,0.2-0.4,0.25,0.3,0.3-0.4,0.3-1,0.4-0.6,0.5,0.7-0.9,0.7-1,0°,1,1-2.5,1-3,1.2-5.5,1.5,1/6-1/8,2-2.3,2-3,2.5-4,2.5-5.5,2.8-3,3-11,3-4,4-6,4-7,4-merou,7-9,abaxially,absent,accrescent,acicular,acute,adaxially,adjacent,age,almost,along,alternate,alyx,anthesi,apart,apparently,area,arising,armed,articulated,articulation,basally,base,becoming,brachyblast,branch,branching,ca,canaliculate,central,cordate,covered,cuneate,dehiscence,detaching,development,discolorous,distributed,divided,dry,eaf,early,edge,eed,ellipsoi,elongating,equal,erect,evenly,except,extending,filiform,flat,flexuous,forming,free,glabrescent,increasing,indumentum,invisible,irregular,irregularly,large,large-leaved,leave,leaved,lengt,lengthening,less,like,line,lobe,lobed,lobing,long,looping,lower,m.,main,mature,maturity,middle,midpoint,midvein,minor,network,nflorescence,nther,oblique,obscured,obscurely,occasionally,often,opposite,orolla,pair,papillose,patch,pendulous,per,perfect,pericarp,pit,plurifoliat,pore,poricidal,portion,present,primary,prior,prominent,protruding,raised,ray,reduced,regular,remnant,ridged,rounded-undulate,ruit,scar,secondary,seemingly,seen,sessile,shoot,shorter,simple,sinus,size,small,small-leaved,smoot,sometimes,somewhat,sparse,sparsely,specimen,spreading,stalk,stalked,strongly,stump,tapering,tearing,tertiary,thicker,thin,tip,toward,tube,ud,unarme,unarmed,undulate,uneven,unit,usually,variable,vary,vein,venation,virtually,visible,white,wide,widening,wrinkled,ympodial,young	2.2,abaxial,adaxial,arrangement,bud,colour,ellipsoid,form,growth,height,history,life,na,number,ovary,plant,position,reproduction,shape,spacing,staman,texture,width
552	wfo-0001029978	success	208	96	69	139	27	0.332	0.5-0.6,1-10,1-2,1.5-3.1,11-19,15-27,3.2-2.5,3.7-8.1,4-7,4.2-5.2,5,8-10,abaxially,adaxially,anther,apex,cell,chartaceous,clavate,cm,coarsely,conical,corolla,covering,dark,diameter,elliptic,filament,finely,flower,forked,fruit,glabrous,green,greenish,hair-like,herb,lateral,leaf,light,medium,membranous,minute,minutely,mm,moniliform,odd-pinnate,ovate,ovoid,pedicel,peduncle,pentagonal,petiole,plant,puberulent,pubescent,purple,rotate,seed,sparsely,stigma,style,terminal,testal,thick,tuber,wall,whitish,yellow	0.3-0.4,0.3-0.7,0.7-1.9,0.8,0.9-2.3,1.3-1.5,1.4-1.5,1.8-5,2-4,3-5,3-7,3.1-6.3,3.5-9.5,4-11,5-16.5,5-merou,acumen,acuminate,ag,along,alyx,apart,apparently,arranged,articulated,asymmetrical,attenuate,axe,axillary,base,basiscopic,bead,berry,blade,brownish,bud,capitat,ciliate,commonly,condition,connivent,darker,decreasing,digestion,distal,dorsally,drying,eaf,edge,eed,enzyme,erec,especially,exceeding,flat,folded,fourt,fresh,geminat,generally,glabrou,gradually,green-white,hair,half,homostylous,honeycomb-shaped,interjected,lanceolate,larger,leaflet,lengthening,less,like,living,lobe,long,lower,make,margin,middle,midrib,mottled,mucilaginous,multiple,narrow,necklace,nflorescence,orbicular,orolla,pair,perfect,petiolule,plurifoliate,pore,poricidal,pubescen,ray,removed,ripe,ruit,secondary,semierect,sessile,seudostipule,side,simple,size,slightly,slit,spaced,specimen,stamen,ste,stem,stolon,straight,subequal,subsessile,subtending,symmetrical,tall,tamen,tem,throughout,tip,tissue,toward,tri-,tube,typically,unit,usually,vary,wet,wide,wing,x,ympodial	abaxial,adaxial,arrangement,capitate,colour,form,growth,height,history,inflorescence,length,life,na,number,ovary,perennial,position,pseudostipule,rachi,reproduction,shape,spacing,staman,surface,texture,trichome,width
553	wfo-0001029980	invalid_json_followup	173	116	78	95	38	0.451	.1,.5,0.1-0.25,0.5-1.2,0.5-2.5,0.5-5,0.7-1.3,1.2-2.5,2-5,2/3,acute,anther,apex,appressed,axil,bark,base,bright,brown,bud,calyx,cm,corolla,curved,dark,elliptic,filament,flattened-reniform,fruiting,glabrous,globose,gray,green,greenish-white,lateral,leaf,lobed,long,main,margin,minutely,mm,one,opposite,ovary,ovate,pale,papillose,pedicel,petiole,pitted,plant,rounded,scar,shape,shiny,shrub,side,simple,slender,slightly,small-capitate,stem,stigma,straight,style,surface,tan,tapering,trichome,tube,tuft,unicellular,uniseriate,vein,way,white,winged	0.25-0.5,0.25-1,0.5-1,0.8-1.2,0.9-4.5,1-1.5,1-1.7,1.5-2,1.5-6,2-6,3-4,3-9,5-10,5-50-flowered,6.4-17,abaxially,adaxially,anthesi,apar,appearing,ba,berry,black,closely,conical,decurrent,deflexed,deltoid,density,dia,differing,difoliate,dried,drying,eaf,edicel,eed,elevation,especially,exserted,five,free,geminat,greatly,high,impressed,incrassate,knob,live,lobe,lon,lower,major,material,middle,minor,near,nflorescence,node,often,older,onto,orbicular,overlapping,pair,paler,pore,poricidal,portion,prominent,proximal,puberulent,race,reflexed,ruit,shaped,size,somewhat,soon,spaced,specimen,tall,tear-drop,tip,ud,unit,varying,venezuelan,whit,widest,woody,x,yellowish,ympodial,young	'',5-50,[,``,abaxial,adaxial,apart,arrangement,center,characteristic,colour,diameter,flower,form,fruit,growth,height,history,inflorescence,length,life,na,new,number,peduncle,perennial,position,prickle,rachi,reproduction,seed,spacing,staman,texture,value,width,{,}
554	wfo-0001029989	success	161	102	67	94	35	0.416	0.5-1,0.5-1.5,1-1.5,1-2.5,3-5,3-8,abaxial,abaxially,acute,adaxially,anther,apex,bark,base,calyx,capitate,closely,cm,congested,conical,corolla,dendritic,densely,difoliate,elliptic,filament,flattened,fruiting,glabrous,globose,gray,green,greenish-black,incrassate,inflorescence,internodal,leaf,lenticular,lobed,margin,minutely,mm,nearly,nodding,opposite,ovary,pedicel,petiole,pitted,pubescent,reddish-brown,scar,shining,shrub,simple,small,spaced,sparsely,stem,stigma,style,surface,tree,tree-like,trichome,unifoliate,white	.2,.5,/2,0.25-0.5,1-2,1-4,1.3-2.3,1.5-2.5,10-14,2.5-3,3.5-8,4-4.5,5-10-flowered,5-6,7-20,anthesi,berry,branch,branched,broadly,brownish-re,central,collection,deflexed,deltoid,dense,described,dia,dimaeter,discussion,drying,due,eaf,edicel,eed,erect,exserted,fleshy,free,geminat,golden,heteromorphic,inflorescenc,lamina,lateral,like,lobe,lon,long,lower,main,middle,nflorescence,northern,occasionally,older,overlappin,pair,papillo,peru,peruvian,perú,petal,petaloid,planar,population,pore,poricidal,portion,probably,pubescence,reddish,rest,ruit,scattered,see,shaped,short-style,somewhat,tall,tear-drop,tip,tube,ud,unit,vein,way,wide,widest,woody,x,yellow,ympodial,young	0.2,2.5-6,5-10,adaxial,arrangement,brownish-red,bud,cell,center,colour,diameter,flower,form,fruit,growth,height,history,length,life,na,new,number,overlapping,peduncle,perennial,plant,position,rachi,reproduction,seed,shape,spacing,staman,texture,width
555	wfo-0001030000	success	155	131	101	54	30	0.652	-4,0.5-1,0.5-14,0.5-3,1,1-10,1-2,1.5-,1.5-2,15-25,2-2.5,2-5,3-16,3-4,3.5-5,30-50,4-5,abaxially,absent,acute,adaxially,also,apart,apex,apiculate,articulated,base,calyx,chartaceous,cm,connective,connivent,conspicuous,coriaceous,deltate,densely,dia,diameter,dilated,distally,eglandular,ellipsoidal,equal,exceeding,flattened,flower,fruit,glabrous,globose,green,hair,immature,leaving,lobe,long,mature,mm,moderately,oblong,obtuse,occasionally,orange,ovoid,pedicel,pedicellar,peduncle,pilose,produced,puberulent,pubescent,purplish,rachi,radiu,rarely,remnant,scar,shorter,shrub,slightly,small,sparsely,spotted,stellate,stigma,strongly,style,subcoriaceous,swelling,thecae,tinge,tip,tree,truncate,umbrella-shaped,unbranched,white,wide,x,yellow,yellow-brown,yellowish	-5,-50,-7,-pilose,0.5-,1-,10-,10-20,2-3,2-4,2.5-,2.5-3,2.5-3.5,25-30,3-,4,4-4.5,4-foliat,7-15,aggregate,ape,axe,biglandula,cell,ciliat,creamy-whit,cucullate,directed,eed,laterally,lon,lower,margin,narrowly,nflorescence,nther,orolla,perfect,pore,pubescen,ruit,smal,spaced,stamen,stone,tal,tem,tomentose,triangular,tube,ud,unit,vary,ympodial	4-foliate,anther,arrangement,biglandular,bud,colour,corolla,creamy-white,form,growth,height,history,inflorescence,leaf,length,life,na,number,ovary,plant,reproduction,seed,shape,spacing,stem,surface,texture,theca,trichome,width
556	wfo-0001030000	invalid_json_followup	178	123	79	99	44	0.444	-4,-pilose,0.5-1,0.5-13,0.5-14,0.5-3,1,1-10,1.5-,1.5-2,15-25,2-2.5,3-16,30-50,4-5,abaxially,acuminate,acute,adaxially,also,apart,apex,articulated,base,calyx,cm,conspicuous,densely,dia,diameter,ellipsoidal,entire,flattened,flower,fruit,glabrescent,glabrous,globose,green,immature,leaving,long,margin,mature,mm,moderately,occasionally,orange,ovate,ovoid,pedicel,pedicellar,peduncle,petiole,pilose,puberulent,pubescent,purplish,rachi,remnant,scar,shrub,simple,small,sparsely,spotted,stellate,stigma,style,tinge,tree,truncate,unbranched,vein,white,x,yellow,yellow-brown,yellowish	-2,-5,-50,-7,0.5-,1-,1-1.5,1-2,1-5,10-,10-20,2-,2-3,2-4,2-5,2.5-,2.5-3,2.5-3.5,25-30,3-,3-4,3.5-5,4,4-25,4-4.5,4-foliat,5-25,7-15,absent,aggregate,ape,apiculate,axe,basal,biglandula,blade,cell,chartaceous,ciliat,connective,connivent,cordate,coriaceous,creamy-whit,cucullate,deltate,dilated,directed,distally,eaf,eed,eglandular,elliptic,equal,exceeding,hair,laterally,lobe,lon,lower,narrowly,nflorescence,nther,oblique,oblong,obtuse,often,orolla,perfect,pilo,pore,produced,pubescen,radiu,rarely,ruit,shorter,slightly,smal,spaced,stamen,stone,strongly,subcoriaceous,swelling,tal,tem,thecae,time,tip,tomentose,triangular,tube,ud,umbrella-shaped,unit,vary,wide,ympodial	'',[,``,abaxial,adaxial,anther,arrangement,bark,biglandular,bud,center,characteristic,colour,corolla,filament,form,fruiting,growth,height,history,inflorescence,leaf,length,life,na,new,number,ovary,plant,position,prickle,reproduction,seed,shape,spacing,staman,stem,surface,texture,trichome,value,width,{,}
557	wfo-0001030004	invalid_json_followup	177	127	88	89	39	0.497	0-0.5,0-1.5,0.2-1,1-2,1.2-2,1.5-2.5,2-20,3-4,5-25,abaxial,acuminate,acute,adaxially,along,anther,bark,base,broadly,calyx,capitate,cm,conical,corolla,crotaloid,dendritic,dense,densely,elliptic,erect,exserted,filament,flat,flattened-reniform,fleshy,fruiting,glabrous,globose,green,hard,inflorescence,later,lateral,leaf,lobed,margin,minutely,mm,nearly,obovate,obovoid,occasionally,onto,ovary,pale,papillate,pedicel,petiole,pitted,plant,plurifoliate,pubescent,scar,seed,shrub,small,spaced,sparsely,stem,stigma,stout,strongly,style,surface,tan,terminal,thick,translucent,tree,trichome,tube,unevenly,variously,vein,white,winged,woody,yellowish,yellowish-green	.3,0.3-1,0.8-1.1,1-1.5,15,15-20,20-200-flowered,3-3.5,3.5-5,4-15,9-30,abaxially,across,always,anthesi,apar,apex,appearanc,axillary,barely,basal,berry,blade,body,branched,branching,bushy,collection,cone,decurrent,deltate,denser,dia,diamete,distal,drying,eaf,edicel,eed,especially,free,giving,greenish-yello,incrassate,juvenile,knob,lamina,large,like,lobe,long,loose,lower,main,many,middle,much,nflorescence,often,older,pair,papillo,pericarp,planar,pore,poricidal,portion,possessing,prominent,pubescence,rest,ruit,sessile,shaped,simple,surpassing,tall,tear-drop,thin,time,tip,tub,tuft,ud,wide,widest,x,ympodia,young	'',20-200,[,``,adaxial,apart,arrangement,bud,cell,center,characteristic,colour,diameter,flower,form,fruit,greenish-yellow,growth,height,history,length,life,na,new,number,peduncle,perennial,position,prickle,rachi,reproduction,shape,spacing,staman,texture,value,width,{,}
558	wfo-0001030007	invalid_json_followup	168	117	77	91	40	0.458	.4,.5,0.2-1,0.8-1,1-1.5,1-15,1-2,1.6-2.2,2-4,3/4,4.5-5,6-10-flowered,7-9,acute,along,anther,apart,apex,bark,base,beneath,branched,brown,bud,calyx,campanulate,clavate,cm,corolla,decurrent,densely,elliptic,filament,flattened,fleshy,fruiting,glabrous,globose,green,leaf,lobed,long,margin,midrib,minutely,mm,occasionally,opposite,ovary,pale,pedicel,petiole,pitted,plant,pubescent,raised,reniform,scar,shrub,simple,slender,small,soft,sparsely,stem,stigma,style,surface,tapering,thick,tree,trichome,uniseriate,way,white,winged,x	.05,0.1-0.5,0.5-1,1.5-5,15-20,2-7,3-5,7-10,abrupt,acuminate,anthesi,ba,becoming,berry,broadly,closely,cork,dark,deltoid,dia,difoliate,dry,edicel,eed,erect,exserted,free,geminateleaf,glabrate,golden,golden-pubescent,gre,hooded,impressed,incrassate,inflorescenc,lateral,like,live,lobe,lon,longer,lower,main,major,material,middle,minor,nflorescence,oblique,obovoid,older,one,onto,outline,pair,papillo,papillose,planar,pore,poricidal,portion,prominent,rest,rounded,ruit,shaped,short,shorter,slightly,soon,spaced,specimen,straight,tall,tear-drop,thickened,tip,trunk,tub,tube,two,type,ud,unit,vein,widening,widest,woody,ympodial,young	'',[,``,abaxial,adaxial,arrangement,cell,center,characteristic,colour,corky,diameter,flower,form,fruit,grey,growth,height,history,inflorescence,length,life,na,new,number,peduncle,perennial,position,prickle,rachi,reproduction,seed,shape,spacing,staman,texture,value,width,{,}
559	wfo-0001030010	success	156	98	65	91	33	0.417	0.5-5,0.9-1.1,1-1.5,1.2-1.5,1.5-2,2-2.2,2-7,4-4.5,5-7,acuminate,acute,anther,apex,bark,brown,bud,calyx,closely,cm,corolla,dark,deflexed,filament,fleshy,fruit,fruiting,furcate,glabrous,globose,green,grey,leaf,lobed,minutely,mm,nearly,obovate,opposite,ovary,ovoid-reniform,papillose,pedicel,persistent,petiole,pitted,puberulent,reddish,scar,shrub,simple,slightly,small,smooth,spaced,stem,stigma,style,surface,tiny,tree,trichome,white,winged,woody,x	.5,.75,/4,0.7-1,1-1.3,1-2,10-15,10-50-flowered,11-12,2.5,20-40,3-5,7-10,anthesi,appearing,area,attenuate,basal,base,beneath,berry,cyathiform,deciduous,decurrent,deltate,dia,differing,difoliate,distal,dry,eaf,edicel,eed,ellipsoid,exserted,f,free,geminat,glabrate,hooded,lateral,lobe,lon,long,lower,m.,main,major,margin,materia,material,middle,midrib,minor,minute,near,nflorescence,occasionally,often,older,one,orange,overlappin,pair,planar,pore,poricidal,portion,prominent,rather,ruit,shaped,shin,size,soon,straight,styl,tall,tapering,tear-drop,tip,trunk,tube,ud,uniseriate,unit,vein,way,widest,ympodial,young	10-50,abaxial,adaxial,alternate,arrangement,cell,center,colour,diameter,flower,form,growth,height,history,inflorescence,length,life,na,new,number,peduncle,perennial,plant,position,rachi,reproduction,seed,shape,shiny,spacing,staman,texture,width
560	wfo-0001030023	invalid_json_followup	171	102	54	117	48	0.316	1-8,1.5-7,10-25,11-40+,2.5-3.5,30-50+,4-10,4-12,6-7,7-9,abaxially,acute,adaxially,apex,calyx,cell,cm,diameter,ellipsoidal,elliptic,entire,especially,finely,flattened,flower,fruit,glabrous,glandular-puberulent,globose,greenish-white,lanceolate,margin,mm,moderately,ovate,pedicel,peduncle,peltiform,petiole,puberulent,pubescent,purplish-,rachi,short-acuminate,simple,sparsely,stellate,stigma,style,tree,unknown,villous,yellowish,young	-,0-100+,0.5-1,1,1-,1-2,1.5-2,10-,12-18,13-20,2,2-3,20-30,3-4.5,3-5,4,4-foliat,5,5-,5-16,5-6,6-26,aggregate,apart,ape,apiculate,articulated,axe,basal,base,beyond,blade,branched,capitat,ciliate,color,connective,connivent,cordate,cuneate,cylindrical,deeply,densely,denser,dilated,directed,distally,eaf,eed,exceeding,except,exserted,fleshy,forked,glandular-puberulen,hair,highly,leaving,lobe,lon,long,loosely,lower,main,membranaceous,narrow,narrowly,near,nflorescence,nther,oblique,oblong,obtuse,occasionally,often,orolla,pedicellar,perfect,pore,presen,present,probably,prominent,pubescen,pubescence,pubescent-pilo,radiu,remnant,ripe,ruit,shorter,slightly,small,somewhat,spaced,stamen,stone,subcoriaceous,swelling,tal,tem,thecae,time,tip,triangular,truncate,tube,ud,unbranched,unit,unknow,usually,vary,vein,wide,x,ympodial	'',50-100+,[,``,abaxial,adaxial,anther,arrangement,bark,bud,capitate,center,characteristic,colour,corolla,filament,form,fruiting,growth,height,history,inflorescence,leaf,length,life,na,new,number,ovary,perennial,plant,position,prickle,pubescent-pilose,reproduction,scar,seed,shape,spacing,staman,stem,surface,texture,trichome,value,width,{,}
561	wfo-0001030032	invalid_json_followup	250	112	78	172	34	0.312	+,0.5-0.6,0.5-2,1-1.3,1-1.5,1.5-2,2-3-locular,2-4,2-60,2.4-3.5,3.5-12,30,8-10,8-20,abaxially,adaxial,anther,apex,articulated,branched,bright,brown,calyx,capitate,cell,cm,conical,corolla,densely,diameter,elliptic,entire,filament,flower,fruit,fruiting,glabrous,golden,green,hair-like,imparipinnate,interrupted,lateral,leaf,length,like,many,margin,middle,mm,oblanceolate,obovate,orbicular,outgrowth,ovary,pale,paler,pedicel,peduncle,petiole,pubescent,rotate,rotate-stellate,seed,simple,soft,stem,stigma,style,surface,testa,time,trichome,uniseriate,vine,wall,woody,yellow	.05,.5,0.1-0.4,0.1-0.5,0.2,0.2-0.3,0.2-0.5,0.25-0.4,0.4-1.5,0.5,0.5-0.7,0.5-1,0.5-1.5,0.6-1.1,0.7-0.8,0.8-1.0,0.8-1.1,1-2-celled,1-3,1-celled,1.5-2.5,11-20,13-35,2,2-10,2-3.5,2-5,2-lobed,3,3-5,3.0-3.5,4-5,4-6-celled,4-celled,4.3-5.0,5-plurifoliate,6-11,60-80,7-16,7.5-10,8-10-celled,absent,abundant,acuminate,acute,adaxially,along,also,anthesi,apical,appearance,appendage,articulation,basal,basally,base,basiscopically,bent,border,branche,breaking,clambering,column,completely,conspicuou,dark,decurrent,deltate,densest,desne,dry,eaf,ebracteate,edicel,eed,exserted,free,give,glandular,gree,greenish-brown,halfway,hea,head,herbarium,interjected,internode,irregularly,lamina,large,larger,leaflet,leave,lobe,long,longest,lower,markedly,midvein,mixed,moderately,much,multicellular,nflorescence,node,oblique,occasionally,often,older,onto,opposite,pair,patent,petiolule,pithy,present,primary,pseudostipule,pubescence,rachi,reflexed,rest,rough,round,ruit,secondary,set,shorter,silky,slightly,smaller,sometimes,somewhat,sparsely,sparser,specimen,splitting,spreading,stamen,staminal,sterile,straight,subopposite,swollen,tall,tangled,tem,terminal,tertiary,thick,thickened,tiny,tip,touch,transparent,truncate,tube,ud,unicellular,unit,usually,vegetatio,vein,venation,weaker-walled,well-developed,white,wide,winged,ympodial,younger,½-3/4	'',[,``,abaxial,arrangement,bark,bud,center,characteristic,colour,dense,form,growth,height,history,inflorescence,life,na,new,number,perennial,plant,position,prickle,reproduction,scar,shape,spacing,staman,texture,value,width,{,}
562	wfo-0001030048	invalid_json_followup	156	116	74	82	42	0.474	.5,0.5-1.5,1.2-2,1.3-1.6,2-3,2-5,3-5,5-8,abaxial,abaxially,acute,adaxially,along,anther,apex,apically,arachnoid,bark,base,bi-lobed,blue,calyx,clavate,closely,cm,conical,corolla,densely,elliptic,felt-like,filament,fruiting,glabrate,glabrous,globose,green,greyish,internodal,leaf,lightly,lobed,main,margin,matted,minutely,mm,nearly,opposite,ovary,ovoid-reniform,pale,pedicel,petiole,pitted,pointed,pubescent,reddish-brown,scar,shiny,shrub,simple,small,spaced,sparsely,stem,stigma,style,surface,tan,tree,trichome,vein,white,yellowish	1-1.5,1-2,1.5-3.5,1.5-7,10-16,3-3.5,4-15,4-4.5,5-10-flowered,5973,anthesi,ape,apparently,becoming,berry,bi-colored,broadly,brown,completely,covered,decurrent,deflexed,deltate,dia,difoliate,drying,eaf,edicel,eed,ellipsoid,exserted,fide,fleshy,four-angle,free,geminat,golden,impressed,inflorescenc,lamina,lateral,like,lobe,lon,long,lower,middle,nflorescence,occasionally,older,onto,overlappin,pair,papillo,papillose,planar,pore,poricidal,portion,prominent,rather,rest,ruit,shaped,solomon,somewhat,strongly,tall,tear-drop,thick,thickened,tip,trifoliate,tub,tube,ud,unit,wide,widest,woody,ympodial,young	'',5-10,[,``,adaxial,arrangement,bud,center,characteristic,colour,diameter,flower,form,four-angled,fruit,geminate,growth,height,history,inflorescence,length,life,na,new,number,overlapping,peduncle,perennial,plant,position,prickle,rachi,reproduction,seed,shape,spacing,staman,texture,value,width,{,}
563	wfo-0001030053	invalid_json_followup	141	104	62	79	42	0.44	0.5-1,1-1.3,1-13,1.3-3.5,1.8-2,100,2-2.5,5,abruptly,acuminate,acute,apart,apex,apical,branch,branched,brown,calyx,cell,cm,corolla,cyathiform,diameter,elliptic,entire,filiform,flattened,flower,fruiting,glabrous,greenish,growth,inflorescence,irregularly,many,margin,minutely,mm,near,new,nipple,pale,pedicel,peduncle,petiole,pitted,reniform,revolute,scar,shiny,simple,spaced,stem,surface,terminal,time,tip,turbinate,vine,white,woody,yellowish	0.5,1.5-5.5,10-20,2.5-3,3.5-4,4-,5-merou,7-11,7-9,<,abscission,aiding,alyx,anthesi,apiculae,ark,around,articulated,base,berry,bfeore,climbin,completely,coriaceous,decurrent,eaf,eed,exserted,far,fide,fine,fragrant,frui,hyaline,leaving,lobe,lobed,long,lower,mentz,nflorescence,older,orolla,pair,papilla,papillo,parallel,peg,pendant,per,perfect,plurifoliat,primary,rectangular,rim,secondary,shallowly,shin,shining,sleeve,slightly,small,spreadin,spreading,strongly,support,tem,testal,tiny,truncate,tube,twining,ud,unit,usually,vein,venation,x,ympodial	'',5-merous,[,``,abaxial,adaxial,anther,arrangement,bark,bud,center,characteristic,colour,filament,form,fruit,height,history,leaf,length,life,na,number,ovary,papillose,plant,position,prickle,rachi,reproduction,seed,shape,spacing,staman,stigma,style,texture,trichome,value,width,{,}
564	wfo-0001030057	success	141	75	36	105	39	0.255	1-10,2-4,2-4.5,2-6,20-30,20-80,4-10,apex,bud,cell,cm,diameter,elliptic,flower,forked,fruit,globose,green,greenish,herb,leaf,mm,mucilaginous,odd-pinnate,ovate,ovoid,pedicel,peduncle,petiole,plant,pubescent,seed,stem,subglabrous,terminal,whitish	-2,1-2,2-3-celled,2.1-4.1,3-5,3.5-8,4.3-8.2,5.5-12,7-14,8,8-19,abaxially,absent,acuminate,acute,adaxially,apart,apparently,articulated,axe,axillary,base,berry,blade,borne,broadly,brownish,chartaceous,condition,cordate,covering,cuneate,decreasing,digestion,distal,drying,eaf,eed,end,enzyme,erec,extremely,fresh,geminat,generally,glabrou,greatly,green-white,hair,hair-like,half,high,honeycomb-shaped,interjected,larger,lateral,leaflet,like,living,long,lunate,make,membranous,mottled,narrow,nflorescence,pair,perfect,petiolule,plurifoliate,purple,removed,ruit,scale-like,seudostipule,short,singly,size,small,sometimes,spaced,specimen,ste,stolo,suborbicular,subtending,tall,tem,testal,thick,thir,throughout,toward,tri-,truncate,tuber,typically,unit,unwinged,usually,wall,wet,wing,x,ympodial	abaxial,adaxial,anther,arrangement,bark,calyx,center,colour,corolla,filament,form,fruiting,glabrous,growth,height,history,inflorescence,length,life,margin,na,new,number,ovary,perennial,position,prickle,rachi,reproduction,scar,shape,spacing,staman,stigma,style,surface,texture,trichome,width
565	wfo-0001030057	invalid_json_followup	197	102	62	135	40	0.315	-10,.5-3.5,1-10,2-4,2-4.5,2-6,20-30,20-80,4-10,5-6,8,abaxially,adaxially,anther,apex,bud,cell,cm,corolla,covering,diameter,elliptic,filament,flower,forked,fruit,glabrous,globose,green,greenish,herb,lateral,leaf,lunate,margin,minutely,mm,odd-pinnate,ovate,ovoid,pedicel,peduncle,pentagonal,petiole,plant,puberulent,pubescent,rotate,scale-like,seed,stem,stigma,style,subglabrous,terminal,testal,thick,tuber,wall,white,whitish,yellow	-2,1-2,2-3,2-3-celled,2-5,2.1-4.1,3-5,3.5-8,4.3-8.2,5-10,5-merou,5.5-12,7-14,8-19,absent,acumen,acuminate,acute,ag,along,alyx,apart,apparently,articulated,axe,axillary,base,berry,blade,borne,broadly,brownish,chartaceous,ciliate,condition,connivent,cordate,cuneate,decreasing,digestion,distal,dorsally,drying,eaf,edge,eed,end,enzyme,erec,especially,exceeding,extremely,flat,folded,fresh,geminat,generally,glabrou,globo,greatly,green-white,greenish-yellow,hair,hair-like,half,high,homostylous,honeycomb-shaped,interjected,lanceolate,larger,leaflet,lengthening,like,linear,living,lobe,long,lower,make,membranous,middle,midrib,mottled,mucilaginous,narrow,nflorescence,orolla,ovate-lanceolate,pair,perfect,petal,petiolule,plurifoliate,pore,poricidal,purple,removed,ruit,seudostipule,short,singly,size,slit,small,sometimes,spaced,specimen,stamen,star,ste,stolo,straight,striped,suborbicular,subtending,tall,tamen,tem,thir,throughout,tip,toward,tri-,truncate,tube,typically,unit,unwinged,usually,vary,wet,wing,x,ympodial	'',[,\u201chair-like\u201d,``,abaxial,adaxial,arrangement,bark,calyx,characteristic,colour,form,fruiting,growth,height,history,inflorescence,length,life,na,new,number,ovary,perennial,position,prickle,pseudostipule,rachi,reproduction,scar,shape,spacing,staman,surface,texture,trichome,value,width,{,}
566	wfo-0001030067	success	206	93	61	145	32	0.296	.5,0-1,0-1.5,0.1-0.3,0.2-1,0.5-13,2-2.5,2.5-7,3.5-5.5,7-8,8-11,acicular,anther,black,broadly,brown,calyx,chartaceous,cm,cylindrical,densely,depressed-globose,diameter,extra-axillary,filament,fruit,fruiting,glabrous,globose,green,grey,herbaceous,inflorescence,length,longer,margin,mm,orbicular,ovate,pedicel,peduncle,perennial,petiole,prickle,purple,rachi,recurved,resprouter,rhizomatous,rotate,shrub,simple,stellate-pubescent,stem,stigma,style,time,undulate,white,wide,yellow	%,.05,0-0.1,0-0.2,0-0.7,0-2,0-30,0.1-0.25,0.1-0.5,0.15-0.3,0.2-0.35,0.2-0.4,0.3-0.4,0.3-0.8,0.4-1.1,0.5-0.8,0.6-0.9,0.7-1.3,0.8-1.4,0.9-2.8,1-3,1-6,1-7,10-16,12-16,13-15,2-3,2-foliate,2.5-3.5,3-8,3.6-5.3,4.5-6,5-merou,6-18,9-18,?,abaxially,absen,absent,abundant,accrescent,adaxiall,adaxially,alyx,apart,apex,armed,articulated,axe,ba,basal,base,blade,broad,capitat,coating,connivent,cordate,decimetr,deltate,directed,distall,distinct,distributed,dult,eaf,eed,eglandular,entire,equal,erect,finger,flower,frequently,functional,geminat,gland-tipped,hair,half,homostylous,interpetalar,juic,lamina,lateral,less,lobe,long,loosely,lower,mature,mesocarp,mid-point,midpoint,midvein,minute,moderately,moist,multiradiate,nflorescence,oblique,obscure,obscured,obtuse,often,orolla,ovate-oblong,part,per,perfect,petal,pore,porrect,present,probably,pseudo-racemose,pubescent,ray,resinous,ruit,sessile,shallow,short,slightly,spaced,stage,stalk,stellae,straight,tal,tamen,thick,thickened,throughout,tip,tissue,triangular,tube,unarmed,unbranched,unit,unknow,uvenile,vary,x,ympodial	abaxial,adaxial,arrangement,bark,bud,capitate,cell,center,colour,corolla,form,growth,height,history,leaf,life,na,new,ovary,plant,position,pseudoracemose,reproduction,scar,seed,shape,staman,surface,texture,trichome,unknown,width
567	wfo-0001030080	success	186	83	58	128	25	0.312	0.4-1.5,0.5-4,1-2,1.5-2.5,2.1-7.1,3-10,3-5,4-12,5-13.5,5-7,8-16,8-23,anther,apex,clavate,cm,coriaceous,corolla,dark,diameter,elliptic,filament,flower,forked,fruit,glabrous,green,green-white,greenish,herb,honeycomb-shaped,leaf,light,mm,moniliform,mucilaginous,odd-pinnate,ovate,ovoid,pedicel,peduncle,petiole,plant,purple,pyriform,rachi,seed,stellate,stigma,stolon,style,terminal,throughout,tuber,white,whitish,width,yellow	0.3-7,1-3,1.5-2,1.8-4.5,1999,2-3,2-4,3.3-7.7,4-7,5-merou,5.5-9.9,6.5-18.6,9.9-33,abaxiall,abaxially,absent,acumen,acuminate,adaxially,ag,along,alyx,apart,apparently,arranged,articulated,axe,axillary,base,bead,berry,blade,brownish,bud,capitat,ccording,cell,condition,connivent,covering,cuneate,decreasing,decurrent,digestion,distal,dorsally,dot,drying,eaf,edge,eed,enzyme,erec,exceeding,flat,folded,fresh,geminat,generally,glabrescent,glabrou,hair,hair-like,hal,half,high,homostylous,inconspicuous,interjected,lanceolate,larger,lateral,leaflet,lengthening,like,linear,living,lobe,long,lower,make,medium,mottled,multiple,necklace,nflorescence,ochoa,onto,orolla,pair,perfect,plurifoliate,pore,poricidal,removed,second,seudostipule,size,slightly,slit,sometimes,spaced,specimen,stamen,straight,strongly,subequal,subtending,tall,tamen,tem,testal,thick,tiny,tip,toward,tri-,tube,typically,unit,unknown,usually,vary,wall,wet,winged,x,ympodial	abaxial,adaxial,arrangement,capitate,center,colour,form,growth,height,history,inflorescence,length,life,na,number,ovary,perennial,position,pseudostipule,reproduction,shape,spacing,staman,surface,texture
568	wfo-0001030081	invalid_json_followup	157	112	71	86	41	0.452	0.5-1,0.5-1.5,0.5-2.5,1,1-4,1-5,1.5-3,10-20,2-foliate,4-6,5-15,absent,acute,along,anther,apex,blade,brown,calyx,cell,center,chartaceous,ciliate,cm,denser,diameter,dm,drying,edge,elliptic,elliptic-ovoid,entire,filament,fine,flat,flower,fruit,glabrous,globose,hair,herb,immature,long,lying,margin,membranaceous,mm,moderately,nearly,parallel,pedicel,peduncle,petiole,pubescent,rachi,radiating,raised,ridge,rotate,running,semitransparent,shallow,sparsely,stigma,style,surface,unbranched,vein,white,x,yellow	.5,0.25-0.5,1-2,1-2-celled,1-3,1.5,1.5-7,10-35,1st,2-4,2-7,2nd,3-10,3-6,5-12,abaxially,abundant,adaxiall,adaxially,apically,axe,base,berry,beyond,connected,cordate,decurrent,dehiscing,densely,eaf,eed,emarginat,equal,explosively,exserted,few-branched,frui,geminat,geniculate,held,interpetalar,linear-lanceolate,lobe,longer,lower,maturing,maturit,mesocarp,nfloresence,notch,oblong,obtuse,often,one,orolla,other,per,placenta,pointing,pressure,pubescen,rarely,rounded,ruit,short,single-,slightly,small,sometimes,stamen,straight,swollen,tal,tamen,tem,tissue,triangular,tube,two-celled,unit,usually,vary,watery,wid,woody,ympodial	'',[,``,abaxial,adaxial,arrangement,bark,bud,characteristic,colour,corolla,form,fruiting,growth,height,history,inflorescence,leaf,length,life,na,new,number,ovary,perennial,plant,position,prickle,reproduction,scar,seed,shape,spacing,staman,stem,texture,trichome,value,width,{,}
569	wfo-0001030083	success	146	100	63	83	37	0.432	0.5-2,0.8-1,0.8-3,1-2,1.5-3,3-4,3/4,4-6,accrescent,anther,apex,bark,base,calyx,closely,cm,corolla,deeply,drying,elliptic,fleshy,flower,fruit,fruiting,glabrous,globose,green,greenish-white,internodal,leaf,lobed,long-acuminate,minutely,mm,narrowly,opposite,ovary,ovate,overlapping,ovoid-reniform,pale,papillose,pedicel,petiole,pitted,scar,shrub,simple,slender,small-capitate,somewhat,spaced,stem,stigma,style,surface,tan,tapering,tube,way,white,winged,woody	.5,.75,0.1,0.25-0.5,0.5-1,1-1.5,10-30,2,2-3,2-5-flowered,4-15,9-11,acute,anthesi,beginning,berry,broadly,cup-shaped,dar,deciduous,decurrent,deflexed,deltoid,dia,dry,eaf,edicel,eed,elongate,exserted,greyish-re,hyaline,inflorescenc,lateral,lobe,lon,long,long-styled,lower,main,membranous,middle,near,nflorescence,older,onto,pair,paler,papillae,pore,poricidal,prominent,proximal,raised,red-papillose,reddish-gold,reflexed,ruit,shallowly,shaped,short-styled,single-stemmed,slightly,soon,specimen,straight,strongly,tall,tear-drop,terminal,thickened,thin,tip,translucent,tub,ud,unifoliat,unit,vein,widest,x,ympodial,young	2-5,abaxial,adaxial,arrangement,bud,cell,center,colour,dark,diameter,filament,form,greyish-red,growth,height,history,inflorescence,length,life,margin,na,new,number,peduncle,perennial,plant,position,rachi,reproduction,seed,shape,spacing,staman,texture,trichome,unifoliate,width
570	wfo-0001030093	invalid_json_followup	181	121	81	100	40	0.448	0.1-0.3,0.2,0.5-1.1,1-1.5,1-12,1-5,2-2.5,4-6,8-9,acuminate,acute,anther,apex,bark,base,beneath,brownish-tan,calyx,campanulate,clavate,cm,corolla,ellipsoid,elliptic,erect,filament,flower,fruiting,furcate,glabrous,globose,golden,green,greenish-white,growth,hirsutulous,leaf,lobed,many,margin,minutely,mm,narrowly,nearly,new,obovate,occasionally,often,opposite,ovary,ovoid-reniform,pale,paler,pedicel,petiole,pitted,plant,puberulent,pubescent,scar,shiny,shrub,simple,slender,slightly,small,stem,stigma,style,surface,tapering,terminal,thickened,time,tree,trichome,tube,uniseriate,vein,white,yellowish	.2,.5,0,0.2-0.5,0.2-1,0.6-1.5,0.75-1,1.3-4.5,2.5-11,3-4,3.5-12,5-50-flowered,5-8,7-30,7-9,anthesi,apar,attenuate,becoming,berry,branched,case,closely,collection,commonly,continues,cuneate,deflexed,deltoid,densely,dia,differing,difoliate,eaf,edicel,eed,especially,evenly,except,expanded,exserted,forest,free,geminat,greyish-brow,guyanese,hyaline,impressed,inundated,lateral,like,lobe,lon,long,long-styled,lower,main,major,member,middle,minor,nflorescence,older,one,onto,open,orbicular,pair,papillo,persisting,population,pore,poricidal,portion,present,quite,reflexed,remaining,ruit,shaped,shoot,short-styled,size,soon,southern,spaced,straight,tall,tear-drop,tiny,tip,tub,ud,underside,unit,widest,woody,x,ympodial,young	'',1.5-4,5-50,[,``,abaxial,adaxial,apart,arrangement,bud,cell,center,characteristic,colour,diameter,form,fruit,greyish-brown,height,history,inflorescence,length,life,na,number,papillose,peduncle,perennial,position,rachi,reproduction,seed,shape,spacing,staman,texture,value,width,{,}
571	wfo-0001030115	invalid_json_followup	192	130	95	97	35	0.495	-100,.2,.5,0.5-0.6,1,1-1.2,1.5-2,1.5-3,12,3-4,3.5-5,30-60,5-10,5-5.5,7,<,abaxially,acuminate,acute,anther,anthesi,apart,apex,bark,berry,calyx,closely,cm,conical,corolla,curved,dark,deep,densely,diameter,echinoid,echinoid-stellate,ellipsoid,elliptic,entire,erect,filament,flower,fruiting,glabrescent,globose,green,growth,inflorescence,irregular,lanceolate-elliptic,leaf,lobed,long,long-styled,margin,minutely,mm,new,ovary,pale,pedicel,peduncle,pentagonal,petiole,planar,prickle,pubescent,purple,reddish,scar,scattered,shallowly,shiny,shrub,simple,slightly,small,somewhat,spaced,stellate,stem,stigma,stout,style,surface,terminal,thin,tree,trichome,undulate,violet,white,x,yellowish	-30,0.1,0.2,0.5,10,10-,12-22,2.5-3,3,4,5-8,9-11,>,adaxially,armed,basal,basall,base,beneath,branched,broad-based,brow,c.,completely,cordate,discolorous,distant,drying,eaf,eed,equalling,exserted,free,glabrous,glandular,heterostylous,impressed,included,irregularl,know,known,lamina,later,lengthening,like,linear,lobe,long-triangular,lower,many,midpoint,near,nflorescence,oblique,obscured,obvious,occasionally,often,older,pair,papillate,papillo,pericarp,plurifoliat,pore,poricidal,portion,prickly,primary,prominent,ray,ruit,sessile,short-styled,sinus,slit,sparsely,splitting,strongly,tapering,tearing,time,tip,translucent,trichoem,truncate,tube,ud,unarmed,underside,unit,upper,usually,vein,way,ympodial,young	'',[,``,abaxial,adaxial,arrangement,brown,bud,cell,center,characteristic,colour,form,fruit,height,history,length,life,na,number,papillose,perennial,plant,position,rachi,reproduction,seed,shape,spacing,staman,texture,value,width,{,}
572	wfo-0001030145	invalid_json_followup	153	113	70	83	43	0.458	-3,0.2-2,0.3-,0.5-1,1,1-2,1-2.5,1-3,1-5,1.5,1.5-2,1.5-4.5,2.5-6.5,3-10,3-4,3-5,6-40,abaxially,acute,adaxially,also,apart,apex,articulated,base,calyx,campanulate,cell,cm,compound,densely,diameter,ellipsoidal,entire,flower,forked,fruit,glabrous,glandular,globose,hair,herb,leaf,long,margin,mm,moderately,near,ovate-elliptic,pedicel,peduncle,petiole,pilose,puberulent,rachi,shrub,simple,sinuate,slender,sparsely,stigma,style,ternately,toward,truncate,unbranched,unknown,violet,x,yellow	-2,0.5,0.5-4,1-1.5,1.5-7,10-12,2-3,2-4,3,4-5,4-8,4-foliat,8-11,absent,adpressed,aggregate,ape,axe,basal,beyond,blade,chartaceous,color,connective,cuneate,cylindrical,deltate,directed,distally,dunal,eaf,eed,elliptic,elliptic-ovate,exceeding,exserted,fide,fleshy,lanceolate,larger,lateral,leaflet,leaving,less,lobe,lon,lower,narrowly,nflorescence,nther,obtuse,orolla,pedicellar,pore,presen,puberulen,radiu,reddish,remnant,ripe,ruit,shorter,slightly,somewhat,spaced,stamen,stone,subcordate,subcoriaceous,tal,tem,terminal,thecae,time,tomento,triangular,truncat,tube,ud,unit,vary,wide,ympodial	'',[,``,abaxial,adaxial,anther,arrangement,bark,bud,center,characteristic,colour,corolla,filament,form,fruiting,growth,height,history,inflorescence,length,life,na,new,number,ovary,plant,position,prickle,reproduction,scar,seed,shape,spacing,staman,stem,surface,texture,trichome,value,width,{,}
573	wfo-0001030146	invalid_json_followup	210	122	77	133	45	0.367	60+,abaxial,acuminate,acute,adaxial,anther,anthesi,apex,base,berry,bright,brown,brownish,c.,calyx,capitate,center,cm,coriaceous,corolla,cup-shaped,dark,densely,diameter,echinoid,elliptic,entire,filament,flattened-reniform,flower,fruiting,globose,golden,green,growth,inflorescence,leaf,length,lobed,margin,minutely,mm,multangulate,narrowly,new,nodding,pale,pedicel,peduncle,peltate,persistent,petiole,pitted,plant,pubescent,reddish,revolute,ripe,scar,short-stalked,simple,small,stellate,stem,stigma,stout,style,surface,tan,terminal,tree,treelet,trichome,unevenly,way,white,yellow	.1,.2,.5,0.2–0.4,0.5,0.5–1,0.6–0.7,0.6–2,0.9–1,1.2–1.5,1.5–2,16–20,1–1.1,1–1.5,2.5–9,20,20–30,2–5,3–4,3–6,40–50,4–30,4–4.5,5-merou,5–8,6.5–16,6–7,8–15,9–9.5,>,abaxially,absent,ag,almost,along,alyx,apar,appearing,ark,articulated,axe,beig,beneath,branched,branching,cell,closely,connivent,covered,deeply,deltate,dense,dichasia,discolorous,drying,eaf,edge,eed,ellipsoidal,elongate,erec,exserted,free,fresh,fused,glabrous,gradually,halfway,ilament,impressed,lamina,layer,lengthening,less,like,lobe,long,loosely,lower,many,midpoint,narrowing,nflorescence,older,olive,orolla,pair,papillose,part,per,perfect,pericarp,plurifoliate,pore,poricidal,portion,primary,projection,pubescence,ray,reflexed,regularly,rhachi,ruit,scurfy,sessile,shiny,slit,spaced,sparsely,strongly,subtended,tall,tangled,tem,testal,thin,time,tiny,tip,tube,ud,undersurface,unit,upper,vary,varying,vein,visible,wide,woody,ympodial,–18	'',0.2\u20130.4,0.6\u20132,1.2\u20131.5,1.5\u20132,1\u20131.5,2.5\u20139,3\u20134,3\u20136,5-merous,5\u20138,8\u201315,9\u20139.5,[,\u201318,``,apart,arrangement,bark,beige,bud,characteristic,colour,form,fruit,height,history,life,na,number,ovary,position,prickle,rachi,reproduction,seed,shape,spacing,staman,texture,u00be,value,width,{,}
574	wfo-0001030147	invalid_json_followup	158	109	64	94	45	0.405	0.5-2,1-4,1-5,15-30,2-10.5,2-3,4-5.5,5-8,8-38,acute,apex,articulate,blue,branched,calyx,cell,cm,conical,corolla,covering,cyme,deep,diameter,dichasial,dichasially,distal,ebracteate,elliptical,filament,finely,flower,forked,green,green-white,half,herbaceous,lateral,leaf,medium,mm,monochasial,narrowly,obtuse,odd-pinnate,ovate,ovoid,pedicel,peduncle,perennial,petiole,plant,proximal,pubescent,purple,rotate,seed,stigma,style,testal,thick,throughout,tip,wall,yellow	-8,0-5,1.0-2.0,1.0-2.2,10-19,14-35,2,2-10,2-13,2-5,2.5-7.5,3-,3-6-foliat,4-3.,4.2-7.5,4.5-10,5-7,abaxiall,abaxially,acumen,acuminate,adaxially,apical,apically,attenuate,base,connate,cuneate,dehiscent,digestion,diminishing,dorsally,eaf,edge,eed,emoval,enzyme,exceeding,flat,folded,generally,globo,gradually,hair-like,honeycomb,interjected,introrse,leaflet,living,lobe,lon,long,long-attenuate,lower,lunat,make,maturing,mucilaginous,nflorescence,nther,oblique,often,orolla,pair,pattern,perfect,petiolule,plan,poricidally,reveal,rounded,ruit,sessile,seudostipule,short,size,slit,specimen,stamen,straight,subequal,subsessile,tal,tem,terminal,throughou,toward,tuber-bearing,typically,unit,vary,wide,ympodial,¼	'',[,\u00bc,\u201chair-like\u201d,``,abaxial,adaxial,anther,arrangement,bark,bud,center,characteristic,colour,form,fruit,fruiting,globose,growth,height,history,inflorescence,length,life,margin,na,new,number,ovary,position,prickle,rachi,reproduction,scar,shape,spacing,staman,stem,surface,texture,trichome,value,width,{,}
575	wfo-0001030151	invalid_json_followup	175	102	60	115	42	0.343	-50,0.2-0.5,0.5-1,1-17,1-3,1-5,1.5-2.5,10-25,15-35,2-11,2-6,2-7-compound,3-14,4-5,6-9,acuminate,adaxial,apex,blotch,calyx,cell,chartaceous,cm,diameter,elliptic,entire,flower,fruit,glabrous,globose,lanceolate,leaf,lilac-tinged,longitudinal,margin,membranaceous,mm,obovate,pedicel,peduncle,petiole,pinnately,puberulent,pyriform,rachi,simple,sometimes,sparsely,stellate,stigma,stripe,style,surface,tree,truncate,unbranched,white,x,yellow,yellow-green	-3,0.3-0.5,0.5,1,1-1.5,1-2,1.5-2,10-20,2-25,2-3,20-30,3-5,3.5-32,4-foliat,5-6,?,abaxially,absent,abundantly,acute,adaxially,aggregate,apart,ape,apiculate,around,articulated,axe,basal,base,beyond,blade,channe,ciliat,compound,connate,connective,cordate,cuneate,cylindrical,decurrent,deltate,directed,distally,eaf,eed,eglandular,exceeding,except,exserted,glabrate,glandular,glandular-puberulent,hair,leaflet,leaving,less,line,lobe,lon,long,lower,narrowly,near,nflorescence,nther,oblique,oblong,obtuse,often,orolla,pedicellar,perfect,pore,presence,probably,purplish,radiu,remnant,ring,ripe,ruit,sand-punctat,sand-punctate,scattered,shallowly,short,shorter,slender,slightly,small,somewhat,spaced,stalked,stamen,stone,tal,tem,thecae,time,tip,toward,triangular,truncat,tube,ud,unit,unknow,vary,vein,veiny,white-puberulent,whitish,wide,ympodial	'',[,``,abaxial,anther,arrangement,bark,bud,center,characteristic,colour,corolla,filament,form,fruiting,growth,height,history,inflorescence,length,life,na,new,number,ovary,perennial,plant,position,prickle,reproduction,scar,seed,shape,spacing,staman,stem,texture,trichome,value,width,{,}
576	wfo-0001030153	success	147	125	97	50	28	0.66	/3,0.2-1,0.8-1.3,1-1.5,1-10,1-2,1.3-1.5,1.3-1.9,2-8,2-lobed,2.5-4,3-4,3-5,3-50,5-6,acuminate,acute,age,anther,anthesi,apart,apex,apparently,attenuate,bark,base,berry,branched,broadly,calyx,campanulate,clavate,cm,conical,corolla,dark,deltate,diameter,distinct,domatia,ellipsoid,elliptic,entire,erect,filament,flower,fruiting,glabrous,globose,green,growth,internodal,lanceolate,lengthening,less,lobe,lobed,margin,minutely,mm,narrowly,new,nodding,occasionally,older,ovary,papillate,pedicel,peduncle,perfect,petiole,pit-like,plane,pore,poricidal,rachi,revolute,ripe,scar,simple,slightly,slit,small,stem,stigma,style,surface,terminal,time,tip,tree,treelet,way,white,x,yellowish,young	.1,.2,0.8-0.9,1-1.2,1-2.5,1.5-2,3.5-10.5,6-8,abaxially,absent,adaxially,ape,apiculate,axil,brittle,caly,densely,dot,dry,eaf,enlarged,exerted,free,glabrou,impressed,irregularly,known,lower,markedly,membranous,nflorescence,ot,pair,paler,papillat,plurifoliat,portion,primary,resinous,ruit,spaced,specimen,straight,strongly,thin,tube,ud,unit,vein,ympodial	abaxial,adaxial,arrangement,bud,cell,center,colour,form,fruit,height,history,inflorescence,leaf,length,life,na,number,perennial,plant,position,prickle,reproduction,seed,shape,spacing,texture,trichome,width
577	wfo-0001030155	invalid_json_followup	183	116	61	122	55	0.333	2,3.5,4,acuminate,acute,anther,apex,base,branched,bud,calyx,campanulate,cm,corolla,deeply,diameter,ellipsoid,entire,filament,flattened,flower,fruit,glabrous,globose,green,immature,imparipinnately,internode,lateral,leaflet,lobed,margin,mature,minutely,mm,oblong,pedicel,peduncle,petiole,pinnatifid,pitted,plant,prickle,purple,rachi,recurved,robust,rounded,stellate,stem,stigma,strongly,style,subwoody,surface,tapering,terminal,vine,white,woody,yellow	0,0.2,0.4,0.5,0.5-0.6,0.5–1.2,0.7,1-1.2,1/2,12–19,12–20,1–2,2-4,2.5,2.5-3,2/3,2–,2–3,3,3–5,4–5,4–6,4–8,4–9,5–10,5–6,5–8,607,6–8,abaxially,ag,alyx,anthesi,armed,articulated,ba,basal,basally,becoming,berry,blade,brown,cell,central,chartaceous,clustered,confluent,connecting,connivent,corresponding,decurrent,degree,deltate,densely,eaf,eed,elongating,equal,et,exserted,fresh,glabrou,knob,lengthening,light,lobe,long,long-styled,lower,major,middle,midrib,narrowly,nflorescence,often,orolla,outline,papillate,part,pericarp,petiolulate,plurifoliat,pore,poricidal,present,prominent,protuberant,rectangular,recurve,rodriguez,rounde,ruit,side,size,slender,slit,soon,spreading,stout,straight,tamen,terminally,testal,third,time,tip,tissue,truncat,ttriangular,tub,tube,unit,vary,vein,way,wide,widest,wing,ympodial,×,–17,–27	'',0.4-0.7,0.5-1.2,1,10,12-20,2-3,3-5,4-5,4-8,4-9,5-10,5-6,5-8,6-8,[,``,abaxial,adaxial,arrangement,bark,characteristic,color,form,fruiting,greyish,growth,hair,height,hirsute,history,inflorescence,leaf,length,life,na,new,number,ovary,ped,perennial,position,reproduction,scar,seed,shape,spacing,staman,texture,trichome,truncate,value,width,{,}
578	wfo-0001030160	invalid_json_followup	177	118	88	89	30	0.497	.5,.8,0.2,1,1-5,2,3,4-rayed,8-9,?,acicular,acuminate,acute,almost,anther,apart,apex,bark,base,bluish-violet,bud,calyx,closely,cm,completely,conical,corolla,densely,diameter,dioecious,elliptic,elongate,entire,filament,flower,fruit,fruiting,glabrous,globose,growth,height,inflorescence,internodal,irregularly,lobed,long,margin,minutely,mm,narrowly,nearly,new,occasionally,orange-red,ovary,pale,pedicel,peduncle,petiole,pitted,plant,prickle,pubescent,red,reniform,scar,scattered,shiny,short-stalked,shrub,simple,spaced,sparsely,stellate,stem,stigma,style,surface,terete,thin,tip,triangular,trichome,undulate-toothed,unisexual,unknown,woody,yellow	.2,00,1-1.5,1-2,1-3,1.5-2,1.5-4.5,1030.,10300,2.5-3,3-11,3-3.5,3-4,5-6,7-10,absent,amshoff,apparently,armed,beneath,berry,broad-based,capitat,consisting,conspicuous,coriaceous,dry,eaf,eed,ekman,exserted,female,fide,flattened,flowered,forming,free,glabrescen,like,lobe,long-triangular,m.,male,marginal,markedly,mere,midpoint,midrib,minute,near,nflorescence,oblique,often,older,other,ower,pair,per,pericarp,plurifoliat,poricidal,portion,primary,prominent,ray,ruit,several,shallow,single,small,sometimes,somewhat,stiff,strongly,stub,terminating,ti,tiny,truncate,tube,ud,unit,usually,vein,vestigial,winged,x,ympodial,young	'',[,``,abaxial,adaxial,arrangement,capitate,center,characteristic,colour,form,glabrescent,history,leaf,length,life,na,number,position,rachi,reproduction,seed,shape,spacing,staman,texture,value,width,{,}
579	wfo-0001030161	invalid_json_followup	179	110	77	102	33	0.43	.5,0.1-0.2,0.2-0.5,0.2-1.3,0.4-0.8,0.5,0.5-0.6,1,1.1-1.3,2.5-3,4,4-20,4-5,acute,anther,apex,bark,calyx,cell,clavate,cm,conical,corolla,densely,diameter,ellipsoid,elliptic,entire,filament,filiform,flattened,flower,fruit,fruiting,furcate,globose,growth,internodal,irregularly,leaf,lobed,long-triangular,margin,minutely,mm,narrowly,new,orange,ovary,pale,pedicel,peduncle,petiole,pitted,prickle,prickly,pubescent,red,reddish,reniform,rhomboid,scar,scattered,shiny,simple,spaced,sparsely,stellate,stem,stigma,straight,style,surface,treelet,trichome,white,yellowish	.1,.2,.25,0,0.1,0.8-1,1.5-2,1.5-5,12-16,2-2.5,2-3,3-15,3-3.5,5197,8-9,9-10,<,?,abaxially,acuminate,adaxially,almost,anthesi,apar,apparently,articulated,base,bearing,beneath,berry,breaking,broad-based,coriaceous,curved,difoliate,eaf,eed,egger,erect,especially,exserted,fide,free,fused,geminat,glabrescent,glabrous,impressed,later,leave,lengthening,lepidote,like,lobe,long,looping,lower,marginal,midpoint,midvein,near,nearly,nflorescence,occasionally,older,outline,pair,papillo,per,perfect,pericarp,planar,pore,poricidal,porrect,portion,primary,prominent,ray,ruit,sessile,shorter,slightly,slit,small,somewhat,stalked,strongly,tapering,testal,thick,tip,tooth,tub,tube,ud,undulate-toothed,unit,vein,woody,x,ympodial	'',[,``,abaxial,adaxial,apart,arrangement,bud,center,characteristic,colour,form,height,history,inflorescence,length,life,na,number,perennial,plant,position,rachi,reproduction,seed,shape,spacing,staman,texture,value,width,{,}
580	wfo-0001030167	success	141	97	52	89	45	0.369	.8,12,5-merous,abaxially,acuminate,adaxially,anther,apex,branch,chartaceous,cm,contiguously,densely,diameter,extra-axillary,filament,flattened,flower,fruit,glabrous,green,herbaceous,lanceolate,margin,membranaceous,membranous,mm,near,nearly,ovate,ovoid,pedicel,peduncle,petal,petiole,pointed,rachi,sand-punctate,simple,slender,somewhat,stellate,stigma,style,thinly,tip,unbranched,unit,unknown,vine,white,x	.9,0.1–0.2,0.5–0.6,0.5–0.7,0.6,0.6–0.8,0.7–1.2,0.8–1,1.2–2.5,1.5–2,1.5–7,14–19,15–20,17–58,1–1.2,1–1.5,2–3,2–4.5,4.5–8,4–10,4–4.5,4–5,4–7,8–10,accrescent,acute,along,alyx,apar,apically,axe,base,berry,blade,c.,calyx,ciliat,ciliate,clavate,climbing,eaf,eed,enlarged,entire,fertile,fruiting,gap,glabrou,immature,less,lobe,long,lower,m.,maturity,minutely,moderately,nflorescence,nternode,obtuse,orolla,pair,penden,perfec,pinnate,plurifoliat,reflexed,rounded,ruit,scar,secondary,seen,slightly,spaced,sparsely,subequal,symmetrical,tamen,tem,time,truncat,tube,vary,vegetation,vein,venation,weakly,wide,ympodial	0.1-0.2,0.7-1.2,0.8-1,1-1.5,1.5-2,1.5-7,15-20,17-58,2-4.5,4-10,4-4.5,8-10,abaxial,adaxial,apart,arrangement,colour,corolla,form,growth,height,history,inflorescence,internode,leaf,length,life,na,number,ovary,pendent,perfect,plant,plurifoliate,position,reproduction,seed,shape,spacing,staman,surface,sympodial,texture,truncate,width
581	wfo-0001030170	invalid_json_followup	230	133	80	150	53	0.348	1.5,2,4,8.5,accrescent,acicular,acute,anther,apart,apex,base,blue,bud,calyx,cm,coarse,densely,diameter,entire,erect,extra-axillary,filament,flattened,flower,fruit,fruiting,glabrous,gland-tipped,glandular-puberulent,globose,hair,leaf,less,lobe,long,margin,maturity,minutely,mm,nearly,oblong-apiculate,obtuse,orbicular,pedicel,peduncle,perennial,petiole,prickle,puberulent,pubescent,rachi,rarely,reniform,shallow,short-puberulent,shrub,simple,smooth,spreading,stellate,stem,stiffly,stigma,stipitate-glandular,stout,straight,style,subdeltoid,surface,thick,thin-textured,tooth,triangular,unbranched,violet,white,wide,x,yellow,yellowish	-6,.2,/2,0,0.1,0.15–0.35,0.2–0.5,0.2–2,0.5–15,0.5–2,0–30,1,10–15,12.5,15–20,1–2-celled,1–2.5,1–4.5,2-foliate,2.5–3,20–25,20–30,2–3-celled,2–4,2–5,2–8,3,3.5–4,3.5–4.4,3–10,4–13-rayed,4–22,5,5–10,5–12,5–15,5–apiculate,abaxially,absent,adaxially,also,appearing,around,articulated,axe,ba,blade,capitat,confined,connivent,conspicuously,cordate,curved,cylindrical,directed,disappearing,distall,eaf,eed,enlarged,eventually,falling,fertile,few-branched,few-rayed,flexuous,frui,geminat,geminate,gland,glandular,ground,horizontal,hyaline,interpetalar,lanceolate,larger,like,lobed,lon,longer,longest,lower,lowest,major,male,many,mesocarp,minute,mostly,multangulate,near,nflorescence,numerous,oblique,often,one,orolla,pair,perfect,pore,pubescence,ranging,rare,ray,reflexed,rootstock,ruit,scarcely,scattered,senescent,sessile,shorter,similar,single,size,slightly,small,solitary,sometimes,somewhat,spaced,spongy,stella,stellae,sterile,stipitate,strongly,surfac,tall,tamen,tem,thic,tissue,toward,truncate,tube,twice,ultimately,unit,upper,usually,various,vary,vein,vestigial,way,without,ympodial,–4	'',0.2-0.5,0.2-2,0.5-15,1-2-celled,1-2.5,1-4.5,1.2,10,10-15,2-4,2-5,2-8,2.5-3,20-30,3-10,[,``,abaxial,adaxial,arrangement,bark,capitate,center,characteristic,colour,corolla,dense,form,growth,height,history,inflorescence,length,life,na,new,number,ovary,plant,position,reproduction,scar,seed,shape,spacing,staman,texture,trichome,value,width,{,}
582	wfo-0001030176	invalid_json_followup	171	112	69	102	43	0.404	.2,.7,.75-1.5,0.4-1.5,0.5-2,0.6-0.9,0.7-1.4,0.7–0.8,1,1-5,1.2-2.5,1.6,2.25-3.25,3-5,3-lobed,4-9,6-8,acute,anther,apart,apex,bilobed,broadly,calyx,chartaceous,cm,depressed-globose,diameter,especially,extra-axillary,few-branched,filament,flattened-reniform,flower,fruit,fruiting,glabrous,hair,herb,hermaphroditic,lanceolate-oblong,light,long,major,margin,mm,ovate,pale,pedicel,peduncle,petiole,plant,rachi,rarely,recurved,ripe,rotate-stellate,simple,slightly,stigma,style,unbranched,vein,violet,white,x,yellow,yellow-orange,young	-1.4,-4.25,-6.25,0.5,1-2,1.2,1.5-2,1.5-2.5,1/3,1/6,2-3,2-foliate,2.5,2.5–7.5,2.5–9,2–3,3.75-5,5-merou,6–8,abaxially,accrescent,adaxiall,adaxially,alyx,angulate,apparently,articulated,asymmetrically,attenuate,axe,ba,basal,base,berry,bi-lobed,blade,branch,broad,capitat,ciliate,connivent,contact,covering,cylindrical,decumbent,dehiscent,downward,eaf,eed,erec,forming,geminat,hold,interlobal,juic,lance-ovate,lateral,line,lobe,lon,longitudinall,lower,mesocarp,midrib,minutely,near,nearly,nflorescence,node,numerous,oblong,often,orolla,partially,patch,perfect,pore,prostrate,pubescent,recurve,rooting,round,ruit,sinus,soil,sometimes,somewhat,spaced,sparsely,tamen,tem,terminal,time,tip,triangular,tube,unit,vary,white-puberulent,wide,winged,ympodial	'',[,``,abaxial,adaxial,arrangement,bark,bud,capitate,cell,center,characteristic,colour,corolla,form,growth,height,history,inflorescence,leaf,length,life,na,new,number,ovary,perennial,position,prickle,reproduction,scar,seed,shape,spacing,staman,stem,surface,texture,trichome,value,width,{,}
583	wfo-0001030180	success	135	86	52	83	34	0.385	.5,0.05-1,0.5-1,0.8-2,1.1-1.2,3-8,4.5-5,anther,apart,apex,bark,calyx,clavate,cm,corolla,dark,ellipsoid,filament,fruit,fruiting,furcate,glabrous,globose,green,height,leaf,linear,lobed,mm,opposite,ovary,papillate,pedicel,petiole,planar,prominent,puberulent,rounded,scar,shrub,slender,stem,stigma,style,surface,trichome,uniseriate,unknown,white,winged,x,yellowish	.1,.75,0.9-1.8,1-1.5,10-30-flowered,3-4,6,8-10,8.5-23,?,abruptly,accrescent,anthesi,apiculate,appearing,attenuate,base,becoming,berry,clu,decurrent,deflexe,deltoid,dia,eaf,edicel,eed,erect,exserted,free,glabrate,immature,inflorescenc,interpetalar,known,lateral,lenticellat,lobe,lon,long,long-acuminate,lower,main,middle,minute,minutely,narrowing,nearly,nflorescence,occasionally,older,overlapping,pair,papillose,peduncl,plurifoliat,pore,poricidal,portion,proximal,raised,ruit,shaped,sinus,slightly,soon,spaced,sparsely,straight,tear-drop,terminal,thin,tip,tube,ud,unevenly,unit,vein,widely,widest,woody,ympodial,young	10-30,abaxial,adaxial,arrangement,bud,cell,center,colour,diameter,flower,form,growth,history,inflorescence,length,lenticellate,life,margin,na,new,number,peduncle,plant,plurifoliate,position,prickle,rachi,reproduction,seed,shape,spacing,staman,texture,width
584	wfo-0001030182	success	205	114	90	115	24	0.439	0.5-1,1-1.5,1-4.5,12-15,15-20,2-15,2-3,2-5,3-12,3-4,anther,bark,base,berry,blue,branched,brown,brownish,calyx,cell,clavate-truncate,closely,cm,coriaceous,corolla,dark,diameter,elliptic,erect,ferruginous-tomentose,filament,finely,flattened,flower,fruit,fruiting,glabrescent,glandular,globose,green,growth,heterostylous,internodal,leaf,lobed,margin,microscope,mixed,mm,nearly,new,ovary,ovate,ovate-elliptic,ovoid,papillose,pedicel,peduncle,petiole,plant,porrect,prickle,pubescent,red,reddish,repand,reticulate,rusty,scar,seen,sessile,shrub,simple,stellate,stellate-glandular,stem,stigma,style,subcoriaceous,subreniform,subsessile,surface,terminal,tomentose,treelet,trichome,velutinous,violet,yellow,yellowish	-12,0.2-0.3,0.3-0.5,1,1-1.7,1-celle,1-celled,1-multicellular,1-nerved,1.2-1.5,1.5-2,1/4,2-2.2,2-8,2.4-2.5,3-5,3-8,4-10,4-5,abaxially,accrescent,acute,adaxially,adult,angulate-lobed,anthesi,apex,armed,articulated,asymmetric,basal,den,discolorous,distal,e,eaf,eed,eglandular,entire,evident,exserted,free,hirsute,immature,juvenile,later,lengthening,like,linear-lanceolate,lobe,long,long-styled,lower,many,midpoint,midrib,minute,minutely,mixture,multangulat,multicellular,nflorescence,oblique,obtuse,older,one,papillo,per,perfect,pericarp,plurifoliat,pore,poricidal,porrect-,porrect-stellate,portion,prickly,pubescence,ray,recurved,reduced,reflexed,ripe,rounded,ruit,short,short-styled,similar,slightly,slit,space,sparse,sparsely,stalked,staminate,strongly,tall,tapering,testa,tip,triangular-lanceolate,tub,tube,turbinate,ud,unarmed,uniseriate,unit,upper,variegated,vein,wood,x,ympodial,¼	abaxial,adaxial,arrangement,bud,center,colour,form,height,history,inflorescence,length,life,mentioned,number,perennial,position,reproduction,seed,shape,spaced,spacing,staman,texture,width
585	wfo-0001030185	invalid_json_followup	206	123	80	126	43	0.388	1,1-10,1-4,10,2-3,2.0-3.0,20-65,5-7,8-11,9-18,acuminate,acute,apex,beyond,blue,blue-violet,branched,calyx,cell,center,cm,commonly,corolla,covering,cyme,dark,darker,deep,densely,diameter,dichasial,dichasially,distal,ebracteate,elliptic,filament,flower,forked,glandular-pubescent,globose,green,green-white,half,herbaceous,lanceolate,lateral,light,medium,mm,moderately,monochasial,narrowly,odd-pinnate,ovate,ovoid,pedicel,peduncle,perennial,plant,puberulent,purple,rhizomatous,rotate,scarcely,seed,shape,sometimes,spot,star,stem,stigma,style,testal,thick,tinged,violet,wall,white,without,yellow	-0.5-1.3,0.2,1-8,1.0-1.3,1.5-4,1.7,15,2,21,25,3-6-foliat,3.5-4.2,35,4,4-7,5-10,5-lobed,abaxially,acumen,adaxially,angular,apical,apically,apiculate,articulate,b,ba,basal,base,becoming,caudate,cente,clasping,coat,collection,color,connate,cordate,cuneate,decreasing,dehiscent,digestion,eaf,eed,embryo,emoval,enzyme,erect,exceeding,formed,generally,glabrescent,glabrous,gland,globo,hair,hair-like,honeycomb,interjected,introrse,leaflet,living,lobe,lon,long,lower,make,maturing,middle,mucilaginous,nearly,nflorescence,nther,obliquely,oblong,occasional,often,one,orolla,pair,pattern,pentagonal,perfect,petiolate,petiolulate,petiolule,poricidally,purpl,radiating,rare,reduced,reveal,rhizome,rotate-,rounded,ruit,semi-lunate,sessile,seudostipule,short,size,slightly,slit,somewhat,specimen,stamen,ste,straight,subequal,symmetrically,tem,terete,terminal,tip,trailing,type,typically,unbranched,unit,usually,vary,visible,wid,wide,wider,ympodial	'',[,\u201chair-like\u201d,``,abaxial,adaxial,anther,arrangement,bark,bud,characteristic,colour,form,fruit,fruiting,growth,height,history,inflorescence,leaf,length,life,margin,na,new,number,ovary,petiole,position,prickle,rachi,reproduction,rotate-pentagonal,scar,spacing,staman,surface,texture,trichome,value,width,{,}
586	wfo-0001030189	invalid_json_followup	188	120	83	105	37	0.441	/3,0-1,0.1-0.2,0.5-1.6,0.9-1.1,1,1-2,1.3-4.2,2-3,2-5.5,2.5-4,5-10,5-6,5-merous,abaxially,anther,apex,articulated,bark,base,berry,branched,calyx,chartaceous,cm,concolorous,diameter,drying,dull,elliptic,entire,erect,evenly,filament,flattened-reniform,flower,fruit,fruiting,glabrescent,glabrous,gray,green,lateral,leaf,length,lobed,long,margin,maturity,mauve,mm,moderately,oblong,orange,ovate,pedicel,peduncle,petiole,porrect,purple,red,rounded,scandent,scar,sessile,shrub,simple,sparsely,spherical,stalked,stellate,stellate-pubescent,stem,style,surface,terete,terminal,trichome,variously,way,yellow,yellow-green,young	-1/2,-4,.2,0-15,0-30,0.1,0.2-0.3,0.2-0.5,1-1.5,1-3-cellular,1-4-cellula,1-4-cellular,1.1-2.7,1.5-2,1.5-4.5,1.5-5,1/,1/3,1/6-1/3,2,3-4,3.2-4.5,4-13,4-5.5,5-,6-10,6-12,8,8-10,8-18,acut,alyx,apar,apically,apparently,appressed,blade,connivent,cordate,curved,deltate,densely,eaf,eed,elongating,equal,faint,foliaceous,free,frui,glabrescen,gland-tipped,infructescence,lobe,longer,lower,mature,midpoint,nflorescence,obtuse,often,older,one,open,orolla,oung,pair,per,perfec,pericarp,plurifoliat,poricidal,portion,primary,ray,recurved,red-brow,reflexed,ruit,shorter,slender,smooth,sometimes,somewhat,spaced,spreading,stalk,strongly,tamen,tapering,tertiary,time,tip,tube,unarme,unarmed,unit,upper,vary,vein,venation,visible,wide,woody,ympodial	'',[,``,abaxial,adaxial,apart,arrangement,bud,characteristic,colour,corolla,form,growth,height,history,inflorescence,life,na,new,number,ovary,plant,position,prickle,rachi,red-brown,reproduction,seed,shape,spacing,staman,stigma,texture,value,width,{,}
587	wfo-0001030195	success	255	100	81	174	19	0.318	.5,0.1–0.2,0.2–1.0,0.5–4.0,0.8–0.9,0.9–4.8,1.2–1.6,1.3–2.6,2,2.3,3.8–4.8,5.5–6.5,acuminate,aequilateral,anther,bark,base,based,blade,borne,broad,brochidodromous,brown,calyx,capitate,chartaceous,cm,corolla,cuneate,deltate,densely,diameter,evenly,filament,flattened-orbicular,fruit,glabrous,globose,green,individually,internode,lateral,leaf,long,midvein,mm,moderately,notched,oblique,ovate,pedicel,petiole,pitted,prickle,pubescent,red,reddish,rounded,sessile,shoot,short,shot,shrub,spatulate,stellate,stellate-pubescent,stem,stigma,style,subcoriaceous,surface,terminal,transparent,vein,weakly,white,yellow,yellow-ferruginous,yellow-tan,±glabrous,×	.2,.3,.6,.7,/3,0.2–0.3,0.2–0.5,0.3–0.7,0.5,0.5–0.6,0.5–1.3,0.7–1.0,0.8,1,1.0,1.0–1.4,1.0–1.5,1.3–1.5,1.4–1.6,1.5–1.7,1.5–1.9,1.7–2.2,1.7–3.2,1.8–2.0,1.8–2.5,1/3,2.2–2.7,3–6,3–7.3,4-merou,4.9–7.0,6.3–7.7,6–8,6–9,abaxially,adaxial,adaxially,adnate,ag,along,alyx,anthesi,apex,apical,apiculate,apparently,appearing,appresse,around,articulate,attachment,attenuate,ba,berry,broad-based,bud,channeled,connivent,dark,dentate,developed,directed,distal,distally,distinct,dry,eaf,edge,eed,either,elliptic,emerging,endocarp,entire,exocarp,extending,extra-axillary,fertile,filiform,flat,flattened-irregular,flexed,flower,free,glandular,glossy,gradually,gree,hair,homostylous,hort,immature,increasing,indistinct,intact,interpetalar,intersepalar,isolated,juic,layer,laying,light,lobe,lon,longer,lower,m.,many,margin,markedly,mature,middle,midpoint,midrib,minute,mottled,narrowly,nearly,nflorescence,nodding,oblong,obtuse,occasionally,opaque,orolla,per,perforated,plurifoliat,point,poorly,pore,porrect,portion,potentially,presen,raised,ray,reflexed,remaining,restricted,ruit,scattered,side,simple,sinus,slightly,sloughing,smoot,sparsely,splitting,stamen,stellae,straight,striped,suture,tamen,tem,thin,time,tip,tissue,truncate,tube,typically,ud,unarmed,unit,vary,wide,yellow-ferruginou,ympodial,young,±90°,±equal	1.7,arrangement,colour,form,growth,height,history,inflorescence,length,life,ovary,perennial,plant,position,seed,shape,staman,texture,width
588	wfo-0001030198	invalid_json_followup	234	135	78	156	57	0.333	0.8,1,16,abaxially,acute,adaxially,angulate,anther,apart,apex,articulated,attenuate,base,black,calyx,closely,cm,deltoid,densely,diameter,entire,filament,finely,flattened-reniform,flower,fruit,glabrate,glabrous,globose,homostylous,interpetalar,interwoven,irregularly,lateral,leaf,lilac,margin,minute,minutely,mm,nearly,orange,ovate,overtopped,ovoid,pedicel,peduncle,petiole,pitted,porrect,prickle,purple,recurved,sessile,short-stalked,shrub,simple,sinuate,soon,stellae,stellate,stellate-tomentose,stem,stigma,straight,style,surface,tan,terminal,tissue,tomentose,weak,well-developed,white,whitish,whitish-tomentose,yellow,yellowish	.2,0.6,0.7–,0.7–0.8,0.7–0.9,0.7–1.1,0.8–1.4,0.9–1.7,0.9–2,1.2,1.4–1.6,1.5–3.5,1.5–6.5,10–12,13–20,1–2.5,2,2.5,2.5–14,2.5–3.0,2–2.8,2–3,2–3-lobed,3.4–4.0,3.5–7,3–3.5,3–4,3–9,4,4.5,4–12-branched,5-merou,5.3–7,5.5–13,5–12,60–150,6–10,7.5–10,acicular,adaxiall,alyx,ampliate,apical,apparently,appearing,axe,basal,berry,blade,branch,broad,broadly,capitat,caudate,contrasting,cordate,coroll,dark,darker,deeply,directed,distall,distally,drying,eaf,eed,except,extra-axillary,fewer,filiform,formed,free,frui,geminat,glabrescent,gland-tipped,gradually,green,hair,hal,high,immature,initially,internode,larger,like,lobe,lobed,lon,long,lower,major,many,midpoint,midri,midrib,midvein,midzone,much,near,nflorescence,oblong-lanceolate,often,one,orolla,part,perfect,persistently,plurifoliate,pore,principal,ray,reflexed,relatively,rounded,ruit,shiny,shorter,side,sinus,slightly,sometimes,somewhat,spaced,sparse,splitting,spreading,stalk,stella,stout,strongly,tamen,tem,thickened,time,tip,triangular,truncate,tube,turning,ud,unarmed,unit,upper,usually,vary,vein,white-tomentose,wide,ympodial,×,–17,–18,–20,–3,–3.5	'',0.7\u2013,0.8\u20131.4,0.9\u20132,1.5\u20133.5,10\u201312,1\u20132.5,2\u20132.8,3\u20139,5-merous,5.3\u20137,5\u201312,60\u2013150,7.5\u201310,[,\u00d7,\u201320,\u20133,\u20133.5,``,abaxial,adaxial,arrangement,bark,bud,capitate,characteristic,colour,corolla,form,fruiting,growth,height,history,inflorescence,length,life,na,new,number,ovary,perennial,plant,position,rachi,reproduction,scar,seed,shape,spacing,staman,texture,trichome,value,width,{,}
589	wfo-0001030212	success	188	104	75	113	29	0.399	0.2-0.4,0.5-1,1-1.5,1-15,1-3,1-6,1.5-2,2-2.5,2-5,2.1-3.4,2.4-3.3,3-5,3.5-5,4-23,4.5-6,abaxial,accrescent,acicular,adaxial,andromonoecious,anther,apex,articulated,base,broadly,calyx,capitate,center,chartaceous,cm,compound,cylindrical,deeply,depressed-globose,diameter,filament,flower,fruit,fruiting,glabrous,green,herbaceous,inflorescence,leaf-opposed,length,lobed,margin,mm,ovate,pedicel,peduncle,petiole,pinnately,plant,prickle,prostrate,purple,rachi,resprouter,rotate,rotate-stellate,simple,slightly,sprawling,stigma,straight,strongly,style,surface,unbranched,weakly,winged,x,yellow,yellowish-green	%,0-4,0.5-0.6,0.5-7,0.9-1.3,1-1.2,1-2,1-5,1.2-1.8,1.4-1.8,12-40,15-40,2-4,2.5-6,2.6-6.5,20-50,25-60,28-37,30-150,4-27,4-6,4-9,5-merou,6-9,7-11,8-9,9-10,abaxially,absen,absent,abundant,acute,adaxiall,adaxially,alyx,apart,apparently,armed,attenuate,axe,ba,bilobe,blade,bristle-like,brown,connivent,cuneate,d.,deltate,directed,distall,divided,eaf,eed,finger,functional,geminat,gland-tipped,glandular-puberulent,hair,half,heterostylous,index,interpetalar,juic,lamina,lateral,lobe,lobing,lon,long,lower,mature,mesocarp,mid-point,midvein,minute,moist,narrowly,nflorescence,oblique,orolla,part,per,plurifoliate,pore,presen,present,pricke,ruit,short,side,spaced,sparse,sparsely,stage,tal,tamen,tem,thick,throughout,time,tissue,toothed,triangular,tube,unit,unknown,uvenile,vary,vein,wide,ympodial	5-merous,arrangement,bark,bilobed,bud,cell,colour,corolla,form,growth,height,history,leaf,life,na,new,number,ovary,position,reproduction,scar,seed,shape,spacing,staman,stem,texture,trichome,width
590	wfo-0001030219	invalid_json_followup	191	125	81	110	44	0.424	0.1–0.3,0.2–2.3,0.5,0.5–,1.0–1.2,1.0–2.2,10,15,2.0–2.5,4.5–5.5,4–7,60,6–10,6–8,9–10,abaxially,acute,adaxially,anther,anthesi,apart,apex,articulated,base,black,blue,branched,brown,calyx,cm,deeply,densely,diameter,elliptic,filament,flattened,flower,fruit,glabrous,globose,green,incised,lanceolate,leaf,lilac,long,margin,marking,mm,moderately,multicellular,number,oblong,olive,opposed,ovate,pale,paler,pedicel,peduncle,pentagonal,perennial,petiole,pitted,pubescent,purple,shallowly,shrub,simple,sparsely,stigma,style,surface,unicellular,uniseriate,velutinous,wide,woody,x,yellow,–9.5	0.4–1.0,0.7–1.1,0.8–3.0,0–,1.0–1.5,1.0–2.0,1.3–2.9,1.4–2.8,1.5,1.6–,1–2.5,2.0–3.2,2.0–5.5,2.4–6.0,2–,2–2.5,2–3,2–4.5,3,4.8–11.5,4–5,5,5–,5–8,6–,7–11,8–18,9–12,abaxiall,acut,adaxiall,adnate,ag,along,anisophyllous,apical,apparently,appearing,arising,arranged,axe,ba,basal,blade,bract–like,cell,chartaceous,clavat,concave,connivent,convex,cylindrical,decreasing,decurrent,diamete,difoliate,directed,distally,eaf,eed,equal,erect,geminat,glabrescent,hair,indistinct,internode,lobe,longitudinal,lower,nflorescence,opening,oppositely,orolla,pair,perfect,pore,present,procumbent,rapidly,red–purple,regularly,rounded,ruit,serrate,sessile,sid,side,size,smaller,spaced,split,stone,straight,stripe,strongly,tal,tamen,tem,time,tube,two,unit,vary,white,wing,winged,ympodial,–3.0,–7.0	'',1.6–3.2,5–11,[,``,abaxial,adaxial,arrangement,bark,bud,center,characteristic,clavate,colour,corolla,form,fruiting,growth,height,history,inflorescence,length,life,na,new,opposite,ovary,plant,position,prickle,rachi,reproduction,scar,seed,shape,spacing,staman,stem,texture,trichome,value,width,{,}
591	wfo-0001030224	success	191	115	84	107	31	0.44	0.5-1,0.5-1.5,1-3.5,1.5-9,12-14,14-17,2-10,2-4,2-5,2.5-4.5,4-10,5-10,5-merous,6-15,abaxially,adaxially,andromonoecious,anther,armed,bark,black,brown,calyx,cell,chartaceous,clavate,cm,dark,deflexed,densely,diameter,elliptic,extra-axillary,ferruginous,filament,finely,flattened,flower,forked,form,fruit,fruiting,glabrous,globose,green,greyish,hair,lighter,mm,moderately,occasionally,orange,outline,pedicel,peduncle,petiole,pink,plant,prickle,pseudohair,pubescent,purple,rachi,recurved,red,reddish-brown,reniform,scandent,shrub,simple,sparsely,stellate,stellate-pubescent,stem,stigma,style,subcoriaceous,suborbicular,surface,tan,unbranched,x,yellow,yellowish	-2.5,.25,.5,0.5-3,1-1.5,1-2,10-20,2-3-celled,2.5-4,2.5-8,20-25,3-4-foliate,4-4.5,4-6,4.5-5,6-10,6-8,7-10,8-12,absent,accrescen,acuminate,acute,adaxiall,ag,alyx,andromonoeciou,apart,apex,articulated,axe,ba,base,berry,blade,broad-based,capitat,connivent,cylindrical,directed,distally,dry,eaf,eed,eglandular,equal,fissure,free,functionally,geminat,gradually,hermaphroditic,heteromorphic,interpetalar,lateral,like,linear-lanceolate,lobe,long,long-,longer,longitudinal,lower,lowering,major,mature,maturit,midpoint,midvein,narrowly,nflorescence,one,opening,orolla,other,part,perfect,pericarp,pore,ray,reflexed,ruit,sessile,shiny,short-styled,side,slit,small,spaced,sparse,staminate,strongly,tamen,tapered,testal,tightly,time,tissue,triangular,tube,unit,vary,vein,wall,wide,wtih,ympodial	abaxial,adaxial,arrangement,bud,capitate,center,colour,corolla,fissured,growth,height,history,inflorescence,leaf,length,life,margin,na,new,number,ovary,position,reproduction,scar,seed,shape,spacing,staman,texture,trichome,width
592	wfo-0001030225	invalid_json_followup	155	105	62	93	43	0.4	-30,.5-2.5,0-5,1,1-4,1-6,10-15,10-30,2,2-3,2-6,3-11-compound,3-4,4-5,acuminate,acute,apart,apex,articulated,base,calyx,campanulate,cm,coriaceous,densely,diameter,elliptic-ovate,entire,expanded,fleshy,flower,forked,fruit,glabrous,globose,leaf,less,margin,mm,moderately,obtuse,pedicel,peduncle,petiole,pinnately,possibly,puberulent,purple,rachi,scar,shrub,simple,small,stellate,stigma,style,succulent,tree,truncate,unbranched,unknown,x	-1.5,-11,-4,-45,-7,.5,0,0-20,1.5,1.5-2.5,2-18,2-2.5,3-20,3-5,3-foliat,8-15,abaxially,absent,adaxially,ape,apical,apically,ature,axe,basal,beyond,bilobed,blade,color,compound,conivent,connective,cordate,cuneate,cylindrical,deltate,dilated,directed,distally,eaf,eed,equal,especially,exceeding,exserted,glabrate,gland,immature,laterally,leaflet,leaving,lobe,long,lower,minutely,narrowly,nflorescence,nther,oblong,one,orolla,papillose,perfect,pore,prominent,puberulen,radiu,see,seen,shallowly,slightly,somewhat,spaced,sparsely,stalked,stamen,strongly,tal,tem,thecae,time,tip,tomento,toward,triangular,tube,two,ud,unit,unknow,vary,wide,ympodial	'',[,``,abaxial,adaxial,anther,arrangement,bark,bud,cell,center,characteristic,colour,corolla,filament,form,fruiting,growth,height,history,inflorescence,length,life,na,new,number,ovary,plant,position,prickle,reproduction,seed,shape,spacing,staman,stem,surface,texture,trichome,value,width,{,}
593	wfo-0001030244	success	226	116	87	139	29	0.385	0-0.3,0-0.6,0.2-1.3,0.25-0.5,0.5-1,0.5-1.2,0.5-7,1-1.5,1-2,1.5-2,2.5-6.5,3.5-9,5-6,7-24,8-18,abaxially,accrescent,acicular,adaxially,andromonoecious,anther,base,blue,calyx,chartaceous,cm,densely,diameter,entire,erect,extra-axillary,filament,flower,fruit,fruiting,glabrous,globose,green,hair,inflorescence,interpetalar,lanceolate,length,linear,longer,margin,mm,moderately,narrow,narrowly,oblong,pale,pedicel,peduncle,perennial,petiole,plant,prickle,pseudo-racemose,purple,rachi,red,reniform,reticulate,rhizomatous,rotate,scattered,shrub,simple,slightly,solitary,sparsely,stellate,stellate-pubescent,stigma,straight,style,surface,tan,time,tissue,unbranched,white,wide,x,yellow,yellowish	%,.05,.3,0-0.1,0-1,0-3,0.1-1.5,0.2,0.2-0.5,0.2-0.6,0.2-1,0.25-0.4,0.3-0.4,0.3-0.5,0.3-5,0.4-0.7,0.5-3.5,0.6-0.8,0.8-1.2,1-20,1-5,1-6,1-8,1-locular,1.5-,1.5-2.3,1.5-3,11-33,2-2.5,2-4,2-foliate,2.5-13.5,3.3-7.5,4-5,4-5-merou,4-6,6-8,7-15,7-16,7-8,7-9,absen,absent,across,acute,alyx,apart,apex,apparen,articulated,attenuate,axe,ba,blade,brown,capitat,common,confined,connivent,cuneate,cylindrical,decimetre,deltate,directed,distall,distally,distributed,eaf,eed,eglandular,exocarp,finger,geminat,gland-tipped,grey,half,heterostylous,homostylous,incomplete,juicy,lamina,lateral,less,lobe,long,lower,markedly,mature,mesocarp,mid-point,midpoint,midrib,minute,nflorescence,oblique,obtuse,orolla,part,per,perfect,placenta,plump,pore,porrect,present,pubescent,ray,ruit,septum,sessile,short,spaced,sparse,stage,stalk,stalked,stellae,strongly,succulent,tal,tamen,tem,thick,thicker,thicknes,throughout,tissu,triangular,tube,unarme,unarmed,unit,unknow,usually,uvenile,vary,weakly,wid,ympodial	abaxial,arrangement,bark,bud,capitate,cell,center,colour,corolla,form,growth,height,history,leaf,life,na,new,ovary,position,reproduction,scar,seed,shape,spacing,staman,stem,texture,trichome,width
594	wfo-0001030250	success	169	93	60	109	33	0.355	0.5-1,1-3,1.1-1.2,1.4-1.5,1.7-7,2.5-3.25,5-6,anther,apart,apex,arching,bark,broadly,brown,bullate,calyx,capitate,cm,conical,corolla,cup-shaped,dark,elliptic-ovate,filament,fruiting,glabrous,globose,green,greenish-white,greenish-yellow,inflorescence,irregularly,leaf,lobed,long-acuminate,minutely,mm,opposite,ovary,ovoid-reniform,pale,pedicel,petiole,pitted,scar,sea-green,seed,shape,shaped,shrub,simple,slender,slightly,stem,stigma,style,surface,tan,tapering,white-lenticellate	.5,/4,0-seeded,1-1.5,1.1-3.5,1.25-1.5,1.9-2.6,11.2-22,11.3,2-2.5,2.1-6,25,3-5,3.4-6.6,3.5-4,4-7,5-50-flowered,6-8,across,anthesi,appearing,attenuate,base,beginning,beneath,berry,carinate-hooded,consisting,cuneate,curved,decurrent,deflexed,dia,differing,difoliate,dry,eaf,edicel,eed,elliptic,exerted,five,free,fresh,geminat,glabrou,horizontally,inflorescenc,lateral,lobe,lon,long,lower,main,major,maturity,middle,minor,n,nflorescence,node,occasionally,older,one,orbicular,orbiculate,pair,paler,papillo,papillose,pendulous,pit,pore,poricidal,portion,projection,prominent,proximal,raised,reflexed,rim,ruit,shallow,size,smooth,soon,spaced,specimen,spreading,straight,tall,tear-drop,tip,translucent,translucent-green,tube,two,ud,unit,usually,vein,way,white-lenticellat,wide,widest,winged,woody,x,ympodial	0.5,5-50,abaxial,adaxial,arrangement,bud,cell,center,colour,diameter,flower,form,fruit,growth,height,history,length,life,margin,na,new,number,peduncle,perennial,plant,position,rachi,reproduction,spacing,staman,texture,trichome,width
595	wfo-0001030271	success	195	121	94	101	27	0.482	0-2,0.15-0.75,0.7-9.5,1-2,1.4-2.1,15-61,2-6,2.4-5.6,3-10,3-5,4-22,4-7,6-15,abaxially,adaxially,along,anther,apex,articulated,attenuate,axillary,base,bead,berry,blue,brownish,bud,cell,clavate,cm,coloration,condition,considerably,coriaceous,corolla,covering,dark,decreasing,deep,diameter,drying,elliptic,filament,flower,forked,fresh,fruit,glabrous,green,greenish,hair-like,herb,interjected,larger,lateral,leaf,leaflet,light,like,lilac,medium,mm,moniliform,necklace,odd-pinnate,orbicular,ovate,ovoid,pair,pedicel,peduncle,pentagonal,petiole,plant,purple,rotate,rounded,seed,size,slightly,spot,stigma,stolon,style,subtending,terminal,testal,thick,toward,tuber,wall,white,whitish,yellow	0.5-1.2,0.9-2.5,0.9-3.6,1-2.5,1-3,1-4,1-6,1-7,1.9-6.6,2-2.7,2-3,2-4,3.4-7.5,5-8,5-merou,5.6-12.3,acumen,acute,adaxiall,ag,alyx,apart,apparently,arranged,asymmetric,axe,basiscopic,blade,capitat,completely,connivent,digestion,distal,dorsally,eaf,edge,eed,enzyme,erect,exceeding,flat,folded,geminat,generally,glabrou,green-white,habi,half,homostylous,honeycomb-shaped,lanceolate,lengthening,linear,living,lobe,long,lower,make,middl,mottled,mucilaginous,multiple,nflorescence,orolla,perfect,petiolulate,plurifoliate,pore,poricidal,removed,ripe,rosette,ruit,sessile,seudostipule,side,slit,sometimes,spaced,specimen,stamen,straight,symmetric,tall,tamen,tem,throughout,tip,tissue,tri-,tube,typically,unit,unwinged,usually,vary,vein,wet,wide,x,ympodial	abaxial,adaxial,arrangement,capitate,colour,form,growth,height,history,inflorescence,length,life,middle,na,number,ovary,perennial,position,pseudostipule,rachi,reproduction,shape,spacing,staman,surface,texture,width
596	wfo-0001030272	success	179	94	61	118	33	0.341	-6,.5,0.05-1.5,0.5-1.5,0.65-1,0.7-2.5,0.8-1.5,1,1.2-1.8,1.5-2.5,3.5-5,4-8,anther,bark,bright,calyx,cm,diameter,elliptic,entire,evenly,filament,flattened-reniform,flower,fruit,fruiting,glabrescent,glabrous,green,lateral,leaf,length,less,lobed,margin,mauve,membranous,mm,multangulate,orange-brown,pedicel,peduncle,petiole,porrect,red,red-brown,scar,sessile,shallowly,shrub,simple,spherical,stellate,stellate-pubescent,stem,style,surface,terminal,trichome,unbranched,undulate	.3,/4,0-20,0.05-0.1,0.5-1,0.5-2,0.6-0.9,1-1.5,1-2.8,1.5-3,1/3,1/3-2/3,10-20,2-2.5,2-6.5,2.5-3,2.5-3.5,2.8-3.5,3-8,4-10,4-15,4-6,5-7,5-merous,abaxially,acut,acute,almost,alyx,ame,apar,apex,apically,apparently,articulated,ba,base,berry,blade,c.,concolorous,connivent,deltate,densely,difoliate,drying,eaf,eed,elongating,equal,erect,free,geminat,glabrescen,gland,glandular,gra,hair,infructescence,lobe,long,long-attenuate,longer,lower,mature,maturity,midpoint,minute,moderately,narrow-deltate,near,nflorescence,obtuse,older,one,open,orolla,oung,pair,per,perfec,pericarp,poricidal,portion,primary,ray,reduced,reflexe,rounded,ruit,shorte,slender,smooth,sometimes,spaced,sparsely,spreading,straight,tamen,tapering,terete,tertiary,time,tip,tube,unarme,unarmed,unit,upper,vary,vein,venation,visible,way,wide,woody,ympodial,young	abaxial,adaxial,apart,arrangement,bud,cell,center,colour,corolla,form,gray,growth,height,history,inflorescence,life,na,new,number,ovary,perennial,plant,position,prickle,reproduction,seed,shape,spacing,staman,stigma,texture,unknown,width
597	wfo-0001030278	invalid_json_followup	235	144	109	126	35	0.464	0-0.2,0-1,0.1-0.3,0.6-1,1-2,12-25,15-20,2,2-6,2-7,3-4,3-7,4-12,5-20,5-8,6-12,7-10,7-12,abaxially,accrescent,achlorophyllous,adaxial,adaxially,along,anther,apex,articulated,base,branched,broadly,brown,calyx,closely,cm,coarsely,completely,compressed,concentrated,contiguous,corolla,covering,dark,densely,dentate,diameter,divergently,ellipsoid,elliptic,elongate,erect,extra-axillary,filament,flexuous,flower,fruit,fruiting,glabrous,hermaphroditic,hirsute,inflorescence,laterally,length,lenticular,lignescent,margin,midpoint,minutely,mm,moderately,nearly,orange,outline,ovate,pedicel,peduncle,perennial,petiole,pitted,prickle,prickly,pubescent,rachi,ripe,sessile,simple,slender,spaced,sparsely,spreading,spreading-hirsute,stalked,stellae,stellate,stem,stigma,style,subglobose,surface,surrounding,tan,thin-textured,trichome,truncate,unbranched,uniseriate,vein,white,x,yellow	1-several,1/3-1/2,10-20,10-30,2-4,2-foliate,2.5-3,3-5,3.5-5,3.5-7,4-8,4-locular,6-18,7-20,8-30,9-18,absent,acute,acute-,adaxiall,also,armed,ascending,attenuate,axe,ba,basally,blade,breaking,broad-based,capitat,capitate-glandular,cauline,collection,commonly,connivent,cordate,cylindrical,deltoid,density,directed,distal,distall,eaf,eed,entire,female-sterile,finally,fine,flesh,geminat,glabrou,gland-tipped,glandular-puberulen,hair,immature,inserted,interlobal,intermixed,large,lateral,less,linear-lanceolate,lobe,long,longer,lower,major,maturit,medium-sized,midrib,mixed,mostly,much,narrowly,nflorescence,numerous,obtuse,obtuse-tipped,occasionally,often,open-campanulate,orolla,ovate-lanceolate,pale,per,petaloid,pore,principal,prominent,ray,recurved,reduced,resembling,rigid,ruit,section,short-stalked,short-styled,side,similar,sinus,small,smaller,sometimes,somewhat,ste,straight,straighter,subequal,tal,tamen,tem,termination,tip,toothlike,tube,unarmed,unit,usually,vary,varying,weakly,wide,widely,ympodial	'',[,``,abaxial,arrangement,bark,bud,capitate,characteristic,colour,dense,form,glandular-puberulent,growth,height,history,leaf,life,na,new,number,ovary,plant,position,reproduction,scar,seed,shape,spacing,staman,texture,value,width,{,}
598	wfo-0001030281	success	193	118	93	100	25	0.482	0.2-0.8,0.5-1,0.5-1.0,0.5-3,1-2,1-2.5,1.5,1.5-3,10-13,10-14,12-16,12-20,2-4,2-4.5,2.5-5,3-12,3-6,4-7,5-10,abaxial,abaxially,absent,acute,adaxial,andromonoecious,anther,apex,base,brown,capitate,chartaceous,cm,dark,densely,diameter,extra-axillary,filament,flower,fruit,functionally,glabrous,globose,green,hair,hermaphroditic,leaf,like,lobed,male,many,midpoint,midrib,midvein,mm,moderately,multicellular,nearly,netlike,obtuse,orange,ovate,pedicel,peduncle,petiole,pit,plant,porrect-stellate,prickle,pubescent,rachi,raised,ray,recurved,red,reniform,ridge,rusty,separated,simple,small,stellate,stem,stigma,style,surface,tan,unbranched,unicellular,vine,white,whitish-green,x,yellow	0.5,0.5-1.5,1,1-.,10-25,2-5,2.5-3,2.5-3.5,20-30,4-6,4-8,5-16,5-merou,6-8,absen,accrescent,adaxiall,adaxially,alyx,anthesi,apar,apical,armed,asymmetrical,attenuate,axe,berry,beyond,blade,calyx,connivent,cordate,curved,cylindrical,difoliate,directed,discolorous,distally,eaf,eed,either,em,expanded,exserted,flattened,frui,fruiting,geminate,glabrou,glandular,gree,heteromorphic,interpetelar,introrsel,lacking,leathery,lobe,long,long-styeld,lower,major,mature,multiseriate,narrowly,nflorescence,often,older,orolla,pair,per,planst,pore,reflexed,roselike,ruit,short,short0styled,side,slightly,spaced,sparsely,stalk,stamen,staminate,ste,tamen,tapering,tissue,triangular,tube,unarmed,unequa,unit,unlobed,usually,vary,vein,wide,ympodial,young	1-4,5-merous,apart,arrangement,colour,corolla,form,growth,height,history,inflorescence,length,life,na,number,ovary,perennial,position,reproduction,seed,shape,spacing,staman,texture,width
599	wfo-0001030285	success	279	134	111	168	23	0.398	.1,.6,0.3–0.7,0.6–0.9,0.7–1.3,1.6–5.0,1/3,10.8–12.3,2.2–4.8,3.5–6.0,3.7–5.4,4,4.3–11.8,5,9.2–15.2,9.9–14.9,abaxially,adaxial,adaxially,age,alveolate,anther,apart,apex,area,base,becoming,calyx,capitate,central,channel,chartaceous,cm,congested,corolla,densely,diameter,distally,dry,elliptic,erect,extra-axillary,filament,flattened-irregular,flattened-orbicular,flattened-reniform,flower,fruit,glabrous,glandular,globose,gradually,green,growth,hair,homostylous,increasing,internode,interpetalar,lateral,lavender,leaf,long,margin,mature,maturing,minute,mm,moderate,moderately,nearly,obovate,often,ovoid,pedicel,peduncle,petiole,poorly-developed,porrect,pubescence,pubescent,purple,red,restricted,sessile,shiny,shrub,simple,slightly,small,smooth,sparse,stellae,stellate,stigma,straight,style,surface,tall,thin,tissue,toward,tree,upper,white,yellow,yellow-ferruginous,young,±glabrous,±overlapping,×	.04,.4,.8,0.1–1.1,0.2–0.3,0.3–0.4,0.3–0.6,0.4–0.5,0.4–0.6,0.5–0.7,0.7–1.1,0.7–1.5,0.7–1.7,0.9–1.5,1.0–1.3,1.0–2.2,1.2–2.1,1.2–2.3,1.3–1.8,1.4–1.9,1.4–2.0,1.6–2.3,1.9–4.0,10–14,13.5,15.0–25.5,1984,2.4–3.2,2.8–3.1,3/4,4.0–7.0,4.6–8.8,45,4–5-merou,5.7–6.5,6.0–9.0,6–10,6–8-ray,90°,acuminate,adnate,aequilateral,alyx,anthesi,apical,apiculate,apparently,appearing,appressed,armed,articulated,attached,attachment,attenuate,axe,ba,basal,berry,bilobe,blade,branch,brochidodromous,bu,bud,channeled,clinate,conical,connivent,cuneate,deciduous,dehiscence,dentate,difoliate,dorsally,eaf,eed,either,emerging,enclosing,endocarp,entire,exocarp,fertile,filiform,flat,flexed,fork,forking,free,frui,fully,geminat,immature,inclined,intersepalar,juic,lanceolate,large,laying,less,line,lobe,lon,lower,major,many-flowered,midpoint,midrib,midvein,minor,nflorescence,notched,oblique,occasionally,orolla,peekel,per,perforate,point,pore,porrect-stellate,portion,potentially,prickle,protuberance,raised,ray,reduced,reported,rigid,ripe,rounded,row,ruit,shorter,side,single,sinus,soon,sparsely,splitting,spread,stellate-pubescent,stem,suture,tamen,tem,time,tip,transparent,triangular,truncate,tube,two,ud,unarme,unarmed,unbranched,vary,vein,vigorous,wavy,weakly,wide,ympodia,±90°,±90°and,±equal	4–5-merous,abaxial,arrangement,bilobed,colour,dioecious,form,height,history,inflorescence,length,life,na,ovary,perennial,plant,position,reproduction,seed,shape,spacing,staman,texture
600	wfo-0001030287	success	150	113	79	71	34	0.527	-11,-40,-many,0-15,0.5-1,1,1-10,1-15,1-2,1-4,1-5.5,1.5-2.5,1966,2-,2-12,3-9,4-5,4-6,4.5-6,?,acute,aggregate,apart,apex,articulated,base,bluish,cell,chartaceous,cm,compound,dendritically,densely,diameter,down,ellipsoidal,elliptic-ovate,entire,fide,flattened,flower,forked,glabrous,herb,leaf,lilac,long,margin,membranaceous,mm,moderately,ovoid,pedicel,peduncle,petiole,pinnately,puberulent,pubescent,purple,rachi,rugulose,scar,shrub,simple,slightly,smith,stellate,stigma,stone,strongly,style,subcordate,subcoriaceous,truncate,unbranched,unit,unknown,x,yellow	-foliat,.5-2.5,1-2.5,1-3,1.5-10,2,2-10,2-5,2.5-4,3,5-10,8-13,abaxially,adaxiall,adaxially,axe,basiscopically,blade,branched,calyx,color,connivent,cylindrical,decurrent,deltate,dendritic,dendritic-pubescen,directed,distall,eaf,eed,eglandular,gland,glandular,hair,lanceolate,lateral,leaflet,leaving,lobe,lon,long-stalked,lower,narrowly,nflorescence,nther,oblong,obtuse,often,orolla,pedicellar,pore,presen,radiu,ruit,scattered,spaced,sparsely,sparser,stalked,subcapitat,tal,tem,time,tip,triangular,tube,upper,vary,wide,ympodial	-foliate,abaxial,adaxial,anther,arrangement,colour,corolla,dendritic-pubescent,filament,form,fruit,growth,height,history,inflorescence,length,life,na,number,ovary,perennial,plant,position,present,reproduction,seed,shape,spacing,staman,subcapitate,surface,sympodial,texture,width
601	wfo-0001030299	invalid_json_followup	179	113	70	109	43	0.391	-40,-50,1-1.5,1-10,1.5-2,1.5-3,10-20,2,2-,2-10,2-20,2.5-12,25-50,3-13,3-9-compound,4-6,6-22,6-9,abaxially,acuminate,adaxially,apart,apex,calyx,campanulate,capitate,cell,chartaceous,cm,densely,diameter,ellipsoidal,entire,flattened,flower,forked,fruit,glabrous,globose,leaf,long,margin,mm,moderately,ovate,pedicel,peduncle,petiole,pink,pinnately,pubescent,pubescent-pilose,purple,rachi,rugose-reticulate,shrub,simple,small,sparsely,stigma,style,tomentose,tree,truncate,unbranched,urceolate-,violet,white,x,yellow	-2,-6,.5-2,0.5-1,1-2,1-3,1-5,1.5-4,10-16,2-4,20-30,3,3-30,3-4,3-5,4,4-5,4-8,4-foliat,5-10,5-40,5-8,?,absen,absent,acute,aggregate,also,ape,apiculate,articulated,axe,basal,base,basiscopically,beyond,blade,color,compound,connective,connivent,cordate,coriaceous,cylindrical,decurrent,diamete,dilated,directed,distally,eaf,eed,equal,exceeding,expanded,exserted,fide,hair,lateral,laterally,leaflet,leaving,lobe,lon,lower,midnerve,narrowly,nflorescence,nther,obtuse,often,orolla,pavón,pedicellar,perfect,perhaps,pilose-hirsute,pore,present,prominent,puberulent-pubescen,puberulent-pubescent,pubescent-pilo,radiu,remnant,ruit,ruiz,shorter,slightly,spaced,stamen,stone,tal,tem,thecae,thickened,time,tip,tomento,toward,triangular,tube,ud,unequal,unit,unknow,upper,vary,wide,ympodial	'',[,``,abaxial,adaxial,anther,arrangement,bark,bud,center,characteristic,colour,corolla,filament,form,fruiting,growth,height,history,inflorescence,length,life,na,new,number,ovary,plant,position,prickle,reproduction,scar,seed,shape,spacing,staman,stem,surface,texture,trichome,value,width,{,}
602	wfo-0001030300	invalid_json_followup	235	113	79	156	34	0.336	-1,-7,0.2-0.5,0.5,0.5-4,0.6-0.8,0.8-3,0.8-4,0.9-1,1,1-2,1-4,1.5-2.5,2-2.1,4-11,6-15,abaxially,adaxial,anther,apex,bifid,broadly,brown,calyx,capitate,cm,corolla,crenate,densely,diameter,ellipsoidal,elliptical,elongate,filament,flower,fruit,fruiting,globose,golden,green,hair-like,herb,imparipinnate,inflorescence,interrupted,irregularly,large,less,margin,mm,moderately,obovate,once-branched,orbicular,outgrowth,ovary,pale,pedicel,peduncle,pentagonal,perennial,petiole,plant,pubescent,rounded,simple,slightly,sparsely,spreading,stem,stigma,style,surface,trichome,uniseriate,yellow,yellowish,yellowish-green,zygomorphic	-0.9,.5,0.1,0.1-0.15,0.15-1,0.2,0.2-1.5,0.4-0.5,0.4-1.5,0.4-4.5,0.5-0.6,0.5-1,0.5-5,0.6-0.7,0.7-0.8,0.7-1.2,0.7-1.5,0.8-1,1-1.3,1-2-celled,1-6,1-celled,1.2-,1.4-2.4,1.5-,2-2.5,2-3,2-4,2-foliate,2-locular,2.2-7.5,3.5-13,3/4,4-celled,6-8-celled,9-12,absent,abundant,acute,adaxially,almost,although,always,anthesi,apical,appearance,appendage,articulated,articulation,ba,basal,base,bent,beyond,bract,bracteate,brittle,cell,coherent,column,cordate,crenat,curved,deltate,developed,diamete,distal,eaf,edicel,eed,eglandular,entire,even,exserted,face,finely,frequently,give,glabrous,glandular,glutinous-viscose,gree,halfway,head,interjected,internode,introrse,lamina,larger,lateral,leaflet,leave,like,lobe,lon,long,longer,markedly,midvein,minute,multicellular,narrowly,nflorescence,node,oblique,occasionally,pair,papillae,partially,petal,petiolule,pith,population,pore,present,primary,pseudostipule,pubescence,reflexed,rest,ruit,secondary,silky,spathulate,spreadin,staminal,sterile,straight,strongly,tall,tem,terminal,tertiary,testa,thick,tip,triangular,tube,two,ud,underlying,unicellular,unit,united,upper,usually,vein,velvety,wall,weak,well,wide,wider,winged,woody,ympodial	'',[,``,abaxial,arrangement,bark,bud,center,characteristic,colour,form,growth,height,history,leaf,length,life,na,new,number,position,prickle,rachi,reproduction,scar,seed,shape,spacing,staman,texture,value,width,{,}
603	wfo-0001030311	invalid_json_followup	182	114	57	125	57	0.313	.2,5-pinnate,abaxially,accrescent,adaxial,adaxially,anther,apex,brown,calyx,chartaceous,cm,densely,diameter,entire,extra-axillary,filament,flower,fruit,fruiting,glabrous,granular,green,herbaceous,lenticular,margin,membranaceous,membranous,mm,orangish,ovoid-rhomboid,pedicel,peduncle,petiole,pubescent,purplish,rachi,sand-punctate,scattered,short,slender,slightly,sparsely,stellate,stem,stigma,style,surface,tan,terrestrial,trichome,unbranched,vine,white,wide-diameter,widely,x	.5,.5–1.8,0.1,0.1–0.2,0.3–1.5,0.4–2,0.5–0.8,0.5–1,0.5–2,0.5–2.5,0.6–1,0.6–2.4,0.8–1.2,0.8–4,0.8–4.5,1.2–7,1.5–2,1.5–3,1.5–5.5,1.5–6,1.5–8,1.8–2,15–22,1–1.2,1–1.5,1–2,1–2.5,1–3,2.2–2.5,2.2–3,2.5–9,2–10,2–2.5,2–6,3–5,3–7,5–10,<,acuminate,acute,along,alyx,apar,apical,appearance,axe,basal,base,berry,blade,c.,capitat,ciliat,ciliate,clavate,color,cordate,cuneate,deltoid,dense,distal,eaf,eed,elliptical,especially,falcate,fallen,flattened,giving,glabrou,groov,groove,ground,hair,half,lanceolate,lateral,leaflet,like,lobe,log,lon,long,lower,m.,midvein,minutely,nflorescence,nternode,oblique,obovate,obtuse,occasionally,orolla,pair,papillose,petiolulate,petiolule,plurifoliat,present,proximal,pubescence,rhomboid,rounded,ruit,sessile,shortly,side,smaller,spaced,strongly,tamen,tem,thick,thickened,thinner,tip,trailing,tube,unit,upper,vary,vein,wide,ympodial	'',.5-1.8,0.1-0.2,0.3-1.5,0.5-1,0.6-1,0.8-1.2,1-1.5,1-3,1.5-3,1.5-5.5,15-22,2-10,2-2.5,2-6,2.5-9,3-5,3-7,5-10,[,``,abaxial,apart,arrangement,bark,bud,capitate,center,characteristic,colour,corolla,form,growth,height,history,inflorescence,leaf,length,life,na,new,number,ovary,plant,position,prickle,reproduction,scar,seed,shape,spacing,staman,texture,value,width,{,}
604	wfo-0001030311	invalid_json_followup	203	115	75	128	40	0.369	.2,.5,0-2.5,0.5-1,0.6-1,0.8-1.2,1-1.5,1-3,1.5-5.5,15-22,2-10,2-2.5,2-6,3-5,3-7,5-10,5-pinnate,[,abaxially,acuminate,adaxial,adaxially,along,anther,apart,apex,brown,chartaceous,cm,densely,diameter,entire,especially,filament,flattened,flower,fruit,glabrous,granular,green,groove,herb,lenticular,long,margin,membranaceous,minutely,mm,obtuse,orangish,ovoid-rhomboid,pedicel,peduncle,petiole,pubescent,purplish,rachi,rounded,scattered,simple,slender,sparsely,stellate,stem,stigma,style,surface,tan,unbranched,uniseriate,vein,white,widely,x,yellow	.5-1.8,0.1,0.4-2,0.5-0.8,0.5-2,0.6-2.4,0.8-4,0.8-4.5,1-1.2,1-2.5,1.2-7,1.5-2,1.5-3,1.5-6,1.5-8,1.8-2,2.2-2.5,2.2-3,2224,5-merou,8031,<,],absen,absent,accrescent,acute,ag,aggregate,alyx,apical,apparently,appearance,articulated,axe,ba,basal,basally,base,blade,capitat,cell,ciliat,ciliate,clavate,color,connivent,cordate,cuneate,deltoid,dense,dig,directed,distal,distally,eaf,eed,elliptical,equal,falcate,fallen,formation,g,geminat,gh,giving,groov,ground,hair,half,interjected,large,lateral,leaflet,like,lobe,log,lon,longitudinal,lower,m.,midvein,nflorescence,node,oblique,oblong,obovate,occasionally,opening,orolla,pair,papillose,perfect,petiolulate,petiolule,pittier,plurifoliate,pore,present,proximal,rhomboid,rooting,ruit,sessile,short,shortly,side,sinple,slightly,slit,smaller,spaced,stone,strongly,tamayo,tamen,tem,thick,thickened,thinner,tip,trailing,tube,unit,upper,vary,wide,ympodial	'',``,abaxial,arrangement,bark,bud,calyx,capitate,center,characteristic,colour,corolla,form,fruiting,growth,height,history,inflorescence,leaf,length,life,na,new,number,ovary,plant,position,prickle,reproduction,scar,seed,shape,spacing,staman,texture,trichome,value,width,{,}
605	wfo-0001030335	invalid_json_followup	153	112	70	83	42	0.458	.1,0-5,0.05-0.2,0.25-0.5,0.5-1,0.7-1,1-2,1.1-1.4,2-2.5,2-5,3/4,5-6,acute,along,anther,apex,bark,base,beneath,bi-lobed,bud,calyx,cm,conical,corolla,dark,densely,dry,elliptic,erect,filament,filiform,fruiting,glabrous,globose,green,greyish-red,leaf,lobed,long,material,minutely,mm,narrowly,opposite,ovary,ovoid-reniform,pale,papillose,pedicel,petiole,pitted,puberulent,pubescent,ripe,shrub,simple,sparsely,stem,stigma,style,surface,tan,trichome,uniseriate,vein,way,white,yellow,yellowish-green	.25,.5,.75,0.1-0.5,1-1.5,1-3-flowered,1.1.5,2-2.2,2-4.5,2.5-3,5-7,7-13,acuminate,anthesi,aspec,ba,berry,branch,deciduous,decurrent,deflexed,deltoid,dia,eaf,edicel,eed,except,expanded,exserted,flattened,free,geminate,gently,giving,horizontally,lamina,lateral,lenticellate,lightly,like,lobe,lon,lower,main,middle,minute,nflorescence,obovoid,occasionally,often,older,onto,pair,papillo,pore,poricidal,portion,prominent,puberulen,raised,reflexed,ruit,shaped,slightly,soon,spreading,straight,strongly,tall,tapering,tear-drop,tip,tube,ud,underside,unifoliat,unit,widest,winged,woody,x,ympodial,young	'',1-3,[,``,abaxial,adaxial,arrangement,cell,center,characteristic,colour,diameter,flower,form,fruit,growth,height,history,inflorescence,length,life,margin,na,new,number,peduncle,perennial,plant,position,rachi,reproduction,scar,seed,shape,spacing,staman,texture,unifoliate,value,width,{,}
606	wfo-0001030336	invalid_json_followup	266	112	76	190	36	0.286	0.2-0.8,0.5,0.5-0.7,0.8-1.3,1-1.5,1-3,1.7-2.3,4-10,8-20,acute,almost,anther,apex,articulated,bifurcate,bluntly,bright,brown,calyx,capitate,cm,conical,corolla,crenate,dark,densely,diameter,elliptic,elongate,entire,filament,flower,fruit,fruiting,globose,grayish,green,greenish,hair-like,herb,imparipinnate,inflorescence,interrupted,leaf,less,margin,mm,obovate,orbicular,outgrowth,ovary,pale,pedicel,peduncle,perennial,petiole,pubescent,rachi,rotate,rounded,scattered,shrub,simple,slightly,small,stellate,stem,stigma,style,surface,trichome,uniseriate,velvety,white,woody,yellow	-1.5,-10,-19,-2,.5,0-,0.1-0.3,0.1-0.5,0.1-0.7,0.1-1,0.15-0.2,0.15-0.9,0.2,0.2-0.25,0.2-1,0.2-1.5,0.3-0.4,0.3-1.1,0.5-1,0.5-1.5,0.6-0.8,0.6-1.5,0.8-0.9,0.8-1.2,0.8-3,1,1-1.4,1-celled,1.0-1.4,1.5-,1.5-2,1.5-3.5,1.5-5,1.6-7,1.8-3.0,1/4-1/3,10,2-4,2-9,2-foliate,2-locular,2/3,3-5,4,4-,4-celled,6,8-16,8-celled,absent,adpressed,amongst,anthesi,apical,appearance,appearing,appendage,articulation,basal,base,basiscopically,bent,berry,bract,bracteate,branch,cell,clavat,coat,column,completely,cordate,curved,darker,decurrent,deeply,developed,diamete,distal,divided,eaf,edicel,eed,eglandular,entir,erect,essentially,exserted,extremely,first,flushed,giving,glandula,glandular,half,halfway,head,interjected,internode,investing,lanceolate,large,larger,largest,lateral,leaflet,leave,like,lobe,lobed,lon,long,longer,loosely,lower,markedly,maturity,mere,middl,midvein,minute,minutely,mixed,mostly,narrowing,narrowly,nflorescence,node,oblique,occasionally,often,once-branched,pair,papillate,part,petiolule,population,present,primary,proximal,pseudostipule,puberulent,purple,range,reflexed,rest,ruit,secondary,sessile,shaggy,shorter,silky,sinus,soft,sometimes,southern,sparse,spreadin,spreading,staminal,sterile,straight,stripe,strongly,surrounding,tall,tem,ten,terminal,tertiary,testa,thick,tip,truncate,tube,two,ud,unicellular,uniformly,unit,united,upper,usually,wall,way,weak-walled,wide,winged,ympodial,young	'',1.5-4,[,``,abaxial,adaxial,arrangement,bark,bud,center,characteristic,clavate,colour,form,growth,height,history,length,life,na,new,number,plant,position,prickle,reproduction,scar,seed,shape,spacing,staman,texture,value,width,{,}
607	wfo-0001030342	success	155	81	42	113	39	0.271	1-6.5,3-pinnate,anther,apex,brown,chartaceous,cm,dense,diameter,entire,extra-axillary,filament,flower,fruit,glabrous,greenish,herbaceous,leaf,lenticular,light,margin,membranous,mm,ovoid-rhomboid,pedicel,peduncle,petiole,rachi,scattered,slender,smooth,stellate,stigma,style,surface,trichome,unbranched,undulate,vine,white,widely,yellowish	.2,.5,0.1–0.2,0.3–1.2,0.5–1,0.5–3,0.5–5,0.8–1.5,0.8–4,1-5,1.2–3,1.5,1.5–13,1.5–2,1.5–5,1.5–7.5,10–25,1–1.2,1–1.5,1–2.5,1–3,1–5.5,1–6,1–7,2–,2–2.5,2–4,3,3–12,4–5,4–8,5-merous,6–7,abaxially,abundant,accrescent,acuminate,acute,adaxially,along,alyx,apar,apical,apiculate,axe,base,berry,blade,broadly,c.,calyx,capitat,ciliat,cordate,cuneate,cylindrical,deltoid,eaf,eed,elliptical,flattened,fruiting,glabrou,lanceolate,lateral,leaflet,like,lobe,lon,long,lower,m.,minutely,mottled,nflorescence,nternode,oblique,obtuse,often,orolla,perfec,petiolule,plurifoliat,pointed,proximal,pubescen,pubescent,rarely,revolute,rhomboid,rounded,ruit,sand-punctate,side,slightly,spaced,sparsely,stem,tamen,tem,terrestria,tip,truncate,truncate-acuminat,tube,unit,vary,vein,wide,wide-diameter,x,ympodial,–7	0.1-0.2,0.3-1.2,0.8-1.5,1-1.5,1.5-13,1.5-5,10-25,2-2.5,2-7,3-12,4-5,4-8,abaxial,adaxial,arrangement,capitate,colour,corolla,form,growth,height,history,inflorescence,length,life,na,number,ovary,perfect,plant,position,reproduction,seed,shape,spacing,staman,terrestrial,texture,width
608	wfo-0001030342	invalid_json_followup	153	111	69	84	42	0.451	-7,.2,0.5-3,1-1.2,1-1.5,1-6.5,1.5-13,1.5-2,1.5-5,10-25,2-2.5,2-3,3,3-12,3-pinnate,4-5,4-8,abaxially,acuminate,adaxially,anther,apart,apex,brown,calyx,chartaceous,cm,deltoid,diameter,entire,extra-axillary,filament,flower,fruit,fruiting,glabrous,hair,herb,leaf,lenticular,light,margin,membraceous,mm,obtuse,pedicel,peduncle,petiole,pubescent,rachi,rarely,scattered,simple,slender,smooth,stellate,stigma,style,surface,terrestrial,trailing,truncate,unbranched,undulate,uniseriate,white,widely,x,yellow	.5,0.5-1,0.5-5,0.8-4,1-3,1-5,1-5.5,1-6,1-7,1.2-3,1.5-7.5,2-,5-merou,6-7,absent,abundant,accrescent,acute,ag,along,alyx,apical,apiculate,apparently,articulated,axe,ba,basally,base,blade,broadly,capitat,ciliat,connivent,cordate,cuneate,cylindrical,directed,distally,eaf,eed,elliptical,equal,geminat,interjected,lanceolate,lateral,leaflet,lobe,long,longitudinal,lower,minutely,nflorescence,node,oblique,oblong,opening,orolla,perfect,petiolule,plurifoliate,pore,proximal,pubescen,revolute,rhomboid,rooting,rounded,sagittate,side,slightly,slit,spaced,tamen,tem,tip,truncate-acuminat,tube,unit,vary,vein,wide,ympodial	'',5-merous,[,``,abaxial,adaxial,arrangement,bark,bud,capitate,center,characteristic,colour,corolla,form,growth,height,history,inflorescence,length,life,na,new,number,ovary,perennial,plant,position,prickle,reproduction,scar,seed,shape,spacing,staman,stem,texture,trichome,value,width,{,}
609	wfo-0001030353	success	227	121	98	129	23	0.432	-1.5,-6,-merous,.7,0-6,0.5,0.5-0.9,1-2,1-6,1-7,1.8-3,1/2-2/3,1/3,2-7,3-5.5,3.5-4,5,6-15,abaxial,abaxially,acute,adaxial,almost,andromonoecious,anther,apex,articulated,bark,base,berry,brown,chartaceous,cm,conical,connivent,curved,densely,diameter,ellipsoid,elliptic,erect,evenly,filament,flattened,flattened-reniform,flower,fruit,glabrescent,glabrous,green,lateral,leaf,length,lobed,long,lower,margin,maturity,mauve,mm,moderately,multangulate,orange-brown,pedicel,peduncle,petiole,plant,poricidal,porrect,prickle,red-brown,reddish-green,shape,shrub,simple,small,smooth,sometimes,sparsely,stellate-pubescent,stout,straight,style,subentire,surface,tapering,terminal,tip,tree,trichome,unbranched,warty,way,weakly,white-gray,wide,yellow,young	-0.2,-1/2,-2,-3,-5,.1,.2,.5,0,0-15,0-2,0.1-0.2,0.1-0.3,0.15-0.3,0.8,0.8-1.2,1,1-3,1.2-1.8,1.8-2.2,1/,1/5,1/6,1/6-1/4,10-15,11-16,2-10,2.5-4,2.8-3.7,20-200,3-4,4-,4-4.5,4-5,5-6,6,6-8,7-10,8-15,alyx,apar,apart,apically,apiculat,apparently,blade,broad-deltate,c.,calyx,cuneate,deltate,development,discolorous,distal,distance,drying,eaf,eed,elongating,equal,extending,free,fruiting,half,hermaphrodite,heterostylous,infructescence,less,lobe,long-styled,longer,lowermost,mature,midpoint,midvein,narrow-deltate,nflorescence,older,one,open,orolla,oung,pair,patch,pendulous,per,pericarp,plurifoliat,pointed,portion,prickly,primary,ray,reflexed,retaining,rounded,ruit,scar,sessile,short-styled,shorter,side,somewhat,spaced,spreading,stalk,stalked,staminat,stellate,stem,strongly,tamen,terete,tertiary,throughout,time,tube,unarme,unarmed,unit,upper,vary,vein,venation,visible,whit,wo,woody,ympodial	.1-0.2,arrangement,colour,corolla,form,growth,height,history,inflorescence,life,na,number,ovary,perennial,position,reproduction,seed,spacing,staman,stigma,texture,white,width
610	wfo-0001030407	success	182	90	56	126	34	0.308	.5,1-10,1-2,12-14,12-15,2-7,3-6.5,3.5-9.5,30-60,4-5,7-8,acuminate,anther,apex,articulated,berry,bud,cell,cm,conical,corolla,densely,diameter,elliptic-lanceolate,filament,flower,forked,fruit,glabrous,green,greenish,hair-like,herb,homostylous,leaf,light,long,margin,mm,mucilaginous,odd-pinnate,ovate,ovoid,pedicel,peduncle,pentagonal,petiole,plant,pubescent,purple,seed,stigma,style,terminal,whitish,yellow	.2,0.7-3.2,1-3,1-4,1.5-5,2-2.5,2-5,2-6.7,3-10.5,3-4,3-9,5,5-merou,6-7,6.5-18.5,abaxially,absent,acumen,adaxially,ag,alyx,apart,apparently,axe,axillary,base,blade,brownish,capitat,chartaceous,ciliate,condition,connivent,covering,decreasing,digestion,distal,dorsally,drying,eaf,edge,eed,end,enzyme,especially,exceeding,flat,folded,fresh,geminat,generally,glabrou,gradually,green-white,hair,half,honeycomb-shaped,interjected,lanceolate,larger,lateral,leaflet,lengthening,like,living,lobe,lower,make,middle,minute,mottled,nflorescence,obtuse,one,orolla,pair,perfect,petiolule,placed,plurifoliate,pore,poricidal,proximal,pubescen,ray,removed,ripe,round,ruit,secondary,semierec,seudostipule,size,slit,spaced,specimen,stamen,ste,stolo,subequal,subsessile,subtending,symmetrical,tall,tamen,tem,testal,thick,thir,throughout,tip,toward,tri-,tube,tuber,typically,unit,unwinged,usually,vary,wall,wet,white,wide,x,ympodial	abaxial,adaxial,arrangement,bark,calyx,capitate,center,colour,form,fruiting,growth,height,history,inflorescence,length,life,na,new,number,ovary,perennial,position,prickle,rachi,reproduction,scar,shape,spacing,staman,stem,surface,texture,trichome,width
611	wfo-0001030417	invalid_json_followup	242	108	74	168	34	0.306	-5,0.5-0.7,0.5-1,0.7-1,1-1.3,1.2-3,2-3,3,4-25,7-30,annual,anther,apex,biennial,bright,broadly,brown,calyx,capitate,cell,cm,conical,corolla,densely,dentate,diameter,elliptic,elongate,entire,filament,flower,fruit,fruiting,glandular,globose,green,hair-like,herb,imparipinnate,inflorescence,interrupted,leaf,length,like,margin,mm,obovate,occasionally,once-branched,outgrowth,ovary,ovate,pale,pedicel,peduncle,perennial,petiole,pubescent,red,round-crenate,scattered,simple,slightly,sparsely,stellate,stem,stigma,style,surface,thin,trichome,uniseriate,white,yellow	.5,0.05-0.1,0.1-0.25,0.2,0.2-0.4,0.2-0.7,0.25-0.4,0.25-0.5,0.3-0.4,0.5-0.8,0.5-1.2,0.5-2,0.8,1,1-1.2,1-1.5,1-2,1-2-celled,1-2.3,1-3.5,1-4,1.5-2,1.5-3.5,1.5-5,1.5-8,1/3,2-4,2-8,2-locular,2.5-5,2/3,3-foliate,3/4,4-12,8-11,abaxially,absen,absent,abundant,acuminate,acute,along,also,anthesi,apical,appearance,appendage,articulation,basal,base,basiscopically,bent,branch,cente,column,common,cordate,crenate,decreasing,decurrent,distal,eaf,ebracteate,edicel,eed,eglandular,erect,exserted,extended,extending,extremely,free,generally,giving,glabrous,gree,hal,head,hybrid,included,initially,interjected,internode,lanceolate,larger,largest,later,lateral,leaflet,lobe,lon,long,lower,maturation,mature,minute,minutely,mixture,multicellular,narrowly,nflorescence,northern,oblique,often,pair,parallel,part,patent,pedice,peruvian,petiolule,point,population,portion,primary,procumbent,proximal,pseudostipule,pubescence,putatively,rachi,range,rarely,reflexed,rest,ripe,robust,rounded,ruit,secondary,sessile,several,shaggy,short,silky,size,sometimes,somewhat,species,staminal,sterile,straight,strongly,tem,terminal,tertiary,testa,theseadpressed,thick,third,tip,toward,truncate,tube,type,ud,unicellular,unit,usually,variable,vein,velvety,viny,wall,way,wide,winged,ympodial	'',0.8-5,[,``,abaxial,adaxial,arrangement,bark,bud,center,characteristic,colour,form,growth,height,history,life,na,new,number,plant,position,prickle,reproduction,scar,seed,shape,spacing,staman,texture,value,width,{,}
612	wfo-0001030420	invalid_json_followup	170	123	78	92	45	0.459	-20,-30,-9,-pubescent,0.5-1,0.5-4,0.5-8,1-,1-3,1-4,1-6,1.5-3,10-,15-25,2-,2-3,2-6,2-9,3-lobed,4-7,5-,5-15,6-7,abaxially,acuminate,adaxially,also,apart,apex,articulated,base,calyx,chartaceous,cm,densely,diameter,eglandular,ellipsoidal,elongated,entire,flower,forked,fruit,glabrous,glandular-puberulent,hair,leaf,lobed,long,margin,mm,moderately,often,pedicel,peduncle,petiole,pilose,pinnately,puberulent,pubescent-pilose,purple,rachi,rarely,shrub,simple,small,sparsely,stellate,stigma,style,subcoriaceous,tree,truncate,unbranched,unknown,unlobed,x,yellow	-2,-35,-4,0.5-,1,1-1.5,1-2,1-7.5,1.5-5,1/2,10-25,2-14.5,2-5,3-7,4-foliat,5-6,7-19,7-22,7/8,absent,acute,aggregate,ape,axe,basal,beyond,blade,cell,color,connective,connivent,cordate,cylindrical,dark,deltate,directed,distally,divided,eaf,eed,eglandular-pilo,eglandular-puberulent,elliptic-ovate,equal,exserted,glabrate,glandular-,lanceolate,leaving,lobe,lon,lower,midrib,narrowly,nearly,nflorescence,nther,obtuse,orolla,ovate,pedicellar,perfect,pore,presen,puberulent-pubescent,pubescent,pubescent-pilo,radiu,remnant,ripe,ruit,shorter,sinus,spaced,stamen,stone,tal,tem,thecae,time,tip,tomento,triangular,truncat,tube,ud,unit,vary,vein,wide,yello,ympodial	'',[,``,abaxial,adaxial,anther,arrangement,bark,bud,center,character,characteristic,colour,corolla,filament,form,fruiting,growth,height,history,inflorescence,length,life,na,new,number,ovary,plant,position,prickle,reproduction,scar,seed,shape,spacing,staman,stem,surface,texture,tomentose,trichome,value,width,{,}
613	wfo-0001030426	success	158	79	53	105	26	0.335	-30,0.4-0.7,1-4,1-4.2,15-25,2-3,2.5-4,2.5-6,3-12,6-8,9,acute,apex,branched,cell,cm,corolla,cyme,diameter,dichasial,dichasially,distal,ebracteate,filament,flower,forked,glandular,globose,green,green-white,half,heart-shaped,herbaceous,leaf,mm,monochasial,mucilaginous,odd-pinnate,ovoid,pedicel,peduncle,perennial,petiole,pilose,plant,rachi,seed,spot,stellate,stigma,style,white,yellow	0.3-7,0.3-8,1.5-3,1.5-6.5,1.7-3.2,10,2,3-4,3-6,3-6-foliat,4-10,4-6.5,6-11.5,abaxially,absen,acumen,adaxially,apical,apically,apiculate,articulate,base,calyx,caudate,connate,covering,decurrent,dehiscent,digestion,diminishing,dorsally,eaf,edge,eed,elliptic-lanceolate,emoval,enzyme,exceeding,flat,folded,generally,globo,gradually,hair-like,honeycomb,interjected,introrse,lanceolate,larger,lateral,leaflet,linear,linear-lanceolate,linear-oblong,living,lobe,lon,long,lower,make,maturing,nflorescence,nther,oblique,oblong,obtuse,often,orolla,pair,pattern,perfect,pinnatifi,plan,poricidally,proximal,reveal,rounded,ruit,second,sessile,seudostipule,short,size,slit,specimen,stamen,straight,stripe,tal,tem,terminal,testal,thick,throughout,toward,tuber-bearing,typically,unit,vary,wall,whit,wide,without,ympodial,¼	abaxial,adaxial,anther,arrangement,center,colour,form,fruit,growth,height,history,inflorescence,length,life,na,number,ovary,pinnatifid,position,reproduction,shape,spacing,staman,surface,texture,width
614	wfo-0001030430	invalid_json_followup	171	119	65	106	54	0.38	.2,0.25,0.3,0.4,0.5,abaxially,adaxially,anther,anthesi,apart,apex,appressed,articulated,axillary,base,blade,blue,branched,brown,bud,calyx,capitate,clavate,cm,densely,diameter,filament,flattened,flower,fruit,glabrous,globose,green,indumentum,leaf,lobed,long,margin,mm,moderately,multicellular,occasionally,pale,pedicel,peduncle,pentagonal,perennial,petiole,pubescent,purple,regularly,shoot,shrub,simple,stigma,style,subglabrous,surface,terminal,unifoliate,uniseriate,violet,white,x,yellow	.5,0.5–12,0.6,0.6–0.8,0.6–1.0,0.8–3.0,0.8–5.6,0.9–1.0,0–20,1.0–1.2,1.0–1.5,1.0–2.0,1.2–2.0,1.3–8.0,1.4–1.5,1.5–1.7,1.6–1.8,1.8–5.0,12–20,12–30,1–3,1–9,2.0–3.0,2.0–4.2,2–3,3.0–4.5,30–200,3–17,3–24,3–4,3–5,3–8,5,5.5–12,5–10,5–6,6–10,abundant,acute,adaxiall,ag,apical,axe,ba,basal,borne,brittle,cell,chartaceous,connivent,convex,cylindrical,decurrent,dentate,diamete,eaf,eed,elliptic,equal,erect,especially,few-seeded,fleshy,geminat,hair,lobe,lon,longitudinal,lower,m.,nflorescence,oblong,opening,orolla,ovate,pair,perfect,pitted,pore,poricidal,present,rounded,ruit,serrate,shallowly,shaped,side,slit,spaced,stone,straight,tal,tamen,tear-drop,tem,time,tip,toward,tube,unit,vary,wide,woody,ympodial,–2.7,–40	'',0-20,0.5-12,1.0-1.5,1.0-2.0,12-20,12-30,3-17,3-5,3-8,3.0-4.5,30-200,40,5-10,5-6,[,``,abaxial,adaxial,arrangement,bark,center,characteristic,colour,corolla,form,fruiting,growth,height,history,inflorescence,length,life,na,new,number,ovary,plant,position,prickle,rachi,reproduction,scar,seed,shape,spacing,staman,stem,texture,trichome,value,width,{,}
615	wfo-0001030441	invalid_json_followup	178	134	97	81	37	0.545	+,.5,0.5,0.5-0.75,0.5-3,1-1.4,1-1.5,1-2-celled,1.5-2,10-40,2,2-10,2-5.5,3-4,5-7.5,6-11,<,acuminate,acute,anther,apart,apex,base,berry,branched,bright,c.,capitate,cell,cm,corolla,diameter,ellipsoid,elliptic,entire,filament,flattened,flower,glabrous,glandular,globose,green,growth,irregularly,lateral,lobed,long,many,margin,membranous,minutely,mm,narrowly,new,occasionally,open,otherwise,pale,papillose,pedicel,peduncle,petiole,plant,poricidal,pubescent,red,reniform,ripe,scar,shiny,shrub,simple,slightly,spaced,spot,spreading,stellate,stigma,style,surface,terminal,thin,time,tip,trichome,tube,undulate,uniseriate,unit,usually,vine,violet,wall,way,white,woody,yellow	0.5-1,1,1.2-1.4,2-3,2.5,30,4-5,5-14,5-6,5-7,5-merou,>,ag,along,alyx,anthesi,ark,articulated,attenuate,brow,calyx,closely,decurrent,deltate,distall,eaf,eed,exerted,eye,flexuous,free,fruiting,glabrou,glandula,hair,ilament,impressed,juicy,leaving,lengthening,lobe,lon,lower,making,markedly,midvein,nflorescence,older,onto,orolla,pair,papillat,peg,per,perfect,pericarp,plurifoliat,pore,portion,primary,reflexed,ridged,ruit,scandent,short,shrubby,slit,small,somewhat,spreadin,stem,strongly,tem,trailing,triangular,ud,upper,vary,vein,wide,ympodial	'','hair,5-merous,[,],``,abaxial,adaxial,arrangement,bark,brown,characteristic,color,form,fruit,height,history,inflorescence,leaf,length,life,number,ovary,papillate,perennial,plurifoliate,position,reproduction,seed,shape,spacing,sympodial,texture,value,width,{,}
616	wfo-0001030444	success	196	80	54	142	26	0.276	0.15-0.8,0.8-2,1-10,1-2,11-45,2.4-3.8,3-10,3-5,4-39,4-7,7.1-17.5,anther,apex,berry,blue,cell,clavate,cm,coriaceous,corolla,dark,deep,diameter,elliptic,filament,flower,forked,fruit,glabrous,green,greenish,herb,honeycomb-shaped,leaf,light,lilac,medium,mm,mucilaginous,odd-pinnate,ovate,ovoid,pedicel,peduncle,pentagonal,petiole,plant,rotate,seed,stigma,style,terminal,whitish,yellow	0-24,1,1-4,1-5,1.1-2.7,1.2-1.8,2-3,2-6,2-8,2.3-3.6,3.7-6.8,4-17,5-merou,5.3-9,6.1-12.8,9.4-20.1,abaxiall,abaxially,acumen,acuminate,acute,adaxially,ag,along,alyx,apart,apparently,arranged,articulated,asymmetric,attenuate,axe,axillary,base,basiscopic,bead,blade,brownish,bud,capitat,ciliate,condition,connivent,covering,decreasing,digestion,distal,dorsally,dot,drying,eaf,edge,eed,enzyme,erec,exceeding,flat,folded,fresh,geminat,general,generally,glabrou,green-white,hair-like,hal,half,high,homostylous,interjected,lanceolate,larger,lateral,leaflet,lengthening,like,linear,living,lobe,long,lower,make,margin,moniliform,multiple,narrow,necklace,nflorescence,orbicular,orolla,pair,perfect,petiolulate,plurifoliate,pore,poricidal,purple,removed,ripe,rough,rounded,ruit,sessile,seudostipule,shortly,side,size,slit,sometimes,spaced,specimen,stamen,stolon,straight,subequal,subtending,symmetric,tall,tamen,tem,testal,thick,throughout,tip,tissue,touch,toward,tri-,tube,tuber,typically,unit,unwinged,usually,vary,wall,wet,white,wide,wing,x,ympodial	abaxial,adaxial,arrangement,capitate,center,colour,form,growth,height,history,inflorescence,length,life,na,number,ovary,perennial,position,rachi,reproduction,shape,spacing,staman,surface,texture,width
617	wfo-0001030445	invalid_json_followup	226	133	96	130	37	0.425	0.2-0.4,0.2-0.5,0.4,0.6-2.2,0.6-3.5,1-7,1.3,1.3-2,1.5-2.1,1.7-2.4,2.1-5.2,3.5-4.2,4.1-8.7,4.2-10,6.1-9.1,7.5-16,8.2-18,abaxial,abaxially,accrescent,acuminate,adaxially,along,anther,apart,apex,articulated,bark,base,black,blade,branched,brown,bud,calyx,capitate,cm,corolla,deltoid-reniform,diameter,drying,elliptic,elliptical,elongated,entire,ferruginous,ferruginous-tomentose,filament,flower,fruit,fruiting,glabrate,globose,green,greyish-tan,homostylous,leaf,long,many,margin,mm,mostly,oblong-lanceolate,obovate,orange,orangish-tan,orbicular,pedicel,peduncle,petiole,porrect-stellate,pseudoterminal,rachi,reniform,reticulate-punctate,semi-spherical,sessile,shrub,simple,small,stellate,stem,stigma,style,surface,thick-textured,thin-,time,tomentose,tree,vein,white,x,yellow,yellowish,yellowish-tan	.1,.5,/5-2/3,0.1-0.7,0.2,0.2-0.7,0.3,0.5,0.7,0.8,1,1-1.3,1.1-4.3,1.3-1.8,1.6-2,1.8-3.5,10-14,10-16,14,15-35,2.2-2.9,2.2-3.5,2.4-4.7,3-5.4,3.1-5,3.4-5.6,5-125,5-merou,5.2-7.1,5.9-15,5.9-8.3,8.1-10,acute,ag,alyx,appressed,around,axillary,berry,blunt-tippe,blunt-tipped,branch,brownish-yellow,bulbous-based,concentrated,cylindrical,decurrent,directed,distally,eaf,earl,edge,eed,erect,exserted,ferruginous-granular,free,geminate,glabrescen,glabrous,hair,high,inserted,intermediate,lackin,lateral,lengthening,lobe,lobed,lon,longitudinal,lower,m.,main,midrib,midvein,multangulat,multangulate,nflorescence,oblong,obscured,obtuse,older,open,orolla,ovate,ovate-lanceolate,plurifoliate,pore,poricidal,porrect-stellat,pubescence,pubescent,ray,relatively,resorption,rounded,ruit,runk,side,slightly,slit,somewhat,soon,spaced,sparse,sparsely,splitting,stalk,stamen,stout,subcampanulate,sulcate,suture,tamen,thick,thicknes,thin,tip,tissue,tomentum,tube,unarme,unit,vary,vestigial-rayed,way,wide,ympodial,young	'',5-merous,55-125,[,``,adaxial,arrangement,characteristic,colour,form,glabrescent,growth,height,history,inflorescence,length,life,na,new,number,ovary,perennial,plant,position,prickle,reproduction,scar,seed,shape,spacing,staman,texture,trichome,value,width,{,}
618	wfo-0001030447	invalid_json_followup	276	155	113	163	42	0.409	.2,.5,/5,0.5-0.65,0.5-10,0.5-3,0.7-1,0.8-3.5,1,1.5,1.5-7,1/3,2-4,2.5-10,2.5-6.5,3,6-10,6-16,7-8,8,abaxially,always,anther,apical,armed,bark,berry,c.,calyx,cell,clavate,cm,corolla,cupular,curved,densely,diameter,drying,erect,filament,finely,flattened,flattened-reniform,flower,fruit,fruiting,gently,glabrous,globose,leaf,length,lobed,long,lower,margin,mature,maturity,midvein,mm,moderately,obconical,oblong,orange,orange-brown,orange-red,outline,ovate,pale,pedicel,peduncle,persisting,petiole,pit,porrect,prickle,prostrate,pubescent,purple,rachi,raised,red-brown,ridged,scar,sessile,shallowly,shiny,shortly,shrub,side,slender,small,smooth,sometimes,sparse,sparsely,stalked,stellate,stellate-pubescent,stem,stigma,straight,straw-yellow,stump,style,surface,terete,thin,translucent,trichome,unarmed,unbranched,white,yellow	.3,0,0.1,0.1-0.3,0.15-0.3,0.2,0.2-0.4,0.4-0.7,0.4-0.9,0.5,0.8-1.7,1-1.5,1-10,1-2,1-2.5,1-3,1-5,1-6,1.5-2.5,1.8-2.5,1/3-1/2,1/3-2/3,1/4-1/3,2.2-2.8,3-4.5,3-5,30-45°,4-8,5,5-15,5-merou,6,6-7,6-8,6-9,6.5-9,accrescent,acute,adaxially,age,alyx,apar,apart,apex,apically,apparently,articulated,axe,base,beyond,blade,branche,broad-deltate,characteristically,chartaceous,covering,cuneate,dark,deltate,development,difoliate,discolorous,distance,divided,eaf,eed,elongating,equal,exserted,extending,filiform,fine,finger-hair,flat,free,geminat,glabrescent,herbaceous,infructescence,irregula,irregular,lateral,lengthening,less,lobe,long-ovoi,long-styled,longer,longitudinal,midpoint,minute,mostly,narrow-deltate,nflorescence,oblique,obtuse,often,older,one,open,opening,orange-translucent,orolla,oung,pair,papillo,pendulous,per,perfect,pericarp,point,pore,poricidal,portion,primary,pronounced,ray,reduced,rest,ri,ridge,rounded,ruit,shallow,short-styled,shorter,simple,sinus,slit,somewhat,spaced,spherical,spreading,stalk,stout,subsessile,tamen,tapering,terminal,tertiary,thick,throughout,time,tip,toward,tube,ud,unequal,unit,usually,variously,vary,vein,venation,visible,weakly,wide,widest,woody,x,yellow-orange,ympodial,×	'',5-merous,[,``,abaxial,adaxial,arrangement,branched,branching,bud,center,characteristic,colour,form,green,greyish,growth,hair,height,hirsute,history,inflorescence,life,long-ovoid,moderate,na,new,number,ovary,papillose,perennial,plant,reproduction,seed,shape,staman,texture,u00bc,value,width,{,}
619	wfo-0001030452	success	199	100	61	138	39	0.307	80,abaxially,absent,acuminate,acute,anther,apex,black,broadly,cm,curved,dense,diameter,dull,filament,flower,fruit,glabrous,glandular-puberulent,globose,hair,hyaline,immature,leaf,mature,mm,moderately,narrowly,nearly,opposite,orbicular,ovate,pedicel,petiole,pilose,prickle,pubescent,rachi,reddish,sessile,shape,shrub,similar,simple,slightly,smooth,somewhat,sparse,spreading,stellate,stem,stigma,straight,style,subopposite,surface,thin-textured,truncate,white,yellow,yellowish	.5–4.5,.6,0.1–0.4,0.2–0.3,0.4,0.6,0.7,0.8,1.2,1.2–1.6,1.5–3,100,10–15,1–1.3,1–2,1–3-celled,1–4,2,2.5–3,2.5–4,2.5–6,20–30,2–2.5,2–4,2–5.5,2–foliate,3,3.7–5.2,4,4–5-rayed,5,5–6,5–7,6–12,8–11,911,accrescent,adaxially,also,apparently,appressed,attenuate,axe,base,blade,broad,calyx,canthophora,capitat,central,collected,contiguou,cordate,counted,cylindrical,deflexed,developing,directed,distall,drying,eaf,eed,eglandular,enlarged,enlarging,f,flattened,free,fruiting,fully,geminat,glabrou,gland-tipped,gland–tipped,gradually,half,herter,hig,imple,initially,internode,larger,less,lobe,lon,long,longer,lower,major,margin,matur,maturity,minutely,nflorescence,numerous,often,one,orolla,per,pore,probably,proximal,pubescence,ray,reflexed,ruit,sec,short,sinuate,size,small,sof,sometimes,sprawling,ste,stellae,strongly,sulcate,tamen,tem,terete,thin–textured,tip,toward,triangular,tube,ultimately,uniform,unit,usual,various,vary,vein,wide,wing,x,ympodial,–9	0.1-0.4,1-1.3,1-2,1-3-celled,1-4,10-15,2-4,2.5-3,20-30,5-6,8-9,abaxial,adaxial,arrangement,capitate,colour,contiguous,corolla,form,growth,height,history,inflorescence,length,life,na,number,ovary,peduncle,perennial,plant,position,reproduction,seed,spacing,staman,texture,trichome,width
620	wfo-0001030453	success	127	70	44	83	26	0.346	.25,/4,0.8-1.5,1-1.3,1.5-1.6,1.5-2.5,3-3.5,abaxially,acuminate,acute,adaxially,anther,apex,arachnoid,base,clavate,closely,cm,corolla,divided,elliptic,filament,glabrous,leaf,mm,narrowly,occasionally,opposite,ovary,pedicel,petiole,pubescent,reddish,shiny,shrub,simple,slender,spaced,sparsely,stigma,style,surface,way,white	.5,0.25-0.5,1-1.5,4-5,9-12,9-14,along,anthesi,arachnoid-pubescent,attenuate,axi,bark,broadly,calyx,cup-shaped,dark,deflexed,delicate,deltate,dendritic,densely,dia,eaf,edicel,eed,ellipsoid,especially,exserted,fine,flat,floccose,free,glabrate,know,known,later,lateral,less,lobe,lon,long,lower,main,margin,middle,midrib,minute,minutely,near,nearly,nflorescence,older,overlappin,pair,papillat,papillose,planar,pore,poricidal,portion,reddish-brow,rounded,ruit,scar,shaped,soon,stem,straight,strongly,tall,tear-drop,tip,trichome,tub,tube,ud,unifoliat,unit,vein,wide,widest,ympodial,young	abaxial,adaxial,arrangement,colour,diameter,flower,form,fruit,green,growth,height,history,inflorescence,length,life,na,perennial,plant,position,reproduction,seed,shape,spacing,staman,texture,unifoliate
621	wfo-0001030486	success	141	113	78	63	35	0.553	.5,1-1.5,1-5,1.1-1.4,1.5-2,1.7-2,1/2,1/4,2-3,3/4,4.5-5,6-7,acute,anther,apex,bark,basal,base,brown,calyx,clavate,closely,clustered,cm,completely,conical,corolla,dark,dia,distal,dry,ellipsoid,elliptic,erect,f,filament,fleshy,fresh,fruiting,glabrous,globose,green,internodal,later,leaf,lobed,margin,material,minutely,mm,opposite,ovary,overlapping,ovoid-reniform,pale,papillose,pedicel,petiole,pitted,scar,shrub,simple,slightly,small,spaced,stem,stigma,stout,style,surface,tan,tapering,treelet,tube,way,white,x,yellow-green	0.8-2.2,10-12,10-14.5,2-5.5,3-3.5,3-5,4-4.5,4-6.5,5-8-flowered,abaxially,adaxially,anthesi,ba,beneath,berry,deflexed,deltate,differing,difoliate,drying,eaf,edicel,eed,exserted,free,geminat,inflorescenc,lateral,lobe,lon,long,lower,m.,main,major,middle,minor,nflorescence,older,pair,papillo,planar,pore,poricidal,portion,reddish,ruit,shaped,shin,size,tall,tear-drop,thickened,tip,tub,ud,unit,usually,vein,widest,woody,ympodial,young	5-8,abaxial,adaxial,alternate,arrangement,bud,cell,center,colour,diameter,flower,form,fruit,growth,height,history,inflorescence,length,life,na,new,number,peduncle,plant,position,rachi,reproduction,seed,shape,shiny,spacing,staman,texture,trichome,width
622	wfo-0001030489	success	196	125	94	102	31	0.48	-6.5,.5-2.8,0.25-0.4,0.5-3,0.75-0.9,1.2-1.6,1.6-2.1,1/3-1/2,100,2.1-2.9,3-6,3-8,4-8,5,7-15,abaxially,adaxially,anther,apart,apex,appressed-pubescent,articulated,base,becoming,branch,broadly,brown,bud,calyx,chartaceous,cinereous,cm,conical,corolla,deltoid,diameter,echinoid,elliptic,elongate,filament,flower,fruit,glabrate,globose,greenish,growth,hair,high,honeycombed,lateral,leaf,length,lobed,long-acuminate,minutely,mm,multangulate,obtuse,ovate-lanceolate,pale,pedicel,peduncle,petiole,porrect-stellate,probably,pubescent,pulverulent,rachi,reniform,reticulate-punctate,ripe,sessile,short-stalked,shrub,simple,small,smooth,somewhat,sparingly,stellate-pubescent,stellate-rotate,stem,stigma,style,subglobose,suborbicular,terete,testa,tree,way,white,x,yellow,yellowish	.5-3,.75-5.25,0.6-0.9,0.9-1.1,1-1.3,1-3,1-3.75,1.1-1.3,1.2-1.5,1.7-2,1.75-2,1.9-2.6,1/5-1/2,12-24,4.5-9,5-6,6-8,abruptly,absen,acuminate,acute,adaxiall,ag,anthesi,apical-lateral,apparently,appressed,attenuate,axe,axillary,ba,bark,berry,blade,blunt-tipped,branched,closely,continued,cylindrical,dehiscing,densely,dichotomously,due,eaf,echinoi,eed,entire,fleshy,free,glabrous,inserted,introrse,large,lobe,long,long-exserted,longitudinal,lower,main,margin,midvein,minute,mostly,narrowly,nflorescence,oblong,older,orolla,ovate,perfect,plurifoliate,pore,pseudo-terminal,puberulent,pulverulen,ruit,runk,several,short,side,slender,slit,spaced,sparse,subcampanulate,subcapitat,tamen,thick,time,tomentose,toward,tube,turn,unarme,unarmed,unit,usually,vary,vein,wide,ympodial,young	abaxial,adaxial,arrangement,cell,center,colour,form,fruiting,height,history,inflorescence,life,na,new,number,ovary,plant,position,pseudoterminal,reproduction,scar,seed,shape,spacing,staman,subcapitate,surface,texture,trichome,trunk,width
623	wfo-0001030492	invalid_json_followup	221	132	95	126	37	0.43	0.25-0.5,0.5-1,1-1.5,1-8,1.5-2,1.5-6,10-50+,15-20,2-2.5,2-3,2-5,3-10,3-8,5-7,9-11,?,abaxially,accrescent,acute,adaxially,anther,apart,apex,articulated,base,branched,brown,calyx,chartaceous,cm,coarse,coarsely,densely,diameter,elliptic,entire,erect,extra-axillary,filament,flattened,flower,forked,fruit,fruiting,fully,glabrous,glandular-puberulent,globose,green,lanceolate,leaf,light,margin,maturity,midvein,minutely,mm,moderately,often,ovate,pedicel,peduncle,perfect,perhaps,petiole,pinnatifid,pitted,plant,prickle,pubescent,rachi,recurved,ripe,shape,shrub,simple,slightly,small,somewhat,sparsely,stellate,stellate-pubescent,stem,stigma,straight,style,surface,toothed,tree,unbranched,white,woody,x,yellow,yellowish	-2,.1,.5,0.1-0.5,0.1-1,0.3-0.5,1,1.5,10,10-35+,12-25,2,2-4,25-50+,3-5,3-7,30-40+,4,4-6,4-7,4-8,5-30+,5-6,7-18,adaxiall,also,apparently,armed,axe,ba,blade,broad-based,capitat,caudate-acuminate,connivent,covering,cylindrical,deeply,difoliate,directed,distall,divided,eaf,eed,eglandular,emerging,female-sterile,ferruginous,ferruginous-pubescent,first,frui,geminat,gland,glandular,hair,halfway,held,interpetalar,juvenile,larger,later,lateral,less,like,lobe,lobed,lon,long,longer,lower,lowering,major,midpoint,midrib,mostly,much,narrow,near,nearly,nflorescence,oblique,occasionally,orolla,pair,part,pore,ray,rectangular,ruit,rusty,scattered,sessile,short,short-stalked,shorter,similar,sinus,size,sometimes,spaced,sparse,splitting,sprout,stalk,ste,stellae,subcordate,tal,tamen,tapered,time,tip,tissue,truncate,tube,unarmed,uniform,unit,upper,uprigh,vary,vein,wide,ympodial,younger,youngest	'',[,``,abaxial,adaxial,arrangement,bark,bud,capitate,center,characteristic,colour,corolla,form,growth,height,history,inflorescence,length,life,na,new,number,ovary,perennial,position,reproduction,scar,seed,spacing,staman,texture,trichome,value,width,{,}
624	wfo-0001030509	invalid_json_followup	220	125	88	132	37	0.4	-6,0-0.3,0-5,0.1-0.2,0.1-0.3,0.3-2.5,0.5-1.5,0.8-1.2,1-1.5,1-2,1-6,2-2.5,2-3,2-4.2,2-4.5,2-6,2/3-3/4,4.5-8,5-merous,abaxially,andromonoecious,anther,apex,bark,base,berry,calyx,cm,curved,densely,diameter,entire,erect,filament,flattened-reniform,flower,fruit,fruiting,glabrescent,glabrous,gray,half,herb,inflated,lateral,leaf,length,lobed,margin,mauve,mm,moderately,obtuse,occasional,occasionally,orange,orange-brown,ovate,pale,pedicel,peduncle,petiole,plant,porrect,prickle,purple,rounded,scar,shrub,simple,sparsely,spherical,stalked,stellate,stellate-pubescent,stem,straight,style,surface,terete,terminal,trichome,unbranched,upper,way,weakly,yellow,yellow-green	-10,-2,/3,0,0-100,0-15,0-3,0.1,0.1-0.25,0.2,0.6-1,0.8-4,1,1-3,1-4,1.3-2,1.5-2,1.7-2,1/,1/3-2/3,1/4,2.8-3,3-10,3-4,4.5-10,4.5-12,5-10,7-15,7-9,8-16,alyx,apar,apart,apical,apically,apparently,articulated,becoming,blade,broad-deltate,brow,chartaceous,connivent,cordate,cream,cuneate,dark,difoliate,discolorous,distal,distance,drying,eaf,eed,elongating,equal,extending,eye,free,geminat,gland,globular,green,herbaceous,hermaphrodite,heterostylous,infructescence,lobe,long,long-acuminat,long-styled,longer,lower,lowermost,marking,mature,maturity,midpoint,midvein,naked,narrow-deltate,narrow-oblong,nflorescence,often,older,one,open,orolla,oung,pair,pendulous,per,pericarp,perpendicular,poricidal,portion,prickly,primary,ray,reduced,ruit,short-styled,shorte,shorter,side,slender,smooth,sometimes,spaced,spreading,stalk,staminat,subsessile,tamen,tapering,tertiary,time,tip,tube,unarme,unarmed,unit,usually,variously,vary,vein,venation,visible,wide,woody,ympodial,young	'',[,``,abaxial,adaxial,arrangement,brown,bud,center,character,characteristic,colour,corolla,form,growth,height,history,inflorescence,life,na,new,number,ovary,perennial,position,rachi,reproduction,seed,shape,spacing,staman,stigma,texture,value,width,{,}
625	wfo-0001030511	invalid_json_followup	166	124	88	78	36	0.53	.5,0.1-0.15,0.4-0.5,0.5,0.5-1,0.8-1,1,1-2,acicular,almost,anther,anthesi,apex,bark,base,berry,bright,calyx,cell,closely,cm,conical,corolla,deeply,diameter,difoliate,ellipsoid,entire,erect,filament,filiform,flattened,flower,fruiting,globose,growth,inflorescence,internodal,lanceolate,leaf,less,like,linear,lobed,long,margin,minute,minutely,mm,nearly,new,nodding,ovary,pale,pedicel,peduncle,petiole,pitted,plant,porrect,prickle,pubescent,red,reniform,ripe,rounded,scar,sessile,shiny,shrub,simple,sinuate,spaced,sparsely,stellate,stem,stigma,style,surface,tan,testal,thin,trichome,unit,violet,white,x,yellowish	-6,0.1,0.5-0.6,1.5,1.5-4,4-7,4-8,4-merous,5-7,5-9,6-8,?,abaxially,absent,adaxially,along,also,arising,articulated,attenuate,barely,brow,curved,deltate,densely,eaf,eed,either,especially,exserted,free,geminat,glabrous,leave,lengthening,lobe,lower,membranous,midpoint,midrib,midvein,nflorescence,noddin,older,overlappin,pair,papillo,per,perfect,pericarp,planar,pore,poricidal,portion,prickly,primary,rarely,ray,rest,ruit,short-stalked,sometimes,strongly,tall,tapering,tip,toward,triangular,tube,ud,upper,vein,visible,woody,yellow,ympodial,½,¾	'',[,``,abaxial,adaxial,arrangement,brown,bud,characteristic,colour,dense,form,fruit,geminate,height,history,length,life,na,number,overlapping,papillose,perennial,position,rachi,reproduction,seed,shape,spacing,staman,sympodial,texture,value,width,{,}
626	wfo-0001030516	success	172	110	81	91	29	0.471	0.4-1.5,1-4,1-7,1.8-2.4,2-12,3-8,4-22,4-6,8-9,9-32,acuminate,acute,apex,articulate,base,branched,cell,cm,cordate,corolla,covering,cuneate,cyme,darker,diameter,dichasial,dichasially,diminished,distal,ebracteate,elliptical,filament,flower,globose,gradually,green,green-white,hair-like,half,herbaceous,honeycomb,lateral,leaf,leaflet,light,long,mm,monochasial,mucilaginous,oblique,odd-pinnate,outline,ovate,ovoid,pattern,pedicel,peduncle,pentagonal,perennial,petiole,pilose,plant,proximal,puberulent,pubescent,rotate,seed,size,slightly,sometimes,stigma,stripe,style,testal,thick,throughout,toward,triangular,wall,yellow,¼	1-2.5,1.1-3.5,1.1-4.1,1.5-2,1.7,2-2.,2-3,2-4,3-6,3-6-foliat,3-9.8,4-4,4-7,4.2-10.7,6-15,9-22,abaxially,acumen,adaxially,apical,apically,calyx,connate,covered,decurrent,dehiscent,densely,digestion,dorsally,eaf,edge,eed,emoval,enzyme,exceeding,first,flat,folded,forked,generally,gland,globo,hair,interjected,introrse,less,living,lobe,lon,long-attenuate,longer,lower,lunat,make,maturing,nflorescence,nther,often,orolla,pair,perfect,plan,poricidally,rarely,reveal,ruit,second,sessile,seudostipule,short,short-petiolate,short-stalked,slit,specimen,spreading,stamen,straight,tal,tem,terminal,time,triangulat,tuber-bearing,type,typically,unit,vary,whit,wide,ympodial,’	abaxial,adaxial,anther,arrangement,colour,form,fruit,growth,height,history,inflorescence,length,life,lunate,na,number,ovary,position,pseudostipule,rachi,reproduction,shape,spacing,staman,surface,texture,wet,white,width
627	wfo-0001030522	invalid_json_followup	192	114	83	109	31	0.432	.2,0.3-0.7,0.5-0.6,0.5-1,1-1.4,1.5,2-lobed,20-30,3-4.5,3-5,4,abaxially,absent,acute,adaxially,anther,apart,apex,bark,base,berry,brown,calyx,cell,cm,completely,corolla,cup-shaped,dark,darker,densely,diameter,dioecious,ellipsoid,elliptic,entire,erect,filament,flattened,flower,fruit,fruiting,glabrous,globose,green,growth,inflorescence,internodal,leaf,lobed,margin,minutely,mm,new,orange,ovary,ovate,pedicel,petiole,pitted,plant,porrect,prickle,pubescent,reddish,reniform,ripening,scar,sessile,shrub,small,sparsely,stellate,stem,stigma,straight,style,surface,thin,treelet,trichome,vestigial,white	-4,-8,.5,.7,/4,0,0.05-0.15,0.3-0.4,0.5,0.7,0.9-1.3,1,1-1.5,1-5-2,1.7-3,2,2.5-2.8,2.5-6,3,3-4,4-10,4-9,5-10,6-7,7-10,almost,also,anthesi,armed,articulated,ba,bearing,broad-based,brow,conical,consisting,cordate,dense,diamete,difoliate,directed,eaf,eed,female,fleshy,free,geminat,impressed,included,irregularly,juvenile,lamina,le,less,like,lobe,lon,long,lower,male,mature,membranous,midpoint,minute,mixture,nflorescence,notably,oblique,obscured,obtuse,occasionally,often,orbicular,pair,per,pericarp,pistillate,planar,pollen-bearing,pore,poricidal,portion,primary,pubescence,ray,rounded,ruit,shallowly,short-stalked,single,somewhat,sparser,staminate,testal,tip,toward,tube,ud,unarmed,unisexual,unit,upper,upwardly,usually,vein,way,woody,x,ynpodial	'',[,``,abaxial,adaxial,alternate,arrangement,bud,center,characteristic,colour,form,height,history,length,life,na,number,peduncle,position,rachi,reproduction,seed,shape,spacing,staman,texture,value,width,{,}
628	wfo-0001030551	success	167	105	74	93	31	0.443	-12,0.5-1,1-10,1-2,1-3.5,1-4,1.5-2.5,10-20,10-40,2,2-6,3-,3-12,4-5,4-7,5-6,abaxially,abruptly,acuminate,acute,adaxially,also,apart,apex,articulated,base,blue,broad,calyx,campanulate,chartaceous,cm,concave,connective,densely,diameter,distally,ellipsoidal,fading,flower,fruit,glabrous,glandular-puberulent,globose,mm,moderately,narrowed,oblong-fusiform,often,ovate,ovate-elliptic,ovoid,papillose,pedicel,peduncle,petiole,puberulent,puberulent-pubescent,pubescent-pilose,rachi,radiu,shrub,simple,sparsely,stellate,stigma,style,triangular-elliptic,truncate,unbranched,unknown,violet,x,yellowish	-30,-5,0-2,0.6-1.5,1,1-,1-2.5,1-5,1.5-,13.,2-3,2.5-4,2.5-5,20-25,3-5,3-8,4-,4-foliat,5-17,9-20,absent,adpressed,aggregate,ape,axe,basal,beyond,bilobe,blade,cell,clavate,color,cordate,dia,dilated,directed,eaf,ed,entire,equal,et,exceeding,exserted,fleshy,hair,lanceolate,laterally,leaving,lobe,lon,long,lower,margin,martinelli,narrow,narrowly,nflorescence,nther,obtuse,orolla,pedicellar,perfect,pilose,pore,puberulen,pubescent-pilo,remnant,ripe,round,ruit,seen,shorter,slightly,small,spaced,stamen,stone,subcoriaceous,tal,tem,thecae,time,tip,tomento,triangular,tube,ud,unit,unknow,vary,wide,widening,ympodial	4-6,abaxial,adaxial,anther,arrangement,bilobed,bud,colour,corolla,filament,form,growth,height,history,inflorescence,leaf,length,life,na,number,ovary,plant,position,reproduction,seed,shape,spacing,staman,surface,texture,width
629	wfo-0001030570	success	173	110	74	99	36	0.428	0.3-0.5,1-4,1-5,1-8,10-25,15-35,2-3,2-7,2-7-lobed,2-8,3-10,3.5-5,4-5,abaxially,acuminate,acute,adaxially,apart,apex,articulated,base,calyx,campanulate,cell,cm,cylindrical,diameter,dilated,distally,ellipsoidal,entire,flattened,fleshy,flower,forked,fruit,glabrous,glandular-puberulent,globose,green,leaf,lobed,margin,mm,near,occasionally,ovoid,pedicel,peduncle,petiole,pilose,pinnately,pubescent,purplish,rachi,rarely,rugose,simple,slightly,sparsely,stellate,stigma,style,subcoriaceous,submarginally,tree,truncate,unbranched,unknown,unlobed,vein,white,x,yellow	-1,.3-0.5,0-,0.5-,0.5-1,1,1-,1-1.5,1-2,1-3,1.5,1.5-2.5,1/2,10-17,15-20,2-2.5,2-4,2-5,2.5-22,20-30,3-5,3-6,4-25,4-7,4-foliat,4/5,5-,8-,absent,aggregate,ape,apiculate,axe,basal,beyond,blade,color,connective,connivent,cordate,directed,divided,eaf,eed,eglandular,elliptic-oblong,exceeding,exserted,glabrat,hair,lanceolate,leaving,lobe,lon,long,lower,midrib,narrowly,nflorescence,nther,obtuse,often,orolla,ovate,pedicellar,perfect,pilo,pore,presen,punctate,purpl,radiu,remnant,ripe,rounded,ruit,shorter,sinus,small,sometimes,somewhat,spaced,stamen,stone,tal,tem,thecae,time,tip,tomento,triangular,truncat,tube,ud,unequal,unit,vary,wide,ympodial	abaxial,adaxial,anther,arrangement,bark,bud,center,colour,corolla,filament,form,fruiting,growth,height,history,inflorescence,length,life,na,new,number,ovary,perennial,plant,position,reproduction,scar,seed,shape,spacing,staman,stem,surface,texture,trichome,width
630	wfo-0001030580	invalid_json_followup	230	126	78	152	48	0.339	.0,.7,2,along,anther,apex,arching,area,attachment,becoming,black,brown,bud,calyx,caudate,central,channeled,chartaceous,cm,corolla,densely,developed,diameter,dry,elliptic,entire,extra-axillary,ferruginous,filament,flattened-orbicular,flattened-reniform,flower,fruit,glabrous,globose,homostylous,interpetalar,lateral,leaf,lobe,margin,midrib,mm,moderately,nearly,notched,ovate,pedicel,petiole,pitted,point,porrect,pubescent,rounded,sepal,sessile,shrub,simple,slightly,smooth,sparsely,stellae,stellate,stellate-pubescent,stem,stigma,straight,style,surface,tip,tissue,translucent,truncate,unarmed,well,white,yellow,young	.0–6.2,.2,.3,.5,/2,/3,0.2–0.3,0.3–0.4,0.3–0.7,0.4–0.5,0.4–0.7,0.6–1.1,0.6–2.1,0.7–0.8,0.9–1.2,1.2–1.5,1.3–1.5,1.3–3.0,1.5–,1.5–2.0,1.5–4.0,1.5–9.0,1.6–1.8,1.6–2.5,1.7–1.8,1/3,1–2,2.0–2.2,2.0–3.1,2.3–5.5,3,3.7–5.4,3–5,4–6,4–8,5-merou,5–5.4,6–8,8.3–10.0,abaxially,acute,adaxially,adnate,ag,alyx,anthesi,apical,apparently,appearing,appresse,around,articulate,attenuate,ba,base,berry,blade,broad,brochidodromous,capitat,connivent,curved,deltoid,dentate,difoliate,directed,distal,distally,distinct,dramatically,eaf,edge,eed,either,emerging,endocarp,erect,exocarp,extending,fertile,filiform,flat,flexed,free,geminat,glabrescent,glossy,gradually,hair,increasing,indistinct,inter-sepalar,internode,intersepalar,juic,laying,lon,long,longer,lower,mainly,many,mature,middle,midpoint,midvein,minute,much,nflorescence,oblong,orolla,per,perforate,persistent,pore,portion,potentially,probably,raised,ray,ruit,scattered,side,sinus,smoot,sometimes,splitting,spread,stamen,strongly,suture,tamen,tardily,tem,thin,though,time,toward,tube,typically,ud,unit,vary,vein,weakly,wide,ympodial,±90°,±aequilateral,×,–2.5,–8	'',1-2,1.5-2.0,1.5-9.0,1.6-1.8,3.7-5.4,5-merous,[,``,abaxial,adaxial,age,arrangement,bark,capitate,center,characteristic,colour,form,fruiting,growth,height,history,inflorescence,length,life,na,new,number,ovary,peduncle,perennial,plant,position,prickle,rachi,reproduction,scar,seed,shape,spacing,staman,texture,trichome,value,width,{,}
631	wfo-0001030581	invalid_json_followup	187	124	82	105	42	0.439	1-4-celled,5-merous,9,abaxial,abaxially,acute,adaxial,along,angle,angled,anther,apex,appressed,berry,black,bright,calyx,capitate,central,clustered,cm,conical,corolla,densely,diameter,elliptic,entire,filament,flattened-reniform,flower,fruit,fruiting,globose,green,growth,herb,inflorescence,intermodal,lateral,leaf,lobe,margin,markedly,maturity,minutely,mm,new,occasionally,once-branched,ovary,ovate,pedicel,peduncle,petiole,pitted,plant,portion,pubescent,purplish,rachi,ripe,scar,shallow,shiny,simple,somewhat,sparsely,spreading,stellate,stem,stigma,straight,style,surface,terete,trichome,turning,uniseriate,white,woody,yellow,yellowish	.3,.5,0.2–0.8,0.4–0.6,0.4–1.6,0.5,0.5–0.7,0.5–2.5,0.6–0.7,0.7–0.8,0.9–1,1,1.2–1.5,1.8–8,1–2,1–2-celled,1–2.5,1–4-celled,2,20–50,2–3-celled,35–45,3–4,3–5,4.5–12,4–7,4–9,5–6,5–8,adaxially,aggregate,anthesi,apar,articulated,basal,base,becoming,beyond,branched,cell,cone,decurrent,denser,difoliate,drop,eaf,eed,ellipsoid,exserted,florescence,free,geminat,glabrous,halfway,individual,lacking,later,leave,less,like,live,lobed,lon,long,lower,minute,narrowly,near,often,outline,pair,papillate,pentagonal,per,perfect,primary,reflexe,reflexed,remaining,ridge,rounded,ruit,shorter,slightly,spaced,sprawlin,stone,strongly,tall,tangled,tem,testal,third,translucent,tube,ud,unit,upper,usually,vein,wide,winged,ympodial,–15,–5	'',0.2-0.8,0.4-0.6,0.4-1.6,0.5-2.5,0.6-0.7,1-2.5,1.5,20-50,3-4,3-5,5,5-6,[,``,apart,arrangement,bark,bud,center,characteristic,colour,form,height,history,length,life,na,number,perennial,position,prickle,reproduction,seed,shape,spacing,staman,texture,value,width,{,}
632	wfo-0001030582	success	190	91	55	135	36	0.289	.5,5,abaxially,acute,adaxially,anther,apart,apex,attenuate,blue,brown,closely,cm,densely,diameter,ellipsoid,evenly,filament,finely,flattened-reniform,flower,fruit,glabrous,globose,initially,lateral,leaf,light,lighter-colored,minutely,mm,moderately,orange,ovate-lanceolate,overtopped,ovoid,pedicel,peduncle,petiole,pitted,red,ripe,shrub,simple,soon,sparsely,stellate-pentagonal,stellate-tomentose,stem,stigma,style,surface,terminal,tomentose,yellow	.1,0,0.1,0.2,0.4,0.4–0.5,0.4–1,0.6,0.8–1,1.4–2,1.5,1.5–3,10,10–12,12,1–1.5,2.5–3,2–10-branched,2–2.5,2–4.5,3.5–9.5,3–3.2,3–3.5,3–5,4–4.5,4–9-rayed,5-merou,5–8,6–8-rayed,7–11,7–20,adaxiall,age,alyx,apparently,articulated,axe,ba,base,becoming,blade,branch,branched,broad,c.,capitat,caudate,cordate,dark,dichotomously,directed,distall,eaf,eed,entire,except,extra-axillary,filiform,free,geminat,glabrescent,gland-tipped,hair,homostylous,internode,interpetalar,larger,later,lea,less,like,linear-attenuate,lobe,lon,long,lower,margin,maturit,midpoint,midzone,minute,narrowly,nearly,nflorescence,numerous,obscurely,often,orolla,part,per,perfect,plurifoliate,pore,principal,probably,rounded,ruit,sessile,shiny,short,short-stipitate,side,sinuate,sinus,slender,somewhat,spaced,splitting,stellae,stellate-tomento,stipe,tall,taller,tamen,tardily,tem,thick-chartaceous,tip,tissue,triangular,truncate,tube,ud,ultimate,unarme,unarmed,underside,vary,vein,visible,well-developed,wide,ympodia,young,×	0.4-1,1.4-2,10-12,2-4.5,3-3.5,3-5,7-11,abaxial,adaxial,arrangement,bud,calyx,capitate,colour,corolla,form,growth,height,history,inflorescence,length,life,maturity,na,number,ovary,plant,position,rachi,reproduction,seed,shape,spacing,staman,texture,width
633	wfo-0001030583	invalid_json_followup	166	126	93	73	33	0.56	.5,0.1-0.5,0.2-1,0.3-1,1,1-1.5,1-8,1/2,2.5,3-4,3/4,5-6,5-7,abaxial,acute,along,anther,apex,bark,base,calyx,cell,closely,cm,corky,corolla,crisped,cultivar,dark,deep,deflexed,dendritic,densely,dia,ellipsoid,elliptic,enlarged,erect,flattened-reniform,flower,form,fruit,fruiting,glabrous,globose,golden,green,immature,incrassate,irregular,leaf,live,lobed,long-rectangular,margin,midvein,minutely,mm,narrowly,often,opposite,orange-red,ovary,overlapping,pale,papery,papillose,pedicel,petiole,pitted,plant,prostrate,pubescent,ripe,rounded,scar,shrub,simple,small-capitate,spaced,stem,stigma,stout,style,surface,tan,thin,tip,trichome,way,white,x,yellow	.2,0.4-2.7,0.5-1,0.7-4.5,0.8-1,0.9-3.5,1-2,1.5-4,2.5-3,2.5-9,4-6,6-7,abaxially,adaxially,anthesi,ba,berry,brow,conical,cultivated,differing,difoliate,dry,eaf,edicel,eed,especially,filament,free,frui,geminat,included,lateral,leave,like,lobe,lon,long,long-triangular,lower,main,major,minor,nflorescence,occasionally,older,outline,pair,papillo,pericarp,planar,pore,poricidal,portion,rest,ruit,shaped,size,small,soon,spathulate,specimen,tall,tear-drop,testal,tube,ud,uniseriate,unit,vein,woody,ympodial,young	'',[,``,adaxial,arrangement,brown,bud,center,characteristic,colour,diameter,growth,height,history,inflorescence,length,life,na,new,number,peduncle,perennial,position,rachi,reproduction,seed,shape,spacing,texture,value,width,{,}
634	wfo-0001030605	invalid_json_followup	144	129	90	54	39	0.625	.4,.5,0.1,0.3-0.5,1-4,1.5-2,1.7,2,2-3,7,acute,adaxially,almost,along,anther,apart,apex,area,base,branched,brown,calyx,cinereous,cm,conical,coriaceous,corolla,covered,cylindrical,dark,dendritic-echinoid,densely,difoliate,ellipsoid,filament,fruiting,glabrous,globose,green,growth,inflorescence,internodal,leaf,less,lobed,long,margin,midrib,minutely,mm,nearly,new,obovate,obtuse,occasionally,olive,opposite,ovary,overlapping,ovoid-reniform,pedicel,peduncle,petiole,pitted,pubescent,rarely,revolute,rounded,scar,scattered,shiny,shrub,simple,slender,slightly,smooth,sparesly,sparsely,stigma,style,surface,thickened,tip,trichome,unifoliate,vein,way,white,woody,x	1,1.5-5.5,1/3-1/2,12-19-flowered,2.5,5-12.5,abaxially,anthesi,ape,apical,attenuate,beginning,beneath,berry,branch,commonly,deflexed,dia,dry,drying,eaf,edicel,eed,entire,exerted,free,geminat,glabrate,gold,inflorescenc,light,lobe,lower,material,nflorescence,otherwise,ovate,papillate,papillosefruit,pore,poricidal,portion,reflexed,shaped,somewhat,soon,tear-drop,tinged,tub,tube,ud,unit,yellow,ympodial	'',12-19,[,``,abaxial,adaxial,arrangement,bark,bud,characteristic,colour,diameter,flower,form,fruit,geminate,height,history,length,life,na,number,papillose,perennial,plant,position,prickle,rachi,reproduction,seed,shape,spacing,staman,stem,texture,value,width,{,}
635	wfo-0001030611	invalid_json_followup	217	124	84	133	40	0.387	0,0-0.5,0.5,0.5-1.5,1,1.5-10,1.5-2,1mm,2-3.5,2-7,3-4,3.5-5.5,5-10,6-9,abaxially,acicular,adaxially,anther,apart,apex,articulated,base,broadly,calyx,campanulate,cm,coarsely,deltoid,dentate,depressed-deltoid,development,diameter,elliptic,elongated,erect,felty-pubescent,filament,flower,fruit,globose,inflorescence,leaf-opposed,length,lenticular,less,lobe,long,margin,minutely,mm,orange,outline,ovate,pedicel,peduncle,perennial,petiole,pitted,prickle,pubescent,rachi,ripe,round-tipped,sessile,simple,slightly,spreading,spreading-hirsute,stellae,stellate,stellate-pubescent,stigma,style,suffrutescent,surface,tan,thin-textured,truncate,unbranched,white,whitish,x,yellow,yellow-orange	-1.3,-35,0.1-0.3,0.5-2.5,0.7-1.5,1-2,1-3,1.5-3,1/4-1/3,12-10,12-15,15,2,2-4,2-6,2-foliate,2.2-2.5,3,3-5,4-5,4-6,4-8,5-15,5-8,7-25,9-30,abaxiall,acute,adaxiall,along,appearing,attenuate,axe,ba,basally,blade,blunt-tipped,branched,capitat,cauline,commonly,composed,connate,connivent,crowded,cylindrical,densely,directed,distal,distally,divergently,eaf,eed,elongate,entire,equaling,exceeding,female-sterile,finally,flesh,free,geminat,glabrou,glabrous,glandula,hair,hermaphroditic,inserted,interlaced,interlobal,intermixed,lacking,larger,lateral,light,lon,long-stalked,longer,longest,lower,main,midpoint,midrib,midvein,much,nflorescence,numerous,oblong-tapering,obtuse,often,one,orolla,ovate-lanceolate,part,per,pore,predominantly,present,principal,prominent,radiu,ray,reduced,resembling,ruit,section,short,short-stalked,short-styled,side,sinus,small,sometimes,somewhat,spaced,stalk,ste,stellate-woolly,stipitate,tal,tamen,tem,termination,time,tube,unarmed,unit,usually,vary,vein,wide,widely,ympodial	'',[,``,abaxial,adaxial,arrangement,bark,bud,capitate,cell,center,characteristic,color,corolla,form,fruiting,growth,height,history,leaf,life,na,new,number,ovary,plant,position,reproduction,scar,seed,shape,spacing,staman,stem,texture,trichome,value,width,{,}
636	wfo-0001030624	invalid_json_followup	170	104	62	108	42	0.365	0.5-1.5,0.9-1,1-3,1.2-1.8,1.5-2,2-10,3-3.5,acute,anther,anthesi,apart,apex,axil,bark,base,calyx,cell,clavate,cm,corolla,elliptic,filament,flattened-reniform,fruiting,furcate,glabrous,globose,green,greyish,lateral,leaf,lobed,main,margin,minutely,mm,narrowly,nearly,occasionally,opposite,ovary,pedicel,petiole,pitted,planar,scar,shining,shrub,simple,slender,small,stem,stigma,style,surface,tree,trichome,uniseriate,vein,white,yellowish,yellowish-green	.25,.5,0.5,0.5-1,1.2-2,2,2-3,2.5-5.5,25-40-flowered,3,3.5-4,4.5-8,6-13,7-9,apiculate,appearing,attenuate,ba,beginning,berry,branch,caly,decurrent,deflexed,dia,differing,difoliate,dimorphic,distal,dry,eaf,edicel,eed,ellipsoid,end,erect,except,expanded,exserted,extreme,falcate,free,geminat,glabrate,glandular,hyaline,incrassate,inflorescenc,large,later,like,lobe,lon,long,longitudinally,lower,major,material,middle,midrib,minor,near,nflorescence,older,one,outer,pair,pale,papillose,pore,poricidal,portion,prominent,puberulent,raised,remaining,round,rugo,ruit,short,size,slightly,somewhat,soon,spaced,square,straight,tall,tapering,thickened,three,ti,tip,trunk,tube,tuft,two,ud,unevenly,unit,wall,widest,woody,x,yellow,yellowish-grey,ympodial,young	'',0.25,25-40,7,[,``,abaxial,adaxial,arrangement,bud,center,characteristic,colour,diameter,flower,form,fruit,growth,height,history,inflorescence,length,life,na,new,number,peduncle,perennial,plant,position,prickle,rachi,reproduction,seed,shape,spacing,staman,texture,value,width,{,}
637	wfo-0001030628	success	229	131	97	132	34	0.424	.1,.2,.5,5-merous,abaxial,adaxial,adaxially,andromonoecious,anther,apart,bark,becoming,branched,brown,calyx,capitate,chartaceous,cm,dark,densely,diameter,discolorous,ellipsoidal,elliptical,entire,extra-axillary,filament,fissure,flattened,flower,fruit,fruiting,glabrous,glandular,green,hair,heterstylous,inflated,inflorescence,interpetalar,juicy,knobby,lanceolate,leaf,length,light,like,lobed,margin,maturity,mm,moderate,multangulate,ovary,ovate,pedicel,peduncle,petiole,plant,porrect-stellate,prickle,pubescent,purple,rachi,reddish,reniform,rotate-stellate,rugose,sessile,shallow,shallowly,simple,slightly,sparsely,stalked,stellate,stem,stigma,strongly,style,surface,thin,tissue,tree,turbinate,violet,whitish-,whitish-golden,width,woody,yellow,yellowish-green,young,×,–30,–5,–9	.5–1.7,0.1–0.3,0.5–3,0.7–0.9,1,10+,10–20,10–40,10–55,11–16,12–20,16–18,1–1.5,1–10,1–2,2.5–8,20–35,2–10,2–3,3.5–4,3.5–5,4,4–4.4,4–6,4–6.5,4–8,5–,5–6,5–8.5,6–10,6–8,7–25,7–40,8–1,8–25,abaxially,acuminate,acute,age,along,alyx,andromoneciou,anthesi,apex,articulated,axe,ba,base,berry,bilobe,blade,broad-based,broadly,central,congested,connivent,cordate,curved,cylindrical,db,difoliate,directed,distally,dried,eaf,eed,eglandular,either,flowering,free,fresh,frui,functionally,geminat,half,hermaphroditic,inclusion,lobe,long,longitudinal,lower,major,maturit,membranaceous,midpoint,midvein,moderately,multangulate-stellate,multiseriate,near,nearly,nflorescence,oblique,often,one,opening,orolla,part,pericarp,point,pore,portion,ratio,ray,reddish-tan,remaining,rounded,ruit,runk,sclerified,sharp,side,similar,slit,spaced,stalk,staminate,stellate-pubescent,stout,straight,subtending,tamen,tapered,thick,tube,unarmed,unequal,unit,vary,vein,ympodial,–50	1-2,10-20,10-55,11-16,16-18,2-10,2.5-8,5-6,5-8.5,8-25,arrangement,bilobed,bud,cell,center,colour,corolla,form,growth,height,history,life,na,new,perennial,position,reproduction,scar,seed,shape,spacing,staman,texture,trichome
638	wfo-0001030638	invalid_json_followup	177	112	76	101	36	0.429	0.1,0.5-1,0.5-1.5,0.7-1.5,1-1.2,1-2,1.5-2,1.6-2.2,3-10,4-6,8-9,acute,along,anther,apex,apically,axil,bark,broadly,bud,calyx,closely,cm,corky,corolla,cup-shaped,elliptic,filament,flattened,fleshy,fruit,fruiting,glabrous,globose,green,inflorescence,large,leaf,less,lobed,margin,minutely,mm,obovate,open,opposite,ovary,overlapping,pale,paler,papillose,pedicel,persistent,petiole,red-glandular,roundish,rugose,scar,seed,shape,shrub,simple,spaced,stem,stigma,style,surface,tapering,terminal,thickening,tree,trichome,vein,white,woody,x	0.5,0.5-0.7,0.5-2,1-1.5,1.4-1.7,2-3,2-5,2-7-flowered,2.5-4,3-13,8,8-11,anthesi,appear,appearing,axi,ba,base,beginning,beneath,berry,blade,branched,conspicuously,cucullate,deflexed,deltoid,densely,dia,differing,difoliate,dry,eaf,eed,entire,erect,exfoliating,extending,free,geminat,geminate,glabrate,glandular,gre,impressed,irregular,known,lamina,later,lateral,like,lobe,lon,long,lower,main,major,material,middle,minor,near,nearly,nflorescence,occasionally,often,older,one,ovoi,pair,papillae,papillo,planar,pore,poricidal,portion,present,prominent,rather,red,reddish,rest,ruit,shaped,size,soon,speciman,straight,tall,tear-drop,thick,thickened,tip,transversely,tube,uniseriate,unit,usually,wall,widest,ympodial,young	'',2-7,[,``,abaxial,adaxial,arrangement,cell,center,characteristic,colour,diameter,flower,form,grey,growth,height,history,length,life,na,new,number,peduncle,plant,position,prickle,rachi,reproduction,spacing,staman,texture,value,width,{,}
639	wfo-0001030661	invalid_json_followup	183	130	95	88	35	0.519	.5,0.5-0.6,0.5-0.75,0.5-2,1-1.4,1-1.5,1.5-2,1.5-7,4-15,5-10,5-5.5,50-100+,along,anther,anthesi,apex,attenuate,base,berry,branch,branched,brown,calyx,capitate,clustered,cm,corolla,densely,diameter,ellipsoid,elliptic,entire,erect,filament,flattened,flower,fruiting,glabrous,globose,group,growth,inflorescence,lateral,leaf,lobed,long,many,margin,mature,membranous,midrib,minutely,mm,narrowly,new,nodding,occasionally,pale,pedicel,peduncle,petiole,pitted,pubescent,red,reddish,reniform,scar,shiny,shrub,simple,slender,small,sparsely,stellate,stem,stigma,strongly,style,surface,terminal,thin,time,tinged,tip,tree,trichome,uniseriate,vein,violet,way,white,x,yellowish,½,¾	-24,.2,0,0.7-0.8,1-,1-.,1-1.2,1-1.3,1.2-7,12-16,2-,2-2.5,3-20,3-3.5,3-4,4-6,5-merou,acute,ag,alyx,ark,articulated,brow,cell,conical,connivent,dar,deltate,denser,drying,eaf,eed,em,erec,exserted,extending,free,glabrescent,glabrou,ilament,insertion,lamina,lengthening,lobe,lon,loosely,lower,minute,near,never,nflorescence,older,onto,orolla,otherwise,pair,papillo,per,perfect,pericarp,planar,platform,plurifoliat,point,pore,poricidal,portion,primary,rectangular,ruit,scattered,sleeve,slightly,slit,spreading,tangled,testal,tube,twinin,ud,unit,upper,usually,vary,winged,woody,yellow,ympodial	'',1-5,5-merous,[,``,abaxial,adaxial,arrangement,bark,bud,characteristic,colour,form,fruit,height,history,length,life,na,number,ovary,plant,position,prickle,rachi,reproduction,seed,shape,spacing,staman,texture,value,width,{,}
640	wfo-0001030665	invalid_json_followup	191	117	78	113	39	0.408	0.2-0.4,0.2-0.6,0.5-11,0.5-2,1.5-2,1.5-2.5,1.5-3,2-16,2-5,2.5-3.5,3-5,absent,acicular,adaxially,anther,apex,broad-based,brown,calyx,campanulate,chartaceous,cm,cordate,deeply,deltate,depressed-globose,depression,diameter,elliptical,extra-axillary,filament,flower,flushed,fruit,fruiting,glabrous,gland-tipped,globose,green,greenish,grey-green,hair,herbaceous,inflorescence,leaf-opposed,length,light,lilac,lobed,margin,minutely,mm,obtuse,ovate,pale,papery,pedicel,peduncle,petiole,present,prickle,prostrate,purple,rachi,resprouter,reticulate,rotate,short,simple,sprawling,stigma,straight,style,surface,throughout,unbranched,vein,yellow	%,-5,-7,0.4-0.6,0.5-1,0.7-1,0.8-1.1,1-17,1-2,1-4,1.1-2.8,1.4-1.7,1.6-4.5,10-200,2-3,2-6,2-8,2.3-10,2.5-9,20-30,3-10,3-3.8,4-5,5-8,5-merou,6-8,abaxially,absen,abundant,accrescent,acute,adaxiall,adult,alyx,appearance,appessed,armed,articulated,axe,ba,base,blade,branche,broad,capitat,cut,cylindrical,decimetre,deflexed,directed,distall,dr.,eaf,eed,ellipoidal,finally,finger,folded,geminat,give,grey,half,homostylous,index,interpetalar,inward,lamina,lateral,less,lobe,lobing,lon,long,longer,lower,mature,mesocarp,midvein,minute,nflorescence,oblique,orolla,part,per,perfect,pore,puberulent,rather,reflexed,rounded,ruit,scarcely,side,sinus,sparsely,stage,stellate-campanulate,tal,tamen,tem,thick,thin,time,tissue,tube,unifoliate,unit,uvenile,vary,wide,x,ympodial,¾	'',[,``,abaxial,adaxial,arrangement,bark,bud,capitate,cell,center,characteristic,colour,corolla,form,growth,height,history,leaf,life,na,new,number,ovary,plant,position,reproduction,scar,seed,shape,spacing,staman,stem,texture,trichome,value,width,{,}
641	wfo-0001030676	invalid_json_followup	220	136	96	124	40	0.436	1-1.2,1-3,1.1-1.4,1/4,14-17,2.2-5.7,3-6,4-6,7-10,7-8,8-10,abaxially,adaxially,angled,anther,anthesi,apart,apex,appressed-tomentose,articulated,bark,base,becoming,branched,brown,bud,calyx,chartaceous,cm,conical,corolla,deltoid,diameter,dichotomously,echinoid,elongate,entire,exserted,filament,finely,flower,fruit,glabrescent,globose,granular-tomentose,green,greenish,grooved,growth,honeycombed,lateral,leaf,length,lined,lobed,longitudinally,margin,minutely,mm,multangulate,oblong-elliptic,openly,pedicel,peduncle,petiole,probably,pseudo-terminal,pulverulent,rachi,reniform,reticulate-punctate,ridged,ripe,scabrous,sessile,short-attenuate,short-stalked,shrub,simple,small,somewhat,stellate,stem,stigma,strongly,style,subglobose,suborbicular,terete,tree,velutinous,way,white,whitish,yellow,yellowish	-1.6,-2.5,-3.9,-8.5,/10-1/5,0-100,0.4,0.6-1.2,1,1.1-1.9,1.2-1.3,1.3-1.5,1.7-2,11-14,16,19-35,2.1-2.3,2.1-2.6,2.4-3.1,2.5-5.5,2.75-3.25,3-3.5,3-5,4-6.5,7-9,8-12,abruptly,acute,along,apical-lateral,apparently,appearing,axillary,ba,berry,blade,blunt-tipped,branch,closely,continued,crown,cylindrical,dehiscing,densely,due,eaf,echinoi,eed,except,flat-topped,fleshy,forming,free,glabrescen,glabrous,hair,high,horizontal,initially,inserted,introrse,lackin,lamina,large,lengthen,lobe,long,longitudinal,lower,main,midvei,midvein,minute,moderately,mostly,nearly,nflorescence,oblique,oblong,obtuse,occasional,often,older,opening,orolla,ovate,ovate-lanceolate,parallel,perfect,plurifoliate,pore,pubescent,rather,ray,ruit,runk,scattered,side,slit,spaced,sparsely,spreading,stellate-pubescent,subcampanulate,subcapitat,tamen,tending,testa,thick,thin,time,tip,tomentose,tube,tuft,unarme,unit,usually,vary,vein,wide,x,ympodial,young	'',3-3.9,50-100,[,``,abaxial,adaxial,arrangement,center,characteristic,colour,form,fruiting,height,history,inflorescence,life,na,new,number,ovary,perennial,plant,position,prickle,reproduction,scar,seed,shape,spacing,staman,subcapitate,surface,texture,tomente,trichome,value,width,{,}
642	wfo-0001030686	invalid_json_followup	182	113	80	102	33	0.44	.5,.5-1,1-1.1,1-1.2,1-2,1.5-4.5,1.6-3,2-2.5,2.5-4,2.5-8,5-25,5-30,abruptly,acuminate,acute,anther,apart,apex,bark,bifid,black,branched,brittle,brown,calyx,cm,conical,corolla,cup-shaped,dark,deeply,densely,diameter,elliptic,entire,erect,filament,flattened,flower,form,fruit,fruiting,globose,height,internodal,leaf,leaf-opposed,lepidote,lilac,lobed,margin,mm,orange,ovary,pale,paler,pedicel,peduncle,petiole,pitted,plant,pubescent,purple,rachi,scar,seed,shallow,shallowly,shiny,simple,spaced,stem,stigma,style,surface,thin,tree,trichome,uniformly,yellow	.2,0.5-1,1-1.5,1.2-1.5,1.5-2,15,1972,2-3,2-6.5,3-3.5,5-12,5-6,8-9,?,abaxially,aborted,adam,adaxially,age,anthesi,basal,base,beneath,berry,breast,bu,c.,centre,closely,darker,denser,different,difoliate,discolorous,dry,drying,eaf,edicel,eed,empty,exerted,fide,fragrant,free,geminat,glabrescen,glabrous,golden,half,heteromorphic,lamina,lengthening,less,lobe,long,lower,many,maturity,midrib,midvein,minutely,nflorescence,noddin,oblique,older,overlapping,pair,papillae,papillose,pericarp,planar,pore,poricidal,portion,primary,pubescen,ruit,scarious,short,slightly,slit,somewhat,space,sparsely,spreading,stellate,strongly,styl,time,tip,tissue,tube,ud,unit,usually,vein,visible,way,woody,x,ympodial,–	'',[,``,abaxial,adaxial,arrangement,bud,cell,center,character,characteristic,colour,glabrescent,growth,history,inflorescence,length,life,na,new,number,perennial,position,prickle,reproduction,shape,spacing,staman,texture,value,width,{,}
643	wfo-0001030696	success	202	101	68	134	33	0.337	0.1-0.3,0.8-1.8,1-3,1-9,12-18,3-4,3-6,4-4.5,7-10,absent,accrescent,acicular,acute,adaxially,andromonoecious,anther,apex,articulated,base,calyx,chartaceous,cm,contiguous,deeply,densely,diameter,elliptical,extra-axillary,filament,flower,fruit,fruiting,glabrous,globose,green,herbaceous,inflorescence,length,lobed,margin,mm,moderately,nearly,obtuse,ovate,pale,pedicel,peduncle,petiole,plant,prickle,prostrate,pseudo-umbellate,rachi,resprouter,simple,solitary,sparsely,sprawling,stellate,stellate-pubescent,strongly,style,unbranched,usuallu,white,yellow,yellowish	%,.5,0-0.1,0-3,0.05-0.2,0.1-0.4,0.2-1,0.3-1.1,0.4-0.6,0.5-3,0.7-1,0.7-1.1,0.8-1.2,0.8-1.3,0.8-1.5,0.8-1.7,0.9-1.5,1,1-1.5,1-2.5,1-4,1.5-2,1.5-3,1.6-2.2,10-16,10-50,2-3-foliate,2-4,2-5.5,2-8,2-locular,2.3-4,2.5-6,20-35,3.8-4,4-17,4-7,4-8,5-merou,8-18,abaxially,absen,across,adaxiall,adult,alyx,apart,armed,ascending,axe,ba,blade,branche,brown,cross-section,cuneate,cylindrical,decimetre,deltate,directed,distall,distally,distributed,eaf,eed,eglandular,exocarp,finger,frui,functional,geminate,gland-tipped,hair,half,heterostylous,index,juicy,lamina,lanceolate,lateral,less,lobe,lobing,long,longer,lower,markedly,mature,mesocarp,mid-point,midpoint,midvein,minute,moist,nflorescence,oblique,onl,orolla,part,per,placenta,pore,porrect,present,probably,ray,ruit,semi-circula,sessile,short,side,spaced,sparse,stage,stalk,stellae,straight,tal,tamen,tem,thick,thicker,thicknes,throughout,time,tube,unit,uvenile,vary,vein,wide,winged,x,ympodial	5-merous,abaxial,adaxial,arrangement,bark,bud,cell,center,colour,corolla,form,growth,height,history,leaf,life,na,new,number,ovary,position,reproduction,scar,seed,shape,spacing,staman,stem,stigma,surface,texture,trichome,width
644	wfo-0001030699	invalid_json_followup	195	124	92	103	32	0.472	0,0.5-0.7,1-1.5,1-2,12-15,2-3,2-4,2-5,2.5-3,3-10,3-5,4-5,4-7,8-10,acute,anther,apart,apex,apical,bark,base,berry,blue,brown,calyx,clavate,cm,cordate,corolla,corymbose,cyme,diameter,entire,filament,flower,fruiting,glandular-lanate,globose,golden,green,greenish,grey,growth,heterostylous,inflorescence,juvenile,lanate,length,lobed,lobed-angulate,long-styled,margin,middle,mm,nearly,new,ovary,ovate,ovate-elliptic,ovate-lanceolate,ovoid,pedicel,peduncle,petiole,plant,poricidal,porrect,prickle,purple,red,rusty,scar,sessile,short-styled,shrub,spaced,stellate,stem,stigma,style,subscabrous,subsessile,surface,tapering,tip,trichome,unevenly,velutinous,winged,x,yellow,¼	-13,-8.5,0.2-0.3,1.4-1,1.5-2,1/10,1/6,11-12,2-2.5,3-6,4-6,4-6-celled,5,5-6,6-,9-11,abaxially,adaxially,anthesi,antrorse,apically,armed,articulated,basal,branched,brow,cell,compressed,curved,decurrent,densely,discolorous,distal,eaf,eed,elongate,erect,exserted,foliaceous,free,glabrous,glandular,half,hirsute,immersed,induman,known,lengthening,like,linear-lanceolate,lobe,long,lower,many,midpoint,minute,mixed,multangulate,multicellular,nflorescence,older,onto,papillat,partially,perfect,pericarp,plurifoliat,pore,portion,prickly,pubescence,pubescent,rarely,ray,reduced,reflexed,rotate,ruit,simple,single,slightly,slit,sparsely,stalked,staminate,stellate-puberulent,straight,subcoriaceous,subrounded,subscandent,tall,time,tomentose-lanate,tube,ud,unit,upper,vein,villous,without,wood,yellowish,ympodial	'',[,``,abaxial,adaxial,arrangement,bud,center,characteristic,colour,form,fruit,height,history,leaf,life,na,number,papillate,perennial,position,rachi,reproduction,seed,shape,spacing,staman,texture,value,width,{,}
645	wfo-0001030709	invalid_json_followup	217	131	97	120	34	0.447	0-20,0.1-0.2,0.3-1.5,0.7-1,0.8-4,1-1.6,1-4.5,1.3-1.4,1/2-2/3,1/3-1/2,1/4,10-14,2-6,2.3-3,4-5-merous,5-10,5-20,5-6,6-7,8-15,abaxially,acuminate,acute,anther,apart,apex,articulated,bark,base,berry,branched,bright,calyx,chartaceous,cm,conical,diameter,dull,elliptic,elongating,erect,filament,finely,flattened-reniform,flower,fruit,fruiting,glabrescent,glabrous,inflorescence,lateral,leaf,length,lobed,long,margin,mature,maturity,mauve,mm,moderately,orange-brown,pedicel,peduncle,perpendicular,petiole,pitted,porrect,prickle,prickly,purple,red-green,red-orange,reflexed,scar,seed,shrub,simple,smooth,sparsely,spherical,stalked,stellate,stellate-pubescent,stem,straight,style,surface,terete,terminal,trichome,upper,variously,way,wide,yellow,yellow-green	-2,-5,-9,0,0-,0-30,0.15-0.5,0.2-0.5,0.4,0.9-1.5,1-1.2,1-6,1.4-2,1.6-2.1,1.9-2.8,1/4-1/3,10-50,2-4,2-5,2-8,2/3-3/4,3-,5-7,5-9,6-10,6-21,6-8,7-8,7-9,8-11,adaxially,almost,alyx,ame,apar,ape,apically,apparently,blade,broad-deltate,brow,c.,connivent,cordate,cuspidate,deltate,discolorous,distance,drying,eaf,edge,eed,equal,extending,free,increasing,infructescence,lanceolate,lengt,lobe,lobing,lon,long-acuminat,longer,lower,middle,midpoint,midvein,narrow-deltate,nflorescence,occasionally,often,older,one,open,orolla,oung,pair,pendulous,per,perfect,pericarp,pit,plurifoliat,poricidal,portion,prickl,primary,ray,retrorse,rounded,ruit,secondary,short-styled,shorter,side,size,slender,sometimes,spaced,spreading,stalk,tamen,tapering,tertiary,time,tip,toward,truncate,tube,unarmed,unit,usually,vary,vein,venation,visible,weakly,woody,ympodial	'',[,``,abaxial,adaxial,arrangement,brown,bud,characteristic,colour,corolla,form,growth,height,history,life,na,new,number,ovary,perennial,plant,position,rachi,reproduction,shape,spacing,staman,stigma,texture,value,width,{,}
646	wfo-0001030714	invalid_json_followup	178	134	99	79	35	0.556	-3,.2,/3,0.1-0.3,0.5,0.5-0.8,0.5-1.9,0.7-0.8,1-1.2,1-1.3,1.2-1.5,1.2-4,2-2.6,3-3.5,5-100,7-17,abaxial,adaxially,along,anther,anthesi,bark,base,beneath,blue,blue-black,calyx,campanulate,clavate,cm,conical,corolla,dark,densely,diameter,elliptic,entire,especially,except,flattened,flower,fruit,glabrous,globose,gradually,greyish,growth,herbaceous,leaf-opposed,liana,lobed,margin,membranous,midrib,minute,minutely,mm,narrowly,new,ob-ellipsoid,ob-elliptic,occasionally,ovary,pale,paler,papillate,pedicel,peduncle,peg,perfect,petiole,pitted,planar,pubescent,quadrate,reniform,ripe,scar,shape,simple,slightly,sparsely,stellate,stem,stigma,style,surface,tapering,terminal,tip,trichome,uniseriate,vein,vine,violet,way,woody,x,yellow	.5,0.3-0.4,0.8-1,1-1.5,1-2.5,1.4-3.5,1.5-2,1/3,2-2.5,20,3-7,5-6,>,abaxially,acuminate,acute,age,aid,apar,apex,articulating,basal,becoming,berry,branching,climbin,cordate,cup,denser,eaf,eed,ellipsoid,exserted,fide,filament,free,grading,gree,howard,joined,leaving,lengthening,like,lobe,long,lower,many,narrow,nflorescence,nodding,node,oblique,older,overall,pair,papillat,pedice,per,plurifoliat,pore,poricidal,portion,primary,prominent,ruit,slit,spaced,strongly,submarginal,thickened,time,truncate,tub,tube,twining,ud,unit,widely,ympodial	'',0.2,[,``,adaxial,apart,arrangement,bud,cell,center,characteristic,colour,form,fruiting,green,height,history,inflorescence,leaf,length,life,na,number,perennial,plant,position,prickle,reproduction,seed,spacing,texture,value,width,{,}
647	wfo-0001030730	success	205	118	86	119	32	0.42	0.1-0.3,0.8-4.4,1-1.2,1-8,10,11-17,11-20,2-2.5,2-2.9,2-8,2.3-6,3-15,4-11,5.5-6.5,9-10.5,9-15,accrescent,acicular,acute,adaxially,anther,apex,calyx,chartaceous,cm,densely,depressed,diameter,entire,extra-axillary,filament,finally,flower,fruit,fruiting,glabrous,globose,green,grey,herbaceous,inflorescence,later,length,light,lobed,long,longer,marbled,margin,minutely,mm,obtuse,ovate,pale,pedicel,peduncle,perennial,petiole,pink,prickle,pseudo-racemose,purple,rachi,resprouter,rhizomatous,rugose,shallowly,shrub,simple,smooth,stellate,stellate-pubescent,stigma,straight,style,surface,thick,time,toward,white,wide,x,yellow,yellow-brown,yellowish,yellowish-green	%,0-0.8,0-1,0-1.2,0-1.6,0-6,0.05-0.1,0.05-0.2,0.5-0.9,0.5-1,0.6-1.2,0.7-1.2,0.8-1.2,1-1.7,1-10,1-3,1.1-1.9,1.5-4.5,1.7-2.3,15-60,2-4,2-5,2-foliate,2.5-7,240-700,3-20,4-7,4-locular,5-40,5-merou,5.5-14.5,7-8,abaxially,absent,across,adaxiall,alyx,apart,armed,articulated,ascending,attenuate,axe,ba,base,blade,bony,connivent,cuneate,curved,cylindrical,d.,deltate,directed,distall,distributed,drooping,eaf,eed,eglandular,finger,first,geminate,glabrou,gland-tipped,hair,half,hard,lamina,lanceolate,lateral,less,lobe,lon,loosely,lower,mature,mid-point,midpoint,midvein,minute,nflorescence,oblique,orolla,part,per,perfect,pore,porrect,presen,present,probably,ray,ridged,ruit,rusty,short,slightly,spaced,sprawling,spreading,stage,stalk,stellae,subcordate,tal,tamen,tem,throughout,truncat,tube,unarmed,unbranched,unit,unknow,uvenile,vary,vein,ympodial	abaxial,adaxial,arrangement,bark,bud,cell,center,colour,corolla,form,growth,height,history,leaf,life,na,new,number,ovary,plant,position,reproduction,scar,seed,shape,staman,stem,texture,trichome,truncate,unknown,width
648	wfo-0001030733	success	130	103	64	66	39	0.492	/4,0.5-1,1-1.2,1-1.5,1-2,3-5,4.5-5,6-7,abaxially,acuminate,acute,adaxially,anther,apex,bark,base,bi-lobed,broadly,brown,calyx,capitate,closely,cm,conical,corolla,dark,densely,ellipsoid,elliptic,erect,filament,fruiting,glabrous,globose,green,later,leaf,lobed,long,minutely,mm,moderately,narrowly,opposite,ovary,ovoid-reniform,pedicel,petiole,pubescent,scar,shrub,simple,smooth,spaced,sparsely,stem,stigma,style,surface,treelet,trichome,uniseriate,way,white	.5,1.5-5,1.7-2.7,2-2.5,3-4,4-15,5-8-flowered,6-9,?,along,anthesi,ape,berry,clearly,coriaceous,decurrent,deltate,denser,dia,eaf,eed,elongate,embryo,exserted,free,grayish-brow,lamina,lateral,like,lobe,lon,lower,main,margin,middle,nflorescence,older,onto,overlappin,pair,papillo,planar,pore,poricidal,portion,rounded,ruit,shaped,somewhat,strongly,tall,tear-drop,testa,thick,tip,tube,ud,unifoliat,unit,vein,visible,widest,woody,x,ympodial,young	0.5,5-8,abaxial,adaxial,arrangement,bud,cell,center,colour,dense,diameter,flower,form,fruit,grayish-brown,growth,height,history,inflorescence,length,life,na,new,number,overlapping,papillose,peduncle,perennial,plant,position,rachi,reproduction,seed,shape,spacing,staman,texture,unifoliate,width
649	wfo-0001030751	invalid_json_followup	226	134	100	126	34	0.442	-5,-7,.5,0,0-0.5,0-1,0.5-1.5,0.5-1mm,0.6-1.5,1,1-24,1-3,1-4,14-20,2-3,2-3.5,3-5,5-15,5-6,7-15,8-13,abaxially,acute,acute-,adaxially,anther,apart,apex,articulated,base,branched,broadly,calyx,campanulate,closely,cm,coarsely,deltoid,densely,dentate,depressed-deltoid,diameter,divergently,elliptic,erect,felty-pubescent,filament,flower,form,fruit,fruiting,glabrous,globose,hair,inflorescence,interwoven,leaf-opposed,length,lenticular,light,like,lobe,margin,minutely,mm,obtuse-tipped,orange,ovate,pedicel,peduncle,perennial,petiole,pitted,prickle,pubescent,purplish,rachi,ripe,sessile,simple,small,spaced,sparsely,spreading-hirsute,stalked,stellae,stellate,stellate-woolly,stem,stigma,style,surface,tan,thin-textured,trichome,unbranched,white,x,yellow,young	.2,0.1-0.3,0.1-0.4,1-2,1/4-1/2,10-15,11-40,13-50,2,2-foliate,2.5-4,20-25,3-6.5,3.5-4.5,4-6,5-7,5-8,6-9,7-13,accrescent,adaxiall,along,also,among,attenuate,axe,ba,basally,blade,broad,capitat,cast,cauline,clas,commonly,completely,connivent,cordate,covering,cylindrical,deciduou,directed,distal,distall,distinct,divergent,dominant,eaf,eed,elongate,entire,equaling,especially,essentially,female-sterile,finally,flesh,foliar,frui,geminat,green,inserted,interlobal,lanceolate,larger,lateral,less,lignescent,long,longest,lower,major,midpoint,mixture,mostly,multiseriate,nflorescence,numerous,occasionally,often,one,orolla,ovate-lanceolate,per,petaloid,pore,present,prickl,prickly,principal,prolonged,pubescence,ray,recurve,ruit,scattered,shallowly,short,shorter,side,sinus,smaller,somewhat,spreading,stalk,stellate-pubescent,stipitate,straight,tal,tamen,tem,termination,tip,tooth-like,truncate,tube,typically,unarmed,unit,usually,variable,vary,vein,vivo,wide,ympodial	'',[,``,abaxial,adaxial,arrangement,bark,bud,capitate,characteristic,colour,corolla,growth,height,history,leaf,life,na,new,number,ovary,plant,position,reproduction,scar,seed,shape,spacing,staman,texture,value,width,{,}
650	wfo-0001030772	success	155	94	65	90	29	0.419	-2,.05,0.2-0.8,0.25-0.5,0.75-1,0.9-1,1-2,1.5-2,3-3.5,3-5,5-6,acuminate,anther,apex,bark,branch,bud,capitate,closely,cm,corolla,dark,elliptic,filament,fruit,gently,glabrous,globose,green,grey,leaf,lenticellate,lobed,long,minutely,mm,node,occasionally,opposite,ovary,overlapping,ovoid-reniform,pale,paler,papillose,pedicel,petiole,pitted,scar,shape,shrub,simple,slightly,spaced,stem,stigma,style,surface,swollen,tan,tapering,trichome,uniseriate,white,x	.2,.25,.5,0.5-1,0.9-3.1,1-2.5,1.2-5,1.4-1.6,2-7,4.2-6.5,5-10-flowered,8-10,9-15,acute,anthesi,archin,attenuate,ba,base,becoming,beginning,beneath,berry,calyx,deflexed,dia,differing,difoliate,eaf,edicel,eed,ellipsoid,erect,extreme,free,fruiting,geminat,impressed,inflorescenc,large,later,lateral,lobe,lon,long-acuminate,long-triangular,lower,main,major,margin,methyl,middle,minor,nearly,nflorescence,older,one,pair,papillo,per,pore,poricidal,portion,prominent,reflexed,ripe,rounded,ruit,salicylate,shaped,shining,size,slender,smelling,soon,straight,strongly,tall,tear-drop,tip,tube,ud,unit,usually,vein,widest,wintergreen,woody,ympodial,young	5-10,abaxial,adaxial,arching,arrangement,colour,diameter,flower,form,growth,height,history,inflorescence,length,life,na,new,number,peduncle,perennial,plant,position,rachi,reproduction,seed,spacing,staman,texture,width
651	wfo-0001030781	invalid_json_followup	213	125	85	128	40	0.399	0.5-6,1-10,1-12,1-2,10-40,15-35,2.5-14,2.5-3.5,4-15,5-6,7.5-9,abaxially,adaxially,anther,apex,apiculate,axillary,brownish,bud,cell,chartaceous,cm,condition,corolla,covering,dark,deep,densely,diameter,dot,drying,filament,finely,flower,forked,fresh,fruit,glabrous,globose,gray-green,green,greenish,herb,lateral,leaf,light,margin,membranous,minutely,mm,obovate,odd-pinnate,ovate,ovoid,pedicel,peduncle,pentagonal,petiole,pilose,plant,pointed,puberulent,pubescent,purple,rachi,rotate-pentagonal,rounded,scattered,seed,slightly,small,sometimes,stem,stigma,style,subovoid,subtending,terminal,testal,thick,violet,wall,white,whitish,yellow	0-5,0.2-4,0.5-8,1-1.5,1-4,1-8,1.5-12,1.5-2,1.5-9,1.6-2.2,2-20,2-3,3-4,3-6,5-7,5-8,5-merou,6-7,abruptly,acumen,ag,along,alyx,apart,apparently,articulated,axe,base,berry,blade,borne,broadly,brown,caly,capitat,ciliate,connivent,cuneate,decreasing,decurrent,digestion,distal,dorsally,eaf,edge,eed,elliptic,end,enzyme,erect,especially,exceeding,flat,folded,geminat,generally,glabrou,glandular,gradually,green-white,hair,hair-like,half,high,homostylous,honeycomb-shaped,interjected,lanceolate,larger,leaflet,lengthening,like,living,lobe,long,low-growin,lower,make,midrib,mucilaginous,narrowed,nflorescence,orbicular,orolla,ovate-lanceolate,pair,papillose,perfect,petiolulate,plurifoliate,pore,poricidal,rarely,removed,ruit,sessile,seudostipule,short,simple,singly,size,slit,somewhat,spaced,sparsely,specimen,stamen,ste,stolo,straight,tall,tamen,tem,throughout,tip,toward,tri-,tube,tuber,typically,unit,unwinged,usually,vary,wet,wide,x,ympodial	'',[,\u201chair-like\u201d,``,abaxial,adaxial,arrangement,bark,calyx,capitate,center,characteristic,colour,form,fruiting,growth,height,history,inflorescence,length,life,na,new,number,ovary,perennial,position,prickle,reproduction,scar,shape,spacing,staman,surface,texture,trichome,value,width,{,}
652	wfo-0001030782	success	198	81	56	142	25	0.283	0.4-1.5,1-2,1.5-7.5,12-30,13-22,2,2.2-4,3-10,3-5,5-20,6-8,7-15.6,anther,apex,clavate,cm,coriaceous,corolla,dark,deep,diameter,elliptic,filament,flower,forked,fruit,glabrescent,glabrous,globose,green,greenish,herb,leaf,light,lilac,medium,mm,moniliform,odd-pinnate,ovate,ovoid,pedicel,peduncle,pentagonal,petiole,plant,rachi,rotate,seed,stigma,style,terminal,tuber,white,whitish,yellow	0-1,0-7,1-3,1-5,1-6,1.2-3.9,1.3-1.6,1.5-2,1.6-4.6,11-47,15,2-3,2.4-11.5,4-11.6,4-6,4.6-26,5-merou,abaxiall,abaxially,acumen,acuminate,acute,adaxially,ag,along,alyx,apart,apparently,arranged,articulated,asymmetric,attenuate,axe,axillary,base,basiscopic,bead,berry,blade,broadly,brownish,bud,capitat,cell,condition,connivent,covering,cuneate,decreasing,digestion,distal,dorsally,drying,eaf,edge,eed,enzyme,exceeding,flat,folded,fresh,geminat,generally,glabrou,green-white,hair,hair-like,hal,half,high,homostylous,honeycomb-shaped,inconspicuous,interjected,lanceolate,lateral,leaflet,lengthening,like,living,lobe,long,lower,make,mottled,mucilaginous,multiple,necklace,nflorescence,orbicular,orolla,pair,perfect,petiolulate,plurifoliate,pore,poricidal,prominently,purple,removed,ripe,rounded,ruit,scarce,second,sessile,seudostipule,short,side,size,slit,smaller,sometimes,spaced,specimen,stamen,stolon,straight,subequal,subtending,tal,tamen,tem,testal,thick,throughout,tip,tissue,totally,toward,tri-,tube,typically,unit,usually,vary,wall,wet,wide,winged,x,ympodial	abaxial,adaxial,arrangement,capitate,colour,form,growth,height,history,inflorescence,length,life,na,number,ovary,perennial,position,pseudostipule,reproduction,shape,spacing,staman,surface,texture,width
653	wfo-0001030802	invalid_json_followup	171	104	65	106	39	0.38	.5,0.5-1,0.5-1.5,0.75-1,1,1-1.1,2-3,3-3.5x,abaxially,anther,apex,bark,brown,bud,calyx,campanulate,cm,corolla,difoliate,evenly,filament,flattened-reniform,fruit,fruiting,glabrous,glandular,globose,heart-shaped,internodal,irregularly,leaf,length,lobed,long-triangular,margin,minutely,mm,ovary,ovoid,pale,papillate,pedicel,petiole,pitted,plant,pubescent,red,reddish,scar,shrub,simple,somewhat,spaced,stem,stigma,style,subshrub,surface,trichome,unifoliate,uniseriate,white,widely,yellow,yellowish	.3,.5mm,0,0.25-0.4,0.5-0.75,0.7-1cm,0.9-1,1-1.2,1-1.5,2-2.5,2-5,2.5-3,3-4,3-6,4-5mm,4-6,5-10-flowered,abrupt,acuminate,acute,adaxially,along,anthesi,appearing,basal,base,becoming,beginning,beneath,berry,cordate,cucullate,deeply,deflexed,densely,denser,dia,dry,eaf,edicel,eed,ellipsoid,except,exerted,exudate,filiform,free,geminat,gland,glandurla,halfway,hanging,incrassate,inflorescenc,invest,lamina,later,lateral,line,live,lobe,long,lower,m.,main,markedly,material,midvein,near,nflorescence,obconic,older,pair,palmate,papillose,per,persistently,pore,poricidal,portion,prominent,pubescen,raised,ruit,shaped,single-celled,slender,soon,specimen,stigm,straight,strongly,tapering,tear-drop,tip,tipped,trichoem,tube,ud,unit,variable,vein,woody,x,ympodial,young	'',0.7-1,4-5,5-10,[,``,abaxial,adaxial,arrangement,cell,center,characteristic,colour,diameter,flower,form,growth,height,history,inflorescence,life,na,new,number,peduncle,perennial,position,prickle,rachi,reproduction,seed,shape,spacing,staman,texture,value,width,{,}
654	wfo-0001030803	success	185	123	96	89	27	0.519	.5,0.2,0.5,0.5–1.5,0.75–1,1.5,10–15,1–2.5,1–3,2.5,20–40,3–10,3–4,3–5,6–8,abaxially,acuminate,adaxially,anther,anthesi,apex,armed,articulated,base,berry,branched,brown,bud,calyx,campanulate,chartaceous,cm,corolla,diameter,entire,filament,flattened-reniform,flower,fruiting,glabrous,globose,green,hair,imparipinnately,leaf,leaflet,light,lobed,long,margin,midrib,minute,minutely,mm,often,papillae,pedicel,peduncle,petiole,pinnate,pinnatifid,pitted,pointed,prickle,puberulent,rachi,ranging,rarely,recurved,rounded,rugose,shape,sharply,simple,slender,spreading,stellate,stem,stigma,stout,strongly,style,subwoody,surface,terminal,truncate,turbinate,variable,variously,vine,woody,yellow,yellowish,×,–10,–5	0.2–0.3,0.3,0.4,0.9–1.5,1,1-,1.5-,1.5-3,1/3,10967,2–,3-6,4–10,5,6–12,7–9,?,absent,acute,adaxiall,adjacent,ag,almost,alyx,axe,basal,becoming,blade,broadly,confluent,connecting,connivent,corresponding,dr.,eaf,eed,elliptic,elongating,equal,exserted,hinton,internode,lanceolate,lateral,lengthening,lobe,long-styled,lower,major,middle,midri,narrowly,nflorescence,orolla,outline,ovate,pericarp,petiolule,plurifoliat,pore,poricidal,present,purple,recurve,ruit,side,size,slit,somewhat,straight,swolle,tamen,tapering,time,tip,tissue,triangular,truncat,tube,unit,usually,vary,vein,wide,widest,wing,wood,ympodial,–16	abaxial,adaxial,arrangement,bark,colour,dry,form,fruit,growth,height,history,inflorescence,length,life,na,new,number,ovary,perennial,plant,position,reproduction,scar,seed,staman,texture,width
655	wfo-0001030809	invalid_json_followup	154	110	64	90	46	0.416	0.2,0.5-1,1.2-1.4,1.4-1.5,1.5-3.5,2-2.5,4.5-5,6-8,8,acute,along,anther,apex,bark,base,beneath,branched,calyx,cm,corolla,curl-tipped,densely,ellipsoid,elliptic,especially,filament,fruit,fruiting,glabrous,globose,golden,green,lateral,leaf,lobed,long,long-papillose,main,midrib,mm,nearly,opposite,ovary,ovate,pedicel,petiole,scar,scattered,several,shining,simple,stem,stigma,style,tapering,time,tip,tomentose,tree,trichome,uniseriate,vein,white,yellow-brown	.5,1-1.25,1-1.5,1.5-2.4,2.3-5.5,20-60-flowered,5-8,9.9-12,across,also,anthesi,apar,appearing,berry,broadly,caly,campanulate,clavate,curved,dark-papillo,deciduous,deflexed,deltoid,dense,dia,difoliate,distally,eaf,edicel,eed,erect,evenly,exserted,falcate,free,geminat,hair,hidden,interpetalar,known,large,leave,like,lobe,lon,lower,major,markedly,mature,membranous,middle,minor,minutely,nflorescence,older,one,overtopping,planar,pore,poricidal,portion,present,pubescent,round,ruit,shinin,shoot,sinus,size,slender,slightly,small,soon,spaced,straight,tall,terminal,three,triangular,tube,two,ud,underside,unequal,unit,wide,widest,x,ympodial,young	'',1.5,20-60,[,``,abaxial,adaxial,alternate,apart,arrangement,bud,cell,center,characteristic,colour,dark-papillose,diameter,flower,form,growth,height,history,inflorescence,length,life,margin,na,new,number,peduncle,perennial,plant,position,prickle,rachi,reproduction,seed,shape,spacing,staman,surface,texture,value,width,{,}
656	wfo-0001030810	success	191	121	73	118	48	0.382	0.2,abaxially,adaxially,along,anther,apart,axillary,bipinnate,blue,borne,branched,brown,calyx,cell,chartaceous,clavate,cm,colour,dark,densely,denser,diameter,divided,erect,filament,flattened,fleshy,flower,fruit,glabrous,globose,green,greyish,hair,indumentum,leaf,leafy,long,margin,midvein,mm,moderately,multicellular,pair,pale,pedicel,peduncle,pentagonal,petiole,pinnae,pinnate,pitted,primary,pubescent,shallowly,shiny,shoot,shrub,simple,stem,stigma,style,surface,time,tomentose,unicellular,uniseriate,unknown,violet,white,woody,x,yellow	0.2–0.3,0.3,0.4,0.5–,0.5–0.8,0.6–1.0,0.7–1.4,0.8–5.5,0.95–2.0,0–,1,1.0–1.5,1.0–2.0,1.0–3.0,1.1–2.0,1.1–2.2,1.2–1.5,1.5–1.9,1–2,1–3,1–5,2.9–4.5,20–100,2–3,2–4,3.0–5.0,3.3–5.5,3.3–8.5,3.5–4.6,3–19,4–14,4–5,4–7,5,5–15,5–30,5–32,6–10,6–22,7–10,7–11,8–10,absen,accrescent,acute,adaxiall,ag,anthesi,apex,articulated,axe,ba,base,blade,connivent,cylindrical,decreasing,eaf,eed,elliptic,elliptical,equal,especially,geminat,half,hig,irregular,lobe,lon,longitudinal,lower,m.,midrib,narrow,nflorescence,oblong,obtu,occasionally,older,opening,opposed,orolla,oung,perfect,plurifoliate,pore,poricidal,rarely,reflexed,rounded,ruit,secondary,shaped,side,size,slit,sometimes,spaced,sparsely,stone,straight,subglabrous,tamen,tardily,tear-drop,tip,tube,unit,vary,wide,wing,ympodial,–2.5,–3,–3.4,–4.5,–5.0,–8	0.2-0.3,0.6-1.0,1-2,1.0-1.5,1.1-2.2,20-100,3,3.3-5.5,3.5-4.6,4-14,4-5,5-15,5-32,6-22,7-10,8-10,abaxial,adaxial,arrangement,bark,bud,center,corolla,form,fruiting,growth,height,history,inflorescence,length,life,na,new,number,ovary,perennial,plant,position,prickle,reproduction,scar,seed,shape,spacing,staman,texture,trichome,width
657	wfo-0001030814	invalid_json_followup	223	127	88	135	39	0.395	-3.5,.5,0-0.2,0-0.3,0.4,0.5-1.5,1.5,1.5-2,1.8-3.5,15-20,3-5,5-12,5-15,5-8,5.5,6-9,abaxially,adaxially,almost,anther,apart,base,branched,broadly,calyx,campanulate,cm,coarsely,densely,dentate,diameter,divergently,divided,elongating,essentially,extra-axillary,felty,filament,flower,form,fruit,glabrous,globose,immature,inflorescence,interwoven,length,lenticular,lignescent,long,margin,minutely,mm,narrower,obsolete,oval,ovate,ovoid,pedicel,peduncle,perennial,petiole,pitted,pubescent,rachi,ripe,scattered,sericeous,sessile,short,short-stalked,simple,somewhat,spreading,stellae,stellate,stellate-pubescent,stem,stigma,style,tan,thin-textured,trichome,uniseriate,weakly,white,x,yellow	-0.5,-1.5,-4,.5-3,0.1-0.2,0.1-0.3,0.3-0.6,1-2,1-4,1/8-1/3,10-12,10-25,14-15,15-16,16-30,2-3,2-foliate,23-31,3-7,4-,4-5,4-6,5,5-9,6-15,6-locular,7-11,7.5-11,absent,acute,acute-tipped,adaxiall,along,apex,apiculate,appressed,articulated,ascending,asymmetric,attenuate,axe,ba,basal,become,becoming,blade,bulge,capitat,capitate-glandular,connivent,cultivated,cylindrical,depressed-deltoid,developed,diffusely,directly,distal,distall,eaf,eed,elongate,entire,female-sterile,geminat,glabrescent,hair,hirsute,inserted,interlobal,intermixed,invested,lanceolate,lateral,less,lobe,lon,lower,major,mature,midpoint,midvein,minute,much,nflorescence,obtuse,obtuse-tipped,often,orolla,oung,ovate-lanceolate,per,pericarp,pore,prominent,pubescence,ray,replaced,rip,rounded,ruit,shorter,side,similar,simple-,simple-haired,sinus,slightly,small,sometimes,soon,spaced,specimen,stalk,stellate-,stellate-pubescen,strongly,swollen,tal,tamen,termination,time,truncate,tube,unarme,unarmed,unbranched,unit,unknown,usually,vary,vein,weak,wide,ympodial,young	'',[,``,abaxial,adaxial,arrangement,bark,bud,capitate,cell,center,characteristic,colour,corolla,fruiting,growth,height,history,leaf,life,na,new,number,ovary,plant,position,prickle,reproduction,scar,seed,shape,spacing,staman,surface,texture,value,width,{,}
658	wfo-0001030822	success	146	81	53	93	28	0.363	.2,0.5-1.5,0.9-1,1-1.5,2-2.5,2-5,3-3.5,3-5,5-6,acute,anther,apex,calyx,clavate,closely,cm,corolla,elliptic-obovate,filament,filiform,flattened-reniform,flower,fruiting,glabrous,globose,green,inflorescence,internodal,leaf,lobed,margin,minutely,mm,ovary,pale,pedicel,petiole,pitted,revolute,shiny,shrub,simple,spaced,stem,stigma,strongly,style,surface,tan,white,winged,x,yellowish-brown	0-0.5,0.1-0.2,0.4,0.4-1,0.8-1,1-1.2,1.5-2,11-15.5,2-3.8,3.5-7,5-7,8-9,abaxially,adaxially,anthesi,attenuate,ba,base,beneath,berry,broadly,clustered,completely,cucullat,cucullate,cup,decurrent,deflexed,deltate,dia,differing,difoliate,eaf,edicel,eed,erect,exserted,fleshy,free,geminat,incrassate,inflorescenc,later,lateral,lobe,lon,long,long-ellipsoid,lower,main,major,middle,minor,minute,near,nearly,nflorescence,occasionally,older,onto,open,opposite,pair,papillo,papillose,perhaps,planar,pore,poricidal,portion,present,red-papillose,ruit,scar,shaped,size,slightly,somewhat,sparsely,tall,tapering,tear-drop,tip,tube,ud,unit,usually,vein,widest,woody,yellowish,ympodial,young	abaxial,adaxial,alternate,arrangement,bud,colour,diameter,form,fruit,growth,height,history,length,life,na,number,peduncle,perennial,plant,position,rachi,reproduction,seed,shape,spacing,staman,texture,width
659	wfo-0001030846	invalid_json_followup	214	131	103	111	28	0.481	-0.8,0.2-0.5,0.5-0.7,1-1.5,1-2,1-3,1-4,10-15,2-10,2-3,2.5-3,5-15,6-8,8-10,abaxial,abaxially,acute,adult,angulate,anther,apart,apex,bark,base,beige,berry,branching,brown,brownish,calyx,clavate,cm,corolla,cream,curved,dark-green,diameter,elliptic,entire,filament,flattened,flower,fruit,fruiting,glandular,glandular-viscous,golden,grey,growth,heterostylous,hirsute,inflorescence,juvenile,lateral,leaf,lobed,many,margin,mm,nearly,new,oblanceolate,obovate,opposite,oval,ovary,ovate-elliptic,pedicel,peduncle,perfect,petiole,plant,porrect,prickle,pubescence,pubescent,rachi,ray,red,reddish,reniform,rhombic,rugose,rusty,scabrous,scar,shrub,sparsely,stellate,stem,stigma,style,subglobose,surface,terete,time,tip,tomentose,tomentose-velutinous,trichome,undulate-reticulate,white,yellowish	-11,-4,.3,0.1,0.1-0.3,0.2-0.4,0.8-1,1-1.2,1-2-celled,1-2.5,1-multicellular,1.5-2,3-,3-3.5,3/4,4-4.5,4-5,4-6,5-8,6-18,acuminate,adaxially,anthesi,anthesisflower,antrorse,apical,armed,articulating,assymetric,basal,chartaceous,cuneate,deciduous,decurrent,densely,discolorous,distal,eaf,eed,erect,exserted,ferruginous,free,glabrescent,gland,lanceolate,larger,lengthening,like,linear,linear-lanceolate,lobe,long,long-styled,longer,lower,midpoint,midrib,mixture,much-branched,multiangulate,multicellular,near,nflorescence,obliqu,oblong,obverse,ochraceous,older,papillat,pendant,pericarp,persistent,plurifoliat,pore,poridical,portion,prickly,prominent,puberulent,raised,reflexed,relatively,rest,rotate,ruit,sessile,short,short-styled,similar,simple,slightly,slit,sometimes,stalked,staminate,stipitate,straight,testa,thick,tube,ud,unarmed,unit,upper,wide,without,x,ympodial,young,¼	'',[,``,adaxial,arrangement,bud,characteristic,colour,form,height,history,length,life,na,number,papillate,perennial,position,reproduction,seed,shape,spacing,staman,texture,value,width,{,}
660	wfo-0001030850	success	240	123	98	142	25	0.408	0.1-0.5,1-10,1-2,1-2.5,1-5,1-8,1.5,1/2-3/4,15-20,2-25,2-3,3-10,3-15,3.5-6,4,6-11,8.5-11.5,abaxial,abaxially,acuminate,adaxial,andromonoecious,anther,apart,apex,articulated,bark,base,berry,branched,bright,broadly,calyx,cell,chartaceous,climber,cm,curved,deltate,densely,diameter,elliptic,elongating,erect,filament,flattened,flattened-reniform,flower,fruit,fruiting,glabrescent,glabrous,gray,leaf,length,lobed,long,margin,mauve,mm,moderately,obtuse,orange,orange-brown,outline,ovate,pale,pedicel,peduncle,petiole,pit,plant,porrect,prickle,pubescent,purple,raised,red-brown,red-orange,rounded,scandent,scar,sessile,shrub,simple,small,smooth,sparsely,spherical,stalked,stellate-pubescent,stem,style,surface,terete,trichome,way,yellow	-6,.5,/4,0-,0-0.5,0-30,0-40,0.1-0.2,0.1-0.3,0.1-0.4,0.2,0.5-2,00,1-,1-20,1-3,1-4,1.2,1.5-2.5,1/2,1/2-1/5,1/3,1/3-3/,1/3-3/4,10-100,10-20,2-15,2-4,2-6,3-3.7,3-4,3-5,3-6,4-8,5-10,5-12,5-13,5-merous,6-8,7-15,7-22,8-20,acuminat,acute,alyx,apar,apically,apparently,blade,broad-deltate,brow,connivent,cordate,cream,cuneate,dark,difoliate,discolorous,distal,distance,drying,eaf,eed,elongate,elongated,entire,equal,extending,free,geminat,gently,green,green-brown,hermaphrodite,heterostylous,infructescence,lateral,lobe,lobing,long-styled,longer,lower,lowermost,marking,mature,maturity,midpoint,midvein,nflorescence,oblong,obovate,often,older,one,open,orolla,oung,pair,pendulous,per,pericarp,poricidal,portion,prickl,prickly,primary,ray,red-green,reduced,ruit,secondary,short-styled,shorter,side,sometimes,somewhat,spaced,spreading,stalk,staminat,stellate,stout,straight,tamen,tapering,terminal,tertiary,time,tip,truncate,tube,unit,upper,variously,vary,vein,venation,visible,wide,woody,ympodial,young	arrangement,brown,bud,center,colour,corolla,form,growth,height,history,inflorescence,life,na,new,number,ovary,perennial,reproduction,seed,shape,spacing,staman,stigma,texture,width
661	wfo-0001030867	success	259	146	126	133	20	0.486	.3,.5,0-,0.6-1.5,1-1.5,1-2,1-2.5,1-5,1.5,1.5-4.5,1/4,10,12-15,2-6,2.5-3,4-4.5,5-6,6-7,abaxially,acute,adaxially,andromonoecious,anther,anthesi,apart,apex,band,bark,base,berry,branched,brown,bud,calyx,chartaceous,cm,concolorous,corolla,cup-shaped,curved,dark,densely,diameter,either,ellipsoid,elliptic,elongate,erect,expanded,filament,flower,fruit,fruiting,glabrous,globose,green,greyish,growth,herbaceous,inflorescence,internodal,lateral,leaf,leathery,length,less,like,lobed,long,long-styled,margin,mature,membranous,midvein,mm,new,nodding,occasionally,opposite,outline,ovary,ovoid,pale,pedicel,peduncle,pentagonal,petal,petiole,plant,prickle,prickly,pubescent,reniform,sessile,shallowly,short-stalked,short-styled,shrub,side,simple,sinuate,slightly,somewhat,spaced,sparsely,stellate,stellate-pubescent,stem,stigma,straight,style,subshrub,surface,tan,thick,tip,translucent,trichome,unevenly,violet,way,white,wide,x,yellow,yellowish	-1/3,-6,.25,0.3,0.5,0.6,1,100,14,18,2-2.5,2-3,2-5,2.5-3.5,3-4,3-5,3.5-8.5,4,4-5,4-6,4.5-14,5-25,5-merous,6,<,>,abundant,acumen,alyx,approximately,area,armed,articulated,attenuate,bi-lobe,borne,broad-based,cast,cell,curve,decurrent,denser,difoliate,directed,distal,distall,distance,dry,drying,eaf,easily,eed,equal,exposed,exserted,flowering,free,functionally,geminate,glabrescen,greatest,halfway,hermaphroditic,heterostylous,immature,infructescence,interpetalar,lamina,larger,lobe,lon,longer,lower,lowermost,mal,markedly,maturing,maturit,midpoint,midrib,mottled,narrowly,near,nflorescence,often,older,onto,orolla,pair,pendent,per,pericarp,planar,pore,poricidal,portion,primary,ray,re,reflexed,rest,ruit,scar,shap,size,small,splitting,still,stouter,strongly,tall,tamen,tapering,testal,thickened,thinne,tissue,triangular,tube,type,ud,unit,upper,usually,vary,varying,vein,visible,whitish,winged,woody,ympodial,¼	abaxial,adaxial,arrangement,bi-lobed,colour,form,height,history,life,na,number,perennial,position,reproduction,seed,shape,spacing,staman,texture,width
662	wfo-0001030871	invalid_json_followup	248	129	91	157	38	0.367	0.2-0.4,0.3-4,0.4-1.8,0.6-1.5,1-1.3,1-18,1.3-2,2-8,2.8-4.5,3-32,3-4.4,4.5-6.5,5-33,abaxially,abruptly,acuminate,acute,adaxial,adaxially,anther,apart,apex,appressed-tomentose,bark,becoming,berry,brown,bud,calyx,chartaceous,cm,conical,continued,corolla,dark,deltoid,diameter,due,elongate,entire,filament,fleshy,flower,fruit,fruiting,glabrescent,granular-tomentose,grayish,green,greenish,growth,honeycombed,lateral,leaf,length,lobed,margin,mm,mostly,orbicular,ovate,pale,pedicel,peduncle,petiole,probably,purple,rachi,reniform,reticulate-punctate,ripe,rotate-stellate,scabridulous,short,shrub,simple,stellate-tomentose,stem,stigma,style,suborbicular,terminal,tomentose,tree,velutinous,violet,white,x,yellow,yellowish,young	.2-3,.8-3.5,.9-1.2,/30-1/5,0-120,0.7-1.3,0.7-2.5,1.3-3,1.4-2.7,1.5-3,1.5-6,1.8-2.6,1.8-3.5,1/2,1/2-3/4,1/4,1/4-1/3,11,2-3,3-5,3-6,3.5-14,30,4.8-9.5,5-7,6-40,7-12,9-13,accrescent,ag,along,anthesi,apical-lateral,apparently,appressed,articulated,attenuate,axe,axillary,ba,base,blade,blunt-tipped,branch,branched,campanulate,capitat,closely,decurrent,dehiscing,dendritic-echinoi,dendritic-echinoid,dendritic-multangulate,densely,directed,distal,eaf,earl,early,echinoi,echinoid,eed,elliptic,equal,erect,evident,exserted,extend,free,glabrescen,glabrous,hair,held,high,inserted,introrse,large,lobe,long,long-,long-stalked,longer,longitudinal,lower,m.,main,midvein,minute,mixed,multangulat,multangulate,narrowly,nearly,nflorescence,nodding,oblong,obtuse,occasionally,often,older,open,orbicula,orolla,ovate-lanceolate,overlapping,partly,perfect,plait,plurifoliate,pore,porrect-stellate,present,prominent,pubescent,rather,ray,reflexed,relatively,ruit,runk,sessile,short-,short-stalked,side,slit,small,sometimes,somewhat,soon,spaced,sparingly,sparsely,splitting,stamen,striate,strongly,subglobose,sulcate,suture,tamen,terete,testa,thick,thick-stalked,thin-stalked,time,toward,tube,unarme,unarmed,unit,usually,vary,vein,way,wide,ympodial	'',0.2-3,30-120,[,``,abaxial,arrangement,capitate,cell,center,characteristic,colour,form,height,history,inflorescence,life,na,new,number,ovary,perennial,plant,position,prickle,reproduction,scar,seed,shape,spacing,staman,surface,texture,trichome,value,width,{,}
663	wfo-0001030872	success	166	98	65	101	33	0.392	.5,0.8-1,1-1.5,1.2-1.5,1.5-5,2-5,4-6,5.5-7,acuminate,acute,adaxial,anther,apex,area,bark,base,black,broadly,brown,calyx,center,closed,closely,cm,completely,corolla,crateriform,dark,deflexed,ellipsoid-ovoid,elliptic,erect,filament,fleshy,fruiting,glabrous,globose,green,leaf,lobed,margin,mm,nearly,opposite,ovary,ovate,paler,papillose,pedicel,petiole,scar,shining,simple,slightly,small,spaced,stem,stigma,style,tip,tree,treelet,white,x,young	0.5,0.5-1,0.8-2,1-1.2,1-2,1.2-3,1.5-2,12-18,3-7,4-6-flowered,5-6,6-12.5,age,along,anthesi,appearing,beginning,berry,caly,consisting,corky,cucullate,darker,deltoid,densely,dia,difoliate,dry,eaf,edicel,eed,exserted,free,full,geminat,glabrate,hooded,incurved,inflorescenc,known,large,lenticel,lenticellate,less,like,live,lobe,lon,long,lower,major,material,middle,minor,minutely,nerve,nflorescence,oblique,older,one,overlapping,pair,pale,petal,planar,pore,poricidal,portion,primary,prominent,proximal,puberulent,raised,rather,red-glandular-puberulent,reddish-glandular,reddish-glandular-puberulent,relative,rest,ridge,rounded,ruit,shaped,shorter,side,size,soon,specimen,straight,strongly,styl,tall,tapering,tear-drop,thickened,tube,ud,unit,widest,woody,ympodial	abaxial,alternate,arrangement,bud,cell,colour,diameter,flower,form,fruit,growth,height,history,inflorescence,length,life,na,new,number,peduncle,perennial,plant,position,rachi,reproduction,seed,shape,spacing,staman,surface,texture,trichome,width
664	wfo-0001030877	success	223	108	78	145	30	0.35	0-0.5,0-5,0.1-0.6,0.1-1,0.5-1,0.7-1.4,1-1.5,1-2,1.5-2,2-15,2-3,3-10,4-6,5-6,6-11,7.5-10,8-15,accrescent,acicular,acute,andromonoecious,anther,apex,articulated,base,broadly,calyx,chartaceous,cm,cylindrical,densely,diameter,entire,erect,extra-axillary,filament,flattened,flower,fruit,fruiting,glabrous,globose,green,inflorescence,leaf,length,lobed,margin,minutely,mm,ovate,pale,pedicel,peduncle,perennial,petiole,plant,prickle,pseudo-racemose,purple,rachi,reticulate,rhizomatous,rotate-stellate,shallowly,shrub,simple,stellate-pubescent,stem,stigma,style,surface,unbranched,weakly,x,yellow,yellowish,yellowish-green	%,0-0.2,0-10,0-15,0-4,0.1-0.4,0.2-0.6,0.3-0.4,0.4-0.5,0.4-0.8,0.5-0.6,0.5-0.8,0.7-1.6,0.9-1.2,1-1.3,1-1.4,1-3,1.5-2.4,1.5-3,1.8-2.6,10-14,10-30,10-40,17-26,2,2-3-locular,2-foliate,2.2-2.7,2.9-4.8,2.9-8,4-10,4-8,5,5-11,5-merou,6-12,6-15,6-9,7-9,8-14,8-9,9-14,9-15,abaxially,absen,absent,abundant,across,adaxially,adult,alyx,anvil-shape,apart,ascending,attenuate,axe,ba,blade,branch,branche,brown,capitat,connivent,cross-section,cuneate,directed,distall,distributed,dm,dult,eaf,eed,eglandular,exocarp,finger,functional,geminat,gland-tipped,hair,half,heterostylous,index,interpetalar,juicy,juvenile,lamina,lanceolate,lateral,less,lobe,lobing,long,longer,loosely,lower,mature,mesocarp,mid-point,midpoint,midrib,midvein,minute,moderately,moist,nflorescence,oblique,obtuse,orolla,pair,part,per,placenta,pore,porrect,present,pubescent,ray,ruit,rusty,short,side,spaced,sparsely,stalk,stalked,stellae,stellate,straight,tal,tamen,thick,throughout,time,tissu,tissue,triangular,tube,unarme,unarmed,unit,upper,vary,vein,wide,ympodial	5-merous,abaxial,adaxial,arrangement,bark,bud,capitate,cell,center,colour,corolla,form,growth,height,history,life,na,new,number,ovary,position,reproduction,scar,seed,shape,spacing,staman,texture,trichome,width
665	wfo-0001030882	success	144	87	57	87	30	0.396	.1,.5,0.5-1,0.5-1.1,0.9-1.1,1-1.3,1-4,3-3.5,accrescent,acuminate,anther,apex,bark,calyx,capitate,closely,cm,corolla,crenulate,elliptic,filament,fruit,fruiting,glabrous,globose,green,leaf,lobed,margin,minutely,mm,narrowly,occasionally,opposite,ovary,overlapping,ovoid,ovoid-reniform,pale,papillose,pedicel,petiole,pitted,scar,shrub,simple,slightly,small,spaced,stigma,style,surface,tan,tapering,tree,white,yellowish	0.5-0.75,0.75-1,0.8-1.1,0.8-2.4,1-1.5,1.6-2,2,2-5.4,2-6,2.2-4.6,3/4,6.5-15.6,8-12,?,anthesi,attenuate,base,beginning,beneath,berry,conical,deflexed,deltoid,dia,differing,difoliate,eaf,edicel,eed,erect,exserted,extreme,free,geminat,inflorescenc,lateral,lightly,lobe,lon,long,lower,main,major,middle,minor,nearly,nflorescence,older,one,pair,paler,papillo,peelin,planar,pore,poricidal,portion,prominent,raised,ruguse,ruit,shaped,short,size,slender,soon,stem,straight,tall,tear-drop,terminal,thick,thickened,tip,transversely,truncate,tub,tube,ud,unit,vein,way,widest,woody,x,ympodial,young	abaxial,adaxial,alternate,arrangement,bud,colour,diameter,flower,form,growth,height,history,inflorescence,length,life,na,number,peduncle,perennial,plant,position,rachi,reproduction,rugose,seed,shape,spacing,staman,texture,width
666	wfo-0001030883	success	179	97	68	111	29	0.38	.05,.1,.5,0.5-3,0.5-5,1-1.2,1-1.3,1-1.5,1.5-3.5,2-5,5-6,acuminate,acute,anther,apart,apex,bark,brown,calyx,cell,clavate,cm,corolla,dark,elliptic,evenly,filament,fleshy,fruit,fruiting,glabrous,globose,green,hard,imbedded,inflorescence,leaf,lobed,long-acuminate,massive,minutely,mm,occasionally,opposite,ovary,ovate,ovoid-reniform,papillate,pedicel,petaloid,petiole,pitted,plant,puberulent,russet,scar,seed,shrub,spaced,stem,stigma,stout,style,surface,tapering,trichome,white,woody	-3,1-1.1,1-4,1.5-2,10-18,18-44.5,20-50-flowered,3-3.5,3-4,3/4,9.5-27.5,accrescent,across,anthesi,appearing,approximatately,arching,base,becoming,berry,branched,bu,collapsed,collection,deflexed,dia,differing,difoliate,dry,eaf,edicel,eed,epidermal,erect,finely,free,furcate,geminat,geminate,glandular,hollow,laminar,large,later,lateral,lenticellat,less,like,little,live,living,lobe,lon,long,lower,main,malodorous,markedly,material,middle,midrib,minute,narrowly,nflorescence,oblique,older,pair,pale,papillo,papillose,perpendicular,placenta,pore,poricidal,portion,present,proximal,pulp,quite,rather,reflexed,reticulate,ruit,shaped,size,slender,slightly,sometimes,soon,straight,strongly,tall,tan,tear-drop,thick,time,tip,triangular,tube,two,ud,uniseriate,unit,upper,vein,wall,way,widest,x,ympodial,young	20-50,abaxial,adaxial,arrangement,bud,center,colour,diameter,flower,form,growth,height,history,length,life,margin,na,new,number,peduncle,perennial,position,rachi,reproduction,shape,spacing,staman,texture,width
667	wfo-0001030884	invalid_json_followup	218	115	83	135	32	0.381	0.4-3,0.5-1.2,0.8-1,0.9-5,1-1.5,1.5-2.5,10,2-5,4.5-5,5-30,5-merous,9-11,abaxial,acute,adaxial,anther,apex,bark,berry,brown,calyx,capitate,cm,conical,curved,dark,densely,di-,diameter,elliptic,filament,flower,fruiting,gray-tinged,green,greenish,growth,inflorescence,lateral,leaf,leafy,length,lobed,margin,minutely,mm,moderately,new,ovary,ovoid-reniform,pale,pedicel,peduncle,petiole,plant,prickle,pubescent,red,reddish,regularly,scar,sessile,shallowly,short-stalked,shrub,simple,slender,spaced,sparsely,spherical,stellate,stellate-pubescent,stem,stigma,style,surface,tannish,treelet,trichome,trifoliate,white,winged,yellow	.2,.5,.7,0.3,0.3-0.5,0.5,1,1-1.2,1-3,1.5,1.5-2,100,2,4-13,4-5,5,5-6,5.5-7,6-10,6-25,6-8,7-8,>,abaxially,abruptly,adaxiall,along,also,alyx,andromonoeciou,anthesi,apar,arme,articulated,basal,base,blade,broad-based,c.,connivent,decurrent,differing,directed,discolorous,distal,eaf,eed,equal,extend,extending,flowering,free,geminate,glabrous,glandular,gree,half,herbaceous,heterostylous,infructescence,like,lobe,long,long-stalked,long-styled,long-triangular,lower,magnification,mature,midpoint,midrib,minute,mixture,nflorescence,node,occasionally,older,one,onto,open,orolla,oung,outlin,pair,papillat,per,pore,poricidal,porrect,portion,present,prickly,primary,principal,ray,reflexe,reflexed,rest,ruit,sagittate,scattered,shap,short,short-styled,similar,size,spreading,stiff,still,strongly,tall,tamen,tapering,time,tip,tube,unarmed,unicellular,uniformly,uniseriate,unit,upward,usually,vary,varying,vein,visible,way,weakly,wide,wing,without,woody,ympodial,young	'',0.2-0.5,[,``,arrangement,bud,cell,center,characteristic,colour,corolla,form,fruit,height,history,life,na,number,papillate,perennial,position,rachi,reproduction,seed,shape,spacing,staman,texture,value,width,{,}
668	wfo-0001030899	success	146	101	65	81	36	0.445	.5-2,0.3-0.5,0.5-1,1-3,1-6,10-20,2,2-3,2-3.5,2.5-3.5,3-12,3-4,4-5,5-10,?,abaxially,acuminate,adaxially,apex,articulated,basal,base,bronze,calyx,cell,cm,coriaceous,densely,diameter,ellipsoidal,end,entire,flattened,flower,fruit,glabrous,glandular-puberulent,globose,green,inside,lobe,margin,mm,obconical,outside,ovate,ovoid,pedicel,peduncle,petiole,puberulent,pubescent,purple,rachi,shrub,simple,splotch,stellate,stigma,stripe,style,unbranched,white,x,yellow	-45,0.5,1,1-1.5,1-2,1.5-2,10-13,20-25,3-5,3-foliate,3.5-4,5-6.5,6.5-31,7-27,8-11,absent,acute,aggregate,apart,ape,axe,beyond,blade,chartaceous,connective,connivent,cordate,deeply,desc,dilated,directed,distally,eaf,eed,ex,exceeding,exserted,extrorse,leaving,less,light,lon,long,lower,mucronate,narrowly,nflorescence,nther,oblong,obtuse,orang,orolla,pedicellar,peltifor,perfect,pore,presen,puberulen,radiu,remnant,ruit,shorter,slightly,spaced,stamen,stone,strongly,tal,tem,thecae,time,tomento,triangular,tube,ud,unit,upward,vary,vein,wide,ympodial	abaxial,adaxial,anther,arrangement,bud,center,colour,corolla,filament,form,fruiting,growth,height,history,inflorescence,leaf,length,life,na,new,number,ovary,peltiform,plant,position,reproduction,scar,seed,shape,spacing,staman,stem,surface,texture,trichome,width
669	wfo-0001030902	invalid_json_followup	159	105	59	100	46	0.371	-20,0.6-1.5,1-6,1.5-13,1.5-2.5,10-15,15-50,2,2-3,2-5,3-20,3.5-4,4-22,5-7,acuminate,along,angled,apex,articulated,brown-pilose,calyx,cell,cm,dark,densely,diameter,ellipsoidal,entire,flattened,fleshy,flower,forked,fruit,glabrescent,glabrous,globose,margin,mm,orange,ovate,pedicel,peduncle,petiole,pinkish,purple,purplish,rachi,reddish,simple,stellate,stigma,style,subcoriaceous,tree,truncate,unbranched,vein,x,yellow	-2,-5,0-15,1-2,1.5-,1.5-2,2.5,2.5-4,3-13,3-4,30-50,4,4-6,4-7,4-foliat,5-9,6-24,8-14,abaxially,absent,acute,adaxially,aggregate,apart,ape,apically,apiculate,axe,basal,base,beyond,blade,branched,brow,connective,connivent,cordate,cylindrical,deltate,dilated,directed,distally,eaf,eed,eglandular,equalling,exceeding,except,exserted,glabrat,glandular,glandular-puberulen,hair,laterally,leaving,lobe,lon,long,lower,mature,narrowly,nflorescence,nther,oblong,obtuse,occasionally,orolla,pedicellar,perfect,pore,presen,present,puberulence,radiu,rarely,remnant,ruit,shorter,slightly,small,somewhat,spaced,sparse,sparsely,stamen,stone,subcapitat,tal,tem,thecae,time,tip,tomento,triangular,tube,ud,unit,vary,wide,ympodial	'',[,``,abaxial,adaxial,anther,arrangement,bark,bud,center,characteristic,colour,corolla,filament,form,fruiting,growth,height,history,inflorescence,leaf,length,life,na,new,number,ovary,perennial,plant,position,prickle,reproduction,scar,seed,shape,spacing,staman,stem,subcapitate,surface,texture,trichome,value,width,{,}
670	wfo-0001030906	success	134	81	38	96	43	0.284	1-1.4,1.0-1.4,1/3-2/3,2.3-3.5,38,4-11,8-13,annual,anther,blade,broad-based,broadly,calyx,cm,flattened-ovoid,foveolate,glabrous,herb,internodal,length,long,minutely,mm,ovate,pedicel,pentagonal,petiole,plicate,prickle,seed,somewhat,spherical,stellate-pubescent,stellate-tomentose,stem,subulate,surface,yellow	1,1.5-2.5,2.0-2.6,40-80,6-10,6-8,7-12-flowere,7-16,9-12,accrescent,across,almost,along,alyx,ample,anthesi,arcuate,armed,ascending,base,bearing,berry,branched,bristly,campanulate,cauline,da,densely,developing,dia,difoliate,divided,dry,eaf,essentially,exceeding,externall,faces,flat,geminat,interpetalar,invested,lateral,linear,lobe,long-stalked,main,maturity,n,near,nearly,nflorescence,numerous,obtuse,often,orolla,partly,per,pinnatifid,pinnatisect,prickl,prickly,purple,purpli,red,rounded,ruit,sessil,short,slender,slightly,sometimes,splitting,spreadingly,stellae,strait,suffused,tamen,taprooted,throughout,tightly,tigma,tissue,tub,tube,twice,tyle,ultimate,undulate,unexpande,unit,usually,vary,vein,yello,ympodial	7-12-flowered,abaxial,adaxial,apex,arrangement,bark,bud,cell,center,colour,corolla,diameter,filament,flower,form,fruit,fruiting,growth,height,history,inflorescence,leaf,life,margin,na,new,number,ovary,peduncle,plant,position,rachi,reproduction,scar,shape,spacing,staman,stigma,style,texture,trichome,unexpanded,width
671	wfo-0001030914	invalid_json_followup	186	130	93	93	37	0.5	.5,/4,0-0.25,0.1-0.5,0.7-1,1-1.5,1-2,1.2-1.5,1.5-3,1.5-8,2-10,3-4,7-8,acute,along,anther,apex,bark,base,beneath,berry,bud,calyx,campanulate,capitate,closely,cm,constriction,corolla,dark,decurrent,dia,elliptic,erect,evenly,filament,flower,fruiting,furcate,glabrous,globose,green,inflorescence,leaf,lemon-yellow,length,lobed,long-styled,many,margin,minutely,mm,narowly,obovate,occasionally,opposite,ovary,ovoid-reniform,pale,papillose,pedicel,petiole,pitted,plant,puberulent,reddish-brown,ripe,scar,shape,short-styled,shrub,simple,slender,small,spaced,sparsely,stem,stigma,style,surface,tan,tapering,time,tree,trichome,tube,uniseriate,usually,vein,way,white,winged,x	.1,0.5-1,0.8-1,0.8-1.3,1.5-2,2-2.5,2.5-11,2.5-3,3.5-17,5-17,5-25-flowered,7-10,9-35,anthesi,attenuate,blade,deflexed,deltoid,densely,differing,difoliate,distal,dry,eaf,edicel,eed,ellipsoid,equal,even,exserted,free,geminat,glabrate,golden,greyish-brow,individual,later,lateral,like,live,lobe,lon,long,lower,main,major,middle,minor,nflorescence,often,older,one,onto,otherwise,overlappin,pair,papillo,planar,pore,poricidal,portion,prominent,pubescent,quite,raised,rest,rounded,ruit,shaped,size,slightly,sometimes,soon,specimen,straight,tall,tear-drop,thick,third,ti,tip,trunk,tub,ud,unit,variable,weight,widest,within,woody,yellow,ympodial,young	'',5-25,[,``,abaxial,adaxial,arrangement,cell,center,characteristic,colour,diameter,form,fruit,greyish-brown,growth,height,history,life,na,new,number,overlapping,peduncle,perennial,position,rachi,reproduction,seed,spacing,staman,texture,unripe,value,width,{,}
672	wfo-0001030918	invalid_json_followup	230	116	80	150	36	0.348	-3.2,-4.5,-40,0.1-0.25,0.3-1.5,0.5-2,0.5-2.5,0.6-2.5,0.7-1.7,1,1-1.5,1.5-2.5,2-10,2-25,2-7,3-15,3-6.5,3-7,5.5-7,abaxial,adaxial,anther,apart,apex,bark,calyx,cell,chartaceous,cm,curved,diameter,dull,elliptic,erect,filament,flattened-reniform,flower,fruit,fruiting,glabrescent,glabrous,green-brown,lateral,leaf,length,lobed,margin,mauve,mixture,mm,moderately,obtuse,orange,orange-brown,pale,pedicel,peduncle,petiole,porrect,prickle,purple,red,red-brown,scar,seed,sessile,shrub,simple,smooth,spaced,spherical,stalked,stellate-pubescent,stem,straight,style,surface,terminal,trichome,yellow	-12,-2.3,-4,-5,-6,-9,.5,.7,0-10,0-20,0-25,0-4,0-6,0.1,0.2-0.4,0.25-0.45,0.5-0.7,0.6,0.7-1.2,1-1.8,1-2,1-4,1.5-2,1.5-5.5,1/2-2/3,1/2-3/4,1/3,1/3-,1/3-1/2,1/4-1/3,2-2.5,2-3,2-4,2-8,2.8-3,2/,3-4,3.5-6,4-7,5-7,5-8,5-merous,6-8,7-10,abaxially,acicular,acute,alyx,ame,apar,apically,apparently,articulated,base,berry,blade,branched,brow,c.,caudat,connivent,cuneate,dark,deltate,densely,difoliate,discolorous,distance,drying,eaf,elongated,elongating,equal,evenly,extending,faint,flattened,free,geminat,green,infructescence,lobe,lobing,long,longer,lower,mature,maturity,midpoint,midvein,narrow-deltate,nflorescence,oblong,occasionally,older,one,open,orolla,oung,outline,pair,pendulous,per,perfec,pericarp,perpendicular,pit,poricidal,portion,prickl,prickly,primary,pubescent,raised,ray,reduced,reflexed,ruit,scandent,secondary,side,slender,small,sometimes,somewhat,sparsely,spreading,stalk,stellate,strongly,tamen,tapering,terete,tertiary,time,tip,tube,unit,upper,usually,vary,vein,venation,visible,way,weakly,wide,woody,ympodial,young	'',[,``,arrangement,brown,bud,center,characteristic,colour,corolla,form,growth,height,history,inflorescence,life,na,new,number,ovary,perennial,perfect,plant,position,rachi,reproduction,shape,spacing,staman,stigma,texture,unknown,value,width,{,}
673	wfo-0001030919	success	219	122	79	140	43	0.361	12,2,3,5-merous,abaxial,abaxially,acute,adaxial,adaxially,andromonoecious,anther,apart,apex,branched,brown,calyx,chartaceous,cm,densely,diameter,elliptic,entire,extra-axillary,filament,flower,fruit,fruiting,glabrous,glandular,globose,green,hair,interpetalar,leaf,length,like,long,margin,mm,moderate,moderately,multicellular,multiseriate,ovate,pedicel,peduncle,petiole,plant,porrect-stellate,prickle,protrusion,pubescent,rachi,reddish,reniform,roselike,rugose,rusty,scandent,shrub,simple,small,stellate,stellate-pubescent,stem,stigma,style,subopposite,surface,tan,tissue,triangular,twice,unbranched,unicellular,uniseriate,white,whitish,yellow	.2–0.4,.2–0.6,0.1–0.2,0.1–0.3,0.3–0.6,0.5–1,0.5–1.5,0.5–3,1.2–2,1.5,10–13,10–14,10–20,12–16,12–18,1971,1–2,1–3,2.5,25–50,2–3,2–4,2–8,3–4,3–6,3–8,4–7,4–8,5–10,5–7,5–8,7–10,7–11,8–12,absent,accrescent,alyx,anthesi,apparently,armed,articulated,asymmetrical,attenuate,axe,ba,base,berry,beyond,blade,capitat,connected,connivent,cordate,coriaceous,covering,cylindrical,directed,discolorous,distally,eaf,eed,exserted,festooning,flattened,frui,functionally,fused,glabrou,hard,hermaphroditic,horizontal,incompletely,introrsely,lateral,linear-lanceolate,lobe,lobed,longitudinal,lower,male,maturity,midpoint,midrib,midvein,narrowly,nearly,nflorescence,notch,obtuse,occasionally,often,older,opening,orange,orolla,partially,per,perfec,petiolate,pinnate,placenta,plurifoliat,pore,positioning,proximally,ray,recurved,reflexed,roe,ruit,secondary,see,shortly,side,slightly,slit,spaced,sparsely,spine,stalk,stamen,ste,subsessile,swollen,tal,tamen,tapering,tem,terminology,triangular-ovate,tube,unarmed,unit,vary,vein,venation,wide,ympodial,young,×	0.1-0.2,0.5-1.5,0.5-3,1-2,1-3,10-20,12-18,2-4,2-8,3-4,3-6,4-7,7-10,7-11,arrangement,bark,bud,capitate,cell,center,colour,corolla,form,growth,height,history,inflorescence,life,na,new,ovary,perennial,position,reproduction,scar,seed,shape,spacing,staman,texture,trichome,width,x
674	wfo-0001030921	success	185	110	83	102	27	0.449	0,0.4-0.5,1-2,1-3,2-3,2-6,3-3.5,3-4,3-5,4-10,7-8,acuminate,acute,anther,apart,apex,bark,base,berry,brown,calyx,campanulate,cm,corolla,corymbose,cyme,deep,diameter,elliptic,entire,filament,flattened,flower,fruit,fruiting,globose,green,grey,growth,inflorescence,internodal,lanceolate-elliptic,liana,lobed,many,margin,mm,nearly,new,oblong,ovary,ovoid-conical,pedicel,peduncle,petiole,porrect,prickle,pubescent,purple,recurved,reddish,reniform,reticulate-undulate,rugose,scabrous,scar,sessile,stellate,stellate-pubescent,stem,stigma,style,subspherical,subtruncate,surface,terete,tomentose,trichome,velutinous,violet,white,woody,yellowish	.5,1-1.2,1-1.5,1/3,10,2-2.5,3.5-5,4-6,6-7,9-15,abaxially,adaxially,anthesi,antrorse,appressed,armed,articulated,asymmetric,basal,branched,caly,channelled,compressed,congested,coriaceous,curved,deeply,densely,diamete,discolorous,distal,eed,elongating,erec,erect,exceeding,exserted,free,glabrescent,glabrous,half,hermaphroditic,heterostylous,included,like,linear-lanceolate,lobe,long,long-styled,longer,lower,midpoint,minute,multicellular,near,nflorescence,obverse,older,one,partially,perfect,pericarp,plurifoliateleaf,pore,poricidal,porrect-stellate,portion,prickly,puberulent,pubescence,raise,ray,reduced,reflexed,ruit,rusty,short-styled,shorter,shrub,slightly,slit,spaced,sparse,sparsely,staminate,straight,strongly,subequal,tapering,testa,time,tip,triangular,tube,ud,unevenly,unicellular,unit,upper,x,ympodial,young	abaxial,adaxial,arrangement,bud,cell,center,colour,form,height,history,leaf,length,life,na,number,plant,plurifoliate,position,rachi,reproduction,ruggy,seed,shape,spacing,staman,texture,width
675	wfo-0001030941	success	259	128	96	163	32	0.371	-1.5,0.02-0.4,0.04-0.08,0.1-0.3,0.5-1.5,0.8-1.3,1-1.4,1-9,1.4-1.6,2-3.2,2-5,4-6,6-22,7-23,9,abaxially,accrescent,acuminate,adaxially,anther,apart,apex,appressed-tomentose,articulated,bark,base,becoming,brown,bud,calyx,cm,conical,continued,corolla,deltoid,diameter,due,ellipsoid,elliptic,entire,filament,flower,fruit,fruiting,glabrescent,globose,gray,growth,honeycombed,lateral,leaf,length,long,margin,minutely,mm,moderately,mostly,narrowly,nearly,obovate,occasionally,ovoidal,pale,pedicel,peduncle,petiole,porrect-stellate,pubescent,rachi,reticulate-punctate,ripe,scabridulous,scabrous,sessile,short,short-stalked,shrub,simple,small,somewhat,sparingly,stelliform,stem,stigma,style,suborbicular,subreniform,terete,terminal,testa,tree,white,x,yellow,yellowish	-16,-4,-6,.01-0.3,.03-0.25,.04-0.1,.04-0.12,.04-0.22,.04-0.4,.2-0.8,.5-5,/50-1/15,0-100,0.01-0.22,0.02-0.04,0.02-0.06,0.02-0.25,0.02-0.3,0.03-0.05,0.03-0.06,0.03-0.6,0.04-0.1,0.04-0.35,0.04-0.5,0.04-0.6,0.06-0.35,0.06-0.42,0.07-0.4,0.08-0.35,0.08-0.5,0.8-1.1,1.1-1.3,1.1-1.7,1.1-2.8,1.2-2.1,1.2-2.2,1.3-2.5,1.3-4.5,1.4-3.5,1.5-3.5,1.5-4.5,1/3-1/2,10,10-25,2-3.3,3-4.5,3-5,3.5-10,3/4,4-12,4-8,4-9,5-9,5-merou,6-10,6-9,7-10,absen,acute,ag,along,alyx,anthesi,apical-lateral,apparently,axe,axillary,berry,blade,blunt-tipped,branch,branched,campanulate,chartaceous,color,darker,decurrent,dehiscing,dense,densely,directed,eaf,eed,exserted,extend,few-rayed,fleshy,free,glabrous,glandular,hair,high,inserted,introrse,lanceolate,large,less,lobe,lobed,lon,long-attenuate,longer,longitudinal,lower,m.,main,midpoint,midvein,mixed,multangulat,multangulate,multiseriate,nflorescence,oblong,obscured,obtuse,often,older,orolla,ovate,perfect,plurifoliate,pore,porrect-stellat,rarely,rather,ray,ruit,runk,side,slit,sometimes,spaced,sparse,sparsely,stalk,stamen,stipitate-glandular,strongly,subcapitat,subcoriaceous,suture,tamen,thick,thick-stalked,time,tomentose,tomentu,touching,toward,triangular,tube,unarme,unarmed,unit,usually,vary,vein,way,weakly,wide,ympodial,young	0.2-0.8,0.5-5,20-100,5-merous,abaxial,adaxial,arrangement,colour,form,height,history,inflorescence,life,na,new,number,ovary,perennial,plant,position,prickle,reproduction,scar,seed,shape,spacing,staman,subcapitate,surface,texture,trichome,width
676	wfo-0001030943	invalid_json_followup	167	105	69	98	36	0.413	1-1.2,1-1.5,1.8-2.2,10-25,12-15,2-6,4-4.5,4-6,abaxial,acuminate,adaxial,anther,apex,bark,becoming,bi-lobed,black,calyx,cm,conical,corolla,dendritic,densely,diameter,echinoid,elliptic,filament,flattened,flower,fruiting,glabrous,globose,golden,golden-yellow,growth,lateral,leaf,lenticular,lobed,minutely,mm,narrowly,ovary,pale,pedicel,pericarp,petiole,pitted,plurifoliate,pubescent,purplish-black,reddish-brown,scar,scattered,shrub,small,sparsely,stem,stigma,style,surface,tapering,terminal,thin,tree,tree-like,trichome,violet,yellowish-white	.5,0,0.5-1,0.5-3,1.1,1.5-2,1/2,3,3-4,3/4,4-5,7-13.5,7-8,8-10,abaxially,absent,acute,adaxially,age,along,anthesi,apical,basal,base,belo,berry,branch,branching,cupulate,dark,decurrent,deflexed,denser,drying,eaf,edicel,eed,elongate,erect,ew,exserted,fide,free,glabrat,horizontal,im,inserted,large,lobe,lon,long,lower,m.,main,minute,monochasia,nflorescence,nodding,often,older,outline,overtopping,pair,papillo,pearce,per,planar,pore,poricidal,portion,raised,ruit,secondary,shoot,showy,sleeve,slightly,slit-like,somewhat,stamen,strongly,tall,time,tip,triangular,tub,tube,ud,unit,upper,vein,way,wide,woody,x,yellow,ympodial,young	'',[,``,arrangement,bud,center,characteristic,colour,form,fruit,glabrate,height,history,inflorescence,length,life,margin,na,new,number,papillose,peduncle,plant,position,prickle,rachi,reproduction,seed,shape,spacing,staman,texture,value,width,{,}
677	wfo-0001030959	success	164	87	55	109	32	0.335	.05,.2,.8,0.5-1.5,0.7-1.2,1-10,1.2-1.8,10-15,4-6,5-6,5-9,almost,anther,apex,bark,brown,brown-green,cm,diameter,elliptic,erect,filament,flower,glabrous,inflorescence,lateral,leaf,length,long-acuminate,margin,membranous,mm,part,pedicel,peduncle,petiole,porrect,present,prickle,scar,sessile,shrub,simple,sparsely,stellate,stellate-pubescent,stem,straight,straw,style,subentire,surface,trichome,yellow,youngest	/5,0.5,1-2,1-7,1.5-2,1.5-3.5,1/5-1/10,2-4,2.5-4,2.5-4.5,2.5-5,4-8,5-merous,6-8,9-12,abaxially,alyx,ame,apar,apart,apically,apparently,armed,articulated,base,blade,branched,c.,color,concolorous,connivent,cuneate,curved,deltate,densely,difoliate,distributed,drying,eaf,eed,equal,evenly,free,fresh,geminat,gently,glabrescent,glabrou,glandular,green-brow,hair,know,known,less,like,lobe,lobed,long,long-acuminat,longer,lower,midpoint,minute,narrow-deltate,nflorescence,numerous,older,one,open,orolla,oung,pair,perfec,perpendicular,poricidal,portion,prickl,prickly,primary,prominent,ray,ruit,scrambling,secondary,several,short,side,slender,spaced,spreading,tamen,tapering,terete,tertiary,time,tip,toward,tube,unarmed,unit,usually,vary,vein,venation,visible,way,whole,wide,ympodial	abaxial,adaxial,arrangement,bud,calyx,colour,corolla,form,fruit,fruiting,green-brown,growth,height,history,life,na,new,number,ovary,perennial,plant,position,rachi,reproduction,seed,shape,spacing,staman,stigma,texture,unknown,width
678	wfo-0001030982	success	215	95	70	145	25	0.326	0.05-0.5,0.1,0.2-3,0.5,0.5-0.9,0.5-1,1.5,1.5-2,3-8,4-5,6-8,anther,apex,bud,calyx,capitate,closely,cm,conical,corolla,dark,diameter,elliptic,entire,filament,flattened-reniform,fleshy,flower,form,fruit,fruiting,glabrous,globose,green,growth,leaf,lobed,margin,minutely,mm,new,opposite,ovary,ovate,packed,pale,pedicel,peduncle,petiole,pitted,plant,pubescent,rhizomatous,scar,seed,separated,simple,sinuate,slightly,somewhat,sparsely,stem,stigma,style,subshrub,surface,trichome,uniseriate,white,yellowish	-2-2.5,.1,.2,.5,0.05,0.1-0.15,0.3-2,0.5-3,1,1-1.5,1-8,1.5-3,2/3,3-21,4-12,abaxially,acuminate,acute,adaxially,age,angular,anisophyllous,anthesi,ape,appressed,ba,base,beneath,berry,broadly,brown,brownish,caducous,central,channelled,chartaceous,ciliate,conic,cream,cucullate,cuneate,curved,deflexed,deltate,differing,difoliate,distall,distally,distichou,dry,drying,eaf,edicel,eed,ellipsoid,enlarged,exerted,extension,external,foliage,free,fresh,geminate,glabrescent,glandular,glandular-papillose,golden-green,greenish,hilum,impressed,inconspicuously,internal,isostylous,larger,later,lengthening,less,like,live,lobe,long,lower,major,materia,material,maturity,midvein,minor,mostly,near,nflorescence,oblique,obovate,occasionally,often,olive,one,overlappin,pair,papillae,papillat,papillate,papillose,planar,pore,poricidal,portion,primary,projection,prominent,prominently,puberulent,reddish,reflexed,rest,revolute,ruit,sagittate,shoot,sigmoidally,situated,size,slit,stamen,straight,stripe,strongly,testa,tetramerous,tightly,time,tip,transverse,tub,tube,ud,unit,vegetative,vein,veined,way,weakly,x,ympodial,young	abaxial,adaxial,arrangement,bark,cell,center,colour,distichous,height,history,inflorescence,length,life,na,number,overlapping,position,prickle,rachi,reproduction,shape,spacing,staman,texture,width
679	wfo-0001030989	invalid_json_followup	177	103	62	115	41	0.35	0.5-1,1-1.5,1-10,12-15,3-20,3-4,3-7.5,6-6.5,9-10,abaxially,adaxially,anther,apex,articulated,berry,bud,cell,chartaceous,ciliate,cm,conical,corolla,covering,densely,diameter,filament,flower,forked,fruit,glabrous,green,greenish,hair-like,herb,lateral,leaf,light,long,margin,mm,obtuse,odd-pinnate,ovate-lanceolate,ovoid,pedicel,peduncle,petiole,plant,pubescent,rotate,seed,sparsely,stem,stigma,style,terminal,testal,thick,violet,wall,whitish,yellow	.5,1-2,15-27.5,2-3.5,3-5.5,4-5,4-7,4-8,5,5-merou,5.5-7.9,6-13,acuminate,ag,alyx,apart,apparently,axe,axillary,base,blade,brownish,capitat,condition,connivent,decreasing,digestion,distal,dorsally,drying,eaf,edge,eed,end,enzyme,erec,especially,flat,folded,fresh,geminat,generally,glabrou,gradually,green-white,hair,half,homostylous,honeycomb-shaped,interjected,lanceolate,larger,leaflet,lengthening,like,living,lobe,lower,make,minute,mucilaginous,nflorescence,occurring,orbicular,orolla,ovate,pair,pale,perfect,petiolule,plurifoliate,pore,poricidal,present,proximal,pubescen,ray,removed,ripe,ruit,secondary,semierect,seudostipule,singly,size,slit,spaced,specimen,ste,stolo,subequal,subsessile,subtending,symmetrical,tall,tamen,tem,thir,throughout,tip,toward,tri-,triangular,tube,tuber,typically,unit,unwinged,usually,vary,wet,wide,wider,x,ympodial	'',3,[,``,abaxial,adaxial,arrangement,bark,calyx,capitate,center,characteristic,colour,form,fruiting,growth,height,history,inflorescence,length,life,na,new,number,ovary,perennial,position,prickle,rachi,reproduction,scar,shape,spacing,staman,surface,texture,trichome,value,width,{,}
680	wfo-0001030991	invalid_json_followup	204	141	105	99	36	0.515	.5,0.5,0.5-1.5,0.7-1.2,1-1.5,1-1.6,1-2.2,1-2.5,3-,3-5-lobed,4-10,5-5.5,9-11,abaxially,absent,acuminate,acute,angled,anther,apex,apparently,appressed,ascending,base,berry,brown,calyx,capitate,cm,color,conical,corolla,densely,diameter,different,ellipsoid,elliptic,elongate,entire,eye,filament,filiform,flattened,flower,fruiting,furcate,fusiform,glabrous,globose,grey,growth,herb,inflorescence,lanceolate,lateral,leaf,leaf-opposed,lobed,margin,minutely,mm,narrowly,nearly,new,occasionally,often,packed,pedicel,peduncle,petiole,pinnatifid,pitted,pubescent,red,reniform,ripe,scar,scattered,shiny,short,shrub,simple,slightly,small,sparsely,stellate,stem,stigma,strongly,style,suffrutescent,surface,terminal,thin,tightly,tip,trichome,uniformly,uniseriate,variably,violet,white,x,yellowish,young	0,0.1,0.2,0.2-0.7,0.3-0.4,0.5-0.7,0.5-1,0.5-3.5,0.6-0.8,1-7,1.5,10-20,2-plurifoliat,2.5-10,2.5-3,2/3,5-merou,<,adaxiall,adaxially,ag,along,alyx,anthesi,arising,ark,articulated,attenuate,basal,bulbous,cell,connivent,distally,drying,eaf,eed,ellipsoidal,enlarged,exerted,free,frui,glabrescen,ilament,incised,leave,lengthening,less,like,lobe,long-triangular,loosely,lower,midrib,minute,nflorescence,nodding,older,orolla,outline,pair,papillo,part,particularly,pendant,per,perfect,pericarp,platfor,pointing,pore,poricidal,portion,primary,pseudoumbel,rectangular,reflexed,rest,rootstoc,ruit,shallowly,sleeve,slit,somewhat,spreading,tangled,tem,testal,tube,twinin,ud,unit,upper,vary,vein,weak,weight,winged,woody,ympodial	'',5-merous,[,``,abaxial,adaxial,arrangement,bark,bud,characteristic,colour,form,fruit,glabrescent,height,history,length,life,na,number,ovary,perennial,plant,position,prickle,rachi,reproduction,seed,shape,spacing,staman,texture,value,width,{,}
681	wfo-0001031005	invalid_json_followup	231	153	121	110	32	0.524	.5,/3-1/2,0-0.5,0.1,1-1.5,1-2,1-2.5,1-3,2-3.2,2.5,3-10,3-6.5,5-7,abaxial,abaxially,acuminate,acute,adaxially,almost,along,anther,anthesi,apex,apically,bark,base,berry,black,blue,brachyblast,branch,brown,calyx,capitate,chartaceous,clustered,cm,concolorous,conical,corolla,cupular,dark,dendritic,dendritic-pubescent,diameter,dilated,discolorous,drying,elliptic,elongated,evenly,eye,filament,fine,flat,flattened,flexuous,flower,form,fruit,fruiting,glabrous,greenish,lateral,leaf,length,liana,like,lobed,longitudinally,margin,membranous,midvein,mm,naked,network,obovate,occasional,occasionally,older,orange-brown,outside,ovoid,pair,pedicel,peduncle,petiole,primary,prominent,pubescent,purple,rachi,raised,ridged,scar,seed,short,side,slender,sometimes,somewhat,stem,stigma,stump,style,surface,terete,terminal,tertiary,thick-chartaceous,tip,toward,trichome,usually,vein,venation,visible,weakly,white,wide,x	.4,0.3-0.5,0.5-1.5,0.8,0.9,1,1.5-2.5,1.5-4,10,2.3-3,2.5-4,3-4,4-6,5,5-8,5°,6-12,accrescent,age,alyx,apar,apparently,articulated,attenuate,branched,branching,clearly,clum,common,curved,datum,deeply,delineated,deltoid,denser,density,detaching,developing,divided,domatia,eaf,ellipsoi,entire,equal,extending,fertilisation,forming,free,immature,increasing,inside,junction,known,leave,lengthening,linear,lobe,long,loop,lower,m.,main,minute,much,nflorescence,nther,oblong,obscure,often,onl,orolla,ou,ovate,pendulous,perfec,pericarp,plurifoliat,pointed,pore,poricidal,portion,protruding,ray,region,rest,ruit,secondary,simple,smaller,smoot,smooth,soon,sparsely,spread,spreading,standing,strongly,surrounding,tangling,tearing,thin,tube,ud,unarmed,uneven,unit,vary,well-developed,ympodial,young	'',[,``,adaxial,arrangement,bud,characteristic,colour,ellipsoid,growth,height,history,inflorescence,life,na,new,number,ovary,perennial,perfect,plant,position,prickle,reproduction,shape,spacing,staman,texture,value,width,{,}
682	wfo-0001031007	invalid_json_followup	207	137	98	109	39	0.473	0.5-10,0.75-1.5,1,1-1.5,1-3.5,1.2-1.5,1.5-2,1.9-3,15,4.5-5,5,50-100,6,7-10,acute,alfway,along,anther,apex,base,becoming,berry,bifid,black,branched,brown,c.,calyx,capitate,chartaceous,clustered,cm,corolla,dendritic,densely,diameter,ellipsoid,elliptic,entire,extending,filament,flattened-reniform,flower,fruit,fruiting,glabrous,globose,growth,inflorescence,irregularly,lamina,lax,lilac,lobed,long,loose,many,margin,minutely,mm,narrowly,new,occasionally,often,outline,papillate,pedicel,peduncle,perfect,petiole,pitted,pubescent,reddish,revolute,scar,shrub,simple,slender,spaced,sparsely,stellate,stellate-pentagonal,stem,stigma,style,surface,tangled,terminal,thin,time,tip,trichome,usually,vein,vine,woody,x,yellow	.5,0.2,0.5,0.5-1,1-1.2,1.3-,1.6-2,1/3,11-14,2.5-,2.5-5,3-4,4-6,4-7,5-12,5-merou,5.5-6,8-10,<,abaxiall,abruptly,ag,almost,alyx,anthesi,apar,apparently,ark,articulated,beginning,branching,broad,broadly,campanulate,cell,completely,connivent,cuneate,cup-shaped,dark,deltate,dilated,drying,dull,eaf,eed,exserted,fleshy,free,geminat,glabrescen,glabrou,herbarium,ilament,impressed,intramarginal,junction,leaving,lengthening,lobe,looping,loosely,lower,m.,markedly,matte,midvein,multi-celled,narrowing,near,nflorescence,nodding,older,orolla,pale,papillat,peg,per,pericarp,planar,plurifoliate,pore,poricidal,portion,primary,prominent,rat,round-rectangular,ruit,sagittate,shiny,sleeve,slightly,slit,specimen,splitting,spreading,stout,strongly,testal,tiny,tube,twining,ud,unit,upper,vary,way,ympodial	'',5-merous,[,``,abaxial,adaxial,apart,arrangement,bark,bud,characteristic,colour,form,glabrescent,green,height,history,leaf,length,life,na,number,ovary,paler,perennial,plant,position,prickle,rachi,reproduction,seed,shape,spacing,staman,texture,value,width,{,}
683	wfo-0001031007	invalid_json_followup	206	129	93	113	36	0.451	0.5-10,0.75-1.5,1,1-1.5,1-3.5,1.2-1.5,1.9-3,15,4.5-5,5,50-100,6,7-10,acute,adaxial,along,anther,apex,bark,becoming,berry,bifid,black,branched,broad,brown,calyx,capitate,clustered,cm,corolla,dendritic,densely,diameter,dull,ellipsoid,elliptic,entire,extending,filament,flattened,flower,fruit,fruiting,glabrous,globose,growth,inflorescence,irregularly,lamina,lax,lilac,long,loose,many,margin,matte,minutely,mm,narrowly,new,occasionally,often,papillate,pedicel,peduncle,petiole,pitted,pubescent,reddish,reniform,scar,shrub,simple,slender,spaced,sparsely,stellate,stellate-rotate,stem,stigma,style,surface,tall,tangled,terminal,thin,time,tip,trichome,vein,vine,woody	.5,0.2,0.5,0.5-1,1-1.2,1.3-,1.5-2,1.6-2,1/3,11-14,2.5-,2.5-5,3-4,4-6,4-7,5-12,5-merou,5.5-6,8-10,<,abaxially,abruptly,ag,alfway,almost,alyx,anthesi,apar,apparently,articulated,base,beginning,branching,broadly,c.,campanulate,cell,chartaceous,completely,cuneate,cup-shaped,dark,deltate,dilated,drying,eaf,eed,exserted,fleshy,free,glabrescen,glabrou,herbarium,ilament,impressed,intramarginal,junction,leaving,lengthening,lobe,lobed,looping,lower,m.,markedly,midvein,multi-celled,narrowing,near,nflorescence,nodding,older,orolla,outline,pale,papillat,peg,per,perfect,pericarp,planar,plurifoliat,pore,poricidal,portion,primary,prominent,rat,revolute,round-rectangular,ruit,sagittate,shiny,sleeve,slightly,slit,specimen,splitting,spreading,stout,strongly,testal,tiny,tube,twinin,ud,unit,upper,usually,vary,way,wide,ympodial	'',5-merous,[,``,abaxial,apart,arrangement,bud,characteristic,colour,form,glabrescent,height,history,leaf,length,life,na,number,ovary,paler,perennial,plant,position,prickle,rachi,reproduction,seed,shape,spacing,staman,texture,value,width,{,}
684	wfo-0001031022	success	287	110	88	199	22	0.307	0.5–1.5,0.5–5.8,0.6–1.6,0.8–3.4,0.9–1.9,1.1–8.3,1.2–2.3,1.2–2.6,1.9–2.8,10,12.9,14.9,17–145,2.3–3.1,8.8,abaxially,acuminate,acute,adaxially,along,anther,apart,apex,area,base,becoming,bent,black,calyx,capitate,central,chartaceous,cm,corolla,cream,densely,diameter,dry,evenly,extra-axillary,filament,flattened-reniform,flower,forking,fruit,glabrous,globose,green,heterostylous,lanceolate,lateral,leaf,length,less,long,margin,mature,mm,moderately,ovate,pedicel,peduncle,petiole,pubescent,purple,reticulate,short,shrub,simple,small,smooth,spaced,sparsely,stellate,stigma,straight,style,surface,time,toward,tree,unbranched,vein,well,white,yellow,yellow-tan,±90°	.04,0.1,0.2–0.3,0.2–0.9,0.3–0.6,0.3–0.8,0.4–0.5,0.4–1.2,0.4–1.3,0.5–1.4,0.5–2.2,0.6–1.0,0.6–1.2,0.6–2.4,0.6–2.6,0.7,0.7–1.7,0.8–1.2,0.8–1.3,0.8–2.9,1.0–2.6,1.0–4.5,1.1–3.4,1.4–4.0,1.5–2.5,1.6–4.8,1.8–12.1,1/3,1/4,1/4–1/3,10.5,2.8–6.3,2/3,3.2–4.9,3.2–7.0,3.8,3.9–6.5,4.5–21.9,4–6-merou,4–9,5.1–8.7,5.8–11.4,5–7,5–8,6.9,6–10,8.2,8.9,90°,absent,adnate,aequilateral,alyx,anthesi,apical,apiculate,apparently,appearing,appressed,arching,arcuate,around,articulate,attenuate,axe,ba,bark,basal,berry,blade,branch,broad,brochidodromous,brown,bud,bulge,caudate,channeled,clinate,crea,cuneate,deciduous,dentate,development,difoliate,directed,directly,distal,distally,distinct,eaf,edge,eed,either,emerging,endocarp,entire,erect,exocarp,extending,ferruginous,fertile,filiform,free,geminat,glandular,glossy,gradually,hair,immature,increasing,intac,internode,interpetalar,intersepalar,juic,large,layer,lobe,lobed,lon,longer,lower,major,many,markedly,midpoint,midrib,midvein,minor,minute,nearly,nflorescence,oblique,opaque,opposed,orolla,oval,ove,per,perforated,poorly,pore,porrect,portion,potentially,raised,ray,reddish,reflexe,remaining,ridge,rigid,rounded,row,ruit,semicraspedodromous,sessile,several,shorter,side,sinus,sloughing,sometimes,splitting,spread,spreading,stellae,stellate-pubescent,stem,stipe,stipitate,suture,tamen,tardily,tem,terete,thin,tip,tissue,transparent,truncate,tube,two,ud,unarmed,unit,upper,various,vary,weakly,well-developed,wide,yellow-ferruginous,ympodial,young,±equal,±glabrous,×	4–6-merous,abaxial,adaxial,arrangement,colour,form,growth,height,inflorescence,na,number,ovary,plant,position,rachi,reproduction,seed,shape,spacing,staman,texture,width
685	wfo-0001031036	invalid_json_followup	150	105	63	87	42	0.42	.2,.5,0.8-1,0.8-1.2,1-2.5,1.2-1.5,1.5-3,2-2.5,5-6,acute,anther,anthesi,apex,axil,bi-lobed,broadly,brown,calyx,closely,cm,conical,corolla,crisped,dark,dry,ellipsoid,elliptic,filament,filiform,flattened-reniform,fruiting,glabrous,globose,green,greenish-white,leaf,lobed,margin,material,minutely,mm,opposite,ovary,pedicel,petiole,pitted,planar,scar,shiny,shrub,simple,slightly,spaced,stem,stigma,style,surface,trichome,uniseriate,vein,white,winged,x	.25,0.5-1,1-1.3,10-20-flowered,12-15,2.2-3.7,3-4,3-5,3.5-5.5,4.5-6.5,7-8,abaxially,acuminate,adaxially,along,angle,arising,ba,base,becoming,berry,decurrent,deflexed,dia,differing,difoliate,drying,eaf,edicel,eed,enlarged,erect,exserted,fleshy,free,fresh,geminat,knob-like,lamina,lateral,lobe,lon,long,lower,main,major,middle,minor,nearly,nflorescence,oblique,older,onto,overlappin,pair,papillo,papillose,perhaps,pointed,pore,poricidal,portion,rounded,ruit,sagittate,shaped,short,sinus,size,soon,spathulate,strongly,tall,tapering,tear-drop,thickened,tip,tub,tube,ud,unit,usually,widest,woody,yellowish,ympodial,young	'',10-20,[,``,abaxial,adaxial,arrangement,bark,bud,cell,center,characteristic,colour,diameter,flower,form,fruit,growth,height,history,inflorescence,length,life,na,new,number,peduncle,perennial,plant,position,prickle,rachi,reproduction,seed,shape,spacing,staman,texture,value,width,{,}
686	wfo-0001031040	invalid_json_followup	217	128	74	143	54	0.341	.5,2,3,6,abaxially,acuminate,adaxially,anther,apart,apex,broad-based,broadly,calyx,cm,densely,diameter,dull,entire,filament,finely,flattened-reniform,flower,fruit,glabrous,globose,green,inflorescence,lanceolate,lateral,lavender,leaf,lighter,longer,margin,minutely,mm,narrowly,ovate,ovoid,pale,pedicel,peduncle,petiole,pitted,plant,prickle,purple,rarely,recurved,scabrous,sessile,sessile-stellate,shape,shrub,simple,slightly,small,somewhat,sparsely,stellate,stellate-pubescent,stem,stigma,straight,style,surface,tree,triangular,triangular-attenuate,violet,white,yellow,yellow-brown,yellowish-tawny	0.1–0.3,0.2–0.6,0.3–3,0.8–7.5,1.2–1.3,1.2–2.1,1.4–2.7,1.5–4,1.5–5,1.7,1.7–3.1,10,10–10.5,10–13,12–14,15–23,1–1.4,2.2–2.5,2.4–3,2.5–4,2.5–9,2–10,2–5-branched,3.5–5,3–26,3–4.5,3–5,4–6,5,5-merou,6.5–25,6–6.5,6–8,7–9,8–30,accrescent,acute,adaxiall,age,also,alyx,anthesi,apical,apparently,articulated,attenuate,axe,ba,base,becoming,berry,blade,branch,capitat,contrasting,dark,deeply,depending,difoliate,directed,distall,eaf,eed,either,especially,filiform,flowering,free,geminat,glabrescent,glabrou,gland-tipped,glandular,hair,highly,homostylous,immature,internode,interpetalar,larger,like,lobe,lobed,lon,long,lower,major,midpoint,midvein,midzone,minute,much,nflorescence,numerous,older,orolla,outside,perfect,persistent,pinnatifid,pore,porrect,principal,probably,ray,rounded,ruit,scarcely,several-celled,short,side,similar,size,sometimes,soon,spaced,sparse,splitting,sprout,stellae,subcordate,subcoriaceous,tamen,tem,thickened,time,tissue,tube,turning,ud,unarmed,unit,upward,usually,variable,vary,vein,vigor,vigorous,wide,ympodial,×,–6	'',0.1-0.3,0.3-3,0.8-7.5,1.2-1.3,1.5-4,10-10.5,12-14,15-23,2-10,2-5-branched,2.2-2.5,2.4-3,3-5,5-merous,7-9,8-30,[,``,abaxial,adaxial,arrangement,bark,bud,capitate,center,characteristic,colour,corolla,form,fruiting,growth,height,history,length,life,na,new,number,ovary,position,rachi,reproduction,scar,seed,spacing,staman,texture,trichome,value,width,x,{,}
687	wfo-0001031062	invalid_json_followup	216	123	75	141	48	0.347	-5.5,0.5,1,2,2-3.5,20,3-8,?,acute,anther,apart,apex,articulated,base,bud,calyx,campanulate,chartaceous,cm,densely,diameter,entire,extra-axillary,ferruginous-tomentose,filament,flattened-reniform,flower,forked,foveolate,fruit,fruiting,fully,glabrous,globose,green,hair,leaf,least,lobe,long,margin,minutely,mm,ovate-lanceolate,pedicel,pentagonal,per,perhaps,petiole,plant,prickle,rachi,ripe,rotate-stellate,sessile,shallow,shape,shub,side,simple,small,sometimes,stellate,stellate-tomentose,stem,stigma,stipitate,style,surface,treelet,unbranched,white,wide,x,yellow	.5,0,0.3,0.5–0.6,0.7–0.8,1.2–1.4,1/3,13–15,15,16,17,1–2.5,1–4,2.5,22,2–3,2–5.5,3,3–10,4,4–10,4–4.5,5,5–7-rayed,7,7–15,7–8-rayed,9–11,abaxially,absent,accrescent,adaxiall,adaxially,ag,ample,apiculate,appearing,armed,axe,ba,blade,bottom,branch,brownish,capitat,clustered,colored,connivent,count,cuneate,curved,cylindrical,diamete,difoliate,directed,distally,eaf,eed,even,eventually,except,fertile,fragrance,geminat,glabrou,grading,heavily,ilament,interpetalar,juvenile,larger,lateral,less,lighter,lobed,longitudinal,loosely,lower,m.,main,midpoint,midrib,much,nearly,nflorescence,numerous,obscuring,obsolete,often,one,opening,orolla,overtopped,part,partially,perfect,pore,pubescent,rarely,recurved,rest,ruit,scabrous,short,short-stalked,size,slightly,slit,spaced,sparsely,sprout,stellae,straight,sweet,tall,tapered,tem,terminal,thick,thick-based,tip,tissue,tomentose,toward,triangular,truncate,tube,unarme,unarmed,unifoliate,uniform,unit,uppermost,usually,vary,vigorous,visible,ympodial,young,younger,–3	'',0.7-0.8,1-2.5,1-4,13-15,2-3,2-5.5,3-10,4-4.5,7-8-rayed,9-11,[,``,abaxial,adaxial,arrangement,bark,capitate,cell,center,characteristic,colour,corolla,form,growth,height,history,inflorescence,length,life,na,new,number,ovary,peduncle,perennial,position,reproduction,scar,seed,spacing,staman,texture,trichome,value,width,{,}
688	wfo-0001031064	invalid_json_followup	179	103	65	114	38	0.363	0.5,0.5-0.7,1-2,1-3,1.2,10-12,2.5-3,3.5-4,5-6,acuminate,along,anther,apex,bright,calyx,cell,cm,conical,corolla,densely,diameter,elongate,filament,fleshy,flower,fruit,fruiting,glabrous,globose,green,inflorescence,leaf,lightly,lobed,margin,minutely,mm,nodding,obovate,ovary,ovate,ovoid-reniform,papillate,pedicel,petiole,pinnate,pubescent,purple,rachi,rugose,scar,shrub,simple,slender,somewhat,sparsely,stem,stigma,style,surface,translucent,trichome,uniseriate,vein,white	.0-2.5,.05,.5,.5-1,0,0-15,0.5-0.8,1,1-1.2,1.5-2,1.7-4.2,10-12.5,10-17,2,3,3-5.5,3-7,4-5-celled,5-10.5,6-16,7-16,8-10-celled,abaxially,acroscopic,adaxially,anthesi,anticlinal,arising,attenuate,axil,basal,base,bearing,berry,blade,broader,clavat,commentary,completely,conspicuous,dark,deltate,denser,distal,dr.,eaf,edicel,eed,epidermal,erec,exserted,free,half,highly,irregular,irregularly,lamina,lateral,leaflet,leave,lenticel,like,lobe,lon,long,lost,lower,minute,narrower,near,nearly,nflorescence,node,occasionally,often,open,pair,per,petiolule,planar,poricidal,portion,projection,prominent,pubescen,ruit,scattered,see,short-pubescent,side,single,sinuous,sinus,smaller,splitting,strongly,swollen,tal,tem,terminal,thickening,time,tip,tub,tube,ud,unifoliat,unit,usually,wand-like,winged,without,x,ympodial	'',0.5-1,[,``,abaxial,adaxial,arrangement,axillary,bark,bud,center,characteristic,clavate,colour,form,growth,height,history,length,life,na,new,number,peduncle,perennial,plant,position,prickle,reproduction,seed,shape,spacing,staman,texture,value,width,{,}
689	wfo-0001031065	success	140	103	72	68	31	0.514	.2,.3,.6,1-,1-celled,acicular,aculeate,acuminate,acute,almost,also,anther,apex,apparently,celled,chestnut,cm,concolorous,corolla,dense,difoliate,eglandular,externally,extra-axillary,ferruginous,filament,flower,fruit,geminate,glabrous,glandular,green,green-striate,herb,indumentum,light,lilac,margin,mm,non-glandular,nonglandular,ovary,ovate-lanceolate,ovoid,pale,pedicel,peduncle,perhaps,petiole,porrect-stellate,rarely,rough,scabrid,sessile,short-pedunculate,simple,solitary,sometimes,sparse,spheroid,spine,stellate,stem,stigma,style,subshrub,surface,terete,trichome,umbelliform,unit,white	.1–0.3,.4,.5–2,0.2–1.1,0.5–1.6,0.5–5,0–30,1,1.8–7.8,2,4,4-merous,5-merous,accrescent,alyx,apical,armed,asymmetrical,attenuate,base,berry,beyond,calyx,cell,central,color,composed,deltate,dia,eaf,eed,either,entire,erect,frui,held,lamina,lateral,lobe,lobed,lower,many,many-celled,midpoint,midvein,multi-celled,narrowly,nflorescence,occasionally,orolla,per,perfec,persistent,portion,puberulous,radial,rare,rounded,ruit,shor,short,slightly,tall,unifoliat,upper,usually,x,ympodial	.1-0.3,0-30,0.2-1.1,0.5-1.6,abaxial,adaxial,arrangement,colour,diameter,form,growth,height,history,inflorescence,leaf,length,life,na,number,plant,position,rachi,reproduction,seed,shape,spacing,staman,sympodial,texture,unifoliate,width
690	wfo-0001031071	success	186	101	75	111	26	0.403	0.2-0.8,1-2,1.5-2.2,2.1-3,2.4-3.4,3-10,3-5,3.8-5.4,4-25,4-6,5.7-8.8,6-8,8-28,abaxially,acute,adaxially,anther,apex,blue,brownish,cell,clavate,cm,color,condition,coriaceous,corolla,covering,dark,deep,diameter,drying,elliptic,filament,flower,forked,fresh,fruit,glabrous,globose,green,greenish,hair-like,herb,lateral,leaf,leaflet,lilac,medium,mm,moniliform,odd-pinnate,ovate,ovoid,pedicel,peduncle,pentagonal,petiole,plant,purple,rotate,round,seed,spot,star,stigma,style,terminal,testal,thick,tuber,wall,white,whitish,yellow	0-10,0.4-2,1-1.5,1-3,1-7,2-3,2-5,2-8,3-6,5-9.4,5-merou,7-16.5,7-8,abaxiall,acumen,ag,along,alyx,apart,apparently,arranged,articulated,asymmetric,attenuate,axe,axillary,base,basiscopic,bead,berry,blade,bud,capitat,connivent,decreasing,digestion,distal,dorsally,eaf,edge,eed,enzyme,erec,exceeding,flat,folded,geminat,generally,glabrou,green-white,half,homostylous,honeycomb-shaped,interjected,lanceolate,lengthening,like,living,lobe,long,lower,make,middl,mottled,mucilaginous,multiple,narrowly,necklace,nflorescence,orbicular,orolla,pair,perfect,petiolulate,plurifoliate,pore,poricidal,removed,ripe,ruit,sessile,seudostipule,short,side,size,slightly,slit,spaced,specimen,stamen,stolon,straight,subequal,subtending,tall,tamen,tem,throughout,tip,tissue,toward,tri-,tube,typically,unit,usually,vary,wet,winged,x,ympodial	abaxial,adaxial,arrangement,capitate,colour,form,growth,height,history,inflorescence,length,life,na,number,ovary,perennial,position,pseudostipule,rachi,reproduction,shape,spacing,staman,surface,texture,width
691	wfo-0001031097	success	174	124	97	77	27	0.557	0.45,1-4,1-4.5,1.5,1.6-5.5,13-30,2-3.3,3.7-8.4,4-6,4-7,5-11,8-11,abaxial,abaxially,acuminate,acute,adaxially,along,apex,articulate,base,branched,cell,cm,corolla,covering,cuneate,cyme,darker,deep,diameter,dichasial,dichasially,diminishing,distal,dotted,ebracteate,edge,elliptical,filament,flower,green,green-white,hair-like,half,herbaceous,lateral,leaf,leaflet,light,lighter,make,margin,medium,mm,monochasial,mottled,mucilaginous,narrow,oblique,obovate,odd-pinnate,ovate,ovoid,pedicel,peduncle,pentagonal,perennial,petiole,petiolule,plant,proximal,puberulent,pubescent,purple,rachi,rapidly,rotate,seed,side,size,stigma,strigose,style,terminal,testal,thick,throughout,toward,tuber-bearing,vbase,violet,violet-blue,wall,wide,yellow,¼	0.5,1,1-3,1.8-2.5,1.8-2.6,2-3,2-4,3-5,3-6-foliat,3.5-6,5-12,5-9,9-21,acumen,apical,apically,calyx,connate,decurrent,dehiscent,digestion,dorsally,eaf,eed,emoval,enzyme,exceeding,flat,folded,forked,frequently,generally,globo,gree,highly,honeycomb,interjected,interpetalar,introrse,living,lobe,lon,long,lower,lunat,maturing,nflorescence,noticeably,nther,often,orolla,pair,pattern,perfect,petal,petiolulate,plan,poricidally,rarely,reveal,ruit,sessile,seudostipule,short,slit,sometimes,specimen,stamen,straight,tal,tem,tissu,typically,unit,vary,without,ympodial	adaxial,anther,arrangement,colour,form,fruit,globose,growth,height,history,inflorescence,length,life,lunate,na,number,ovary,position,pseudostipule,reproduction,shape,spacing,staman,surface,texture,wet,width
692	wfo-0001031101	success	197	123	93	104	30	0.472	-5,/2,0.1-0.2,0.5-0.8,0.5-3,0.8-,1-2,1-2.3,1-3,1.3-2,1.4-1.7,1/4-1/2,10-30,2-6,3-15,3.5-4.5,4-5-merous,4.5-9,abaxial,abaxially,acuminate,adaxial,almost,anther,apex,apical,articulated,bark,base,berry,bright,calyx,cm,diameter,dull,elongating,entire,erect,filament,filiform,flattened-reniform,flower,fruiting,glabrescent,glabrous,glandular,green-brown,hair,lateral,leaf,length,lobed,long,long-acute,margin,maturity,mauve,membranous,minute,mm,moderately,multangulate,orange-brown,orange-red,ovate,pale,pedicel,peduncle,petiole,porrect,red,scandent,scar,sessile,shrub,simple,sparsely,spherical,stalked,stellate,stellate-pubescent,stem,straight,style,surface,terete,terminal,trichome,umbel,way,white,yellow,yellow-green	-1,-16,-20,-30,-8,/2-equal,0.05-0.2,0.1-0.3,0.3-0.5,0.6-0.8,0.7-0.8,1-,1.3-2.5,1.5-3,1/3-1/2,2-2.8,2-4,2-5,2.5-,2.5-3.5,2.5-3.8,3-10,3-8,4-10,4-7,5-20,5-6,6-10,8-15,alyx,ame,apar,apically,apparently,ba,blade,branched,c.,concolorous,connivent,deltate,difoliate,drying,eaf,eed,equal,evenly,free,frui,geminat,green,herbaceous,infructescence,lobe,long-acuminat,longer,lower,mature,midpoint,narrow-deltate,near,nflorescence,obtuse,often,older,one,open,orolla,oung,pair,pendulous,per,perfec,pericarp,poricidal,portion,primary,ray,red-brow,resembling,rounded,ruit,smooth,spaced,spreading,stalk,stellate-pubescen,tamen,tapering,tertiary,time,tip,tube,unarme,unarmed,unit,variously,vary,vein,venation,visible,wide,ympodial,young	apart,arrangement,bud,cell,center,colour,corolla,form,fruit,growth,height,history,inflorescence,life,na,new,number,ovary,plant,position,rachi,red-brown,reproduction,seed,shape,spacing,staman,stigma,texture,width
693	wfo-0001031114	invalid_json_followup	208	122	81	127	41	0.389	.2,0.5,0.5-1,0.8-1.2,1-10,1-7,1-8,1.5-4,2-3,25-50,3-10,4-10,4.5-6,abaxially,acuminate,acute,adaxially,anther,apex,becoming,branched,brown,calyx,chartaceous,cm,dark,densely,diameter,elliptic-ovate,entire,erect,especially,filament,first,flattened,flower,fruit,fruiting,glabrous,globose,green,homostylous,leaf,leaf-opposed,light,margin,membanaceous,mm,nearly,nodding,outline,ovate,pedicel,peduncle,petiole,purple,rachi,reniform,ripe,rugulose,shrub,simple,small,sparsely,stellate,stellate-pubescent,stem,stigma,strongly,style,subcoriaceous,surface,thickened,toward,tree,truncate,white,white-pubescent,x,yellow,yellowish	.1,.5,0-0.3,0.3-0.5,0.7-1.5,1-1.5,1-2,1-4.5,1.5-2.5,10-15,2-17,2-4,2-7,2.5-3,2/3,3-4,3-5,3-7,4-5,4-8,5-10,5-8,5-merou,6-7,7-15,absen,accrescent,adaxiall,ag,alyx,apart,apparently,articulated,axe,ba,base,berry,blade,capitat,connivent,covering,cylindrical,deltate,differentiated,directed,discolorous,distal,distally,dried,eaf,echinoid,eed,equal,fleshy,free,frui,geminate,hair,highly,impressed,interpetalar,introrsely,juic,lacking,large,like,lobe,long,long-stalked,longitudinal,lower,major,midpoint,minor,multangulate,nflorescence,oblong,obtuse,often,one,opening,orolla,paired,part,perfect,pericarp,plurifoliate,pore,porrect,prominent,pubescent,ray,rounded,ruit,sessile,short,short-,short-stalked,side,slightly,slit,somewhat,spaced,stalk,ste,straight,subcucullate,subcuneate,subtending,tall,tamen,tem,thin,time,tip,tissue,triangular,tube,unarme,unit,vary,vein,white-stellate,whitish,wide,without,ympodial	'',5-merous,[,``,abaxial,adaxial,arrangement,bark,bud,capitate,cell,center,characteristic,colour,corolla,form,growth,height,history,inflorescence,length,life,na,new,number,ovary,plant,position,prickle,reproduction,scar,seed,shape,spacing,staman,texture,trichome,value,width,{,}
694	wfo-0001031116	invalid_json_followup	191	120	82	109	38	0.429	.5,/4,0.05-0.15,0.3-0.5,1,1-5,2-5,3.5-4,30-100,4-7,5-merous,8-11,abaxial,abaxially,acuminate,adaxial,anther,apart,apex,apparently,bark,base,berry,calyx,caudate,cm,densely,diameter,dull,elliptic,erect,evenly,filament,flattened-reniform,flower,fruit,fruiting,glabrescent,glaucous-green,green,lateral,leaf,length,less,lobed,long,margin,maturity,mauve,mm,moderately,multangulate,obovate,orange-brown,orange-red,pedicel,peduncle,petiole,recurved,red-brown,scar,sessile,sharply,shortly,shrub,simple,small,sparsely,spherical,stalked,stellate,stellate-pubescent,stem,style,subentire,surface,terete,tree,trichome,way,yellow,young	-10,.2,.8,0,0.1,0.4-0.7,0.7-0.9,0.7-1,1/2,1/3-2/,1/6-1/4,10-14,15-25,2.7-3.2,30-50,4-10,5,5-15,9-13,almost,alyx,ame,apar,apically,arachnoid,articulated,attenuate,blade,branching,bristle,broad-deltate,brow,c.,clearly,collapsed,connivent,dirty-white,discolorous,drying,eaf,eed,elongated,elongating,epidermi,equal,flat,flexuous,fragile,free,glabrous,hair,infructescence,lobe,longer,lower,mature,membranous,midpoint,minute,narrow-deltate,nflorescence,obtu,obtuse,often,older,one,open,orolla,oung,pair,per,perfec,pericarp,perpendicular,plurifoliat,poricidal,portion,primary,ray,reflexed,rounded,ruit,secondary,single,slender,smooth,soft,sometimes,spaced,stalk,straight,tamen,tapering,tertiary,time,tip,tube,unarme,unarmed,unit,upper,vary,vein,venation,visible,weakly,wide,woody,ympodial	'',1.8,[,``,arrangement,brown,bud,cell,center,characteristic,colour,corolla,form,glaucous,growth,height,history,inflorescence,life,na,new,number,ovary,plant,position,prickle,rachi,reproduction,seed,shape,spacing,staman,stigma,texture,value,width,{,}
695	wfo-0001031127	invalid_json_followup	196	125	95	101	30	0.485	+,0.4-1.5,0.5,0.5-1,0.5-1.3,0.8-2,1-1.5,1.5-2,1.5-2.5,2,2-lobed,3.5-4,30-100,6-6.5,7-30,abaxially,acicular,acute,adaxially,almost,anther,apex,bark,brown,calyx,capitate,chartaceous,cm,conical,corolla,cupuliform,deep,densely,diameter,ellipsoid,elliptic,filament,flattened,flower,fruit,fruiting,glabrous,globose,growth,inflorescence,internodal,lanceolate-elliptic,leaf,lobed,long-styled,margin,membranous,midrib,minutely,mm,new,number,opposite,ovary,pale,pedicel,peduncle,pentagonal,petiole,pinnatifid,pitted,porrect,prickle,prickly,pubescent,purple,red-violet,reddish,relatively,reniform,scar,scattered,shallowly,shiny,short-styled,shrub,simple,somewhat,sparsely,stellate,stem,stigma,stout,style,surface,tan,thin,trichome,x,yellowish	-2,.5,0.3-0.4,0.5-3,0.8-1,1,1-5-2,1.5-3,12268,2-3,3-4,3-5,3.5-7,3/4,4,5,5-8,8,8-16,?,anthesi,apar,apparently,armed,articulated,attenuate,base,berry,cell,eaf,eed,ekman,elongate,elongating,equal,even,extremely,fide,free,heterostylous,hyaline,included,individual,lamina,like,linear,lobe,long,long-triangular,lower,m.,midpoint,minute,near,nflorescence,nodding,older,open,outline,pair,papillat,per,pericarp,planar,plurifoliat,pore,poricidal,portion,primary,prominent,ray,rectangular,reduced,rest,ruit,sessile,shin,short-stalked,sinuate,sinus,slightly,slit,sometimes,spaced,spreading,tapering,testal,time,tip,tube,ud,unit,upper,variable,vein,way,widely,woody,yellow,ympodial,½	'',[,``,abaxial,adaxial,apart,arrangement,bud,characteristic,colour,form,height,history,length,life,na,perennial,plant,position,rachi,reproduction,seed,shape,spacing,staman,texture,value,width,{,}
696	wfo-0001031128	success	213	102	70	143	32	0.329	0.05-0.2,0.5-0.7,0.5-0.8,0.5-5,0.6-1,0.8-1.7,1.5-3,20-50,5-19,abaxial,anther,apex,bark,branched,brown,calyx,cm,densely,diameter,dull,elliptic,entire,erect,evenly,filament,flattened-reniform,flower,fruit,fruiting,glabrescent,glabrous,green,inflorescence,lateral,leaf,length,lobed,long-acuminate,margin,mauve,membranous,mm,multangulate,orange-brown,pale,pedicel,peduncle,petiole,purple-black,recurved,red,red-brown,scar,sessile,shallowly,shrub,simple,spherical,stellate,stellate-pubescent,stem,style,surface,terete,terminal,trichome,undulate,white,yellow,yellow-green	-10,-100,-4.5,-6.5,/4,0,0-30,0.05-0.25,0.2,0.2-0.4,0.3-0.8,0.5-1.5,1,1-,1-1.6,1.2-2,1.5-3.5,1/,1/6-1/3,10-20,10-35,2-5,2-9.5,2.3-,2.5-10,2.5-3.5,20-60,3-4,3.5-4.5,4-5-merous,4-7,5-,5-15,5-30,8-12,8-23,abaxially,acute,almost,alyx,apar,apart,ape,apically,apparently,articulated,base,berry,blade,branching,bristle,concolorous,connivent,cuneate,deltate,drying,eaf,eed,elongated,elongating,equal,eye,filiform,flexuous,free,gland,glandular,gra,hair,infructescence,less,lobe,lon,long,long-acuminat,longer,lower,mature,maturity,midpoint,minute,moderately,multangualte,naked,narrow-deltate,near,nflorescence,occasionally,often,older,one,open,orolla,oung,pair,per,perfect,pericarp,perpendicular,plurifoliat,poricidal,portion,primary,ray,reduced,reflexed,ruit,secondary,short-attenuate,short-styled,side,single,smooth,soft,spaced,spreading,stalk,stalked,staminate,straight,tamen,tapering,tertiary,time,tip,tube,unarme,unarmed,unit,usually,variously,vary,vein,venation,visible,way,weakly,whitish,wide,woody,yellow-brown,ympodial,young	1-6.5,2.3-4.5,20-60-100,adaxial,arrangement,bud,cell,center,colour,corolla,form,gray,growth,height,history,life,na,new,number,ovary,plant,position,prickle,rachi,reproduction,seed,shape,spacing,staman,stigma,texture,width
697	wfo-0001031135	success	189	117	84	105	33	0.444	1-,1-1.5,1-10,1-3,1.5-2,1.5-3,1.5-9,10-20,2-,2-3,2-4,3-10,3-4,3.5-12,4-5,5-30,5-9-pinnate,abaxially,acuminate,adaxially,along,also,apart,apex,base,campanulate,cell,cm,compound,darker,deflexed,densely,diameter,eglandular-pubescent,ellipsoidal,especially,fading,flattened,flower,frequently,fruit,fusiform,glabrous,glandular-,green,leaf,light,longitudinal,midrib,mm,moderately,oblong,often,ovoid,papillose,pedicel,peduncle,peltiform,petiole,pilose,pink,pinnatifid,puberulent,pubescent,purple,rachi,ripe,shrub,simple,spaced,sparsely,stigma,stripe,style,toward,tree,unbranched,unlobed,violet,white,whitish,x,yellow-green,yellowish	-7,0-2,0.5-2,0.7-2,1-2.5,1-4,2,2-2.5,2-23,2-3.5,2-5,2.5-28,3-5,4-foliat,5-11,7-15,absent,acute,adpressed,aggregate,ape,articulated,axe,basal,basiscopically,beyond,biglandula,blade,broad,calyx,chartaceous,color,connective,cordate,coriaceous,cuneate,cylindrical,decurrent,deltate,dilated,directed,distally,eaf,eed,ellipsoida,elliptic,entire,equal,exceeding,exserted,hair,interstitial,irregularly,lateral,laterally,leaflet,leaving,lobe,lobed,lon,long,lower,margin,narrowed,nflorescence,nther,obconical,oblique,obtuse,occasionally,orolla,ovate,pedicellar,perfect,pilo,pinnately,pore,present,radiu,remnant,ruit,shorter,slightly,small,smaller,stamen,stone,strongly,subcoriaceous,tal,tem,thecae,time,tip,tomento,triangular,truncate,tube,ud,unit,unknow,upper,vary,wide,ympodial	abaxial,adaxial,anther,arrangement,biglandular,bud,center,colour,corolla,filament,form,growth,height,history,inflorescence,length,life,na,new,number,ovary,plant,position,reproduction,scar,seed,shape,spacing,staman,stem,surface,texture,width
698	wfo-0001031143	invalid_json_followup	217	129	70	147	59	0.323	2.5,4,5,abaxially,adaxially,anther,apart,apex,articulated,base,broad-based,broadly,bud,cm,densely,diameter,elliptic,entire,evenly,extra-axillary,filament,finely,flattened-reniform,flower,fruit,glabrous,globose,green,interpetalar,irregularly,lateral,leaf,length,lobe,margin,minutely,mm,moderately,narrowly,nearly,oblong,often,ovate,ovoid,pale,pedicel,peduncle,per,petiole,pitted,prickle,repand,shallow,shrub,side,simple,smooth,stellate,stellate-tomentose,stem,stigma,straight,style,surface,tissue,usually,well-developed,white,yellow,yellow-orange	0.3–0.5,0.3–0.8,0.4–0.8,0.4–1,0.7–0.9,0.9–1,0–50,1.1–2,1.4–1.7,1.5,1.5–1.9,1.5–2.5,1.5–3,1.5–5.5,10,10.5–11,15–23,1–1.2,1–1.5,1–4,2,2.3–2.5,2.5–4,2.5–4.5,2–2.5,2–3,2–3-branched,2–9,3,3–3.5,4–8-rayed,5-merou,5–7,6–8,7–12,8–10,9,acicular,acute,alyx,apical,apparently,appearing,armed,attenuate,axe,ba,berry,bifoliate,blad,blade,branch,broad,capitat,contrast,dark,directed,distall,dried,eaf,eed,except,fertile,filiform,forming,free,geminat,glabrescent,glabrou,hair,half,high,homostylous,immature,internode,lanceolate,large,layer,leaving,like,lon,long,lower,major,material,maturing,midpoint,midrib,midvei,midvein,minor,minute,mixed,mostly,much,near,nflorescence,orolla,overlapping,pore,porrect,potentially,principal,rarely,ray,remaining,ruit,sessile,set,several,short-caudate,shorter,sinus,slender,soon,spaced,splitting,stellae,stellate-tomento,stipe,stipitate,subcordate,tamen,tardily,tem,thick-chartaceous,time,tip,tomentum,truncate,tube,ud,unarme,unarmed,various,vary,vein,weak,wide,yellow-ferruginous,ympodia,×,–11,–2.5,–4,–4.5,–8	'',0.3-0.8,0.9-1,1-1.2,1-1.5,1-4,1.1-2,1.5-2.5,1.5-3,2-2.5,2-3,2-3-branched,2.5-4,2.5-4.5,20-50,4.5,5-merous,6-8,8,8-10,[,``,abaxial,adaxial,arrangement,bark,calyx,capitate,characteristic,colour,corolla,form,fruiting,growth,height,history,inflorescence,life,na,new,number,ovary,perennial,plant,position,rachi,reproduction,scar,seed,shape,spacing,staman,texture,trichome,value,width,x,{,}
699	wfo-0001031144	invalid_json_followup	231	127	95	136	32	0.411	0.2,0.8-1.4,1-1.5,1-4,1.1-2.5,100,2-3,2-6,2/3,25,3-7,6,7-10,acuminate,acute,anther,apart,apex,base,berry,bright,broadly,brown,calyx,capitate,cm,commonly,corolla,densely,diameter,elliptic,entire,filament,flattened-reniform,flower,form,fruiting,glabrous,globose,groove,growth,inflated,inflorescence,irregularly,later,lateral,leaf,less,lobed,margin,minutely,mm,new,number,pale,pedicel,peduncle,petiole,pinnately,pinnatifid,pitted,pubescent,red,reddish,ripe,scar,seed,shiny,simple,slightly,spaced,sparsely,stellate-rotate,stem,stigma,style,surface,tan,terete,terminal,tiny,tip,triangular,trichome,uniseriate,usually,vine,violet,way,white,woody,x,yellow,yellowish,½	-11,-13,.2,.5,0.5,1-,2,2-,2-9,2.5-3,3-4.5,3.5-10,4,4-20,4-4.5,4-6,5,5-9,5-merou,<,adaxially,ag,alyx,anthesi,apicula,apiculae,appearing,ark,around,articulated,asymmetric,away,axi,basal,basiscopically,blac,branch,branche,brow,cell,closer,connivent,cordate,corresponding,cupped,curved,divaricate,drying,eaf,eed,ellipsoid,elongate,elongating,exserted,extending,flattened,four,free,geminat,ilament,lamina,larger,leaflet,leaving,lengthening,like,lobe,long,longer,longest,loosely,lower,many,markedly,membranous,mere,minute,near,nflorescence,oblique,occasionally,often,older,one,open,orolla,outline,pair,papillo,peg,pendant,pentagonal,per,perfect,pericarp,plurifoliate,pore,poricidal,portion,primary,progress,quite,rim,ruit,sleeve,slit,small,smaller,sometimes,spreading,strongly,tangle,tem,testal,thin,third,together,truncate,tube,tuft,twinin,twining,two,ud,unequal,unit,upper,variable,vary,vein,wall,weight,widest,wing,wood,ympodial	'',[,``,abaxial,adaxial,arrangement,bark,bud,center,characteristic,colour,fruit,height,history,length,life,na,ovary,plant,position,prickle,rachi,reproduction,shape,spacing,staman,tangled,texture,value,width,{,}
700	wfo-0001031152	success	232	120	88	144	32	0.379	-10,.4,0.2-0.3,0.2-1.5,0.3-1.3,0.3-3,1-1.5,1-6,1.2-1.8,11,2.7-3.7,4-19,4-6,4-8,8-20,abaxially,acuminate,adaxially,anther,apart,apex,becoming,brown,bud,bullate,calyx,chartaceous,cm,conical,continued,corolla,deltoid,densely,diameter,due,entire,filament,flower,fruit,fruiting,globose,green,greenish,growth,honeycombed,lanceolate,lateral,lavender,leaf,length,lilac,long,margin,mm,mostly,narrowly,oblanceolate,orbicular,pale,pedicel,peduncle,petiole,pitted,probably,pubescent,rachi,reniform,reticulate-punctate,ripe,rotate-stellate,scabrous,shrub,simple,sparingly,sparsely,stellate-pubescent,stem,stigma,style,suborbicular,surface,terminal,tree,violet,x,yellow,yellowish,young	-1.5,-5.5,/100-1/16,0-100,1-3,1.1-2.2,1.1-3,1.3-4,1.4-2.6,1.5-3,1.5-3.5,1/2-2/3,1/2-3/4,13-27,2-5,2.5-7.5,2.7-4.5,2.7-6,2.8-4,3.7-7,4-7,5-6,6.5-10,9-13,accrescent,acute,ag,along,anthesi,apical-lateral,apparently,articulated,attenuate,axe,axillary,ba,basal,base,berry,blade,blister,blunt-tipped,branch,branched,capitat,closely,decurrent,dehiscing,directed,eaf,earl,eed,evident,exserted,extend,few-rayed,fleshy,free,glabrescen,glabrous,granular-tomentose,hair,high,inserted,introrse,lackin,large,less,lobe,lobed,long-,longer,longitudinal,lower,m.,main,midvein,mixed,moderately,multangulat,multangulate,nearly,nflorescence,oblong,obtuse,occasionally,one,open,openly,orolla,ovate,partly,perfect,persistently,plurifoliate,pore,porrect-stellate,rather,ray,reddish,reddish-brown,relatively,ruit,runk,sessile,short-,short-stalked,side,slightly,slit,somewhat,soon,spaced,splitting,stamen,stelliform,stipitate-glandular,stout-stalked,strongly,suture,swelling,tamen,terete,testa,thick,thick-stalked,thin,thin-,thin-stalked,time,tomentose,touching,toward,tube,unarme,unarmed,unit,usually,variously,vary,vein,way,wide,ympodial	30-100,abaxial,adaxial,arrangement,bark,capitate,cell,center,colour,form,glabrescent,height,history,inflorescence,life,na,new,number,ovary,perennial,plant,position,prickle,reproduction,scar,seed,shape,spacing,staman,texture,trichome,width
701	wfo-0001031155	invalid_json_followup	193	126	91	102	35	0.472	.5,0.2-1.2,0.5,1,1-1.2,1-1.5,1.5-2,2-5,2.5-3.2,4-,4-6,5-20,7-15,abaxially,acuminate,acute,almost,anther,apart,apex,bark,base,beneath,bilobed,calyx,closely,cm,corolla,cream,dark,deeply,densely,diameter,distally,echinoid,elliptic,evenly,filament,flower,glabrous,globose,growth,height,heterostylous,inflorescence,internodal,lanceolate,leaf-opposed,like,lobed,lower,margin,midrib,minutely,mm,multangulate,new,once-branched,orange,pale,part,pedicel,peduncle,petiole,prickle,prickly,pubescent,scar,shallowly,shiny,shrub,simple,spaced,sparsely,stellate,stem,stigma,strongly,style,surface,tan,terminal,tip,trichome,unknown,white,whitish,widely,within,x,yellowish	0,0.1,0.2,0.3-0.4,0.7,0.7-1.5,1.5,1.5-1.6,1.5-5,3-4-foliate,4.5-7,5-7,8.5-13,adaxially,age,along,anthesi,apparently,appearing,armed,articulate,axi,broader,bullate,cell,central,climbing,common,cup-shaped,deltate,discolorous,distall,due,eaf,eed,enlarged,equal,exserted,ferrugineous,fine,glabrescen,glandular,halfway,heavily,hub-like,intertwined,know,known,larger,leaving,lengthening,lobe,long,longer,los,midpoint,mixed,mixture,multiseriate,narrowly,nflorescence,oblique,obtuse,occasionally,older,open,outline,pair,papillat,peg,plurifoliate,pore,poricidal,porrect,primary,principal,purple,ray,reddish,ruit,seen,sessile,short-stalked,short-styled,size,slightly,small,somewhat,sparse,sparser,split,stalk,stout,straight,tapering,tube,ud,unevenly,unit,variable,vein,ympodial	'',[,``,abaxial,adaxial,arrangement,bud,center,characteristic,colour,form,fruit,fruiting,glabrescent,history,leaf,length,life,na,number,ovary,papillate,plant,position,rachi,reproduction,seed,shape,spacing,staman,texture,value,width,{,}
702	wfo-0001031162	invalid_json_followup	241	131	94	147	37	0.39	.5,0.5-0.7,0.5-7,0.7-5,1-1.5,1-15,1-5,1.5-2,1.5-3,1.5-8,1.7-4.5,10-30,2-,3-10,3-branched,3.5-5.5,5-10,7-9,8-14,abaxially,accrescent,acicular,adaxially,angled,anther,apart,apex,base,black,broadly,calyx,chartaceous,cm,cordate,deeply,densely,diameter,erect,extra-axillary,filament,flower,fruit,fruiting,glabrous,globose,green,homostylous,inflorescence,interpetalar,irregularly,leaf,length,lobe,lobed,long,margin,minutely,mm,moderately,obtuse,outline,ovate,pale,pedicel,peduncle,pendant,perennial,petiole,prickle,pseudohair,pubescent,purple,rachi,reniform,reticulate,rhizomatous,shrub,simple,somewhat,sparsely,stellate,stellate-pubescent,stigma,style,surface,tan,thick,throughout,tissue,unbranched,white,x,yellow,yellowish	%,-74,0,0-1.2,0-1.5,0-2.5,0-25,0.05-0.1,0.1-0.15,0.1-0.2,0.1-0.8,0.15-0.4,0.25,0.4-0.8,0.5-0.8,0.5-1.5,0.5-2,0.5-3,0.6-0.8,0.7-1.2,0.8-1.2,1-1.7,1-10,1-13,1-2,1-locular,1.2-1.4,1.5-1.9,1.5-2.5,10,10-12,15-20,2-2.8,2-7,2-foliate,20-40,26-,3-4,3.5-10,35-200,4-5,4-6,4-8,4-9,5-6,5-7,5-merou,6,6-7,6-8,60,600-1400,7-17,7-70,absent,across,acute,adult,alyx,apparen,armed,articulated,ascending,attenuate,axe,ba,blade,branch,branche,capitat,connivent,cylindrical,decimetre,deltate,directed,distall,distributed,dm,eaf,eed,eglandular,exocarp,finger,geminat,generally,gland-tipped,hair,half,incomplete,index,juicy,juvenile,lamina,lanceolate,lateral,less,lobing,lon,longer,lower,mature,mesocarp,mid-point,midpoint,midvein,minute,moderate,narrow,nflorescence,oblique,orolla,pair,part,per,perfect,placenta,pore,porrect,presen,present,ray,ruit,septum,sessile,short,side,spaced,sparse,stalk,stellae,straight,succulent,tal,tamen,tem,time,tissu,transparent,triangular,tube,unit,upper,vary,vein,wide,wing,ympodial	'',5-merous,[,``,abaxial,adaxial,arrangement,bark,bud,capitate,characteristic,colour,corolla,form,growth,height,history,life,na,new,number,ovary,plant,position,reproduction,scar,seed,shape,spacing,staman,stem,texture,trichome,value,width,{,}
703	wfo-0001031178	success	167	84	55	112	29	0.329	0.3-0.6,0.7-1.7,1.5-6,11-18,4-4.5,7-11,7.5-8.5,acicular,acute,adaxially,anther,apex,calyx,cm,densely,diameter,entire,erect,extra-axillary,fruit,fruiting,glabrous,globose,green,grey,inflorescence,length,lobed,longer,margin,mm,ovate,pedicel,perennial,petiole,prickle,pseudo-racemose,purple,rhizomatous,rusty,shallowly,shrub,simple,solitary,sparsely,stellate,stellate-pubescent,stem,straight,style,time,unbranched,unknown,wide,yellow	%,0-0.2,0-0.25,0-0.4,0-0.6,0-10,0-5,0-6,0.1-0.2,0.1-0.25,0.4-0.6,0.6-0.9,0.6-1,0.6-1.2,0.7-1,0.8-1.2,0.9-1.2,1-2,1-3,1-4,1.2-1.4,1.2-1.5,1.2-3.4,1.5-5.2,180-400,19-30,2-3.5,2-5,3.5-9,4-9,40-65,5-11,5-merou,6-14,6-8,7-8,abaxially,absent,accrescent,across,adaxiall,alyx,apart,armed,articulated,ascending,attenuate,axe,ba,base,blade,brown,chartaceous,cuneate,cylindrical,d.,directed,distall,distributed,dult,eaf,eed,eglandular,finger,flower,glabrou,gland-tipped,hair,half,hig,juic,lamina,lanceolate,lateral,lobe,lon,long,lower,mature,mesocarp,midpoint,midvein,minute,moist,nflorescence,oblique,orolla,part,peduncle,per,pore,porrect,presen,present,ray,ruit,short,spaced,stage,stalk,stellae,tamen,thick,throughout,tube,unit,unknow,uvenile,vary,vein,x,ympodial	abaxial,arrangement,bark,bud,cell,center,colour,corolla,filament,form,growth,height,history,leaf,life,new,ovary,plant,position,reproduction,scar,seed,shape,staman,stigma,surface,texture,trichome,width
704	wfo-0001031185	invalid_json_followup	213	150	116	97	34	0.545	.2,.5,0.5,0.5-3,1,1-10,1-5,10-40,2.5-16,2/3,3-4,4.5-7.5,7-10,anther,apart,appearing,away,axi,base,berry,branched,bright,broadly,brown,calyx,capitate,cell,cm,commonly,corolla,curved,deeply,densely,diameter,dry,ellipsoid,elongate,entire,eye,filament,flattened,flower,fruiting,glabrous,globose,green,growth,inflorescence,irregularly,lateral,lax,leaf,like,living,lobed,long,many,margin,material,mature,meter,minutely,mm,moderately,new,open,outline,ovate,pale,papillate,pedicel,peduncle,perfect,petiole,pinnatifid,pitted,pointing,pubescent,red,reniform,ripe,scar,seed,several,shape,shiny,shrub,simple,slender,slightly,spaced,sparsely,spreading,stellate,stem,stigma,style,surface,tan,terminal,thin,time,tip,trichome,uniseriate,variously,vine,violet,wall,way,white,whitish,woody,yellow,yellowish,½	-10,-8,0.5-1.5,0.8-1,0.8-1.3,0.9-,1-,1-1.2,1-1.5,1-4,1.2-5,1.5-4,2-9,20,4-6,5-merou,>,acuminate,acute,ag,alyx,anthesi,apex,apically,appressed,ark,articulated,attenuate,basal,blade,closer,conical,connivent,deltate,distal,eaf,eed,exserted,extremely,free,glabrescen,ilament,inflorescenc,irregular,leaving,lengthening,lobbing,lobe,lon,loosely,lower,materia,midrib,nflorescence,older,onto,orolla,pair,part,particularly,peg,per,pericarp,plurifoliat,pore,poricidal,portion,reflexed,rounded,ruit,sinus,size,slit,small,spreadin,still,strongly,tem,thickened,third,toward,truncate,tube,ud,ultimate,unit,upper,usually,variable,vary,visible,weak,wide,widest,winged,within,ympodial	'',5-merous,[,``,abaxial,adaxial,arrangement,bark,bud,center,characteristic,colour,form,fruit,glabrescent,height,history,length,life,na,number,ovary,perennial,plant,position,prickle,reproduction,spacing,staman,texture,value,width,{,}
705	wfo-0001031195	success	216	115	85	131	30	0.394	0-0.7,0.2-0.4,0.3,0.5-1,0.6-1.5,1,1-1.5,1-4,11-28,2,2-2.5,3-6,3.5-5.5,7.5-8,9-15,accrescent,acicular,acute,anther,apart,apex,articulated,base,broadly,calyx,center,chartaceous,cm,cylindrical,deeply,densely,diameter,ellipsoidal,entire,extra-axillary,filament,finely,flattened,flower,fruit,fruiting,glabrous,globose,green,inflorescence,irregularly,leaf,length,lobed,margin,mm,moderately,obtuse,ovate,pale,pedicel,peduncle,perennial,petiole,plant,prickle,prostrate,pseudo-racemose,purple,rachi,reticulate,rusty,shallowly,shrub,simple,solitary,splitting,stellate-pubescent,stigma,stoloniferous,straight,style,surface,unbranched,white,whitish,x,yellow,yellowish,yellowish-green	%,0-3,0-8,0.05-0.3,0.2-0.5,0.25-0.35,0.3-0.4,0.5-0.7,0.6-0.8,0.6-3,1-2,1-locular,1.4-1.6,1.4-2.9,1.5-2.5,10-13,10-14,10-19,15-35,2-4,2-5,2.5-4,20-32,3-3.5,3-4,3-5,3.5-4,4-5,4-7,4-9,5-9,5-merou,5.5-10,6-10,7-8,8-9,abaxially,absen,absent,across,adaxially,alyx,andromonoecious,attenuate,axe,ba,blade,capitat,confined,connivent,cuneate,d.,difoliate,directed,distal,distall,distributed,eaf,eed,eglandular,exocarp,filiform,finger,functional,geminate,gland-tipped,grey,hair,half,heterostylous,incomplete,interpetalar,juic,lamina,lateral,less,lobe,long,longer,loosely,lower,mature,mesocarp,midpoint,midrib,midvein,minute,moist,narrowly,nflorescence,oblique,orolla,part,per,pore,porrect,presen,present,probably,ray,ruit,septum,sessile,short,spaced,sparse,sparsely,stage,stellae,stellate,tal,tamen,tem,thick,throughout,time,tip,tissu,tissue,transparent,triangular,tube,unarme,unarmed,unit,uvenile,vary,vein,weakly,wide,ympodial	5-merous,abaxial,adaxial,arrangement,bark,bud,capitate,cell,colour,corolla,form,growth,height,history,life,na,new,number,ovary,position,reproduction,scar,seed,shape,spacing,staman,stem,texture,trichome,width
706	wfo-0001031202	invalid_json_followup	198	128	93	105	35	0.47	.1,0-0.5,0-1,0.1-0.3,0.6-1.1,0.8-1,1-1.5,1-5,1.5-2.5,2-8,2/3,3.5-4,6-25,abrupt,accrescent,acute,anther,apart,apex,bark,base,broadly,bud,calyx,capitate,cm,complex,corky,corolla,cup-shaped,densely,erect,filament,fleshy,flower,fruit,fruiting,furcate,glabrous,globose,green,hard,inflorescence,later,lateral,leaf,lobed,long,many,margin,minutely,mm,narrowing,obovate,opposite,ovary,overtopping,ovoid-reniform,pale,paler,papillose,pedicel,petiole,pitted,plant,puberulent,raised,reddish-brown,scar,shape,shoot,shrub,slender,slightly,small,sparsely,stem,stigma,style,surface,tan,tapering,terminal,time,tip,tree,trichome,tube,uniseriate,way,white,woody,x	.5,0.5,0.5-1,1-1.7,1.5-2,1.5-9,15-40,2-3,2.5-13,2.5-3.5,2.5-4,20-100-flowered,9-11,9-20,along,anthesi,apiculate,axi,beneath,berry,completely,condition,cordate,decurrent,deflexed,deltoid,dia,differing,difoliate,distal,dry,due,eaf,edicel,eed,enclosed,exserted,extremely,free,frui,geminat,glabrate,golden,greenish-white,greyi,irregularly,large,like,live,lobe,lon,long-ellipsoid,long-styled,longer,lower,main,major,material,middle,minor,minute,nflorescence,occasional,occasionally,often,older,one,orbicular,pair,papillo,planar,pore,poricidal,portion,prominent,pubescent,quite,rounded,ruit,scattered,sessile,shaped,short-styled,size,spaced,specimen,straight,tall,tear-drop,thick,thickened,thicker,third,tub,ud,unit,usually,variable,vein,weight,whitish,widest,winged,ympodial,young	'',20-100,[,``,abaxial,adaxial,arrangement,center,characteristic,colour,diameter,form,greyish,growth,height,history,length,life,na,new,number,peduncle,perennial,position,prickle,rachi,reproduction,seed,spacing,staman,texture,value,width,{,}
707	wfo-0001031203	invalid_json_followup	218	118	78	140	40	0.358	-2,.7-1,0-0.5,0-0.8,0-2.5,0.3-0.6,0.4-1,1-2,1.5-2.5,1.8-2.8,2-7,3-10,4-16,6-16,6.5-9.5,8-11,almost,anther,apex,berry,broadly,calyx,cinereous-tomentose,cm,coarsely,deciduous,deep,densely,dentate,diameter,erect,essentially,extra-axillary,filament,first,flower,foveolate,fruit,glabrous,globose,greenish-white,inflorescence,length,lenticular,lignescent,margin,maturity,minutely,mm,orange-red,outline,ovate,ovoid,pedicel,peduncle,perennial,petiole,rachi,rarely,red,reniform-ovate,sericeous,simple,smooth,sparsely,spreading,stellate,stellate-pubescent,stem,stigma,style,surface,thin-textured,unbranched,usually,white,x,yellow	-1.5,.2,0.05-0.15,0.05-0.2,0.1,0.1-0.8,0.3,0.5-1.8,1-3,1-5,1/10-1/4,11-18,15-22,15-50,2-3.5,2-5,2-foliate,2.1-2.7,2.5-9.5,21-39,25-45,3.2-4,4-12,4-6-locular,4-6.5,5-7,5-8,5-8.5,5-9,5.5-8,8-14,abaxiall,abaxially,acute,acute-tipped,adaxiall,adaxially,along,apart,apparently,articulated,asymmetric,attenuate,axe,ba,base,blade,campanulate,capitat,connivent,consisting,curved,cylindrical,deltoid,directed,distall,distributed,downcurved,eaf,eed,elongate,flesh,geminat,hair,interlobal,interwoven,invested,lanceolate,lateral,less,linear-lanceolate,lobe,lon,long,longer,lower,lowermost,lying,major,midpoint,midvein,much,nflorescence,numerous,obsolete,obtuse,often,orolla,ovate-lanceolate,pair,parallel,per,perfect,plane,pore,present,prickl,projecting,prominent,pubescence,ray,reduced,relatively,ripe,ruit,sessile,short,short-stalked,shorter,side,sinus,smaller,somewhat,spaced,stalk,stellae,stellate-pubescen,surfac,tal,tamen,tem,terete,termination,thickened,three,time,tip,tooth-like,truncate,tube,unarmed,unit,uppermost,upward,vary,vein,weakly,well-developed,wide,ympodial	'',[,``,abaxial,adaxial,arrangement,bark,bud,capitate,cell,center,characteristic,colour,corolla,form,fruiting,growth,height,history,leaf,life,na,new,number,ovary,plant,position,prickle,reproduction,scar,seed,shape,spacing,staman,texture,trichome,value,width,{,}
708	wfo-0001031207	success	219	106	78	141	28	0.356	0-0.5,0.1-0.5,0.25-0.5,0.5-1,0.6-1.2,0.85-1.4,1.4-2,2-3,3-5,5-8,abaxially,anther,apart,bark,berry,branched,calyx,cell,cm,curved,dark,densely,diameter,dull,evenly,filament,flattened-reniform,flower,fruit,fruiting,gently,glabrescent,glabrous,gray,green,herb,lateral,leaf,length,lobed,margin,maturity,mauve,mm,moderately,orange-brown,outline,ovate,pale,pedicel,peduncle,petiole,pit,prickle,raised,red,scandent,scar,shrub,simple,small,smooth,sometimes,spherical,stellate,stellate-pubescent,stem,straight,style,subentire,surface,terete,terminal,trichome,white,yellow,yellow-green,young	-0.4,-1/2,-11,-4,-5,-7,-8,.1,/5,0,0-10,0-20,0.1-0.2,0.1-0.3,0.2,0.2-0.3,0.3-0.5,0.6-0.9,0.7-2,0.8,0.9-1.6,1,1-3,1-4,1-5,1.5-5,1/,1/3,1/3-equal,1/4-1/3,2-4,2.1-2.3,2.5-,2.8-3,3.5-7,5-merous,6-8,6.5-8,9,acuminat,acute,alyx,ame,apar,apex,apically,apparently,articulated,base,blade,bristle,bristly,broad-deltate,brow,c.,chartaceous,concolorous,cordate,difoliate,discolorous,distance,drying,eaf,eed,elongated,elongating,equal,erect,extending,eye,filiform,free,geminat,herbaceous,infructescence,lanceolate,less,like,lobe,long,longer,lower,mature,midpoint,midvein,multangulate,naked,narrow-deltate,nflorescence,oblong,obtuse,occasionally,older,one,open,orolla,oung,pair,pendulous,per,perfec,pericarp,perpendicular,persistent,poricidal,porrect,portion,prickl,prickly,primary,ray,reflexed,rounded,ruit,sessile,shorter,side,spaced,spreading,stalk,stalked,tamen,tapering,tertiary,time,tip,toward,tube,unarmed,unit,upper,usually,variously,vary,vein,venation,visible,way,weakly,wide,ympodial	0-8,abaxial,adaxial,arrangement,brown,bud,center,colour,corolla,form,growth,height,history,inflorescence,life,na,new,ovary,plant,position,reproduction,seed,shape,spacing,staman,stigma,texture,width
709	wfo-0001031217	success	222	126	95	127	31	0.428	.5,0.1-0.3,0.25-1.3,0.5-0.75,0.6-1.8,1-1.5,1.5-2,13-21,2-5,2-9,3-4,3.5-4.5,5.5-7,6-12,7-17,abaxially,absent,accrescent,acicular,acuminate,acute,adaxially,anther,apex,articulated,base,borwn,broad-based,calyx,chartaceous,cm,contiguous,cylindrical,densely,diameter,elliptical,entire,extra-axillary,filament,flower,fruit,fruiting,glabrous,gland-tipped,globose,green,greenish-white,hair,inflorescence,interpetalar,lanceolate,leaf,length,light,longer,margin,mm,moderately,nearly,ovate,overlapping,pale,pedicel,peduncle,perennial,petiole,present,prickle,pseudo-umbellate,purple,rachi,red,reticulate,rhizomatous,scarcely,scattered,shape,short,shrub,simple,sparsely,stellate,stellate-pubescent,stigma,straight,style,surface,time,tissue,unarmed,unbranched,violet,wide,x,yellow	%,.5-2,0-0.1,0-3.5,0-5,0-6,0.1-0.2,0.15-0.25,0.2-0.3,0.25-0.4,0.3-0.4,0.3-0.5,0.3-1,0.35-0.6,0.4-0.7,0.5-3,0.8-4,1,1-2,1-20,1-4,1-locular,1.5-4,1.5-4.2,2-2.5,2-3,2-8,2.5-4,2.6-3,3-4.2,4-11,4-6,5-12,5-7,5-merou,6-8,7-8,7-9,9-10,absen,across,adult,alyx,apart,apparen,axe,ba,blade,branch,branche,brown,confined,connivent,cuneate,directed,distall,distributed,dm,eaf,eed,eglandular,elliptic,erect,exocarp,finger,geminate,half,incomplete,juicy,juvenile,lamina,lateral,less,lobe,lobed,long,loosely,lower,mature,mesocarp,mid-point,midpoint,midrib,midvein,minute,much,narrowly,nflorescence,oblique,orolla,pair,paired,part,pendent,per,perfect,placenta,plurifoliate,pore,porrect,ray,ruit,septum,sessile,shallowly,smaller,sometimes,spaced,sparse,stalk,stellae,succulent,tal,tamen,tem,thick,throughout,tissu,transparent,triangular,truncat,tube,unarme,unit,upper,vary,ympodial	5-merous,abaxial,adaxial,arrangement,bark,bud,cell,center,colour,corolla,form,growth,height,history,life,na,new,number,ovary,plant,position,reproduction,scar,seed,spacing,staman,stem,texture,trichome,truncate,width
710	wfo-0001031218	success	154	107	75	79	32	0.487	-5,0.5-1,1-2,15-25,2-2.5,2-22,2-3,3-14,3-5,4-5,4-8,40-100+,5-7,6-7,8-20,abaxially,acuminate,adaxially,apart,apex,articulated,base,branched,calyx,cm,connective,coriaceous,dark,densely,diameter,eglandular-pilose,ellipsoidal,especially,flattened,flower,fruit,glabrous,glandular-puberulent,globose,greenish-purple,lanceolate,lavender,leaving,long,minutely,mm,moderately,mottled,obtuse,orange,ovate,ovate-elliptic,ovoid,pedicel,pedicellar,peduncle,petiole,puberulent,pubescent,purple,rachi,radiu,remnant,ripe,simple,sparsely,stellate,stigma,style,succulent,toward,tree,violet,x,yellow	0.5,1-3,1-4,10-19,2.5-3,3,4-28,4-7,4-foliat,40,5-37,5.5-7,6-10,6-9,8-17,acute,aggregate,ape,apiculate,axe,basal,beyond,blade,cell,connivent,cordate,cylindrical,directed,distally,eaf,eed,eglandular,entire,equal,exceeding,exserted,glabrou,glandular,hair,introrse,less,lobe,lon,lower,margin,narrowly,nflorescence,nther,oblique,orolla,papillo,perfect,pore,presen,present,purpl,ruit,shorter,slightly,small,sometimes,spaced,stamen,stone,subcoriaceous,tal,tem,thecae,time,tip,tomento,triangular,truncat,tube,ud,unit,vary,wide,ympodial	abaxial,adaxial,anther,arrangement,bud,colour,corolla,filament,form,growth,height,history,inflorescence,leaf,length,life,na,number,ovary,papillose,perennial,plant,position,reproduction,seed,shape,spacing,staman,surface,texture,truncate,width
711	wfo-0001031225	invalid_json_followup	163	114	78	85	36	0.479	0.2,0.2-0.75,0.5,0.7-6,0.75-1,0.8-1,1-1.5,1-5,2.5-3,3/4,5-6,7-9,acute,along,anther,apart,apex,bark,base,broadly,bud,calyx,characteristic,closely,cm,corolla,cup-shaped,elliptic,filament,fruiting,furcate,glabrous,globose,green,growth,inflorescence,leaf,less,lobed,long,margin,minute,minutely,mm,often,opposite,ovary,ovate,ovoid-reniform,pale,papillose,pedicel,petiole,pitted,plant,pubescent,scar,shape,shaped,shrub,slender,small,spaced,stem,stigma,style,surface,tan,tapering,tree,trichome,tube,unevenly,uniseriate,vein,way,white,x	.25,.5,/3,0.1-0.75,0.5-1,1-1.7,1-3,1.5-5,2,3-9,5-50-flowered,6-8,9-16,anthesi,beginning,berry,conspicuous,darker,decurrent,deltoid,dia,differentiated,differing,difoliate,dry,eaf,edicel,eed,ellipsoid,erect,exserted,flattene,fragrant,free,geminat,glabrate,greyish-brow,inflorescenc,lateral,like,live,lobe,lon,lower,main,major,middle,minor,much,narrowly,nflorescence,older,one,outline,pair,papillo,pore,poricidal,portion,prominent,proximal,raised,red-papillose,reflexed,rest,rhomboidal,rounded,ruit,size,slightly,soon,specimen,straight,strongly,sweetly,swelling,tall,tear-drop,tip,ud,unit,widest,woody,ympodial,young	'',5-50,[,``,abaxial,adaxial,alternate,arrangement,center,colour,diameter,flower,form,fruit,greyish-brown,height,history,length,life,na,new,number,peduncle,perennial,position,prickle,rachi,reproduction,seed,spacing,staman,texture,value,width,{,}
712	wfo-0001031231	invalid_json_followup	175	115	75	100	40	0.429	-2,.5,0.5-1.5,1.5-2,13,2-3,37/2,37/3,5-7,8-10,absent,acumen,anther,apex,aromatic,axillary,branch,branched,brown,calyx,campanula,campanulate,cell,cm,colour,corolla,dark,discoidal,ellipsoid,elliptic,exceeding,filament,flower,fork,glabrous,glandular,globose,green,greyish,hair,juvenile,lanceolate,leaf,len,less,marbled,margin,mauve,minute,mm,occasionally,often,ovary,pedicel,peduncle,pentagonal,pinnatisect,plant,purple,rh,ripening,rotate,rounded,rugose-ruminate,seed,short,shrub,simple,sometimes,stigma,style,succulent,surface,tinged,violet	1-1.5,1-2,1-3,1-4,2-4,2.5-3,25-35,3-4,4-8,80-110,acuminate,acute,adherent,almost,along,anthesi,aspect,axi,basal,base,becoming,berry,beyond,blunt,bluntly,clonal,cluster,declinate,developed,dia,eaf,eed,entire,equal,erect,except,exerted,expanded,facetted,fleshy,flowering,folded,general,gree,habit,herbarium,interacuminal,lasting,lengthening,lobe,lon,long,loosely,lower,mature,midrib,nflorescence,oblong,pedice,pedicellate,petal,plurifoliat,pore,poricidal,projecting,rarely,readily,recurve,ripe,ruit,sessile,several,shallow,shed,sinus,slightly,slit,small,soft,specimen,stone,stonrgly,stout,tip,tissue,toward,translucent,triangular,tub,ud,unit,usually,variable,vigorous,well,without,wooded,x,year,ympodial	'',[,``,abaxial,adaxial,arrangement,bark,bud,center,characteristic,diameter,form,fruit,fruiting,growth,height,history,inflorescence,length,life,na,new,number,perennial,petiole,position,prickle,rachi,reproduction,scar,shape,spacing,staman,stem,texture,trichome,value,width,{,}
713	wfo-0001031252	success	170	120	88	82	32	0.518	0.2-1.5,0.3-1.1,1-2,1.75-5.2,12-20,16-33,2.8-3.6,3-10,3-5,5-8,5-9,abaxially,acute,adaxially,along,anther,apex,articulated,axillary,bead,brownish,bud,cell,clavate,cm,condition,coriaceous,corolla,covering,dark,deep,diameter,distal,drying,elliptic,entire,filament,flower,forked,fresh,fruit,glabrous,globose,green,green-white,greenish,hair-like,half,herb,high,homostylous,lateral,light,like,make,margin,medium,mm,moniliform,mucilaginous,necklace,ovate,ovoid,pedicel,peduncle,petiole,plant,purple,ripe,rotate,rounded,seed,simple,stigma,stolon,stripe,style,subtending,terminal,testal,thick,throughout,tuber,wall,wet,white,whitish,yellow	0.4-3,1-3,1.3-1.9,2-3,2.5-7,3-6,5-17,5-merou,5.5-6.5,7-18,absent,acumen,adaxiall,ag,alyx,apart,apparently,arranged,attenuate,axe,base,berry,blade,capitat,ciliate,connivent,cuneate,digestion,dorsally,eaf,edge,eed,enzyme,erec,exceeding,flat,folded,geminat,generally,glabrou,hal,honeycomb-shaped,interjected,lanceolate,leaflet,lengthening,linear,living,lobe,long,lower,mottled,multiple,nflorescence,orolla,perfect,plurifoliate,pore,poricidal,removed,ruit,serrate,seudostipule,slit,sometimes,spaced,specimen,stamen,straight,tall,tamen,tem,tip,tri-,tube,typically,unit,unwinged,usually,vary,x,ympodial	abaxial,adaxial,arrangement,calyx,capitate,center,colour,form,fruiting,growth,height,history,inflorescence,leaf,length,life,na,new,number,ovary,perennial,position,reproduction,scar,shape,spacing,staman,stem,surface,texture,trichome,width
714	wfo-0001031257	invalid_json_followup	206	118	75	131	43	0.364	-5,-6,0.75-2.5,1-1.2,1-1.3,2-4.5,3.5-,4-4.5,7.5-9,abundant,acuminate,anther,anthesi,apex,base,berry,blue-violet,bud,calyx,campanulate,cm,coarsely,corolla,dark,dentate,diameter,edentate,erect,filament,flexuous,fruiting,glandular,globose,herb,hollow,honey-combed,leaf,length,light,little,long,longer,longitudinally,margin,midvein,mm,non-glandular,ovate,patent,petiole,pubescent,purple,rarely,ridged,ring,robust,secondary,seed,serrate,shrub,slightly,solitary,stem,stigma,style,subglobose,tip,trans-ovoidal,trichome,tube,vein,white,within,x,yellow	-12,-22.5,0,0.4,0.5,0.5-0.8,0.7-1,1.1-1.2,1.5,1.5-1.7,1.5-2,1/10,10-16,11.5-15,2-,3,3.5-5.7,4-10,4.5-,5,5-,5-8.5,6-12,6-celled,7-,8,8-celled,abaxially,accrescen,adaxially,ag,aggregate,antrorse,ascending,attenuate,basal,bicellular,branch,broad,cell,coat,connectival,cotyledon,cuneate,curved,cuticle,deep,densely,diamete,difoliate,directed,dorsally,eaf,eed,ellipsoidal,elliptical,embryo,endosperm,epidermal,finely,foliage,free,geminat,glabrous,hair-like,half,head,herbaceous,high,inconspicuous,inserted,lamina,lateral,like,lobe,lon,long-stalked,longitudinal,lower,many-seeded,narrowly,odorles,opening,orolla,outward,pair,papillate,pericarp,pore,poricidal,portion,prolongation,reduced,ree,rest,ruit,saddle-shape,scarce,scarcely,separated,short-stalked,shorter,simple,single-celled,sinus,slit,small,smooth,somewhat,spur-like,stalk,stone,strand,striate,tem,thecae,thickened,thickening,time,tooth,triangular,unequal,unit,upward,vary,ventrifixed,verrucate,viscid,viscid-pubescen,wall,ympodial	'',[,``,abaxial,accrescent,adaxial,arrangement,bark,center,characteristic,colour,flower,form,fruit,geminate,growth,height,history,inflorescence,life,na,new,number,ovary,pedicel,peduncle,perennial,plant,position,prickle,rachi,reproduction,saddle-shaped,scar,shape,spacing,staman,surface,texture,value,width,{,}
715	wfo-0001031270	invalid_json_followup	234	143	112	122	31	0.479	0.4-1.5,0.5-1,1,1-1.2,1-4,1/3,10,10-12,2-3,2-4,3-10,5-15,5-merous,6-50,9-10,abaxial,abaxially,accrescent,adaxial,anther,apart,bark,base,berry,bipinnatifid,bright,brown,calyx,capitate,clavate,cm,conical,curved,deeply,densely,depressed-spherical,diameter,elliptic,filament,flower,fruiting,glabrous,glandular,green,growth,herb,heterostylous,inflorescence,investing,lateral,leaf,leaf-opposed,length,like,live,lobed,long,long-styled,margin,membranous,minutely,mixture,mm,new,obovate,ovoid,pale,pedicel,peduncle,petiole,pinnatifid,pitted,plant,prickle,prickly,pubescent,rachi,red,reddish,reflexed,reniform,ripe,scar,scattered,shallowly,shining,short-styled,simple,slender,slightly,sparsely,spherical,stellate,stem,stigma,straight,straw-colored,strongly,style,surface,tan,terete,thin,tightly,trichome,uniseriate,usually,way,white,yellow,yellowish,½	+,.5,1-3,1.2-1.6,1.5,1.5-2,100,2-2.5,2-20,2-7,2.5-3,3-20,3-5,4-5,5,5-10,5-6,6-17,7-12,8,>,acute,adaxiall,along,alyx,anthesi,apex,arme,articulated,associated,basal,beginning,blade,brow,c.,cell,celled,colored,connivent,consistently,differentiated,difoliate,directed,distal,eed,ellipti,entire,equal,erect,few-rayed,free,frui,geminat,gland,glandular-pubescent,heavily,infructescence,later,leafy,lobe,lon,longer,loosely,lower,midpoint,midvein,minute,multangulate,multiseriate,narrowly,nflorescence,occasionally,often,older,orolla,oung,outline,pair,papillo,per,pericarp,pore,poricidal,portion,primary,ray,rest,rounded,ruit,secondary,sessile,shallow,short-stalked,shrub,single,sinuate,size,small,spreading,stalk,staminat,tall,tamen,tapering,testal,thus,tip,tissue,truncate,tube,unit,upward,vary,varying,vein,well,wice,wid,wide,wing,woody,ympodial	'',[,``,adaxially,arrangement,bud,center,characteristic,colour,corolla,dioecious,form,fruit,height,history,life,na,number,ovary,perennial,position,reproduction,seed,shape,spacing,staman,texture,value,width,{,}
716	wfo-0001031283	invalid_json_followup	52	57	15	37	42	0.288	0.7,apex,brown,cell,diameter,erect,fruit,obovate,pale,pubescent,shrub,somewhat,sprawling,surface,woody	-0.25,.7-2.3,0.1-0.15,0.4-0.5,0.5-0.7,2.2-2.8,30-40,acute,appearance,base,calyx,cm,eed,elongating,fide,give,hair-like,lateral,lo,lobe,long,markedly,mm,moore,narrowly,outgrowth,pleasant,silky,small,smelling,spreadin,tall,testa,thick,wall,wide,winged	'',[,``,abaxial,adaxial,anther,arrangement,center,characteristic,colour,corolla,filament,flower,form,growth,height,history,inflorescence,leaf,length,life,na,number,ovary,pedicel,peduncle,petiole,plant,position,rachi,reproduction,seed,shape,spacing,staman,stigma,style,texture,value,width,{,}
717	wfo-0001031287	success	147	101	69	78	32	0.469	.5,0.5-1.5,0.9-1,1,1-5,1.5-2,2-2.5,3-5,4.5-5,6-7,abaxially,acute,adaxially,anther,apex,bark,base,bi-lobed,calyx,cm,conical,corolla,dark,dendritic,densely,divergently,elliptic,elongate,erect,filament,fleshy,fruiting,glabrous,globose,green,greenish-white,internodal,leaf,lobed,long,minutely,mm,nearly,ovary,ovoid-reniform,pale,papillose,pedicel,petiole,pitted,pointed,pubescent,rounded,shoot,short,shrub,simple,somewhat,stem,stigma,strongly,style,surface,tan,thick,trichome,tuft,white,x	1-1.2,1-1.3,1-1.5,1.5-5.5,3-4,4-5,4-6,5-14,6-10-flowered,anthesi,apar,ape,attenuate,axil,bearing,berry,branch,connective,coriaceous,deflexed,deltate,dia,difoliate,eaf,edicel,eed,ellipsoid,enlarged,exserted,free,frui,geminate,knob,lamina,later,lateral,lobe,lon,lower,main,many,margin,membranous,middle,nflorescence,occasionally,older,onto,pair,papillo,planar,plurifoliate,pore,poricidal,portion,red-papillose,reddish-brow,reflexed,ruit,scar,shaped,sinus,small,spaced,tear-drop,thin,tip,tub,tube,ud,unevenly,unit,vein,widest,winged,woody,ympodial,young	6-10,abaxial,adaxial,apart,arrangement,bud,colour,diameter,flower,form,fruit,growth,height,history,inflorescence,length,life,na,number,peduncle,perennial,plant,position,rachi,reddish-brown,reproduction,seed,shape,spacing,staman,texture,width
718	wfo-0001031300	invalid_json_followup	219	133	97	122	36	0.443	-4,-6,0.2-0.4,0.2-0.5,0.3,0.3-0.6,0.5-0.9,0.5-1.5,0.5-18,0.5-2,0.7-0.9,0.8-1.5,1-2,1-4,1.5-3.5,1/3-1/2,2-3,2-6,2.5-3.2,5-merous,6-8,anther,apart,apex,apparently,bark,berry,brown-green,calyx,cell,chartaceous,cm,creeping,curved,densely,diameter,dull,elongating,erect,filament,filiform,flattened,flattened-reniform,flower,fruit,fruiting,glabrescent,glabrous,gray-green,lateral,leaf,length,lobed,long,margin,mature,maturity,membranous,mm,moderately,near,oblanceolate,orange,orange-brown,orange-green,outline,pale,pedicel,peduncle,petiole,pit,porrect,prickle,pubescent,raised,red,scar,shrub,side,simple,small,smooth,sparsely,spherical,stellate,stellate-pubescent,stem,style,surface,terete,trichome,uniradiate,white,winged,yellow,yellow-green,yellow-orange	-2.2,-5,.5,/4,0-15,0-20,0-3,0-8,0.1,0.1-0.5,0.1-0.6,0.15-0.7,0.2-0.7,0.2-1,0.3-1.3,0.6-0.8,0.6-1,0.6-1.2,0.7-1.2,1-5,1.2-1.7,1.3-2,1/2-3/4,1/6-1/4,10-30,2-,2-4,2-5.5,2.2-2.3,2.2-2.7,3-,3-4,4,4.5-6,5-15,abaxially,absent,acute,also,alyx,apar,apically,articulated,attenuate,ba,base,blade,branched,brow,bulbous,caudat,concolorous,connivent,deltate,difoliate,distance,drying,eaf,eed,equal,extending,eye,free,geminat,geniculate,hair,herbaceous,highly,infructescence,lobe,lon,longer,lower,midpoint,midvein,minute,naked,nflorescence,oblong,obtuse,older,one,open,orolla,oung,pair,pendulous,per,perfec,pericarp,poricidal,portion,prickl,prickly,primary,rarely,ray,reduced,rounded,ruit,sessile,spaced,spreading,stalk,stalked,tamen,tapering,tertiary,thin,time,tip,tube,unit,vary,vein,venation,visible,way,weakly,wide,wider,ympodial	'',[,``,abaxial,adaxial,arrangement,brown,bud,characteristic,colour,corolla,form,growth,height,history,inflorescence,life,na,new,number,ovary,perennial,plant,position,rachi,reproduction,seed,shape,spacing,staman,stigma,texture,value,width,{,}
719	wfo-0001031310	invalid_json_followup	203	111	71	132	40	0.35	1-10,1-3,1-6,1.5-4,15-40,3-10,4-10,4.5-4.8,abaxially,adaxially,anther,apex,blue,blue-purple,brown,brownish,bud,cell,chartaceous,cm,condition,corolla,covering,diameter,drying,filament,flower,forked,fresh,fruit,glabrous,globose,green,greenish,herb,lateral,leaf,light,margin,membranous,minutely,mm,obtuse,odd-pinnate,ovate,ovate-elliptic,ovoid,pale,pedicel,peduncle,petiole,pilose,plant,puberulent,pubescent,rachi,rotate,seed,simple,sometimes,sparsely,stem,stigma,streak,style,terminal,testal,thick,wall,whitish,yellow	.5,0-3,0-4,0.5-3,1-2,1-5.5,2-3,2.5-5.5,2.5-8.5,4-12,5-6,5-7,5-merou,5.5-21,6-7,absent,acumen,acuminate,ag,along,alyx,apart,apparently,articulated,attenuate,axe,axillary,base,berry,blade,borne,broadly,caly,ciliate,connivent,conspicuously,cuneate,decreasing,decurrent,digestion,distal,dorsally,eaf,edge,eed,elliptic,end,enzyme,erect-decumben,especially,exceeding,extremely,flat,folded,geminat,generally,glabrou,gradually,green-white,hair,hair-like,half,high,homostylous,honeycomb-shaped,interjected,lanceolate,larger,leaflet,lengthening,less,like,living,lobe,long,lower,make,midrib,mottled,mucilaginous,multicellular,narrowly,nflorescence,orolla,ovate-lanceolate,pair,perfect,petiolule,plurifoliate,pointed,pore,poricidal,purple,removed,rosette-forming,ruit,seudostipule,shortly,singly,size,slightly,slit,small,somewhat,spaced,specimen,stamen,ste,stolo,straight,subellipsoi,subrosette-forming,subtending,tall,tamen,tem,throughout,tip,tissue,toward,tri-,tube,tuber,typically,unit,unwinged,usually,vary,wet,white,x,ympodial	'',[,\u201chair-like\u201d,``,abaxial,adaxial,arrangement,bark,calyx,center,characteristic,colour,form,fruiting,growth,height,history,inflorescence,length,life,na,new,number,ovary,perennial,position,prickle,reproduction,scar,shape,spacing,staman,subellipsoid,surface,texture,trichome,value,width,{,}
720	wfo-0001031316	invalid_json_followup	207	127	91	116	36	0.44	-2,0.1-0.2,0.3-1,0.5-2,0.8-1.8,0.9-1.3,1-5,1.5-2,2-3,3-8,4-9,5-10,5-8,5-merous,6-20,abaxial,abaxially,acuminate,acute,adaxial,almost,anther,apex,bark,berry,blue-mauve,bright,calyx,cm,cream,dark,densely,diameter,dull,elongating,entire,erect,filament,flattened-reniform,flower,fruit,fruiting,glabrescent,glabrous,gray,green,hair,lateral,leaf,length,lobed,long,margin,marking,maturity,membranous,minute,mm,moderately,multangulate,obtuse,orange,orange-brown,ovate,pale,pedicel,peduncle,petiole,porrect,purple,red-brown,scar,sessile,shrub,simple,sparsely,spherical,stalked,stellate,stellate-pubescent,stem,style,surface,terete,terminal,trichome,white,white-green,yellow,yellow-green,young	.1,/3,0.05-0.1,0.05-0.15,0.4-0.6,0.4-0.8,0.6-1,0.8-1.2,1.2-2.1,1.3-3.5,1.5-,1.5-3.5,1.5-5,1/3-1/2,1/3-2/3,2-20,2-4,2.5-8,3-10,3.5-3.8,3.8-5,4,4-7,5-15,5-6,8-11,8-12,8-25,alyx,ame,apar,apically,apparently,articulated,base,becoming,blade,branched,broad,c.,colored,concolorous,connivent,contrast,curved,difoliate,discolorous,drying,eaf,eed,eye,fifth,foliaceou,four,free,geminat,glabrou,held,herbaceous,infructescence,inward,lobe,long-acuminat,longer,lower,lowermost,mature,midpoint,naked,narrow-deltate,nflorescence,older,one,open,orolla,oung,pair,pendulous,per,perfec,pericarp,poricidal,portion,primary,ray,red-brow,reflexed,ruit,slender,smooth,sometimes,spaced,spreading,stalk,stellate-pubescen,strongly,tamen,tapering,tertiary,time,tip,tube,unarme,unarmed,unequal,unit,usually,variously,vary,vein,venation,visible,way,whitish,wide,ympodial	'',[,``,apart,arrangement,bud,center,characteristic,colour,corolla,form,growth,height,history,inflorescence,life,na,new,number,ovary,perennial,plant,position,prickle,rachi,reproduction,seed,shape,spacing,staman,stigma,texture,value,width,{,}
721	wfo-0001031333	invalid_json_followup	194	122	84	110	38	0.433	0.1-0.5,0.5,1-1.5,1-4,1.2-2,1.5-2,2.5-3,3-4,30-40,7-10,7-9,?,acuminate,acute,anther,anthesi,apart,apex,berry,bilobed,broadly,brown,calyx,capitate,cm,conical,densely,diameter,ellipsoidal,elliptic,entire,filament,flattened,flower,glabrescent,glabrous,globose,golden,green,greenish,growth,immature,inflorescence,lamina,long,margin,matte,minutely,mm,narrowly,new,nodding,ovate,pale,pedicel,peduncle,pentagonal,petiole,pitted,pubescent,pubescent-papillate,reniform,scar,simple,somewhat,sparsely,stellate,stem,stigma,style,surface,terminal,thin,trailing,triangular,trichome,unevenly,uniseriate,vein,vine,white,woody,x,yellow	+,.5,1-5,1.5,1.5-1.7,1/2,2,2-3,2.7-7,3/4,5-7,5-8,5-merou,50,<,>,abaxially,adaxiall,adaxially,adjacent,ag,almost,alyx,appearing,ark,articulated,base,branche,branched,cell,clustered,collection,composed,crea,cupped,denser,eaf,eed,exserted,free,fruting,glabrescen,half,high,ilament,leaving,lengthening,less,like,lobe,lobed,lower,m.,many,membranous,mere,minute,near,nflorescence,occasionally,older,orolla,outline,pair,papillat,peg,penden,per,perfect,pericarp,planar,plurifoliat,pore,poricidal,portion,primary,quadrate,rest,rhachi,ruit,sinus,slightly,slit,small,soon,splitting,ste,striped,strongly,tangled,tem,testal,thickened,time,tip,truncate,tube,twining,ud,undersurface,undulation,unequal,unit,upper,vary,venation,way,whitish,yellowish,ympodial	'',5-merous,[,``,abaxial,adaxial,arrangement,bark,bud,center,characteristic,colour,corolla,form,fruit,fruiting,height,history,leaf,length,life,na,number,ovary,plant,position,prickle,rachi,reproduction,seed,shape,spacing,staman,texture,value,width,{,}
722	wfo-0001031333	invalid_json_followup	194	123	88	106	35	0.454	+,0.1-0.5,0.5,1-1.5,1-4,1.5-2,2.5-3,2.7-7,3-4,30-40,7-10,7-9,?,acuminate,acute,almost,anther,apex,bark,berry,bilobed,broadly,brown,calyx,capitate,cm,conical,corolla,cream,densely,diameter,ellipsoid,elliptic,entire,filament,flattened,flower,fruiting,glabrescent,glabrous,globose,golden,green,greenish,growth,immature,inflorescence,lamina,lobed,margin,matte,membranous,minutely,mm,narrowly,new,nodding,ovate,pale,pedicel,peduncle,petiole,pitted,pubescent,pubescent-papillate,reniform,rotate-stellate,scar,simple,somewhat,sparsely,stellate,stem,stigma,style,surface,terminal,thin,trailing,triangular,trichome,unevenly,uniseriate,vein,vine,white,whitish,woody	.5,1-5,1-5-2,1.5,1.5-1.7,1/2,2,2-3,3,3/4,5-7,5-8,5-merou,50,<,>,abaxially,adaxiall,adaxially,adjacent,ag,alyx,anthesi,apart,appearing,articulated,base,branche,branched,cell,clustered,composed,cupped,denser,eaf,eed,exserted,free,glabrescen,half,high,ilament,leaving,lengthening,less,like,lobe,long,lower,m.,many,mere,minute,near,nflorescence,occasionally,older,orolla,outline,pair,papillat,peg,penden,per,perfect,pericarp,planar,plurifoliat,pore,poricidal,portion,primary,quadrate,rest,rhachi,ruit,sinus,slightly,slit,small,soon,spaced,splitting,striped,strongly,tangled,testal,thickened,time,tip,truncate,tub,tube,twinin,ud,undersurface,undulation,unequal,unit,upper,vary,venation,way,wide,yellowish,ympodial	'',[,``,abaxial,adaxial,arrangement,bud,center,characteristic,colour,form,fruit,height,history,leaf,length,life,na,number,ovary,perennial,plant,position,prickle,rachi,reproduction,seed,shape,spacing,staman,texture,value,width,{,}
723	wfo-0001031359	invalid_json_followup	166	110	68	98	42	0.41	.25,0.5-1,0.5-6,1-4,1.2-1.6,1.2-2.5,1.3-1.6,3-3.5,5-angled,6-7,acuminate,anther,apart,apex,attenuate,axil,bark,beneath,berry,bi-lobed,brown,calyx,cm,corolla,curled,dark,dull,elliptic,filament,flattened-reniform,fruiting,glabrous,globose,green,lateral,leaf,lobed,main,margin,membraneous,mm,narrowly,nearly,obovoid,opposite,ovary,pedicel,petiole,pitted,plant,round,scar,shrub,simple,stem,stigma,style,surface,tan,tapering,trichome,tuft,undulate,uniseriate,vein,white,yellow,yellow-orange	.02,.5,/4,0.75-1,1.1-1.6,1.5-2,1.6-2.8,1.9-2.3,12-21,2.5-3,3.6-8.8,5-30-flowered,5-7,5.3-7.5,angle,anthesi,apiculate,appearing,ba,base,beginning,broadly,deflexed,dia,differing,difoliate,distal,dried,eaf,edicel,eed,evenly,extending,free,geminat,incrassate,inflorescenc,internodal,interpetalar,lamina,live,lobe,lon,long,lower,major,middle,minor,minutely,near,nflorescence,occasionally,often,older,one,originating,outline,pair,paler,papillae,papillo,papillose,pit,planar,pore,poricidal,portion,reflexed,ridged,ripe,ruit,rusty,shaped,shiny,sinus,size,slender,slightly,somewhat,spaced,specimen,straight,strongly,tall,tear-drop,tip,triangular,tub,tube,ud,unit,way,white-lenticellat,widest,woody,x,ympodial,young	'',5-30,[,``,abaxial,adaxial,alternate,arrangement,bud,cell,center,characteristic,colour,diameter,flower,form,fruit,growth,height,history,inflorescence,length,life,na,new,number,peduncle,perennial,position,prickle,rachi,reproduction,seed,shape,spacing,staman,texture,value,white-lenticellate,width,{,}
724	wfo-0001031362	success	138	103	70	68	33	0.507	.2,.5,0.5-1,1-1.1,1-3,1-4,2-2.5,3-6,?,acute,anther,apex,bark,base,brown,calyx,cell,closely,cm,corolla,dendritic,densely,ellipsoid,filament,flattened-reniform,fruiting,glabrous,globose,golden,incrassate,internodal,lanceolate,leaf,lobed,margin,minutely,mm,nearly,nodding,opposite,orange-red,ovary,pale,papillose,pedicel,petiole,pitted,pubescent,pubesent,rectangular,red,rounded,scar,shiny,shrub,simple,slender,small-capitate,somewhat,spaced,sparsely,stem,stigma,style,subshrub,surface,tan,thin,trichome,white	.3,0.4-0.5,0.7-1,1-1.5,1-3-flowered,1.5-2,3-4,abaxially,adaxially,along,anthesi,appearance,attenuate,berry,branch,bushy,conical,denser,dia,eaf,edicel,eed,erect,exceeding,exserted,flattened,free,giving,golden-brow,inflorescenc,lamina,lateral,like,lobe,lon,long,long-triangular,lower,main,middle,nflorescence,older,outline,overlappin,packed,pair,papillo,pericarp,planar,plurifoliat,pore,poricidal,portion,rest,ruit,shaped,straight,tear-drop,tip,tube,ud,unit,vein,widest,woody,x,ympodial,young	abaxial,adaxial,arrangement,bud,center,colour,diameter,flower,form,fruit,golden-brown,growth,height,history,inflorescence,length,life,na,new,number,overlapping,peduncle,plant,plurifoliate,position,rachi,reproduction,seed,shape,spacing,staman,texture,width
725	wfo-0001031363	success	198	94	63	135	31	0.318	0-6,1-2.2,1-5,1.1-1.6,1.5-4,10-11.5,3-7,4.5-7.5,5-10,7-12,acicular,adaxially,anther,apex,articulated,bark,base,broadly,brown,calyx,chartaceous,cm,corky,densely,diameter,erect,extra-axillary,flower,fruit,fruiting,furrowed,glabrous,globose,green,inflorescence,leaf,length,lobed,margin,mm,moderately,obtuse,ovate,pale,pedicel,peduncle,perennial,petiole,plant,prickle,pseudo-racemose,purple,rhizomatous,shallowly,shrub,simple,sparsely,stellate,stellate-pubescent,style,surface,throughout,yellow	%,.3,.5,0-15,0-3,0-30,0.3-0.5,0.3-0.6,0.3-0.7,0.4-0.5,0.4-0.8,0.5-0.8,0.5-0.9,0.5-1,0.7-1.5,0.9-1.6,1-2,1-6,1-locular,1.1-1.4,1.6-2.1,10-12,13-25,2-3,2-foliate,2.3-2.5,2.5-7.5,3-4,3-5,3.5-5.5,3.5-6,30,4-7,4-8,5-6,5-7,5-8,5-merou,6-13,6-8,6.5-11,6.5-8.5,80-120,abaxially,absen,absent,across,acute,adaxiall,adult,alyx,andromonoecious,apart,attenuate,axe,ba,blade,branch,branche,cross-section,cylindrica,decimetre,deltate,directed,distall,distributed,dm,eaf,eed,eglandular,exocarp,finger,functional,geminat,gland-tipped,hair,half,heterostylous,incomplete,index,juicy,juvenile,lamina,lateral,less,lobe,lobing,long,longer,lower,mature,mesocarp,midpoint,midvein,minute,moist,nflorescence,oblique,orolla,pair,part,per,placenta,pore,porrect,present,ray,ruit,semi-circula,septum,sessile,short,side,spaced,stalks-0.1,stellae,straight,tal,tamen,tem,thick,time,transparent,tube,unarme,unarmed,unbranched,unit,upper,vary,vein,weakly,wide,x,ympodial	5-merous,abaxial,adaxial,arrangement,bud,cell,center,colour,corolla,filament,form,growth,height,history,life,na,new,number,ovary,position,reproduction,scar,seed,shape,spacing,staman,stem,stigma,texture,trichome,width
726	wfo-0001031372	invalid_json_followup	192	124	84	108	40	0.438	0,0.2-0.8,1,1-2,10-14,2-5,2-7,2.5-4.5,3,5-10,7-10,abaxially,adaxially,anther,apart,apex,articulated,base,broadly,brown,calyx,central,closely,cm,coarsely,compressed,dark,densely,diameter,elliptic,extra-axillary,filament,flattened,flower,foliaceous,fruit,fruiting,glabrous,globose,green,laterally,leaf-opposed,length,light,lighter,lilac,long,margin,minutely,mm,obtuse,ovate,pedicel,peduncle,perennial,petiole,pitted,prickle,prickly,pubescent,rachi,recurved,repand,several,simple,spaced,sparsely,spreading,star,stellate,stellate-pubescent,stellate-woolly,stelliform,stem,stigma,style,thin-textured,ultimately,unbranched,weakly,white,woolly,x,yellow	-1.5,0-15,0.05-0.2,0.4-0.6,1.5,1/4-1/3,10,10-12,10-30,2-2.5,2-foliate,2.5,25-30,4-5,5-20,6-9,7,8-10,8-15,abaxiall,accrescent,acute,acute-,adaxiall,along,armed,axe,ba,blade,blunt-tipped,broad-based,capitat,completely,concealing,connivent,covering,cylindrical,decurrent,deltoid,directed,distal,distally,eaf,eed,entirely,enveloping,female-sterile,geminat,glabrou,hair,interwoven,lanceolate,large,lateral,lobe,longer,lower,m.,main,midpoint,midrib,minute,mostly,much,multiseriate,nflorescence,often,onto,orolla,ovate-lanceolate,perfect,pore,present,probably,ray,reaching,reddish,round-tipped,ruit,scattered,short,short-styled,shorter,side,similar,soft-wooded,somewhat,stalk,ste,stellae,stipitate,tal,tamen,tem,termination,time,tube,unarmed,unit,vary,vein,well-developed,whitish,wide,widely,winged,ympodial,young	'',[,``,abaxial,adaxial,arrangement,bark,bud,capitate,center,characteristic,colour,corolla,form,growth,height,history,inflorescence,leaf,life,na,new,number,ovary,plant,position,reproduction,scar,seed,shape,spacing,staman,surface,tall,texture,trichome,value,width,{,}
727	wfo-0001031389	invalid_json_followup	242	125	87	155	38	0.36	0-0.5,0-1,0-2,0.25-0.75mm,0.4-1.8,0.5-1,0.8-2.5,1-1.5,1-5,1.5-2.5,4-5.5,5-8,5.5-8,6-9,8-15,accrescent,acicular,acute,almost,andromonoecious,anther,apex,articulated,base,calyx,chartaceous,cm,dark,densely,diameter,entire,extra-axillary,filament,flower,fruit,fruiting,glabrous,globose,green,hair,inflorescence,lanceolate,leaf,length,lilac,margin,minutely,mm,obtuse,ovate,pale,pedicel,peduncle,perennial,perfect,petiole,pitted,plant,prickle,pseudo-racemose,pseudo-umbellate,purple,rachi,red,reddish,reniform,reticulate,reticulately,rhizomatous,rotate-stellate,scattered,shrub,simple,sometimes,somewhat,sparsely,stellate,stellate-pubescent,stigma,style,surface,tip,weakly,white,x,yellow,yellowish	%,0-0.1,0-0.4,0-0.6,0-10,0-3,0.05-0.1,0.25-0.4,0.25-0.5,0.3-0.5,0.3-0.6,0.3-0.8,0.4-0.6,0.5-1.5,0.5-3,0.6-0.7,0.65-1,0.9-4.5,1-2,1-3,1-4,1-locular,1.3-2.4,1.5-3,1.5-4,1.5-5,1.8-3.5,1.9-2.2,11-16,14-18,14-30,2-6,2-foliate,2.5-13,20-60,4-5,4-7,4-8,5-merou,6-10,6-12,6-7,7-8,abaxially,absen,absent,across,adaxially,adult,alyx,apart,apparen,axe,ba,becoming,blade,branch,branche,brown,capitat,confined,connivent,cuneate,cylindrical,decimetre,deltate,directed,distall,distally,distributed,dm,eaf,eed,eglandular,erect,exocarp,finger,first,functional,geminat,gland-tipped,half,heterostylous,homo-,incomplete,interpetalar,juicy,juvenile,lamina,lateral,less,lobe,lobed,long,longer,loosely,lower,markedly,mature,mesocarp,mid-point,midpoint,midrib,midvein,minute,moderate,narrowly,nflorescence,oblique,often,orolla,pair,part,per,placenta,plump,pore,porrect,present,ray,rostrate,ruit,septum,sessile,shallowly,short,solitary,spaced,sparse,stalk,stellae,straight,succulent,summit,tal,tamen,tem,thick,thicker,thicknes,throughout,tightly,time,tissu,tissue,triangular,tube,unarme,unarmed,unbranched,unit,upper,vary,wide,ympodial	'',5-merous,[,``,abaxial,adaxial,arrangement,bark,bud,capitate,cell,center,characteristic,colour,corolla,form,growth,height,history,life,na,new,number,ovary,position,reproduction,scar,seed,shape,spacing,staman,stem,texture,trichome,value,width,{,}
728	wfo-0001031394	invalid_json_followup	217	115	64	153	51	0.295	3,4,abaxially,accrescent,acicular,acute,alternate,anther,apex,calyx,cm,crenulate,diameter,eventually,extra-axillary,filament,finely,flattened,flower,fruit,fruiting,glabrous,gland-tipped,globose,hair,hyaline,length,light,margin,minute,mm,numerous,ovate,pedicel,peduncle,petiole,pilose,pitted,plant,prickle,pubescent,purple,rachi,recurved,red,short,simple,sometimes,sparse,stellate,stem,stigma,stipitate-glandular,style,subreniform,subshrub,tan,taprooted,thin-textured,unbranched,white,x,yellow,yellow-orange	-celled,-rayed,0.2–0.4,0.3,0.3–1.5,0.5,0.5–1,0.6–1.6,0.8,1,1.1–1.6,1.2–3.2,1.4–2.1,1.7–4.5,1/2,1/3,1–,1–1.5,1–2,1–3,1–4,2,2-foliat,2.2–2.5,2.5–3,2–3,2–3-celled,2–3.2,2–4,3.7–7.6,33–80,3–4,3–5,3–6,4–8,5,5–8,64,6–11,6–8,9–13,=,?,adaxially,additional,almost,apart,apparently,appearing,armed,articulated,axe,ba,basal,base,beginning,blade,bottom,branch,branched,broadly,bulbous,caudate,curved,cylindrical,densely,directed,distal,distall,eaf,eed,enlarging,even,fertile,free,glabrou,gland-tippe,glandular-pilosulose,glandular-pubescent,halfway,investing,lanceolate,leafy,least,less,lobe,lon,long,longest,lower,main,male,many,maturity,midpoint,midrib,n,narrowly,nflorescence,one,orolla,overtopped,per,pore,pubescence,quite,reaching,reflexed,rounded,ruit,scattered,sessile,shorter,side,similar,single-celled,slightly,small,smaller,somewhat,spaced,spreadin,staminate,stellae,sterile,stout,straight,subcordate,tall,taman,tem,terminal,thick,thickened,time,tip,tooth,triangular,truncat,tube,unit,usually,variable,vary,vein,wide,ympodial,±,–1.5,–2,–3,–5,–6	'',0.2-0.4,0.3-1.5,0.5-1,1-3,1-4,1.2-3.2,1.4-2.1,1.7-4.5,2-4,3.7-7.6,4-8,5-8,[,``,abaxial,adaxial,arrangement,bark,bud,cell,center,characteristic,colour,corolla,form,growth,height,history,inflorescence,leaf,life,na,new,number,ovary,position,reproduction,scar,seed,shape,spacing,staman,surface,texture,trichome,truncate,value,width,{,}
729	wfo-0001031400	success	161	79	55	106	24	0.342	0.25-0.8,0.7-6,1-4,1.2-2,1.5-5,10-11,4-17,4-6.5,7-28,abaxial,acute,apex,branched,cell,cm,corolla,cyme,dark,deeply,diameter,dichasial,dichasially,distal,ebracteate,filament,flower,globose,green,green-white,half,herbaceous,leaf,linear,linear-lanceolate,mm,monochasial,mucilaginous,odd-pinnate,ovoid,pedicel,peduncle,perennial,petiole,plant,puberulent,rachi,seed,stellate,stigma,style,subglabrous,tone,violet,white,yellow	-3,0.4-1.7,0.6-1.8,0.8-1.1,1,1-,2,2-3,2-5,2-9,3-6-foliat,4-,4-13,4-7,5-12.5,6-23,7-25,abaxially,abruptly,absen,acumen,adaxially,apical,apically,apiculate,articulate,base,calyx,connate,covering,cuneate,decurrent,dehiscent,digestion,diminishing,dorsally,eaf,edge,eed,emoval,enzyme,exceeding,flat,folded,forked,forming,generally,globo,hair-like,honeycomb,interjected,introrse,lateral,leaflet,living,lobe,lon,long,lower,lunat,make,maturing,nflorescence,nther,oblique,oblong,occasionally,often,orolla,pair,pattern,perfect,plan,poricidally,proximal,reveal,ruit,sessile,seudostipule,short,side,size,slit,specimen,stamen,straight,stripe,structure,tal,tem,terminal,testal,thick,throughout,tip,toward,trilobe,tuber-bearing,typically,unit,vary,wall,wide,without,ympodial,¼	adaxial,anther,arrangement,center,colour,form,fruit,growth,height,history,inflorescence,length,life,na,number,ovary,position,reproduction,shape,spacing,staman,surface,texture,width
730	wfo-0001031401	invalid_json_followup	182	109	76	106	33	0.418	0.6-1.2,1-6,1.5-2,2-2.4,2-5,2.5-4,3.5-4,7-9,8-10,abaxial,abaxially,acute,adaxial,anther,apex,bark,bi-lobed,black,brown,calyx,cm,conical,corolla,dark,dendritic,densely,diameter,elliptic,filament,flattened,flower,fruit,fruiting,globose,golden,golden-yellow,growth,leaf,lenticular,lobed,matted,minutely,mm,narrowly,new,occasionally,ovary,pedicel,pericarp,petiole,pitted,pubescent,purplish-black,pyramidal,reddish-brown,rounded,roundish,scar,short,shrub,small,somewhat,stem,stigma,strongly,style,surface,tapering,terminal,thin,tree,tree-like,trichome,violet,white,winged	0.5,0.8-1.2,1,1-1.4,1-1.5,1.1-3,1/2,3,3/4,5,5-7,5-9,adaxially,age,along,anthesi,apical,appearing,attenuate,axi,basal,base,becoming,berry,blade,branch,branching,clearly,deciduous,deflexed,deltoid,denser,dichasial,differentiated,drying,eaf,ecuador,ecuadorian,edicel,eed,ew,exserted,finely,fork,free,glabrous,impressed,inserted,lateral,less,lobe,long,long-triangular,lower,m.,mesophyll,monochasia,near,nflorescence,noddin,nodding,node,often,older,outline,overtopping,pair,papillo,per,planar,plurifoliate,pore,poricidal,portion,prominently,puberulent,pubescen,raised,ruit,secondary,shiny,shoot,sleev,slit-like,sometimes,sparsely,specimen,stamen,ste,tall,time,tip,tub,tube,ud,unit,usually,vein,visible,way,wide,woody,x,yellow,ympodial,young	'',[,``,arrangement,bud,center,characteristic,colour,form,height,history,inflorescence,length,life,margin,na,number,peduncle,perennial,plant,position,prickle,rachi,reproduction,seed,shape,spacing,staman,texture,value,width,{,}
731	wfo-0001031402	success	200	99	67	133	32	0.335	0-0.2,0-0.3,0.2-0.4,0.5-1,0.5-1.3,1-3,1.5-2,10-38,2-2.5,2-8,3-5.5,7.5-8.5,acicular,acute,andromonoecious,anther,apex,articulated,base,calyx,chartaceous,cm,contiguous,deeply,diameter,entire,filament,flower,fruit,fruiting,glabrous,globose,green,herbaceous,inflorescence,leaf,leaf-opposed,length,linear,lobed,margin,mm,moderately,nearly,ovate,ovoid,pedicel,peduncle,petiole,plant,prickle,pseudo-umbellate,purple,rachi,resprouter,rotate-stellate,shallowly,simple,single-flowered,sparsely,stellate-pubescent,stem,stigma,style,unknown,x,yellow	%,0-3,0.3-0.6,0.3-1.1,0.4-1.2,0.5-0.7,0.5-2.6,0.6-1.2,0.7-1.4,0.8-2.5,0.8-3,1,1-15,1-2,1-4,1-5,1.5-2.5,10-15,10-18,14-18,2-3,2-4,2-6,2-foliate,2.2-12,3-15,3-4,3-5,4-7,4-8,5-40,5-merou,6-9,7-15,8-10,abaxially,absen,absent,abundant,accrescent,across,adaxiall,adaxially,adult,alyx,apart,armed,axe,ba,blade,branche,capitat,color,confined,connivent,cuneate,cylindrical,deltate,densely,directed,distall,distributed,dm,dult,eaf,eed,eglandular,erect,finger,functional,geminate,glabrou,gland-tipped,hair,half,heterostylous,index,interpetalar,lamina,lateral,lobe,lobing,lon,long,longer,lower,mature,midpoint,midrib,midvein,minute,narrowly,nflorescence,oblique,obtuse,orolla,part,per,pore,porrect,possibly,present,projecting,ray,ripe,ruit,sessile,short,shorter,side,spaced,sprawling,stage,stellae,straight,strongly,tal,tamen,thick,throughout,time,tissue,tube,unarmed,unbranched,unit,uvenile,vary,vein,weakly,wide,winged,ympodial	5-merous,abaxial,adaxial,arrangement,bark,bud,capitate,cell,center,colour,corolla,form,growth,height,history,life,na,new,number,ovary,perennial,position,reproduction,scar,seed,shape,spacing,staman,surface,texture,trichome,width
732	wfo-0001031480	invalid_json_followup	237	135	104	133	31	0.439	/3,0-0.5,0.1-0.4,0.4-0.8,0.5-2,0.8-1,1-1.5,1-2,1-3,1.8-3,2-,2-6,3-10,3.5-7,5-8,5-merous,6-30,6-8,abaxial,abaxially,acute,adaxial,andromonoecious,anther,apart,apex,articulated,bark,base,branched,bright,calyx,cell,cm,curved,densely,diameter,dull,ellipsoid,elongating,entire,erect,filament,flattened-reniform,flower,fruit,fruiting,glabrescent,glabrous,lateral,leaf,length,lobe,lobed,long,margin,mature,maturity,mauve,minutely,mm,obtuse,orange-brown,outline,ovate,pale,pedicel,peduncle,petiole,pit,plant,porrect,prickle,purple,raised,red,red-brown,red-green,red-yellow-green,reticulate,scandent,scar,shallowly,shrub,simple,small,smooth,spherical,stalked,stellate,stellate-pubescent,stem,straight,style,surface,terete,terminal,thick-chartaceous,trichome,unarmed,variously,way,weakly,yellow	-0.25,-2,0,0-1,0-2,0-30,0-5,0.1,0.1-0.3,0.15-0.3,0.2-0.35,0.4,0.5-,0.6-0.8,0.7,0.8,1-1.3,1-4,1.5-2.2,1.7-2.2,1/2,1/3,1/4,1/6-1/5,2-2.7,2-3,2-5,3,3-6,3-7,4-5,4-6,6-13,7-8,8-12,acuminat,alyx,apar,apically,apparently,ba,berry,blade,branching,broad-deltate,cream,cuneate,dark,deltate,difoliate,discolorous,distal,distance,drying,eaf,eed,elongate,equal,extending,eye,faint,flattened,free,geminat,glandular,green,hair,hermaphrodite,heterostylous,inconspicuous,infructescence,long-styled,longer,lower,lowermost,marking,midpoint,midvein,moderately,naked,near,nflorescence,often,older,one,open,orolla,oung,pair,pendulous,per,pericarp,persistent,poricidal,portion,prickly,primary,pubescent,ray,red-brow,reduced,rounded,ruit,sessile,short-styled,shorter,side,slender,slightly,somewhat,spaced,sparsely,spreading,stalk,staminat,tamen,tapering,tertiary,time,tip,truncate,tube,unarme,unit,upper,vary,vein,venation,visible,wide,woody,ympodial,young	'',[,``,arrangement,bud,center,characteristic,colour,corolla,form,growth,height,history,inflorescence,life,na,new,number,ovary,position,reproduction,seed,shape,spacing,staman,stigma,texture,value,width,{,}
733	wfo-0001031482	success	275	116	87	188	29	0.316	-150,-16,-18,.5-5,0.2-0.3,0.5-1.5,0.6-1.8,0.7-1.3,1-4.5,1.2-1.5,2.5-10,2.5-4,4-13,4-5,4-6,8,abaxially,adaxially,anther,apart,bark,becoming,blue,brown,bud,calyx,cm,continued,corolla,deltoid,densely,diameter,due,elliptic,elongate,entire,farinose,filament,flower,fruit,fruiting,grayish,green,growth,honeycombed,lanceolate,lateral,leaf,length,margin,mm,moderately,mostly,oblong-orbicular,pale,pedicel,peduncle,perfect,petiole,possibly,pubescent,rachi,reniform,reticulate-punctate,ripe,rotate-stellate,scabridulous,shrub,simple,small,somewhat,stellate,stem,stigma,style,subcapitate,subconical,subglobose,suborbicular,subspherical,terminal,tomentose,tree,velutinous,x,yellow,yellowish	-0.06,-0.2,-0.4,-0.5,-0.6,-1.4,-5,-5.3,-5.5,-6,.04-0.1,.04-0.35,.04-0.5,.06-1,.2-1.6,.5-0.7,.5-3.5,/20-,0-0.2,0-0.3,0-0.4,0-0.6,0-0.7,0.02-0.03,0.02-0.04,0.02-0.06,0.03-0.04,0.03-0.3,0.04-0.3,0.04-0.4,0.04-0.5,0.04-0.6,0.04-1.4,0.3-0.5,1,1.2-3,1.3-4,1.4-2.2,1.6-2.8,1.9-2.5,1/10-1/4,1/2-2/3,2-3.3,2-3.5,2-4.6,2-4.7,2.5-4.5,3.5-4.8,3.7-8,3/4,4-7,4.5,5-7,5-80,5-merou,6-11,6-16,9-13,accrescent,acuminate,acute,adaxiall,ag,along,alyx,anthesi,ape,apex,apical-lateral,apparently,appressed,articulated,attenuate,axe,axillary,ba,base,berry,beyond,blade,blunt-tipped,branch,branched,commonly,decurrent,dehiscing,directed,eaf,echinoid,eed,ellipti,evident,exserted,extend,few-rayed,free,glabrescent,glabrous,granular-tomentose,hair,high,immature,inserted,interpetalar,introrse,irregular,lacking,large,later,line,lobe,lobed,long,long-stalked,longer,longitudinal,lower,m.,main,midvein,minute,mixed,multangulate,multiseriate,narrowly,nearly,nflorescence,oblong,obtuse,occasionally,often,older,orolla,ovate,overlapping,persistent,plurifoliate,pore,porrect-stellate,present,prominent,pubescence,rather,ray,relatively,ribbed,rounded,ruit,runk,sessile,short-,short-stalked,side,slender,slightly,slit,sometimes,spaced,sparsely,splitting,stalk,stamen,stelliform,subcampanulate,sulcate,suture,tamen,terete,testa,thick,thin,time,tissue,toward,tube,unarme,unarmed,unevenly,unit,usually,vary,vein,way,weakly,white,wide,ympodial,young	0.5-3.5,15-80,abaxial,adaxial,arrangement,colour,form,height,history,inflorescence,life,na,new,number,ovary,perennial,plant,position,prickle,reproduction,scar,seed,shape,spacing,staman,surface,texture,trichome,width
734	wfo-0001031483	success	154	77	46	108	31	0.299	.5,/2,0.5-2,1-2,2-3,acuminate,acute,almost,anther,apart,apex,base,clavate,cm,corolla,dry,filament,filiform,flower,fresh,glabrous,green,indistinct,leaf,linear,lobed,mm,oblanceolate,obovate,opposite,ovary,ovoid-reniform,pale,pedicel,petiole,shape,shrub,slender,slightly,stigma,style,subshrub,tan,turbinate,way,white	0,0.5,1,1.1-2.5,1.2-1.4,1.7-5.5,1/3,11-20.5,2-2.5,2.5-3.2,3-4,3-8-flowered,6-10,7-10,across,anew,anthesi,attenuate,ba,bearing,beginning,beneath,berry,blade,ca,caly,calyx,continuous,cork,corky,decurrent,deflexed,deltoid,dia,difoliate,distal,eaf,edicel,eed,end,evenly,exserted,free,fruiting,fusiform,geminat,indistinc,internode,larger,lateral,lea,lenticellate,less,lobe,long,lower,main,major,markedly,minor,minutely,nflorescence,oblong,obovoid,often,orbiculate,pair,paler,papillo,papillose,per,planar,pointed,pore,poricidal,portion,prominent,quite,raised,rounded,ruit,scar,shaped,short,short-triangular,simple,somewhat,soon,spaced,stem,straight,strongly,tall,tapering,tear-drop,third,tip,tube,ud,unit,variable,vein,widest,wing,winged,woody,x,ympodial	3-8,abaxial,adaxial,alternate,arrangement,colour,diameter,form,fruit,greyish,growth,hair,height,hirsute,history,inflorescence,length,life,na,number,peduncle,plant,position,rachi,reproduction,seed,spacing,staman,surface,texture,width
735	wfo-0001031486	success	166	138	107	59	31	0.645	0.2-0.7,1-4,1.5-4,1.8-3.3,11-37,2-3,3-26,3.4-10,3.5-6.5,5-10,5-16,abaxially,abruptly,adaxially,almost,apex,apical,apically,articulate,base,branched,cell,cm,commonly,cordate,corolla,covering,cuneate,cyme,darker,deep,dehiscent,diameter,dichasial,dichasially,diminishing,distal,dorsally,ebracteate,elliptic,filament,flat,flower,folded,forked,globose,green,green-white,hair-like,half,herbaceous,honeycomb,interjected,introrse,lateral,leaf,leaflet,less,light,lightly,make,maturing,mm,monochasial,mucilaginous,oblique,obovate,odd-pinnate,often,ovate,ovoid,pattern,pedicel,peduncle,pentagonal,perennial,petiole,plant,poricidally,proximal,puberulent,pubescent,pure,purple,rotate,seed,short,size,slit,sometimes,spot,stigma,strigose,stripe,style,terminal,testal,thick,throughout,tinged,tip,toward,usually,wall,white,yellow,¼	0-1.,0-4.5,0.9-1.7,1-2.2,1-3,1.5-6,2-3.5,2-6,2.5-3.2,2.8-6,3-6-foliat,3.5-8,7.5-22,9-37,acumen,acuminate,acute,calyx,connate,decurrent,digestion,eaf,edge,eed,emoval,enzyme,exceeding,generally,globo,highly,living,lobe,lon,long,long-attenuate,lower,lunat,nflorescence,nther,orolla,pair,perfect,petiolule,plan,reveal,ruit,seudostipule,specimen,stamen,straight,tal,tem,throughou,tuber-bearing,typically,unit,vary,wide,ympodial	0-15,abaxial,adaxial,anther,arrangement,colour,dehiscence,form,fruit,growth,height,history,inflorescence,length,life,lunate,mucilaginousnes,na,number,ovary,position,pseudostipule,rachi,reproduction,shape,spacing,staman,surface,texture,wet,width
736	wfo-0001031492	invalid_json_followup	175	107	71	104	36	0.406	0.5,0.7-1.3,0.9-1.1,1.5-1.8,10-15,2-10,2-3,3-5,4-4.5,6-8,abaxially,adaxially,anther,apex,attenuate,bark,bi-lobed,calyx,cm,conical,corolla,dark,densely,diameter,drying,echinoid,elliptic,filament,flattened,flower,fruit,fruiting,glabrous,globose,grey,growth,lateral,leaf,lenticular,lightly,lobed,medium,minutely,mm,narrowly,ovary,pedicel,petiole,pitted,pubescent,purplish-black,pyramidal,reddish-brown,scar,scattered,shiny,shrub,size,sometimes,sparsely,stem,stigma,style,surface,tapering,terminal,tree,tree-like,trichome,violet,winged	.5,/4,08,1-1.3,1-1.5,1.3-2,1.5-2.5,2-5,20,3-4,4-10,8-11,8-9,absent,acuminate,acute,age,anthesi,apical,appearing,axe,ba,basal,base,becoming,beneath,berry,bitter,branching,dbh,deciduous,decurrent,deltoid,dendritic,denser,distinguishable,dull,eaf,edicel,eed,erect,ew,exserted,free,golden,inserted,juice,lamina,lobe,long,lower,m.,monochasia,nflorescence,nodding,occasionally,older,overtopping,pair,papillo,per,pericarp,planar,plurifoliate,pore,poricidal,portion,predominantly,prominent,rather,remaining,ruit,scarcely,secondary,shoot,short,sleeve,slightly,slit-like,somewhat,stamen,ste,sticky,strongly,sunken,tall,thin,time,tip,tub,tube,ud,undersurface,unit,upper,upturned,vein,way,wide,woody,x,ympodial,young,younger	'',[,``,abaxial,adaxial,arrangement,bud,cell,center,characteristic,colour,form,height,history,inflorescence,length,life,margin,na,new,number,peduncle,plant,position,prickle,rachi,reproduction,seed,shape,spacing,staman,texture,value,width,{,}
737	wfo-0001031497	invalid_json_followup	264	127	90	174	37	0.341	0.1-0.2,0.1-0.8,0.2-0.5,0.5-2.5,1-2,1.2-2,1.5-2.5,1.5-4,12-30,2.5-5,3-10,3-5,3-9,4-12,4.5-7,5-15,6-13,6-9,abaxially,actinomorphic,adaxially,anther,apart,apex,articulated,base,broadly,calyx,campanulate,cm,compressed,deciduous,deeply,deltoid,densely,depressed-deltoid,diameter,erect,extra-axillary,filament,flower,fruit,globose,green,incised,inflorescence,laterally,leaf,length,lenticular,light,lobe,margin,minutely,mm,orange,ovate,ovate-lanceolate,pedicel,peduncle,perennial,perfect,petiole,pitted,prickle,pubescent,purplish,rachi,recurved,red,reniform-ovate,simple,sometimes,spreading,stellate,stellate-pubescent,stem,stigma,strongly,style,surface,tan,thickened,thin-textured,unbranched,weakly,white,x,yellow,zygomorphic	-1.4,-30,-35,-7,.1,.1-0.2,0.05-0.2,0.2-0.4,0.4-1,1,1.2-2.4,1/3,1/5-1/3,10-25,14-,15-,18-25,2-5,2-foliate,2.25-3,2.25-4.75,2.5-4,2.8-3.5,20-30,3-15,3-6,4-locular,4.5-9,5-8,7-12,acuminate,acute,along,ape,appearance,appearing,appressed,attenuate,axe,ba,berry,blade,broa,c.,cast,cauline,clearly,close,closely,coarsely,connivent,curved,cylindrical,dense,denser,directed,distal,distall,distributed,downcurved,due,eaf,eed,entire,equaling,essentially,external,falcate,female-sterile,foliar,geminat,giving,glabrescent,glabrous,hair,high,interlobal,intermixed,lanceolate,large,largely,larger,lateral,less,lignescent,lon,long,longer,lower,main,major,mature,maturity,midpoint,minute,nectary,never,nflorescence,numerous,oblique,obsolete,obtuse,occasionally,often,one,orolla,other,otherwise,oung,outer,outline,pair,per,persistent,pigmented,pore,presence,present,prickly,projecting,pubescence,purple,ray,readily,reduced,rigid,ring,ripe,ruit,scabrous,scattered,section,seldom,sessile,sharp-tipped,short,short-stalked,short-stipitate,side,similar,sinus,slightly,small,smaller,somewhat,spaced,species,stalk,stellae,stellate-puberulent,subcapitat,summi,tamen,three,time,tip,toothlike,truncate,tube,two,type,unarmed,unit,unlobed,uppermost,upward,usually,vary,varyingly,vein,vestiture,wide,widely,ympodial	'',[,``,abaxial,adaxial,arrangement,bark,bud,center,characteristic,colour,corolla,form,fruiting,growth,height,history,life,na,new,number,ovary,plant,position,reproduction,scar,seed,shape,spacing,staman,subcapitate,texture,trichome,value,width,{,}
738	wfo-0001031503	invalid_json_followup	142	110	63	79	47	0.444	-10,-15,-30,-7,0.3-3,0.5-1,0.5-4,1-5,1-7,1.5-8,2-3,2.5-10,6-7,7-10,abaxially,acuminate,acute,adaxially,angled,apart,apex,articulated,base,branched,calyx,cell,chartaceous,cm,densely,diameter,elliptic,entire,flower,forked,glabrous,globose,margin,mm,moderately,orange,ovate,pedicel,peduncle,petiole,puberulent,pubescent,rachi,rarely,reddish,ripe,rugose-pubescent,shrub,simple,sparsely,stellate,stigma,style,truncate,unbranched,uniseriate,white,x,yellow	-25,-6,1-,1-2.5,1-3,1.5-2,1.5-3,1.5-7,1.7-3.5,10-19,3-15,3-4,3-5,3-6,5613,6-many-foliat,7-15,abruptly,absen,aggregate,axe,ba,blade,connivent,cuneate,curled,cylindrical,decurrent,deltate,directed,distall,distally,eaf,eed,eglandular,except,fide,gland,hair,lanceolate,lobe,long,lower,mostly,narrowed,narrowly,nflorescence,nther,obtuse,occasionally,often,orolla,perfect,pore,present,radiu,rounded,ruit,slightly,spaced,stalked,stone,subcapitat,subclavate,tal,tem,time,tip,toward,triangular,tube,unequal,unit,usually,vary,vein,venturi,wide,ympodial	'',[,``,abaxial,adaxial,anther,arrangement,bark,bud,center,character,characteristic,colour,corolla,filament,form,fruit,fruiting,growth,height,history,inflorescence,leaf,length,life,na,new,number,ovary,plant,position,prickle,reproduction,scar,seed,shape,spacing,staman,stem,subcapitate,surface,texture,trichome,value,width,{,}
739	wfo-0001031511	invalid_json_followup	231	118	82	149	36	0.355	-12,-3.5,-5,0.5-1,0.5-5,0.7-2.1,0.8-2,1-1.5,1-2,10-25,2-6,2.5-3,4.5-7,5-9,7-11,accrescent,acute,andromonoecious,anther,apex,articulated,base,black,brown,calyx,chartaceous,cm,conspicuously,contiguous,densely,diameter,discoid,ellipsoidal,entire,erect,extra-axillary,filament,flower,forked,fruit,fruiting,globose,green,inflorescence,length,light,lobed,margin,minutely,mm,nearly,obtuse,orange,ovate,pale,pedicel,peduncle,perennial,petiole,pitted,plant,prickle,pseudo-racemose,purple,rachi,rhizomatous,ripe,rotate,shallowly,shrub,simple,stellate-pubescent,stem,stigma,strongly,style,surface,tomentose,violet,white,x,yellow	%,-15,-7,0,0-0.3,0-1.1,0-2,0-3,0.1-0.2,0.3-0.5,0.3-0.8,0.3-1.7,0.4-0.7,0.5-0.7,0.5-0.9,0.6-1.5,1,1-3,1-7,1.1-1.6,1.7-2.4,1.8-2.6,10-12,10-18,15-25,17-25,2-3,2-4,2-locular,2.2-3,2.2-4.3,2.8-3.5,25-45,3-5,4-10,4.5-9,5-10,5-15,5-6,5-7,5-merou,6-8,6-9,7-8,8-15,9-15,9-20,abaxially,absen,absent,acicular,across,adaxiall,adaxially,alyx,ample,anvil-shape,apart,armed,axe,ba,basal,bisexual,blade,broadly,connivent,cordate,cross-section,cuneate,cylindrical,deltate,dense,directed,distal,distall,dm,dult,eaf,eed,eglandular,exocarp,finger,functional,geminat,glabrous,gland-tipped,hair,half,heterostylous,hig,interpetalar,juicy,lamina,lanceolate,lateral,less,lobe,lon,long,longer,lower,male,mature,mesocarp,mid-point,midpoint,midrib,midvein,minute,moderately,moist,nflorescence,oblique,orolla,part,per,placenta,plurifoliate,pore,porrect,present,pubescent,ray,ruit,rusty,short,somewhat,spaced,sparsely,stage,stalk,stalked,stellae,straight,tamen,thick,throughout,time,tissue,triangular,tube,unbranched,unit,unknow,uvenile,vary,wid,wide,ympodial	'',[,``,abaxial,adaxial,arrangement,bark,bud,cell,center,characteristic,colour,corolla,form,growth,height,history,leaf,life,na,new,number,ovary,position,reproduction,scar,seed,shape,spacing,staman,texture,trichome,value,width,{,}
740	wfo-0001031512	success	199	101	71	128	30	0.357	-3,0.3-1,0.3-1.5,0.5-0.6,0.5-0.8,0.5-1.5,1-1.5,1-2,2-6,3-4,4-8,4.5-6,5-12,7-10,7-12,andromonoecious,anther,apex,black,brown,brownish-black,calyx,chartaceous,cm,cylindrical,densely,diameter,entire,extra-axillary,filament,flat,flower,fruit,fruiting,glabrous,globose,grey,grey-green,inflorescence,lanceolate,length,lilac,margin,minute,mm,pedicel,peduncle,perennial,petiole,plant,prickle,pseudo-racemose,purple,rachi,raised,rotate-stellate,shrub,simple,slightly,stellate-pubescent,stem,stigma,straight,style,surface,though,tubercle,twisted,white,yellow,yellowish	%,0-10,0-3,0.05-0.1,0.1-0.2,0.15-0.2,0.15-0.25,0.15-0.3,0.2-0.3,0.3-0.5,0.5-1.8,0.8-1,0.9-1.5,1-2.5,1-3,1.5-3,12-15,12-16,13-15,13-16,15-25,2-foliate,3-5.1,3.8-5.7,4.5-7,5-7,5-merou,6-13,8-10,abaxially,absen,absent,abundant,accrescent,acute,adaxiall,adaxially,alyx,and/or,apart,articulated,axe,ba,base,blade,broad,broad-based,capitat,connivent,cuneate,decimetr,deltate,directed,distall,distinct,distributed,dr.,dult,eaf,eed,erect,finger,first,functional,geminat,gland-tipped,green,hair,half,heterostylous,interpetalar,lamina,later,lateral,less,lobe,long,longer,loosely,lower,marbled,mature,mesocarp,mid-point,midpoint,moderately,nflorescence,oblique,obtuse,orolla,part,per,pore,porrect,present,pubescent,ray,rhizomatous,rounded,ruit,scarcely,sessile,short,smooth,sometimes,spaced,stage,stellae,stellate,strongly,tal,tamen,thick,throughout,time,tissue,tube,unarmed,unbranched,undulate,unit,unknow,uvenile,vary,weakly,wide,x,ympodial	abaxial,adaxial,arrangement,bark,bud,capitate,cell,center,colour,corolla,form,growth,height,history,leaf,life,na,new,number,ovary,position,reproduction,scar,seed,shape,spacing,staman,texture,trichome,width
741	wfo-0001031586	success	167	98	67	100	31	0.401	-2,0.1-1,0.5-1,1-1.2,1-1.5,1-2,1.4-2.5,2,5-6,acute,anther,apart,apex,bark,base,bright,broadly,bud,calyx,capitate,cm,completely,conical,corolla,cream-colored,elliptic,filament,flower,glabrous,globose,green,greenish,inflorescence,leaf,lobed,margin,mm,nearly,new,open,opposite,ovary,pale,paler,papillate,pedicel,petiole,present,ridged,scar,shiny,shrub,simple,sometimes,somewhat,stem,stigma,style,surface,tapering,trichome,truncate,uniseriate,white,x,yellow,yellowish	.25,0.5-0.8,1,1.3-5,1.5-2,2-2.5,3-11,5-10,7-10-flowered,abrupt,absent,anthesi,apparently,appearing,attenuate,becoming,beneath,borne,branch,campanulate,closer,cucullate,deflexed,deltate,dia,differing,difoliate,distance,drying,eaf,edicel,eed,ellipsoid,exerted,exfoliatin,fleshy,free,fresh,geminate,gree,inflorescenc,know,known,later,lateral,leave,lobe,long,lower,main,major,material,may,minor,minutely,mucro,near,nflorescence,notched,occasionally,older,olive,one,onto,overtopping,pair,papillose,planar,pore,poricidal,portion,prominent,raised,remaining,rounded,ruit,shap,shaped,shin,size,slender,small,soon,spaced,sparsely,straight,swollen,tall,tear-drop,thick,thickened,tip,trunk,tube,ud,unit,vein,widely,ympodial,young	7-10,abaxial,adaxial,arrangement,cell,center,colour,diameter,exfoliating,form,fruit,fruiting,growth,height,history,length,life,na,number,peduncle,perennial,plant,position,rachi,reproduction,seed,shape,spacing,staman,texture,width
742	wfo-0001031587	success	142	86	48	94	38	0.338	0.8-1,1-1.5,1.5-2,1.7-2,2-2.5,5,6-7,acute,anther,apex,bark,bi-lobed,calyx,closely,cm,corolla,dendritic,densely,elliptic-ovoid,erect,evenly,filament,glabrous,globose,inflorescence,leaf,lobed,minutely,mm,ovary,pale,pedicel,petiole,pubescent,reddish-grey,scar,shape,soft,spaced,stem,stigma,style,surface,tree,trichome,white,winged,x	.5,10-15,12-16,17-30,2,2-9-celled,2/3,3-4,6-8,7-9,abaxially,adaxially,along,anthesi,apart,attenuate,axi,base,broadly,clavate,cone,conical,decurrent,deflexed,deltate,denser,dia,differing,drying,eaf,edicel,eed,elliptic,exserted,fide,fleshy,free,furcate,golden-red,included,irregular,know,known,lamina,later,lateral,like,lobe,long,loose,lower,lowered,main,major,middle,minor,mostly,oblique,ocasionally,occasional,older,overlappin,pair,papillate,papillo,parallel,perpendicular,persisten,pore,poricidal,portion,rarely,rect,rest,ruit,shaped,simple,size,somewhat,steinbach,tall,tear-drop,thick,thickened,tip,tub,tube,ud,uniseriate,vein,verrucose,way,widest,young	abaxial,adaxial,alternate,arrangement,bud,cell,center,colour,diameter,flower,form,fruit,fruiting,green,growth,height,hirsute,history,length,life,margin,na,new,number,overlapping,papillose,peduncle,perennial,persistent,plant,position,rachi,reproduction,seed,spacing,staman,texture,width
743	wfo-0001031589	invalid_json_followup	222	122	89	133	33	0.401	-6,0-1,0.1-0.5,0.2-0.5,0.2-3,0.4,0.5-1,0.55-0.7,0.9-1.3,1-1.8,1-5,2-3.5,2.8-4,5-merous,acute,anther,apex,apically,bark,berry,bright,brown-green,calyx,cell,chartaceous,cm,deltate,densely,diameter,dull,elliptic,filament,flattened-reniform,flower,fruit,fruiting,glabrescent,glabrous,gray-green,lateral,leaf,length,lobed,long-obovate,margin,mauve,membranous,mm,moderately,occasionally,often,orange-brown,orange-green,outline,pale,pedicel,petiole,pit,plant,porrect,prickle,raised,reflexed,rounded,scandent,sessile,shiny,shrub,simple,small,smooth,sometimes,somewhat,sparsely,spherical,stalked,stellate,stellate-pubescent,stem,straight,style,subentire,surface,terete,trichome,white,yellow,yellow-green,yellow-orange	-0.5,-15,-6.5,.5,/6,0,0-10,0-3,0-30,0.1,0.15-0.3,0.2-0.4,0.6-1.2,0.7,0.8-2.3,0.9-1.6,1,1.2-1.5,1.5-5,1.7-2.5,1.8-2.9,1/3,1/3-1/2,1/3-1/4,10-30,2-,2-10,2.5-4.5,2.5-6,3-4,3-5,3/4,4-6.5,4/5,5-8,6-8,8-14,8-30,abaxially,alyx,ame,apart,apparently,articulated,attenuate,base,blade,broadly,brow,c.,caudat,concolorous,connivent,cream,dark,density,difoliate,discolorous,distance,drying,eed,elongating,equal,erect,extending,eye,free,geminat,green,higher,infructescence,lengt,lobe,lon,long,longer,lower,marking,mature,maturity,midpoint,midvein,multangulate,naked,narrow,narrow-cuneate,nflorescence,oblong,obovate,older,orolla,oung,pair,part,pendulous,per,perfec,pericarp,poricidal,portion,prickl,prickly,primary,ray,ruit,shorter,side,solitary,spaced,spreading,stalk,stout,subsessile,tamen,tapering,tertiary,time,tip,tube,unit,upper,vary,vein,venation,visible,way,weakly,whole,wide,winged,woody,ympodial,young	'',[,``,abaxial,adaxial,arrangement,brown,bud,caudate,center,characteristic,colour,corolla,form,growth,height,history,inflorescence,life,na,new,ovary,reproduction,scar,seed,shape,staman,stigma,texture,value,width,{,}
744	wfo-0001031609	success	154	98	69	85	29	0.448	0-30,0.4-3,0.5-3,1-10,1-6,1.5-2,10-25,2,2-,2-3,3-5,3-9-lobed,4-6,abaxially,acute,adaxially,apex,around,base,brownish,calyx,campanulate,cm,connective,contiguous,dark,dia,diameter,ellipsoidal,elliptic-ovate,flattened,fleshy,flower,forked,fruit,glabrous,globose,green,inflorescence,leaf,margin,mm,nearly,obovate,obtuse,orange,papillose,pedicel,peduncle,petiole,pinnately,puberulent,rachi,radiu,reticulate,ripe,shrub,simple,small,stellate,stigma,style,succulent,tree,truncate,unbranched,unlobed,x,yellow	.5,/4,0.5-1,1.3-3,1.5-3,2.5-4,20-25,3-24,3-foliat,4,4-5,4.5-60,5-25,5/6,8-20,absen,absent,aggregate,ape,apiculate,articulated,axe,barely,beyond,bilobe,blade,branch,brow,cell,connivent,conspicuous,cuneate,deltate,dilated,directed,distally,divided,eaf,eed,elliptic,emerging,entire,equal,exceeding,exserted,glabrou,laterally,leaving,lobe,lobed,long,lower,midrib,minutely,nflorescence,nther,obconical,occasionally,orolla,pedicellar,point,pore,rounded,ruit,scar,shallowly,sinus,stamen,stone,strongly,succulen,tal,tem,thecae,time,tip,tomento,triangular,tube,two,ud,unit,vary,wide,ympodial	abaxial,adaxial,anther,arrangement,bilobed,brown,bud,colour,corolla,filament,form,growth,height,history,length,life,na,number,ovary,plant,position,reproduction,seed,shape,spacing,staman,surface,texture,width
745	wfo-0001031615	success	154	98	65	89	33	0.422	0.5-1,0.8-1,0.9-1.1,1-1.6,1.3-1.8,1.5-5,5-6,acute,anther,apex,attenuate,axil,bark,base,bilobed,brown,calyx,capitate,closely,cm,corolla,decurrent,deep,elliptic,filament,flattened-reniform,fruit,fruiting,glabrous,glandular,globose,green,inflorescence,lateral,leaf,lobed,main,minutely,mm,nearly,opposite,ovary,packed,papillose,pedicel,petiole,pitted,shrub,slender,small,stem,stigma,style,subumbellate,surface,tapering,tree,trichome,tube,tuft,unicellular,uniseriate,vein,white,winged	.5,0,0.5,1.5,11-15.5,2-3,2-4.2,3.8-6.1,4-6.5,5-20-flowered,6-8,8-10,acuminate,anthesi,arising,ba,becoming,berry,caly,dark,dark-papillo,deflexed,deltoid,dia,differing,difoliate,distal,eaf,edicel,eed,expanded,exserted,free,furcate,geminat,impressed,incrassate,interpetalar,lamina,less,lobe,lon,long,lower,major,margin,maroo,middle,minor,minute,nflorescence,occasionally,older,one,overlappin,pair,paler,papillae,per,pore,poricidal,portion,prominent,reflexed,ruit,scar,scarcely,shaped,shiny,simple,sinus,size,slightly,somewhat,straight,tall,tear-drop,terminal,thickened,thin,tip,ud,unit,urceolate,widest,woody,x,ympodial,young	5-20,abaxial,adaxial,arrangement,bud,colour,dark-papillose,diameter,flower,form,greyish,growth,hair,height,hirsute,history,length,life,maroon,na,number,peduncle,perennial,plant,position,rachi,reproduction,seed,shape,spacing,staman,texture,width
746	wfo-0001031618	success	184	98	75	109	23	0.408	-2,0-3,1-1.5,13,2-3,3-4,5,acute,anther,apex,axil,base,branch,capitate,cell,clonal,cm,corolla,cuneate,cyme,darker,discoidal,ellipsoid,elliptic,equal,facetted,filament,finely,flower,glabrous,green,greyish,habit,lanceolate,lasting,lavender-purple,leaf,less,long,marbled,maturity,mm,narrowly,obovoid,often,ovary,ovoid,pale,pedicel,peduncle,petiole,pinatisect,purple,reddish-brown,reticulate,ripe,rotate,rounded,rugose,scorpioid,several,shrub,simple,soft-wooded,somewhat,stigma,stone,stripe,succulent,surface,tapering,tinged,unequal,variable,year	0.5-1.5,1-7,1.5-2,1.5-3.5,10-18,10-lobed,2-2.5,3,3-8,4-5,40-60,5-12,90-110,acuman,almost,also,anthesi,appearance,appearing,aspect,becoming,berry,beyond,blunt,bluntly,broadly,c.,calyx,cluster,column,conical,covering,cut,developed,dia,eaf,eed,emarginate,enlarged,erect,except,exerted,extending,fleshy,floral,fork,forked,frui,general,giving,glandular,greatly,gree,growing,hair,half,interacuminal,lengthening,lobe,lobed,lon,loosely,lower,mauve,may,mid-vein,midrib,minute,nflorescence,oblong,occasional,occur,ovate-lanceolate,pal,pedicellate,petal,plurifoliat,point,pore,poricidal,rarely,rhachi,ruit,sessile,shallowly,side,single,sinus,slit,sometimes,specimen,stem,stout,strongly,styl,terete,tip,tissue,triangular,tub,ud,unit,vigorous,way,well,x,ympodial,young,younger	arrangement,bud,colour,diameter,form,fruit,growth,height,history,inflorescence,length,life,na,number,plant,position,rachi,reproduction,seed,shape,staman,style,texture
747	wfo-0001031646	success	171	102	73	98	29	0.427	.2,0.2-0.8,0.5-2,1-10,1-6,1.2-2.5,1.5-4,15-25,18-38,2-10,2.5-10,20,4-5,7-8,8-15,abaxially,acuminate,acute,adaxially,anther,apart,apex,articulated,base,blue,branched,brown,chartaceous,cm,darker,densely,diameter,ellipsoidal,elliptic-lanceolate,filament,flattened,flower,fruit,glabrous,globose,green,highly,immature,leaf,light,long,maroon,mature,mm,multicellular,obliquely,pedicel,peduncle,petiole,pubescent,rachi,red,rotate-pentagonal,rugulose,scandent,shortly,shrub,simple,smooth,spreading,stigma,style,surface,uniseriate,vine,violet,x,yellow	-7,-pinnate,.5,0.8-1.5,1-1.8,1.5-3.5,1962,2-2.5,2-3,3.5-4,4-18,4-20,4-8,4-foliate,5,5-6,5-7,5-7.5,5-merou,absen,absent,accrescent,acut,aggregate,alyx,apical,apparently,axe,ba,basally,berry,blade,calyx,cell,ciliat,climbing,connivent,correll,covered,cuneate,cylindrical,decreasing,directed,distall,eaf,eed,elliptic,entire,equal,fide,fruiting,geminat,glandular,hair,high,homostylous,hyaline,interjected,lateral,leaflet,lobe,lower,margin,nflorescence,oblique,oblong,obtuse,orolla,ovate-lanceolat,ovate-lanceolate,part,perfect,petiolule,pore,present,pubescen,pubescence,rounded,ruit,seudostipule,size,slightly,small,spaced,stem,stone,stout,tamen,tawny,tem,tip,toward,tree,truncat,tube,unit,vary,ympodial	abaxial,adaxial,arrangement,colour,corolla,form,growth,height,history,inflorescence,length,life,na,number,ovary,perennial,pinnate,plant,position,pseudostipule,reproduction,seed,shape,spacing,staman,texture,trichome,truncate,width
748	wfo-0001031651	invalid_json_followup	201	128	94	107	34	0.468	-2,-3,.7,/3,0.1-0.2,0.2-0.5,0.3-0.8,0.3-1.5,0.6-1,0.7-1,1,1-1.7,1-2,1-4,1.2-2,4-6,5-merous,abaxial,absent,adaxial,anther,apart,apex,bark,berry,branched,brown,calyx,cell,cm,curved,dark,densely,diameter,dull,elliptic,entire,erect,filament,flattened-reniform,flower,fruit,fruiting,glabrescent,glabrous,gray,herb,lateral,leaf,length,margin,mature,maturity,mm,orange-brown,outline,ovate,pedicel,peduncle,petiole,pit,poricidal,porrect,prickle,prickly,purple,raised,red,red-green,reflexed,rounded,scar,shrub,simple,small,smooth,spherical,stalked,stellate,stellate-pubescent,stem,style,subentire,surface,terete,terminal,tip,trichome,unarmed,variously,weakly,white,yellow,yellow-green	-3.5,.1,.6,/5,0-20,0.1,0.1-0.15,0.1-0.25,0.15-0.2,0.3-0.5,0.6-1.3,1.2-3,1.3-1.6,1.5-2,1/5,1/6-1/4,2-10,2-3,2-3.5,2/3-3/,3-5,4-5,4.5-7,abaxially,acuminat,acute,alyx,ame,apar,apically,apparently,articulated,base,blade,c.,chartaceous,concolorous,cordate,deltate,difoliate,discolorous,drying,eaf,eed,elongating,equal,eye,faint,filiform,free,geminat,gra,herbaceous,infructescence,lanceolate,lobe,lobed,long,longer,lower,midpoint,naked,nflorescence,oblong,obtuse,older,one,open,orolla,oung,pair,pendulous,per,perfec,pericarp,persistent,portion,prickl,primary,ray,ruit,scandent,shorter,sometimes,spaced,spreading,stalk,straight,subsessile,tamen,tapering,tertiary,thick,thick-stalked,time,toward,tube,unarme,unit,upper,vary,vein,venation,visible,way,wide,ympodial	'',[,``,arrangement,bud,center,characteristic,colour,corolla,form,growth,height,history,inflorescence,life,na,new,number,ovary,perennial,plant,position,rachi,reproduction,seed,shape,spacing,staman,stigma,texture,value,width,{,}
749	wfo-0001031654	success	191	105	74	117	31	0.387	0.5-0.75,0.5-2,0.5-3.5,1-2,1-3,1-4,1.5-2.0,2-3,2-8,3-10,4-6,abaxial,acute,adaxial,anther,apex,brown,bud,calyx,chartaceous,cm,cream,cylindrical,dark,diameter,extra-axillary,filament,flower,fruit,fruiting,glabrous,globose,green,immature,leaf,leaf-opposed,lobed,many,margin,mature,mm,moderately,narrowly,netlike,obtuse,ovate,pedicel,peduncle,petiole,pit,prickle,pubescent,rachi,raised,recurved,red,reniform,ridge,separated,shrub,simple,small,sparsely,stellate,stem,stigma,style,surface,triangular,unbranched,white,whitish,x,yellow	0.5,0.5-1,0.5-1.5,1,1-.,1-1.5,1.5-2,1.5-3,1/3-1/2,10-20,2-5,2-6,2-ranked,3,3-6,4-16,4-7,5-8,5-merou,8-15,abaxially,absent,accrescent,adaxiall,adaxially,alyx,apar,apical,apparently,armed,attenuate,axe,base,berry,beyond,blade,connivent,contiguous,cordate,cut,cylindrica,decurrent,densely,difoliate,directed,discolorous,eaf,eed,either,em,equa,exserted,flattened,frui,geminate,glabrou,hair,interpetaler,introrsel,lacking,less,like,lobe,long,lower,m.,major,midpoint,midrib,midvein,multicellular,multiseriate,nearly,nflorescence,obscure,occasional,occasionally,often,onto,orolla,pair,parallel,per,perfect,perpendicular,pore,porrect-stellate,ray,ruit,rusty,scandent,secondary,side,sinus,slightly,spaced,spine,spreading,stalk,stamen,ste,straight,tamen,tan,tapering,thin-skinned,tissue,tube,unarmed,unicellular,unit,usually,vary,vein,way,wide,ympodial	5-merous,apart,arrangement,bark,cell,center,colour,corolla,form,growth,height,history,inflorescence,length,life,na,new,number,ovary,perennial,plant,position,reproduction,scar,seed,shape,spacing,staman,texture,trichome,width
750	wfo-0001031656	success	154	80	50	104	30	0.325	.5,0.5-1,1-2,1-2.5,1.2-1.5,1.5-2,1.5-5,3-3.5,5-ribbed,6-8,acuminate,anther,apex,bark,bright,calyx,capitate,closely,cm,corolla,ellipsoid,elliptic,filament,flower,fruit,fruiting,glabrous,globose,green,greyish,leaf,lobed,margin,mm,opposite,ovary,ovate,pedicel,petiole,plant,reddish,scar,shrub,spaced,stem,stigma,strongly,style,surface,white	/4,0.5,1-1.5,10-20,2.5-3.5,3-5,4-9,5-7,acute,also,anthesi,arising,ba,base,berry,cork,densely,dia,differing,difoliate,directly,drying,eaf,edicel,eed,enclosing,erect,extremely,fleshy,free,geminat,hooded,known,lateral,live,lobe,lon,long,long-acuminate,lower,main,major,matte,mature,middle,minor,minute,minutely,nflorescence,node,oblique,often,older,one,pair,pale,paler,papillo,papillose,peelin,persistent,planar,pore,poricidal,portion,prominent,proximal,rather,red-papillose,reflexed,rib,ridged,rounded,ruit,sessile,shaped,shiny,size,slightly,somewhat,specimen,straight,swollen,tall,tear-drop,terminal,thick,thickened,tip,top,transversely,tube,ud,unit,upper,vein,visible,way,wide,widest,woody,x,ympodial,young	abaxial,adaxial,alternate,arrangement,bud,cell,center,colour,diameter,form,growth,height,history,inflorescence,length,life,na,new,number,peduncle,position,rachi,reproduction,seed,shape,spacing,staman,texture,trichome,width
751	wfo-0001031667	invalid_json_followup	153	103	60	93	43	0.392	0.6-1,1-1.5,1-4,1.4-3,12-35,2-3,3-13,5-15,5-9,8-13,acute,apex,apiculate,articulate,branched,calyx,cell,cm,corolla,cyme,dark,diameter,dichasial,dichasially,distal,ebracteate,elliptic-lanceolate,filament,flower,forked,globose,green,green-white,hair-like,half,herbaceous,lanceolate,leaf,mm,monochasial,mucilaginous,odd-pinnate,ovoid,pedicel,peduncle,perennial,petiole,pilose,plant,proximal,seed,spot,stellate,stigma,stripe,style,throughout,white,yellow,¼	0.6-1.5,1.5-2,10-13,2-5,2-6,2.5-5,3-5,3-6-foliat,3-8,4-1.,6-10,8-15,abaxially,abruptly,acumen,acuminate,adaxially,apical,apically,base,caudate,connate,cordate,covering,cuneate,dehiscent,digestion,diminishing,dorsally,eaf,edge,eed,emoval,enzyme,exceeding,flat,folded,generally,globo,honeycomb,interjected,introrse,irregularly,lateral,leaflet,living,lobe,lobed,lon,long,lower,lunat,make,maturing,nflorescence,nther,oblique,oblong,often,orolla,pair,pattern,perfect,petiolate,petiolule,plan,poricidally,reveal,rounded,ruit,sessile,seudostipule,short,size,slit,specimen,stamen,straight,tal,tem,terminal,testal,thick,toward,tuber-bearing,typically,unit,vary,wall,whit,wide,without,ympodial	'',[,``,abaxial,adaxial,anther,arrangement,bark,bud,center,characteristic,colour,form,fruit,fruiting,growth,height,history,inflorescence,length,life,margin,na,new,number,ovary,position,prickle,rachi,reproduction,scar,shape,spacing,staman,stem,surface,texture,trichome,value,wet,width,{,}
752	wfo-0001031672	invalid_json_followup	157	106	62	95	44	0.395	0.3-0.5,0.5-1.5,1,1-10,1-5,1.5-2,1.5-5,10-20,15-50,2-12,4.5-5,6,acuminate,apart,apex,articulated,base,calyx,cell,chartaceous,cm,densely,diameter,entire,flattened,flower,fruit,glabrous,glandular-puberulent,globose,green,greenish-brown,lanceolate,leaf,lobed,margin,membranaceous,mm,moderately,near,ovate,ovoid,pedicel,peduncle,petiole,pilose,pinnately,puberulent,rachi,simple,sparsely,stellate,stigma,style,subcoriaceous,tree,truncate,unbranched,white,whitish,x,yellow	0,0-2,0.5,0.5-1,1-,1-1.5,1-2,1.5-2.5,1.5-3.5,15-20,2-28,3-4-foliat,3/4,4,4-34,4/5,5-6,9-lobed,abaxially,absent,acute,adaxially,aggregate,ape,apiculate,aublet,axe,basal,beyond,blade,ciliat,connective,cordate,cylindrical,directed,distally,divided,eaf,eed,exceeding,exserted,fide,fleshy,hair,leaving,lobe,lon,long,lower,mature,midrib,narrowly,nflorescence,nther,obtuse,occasionally,often,one,orolla,pedicellar,perfect,pilo,pore,presen,present,pubescent,purple,radiu,remant,represented,rounded,ruit,shorter,sinus,slightly,small,spaced,stamen,stone,tal,tem,thecae,time,tip,toward,triangular,truncat,tube,ud,unit,unlobed,vary,wide,yello,ympodial	'',[,``,abaxial,adaxial,anther,arrangement,bark,bud,center,characteristic,colour,corolla,filament,form,fruiting,growth,height,history,inflorescence,length,life,na,new,number,ovary,perennial,plant,position,prickle,reproduction,scar,seed,shape,spacing,staman,stem,surface,texture,trichome,value,width,{,}
753	wfo-0001031684	success	161	109	77	84	32	0.478	.25,/4,0.4-1.5,0.5-0.7,0.5-0.8,0.5-1,0.7-1,0.75-1,1-1.2,1-5,3-30,acute,along,anther,apex,bark,base,beneath,calyx,clavate,cm,corolla,curly,decurrent,densely,dia,difoliate,elliptic,filament,filiform,flower,fruiting,geminate,globose,green,inflorescence,internodal,leaf,like,lobed,long,minutely,mm,occasionally,opposite,ovary,ovoid-reniform,pale,papillose,pedicel,petiole,pitted,pubescent,rest,scar,shrub,slender,slightly,small,sparsely,stem,stigma,style,surface,tan,tapering,tipped,tree,trichome,tube,unifoliate,uniseriate,vein,way,white,winged,x	.5,.75,0.1,10-100,2,2-9,3-3.5,4-17,5-7,acuminate,anthesi,apar,bearing,berry,black,borne,branched,causing,deflexed,denser,differing,drying,eaf,edicel,eed,elongated,except,expanded,exserted,extremely,free,glabrous,gre,greatly,irregularly,lateral,less,lobe,lon,long-triangular,lower,main,major,middle,midrib,minor,nflorescence,obconic,older,one,pair,papillo,persistently,planar,pore,poricidal,portion,present,previously,pulled,raised,reflexe,reflexed,ruit,shaped,short,single,siz,size,soon,spaced,straight,tall,tear-drop,time,tip,ud,unevenly,unit,varying,widely,widest,ympodial,young	abaxial,adaxial,apart,arrangement,bud,cell,center,colour,diameter,form,fruit,grey,growth,height,history,length,life,na,new,number,peduncle,perennial,plant,position,rachi,reproduction,seed,shape,spacing,staman,texture,width
754	wfo-0001031690	success	140	99	62	78	37	0.443	.5,1.2-2.0,1/2-2/3,2-5,2-8,2.5-3.5,4-9,7-10,anther,apex,apically,blade,blue,broadly,brown,calyx,cm,dark,depressed-spherical,developing,dm,dry,eglandular,foveolate,glabrate,glabrous,green,herb,internodal,invested,length,long,maturity,minutely,mm,ovate,pedicel,perennial,petiole,pinnatifid,prickle,prickly,reflexed,reniform,shape,slightly,splitting,spreading,stellate,stem,stipitate-glandular,terete,thrice,tightly,tube,twice,uniseriate,violet,violet-tinged,viscid-glandular,yellow,zygomorphic	2-3,2.7-3.6,2/3,6-9-flowere,8-40,accrescent,acro,acute,along,always,alyx,anthesi,arcuate,base,bearing,beneath,berry,campanulate,cauline,completely,corky,covered,da,difoliate,divided,eaf,eed,emerging,erect,exceeded,geminat,hair,lanceolate,least,linear,lobe,lon,main,nflorescence,numerous,obtuse,often,orolla,per,persistent,rarely,rhizome,root,rounded,ruit,scattered,separated,sessile,short,slende,slender,somewhat,space,stellae,strait,tall,tamen,tapering,throughout,tigma,tub,tyle,ultimate,unexpande,unit,usually,variable,vary,vein,widely,yearly,ympodial,young	6-9-flowered,abaxial,adaxial,arrangement,colour,corolla,diameter,filament,flower,form,fruit,growth,height,history,inflorescence,leaf,life,na,new,number,ovary,peduncle,plant,position,rachi,reproduction,scar,seed,spacing,staman,stigma,style,surface,texture,trichome,unexpanded,width
755	wfo-0001031695	success	185	105	76	109	29	0.411	0.5-1,0.5-2,1-2,1-9,1.5-8,10-35,2-3,20-30,3-10,3-17,3-7,5-7,6-10,6-20,abaxially,abruptly,acuminate,adaxially,also,apart,apex,articulated,basal,base,branched,campanulate,cell,chartaceous,cm,color,dark,deep,densely,diameter,ellipsoidal,entire,flattened,flower,fruit,glabrous,green,greenish,immature,lavender,leaf,lobe,lobed,margin,mm,moderately,mottled,occasionally,ovate,pedicel,peduncle,petiole,pilose-hirsute,puberulent,puberulent-pubescent,pubescent,purple,purplish,rachi,ripe,shrub,simple,sparsely,stigma,stripe,style,subcoriaceous,tree,unbranched,unknown,x,yellow	1,1-3,1.5-2,1/2,1/3,10-,10-15,15-20,2-4,2-5,2.5-5,3-,3-19,30-40,4-10,4-5,4-6,4-foliat,5,5-20,6-8,7-,?,acute,aggregate,ape,apically,apiculate,axe,beyond,blade,broadened,calyx,capitat,connective,connivent,cordate,cylindrical,d,dilated,directed,divided,eaf,eed,eglandular,eglandular-pilose,exceeding,exserted,fleshy,glabrate,glabrescent,glandular-puberulent,hair,hard,lanceolate,lateral,laterally,leaving,lilac,lon,long,lower,midrib,narrowly,nflorescence,nther,oblique,oblong,obtuse,often,orolla,ovoid,pedicellar,perfect,pilo,pilose,pilose-hirsut,pore,presen,present,radiu,remnant,rounded,ruit,shorter,sinus,slight,slightly,small,sometimes,somewhat,spaced,stamen,stone,swelling,tal,tem,thecae,time,tip,tomento,triangular,tube,unequal,unit,unlobed,vary,wide,ympodial	abaxial,adaxial,anther,arrangement,capitate,center,colour,corolla,filament,form,growth,height,history,inflorescence,length,life,na,number,ovary,plant,position,reproduction,seed,shape,spacing,staman,surface,texture,width
756	wfo-0001031697	success	185	96	56	129	40	0.303	0.4,1.2,2-celled,?,abaxially,accrescent,adaxially,anther,apex,attenuate,calyx,cm,diameter,entire,except,face,filament,flower,foveolate,fruit,fruiting,glabrous,gland-tipped,globose,hair,herbaceous,linear,margin,mm,ovate-lanceolate,pedicel,peduncle,petiole,pilose,plant,prickle,pubescent,purple,shallowly,sharp,simple,somewhat,sparsely,stellate,stem,stigma,straight,style,subreniform,subshrub,thin-textured,tip,unbranched,white,yellow,yellow-brown	-celled,.4,.5,.6,.7,.8,0.1,0.3,0.5,0.6–1.0,0.8,1,1.2–2.5,1.4,1.5–7,10-celled,15,15–60,1–1.6,1–2,2-foliate,2.2,2–3,2–4,3,3.5,3–4,3–8,4,4-rayed,4.5,4–5,5,6–13,acute,apparently,around,axe,base,blade,branch,completely,consistently,cordate,covering,cylindrical,densely,directed,distall,divergent,eaf,eed,especially,fertile,few-celled,flattened,flowering,free,frui,geminat,glabrou,gland-tippe,hilum,hyaline,indentation,lacking,less,lobe,lon,long,longer,longest,lower,lowermost,lowest,major,many,midpoint,minute,mixed,mostly,nflorescence,non-glandular,often,orolla,ovate,part,per,pigment,pore,pubescence,raised,ruit,scattered,sessile,several-celled,shiny,short,shorter,similar,single,size,slender,small,smaller,ste,stellae,tall,tamen,taproo,tem,terminal,thick,time,truncat,tube,tuberculate,ultimate,unarme,unarmed,unit,upper,vary,varying,vein,wide,x,ympodial,–3	0.3-1.6,1.2-2.5,1.5-7,1.7,15-60,2,2-3,3-4,3-8,6-13,abaxial,adaxial,arrangement,bark,bud,colour,corolla,form,growth,height,history,inflorescence,leaf,length,life,na,number,ovary,position,rachi,reproduction,seed,shape,spacing,staman,surface,texture,trichome,truncate,width
757	wfo-0001031698	success	58	73	23	35	50	0.397	2-2.5,2.5,bark,cm,deflexed,dull,elliptic,fruiting,glabrous,green,leaf,margin,minutely,pale,pedicel,pitted,reddish-brown,reniform,repandly,rugose,shrub,stem,surface	'',2.5-3,4-4.5,``,ape,base,branch,decurrent,dia,difoliate,eaf,eed,fide,flattened,geminat,incrassate,long,maguire,mm,older,otherwise,paler,papillae,persistin,stout,strongly,tall,unit,wing,winged,woody,x,yellowish,ympodial,young	abaxial,adaxial,alternate,anther,apex,arrangement,berry,bud,calyx,cell,center,colour,corolla,diameter,filament,flower,form,fruit,growth,height,hirsute,history,inflorescence,length,life,na,new,number,ovary,ovoid,peduncle,petiole,plant,position,prickle,rachi,reproduction,scar,seed,shape,spacing,staman,stigma,style,texture,trichome,type,width,yellow,yellow-green
758	wfo-0001031707	success	178	106	73	105	33	0.41	0.5-1,1-1.3,1.5-6,16-20,2-3,2-4,2-6,4-5,6-7,abaxially,acute,adaxially,almost,along,anther,apex,apically,axillary,brown,calyx,capitate,climbing,cm,conical,corolla,dense,densely,diameter,elliptic,erect,filament,flattened,flower,four-lobed,fruiting,glabrous,globose,green,greenish,high,leaf,leaflet,lobed,margin,mm,ovary,pair,pedicel,petiole,pink,pinnate,plant,pointed,pubescent,reddish,round,scattered,simple,slightly,smooth,spaced,sparsely,stigma,style,surface,ternate,trichome,uniseriate,vein,vine,white,widely,woody	-3,.5,/4,1-1.2,1-1.5,1-3,1.2-1.8,1.2-2,1.5-1.7,1.5-2,1/3,2,2-10,24,3,4-6,5-10-celled,8-12,80-140,9-15,absent,acuminate,anthesi,apical,attenuate,axil,basal,base,basiscopically,bearing,berry,c.,cateniform,cell,clavat,conspicuously,cucullate,distal,distinct,drying,eaf,edicel,eed,endrophilum,enlarged,epidermal,exserted,flap-like,flat,fleshy,free,horizonta,inflorescenc,lanceolate,lateral,less,like,lobe,lon,long,lower,minutely,narrower,narrowly,nflorescence,oblique,obovate,occasionally,open,papillate,penden,per,petiolule,planar,poricidal,portion,primary,quadrate,quite,raised,regular,rest,ruit,sagittate,scar,smaller,somewhat,stout,strongly,tem,terminal,thickening,time,tip,tub,tube,type,ud,unifoliat,unit,usually,way,white-lenticellate,x,ympodial	0.5,8,abaxial,adaxial,arrangement,bark,bud,clavate,colour,form,fruit,growth,height,history,horizontal,inflorescence,length,life,na,number,peduncle,perennial,position,prickle,rachi,reproduction,seed,shape,spacing,staman,stem,texture,width
759	wfo-0001031714	invalid_json_followup	201	125	94	107	31	0.468	-6,-8,0.2-0.5,0.5,1-1.4,1-2,1-3,1.5-2.4,2-3,2-3.5,6-8.5,7,abaxial,absent,anther,apex,bark,base,berry,bright,broadly,calyx,capitate,cell,closely,cm,conical,corolla,cup-shaped,densely,diameter,ellipsoid,elliptic,elongate,entire,filament,flattened,flower,foliose,fruiting,glabrous,globose,greyish,growth,inflorescence,juicy,leaf,less,lobed,margin,minutely,mm,narrowly,nearly,new,often,older,orbicular,ovary,pale,pedicel,peduncle,petiole,pitted,prickle,pubescent,rarely,rectangular,red,reniform,ripe,rounded,scar,shallowly,shoot,short,shrub,simple,sinuate,slightly,spaced,sparsely,stellate,stem,stigma,stout,straight,style,surface,terminal,thin,trichome,white,yellow	-3.5,.25,0.15-0.3,0.3-0.5,0.4-,0.5-,0.5-0.6,0.5-0.8,0.7-2.2,0.8-1.2,1,1-4,1.5-2,2,2-4,3-3.5,3-4,3-6,4-merous,6,7-10,7-8,<,?,abaxially,adaxially,anthesi,appearing,arising,armed,articulated,axi,basal,broad,broad-based,caly,dense,eaf,eed,enlarged,equal,erect,especially,exserted,extending,free,frui,irregular,leafy,lengthening,like,lobe,lon,long,longer,lower,markedly,membranous,midpoint,midrib,mixture,nflorescence,numerous,oblique,obvious,occasionally,pair,papillo,per,perfect,pericarp,planar,plate,plurifoliat,pore,poricidal,portion,prickly,primary,pubescence,ray,ruit,sessile,short-stalked,shorter,size,slit,smaller,sometimes,spreading,stalked,strongly,tapered,testal,tiny,tip,truncate,tube,ud,unarmed,unit,upper,usually,vein,woody,x,ympodial	'',[,``,adaxial,arrangement,bud,center,characteristic,colour,form,fruit,height,history,length,life,na,number,perennial,plant,position,rachi,reproduction,seed,shape,spacing,staman,texture,value,width,{,}
760	wfo-0001031721	invalid_json_followup	208	111	72	136	39	0.346	0-3,0-5,0.2-0.5,0.3-1.1,0.4-2.2,1-1.5,1-3,1.5,2-4,3-10,5-20,5-7,8.5-12.5,accrescent,acicular,andromonoecious,anther,apex,articulated,black,brown,calyx,chartaceous,cm,dark,densely,diameter,elliptic,entire,extra-axillary,filament,flattened,flower,fruit,fruiting,glabrous,globose,green,herbaceous,inflorescence,lavender,leaf-opposed,length,margin,minutely,mm,obtuse,ovate,pale,pedicel,peduncle,petiole,plant,prickle,purple,rachi,resprouter,reticulate,simple,somewhat,sparsely,stellate,stellate-pubescent,stem,stigma,streak,style,surface,unbranched,yellow,yellowish,yellowish-green	%,.1,0-0.1,0-1,0.1-0.2,0.1-0.5,0.25-0.4,0.25-0.5,0.4-0.6,0.4-0.7,0.4-1.6,0.6-1.1,0.6-1.2,0.7-1.2,0.7-1.3,0.8-1.3,1,1-20,1-3.5,1.1-3.2,1.2-1.7,11-30,2.2-3.2,2.5-3,2.7-3.5,3-4.5,3-7,3-foliate,4-5,4-7,4-locular,5-11,5-merou,6-15,6-9,7-10,7-8,7-9,8-15,8-20,abaxially,absen,absent,across,adaxiall,adaxially,alyx,anvil-shape,apart,axe,ba,base,blade,capitat,confined,connivent,cross-section,cuneate,curved,cylindrical,d.,deltate,directed,distall,distributed,dult,eaf,eed,eglandular,erect,exocarp,finger,functional,geminat,gland-tipped,grey,hair,half,heterostylous,hig,juicy,lamina,lanceolate,lateral,less,lobe,long,longer,lower,mature,mesocarp,mid-point,midpoint,midrib,midvein,minute,moderately,moist,nflorescence,oblique,orolla,part,per,placenta,pore,porrect,possibly,present,pseudo-racemose,ray,ruit,semi-circular,sessile,short,solitary,spaced,stage,stalk,stalked,stellae,straight,tamen,thick,throughout,time,tube,unarme,unarmed,unit,uvenile,vary,weakly,white,wide,x,ympodial	'',5-merous,[,``,abaxial,adaxial,arrangement,bark,bud,capitate,cell,center,characteristic,colour,corolla,form,growth,height,history,leaf,life,na,new,number,ovary,perennial,position,reproduction,scar,seed,shape,spacing,staman,texture,trichome,value,width,{,}
761	wfo-0001031723	success	228	117	91	137	26	0.399	-5,0.05-0.2,0.1-0.3,0.4-,0.6-1,0.7-1,1-2.5,1-3,1.2-2,1.5-10,2-,2-7,2/3-3/4,4-11,4-6,abaxial,abaxially,adaxial,anther,apex,bark,base,berry,brown,calyx,chartaceous,cm,conical,dark,densely,diameter,dull,entire,erect,evenly,filament,finely,flattened-reniform,flower,fruit,fruiting,glabrescent,glabrous,gray,green,lateral,leaf,length,lobed,margin,marking,maturity,mauve,mm,moderately,multangulate,orange,orange-brown,ovate,pale,pedicel,petiole,prickle,red,rounded,scar,sessile,shrub,simple,smooth,sometimes,sparsely,spherical,stalked,stellate,stellate-pubescent,stem,straight,style,subentire,surface,terminal,tip,trichome,way,weakly,white,whitish,yellow,yellow-green,young	-1.5,-1/2,-15,-16,-2,-6,-6.5,-8,-merous,0,0.1-0.2,0.1-0.5,0.15,0.2-1,0.4,0.4-0.9,0.4-1,0.55-0.9,0.8-1.5,1-,1-2,1-5,1.5-,1.5-2.5,1/3-1/2,1/4-1/3,1/6-,10-30,15-45,2-3.5,2-5.5,2.5-4.5,2.5-5,2/3,3-10,3-15,4-,4-10,4-20,4-5,5-40,5-9,8-20,acuminate,acut,acute,alyx,ame,apar,apart,apically,apparently,articulated,ba,blade,branched,branching,brow,c.,connivent,cuneate,curved,deltate,discolorous,drying,eaf,eed,elongated,elongating,equal,eye,filiform,free,gently,gland,gland-tipped,glandular,hair,herbaceous,inflated,infructescence,lobe,long,longer,lower,mature,midpoint,minute,naked,narrow-deltate,near,nflorescence,obtuse,older,one,open,orolla,oung,pair,peduncle,per,perfec,pericarp,perpendicular,plurifoliat,poricidal,porrect,portion,prickly,primary,ray,recurved,reflexed,ruit,secondary,spaced,spreading,stalk,strongly,tamen,tapering,terete,tertiary,time,tube,unarme,unarmed,unit,usually,variously,vary,vein,venation,visible,wide,woody,ympodial	arrangement,bud,cell,center,colour,corolla,form,growth,height,history,inflorescence,life,na,new,ovary,perennial,plant,position,reproduction,seed,shape,staman,stigma,texture,unknown,width
762	wfo-0001031729	invalid_json_followup	161	123	80	81	43	0.497	-2,0.5,0.5-1,0.6-,1-2,1-2.5,1.5-2,2-2.5,2-3,2.5-5,3-4,5-6,5-7,50,abruptly,acuminate,along,anther,apex,base,beneath,branched,calyx,cm,conical,corolla,darker,diameter,elliptic,filament,flattened,flower,fruit,fruiting,glabrous,globose,green,greenish,later,less,lobed,long,markedly,minutely,mm,mottling,nearly,obovate,occasionally,ovary,ovate-reniform,pale,papillae,papillose,pedicel,peduncle,petiole,pink,point,pointed,purplish,reddish,scar,scattered,short,shrub,single,smooth,somewhat,stem,stigma,stripe,surface,tan,time,trichome,vein,white,x,young	-0.5,-45,..,0.5-4,1-1.5,1.0-1.3,1.5,10-20,11-30,12-13,2.5-,3-celled,3.5-4,4.1-16,5-,8-9,anthesi,apicula,apiculate-deltate,attenuate,branc,branch,brittle,brow,c.,cell,cucullate,curve,dark,deltate,dry,drying,eaf,edicel,eed,elongate,erec,flattened-capitat,glandular,gradually,lobe,lower,membranous,middle,minute,narrowly,never,nflorescence,noddin,open,outer,outline,pair,papillate,per,pericarp,planar,plurifoliat,primary,quadrate,regularly,ruit,single-stemmed,sinuate,small,striate,testa,thin,thing,tip,toward,triangular,tube,tuft,ud,unit,usually,wall,wand-like,widening,ympodial	'',[,``,abaxial,adaxial,arrangement,bark,bud,center,characteristic,colour,curved,flattened-capitate,form,growth,height,history,inflorescence,leaf,length,life,margin,na,new,nodding,number,perennial,plant,plurifoliate,position,prickle,rachi,reproduction,seed,shape,spacing,staman,style,texture,value,width,{,}
763	wfo-0001031738	success	231	110	84	147	26	0.364	0.1-0.25,0.7-1,0.7-1.1,1-1.5,1-4,1.5-4,15-40,2.3-3,3-7,4-6,4-8,5-8,6-15,abaxial,adaxial,andromonoecious,anther,apex,bark,branched,calyx,cell,chartaceous,cm,curved,dark,densely,diameter,dull,erect,filament,flattened,flattened-reniform,flower,fruit,fruiting,glabrescent,glabrous,gray,lateral,leaf,length,lobed,margin,mm,multangulate,narrow-deltate,orange,orange-brown,outline,ovate,pale,pedicel,peduncle,petiole,pit,plant,porrect,prickle,raised,rounded,scar,shrub,simple,small,smooth,spherical,stalked,stellate,stellate-pubescent,stem,straight,strongly,style,surface,terminal,tree,trichome,variously,weakly,white,yellow,yellow-green,yellowish	-15,-5,-6,-merous,.5,0,0-2,0-3,0.2-0.3,0.25-0.8,0.3-1,0.9-2.1,1-1.8,1-3,1.4-1.7,1.5-,1/,1/2-2/3,1/3,1/3-2/3,1/4-1/3,1/6-1/4,10-15,2-,2-4,20-200,3-4,3-6,3.5-3.8,3.5-4.5,4,4-10,4-5,5,7-12,7-12.5,8-10,8-18,abaxially,acuminat,acute,adaxially,almost,always,alyx,apar,apart,apically,apparently,articulated,auriculate,base,berry,blade,connivent,cordate,deltate,discolorous,distal,distance,drying,eaf,eed,elongating,equal,evenly,extending,free,frequently,green,held,hermaphrodite,heterostylous,infructescence,inside,lobe,lobing,long,long-styled,longer,lower,lowermost,mature,maturity,midpoint,midvein,nflorescence,oblong,obovate,often,older,one,open,orolla,oung,pair,per,pericarp,plurifoliat,poorly,poricidal,portion,prickl,prickly,primary,prominent,pubescent,ray,reflexed,resin,ruit,secondary,sessile,short-styled,shorter,side,sometimes,spaced,sparsely,spreading,stalk,staminat,sticky,stout,tamen,tapering,terete,tertiary,time,tip,truncate,tube,unarmed,unit,upper,usually,vary,vein,venation,visible,way,white-brow,wide,woody,yellow-orange,ympodial,young	arrangement,bud,center,colour,corolla,form,growth,height,history,inflorescence,life,na,new,number,ovary,perennial,position,reproduction,seed,shape,spacing,staman,stigma,texture,white-brown,width
764	wfo-0001031752	success	172	112	80	92	32	0.465	-10,-100,-44,-47,-6,0.5-1,0.5-1.5,1-1.5,1-3,1-4,1.5-10.5,1.5-2,1.5-3.5,15-25,15-40,2-2.5,2-5,3.5-15,5-6,5-8,acuminate,acute,apex,articulated,base,calyx,chartaceous,cm,darker,deltate,densely,diameter,ellipsoidal,elliptic,entire,flattened,fleshy,flower,fruit,fusiform,glabrescent,glabrous,green,immature,light,margin,membranaceous,mm,moderately,near,oblong,older,ovate,ovoid,pedicel,peduncle,petiole,pink,puberulent,pubescent,purplish,rachi,ripe,rugose,shrub,simple,small,sparsely,stellate,stigma,stripe,style,subcoriaceous,tree,truncate,unbranched,white,x,yellow,young	-3,-pubescent,1,1-,1-2,1.5-2.5,1.5-3,2-3,20-35,3-11.5,3-4,3-4-foliat,3-7,3.5-5,5-23,8-15,9-16,abaxially,adaxially,aggregate,apart,ape,apiculate,axe,basal,beyond,blade,cell,ciliat,ciliate,connective,connivent,cuneate,cylindrical,directed,distally,eaf,eed,equal,exceeding,exserted,glabrate,gland,glandular-puberulen,glandular-puberulent,lanceolate,leaving,less,linear,lobe,lon,long,lower,narrowly,nearly,nflorescence,nther,obtuse,often,olde,orolla,pedicellar,perfect,pore,presen,present,purpl,radiu,remnant,rounded,ruit,slightly,spaced,stalked,stamen,stone,subcordate,swelling,tal,tem,thecae,time,tip,tomentose,triangular,truncat,tube,ud,unit,vary,wide,ympodial	abaxial,adaxial,anther,arrangement,bark,bud,colour,corolla,filament,form,growth,height,history,inflorescence,leaf,length,life,na,number,ovary,plant,position,prickle,reproduction,seed,shape,spacing,staman,surface,texture,trichome,width
765	wfo-0001031756	success	186	108	78	108	30	0.419	-5,.5,0-2,0-5,0.1,0.4-1.6,0.5-1,0.8-1,1-3,1-4,1.5-2,1.5-3.5,10,2-6,3-7,5-merous,accrescent,anther,apex,bark,calyx,cm,color,densely,diameter,entire,erect,evenly,filament,finely,flattened-reniform,flower,fruit,fruiting,glabrescent,glabrous,gray,green,invested,known,leaf,lobed,margin,mature,mauve,mm,moderately,orange-brown,ovate,pale,pedicel,peduncle,petiole,pitted,porrect,prickle,red-brown,rounded,scar,shoot,short,shrub,simple,sparsely,spherical,stalked,stellate-pubescent,stem,straight,style,surface,terete,terminal,trichome,variously,white,yellow-green,young	-1,.1,.8,/2,0,0.02-0.2,0.15-0.25,0.2,0.5-1.3,0.6-1.2,0.6-1.6,0.7-1.7,00,1-1.8,1-2,1.8-2.5,1/2,1/3,3-15,3-5,4-5,4.5,6-9,7-10,9-14,abaxially,acut,alyx,apar,apart,apically,apparently,articulated,base,berry,blade,branched,broad-deltate,chartaceous,concolorous,conical,connivent,cordate,curved,deltate,drying,eaf,eed,elongating,enclosing,equal,eye,free,fully,glabrou,herbaceous,inflated,infructescence,lobe,long,longer,lower,midpoint,naked,nflorescence,older,one,open,orolla,oung,pair,pendulous,per,perfec,pericarp,perpendicular,plurifoliat,poricidal,portion,prickl,prickly,primary,ray,ruit,scandent,sessile,shorter,slender,small,smooth,spaced,spreading,stalk,stellate,tamen,tapering,time,tip,truncate,tube,unarmed,unit,vary,vein,visible,way,wide,ympodial	abaxial,adaxial,arrangement,bud,cell,center,colour,corolla,form,growth,height,history,inflorescence,length,life,na,new,number,ovary,perennial,plant,position,reproduction,seed,shape,spacing,staman,stigma,texture,width
766	wfo-0001031761	invalid_json_followup	207	125	89	118	36	0.43	.5,0,0-0.4,0-12,0.3-2.8,0.5,0.5-0.7,0.5-1.5,0.7-1.3,0.9-2,1,1-4,1-8,1/4-1/3,2-3.5,3.2-3.5,4-7,5-merous,abaxially,acicular,acute,anther,apart,apex,bark,base,berry,branched,calyx,cell,cm,densely,diameter,dull,elongating,erect,filament,flattened,flattened-reniform,flower,fruit,fruiting,glabrous,lateral,leaf,length,lobed,long,margin,mature,maturity,mauve,mm,moderately,orange,orange-brown,outline,ovate,pedicel,peduncle,petiole,pit,porrect,prickle,purple,raised,red,red-green,rounded,scandent,scar,shrub,simple,small,smooth,sparsely,spherical,stalked,stellate-pubescent,stem,straight,style,surface,terete,trichome,variously,weakly,wide,yellow	-12,-20,-3/,-6.5,-7,.4,0-10,0-15,0-25,0-4,0-5,0.2-0.4,0.3,0.3-0.4,0.6-1.2,0.7-1.6,0.75-1.7,1-3,1.5,1.5-4.2,1.5-6,1.8-2.3,1/2,1/2-2/3,1/3,1/3-2/3,2,2-4,2-8,2.5-3.1,2.5-5.5,3-15,3-5,4-6,7-9,acut,alyx,ame,apar,apically,apparently,articulated,blade,brow,c.,concolorous,connivent,cordate,curved,deltate,difoliate,discolorous,distance,drying,eaf,eed,equal,extending,faint,free,fully,geminat,gray-green,infructescence,lobe,longer,lower,midpoint,midvein,narrow-oblong,nflorescence,older,one,open,opening,orolla,oung,pair,pale,per,perfec,pericarp,perpendicular,poricidal,portion,prickly,primary,ray,recurved,sessile,shallow,side,slender,sometimes,spaced,spreading,stalk,stellate,tamen,tapering,tertiary,thick-chartaceous,time,tip,tube,uit,unarme,unarmed,unit,upper,vary,vein,venation,visible,way,woody,yellow-green,ympodial	'',[,``,abaxial,adaxial,arrangement,brown,bud,center,characteristic,colour,corolla,form,growth,height,history,inflorescence,life,na,new,number,ovary,plant,position,rachi,reproduction,seed,shape,spacing,staman,stigma,texture,value,width,{,}
767	wfo-0001031786	invalid_json_followup	209	131	94	115	37	0.45	.4,/3,0.1-0.4,0.2-2.5,0.5-1.5,0.7-1,0.7-1.6,0.7-4,1-4,1.2-1.6,1.5-2.5,2-3,2-7,2-8,6-8,abaxially,acute,almost,anther,apex,articulated,bark,base,becoming,berry,calyx,cell,chartaceous,cm,curved,dark,deep,densely,diameter,elliptic,erect,evenly,filament,flattened-reniform,flower,fruit,fruiting,glabrescent,glabrous,gray,green,herb,lateral,leaf,length,lobed,margin,mauve,membranous,mm,orange,orange-brown,outline,ovate,pale,pedicel,peduncle,petiole,pit,porrect,prickle,raised,red,red-brown,reflexed,scar,sessile,shiny,shrub,simple,small,smooth,sometimes,sparsely,spherical,stalked,stellate-pubescent,stem,stigma,straight,style,surface,terete,trichome,variously,way,white,yellow-orange,young	-5,.5,/2,0,0-2,0-20,0-3,0-5,0.1,0.2-0.3,0.25-0.5,0.8,0.8-1.2,1,1-2,1-3,1-6,1.5-1.9,1/3-1/2,2-13,2.5-3.5,3-4,3-5.5,4-5,5-7,5-merous,8-12,acut,alyx,ame,apar,apart,apically,apparently,blade,branched,c.,clavat,concolorous,connivent,cuneate,deltate,distance,drying,eaf,eed,elongating,equal,extending,eye,filiform,flattened,free,gray-brow,herbaceous,inconspicuous,infructescence,lobe,lon,long,longer,lower,mature,maturity,midpoint,midvein,minute,naked,nflorescence,obtuse,older,one,open,orolla,oung,pair,pendulous,per,perfec,pericarp,plurifoliat,poricidal,portion,prickl,prickly,primary,ray,rounded,ruit,scandent,shorter,side,slightly,spaced,spreading,stalk,stellate,tamen,tapering,tertiary,thick,time,tip,truncate,tube,unarmed,unit,vary,vein,venation,visible,weakly,wide,woody,ympodial	'',[,``,abaxial,adaxial,arrangement,bud,center,characteristic,clavate,colour,corolla,form,gray-brown,growth,height,history,inflorescence,life,na,new,number,ovary,perennial,plant,position,reproduction,seed,shape,spacing,staman,texture,unknown,value,width,{,}
768	wfo-0001031791	invalid_json_followup	288	139	90	198	49	0.312	.3,.5,.9,1.6,3,3.0,abaxially,acute,alveolate,anther,apex,apiculate,area,bud,calyx,central,chartaceous,cm,corolla,densely,developed,diameter,dry,drying,entire,erect,extra-axillary,filament,flattened-reniform,flattened-suborbicular,flower,fruit,glabrous,globose,green,immature,inflorescence,interpetalar,lanceolate,lateral,lavender,leaf,length,lobe,long,margin,material,maturing,mm,moderately,nearly,orange-red,oval,ovoid,pedicel,peduncle,petiole,poorly,porrect-stellate,preserved,prickle,pubescent,sessile,shiny,shrub,simple,small,smooth,somewhat,stellate,stem,stigma,straight,style,subcoriaceous,surface,thrice-branched,tip,tissue,tree,triangular,truncate,twice,wavy,well,white,yellow,yellow-brown,yellow-tan,×	.08,.2,.4,0.04,0.2,0.3–0.5,0.3–0.6,0.3–0.7,0.4–0.6,0.5,0.5–0.6,0.5–1.0,0.7,0.7–0.8,0.7–1.0,1.1–1.4,1.3–1.8,1.5,1.5–1.9,1.5–2.3,1.5–3.0,1.6–2.2,1.7–2.3,1.8,1.9–2.2,1/3,11–14,11–15,13.0–30.0,15.0,2.0–11.0,2.0–2.5,2.6–3.4,2.8–3.3,2/3,3.0–3.5,33–54,4.6–5.4,4.9,4.9–7.4,5-merou,6.0,6.0–14.0,6.2–8.5,7.0–9.0,7–10,7–8,8.0–11.0,8–12,9.0–16.0,across,adaxiall,adaxially,adnate,alyx,anthesi,apical,apparently,appearing,appressed,around,articulated,attachment,attenuate,axe,ba,backward,base,berry,blade,branch,broad,broad-based,brochidodromous,capitat,channeled,congested,connivent,cordate,curved,dehiscence,dentate,development,difoliate,distally,distinct,dorsally,eaf,eed,either,emerging,endocarp,entir,especially,fertile,filiform,first,flexed,fork,free,frui,geminat,glabrescent,glandular,gradually,hair,homostylous,inclined,increasing,internode,intersepalar,juic,juvenile,lamina,large,largest,light,like,line,lon,longer,lower,m.,major,mature,membranaceous,middle,midpoint,midrib,midvein,minor,minute,multangulate,nflorescence,notched,numerous,oblique,obscured,often,one,orolla,oung,particularly,persisting,point,pore,porrect,portion,potentially,project,raised,ray,rigid,ripe,rounded,row,rugose,ruit,scarcely,scattered,short,shorter,side,single,sinus,slender,slightly,smaller,sometimes,sparsely,splitting,stamen,stellae,stellate-pubescen,stipe,stipitate,suture,tamen,tardily,time,totally,translucent,tube,two,ud,unarmed,undulate,various,vary,vein,weakly,wide,ympodia,young,±90°at,±equal,±glabrous,±laterally	'',0.3-0.6,0.5-1.0,2.0-11.0,2.8-3.3,3.0-3.5,33-54,5-merous,6.2-8.5,8.0-11.0,[,``,abaxial,adaxial,arrangement,bark,capitate,cell,center,characteristic,colour,dioecious,form,fruiting,growth,height,history,life,na,new,number,ovary,perennial,plant,position,rachi,reproduction,scar,seed,shape,spacing,staman,stellate-pubescent,texture,trichome,value,width,{,}
769	wfo-0001031793	invalid_json_followup	188	117	77	111	40	0.41	-4,.5,0,1-2,1-3,1-8,1.5-4,10-15,15-20,2-3,3-8,40,5-merous,abundant,acuminate,aging,almost,anther,apex,articulated,base,black,branched,broadly,brown,brownish,calyx,capitate,cm,densely,diameter,elliptic,erect,evident,extra-axillary,ferrugineous,filament,flattened,flower,forked,fruit,fruiting,globose,inflorescence,interpetalar,leaf,long,margin,minutely,mm,mucilaginous,orange-yellow,orbicular-ovate,pedicel,peduncle,petiole,prickle,pubescent,rachi,reddish,scarcely,shrub,simple,small,stellate,stellate-pubescent,stem,stigma,style,surface,tissue,tree,trichome,unbranched,white,yellow,yellow-brown	1,1-1.5,1.5-2,1/3,1/4,1/5,13-20,2-5,20,26,3-4,3/4,4,7,8-11,absent,accrescent,acumen,acute,adult,alyx,apparently,armed,aspect,axe,ba,berry,bilobe,blade,branche,broad,central,chartaceous,cuneate,cut,difoliate,distal,eaf,eed,elongatin,erec,extreme,geminat,general,glandular,hair,homostylou,larger,linear,lobe,lobing,lon,lower,main,many,maturing,midpoint,midrib,mostly,nflorescence,oblique,oblong-lanceolate,obtuse,often,older,orolla,ovate,per,perfect,pore,porocidal,porrect,principal,reduced,reticulation,rounded,ruit,rusty,scattered,sessile,shallow,side,similar,single,sinus,size,smaller,sparsely,stellate-pubescen,stipitate,stout,tall,tamen,tem,testa,thickened,tip,triangular,triangular-acuminat,tube,unarmed,unit,upward,usually,uvenile,vary,way,well-developed,woody,x,ympodial	'',[,``,abaxial,adaxial,arrangement,bark,bilobed,bud,center,characteristic,colour,corolla,form,growth,height,history,homostylous,length,life,lobed,na,new,number,ovary,perennial,plant,position,reproduction,scar,seed,shape,spacing,staman,texture,triangular-acuminate,value,width,{,}
770	wfo-0001031795	invalid_json_followup	234	128	93	141	35	0.397	0.5,0.5-2,1-1.2,1-3,1.5-2,1.5-4,10,10-12,2-6,2/3,3,5,50,6-8,abaxial,acuminate,acute,adaxial,anther,apex,bark,base,brownish,calyx,capitate,cm,conical,curved,dark,densely,diameter,elliptic,entire,filament,flattened,flower,fruiting,glabrescent,glabrous,globose,grayish,green,growth,irregularly,lateral,leaf,leaf-opposed,live,lobed,long,margin,matte,minutely,mm,new,occasionally,ovate,pale,pedicel,peduncle,persistent,petiole,pitted,plant,porrect,prickle,pubescent,reniform,ripe,scar,sessile,shallowly,shape,shiny,shrub,simple,slender,slightly,smooth,spaced,stellate-pubescent,stem,stigma,style,surface,tan,terete,thin,trichome,way,white,yellowish,½	..,.2,.5,0.5-1,1,1-1.3,1-4,1/3,100,2-2.5,2.5-3,3-4,4-,4-5,4-6,5-12,5-40+,5-merous,5.5-,7-9,9-17,<,>,abaxially,absent,adaxiall,alf,almost,along,always,alyx,anthesi,apar,armed,around,articulated,berry,blade,branched,broad-based,broadly,c.,caudate,cell,clearly,connivent,deeply,denser,differing,difoliate,directed,discolorous,distally,dry,eaf,eed,equal,evenly,free,geminat,geminate,gland-tipped,glandular,gra,infructescence,lamina,like,lobe,lon,long-stalked,longer,lower,major,many-branched,membranous,midpoint,midrib,midvein,minor,mixture,much,multangulate,multiseriate,never,nflorescence,oblique,often,older,orolla,oung,outline,pair,papillat,pendant,per,perfec,pericarp,pore,poricidal,portion,prickly,primary,ray,reduced,reflexed,ruit,scattered,short,short-,short-stalked,sinuate,size,somewhat,sparsely,spreading,stalk,stellate,straigh,tamen,tapering,testal,thicker,time,tip,toward,triangular,truncate,tube,unarme,unarmed,unicellular,unit,upward,usually,vary,vein,visible,wide,woody,ympodial,young	'',[,``,apart,arrangement,bud,center,characteristic,colour,corolla,form,fruit,gray,height,hermaphroditic,history,inflorescence,length,life,na,number,ovary,p,perennial,position,rachi,reproduction,seed,spacing,staman,texture,value,width,{,}
771	wfo-0001031829	invalid_json_followup	138	93	54	84	39	0.391	.25,0.7-1,1-2,1.3-1.5,1.5-2,1.5-2.5,2-4,4-4.5,acute,adaxial,anther,apex,bark,broadly,calyx,capitate,cm,conical,corolla,densely,elliptic,filament,fruiting,globose,green,greenish-brown,growth,inflorescence,leaf,lobed,margin,mm,opposite,ovary,packed,pedicel,petiole,pubescent,revolute,scar,shrub,simple,soft,sparsely,stem,stigma,style,surface,tapering,trichome,uniseriate,waxy,white,x	.5,0.5-2.1,1,1.5-3.5,1.5-4.5,3-5-flowered,3/4,4-8.5,7-10,abaxially,absent,adaxially,along,anthesi,ape,apiculae,bae,base,berry,branched,crystalline,deflexed,denser,dia,differing,difoliate,drying,eaf,edicel,eed,epidermi,erect,exserted,free,geminat,glabrat,glabrous,immature,known,large-celled,lateral,leathery,like,lobe,lon,long,lower,main,major,minor,minute,minutely,nflorescence,occasionally,often,older,overlappin,pair,papillo,papillose,planar,pore,poricidal,portion,quadrate,ruit,shaped,size,somewhat,tall,tear-drop,thick,tip,tub,tube,tuft,ud,unit,vein,way,woody,yellowish,ympodial,young	'',3-5,[,``,abaxial,arrangement,bud,cell,center,characteristic,colour,diameter,flower,form,fruit,glabrate,height,history,length,life,na,new,number,peduncle,perennial,plant,position,prickle,rachi,reproduction,seed,shape,spacing,staman,texture,value,width,{,}
772	wfo-0001031832	invalid_json_followup	232	135	97	135	38	0.418	0.1-0.3,0.2-1.5,0.3-0.8,0.3-3,0.7-1.5,0.7-2,1-12,1.2-1.6,1/2-3/4,2-3.6,2-6,2.5-6.5,3-6.5,4-20,5-21,9,abaxially,acuminate,adaxially,anther,apart,apex,bark,base,becoming,brown,bud,bullate,calyx,chartaceous,cm,conical,continued,corolla,dark,deltoid,diameter,due,entire,filament,flower,fruit,fruiting,glabrescent,globose,granular-tomentose,green,greenish,growth,honeycombed,lanceolate,lateral,leaf,length,lobed,margin,mm,mostly,oblanceolate,obovoid,orbicular,pale,pedicel,peduncle,petiole,pitted,probably,pubescent,rachi,reniform,reticulate-punctate,ripe,rotate-stellate,rough,scabrous,shrub,simple,smooth,somewhat,soon,sparingly,stellate-pubescent,stem,stigma,style,suborbicular,surface,terminal,translucent,tree,violet,way,white,x,yellow,yellowish,young	-8,.5-1,/50-1/10,0-150,0.2-0.6,0.7-1.6,0.8-1.2,1.1-2.4,1.2-2,1.2-2.5,1.3-4.2,1.5-4,1.7-4,1.8-4,14,2-4,2.8-4.8,3-7,3.5-7,4-7,5.5-10,7-10,8-25,accrescent,acute,ag,anthesi,apical-lateral,apice,apparently,articulated,attenuate,axe,axillary,ba,basal,berry,blade,blister,blunt-tipped,branch,branched,brownish,capitat,closely,connate,decurrent,dehiscing,directed,eaf,eed,evident,exserted,extend,ferrugineous,few-rayed,fleshy,forming,free,glabrescen,glabrous,hair,half,high,indument,inserted,introrse,lackin,large,line,lobe,long,long-,longer,longitudinal,lower,m.,main,midvein,minute,mixed,multangulate,nearly,nflorescence,oblong,obtuse,occasionally,older,orolla,ovate,partly,perfect,persistent,plurifoliate,pore,porrect-stellat,porrect-stellate,pubescence,rather,ray,relatively,ruit,runk,sessile,short-,short-stalked,side,slit,sometimes,spaced,sparse,splitting,stamen,stipitate-glandular,subcampanulate,suture,swelling,tamen,terete,testa,thick,thick-stalked,time,toward,tube,unarme,unarmed,unit,usually,vary,vein,weakly,whitish,wide,ympodial	'',20-150,[,``,abaxial,adaxial,arrangement,capitate,cell,center,characteristic,colour,form,height,history,inflorescence,life,na,new,number,ovary,perennial,plant,position,prickle,reproduction,scar,seed,shape,spacing,sparing,staman,texture,trichome,value,width,{,}
773	wfo-0001031834	success	150	85	55	95	30	0.367	0.5,0.5-1,0.5-3,0.5-3.5,0.6-1.4,0.8-1,1.5,1.6-2,6-7,accrescent,acuminate,anther,apex,calyx,cm,corolla,covered,few-flowered,filament,flattened-reniform,fruit,fruiting,glabrous,globose,green,greenish-yellow,hooked,leaf,less,lobed,minutely,mm,opposite,ovary,ovate,pale,papillose,pedicel,petiole,pitted,scabrous,shrub,simple,slender,slightly,stem,stigma,style,surface,tan,tapering,trichome,white,x,yellow	.5,0.8-1.3,0.9-1.4,1,1.5-4,1.9-6.5,2.9-7,2/3,6.5-14,across,acute,anthesi,apar,apically,apiculate,appear,attenuate,base,berry,bi-cellular,borne,campanulate,deciduou,deciduous,decurrent,deflexed,deltoid,depression,dia,difoliate,eaf,edicel,eed,expanded,eye,free,geminat,glabrou,hook,incrassate,lamina,larger,leaving,like,lobe,lon,long,lower,major,margin,markedly,middle,minor,minute,mound-like,multicellular,naked,nflorescence,often,papillo,persistent,planar,pore,poricidal,portion,proximal,pubescent,ruit,scar,shaped,short,small,soon,spaced,sparsely,speck,straight,tall,tear-drop,tip,tube,tufted,ud,unevenly,uni-,uniseriate,unit,upper,usually,vein,way,widest,woody,ympodial,young	abaxial,adaxial,alternate,apart,arrangement,bud,colour,diameter,flower,form,growth,height,history,inflorescence,length,life,na,number,peduncle,perennial,plant,position,rachi,reproduction,seed,shape,spacing,staman,texture,width
774	wfo-0001031839	success	138	113	73	65	40	0.529	1-1.4,1.2-1.5,1/3-2/3,2.5-3.5,4-8,6-15,7-10,8-15,across,anther,apically,armed,beneath,berry,blade,blue,blue-tinged,broadly,brown,calyx,cm,dark,dark-based,deltoid,developing,dry,erect,extended,foveolate,fully,glabrous,green,herb,internodal,invested,lenticular,ligneous,lobe,long,maturity,minutely,mm,olivaceous,otherwise,ovary,ovate,pale,perennial,petiole,pinnatifid,prickle,pubescent,purple,root,smooth,spherical,splitting,spreading,stellate-pentagonal,stellate-pubescent,stellate-tomentose,stem,subulate,tawny,tightly,tube,twice,velvety-tomentose,weakly,white,whitish,yellow,zygomorphic	.5,1,2/3,3-7,8-14-rayed,9-12,9-13-flowere,accrescent,along,alyx,annually,anthesi,arcuate,base,becoming,bristly,broad,campanulate,cauline,confluent,da,densely,density,dia,difoliate,divided,eaf,eed,emerging,externall,geminat,linear-lanceolate,lon,long-stalked,long-stipitate,main,nearly,nflorescence,often,orolla,persisting,prickly,rounded,ruit,several,short,slende,somewhat,stella,stellae,stellate-tomento,stipitate,tamen,throughout,tigma,tub,tyle,ultimate,unexpande,unit,usually,varying,vein,year,ympodial	9-13-flowered,abaxial,adaxial,apex,arrangement,colour,corolla,diameter,externally,filament,flower,form,fruit,growth,height,history,inflorescence,leaf,length,life,na,new,number,pedicel,peduncle,plant,position,rachi,reproduction,seed,shape,spacing,staman,stigma,style,surface,texture,trichome,unexpanded,width
775	wfo-0001031842	invalid_json_followup	161	126	88	73	38	0.547	.4,.5,0.1-0.5,0.5-2,0.6-1,0.7-1,1,1-1.8,2-10,2.5-3,3-8,3/4,4.5-6,acute,anther,apart,apex,axil,bark,base,beneath,bi-lobed,brown,calyx,capitate,cm,corolla,cup-shaped,dark,deeply,dia,dry,ellipsoid,elliptic,filament,flattened-reniform,fruiting,glabrous,globose,green,irregularly,later,lateral,leaf,leaf-opposed,lobed,long,main,margin,minutely,mm,near,new,often,opposite,ovary,overtopping,pale,papillose,pedicel,petiole,pitted,scar,shiny,shoot,shrub,simple,slender,spaced,specimen,stem,stigma,strongly,style,surface,tapering,terminal,tree,trichome,tube,tuft,uniseriate,vein,way,white,woody,x,young	.1,.75,0.5-1,1-1.5,1-3.5,1.5-2,10-12,10-20,10-30-flowered,2-3,2.5-6,7-9,9-15,anthesi,attenuate,ba,bearing,beginning,berry,cusp,decurrent,deflexed,densely,differing,difoliate,eaf,edicel,eed,exserte,exsertion,free,geminat,incrassate,inflorescenc,lobe,lon,lower,major,middle,minor,nflorescence,older,one,onto,pair,paler,papillo,pore,poricidal,portion,prominent,pubescent,quadrate,reddish,reddish-resinous,reflexed,ruit,shaped,size,somewhat,soon,sparsely,straight,tall,tear-drop,time,tip,ud,unit,widest,yellowish,yellowish-whit,ympodial	'',10-30,[,``,abaxial,adaxial,arrangement,bud,characteristic,colour,diameter,flower,form,fruit,growth,height,history,inflorescence,length,life,na,number,peduncle,plant,position,prickle,rachi,reproduction,seed,shape,spacing,staman,texture,value,width,yellowish-white,{,}
776	wfo-0001031843	success	245	131	103	142	28	0.42	.5,0-4,0.2-2,0.5-1.5,0.6-1.2,1-2,1-7,1.2-2,1.2-2.2,1.5-2,3-4,3-7,5-12,6-9,acuminate,almost,anther,apex,apically,appressed,around,bark,base,berry,black,branch,brown,calyx,capitate,caudate,cm,completely,conical,corolla,cupular,curved,dark,deeply,diameter,dilated,discoid,distributed,drying,dull,entire,erect,evenly,filament,finely,flexuous,flower,fruiting,glabrous,green,honeycomb,largely,leaf,length,liana,lobed,long,longitudinally,main,margin,mm,multiseriate,oblong,obovate,orange,orange-brown,orange-yellow,partly,pattern,pedicel,peduncle,petiole,pitted,present,pubescent,rachi,red,reddish,ribbed,ridged,scar,seed,shrub,side,slender,small,sparsely,spheroidal,stem,stigma,straight,stump,style,surface,terminal,trichome,violet,x,young	.2,.3,.6,0.4-0.5,0.5-1,0.7-1.2,0.7-2,0.8-2,1.5,1.8-2.5,1/6-1/4,1mm,2-3,2-4,2.5,4-12,45-60°,5-10,abaxially,accrescent,adaxially,age,along,always,alyx,anthesi,apar,apice,apparently,articulated,attenuate,basal,becoming,branched,branching,broadly,canaliculate,clearly,collapsing,cuspidate,delineated,deltoid,dendritic,density,detaching,discolorous,domatia,eaf,eed,ellipsoi,equal,even,eye,fertilisation,fine,flat,forming,free,hand,inner,leave,len,lengthening,lignified,like,lobe,loop,looping,lower,m.,midvein,much,naked,network,never,nflorescence,nther,oblique,obscure,older,opening,orolla,outline,ovate,pair,papillo,part,pendulous,perfec,pericarp,pit,plurifoliat,pore,poricidal,portion,primary,prominent,pronounced,protruding,raised,rarely,recurve,reveal,rounded,ruit,see,shallowly,shiny,shortly,simple,sinus,slightly,smaller,smooth,sometimes,soon,spreading,strongly,surfac,tearing,tertiary,thick-chartaceous,thickened,thin,tip,tube,tuft,twice,ud,unarmed,unit,variable,vary,vein,venation,visible,weakly,white,wide,wider,without,ympodial	abaxial,adaxial,arrangement,bud,cell,center,colour,ellipsoid,form,fruit,growth,height,history,inflorescence,life,na,new,number,ovary,papillose,plant,position,reproduction,shape,spacing,staman,texture,width
777	wfo-0001031852	success	155	81	54	101	27	0.348	0.1-1,1-4,1-4.2,1-9,1.4-3,12-35,3-9,4-6,7-,9-11,apex,articulate,branched,cell,cm,conical,corolla,cyme,diameter,dichasial,dichasially,distal,ebracteate,elliptic-lanceolate,filament,flower,green,green-white,half,herbaceous,lanceolate,leaf,light,mm,monochasial,mucilaginous,odd-pinnate,ovoid,pedicel,peduncle,perennial,petiole,plant,proximal,pubescent,rachi,seed,stellate,stigma,style,throughout,white,yellow,¼	-8,0.5-1.3,0.5-3,1-,1.3-2.5,1.5-3,2-3,2-5.5,2.6-9.5,3-4,3-6-foliat,3.5-10,4-,4-10,4-5,5-15,abaxially,abruptly,absen,acumen,acuminate,acute,adaxially,apical,apically,apiculate,attenuate,base,calyx,connate,covering,decurrent,dehiscent,digestion,diminishing,dorsally,eaf,edge,eed,elliptic,emoval,enzyme,exceeding,flat,folded,forked,generally,globo,hair-like,honeycomb,interjected,introrse,lateral,leaflet,living,lobe,lon,long,lower,lunat,make,maturing,nflorescence,nther,oblique,oblong,often,orolla,ovate-elliptic,pair,pattern,perfect,plan,poricidally,reveal,ruit,sessile,seudostipule,short,shortly,size,slit,specimen,stamen,straight,tal,tem,terminal,testal,thick,throughou,toward,tuber-bearing,typically,unit,vary,wall,white-crea,wide,without,ympodial	abaxial,adaxial,anther,arrangement,center,colour,form,fruit,globose,growth,height,history,inflorescence,length,life,na,number,ovary,position,reproduction,shape,spacing,staman,surface,texture,white-cream,width
778	wfo-0001031864	invalid_json_followup	140	110	67	73	43	0.479	.2,.25,.5,0.2-0.5,0.5-13.5,0.5-4,1-1.2,1-1.8,1-2,1.5-10,1.5-2.5,15-60,2-3,2.5-6,3-3.5,3-pinnate,5-15,abaxially,adaxially,anther,apex,calyx,ciliate,cm,deltoid,dense,diameter,emarginate,entire,extra-axillary,filament,flower,fruit,fruiting,glabrous,herbaceous,lenticular,margin,mm,near,ovoid-deltoid,pedicel,peduncle,petiole,pubescence,pubescent,rachi,rotate,rounded,scattered,short,slender,sparsely,stem,stigma,style,surface,tip,trichome,truncate,unbranched,unknown,vine,violet,wide-diameter,widely,x	0.4-3,0.6-3.5,0.6-4,0.7-0.8,0.8-1,1-3,1-5,1-6.5,1.2-1.5,1.5,2,5-9,5-merous,7.5-8,accrescent,acuminate,acute,alyx,apar,apical,apiculate,axe,base,berry,blade,c.,capitat,chartaceous,clavate,color,cuneate,densely,eaf,eed,fine,flattened,fleshy,glabrou,hair,lateral,leaflet,like,lobe,lon,long,lower,m.,middle,minutely,moderately,nflorescence,nternode,oblique,orolla,papillose,perfec,petiolule,plurifoliat,pointed,pubescenc,ruit,sand-punctate,slightly,spaced,tamen,tem,terrestria,tube,typical,unit,vary,vein,ympodial	'',[,``,abaxial,adaxial,apart,arrangement,bark,bud,capitate,cell,center,characteristic,colour,corolla,form,growth,height,history,inflorescence,leaf,length,life,na,new,number,ovary,perfect,plant,position,prickle,reproduction,scar,seed,shape,spacing,staman,terrestrial,texture,value,width,{,}
779	wfo-0001031864	success	148	96	70	78	26	0.473	.2,.25,.5,0.5-13.5,0.5-4,0.6-3.5,0.6-4,1-1.2,1-1.8,1-2,1-3,15-60,2-3,2.5-6,3-3.5,3-pinnate,5-15,abaxially,adaxially,anther,apart,apex,apical,apiculate,apparently,base,blue-purple,ciliate,cm,color,cuneate,dense,diameter,emarginate,entire,extra-axillary,filament,fleshy,flower,fruit,glabrous,herb,leaflet,lenticular,margin,minutely,mm,oblique,pedicel,peduncle,perfect,petiolule,pubescence,pubescent,rachi,rotate,rounded,short,slender,somewhat,stigma,style,surface,terrestrial,trailing,truncate,unbranched,unknown,x,yellow	0.4-3,1-5,1-6.5,1.2-1.5,1.5,1.5-2.5,2,3-5-celled,5-9,5-merou,7.5-8,absent,accrescent,acuminate,acute,ag,alyx,articulated,axe,ba,basally,blade,calyx,capitat,center,clavate,connivent,cordate,deltoid,densely,directed,distally,eaf,eed,equal,etiole,fine,fruiting,geminat,hair,interjected,large,lateral,lobe,long,longitudinal,lower,m.,near,nflorescence,node,oblong,opening,orolla,papillose,plurifoliate,pore,pubescenc,rooting,scattered,simple,slightly,slit,spaced,sparsely,tamen,tem,thick,tip,tube,uniseriate,unit,vary,weakly,widely,wiry,woody,ympodial	abaxial,adaxial,arrangement,capitate,corolla,form,growth,height,history,inflorescence,leaf,length,life,na,number,ovary,petiole,plant,position,reproduction,seed,shape,spacing,staman,texture,width
780	wfo-0001031871	success	185	103	76	109	27	0.411	0.4-2,0.6-1.2,1-2,1.5-11,14-22,3-10,3-5,3.5-4,33-40,6-7,6.5-20.5,abaxially,adaxially,anther,apex,articulated,attenuate,axillary,brownish,bud,cell,chartaceous,clavate,cm,condition,corolla,covering,dark,deep,diameter,distal,dot,drying,elliptic,filament,flower,forked,fresh,fruit,glabrous,globose,green,greenish,hair,hair-like,half,herb,high,homostylous,lateral,medium,mm,odd-pinnate,ovate,ovoid,pedicel,peduncle,petiole,petiolulate,plant,rotate,rounded,seed,short,stigma,style,subglabrous,subtending,terminal,testal,thick,tiny,wall,white,whitish,yellow	1.4-2.1,1.5-2,1.5-2.1,1.6-2.7,2-3,2-4,2.9-6,3-4,36-44,4-6,4-7,5-merou,5.4-12.3,6-12,7-9,7.5-23,acumen,acute,adaxiall,ag,alyx,apart,apparently,asymmetric,axe,base,basiscopic,berry,blade,capitat,connivent,digestion,dorsally,eaf,edge,eed,end,enzyme,erec,exceeding,flat,folded,geminat,generally,glabrou,green-white,hal,honeycomb-shaped,interjected,lanceolate,leaflet,lengthening,linear,living,lobe,long,lower,make,mottled,mucilaginous,narrowly,nflorescence,one,orbicular,orolla,pair,perfect,placed,plurifoliate,pore,poricidal,pubescent,purple,removed,ripe,round,ruit,sessile,seudostipule,side,size,slit,sometimes,spaced,specimen,stamen,stolo,straight,subequal,subglabrou,symmetric,tall,tamen,tem,throughout,tip,tissue,tri-,tube,tuber,typically,unit,usually,vary,wet,wide,winged,x,ympodial	5-merous,abaxial,adaxial,arrangement,capitate,colour,form,growth,height,history,inflorescence,leaf,length,life,na,number,ovary,perennial,position,rachi,reproduction,shape,spacing,staman,surface,texture,width
781	wfo-0001031874	success	197	123	93	104	30	0.472	-1.2,0.2,0.2–0.8,0.4,0.5-1,0.5-1.5,0.5–0.9,1-4,1.2,1.8,1.8–2.3,2-4,2-5,3-lobed,3–5,7–8,9–11,abaxially,acute,adaxially,anther,apart,apex,base,bilobed,blue,broadly,calyx,chartaceous,ciliate,cm,completely,diameter,elliptic,especially,extra-axillary,filament,flattened-reniform,flower,fruit,fruiting,fully,glabrous,globose,green,hair,herb,hermaphroditic,least,length,light,line,lobe,long,margin,midrib,minutely,mm,near,nearly,numerous,obtuse,orange,ovate,pedicel,peduncle,petiole,pitted,puberulent,pubescent,rachi,rarely,recurved,red,ripe,rotate-stellate,short,simple,slightly,sometimes,sparsely,stem,stigma,style,surface,tip,triangular,violet,white,white-puberulent,x,yellow,young	-1.5,-3.5,-4,-7,.5-1.2,0.6-1,1.2-1.8,1.3–1.4,1.4–1.5,1.5-,1/10,1/3,1/5,2,2-3,2-3.5,2-foliate,2–2.5,2–9-branched,3-8,3.5–11,4.5-6,5,5-merou,6–7,accrescent,adaxiall,always,alyx,angulate,articulated,asymmetrically,axe,ba,barely,berr,bi-lobed,bifurcation,blade,branch,broad,capitat,connivent,contact,covering,cylindrical,decumbent,dehiscent,downward,eaf,eed,erect,even,geminat,generally,hold,juic,lanceolate,lateral,level,lobed,long-attenuate,longitudinall,lower,lowermost,main,mesocarp,nflorescence,node,oblong,often,one,orolla,ovate-triangular,partially,passing,petiol,pore,prostrate,rooting,ruit,several,side,soil,somewhat,spaced,spreading,swollen,tall,tamen,tem,terete,terminal,time,tube,unit,usually,vary,vein,way,well,wide,winged,ympodial	abaxial,adaxial,arrangement,bark,bud,capitate,colour,corolla,form,growth,height,history,inflorescence,leaf,life,na,number,ovary,perennial,plant,position,prickle,reproduction,seed,shape,spacing,staman,texture,trichome,width
782	wfo-0001031876	success	140	74	44	96	30	0.314	.1,.5,0-flowered,0.5,1-1.6,1.5-2.2,anther,apex,base,calyx,closely,cm,corolla,cup-like,dia,elliptic,filament,flower,glabrous,globose,green,greenish-yellow,leaf,less,lobed,long,mm,nearly,oblanceolate,oblique,opposite,ovary,papillose,pedicel,petiole,shrub,simple,slender,spaced,stigma,style,tapering,tube,white	0.8-1,1,1-1.5,1-4,27-35,3,5,9-15,?,across,acute,anthesi,apiculate,arc,arising,ba,bark,bearing,beneath,berry,bright,convergence,corky,decurrent,differing,eaf,edicel,eed,erect,family,free,fruiting,glabrou,granular,immature,irregularity,known,lateral,lenticellat,lightly,lobe,long-acuminate,lower,main,major,margin,melastomataceae,member,middle,minute,minutely,nflorescence,often,otherwise,overlappin,pair,parallel,perpendicular,persistent,point,pore,poricidal,portion,present,primary,prominent,raised,recurved,reflexed,resemble,ruit,running,scar,secondary,shaped,slightly,stem,straight,styl,tall,tear-drop,time,tip,ud,unifoliat,unit,vein,venation,wide,widest,winged,woody,x,yellow,ympodial,young	abaxial,adaxial,arrangement,colour,diameter,form,fruit,growth,height,history,inflorescence,length,life,na,number,overlapping,peduncle,perennial,plant,position,rachi,reproduction,seed,shape,spacing,staman,surface,texture,unifoliate,width
783	wfo-0001031877	invalid_json_followup	216	135	101	115	34	0.468	0.3-1,0.3-1.2,0.5,0.6-1.2,1-1.5,1-3,1-4,1.5-1.9,2,3-6,3.5-4,6-8,abaxially,acuminate,acute,adaxially,angled,anther,apex,basally,base,bright,brown,calyx,capitate,clavate,cm,conical,corolla,deltate,densely,diameter,ellipsoid,entire,filament,flattened,flower,fruit,fruiting,furcate,glabrous,globose,greenish,growth,hastate,irregularly,later,lateral,line,linear,lobed,long,margin,minutely,mm,nearly,new,occasionally,outline,pale,pedicel,peduncle,perfect,petiole,pitted,plant,plump,pubescent,purple,red,reddish,reniform,ripe,scar,scrambler,seed,semi-woody,shiny,simple,slender,slightly,sometimes,somewhat,spaced,sparsely,stellate,stem,stigma,style,surface,terminal,thin,tinged,triangular,trichome,uniseriate,usually,vein,vine,white,x	+,.3,.5,0.2,0.3-,0.5-1,0.8-0.9,1,1-3.5,1.1-,1.5,1.5-2,1.8-5,2-,2.5,3-5,5-merou,6-10,abruptly,adaxiall,ag,along,alyx,anthesi,apar,apparently,ark,articulated,ascending,basal,berry,cell,connivent,deep,deflexed,distal,dried,eaf,eed,ellipsoidal,enlarged,erect,especially,exposed,exserted,eye,fleshy,free,green,ilament,impressed,internal,lamina,lengthening,like,lobe,long-acuminate,loosely,lower,material,mature,midvein,minute,nflorescence,often,older,orolla,pair,papillate,papillo,parallel,part,per,pericarp,plurifoliat,pointing,pore,poricidal,portion,primary,prominently,pubescence,purplish,rectangular,reflexed,rest,rounded,ruit,short,shorte,silky,sinuate,sleeve,slit,spreadin,strongly,subshru,tem,testal,tip,truncate,tube,twinin,ud,uniformly,unit,upper,vary,visible,wall,weak,woody,yello,ympodial,young	'',[,``,abaxial,adaxial,apart,arrangement,bark,bud,characteristic,colour,form,height,history,inflorescence,leaf,length,life,na,number,ovary,position,prickle,rachi,reproduction,shape,spacing,staman,texture,value,width,yellow,{,}
784	wfo-0001031880	success	180	95	72	108	23	0.4	.5,0.5-1,0.5-2,0.7-0.8,1,1-1.3,1-1.5,1.5,2-3,2.5-8,3-3.5,3-foliate,3-lobed,6-9,7-9,acuminate,acute,anther,apart,apex,brown,capitate,cm,conical,corolla,dark,densely,diameter,elliptic,erect,filament,flattened,fleshy,flower,fruit,glandular,globose,green,herb,inflorescence,internodal,leaf,minutely,mm,orange,ovary,ovoid,pale,papillose,pedicel,peduncle,petiole,pitted,pubescent,purple,rachi,red,reddish,shallowly,simple,slender,stigma,style,subshrub,surface,thin,triangular,trichome,uniseriate,x,yellow,–5	1-2,2,2-4,2-9,3-4-pluri-foliate,4,4-8,5,5-6,abaxially,adaxially,age,anthesi,basal,base,bearing,becoming,berry,broadly,c.,calyx,cell,ciliate,color,cordate,crenate,crowded,cup-shaped,curved,eaf,edicel,eed,ellipsoid,enlarged,entire,exerted,flush,free,fruiting,glabrous,gland,gland-tipped,growing,heteromorphic,hollow,horn,irregularly,lamina,lengthening,less,lobe,lon,long,longest,lower,margin,markedly,mature,maturit,mid-length,middle,narrowly,near,nflorescence,nodding,ovate,pair,papillo,pericarp,plan,pore,poricidal,portion,primary,pubescen,reflexed,ruit,scar,shortest,single,slightly,slit,sometimes,spaced,sparse,sparsely,spreading,stem,straight,strongly,terminal,testal,tip,toothed,truncate,tube,ud,unicellula,unit,unlobed,upper,upward,vein,wall,widely,widest,woody,ympodial	abaxial,adaxial,arrangement,colour,form,growth,height,history,length,life,na,number,perennial,plant,position,reproduction,seed,shape,spacing,staman,texture,unicellular,width
785	wfo-0001031881	success	168	102	72	96	30	0.429	.5,0.5-0.7,0.5-1,1-1.3,1-1.5,1-7,1.2-6,1.5-2.5,3.5-4,5-6,acute,along,anther,apex,axil,bark,beneath,branched,brown,bud,calyx,capitate,cm,corolla,dark,densely,elliptic,erect,filament,fruit,fruiting,glabrous,globose,golden,golden-puberulent,green,inflorescence,lateral,leaf,lightly,lobed,main,midrib,minutely,mm,obovate,opposite,ovary,ovoid-reniform,pedicel,petiole,pitted,puberulent,pubescent,scar,shape,shrub,simple,small,sparsely,stem,stigma,style,surface,tapering,tree,trichome,uniseriate,usually,vein,white,winged	0.1-0.5,0.2,0.2-0.6,0.4-1,1/3,10-12,10-30,2,2-9,3-19,3/4,7-14,absent,anthesi,apar,apparent,attenuate,ba,base,branch,broadly,campanulate,constriction,decurrent,deflexed,deltoid,dia,differing,difoliate,distal,dry,drying,eaf,edicel,eed,either,ellipsoid,evenly,exserted,fleshy,free,geminat,golden-pubescent,greyish-brow,incrassate,inflorescenc,junction,like,lobe,lon,long,lower,major,margin,material,maturity,middle,minor,minute,nflorescence,occasionally,older,one,orbicular,pair,papillo,papillose,planar,pore,poricidal,portion,puberulen,rest,rounded,ruit,shaped,size,slender,slightly,somewhat,soon,spaced,straight,strong,tall,tear-drop,tip,tube,ud,unit,way,widest,woody,x,ympodial,young	abaxial,adaxial,apart,arrangement,cell,center,colour,diameter,flower,form,greyish-brown,growth,height,history,length,life,na,new,number,peduncle,perennial,plant,position,rachi,reproduction,seed,spacing,staman,texture,width
786	wfo-0001031886	invalid_json_followup	169	105	63	106	42	0.373	-9,0.1,0.5-1,1-1.5,1-4,2,2-2.5,2-3,2-5,20-30,5-6,5-ridged,9-10,acuminate,anther,apex,axillary,bright,brown,bud,calyx,capitate,cell,cm,conical,corolla,diameter,elliptic,filament,flower,fruit,fruiting,glabrous,green,greenish,lobed,margin,minutely,mm,open-conical,ovary,ovoid-reniform,papillose,pedicel,petiole,pinnate,purple,rachi,rugose,scar,scattered,seed,shape,shrub,simple,stigma,strongly,style,surface,trichome,uniseriate,white,x	-1.2,-25,-4,.5,0,1.2-2.5,1.5-2,10-40,2-4,2.0-2.5,3-6,3.0,4,4-15,5-10,6-20,6-8,abaxially,abruptly,absent,adaxially,along,anthesi,anticlinal,arising,attenuate,axil,basal,base,beak,bearing,berry,broadly,clavat,commonly,completely,deltate,distinctly,dry,eaf,earl,edicel,eed,either,em,epidermal,equal,erec,exserted,fleshy,free,half,irregular,lanceolate,lateral,le,leaflet,lobe,long,lower,narrowed,near,nearly,nflorescence,noddin,node,oblique,occasionally,pair,papillae,papillate,per,petiolule,poricidal,portion,primary,projection,raised,reddish,reflexed,ripe,ruit,similar,single,sinuous,smaller,smelling,somewhat,sparse,specimen,terminal,thickening,time,tip,triangular,tub,tube,ud,unifoliat,unit,usually,vein,wintergreen,without,woody,ympodial	'',1,3,[,``,abaxial,adaxial,arrangement,bark,center,characteristic,colour,form,greyish,growth,hair,height,hirsute,history,inflorescence,leaf,length,less,life,na,new,nodding,number,peduncle,perennial,plant,position,prickle,reproduction,spacing,staman,stem,texture,value,width,{,}
787	wfo-0001031895	success	160	113	85	75	28	0.531	1-1.5,1.5-3,2-2.5,2.5-3,3-10,3-8,3.5-6,4,5,5-8,6-7,acute,anther,apex,bark,base,beneath,berry,bluish,capitate,cell,cm,completely,conical,corolla,dark,densely,diameter,ellipsoid,elliptic,entire,exfoliating,filament,fleshy,flower,glabrous,globose,green,growth,irregular,leaf-opposed,leafy,lobed,margin,matte,minutely,mm,new,occasionally,older,once-branched,ovary,ovoid,pale,papillate,patch,pedicel,peduncle,peeling,petiole,pitted,reniform,scar,shiny,shoot,short,shrub,simple,sinuate,small,stem,stigma,stout,style,surface,tan,terminal,thin,tip,tree,violet,way,white,x,¼-1/2	-1.5,0.5,0.5-1,0.5-2,1.5-2,1.5-6,3-4,4-5,4.5-16.5,5-6,6-9,age,anthesi,apparently,articulating,attenuate,blac,broadly,calyx,campanulate,cup-shaped,deltate,drying,eaf,eed,emarginated,enlarging,erec,erect,exerted,expand,fragrant,free,fruiting,glabrou,immature,inflorescenc,intensely,leaving,lengthening,less,lobe,lower,nflorescence,overlapping,pair,papillat,part,peg,perfect,pericarp,planar,plurifoliat,pore,poricidal,portion,primary,reddish,revolute,ruit,slender,slightly,slit,somewhat,straight,strongly,testal,thick,tub,tube,ud,unit,vein,woody,ympodial	abaxial,adaxial,arrangement,bud,center,colour,form,fruit,height,history,inflorescence,leaf,length,life,na,number,perennial,plant,position,rachi,reproduction,seed,shape,spacing,staman,texture,trichome,width
788	wfo-0001031896	success	196	116	88	108	28	0.449	0.3-0.8,0.5-1,0.5-2,1-1.5,1-10,1-2,1-3,10-20,10-20+,13,2-4.5,2-5,2-7,5,5-15,6-9,abaxially,accrescent,acute,adaxially,anther,apart,apex,branched,brown,calyx,cm,coarsely,contiguous,densely,diameter,elliptic,entire,erect,extra-axillary,ferruginous,filament,flattened,flower,forked,fruit,fruiting,glabrous,glandular-puberulent,globose,green,hair,long-stalked,margin,midvein,minutely,mm,moderately,nearly,orange,pedicel,peduncle,perfect,petiole,pinnatifid,pitted,prickle,pubescent,rachi,recurved,sessile,shape,shrub,simple,slightly,small,spaced,sparsely,stalked,stellate,stellate-pubescent,stem,stigma,straight,style,surface,toothed,tree,unbranched,white,whitish,x,yellow	-1.5,0-1.2,0.1-0.6,0.3-0.5,0.3-0.7,0.3-1,0.4-0.8,1-1.2,1.5,15-20,2,2-2.5,2-3,3-30+,3-5,4-7,5-10,5-6,5-9,6-10,6-30+,7-10,9-18,adaxiall,ample,apparently,armed,articulated,axe,ba,base,blade,broad-based,capitat,chartaceous,connivent,conspicuously,covering,curved,cylindrical,denser,difoliate,directed,distall,eaf,eed,eglandular,equal,ferruginous-pubescent,frequently,frui,geminate,gland-tipped,glandular,held,interpetalar,lanceolate,lateral,less,like,lobe,lon,long,long-acuminate,longer,lower,midpoint,midrib,mixed,mostly,multangulate,nflorescence,oblique,occasional,occasionally,often,orolla,pore,porrect,pubescence,ray,rounded,ruit,short,shorter,size,sometimes,stalk,ste,stellae,subcordate,tal,tamen,tapered,tem,time,tip,tissue,truncate,tube,unarmed,uniform,unit,uprigh,vary,vein,wide,ympodial	abaxial,adaxial,arrangement,bark,bud,capitate,colour,corolla,form,growth,height,history,inflorescence,leaf,length,life,na,number,ovary,plant,position,reproduction,seed,spacing,staman,texture,trichome,width
789	wfo-0001031897	success	264	132	116	148	16	0.439	.1,.5,0-1,0.1-0.5,0.15,0.6,1-2,1.1,1.3-2,1.7-3,2-4,5-6,6-9,abaxial,abaxially,adaxial,adaxially,almost,along,anther,apex,apically,articulated,bark,base,berry,black,brachyblast,branch,branched,brown,calyx,cell,chartaceous,clavate,clustered,cm,conical,coriaceous,corolla,curved,densely,diameter,dilated,distributed,dry,drying,dull,elliptic,enlarged,epiphyte,erect,evenly,except,flower,fruit,glabrous,green,grey,hair,inside,lanceolate,lateral,leaf,least,light,lobed,long,longitudinal,longitudinally,main,mauve,midvein,mm,multicellular,obconical,oblong,one,orange-brown,outside,ovoid,papillose,pedicel,peduncle,petiole,pubescent,raised,reddish,ribbed,ridge,ridged,short,shrub,simple,slender,slightly,smooth,sometimes,sparse,sparsely,stem,stigma,style,sunk,surface,terete,terminal,thick,thin,trichome,unarmed,weakly,white,winged,x,young	.8,0.2-0.4,0.4-1.1,0.5-1,0.5-3,0.8-1.5,0°,1,1-1.5,1-2.5,1.5,1.5-8,13,2/3,4-5,462.,8,absent,accrescent,acute,age,alyx,anthesi,apar,apparently,appearing,appendage,arising,aristate,attenuate,axillary,bendy,boiteau,clearly,concolorous,condensed,connate,covering,cuneate,dark,datum,dehiscing,delineated,dendritic,dense,developed,developing,development,divided,domatia,dorsal,dorsifixed,eaf,earliest,ed,entire,equal,even,extending,eye,faint,filament,filiform,fine,foliaceous,free,fruiting,immature,indistinc,inner,known,lamina,larger,lengthening,like,linear,lobe,looped,lower,m.,margi,margin,membranous,minute,minutely,multiseriate,naked,never,nflorescence,nther,oblon,obtuse,occasional,occasionally,orange,orolla,ovate,overlapping,pair,part,partly,pendulous,perfec,pericarp,persisting,plant,plurifoliat,pointed,pore,poricidal,portion,primary,prominent,pronounced,protruding,rarely,reach,revolute,ruit,scar,secondary,see,seen,shoot,side,sinus,smaller,smoot,stump,subulate,tearing,tertiary,tip,toward,tube,ud,unbranched,unicellular,unit,usually,vary,vein,venation,visible,well-developed,wide,wrinkle,ympodial	arrangement,branching,bud,colour,form,growth,inflorescence,length,na,number,ovary,position,seed,shape,spacing,texture
790	wfo-0001031908	invalid_json_followup	213	130	88	125	42	0.413	0-22,0-25,0.4-1.4,1-10,1-2,10-35,2-6,3-8,5-11,9-13,abaxially,acuminate,acute,adaxially,anther,apex,approximately,articulated,axillary,band,blue,broadly,brownish,bud,cell,chartaceous,cm,condition,corolla,covering,dark,densely,diameter,drying,dull,elliptic,elliptic-lanceolate,filament,flower,forked,fresh,fruit,glabrous,globose,green,greenish,herb,lateral,leaf,lilac,margin,medium,membranous,middle,minutely,mm,nearly,odd-pinnate,ovate,ovoid,pedicel,peduncle,petiole,pink,plant,puberulent,pubescent,purple,red-purple,rotate,rotate-pentagonal,seed,shiny,shortly,spot,stem,stigma,style,subtending,surface,terminal,testal,thick,tinged,wall,white,whitish,yellow	0-45,0-9,1-4,1-5.5,1-8,1.5-5.5,3-5,3.5-9,4-25,5,5-13,5-19,5-merou,7,8-22,absent-10,acumen,ag,almost,along,alyx,apart,apparently,ascending,attenuate,auriculate,axe,base,berry,blade,capitat,ciliate,color,connivent,cordate,cuneate,decreasing,decumbent,digestion,distal,dorsally,eaf,edge,eed,enzyme,erect,especially,exceeding,falcate,flat,folded,geminat,generally,glabrou,green-white,hair,hair-like,half,homostylous,honeycomb-shaped,interjected,lanceolate,leaflet,lengthening,like,living,lobe,long,lower,make,midrib,mottle,mucilaginous,nflorescence,oblique,often,orolla,pair,papillose,perfect,petiolulate,plurifoliate,pore,poricidal,prominent,prostrat,rarely,removed,ripe,rounded,ruit,secondary,semi-elliptic,semi-erect,sessile,seudostipule,short,size,slightly,slit,spaced,specimen,stamen,star,ste,stippled,straight,tall,tamen,tem,thir,throughout,tip,tri-,truncate,tube,uniform,unit,unwinged,usually,vary,wet,wing,x,ympodial	'',[,\u201chair-like\u201d,``,abaxial,adaxial,arrangement,bark,calyx,capitate,center,characteristic,colour,form,fruiting,growth,height,hermaphroditic,history,inflorescence,length,life,na,new,number,ovary,perennial,position,prickle,rachi,reproduction,scar,shape,spacing,staman,texture,third,trichome,value,width,{,}
791	wfo-0001032157	success	136	82	54	82	28	0.397	.5,0.6-1,0.75-1,1-3,1.9-2.2,2-3,7-9,acute,anther,apart,apex,bark,base,bi-lobed,calyx,cm,corolla,crystalline,elliptic,evenly,filament,fruiting,glabrous,globose,golden,green,leaf,lobed,minutely,mm,opposite,ovary,ovoid-reniform,paler,pedicel,peeling,persistent,petiole,pitted,plant,reddish,rounded,scar,shrub,simple,spaced,stigma,style,surface,tapering,white,woody,x,yellowish	.75,0.25,0.5-1,2-5,2.2,3-6,5-15-flowered,5-8,5-9,9-17,anthesi,becoming,beginning,beneath,berry,caly,completely,decurrent,deflexed,deltoid,dia,differing,difoliate,dry,eaf,edicel,eed,exserted,free,frui,geminat,glabrou,incrassate,inflorescenc,lateral,less,live,living,lobe,lon,long,longitudinal,lower,main,major,margin,middle,minor,nearly,nflorescence,obscure,older,one,pair,papillo,papillose,pore,poricidal,portion,raised,reflexed,ruit,shaped,shiny,size,slender,slightly,soon,stem,straight,strip,tall,tear-drop,tip,translucen,tube,ud,unit,vein,widest,ympodial,young	5-15,abaxial,adaxial,arrangement,colour,diameter,flower,form,fruit,growth,height,history,inflorescence,length,life,na,number,peduncle,perennial,position,rachi,reproduction,seed,shape,spacing,staman,texture,width
792	wfo-0001032161	invalid_json_followup	146	114	73	73	41	0.5	.5,0.4-1.2,0.75-1,0.8-1,1-3,1.2-1.3,2-7,2.5-3,acute,adaxially,anther,apex,area,bark,base,calyx,closely,cm,conical,corolla,dark,delicate,dendritic,densely,drying,ellipsoid,elliptic,filament,filiform,fruiting,glabrous,globose,golden,green,inflorescence,internodal,leaf,lobed,margin,merely,minutely,mm,mustard,nearly,opposite,ovary,ovoid-reniform,pale,papillose,pedicel,pericarp,petiole,pitted,plant,pubescent,revolute,scar,shiny,shrub,simple,spaced,sparsely,stem,stigma,style,sulcate,surface,tan,thin,trichome,white,yellow,yellowish	0.5-1,0.7-4,1-1.5,1-11,1.4-2,2-8-flowered,3.5-4,?,abaxially,adaxiall,anthesi,apical,ba,beneath,berry,branched,brownish-blac,color,coriaceous,deflexed,deltate,dia,difoliate,eaf,edicel,eed,exserted,free,giving,hanging,lamina,later,like,lobe,long,lower,many,middle,minute,nflorescence,obovate,occasionally,older,overlappin,persistent,plurifoliate,pore,poricidal,portion,projection,quadrate,reflexed,rest,ruit,shaped,shoot,short,strongly,styl,tall,tear-drop,tip,tub,tube,ud,uniseriate,unit,usually,vein,widest,x,ympodial,young	'',2-8,[,``,abaxial,adaxial,arrangement,brownish-black,bud,cell,center,characteristic,colour,diameter,flower,form,fruit,growth,height,history,length,life,na,new,number,overlapping,peduncle,perennial,position,prickle,rachi,reproduction,seed,shape,spacing,staman,texture,value,width,{,}
793	wfo-0001032165	success	197	94	66	131	28	0.335	0.1,0.25-0.5,1-1.2,1-1.5,1-2,1.5-4,2.5-3.5,3-6,5-6,5-7,abaxial,acute,adaxial,anther,apex,bark,broadly,brown,bud,calyx,capitate,center,closely,cm,corolla,cup-shaped,dark,dull,elliptic,erect,filament,fruiting,glabrous,globose,golden-puberulent,green,greyish-brown,inflorescence,leaf,less,lobed,margin,minutely,mm,obovate,ovary,ovoid-reniform,pedicel,petiole,pitted,plant,puberulent,scar,shape,simple,small,spaced,stem,stigma,style,surface,terminal,tree,trichome,uniseriate,white	.25,.5,0.1-0.3,0.3-1,0.75-1,10-25,2-2.5,3-4,3.5-8.5,4-6,5-15,5-30-flowered,5-9.5,8-9,along,anthesi,apparent,appearing,ba,base,beginning,beneath,berry,continued,cucullate,deciduous,decurrent,deltoid,densely,denser,dia,differing,difoliate,distal,dry,due,eaf,edged,edicel,eed,ellipsoid,end,entire,even,expansion,exserted,exsertion,free,geminat,golden,golden-pubescent,immature,inflorescenc,later,lateral,like,live,lobe,lon,long,lower,main,major,markedly,medial,middle,midrib,minor,minute,near,nearly,nflorescence,node,occasionally,older,once-furcate,one,onto,opposite,orbicular,overlapping,pair,pale,paler,papillo,papillose,planar,pore,poricidal,portion,presence,prominent,purplish,rather,rest,ridge,ripe,rounded,ruit,shaepd,single,size,slender,slightly,slow,smoot,specimen,stout,straight,stripe,strongly,swollen,tall,tapering,tear-drop,thickened,time,tinged,tip,tub,tube,ud,unit,vein,widest,winged,woody,x,yellowish,ympodial,young	5-30,alternate,arrangement,cell,colour,diameter,flower,form,fruit,growth,height,history,length,life,na,new,number,peduncle,perennial,position,rachi,reproduction,seed,smooth,spacing,staman,texture,width
794	wfo-0001032167	invalid_json_followup	163	120	81	82	39	0.497	0.5-1,0.5-2.5,1-2,1-2.5,1-5,12-20,2-7,2-foliate,3-7,4-6,5-15,7-10,absent,acute,along,anther,apex,berry,blade,brown,calyx,cell,chartaceous,cm,densely,denser,diameter,dm,drying,elliptic,elliptic-ovoid,entire,filament,flat,flattened,flower,forming,fruit,geniculate,glabrous,globose,growth,herb,immature,lower,lying,margin,maturing,membranaceous,mm,moderately,nearly,netlike,new,one-celled,pedicel,peduncle,petiole,projection,pubescent,purple,rachi,raised,rotate,seed,semitransparent,sparsely,staman,stigma,straight,style,surface,twisted,two-celled,upper,usually,vein,wall,white,x,yellow	.5,0.5-1.5,0.75-3,1,1-2-celled,1-3,1-7,1.5,10-20,10-35,2-4,3-6,4-10,abaxially,abundant,adaxiall,adaxially,appressed,axe,base,ciliate,closely,common,connected,cordate,curved,decurrent,dehiscing,dense,eaf,eed,emarginat,explosively,few-,frui,geminat,growt,hair,held,interpetalar,larger,linear-lanceolate,lobe,long,longer,lowermost,many-branched,maturit,mesocarp,near,nfloresence,notch,oblong,obtuse,often,older,orolla,per,placenta,pressure,pubescen,rounded,ruit,shorter,slightly,small,smaller,sometimes,stamen,tal,tamen,tem,tissue,triangular,tube,unbranched,unit,vary,watery,wid,woody,ympodial	'',[,``,abaxial,adaxial,arrangement,bark,bud,center,characteristic,colour,corolla,form,fruiting,geminate,height,history,inflorescence,leaf,length,life,na,number,ovary,perennial,plant,position,prickle,reproduction,scar,shape,spacing,stem,texture,trichome,value,width,{,}
795	wfo-0001032176	invalid_json_followup	177	100	62	115	38	0.35	.5,0.5-0.7,0.5-1,0.8-6,1-10,1.5-2.5,100,3-4,5-6-celled,6,6-10,7,anther,apart,apex,axillary,base,calyx,cell,cm,conical,corolla,densely,diameter,elliptic,filament,filiform,flower,fruiting,globose,green,greenish,grey-brown,greyish,herb,leaf,lobed,margin,minutely,mm,nearly,obtuse,ovary,ovoid-reniform,pale,papillose,pedicel,petiole,pinnate,pubescent,rachi,rounded,scar,seed,simple,sparsely,stem,stigma,style,trichome,uniseriate,white	0,0.42,0.5,0.5-0.75,0.8-1,1-1.2,1.5-1.6,1.5-6,1/2,2-3,2.5-10,3-15,3-3.5,3-7,adaxially,adhering,along,anthesi,apical,arising,attaining,attenuate,axil,basal,beak,becoming,berry,branched,capitat,cateniform,containing,copiously,creeping,cucullate,denser,drying,eaf,edicel,eed,ellipsoid,epidermal,equal,especially,exserted,fallen,free,glabrous,hangin,inflorescenc,lateral,leaflet,lengt,lengthening,like,lobe,log,long,long-papillose,lower,minute,nflorescence,nodding,node,obovate,occasionally,often,onto,open,pair,per,petiolule,pore,poricidal,portion,projection,quadrate,reflexed,rest,rooting,ruit,separate,single,sinuous,size,slightly,slit,smaller,somewhat,soon,spaced,strait,strongly,tem,terminal,thickening,tightly,time,tip,tree,truncate,trunk,tub,tube,ud,ultimate,unevenly,unifoliat,unit,vein,wall,whit,winged,without,x,ympodial	'',[,``,abaxial,adaxial,arrangement,bark,bud,capitate,center,characteristic,colour,form,fruit,growth,height,history,inflorescence,length,life,na,new,number,peduncle,perennial,plant,position,prickle,reproduction,shape,spacing,staman,surface,texture,value,width,{,}
796	wfo-0001032183	invalid_json_followup	162	97	56	106	41	0.346	0.3-0.6,0.6-0.9,0.7-1.4,1-3,3.5-4.5,5-9,5.5-7,7-9,absent,accrescent,acute,adaxially,anther,apex,calyx,chartaceous,cm,contiguous,densely,diameter,entire,extra-axillary,flower,fruit,fruiting,glabrous,globose,green,inflorescence,lanceolate,length,margin,mm,nearly,obtuse,ovate,pale,pedicel,peduncle,perennial,petiole,porrect,prickle,purple,rachi,red,rotate-stellate,sessile,shrub,simple,stellae,stellate-pubescent,stigma,style,white,yellow	%,0-0.1,0-1.5,0.1-0.2,0.2-0.8,0.25-0.4,0.4-0.5,0.4-0.6,0.4-0.8,0.4-4,0.5-1,0.5-1.5,0.9-1,1-2,1.1-2.3,1.5-1.9,16-23,2-foliate,2.4-2.7,2.7-3.6,4-,4-6,4.5-7,5-merou,7-12,7-8,8-9,abaxially,absen,across,adaxiall,alyx,apart,articulated,axe,ba,base,blade,capitat,confined,cuneate,cylindrical,directed,distall,distally,distributed,eaf,eed,eglandular,elliptic,erect,exceeding,finger,geminat,glaberous,gland-tipped,grey,hair,homostylous,juicy,lamina,lateral,lobe,long,lower,markedly,mature,mesocarp,mid-point,midpoint,midrib,minute,nflorescence,oblique,orolla,part,per,perfect,pore,pseudo-umbellate,pubescent,ray,rhizomatous,ruit,short,solitary,spaced,sparsely,stalk,succulen,tal,tamen,tem,thick,thicker,throughout,time,tube,unarme,unarmed,unbranched,unit,vary,wide,x,ympodial	'',[,``,abaxial,adaxial,arrangement,bark,bud,capitate,cell,center,characteristic,colour,corolla,filament,form,growth,height,history,leaf,life,na,new,number,ovary,plant,position,reproduction,scar,seed,shape,spacing,staman,stem,surface,texture,trichome,value,width,{,}
797	wfo-0001032187	success	139	91	59	80	32	0.424	-11,-4.2,-9,0.5,0.5-,0.5–1,0.6–1.3,1.1–3.2,1.8–2,2–9,3.1–3.5,5-merous,5–7,7–11,acuminate,acute,anther,apex,aromatic,berry,brown,brownish,cm,corolla,cyme,dull,elliptic,erect,filament,forked,glabrescent,globose,green,herb,leaf,light,mature,mm,obovate,occasionally,ovate,pedicel,peduncle,persistent,petiole,plant,purple,rarely,simple,soft,stage,stellate,style,sub-glabrous,texture,tinged,yellow,yellowish,±	-2.1,-4,-5,0.1–1.4,1.3–1.8,1.6–2.1,1.8–2.8,100,1–1.7,22,24.6–26.3,3–3.2,3–4,9,adherent,alyx,angular,ape,appressed,base,blade,branch,broadly,changing,consisting,dark,di-foliate,dia,eaf,eed,eglandular,entire,equal,flowered,fully,geminat,granule,hair,hite,hooked,hydrated,lobe,long,lower,many,margin,marked,nflorescence,numerous,penden,pentagonal,per,perfec,petiolate,pollen,predominantly,presen,protruding,ridge,ruit,running,sclerotic,short,small,sometimes,sparse,spreading,stem,straight,tooth,triangular,truncate,unit,well,widest,wing,ympodial,±1,µm,×	abaxial,adaxial,arrangement,cell,center,colour,diameter,flower,form,fruit,growth,height,history,inflorescence,length,life,na,number,ovary,perennial,perfect,position,rachi,reproduction,seed,shape,spacing,staman,stigma,surface,white,width
798	wfo-0001032190	invalid_json_followup	230	120	83	147	37	0.361	-1,-3.4,0-0.6,0.2-0.3,0.4-1.5,0.5-3,0.6-1.5,1-1.5,1-6,1.6-4.4,1.8-3,2-6,2.7-6.8,3-21,4-5,5-22,abaxially,accrescent,acuminate,adaxially,anther,apart,apex,appressed-tomentose,attenuate,bark,becoming,brown,bud,calyx,cm,conical,corolla,deltoid,diameter,ellipsoid,elliptic,entire,filament,flower,fruit,fruiting,glabrous,globose,green,growth,honeycombed,lanceolate,lateral,leaf,length,margin,mm,mostly,oblanceolate,pale,pedicel,peduncle,petiole,pubescent,rachi,reniform,reticulate-punctate,ripe,rotate-stellate,scabridulous,scabrous,shrub,simple,small,somewhat,stem,stigma,style,suborbicular,terminal,tree,truncate,white,whitish,x,yellow,yellowish	-6,.5-6,/100-1/20,0-80,0.7-1.1,0.8-1.1,1-1.7,1.2-2.1,1.2-3,1.3-5,1.5-3.5,1.5-4,1.9-4.5,1/2-3/4,10,2.5-10,2.5-4.3,3.5-8,4-6,4.5-7,6-11,6x,7-11,7-28,absent,acute,ag,along,anthesi,apical-lateral,apparently,articulated,axe,axillary,ba,base,berry,blade,blunt-tipped,branch,branched,campanulate,chartaceous,closely,coarse-stalked,continued,coriaceous,decurrent,dehiscing,densely,due,eaf,eed,evident,exserted,extend,few-rayed,fleshy,free,glabrescent,glabrou,granular-pubescent,hair,high,hirsute,inserted,introrse,large,line,lobe,lobed,long,long-,long-attenuate,long-stalked,longitudinal,lower,m.,magnification,main,midvein,minute,mixed,moderately,multangulat,multangulate,multiseriate-stalked,near,nearly,nflorescence,oblong,obtuse,occasional,occasionally,older,openly,orolla,ovat,ovate,overlapping,partly,perfect,plurifoliate,pore,porrect-stellat,porrect-stellate,present,rarely,rather,relatively,ruit,runk,sessile,short-,short-stalked,side,slit,spaced,sparse,sparsely,stamen,stelliform,stipitate-glandular,strongly,subcapitat,subcoriaceous,suture,tamen,terete,testa,thick,thin-stalked,time,tomentose,touching,toward,tube,unarme,unarmed,unit,usually,vary,vein,way,wide,ympodial,young	'',20-80,[,``,abaxial,adaxial,arrangement,center,characteristic,colour,form,height,history,inflorescence,life,na,new,number,ovary,perennial,plant,position,prickle,reproduction,scar,seed,shape,spacing,staman,subcapitate,surface,texture,trichome,value,width,{,}
799	wfo-0001032206	success	216	117	72	144	45	0.333	-0.8,-20,acute,andromonoecious,anther,apart,apex,apparently,bark,berry,calyx,chartaceous,cm,cream,dark,deltate,diameter,elliptic,erect,filament,flattened,flattened-reniform,flower,fruit,fruiting,glabrescent,glabrous,green,green-brown,lateral,leaf,length,lobed,long-styled,margin,marking,maturity,mauve,midvein,mm,moderately,obtuse,orange-brown,pale,pedicel,peduncle,petiole,plant,porrect,prickle,purple,reflexed,scar,sessile,short-styled,shrub,slender,smooth,sometimes,spherical,stalked,stellate,stellate-pubescent,stem,style,surface,trichome,usually,white,yellow,yellow-orange,young	-2,-5,..,.2,.5,0,0.2,0.2–0.4,0.2–0.5,0.5–1,0.8–1.2,00–200,0–20,0–30,0–5,1,1.1–1.2,1.2–2.2,1.5–2,1.5–2.5,1/3,1/4–1/2,1/4–1/3,1/6,10–80,11–22,1–2,1–2.3,1–3,1–4,2.5–3.3,2.7–3.5,2–2.5,2–3,2–8,3.5–9,30–80,3–4,4.5–5.8,4–6,5-merous,5–15,5–20,5–6,5–8,5–9,6–10,6–15,6–8,7–10,8–20,abaxially,accrescent,adaxially,alyx,apar,apically,approximately,armed,articulated,base,blade,bluntly,branched,broad-deltate,brow,clearly,concolorous,connivent,covering,cuneate,curved,discolorous,distal,distance,drying,eaf,eed,equal,extending,foliaceous,free,functionally,gently,hermaphroditic,heterostylous,infructescence,lengt,lobe,lobing,long,longer,lowermost,mal,mature,midpoint,nflorescence,often,older,one,open,orolla,ovate,ower,pair,pendent,pendulous,per,pericarp,plurifoliat,poricidal,portion,primary,rarely,ray,secondary,side,spaced,sparsely,spreading,stalk,stout,straight,tamen,tapering,tertiary,time,tip,toward,truncate,tube,uit,unarmed,ung,unit,variously,vary,vein,venation,visible,weakly,wide,woody,ympodial	/,0.2-0.4,0.2-0.5,0.5-1.5,0.8-1.2,1-2,1-2.3,1-3,1.1-1.2,1.5-2.5,1/4-1/2,2-8,2.5-3.3,3-4,3.5-9,4.5-5.8,5-6,6-15,abaxial,adaxial,arrangement,brown,bud,cell,center,colour,corolla,form,growth,height,history,inflorescence,life,na,new,number,ovary,perennial,reproduction,seed,shape,spacing,staman,texture,width
