	coreid	status	nwords_original	nwords_result	nwords_recovered	nwords_omitted	nwords_created	prop_recovered	common_words	original_only	result_only
0	wfo-0001025636	success	208	123	91	117	32	0.438	0.1,0.1-0.3,1-2,1-2.2,1-3.5,1-4,1-5.5,1.4-3.5,1.7-9.2,1.8,10-45,2-4,2.5-6,6.5-10,9.5-29.5,abaxially,acuminate,acute,adaxially,along,anther,apex,base,blade,blue,broadly,brownish,chartaceous,clavate,cm,condition,contracted,corolla,cuneate,diameter,distal,drying,elliptic,especially,fresh,fruit,glabrous,globose,green,greenish,hair,half,herb,highly,lanceolate,like,lobe,long,longer,margin,membranous,midrib,minutely,mm,moderately,mottled,near,oblique,obtuse,odd-pinnate,ovate,ovoid,pedicel,peduncle,petiole,plant,puberulent,pubescent,purple,ripe,rotate,rotate-pentagonal,seed,sessile,size,slightly,sometimes,stem,stigma,style,subglabrous,tube,whitish,wide,x,yellow	0-2,0-5,0.6-2.8,1,1-10,1-3,1-5,1.1-6.1,1.7-5.2,2,2.6-8.3,3-5,3-6,5-merou,absent,acumen,ag,alyx,apart,apparently,articulated,axe,berry,capitat,cell,ciliate,clearly,connivent,covering,decurrent,digestion,dorsally,eaf,edge,eed,end,enzyme,exceeding,except,filament,flat,flower,folded,geminat,generally,glabrou,greatly,green-white,hair-like,hal,high,homostylous,honeycomb-shaped,interjected,larger,lateral,leaflet,lengthening,living,lower,make,minute,mucilaginous,multicellular,nflorescence,obovate,often,orbicular,orne,orolla,pair,perfect,petiolulate,petiolule,plurifoliate,pore,poricidal,proximal,reduced,removed,rosette-forming,rounded,ruit,scale-like,semierec,seudostipule,short,singly,slit,spaced,specimen,stamen,ste,stolo,straight,subequal,tall,tamen,tem,terminal,testal,thick,throughout,tip,tri-,truncate,tuber,typically,unequal,unforked,unit,unwinged,uppermost,vary,wall,wet,ympodial	adhesion,arrangement,calyx,capitate,climate,colour,form,glandular,growth,height,history,inflorescence,leaf,length,life,midpoint,na,number,ovary,perennial,position,presence,pubescence,ray,reproduction,rugulose,shape,staman,stellate,stipe,surface,texture
1	wfo-0001025637	success	193	99	68	125	31	0.352	0-0.3,0.2-0.9,1-12,1-2,1-2.5,1.5-5,1.6-2.5,14-38,2-7,2.5-8,2.8-4.2,3-10,3-9,5-7,anther,blue,brownish,clavate,cm,condition,coriaceous,corolla,dark,deep,diameter,dot,drying,elliptic,fresh,fruit,glabrescent,glabrous,globose,green,greenish,herb,lanceolate,leaf,light,lilac,lobe,long,medium,mm,mottled,odd-pinnate,ovate,ovoid,pedicel,peduncle,pentagonal,petiole,plant,purple,rotate,seed,size,stigma,stripe,style,terminal,tiny,tube,white,whitish,wide,x,yellow	0-27,0.2-0.5,0.3-0.5,0.8-2.6,1-5,1.2-3.5,2-20,2-3,3-4,3-5,4-6,5-merou,abaxially,acumen,acuminate,acute,adaxiall,adaxially,ag,along,alyx,apart,apex,apparently,arranged,articulated,attenuate,axe,axillary,base,bead,berry,blade,bud,capitat,cell,connivent,covering,cuneate,decreasing,decurrent,digestion,distal,dorsally,eaf,edge,eed,enzyme,erec,exceeding,filament,flat,flower,folded,forked,geminat,generally,glabrou,green-white,hair,hair-like,hal,half,high,homostylous,honeycomb-shaped,interjected,lateral,leaflet,lengthening,like,linear,living,lower,make,moniliform,mucilaginous,multiple,necklace,nflorescence,onto,orolla,pair,perfect,petiolulate,petiolule,plurifoliate,pore,poricidal,rachi,removed,ripe,rounded,ruit,secondary,seudostipule,short,slit,sometimes,spaced,specimen,stamen,stolon,straight,subequal,subtending,symmetric,tall,tamen,tem,testal,thick,throughout,tip,toward,tri-,tuber,typically,unit,unwinged,usually,vary,wall,wet,ympodial	abaxial,adaxial,adhesion,arrangement,calyx,capitate,colour,form,growth,height,hermaphroditic,history,inflorescence,length,life,na,number,ovary,perennial,position,presence,pubescence,ray,reproduction,rugulose,shape,staman,stellate,stem,surface,texture
2	wfo-0001025639	success	154	72	54	100	18	0.351	1-2,1-3,10-21,2-3,2-3.5,2.8-3.2,20-35,3-6,3.5-7,4-10,4.5-8.5,5-8,6-12,6-8,broadly,calyx,cm,connate,corolla,dark,diameter,distal,elliptic,forked,globose,green,green-white,half,herbaceous,lateral,leaf,leaflet,long,medium,mm,obovate,odd-pinnate,ovate,ovoid,pedicel,peduncle,perennial,petiole,plant,puberulent,pubescent,rotate,seed,size,terminal,violet,white,wide,yellow	1-4,3-4,3-5,3-6-foliat,5-1.,5-10,8-12,8-9,abaxially,acumen,acuminate,acute,adaxially,apex,apical,apically,articulate,base,belo,branched,cell,covering,cuneate,cyme,dehiscent,dichasial,dichasially,digestion,diminishing,dorsally,eaf,ebracteate,edge,eed,elliptical,emoval,enzyme,exceeding,filament,flat,flower,folded,frequently,generally,globo,gradually,hair-like,honeycomb,interjected,introrse,lobe,lon,long-attenuate,lower,lunat,make,maturing,monochasial,mucilaginous,nflorescence,nther,oblique,often,orolla,pair,pattern,perfect,petiolule,plan,poricidally,present,produced,proximal,rare,reveal,ruit,seudostipule,short,slit,sometimes,stamen,stigma,straight,style,tal,tem,testal,thick,throughou,throughout,top,toward,truncate,tuber-bearing,typically,unit,vary,wall,ympodial,¼	anther,arrangement,colour,form,fruit,growth,height,history,inflorescence,length,life,na,ovary,position,reproduction,shape,stem,texture
3	wfo-0001025642	success	149	66	47	102	19	0.315	0.3-0.4,1,1-2,1-2.5,1-2.7,1-3.2,1.5-2.5,10-20,3-5,3.5-6,4-7.5,4.5-8,5-6,5.5-7,7-11.5,calyx,cm,connate,corolla,diameter,distal,globose,green,green-white,half,herbaceous,lanceolate,lateral,leaf,leaflet,long,mm,odd-pinnate,ovoid,pedicel,peduncle,perennial,petiole,plant,puberulent,seed,size,stellate,terminal,throughout,wide,yellow	1-3,1-4,2-10,2-3,3,3-6-foliat,8-13,9-12,abaxially,absen,absent,acumen,acuminate,acute,adaxially,apex,apical,apically,apiculate,articulate,attenuate,base,branched,cell,covering,cyme,dehiscent,dichasial,dichasially,digestion,diminishing,dorsally,eaf,ebracteate,edge,eed,elliptic,elliptic-lanceolate,emoval,enzyme,exceeding,filament,flat,flower,folded,forked,generally,globo,gradually,hair-like,honeycomb,interjected,introrse,lanceolat,living,lobe,lon,lower,lunate,make,maturing,monochasial,mucilaginous,nflorescence,nther,oblique,obtuse,often,orolla,pair,pattern,perfect,plan,poricidally,present,proximal,reveal,ruit,sessile,seudostipule,short,slit,specimen,stamen,stigma,straight,style,tal,tem,testal,thick,throughou,toward,tuber-bearing,typically,unit,vary,wall,whit,without,ympodial,¼	anther,arrangement,colour,form,fruit,growth,height,history,inflorescence,length,life,na,ovary,position,reproduction,shape,stem,texture,white
4	wfo-0001025644	success	204	114	91	113	23	0.446	0-5,0.8-1.5,1-2,1.3-2.1,10-11,12-28,2-3,2.5-11,2.5-6,25-50,3-10,3-5,3.3-8.2,4-19,4-6,6.5-13,abaxially,adaxially,almost,along,anther,attenuate,axillary,blue,broadly,brownish,bud,chartaceous,ciliate,clavate,cm,condition,corolla,denticulate,diameter,drying,elliptic,especially,finely,fresh,fruit,glabrous,globose,green,greenish,hair,herb,interjected,invested,lanceolate,leaflet,like,lobe,long,margin,membranous,midrib,minutely,mm,mottled,multicellular,non-glandular,odd-pinnate,ovate,ovoid,pedicel,peduncle,pentagonal,petiole,plant,puberulent,pubescent,purple,rounded,seed,short,size,stem,stigma,style,subtending,terminal,tinged,trichome,tube,uniseriate,usually,white,whitish,x,yellow	.3,1-10,10,13-21,2,2-4,2.4-4,3-4,4.5-9.5,5-merou,6-7,absent,acumen,acuminate,acute,ag,always,alyx,apart,apex,apparently,articulated,axe,base,berry,blade,c.,capitat,cell,connivent,cordate,covering,cuneate,digestion,distal,dorsally,eaf,edge,eed,end,enzyme,erec,exceeding,except,filament,flat,flower,folded,forked,geminat,generally,glabrou,greatly,green-white,hair-like,half,homostylous,honeycomb-shaped,lateral,lengthening,living,lower,make,middl,mucilaginous,nflorescence,oblique,often,one,orbicular,orolla,pair,perfect,petiolule,placed,plurifoliate,pore,poricidal,proximal,rarely,reduced,removed,ruit,sessile,seudostipule,shallowly,slit,spaced,specimen,stamen,ste,stolo,straight,subequal,tall,tamen,tem,testal,thick,throughout,tip,tri-,truncate,tuber,typically,unit,vary,wall,well-developed,wet,wing,winged,ympodial	adhesion,arrangement,calyx,capitate,colour,form,growth,height,history,inflorescence,leaf,length,life,na,ovary,perennial,position,presence,pubescence,reproduction,shape,staman,texture
5	wfo-0001025645	success	150	62	42	108	20	0.28	0.3-0.8,0.8,1-3.5,10-16,15-25,2-4.5,2.5,4-12,4-6,5,5-5.5,calyx,cm,connate,corolla,diameter,distal,elliptic-lanceolate,glabrous,globose,green,green-white,half,herbaceous,lanceolate,leaf,long,mm,odd-pinnate,ovoid,pedicel,peduncle,perennial,petiole,plant,puberulent,seed,size,stellate,throughout,wide,yellow	0.5-1,1-2,1-4,10-11,12-17,2-3,3-5.5,3-6-foliat,4-5,4-7,8-10,abaxially,absen,acumen,acuminate,acute,adaxially,apex,apical,apically,articulate,base,branched,cell,covering,cuneate,cyme,decurrent,dehiscent,dichasial,dichasially,digestion,diminishing,dorsally,eaf,ebracteate,edge,eed,elliptic,emoval,enzyme,exceeding,filament,flat,flower,folded,forked,generally,globo,gradually,hair-like,honeycomb,interjected,introrse,larger,lateral,leaflet,living,lobe,lon,lower,lunat,make,maturing,monochasial,mucilaginous,mucronate,nflorescence,nther,oblique,oblong,often,orolla,pair,pattern,perfect,plan,poricidally,proximal,rachi,reveal,ruit,second,sessile,seudostipule,short,slit,specimen,stamen,stigma,straight,style,tal,tem,terminal,testal,thick,throughou,toward,tuber-bearing,typically,unit,vary,wall,whit,without,ympodial,¼	anther,arrangement,colour,form,fruit,growth,height,history,inflorescence,length,life,na,ovary,position,reproduction,shape,stem,texture,tube,white
6	wfo-0001025646	success	136	64	43	93	21	0.316	0.25-0.4,0.6-3,0.7-3.5,1.1-1.4,2-3,2-4,2.3-9.0,3.2-6,3.5-7,4-15.5,4-5,7-8,calyx,cm,connate,corolla,diameter,distal,elliptic,forked,fruit,globose,half,herbaceous,leaf,long,mm,odd-pinnate,ovary,ovate,pedicel,peduncle,pentagonal,perennial,petiole,plant,puberulent,size,stigma,strigose,style,wide,yellow	0-.,0.5-2.1,0.6-2.3,1-4,1-7,1.1-4.5,1.2,1.2-7.0,1.5-3,2.5-3,3,3-6-foliat,4-10,abaxially,abruptly,acumen,acuminate,acute,adaxially,apex,apical,apically,apiculate,articulate,attenuate,ature,base,branched,caudate,cuneate,cyme,decurrent,dehiscent,dichasial,dichasially,diminishing,dorsally,eaf,ebracteate,edge,eed,exceeding,filament,flat,flower,folded,generally,globo,gradually,interjected,introrse,lateral,leaflet,like,lobe,lon,lower,lunat,maturing,monochasial,nflorescence,nther,oblique,obovate,often,orolla,pair,perfect,petiolule,plan,poricidally,probably,proximal,seen,sessile,seudostipule,short,slightly,slit,sometimes,stamen,straight,tal,tem,terminal,toward,tuber-bearing,typically,unit,vary,whit,ympodial,¼	anther,arrangement,colour,form,growth,height,history,inflorescence,length,life,na,position,reproduction,rugulose,seed,shape,stem,surface,texture,tube,white
7	wfo-0001025647	success	194	89	65	129	24	0.335	0.06-0.24,0.8-3,1-2,1-5,1.2-3,1.4-5,1.5-5,2-3,2-4,2.5-3,4-10,5-6,6.2-11,abaxially,adaxially,anther,attenuate,axillary,blue,brownish,chartaceous,clavate,cm,condition,corolla,densely,diameter,drying,elliptic,fresh,fruit,glabrous,globose,green,greenish,herb,lanceolate,light,linear,lobe,long,membranous,minutely,mm,moderately,narrowly,odd-pinnate,ovoid,pedicel,peduncle,petiole,plant,puberulent,pubescent,ripe,rotate,seed,size,stem,stigma,style,tube,whitish,x,yellow	0-4,0.4-1.5,0.6-3,1,1-10,1-3,1.3-2.9,1.5-5.5,2,2-5,3-6,4-6,5-merou,absent,acumen,acute,ag,along,alyx,apart,apex,apparently,articulated,axe,base,berry,blade,borne,broadly,bud,capitat,cell,ciliate,connivent,covering,decurrent,digestion,distal,dorsally,eaf,edge,eed,end,enzyme,erec,especially,exceeding,except,filament,flat,flower,folded,forming,frequently,geminat,glabrou,greatly,green-white,hair,hair-like,hal,half,high,homostylous,honeycomb-shaped,interjected,lateral,leaflet,lengthening,like,living,lower,make,margin,midrib,mucilaginous,multicellular,near,nflorescence,oblique,obtuse,often,orbicular,orolla,ovate,pair,perfect,petiolulate,plurifoliate,pore,poricidal,proximal,reduced,removed,rosette,ruit,scale-like,sessile,seudostipule,short,singly,slit,sometimes,spaced,specimen,stamen,ste,stolo,straight,subequal,subtending,tall,tamen,tem,terminal,testal,thick,throughout,tip,tri-,tuber,typically,unbranched,unit,unwinged,vary,wall,wet,ympodial	adhesion,arrangement,calyx,capitate,colour,form,growth,height,history,inflorescence,leaf,length,life,na,ovary,perennial,position,pubescence,reproduction,rugulose,shape,staman,surface,texture
8	wfo-0001025652	success	156	85	61	95	24	0.391	.3,0.5-1,1-1.5,1.5-2,10-20,2-3,2-6,20-50,3-3.5,3-5,4,4-6,4-7,anther,anthesi,bilobed,calyx,campanulate,cm,connate,corolla,densely,elliptic,fruit,glabrous,green,growth,irregular,leaf,lobe,minutely,mm,opposite,ovary,ovoid-reniform,pale,papillose,pedicel,petiole,pinkish-grey,pitted,planar,plant,poricidal,red-papillose,shape,shiny,shrub,size,small,stem,stigma,style,surface,tan,tightly,tip,tree,tube,white,x	.5,1,15-17,15-19,2-5,3-5-flowered,9-11,abruptly,acuminate,acute,apex,appearing,bark,base,blade,broad,closed,closely,completely,decurrent,dia,differing,difoliate,dry,eaf,edicel,eed,emerge,envelope,filament,fleshy,flower,free,furcate,geminat,glabrate,greyi,greyish,growing,lateral,like,live,lobed,lon,long,lower,main,major,margin,matte,middle,minor,minute,narrowing,nearly,new,nflorescence,occasionally,older,one,onto,overlappin,ovoid,pair,paler,papillae,papillo,parallel,pore,portion,rather,ry,scar,shaped,simple,soon,spaced,specimen,straight,strongly,tall,tapering,tear,tear-drop,thick,thicker,ud,unit,vein,wider,widest,wing,winged,ympodial,young	adhesion,arrangement,colour,diameter,form,height,history,inflorescence,length,life,na,number,peduncle,perennial,position,presence,pubescence,ray,reproduction,rugulose,seed,staman,stellate,texture
9	wfo-0001025653	success	218	121	82	136	39	0.376	.0,.1,.2,.3,.5,.6,.7,.9,0.1,0.8,1.3,20,90°,acuminate,adnate,anther,apex,attenuate,base,blade,broad,brown,calyx,chartaceous,clinate,cm,corolla,deltoid,diameter,erect,extra-axillary,flower,fruit,glabrous,glandular,globolunate,globose,hair,lateral,leaf,least,less,lobe,lobed,long,margin,midpoint,minute,mm,much,obtuse,opposed,ovate,pedicel,peduncle,petiole,porrect-stellate,pubescent,ray,reddish,reduced,restricted,rhizomatous,rounded,scarcely,sessile,short,shrub,simple,sinuate,sparsely,stellate,stem,stigma,stipe,style,subcordate,surface,truncate,tube,±equal,×	.8,0.13,0.15,0.2–0.4,0.3–0.5,0.3–0.8,0.6–1.6,0.7–1.1,1.0–1.6,1.1–1.3,1.3–1.8,1.6,1.9–3.3,1–1.5,2.3–3.2,2.5–4.0,2.6,4–6,5-merou,6–8,6–9,7–12,8–11,abaxially,absent,adaxiall,adaxially,aequilateral,ag,alyx,among,anthesi,apart,apical,apparently,appearing,around,articulate,axe,ba,bark,bud,channeled,congested,craspedodromous,cylindrical,densely,developed,directed,distinct,dry,eaf,edge,eed,either,emerging,entire,extending,ferruginous,fertile,filament,filiform,free,heterostylous,increasing,intact,internode,interpetalar,intersepalar,know,known,lanceolate,layer,lon,longer,low,lower,mature,midrib,midvein,nflorescence,noticeably,oblique,occasionally,opaque,orolla,persistent,plurifoliat,pore,porrect,portion,potentially,prickl,prickle,primary,raised,remaining,rigid,row,ruit,secondary,see,seen,short-stipitate,shorter,shot-stipitate,side,sloughing,splitting,spread,stamen,stellae,stellate-pubescent,stipitate,straight,suture,tamen,tem,time,tip,tissue,transparent,truncat,two,ud,unarme,unarmed,unbranched,vary,vein,well,wide,yellow-ferruginous,ympodia,young,±erect	0.2-0.4,0.3-0.5,0.3-0.8,0.6-1.6,0.7-1.1,1.0-1.6,1.1-1.3,1.3-1.8,1.9-3.3,2.5-4.0,6-9,7-12,adhesion,arrangement,climate,colour,dense,form,growth,height,history,inflorescence,length,life,na,number,ovary,plant,position,presence,present,pubescence,reproduction,rugulose,seed,shape,size,staman,texture
10	wfo-0001025654	success	140	99	69	71	30	0.493	0,1,1-2,15-22,2,25-30,4,5-6,6,7-8,abaxially,absent,acumen,acuminate,anther,apex,base,blade,broadly,calyx,chartaceous,cm,cuneate,diameter,dull,elliptic,flower,fruit,glabrous,glandular,globose,hair,inflorescence,juvenile,lanceolate,leaf,lobe,long,margin,mature,minutely,mm,mostly,narrowed,oblique,pedicel,peduncle,petiole,position,pubescent,purple,repand,shallowly,shortly,shrub,simple,size,stellate,stem,stigma,style,sub-acuminate,sub-axillary,surface,tip,toward,triangular,x,yellow	2-2.5,2-foliate,3/4,4-5,5,5-merous,?,abaxial,abortive,abundant,accrescen,adaxial,alyx,ape,apica,apparently,armed,articulated,axe,ba,branched,eaf,eed,erect,filament,flattened,frequently,fruiting,geminat,homostylou,hooked,larger,later,less,lower,mainly,midvein,minute,nflorescence,often,older,orolla,pale,pedicellate,phase,pore,prickle,rachi,retrorse,ruit,scarcely,scattered,sessile,several,single,slender,slightly,smaller,solitary,sparsely,straw-coloured,tal,tamen,tem,unarme,unit,unknow,unknown,vary,ympodial,young	adhesion,arrangement,climate,colour,corolla,form,growth,height,history,length,life,midpoint,na,number,ovary,perennial,plant,presence,pubescence,ray,red,reproduction,rugulose,seed,shape,staman,stipe,texture,tube,unarmed
11	wfo-0001025655	success	226	135	108	118	27	0.478	-8-17,0.3-0.4,1-1.2,1-1.5,1.3-1.5,1.5-2,11,2-2.5,2-5-celled,2.5-3,2.5-5-,3-,3-5,3-7,4,4-5,6-7,6-8,anther,apex,asymmetric,attenuate,bark,base,beige,branch,brown,calyx,cinereous,clavate,cm,cordate,cordate-lanceolate,curved,cyme,dark,deeply,diameter,epicarp,ferruginous,ferruginous-pubescent,ferruginous-tomentose,flower,fruit,glabrescent,glabrous,glandular-stellate,globose,helicoid,hirsute-glandular,indument,leaf,leathery,length,lilac,linear-lanceolate,lobe,long,many-celled,midrib,minutely,mm,monoclinous,mucilaginous,multiangulate-stellate,oblong-urceolate,parted,pedicel,peduncle,persistently,petiole,plant,porrect-stellate,prickle,prominent,ray,reddish,sessile,shrub,similar,slightly,solitary,staminate,stellate,stigma,straight,style,sub-capitate,sub-globose,sub-sessile,subcoriaceous,subreniform,subsagittate,subterete,terete,tomentose,tomentose-velutinous,triangular-lanceolate,trichome,tube,unarmed,unbranched,villous,violet,wide,within,without,yellowish	-3-5-lobed,0.6-0.8,1-2,1-3,1.4-2,2,2-3,2-3.5,3-8-flowered,4-6,5-6-merous,5-7,8-10,abaxial,accrescent,acuminate,along,alyx,anthesi,armed,articulate,ba,basal,blade,branched,brow,canaliculate,central,compressed,densely,di-,discolorous,distal,dry,eaf,eed,elongate,enlarged,entire,equal,erect,exceeding,filament,free,fruiting,functional,fused,geminat,gland,glandular,glandular-tipped,gynoeci,held,lanate,long-exserted,long-stalked,longer,lower,maturit,mix,multiangulate,multiseriate,nflorescence,numerous,older,one,orolla,papillo,part,peduncl,perennia,persistent,petiol,primary,prolonged,rachi,ranch,recurved,reduced,reflexed,rounded,rugose,ruit,secondary,sepal,short,slender,small,somewhat,sparsely,splitting,stalk,stalked,stamen,stellae,stellate-glandular,stem,strongly,sub-quadrangular,surface,surrounded,tall,tamen,time,trifoliate,uniseriate,unit,upright,vary,vein,velutinous,viscid-velutinous,weakly,woolly,ympodial,young,¼,½	adhesion,armament,arrangement,colour,corolla,form,growth,height,history,inflorescence,life,na,number,ovary,papillose,perennial,position,presence,present,pubescence,reproduction,seed,shape,size,staman,texture,type
12	wfo-0001025656	success	209	135	106	103	29	0.507	-10,-14,0.2-,0.2-0.4,0.8-1,1-1.5,1-2,1-4,1.5-2,1/3,12-15,2-2.5,2.5-5,3-12,3-3.5,3-7,4-4.5,4-5,5-,6-11,8-10,8-9,abaxially,acuminate,acute,adaxially,adult,almost,anther,apex,apically,basal,base,berry,blue,brown,calyx,chartaceous,clavate-truncate,cm,coriaceous,corolla,cuneate,diameter,elliptic,elliptic-ovate,entire,flattened,flower,foliaceous,glabrous,glandular,globose,green,growth,heterostylous,hirsute,inflorescence,internodal,juvenile,lanate,linear-lanceolate,lobe,lobed,lobed-angulate,long-styled,loosely,margin,mature,midpoint,minutely,mm,ochraceous,ovary,ovate,pedicel,peduncle,petiole,plant,poricidal,pubescence,pubescent,purple,reniform,rounded,rusty,short-styled,shrub,simple,stellate,stem,stigma,style,subcoriaceous,subglobose,subreniform,subtuncate,surface,tapering,tip,tomentose,tomentose-lanate,tube,viscid,x,yellow	0.2-0.3,0.5-0.6,1.8-2,10-,10-15,3,30-40,4-6,6,along,anthesi,apart,apical,armed,bark,branched,cell,channelled,congested,corymbose,curved,cyme,densely,denser,discolorous,distal,eaf,eed,elongate,erect,evenly,exserted,filament,flexuous,free,fruiting,gland,gre,grey,inflorescenc,lengthening,like,long,long-stalked,longer,looser,lower,midrib,minute,mixed,multangulate,multicellular,near,new,nflorescence,older,papillat,partially,perfect,pericarp,plurifoliat,pore,porrect,portion,prickle,prickly,raised,reflexed,relatively,reticulate,rugose,ruit,scandent,scar,sessile,several,short-stalked,single,slightly,spaced,sparse,sparsely,stalk,staminate,straight,subscandent,tall,testa,time,tomentose-velutinous,trichome,turbinate,ud,unit,upper,vein,venation,white,whitish,without,wood,ympodial,young	adhesion,arrangement,blade,climate,colour,form,fruit,hair,height,history,leaf,length,life,na,number,papillate,perennial,position,presence,present,ray,reproduction,rugulose,seed,shape,size,staman,stipe,texture
13	wfo-0001025657	success	239	123	99	140	24	0.414	0.1-0.4,0.2-0.4,1-1.1,1-1.3,1-3,1.2-1.5,1.3-2,1.5-1.8,2-10,2-3.5,2.2-5.5,2.5-9.3,3-4,3-6,4-4.4,5-14,5-16,6-12,7-27,7-9.5,8-10.5,8.3-12,acute,anther,apart,apex,base,berry,blade,bluish,blunt-tipped,branch,brown,bud,calyx,chartaceous,closely,cm,conical,cordate,corolla,dark,deltoid,dense,diameter,dried,elliptic,entire,filament,fleshy,flower,fruit,glabrous,glandular,granular,green,hair,lanate-pubescent,lanceolate,leaf,length,lobe,margin,mm,narrowly,oblong,ovate,pedicel,peduncle,persistently,petiole,porrect-stellate,present,pseudo-terminal,pubescence,ripe,semi-ovate,shrub,soft,spaced,stellate,stellate-pubescent,stigma,style,subcampanulate,suborbicular,surface,tan,tomentose,tomentose-pubescent,tree,tube,unarmed,velutinous-pubescent,white,x,yellow,yellowish,young	-2,/3,0.5-2.5,1-1.6,1.7-1.9,12x,2.7-4.3,2/3,25-60,3-4.8,3.2-6,4-4.5,4-7,6-8,6.5-10,7-9,abaxially,accrescent,adaxially,ag,also,anthesi,apparently,appearing,ark,around,articulated,ascending,axe,axillary,ba,branched,broadly,capitat,central,cylindrical,dendritic-multangulat,dendritic-multangulate,densely,directed,distally,due,eaf,earl,edge,eed,especially,evident,exerted,expanded,exserted,farinose,few-rayed,free,fruiting,glandula,half,inserted,lateral,lengthening,light,lobed,long,long-stalked,longitudinal,lower,m.,magnification,main,midrib,minutely,mixed,multangulate,nearly,nflorescence,obtuse,occasional,often,older,open,orbicular,orolla,ovat,ovate-lanceolate,overlapping,pale,part,parted,partly,perfect,persistent,plurifoliate,pore,poricidal,pubescent,rachi,ray,reportedly,reticulate-punctate,ruit,scented,sessile,short,short-,short-stalked,side,simple,slightly,slit,somewhat,splitting,stamen,stem,stipitate-glandular,stipitate-multangulate,strongly,subcoriaceous,suture,tall,tamen,terete,thick-stalked,thickened,thin-stalked,time,tip,tomentum,transparent,two-third,ud,unarme,unit,upper,usually,vary,vein,way,weakly,wide,ympodial	abaxial,adaxial,bark,capitate,colour,form,growth,height,history,inflorescence,life,na,ovary,perennial,plant,position,presence,reproduction,rugulose,seed,shape,size,staman,texture
14	wfo-0001025666	success	217	116	90	127	26	0.415	0-0.7,0.2-0.35,0.2-0.8,0.25-0.35,0.25-0.4,0.3,0.5-1,1,1-1.5,1-1.7,1.5-1.8,1.5-2.5,1.5-3.5,2-3,2.8-4.5,3-3.5,3.5-4,4-5,5.5-9.5,6-20,6-7.5,7-8,andromonoecious,anther,attenuate,base,brown,calyx,chartaceous,cm,connivent,cylindrical,densely,diameter,elliptical,extra-axillary,finely,flattened,fruit,glabrous,gland-tipped,globose,green,hair,inflorescence,lateral,leaf,length,lobe,lobed,long,loosely,midpoint,mm,moderately,narrowly,ovate,pale,pedicel,peduncle,perennial,petiole,pinkish,plant,prostrate,purple,ray,reticulate,ridged,shallowly,short,shrub,simple,sparsely,stellate,stellate-pubescent,stigma,stoloniferous,style,surface,terete,time,triangular,tube,white,whitish,x,yellow,yellowish,yellowish-green	%,.8,0-5,0.05-0.25,0.2-0.3,0.5-1.5,0.5-2,1-1.4,1-2,1-locular,1.6-2.3,10-30,14-29,2-4,2-8,20-60,21-30,25-65,3-5,3-7,4-6,5-6,5-merou,8-12,9-10,9-20,abaxially,absen,absent,acicular,across,acute,adaxially,alyx,apart,apex,armed,articulated,axe,ba,blade,capitat,center,confined,cross-section,cuneate,d.,difoliate,directed,distal,distall,eaf,eed,eglandular,elliptica,entire,exocarp,filament,finger,flower,fruiting,functional,geminate,half,heterostylous,incomplete,index,interpetalar,juicy,lamina,less,lobing,longer,lower,margin,mature,mesocarp,midrib,midvein,minute,moist,nflorescence,oblique,obtuse,orolla,part,per,placenta,pore,porrect,presen,present,prickle,probably,pseudo-racemose,pseudo-umbellate,rachi,ruit,septum,sessile,side,slightly,spaced,sparse,stage,stellae,straight,strongly,tal,tamen,tapered,tem,thick,throughout,tissu,tissue,transparent,unarme,unarmed,unbranched,unit,uvenile,vary,vein,weakly,wide,ympodial	abaxial,adaxial,adhesion,arrangement,capitate,climate,colour,corolla,form,growth,height,history,life,na,number,ovary,position,pubescence,reproduction,rugulose,seed,shape,size,staman,stem,texture
15	wfo-0001025669	invalid_json	216	118	87	129	31	0.403	'',.5,0.1-0.3,1-2,1-2.2,1-4,1.4-2.5,13-35,2-3,2-4,2.2-6,2.2-6.5,3-7,9-24.5,``,abaxially,acuminate,acute,adaxially,along,anther,base,blue,broadly,brownish,chartaceous,clavate,cm,condition,connivent,corolla,diameter,drying,elliptic,especially,flower,fresh,fruit,glabrous,globose,green,greenish,hair,herb,lanceolate,like,lobe,long,membranous,midrib,minutely,mm,moderately,monochasium,mottled,multicellular,odd-pinnate,ovate,ovoid,pedicel,peduncle,petiole,plant,puberulent,pubescent,purple,rarely,ripe,rotate,seed,short,size,slightly,sometimes,stem,stigma,streaked,style,subglabrous,tinged,tube,typically,white,whitish,wide,x,yellow	0-1,0-5,0-7,0.8-2.4,1,1-10,1-3,1.3-4.2,1.6-4.4,2,2.4-7,3-5,4-6,5-merou,absen,absent,acumen,ag,alyx,apart,apex,apparently,articulation,axe,berry,blade,capitat,cell,ciliate,clearly,contracted,covering,cuneate,decurrent,digestion,discussion,distal,distinct,dorsally,eaf,edge,eed,end,enzyme,erec,exceeding,except,extra,filament,flat,flowered,folded,forming,geminat,glabrou,greatly,green-white,hair-like,half,highly,homostylous,honeycomb-shaped,interjected,larger,lateral,leaflet,lengthening,living,lower,make,margin,minute,mucilaginous,near,nflorescence,oblique,obovate,obtuse,often,one,orbicular,orolla,pair,perfect,petiolulate,petiolule,placed,plurifoliate,pore,poricidal,proximal,reduced,removed,rosette,rounded,ruit,scale-like,see,sessile,seudostipule,single,slit,spaced,species,specimen,stamen,ste,stolo,straight,subequal,tall,tamen,tem,terminal,testal,thick,throughout,tip,tri-,truncate,tuber,unbranched,unequal,unit,unwinged,vary,wall,wet,ympodial	'extra,[,],adhesion,arrangement,calyx,capitate,characteristic,colour,form,growth,height,history,inflorescence,leaf,length,life,na,ovary,perennial,position,pubescence,reproduction,rugulose,shape,staman,surface,texture,value,{,}
16	wfo-0001025685	success	222	140	112	110	28	0.505	-15,-30,/3,0.2-0.3,0.4-6,0.45-0.9,0.5-1,1-4,1.4,1.5-2,12-13,2-3,2-5,2-6,2-7,3-3.5,3-4,3.5-10,4-4.5,4-5,6.5-9,7-18,abaxially,acuminate,acute,adaxially,adult,angulate,anther,apex,basal,base,berry,brown,calyx,chartaceous,clavate,cm,cordate,cordiforme,coriaceous,corolla,cuneate,deltate,diameter,entire,flattened,flower,glabrous,glandular,glandular-viscid,globose,green,growth,internodal,juvenile,lanceolate,like,lobe,lobed,long-styled,margin,midpoint,mm,oblique,oblong-lanceolate,orangish,ovary,ovate,ovate-cordiforme,ovate-elliptic,pedicel,peduncle,petiole,plant,puberulent,pubescence,pubescent,quadrate,ray,red,reniform,ripe,scabrous,shallowly,short-styled,shrub,simple,size,small,sparsely,stellate,stem,stigma,style,subcompressed,subglobose,subscabrous,subtruncate,tapering,tomentose-floccose,tomentose-scabrous,tree,triangular-lanceolate,trichome,truncate,tube,velutinous-floccose,way,white,x,yellowish	-22,/4,0.3-0.5,0.3-1,1-1.5,1-multicellular,1.5-2.5,1.8-2.5,10-15,2,2-2.2,2-4,3,3-10,50,7-8,8-10,<,anthesi,apart,apiculate,armed,articulated,ascendin,bark,basally,branched,caly,channelled,concav,curved,dark,deciduous,dense,discolorous,distal,eaf,eed,elongating,erect,exserted,filament,finely,flowering,foliaceous,free,fruiting,glabrescen,heavily,heterostylous,impressed,larger,long,lower,minute,minutely,mixed,multangulate,multicellular,new,nflorescence,obverse,older,ornamented,papillo,partially,per,perfect,pericarp,persistent,plurifoliat,pore,poricidal,porrect,portion,prickle,prickly,raised,recurved,reduced,reflexed,rest,reticulate,ruit,scandent,scar,sessile,slightly,slit,spaced,sparse,stalked,staminate,straight,subcordate,testa,thick,time,tip,tomentose-ferruginous,tomentose-velutinous,turbinate,ud,uneven,unit,vein,venation,without,woody,ympodial	adhesion,arrangement,blade,climate,colour,denser,form,fruit,hair,height,history,inflorescence,leaf,length,life,na,number,position,presence,present,reproduction,rugulose,seed,shape,staman,stipe,surface,texture
17	wfo-0001025688	success	218	112	67	151	45	0.307	0.2,0.5,1-celled,4-lobed,abaxially,abruptly,acute,adaxially,anther,apex,base,blade,brown,calyx,cm,cylindrical,deeply,dense,diameter,entire,erect,extra-axillary,flower,free,fruit,glabrous,gland-tipped,globose,glutinous,hair,leaf,lobe,long,margin,mm,narrowly,otherwise,ovate,pedicel,peduncle,petiole,pilose,puberulent,pubescence,rarely,rather,ripe,shrub,similar,simple,size,stellate,stem,stigma,style,suborbicular,surface,tapering,thin-textured,triangular,truncate,tube,white,x,yellow,yellow-green,yellowish-green	0.1,0.1–2,0.5–2,0.5–3,0.5–3.5,0.6–0.8,0.6–2,0.6–2.4,0.6–4,0.8,0–10,1,1.3–1.7,1.5–2,1.5–3,1.5–4,1/2,14155,15–25,1–1.5,1–1.6,1–1.8,1–2,1–3-celled,1–6-celled,1–8,2-foliate,25,2–3,2–3.5,2–4-celled,2–4–celled,3.2–3.6,3–10,3–4,4,40–75,4–15,4–5-rayed,4–6,4–9,5,59,5°,5–18,6–7,6–8,8–10,8–15,=,accrescent,acicular,adaxiall,also,angle,anthesi,armed,ascending,average,axe,branch,coiling,conpsicuously,constricted,contiguou,curved,darker,densely,developing,directed,distall,distally,eaf,eed,enlarged,except,fewer,filament,flattened,flowering,fresh,fruiting,geminate,gland,grading,green,hyaline,lacking,lanceolate,larger,less,lobed,lon,lower,major,many,minor,minute,mottling,n,narrowed,nearly,nee,nflorescence,none,often,one,orolla,per,pericarp,pore,prickle,rachi,recurved,ruit,scarious,scattered,sessile,short,single,slightly,small,sometimes,somewhat,sparsely,spreading,stellae,stipitate,straight,sulcate,tal,tamen,tem,thic,thick,thickene,thickened,tip,truncat,twice,unbranched,unit,upper,usually,vary,vein,way,wide,wing,ympodial,±	0.5-3,0.5-3.5,0.6-4,1-1.5,1-2,1.5-3,15-25,2-3.5,3.2-3.6,4-15,4-6,4-9,5-18,6-7,8-15,adhesion,arrangement,climate,colour,corolla,form,glandular,growth,height,history,inflorescence,length,life,midpoint,na,number,ovary,perennial,plant,position,presence,present,ray,reproduction,rugulose,seed,shape,staman,stipe,texture
18	wfo-0001025694	success	199	138	110	89	28	0.553	0.3–0.6,0.5–1.5,0.5–3,1.5–2,1.5–3.5,10–25,1–2.5,1–3,2.5–11,20,2–15,2–3.5,2–4,3–5,3–6,4–15,5–10,6–10,6–20,8–12,abaxially,acute,adaxially,androgynoecious,andromonoecious,anther,apart,apex,armed,articulated,asymmetrical,attenuate,base,becoming,blade,brown,calyx,chartaceous,cm,connivent,densely,diameter,drying,elliptic,entire,erect,flower,fruit,functionally,fused,glabrous,gland-tipped,glandular,globose,green,hair,hermaphroditic,inflorescence,interpetalar,length,like,little,lobe,male,margin,midpoint,mixed,mm,moderately,mottled,obtuse,occasionally,often,orange,ovate,pedicel,peduncle,petiole,plant,porrect-stellate,pubescent,ray,recurved,reniform,rusty,scandent,short,shrub,simple,spaced,sparse,sparsely,specifically,spine,stellate,stellate-pubescent,stem,stigma,still,style,surface,tan,tissue,triangular,tube,turning,white,yellow,young,×	0.2,0.2–0.3,0.5–1,1,10–15,1991,1–2,2.5,25–50,2–3,2–5-branched,4–12,4–5,5-merous,abaxial,absen,absent,accrescent,adaxial,adaxiall,alyx,apical,axe,ba,berry,beyond,capitat,center,completely,cordate,covering,cylindrical,dark,discolorous,eaf,eed,exerted,exserted,filament,flattened,frui,fruiting,heterostylou,long,lower,matur,membranaceous,midrib,midvein,multicellular,multiseriate,narrowly,nearly,nflorescence,opening,orolla,per,pinnate,plurifoliat,pore,prickle,rachi,reflexed,roselike,rugose,ruit,secondary,side,slit,stalk,stamen,staminate,swollen,tal,tamen,tem,tip,triangular-ovate,unicellular,uniseriate,unit,vary,vein,venation,walker,whelan,whitish,wide,ympodial	adhesion,arrangement,capitate,climate,colour,corolla,form,growth,height,history,leaf,life,mature,na,number,ovary,position,presence,present,pubescence,reproduction,rugulose,seed,shape,size,staman,stipe,texture
19	wfo-0001025697	success	181	94	65	116	29	0.359	-9,0.15-0.75,1-1.7,1-3,1.5-1.8,1.7-8.6,2-6,25-35,3-10,3-4,3-6,3.3-11,5.5-11.5,6.5-13.5,abaxially,adaxially,anther,blue,brownish,clavate,cm,condition,connivent,coriaceous,corolla,dark,deep,diameter,drying,elliptic,fresh,fruit,glabrescent,glabrous,globose,green,greenish,herb,lanceolate,leaf,light,lilac,lobe,medium,mm,odd-pinnate,ovate,ovoid,pedicel,peduncle,pentagonal,petiole,plant,purple,rotate,seed,size,stigma,stripe,style,terminal,tube,whitish,x,yellow	0-14,0.6-3.5,0.8-2,1-2,10-26,2-10.5,2-2.6,2-4,3-5,4-7.5,5-merou,acumen,acuminate,acute,adaxiall,ag,alyx,apart,apex,apparently,articulated,asymmetric,attenuate,axe,axillary,base,basiscopic,berry,blade,bud,capitat,cell,covering,decreasing,decurrent,digestion,distal,dorsally,eaf,edge,eed,enzyme,erec,exceeding,filament,flat,flower,folded,forked,geminat,generally,glabrou,green-white,hair,hair-like,hal,half,high,homostylous,honeycomb-shaped,interjected,lateral,leaflet,lengthening,linear,living,long,lower,make,mucilaginous,nflorescence,orbicular,orolla,pair,perfect,petiolulate,plurifoliate,pore,poricidal,rachi,removed,ripe,rounded,ruit,sessile,seudostipule,short,side,slightly,slit,spaced,specimen,stamen,straight,subequal,subglabrou,subtending,tall,tamen,tem,testal,thick,throughout,tip,tissue,toward,tri-,typically,unit,unwinged,usually,vary,wall,wet,wood,ympodial	abaxial,adaxial,adhesion,arrangement,calyx,capitate,colour,form,growth,height,hermaphroditic,history,inflorescence,length,life,na,ovary,perennial,position,pubescence,reproduction,rugulose,shape,staman,stem,surface,texture,woody,ye
20	wfo-0001025699	success	181	118	86	95	32	0.475	1,1-1.5,1-2.5,1/3,10,15-20,2,2-2.5,2-6,2cm,3-3.5,3-5.5,3-8,4-5,5.5-14,8-9,absent,acute,almost,anther,apex,attenuate,base,becoming,berry,brown,calyx,capitate,cm,completely,conical,corolla,cup-shaped,dark,diameter,ellipsoid,elliptic,entire,glabrous,globose,green,grey-brown,growth,immature,inflorescence,lanceolate,leaf,leaf-opposed,leafy,lobe,lobed,margin,minutely,mm,narrowly,ovary,pale,papillose,pedicel,peduncle,petiole,poricidal,reniform,reticulate-pitted,rounded,rounded-sagittate,shoot,short,simple,slightly,small,somewhat,stem,stigma,style,surface,tangled,tip,tree,triangular,trichome,tube,way,white,x,½	.2,.5,0.5,1-2,1-3,1.5,1.5-2,3-15,499,5-8,5-winged,abaxially,adaxially,age,anthesi,apart,apparently,appearing,articulating,bark,branching,c.,campanulate,conspicuously,continuing,corrugate,crystal,darker,deltate,densely,difoliate,dorsal,dry,drying,eaf,eed,erect,exerted,face,fide,filament,flower,free,fruiting,glabrou,included,inclusion,inflorescenc,irregularly,leaving,lengthening,less,lower,markedly,midrib,new,nflorescence,nodding,older,one,onto,oxalate,pair,papillat,peg,penden,per,perfect,plurifoliate,pore,portion,primary,red,reddish,ruit,sand,scar,slit,spaced,stearn,straight,strongly,thickened,time,ud,unit,vein,white-spotted,wide,wing,winged,woody,yellow,ympodial,young	1.2,3,adhesion,arrangement,blade,climate,colour,form,fruit,glandular,hair,height,history,length,life,midpoint,na,number,plant,position,presence,pubescence,ray,reproduction,rugulose,seed,shape,size,staman,stellate,stipe,texture
21	wfo-0001025700	success	189	87	62	127	25	0.328	0.30-2.0,0.8-2.6,1-3,1.5-2,10.5-12,15-40,2-12,2-7,2.5-4,5-20,5.3-17.5,5.5-18,5.5-8,9-31,anther,apiculate,brownish,chartaceous,clavate,cm,condition,corolla,diameter,dot,drying,elliptic,fresh,fruit,glabrescent,glabrous,globose,green,greenish,herb,lanceolate,lateral,leaf,light,lilac,lobe,mm,odd-pinnate,ovate,ovoid,pedicel,peduncle,pentagonal,petiole,plant,purple,rotate-pentagonal,seed,size,sometimes,stigma,style,terminal,tube,white,whitish,x,yellow	0-16,0.5-2,0.7-2.7,0.8-4,1-2,1.1-2.3,10-40,3-4,3-8,3.5-10.5,3.7-8.6,4-5,5-15,5-merou,abaxially,acuman,acumen,acuminate,acute,adaxially,ag,alyx,apex,apparently,articulated,asymmetric,attenuate,axe,axillary,basal,base,basiscopic,berry,blade,bud,capitat,cell,connivent,considerably,covering,decrease,decreasing,digestion,distal,dorsally,eaf,edge,eed,enzyme,erec,exceeding,except,filament,flat,flower,folded,forked,geminat,generally,glabrou,green-white,hair,hair-like,hal,half,high,homostylous,honeycomb-shaped,interjected,larger,leaflet,lengthening,linear,living,long,lower,make,medium,mucilaginous,narrowly,nflorescence,orbicular,orolla,pair,par,perfect,petiolulate,plurifoliate,pore,poricidal,proximal,removed,ripe,rounded,ruit,sessile,seudostipule,short,side,slightly,slit,specimen,stamen,straight,subequal,subglabrou,subtending,tall,tamen,tem,testal,thick,throughout,tip,tissue,toward,tri-,typically,unit,unwinged,usually,vary,wall,wet,whose,winged,ympodial	adhesion,arrangement,calyx,capitate,colour,form,growth,height,hermaphroditic,history,inflorescence,length,life,na,ovary,perennial,position,pubescence,reproduction,rugulose,shape,staman,stem,surface,texture
22	wfo-0001025702	success	279	132	103	176	29	0.369	.0,.3,.5,.7,0.3–0.4,0.3–2.2,0.4–2.3,0.5–1.3,0.6–0.9,1.2–1.6,1.3–1.8,1.4–2.8,1.6–1.7,1.6–1.8,1.6–2.0,1.6–2.3,1.7–2.3,1.7–9.2,2,2.3,2.3–7.8,3.2,4.5–5.2,6–10,6–8,acuminate,acute,adnate,anther,apex,apiculate,attachment,attenuate,base,blade,calyx,capitate,chartaceous,cm,completely,corolla,cream,cuneate,deltate,deltoid,densely,developed,diameter,dry,elliptic,entire,extra-axillary,ferruginous,flattened-orbicular,flower,fruit,glabrous,globose,incurved,interpetalar,lanceolate,lateral,lobe,margin,mature,minute,mm,moderately,nearly,notched,oblong,obtuse,ovate,pedicel,petiole,point,poorly,pubescent,ray,red,rounded,scandent,shrub,simple,smooth,somewhat,sparsely,stellate,stem,stigma,style,sub-coriaceous,surface,tip,tissue,truncate,tube,white,yellow,yellow-ferruginous,yellow-tan,×,–6	.1,/2,0.04,0.5–0.6,0.5–0.8,0.6–1.0,0.7–1.4,1.3–2.8,1.4–1.6,1.4–2.2,1.6–2.1,1.7,1.9,1/3,1/4–1/3,2.0–3.2,2.2,2.2–2.9,2.3–6.6,2.5,2.6–7,2–14,3.6–3.9,4,4.3,4–16,5-merou,5.2–7.5,5.4,6.6,6.9–10.3,abaxially,adaxially,adjacent,aequilateral,ag,alyx,anthesi,apart,apical,apparently,appearing,appresse,around,articulate,axe,ba,bark,based,becoming,berry,branch,broad,broad-based,broadly,brochidodromous,brown,bud,channeled,congested,curved,deciduous,deflexed,dentate,difoliate,directed,distal,distally,distinct,eaf,edge,eed,either,emerging,endocarp,exocarp,extending,fertile,filament,filiform,flexed,forked,free,geminat,glandular,glossy,gradually,gree,hair,homostylous,hooked,hort,increasing,indistinct,intact,internode,intersepalar,joining,juic,laterally,lax,layer,limp,lon,long,longer,lower,m.,midpoint,midrib,midvein,nflorescence,oblique,occasionally,opaque,orolla,per,perforated,pore,porrect,portion,potentially,presen,prickle,primary,pseudo-intermarginal,pseudo-peduncle,raised,reddish,reflexed,remaining,retrorse,row,ruit,scattered,secondary,seen,sessile,shoot,side,sinus,sloughing,smoot,sometimes,soon,splitting,spread,stamen,stellae,stellate-pubescent,straight,strongly,suture,tamen,tem,thin,time,toward,transparent,triangular,two,ud,unarmed,unbranched,upper,vary,vein,wide,yellow-ferruginou,ympodia,young,±90,±90°,±connivent,±equal,±glabrous	adhesion,arrangement,colour,form,green,growth,height,history,inflorescence,leaf,length,life,na,number,ovary,peduncle,perennial,plant,position,presence,present,pubescence,reproduction,rugulose,seed,shape,size,staman,texture
23	wfo-0001025704	success	248	138	108	140	30	0.435	0-3.5,0.3-0.8,0.7-1,1-3.5,1-6,1.2-3,1.5-3.2,1/2-4/5,1/5,2-3,2-4.5,2-7,2.7-4,3-15,3-5,3-6,4-5,4.5-6.5,6-12,8-12,8-15,abaxially,acute,almost,andromonoecious,anther,apex,apically,apiculate,auriculate,base,blade,calyx,chartaceous,cm,connivent,cordate,deltate,densely,diameter,discolorous,drying,ellipsoid,elliptic,equal,erect,evenly,flattened-reniform,fruit,glabrescent,green,green-yellow,irregular,lateral,leaf,length,lobe,lobed,long,margin,maturity,mauve,midpoint,mm,near,often,orange,orange-brown,outline,ovate,pale,pedicel,peduncle,petiole,plant,poricidal,ray,round,shape,shrub,side,small,smooth,sometimes,somewhat,sparsely,spherical,stellate,stellate-pubescent,stem,strongly,style,surface,tapering,terminal,tip,tree,truncate,tube,upper,warty,way,white,wide,yellow,yellowish,young,×	-10,-2,-3,-5,/6,0,0-100,0-2,0-5,0.1,0.1-0.3,0.1-0.5,0.15-0.8,0.5-1.5,1,1-4,1.5-2,1.5-4.5,1.8-3.5,1/4-3/4,2,2-10,2-5,2.5-4.5,3-10,4-12,5-20,5-merous,6-15,8-17,abaxial,adaxial,age,alyx,apar,apart,apparently,articulated,axe,ba,bark,berry,branched,broad-deltate,brow,cell,covering,curved,development,distal,distance,eaf,eed,elongating,end,extending,filament,flattened,flower,free,fruiting,glabrous,gray,half,hermaphrodite,heterostylous,infructescence,less,lobing,long-styled,longer,lower,lowermost,mature,midvein,moderately,multangulate,nflorescence,obtuse,occasionally,older,one,open,orolla,oung,pair,pendulous,per,pericarp,pit,plurifoliat,porrect,portion,prickl,prickle,prickly,primary,prominent,raised,rarely,recurved,red-brown,red-green,reflexed,retaining,rounded,ruit,scar,secondary,sessile,short-styled,shorter,slender,spaced,spreading,stalk,stalked,staminat,stellate-pubescen,stout,straight,tamen,terete,tertiary,throughout,time,trichome,unarmed,unbranched,unit,variously,vary,vein,venation,visible,white-gray,widening,woody,yellow-green,ympodial	0.1-0.8,adhesion,arrangement,climate,colour,corolla,form,glandular,growth,hair,height,history,inflorescence,life,na,number,ovary,perennial,position,presence,present,pubescence,reproduction,rugulose,seed,size,staman,stigma,stipe,texture
24	wfo-0001025714	success	249	127	75	174	52	0.301	-5,-rayed,0.5,2,2.5,2.8,abaxially,acute,adaxially,anther,apex,attenuate,base,blade,broadly,calyx,cm,decidedly,diameter,extra-axillary,flattened,flower,free,fruit,glabrous,gland-tipped,glandular-pubescent,globose,hair,hyaline,less,light,lobe,lobed,long,longer,margin,maturity,minutely,mixed,mm,narrowly,orbicular,ovary,ovate,pedicel,peduncle,petiole,pilose,pubescence,rounded,scattered,shrub,similar,simple,size,stellae,stellate,stem,stigma,stipitate-glandular,style,subcordate,subreniform,tan,thin-textured,triangular,truncate,tube,usually,white,wide,x,yellow,yellowish	%,.2,0.1–0.8,0.2–0.8,0.5–0.6,0.5–1.3,0.5–2,0.8,0–0.4,1,1.2–2.4,1.3–3,1.5–2,1.5–2.5,1.5–3.5,1.6–2.3,1.8–,1/3,100,10–11,13,15,15–25,1–2,1–4,2-foliate,2.2–3,2.5–3.8,2–3,2–4-celled,2–7,2–8,3.7–5,3–16,3–9,4–18,4–6,5,5.9–7.5,50,5–25,5–6.5,6.2–6.8,6–16,7–18,7–8.5,8–13,9.2–10,9–22,>,absent,accrescent,acicular,adaxiall,additional,always,anthesi,apart,appearing,armed,around,articulated,ascending,asia,axe,ba,berry,branch,capitat,caudate-tipped,completely,concealing,covering,curved,cylindrical,differing,dilated,dimorphic,directed,distall,eaf,eed,enlarged,entire-margined,erect,fertile,few-branched,few-rayed,filament,forward,frui,fruiting,geminat,glabrou,gland,gland–tipped,half,halfway,herbarium,horizontally,immediately,increasingly,lacking,larger,latter,lobing,longest,lower,lowermost,mainly,major,male,many-rayed,midrib,minor,minute,multangulate,nearly,nflorescence,numerous,obtuse,often,one,orolla,pair,per,perhaps,plane,pointing,pore,predominating,prickle,pubescent,rachi,rare,rarely,recurved,reflexed,ruit,scarcely,sessile,short,shorter,single,slender,slightly,small,smaller,sometimes,spaced,sparse,specimen,spine,spreading,stipitate,stouter,straight,subglabrous,tal,tamen,tem,terete,time,toward,unbranched,unequal,unit,upper,various,vary,way,ympodial,–1.25,–7–9	0-0.8,0.1-0.8,0.2-0.8,0.5-0.6,0.5-1.3,0.5-2,1-2,1.3-3,1.5-2,1.8-3,15-25,2-3,2-4-celled,3-16,3-9,4-18,4-6,5-6.5,5.9-7.5,6.2-6.8,7-9,9-22,adhesion,arrangement,capitate,climate,colour,corolla,form,glandular,growth,height,history,inflorescence,leaf,length,life,midpoint,na,number,perennial,plant,position,presence,present,ray,reproduction,seed,shape,staman,stipe,texture
25	wfo-0001025726	success	158	107	73	85	34	0.462	-10,-16,-5,0.2-0.3,0.5,1,1-1.5,1-2.5,1-3,10-15,2.5,3-10,3-5,5,6-12,6-8,abaxially,acuminate,acute,adaxially,anther,anthesi,apex,base,blade,brown,calyx,campanulate,chartaceous,cm,diameter,entire,flattened,fruit,glabrous,globose,green,hair,light,lobe,margin,mm,narrowly,oblong,occasionally,pedicel,peduncle,perennial,petiole,pinnate,pinnatifid,plurifoliate,puberulent,purple,rarely,rounded,rugose,shape,size,slender,spreading,stellate,stigma,strongly,style,surface,terminal,tube,variable,variously,white,x,yellow	0-1,0.2,0.5-1.5,2-,2-3,20-40,3-4,4,4-10,7-9,accrescen,adaxiall,adjacent,ag,alyx,armed,articulated,axe,ba,becoming,branched,broadly,clustered,compound,confluent,connivent,dr.,eaf,eed,elliptic,elongating,equal,fertile,filament,flower,foveolate,fruiting,geminat,imparipinnately,internode,lateral,leaflet,lengthening,lobed,long,major,midrib,nflorescence,oblon,often,orolla,ovate,pore,poricidal,present,prickle,rachi,ranging,recurve,recurved,ruit,scandent,side,simple,slit,stout,straight,subwoody,swollen,tamen,tem,terminally,time,tip,truncat,ud,unbranched,unit,usually,vary,vein,vin,wide,woody,ympodial	adhesion,arrangement,climate,colour,corolla,dry,form,glandular,growth,height,history,inflorescence,leaf,length,life,midpoint,na,number,ovary,plant,position,presence,pubescence,ray,reproduction,rugulose,seed,staman,stem,stipe,texture,true,truncate,vine
26	wfo-0001025729	success	177	92	66	111	26	0.373	.5,/4,0.7-1.2,1-1.5,1-5,1.1-1.5,1.2-1.8,1.5-2,1.75,2,20,4-5,4-8,9-17,anther,apiculate,base,bright,calyx,cm,corolla,cyathiform,deltoid,dia,dirty,elliptic,flattened-reniform,fleshy,glabrous,globose,green,greenish-yellow,greyish-brown,leaf,live,lobe,lobed,long,minutely,mm,opposite,ovary,pale,papillose,pedicel,petiole,plant,rounded,shiny,short,size,stem,stigma,stout,style,surface,tree,treelet,trichome,tube,tuft,uniseriate,way,white,x,yellow	-20,0.25-0.5,2-3.5,3-6,5-50-flowered,6-8,7-8,abaxial,abaxially,abrupt,acute,adaxially,along,anthesi,apar,apex,apical,appearing,axil,bark,basal,berry,black,blackish,branched,bristly,bud,covered,covering,dark,deflexed,densely,denser,diam,differing,difoliate,drying,eaf,edicel,eed,enclosed,expanded,f,filament,free,fruiting,furcate,geminat,gently,glabrou,growing,incrassate,lamina,lat,lateral,like,lon,lower,m.,main,mainly,major,margin,member,middle,minor,minute,nflorescence,oblique,occasionally,often,older,one,overlapping,overtopping,pair,papillo,partially,pit,pitted,pore,poricidal,portion,prominent,pubescent,quite,raised,reflexed,ripening,ruit,scar,shaped,simple,sparsely,straight,tall,tapering,tear-drop,terminal,tip,touching,tub,ud,unit,usually,vein,widening,widest,woody,ympodial,young	4-20,adhesion,alternate,arrangement,colour,diameter,form,fruit,growth,height,history,inflorescence,length,life,na,peduncle,perennial,position,pubescence,reproduction,rugulose,seed,shape,staman,texture,ye
27	wfo-0001025737	success	220	137	85	135	52	0.386	0.6,1.5,1.5-2,10,abaxially,adaxially,angularly-cordate,anther,apart,apex,articulated,attenuate,base,blade,branch,bright,cm,densely,diameter,entire,extra-axillary,fertile,flattened-reniform,flower,free,fruit,glabrous,gland-tipped,globose,growth,hair,interpetalar,juicy,lateral,light,lighter-colored,like,linear-attenuate,linear-lanceolate,lobe,lobed,loosely,margin,minute,mm,narrow,near,obtuse,orange,ovate,ovate-lanceolate,pale,pedicel,peduncle,per,petiole,rarely,ray,rounded,seed,shallowly,shiny,shrub,side,simple,slender,spaced,stellate,stellate-tomentose,stem,stigma,stipe,style,surface,thick-chartaceous,tinge,tissue,tomentose,triangular-attenuate,tube,usually,violet,white,yellow,×	-branched,0.2–0.3,0.3–0.7,0.3–2,0.6–0.9,0.7–1.3,0.8–1.1,0.9–1.1,1.4–1.8,1.5–2,1.5–3,1.5–5,1.5–6.5,1.7–2.2,10–12,1–,1–1.2,1–1.5,2,2.5–3,2.5–4.5,25–50,2–3,3,3.5–5,3.5–8,3–10,44599,47092,4–11,4–6,5,5-merous,51,5–6,7–8,8–10,8–16,9-10,95,absent,accrescen,acute,adaxiall,age,alyx,apical,apparently,appressed-tomentose,armed,axe,ba,becoming,broad-based,capitat,deeply,difoliate,directed,distall,eaf,eed,except,filament,filiform,finely,geminat,glabrou,green,greenish,high,homostylous,immature,internode,juvenile,lance-ovoid,lon,long,long-stipitate,lower,major,midpoint,midvein,midzone,minutely,mixed,nee,nflorescence,northern,numerous,oblong,odorle,orolla,part,perfect,persistently,pitted,pore,porrect,prickle,principal,range,reflexed,ruit,scarcely,sessile,short-,short-stipitate,shorter,sinus,southern,sparsely,splitting,ste,stellae,stellate-pubescent,straigh,straight,tamen,tem,time,tomento,turning,ud,unarmed,vary,vein,vigorous,whitish,wide,x,ympodia,–14,–20,–3,–4	0.3-0.7,0.3-2,0.6-0.9,0.8-1.1,0.9-1.1,1-1.5,1.4-1.8,1.5-3,1.5-5,1.7-2.2,10-12,14,2-3,2.5-3,2.5-4.5,20,3.5-8,4,4-11,5-6,7-8,8-10,8-16,adhesion,arrangement,calyx,capitate,colour,corolla,form,glandular,height,history,inflorescence,leaf,length,life,na,number,ovary,perennial,plant,position,presence,present,pubescence,reproduction,rugulose,shape,size,staman,texture
28	wfo-0001025741	success	231	129	106	125	23	0.459	0.5–0.8,0.5–3,1.2–1.5,1.8–2.1,11–14,12–15,15–45,1–4,2.5–3,2.5–3.5,2.5–8,30–120,3–10,4–6,4–7,5–17,6.5–9,abaxial,abundant,adaxial,andromonoecious,anther,apart,articulated,base,brown,calyx,chartaceous,cm,congested,connivent,dark,deltate,densely,diameter,equal,extraaxillary,fading,flattened,flower,fruit,glabrous,glandular,globose,golden-tan,green,hair,inflorescence,interpetalar,juicy,lanceolate,leaf,length,light,lighter,like,lobe,long,long-stalked,lustrous,maturity,mm,moderately,multangulate,orange,orange-tan,outline,ovate,pedicel,peduncle,petiole,plant,porrect-stellate,pubescent,reniform,rotate-stellate,sessile,shiny,short,short-cylindrical,short-stalked,somewhat,spaced,sparse,sparsely,stalked,stellate,stem,stigma,strongly,style,surface,tan,tapered,tissue,tree,tube,violet,white,yellow,young,×,–12,–20,–30,–8	.2,.5,0-0.1,0–0.1,1.1–2,1.7–2,10–35,1–2,1–2.5,20–23,29–36,2–3,2–3.2,2–4,2–7.5,3–6,4–5,5-merous,5–6,6–7,8–15+,8–18,abaxially,abundantly,acuminate,acute,adaxially,along,alyx,andromonoeciou,anthesi,apex,armed,axe,ba,bark,becoming,berry,blade,broad-based,capitat,column,covered,cuneate,curved,cylindrical,db,deltoid,difoliate,directed,distall,dry,eaf,eed,eglandular,either,emergent,entire,filament,flowering,free,fresh,frui,fruiting,functionally,geminat,half,hermaphroditic,heterstylous,included,inflated,knobby,lobed,lon,lower,major,margin,membranaceous,midpoint,midvein,multiseriate,nearly,nflorescence,oblique,once-branched,one,orolla,part,pericarp,pore,present,prickle,rachi,ray,remaining,rugose,ruit,runk,shallowly,sharp,side,simple,small,stalk,staminate,stellate-pubescent,stout,straight,subtending,tamen,thi,thin,time,tuft,unarmed,unbranched,unit,vary,vein,wide,within,ympodial,–28,–39,–6	adhesion,capitate,colour,corolla,dbh,form,growth,height,history,life,na,ovary,perennial,position,pubescence,reproduction,rugulose,seed,shape,size,staman,texture,true
29	wfo-0001025743	success	157	109	78	79	31	0.497	%,.5,0.15-0.3,0.4-0.5,0.4-0.8,0.5-0.9,0.9-1.2,0.9-2.6,1.2-4,2-3,2-4,2-4.5,2.8-3.5,3.5-5.5,30-80,4.5-5.5,5-10,6-7,8-10,9-18,adaxially,andromonoecious,apex,articulated,base,blade,broadly,brown,calyx,chartaceous,cm,cordate,cuneate,deeply,deltate,diameter,extra-axillary,flower,fruit,glabrous,gland-tipped,globose,green,grey,hair,herbaceous,inflorescence,lamina,length,lobe,lobed,long,margin,mid-point,mm,obtuse,ovate,pale,pedicel,peduncle,petiole,plant,present,prickle,prostrate,resprouter,short,simple,sprawling,stellate,strongly,style,thick,throughout,tube,white,x,yellow	0-15,0-6,0.1-0.3,0.3-0.5,0.3-0.6,1,1-6,1.3-1.8,11-25,12-17,2.3-5,3-13,3-4,3-6,4-8,5-20,5-merou,6-10,6-20,abaxially,absen,absent,acicular,adaxiall,adult,alyx,apart,armed,axe,ba,branche,cylindrical,decimetre,dense,directed,distall,eaf,eed,finger,fruiting,functional,half,heterostylous,index,lateral,less,lobing,lon,longer,lower,mature,midvein,minute,nflorescence,nther,oblique,onl,orolla,part,per,pore,presen,ruit,side,spaced,stage,straight,tal,tem,time,unbranched,unit,unknow,uvenile,vary,vein,wide,yellowish-gree,ympodial	adhesion,anther,arrangement,climate,colour,corolla,form,glandular,growth,height,history,leaf,life,midpoint,na,number,ovary,position,presence,pubescence,ray,reproduction,seed,shape,size,staman,stem,stigma,stipe,texture,yellowish-green
30	wfo-0001025749	success	217	106	75	142	31	0.346	0.1-0.4,0.2-1.5,0.3-1.5,0.5-0.8,0.5-0.9,0.6-4.5,0.8-0.9,1-10,1-2,1-8.5,1-9,1.5-2,1.5-2.5,2-2.5,2.5-6,3-5,6-8,acute,anther,apex,base,blade,calyx,chartaceous,cm,cuneate,densely,diameter,dull,flattened-reniform,fruit,glabrous,lateral,leaf,length,lobe,lobed,long,long-ovate,lower,margin,maturity,mauve,midpoint,mm,moderately,narrow-deltate,narrow-ovate,orange-brown,orange-red,orbicular,ovate,pedicel,peduncle,petiole,poricidal,ray,rounded,shrub,smooth,sparsely,spherical,spreading,stellate,stellate-pubescent,stem,straw-yellow,style,tapering,tip,tube,white,wide,yellow,yellow-orange	-1,-12,.5,/5,0-10,0-3,0-5,0-6,0-8,0.1,0.1-0.2,0.1-0.3,0.2,0.4-0.7,0.5,0.5-1.3,0.5-3,1,1-13,1-3,1-6,1.5,1/4-1/3,1/5-1/2,2-10,2/3,3-20,4-8,5-,5-10,5-20,5-merous,abaxial,abaxially,acuminat,adaxial,adaxially,adnate,almost,alyx,apar,apart,apically,apparently,articulated,bark,berry,branched,broad-deltate,concolorous,curved,dark,difoliate,discolorous,distance,drying,eaf,eed,elongating,equal,erect,extending,filament,filiform,flattened,flower,free,fruiting,geminat,gently,glabrescent,gray,green-brown,herbaceous,indistinct,infructescence,light,lon,longer,magnification,markedly,mature,midvein,nflorescence,oblong,obtuse,occasionally,older,one,open,orange-brow,orolla,oung,pair,pale,pendulous,per,perfec,pericarp,porrect,portion,prickl,prickle,prickly,primary,procumbent,purple,rarely,recurved,red-brown,reduced,ruit,scar,sessile,shorter,side,sometimes,spaced,stalk,stalked,straight,strongly,surface,tamen,terete,tertiary,time,toward,trichome,unit,usually,variously,vary,vein,venation,visible,way,without,yellow-green,yellowish,ympodial,½-2/	adhesion,arrangement,climate,colour,corolla,form,glandular,growth,hair,height,history,inflorescence,life,na,number,ovary,perennial,plant,position,presence,pubescence,reproduction,seed,shape,size,staman,stigma,stipe,texture,ye,½-2/3
31	wfo-0001025754	success	164	100	65	99	35	0.396	0.1-0.2,0.5-1,0.5-1.5,1-3,1-3.5,1.5,1.5-3,1.5-4,10-20,2-7,4-6,5-12,5-15,acuminate,acute,anther,apex,base,blade,brown,calyx,chartaceous,ciliate,cm,cordate,cordiform,densely,diameter,dm,drying,entire,flower,fruit,glabrous,glandular,globose,hair,herb,immature,leaf,linear-lanceolate,lobe,margin,membranaceous,mm,moderately,nearly,oblong,pedicel,peduncle,petiole,pubescent,rotate,semitransparent,solitary,sparsely,stem,stigma,style,surface,truncate,tube,white,x,yellow	-celled,.5,1,1-2,10-35,2-4,2-5-celled,2-foliate,3-10,3-5,3-6,4,abaxially,absent,abundant,adaxiall,adaxially,along,asymmetrical,axe,barely,berry,beyond,branch,center,connected,decumbent,decurrent,dehiscing,denser,dried,eaf,edge,eed,eglandular,emarginat,equal,erect,explosively,exserted,filament,fine,flat,geminat,held,interpetalar,leaving,like,long,lower,lying,main,material,maturing,maturit,mesocarp,mixed,much-branched,nfloresence,notch,often,orolla,palmately,parallel,penden,per,placenta,pressure,probably,pubescen,rachi,radiating,raised,ridge,ruit,running,shallow,short,slightly,small,sometimes,stamen,straight,swollen,tal,tamen,tem,tissue,triangular,unbranched,unit,upright,vary,vein,visible,watery,wid,woody,ympodial	2.5,adhesion,arrangement,climate,colour,corolla,form,geminate,growth,height,history,inflorescence,length,life,maturity,midpoint,na,number,ovary,perennial,plant,position,presence,present,pubescence,ray,reproduction,rugulose,seed,shape,size,staman,stellate,stipe,texture
32	wfo-0001025760	success	210	107	76	134	31	0.362	-6,0-0.5,0.2-0.35,0.3-1,0.45-0.9,0.5-2,0.8-1.8,1-1.8,1-4,1.5-5,2-2.5,2.1-3.5,2.3-4,2.5-10,3.5-9,5-18,acute,annual,anther,apex,apically,base,blade,broad-deltate,calyx,chartaceous,cm,cream,cuneate,dark,diameter,dull,flattened-reniform,fruit,glabrous,green,hair,herb,lateral,leaf,length,lobe,lobed,long,margin,marking,maturity,membranous,midpoint,mm,moderately,orange,orange-brown,ovate,pale,pedicel,peduncle,perennial,petiole,poricidal,ray,rounded,shape,smooth,spherical,stellate,stellate-pubescent,stem,style,tapering,tip,tube,white,wide,yellow,young	-10,-12,-3,-5,.5,/3,0-100,0.1,0.1-0.2,0.15-0.3,0.4-0.8,0.5-1.5,0.7-2.5,1,1-,1-2,1.5,1.5-2.5,1.5-4.5,1/4,1/4-1/2,1/4-1/3,1/5,2-3,2.5-8,2/3,3,3-6,3.5-17,5-10-merous,8-10,abaxial,abaxially,acut,adaxial,almost,alyx,apar,apparently,articulated,bark,berry,black,brow,concolorous,connivent,cultivar,curved,deltate,difoliate,discolorous,distance,drying,eaf,eed,elliptic,elongating,equal,erect,extending,filament,flower,free,fruiting,geminat,geminate,gently,glabrescent,infructescence,lengt,longer,lower,mature,midvein,minute,nflorescence,often,older,one,open,orolla,oung,pair,pendulous,per,perfec,pericarp,porrect,portion,primary,recurved,red-brown,reflexe,ruit,scar,sessile,shorter,shrub,side,simple,slender,sometimes,spaced,spreading,stalk,stalked,stellate-pubescen,stout,straight,subentire,surface,tamen,terete,tertiary,thick-stalked,time,trichome,unarme,unarmed,unbranched,unit,upper,usually,various,variously,vary,vein,venation,visible,way,weakly,woody,yellow-green,ympodial	8-12,adhesion,alternate,arrangement,brown,climate,colour,corolla,form,glandular,growth,height,hermaphroditic,history,inflorescence,life,na,number,ovary,plant,position,presence,present,pubescence,reproduction,seed,size,staman,stigma,stipe,texture
33	wfo-0001025782	success	200	100	75	125	25	0.375	.5,0-5,0.1-0.25,0.55-0.75,0.9-1.3,1-2,1.2-6,1.3-1.6,2-2.5,2-3,3-4,4,4-4.5,4.5-9,5.5-6,6-14,6-8,acuminate,anther,apex,apically,base,berry,blade,brown,calyx,chartaceous,climbing,cm,connivent,cuneate,deltate,diameter,dull,elliptic,evenly,flattened-reniform,fruit,glabrous,green,hair,lateral,leaf,length,lobe,lobed,long,margin,maturity,membranous,midpoint,mm,moderately,orange-brown,pedicel,peduncle,petiole,plant,poricidal,ray,shrub,sparsely,spherical,stellate,stellate-pubescent,stem,style,tapering,tip,tube,weakly,white,wide,yellow,young	-2,0-10,0.1-0.15,0.1-0.2,0.3-1,0.4-0.6,0.5-1,1,1-1.7,1-2.5,1-4,1.5-3,1/4-1/2,1/4-1/3,1/6,10-13,2-10,2-5,2-7,2.5-3.5,2/3-3/4,20,3-5,5-20,5-6.5,5-8,5-merous,abaxial,abaxially,acuminat,adaxial,also,alyx,andromonoecious,apar,apart,apparently,articulated,bark,concolorous,conical,curved,densely,difoliate,discolorous,distal,distance,drying,eaf,eed,elongated,elongating,equal,extending,filament,flattened,flower,free,fruiting,geminat,geminate,gently,glabrescent,green-brown,hermaphrodite,heterostylous,infructescence,lengt,less,long-styled,longer,lower,lowermost,mature,midvein,minute,nflorescence,occasionally,older,one,open,orolla,oung,pair,pendulous,per,pericarp,porrect,portion,prickl,prickle,prickly,primary,red-brow,reduced,ruit,scar,sessile,short-styled,shorter,side,simple,smooth,spaced,spreading,staminat,stout,straight,surface,tamen,terete,tertiary,time,toward,trichome,unbranched,unit,vary,vein,venation,visible,way,woody,yellow-green,ympodial	8,adhesion,arrangement,climate,colour,corolla,form,glandular,growth,height,inflorescence,na,number,ovary,position,presence,pubescence,seed,shape,size,staman,stigma,stipe,texture,ye
34	wfo-0001025783	success	179	114	83	96	31	0.464	.5,0.5-1.5,0.8-3.5,1-1.2,1-1.5,1-3,2-5,2-6.5,5,abaxially,acute,anther,apex,base,brown,c.,calyx,cm,conical,coriaceous,corolla,densely,diameter,ellipsoid,elliptic,entire,flattened,fleshy,glabrous,globose,greyish,growth,keeled,lateral,lax,less,lobe,lobed,long,margin,mm,narrowly,number,obtuse,occasionally,pale,pedicel,peduncle,petiole,pubescent,purple,reniform,revolute,ripe,sagittate,shiny,shoot,short,shrub,simple,slightly,sometimes,somewhat,sparse,sparsely,stellate,stem,stigma,style,surface,terminal,thin,triangular,trichome,truncate,tube,uniseriate,vine,violet,way,weak,wide,woody	0.5,0.5-1,1.8-2,2,2-3+,3-4,5-merou,7-10,<,abaxiall,adaxiall,adaxially,along,alyx,anthesi,apart,ape,ark,articulated,axil,berry,branched,branching,bud,cell,cluster,completely,confined,dendritic,eaf,eed,erect,expanded,exposed,exserted,filiform,flexuous,flower,free,fruiting,glabrou,green,groove,hromosome,ilament,inserted,known,long/tall,lower,mature,midrib,midvein,minute,minutely,mmm,near,new,nflorescence,nodding,obscured,older,orolla,outlin,pair,penden,pentagonal,perfect,pericarp,pitted,plurifoliat,point,portion,possibly,primary,ruit,scar,scarious,see,sleeve,spaced,strongly,suture,testal,time,transparent,tuft,twinin,type,ud,unit,upper,vary,vein,within,yellowish,ympodial	adhesion,arrangement,blade,climate,colour,form,fruit,glandular,hair,height,history,inflorescence,leaf,length,life,midpoint,na,ovary,plant,position,presence,pubescence,ray,reproduction,rugulose,seed,shape,size,staman,stipe,texture
35	wfo-0001025784	success	241	105	65	176	40	0.27	.5,0.2,0.2-0.3,0.5,1-5,1.2,6,acute,anther,apex,base,black,blade,calyx,cm,cylindrical,diameter,extra-axillary,free,fruit,glabrous,globose,green,greenish,hair,hyaline,irregularly,lanceolate,leaf,lobe,lobed,margin,midpoint,mm,narrowly,nearly,ovate,pedicel,peduncle,petiole,pubescence,purple,ray,rounded,shallowly,shrub,simple,smooth,somewhat,stellate,stem,stigma,style,subcordate,subreniform,surface,thin-textured,triangular,truncate,tube,white,x,yellow,yellow-brown,yellow-green	-3,.2–0.4,0.2–1.1,0.3–0.5,0.4–2.5,0.5–1.8,0.5–2,0.5–3,0.6–0.8,0.7,0.8–1.1,0.8–1.2,0.9–1.2,0.9–1.4,1,1.2–2.5,1.3–1.8,1.6–2.2,1/3,10,10–15,15075,1709,1–,1–3,1–5,2,2-foliate,2.5–3.3,2/3,2–2.5,2–3,2–4,2–5-celled,2–7,3.5,3–4,3–4-rayed,4.5–5.5,5,5–6,6.5–8,6.5–8.5,=,abaxially,accrescent,acicular,adaxiall,adaxially,also,always,anthesi,apart,articulated,asplund,ba,becoming,branched,brazil,cell,ciliate,completely,conical,curved,directed,distall,drying,eaf,eed,enclosing,enlarged,especially,et,exceeding,fertile,fide,filament,flattened,flower,frui,fruiting,geminat,glabrescent,glabrou,gland,gland-tipped,glandular-pubescent,greenish-yellow,insolated,irwin,long,longitudinal,lower,lowest,major,male,many,midrib,minute,minutely,moderately,mostly,mottled,much,n,nflorescence,numerous,obtuse,offset,one,orolla,pair,per,pilose,pore,prickle,pubescent,rachi,raised,rarely,recurved,reflexed,reported,ripe,rudimentary,ruit,second,sessile,sharp,short,side,similar,slightly,small,sometimes,spaced,sparsely,spiny,sprawling,spreading-pilose,stamen,ste,stellae,stipitate,stout,straight,subcapitat,tal,tamen,tem,thick,thicker,time,tip,toward,unarmed,unbranched,unequal,unit,upper,usually,variously,vary,vein,way,wid,wide,widest,without,ympodial,young,–2,–4,–5.5,–8,–9	0.5-3,0.8-1.1,0.9-1.2,10-15,2-2.5,2-3,2-7,2.5-3.3,4.5-5.5,adhesion,arrangement,climate,colour,corolla,form,glandular,growth,height,history,inflorescence,length,life,na,number,ovary,perennial,plant,position,presence,present,reproduction,rugulose,seed,shape,size,staman,stipe,subcapitate,texture,unknown
36	wfo-0001025788	success	158	77	58	100	19	0.367	-8,0.5-2,1-5,1.8-3.9,10-24,14-48,15-30,2-13,2-3,2-5,2.8-9.5,4-5.5,4.5-12.5,6-7,6.2-12.5,abaxially,adaxially,blue,calyx,cm,conical,connate,corolla,deep,diameter,distal,elliptical,finely,forked,green,green-white,half,herbaceous,interjected,lateral,leaf,leaflet,long,medium,mm,narrowly,odd-pinnate,ovate,ovoid,pair,pedicel,peduncle,perennial,petiole,plant,pubescent,purple,rotate,seed,size,terminal,wide,yellow	0-6,1-4,1.8-2.7,2-10,2m,3-,3-6-foliat,4-3.,4.5-10.1,5-8,8-38,abaxiall,acumen,acuminate,acute,apex,apical,apically,articulate,attenuate,base,branched,cell,covering,cuneate,cyme,dehiscent,dichasial,dichasially,digestion,diminishing,dorsally,eaf,ebracteate,edge,eed,emoval,enzyme,exceeding,filament,flat,flower,folded,generally,globo,gradually,hair-like,honeycomb,introrse,living,lobe,lon,long-attenuate,lower,lunat,make,maturing,monochasial,mucilaginous,nflorescence,nther,oblique,obtuse,often,orolla,pattern,perfect,petiolule,plan,poricidally,proximal,reveal,rounded,ruit,sessile,seudostipule,short,slit,specimen,stamen,stigma,straight,style,subequal,subsessile,tal,tem,testal,thick,throughou,throughout,tip,toward,tuber-bearing,typically,unit,vary,wall,ympodial,¼	4-31,anther,arrangement,colour,form,fruit,growth,height,history,inflorescence,length,life,na,ovary,position,reproduction,shape,stem,texture
37	wfo-0001025792	success	203	101	75	128	26	0.369	0.4-0.7,1-2,10-15,2-11,2-3,2.5-3.5,21-28,3.5-6,4-6,5,5-10,7-10,7.5-8,8-10,abaxially,adaxially,anther,auriculate,axillary,blue-mauve,blue-purple,brownish,bud,chartaceous,cm,condition,corolla,densely,diameter,drying,elliptic,flower,fresh,fruit,glabrous,globose,green,greenish,half,herb,lanceolate,lobe,long,mauve,membranous,minute,minutely,mm,narrowly,odd-pinnate,ovoid,papillose,pedicel,peduncle,plant,proximal,puberulent,pubescent,purple,ripe,rotate-pentagonal,seed,size,stem,stigma,streak,style,subtending,terminal,tinged,tube,white,whitish,x,yellow	1-10,1-3,1-4,2-3.5,2.5-4,3-4,3-5,4-12,4.5-7,5-6,5-9,5-merou,9-12,acumen,acuminate,acute,ag,along,alyx,apart,apex,apparently,articulated,articulation,axe,base,basiscopic,berry,blade,broadly,capitat,cell,ciliate,connivent,covering,dark,decurrent,developing,digestion,distal,distinct,distinctly,dorsally,eaf,edge,eed,enzyme,especially,exceeding,except,filament,flat,folded,forked,geminat,generally,glabrou,greatly,green-white,hair,hair-like,hal,high,homostylous,honeycomb-shaped,indistinct,interjected,lateral,leaflet,lengthening,like,living,lower,make,margin,midrib,mottle,mucilaginous,narrow,nflorescence,oblique,often,onto,orolla,pair,perfect,petiole,petiolulate,plurifoliate,pore,poricidal,rachi,reduced,removed,rounded,ruit,semi-erec,semi-rosette,sessile,seudostipule,short,shortly,side,slightly,slit,spaced,specimen,stamen,ste,straight,sub-rosette,subequal,tall,tamen,tem,testal,thick,throughout,tip,tri-,unit,usually,vary,wall,wet,wing,ympodial,young	adhesion,arrangement,calyx,capitate,colour,form,growth,height,history,inflorescence,leaf,length,life,mottled,na,ovary,perennial,position,pseudostipule,pubescence,reproduction,rugulose,shape,staman,surface,texture
38	wfo-0001025804	success	155	109	74	81	35	0.477	.5,1-1.5,1-3,1.2-1.5,1.4-1.7,1.5-2,16-35,2-2.5,3-4.5,3.5-12,4-10,6-8,abaxially,acute,adaxially,anther,apex,apiculate,attenuate,base,bilobed,calyx,cm,conical,corolla,cream,dia,difoliate,elliptic,flattened,glabrous,glandular,globose,green,incrassate,internodal,leaf,light,lobe,lobed,long,margin,mere,minute,minutely,mm,nearly,obovate,occasionally,opposite,ovary,paler,papillae,pedicel,pitted,plurifoliate,poricidal,projection,red,reddish-brown,reniform,rim,shrub,size,somewhat,stem,stigma,style,surface,tip,tube,white,whitish-green,x	.25,0.5-1,10-20,11-20,2.5-4,5,7-10,?,age,anthesi,apar,ape,ba,bark,berry,branched,c.,clavate,covered,cucullate,dark,decurrent,deflexed,densely,differing,drying,eaf,edicel,eed,ellipsoid,erect,exserted,filament,fleshy,flower,free,fruiting,geminat,later,lateral,lengthening,lower,main,major,many,middle,minor,near,nflorescence,often,older,onto,pair,papillat,papillate,papillose,planar,pore,portion,red-papillose,reddish-brow,regularly,ruit,scar,sessile,slit,spaced,strongly,tall,thick,time,tub,ud,unit,vein,widest,wing,winged,woody,ympodial,young	adhesion,arrangement,blade,climate,colour,diameter,form,fruit,geminate,growth,hair,height,history,inflorescence,length,life,midpoint,na,number,peduncle,perennial,petiole,plant,position,presence,pubescence,ray,reproduction,rugulose,seed,shape,staman,stellate,stipe,texture
39	wfo-0001025813	invalid_json	197	123	84	113	39	0.426	'',1-1.5,1-2,1-4,1.5-1.8,1.5-6.5,15-30,3-3.5,3-4,3-5,3-6,3-7,5-18.5,6-7,``,abaxially,acuminate,acute,adaxially,along,anther,apex,articulated,base,blade,blue,broadly,brownish,chartaceous,cm,condition,corolla,cuneate,dark,densely,diameter,distal,drying,elliptic,especially,flower,fresh,fruit,glabrous,globose,green,greenish,hair,herb,lanceolate,light,lobe,long,margin,membranous,midrib,minutely,mm,monochasium,obtuse,odd-pinnate,ovoid,pedicel,peduncle,petiole,pilose,plant,puberulent,pubescent,rarely,rotate,seed,size,stem,stigma,style,suborbicular,tube,typically,violet,white,whitish,x,yellow	0-2,0.7-1.7,1-10,1.2-4.5,1.3-7,1.5-2,2-3,2-4,2-5,5-6,5-merou,absent,acumen,ag,alyx,apart,apparently,axe,berry,borne,cell,ciliate,connivent,contracted,covering,decreasing,decurrent,digestion,discussion,distinct,dorsally,eaf,edge,eed,end,enzyme,exceeding,extra,filament,flat,folded,geminat,glabrou,green-white,hair-like,half,highly,homostylous,honeycomb-shaped,interjected,larger,lateral,leaflet,lengthening,like,living,longer,lower,make,minute,mucilaginous,near,nflorescence,often,orbicular,orolla,ovate,ovoi,pair,perfect,petiolulate,plurifoliate,pore,poricidal,rachi,removed,rosette-formin,ruit,see,sessile,seudostipule,short,single-flowered,singly,slit,sometimes,spaced,species,specimen,stamen,ste,stolo,straight,strongly,tamen,tem,terminal,testal,thick,thir,throughout,tip,toward,tri-,tuber,unforked,unit,unwinged,vary,vein,wall,wet,ympodial	'extra,[,],adhesion,arrangement,calyx,characteristic,climate,colour,form,glandular,growth,height,history,inflorescence,leaf,length,life,midpoint,na,number,ovary,perennial,position,presence,pubescence,ray,reproduction,rugulose,shape,staman,stellate,stipe,surface,texture,third,value,{,}
40	wfo-0001025817	success	238	130	84	154	46	0.353	1-1.6,1.7-2.1,10,abaxially,adaxially,anther,apiculate,armed,asymmetric,base,bifurcate,black,broadly,brown,calyx,campanulate,chartaceous,cm,conical,dark,deeper,deltoid,densely,diameter,dull,eventually,extra-axillary,flower,free,fruit,glabrate,glabrous,globose,green,lanceolate,large,larger,leaf,lenticular,like,lobe,mm,moderate,near,occasionally,ovate,pale,pedicel,peduncle,pedunculate,persistently,petiole,present,prickle,pubescence,pubescent,purple,rarely,ripe,rounded,short,shrub,simple,sized,slender,small,soon,stellate,stem,stigma,style,surface,tapering,time,tree,tube,turning,unequally,usually,violet,white,woolly,yellow,×	0.5–0.7,0.6–0.8,0.8–1.5,0–1.6,1.5–2.5,1.8–2.3,1.8–3,10–16,10–35,12–16,1–3,1–5,2–2.9,2–3,2–5,2–6.5,2–8,3.2–8,3.5–6,3–,3–13,3–6,3–8,4–5.5,4–6,4–7,5-merou,5–20,5–6,6–13,7–9,8–14,8–21,absent,accrescen,acuminate,acute,age,along,although,alyx,amount,apart,apex,apparently,articulated,asymmetrically,axe,ba,berry,bicolorous,blade,branch,branched,broad-based,capitat,central,compresse,deciduous,dense,developing,difoliate,directed,distall,distally,eaf,eed,entire,exceeding,except,expanded,expansion,fertile,fewer,filament,filiform,flowering,forming,fruiting,geminat,glabrou,high,impressed,interpetalar,juvenile,lacking,lateral,laterally,linear-lanceolate,long,low,lower,major,margin,midpoint,midvein,minute,minutely,much,nerve,nflorescence,numerous,oblong,obtuse,often,one,orolla,overlapping,persistent,pinnatifi,pitted,pore,portion,prickly,principal,racemose,rachi,rayed,reaching,recognizable,row,ruit,sessile,single,sinuate–repand,sinus,slightly,sometimes,spaced,sparse,spreading,stalked,stellae,stout,strongly,tamen,tissue,tomentose,trunk,ultimate,unarmed,underside,unit,variously,vary,vein,velvety,weakly,well,white-stellate,wide,without,ympodial,young	0-1.6,0.5-0.7,0.8-1.5,1-3,1.5-2.5,1.8-2.3,1.8-3,10-35,2-3,2-8,3-,3-13,3-8,4-5.5,4-7,5-20,7-9,8-14,8-21,adhesion,arrangement,capitate,colour,corolla,form,growth,height,history,inflorescence,length,life,na,number,ovary,perennial,plant,position,presence,ray,reproduction,rugulose,seed,shape,size,staman,texture
41	wfo-0001025825	success	187	121	87	100	34	0.465	0.4-1,0.5-10.4,1-3,1-5.5,1.1-1.4,10-24,10.5-26,2-3.7,2-5,3-10,3-5,4-8,6-10,6.6-14,abaxially,acuminate,acute,adaxially,anther,apex,asymmetric,attenuate,axillary,back,base,basiscopic,berry,blade,brownish,bud,clavate,cm,condition,coriaceous,corolla,decurrent,diameter,distal,drying,elliptic,fresh,fruit,generally,glabrescent,glabrous,green,greenish,hair,half,herb,lanceolate,leaf,lilac,lobe,long,medium,mm,odd-pinnate,ovate,ovoid,pedicel,peduncle,pentagonal,petiole,petiolulate,plant,rachi,rotate-pentagonal,rounded,seed,sessile,shiny,short,side,size,slightly,stigma,streak,style,subtending,terminal,tissue,tube,white,whitish,x,yellow	0-0.21,0.4-3,0.5-0.8,0.7-2.2,0.9-2,0.9-4,1-2,14-85,22-86,3-8.5,3.7-6.5,4-9,5-10,5-7,5-merou,acumen,adaxiall,ag,alyx,apart,apparently,articulated,axe,capitat,cell,connivent,covering,cuneate,dark,decreasing,digestion,dorsally,eaf,edge,eed,enzyme,erec,exceeding,filament,flat,flower,folded,forked,geminat,glabrou,green-white,hair-like,hal,high,homostylous,honeycomb-shaped,increasing,interjected,lateral,leaflet,lengthening,light,living,lower,make,middle,mucilaginous,nflorescence,orbicular,orolla,pair,perfect,plurifoliate,pore,poricidal,removed,ruit,seudostipule,slit,smaller,spaced,specimen,stamen,straight,subequal,subglabrou,tall,tamen,tem,testal,thick,throughout,tip,toward,tri-,unit,unwinged,usually,vary,wall,wet,wide,wing,winged,ympodial	adhesion,arrangement,calyx,capitate,climate,colour,form,glandular,growth,height,hermaphroditic,history,inflorescence,length,life,margin,midpoint,na,number,ovary,perennial,position,presence,pubescence,ray,reproduction,rugulose,shape,staman,stellate,stem,stipe,surface,texture
42	wfo-0001025835	success	297	103	77	220	26	0.259	.3,0.6-1.3,0.65-0.8,0.7-1.8,0.7-3,1-3,1-9,1.2-2,1.5-1.8,1.5-3.5,2-6,2.2-2.5,2.5-3,3-6,3.5-4,9-11,anther,becoming,berry,bright,broad-deltate,brown,calyx,chartaceous,clavate,cm,corolla,cupular,deltate,diameter,drying,dull,erect,evenly,flattened-reniform,fruit,glabrous,globose,green,lateral,leaf,length,lobe,lobed,maturity,mauve,mm,moderately,obconical,occasional,ovate,ovoid,pale,pedicel,peduncle,red,shiny,shrub,simple,smooth,sparsely,stellate,stellate-pubescent,stem,stigma,straw-yellow,style,surface,tapering,thin,trichome,tube,white,yellow,yellow-orange,young,×	.1,/4,0.05-0.1,0.1,0.1-0.2,0.2-2,0.5,0.5-0.7,0.5-1,0.5-2.8,1,1-1.5,1-2,1-2.5,1-4,1-5,1-7,1-8,1.2-1.8,1.5-2,1.5-3,1/2,1/3,1/3-3/4,1/4-1/2,1/4-1/3,1/4-2/3,2.5-3.5,20,3-5,3-7,30-45°,4,4-5,4-8,5,5-20,5-merou,6,6-8,7-9.5,8,abaxially,accrescent,acuminate,acute,adaxial,adaxially,ag,almost,always,alyx,apar,apart,apex,apically,apiculate,apparently,armed,articulated,axe,bark,base,beyond,black,blade,branche,branched,broad-based,cell,concolorous,covering,curved,dark,deep,developed,development,difoliate,distance,divided,dorsal,eaf,eed,elongating,equal,exserted,extending,faint,filament,finely,finger-hair,flat,flattened,flower,foliaceous,free,fruiting,geminat,gently,glabrescent,gre,green-brown,greenish,infructescence,irregula,irregular,lamina,lengthening,less,lobing,long,long-deltate,longer,longitudinal,lower,margin,mature,midpoint,midvein,minute,mostly,network,nflorescence,oblong,obtuse,often,older,one,open,opening,orange,orange-brown,orange-translucent,orolla,oung,outline,ovoi,pair,papillae,papillo,part,pendulous,per,perfect,pericarp,petiole,pit,point,pore,poricidal,porrect,portion,prickle,primary,pronounced,rachi,raised,rarely,ray,reduced,reflexed,regular,rest,ribbed,ridged,rounded,ruit,scar,secondarily,secondary,sessile,shallow,short,shorter,shortly,side,significantly,sinus,slender,slightly,slit,small,sometimes,somewhat,spaced,spherical,spreading,stalk,stalked,straight,stump,tamen,terete,terminal,tertiary,throughout,time,tip,toward,translucent,trifoliate,ud,unarmed,unequal,unit,upper,usually,variously,vary,vein,venation,visible,weakly,wide,widest,wing,woody,x,yellowish,ympodial	3,adhesion,arrangement,colour,form,growth,height,history,inflorescence,life,na,ovary,papillose,perennial,plant,position,pubescence,reproduction,rugulose,seed,shape,size,staman,texture,unknown,ye
43	wfo-0001025838	success	217	127	99	118	28	0.456	.5,0.5,0.7-2,1-1.2,1-1.5,1.2-5,1.5-2,1.5-2.5,1.5-3.5,1.5-5,1.8-2,2-2.5,2.5-3,2/3,3.5-,4-15,4.5-5.5,6-15,6.5-7,abruptly,acuminate,anther,apex,apiculate,attenuate,base,berry,black,brown,calyx,capitate,clavate,cm,connivent,corolla,cup-shaped,densely,diameter,ellipsoidal,elliptic,entire,flattened,fleshy,fruit,glabrous,globose,greenish,growth,inflorescence,lanceolate,lateral,leaf,like,lobe,lobed,loosely,margin,membranous,minutely,mm,narrowing,narrowly,often,pale,pedicel,peduncle,petiole,pitted,pubescent,purple,quadrate,reddish,reniform,revolute,ripe,seed,shiny,shrub,simple,slightly,sometimes,sparsely,stellate,stem,stigma,style,surface,terminal,thin,tinged,tip,tree,tube,way,white,winged,x,yellow,¾	-20,0.5-1,1.5-1.7,10-15,10-60,2-5,20-40,5,5-merou,adaxial,adaxially,ag,along,alyx,anthesi,apart,appearing,archin,ark,articulated,axil,basall,branch,branched,broad,cell,clustered,cucullate,dark,decurrent,dendritic,dense,denser,disintegrating,drying,eaf,eed,erect,exserted,extending,filament,flower,free,fruiting,glabrescent,hairy,ilament,inserted,insertion,irregularly,keeled,lamina,lengthening,less,long,lower,m.,many,midrib,minute,mostly,never,new,nflorescence,nodding,occasionally,older,onto,orolla,ovoid,pair,papillat,papillo,per,perfect,pericarp,platform,plurifoliat,point,pointed,pore,poricidal,portion,primary,ruit,scar,shin,short,sinus,sleeve,slender,slit,small,spaced,spreading,square,strongly,tall,tem,testal,thi,time,trichome,tuft,turbinate,twinin,ud,uniseriate,unit,upper,vary,vein,wall,weight,wing,woody,yellowish,ympodial	adhesion,arrangement,blade,climate,colour,form,glandular,hair,height,history,length,life,midpoint,na,number,ovary,plant,position,presence,pubescence,ray,reproduction,rugulose,shape,size,staman,stipe,texture
44	wfo-0001025845	success	180	117	92	88	25	0.511	0.3-0.5,0.4-1.5,0.5-11,1-2,1-4.5,1.5,1.5-13,1.5-2,1.5-2.5,1.5-7,2,2-15,2-3,2-5-lobed,2.5-4,4-5,4-6,5-6,abaxially,abundantly,acute,adaxially,anther,apex,apiculate,articulated,base,branch,brown,calyx,chartaceous,cm,compressed,corolla,dark,deltate,diameter,distally,eglandular,ellipsoidal,extra-axillary,flattened,fork,fruit,glabrous,green,greenish,herb,laterally,leaf,light,lobe,located,longitudinal,membranaceous,minutely,mm,narrowly,near,obtuse,often,orange,ovate,ovoid,patch,pedicel,peduncle,petiole,pinnately,puberulent,pubescent,purple,rotate-stellate,rugose-verrucate,sagittate,sand-punctate,shrub,simple,sparsely,stigma,stripe,strongly,style,tapered,tip,triangular,truncate,tube,white,x,yellow,yellowish	.5,0.5-2.5,1,1-1.8,3,3-13,3-4,3-6,3-foliat,6-6.5,6-9,7-10,acuminate,adaxial,aggregate,along,apart,around,ascending,axe,ba,blade,cell,channe,connivent,cuneate,cylindrical,decurrent,diamete,directed,distall,divided,eaf,eed,elliptic,entire,especially,filament,flower,free,glabrou,inserted,lateral,lobed,long,lower,major,margin,mesocarp,midrib,nearly,nflorescence,obovate,orolla,part,perfect,pore,rachi,radiu,rarely,rounded,ruit,shorter,side,sinus,small,spaced,stone,subcordate,tal,tamen,tem,terminal,thecae,thick,tightly,time,tomento,truncat,unbranched,unit,unlobed,vary,vein,veiny,wide,ympodial,youn	adhesion,arrangement,colour,form,growth,height,history,inflorescence,length,life,na,ovary,perennial,plant,position,presence,pubescence,reproduction,seed,shape,size,staman,stellate,stem,texture
45	wfo-0001025850	success	197	124	92	105	32	0.467	-5,.5,.8,0.5-,0.5-1,0.5-3,0.6-1,1,1-1.5,1-3,1.5,1.5-5,2,2-6.5,6-7,acute,anther,apex,base,berry,brown,calyx,capitate,cm,connivent,corolla,cyathiform,deltate,densely,diameter,ellipsoid,elliptic,elongate,entire,flattened,fleshy,glabrous,glandular,globose,green,growth,inflorescence,later,lateral,lax,lobe,lobed,loosely,margin,membranous,mm,narrowly,nearly,occasionally,often,orange,pale,papillate-puberulent,pedicel,peduncle,petiole,pinnatifid,pubescent,reddish,reniform,rhomboid,ripe,rounded,scattered,shallowly,shiny,shrub,simple,slightly,stellate,stem,stigma,style,surface,tan,terminal,thin,tip,trichome,truncate,tube,uniseriate,vine,white,woody,x,yellow	-7,0.5,1-celled,15-20,2-12,3-4,30,4-5,5-7,5-merou,abaxial,ag,along,alyx,anthesi,apar,apparently,ark,articulated,axi,basal,branched,broadly,cell,cupped,deciduous,deflexed,denser,divaricate,divided,drying,eaf,eed,em,erect,exserted,extending,filament,flower,free,fruiting,geminat,glabrou,gland,half,halfway,ilament,irregularly,lamina,leaving,lengthening,less,long,lower,many,midrib,minute,minutely,new,nflorescence,nodding,node,older,openly,orolla,outline,pair,papillo,peg,per,perfect,pitted,planar,plurifoliate,pore,poricidal,portion,primary,puberulen,ruit,scar,sinuate,sinus,sleeve,slender,slit,small,sometimes,soon,spaced,splitting,spreadin,spreading,strongly,surfac,testal,time,tiny,twinin,ud,unit,vary,vein,ympodial,young	adhesion,arrangement,blade,climate,colour,form,fruit,hair,height,history,leaf,length,life,midpoint,na,number,ovary,perennial,plant,position,presence,present,pubescence,ray,reproduction,rugulose,seed,shape,size,staman,stipe,texture
46	wfo-0001025856	success	185	103	56	129	47	0.303	0.5,2,3,acuminate,anther,apex,apiculate,base,blade,brown,calyx,campanulate,chartaceous,cm,compound,connivent,corolla,cuneate,diameter,elliptic,entire,flattened-reniform,glabrescent,glabrous,globose,green,lateral,light,lobe,lobed,margin,mm,oblique,oblong,orange,pedicel,peduncle,perennial,petiole,pinnately,rounded,rugose,spreading,stellate,stigma,streak,strongly,style,surface,terminal,tip,tube,uniformly,white,yellow,×	.4,/4,0,0.3-1,0.3–0.5,1-3,1.5–2,10–,10–15,15–20,1–,1–1.5,1–2,1–5,2.5–4,20,20–30,20–35,2–,2–4,3-10,3–4,3–5,4–,4–10,4–6,5–,5–10,5–15,5–7,6–12,abaxially,acute,adaxially,ag,always,alyx,anthesi,armed,articulated,axe,becoming,berry,branched,bud,c.,calcium,commonly,corresponding,crystal,densely,difoliate,dr.,eaf,eed,ellipsoid,equal,exserted,fifth,filament,flower,four,foveolate,fruiting,geminat,glabrou,herbaceous,internode,larger,leaflet,lengthening,long,long-styled,longer,lower,major,narrowly,nearly,nflorescence,often,one,opposite,orolla,outline,oxalate,pair,papillat,pericarp,petiolulate,petiolule,plurifoliate,pointed,pore,poricidal,present,prickle,rachi,rarely,recurve,recurved,ruit,side,slender,slightly,slit,somewhat,soon,stout,straight,subopposite,subwood,subwoody,tamen,tem,throughout,time,triangular,truncat,tub,unequal,unit,usually,vary,vein,vin,way,wide,widest,ympodial	1-5,10,10-15,10-30,15-20,2-15,2-4,2.5-4,5-7,6-12,adhesion,arrangement,climate,colour,dry,form,fruit,glandular,growth,hair,height,history,inflorescence,leaf,length,life,midpoint,na,number,ovary,plant,position,presence,pubescence,ray,reproduction,rugulose,seed,shape,size,staman,stem,stipe,texture,true,truncate,vine
47	wfo-0001025872	success	160	111	77	83	34	0.481	.5,0.6-1,1-1.3,1-1.5,1-2,1.2-1.6,1.7-3,2-2.5,2-5,2/3,3.5-4,4-4.5,4.5-13,6-8,acute,anther,apex,auriculate,base,becoming,blade,bright,broadly,brownish,calyx,capitate,cm,coriaceous,corolla,crinkled,cup-shaped,dark,deeply,densely,dia,dry,elliptic,flattened-reniform,glabrous,globose,green,greenish-tan,later,lateral,leaf,live,lobe,lobed,margin,material,mm,narrowly,occasionally,often,opposite,ovary,pedicel,petiole,pitted,plant,poricidal,pubescent,red-papillose,revolute,rounded,rounded-triangular,shrub,stem,stigma,style,surface,terminal,tip,tube,way,white,x	.1,0.25-0.5,0.5,0.5-1,1,1.2-1.5,10-25-flowered,6-10,along,anthesi,apart,apically,ba,bark,beginning,beneath,berry,branched,crowded,decurrent,deflexed,dense,eaf,edicel,eed,exserted,filament,flattened,fleshy,flower,free,fruiting,glandular-resinous,grayish-brow,incrassate,inflorescenc,irregularly,junction,lon,long,lower,main,midrib,minutely,nflorescence,older,onto,pair,paler,papillae,papillo,papillose,planar,plurifoliat,pore,portion,prominent,ruit,scar,several,shaped,simple,somewhat,soon,spaced,specimen,straight,tall,tapering,tear-drop,thick,thickened,time,trichome,tub,ud,uniseriate,unit,vein,visible,woody,ympodial,young	adhesion,arrangement,climate,colour,diameter,form,fruit,glandular,growth,hair,height,history,inflorescence,length,life,midpoint,na,number,peduncle,perennial,plurifoliate,position,presence,pubescence,ray,reproduction,rugulose,seed,shape,size,staman,stellate,stipe,texture
48	wfo-0001025875	success	205	121	97	108	24	0.473	0-0.5,0.1-0.2,0.1-1.1,0.3-0.4,0.3-2,0.5-6,0.8-0.9,0.8-1.8,0.9-1.4,1.1-1.6,1.5-2.5,2.3-3,2.4-2.8,2.5-4.5,4.5-6.5,5-10,5-14,7-10,7-8,8-11,9-13,abaxially,absent,acute,adaxially,andromonoecious,anther,apex,attenuate,basal,base,blade,calyx,chartaceous,cm,cuneate,cylindrical,dark,deeply,deltate,densely,diameter,entire,erect,extra-axillary,flower,fruit,glabrous,gland-tipped,globose,green,grey,hair,hastate,inflorescence,lanceolate,lateral,leaf,length,lobe,lobed,long,margin,mid-point,mm,oblate,obtuse,pale,pedicel,peduncle,perennial,petiole,plant,present,purple,ray,rhizomatous,rotate,shallowly,short,shrub,simple,sparsely,stellate,stellate-pubescent,stigma,streak,style,thick,throughout,time,truncate,tube,weakly,white,x,yellow	%,.05,0-0.1,0-1.5,0-5,0.2-0.45,0.25-0.4,0.4-0.5,0.4-0.7,0.5-1,0.5-1.3,0.7-0.8,1-10,1-2,1-3,1-7,1.2-1.8,1.5-6,15-25,2-locular,3-5,3-6,4-10,5-11,5-15,5-9,5-merou,6-13,7-14,8-14,?,absen,accrescent,acicular,across,adaxiall,adult,alyx,anvil-shape,apart,articulated,axe,ba,branchlet,cross-section,decimetre,directed,distally,dm,eaf,eed,eglandular,exocarp,filament,finger,fruiting,functional,geminat,half,heterostylous,juicy,juvenile,lamina,less,linear,longer,lower,mature,mesocarp,midpoint,midvein,minute,moist,narrowly,nflorescence,oblique,orolla,pair,part,per,placenta,plurifoliate,pore,porrect,possibly,prickle,pseudo-racemose,ruit,sessile,spaced,stalk,stalked,stellae,straight,surface,tal,tamen,tem,transparent,unarme,unarmed,unbranched,unit,upper,vary,wide,yellowish,ympodial	adhesion,arrangement,colour,corolla,form,glandular,growth,height,history,life,na,number,ovary,position,presence,pubescence,reproduction,seed,shape,size,staman,stem,stipe,texture
49	wfo-0001025888	success	256	129	80	176	49	0.312	0.04,1.5,2.1,3.2,3.8,90°,abaxially,acute,adaxially,adnate,anther,apex,apiculate,attachment,base,blade,calyx,chartaceous,clinate,cm,corolla,cuneate,deltoid,diameter,dry,entire,extra-axillary,flattened-orbicular,flexed,flower,fruit,glabrous,glandular,globose,hair,lateral,leaf,less,lobe,margin,midpoint,mm,moderately,nearly,notched,oblong,orange-red,ovate,pedicel,peduncle,petiole,point,porrect,pubescence,pubescent,ray,red,restricted,rounded,sessile,shrub,simple,sinuate,small,stellae,stellate,stigma,stipe,style,surface,tip,tree,truncate,tube,white,yellow,yellow-ferruginous,yellow-tan,±90°,±glabrous	.05,.3,.4,.5,.6,0.1,0.2,0.3–0.5,0.4,0.4–0.6,0.4–0.7,0.5–0.7,0.6–1.2,0.7–0.8,0.7–1.5,0.8,0.8–1.0,0.9–1.1,0.9–1.2,0.9–1.3,1.0–1.8,1.2–2.3,1.4–1.8,1.5–1.9,1.5–2.0,1.5–2.1,1.5–4.0,1.7–2.1,1.8–2.3,1.8–3.5,1.9–2.2,1.9–3.4,1/2–2/3,1/3,2.2,2.5–2.6,2.6,2.7–3.0,3,3.0–11.1,3.1–4.2,3/4,4.2–5.5,4–8,4–9,5,5-merou,5.5–11.1,5–7,6–10,7.1–9.1,8.1–17.1,9.5,across,along,alveolate,alyx,anthesi,apart,apparently,appearing,appresse,arching,area,articulate,axe,ba,berry,branch,branching,broad,brochidodromous,bud,capitat,central,channeled,congested,dehiscen,densely,denser,dentate,development,difoliate,distal,distinct,eaf,eed,either,emerging,endocarp,exocarp,fertile,filament,filiform,free,geminat,glabrescent,gradually,homostylous,hooked,increasing,internode,interpetalar,intersepalar,juic,lamina,little,lon,long,longer,longitudinally,lower,major,many,mature,middle,midrib,midvein,minor,minute,nflorescence,oblique,opaque,orolla,per,poorly-developed,portion,potentially,pubescen,raised,reflexed,rigid,row,ruit,scattered,shinny,short-stipitate,shorter,side,sinus,smoot,sometimes,spaced,sparsely,splitting,spread,spreading,stellate-pubescent,straight,swelling,tamen,tardily,tem,thin,though,time,tissue,two,typically,ud,unarmed,unbranched,vary,vein,weakly,well,wide,ympodia,young,±aequilateral,±equal,±erect,±overlapping,±smooth,±straight,×	0.05,0.3,0.3-0.5,0.4-0.6,0.4-0.7,0.6-1.2,0.7-1.5,0.8-1.0,0.9-1.2,1.0-1.8,1.4,1.5-2.0,1.5-4.0,1.9-2.2,2.5-2.6,3.0-11.1,4-9,6-10,7.5,8.1-17.1,adhesion,arrangement,capitate,climate,colour,dense,form,growth,height,history,inflorescence,length,life,na,number,ovary,perennial,plant,position,presence,present,reproduction,rugulose,seed,shape,size,staman,stem,texture
50	wfo-0001025892	success	170	100	72	98	28	0.424	0-0.1,0.1-0.2,0.2-0.4,0.2-0.5,0.3-0.5,0.3-0.7,0.3-0.8,0.8-1.1,2-7,2.5-4,2.5-6,2.8-3,4.5-7.5,5-17,8-10,8-11.5,adaxially,anther,apex,base,blade,calyx,chartaceous,cm,connivent,cuneate,deltate,densely,diameter,entire,extra-axillary,fruit,glabrous,glandular,globose,grey,grey-green,hair,herbaceous,inflorescence,lanceolate,leaf-opposed,length,linear,lobe,long,margin,midpoint,mm,narrowly,oblate,obtuse,pale,pedicel,peduncle,petiole,present,purple,ray,resprouter,simple,stellate,stellate-pubescent,stem,sticky-glandular,stigma,style,tube,white,x,yellow,yellowish-green	%,.3,0-0.3,0-1,0-10,0.05-0.1,0.2-0.8,0.4-0.6,0.4-0.8,0.7-0.9,1-2,1.5-5,10-17,2-locular,4-merou,5-7,6-10,7-15,8-11,8-13,9-18,abaxially,absen,absent,adaxiall,alyx,apart,articulated,axe,ba,broad-based,cross-section,curved,cylindrical,d.,dense,directed,distall,distributed,dult,eaf,eed,eglandular,erect,exocarp,finger,flower,fruiting,geminat,gland-tipped,half,juicy,lamina,lateral,less,longer,lower,mature,mesocarp,mid-point,minute,moist,nflorescence,oblique,orolla,papillae,part,per,perfect,placenta,pore,porrect,prickle,pseudo-racemose,ruit,sessil,sessile,short,solitary,spaced,stage,stalk,stellae,straight,tal,tamen,thick,throughout,time,triangular,truncat,unarmed,unbranched,unit,uvenile,vary,wide,ympodial	1.3,adhesion,arrangement,climate,colour,corolla,form,growth,height,history,leaf,life,na,number,ovary,perennial,plant,position,presence,pubescence,reproduction,seed,shape,size,staman,stipe,texture,truncate
51	wfo-0001025893	success	157	85	61	96	24	0.389	.4,0.5-1.5,0.8-1,1-1.2,1-1.5,1-4,1.5-2,11-20,2-2.5,2-3,5-6,along,anther,base,beneath,bi-lobed,broadly,brownish-green,calyx,capitate,cm,corolla,cup-shaped,densely,dia,elliptic,fruit,glabrous,globose,golden-puberulent,green,internodal,leaf,lobed,minutely,mm,narrowly,nearly,obovate,opposite,ovary,ovoid-reniform,pale,papillose,pedicel,petiole,pitted,poricidal,red-papillose,shrub,sometimes,stem,stigma,style,surface,tip,tube,vein,white,x,young	.25,.5,1-2.5,1.5-1.7,3-5,6-10,accrescent,anthesi,apex,attenuate,bank,barely,bark,bearing,beginning,berry,blade,branched,closely,decurrent,deflexed,deltoid,difoliate,dry,eaf,early,eed,ellipsoid,erect,even,exserted,faintly,filament,flower,free,fruiting,geminate,glabrate,gravelly,greyish,growing,impressed,inflorescenc,lateral,lobe,lon,long,long-acuminate,longitudinally,lower,main,many,margin,material,middle,nflorescence,occasionally,older,overlapping,pair,papillo,planar,plurifoliat,pore,portion,puberulent,reflexed,river,rocky,ruit,sandy,scar,shaped,slender,slightly,spaced,specimen,straight,stream,striat,tall,tapering,tear-drop,thickened,time,trichome,ud,unicellular,unit,usually,visible,widest,winged,woody,yellowish,ympodial	arrangement,colour,diameter,form,growth,height,history,inflorescence,length,life,na,peduncle,perennial,plant,position,presence,pubescence,reproduction,rugulose,seed,shape,size,stellate,texture
52	wfo-0001025896	success	146	98	72	74	26	0.493	-3,0.5,0.5-2,1-1.5,1-3,1-6.5,1-8,1.5-2,2-14,2-2.5,2.5-14,2.5-5,4,4-23,4-5,4-6,5-15,6-10,abaxially,acuminate,angled,apex,base,brownish,calyx,chartaceous,cm,constricted,cuneate,deltate,densely,diameter,elliptic-ovate,entire,fruit,glabrous,globose,greenish,hair,inflated,lobe,margin,mm,moderately,nearly,orange,ovate,pale,pedicel,peduncle,petiole,present,puberulent,pubescent,purple,red,rotate-stellate,rugose,shrub,simple,smooth,sparsely,stem,stigma,style,subcordate,surface,triangular-subulate,tube,white,x,yellow	-30,.5-2.5,1-25,1.5-9,10-15,10-25,4-12,5-7,6-13,7-,7743,abaxial,absen,acosta,acute,adaxiall,adaxially,aggregate,also,apart,articulated,axe,ba,blade,branched,cell,connivent,cylindrical,dendritically,directed,distall,eaf,eed,eglandular,especially,flower,forked,gland,like,long,lower,many-foliat,membranaceous,near,nflorescence,nther,obtuse,occasionally,often,orolla,perfect,pore,pubescen,rachi,radiu,ripe,ruit,short-stalked,solí,spaced,stalked,stone,tal,tem,time,tip,triangular-ovate,truncat,unbranched,unit,vary,vein,wide,ympodial	anther,arrangement,colour,corolla,form,glandular,growth,height,history,inflorescence,leaf,length,life,na,ovary,plant,position,presence,pubescence,reproduction,rugulose,seed,shape,size,texture,truncate
53	wfo-0001025902	success	211	125	98	113	27	0.464	.2,0.1-0.5,0.5-2,0.5-2.5,1-1.2,1-1.5,1.5,1.5-2,1.5-3,1/3,11-15,1983,2-6,2.5-4,4-13,5-6,abaxially,acute,adaxially,anther,apex,attenuate,base,becoming,black,broadly,cabrera,calyx,chartaceous,clavate,cm,completely,conical,connivent,corolla,deltate,densely,diameter,dull,ellipsoid,entire,fide,flattened-reniform,fleshy,glabrous,globose,green,growth,inflorescence,lanceolate,lateral,leaf,leaf-opposed,length,linear,lobe,long,loosely,lower,margin,mature,minute,minutely,mm,occasionally,ovary,pale,pedicel,peduncle,perfect,petiole,pitted,pubescent,rotate-stellate,rounded,scattered,semi-circular,simple,sometimes,somewhat,sparsely,stem,stigma,style,surface,tapering,terminal,trichome,tube,uniseriate,vine,violet,whitish,woody,x,yellow,yellowish,½	.5,/2,1.2-1.5,3-10,4,4-5,4-6,40,5-merou,8-10,8-15,8-9,>,absent,accompanied,ag,aid,along,always,alyx,anthesi,apar,ark,articulated,axi,bark,beginning,berr,berry,branch,branched,branching,c.,cell,circular,climbin,deciduou,eaf,eed,either,except,exfoliatin,exserted,filament,flower,free,fruiting,geminat,ilament,leaving,lengthening,less,lobed,low,markedly,midvei,new,nflorescence,obscured,often,older,one,orolla,pair,papillat,papillose,peg,pendant,per,pericarp,planar,plurifoliate,pore,poricidal,portion,primary,prominent,revolute,ridged,ruit,scar,scrambling,semi-aquati,shallow,sleeve,slender,slit,small,soon,spaced,spreading,strongly,tangled,tem,testal,thin,time,tip,twining,ud,ultimate,unit,usually,vary,vegetation,vein,water,way,weak,weight,widely,wing,ympodial	adhesion,arrangement,blade,climate,colour,form,fruit,glandular,hair,height,midpoint,na,number,plant,position,presence,pubescence,ray,reproduction,rugulose,seed,shape,size,staman,stellate,stipe,texture
54	wfo-0001025906	success	188	115	90	98	25	0.479	0.1-2,0.20-0.60,1-2,1.1-2,1.6-12.4,16-51,2-4.4,2-6,3-10,3-5,4-5,4-7,5.2-9,8-16,8.5-12.5,abaxially,adaxially,anther,apart,articulated,axillary,blue,brownish,bud,cell,clavate,cm,condition,connivent,coriaceous,corolla,covering,diameter,distal,drying,fresh,fruit,glabrous,globose,green,green-white,greenish,hair,hair-like,half,herb,high,lanceolate,lateral,leaf,light,lilac,linear,lobe,long,make,mm,mucilaginous,odd-pinnate,ovoid,pedicel,peduncle,pentagonal,petiole,plant,pubescent,purple,ripe,rotate,seed,shiny,short,size,spaced,stigma,stripe,style,sub-glabrous,subtending,terminal,testal,thick,throughout,tube,wall,wet,white,whitish,x,yellow	0-14,0.15-0.6,0.2-0.6,1-3,1-6,1.8-4.8,2.6-5.2,4-10,4-12,5-6,5-7,5-merou,acumen,acute,adaxiall,ag,alyx,apex,apparently,axe,base,berry,blade,capitat,cuneate,dark,decreasing,decurrency,decurrent,delimited,digestion,diminishing,dorsally,eaf,edge,eed,enzyme,erec,exceeding,falcate,filament,first,flat,flower,folded,forked,geminat,generally,glabrou,hal,homostylous,honeycomb-shaped,interjected,leaflet,lengthening,living,lower,next,nflorescence,obtuse,orolla,pair,perfect,plurifoliate,pore,poricidal,rachi,removed,ruit,second,sessile,seudostipule,slightly,slit,smaller,sparsely,specimen,stamen,straight,subequal,subglabrou,subglabrous,tall,tamen,tem,third,tip,toward,tri-,typically,unit,unwinged,usually,vary,well,width,wood,ympodial	adhesion,arrangement,calyx,capitate,colour,form,growth,height,history,inflorescence,length,life,na,ovary,perennial,position,pubescence,reproduction,rugulose,shape,staman,stem,surface,texture,woody
55	wfo-0001025907	success	148	95	74	74	21	0.5	.5,.5-1,1,1-1.2,1-2.3,1-3,1-5,1.5-2,1.5-2.2,12-45,2,2-3.5,2/3,3-,4-5,5-15,acuminate,acute,along,anther,apex,attenuate,axillary,base,brown,c,calyx,cm,conical,densely,diameter,elliptic,flattened,fruit,glabrous,globose,green,greenish,growth,iquito,isolated,long,lower,margin,minutely,mm,near,new,obovate,ovary,ovoid-reniform,papillate,papillose,pedicel,petiole,plant,population,poricidal,pubescent,red-papillate,round,rugose,seed,shrub,simple,size,stigma,style,tip,trichome,truncate,tube,uniseriate,x	-4,.05,0,0-60,0.8-1.8,10-15,2-8,3-4,3/2,absent,anthesi,anthesis5-7,anticlinal,appearing,axil,beak,bearing,berry,breaking,cell,clavat,conspicuously,deciduous,eaf,edicel,eed,epidermal,erec,filament,flower,free,fruiting,highly,included,irregular,lamina,lobe,lobed,lon,nearly,nflorescence,occasionally,open,pair,per,portion,primary,projection,raised,reflexed,remaining,ruit,scar,scattered,single-stemmed,sinuous,slender,soon,sparsely,surface,tal,tem,thickening,time,tub,ud,unifoliat,unit,variable,vein,white,white-lenticellate,without,ympodial	5-7,arrangement,clavate,colour,form,height,history,inflorescence,leaf,length,life,na,peduncle,perennial,position,pubescence,reproduction,shape,stem,texture,unifoliate
56	wfo-0001026203	success	197	106	78	119	28	0.396	0.06-0.86,0.3-11,0.38-11.3,0.4-3,0.5-2.3,0.7-2.6,1-9,2-4.9,2-5,2.2-13.3,3-10,3-11,3.2-22,3.2-23,7-47,abaxially,adaxially,anther,articulated,axillary,berry,blue,brownish,bud,clavate,cm,condition,coriaceous,corolla,dark,deep,diameter,distal,drying,elliptic,fresh,fruit,glabrescent,glabrous,globose,green,greenish,hair,half,herb,high,lanceolate,leaf,lilac,lobe,long,medium,middle,mm,odd-pinnate,ovate,ovoid,pedicel,peduncle,pentagonal,petiole,plant,ripe,rotate,seed,short,size,sometimes,stigma,stripe,style,subtending,terminal,tube,whitish,wide,x,yellow	0-39,0-7,0.3-6,0.5-3.2,1-13,1-2,1-4,1-5,1.1-7.9,1.2-5.5,2-10,2-43,2-8.5,3-5,5-merou,acumen,acuminate,acute,ag,along,alyx,apart,apex,apparently,arranged,asymmetric,attenuate,axe,base,basiscopic,bead,blade,capitat,cell,connivent,covering,decreasing,decurrent,digestion,dorsally,eaf,edge,eed,enzyme,erect,exceeding,filament,flat,flower,folded,forked,geminat,generally,glabrescen,glabrou,green-white,hair-like,hal,homostylous,honeycomb-shaped,interjected,lateral,leaflet,lengthening,light,like,linear,living,lower,make,moniliform,mucilaginous,multiple,necklace,nflorescence,orbicular,orolla,pair,perfect,plurifoliate,pore,poricidal,rachi,removed,rosett,rounded,ruit,sessile,seudostipule,side,slightly,slit,spaced,specimen,stamen,stolon,straight,subequal,subglabrous,tall,tamen,tem,testal,thick,throughout,tip,tissue,toward,tri-,tuber,typically,unit,unwinged,usually,vary,wall,wet,white,ympodial	adhesion,arrangement,calyx,capitate,colour,form,growth,height,history,inflorescence,length,life,na,number,ovary,perennial,position,presence,pubescence,ray,reproduction,rugulose,shape,staman,stellate,stem,surface,texture
57	wfo-0001026205	success	165	101	73	92	28	0.442	.5-2,0.3-2,1,1-1.5,1-6,1.5,15-20,2-14,4,5-7.5,7-9,abaxially,acuminate,acute,anther,apex,attenuate,base,blade,calyx,chartaceous,cm,cream,cuneate,deeply,densely,diameter,elliptic,enlarged,entire,extra-axillary,flattened,fruit,glabrous,glandular,globose,growth,hair,leaf,linear-lanceolate,lobe,margin,midpoint,minutely,mm,pedicel,peduncle,petiole,pubescent,purple,ray,seed,short,shortly,shrub,simple,size,slightly,sparsely,stellate,stellate-pubescent,stem,stigma,strongly,style,summit,surface,toward,tube,violet,white,x,yellow	-14,-2.5,-6,.5,0.5-,0.75-1,1-2,1-3,2-3,3,3/4,30-35,5-merous,5.5-6,8,absent,accrescen,adaxially,alyx,apical,apparently,armed,around,articulated,axe,ba,difoliate,distinct,divided,eaf,eed,erect,exceeding,extror,filament,flower,four,fruiting,geminat,globo,homostylous,including,lateral,long,lower,major,maturing,minor,minute,new,nflorescence,node,oblique,often,orolla,perfec,pore,porrect,porrect-stellate,prickle,proximally,rachi,rare,rarely,ruit,scarcely,sessile,similar,slender,small,smaller,solitary,sparse,stellat,stellate-pubescen,straight,tall,tamen,tem,thickened,third,tip,trichome,unarme,unarmed,unit,usually,vary,wide,wing,ympodial,zigza	0.5-2.5,adhesion,arrangement,climate,colour,corolla,form,height,history,inflorescence,length,life,mature,na,number,ovary,plant,position,presence,present,pubescence,red,reproduction,rugulose,shape,staman,stipe,texture
58	wfo-0001026208	success	214	122	92	122	30	0.43	/3,0.1-0.3,0.5-1.2,0.6-0.8,0.6-0.9,0.7-2,0.8-1.5,1-2,1-5,1.8-2.3,1.8-2.5,11-25,2-20,2.5-6,3-5,3.5-5,5-17,6-8,abaxially,acuminate,acute,anther,apex,base,berry,blade,bright,brown,calyx,chartaceous,cm,connivent,cuneate,dark,deltate,densely,diameter,dull,erect,evenly,flattened-reniform,fruit,glabrous,green,lateral,leaf,length,lobe,lobed,long,lower,margin,maturity,mauve,membranous,midpoint,mm,moderately,orange,orange-brown,ovate,pale,pedicel,peduncle,petiole,poricidal,ray,red,rounded,shrub,smooth,sometimes,somewhat,sparsely,spherical,stellate,stellate-pubescent,stem,straw-yellow,style,subentire,tapering,terminal,tip,toward,trichome,tube,way,white,wide,yellow,young	-1/2,-10,-3,-5,.5,0,0-20,0-4,0-5,0-8,0.1,0.1-0.2,0.1-0.25,0.5-0.8,0.8-1.3,1-4,1.5,1.5-2.5,1/3,1/4-1/3,1/4-1/6,2,2-3,2-4,2.5-5,3-30,3-6,3/,4-7,4-9,5,5-,5-22,5-merous,6-22,abaxial,acut,adaxial,alyx,apar,apart,apically,apparently,articulated,bark,becoming,branched,broad-deltate,conical,curved,difoliate,discolorous,distance,drying,eaf,eed,elliptic,elongated,elongating,equal,extending,filament,flattened,flower,free,fruiting,geminat,geminate,glabrescent,gray-greenish,green-brown,infructescence,longer,mature,midvein,nflorescence,older,one,open,orolla,oung,pair,pendulous,per,perfec,pericarp,porrect,portion,prickle,prickly,primary,pubescent,recurved,red-brow,ruit,scar,sessile,shorter,side,slender,spaced,spreading,stalk,stalked,stout,straight,surface,tamen,terete,tertiary,time,unarme,unarmed,unit,usually,variously,vary,vein,venation,visible,woody,ympodial	3/4,adhesion,arrangement,climate,colour,corolla,form,glandular,growth,hair,height,history,inflorescence,life,na,number,ovary,plant,position,presence,present,pubescence,reproduction,seed,shape,size,staman,stigma,stipe,texture
59	wfo-0001026215	success	150	118	83	67	35	0.553	-3,.05,.5,0.5-1,1,1-3,1.5,1.5-2,1.5-2.2,13-35,2-3,2-3.5,3/4,4-15,4-5,7-8,abruptly,acuminate,along,anther,apex,axillary,base,broadly,brown,calyx,clavate,cm,completely,conical,conspicuously,corolla,deltate,densely,diameter,elliptic,entire,flattened-round,free,fruit,glabrous,green,greenish,herb,horizontal,kink,length,lobe,lobed,long,marked,markedly,mm,narrowing,nearly,occasionally,often,ovary,ovoid-reniform,papillae,papillate,pedicel,petiole,poricidal,purple,red-papillose,rounded,rugose,seed,shrub,stem,stigma,strongly,style,surface,tip,tube,way,white,white-lenticellate,white-pubescent,winged,x	0,0.05,15-2,18-20,2,2-4,abaxially,absent,anthesi,anticlinal,ape,axil,beak,berry,bifi,cell,continually,eaf,edicel,eed,enlarged,epidermal,erect,exserted,filament,flower,fruiting,globose,highly,internode,irregular,less,lower,minutely,nflorescence,noddin,nodding,onto,pair,papillat,per,portion,primary,projection,raised,reflexed,ruit,scar,shortsympodial,simple,single-stemmed,sinuous,small,ste,tal,tem,thickening,time,tub,ud,unifoliat,unit,usually,vein,wide,wing,without	adhesion,arrangement,bifid,blade,climate,colour,form,glandular,growth,hair,height,history,inflorescence,leaf,life,margin,midpoint,na,number,peduncle,plant,position,presence,pubescence,ray,reproduction,rugulose,shape,size,staman,stellate,stipe,tall,texture,unifoliate
60	wfo-0001026220	success	158	95	54	104	41	0.342	/3,0.2,0.3-1.5,1.3-1.7,1.5-2.5,10-20,2.5-3.5,4-10,4-12,8-12,annual,anther,armed,base,bearded,blade,brown,calyx,campanulate,cm,dark,dry,essentially,foliaceous,foveolate,glabrous,glandular,hair,herb,internodal,lanceolate,leaf,lobe,long,maturity,minutely,mm,often,ovate,pentagonal,petiole,plant,ray,reticulately,ridged,simple,spherical,splitting,stellate,stellate-pubescent,stem,surface,tube,yellow	.3-2.8,.5,1,1.0-1.8,5-10,50-90,6-10,7-11-flowere,accrescent,across,acute,along,alyx,anthesi,ape,back,band,becoming,berry,closely,coarsely,conspicuous,developing,dia,difoliate,divided,dryin,eaf,eed,flattened-ovo,geminat,glaucescent,heteromorphic,interpetalar,invested,lacking,large,later,latter,lon,main,many,mostly,much,near,nearly,nflorescence,obtuse,one,orolla,pentagonal-stellae,per,persistent,persisting,petal,pigment,pinnatifid,pinnatisect,plicate,portion,prickle,prickly,proximal,purple,red,reddish,reduced,ruit,scattered,second,short,shorter,side,similar,slende,somewhat,spaced,stellae,straight,suffused,surrounding,tall,tamen,terminally,thrice,tightly,tigma,tissue,tub,twice,tyle,ultimate,unexpande,unit,upon,vary,vein,ventral,well-developed,widely,year,yello,ympodial,young	2.3-2.8,adhesion,apex,arrangement,climate,colour,corolla,diameter,flattened-ovoid,form,fruit,growth,height,history,inflorescence,length,life,margin,midpoint,na,number,ovary,pedicel,peduncle,pentagonal-stellate,position,presence,present,pubescence,reproduction,rugulose,seed,shape,size,slender,staman,stigma,stipe,style,texture,unexpanded
61	wfo-0001026227	success	150	95	66	84	29	0.44	.3,.8,0-1.5,0.25-0.4,0.3-0.5,0.3-2.2,0.4-1.4,0.5-1,1.5-4,1.6-2,2-2.5,2.5-3,6-8,absent,adaxially,apex,base,blade,calyx,chartaceous,cm,cuneate,deltate,densely,diameter,elliptical,entire,flower,fruit,globose,green,grey,hair,herbaceous,inflorescence,lateral,leaf-opposed,length,lobe,lobed,long,margin,mm,moderately,obtuse,ovate,pale,pedicel,peduncle,petiole,present,ray,resprouter,shallowly,simple,sparsely,stellate,stellate-pubescent,stigma,style,thick,throughout,time,tube,x,yellow	%,0,0-0.1,0-1,0-3,0.1-0.7,0.3-0.4,0.3-0.6,0.3-0.9,0.9-1.2,1,1-1.3,1-4,10-15,15-20,17-55,2-10,2-3,3-6,3-7.5,5-30,5-merous,7-8,abaxially,absen,acicular,across,apart,armed,articulated,axe,ba,chartaceou,d.,distributed,eaf,eed,eglandular,finger,fruiting,gland-tipped,gree,half,index,lamina,lobing,lon,longer,lower,mature,mid-point,midpoint,midvein,nflorescence,oblique,orolla,part,per,porrect,prickle,pseudo-racemose,ruit,sessile,short,side,solitary,spaced,sprawling,stage,stalk,stellae,straight,tal,tamen,tem,transparent,unbranched,unit,unknow,uvenile,vary,wide,yellowish,ympodial	adhesion,anther,arrangement,colour,corolla,form,glandular,growth,height,history,leaf,life,na,number,ovary,perennial,plant,position,presence,pubescence,reproduction,seed,shape,size,staman,stem,stipe,texture,unknown
62	wfo-0001026229	success	299	126	81	218	45	0.271	1,1.8,5,acute,anther,apex,attenuate-caudate,base,berry,black,blade,brown,calyx,clavate,cm,connivent,corolla,cuneate,densely,diameter,elliptic,entire,flattened,flower,fruit,glabrous,glandular,globose,golden,green,growth,hair,hirsute,immature,inflorescence,internodal,lanceolate,lateral,leaf,lobe,lobed,long,margin,mature,membranaceous,midpoint,mm,moderately,narrow-ovate,narrowly,oblong,ovate-elliptic,pale,pedicel,peduncle,perfect,petiole,pubescent,purple,ray,reniform,revolute,rounded,shiny,shrub,simple,size,slightly,sparsely,stellate,stem,stigma,style,subopposite,surface,terminal,tube,white,wide,yellow,yellowish-white	0.1–1.47,0.2–0.8,0.35,0.3–0.9,0.3–1.2,0.4,0.8–1.2,0.8–2,0.9,0.9–4.3,1-celled,1.2–4.8,1.3–1.5,1.3–1.7,1.4,1.7–11.8,1.7–2.3,1.8–5.5,1.9–2.5,1/3,13,1–1.4,1–2,1–4,2,2.3–3.4,2.8–4,2–3,2–3-celled,2–4-celled,3,35,3–4,3–5,4.5–6.5,4–6,5-merou,5–9,6–15,6–7,6–8,8.6–12,8–10,9–31,abaxial,abaxially,accrescent,acuminate,adaxial,adaxiall,adaxially,ag,almost,also,always,alyx,anthesi,ark,articulated,associated,asymmetric,axe,ba,barely,beneath,branch,branching,broadly,broken,camptodromous,capitate,celled,central,changing,commentary,commonly,completely,concentrated,cordate,covered,creating,cylindrical,cyme,dark,deltoid,develope,developed,differing,directed,discolorous,di­,dried,drying,eaf,eed,eglandular,ellipsoidal,elongated,even,faces,few-rayed,found,free,frequently,fresh,fully,geminate,glabrescent,gland,glandular-capitate,head,hispid,hyaline,ilament,impressed,included,insertion,introrsely,involute,irregular,lamina,larger,less,like,long-stalked,longer,longitudinal,lower,mainly,material,maturit,midri,midvein,minute,mixed,much,multangulate,multangulate-stellate,multiseriate,near,nearly,new,nflorescence,often,old,older,one,open,opening,orientation,orolla,other,oung,ovate,pair,paired,papillose,pedunculate,per,pink,pit,plurifoliate,point,poorly,pore,poricidal,porrect-stellate,portion,primary,purplish,ra,rachi,raised,rarely,remnant,ruit,secondary,see,sessile,shin,short-,short-stalked,shorter,slit,small,smaller,solitary,sometimes,somewhat,spread,spreadin,spreading,stalk,strongly,subsessile,supported,surfac,three,tree,trichome,trifoliate,tuft,type,ud,unbranched,unequal,unit,upper,usually,vary,vein,venation,vestiture,visible,weakly,whitish-green,ympodial,¾	0.1-1.47,0.3-0.9,0.3-1.2,0.35-4.3,0.8-1.2,1-1.4,1-2,1.2-4.8,1.3-1.7,1.7-11.8,1.7-2.3,1.8-5.5,1.9-2.5,2.3-3.4,2.8-4,3-5,4-6,6-7,6-8,8.6-12,adhesion,arrangement,climate,colour,form,height,history,length,life,na,number,ovary,perennial,plant,position,presence,present,pubescence,reproduction,rugulose,seed,shape,staman,stipe,texture
63	wfo-0001026230	success	144	84	60	84	24	0.417	.5,.8,0.3-1.5,0.5-3,0.9-2,1-1.4,1-1.5,1.1-1.8,12.6-20.8,2-4,3-4,4.6-9.3,anther,area,bark,base,bud,calyx,cm,corolla,deltoid,dia,elliptic,fruit,glabrous,globose,green,grey,immature,large,leaf,lobe,lobed,long-acuminate,long-triangular,major,minutely,mm,nearly,older,opposite,ovary,papillose,pedicel,petiole,poricidal,rusty-papillose,shrub,small,stem,stigma,style,surface,tip,tree,tube,umbonate,white,x,young	.25,0.75-1,1-4,1.8-2.3,1.9-4.1,2-5,5-10,5-20-flowered,acuminate,acute,anisomorphic,anisophyllou,anthesi,apart,apex,apiculate,appears,back,beginning,beneath,berry,broadly,clavate,clu,completely,cordate,coroll,deflexed,difoliate,distal,eaf,edicel,eed,enclosing,erect,evenly,except,filament,free,fruiting,geminate,inflorescenc,lateral,lon,long,lower,main,margin,middle,minor,nflorescence,obtuse,orbicular,ovoid,pair,pointed,pore,portion,raised,reflexed,rounded,ruit,scar,shaped,simple,sinus,slender,slightly,spaced,straight,strongly,tall,tapering,tear-drop,thickened,ud,unit,unknown,vein,white-lenticellat,widest,winged,woody,ympodial	0.5,arrangement,colour,diameter,form,growth,height,history,inflorescence,length,life,na,peduncle,perennial,plant,position,pubescence,reproduction,rugulose,seed,shape,size,texture,white-lenticellate
64	wfo-0001026233	success	165	105	68	97	37	0.412	-1,-3.8,-5.5,-50,.25,.75,0.7-0.8,0.8-4,1.2-2.7,1.5,1/2,2.1,2.3-7,2.4-3.5,2.6,2/3,3.5-4.5,5-30,6,acute,annual,anther,antrorse,apex,basal,base,broadly,calyx,campanulate,capitate,cm,cuneate-attenuate,densely,diameter,ellipsoidal,elliptic,entire,glabrous,globose,hair,herb,leaf,less,lilac,lobe,margin,mm,moderately,ovate,pale,papery-scarious,petiole,pinnatisect,pubescent,seed,simple,sparsely,stigma,style,subglobose,surface,trans-ovoidal,trichome,tube,unifoliate,uniseriate,x,yellow	-1.9,-8.1,0.3,0.5,0.7-,0.8-1.3,0.8-1.55,1,1-,1.1,2,2-,3.2-3.7,3.2-4.7,4-,5-6.2,abundant,accrescent,ag,annular,articulated,ascending,bearing,berry,coat,conspicuous,curved,cylindrical,difoliat,dimorphic,eaf,eed,embryo,evident,few-,filament,fruiting,herbaceous,hig,interlobular,investing,lamina,larger,lobed,long,longitudinal,longitudinally,lower,membrane,minutely,multicellular,narrowly,near,non-glandular,obtuse,occasionally,opening,orolla,other,outer,ovule,partially,pinnatipartite,pore,poricidal,portion,present,protuberance,pubescen,ree,reticulate,ridged,rounded,ruit,scarcely,seede,serrate,shorter,slender,slightly,slit,small,smaller,striate,strongly,styl,tem,tip,tuberculate,unequal,unit,vary,venatio,verrucose,wider,winged,ympodial	0.7-1.3,adhesion,arrangement,blade,climate,colour,corolla,difoliate,form,fruit,glandular,growth,height,history,inflorescence,length,life,midpoint,na,number,ovary,pedicel,peduncle,plant,position,presence,pubescence,ray,reproduction,rugulose,shape,size,staman,stellate,stem,stipe,texture
65	wfo-0001026241	success	220	120	75	145	45	0.341	0.5,109,abaxially,anther,apex,base,berry,black,brittle,brown,calyx,capitate,cm,conical,cordate,corolla,cup,dia,dry,eglandular,elliptic,entire,erose,et,fruit,galiano,glabrous,glandular,glandular-pubescent,globose,herb,inflorescence,internodal,irregularly,leaf,lobe,lobed,margin,mm,open,orangish,outline,ovary,ovate,ovoid,pedicel,peduncle,perennial,petiole,pinnatifid,pubescent,rachi,reniform,seed,shiny,simple,somewhat,spatulate,stellate,stem,stigma,style,subshrub,surface,taproot,ternate,thickened,triangular,trichome,truncate,tube,uniseriate,white,woody,x	.2,.3,.5,0.1–0.15,0.2–,0.3–,0.3–0.4,0.3–0.6,0.3–1,0.5–0.7,0.5–0.8,0.5–1,0.7–1.1,1-,1-celled,1.2–1.5,1.2–2,1.5–1.7,1.5–2.5,1.5–3.5,1.9–2.1,1/3–1/2,10-20,1–,1–1.1,1–1.4,1–1.5,1–2,2-flowered,2.5–3,2–2.1,2–3,3,3-,30–50,3–3.1,4-,4.5–5,5,5-celled,5-merous,6,adaxially,always,anthesi,apical,appearing,appears,articulated,attenuate,ba,basal,basiscopically,beak,branching,broader,campanulate,cell,center,connecting,covered,curved,curving,darker,decurrent,deflexe,dehiscing,deltate,densely,denser,depressed-globose,difoliate,discrete,drying,dwarf,eaf,enclosed,equal,erect,extended,filament,flower,foliat,foliose,free,fruiting,geminate,gland,intially,larger,lateral,leaflet,like,lon,long,longitudinal,main,midvein,mixture,much,near,nflorescence,oblique,one,onto,papillat,papillate,per,perfect,pericarp,pitted,pore,portion,prolonged,pubescen,pulp,remain,robust,ruit,shallowly,sinuate,slightly,slit,small,smaller,sometimes,stamen,stout,strongly,succulent,sulcate,terminal,testa,thick,tip,tissue,tuberculate,ud,unit,usually,vein,way,wide,wing,ympodial	0.5-0.7,1,1-1.4,1-1.5,1-2,1-2.5,1-3.5,1.5-1.7,1.9-2.1,2-2.1,2-3,2.5-3,3-3.1,30-50,4.5-5,adhesion,arrangement,blade,climate,colour,decurrenct,dense,diameter,form,growth,hair,height,history,length,life,midpoint,na,number,plant,position,presence,pubescence,ray,reproduction,rugulose,shape,size,staman,stipe,texture
66	wfo-0001026242	success	210	104	81	129	23	0.386	0-2,0.05-0.2,0.3-0.5,0.4-0.5,0.4-2,0.55-0.9,0.7,0.7-1.3,1-2.5,1.5-3,1.5-4,1/6-1/4,2-2.5,2.5-2.8,2.5-4.5,3-6.5,4-13,7-17,abaxially,acute,almost,ame,anther,apex,base,blade,bright,c.,calyx,cm,connivent,curved,densely,diameter,dull,equal,erect,evenly,filiform,flattened-reniform,fruit,glabrescent,glabrous,green,lateral,leaf,length,lobed,long,margin,maturity,membranous,mm,moderately,orange-brown,pedicel,peduncle,petiole,poricidal,prickly,ray,red,shorter,shrub,sparsely,spherical,spreading,stellate,stellate-pubescent,stem,straight,style,surface,tapering,tip,tube,weakly,white,wide,yellow,young	-0.9,-1.5,-2,-5,-6,/4,0,0.1,0.35-,0.4-0.55,0.5,0.5-0.7,0.5-1,1-1.5,1-3,1.2-2,1/2,1/5-1/3,10-,10-20,2-5,30-80,4-10,4-5-merous,4.5-5.5,5-,5-18,5-7,6.5-8,8-20,abaxial,acut,alyx,apar,apart,apically,apparently,articulated,bark,berry,branched,broad-deltate,concolorous,cuneate,deltate,difoliate,distance,drying,eaf,eed,elliptic,elongating,extending,eye,filament,flattened,flower,free,fruiting,geminat,glabrou,glandular,green-gra,hair,infructescence,irregularly,largely,lobe,longer,lower,mature,midpoint,midvein,minute,multangulate,naked,narrow-deltate,nflorescence,obtuse,occasionally,older,one,open,orolla,oung,pair,pale,pale-brown,per,perfec,pericarp,porrect,portion,prickl,prickle,primary,recurved,red-brown,reflexed,rounded,ruit,scar,sessile,shorte,side,simple,smooth,sometimes,spaced,stalk,stalked,subentire,tamen,terete,tertiary,time,trichome,unarme,unarmed,unit,upper,variously,vary,vein,venation,visible,way,woody,ympodial	0.35-0.55-0.9,adhesion,colour,corolla,form,growth,height,inflorescence,na,number,ovary,plant,position,presence,present,pubescence,seed,shape,size,staman,stigma,stipe,texture
67	wfo-0001026259	success	233	99	80	153	19	0.343	.1,.7,.8,0.3–1.2,0.4–0.6,0.5–0.6,0.7–0.9,1.0–1.2,1.0–3.3,1.2–8.4,1.4–4.0,1.5,1.5–2.0,12–24,2/3,2–17,3.0–3.4,6,8–11,anther,apex,base,berry,broadly,brown,calyx,cm,concave-reniform,corolla,cylindrical,deltate,densely,diameter,ellipsoid,fleshy,fruit,glabrous,globose,green,green-orange,herb,inflorescence,internodal,lateral,leaf,length,lilac,lobe,long,membranous,mm,nearly,ovary,ovate-lanceolate,pale,pedicel,peduncle,petiole,plant,pubescent,purple-coloured,rarely,rounded,shiny,shrub,simple,smooth,somewhat,sparsely,stellate,stem,stigma,style,surface,translucent,tube,turning,white,wide,yellow	0.1–0.2,0.2–0.4,0.5,0404,0–2,1,1-celled,11–22,1m,1–2,1–2-celled,1–3-celled,2-ridged,2–3-celled,35–45,4–5,5-merous,5–14,5–7-celled,7–10,?,abaxial,abaxially,acuminate,acute,adaxial,adaxially,affected,age,anthesi,apar,appressed,arising,becoming,beyond,branch,branched,branching,cell,central,close,coloured,cone,congested,conical-ellipsoid,cream-coloured,decurrent,dehiscing,difoliate,drop,eaf,eed,elongating,end,entire,especially,et,exerted,filament,flower,free,fruiting,geminat,gradually,growt,halfway,hilum,individual,knapp,larger,leave,lengthening,less,like,live,lobed,lon,longer,lower,lowermost,margin,minutely,much,narrower,narrowly,near,nflorescence,node,occasionally,often,once-branched,one,outline,pair,papillate,pathogen,pentagonal,per,perfect,pericarp,pore,poricidal,portion,positioned,primary,purple,purple-black,rachi,recurving,reduced,reflexed,relatively,remaining,ripe,ruit,scar,short,shorter,similar,slightly,slit,sometimes,spaced,splitting,spreading,star,stone,stout,straight,strongly,sub-laterally,tall,tapering,tem,testal,thick,tightly,tinged,tip,together,toward,trichome,two,ud,uniseriate,unit,vein,winged,woody,yellow-green,ympodial,young,–15	adhesion,arrangement,colour,form,growth,height,history,life,na,perennial,position,pubescence,reproduction,rugulose,seed,shape,size,staman,texture
68	wfo-0001026262	success	179	102	79	100	23	0.441	0.5-1,0.8-1.4,1.5,1.5-2,10-15,2-2.5,2-5,3,3-10,3-6,4-15,4-6,4-8,5-8,7-13,7-9,abaxial,abaxially,absent,adaxial,anther,attenuate,base,brown,calyx,chartaceous,cm,connivent,contiguous,cylindrical,dark,densely,diameter,distal,end,expanded,extra-axillary,filiform,flower,fruit,geminate,glabrous,globose,green,hair,immature,leaf,light,lobed,mature,mm,moderately,mottling,nearly,orange,ovate,pedicel,peduncle,petiole,porrect-stellate,pubescent,ray,reniform,rusty,shrub,slightly,stellate,stem,stigma,style,surface,tan,tapering,tube,unlobed,vine,white,x,yellow	0.2-0.6,0.25-0.5,0.5,0.5-1.5,0.5-1mm,0.75-1.5,1,1-.,1-2,1-5,2-3,30,4-10,4-7,5-merou,absen,accrescent,acute,adaxiall,adaxially,alyx,apar,apex,apical,apparently,armed,asymmetrical,axe,berry,beyond,blade,cordate,difoliate,directed,discolorous,eaf,eed,either,em,exserted,filament,frui,fruiting,glabrou,gree,interpetelar,intorsel,lacking,like,lobe,long,lower,major,midpoint,midrib,midvein,multicellular,multiseriate,narrowly,netlike,nflorescence,obscure,obtuse,occasionally,often,orolla,pair,per,perfect,pit,pore,prickle,rachi,raised,recurved,ridge,roselike,ruit,scandent,secondary,separated,side,simple,spaced,sparsely,stalk,stamen,ste,tamen,tissue,triangular,unarmed,unbranched,unequa,unicellular,unit,vary,vein,wide,ympodial	1-4,adhesion,arrangement,colour,corolla,form,growth,height,inflorescence,length,number,ovary,plant,position,presence,present,pubescence,rugulose,seed,shape,size,staman,texture
69	wfo-0001026267	success	162	131	96	66	35	0.593	0.1-1,0.5-1,0.6-1.7,0.7-1.1,1-1.2,1-2.6,1.5-2,2.5-3,3-15,3-6.1,5-7,8.5-15,acuminate,acute,anther,apex,attenuate,axil,base,beneath,body,bright,broadly,calyx,cm,corolla,crateriform,cuneate,densely,dia,distally,drying,except,flattened-reniform,glabrous,globose,green,greenish-white,hard,incrassate,larger,lateral,lavender,leaf,lobe,lobed,long,main,margin,maturity,minutely,mm,narrowly,nearly,occasionally,often,opposite,ovary,ovate,papillose,pedicel,petiole,pitted,pitting,pore,poricidal,pubescent,quickly,remaining,ripening,scattered,shaped,shrub,size,slightly,small,softening,sparsely,stem,stigma,style,surface,tan,tear-drop,tinge,tip,tree,triangular,trichome,tube,tuft,uniseriate,vein,white,x,yellow-green	.25,.5,1-1.5,1-4,1.5-2.3,20-30-flowered,3.2-8.6,4-8,8-10,anthesi,ba,bark,beginning,berry,blackish,closely,decurrent,deflexed,depressed,differing,difoliate,distinct,eaf,edicel,eed,exerted,filament,free,fruiting,geminat,greyish-green,inflorescenc,lon,longinflorescence,lower,major,middle,minor,older,one,overlapping,pair,pale,papillo,portion,raised,reflexed,rough,ruit,scar,scarious,simple,slender,soon,spaced,straight,tall,tapering,ud,unit,widest,wing,winged,woody,ympodial,young	0.5,adhesion,arrangement,blade,climate,colour,diameter,form,fruit,glandular,growth,hair,height,history,inflorescence,length,life,midpoint,na,number,peduncle,perennial,plant,position,presence,pubescence,ray,reproduction,rugulose,seed,shape,staman,stellate,stipe,texture
70	wfo-0001026272	success	182	135	106	76	29	0.582	0.2-0.3,1,1-1.5,1-1/5,1-2,1-2-celled,1.2-1.5,1.5-2,12-15,2-2.5,2-3,2-7,3-4,3-5,3.5-4,4-5,5-8,7-10,7-8,abaxial,adaxially,anther,apex,apiculate,articulated,base,berry,beyond,brown,calyx,clavate,cm,coriaceous,corolla,densely,denser,diameter,discolorous,elliptic,exserted,flattened,flower,form,fused,glabrous,glandular,globose,green,growth,inflorescence,internodal,lanceolate,like,lobe,lobed,long-styled,lower,midpoint,mm,multicellular,obelliptic,oblong,ovary,ovoid,pedicel,peduncle,petiole,poricidal,porrect,pubescence,pubescent,quarter,reddish,reniform,rugose,rusty,scabrous,scandent,sessile,short-styled,shrub,simple,somewhat,sparsely,stellate,stem,stigma,style,sub-sessile,subcoriaceous,subglobose,surface,tapering,terete,thick,tip,triangular-lanceolate,trichome,tube,unarmed,viscid-pubescent,way,white,x,yellowish,¾	1/3,20,20-30,6-8,abaxially,age,anthesi,armed,bark,basal,branched,celled,corymbose,cream-colored,cyme,distal,eaf,eed,epidermi,erect,filament,free,fruiting,heterostylous,lengthening,long,many,midpoin,minute,mixed,multangulate,new,nflorescence,numerous,older,partially,pendant,per,perfect,pericarp,pitted,plurifoliat,pore,porrect-stellate,portion,prickle,prickly,rachi,raise,recurved,reduced,reticulately,ruit,scar,slightly,slit,spaced,sparse,stalked,staminate,subconical,subtruncat,testa,time,turbinate,ud,unarme,unevenly,unicellular,unit,upper,velutinous,venation,visible,woody,ympodial	adhesion,arrangement,blade,climate,colour,fruit,hair,height,history,leaf,length,life,margin,na,number,plant,position,presence,present,ray,reproduction,rugulose,seed,shape,size,staman,stipe,subtruncate,texture
71	wfo-0001026279	success	248	129	101	147	28	0.407	-34.3,-5.9,0.2-0.4,1-10,1-3.5,1.1-1.6,1.1-1.9,1.5-1.8,1.5-3,1.7-2.3,1.9-3,11.5-19.7,14-27,3-4,3.1-4.2,3.4-5.2,3.5-7.8,8,9-22,abaxially,acuminate,acute,adaxially,anther,apex,attenuate,base,black,blade,blunt-tipped,brown,calyx,capitate,chartaceous,cm,conical,corolla,cuneate,dark,deltoid,diameter,drying,elliptic,elongated,entire,fleshy,flower,fruit,globose,granular,grayish,green,hair,immature,inserted,lanceolate,lavender,leaf,length,lilac,lobe,margin,mature,mm,narrowly,oblong,occasionally,pale,pedicel,peduncle,petiole,plant,present,pseudo-terminal,pubescence,reticulate-punctate,rounded,scabridulous,scabrous,scattered,semi-ovate,short,shrub,simple,stellate,stem,stigma,style,subcampanulate,suborbicular,surface,tomentose,tomentose-pubescent,tree,tube,white,whitish,x,yellow,yellowish,yellowish-tan	-11.4,-2.9,-4,/14-1/8,0.25-0.4,0.8-2.3,0.9-1,0.9-1.8,1-1.4,1.9-3.2,1/2,2.4-3.2,2.5-3.2,2.6-4.8,2/3,3.1-3.6,3.8-5.1,4-7.5,5-200,5-8,8-11,8.5-10.5,accrescent,adaxiall,ag,anthesi,apart,apparently,appearing,appressed,ark,around,articulated,axe,axillary,ba,berry,branch,branched,bud,closely,completely,covering,cylindrical,dendritic-echinoi,dendritic-echinoid,dense,directed,distally,due,eaf,earl,echinoi,echinoid,edge,eed,enveloping,equal,evident,exerted,expanded,farinose,few-rayed,filament,free,fruiting,glabrescen,glabrescent,glabrous,grayish-green,half,lateral,lengthening,lobed,long,long-stalked,longer,longitudinal,longitudinall,lower,m.,main,many,midrib,minute,mixed,multangulate,multangulate-pubescent,multiseriate,nflorescence,obovate,occasional,often,older,open,orbicular,orolla,ovate-lanceolate,overlapping,partly,perfect,plurifoliate,pore,poricidal,porrect-stellate,prominent,rachi,ruit,secondary,sessile,short-,short-decurrent,short-stalked,side,slightly,slit,slowly,somewhat,spaced,splitting,stalk,stamen,subcoriaceous,subsessile,sulcate,suture,tall,tamen,tertiary,thickened,thin,thin-stalked,time,tip,ud,unarme,unarmed,unit,unwinged,upper,usually,vary,vein,way,wide,ympodial,young	adhesion,arrangement,climate,colour,form,glandular,growth,height,history,inflorescence,life,longitudinally,midpoint,na,number,ovary,perennial,position,presence,ray,reproduction,rugulose,seed,shape,size,staman,stipe,texture
72	wfo-0001026292	success	190	122	92	98	30	0.484	0.25-0.5,0.5-1,0.5-1.5,0.5-2,0.75-1.25,1-1.5,1-3,1-8,1.5,1.5-2,10-15,12-16,2-3,2-4,2.5-3.5,20-25,3-15,3-9,4-8,5-10,abaxially,absent,acute,adaxially,anther,apex,attenuate,base,blade,brown,bud,calyx,chartaceous,cm,connivent,curved,diameter,distal,distally,end,expanded,extra-axillary,filiform,flower,fruit,glabrous,globose,green,hair,immature,leaf,like,lobe,lobed,margin,mature,midpoint,mm,moderately,nearly,obtuse,orange,orange-red,ovate,pedicel,peduncle,per,petiole,porrect-stellate,pubescent,ray,reniform,shrub,side,simple,slightly,sparsely,spreading,stellate,stem,stigma,style,surface,tan,tapering,triangular,tube,upward,white,wide,x,yellow	-13,0.5,1-2.5,1-5,1.5-2.5,1.5-8,1/3,13-17,2-6,3-5,3-8,30-40,5-merou,absen,accrescent,adaxial,adaxiall,alyx,apar,apical,apparently,armed,asymmetrical,axe,berry,beyond,cordate,cut,cylindrical,dark,densely,difoliate,directed,discolorous,eaf,eed,either,exserted,filament,flattened,frui,fruiting,geminate,glabrou,gree,introrsel,lanceolate,less,lon,long,lower,major,many,midrib,midvein,multicellular,multiseriate,netlike,nflorescence,obscure,occasionally,often,orolla,pair,perfect,pit,pore,prickle,rachi,raised,recurved,reflexed,ridge,roselike,ruit,scandent,secondary,separated,sinus,small,spaced,stalk,stamen,swollen,tamen,tem,thin-skinned,unarmed,unbranched,unequa,unicellular,unit,vary,vegetatio,vein,way,whitish,ympodial	adhesion,arrangement,climate,colour,corolla,form,glandular,growth,height,history,inflorescence,length,life,na,number,ovary,perennial,plant,position,presence,present,pubescence,reproduction,rugulose,seed,shape,size,staman,stipe,texture
73	wfo-0001026298	success	192	102	73	119	29	0.38	0.2-4,0.3-2,0.4-1,0.5-2,0.5-3,0.6-1.5,0.75-1,1-1.5,1.5-2.5,1.5-4,2850,3-4,3-6,4-13,8-28,acuminate,acute,anther,apex,area,base,blade,broadened,calyx,cm,conical,corolla,deltoid,densely,dia,fide,glabrous,globose,green,greyish,haught,inflorescence,leaf,length,lobe,lobed,long-styled,long-triangular,margin,minutely,mm,obovate,opposite,ovary,ovoid-reniform,pale,pedicel,petiole,pitted,plant,poricidal,puberulent,red,rhizomatous,shape,short-styled,shrub,size,stem,stigma,style,surface,tip,treelet,tube,white,x,yellowish-tan	.5,0.1-0.3,0.25-0.5,0.8-2,1.4-6,1.5-9,2-3,3/4,5-30-flowered,7-12,along,american,anthesi,appearing,appressed,auriculate,ba,bark,bearing,beginning,beneath,berry,bu,caudate,central,closely,corky,costa,deflexed,differing,difoliate,distal,dry,eaf,edicel,eed,ellipsoid,elliptic,erect,even,exsertion,filament,flower,free,fruiting,geminat,glabrate,golden,impressed,inflorescenc,later,lateral,locality,lon,long,lower,main,major,material,middle,midrib,minor,minute,nflorescence,oblique,occasionally,often,older,one,orbicular,overlapping,pair,papillo,papillose,peelin,planar,pore,portion,prominent,rarely,rather,reddish,reflexed,rest,rican,rough,rounded,ruit,scar,scattered,shaped,shorter,simple,single,slender,sometimes,somewhat,spaced,straight,tall,tapering,tear-drop,thick,third,time,trichome,two,ud,unicellular,uniseriate,unit,variable,varying,vein,way,widest,woody,ympodial,young	/,adhesion,arrangement,climate,colour,diameter,form,fruit,glandular,growth,hair,height,history,life,midpoint,na,number,peduncle,position,presence,pubescence,ray,reproduction,rugulose,seed,staman,stellate,stipe,texture
74	wfo-0001026299	success	239	95	74	165	21	0.31	0.4-0.5,0.5,0.5-0.6,0.5-0.7,0.5-2.5,0.8-1,1,1-1.4,1.1-1.7,1.2-1.6,1.8-2,2.2-3.2,2.5-7,6-20,7-12,anther,apex,basal,broadly,brown,calyx,capitate,cm,corolla,dark,densely,diameter,elliptic,fruit,glabrous,glandular,globose,green,half,herb,imparipinnate,inflorescence,interrupted,lanceolate,leaf,less,lobe,long,margin,minute,minutely,mm,obovate,ovary,pale,pedicel,peduncle,pentagonal,perennial,petiole,pubescence,pubescent,short,size,sparsely,stem,stigma,stripe,style,surface,thick,tip,trichome,tube,variously,velvety,white,wide,yellow	--,-0.8,-1,-10,-2.5,-3.5,-5,.5,0-8,0.1-0.2,0.1-0.25,0.1-0.4,0.1-0.5,0.15-0.2,0.2-0.25,0.2-1,0.25-0.5,0.3-0.4,0.4-2,0.5-1,0.6-2,0.7-3.5,0.8-0.9,0.9-1,1-celled,1.2-5,1.5-,1.5-2.3,2-4,2-6,2-foliate,2-locular,2.5,25,3-,3.5-10,5,5-15,5-20,abaxially,absent,abundant,acroscopically,acute,adaxially,almost,along,angled,anthesi,apical,appearance,appendage,approximately,articulated,axi,base,basiscopically,beneath,berr,bract,bracteate,cell,change,chota,column,conical,could,crenat,crenate-serrate,decurrent,developed,diamete,distal,eaf,ebracteate,edicel,eed,eglandular,entire,erect,exserted,filament,flower,fruiting,give,gree,hair-like,hal,head,interjected,intermixed,internode,investing,irregularly,jequetepeque,lacking,larger,lateral,leaflet,like,lobed,lon,long-acuminate,longer,loosely,lower,marañón,maturity,middle,mixture,multicellular,narrowly,nearly,nflorescence,node,oblique,occasionally,often,outgrowth,pair,patent,petiolule,population,present,primary,prostrate,pseudostipule,purple,rachi,reflexed,regularly,rest,ruit,scarcely,scattered,secondary,sessile,silky,simple,sparse,spreading,staminal,sterile,stout,straight,tall,tem,terminal,tertiary,testa,toward,truncate,ud,unicellular,uniseriate,unit,usually,valley,vein,wall,way,weak-walled,winged,woody,ympodial	1.5-10,3-15,adhesion,arrangement,colour,form,growth,height,history,length,life,na,plant,position,reproduction,rugulose,seed,shape,staman,texture,ye
75	wfo-0001026305	success	135	110	73	62	37	0.541	/4,0.2-1,0.5-2,0.6-1,0.7-1,1-1.5,2-2.5,2.5-3,3-8.5,4-4.5,5-7,6-9,7-16,abaxial,abaxially,acute,adaxially,anther,apex,apical,area,attenuate,base,calyx,cm,conical,corolla,deltate,densely,dia,difoliate,elliptic,glabrous,globose,green,greenish-white,knob-like,leaf,leaf-opposed,lobe,lobed,margin,minute,minutely,mm,occasionally,ovary,ovoid-reniform,pale,papillose,pedicel,petiole,pitted,pore,poricidal,projection,pubescent,rounded,shaped,shining,shrub,sparsely,stem,stigma,style,surface,tan,tear-drop,tip,tube,unifoliate,way,x	.25,0.25-0.5,1.3-1.5,2-6-flowered,7-9,along,anthesi,ba,bark,beige-tan,berry,closely,congested,dark,deflexed,dendritic,drying,eaf,edicel,eed,exserted,filament,free,fruiting,geminat,glabrate,interlocking,lamina,lateral,like,lon,long,lower,main,middle,midrib,nflorescence,older,overlappin,pair,planar,portion,reddish-brow,ruit,scar,scattered,simple,slender,spaced,strongly,styl,tall,trichome,tub,ud,unit,vein,visible,widest,woody,ympodial,young	adhesion,arrangement,blade,climate,colour,diameter,form,fruit,geminate,glandular,growth,hair,height,history,inflorescence,length,life,midpoint,na,number,peduncle,perennial,plant,position,presence,pubescence,ray,reddish-brown,reproduction,rugulose,seed,shape,size,staman,stellate,stipe,texture
76	wfo-0001026307	success	193	116	73	120	43	0.378	0.6,2/3,abaxially,acute,acute-acuminate,anther,apex,base,berry,black,broadly,calyx,central,clavate,cm,corolla,cuneate,cylindrical,decurrent,densely,diameter,ellipsoid,entire,eye,flattened-reniform,fruit,glabrous,glandular,globose,green,growth,herb,internodal,lateral,length,lobe,lobed,long,margin,membranous,mm,ovary,ovate,pedicel,peduncle,petiole,pubescent,purple-yellow,ripe,shallow,shallowly,shape,shrub,simple,sparsely,stellate,stem,stigma,style,surface,triangular,trichome,tube,turning,undulate,uniseriate,variable,vigorous,weak-stemmed,white,wide,yellow,yellow-green	.0–1.2,.3,.5,.5–4.0,.6,.8,0.2–0.5,0.2–1.5,0.4,0.5–0.6,0.5–0.7,0.5–5.0,0.8–0.9,0.8–2,0.8–5,1.0–1.2,1.0–1.5,1.0–2.0,1.0–2.4,1.0–2.5,1–3-celled,1–6-celled,2.0,2.0–3.0,2.0–3.5,2.6–13,3.0–4.0,3.5–7.0,35–45,3–8,3–8-celled,4–5.7,5-merous,5–7,8–12,9,abaxial,adaxial,adaxially,age,angled,anthesi,apar,appressed,articulated,becoming,beyond,cell,cone,difoliate,eaf,eed,end,exerted,facing,filament,flower,free,fruiting,geminat,gradually,hilum,later,lengthening,like,longer,lower,middle,minutely,narrower,narrowing,new,nflorescence,one,outline,pair,paler,papillat,pentagonal,per,perfect,pore,poricidal,portion,positioned,primary,purple,recurved,reflexe,reflexed,restricted,ruit,scar,shorter,side,slightly,slit,spaced,spreading,ste,stone,straight,strongly,sub-laterally,tal,tem,testal,three,tinged,tip,toward,translucent,two,ud,unequal,unevenly,unit,upper,vein,ympodial	0.2-0.5,0.2-1.5,0.3-0.4,0.5-0.7,0.5-5.0,0.8,0.8-5,1.0-2.4,2.0-3.5,2.6-13,3.0-4.0,3.5-7.0,4-5.7,8-12,adhesion,arrangement,blade,climate,colour,form,hair,height,history,inflorescence,leaf,life,midpoint,na,number,perennial,plant,position,presence,present,pubescence,ray,reproduction,rugulose,seed,size,staman,stipe,texture
77	wfo-0001026317	success	169	99	79	90	20	0.467	/4,0.25-1,0.3-1.2,0.5,0.5-0.6,0.5-1,0.6-,0.8-1,1-1.5,1-5.7,2-,2-2.5,2-4,2.5-10,3-3.5,3.5-15,4-5,anther,apex,base,berry,bright,calyx,capitate,clonal,cm,conical,corolla,dendritic,densely,diameter,elliptic,flattened,glabrous,globose,growth,inflorescence,internodal,less,lobe,lobed,minutely,mm,narrowly,orange,ovary,pale,papillate,pedicel,peduncle,perfect,petiole,pitted,plant,poricidal,pubescence,pubescent,pulp,reniform,shrub,simple,sparsely,stem,sticky,stigma,straight,style,surface,terminal,thin,tip,triangular,trichome,tube,uniseriate,way,white,x,yellowish	.5,0.5-0.8,0.7-0.9,1-1.2,10-12,3,3-foliate,50-200,6-8,6x,?,abaxially,absent,acuminate,acute,adaxially,age,anthesi,apart,apically,approximately,attenuate,bark,branched,brown,closely,correlated,dark,deltate,dense,distally,drying,eaf,eed,em,entire,erec,erect,essentially,exerted,extremely,filament,flower,found,free,fruiting,geminat,halfwa,lamina,lengthening,like,longer,lower,many,margin,maturity,new,nflorescence,nodding,occasionally,often,packed,pair,papillat,per,pericarp,planar,plane,population,pore,portion,primary,pubescen,rachi,red,reflexed,ruit,scar,shiny,slightly,slit,swollen,time,toward,ud,unit,variable,vein,woody,ympodial	2,adhesion,arrangement,colour,form,fruit,height,history,leaf,length,life,position,presence,reproduction,seed,shape,size,staman,stellate,texture
78	wfo-0001026321	success	213	101	77	136	24	0.362	.5,0-0.2,0.1-0.4,0.4-0.6,0.4-0.7,0.5-0.6,1.2-3.5,1.5-3,2-7,2.5-5.5,2.7-3.1,3-10,3-4,3.5-8.5,4.5-6,6-11,7-10,8-20,abaxially,adaxially,andromonoecious,anther,attenuate,bisexual,broadly,brown,calyx,chartaceous,cm,connivent,deltate,densely,diameter,extra-axillary,flower,fruit,glabrous,glandular-puberulent,globose,green,herbaceous,inflorescence,juicy,lanceolate,leaf,leaf-opposed,length,lobe,long,mm,moderately,moist,orbicular,ovate,pale,pedicel,peduncle,petiole,plant,present,prostrate,ray,resprouter,rostrate,rusty,simple,sprawling,stellate,stellate-pubescent,stigma,style,tube,weakly,white,x,yellow,yellowish-green	%,0-0.1,0-0.25,0-0.3,0-2,0-3.5,0.1-0.2,0.1-0.3,0.3-0.6,0.6-0.9,1-1.2,1-1.5,1-2,1-3,1-4,1-5,1-locular,1.2-1.7,10-17,2-3,2-4,2-5,2-5.5,20-40,30-65,4-,4.5,5-25,5-merou,50-100,6-10,7-9,8-11,absent,accrescent,acicular,across,adaxial,adaxiall,adult,also,alyx,apart,apex,armed,articulated,ascending,axe,ba,base,blade,branchlet,capitat,central,cordate,cross-section,cylindrical,decimetre,directed,distall,eaf,eed,eglandular,elliptica,entire,exocarp,finger,frui,fruiting,functional,gland-tipped,glandular,greenish-white,grey-green,hair,half,halfway,heterostylous,hig,incomplete,juvenile,lateral,less,lobed,longer,lower,margin,mature,mesocarp,mid-point,midpoint,midrib,midvein,minute,nflorescence,oblique,obtuse,orolla,pair,part,per,placenta,pore,porrect,prickle,pseudo-racemose,rachi,ruit,septum,sessile,shallowly,shallowly-lobed,short,side,solitary,spaced,sparse,stalk,stellae,straight,surface,tamen,tem,thick,throughout,time,transparent,unarme,unarmed,unbranched,unit,unknow,upper,vary,wide,ympodial	adhesion,arrangement,capitate,colour,corolla,elliptical,form,growth,height,history,life,na,number,ovary,position,presence,pubescence,reproduction,seed,shape,size,staman,stem,texture
79	wfo-0001026325	success	216	130	80	136	50	0.37	0.5,2,3,abaxially,acute,adaxially,andromonoecious,anther,apex,base,blade,blue-violet,calyx,cm,cuneate,darker,densely,diameter,ellipsoid,elliptic,extra-axillary,finely,flattened-reniform,foveolate,fruit,glabrous,green,hair,herb,inflorescence,lanceolate,leaf,lenticular,less,light,like,linear,lobe,lobed,margin,maturity,mm,moderately,mottling,narrowly,oblong,obtuse,ovate-elliptic,ovoid,pale,pedicel,peduncle,perennial,petiole,pubescent,ray,rotate-stellate,shallowly,simple,sinuate,sometimes,sparsely,stellate,stellate-pentagonal,stellate-pubescent,stem,stigma,style,subentire,subglobose-ovoid,subtruncate,surface,triangular,tube,usually,white,yellow,yellow-orange,young,×	.2,0.15–0.4,0.3,0.5–1.5,0.5–5,0.6–1.8,1,1.1–2,1.2–1.8,1.2–2,1.2–2.2,1.2–2.5,1.3–2.5,1.5,1.5–2.3,1.7–3.5,1.8–2.5,10–12,10–20,12–16,1–1.5,1–2,1–2.5,1–5,1–6,2-,2.5–4,2–10,2–4,2–5,2–6,3-foliate,3.3,3.5,4,4–7,4–8,5,5-merous,5–9,6.5–15,7–10,7–8.5,absent,accrescent,acuminate,adaxiall,alyx,apart,appearing,armed,articulated,axe,berry,bud,c.,capitat,caudate,central,chartaceous,completely,connivent,covering,curved,cylindrical,deltate,directed,directly,discolorous,distal,distall,downward,eaf,eed,emerging,exserted,few-branched,filament,flower,forked,formed,fruiting,functionally,geminat,hermaphorditi,hermaphroditic,heteromorphic,lateral,lon,long,long-stuled,lower,lowermost,major,malae,nflorescence,node,often,one,orolla,outline,per,plurifoliate,pointed,pore,prickle,producing,proximal,rind,root,ruit,sessile,shoot,short-styled,side,somewhat,spaced,staminate,straight,swelling,tall,tamen,tapered,tem,toug,tuber-like,unarmed,unbranched,unequal,unit,upright,vary,vein,weakly,ympodial,–3	0.15-0.4,0.5-5,1-1.5,1-2,1-2.5,1.1-2,1.2-1.8,1.2-2,1.2-2.2,1.2-2.5,1.3-2.5,1.5-2.3,1.7-3.5,1.8-2.5,10-12,2-10,2.5-4,4-7,4-8,7-8.5,adhesion,arrangement,capitate,climate,colour,corolla,form,glandular,growth,height,history,length,life,midpoint,na,number,ovary,plant,position,presence,present,pubescence,reproduction,rugulose,seed,shape,size,staman,stipe,texture
80	wfo-0001026335	success	157	112	82	75	30	0.522	0.1-0.3,0.25-0.5,0.5-1,0.6-1,1,1-1.5,1-2,1-4,1.5-2,10-20,2,2-4,2-7.5,3-18,5-15,5-7,7-8,abaxially,acute,adaxially,anther,apart,articulated,base,calyx,chartaceous,cm,curved,deltate,dense,densely,diameter,elliptic,elliptic-ovate,equal,erect,especially,flattened,flower,fruit,glabrescent,glabrous,globose,green,hair,leaf,leaf-opposed,like,lobe,mm,moderately,multangulate,oblong,pedicel,peduncle,petiole,probably,pubescence,pubescent,ray,ripe,scattered,sessile,shrub,simple,spaced,stellate,stellate-pubescent,stem,stigma,straight,style,surface,tip,toward,tube,unripe,white,whitish,x,yellow,yellowish	.5,.5-3.5,0.8-1.3,1-3,1.5-4,10-30,2-3,3-5,4-5,5-,accrescent,acuminate,adaxiall,ag,apex,apparently,axe,ba,blade,branched,capitat,connivent,covering,cuneate,cylindrical,directed,distally,eaf,eed,entire,filament,forked,frui,fruiting,geminate,glandula,glandular,held,lanceolate,large,long,longitudinal,lower,many-foliate,margin,midpoint,much,nflorescence,often,opening,orolla,paired,perfect,pore,rachi,reticulate,rounded,ruit,slightly,slit,smaller,sometimes,ste,subtending,tal,tamen,tem,time,unit,uprigh,usually,vary,vein,wide,ympodial	abaxial,adhesion,arrangement,capitate,colour,corolla,form,growth,height,history,inflorescence,length,life,na,number,ovary,perennial,plant,position,presence,reproduction,rugulose,seed,shape,size,staman,stipe,texture,unknown,ye
81	wfo-0001026342	success	280	92	56	224	36	0.2	.3,0.06,2.0,4.7,acuminate,acute,adnate,anther,apex,base,blade,calyx,chartaceous,cm,corolla,densely,diameter,entire,erect,flattened-orbicular,fruit,glabrous,glandular,globose,hair,inflorescence,lateral,leaf,length,lobe,margin,mm,nearly,notched,oval,ovate,pedicel,peduncle,petiole,pubescence,pubescent,ray,red,rounded,shrub,sparsely,stellae,stellate,stem,stigma,stipe,style,truncate,tube,white,yellow-tan	.4–3.0,.6,.9,0.07,0.08,0.3–0.5,0.3–0.6,0.3–0.9,0.4–0.6,0.6–1.3,0.6–2.8,0.7–1.4,0.7–1.6,0.7–1.8,0.8,0.8–1.1,0.8–1.2,0.8–1.5,0.9–1.3,1.1–1.5,1.1–3.7,1.2,1.3–1.8,1.5–2.1,1.5–2.3,1.7–2.6,1.8–2.2,1.9–2.9,1/2–2/3,1/3,2.0–7.6,2.1,2.1–3.3,2.1–3.7,2.5,2.5–3.8,2.8–4.9,2.9,3.1–13.7,3.2–3.7,3.6–4.6,4602,5-merou,5.1–6.6,5.2–7.7,5–8,6–12,7.7–11.2,7–8,8,8.5–9.5,8–13,9.5–14.2,90°,abaxially,absent,adaxial,adaxially,aequilateral,ag,along,alyx,anthesi,apart,apical,apparently,appearing,arching,around,articulate,attachment,attenuate,axe,ba,bark,becoming,bent,berry,borne,branch,broad,brochidodromous,brown,bud,cancellate,capitat,caudate,channeled,climate,clinate,congested,connivent,deciduous,deltoid,dentate,development,difoliate,directed,distal,dorsally,dry,edge,eed,either,emerging,endocarp,exocarp,extending,extra-axillary,fertile,filament,filiform,flattened-reniform,flexed,flower,free,geminat,glossy,gradually,homostylous,immature,increasing,individually,intact,internode,interpetalar,intersepalar,juic,laxly,layer,less,lon,long,longer,lower,many,markedly,mature,mckee,midpoint,midrib,midvein,minute,moderate,moderately,nflorescence,oblique,oblong,observed,occasionally,one,orolla,ove,per,perforated,point,pore,porrect,porrect-stellate,portion,potentially,raised,reddish,reflexe,remaining,rigid,row,ruit,seen,sessile,short-stipitate,shorter,side,simple,sinus,slightly,sloughing,smoot,soon,spaced,speciman,splitting,spread,stamen,stellate-pubescent,straight,surface,suture,tamen,tardily,tem,thin,time,tip,tissue,toward,translucent,transparent,trifurcating,two,typically,ud,unarmed,unbranched,upper,various,vary,vein,weakly,well-developed,wide,yellow,yellow-ferruginous,ympodia,young,±90°,±densely,±equal,±evenly,±glabrous,×,–0.9,–19.0,–31.0	0.2-1.2,0.3-0.5,0.3-0.6,0.3-0.9,0.4-0.6,0.6-2.8,0.7-1.6,0.8-1.2,0.8-1.5,1.1-1.5,1.1-3.7,1.5-2.1,1.8-2.2,3.1-13.7,3.2-3.7,5.2-7.7,6-12,7.7-11.2,8-13,adhesion,capitate,colour,form,growth,height,number,ovary,plant,position,presence,present,seed,shape,size,staman,texture
82	wfo-0001026343	success	221	122	93	128	29	0.421	-15,-3.5,-4,-7,.5,0-4,0.05-0.5,0.1-0.2,0.45-1,1.3-1.7,1.5-2.5,1.8-2.2,1.8-3,1/3,2-3,2-3.2,2-4,2-6,2.2-3.2,3-4,5.5-9,7-8,7-9,abaxially,acute,andromonoecious,anther,apex,base,berry,blade,broadly,calyx,chartaceous,cm,connivent,cream,cuneate,dark,deltate,densely,diameter,dull,elliptic,equal,erect,flattened-reniform,fruit,glabrescent,glabrous,green,lateral,leaf,length,lobe,lobed,long,lower,margin,marking,maturity,mauve,midpoint,mm,orange,orange-brown,ovate,pale,pedicel,peduncle,petiole,plant,poricidal,purple,ray,rounded,shrub,small,sparsely,spherical,stellate,stellate-pubescent,stem,style,tapering,tip,tree,tube,upper,weakly,wide,yellow,young	-1,-1.5,/2,/5,0,0-10,0-2,0-40,0-5,0.05-0.2,0.15,0.2,0.2-0.3,0.2-0.7,0.3,0.5,0.5-1.5,0.8-1.5,1-2,1-3,1-4,1.5-2,1/,1/4-2/3,1/5,10-30,2-5,2-8,2.5-8,3-5,3.5-4.5,5-10,5-merous,6-9,7-12,7-14,abaxial,acuminat,adaxial,alyx,apar,apart,apically,apparently,articulated,bark,branched,brow,concolorous,curved,distal,distance,drying,eed,elongating,extending,faint,filament,flattened,flower,free,fruiting,green-brown,hermaphrodite,heterostylous,infructescence,less,lobing,lon,long-styled,longer,lowermost,mature,midvein,moderately,multangulate,narrow-deltate,nflorescence,obtuse,older,one,open,orolla,oung,pair,pendulous,per,pericarp,plurifoliat,porrect,portion,prickl,prickle,prickly,primary,reddish,reduced,reflexed,ruit,scar,secondary,sessile,short-styled,side,smooth,sometimes,spaced,spreading,stalk,stalked,staminat,stout,surface,tamen,terete,tertiary,time,trichome,unarmed,unit,variously,vary,vein,venation,visible,way,woody,ympodial	adhesion,arrangement,climate,colour,corolla,form,glandular,growth,hair,height,history,inflorescence,life,na,number,ovary,perennial,position,presence,present,pubescence,reproduction,seed,shape,size,staman,stigma,stipe,texture
83	wfo-0001026351	success	199	120	94	105	26	0.472	0.25-0.5,0.5-1,0.5-1.0,0.5-1.5,0.5-1mm,0.75-1.0,1-1.5,1-2,1-2.5,1-3,10-15,2-3.5,2-5,3-10,3-9,4-7,5-15,6-10,8-15,abaxially,acute,andromonoecious,anther,apex,attenuate,base,blade,brown,bud,calyx,chartaceous,cm,connivent,coriaceous,corolla,densely,diameter,entire,extra-axillary,filiform,flower,fruit,glabrous,globose,green,hair,immature,leaf,leathery,length,like,lobe,lobed,margin,mature,midpoint,mm,moderately,narrowly,nearly,obtuse,orange,orange-red,ovary,ovate,pale,pedicel,peduncle,petiole,plant,proximally,pubescent,purple,ray,reniform,seed,simple,slightly,spreading,stellate,stem,stigma,style,subcoriaceous,surface,tan,tapering,triangular,tube,vine,white,wide,x,yellow	0.5,1-.,1-4,10-18,12-16,15-50,2-4,3-6,4-6,4-9,40-80,5-merou,6-8,abaxial,absent,accrescent,adaxial,adaxially,alyx,apar,apical,apparently,armed,asymmetrical,axe,berry,beyond,branch,branched,commonly,cordate,cylindrical,dark,difoliate,directed,discolorous,distally,distinct,eaf,eed,either,em,exserted,exseted,filament,flattened,forming,frui,fruiting,functionally,geminate,glabrou,gree,hermaphroditic,heteromorphic,introrsel,long,long-styled,lower,major,male,midrib,midvein,multicellular,multiseriate,nflorescence,occasional,occasionally,often,orane,orolla,outer,pair,per,pore,porrect-stellate,prickle,rachi,recurved,red,revolute,roselike,ruit,scrambling,short-,side,siz,spaced,sparsely,stalk,stamen,ste,stellare,straight,surfac,swellin,tamen,unarmed,unbranched,unequal,unicellular,unit,vary,vein,ympodial	1-6,adhesion,arrangement,climate,colour,form,glandular,growth,height,history,inflorescence,life,na,number,perennial,position,presence,present,pubescence,reproduction,rugulose,shape,size,staman,stipe,texture
84	wfo-0001026352	invalid_json	209	130	91	118	39	0.435	.3,0.5,0.5-0.8,0.5-1,0.5-3,0.6-,0.7-2,1-,1-2-celled,1.2-1.7,1.5-4.6,3-15,3.5-9,4-4.5,5-6,<,?,abaxially,acuminate,acute,anther,apex,base,berry,blue,broadly,brown,calyx,capitate-truncate,chartaceous,cm,conical,cordate,corolla,deltate,densely,diameter,ellipsoid,entire,evenly,flattened,glabrous,globose,green,greenish,growth,immature,inflorescence,lamina,leafy,length,lobe,lobed,long,margin,membranous,mm,narrowly,nearly,ovate,papillate,pedicel,peduncle,petiole,pink,pubescent,reniform,shallowly,shiny,shoot,short,simple,stellate,stem,stigma,style,surface,terminal,thin,trichome,truncate,tube,unspecified,vein,vine,violet,weak,white,wide,woody,yellowish	.5,0.5-1.5,0.9-1,1-1.5,1-10,1.5,1.5-2,10+,12-60,2,2-3-celled,5-merou,6-7,7-9,adaxiall,ag,almost,alyx,angle,anthesi,antrorsely,apart,apparently,appearance,arising,articulated,articulation,axi,bark,basal,bending,branch,branching,cell,curved,deciduous,denser,discolorous,eaf,eed,eventually,expanded,exserted,few-celled,filament,flower,free,fruiting,giving,half,heigh,herbarium,ilament,impressed,inflorescenc,irregularly,junction,large,largest,leave,leaving,lengthening,like,lower,many,mature,minutely,near,new,nflorescence,older,orolla,outline,pair,pale,papillo,peg,per,perfect,pericarp,plurifoliat,point,pore,poricidal,portion,primary,principal,rachi,reflexed,rest,revolute,right,ruit,scar,seen,sleeve,slit,small,spaced,sparser,specimen,spreadin,spreading,straw-colored,strongly,tem,third,time,tip,tub,tuberculate,ud,uniseriate,unit,upper,vary,widest,ympodial	'','pale,[,],``,adhesion,arrangement,blade,characteristic,climate,colour,form,fruit,glandular,hair,height,history,leaf,life,midpoint,na,number,ovary,plant,position,presence,pubescence,ray,reproduction,rugulose,seed,shape,size,staman,stipe,texture,value,{,}
85	wfo-0001026352	invalid_json	214	129	92	122	37	0.43	.3,0.5,0.5-0.8,0.5-1,0.5-3,0.6-,0.7-2,1-,1-2-celled,1.2-1.7,1.5-4.6,3-15,3.5-9,4-4.5,5-6,<,?,abaxially,acuminate,acute,adaxially,anther,apex,base,berry,blue,broadly,brown,calyx,capitate-truncate,chartaceous,cm,conical,connivent,cordate,corolla,deltate,densely,diameter,ellipsoid,entire,evenly,flattened-reniform,form,glabrous,globose,green,greenish,growth,immature,inflorescence,lamina,leaf,leafy,length,lobe,lobed,margin,membranous,mm,narrowly,nearly,ovate,pedicel,peduncle,petiole,pink,pubescent,shallowly,shiny,shoot,short,simple,stellate,stem,stigma,style,surface,terminal,trichome,truncate,tube,unspecified,vein,vine,violet,weak,white,woody,x,yellow,yellowish	.5,0.5-1.5,0.9-1,1-1.5,1-10,1.5,1.5-2,10+,12-60,2,2-3-celled,5-merou,6-7,7-9,ag,almost,alyx,angle,anthesi,antrorsely,apart,apparently,appearance,arising,ark,articulated,articulation,axi,basal,bending,branch,branching,cell,curved,deciduous,denser,discolorous,eaf,eed,eventually,expanded,exserted,few-celled,filament,flower,free,fruiting,geminat,giving,half,heigh,herbarium,ilament,impressed,inflorescenc,irregularly,junction,large,largest,leaving,lengthening,like,long,lower,many,mature,minutely,near,new,nflorescence,older,orolla,outline,pair,pale,papillate,papillo,peg,per,perfect,pericarp,plurifoliate,point,pore,poricidal,portion,primary,principal,rachi,reflexed,rest,revolute,right,ruit,scar,seen,sleeve,slit,small,spaced,sparser,speciman,specimen,spreadin,spreading,straw-colored,strongly,tem,thin,third,time,tip,tub,tuberculate,twining,ud,uniseriate,unit,upper,vary,widest,ympodial	'','pale,[,],``,adhesion,arrangement,blade,characteristic,climate,colour,fruit,glandular,hair,height,history,life,midpoint,na,number,ovary,plant,position,presence,pubescence,ray,reproduction,rugulose,seed,shape,size,staman,stipe,texture,value,{,}
86	wfo-0001026357	success	206	125	101	105	24	0.49	0.1-0.3,0.11-0.29,0.2-0.7,0.8-1,0.8-1.2,0.9-1.2,1-1.2,1-6,1.1-1.7,1.4-2,1.5-2.2,1.5-2.5,1.5-2.8,10-17,2-2.8,2-3,2-3.3,2-6,3.9-6.2,4-7,5,5.8-13.6,7-15,abaxially,acute,adaxially,anther,anthesi,apart,articulated,asymmetrically,base,blunt-tipped,branched,brown,calyx,chartaceous,closely,cm,conical,corolla,dark,densely,diameter,elliptic,exserted,ferrugineous-pubescent,flower,foveolate,fruit,globose,granular,green,half,immature,inserted,lanceolate,leaf,length,lobe,lower,many,mature,mm,narrowly,nearly,oblanceolate,oblong,ovate,pale,pedicel,peduncle,perfect,persistently,petiole,rough,scabrous,semi-ovate,several,shrub,simple,small,smooth,spaced,sparsely,stellate,stellate-pubescent,stellate-tomentose,stelliform,stem,stigma,style,tan,time,tomentose-pubescent,tree,tube,weakly,white,x,yellow	0.4-1.6,0.6-1.5,1.7-2.9,1/2,10-11,2.3-4.2,2.5-3.3,30-68,4-5,4-6,6-7.5,7-10,absen,accrescent,adaxiall,ag,along,apex,apparently,around,axillary,ba,bark,berry,blade,branch,capitat,completely,conspicuous,coriaceous,covering,cylindrical,decurrent,directed,distally,eaf,edge,eed,ellipsoid,entire,enveloping,farinose,filament,fleshy,free,fruiting,glabrous,hair,hig,large,lateral,lengthening,line,lobed,long,long-attenuate,m.,main,margin,midrib,minute,mostly,multangulat,multangulate,multangulate-pubescent,nflorescence,obovoid,obtuse,older,orolla,ovate-lanceolate,plurifoliate,pore,poricidal,porrect-stellat,porrect-stellate,pubescent,rachi,revolute,ruit,runk,sessile,short-stalked,side,slightly,slit,somewhat,sparse,stellate-pubescen,suture,tamen,terete,testa,thick-stalked,tip,touching,ud,unit,vary,vein,way,whitish,within,ympodial,young	adhesion,arrangement,capitate,colour,form,growth,height,history,inflorescence,life,na,ovary,perennial,plant,position,pubescence,reproduction,rugulose,seed,shape,size,staman,surface,texture
87	wfo-0001026367	success	216	115	67	149	48	0.31	1.2-1.6,acuminate,anther,apex,asymmetric,attenuate,base,black-brown,blade,blue,broadly,close,cm,cordate,deltoid,dense,diameter,entire,eventually,fruit,glabrate,glabrous,globose,green,growth,hair,immature,irregularly,lance,lateral,lavender,leaf,lenticular,lobe,lobed,margin,mm,narrowly,ovate,pedicel,peduncle,pentagonal,petiole,plump,pubescence,pubescent,ray,rotate,rounded,shallowly,shrub,simple,sinuately,stellate,stem,stigma,style,surface,tan,tawny,terminal,thick-chartaceous,tomentose,tube,weakly,yellow,×	.5,0.2–0.5,0.4–0.6,0.4–0.7,0.5–0.7,0.7–1.5,1.8–2.5,10,10–15,10–18,15-20,15–30,1–2,1–3,2.5–4,2–3,2–3.5,2–4,2–4.5,2–5-branched,3–4,3–6,3–7,5-merou,5–7.5,5–9,6–8,7-9.7,7–11,8–10,abaxial,abaxially,acicular,acute,adaxial,adaxiall,adaxially,age,along,alyx,apart,apparently,armed,articulated,ascending,axe,ba,branch,branched,capitat,caudate,center,closely,colored,deeply,densely,denser,directed,distally,dried,eaf,eed,erect,farinose,filament,filiform,finely,flower,geminat,high,homostylous,initially,internode,interpetalar,interwoven,larger,later,lighter,like,little,lon,long,longer,loosely,looser,lower,maturit,midpoint,midvei,midvein,midzone,minutely,mostly,much,near,nflorescence,oblong,often,orolla,overtopped,ovoid,perfect,pitted,plurifoliate,pore,porrect,prickle,principal,ruit,sessile,short,shorter,side,similar,sinus,slightly,small,somewhat,some­what,soon,spaced,sparsely,splitting,spreadin,spreading,spreadingly,stalk,stalked,ste,stellae,stellate-pubescent,stellate-tomentose,tamen,tem,time,tip,tissue,tomento,triangular,turning,ud,unarmed,usually,vary,vein,well-developed,wide,ympodia,–20	0.2-0.5,0.5-0.7,0.7-1.5,1-2,1-3,1.8-2.5,10-15,10-18,2-3,2-4,2-4.5,2.5-4,20,3-4,3-7,5-7.5,6-8,8-10,adhesion,arrangement,calyx,capitate,colour,corolla,form,glandular,height,history,inflorescence,length,life,maturity,na,number,ovary,perennial,plant,position,presence,present,reproduction,rugulose,seed,shape,size,staman,stipe,texture
88	wfo-0001026377	success	155	74	52	103	22	0.335	0,2,2-3,30,5-7,8-13,abaxially,abundant,abundantly,andromonoecious,anther,apex,articulated,base,bright,broadly,brownish,calyx,chartaceous,cm,densely,distinctly,extra-axillary,hair,leaf,mm,narrow,ovate,pale,pedicel,peduncle,petiole,plant,polished,prickle,prickly,pubescent,purple,scattered,shrub,stellate,stellate-pubescent,stem,stigma,straight,style,surface,tapered,triangular,tube,unequal,x	-8,0.5,1,1/5-1/4,12,16,2.5,3,3-,3-5,4,5-6,5-merous,7,7-7.5,abaxiall,acumen,acute,adaxially,along,apica,armed,axe,ba,belo,blade,branched,broad,cell,central,cut,distall,eaf,eed,ending,ermaphroditic,filament,flower,forked,fresh,geminat,hermaphrodite,hermaphroditic,heterostylous,internode,lateral,like,linear,lobe,lon,long,lower,main,mainly,margin,midpoint,midrib,minor,nflorescence,oblique,often,orolla,pore,porrect,prickl,proximal,rachi,ray,reduced,repand,retrorse,rounded,ruit,seen,shallow,sharp,short,side,simple,single,sinus,smaller,sparsely,staminate,stipe,stou,straggly,structure,subcordate,subsagittate,tamen,taminate,tem,tipped,transition,unbranched,unknow,unknown,vary,vein,vestigia,way,ympodial	3-6,abaxial,adaxial,colour,corolla,form,growth,height,history,inflorescence,length,life,ovary,perennial,position,pubescence,reproduction,shape,size,staman,texture,vestigial
89	wfo-0001026379	success	219	127	99	120	28	0.452	-4.5,0.2-0.38,0.2-0.4,0.8-1.2,0.9-1.2,1-1.7,1-10,1-2,1-3.7,1.3-2.1,1.5-2.3,1.7-4.9,1.8-2.6,1.8-3.2,1.9-3.4,13,2-7,2.6-3.7,2/3,3-11,5.3-10.2,8-15,8-29,8.3-10,acute,anther,apart,apex,articulated,attenuate,basal,base,blade,blunt-tipped,brown,calyx,closely,cm,conical,corolla,dark,densely,diameter,dried,entire,finely,fleshy,flower,fruit,globose,granular,gray-brown,grayish,growth,hair,inserted,leaf,length,lobe,long-attenuate,margin,minutely,mm,multangulate-pubescent,oblong,obovate,ovate,pale,pedicel,peduncle,petiole,pitted,plant,porrect-stellate,present,reniform,rich,scabrous,semi-ovate,shrub,simple,size,small,spaced,stellate,stellate-tomentose,stelliform,stem,stigma,style,terete,tomentose-pubescent,tree,tube,velutinous-pubescent,violet,whitish,x,yellow	0.7-1,0.7-2.5,1.8-5,1/2,2-2.8,2.4-5.1,2.9-4,3/4,4-5,4.1-7,50-450,6-10.6,8-13,9-14,abaxially,accrescent,adaxiall,adaxially,ag,along,anthesi,apparently,around,axillary,ba,bark,berry,branch,branched,capitat,chartaceous,completely,covering,cylindrical,dendritic-echinoid,directed,distal,distally,eaf,echinoi,echinoid,echinoid-pubescent,edge,eed,ellipsoid,enveloping,evident,farinose,few-rayed,filament,free,fruiting,glabrous,hig,included,lacking,large,lateral,lengthening,line,lobed,long,lower,m.,main,many,mature,midrib,minute,mostly,multangulat,multangulate,nearly,nflorescence,obtuse,often,older,orolla,ovate-lanceolate,partly,perfect,persistently,plurifoliate,pore,poricidal,pubescen,rachi,rather,recent,ruit,runk,scattered,sessile,short-stalked,side,slit,sometimes,somewhat,sparse,stellate-,stellate-pubescent,suture,tamen,testa,thin,time,tip,translucent,ud,uneven,unit,upper,usually,vary,vein,vestigial,way,whitish-brown,ympodial,young	adhesion,arrangement,capitate,climate,colour,form,glandular,height,history,inflorescence,life,midpoint,na,number,ovary,perennial,position,presence,pubescence,ray,reproduction,rugulose,seed,shape,staman,stipe,surface,texture
90	wfo-0001026388	success	264	103	67	197	36	0.254	0.2-0.6,1-2,1.4,1.5-2,1.6,1.8,8.5,abaxially,acicular,adaxially,anther,armed,attenuate,bilobed,brown,calyx,cm,corolla,diameter,distinctly,erect,extra-axillary,flower,fruit,glabrous,globose,glutinous,green,halfway,inserted,leaf,length,life,light,lobe,minutely,mm,moderately,ovate,ovate-apiculate,pedicel,peduncle,petiole,pilose,plant,prickle,ripe,shape,shrub,simple,size,sometimes,sparsely,stellate,stem,stigma,straight,style,suborbicular,surface,thin-textured,triangular,truncate,tube,x,yellow-orange,yellowish	.2,.5,.7,0.15,0.2–1,0.2–2,0.4–1,0.5–1.7,0.5–2,0.5–4,0.8–1.5,0.8–2.5,1.4–1.6,1.5–2.2,1.5–3.5,108,10–20,12,1–2,1–2.5,1–6,2-foliate,2.5–4,20–,25,2–4,2–4-celled,2–9,3,3.2–3.7,45,4–10,4–5-rayed,4–6-celled,5,5–12,5–20,6,65–145,6–11,6–7,8-13,=,?,abundant,acuminate,acute,adaxiall,always,angle,apar,apex,apiculate,apparent,appearance,ascending,base,becoming,blade,bleaching,branch,bright,ciliate,closely,color,conduplicate,confined,covering,cylindrical,deeply,dense,developing,dilated,directed,distall,divided,division,dried,eaf,eed,enlarged,entire,especially,exceeding,except,exclusive,exserted,filament,first,flowering,folded,forward,free,geminat,geminate,giving,gland,glistening,golden,grading,greenish,hair,hyaline,inside,lanceolate,larger,lateral,least,less,lighter,lobed,lon,long,lower,major,margin,midrib,minute,mostly,much,n,nearly,nflorescence,oblique,often,one,orolla,otherwise,outside,pair,papillat,par,per,plane,pointing,pore,pressing,probably,purple-colored,rachi,ranging,rarely,recurved,reflexed,reported,rip,ruit,scarious,scattered,sessile,shallowly,sideway,similar,single,sinuate,sinus,slightly,small,smaller,somewhat,spaced,spreading,stamen,stellae,stipitate,straw,strongly,sunlight,tal,tamen,tem,thickened,tip,turning,twice,twisted,two,unarmed,unbranched,unicellular,unit,upper,usually,various,variously,vary,vein,viewed,white,whole,wide,wing,yellow,yellow-green,ympodial,±,–8	0.4-1,0.5-1.7,0.5-2,0.8-2.5,1-2.5,1.4-1.6,1.5,10-20,2-9,20-45,3.2-3.7,5-12,5-20,6-7,adhesion,arrangement,colour,form,growth,height,history,inflorescence,na,ovary,papillate,perennial,position,presence,present,pubescence,purple,reproduction,rugulose,seed,staman,texture
91	wfo-0001026397	success	202	122	103	99	19	0.51	0.5-1,1-2,1-3,1-9,1.5-3.5,10-14,10-20,12-15,13-18,2-10,2-2.5,2.5,3-3.5,3-4,3-5,3-9,4-16,5-15,5-8,abaxially,absent,adaxial,adaxially,anther,armed,attenuate,base,brown,bud,chartaceous,cm,connivent,coriaceous,cylindrical,dark,densely,diameter,expanding,extra-axillary,filiform,flower,fruit,functionally,glabrous,glandular,globose,greatly,green,hair,hermaphroditic,immature,leaf,leathery,like,line,lobed,male,many,mature,mm,moderately,nearly,netlike,occasional,orange,ovate,pedicel,peduncle,petiole,pit,plant,porrect-stellate,prickle,pubescent,purple,rachi,raised,recurved,red,reniform,ridge,roselike,rusty,separated,simple,small,sparsely,spreading,stellate,stem,stigma,style,surface,tan,tapering,thick,vine,weakly,white,whitish,woody,x,yellow	0.5-1.5,1,1-.,1-2.5,1-6,1.5,1.5-3,12-16,2-5,4-8,5,5-merou,50-100,6-10,8-20,absen,accrescent,acute,alyx,andromonoecious,anthesi,apar,apex,apical,asymmetrical,axe,berry,beyond,blade,calyx,cordate,difoliate,directed,discolorous,eaf,eed,either,em,entire,exserted,filament,flattened,frui,fruiting,geminate,glabrou,gree,greem,heteromorphic,introrsel,lobe,long,long-styled,lower,major,margin,midpoint,midrib,midvein,multicellular,multiseriate,narrowly,nflorescence,obscure,obtuse,often,older,orolla,pair,per,pore,present,ray,reflexed,ruit,secondary,short-and,side,siz,slightly,spaced,stalk,stamen,ste,straight,tamen,triangular,tube,unarmed,unbranched,unequal,unicellular,unit,usually,vary,vein,wide,ympodial,young	1-4,5-merous,armature,arrangement,colour,corolla,form,growth,height,inflorescence,length,ovary,position,pubescence,seed,shape,size,staman,texture
92	wfo-0001026400	success	187	108	79	108	29	0.422	0.2-0.8,0.4-1,0.5-1.2,1.7-2.2,13-30,2-8,3.4-4.8,30-55,4-7,5-7,6-13,6-15,6.5-20,8-12,9-13,abaxially,adaxially,anther,axillary,blue,brownish,bud,clavate,cm,condition,connivent,coriaceous,corolla,dark,deep,diameter,drying,elliptic,finely,fresh,fruit,glabrescent,glabrous,globose,green,greenish,hair,herb,lanceolate,leaf,light,lilac,linear,lobe,mm,moderately,odd-pinnate,ovate,ovoid,pedicel,peduncle,pentagonal,petiole,plant,puberulent,pubescent,purple,ripe,seed,semi-stellate,short,simple,size,stigma,stripe,style,subtending,terminal,tip,tube,white,whitish,x,yellow	0.5-1,0.7-1.1,1-10,1-2,1.3-2.6,10-18,10-28,12-27,2-6,2.4-5.9,3-6,3.5-5.9,5-merou,acumen,acuminate,acute,adaxiall,ag,alyx,apart,apex,apparently,articulated,asymmetric,attenuate,axe,base,basiscopic,berry,blade,capitat,cell,covering,decreasing,decurrent,digestion,distal,dorsally,eaf,edge,eed,enzyme,erec,exceeding,filament,flat,flower,folded,forked,geminat,generally,glabrou,gree,green-white,hair-like,hal,half,high,homostylous,honeycomb-shaped,interjected,lateral,leaflet,lengthening,living,long,lower,make,mucilaginous,nflorescence,orbicular,orolla,pair,perfect,petiolulate,plurifoliate,pore,poricidal,removed,rounded,ruit,sessile,seudostipule,side,slightly,slit,spaced,specimen,stamen,straight,subequal,tall,tamen,tem,testal,thick,throughout,tissue,toward,tri-,typically,unit,unwinged,usually,vary,wall,wet,ympodial	abaxial,adaxial,adhesion,arrangement,calyx,capitate,colour,form,growth,height,hermaphroditic,history,inflorescence,length,life,na,ovary,perennial,position,pseudostipule,pubescence,reproduction,rugulose,shape,staman,stem,surface,texture,ye
93	wfo-0001026406	success	219	115	89	130	26	0.406	-1,.2,.5,0.3-0.5,0.4-0.8,0.5-1.5,1-2,1/3,1/4,12-19,2-2.7,2.5-8,2.9-3.2,3-10.5,3.2-3.8,5-25,6-12,7-10,7-8,9-15,abaxially,acute,anther,apex,base,blade,broad-deltate,calyx,chartaceous,cm,connivent,cordate,cream,dark,densely,diameter,equal,flattened-reniform,fruit,glabrous,green,herb,lateral,leaf,length,lobe,lobed,long,lower,margin,marking,maturity,mauve,midpoint,midvein,mm,moderately,oblong,obtuse,orange-brown,ovate,pale,pedicel,peduncle,petiole,plant,poricidal,prickly,purple,ray,red-brown,shrub,sparsely,spherical,stellate,stellate-pubescent,stem,stout,style,tapering,terminal,tip,tube,upper,velvety,white,wide,yellow,young	0,0-3,0-30,0-5,0.3,0.3-0.7,0.4-0.9,0.5,0.5-2.5,0.8,00-200,1,1.3-1.5,1.5-2,1.5-5,1.8-2.4,1/,1/4-1/2,1/4-1/3,10-30,2-3,2-6,20-60,3-4,30-60,5,5-50,5-6,5-7,5-8,5-merous,6-15,6.5-7,7-9,abaxial,adaxial,adaxially,alyx,ame,andromonoecious,apar,apart,apically,apparently,articulated,bark,berry,branched,c.,conical,curved,deltate,dirty-whitish,discolorous,distal,distance,drying,eaf,eed,elongated,elongating,erect,extending,filament,flattened,flower,foliaceous,free,fruiting,fully,gently,hermaphrodite,heterostylous,infructescence,least,lon,long-styled,longer,lowermost,mature,nflorescence,older,one,open,opening,orolla,oung,pair,pendent,pendulous,per,pericarp,plurifoliat,porrect,portion,prickl,prickle,primary,reflexed,rounded,ruit,scar,sessile,short-styled,side,smooth,sometimes,spaced,spreading,stalk,stalked,staminat,straight,surface,tamen,terete,tertiary,time,trichome,unit,variously,vary,vein,venation,visible,way,weakly,woody,yellow-brow,ympodial	adhesion,arrangement,climate,colour,corolla,form,glandular,growth,hair,height,inflorescence,na,number,ovary,position,presence,present,pricklines,pubescence,seed,shape,size,staman,stigma,stipe,texture
94	wfo-0001026407	success	221	132	101	120	31	0.457	-11,-6,.5,/3,0.5-0.6,0.5-2,0.9-3,1.2-1.5,1.3,1.5-1.7,1.5-2,1.5-7,2-2.5,2.5-3,3.5,4-5,5,5-10,7-8,abaxially,acute,adaxially,anther,apex,basal,base,becoming,berry,black,brown,brownish,calyx,capitate,chartaceous,cm,conical,corolla,deep,deltate,dendritic,densely,diameter,ellipsoid,elliptic,entire,erect,flattened-reniform,fleshy,glabrous,globose,golden,golden-pubescent,growth,inflorescence,internodal,lateral,lax,lobe,lobed,margin,markedly,membranous,minutely,mixture,mm,narrowly,oblique,occasionally,pale,papillate,pedicel,peduncle,petiole,pubescence,pubescent,purple,purplish,reddish,revolute,ripe,shiny,short,shrub,simple,slightly,stellate,stem,stiff,stigma,style,surface,terminal,trichome,truncate,tube,vine,violet,way,woody,x,yellow	+,0.5,0.5-1,1,1-1.2,1-10,20-30,20-40,3.5-5.5,5-7,5-merou,7-10,ag,aid,along,always,alyx,anthesi,apart,appearing,area,ark,around,articulated,axi,beneath,berr,blunt,branch,branched,broadly,cell,clear,climbin,congested,connivent,dense,denser,discolorous,eaf,eed,evenly,exserted,filament,flower,free,fruiting,geminat,glabrescen,glabrou,ilament,interpetalar,irregularly,lamina,leafy,leaving,lengthening,like,long,loosely,lower,many,midvein,near,new,nflorescence,numerous,obscured,often,older,open,orolla,outline,pair,paler,papillat,pedice,peg,pentagonal,per,perfect,pericarp,persistent,pitted,planar,plurifoliate,pore,poricidal,portion,primary,pubescenc,ruit,scar,sinus,sleeve,slit,small,spaced,sparsely,sparser,spreading,stout,strongly,tangled,tem,testal,thin,time,tip,transition,twining,ud,undulate,unit,upper,usually,vary,vein,weak,ympodial	adhesion,arrangement,blade,climate,colour,form,fruit,glandular,hair,height,history,leaf,length,life,midpoint,na,number,ovary,perennial,plant,position,presence,ray,reproduction,rugulose,seed,shape,size,staman,stipe,texture
95	wfo-0001026422	success	273	110	69	204	41	0.253	0.04,0.2,10,3.5,6.8,7.6,8.4,acuminate,acute,adnate,anther,apex,apiculate,base,blade,calyx,capitate,chartaceous,cm,corolla,cuneate,deltoid,densely,diameter,elliptic,entire,extra-axillary,flattened-irregular,flattened-reniform,flower,fruit,glabrous,glandular,globose,green,hair,lanceolate,lateral,length,lobe,margin,mm,moderately,nearly,ovate,pedicel,peduncle,petiole,pubescence,pubescent,ray,red-brown,rounded,shrub,simple,sinuate,stellae,stellate,stem,stigma,style,tip,truncate,tube,unarmed,white,yellow,yellow-tan,yellowish-green	.0,.04,.3,.6,.7,.9,/3,0.06,0.08,0.1–0.5,0.2–0.4,0.3–0.5,0.3–0.7,0.4–1.3,0.4–2.4,0.6–0.9,0.6–1.1,0.6–2.0,0.7–0.8,0.7–1.6,0.8,0.9–1.5,0.9–1.9,0.9–7.5,1.0,1.0–1.9,1.1–1.4,1.2–2.8,1.3–2.2,1.6–1.9,1.6–2.2,1.7–2.4,1.8–2.2,1.8–2.3,1/2–2/3,1/3,1/3–2/3,13.2–27.8,1–3,2.0–3.2,2.2–14.0,2.8–4.2,3.5–4.5,3.8–4.8,4.7,4–8,5-merou,5.0,5.8–7.4,5.8–8.3,56,5–7,6–8,7.7–9.2,7.8–26.9,abaxially,absent,adaxially,aequilateral,ag,alveolate,alyx,anthesi,apart,apical,apparently,appearing,appresse,around,articulate,attenuate,axe,ba,bark,basal,becoming,bent,berry,borne,branch,branching,broad,brochidodromous,bud,channeled,cream,darker,deciduous,dentate,development,difoliate,directed,distal,distally,distinct,dry,eaf,edge,eed,either,emerging,endocarp,erect,especially,evenly,exocarp,extending,fertile,filament,filiform,free,geminat,glossy,gradually,gray-brown,gree,homostylous,immature,increasing,individually,intact,internode,interpetalar,intersepalar,juic,layer,light,lon,long,longer,lower,many,many-flowered,mature,midpoint,midrib,midvein,minute,much,nflorescence,oblique,oblong,observed,occasionally,orolla,ove,per,perforated,pore,porrect,porrect-stellae,portion,potentially,presumably,raised,reflexed,remaining,rigid,row,ruit,scarcely,sessile,short-stipitate,side,sinus,sloughing,smoot,soon,sparsely,splitting,spreading,stamen,stellate-pubescent,stipe,straight,stripe,surface,suture,tamen,tardily,tem,thin,time,tissue,translucent,transparent,two,typically,ud,unbranched,upper,various,vary,vein,weakly,well-developed,wide,yellow-ferruginous,ympodia,young,±congested,±erect,×,–5	0.1-0.5,0.3,0.3-0.7,0.4-1.3,0.4-2.4,0.6,0.6-1.1,0.6-2.0,0.7-0.8,0.7-1.6,0.9-1.5,0.9-1.9,1.3-2.2,1.6-1.9,1.8-2.3,13.2-27.8,2.2-14.0,3.5-4.5,4-8,5.8-7.4,6-8,7.8-26.9,adhesion,arrangement,colour,form,growth,height,inflorescence,leaf,number,ovary,plant,position,presence,present,seed,shape,size,staman,texture
96	wfo-0001026424	success	138	84	43	95	41	0.312	1-1.5,1.5-2,10-15,15,15-30,3-4,acuminate,acute,apex,axil,base,bluntly,blush-violet,broadly,calyx,campanulate,cm,corolla,cuneate,distinct,elliptic,fork,glabrous,glandular,hair,leaf,lobe,minute,mm,oblique,obovate,pedicel,peduncle,petiole,pinnatisect,rotate-stellate,shrub,simple,stem,triangular,unwinged,usually,x	-25,-3.5,-4,0.75-1.5,1,1-,1-10,1-2,10,12-60,2,3-11,637/1,8-,acuman,acumen,age,angular,anthesi,aspect,ba,becoming,blunt,broad,cell,clonal,close,common,conspicuous,cut,cyme,dia,downard,eaf,ellipsoid,erect,exceeding,except,exerted,facetted,facing,floral,flower,forked,general,gree,growing,interacuminal,lacking,lanceolate,lanceolate-elliptic,larger,lasting,lavender,line,lobed,lon,long,lower,midvein,nflorescence,often,part,pedicellate,plurifoliat,point,rachi,raised,rarely,rh,rounded,scorpioid,second,several,shallowly,short,sinus,slightly,soft-wooded,soon,stone,straggly,time,tip,tissue,toward,tub,ud,unit,violet,within,woody,year,ympodial,young	1-4,adhesion,anther,arrangement,blade,climate,colour,diameter,form,fruit,green,growth,height,history,inflorescence,length,life,margin,midpoint,na,number,ovary,perennial,plant,position,presence,pubescence,ray,reproduction,rugulose,seed,shape,size,staman,stellate,stigma,stipe,style,surface,texture,tube
97	wfo-0001026440	success	181	126	101	80	25	0.558	1-5,1.1-1.4,1.3-1.7,1.5-2.1,1.9-3.7,1/2,1/2-2/3,14-30,2-2.8,2-4,2.9-4.4,3-5,3-7,3-8,3/4,4-12,7-14,9,abaxially,acute,adaxially,along,anther,apex,articulated,basal,base,blunt-tipped,branched,broadly,brown,calyx,chartaceous,closely,cm,conical,corolla,diameter,distal,elliptic,entire,flower,globose,granular,green,greenish-yellow,hair,inserted,leaf,length,lobe,lobed,long-attenuate,many,margin,minute,minutely,mm,multangulate,multangulate-pubescent,nearly,oblong,obovate,obtuse,ovate,pale,pedicel,peduncle,perfect,persistently,petiole,pitted,porrect-stellate,reniform,ripe,scabrous,semi-ovate,sessile,short-acuminate,short-stalked,shrub,simple,size,small,spaced,stellate,stem,stigma,style,terete,time,tomentose,tomentose-pubescent,tree,truncate,tube,turning,way,white,x,yellow	0-15,1.1-1.5,1.8-4.5,3.9-6.5,5-7,accrescent,adaxiall,ag,always,anthesi,apparently,appressed,axillary,ba,bark,berry,blade,bract-like,branch,branche,capitat,dendritic-echinoid,dense,developed,dichotomy,directed,distally,eaf,echinoi,echinoid,eed,filament,first,fleshy,free,fruiting,high,included,large,lengthening,long,lower,m.,mostly,multangulat,nflorescence,obovoid-oblong,obscure,often,older,openly,orolla,pair,plurifoliate,pore,poricidal,pubescen,rather,ruit,runk,slit,sometimes,somewhat,sparse,stellate-pubescent,suture,tamen,testa,thick,thin,tip,tomentum,translucent,ud,uneven,unit,usually,vary,ympodial,young	adhesion,arrangement,capitate,colour,form,fruit,growth,height,history,inflorescence,life,na,ovary,perennial,plant,position,pubescence,pubescent,reproduction,rugulose,seed,shape,staman,surface,texture
98	wfo-0001026441	success	197	129	104	93	25	0.528	0.3-0.7,1-1.5,1-2,1.5-2,1.5-2.5,10,15-20,2-2.5,2-8,4-6,4-8,4-8.5,4.5-6.5,5,5-10.5,7-20,7-8,abaxially,acuminate,adaxially,anther,apex,articulated,attenuate,axillary,base,berry,brownish,bud,cell,chartaceous,ciliate,cm,condition,conical,corolla,covering,diameter,distal,drying,elliptic-lanceolate,exceeding,fresh,fruit,glabrous,green,green-white,greenish,hair,hair-like,herb,lanceolate,lateral,leaf,leaflet,light,like,lobe,long,make,margin,middle,minute,minutely,mm,mottled,mucilaginous,obtuse,odd-pinnate,ovate,ovoid,pale,pedicel,peduncle,petiole,plant,puberulent,pubescent,purple,ripe,rotate,rounded,seed,size,slightly,sparsely,stamen,stem,stigma,style,subtending,terminal,testal,thick,throughout,tube,usually,violet,wall,wet,whitish,wide,x,yellow	.5,0-2,0.4-3,0.5-1.5,0.8,1-10,10-14,2-5.5,3-5,5-merou,6-15,9-14,absent,acumen,ag,alyx,apart,apparently,axe,blade,capitat,connivent,decreasing,digestion,dorsally,eaf,edge,eed,end,enzyme,equal,erec,especially,filament,flat,flower,folded,forked,fourt,geminat,generally,glabrou,gradually,half,homostylous,honeycomb-shaped,interjected,internal,larger,lengthening,living,lower,narrow,nflorescence,one,orbicular,orolla,pair,perfect,petiolule,placed,plurifoliate,pore,poricidal,removed,ruit,secondary,semierect,seudostipule,short,slit,spaced,specimen,star,ste,stolo,straight,subequal,subsessile,symmetrical,tall,tamen,tem,tip,toward,tri-,tuber,typically,unit,vary,white,wing,ympodial	adhesion,arrangement,calyx,capitate,colour,form,fourth,growth,height,history,inflorescence,length,life,na,ovary,perennial,position,pseudostipule,pubescence,reproduction,rugulose,shape,staman,surface,texture
99	wfo-0001026453	success	211	111	82	129	29	0.389	0.1-2.7,0.5,0.5-0.7,0.5-1,0.8-1.1,1-1.5,1-2,1.5-2,1.9-21.3,15,2-2.5,4m,5.5-8,6-8,7-9,acuminate,acute,almost,anther,apex,attenuate,base,bright,brown,calyx,capitate,cm,conical,corolla,deltate-triangular,diameter,elliptic,entire,flattened,glabrous,globose,growth,inflorescence,lateral,leaf,length,linear,lobe,margin,midpoint,minutely,mm,narrowly,pale,pedicel,peduncle,petiole,poricidal,porrect,pubescence,ray,red,reddish,reniform,sessile,shiny,shrub,simple,small,stellate,stem,stigma,strongly,style,surface,tan,tapering,thin,tip,tree,triangular,trichome,tube,violet,white,x,yellowish	.5,0.45-5.5,1,1-1.2,10-20,2,30,5-32,6-10,6376,<,abaxially,aberrant,absent,adaxial,adaxially,along,anthesi,apart,armed,articulated,axi,bark,basal,based,beneath,bent,berry,branched,broad,cell,deflexed,dense,densely,denser,directed,distall,distally,eaf,easily,eed,enlarged,enmeshing,equal,evenly,exceeding,exserted,filament,filiform,flower,free,fruiting,glabrescent,grayish,hanging,howard,internode,irregularly,lamina,lengthening,less,like,lobed,long,lower,maturity,midrib,midvein,nearly,new,nflorescence,oblique,occasionally,often,older,one,open,opposite,orange,outline,pair,papillo,parallel,per,perfect,pericarp,pitted,plurifoliat,pore,portion,prickle,primary,pubescent,rest,rounded,ruit,scar,scattered,shallowly,shorter,side,sinuate,slightly,slit,smaller,sometimes,somewhat,sorter,spaced,sparse,sparsely,sparser,spreading,straight,surfac,tangled,testal,time,trunk,ud,unarmed,unit,upper,usually,vein,visible,weak,within,ympodial	adhesion,arrangement,blade,climate,colour,form,fruit,glandular,hair,height,hermaphroditic,history,life,na,number,ovary,perennial,plant,position,presence,present,reproduction,rugulose,seed,shape,size,staman,stipe,texture
100	wfo-0001026460	success	131	109	71	60	38	0.542	.1,0.5-1.5,1-1.5,1.5-2,13.5-21,2.5-3,4.5-5,6-7,6-9,7-9,abaxially,acute-acuminate,adaxially,anther,apex,base,becoming,branched,brown,calyx,capitate,cm,completely,conical,corolla,dark,deltate,dia,elliptic,floccose,glabrous,globose,green,greenish,inflorescence,internodal,leaf,less,lobe,lobed,minutely,mm,nearly,often,opposite,ovary,ovoid-reniform,papillose,pedicel,pitted,pore,poricidal,puberulent,reddish,shaped,shrub,somewhat,soon,stem,stigma,style,subshrub,surface,tear-drop,tiny,tip,trichome,tube,white,x,yellow	.5,1/2,10-15,2-2.5,5,513,8-10,acut,anthesi,axi,berry,closely,deflexed,distal,do,drying,eaf,edicel,eed,erect,fide,filament,filiform,flower,free,frui,fruiting,inflorescenc,like,long,long-exserted,lower,major,membraneous,middle,nflorescence,older,pair,pale,papillo,portion,reddish-brow,reflexed,ruit,santo,scar,simple,slightly,spaced,tall,tapering,tub,ud,unifoliat,unit,vein,widest,woody,ympodial,young	acute,adhesion,arrangement,blade,climate,colour,diameter,form,fruit,glandular,growth,hair,height,history,length,life,margin,midpoint,na,number,peduncle,petiole,plant,position,presence,pubescence,ray,reddish-brown,reproduction,rugulose,seed,shape,size,staman,stellate,stipe,texture,unifoliate
101	wfo-0001026485	success	188	112	80	108	32	0.426	-35,.25,0.25-1,1-10,1-2,1-2.5,1-4,2,2-6,2.3-5,2.5-5,20-30,3-25,3-4,3-6,3-7,3.5-7,4.5-9,5-7,6-9,abaxially,acute,adaxially,andromonoecious,anther,apex,attenuate,base,blade,bright,brown,calyx,cm,compound,connivent,diameter,entire,flattened,flower,fruit,glabrous,globose,greenish-white,inflorescence,leaf,light,lobe,long-attenuate,margin,mm,oblique,obovoid,opposite,orange,ovate,pair,pedicel,peduncle,perennial,petiole,plant,puberulent,pubescent,pyriform,rarely,reflexed,ripe,simple,sparsely,spreading,stellate,stigma,strongly,style,surface,tapering,truncate,tube,x,yellow	-1.5,-22,1.5,1.5-5,10-20,10-25,2-3,2-4,20-40,20-50,4-9,45,5-20,5-merou,6-10,7-15,abaxiall,absen,accrescen,aggregate,alyx,apart,appearing,armed,articulated,axe,broadly,chartaceous,congested,cylindrical,developing,difoliate,directed,distall,dr.,eaf,eed,elliptic,elongating,even,fertile,filament,forked,foveolate,fruiting,geminat,glabrou,heterostylous,hollow,imparipinnate,internode,lanceolate,lateral,leaflet,leaving,like,long,lower,lowermost,major,midvein,narrowly,nearly,nflorescence,occasionally,one,orolla,per,pore,prickle,rachi,recurve,recurved,robust,rugose,ruit,scandent,scar,side,slightly,small,sometimes,spaced,speciman,straight,subcoriaceous,subopposite,swollen,tamen,tem,thickened,time,tip,tissue,tone-cell,toward,triangular,trichome,truncat,unbranched,unit,usually,vary,vein,vin,wide,winged,ympodial	adhesion,arrangement,climate,colour,corolla,form,glandular,growth,hair,height,history,length,life,midpoint,na,number,ovary,position,presence,pubescence,ray,reproduction,rugulose,seed,shape,size,staman,stem,stipe,texture,vine,ye
102	wfo-0001026489	success	153	102	68	85	34	0.444	0.5-1,0.5-2,0.8-1.2,0.8-1.3,0.8-3.7,1-1.5,1.5-5,2-3,2-4,2-5,2.5-13,2.5-4,2/3,5-6,acute,along,anther,apex,area,axil,base,beneath,branched,broadly,brown,calyx,cm,corolla,cup-shaped,dark,deltoid,dia,elliptic,flattened-reniform,glabrous,globose,green,leaf,lobe,lobed,margin,minutely,mm,opposite,ovary,pedicel,petiole,pitted,poricidal,pubescent,shiny,shrub,simple,size,stem,stigma,style,surface,tip,trichome,tube,uniseriate,vein,way,white,whitish,widened,x	.3,0.05-0.1,0.25-0.5,0.5,0.5-0.75,0.6-1.4,1.3-3,2-8-flowered,8-13,anthesi,appearing,ba,bark,berry,closely,deflexed,densely,differing,difoliate,dry,eaf,edicel,eed,erect,exserted,extending,filament,flattened,fleshy,free,fruiting,geminat,gra,incrassate,lamina,later,lateral,lon,long,lower,main,major,middle,minor,nflorescence,occasionally,often,older,one,overlappin,pair,paler,papillo,papillose,parallel,perpendicular,planar,pore,portion,prominent,red-papillose,rhachi,ruit,scar,shaped,slender,somewhat,soon,spaced,specimen,straight,strongly,tall,tapering,tear-drop,terminal,thickened,tub,ud,unit,usually,widest,woody,ympodial,young	adhesion,arrangement,blade,climate,colour,diameter,form,fruit,glandular,gray,growth,hair,height,history,inflorescence,length,life,midpoint,na,number,peduncle,plant,position,presence,pubescence,ray,reproduction,rugulose,seed,shape,staman,stellate,stipe,texture
103	wfo-0001026490	success	272	125	107	165	18	0.393	.5,0.1–0.2,0.1–2.5,0.5–1,0.5–8,0.8–1.5,0.8–12,1.5–2,1.5–3.5,10–20,1–1.2,1–2.5,1–3,2.5–3.5,2–2.5,2–4,3,3–4.2,3–4.5,5–7,7-pinnate,7–15,abaxially,adaxially,along,anther,apex,axillary,brown,calyx,chartaceous,cm,connivent,corolla,covered,crisped,cylindrical,darker,densely,diameter,ellipsoidal,extra-axillary,flattened,flower,fruit,glabrous,green,immature,incurved,inflorescence,leaf,length,lenticular,light,lobe,long,lower,main,mature,medium,middle,midvein,mm,moderately,mottled,oblong,obtusely,orange,ovate-lanceolate,papillose,pedicel,peduncle,pentagonal,petiole,pointed,pubescence,pubescent,rounded,seed,shape,shoot,short,simple,size,slightly,sometimes,sparsely,spur,stem,stigma,striping,style,surface,tawny,teardrop-shaped,terminal,tip,transparent,trichome,tube,vine,violet,white,yellow,½,×,–4.5	0.2–1,0.2–1.5,0.3–3.5,0.4–0.8,0.5–1.5,0.5–3.5,0.7–3,1.2–8,1.5,1.5–5,1.8–2.2,1.9,1–15,1–8,2,2–6,2–8,3–5,3–5-pinnate,3–8,4.6,4–4.5,4–5,5-merous,6,7,=,[,],absent,accrescent,acuminate,acute,ag,alyx,anthesi,apart,apical,apicall,apparently,around,articulated,axe,ba,base,becoming,blade,bract,bracteate,branched,broadly,capitat,cauline,ciliate,climbing,commonly,completely,contiguously,cordate,decreasing,directed,distal,distally,eaf,eed,eglandular,elliptic,entire,equal,exceeding,expanded,filament,flat,free,fruiting,fused,geminat,ground,interjected,irregularly,lacking,large,lateral,latrorse-introrse,leaflet,lobed,longitudinal,lowermost,lunate,margin,markedly,match,mean,mean=,minute,multicellular,near,nearly,nflorescence,node,obliqu,oblique,obliquely,oblon,obtuse,occasionally,one,opening,orolla,ovate,pair,part,per,perfec,perfect,petiolule,plurifoliate,pore,present,pseudostipule,pubescen,punctate,pur,rachi,radial,reflexed,reniform,resulting,revolute,rooting,ruit,sand,seudostipule,shorter,similar,slender,slit,smaller,smooth,somewhat,spaced,stamen,striation,strongly,tamen,tem,thickened,toward,trailing,trichomessympodial,truncate,typically,unbranched,undulate,unit,vary,vegetation,wide,wing,woody,yellowish-tan,youn,–4,–8,–9.5	adhesion,arrangement,capitate,colour,form,growth,height,na,ovary,plant,position,presence,reproduction,rugulose,staman,stellate,texture,young
104	wfo-0001026491	success	165	118	81	84	37	0.491	.5,1-2,1.5-2,1.5-2.5,1.5-3.5,1.7,2.5-3.5,3,3-pinnate,5-6,5-8,6-8,abaxially,acuminate,acute,adaxially,anther,apex,articulated,base,blade,broadly,cellular-papillose,central,cm,crinkly,cuneate,deep,deltoid,diameter,elliptic-lanceolate,entire,equal,glistening,globose,green,hair,inflorescence,lanceolate,leaf,light,lobe,margin,middle,minutely,mm,oblong-elliptic,obtuse,often,ovate,ovate-elliptic,ovoid,pale,pedicel,peduncle,petiole,present,pubescent,purple,rotate-pentagonal,rotate-substellate,rounded,row,sharp,shortly,shrub,simple,spotted,stigma,straight,strigose,subacute,suborbicular-ovate,surface,tawny,tip,tube,white,whitish,x,yellow	1,10-50,1977,2-3,2-4,2-celled,5-merou,7-8,abaxiall,absent,alyx,anderson,apparently,appressed,averaging,axe,ba,bayonet,bent,berry,bract,branched,branching,capitat,cellular-pilose,connivent,conspicuously,deciduous,densely,directed,distall,eaf,eed,filament,first,flower,geminat,greatly,growing,highly,homostylous,interjected,lateral,leaflet,less,long,lower,lunulat,mean,near,nflorescence,orolla,perfect,pilose,plurifoliate,point,pore,poricidal,porrect-incurved,rachi,rarely,readily,reduced,ruit,scandent,seudostipule,similar,slender,small,strigo,strong,strongly,tal,tamen,tem,terminal,tightly,tyle,uniseriate,unit,upright,usually,ventral,ympodial	adhesion,arrangement,calyx,capitate,climate,colour,corolla,distally,form,fruit,glandular,growth,height,history,length,life,midpoint,na,number,ovary,perennial,plant,position,presence,pubescence,ray,reproduction,rugulose,seed,shape,size,staman,stellate,stem,stipe,style,texture
105	wfo-0001026501	success	195	120	88	107	32	0.451	-1.7,.6,/3,0-1,0.05-0.3,0.27-0.7,0.5-0.6,0.5-0.9,0.5-1,0.6-1.1,0.6-2,0.9-2.2,1-2,1-2.5,1.8-2.2,1/4,2.5-4,2.8-3,3.5-4,6-9,7-9,?,abaxially,acute,anther,apex,apically,base,berry,blade,brown,calyx,chartaceous,cm,cuneate,deltate,densely,diameter,dull,elliptic,entire,flattened-reniform,fruit,glabrous,gray,green,leaf,length,light,lobe,lobed,long,margin,mauve,midpoint,mm,moderately,orange-brown,orbicular,ovate,pale,pedicel,peduncle,petiole,poricidal,ray,rounded,shoot,short,shrub,simple,sparsely,spherical,spreading,stellate,stellate-pubescent,stem,style,surface,tapering,terminal,tip,tube,upper,way,white,wide,yellow	-3,.1,.35,.5,.7,0,0-2,0.1,0.2-1.8,0.5,0.6-1,1,1/2-2/3,1/6-1/2,2-10,3-4,3-5,3-9,4-5,4-7,5-merous,acicular,almost,alyx,apar,apart,apparently,articulated,bark,becoming,borne,branched,brown-green,color,concolorous,curved,discolorous,drying,eaf,eed,elongated,elongating,equal,erect,eye,filament,filiform,filiform-acuminat,flattened,flower,free,fruiting,glabrou,infructescence,known,longer,lower,mature,naked,nflorescence,often,older,one,open,orolla,oung,pair,pendulous,per,perfec,pericarp,plurifoliat,porrect,portion,prickl,prickle,prickly,primary,reddish,ruit,scandent,scar,sessile,shorter,slender,small,smooth,sometimes,somewhat,spaced,stalk,stalked,straight,subsessile,tamen,terete,time,trichome,unarme,unarmed,unit,variously,vary,vein,visible,yellow-green,ympodial	adhesion,arrangement,climate,colour,corolla,filiform-acuminate,form,glandular,growth,hair,height,history,inflorescence,life,na,number,ovary,perennial,perfect,plant,position,presence,pubescence,reproduction,seed,shape,size,staman,stigma,stipe,texture,ye
106	wfo-0001026503	success	269	144	128	141	16	0.476	.3,.9,0.3–,0.3–0.6,0.4–1.2,0.6–0.7,0.6–1.0,0.7,0.7–3.7,0.8–1.1,0.8–1.7,0.8–3.5,1.0–1.6,1.0–3.5,1.1–1.4,1.3–1.6,1.9–5.5,1/3,2.2–2.5,2.2–2.8,2.2–6.3,2.6–2.9,3,3.0–4.5,4.0–12.0,8.2,9.0–1.0,abaxially,acuminate,acute,adaxially,adnate,aequilateral,anther,anthesi,apex,apiculate,attachment,attenuate,bark,base,blade,brown,calyx,capitate,chartaceous,cm,corolla,developed,diameter,dry,eglandular,entire,extra-axillary,flattened-orbicular,flattened-reniform,flower,fruit,glabrous,glandular,globose,green,hair,internode,interpetalar,lacking,lanceolate,lateral,layer,leaf,lobe,long,margin,mature,minute,mm,moderate,moderately,nearly,notched,oblique,oblong,ovate,pale,pedicel,peduncle,petiole,point,pubescence,pubescent,red,red-brown,reddish,rotate-stellate,rounded,scarcely,scattered,short,shortly,shrub,simple,sinuate,sloughing,small,sparse,sparsely,stellate,stem,stigma,stipitate,straight,style,subacute,tip,tissue,transparent,tree,truncate,tube,upper,well,white,yellow,yellow-ferruginous,yellow-tan,yellowish,young,×	.5,.6,0.03,1.0–1.5,1.3,1.3–3.7,1.4–1.7,1.4–2.3,1.5–1.8,1.5–2.0,1.5–2.5,1.7,1/3–1/2,1/4–1/3,2.3–2.6,22,2–3,4.7,4.8,4.9–5.8,5,5-merou,5.0,6.0,6.9–10.3,7–10,90°,ag,always,alyx,apart,apical,apparently,appearing,arching,around,articulate,axe,ba,becoming,bent,berry,branch,branching,brochidodromous,bud,central,channeled,deltoid,dentate,depression,development,difoliate,directed,distal,distally,eaf,edge,eed,either,emerging,endocarp,exocarp,extending,fertile,filament,filiform,flattened,flexed,free,geminat,glabrou,glossy,gradually,gree,homostylous,increasing,intact,intersepalar,irregularly,juic,lackin,lon,lower,lying,major,many,midrib,midvein,minor,near,nflorescence,obviously,ocasionally,occasionally,opaque,orolla,outline,oval,per,perforated,pore,portion,potentially,present,raised,reflexe,remaining,rigid,row,ruit,shallow,side,sinus,slightly,smoot,spaced,splitting,spread,spreading,stamen,surface,suture,tamen,tem,thin,though,time,two,ud,unarmed,usually,vary,vein,weakly,wide,without,ympodia,±equal,±smooth,±straight	adhesion,arrangement,colour,form,growth,height,inflorescence,length,ovary,plant,position,seed,shape,size,staman,texture
107	wfo-0001026513	success	138	88	50	88	38	0.362	0.8-2,1-1.5,1-3,2-5,3-5,4-5,6-8,8-16,acute,anther,apex,base,broadly,calyx,cm,corolla,deltoid,dia,elliptic,flower,fruit,glabrous,globose,green,lanceolate,leaf,lobe,lobed,long-styled,mm,opposite,ovary,papillose,pedicel,petiole,plant,shaped,short-styled,shrub,slender,small,stem,stigma,style,surface,tear-drop,treelet,tube,white,x	.1,.25,.3,.75,/3,2-2.2,3-6-flowered,7-9,anthesi,apiculate,area,ba,bark,berry,caly,closely,completely,darkish,decurrent,deflexed,delicate,differentiated,dry,eaf,edicel,eed,erect,except,exserted,filament,free,fruiting,gre,hirsute,immature,known,lateral,leave,less,live,long,longer,lower,main,mature,middle,minute,minutely,much,nflorescence,obscure,older,overlappin,pair,pale,pore,poricidal,portion,prominent,raised,reflexed,rest,ruit,scar,shiny,simple,somewhat,soon,spaced,specimen,straight,styl,tall,tip,trichome,ud,undersurface,unifoliat,uniseriate,unit,vein,venation,way,wide,widest,woody,ympodial,young	0.25,0.3,1,3,adhesion,arrangement,blade,climate,colour,diameter,form,glandular,growth,hair,height,history,inflorescence,length,life,margin,midpoint,na,number,peduncle,position,presence,pubescence,ray,reproduction,rugulose,seed,shape,size,staman,stellate,stipe,texture,unifoliate
108	wfo-0001026529	success	219	106	80	139	26	0.365	0.3-1,0.5-4.5,1-2,1.1-2.5,1.5-2.5,10-28,11-14,12-22,120-210,3-5,3-9.5,4-8,5-15,5-9,6-20,?,abaxially,adaxially,anther,attenuate,blue,brownish,chartaceous,clavate,cm,condition,corolla,creamy,dark,deep,densely,diameter,drying,faintly,fresh,fruit,glabrous,globose,green,greenish,herb,lanceolate,length,lilac,lobe,long,medium,membranous,minutely,mm,moderately,odd-pinnate,orbicular,ovate,ovoid,pedicel,peduncle,pentagonal,petiole,plant,puberulent,pubescent,pure,rarely,ripe,seed,shape,size,slightly,stem,stigma,style,substellate,terminal,tube,white,whitish,x,yellow,yellowish	0-25,1,1-10,1-3,1-4.5,1.5-4,10,2,2-5,2-7.5,20-60,3-12,3-6,5-17,5-merou,50-70,600-950,acumen,acuminate,acute,ag,along,alyx,apart,apex,apparently,articulated,axe,axillary,base,berry,blade,broadly,bud,capitat,cell,ciliate,connivent,cordate,covering,digestion,distal,dorsally,dot,eaf,edge,eed,elliptic,enzyme,erec,especially,exceeding,except,filament,flat,flower,folded,forked,geminat,generally,glabrou,gland,glandular,greatly,gree,green-white,hair,hair-like,hal,half,head,homostylous,honeycomb-shaped,interjected,lateral,leaflet,lengthening,light,like,living,longer,lower,lunate,make,margin,midrib,mucilaginous,narrowly,nflorescence,non-glandular,oblique,often,orolla,pair,perfect,petiolulate,petiolule,plurifoliate,pore,poricidal,proximal,reduced,removed,rounded,ruit,scattered,sessile,seudostipule,short,slit,spaced,specimen,stamen,ste,straight,subequal,subsessile,subtending,tall,tamen,tem,testal,tetralobulate,thick,throughout,tip,tri-,trichome,typically,unit,unwinged,usually,vary,varying,wall,wet,wide,wing,ympodial	adhesion,arrangement,calyx,capitate,colour,form,growth,height,hermaphroditic,history,inflorescence,leaf,life,na,ovary,perennial,position,presence,present,pubescence,reproduction,rugulose,staman,stellate,surface,texture
109	wfo-0001026534	success	150	96	69	81	27	0.46	0.5-1,1-2,1.5-9,10-20,2-2.5,2-3,2-7,2.5-15,3-25,3-4,3-5,3.5-4,4-10,5-6,6-35,7-40,abaxially,acuminate,adaxially,apex,apiculate,auriculate,base,branched,calyx,chartaceous,cm,connivent,cordate,deltate,densely,diameter,ellipsoidal,entire,flattened,fleshy,fruit,glabrous,lanceolate,lobe,margin,mm,moderately,obtuse,orange,ovate,ovoid,pale,pedicel,peduncle,petiole,pinkish,puberulent,pubescent,purple,red,simple,stellate,stigma,style,subcoriaceous,tip,tree,truncate,tube,unbranched,white,x,yellow	-1.5,1-2.5,1-3,1.5-6,10-15,10-50,15-50,2-8,2.5-4,3-,3-10,4-foliat,4.5-5,7-12,absent,acute,aggregate,apart,ape,articulated,axe,basal,beyond,blade,bright,cell,connective,cylindrical,darker,directed,distally,eaf,eed,eglandular,equal,exserted,flower,glandular,hair,leaving,lemon-yello,lon,long,longitudinal,lower,m.,narrowly,nflorescence,nther,often,orolla,pedicellar,perfect,pore,presen,puberulen,rachi,radiu,remnant,ruit,shorter,slightly,small,spaced,sparsely,stamen,stone,stripe,tal,tem,thecae,time,tomento,triangular,truncat,ud,unit,vary,vein,wide,ympodial	anther,arrangement,colour,corolla,form,growth,height,hermaphroditic,history,inflorescence,leaf,length,life,na,ovary,perennial,plant,position,pubescence,reproduction,rugulose,seed,shape,size,stem,surface,texture
110	wfo-0001026535	success	248	141	112	136	29	0.452	.5,.8,0.15,0.2,0.7-1.5,1,1.2-2,1.3,1/3,2-3,2-5,2.5,3,3-4.5,3-5,3.5-4,4-15,7-8,acute,age,almost,along,anther,apex,apically,apparently,base,becoming,berry,black,brachyblast,branch,broadly,brown,calyx,chartaceous,clavate,clustered,cm,condensed,conical,corolla,cuneate,cupular,dark,deltoid,dendritic,dendritic-pubescent,dense,developed,diameter,distributed,dorsal,drying,elliptic,elongated,entire,evenly,free,fruit,glabrous,inside,leaf,length,liana,like,lobe,lobed,long,lower,margin,membranous,mm,mostly,number,oblong,obovate,older,orange-brown,outside,ovate,ovoid,partly,pedicel,peduncle,petiole,plant,pubescent,rachi,rarely,ray,rounded,short,shrub,side,sparsely,stem,stigma,style,surface,terminal,thin,trichome,truncate,tube,unevenly,violet,white,widely,x,yellowish,young	.1,.2,.4,0-0.5,0.1-0.2,0.2-0.3,0.2-1.5,0.5-1,1-2,1-3,1-5,1.5-2,1.5-3,1/2-2/3,5-10,5-7,5°,abaxial,abaxially,absent,accrescent,adaxially,alternate,alyx,anthesi,apar,area,around,articulated,bark,branched,branching,clearly,concolorous,cup,curved,deeply,delineate,delineated,detaching,developing,dilated,discolorous,divided,domatia,dry,eaf,eed,ellipsoi,equal,except,eye,fertilisation,filament,fine,flat,flexuous,flower,forming,frui,fruiting,green-brown,increasing,known,leave,lengthening,linear,lon,loop,loose,m.,main,marginal,midvein,minute,minutely,much,naked,network,nflorescence,nther,obscure,orolla,pair,papillo,pendulous,perfec,pericarp,plurifoliat,pointed,pore,poricidal,portion,primary,prominent,protruding,raised,reaching,ridged,ruit,scar,secondary,see,simple,sinus,slender,slightly,smaller,smooth,soon,spaced,spreading,stump,tearing,terete,tertiary,tip,tissue,toward,translucent,tufted,two,ud,unarmed,uneven,unit,unlignified,vary,vein,venation,visible,weakly,wide,wider,ympodial,youngest	0.1,adhesion,arrangement,blade,climate,colour,form,glandular,growth,hair,height,inflorescence,midpoint,na,ovary,perfect,position,presence,present,pubescence,reproduction,rugulose,seed,shape,size,staman,stellate,stipe,texture
111	wfo-0001026538	success	226	114	92	134	22	0.407	-3.5,0.1-0.3,0.6-0.8,0.8-1.2,0.8-2.2,0.9-1.2,1-1.9,1-2.5,1-3,1.2-1.4,1.2-1.5,1.2-2.6,1.3-2.8,1.4-2.6,1.7-2.5,12-21.5,2-5,3.5-4.6,3.5-5.8,4-8,5,6-13,6.7-,8.1-14.8,acute,anther,apart,base,black,broadly,brown,brown-black,calyx,closely,cm,corolla,deltoid,diameter,drying,elliptic,flower,fruit,glabrous,globose,gray,green,hair,inserted,lanceolate,leaf,length,lobe,mm,mostly,obovate,occasionally,ovate,ovate-lanceolate,pale,pedicel,peduncle,petiole,porrect-stellate,pseudo-terminal,pubescence,rarely,reticulate-punctate,scabridulous,semi-ovate,sessile,shrub,simple,small,spaced,stellate,stem,stigma,style,subcampanulate,subconical,suborbicular,surface,terete,thin-textured,tomentose-pubescent,tree,tube,white,x,yellow,yellowish,yellowish-tan	-5.8,.5-3,/15-1/9,0-160,0.3-1.5,0.4-,0.8-1.5,1.4-3,1.5-2.5mm,1.8-4.6,1/2,2-3.5,2.1-3.2,2.1-3.4,3-4,3.2-4.8,3.7-5.8,6.3-8.9,8-10,[,],abaxially,accrescent,acuminate,adaxiall,adaxially,ag,along,anthesi,apex,apparently,appearing,around,articulated,axe,axillary,ba,bark,berry,blade,blunt-tipped,branch,branched,bud,capitat,chartaceous,completely,constricted,covering,cylindrical,decurrent,dense,densely,directed,distally,due,eaf,edge,eed,entire,enveloping,exserted,farinose,filament,fleshy,free,frui,fruiting,glabrescen,glabrou,lackin,lateral,lengthening,lobed,long,long-attenuate,long-stalked,longer,longitudinal,lower,main,many,margin,measured,midrib,mixed,multangulate,nearly,nflorescence,obscured,obtuse,older,orolla,overlapping,perfect,plurifoliate,pore,poricidal,porrect-stellat,pubescent,rachi,rather,ruit,runk,short,short-stalked,side,slightly,slit,sometimes,somewhat,soon,stamen,suture,tall,tamen,thick,thickened,time,tip,tomentu,touching,ud,unarme,unarmed,unit,usually,vary,vein,way,weakly,wide,ympodial,young	adhesion,arrangement,capitate,colour,form,growth,height,history,inflorescence,life,na,ovary,perennial,plant,position,reproduction,seed,shape,size,staman,texture,unknown
112	wfo-0001026539	success	194	122	84	110	38	0.433	.5,0,0.2,2,30,5.5,abaxially,acuminate,acute,adaxially,anther,anthesi,apex,apiculate,base,berry,blade,broadly,brown,calyx,campanulate,chartaceous,clustered,cm,corolla,creamy,cucullate,densely,diameter,entire,equal,flattened-reniform,fruit,glabrous,globose,growth,hair,height,hooked,lance-elliptic,lateral,leaf,lobe,long-attenuate,margin,minutely,mm,nearly,oblanceolate,occasionally,orange,pedicel,peduncle,perennial,petiole,pilosulose,pitted,puberulent,pubescent,red,rounded,rugose,shoot,short,sinuate,slender,spreading,staman,stellate,stem,stigma,strongly,style,surface,terminal,tip,tube,usually,vine,white,winged,yellow,young,×	-6,0.25,0.3-0.5,0.5,0.9,1,1-1.5,1-2-celled,1.5–2,10–15,10–28,15–20,1–2,2-4-celled,2.5,2.5–4,20,20–35,2–2.5,2–3,2–4,2–5,3,3–5,4–6,5,5–,5–10,6–15,absent,ag,always,alyx,approximately,armed,articulated,axe,ba,basal,becoming,branched,bud,capitat,cell,connivent,deltate,dr.,eaf,early,eed,ellipsoid,elongate,elongating,exserted,filament,flower,four,glabrou,ine,interpetalar,larger,lengthening,lobed,long,long-styled,longer,lower,major,midrib,narrowly,nflorescence,often,one,orolla,pair,pericarp,pointed,pore,poricidal,present,prickle,pustulate,rachi,recurve,recurved,robust,ruit,sessil,shallow,side,simple,slightly,slit,somewhat,stout,straight,subwoody,tamen,tapering,terminally,time,tissue,triangular,trichome,tub,unequal,vary,vein,wide,woody	0.25-0.9,1.5-2,10-15,10-28,2-4,2.5-4,4-6,5-10,6-15,adhesion,arrangement,capitate,climate,colour,dry,form,glandular,history,inflorescence,length,life,midpoint,na,number,ovary,plant,position,presence,pubescence,ray,reproduction,rugulose,seed,sessile,shape,size,stipe,texture
113	wfo-0001026604	success	192	108	97	95	11	0.505	.4,.5,0.8-0.9,1-1.2,1.2-1.7,1.5-2,1.5-9,10-30,2-2.3,2-2.5,2.3-3.5,3-3.5,3-5,4-4.5,4.5-7,5-7,acuminate,anther,apex,articulated,articulation,bark,base,berry,brown,c.,calyx,capitate,cm,conical,cordate,corolla,dark,densely,diameter,distal,ellipsoid,entire,flattened,fruit,glabrous,globose,growth,inflated,liana,lobed,margin,midrib,minute,minutely,mm,narrowly,new,nodding,oblique,ovary,ovate,ovoid,pair,pale,papillose,pedicel,peduncle,petiole,pitted,poricidal,primary,pubescent,purple,quarter,red,reddish,reniform,ripe,shape,shiny,shrub,simple,somewhat,stellate,stem,stigma,stout,style,surface,thin,tip,trichome,truncate,tube,uniseriate,vein,vining,violet,way,woody,x	.75,0,0.1,0.4-0.6,0.8-1,1.1-1.3,3.5-4,5,50-100,<,?,absent,age,aid,along,always,anthesi,apart,appearing,atop,basal,branching,brow,cell,clearly,climbing,comical,cucullate,cupped,deflexed,differentiated,distinct,drying,due,eaf,eed,elongate,expanding,exserted,filament,flexuous,flower,free,fruiting,later,leaf-opposed,leaving,lengthening,lobe,lower,mere,nflorescence,occasionally,older,outline,overall,papillo,part,particularly,peg,per,perfect,pericarp,planar,plurifoliat,poin,point,pore,portion,receptacle-like,rim,ruit,scar,series,sinuate,slender,slightly,slit,spaced,strongly,structure,support,swolle,terminal,testal,time,tub,twisting,ud,undulation,unit,upper,widely,ympodial,½	bud,colour,form,inflorescence,leaf,length,pubescence,seed,size,texture,type
114	wfo-0001026606	success	213	109	66	147	43	0.31	0.4-0.8,0.5-1.6,1.3-1.9,1.4-2.1,12.5-22.5,2-3,3-6,abaxially,acute,apex,asymmetric,berry,black,broadly,chartaceous,cm,densely,diameter,extra-axillary,flower,fruit,glabrate,glabrous,globose,golden,lanceolate,lenticular,linear,lobe,low,minutely,mm,ovate,pedicel,peduncle,pentagonal,petiole,pitted,present,puberulent,pubescence,pubescent,ray,rayed,ripe,rounded,scabrous,shrub,simple,small,stellate,stellate-pubescent,stelliform,stem,stigma,style,surface,tan,tapering,tree,tube,white,wider,woolly,x,yellow	0.5–0.8,1.7-2.1,10–20,12-17,15–20,15–25,1–1.5,1–3,2.4-3.6,2–2.5,2–4,3-4.6,3–10,3–4,3–5,3–6,4.2-5.2,4–20,4–7,5-merou,5.8-7.2,5–15,6–7,6–8,7.3-9.7,7–12,8–10,abaxial,abaxiall,absent,adaxial,adaxially,almost,along,alyx,an¬ther,apart,apiculate,apparently,armed,articulated,asymmetrically,axe,ba,band,base,based,blade,blunt-tipped,branched,broad,capitat,central,closely,coarsely,compressed,concentrated,cordate,cylindrical,developed,difoliate,directed,distally,eaf,eed,entire,eventually,expanded,filament,forming,geminat,glabrou,hair,homostylous,initially,internode,interpetalar,larger,lateral,laterally,lighter,lon,long,lower,main,margin,midpoint,midvein,moderately,much,nearly,nerve,nflorescence,obsolete,obtuse,occasionally,often,of¬ten,older,open,orolla,perfect,peripherally,persistently,pore,prickle,prickly,pubescen,rachi,rarely,recurved,reduced,ruit,scar,scattered,sessile,short,shortly,slightly,sometimes,spaced,sparingly,sparsely,spreading,stellae,stout,subentire,tall,tamen,tem,thick,thickened,three,tissue,toothed,truncate,unarmed,usually,vary,vein,warty,weakly,wide,widely,yello,ympodia,young	0.5-0.8,1-1.5,15-20,15-25,2-2.5,3-10,3-4,4-20,4-7,6-7,6-8,7-12,8-10,adhesion,anther,arrangement,calyx,capitate,colour,corolla,form,growth,height,history,inflorescence,leaf,length,life,na,number,ovary,perennial,plant,position,presence,reproduction,rugulose,seed,shape,size,staman,texture,unknown
115	wfo-0001026607	success	204	94	70	134	24	0.343	0.1-0.3,0.8-3.4,0.8-4.5,0.8-5,1-2,1.5-4,10-30,2-2.5,2.4-5.8,2.5-3.8,3-8,4-6,5.8-19.8,6-10,abaxially,adaxially,anther,attenuate,axillary,brownish,bud,chartaceous,clavate,cm,condition,corolla,deep,diameter,drying,elliptic,finely,fresh,fruit,glabrous,globose,green,greenish,herb,lanceolate,leaf,lobe,long,medium,membranous,minutely,mm,moderately,odd-pinnate,ovate,ovoid,pedicel,peduncle,pentagonal,petiole,plant,puberulent,pubescent,ripe,seed,size,stem,stigma,style,subtending,terminal,tube,violet,whitish,x,yellow	0-3,0-4,0.3-1.8,0.5-5.8,1-10,1-3.8,1-5,1-8,2-10,2-3,2.7-19,4-10,5,5-merou,absent,acumen,acute,ag,along,alyx,apart,apex,apparently,articulated,axe,base,basiscopic,berry,blade,capitat,cell,ciliate,clearly,coarse,connivent,covering,decreasing,decurrent,digestion,distal,dorsally,dot,eaf,edge,eed,enzyme,especially,exceeding,filament,flat,flower,folded,forked,forming,geminat,generally,glabrou,greatly,gree,green-white,hair,hair-like,hal,half,high,homostylous,honeycomb,interjected,larger,lateral,leaflet,lengthening,like,living,lower,make,margin,marked,midrib,minute,much,mucilaginous,nflorescence,obtuse,often,orbicular,orolla,pair,perfect,petiolulate,plurifoliate,pore,poricidal,present,rachi,rarely,removed,rosette,rounded,ruit,scattered,semierec,sessile,seudostipule,shaped,short,side,simple,slit,sometimes,spaced,specimen,stamen,ste,straight,tall,tamen,tem,testal,thick,throughout,tip,toward,tri-,typically,unit,unwinged,usually,vary,wall,wet,white,without,ympodial	adhesion,arrangement,calyx,capitate,colour,form,growth,height,hermaphroditic,history,inflorescence,length,life,na,ovary,perennial,position,pubescence,reproduction,rugulose,shape,staman,surface,texture
116	wfo-0001026613	success	159	93	60	99	33	0.377	1-2,11-19.5,2.3-8,2.5-2.8,3-5,4-5,5-6,5-7,8-18,8.5-10,8.5-9,9.5-13.5,abaxially,acuminate,adaxially,anther,apex,attenuate,base,berry,blade,chartaceous,cm,cordate,corolla,densely,diameter,fruit,glabrous,green,hair,herb,lanceolate,leaf,lobe,long,margin,membranous,minutely,mm,mottled,odd-pinnate,ovate,pedicel,peduncle,petiole,plant,puberulent,pubescent,purple,rotate-pentagonal,size,sparsely,stem,stigma,style,terminal,tube,x,yellow	0.5-1,0.6,1-10,1.5-4,2-7.5,3-10,4.5-8.5,5,5-merou,5.5-7,6-12,6-8,6.2-9.5,absent,acumen,ag,along,alyx,apart,apparently,articulated,axe,axillary,borne,bud,capitat,ciliate,conical,connivent,decreasing,distal,dorsally,eaf,edge,eed,end,erec,especially,filament,flat,flower,folded,forked,geminat,generally,greatly,hal,half,homostylous,immature,interjected,larger,lateral,leaflet,lengthening,like,lower,m-1.2,mature,middle,midrib,minute,nflorescence,orolla,pair,perfect,petiolule,plurifoliate,pore,poricidal,proximal,pubescen,ruit,secondary,semierect,seudostipule,singly,slit,spaced,ste,stolo,subequal,subtending,symmetrical,tall,tamen,tem,tip,toward,tri-,tuber,typically,unit,unknow,unknown,unwinged,usually,vary,ympodial	0.6-1.2,adhesion,arrangement,calyx,capitate,climate,colour,form,glandular,growth,height,history,inflorescence,length,life,midpoint,na,number,ovary,perennial,position,presence,pubescence,ray,reproduction,rugulose,seed,shape,staman,stellate,stipe,surface,texture
117	wfo-0001026614	success	200	126	80	120	46	0.4	.8,0.2,0.4-0.7,1.3-1.8,2.2,2.5,abaxially,acuminate,acute,adaxially,anther,apex,base,berry,black,blade,brown,calyx,campanulate,cm,dark,densely,diameter,dried,entire,evenly,extra-axillary,flattened-reniform,flower,foveolate,fruit,glabrescent,glabrous,gland-tipped,globose,golden,hair,interpetalar,lanceolate-attenuate,leaf,linear,lobe,lobed,margin,midpoint,minute,minutely,mm,mottled,oblique,orange,orange-red,ovate,ovate-lanceolate,pedicel,peduncle,petiole,pubescence,pubescent,ray,repand,ripe,rotate-pentagonal,shallowly,shrub,simple,soon,sparsely,stellate,stellate-pubescent,stem,stigma,style,surface,tissue,tube,white,x,yellow,yellowish	0.2–0.3,0.5,0.5–2,1-,1.5–2,11-15,15–30,1–2,1–3,1–5,2.2-5.5,2.5–3,20–25,2–4,2–4-branched,2–6.5,3-foliate,3.2-5.2,3–10,4-7,4.5–11,4.5–5.5,5,5-merou,5.3-8.2,50,6.4-8.4,6–8,7.2-9.8,8–10,9–16,>,absent,across,adaxiall,alyx,apart,apparently,armed,articulated,axe,ba,blunt-tipped,broad-based,capitat,chartaceous,clavate,closely,commonly,concentrated,cylindrical,denser,developed,directed,distally,eaf,eed,erect,especially,expanded,filament,fleshy,fruiting,geminate,globo,homostylous,internode,irregularly,lateral,less,lon,long,lower,midvein,nearly,nflorescence,obtuse,often,orolla,ovoid,pair,per,perfect,pore,prickle,rachi,rarely,reflexed,rounded,ruit,scattered,sessile,shin,side,similar,slightly,smaller,sometimes,somewhat,spaced,spreading,stellae,tall,tamen,tapering,tem,time,tissu,ud,unarme,unarmed,usually,vary,vein,weakly,well,wide,ympodia,young,–5	0.2-0.3,0.5-3,1-2,1-5,1.5-2,2-4,2-6.5,2.5-3,20-25,3-10,4.5-11,4.5-5.5,6-8,8-10,9-16,adhesion,arrangement,capitate,climate,colour,corolla,form,glandular,growth,height,history,inflorescence,length,life,na,number,ovary,perennial,plant,position,presence,reproduction,rugulose,seed,shape,shiny,size,staman,stipe,texture,ye
118	wfo-0001026632	success	108	97	61	47	36	0.565	.5,0,1-2,10-12,6,7,abaxially,abundantly,acuminate,acute,adaxially,anther,apex,base,blade,broadly,cm,densely,diameter,divided,elliptic,erect,exposed,extra-axillary,flower,glandular,hair,halfway,height,lamina,leaf,lobe,long,margin,minute,mm,moderately,ovate,pedicel,peduncle,petiole,prickle,prickly,prominent,pubescent,ray,reddish-brown,rounded,scarcely,short,shrub,simple,stellate,stellate-pubescent,stigma,style,triangular,truncate,tube,unknown,x	1.5,3-4,5-merou,acumen,alyx,armed,ba,bu,capitat,cell,central,commonly,condensed,cyme,developed,eaf,eed,equal,filament,flattened,geminat,interacuminal,lanceolat,lateral,less,little,lon,lower,nflorescence,orolla,porrect-stellate,ruit,sessile,shallow,sinus,straight,structure,tamen,tem,tissue,toward,unarme,unknow,vary,well,ympodial,young	adhesion,arrangement,bud,calyx,capitate,climate,colour,corolla,form,fruit,growth,history,inflorescence,lanceolate,length,life,midpoint,na,number,ovary,plant,position,presence,present,pubescence,reproduction,rugulose,seed,shape,size,staman,stem,stipe,surface,texture,unarmed
119	wfo-0001026642	success	193	119	71	122	48	0.368	.05,0.1,0.25,6,<,abaxially,annual,anther,anthesi,apex,axillary,base,bipinnate,black,blade,blue,borne,brown,calyx,clavate,cm,dark,densely,diameter,elliptic,flattened,fruit,glabrous,glandular,globose,green-purple,hair,herb,indumentum,lavender,leaf,length,lilac,lobe,long,mm,moderately,multicellular,number,oblong,obtuse,often,ovate,pale,pedicel,peduncle,pentagonal,perennial,petiole,pinnate,pitted,pubescent,shallowly,shoot,simple,sparsely,stigma,style,subglabrous,surface,tube,uniseriate,violet,white,x,yellow	.1,.8,0.1–0.3,0.2,0.4,0.4–2.2,0.5,0.5–,0.5–0.7,0.5–1.7,0.5–2.0,0.5–3.5,0.6,0.6–1.0,0.75–1.0,0.75–2.0,0.7–1.6,0.8–1.2,1.0,1.0–2.0,1.2–1.7,1.2–2.0,1.2–3.5,1.2–6.2,1.6–8.0,1.9–3.0,12–30,1–10,1–3,2.0–4.0,2.5–3.5,2.5–4.0,2.8–3.0,3.0–5.1,3–5,4.0–6.0,4–7,5,5.0–7.0,50–100,abaxial,acute,adaxiall,adaxially,ag,along,apart,appressed,articulated,axe,ba,branched,cell,chartaceous,circular,connivent,cylindrical,decreasing,decumbent,denser,divided,eaf,eed,either,equal,erect,filament,fleshy,flower,geminat,glabrescen,gland,half,lon,longitudinal,lower,m.,narrow,nflorescence,occasionally,opening,orolla,pair,perfect,pinnae,pore,poricidal,present,primary,probably,rapidly,rounded,ruit,secondary,sessile,side,slit,sometimes,spaced,stone,straight,tal,tamen,tem,time,tip,unicellular,unifoliate,unit,usually,vary,vein,wide,wing,woody,ympodial,–1.2,–11.0,–2.0,–4.5,–6,–7	0.1-0.3,0.4-2.2,0.5-0.7,0.5-2.0,0.5-3.5,0.5-6.2,0.5-8.0,0.75-1.0,0.75-2.0,0.8-1.2,1-3,1.2-1.7,1.2-2.0,2.8-3.0,3.0-5.1,4.0-6.0,5.0-7.0,50-100,adhesion,arrangement,climate,colour,corolla,form,growth,height,history,inflorescence,life,margin,midpoint,na,ovary,plant,position,presence,pubescence,ray,reproduction,rugulose,seed,shape,size,staman,stellate,stem,stipe,texture
120	wfo-0001026651	success	222	117	97	125	20	0.437	-celled,0.9–3,1.8,1–2,2.2–10,2.8,2–11.5,2–13,2–3,2–3.3,2–4.5,2–8,3,3-plurifoliate,4,4–6,4–7.8,6–10,6–14,8,acuminate,acute,anther,apex,articulated,attenuate,base,berry,brownish-green,calyx,capitate,cell,chartaceous,cm,dark,densely,diameter,drying,dull,entire,exfoliating,flattened,flower,fruit,geminate,glabrescent,glabrous,globose,green,herb,lanceolate,lateral,leaf,length,light,lobe,margin,membranaceous,mm,moderate,mostly,narrowly-elliptic,oblong-ellipsoid,ovate-deltate,ovate-reniform,pedicel,peduncle,petiole,plant,pubescence,pubescent,revolute,ripe,rounded,seed,shape,similar,simple,size,slightly,sometimes,spaced,stellate,stem,stigma,style,sub-opposite,surface,terminal,translucent,trichome,undulate,uniseriate,unit,white,yellow,×	0.2–1.3,0.35–2.6,1,2–4,3–5,3–7,5-merou,abaxially,absent,accrescent,adaxiall,adaxially,along,alyx,anisophyllous,antror,antrorse,antrorsely,apar,appressed,arcuate,ark,asymmetric,axi,beneath,beyond,branch,broadly,brochidodromous,brown,capitat,ciliate,circular,connivent,cordate,cylindrical,cyme,decumbent,decurrent,differing,directed,discolorous,eaf,eed,elliptic,emarginate,equal,erect,exserted,eye,filament,flexuous,frui,geniculate,glabrou,glandular,growt,hair,head,highly,hilum,hollow,impressed,introrsely,less,like,long,longitudinal,lower,lying,major,markedly,matte,midrib,minor,moderately,much-branched,multicellular,naked,new,nflorescence,normally,obtuse,older,one,onto,opening,orolla,ovate-lanceolate,parallel,pedunculate,per,perfect,pore,poricidal,prominent,reduce,region,ruit,secondary,shiny,shrub,single-celled,slit,small,smaller,stalk,stamen,straight,subapical,tall,tamen,tem,turning,unbranched,upper,usually,vary,vein,venation,visible,wide,woody,ympodial,young	apart,arrangement,bark,colour,corolla,form,growth,height,history,inflorescence,life,na,ovary,perennial,position,reproduction,staman,sympodial,texture,tube
121	wfo-0001026656	success	211	105	79	132	26	0.374	1-1.8,1-10,1-2,1-3.8,1.1-8.1,1.5-7,2-6,2.5-17,20-60,4-13,4-8,5-35,5.5-27,9-11,abaxially,acute,adaxially,anther,attenuate,blue,broadly,brownish,capitate,chartaceous,cm,condition,corolla,densely,diameter,dot,drying,elliptic,fresh,fruit,generally,glabrous,globose,green,greenish,hair,herb,lanceolate,light,like,lobe,long,lunate,membranous,minutely,mm,moderately,mottled,narrowly,occasionally,odd-pinnate,ovate,ovoid,pedicel,peduncle,pentagonal,plant,puberulent,pubescent,purple,rotate-pentagonal,scale-like,scattered,seed,stem,stigma,style,subglabrous,terminal,tube,violet,white,whitish,wide,yellow	0-4,0.3-3,0.3-4.2,0.4-6.5,0.7-10.5,0.9-13,1,1-4,1-5,10,2-8,4-10,5,5-18,5-merou,absent,acumen,acuminate,ag,along,alyx,apart,apex,articulated,base,bearing,blade,borne,bud,cell,ciliate,clavat,connate,connivent,covering,cuneate,curved,dark,decurrent,digestion,distal,dorsally,eaf,edge,eed,end,enzyme,erec,especially,exceeding,filament,flat,flower,folded,forked,geminat,glaucous,greatly,green-white,greenish-yellow,hair-like,half,homostylous,honeycomb-shaped,interjected,larger,lateral,leaflet,lengthening,living,lower,make,margin,middl,midvein,mucilaginous,nflorescence,non-glandular,oblique,often,orolla,pair,petiole,petiolulate,petiolule,plurifoliate,pore,poricidal,pubescen,rachi,ranging,removed,ruit,seudostipule,short,singly,slightly,slit,sometimes,somewhat,spaced,specimen,stamen,star,ste,stolo,straight,subequal,subtending,symmetrical,tall,tamen,tem,tertiary,testal,therefore,thick,throughout,tinged,tip,tri-,truncate,tuber,typically,unit,unwinged,vary,wall,wet,wing,without,ympodial	adhesion,arrangement,calyx,clavate,colour,form,growth,height,history,inflorescence,leaf,length,life,na,ovary,perennial,position,pseudostipule,pubescence,reproduction,rugulose,shape,size,staman,surface,texture
122	wfo-0001026663	success	251	101	76	175	25	0.303	-2.9,0.2-0.6,0.3-0.8,1-2.5,1-3.2,1-5,1.1,1.2-2,1.6-2.3,10-26,2-12,2.1-2.6,2.5-3.7,2.9-5,2/3,24-45,31,4.7-25.9,8-17,abaxially,acute,adaxially,anther,blunt-tipped,brown,calyx,cm,conical,corolla,dark,diameter,drying,echinoid-pubescent,fleshy,fruit,globose,granular,green,greenish-brown,inserted,lanceolate,leaf,length,light,lobe,mm,ovate,ovate-lanceolate,pale,pedicel,peduncle,petiole,plurifoliate,pseudo-terminal,pubescence,rich,scabrous,shrub,slightly,small,stellate,stem,stigma,style,subcampanulate,subglobose,tomentose,tomentose-pubescent,tree,tube,upper,violet,white,whitish,x,yellow	-15,-8,-9.7,.5-2.5,/25-1/15,/3,0-160,0.4-2.2,0.9-1.5,1,1.1-2.1,1.4-2.6,1.4-3.1,1.9-2.6,1/2,1/3,1/4-1/2,10.3-13.2,12-14,2.8-5.3,3-5,3.5-5,3.8-5.7,4.5-5.7,5-8,5.5-,5.5-8.8,7.5-9,accrescent,acuminate,adaxiall,ag,along,angled,anthesi,apart,apex,apparently,appressed,around,articulated,ascending,attenuate,axe,axillary,bark,base,becoming,berry,blade,branch,branched,broadly,bud,capitat,chartaceous,closely,completely,constricted,covering,cylindrical,densely,directed,distally,distributed,eaf,echinoi,echinoid,edge,eed,elongated,entire,enveloping,especially,evident,exserted,farinose,filament,flared,flower,free,fruiting,glabrescen,glabrescent,glabrous,granular-tomentose,grooved,hair,immature,lateral,lengthening,less,line,lined,lobed,long,long-stalke,long-stalked,longer,longitudinal,longitudinally,lower,m.,main,many,margin,matur,midrib,midvein,minute,multangulate,multangulate-pubescent,nearly,nflorescence,obtuse,occasional,occuring,older,opening,openly,orolla,ovate-lanceolat,perfect,persistent,pore,poricidal,porrect-stellate,present,pubescent,rachi,rather,ray,ridged,robust,ruit,runk,sessile,short,short-stalked,side,simple,slit,sometimes,somewhat,soon,spaced,sparsely,stalk,stalked,stamen,strongly,subcoriaceous,subglabrous,suture,tall,tamen,tangled,terete,thick,thin,time,tip,tomentum,touching,ud,unarme,unarmed,unit,usually,vary,vein,way,wide,ympodial,young	5.5-9,adhesion,arrangement,capitate,colour,form,growth,height,history,inflorescence,life,na,ovary,perennial,plant,position,reproduction,rugulose,seed,shape,size,staman,surface,texture,unknown
123	wfo-0001026686	success	196	93	69	127	24	0.352	.4,0.6-0.9,1-2,1.5-7,1.7-2.5,10-28,2.4-3.6,3-4,4-6,5-16.5,5-8,6.5-12.7,7-9,8-10,8-27,abaxially,acuminate,adaxially,anther,axillary,berry,brownish,bud,chartaceous,cm,condition,conical,corolla,densely,diameter,drying,fresh,fruit,glabrous,green,greenish,herb,lanceolate,leaf,light,lobe,long,minutely,mm,mottled,odd-pinnate,ovoid,pedicel,peduncle,petiole,plant,puberulent,pubescent,purple,purple-violet,ripe,rotate-stellate,seed,size,sparsely,stigma,style,subtending,terminal,tube,whitish,wide,x,yellow	0.2-0.5,1,1-10,1-2.5,1.2-3.4,1.2-3.6,2-10,2-9,2.5-8,3-5,3.7-8,5,5-merou,8-14,absent,acumen,ag,along,alyx,apart,apex,apparently,articulated,axe,base,blade,borne,capitat,cell,ciliate,connivent,covering,decreasing,digestion,distal,dorsally,eaf,edge,eed,elliptic-lanceolate,end,enzyme,equal,erec,especially,exceeding,filament,flat,flower,folded,forked,geminat,generally,glabrou,gradually,green-white,hair,hair-like,half,homostylous,honeycomb-shaped,interjected,larger,lateral,leaflet,lengthening,like,living,lower,make,margin,middle,midrib,minute,mucilaginous,nflorescence,obtuse,often,orbicular,orolla,ovate,pair,perfect,petiolule,plurifoliate,pore,poricidal,pubescen,removed,round,ruit,secondary,semierect,seudostipule,singly,slightly,slit,spaced,specimen,stamen,star,ste,stolo,straight,stripe,subequal,subsessile,symmetrical,tall,tamen,tem,testal,thick,throughout,tip,toward,tri-,tuber,typically,unit,usually,vary,wall,wet,white,wing,ympodial	adhesion,arrangement,calyx,capitate,colour,form,growth,height,history,inflorescence,length,life,na,ovary,perennial,position,pubescence,reproduction,rugulose,shape,staman,stem,surface,texture
124	wfo-0001026695	success	128	90	52	76	38	0.406	0.6-8,1-1.5,1.6,2,2.5-5.2,3-4,3-8,4,4-5,6-7,6-8,8-16,abaxially,acumen,acute,adaxially,apex,base,calyx,cm,connate,cordate,corolla,cuneate,diameter,distal,glabrescent,half,herbaceous,leaf,lobe,long,mm,oblique,odd-pinnate,ovate,ovate-lanceolate,pedicel,peduncle,perennial,petiole,plant,pubescent,rounded,short-acuminate,simple,stellate,stigma,style,triangular,wide,yellow	1-2,1-4,11-14,2-3,2-6,2.5-3,2.5-7,3-6-foliat,4-5.5,6-12,6.5-13,8-17.5,absen,acuminate,apical,apically,articulate,branched,compound,cyme,decurrent,dehiscent,dichasial,dichasially,dorsally,eaf,ebracteate,edge,eed,exceeding,filament,flat,flower,folded,forked,generally,globo,interjected,introrse,lateral,leaflet,lon,lower,lunat,maturing,monochasial,nflorescence,nther,often,one,orolla,pair,perfect,plan,poricidally,proximal,ruit,sessile,seudostipule,short,slit,stamen,straight,tal,tem,terminal,tuber-bearing,typically,unit,unknow,unknown,vary,whit,without,ympodial,¼	adhesion,anther,arrangement,blade,climate,colour,form,fruit,glandular,globose,growth,hair,height,history,inflorescence,length,life,margin,midpoint,na,number,ovary,position,presence,pubescence,ray,reproduction,rugulose,seed,shape,size,staman,stem,stipe,surface,texture,tube,white
125	wfo-0001026696	success	139	87	61	78	26	0.439	0.3-4.5,0.8-7,0.9-7.2,1,1-1.3,1.3-2.1,2-17,2-3,3-17,3-3.5,3-6,3-8.5,9,abaxially,adaxially,broadly,calyx,cell,cm,connate,corolla,covering,densely,diameter,distal,forked,generally,globose,green,green-white,hair-like,half,herbaceous,lanceolate,lateral,light,linear,long,make,mm,mucilaginous,odd-pinnate,ovate,ovoid,pedicel,peduncle,perennial,petiole,plant,pubescent,seed,stellate,stigma,style,testal,thick,throughout,wall,white-cream,wide,yellow	1-4,1.5-3,3-6-foliat,4-16,5-35,acumen,acute,apex,apical,apically,apiculate,articulate,base,branched,cuneate,cyme,decurrent,dehiscent,dichasial,dichasially,digestion,dorsally,eaf,ebracteate,edge,eed,emoval,entire,enzyme,exceeding,filament,flat,flower,folded,globo,honeycomb,introrse,light-yello,living,lobe,lon,lower,lunat,margin,maturing,monochasial,nflorescence,nther,oblong,obtuse,often,orolla,pattern,perfect,plan,poricidally,proximal,reveal,rounded,ruit,seudostipule,short,simple,sinuate,slit,specimen,stamen,straight,tal,tem,throughou,tuber-bearing,typically,unit,vary,without,ympodial,¼	anther,arrangement,colour,form,fruit,growth,height,history,inflorescence,leaf,length,life,light-yellow,na,ovary,position,pubescence,reproduction,rugulose,shape,size,stem,surface,texture,tube,wet
126	wfo-0001026706	success	232	106	83	149	23	0.358	-3.1,0.2-0.3,0.2-0.5,0.8-1.2,0.8-1.5,1-2.2,1-5,1.1-4,1.5-3,12,14-32,2.2-3.3,2.5-3,2/3-3/4,3-4.6,3.1-3.8,4,4.2-12,4.5-5.5,5.3-6.4,6.1-,7-16,9.8-15.4,acute,anther,blunt-tipped,brown,calyx,cm,coriaceous,corolla,dark,densely,diameter,fleshy,flower,fruit,glabrate,globose,golden,green,inserted,lanceolate,leaf,length,lobe,lower,mm,obtuse,ovate,ovate-elliptic,pale,pedicel,peduncle,petiole,pseudo-terminal,pubescence,pubescent,reticulate-punctate,semi-ovate,shrub,simple,small,softly,stellate,stem,stigma,style,subcampanulate,subconical,subglobose,suborbicular,surface,tall,tomentose-pubescent,tree,tube,velutinous,white,whitish,x,yellow,yellowish-tan	-4.4,-5.5,-6.1,.5,/14-1/6,0-240,0.6-2.2,0.8-2.8,0.9-1.9,0.9-2,1/2-2/3,10-15,2.3-3.8,2.7-4,2.9-6,3.6-5.7,5-6.5,6-10,6-8,8-14,abaxially,accrescent,adaxiall,adaxially,ag,anthesi,apart,apex,apparently,appearing,around,articulated,attenuate,axe,axillary,ba,bark,base,becoming,berry,blade,branch,branched,bud,capitat,chartaceous,closely,completely,covering,crisped,cuneate,cylindrical,dendritic-echinoid,dendritic-multangulate,directed,distally,eaf,edge,eed,entire,enveloping,exserted,farinose,filament,fourth,free,fruiting,furfuraceou,glabrous,grayish,hair,herbarium,indument,lackin,lacking,lateral,lengthening,lobed,long,long-stalked,longitudinal,m.,main,many,margin,matted,midrib,minute,mixed,multangulat,multangulate,nearly,nflorescence,oblong,obscured,occasionally,often,older,orolla,ovate-lanceolate,perfect,persistent,plurifoliate,pore,poricidal,porrect-stellate,rachi,rather,reddish,ruit,runk,sessile,short-,short-stalked,side,slightly,slit,somewhat,soon,spaced,sparsely,specimen,splitting,stalked,stamen,strongly,sulcate,suture,tamen,thin-walled,time,tip,tomentu,touching,translucent,transparent,ud,unarme,unarmed,unevenly,unit,upper,vary,vein,wavy,way,wide,ympodial,young	abaxial,adaxial,adhesion,arrangement,capitate,colour,form,growth,height,history,inflorescence,life,ovary,perennial,plant,position,reproduction,seed,shape,size,staman,texture,unknown
127	wfo-0001026707	success	196	111	79	117	32	0.403	-1/3,/3,0.05-0.15,0.3-0.8,0.5-1,0.6-0.7,0.7-1,0.7-1.4,0.7-1.5,1.6-2,1/3,1/8-1/4,11-16,2.5-4,3-4,3-4.5,3-7,4,8-15,?,abaxially,acute,anther,apex,apically,attenuate,base,berry,blade,broad-deltate,calyx,chartaceous,clustered,cm,connivent,densely,diameter,entire,equal,fruit,glabrous,green,lateral,leaf,length,lobe,lobed,long,margin,mauve,midpoint,mm,moderately,narrow-oblong,obtuse,pedicel,peduncle,petiole,poricidal,ray,red-brown,rounded,shrub,small,spherical,stellate,stellate-pubescent,stem,style,surface,tapering,terminal,tip,tree,tube,upper,way,white,wide	-3,-5,.5,.8,0,0-20,0.05,0.1-0.2,0.5-3,0.6-0.8,1-1.7,1-3,1-5,1.5-1.8,1/3-1/2,1/3-3/4,1/4-1/3,2-10,2-2.3,2-6,2.5-3,2.5-6,3-8,5-10,5-25,5-7,5-8,5-merous,alyx,apar,apart,apparently,articulated,bark,branche,branched,broadly,color,concolorous,curved,cuspidat,decurrent,discolorous,drying,eaf,eed,elongating,erect,eye,filament,flattened-reniform,flower,foliaceous,free,fruiting,fused,gently,glabrescent,glabrou,gray,inflated,infructescence,juvenil,known,less,longer,lower,mature,naked,narrow-deltate,nflorescence,older,one,open,orange-brown,orolla,oung,per,perfec,pericarp,plurifoliat,porrect,porrect-lepidote,portion,prickle,prickly,pubescent,reflexed,ruit,scar,sessile,shorter,simple,slender,smooth,sometimes,spaced,sparsely,spreading,stalk,stalked,stout,straight,tamen,terete,time,trichome,unarmed,unit,variously,vary,venation,visible,weakly,yellow-green,ympodial,¼	adhesion,arrangement,branch,climate,colour,corolla,cuspidate,form,glandular,growth,hair,height,hermaphroditic,history,inflorescence,life,na,number,ovary,perennial,plant,position,presence,present,pubescence,reproduction,shape,size,staman,stigma,stipe,texture
128	wfo-0001026711	success	210	121	87	123	34	0.414	-15,-5,0-6,0.3-1,0.5-1.5,0.7-,0.7-1.4,0.75-1,0.8-2.2,0.9-1.1,1.5-2.2,1.7-4,1/2-2/3,1/3,2-2.2,2-3.5,2.1-2.5,3-4.5,3.5-5.2,4.5-7,7-8,acute,anther,apex,apically,base,berry,blade,calyx,cm,connivent,cuneate,densely,diameter,dull,erect,evenly,flattened-reniform,fruit,glabrous,green,lateral,leaf,length,lobe,lobed,long,lower,margin,maturity,mauve,midpoint,mm,narrow-deltate,obtuse,orange,orange-brown,pale,pedicel,peduncle,petiole,poricidal,purple,ray,red,rounded,shallowly,shrub,smooth,sometimes,spherical,stellate,stellate-pubescent,stem,style,surface,tapering,terminal,thick-chartaceous,tip,tube,upper,way,weakly,wide,yellow,young	-2,-6,-7,.2,.5,.8,0,0-0.2,0-25,0-4,0.1,0.15,0.2-0.3,0.7-0.9,0.8,0.9-1.5,1-,1-2,1-30,1.5-,1/,1/4,1/4-1/3,2-2.5,2-4,2-6,3-4,3-5,3-7,4-8,5-merous,abaxially,acicular,acuminat,alyx,ame,apar,apart,apparently,articulated,bark,branched,brow,c.,cell,concolorous,curved,deltate,difoliate,discolorous,distance,drying,eaf,eed,elliptic,elongating,equal,extending,faint,filament,flower,free,fruiting,geminat,infructescence,less,longer,mature,midvein,moderately,nflorescence,occasionally,older,one,open,orolla,oung,outline,pair,pendulous,per,perfec,pericarp,perpendicular,pit,porrect,portion,prickl,prickle,prickly,primary,raised,reduced,reflexed,ruit,scar,sessile,shorter,side,slender,small,somewhat,spaced,spreading,stalk,stalked,straight,tamen,terete,tertiary,time,trichome,unarmed,uniform,unit,variously,vary,vein,venation,visible,woody,yellow-green,ympodial	0.2,8,acuminate,adhesion,arrangement,climate,colour,corolla,form,glandular,growth,hair,height,history,inflorescence,life,na,number,ovary,perennial,plant,position,presence,pubescence,reproduction,rugulose,seed,shape,size,staman,stigma,stipe,texture,ye
129	wfo-0001026717	success	207	98	74	133	24	0.357	0.3-0.6,0.6-1.5,1-2,1-2.5,1.4-2.2,13-28,14-22,2.5-4.5,2.5-5.5,3-4,3-6,3.3-11,4-6,5-11,5-13.5,7-11,abaxially,adaxially,anther,attenuate,axillary,brownish,bud,chartaceous,cm,condition,conical,corolla,dark,diameter,drying,elliptic,fresh,fruit,glabrous,green,greenish,hair,herb,lanceolate,leaf,light,like,lobe,long,membranous,minutely,mm,mottled,odd-pinnate,ovoid,pedicel,peduncle,pentagonal,petiole,plant,puberulent,pubescent,purple,ripe,rotate,seed,size,sparsely,stigma,style,subtending,terminal,tube,violet,whitish,wide,x,yellow	0.3-2.5,0.3-5,0.8,1-10,1-3,1.3-2.5,1.8-3,15-34,2.2-5,3-5,4-8,4-9,5,5-6,5-merou,5.3-9,acumen,acuminate,ag,along,alyx,apart,apex,apparently,articulated,axe,base,berry,blade,borne,capitat,cell,ciliate,connivent,covering,darker,decreasing,decurrent,digestion,distal,dorsally,eaf,edge,eed,end,enzyme,equal,erec,especially,exceeding,filament,flat,flower,folded,forked,geminat,generally,glabrou,gradually,green-white,hair-like,half,homostylous,honeycomb-shaped,interjected,larger,lateral,leaflet,lengthening,living,lower,make,margin,medium,middle,midrib,minute,mucilaginous,narrow,nflorescence,obtuse,often,one-quarte,orbicular,orolla,ovate,pair,perfect,petiolule,plurifoliate,pore,poricidal,present,pubescen,removed,round,ruit,secondary,semierect,sessile,seudostipule,singly,slightly,slit,spaced,specimen,stamen,ste,stolo,straight,stripe,subequal,subglabrous,subsessile,symmetrical,tall,tamen,tem,testal,thick,throughout,tip,toward,tri-,tuber,typically,unit,usually,vary,wall,wet,wing,ympodial	adhesion,arrangement,calyx,capitate,colour,form,growth,height,history,inflorescence,length,life,na,ovary,perennial,position,pubescence,reproduction,rugulose,shape,staman,stem,surface,texture
130	wfo-0001026725	success	166	104	71	95	33	0.428	.5,/4,0.2,0.7-1.2,1-1.2,1-1.5,1-4.5,1-5,1.5,1.5-2,1.6-2,2,3.5-4,3.6-7.7,8-18.6,acute,anther,apex,base,beneath,broadly,calyx,capitate,cm,corolla,cup-shaped,dark,dia,elliptic,flattened-reniform,fruit,glabrous,glandular-papillose,globose,green,greenish-white,leaf,less,lobe,lobed,long,margin,minutely,mm,opposite,ovary,ovate,papillose,pedicel,petiole,pitted,poricidal,pubescent,reddish-brown,rounded,scarious,shrub,size,stem,stigma,style,surface,tip,triangular,trichome,tube,tuft,uniseriate,way,white,x	.3,1.2-1.7,1/2,2.2-4,5-20-flowered,5-5.5,5-6,8-9,accrescent,anthesi,apart,attenuate,axil,bark,becoming,berry,black,bluish,brownish-papillose,character,crackin,deflexed,differing,difoliate,dry,drying,eaf,edicel,eed,ellipsoid,evenly,extremely,filament,free,fruiting,geminat,geographically,incrassate,inflorescenc,interpetalar,large,lateral,lon,lower,main,major,margine,material,middle,minor,nflorescence,occasionally,often,older,one,onto,open,ovoid,pair,pale,paler,papillo,planar,pore,portion,prominent,proximal,reflexed,ruit,scar,shaped,short,simple,sinus,slender,slightly,spaced,split,straight,stretching,subshrub,tall,tan,tapering,tear-drop,ud,unit,upper,varying,vein,widest,winged,woody,ympodial,young	adhesion,arrangement,blade,climate,colour,diameter,form,glandular,growth,hair,height,history,inflorescence,length,life,midpoint,na,number,peduncle,perennial,plant,position,presence,pubescence,ray,reproduction,rugulose,seed,shape,staman,stellate,stipe,texture
131	wfo-0001026733	success	188	137	101	87	36	0.537	-13,-7,0.3-0.5,0.5-2,1-1.5,1-3,1-7,1.5-14,1.5-2,1.5-2.5,10-20,2-2.5,2-3,2.5-7.5,25-40,3-15,3-3.5,3-7,4,4-23,4-5,5-8,abaxially,acuminate,acute,adaxially,apex,base,blade,calyx,chartaceous,cm,color,connivent,cordate,curled,deltate,dense,densely,diameter,eglandular-pilose,eglandular-pubescent,eglandular-villous,ellipsoidal,elliptic-ovate,entire,especially,flattened,fruit,fusiform,glabrate,glabrous,gland-tipped,glandular-,glandular-puberulent,glandular-tomentose,green,greyish,hair,hirsute,immature,lanceolate,lobe,long,longitudinal,margin,membranaceous,midrib,mm,moderately,oblique,ovate,pedicel,peduncle,petiole,pilose,pubescent,pubescent-pilose,ripe,shining,simple,sometimes,sparsely,stellate,stigma,stripe,style,submarginally,toward,tree,truncate,tube,unknown,vein,villous,white,white-puberulent,wide,x,yellow,yellowish	-1,-11,-14,-15,-2,-4,-8,.5-3,0.3-2,0.5,0.5-1,0.5-4,1,1-2,15-,2-4,2-6,20-50,3-4-foliat,4.5-5,7-10,8-12,acute-acuminate,aggregate,apart,ape,articulated,axe,basal,beyond,capitat,cell,ciliat,connective,cylindrical,dia,directed,distally,eaf,eed,equal,exceeding,exserted,flower,forked,glandula,leaving,linear-triangular,lon,lower,narrowly,near,nflorescence,nther,orolla,ovoid,ovum,pedicellar,perfect,pore,present,pubescent-pilo,rachi,radiu,remnant,round,ruit,shorter,slightly,small,smooth,spaced,stamen,stone,swelling,tal,tem,thecae,time,triangular,ud,unbranched,unit,unknow,usually,vary,ympodial	adhesion,anther,arrangement,capitate,climate,colour,corolla,form,glandular,growth,height,history,inflorescence,leaf,length,life,midpoint,na,number,ovary,perennial,plant,position,presence,pubescence,ray,reproduction,rugulose,seed,shape,size,staman,stem,stipe,surface,texture
132	wfo-0001026734	success	266	120	85	181	35	0.32	0.1,0.3,1,3,8,accrescent,acuminate,anther,apex,base,blade,bright,broadly,brown,calyx,chartaceous,clavate,cm,connivent,corolla,cuneate,cylindrical,dark,densely,diameter,drying,elliptic,entire,flattened,flower,fruit,geminate,glabrous,glandular,globose,green,growth,hair,immature,internodal,lanceolate,lateral,leaf,length,less,lobe,lobed,long,long-attenuate,margin,maturity,membranaceous,midpoint,mm,moderately,narrow,oblong,obtuse,ovary,ovate,pale,pedicel,peduncle,petiole,pubescence,pubescent,purple,ray,reniform,shape,shrub,size,slightly,sparsely,stellate,stem,stigma,style,subopposite,surface,tube,white,wide,yellow,yellowish	0.2,0.5,0.6,0.7–0.9,0.7–1,0.8–1,1.6–2,1.6–2.5,1.8–2.2,1.8–3,1/4,1–1.2,1–3,2.2–7,2.3–5,2.5–3,2–2.4,2–3,3.2–3.8,3–4,3–4-celled,3–8,4–6,4–7,4–8,4–9,5-merou,5–9,abaxial,abaxially,absent,acute,adaxial,adaxiall,adaxially,ag,also,always,alyx,anthesi,apical,apice,archin,ark,articulated,associated,asymmetric,axi,barely,becoming,beneat,beneath,berry,branch,branched,caly,camptodromous,capitate,celled,central,closely,commonly,congested,covered,covering,cyme,dense,denser,differing,directed,discolorous,distally,downward,dried,due,eaf,eed,eglandular,emergent,erect,f.,fewer,flat,foliate,forked,found,free,frequently,glabrescen,glabrescent,gray,held,ilament,initially,introrsely,irregular,j,lamina,large,longer,longitudinal,lower,lying,material,mature,maturit,midri,minute,mostly,much,multiseriate,near,new,nflorescence,normally,obovate,observed,often,old,older,one,one-celled,opening,orolla,other,oung,pair,paired,papillose,perfect,pit,plane,pointing,pore,poricidal,porrect,porrect-stellate,portion,purplish,rachi,raised,rarely,rayed,reaching,rounded,ruit,scandent,secondary,sessile,shiny,short-stalked,shorter,simple,slit,smaller,sometimes,spaced,sparse,spread,spreading,stalk,still,subsessile,surfac,terminal,trichome,tuft,ud,unbranched,unequal,uniseriate,unit,upward,vary,vein,venation,vestiture,visible,whole,ympodial,¾	0.7-0.9,0.8-1,1-3,1.6-2,1.6-2.5,1.8-3,2-2.4,2.2-7,2.3-5,2.5-3,3-8,4-9,5-9,adhesion,arrangement,climate,colour,form,height,history,inflorescence,life,na,number,perennial,plant,position,presence,reproduction,rugulose,seed,staman,stipe,texture,ye
133	wfo-0001026739	success	197	118	94	103	24	0.477	0.25-0.94,0.4-5,1-2,1-3,1.2-2.1,16-54,2-9,2.5-13.5,2.6-4.8,3-4,3.2-17.5,4-8,5.6-13.1,6-13,6.6-18,abaxially,acumen,adaxially,anther,articulated,axillary,brown,brownish,bud,cell,clavate,cm,condition,coriaceous,corolla,covering,densely,diameter,distal,drying,fresh,fruit,glabrous,globose,green,green-white,greenish,hair,hair-like,half,herb,high,lanceolate,lateral,leaf,light,linear,lobe,long,make,margin,mm,mucilaginous,oblanceolate,odd-pinnate,ovate,ovoid,pedicel,peduncle,pentagonal,petal,petiole,plant,pubescent,purple,ripe,rotate,seed,short,simple,size,sometimes,stem,stigma,stripe,style,sub-glabrous,subtending,terminal,testal,thick,throughout,tube,wall,wet,white,whitish,x,yellow	0-0.34,0-38,0.5-1.2,1-10,1.4-3.5,10-60,2-4,2-5.3,2-6,2.7-6.9,3.8-8.5,5-merou,7-9,abaxiall,acuminate,acute,ag,along,alyx,apart,apex,apparently,arranged,asymmetric,attenuate,axe,base,basiscopic,bead,berry,blade,capitat,connivent,dark,decreasing,digestion,dorsally,eaf,edge,eed,enzyme,erec,exceeding,filament,flat,flower,folded,forked,geminat,generally,glabrou,hal,homostylous,honeycomb-shaped,interjected,larger,leaflet,lengthening,like,living,lower,moniliform,multiple,necklace,nflorescence,orbicular,orolla,pair,perfect,plurifoliate,pore,poricidal,removed,rest,rounded,ruit,sessile,seudostipule,side,slit,spaced,specimen,stamen,stolon,straight,subequal,tall,tamen,tem,tip,tissue,toward,tri-,tuber,typically,unit,usually,vary,wide,wing,winged,yellowish,ympodial	adhesion,arrangement,calyx,capitate,colour,form,growth,height,history,inflorescence,length,life,na,ovary,perennial,position,pseudostipule,pubescence,reproduction,rugulose,shape,staman,surface,texture
134	wfo-0001026740	success	171	103	68	103	35	0.398	0.5-1,1-2,1-3,1-5,10-20,2-3,2-4,2.5-27,2.5-3,2.5-4.5,2.5-6,3-15,3-3.5,3.5-40,4-5,4.5-10,5-40,5-8,6-10,acuminate,acute,apex,base,blade,calyx,cm,cordate,deltate,densely,diameter,ellipsoidal,elliptic,entire,flattened,fruit,glabrous,glandular-puberulent,greenish,hair,lanceolate,lobe,margin,mm,moderately,oblong,ovate,pedicel,peduncle,petiole,pilose,puberulent,pubescent,purple,simple,sparsely,stellate,stigma,style,subcoriaceous,tomentose,tree,truncate,tube,violet,white-puberulent,whitish,x,yellow	-17,-2,0-10,1-10,1-12,1-4,10-30,20-50,3-5,3-foliat,8-19,abaxially,absen,absent,acute-acuminate,adaxially,aggregate,also,apart,ape,apiculate,articulated,axe,basal,beyond,branched,browni,cell,ciliate,connective,connivent,corky,curled,cylindrical,darker,directed,distally,eaf,eed,eglandular,equal,especially,exceeding,exserted,fleshy,flower,glabrate,immature,leaving,lon,long,lower,mature,narrowly,near,nearly,nflorescence,nther,obtuse,often,orange,orolla,ovoid,pedicellar,perfect,pilo,pore,present,rachi,radiu,rarely,remnant,reticulate,ruit,scar,sessile,shorter,slightly,small,sometimes,spaced,stamen,stone,stripe,swelling,tal,tems,thecae,time,toward,triangular,truncat,ud,unbranched,unit,unlobed,vary,vein,villous,wide,woody,ympodial,young	adhesion,anther,arrangement,climate,colour,corolla,form,glandular,growth,height,history,inflorescence,leaf,length,life,midpoint,na,number,ovary,perennial,plant,position,presence,pubescence,ray,reproduction,rugulose,seed,shape,size,staman,stem,stipe,surface,texture
135	wfo-0001026752	success	169	130	103	66	27	0.609	-25,-4,1,1-12,1-2,1-3,1-5,1-6,1.5-12,1.5-2,1.5-2.5,10-20,2-2.5,2-3,2.5-20,2.5-5,20-30,3,3-18,3-4,3.5-4,4-45,4-5,abaxially,abruptly,acute,adaxially,also,apex,apiculate,articulated,base,black,branched,calyx,campanulate,chartaceous,cm,cordate,cuneate,cylindrical,darker,deltate,densely,diameter,dilated,distally,ellipsoidal,elliptic-oblong,elliptic-ovate,entire,finely,flattened,fleshy,forked,fruit,glabrous,globose,green,greenish-brown,immature,lanceolate,leaving,less,lobe,long,margin,mm,moderately,near,nearly,ovoid,papillose,pedicel,pedicellar,peduncle,petiole,pilose,possibly,pubescent,pubescent-pilose,purplish,rachi,radiu,rarely,rather,remnant,ripe,short-acuminate,simple,slightly,stellate,stigma,stripe,style,tree,truncate,unbranched,violet,white,whitish,x,yellow	-3,-50,0-,1-1.5,15-35,2,2-4,3-5,3-foliat,7-15,8-16,absent,aggregate,apart,ape,axe,basal,beyond,blade,capitat,cell,connective,connivent,coriaceous,directed,eaf,eed,equal,exceeding,exserted,flower,hair,laterally,lon,lower,narrowly,nflorescence,nther,obtuse,orolla,perfect,pilo,pore,presence,present,ruit,small,somewhat,spaced,stamen,stone,tal,tem,thecae,time,tomento,triangular,tube,ud,unit,unknow,vary,vein,wide,yello,ympodial	abaxial,anther,arrangement,bud,capitate,colour,corolla,form,growth,height,hermaphroditic,history,inflorescence,leaf,length,life,ovary,perennial,plant,position,pubescence,reproduction,seed,shape,size,stem,texture
136	wfo-0001026754	success	176	111	78	98	33	0.443	-6+,.5,0.9-1.1,1-,1.5-3,1/2,10,2,2-2.5,2-3,2-4,2.5-3.5,2/3,5,5-lobed,5.5-9,abaxially,acute,anther,apex,asymmetric,basal,base,berry,calyx,clavate,cm,conical,corolla,deeply,densely,diameter,ellipsoid,elliptic,entire,glabrous,globose,growth,half,inflorescence,irregularly,lamina,later,lateral,leaf,lobe,lobed,margin,membranous,minute,minutely,mm,narrowly,oblique,pedicel,peduncle,petiole,pubescent,simple,sparsely,splitting,stellate-rotate,stem,stigma,style,surface,terminal,trichome,truncate,tube,vein,vine,way,white,woody,x,yellow,yellowish	0.5,0.5-1,1,198.,3-4-celled,30+,4-5,5-merou,7-9,9,9-11,adaxially,ag,along,alyx,anthesi,apar,apparently,ark,articulated,axi,branched,broadly,brow,cabrera,complete,connivent,cucullat,dendritic,denser,distal,divided,eaf,ed,especially,exerted,extending,fide,filament,flower,free,halfway,ilament,leaving,lengthening,like,long,loosely,lower,many,mature,midvein,mixture,mostly,new,nflorescence,older,orolla,outline,pair,papillo,peg,perfect,pinnate,planar,plurifoliat,pore,poricidal,portion,primary,puberulent,ruit,scandent,scar,seen,sleeve,slender,slit,small,sometimes,spaced,spreading,tangled,tem,time,tip,transparent,tub,twinin,twining,ud,uniseriate,unit,upper,vary,weak,within,ympodial	adhesion,arrangement,blade,brown,climate,colour,form,fruit,glandular,hair,height,history,length,life,midpoint,na,number,ovary,perennial,plant,position,presence,pubescence,ray,reproduction,rugulose,seed,shape,size,staman,stellate,stipe,texture
137	wfo-0001026756	success	147	122	87	60	35	0.592	0-7-1.2,0.25-0.5,0.5-1,0.5-3,1-1.5,1.5-1.7,1.5-10,1.5-2,1.8-3,3-4,3.5-8.5,5-10,5-5.5,6-16,abaxial,abaxially,acute,adaxially,anther,apex,attenuate,base,bilobed,broadly,brown,calyx,cm,conical,corolla,corresponding,dark,deltate,dendritic,densely,dia,difoliate,distal,elliptic,glabrous,globose,green,hard,irregular,lax,leaf,like,lobe,lobed,long,minutely,mm,nearly,occasionally,opposite,ovary,ovate,ovoid-reniform,pale,pedicel,petiole,pinkish-white,pitted,pore,poricidal,pubescence,pubescent,rest,shape,shaped,shrub,simple,somewhat,sparsely,stem,stigma,style,surface,tear-drop,tip,tree,trichome,tube,unifoliate,uniseriate,white,wide,woody	.25,.5,1-2,1.5-3,5-10-flowered,6-10,along,anthesi,apiculate,ba,bark,berry,closely,deflexed,denser,differing,eaf,edicel,eed,erect,exserted,filament,fleshy,free,fruiting,geminat,glabrescent,grayish-brow,inflorescenc,lamina,lateral,lower,main,major,middle,minor,nflorescence,older,overlappin,pair,papillo,perhaps,pericarp,planar,portion,present,ruit,scar,soon,spaced,strongly,tall,thick,tub,ud,unit,vein,widest,ympodial,young	adhesion,arrangement,blade,climate,colour,diameter,form,fruit,geminate,glandular,grayish-brown,growth,hair,height,history,inflorescence,length,life,margin,midpoint,na,number,peduncle,plant,position,presence,ray,reproduction,rugulose,seed,size,staman,stellate,stipe,texture
138	wfo-0001026777	success	168	99	65	103	34	0.387	0.5-1,0.5-1.5,1-1.3,1-1.5,1-10,1-2,1-4,1.2-1.8,1.5-3,2-4,2-4.5,3-3.5,5-14,5-7,acuminate,acute,anther,apex,base,beneath,blue,brown,calyx,capitate,cm,corolla,cup,dia,elliptic,fide,flattened,flattened-reniform,glabrous,globose,green,growth,leaf,lobe,lobed,margin,mm,narrowly,nearly,opposite,ovary,pedicel,petiole,poricidal,pubescent,quadrate-deltoid,russet,seed,shiny,shrub,size,sparsely,stem,stigma,style,surface,tip,tube,vellozo,white,x	.25,.5,/3,0.25-0.5,0.5-5,0.9-3,1.5-5,2-5,4-8,5-50-flowered,anthesi,apart,apiculate,axil,ba,beginning,berry,body,branching,campanulate,cell,decurrent,deflexed,dense,differing,difoliate,distal,eaf,edicel,eed,end,exserted,filament,filiform,flexuous,free,fruiting,geminat,glabrate,greyi,hyaline,incrassate,inflorescenc,irregularly,lateral,like,lon,long,lower,main,major,matted,middle,minor,minutely,near,new,nflorescence,occasionally,often,older,one,onto,outline,overtopping,pair,papillo,papillose,pitted,planar,pore,portion,prominent,quite,rest,ruit,scar,shaped,sinuate,slightly,smooth,somewhat,soon,spaced,straight,tall,tapering,tear-drop,testa,thread-like,trichome,tuft,ud,uniseriate,unit,vein,wall,way,widest,woody,yellowish,ympodial,young	0.25,adhesion,arrangement,blade,climate,colour,diameter,form,fruit,glandular,greyish,hair,height,history,inflorescence,length,life,midpoint,na,number,peduncle,perennial,plant,position,presence,pubescence,ray,reproduction,rugulose,shape,staman,stellate,stipe,texture
139	wfo-0001026782	success	206	122	83	123	39	0.403	-4,0.5-1,0.5-2,1,1-1.5,1.4–2,1.5,1.8–3,2,2-5,3,3-4,8-10,abaxially,acute,adaxially,annual,anther,anthesi,apex,base,blade,blue,bluish,brown,calyx,cm,cordate,dark,darker,diameter,except,finely,fruit,glabrous,globose,green,greenish,hair,herb,immature,irregularly,length,light,lilac,lobe,margin,maturity,midpoint,mm,mottling,narrowly,obtuse,ovate,pedicel,peduncle,petiole,pubescence,pubescent,purple,ray,reniform,rotate-campanulate,simple,small,stellae,stellate,stellate-tomentose,stem,stigma,style,surface,tapered,thin-textured,tip,tomentose,triangular,tube,white,x,yellow,yellowish-brown,–5	-10,-5,0.5,0–1,0–10,1.3,1.5–2.5,1/3–1/2,10–15,15,1–3,1–5,2-foliate,2–4,3.5–8.5,3–12,4,4–10-rayed,4–13,4–6-rayed,4–9,5,6,6-7,7,abundant,abundantly,accrescent,acicular,adaxiall,additional,apiculate,armed,articulate,axe,becoming,berr,clavat,clustered,coarse,commonly,curved,dehiscent,deltoid,densely,dilated,divided,eaf,eed,enclosing,exceeding,fertile,filament,flower,fruiting,geminat,glabrou,gland-tipped,gradually,internode,interpetalar,larger,like,lon,long,lower,lowermost,main,male,midrib,minute,much,much-branched,nearly,nflorescence,numerous,often,one,orolla,pair,partially,perfect,pore,porrect-stellate,prickle,pustulate,rachi,radiu,rarely,ruit,sessile,shallow,short,shorter,slightly,smaller,somewhat,sparsely,spreading,stalk,staminate,ste,stellate-pubescent,stipitate,straight,strongly,tall,tamen,tem,terminal,thick-stalked,tissue,tooth,two,unbranched,upper,upward,vary,vein,way,woody,ympodia,–6	0-1,1-5,10-15,3-10,3-12,4-13,4-5,4-6,4-9,adhesion,arrangement,clavate,climate,colour,corolla,form,glandular,growth,height,history,inflorescence,leaf,life,lobed,na,number,ovary,plant,position,presence,present,reproduction,rugulose,seed,shape,size,staman,stipe,texture
140	wfo-0001026788	success	291	124	100	191	24	0.344	.3,0.2–0.3,0.3–0.4,0.3–0.5,0.4–0.6,0.6–1.3,0.6–1.9,0.8–1.1,0.9–1.2,0.9–1.3,0.9–2.0,1.0–1.5,1.0–2.0,1.2–1.7,1.3–1.6,1.3–2.5,1.7–1.9,1/4–1/3,2.1–2.9,2.7–5.7,2.8–3.1,3.8,3.8–4.9,4,4–8,6.4,7.8–11.0,8,8.5,acuminate,adnate,anther,attachment,attenuate,basal,calyx,chartaceous,cm,corolla,densely,developed,diameter,distinctly,dry,erect,extra-axillary,flattened-orbicular,flattened-reniform,flower,fruit,glabrous,glandular,globose,hair,incurved,interpetalar,lanceolate,lateral,leaf,lobe,lobed,longer,markedly,mature,mm,moderately,notched,orange,oval,ovate,pedicel,peduncle,petiole,point,portion,pubescent,ray,restricted,scandent,scarcely,shrub,simple,small,somewhat,sparsely,stellate,stem,stigma,style,subcoriaceous,surface,tissue,tree,tube,well,white,yellow,yellow-tan,±glabrous,×	.0,.04,.05,/3,0.4–0.7,0.5–0.7,0.5–0.8,0.6–1.0,0.8–1.8,0–,1.1–1.3,1.2–1.6,1.3–1.8,1.4–2.2,1.5–1.9,1.5–2.2,1.7,1/3,10.8,1–3,2.0,2.5–11.0,2.9–4.0,2/3,2/3s,2–3,3,3.0,3.4,4.0,4.6–6.0,4–7,5,5-merou,7.0–8.9,8.3–10.9,90°,abaxially,absent,acute,adaxially,adjacent,aequilateral,ag,alveolate,alyx,anthesi,apart,apex,apical,apparently,appearing,appressed,around,articulate,axe,ba,bark,base,based,becoming,berry,blade,branch,branching,broad,broad-based,broadly,brochidodromous,brown,bud,capitat,channeled,clinate,connivent,curved,deciduous,deflexed,deltoid,dentate,development,difoliate,directed,distal,distally,distinct,eaf,edge,eed,either,emerging,entire,evenly,exocarp,extending,fertile,filament,filiform,flat,flexed,free,geminat,glossy,gradually,homostylous,hort,increasing,intact,internode,intersepalar,juic,layer,laying,less,lon,long,lower,many,margin,midpoint,midrib,midvein,minute,nearly,nflorescence,oblique,occasionally,opaque,orolla,per,perforated,pore,porrect,porrect-stellate,potentially,presen,prickle,primary,proximal,raised,reddish,reflexe,remaining,retrorse,rigid,rounded,row,ruit,scattered,sessile,shoot,side,sigmoid,sinuate,sinus,slightly,sloughing,smoot,sometimes,soon,spaced,splitting,spread,stamen,stellae,stellate-pubescent,straight,suture,swelling,tamen,tem,thin,time,transparent,triangular,two,ud,unarmed,unbranched,upper,vary,vein,weakly,wide,yellow-ferruginou,yellow-ferruginous,ympodia,young,±90°,±dense,±equal	adhesion,arrangement,capitate,colour,form,growth,height,inflorescence,length,na,number,ovary,plant,position,presence,present,pubescence,rugulose,seed,shape,size,staman,stipe,texture
141	wfo-0001026790	success	236	125	100	136	25	0.424	-11,-19,-4,-40,0-10,0.2-0.6,0.2-1.5,0.5-2,0.5-4,0.6-10,0.7-3,1-1.5,1.5-3,1.5-5,1.8-4,1.9-2.6,1/4,1/4-1/2,2-11,2.5-4.5,2.7-3.2,3.5-17,4-9,5-10,6-8,6.5-9,7-15,abaxially,acute,anther,apex,base,berry,blade,calyx,chartaceous,cm,connivent,cordate,cream,dark,deltate,densely,diameter,dull,elliptic,equal,erect,flattened-reniform,flower,fruit,glabrous,green,lanceolate,lateral,leaf,length,lobe,lobed,long,long-styled,lower,margin,marking,maturity,mauve,midpoint,mm,moderately,narrow-deltate,orange-brown,ovate,pale,pedicel,peduncle,petiole,plant,poricidal,ray,rounded,short-styled,shrub,smooth,sparsely,spherical,stellate,stellate-pubescent,stem,stout,style,surface,tapering,terminal,tip,tube,upper,way,wide,yellow,young	-1/2,-1/3,-10,-2,-3,-6,-merous,0,0-150,0-20,0-30,0-5,0.2,0.2-0.4,0.2-2,0.7-1.5,0.8,1,1-2,1-3,1.5,1.5-2.5,1.5-4,1/2-3/,1/5-1/3,1/6-1/4,2,2-,2-3,2-30,2-5,2-7,4-,4-11,4-7,5,5-9,6-12,7-12,7-13,7-20,acuminat,adaxially,alyx,ame,andromonoecious,apar,apart,apically,apparently,articulated,bark,becoming,branched,broad-deltate,brown-green,c.,concolorous,conical,curved,discolorous,distance,drying,eaf,eed,elongated,elongating,entire,extending,filament,flattened,free,fruiting,gently,glandular,green-brown,hair,heterostylous,inflorescenc,infructescence,longer,mature,midvein,minute,near,nflorescence,obtuse,older,one,open,orolla,oung,pair,pendulous,per,pericarp,plurifoliat,porrect,portion,prickle,prickly,primary,red-brow,red-brown,reduced,reflexed,ruit,scar,sessile,side,simple,sometimes,spaced,spreading,stalk,stalked,straight,tamen,terete,tertiary,time,toward,trichome,unarme,unarmed,unit,usually,variously,vary,vein,venation,visible,weakly,woody,yellow-green,ympodial	1/2-3/4,adhesion,arrangement,climate,colour,corolla,form,growth,height,inflorescence,na,number,ovary,plurifoliate,position,presence,present,pubescence,seed,shape,size,staman,stigma,stipe,texture
142	wfo-0001026818	success	252	118	92	160	26	0.365	-15,-3,0-1,0.5-1,0.5-2.5,0.7-2,1.8-3.5,2-4,2-4.5,2.5-4,2.7-4,3-5,4-10,5-11,5-15,6.5-9.5,7-30,7-50,8-11,abaxially,acute,adaxially,anther,apex,attenuate,base,blade,branched,broadly,calyx,campanulate,cm,coarsely,cordate,deltoid,densely,dentate,diameter,elliptic,elliptic-ovate,erect,extra-axillary,fruit,glabrous,globose,hair,inflorescence,lanceolate,leaf-opposed,length,lenticular,lobe,margin,middle,minutely,mm,obtuse,orange,orange-red,outline,ovate,pedicel,peduncle,perennial,petiole,pitted,pubescence,pubescent,ray,reniform-ovate,ripe,sessile,shallowly,simple,size,sparsely,spreading-hirsute,spreadingly,stellae,stellate,stellate-pubescent,stem,stigma,style,surface,tan,thin-textured,truncate,tube,white,x,yellow	-1.5,-2,-2.5,-4.5,-7,0-1.5,0.1-0.3,0.3-0.8,0.3-1,0.3-2.5,0.5-1.5,1,1-4,1.5-,1/3,2,2-15,2-3,2-foliate,2.5-5,4-6,4-7,5-12,5-20,5-9,6-10,7-15,8-15,abrupt,abundant,accrescent,acute-,adaxiall,along,always,apart,apparent,articulated,ascending,average,axe,ba,becoming,broad-based,capitat,capitate-glandular,cast,cauline,class,closely,commonly,compresse,connivent,covering,cream,cylindrical,density,depressed-deltoid,directed,distal,distall,distinct,eaf,eed,elongate,entire,equaling,especially,essentially,felty-pubescent,female-sterile,filament,flower,foliar,frui,fruiting,geminate,grading,inserted,interlobal,large-leaved,larger,largest,lateral,laterally,less,lignescent,like,long,longest,lower,major,maturit,mesocarp,midpoint,midrib,mixture,mostly,multiseriate,nearly,nflorescence,numerous,oblique,obtuse-,occasionally,often,one,orolla,oung,ovate-lanceolate,per,perfect,persistent,pore,prickle,prickly,principal,prominent,purplish,rachi,radiu,round-tipped,ruit,scattered,short,shorter,side,similar,sinus,smaller,sometimes,somewhat,spaced,sparse,spreading,stalk,stalked,ste,stipitate,tal,tamen,termination,thickened,time,tooth-like,transition,trichome,two,unarmed,unbranched,unit,usually,variable,vary,vein,vivo,weakly,wide,yellowish,ympodial	adhesion,arrangement,capitate,colour,corolla,form,glandular,growth,height,history,leaf,life,na,number,ovary,plant,position,presence,reproduction,rugulose,seed,shape,staman,stipe,texture,ye
143	wfo-0001026819	success	218	114	88	130	26	0.404	1-2,1.5-10,1.5-12,1.5-3.3,1.6-3.5,10-26,2-5,2.5-5,3-120,3-18,3-35,3-38,4-7,5-30,6-11,abaxially,acute,adaxially,anther,attenuate,blue,broadly,brownish,bud,capitate,chartaceous,cm,condition,connate,connivent,corolla,densely,diameter,dot,drying,elliptic,fresh,fruit,glabrous,globose,green,greenish,hair,herb,lanceolate,light,like,lobe,long,lunate,membranous,minutely,mm,moderately,mottled,narrowly,non-glandular,odd-pinnate,ovate,ovoid,pedicel,peduncle,pentagonal,plant,puberulent,pubescent,purple,rotate-pentagonal,scale-like,scattered,seed,short,slightly,stem,stigma,stripe,style,subglabrous,subtending,terminal,tinged,tube,usually,violet,white,whitish,wide,yellow	0-27,0.3-4.7,0.5-1.5,1-10,1-2.3,1-5,1.2-36,1.5-3.0,1.5-3.5,10,2-6,3-20,4,4-10,5-merou,7,absent,acumen,acuminate,ag,along,alyx,apart,apex,articulated,ascending,base,bearing,blade,borne,cell,ciliate,clavat,covering,cuneate,curved,dark,decurrent,digestion,distal,dorsally,eaf,edge,eed,end,enzyme,erec,especially,exceeding,filament,flat,flower,folded,forked,geminat,generally,glabrou,glaucous,greatly,green-white,greenish-yellow,hair-like,half,homostylous,honeycomb-shaped,interjected,larger,lateral,leaflet,lengthening,living,lower,make,margin,middle,midvein,mucilaginous,nflorescence,oblique,often,orolla,pair,pedice,petiole,petiolule,plurifoliate,pore,poricidal,rachi,ranging,removed,ruit,seudostipule,singly,slit,sometimes,somewhat,spaced,specimen,stamen,star,ste,stolo,straight,subequal,suborbicular,subrosette,symmetrical,tall,tamen,tem,tertiary,testal,therefore,thick,throughout,tip,tri-,truncate,tuber,typically,unit,unwinged,vary,wall,wet,wing,within,without,ympodial	adhesion,arrangement,calyx,clavate,colour,form,growth,height,history,inflorescence,leaf,length,life,na,ovary,perennial,position,pseudostipule,pubescence,reproduction,rugulose,shape,size,staman,surface,texture
144	wfo-0001026821	success	204	122	92	112	30	0.451	.2,/3,0.3-1.2,0.3-2.5,0.4-1.5,0.5-1.2,0.7-1.8,0.8-1,1-2,1-5,1.2-1.5,1.5-2.5,2-3.5,2-celled,2.5-18,3-18,4-4.5,5-12,5-20,5-34,abaxially,adaxial,adaxially,angular,anther,apically,appressed,auriculate,base,bayonet,broadly,brown,cm,cordate,dark,diameter,due,ellipsoidal,elliptic,flattened,fruit,fused,gglobose,glabrous,green,hair,herb,incurved,lanceolate,lateral,leaf-opposed,length,light,lobe,long,mature,membranous,mm,narrowly,obliquely,oblong,odd-pinnate,pale,pedicel,peduncle,petiole,pilose,puberulent,pubescent,remnant,reniform,rounded,scandent,short,slender,small,somewhat,sparsely,stellate,stigma,stripe,style,subglabrous,substellate,surface,thickening,tube,wall,white,winged,x,yellow	0-20,0.2-1.5,0.5-3.5,1-1.5,1-20,1-3,10-15,17,1977,2-15,2-6,3-11,3-6,3-7,3-branched,3-celled,5-10,5-merou,acuminate,acut,ag,alyx,anderson,apart,apex,apical,apiculate,articulated,axe,ba,basal,berry,blade,bract,cell,chartaceous,ciliat,cuneate,deltate,directed,distal,distally,eaf,eed,equal,especially,exceeding,filament,flower,forked,frequent,geminat,glabrou,gland-tipped,greatly,homostylous,interjected,interstaminal,large,leaflet,long-attenuate,longitudinal,lower,lowermost,many,margin,mean,membrane,minute,minutely,moderately,much,nflorescence,oblique,obtuse,occasional,occasionally,one-celled,opening,orolla,pair,paired,per,perfect,petiolule,plurifoliate,pore,present,pseudostipular,pubescen,rachi,rarely,reduced,ruit,seudostipule,slightly,slit,smaller,spaced,stamen,subtended,tamen,tem,terminal,time,tri-,truncat,unbranched,unit,vary,wide,ympodial	abaxial,adhesion,arrangement,calyx,colour,corolla,form,growth,height,history,inflorescence,leaf,life,na,ovary,perennial,plant,position,pseudostipule,pubescence,reproduction,rugulose,seed,shape,size,staman,stem,texture,truncate,type
145	wfo-0001026827	success	143	98	75	68	23	0.524	/3,0.2-0.5,0.4-0.6,0.5-2,0.6-1,1-,1-1.1,1-1.5,1-2,1-2.1,1.3-1.6,1.5-2,2-2.2,2-2.5,2-4,3-9,5-6,abaxially,age,anther,apex,base,branched,broadly,calyx,clavate,cm,conical,corolla,deltate,dendritic,densely,diameter,distally,especially,filament,glabrescent,glabrous,growth,inflorescence,internodal,irregularly,lanceolate,leaf,lengthening,like,lobe,lobed,mm,narrowly,oblanceolate,ovary,papillate,pedicel,peduncle,petiole,pore,poricidal,pubescent,reddish,shrub,sinus,slit,sparsely,stem,stigma,style,surface,tip,trichome,tube,uniseriate,way,white,x	.5,7-9,?,acute,adaxiall,and/or,anthesi,apart,appearing,arachnoid,attenuate,bark,branch,crowded,deciduou,dense,dry,drying,eaf,ellipsoid,erect,exerted,fleshy,flower,free,know,known,lamina,less,lower,margin,minutely,near,new,nflorescence,nodding,ot,pair,paler,papillat,perfect,planar,plane,plurifoliat,portion,primary,rachi,revolute,scar,simple,slender,small,soon,stout,straight,strongly,surfac,terminal,thick,thickened,third,tub,ud,unit,upper,vein,widest,ympodial	1.5,adaxially,arrangement,colour,form,fruit,height,hermaphroditic,history,length,life,na,perennial,plant,plurifoliate,position,pubescence,reproduction,rugulose,seed,shape,size,texture
146	wfo-0001026830	success	198	102	77	121	25	0.389	0.3-1.3,0.4-1,0.9-1.9,1-11,1-2,1.5-4,10-57,2.5-5,4-14.5,4-7,4.4-14.5,4.5-17.5,5-11,6-13,abaxially,adaxially,anther,axillary,brown,brownish,bud,ciliate,clavate,cm,condition,coriaceous,corolla,deep,diameter,drying,elliptic,finely,fresh,fruit,glabrescent,glabrous,globose,green,greenish,hair,herb,lanceolate,leaf,linear,lobe,long,margin,medium,mm,moderately,odd-pinnate,ovate,ovoid,pedicel,peduncle,pentagonal,plant,puberulent,pubescent,purple,ripe,rotate,seed,short,simple,size,stigma,stripe,style,subglabrous,subtending,terminal,tube,white,whitish,x,yellow	0-10,0.5-1.0,0.5-1.2,1-10,1.1-2.7,1.4-4,2-4,2-6,2.5-4.4,2.7-8,3.5-8.5,4-10,5-merou,7-18,acumen,acuminate,acute,adaxiall,ag,along,alyx,apart,apex,apparently,arranged,articulated,asymmetric,attenuate,axe,base,basiscopic,bead,berry,blade,capitat,cell,connivent,covering,decreasing,digestion,distal,dorsally,eaf,edge,eed,enzyme,erec,exceeding,filament,flat,flower,folded,forked,geminat,generally,glabrou,green-white,hair-like,hal,half,high,homostylous,honeycomb,interjected,lateral,leaflet,lengthening,light,like,living,lower,make,moniliform,mucilaginous,multiple,necklace,nflorescence,orbicular,orolla,pair,perfect,petiole,petiolulate,plurifoliate,pore,poricidal,removed,rounded,ruit,sessile,seudostipule,shaped,side,slit,spaced,specimen,stamen,stolon,straight,subequal,subglabrou,tall,tamen,tem,testal,thick,throughout,tip,tissue,toward,tri-,tuber,typically,unit,unwinged,usually,vary,wall,wet,yellowish,ympodial	adhesion,arrangement,calyx,capitate,colour,form,growth,height,history,inflorescence,length,life,na,ovary,perennial,position,pseudostipule,pubescence,reproduction,rugulose,shape,staman,stem,surface,texture
147	wfo-0001026831	success	207	126	93	114	33	0.449	-6.5,-9,/4,0-6,0.1-0.25,0.2-1,0.3-0.65,0.5-1.2,0.6,0.6-2,0.65-1,0.7-2,1-2.2,1-2.5,1.5-2.5,1/3,2-2.5,2.3-2.9,2.5-4.5,3-6,7-10,7-8,abaxially,acute,anther,apex,apically,attenuate,base,berry,blade,bright,calyx,chartaceous,cm,connivent,cream,dark,deltate,densely,diameter,dull,elliptic,erect,flattened-reniform,fruit,glabrous,gray-brown,green,lateral,leaf,length,lobe,lobed,long,lower,margin,marking,maturity,mauve,membranous,midpoint,mm,moderately,narrow-cuneate,orange,orange-brown,pale,pedicel,peduncle,petiole,poricidal,ray,rounded,scandent,shrub,sometimes,sparsely,spherical,stellate,stellate-pubescent,stem,style,surface,tapering,tip,tube,upper,way,white,wide,yellow,young	-0.25,-5,.5,0-10,0-20,0-3,0.1,0.1-0.2,0.15-0.25,0.2-0.4,0.3-0.6,0.7-1.1,1-10,1-2,1-3,1-4,1-6,1.2-2,1/3-1/,1/3-2/3,1/5-1/4,2-3,2-4,3-5,3.5-10,5-merous,alyx,apar,apart,apparently,articulated,bark,branched,broad-deltate,brow,caudat,cell,concolorous,curved,difoliate,distance,drying,eaf,eed,elongating,equal,extending,eye,filament,flower,free,fruiting,fully,geminat,glabrescent,herbaceous,infructescence,less,longer,mature,midvein,multangulate,naked,nflorescence,oblong,occasionally,older,one,open,opening,orolla,oung,outline,ovate,pair,pendulous,per,perfec,pericarp,porrect,portion,prickl,prickle,prickly,primary,raised,red-brown,reduced,ruit,scar,sessile,shiny,shorter,side,slender,smooth,spaced,spreading,stalk,subsessile,tamen,terete,tertiary,time,trichome,unit,usually,vary,vein,venation,visible,white-gray,yellow-green,ympodial	1/3-1/2,adhesion,arrangement,caudate,climate,colour,corolla,form,glandular,growth,hair,height,history,inflorescence,life,na,number,ovary,perennial,plant,position,presence,pubescence,reproduction,rugulose,seed,shape,size,staman,stigma,stipe,texture,ye
148	wfo-0001026841	success	139	89	51	88	38	0.367	0.25-0.5,0.5-1,0.6-1,0.8-1,0.8-3,1.5,1.5-2,3-6.5,3.5-5,4-8,6-8,9.2-18,acute,anther,apex,base,bi-lobed,broadly,calyx,clavate,cm,conical,corolla,deltoid,dia,elliptic,glabrous,globose,green,inflorescence,leaf,lobe,lobed,margin,mm,opposite,ovary,pedicel,petiole,poricidal,pubescent,shining,shrub,sparsely,stem,stigma,style,tip,tube,white,x	.25,.5,/4,0.05,0.25-0.3,0.5-0.75,0.5-2,0.75-1,2-2.5,5-8-flowered,7-9,along,anthesi,apart,arch,axi,ba,bark,beneath,berry,coroll,curly-tipped,decurrent,deflexed,eaf,edicel,eed,ellipsoid,exsertion,filament,filiform,free,fruiting,glabrate,greyish-gree,hyaline,immature,joined,known,later,lateral,like,lon,long,lower,main,middle,minutely,nflorescence,older,pair,paler,papillo,papillose,pore,portion,prominent,raised,reddish,reflexed,rest,ruit,scar,series,shaped,simple,slender,slightly,spaced,straight,tall,tapering,tear-drop,terminal,thickened,trichome,ud,unevenly,unifoliat,uniseriate,unit,vein,way,widest,winged,woody,ympodial,young	0.25,adhesion,arrangement,blade,climate,colour,diameter,form,fruit,glandular,greyish-green,growth,hair,height,history,length,life,midpoint,na,number,peduncle,perennial,plant,position,presence,pubescence,ray,reproduction,rugulose,seed,shape,size,staman,stellate,stipe,surface,texture,unifoliate
149	wfo-0001026849	success	180	119	99	81	20	0.55	0-10,0.5-1,1,1-1.5,1-2,1-6,1.5-2.5,1.75-2,2,2-3,38/2,5,5-10,637/2,7-8,acute,adult,anther,apex,aster,axil,base,brown,calyx,capitate,cell,cm,colour,conical,corolla,cyme,discoidal,distinctly,entire,erect,except,expanded,filament,filled,flesh,floral,flowered,fork,free,glabrous,glandular,granule,green,grey-brown,growth,hair,inflorescence,lavender,leaf,less,linear-lanceolate,little,long-cuneate,loosely,margin,minute,minutely,mm,oblong,oblong-lanceolate,ovary,pale,pedicel,peduncle,petiole,poricidal,purple,reproducing,reticulate,rh,rhachi,rotate,rounded,sea,seed,short-lived,shrub,simple,slightly,stem,stigma,stone,stony,stout,style,surface,tip,tube,undulate,vegetatively,violet,well,x,young	-50,100-130,11,30-,40,80-,adherent,amongst,appearing,aspect,australian,berry,composed,conspicuous,curved,cut,deflexed,developed,dia,distinct,eed,ellipsoid,emarginate,enlarge,exceeding,exerted,facetted,flower,fruiting,general,globose,globular,greater,gree,half,interacuminal,large,leave,lengthening,lobe,lon,long,lower,mature,maturity,mid-vein,native,nflorescence,occasionally,often,pal,pedicellate,petal,plurifoliat,pore,preparation,pruinose,rarely,relatively,ruit,ruiting,shallow,shed,sinus,slende,slit,soft-wooded,solanum,solitary,sometimes,somewhat,soon,thus,tissue,tub,ud,unarmed,unit,uvenile,way,ympodial	30-50,8,arrangement,diameter,enlarged,form,fruit,height,history,juvenile,length,life,plant,plurifoliate,position,pubescence,reproduction,shape,size,texture
150	wfo-0001026851	success	267	119	82	185	37	0.307	.8,4-5,5,acute,andromonoecious,anther,apex,base,berry,bilobed,blade,bright,broadly,calyx,capitate,circular,cm,connivent,cordate,dark,diameter,except,fading,flattened,fruit,glabrous,gland,globose,glossy,greenish,hair,hyaline,inside,irregularly,lateral,leaf,less,light,lighter,lobe,lobed,long,margin,matte,membranous,minute,minutely,mm,moderately,orange,outside,ovate,pedicel,peduncle,petiole,pilose,plant,pubescence,pubescent,shrub,similar,simple,size,slightly,stellate,stem,stipitate,stipitate-glandular,straw-colored,style,suborbicular,surface,tapering,tip,triangular,tube,white,wide,yellow,yellowish,–13,–2	-2,-celled,.4,0.3–1,0.8–1.5,0–1,1,1-7,1.5,1.5–2,1.5–2.8,10-15,15,175–415,1979,1–4.5,1–7,2,2.2–3.6,2.5–4,2/3,2–10,2–3,2–3.5,300,3–3.6,3–5,4–5-celled,4–6,4–6-celled,5-merous,5–6.5,5–7-celled,6–11,7–12,8–10.5,8–15,=,abaxial,abaxiall,abundant,acicular,adaxial,almost,alyx,apar,appearing,armed,articulated,average,ba,becoming,branched,c.,ciliate,coarse,coarsely,coil,complete,conspicuous,conspicuously,curve,densely,dentate,difoliate,directed,distall,distally,dot,eaf,eed,elongating,endocarp,enlarged,entire,equal,evenly,exceeding,eye,fertile,fide,filament,fine,flexuous,flower,free,fruiting,geminat,grading,gradually,green,heavily,heterostylous,infructescence,lacking,large,larger,lenticel,little,live,long-styled,lower,major,making,merely,midrib,minor,mostly,much,n,naked,narrowly,near,nearly,nee,nflorescence,occasionally,often,one,orolla,otherwise,oung,pair,papillo,pattern,per,pericarp,pore,poricidal,portion,preserved,prickle,prickly,recurved,reflexed,rest,ruit,sap,scanden,scant,scar,scarious,scattered,sessile,shiny,short-styled,slender,small,smaller,sometimes,somewhat,spaced,sparsely,specimen,speckled,spongy,sprawling,spreading,stamen,staminat,straight,tall,tamen,tasteles,terete,thick,thickened,tooth,tough,trichome,twice,unarmed,unbranched,uniform,unit,usually,vary,vein,visible,watery,way,well,wing,winged,ympodial	0.3-1,1.5-2,2-10,2-3.5,4-6,5-6.5,6-11,7-12,adhesion,arrangement,climate,colour,corolla,form,glandular,growth,height,history,inflorescence,length,life,midpoint,na,number,ovary,perennial,position,presence,ray,reproduction,rugulose,seed,shape,staman,stigma,stipe,texture
151	wfo-0001026858	success	153	77	52	101	25	0.34	-30,0.8,0.8-1,1-11.5,1.3-1.5,1.5-4,2-3,2-4,2.5-3,3-4,4.5-10.5,6-10,6-7,abaxially,adaxially,calyx,cm,connate,corolla,diameter,distal,forked,generally,glabrescent,glabrous,globose,green,green-white,half,herbaceous,leaf,light,long,mm,odd-pinnate,ovate,ovate-lanceolate,ovoid,pedicel,peduncle,perennial,petiole,plant,seed,shiny,size,stellate,stigma,style,throughout,wide,yellow	-4,0-.,0.5,1-,1-10,1-4,1-5,2-2.5,3-,3-6-foliat,4-24,5-15,6-18,abruptly,acumen,acute,apex,apical,apically,articulate,base,branched,cell,cordate,covering,cuneate,cyme,dehiscent,dichasial,dichasially,digestion,diminishing,dorsally,eaf,ebracteate,edge,eed,emoval,enzyme,exceeding,filament,flat,flower,folded,globo,hair-like,honeycomb,interjected,introrse,lateral,leaflet,living,lobe,lon,lower,lunat,make,maturing,minute,monochasial,mucilaginous,mucronate,nflorescence,nther,oblique,oblong,obtuse,often,orolla,pair,pattern,perfect,plan,poricidally,proximal,reveal,rounded,ruit,seudostipule,short,slightly,slit,specimen,stamen,straight,tal,tem,testal,thick,throughou,toward,triangular,tuber-bearing,typically,unit,vary,wall,white-crea,without,ympodial,¼	3-15,anther,arrangement,colour,form,fruit,growth,height,history,inflorescence,length,life,na,ovary,position,pubescence,reproduction,rugulose,shape,stem,surface,texture,true,tube,white-cream
152	wfo-0001026870	success	206	110	83	123	27	0.403	.5,0-0.1,0.2-0.35,0.25-0.5,0.4-0.8,0.5-1,0.7-1.4,1.4-1.8,2-3,2-3.5,2-5,2-6,2-7,3-12,4-5,5-7.5,7-11,7-8,9.5-12,absent,acute,anther,apex,base,black,blade,brownish,calyx,chartaceous,cm,cuneate,deeply,deltate,densely,diameter,dioecious,elliptical,erect,extra-axillary,forked,fruit,glabrous,globose,grey,grey-green,hair,inflorescence,lanceolate,length,lobe,lobed,long,margin,midpoint,mm,obtuse,ovate,ovate-reniform,pedicel,peduncle,perennial,petiole,plant,present,purple,ray,rhizomatous,rotate,rotate-stellate,rusty,shrub,simple,stellate-pubescent,stem,stigma,style,surface,throughout,tube,unknown,white,x,yellow	%,.05,0,0-1,0.05-0.15,0.2-1.2,0.25-0.4,0.3-0.4,0.7-2,1,1-11,1-4,1-5,1.5-2,1.9-3,10-14,11-14,12-28,140-600,15-25,18-30,2-foliate,2.5-12,3-10,3-5,300-600,4-7,4-9,5-merou,6-70,abaxially,abundant,accrescent,acicular,adaxiall,adaxially,alyx,apart,armed,articulated,ascending,axe,ba,basal,broad-based,broadly,brown,color,cylindrical,d.,diamete,directed,distal,distall,distributed,dult,eaf,eed,eglandular,enclosing,female,filament,finely,finger,flattened,flower,fruiting,functional,geminat,glabrou,gland-tipped,heterostylous,index,interpetalar,lamina,lateral,lobing,lon,longer,lower,male,mature,midvein,minute,nflorescence,oblique,orolla,part,per,pore,porrect,presen,prickle,probably,pseudo-racemose,reticulate,ridged,ruit,sessile,short,side,solitary,spaced,stage,stalk,stellae,straight,tal,tamen,terete,thick,time,tissue,triangular,unbranched,unit,unknow,uvenile,vary,vein,wide,yellowish,ympodial	adhesion,arrangement,climate,colour,corolla,form,glandular,growth,height,history,leaf,life,na,number,ovary,position,presence,pubescence,reproduction,rugulose,seed,shape,size,staman,stellate,stipe,texture
153	wfo-0001026874	success	222	116	76	146	40	0.342	.3,.5,0-1,0.5,1.5,3-5,acuminate,acute,anther,apex,asymmetric,attenuate,base,blade,broadly,calyx,cm,connivent,dark,diameter,entire,flower,fruit,glabrate,glabrous,glandular,glandular-pubescent,globose,growth,hair,lanceolate,leaf,length,lenticular,lobe,margin,mm,near,obtuse,orange,ovate,pedicel,peduncle,petiole,pinnatifid,point,present,pubescence,pubescent,reddish,repand,ripe,rounded,scabrous,shiny,shrub,simple,slender,sparsely,stellate,stellate-pentagonal,stellate-tomentose,stem,stigma,style,subulate,surface,tan,thin-textured,truncate,tube,weakly,white,widest,x,yellow	0,0.2–0.6,1.5–2.5,1.5–4,1.5–5,12–20,15-20,1–,1–3,2,2-foliate,2–2.5,2–3,2–4,2–5,2–6,2–several-branched,4.5,4–7.5,5.5,5.5–7.5,5–15,6-7,6–12,6–9,8-12,8–20,9.5–11.5,abaxially,absent,across,adaxiall,adaxially,along,apar,apical,axe,basally,based,berry,beset,broad,capitate,caudate,clavat,colored,compressed,deltoid,dense,densely,depressed,developed,drying,eaf,eed,erect,except,filament,filiform,finely,flowering,foveolate,fruiting,geminat,generally,glabrou,gland,green,hermaphroditic,internode,interpetalar,juvenile,lance,lanceolat,lanceoloid,larger,lateral,laterally,lighter,like,lon,long,lower,main,major,midpoint,midrib,midvein,minute,moderately,narrowly,new,nflorescence,often,orolla,ovoid,per,perfect,pore,portion,prickle,prickly,prominently,pubescen,rachi,recurved,reduced,ruit,scattered,sessile,short,side,similar,slightly,small,sometimes,somewhat,spaced,sparse,spreading,stalked,stellae,straight,swollen,tall,tamen,tem,tip,tipped,tissue,tooth,ud,unarmed,upon,usually,variable,vary,varying,vein,vestiture,warty,widely,yello,ympodia,–5,–many	0.2-0.6,1-3,1.5-2.5,1.5-4,12-20,2-2.5,2-3,2-6,4-7.5,5.5-7.5,6-12,6-9,8-20,9.5-11.5,adhesion,arrangement,clavate,colour,corolla,form,height,history,inflorescence,life,na,number,ovary,perennial,plant,position,presence,ray,reproduction,rugulose,seed,shape,size,staman,stipe,texture
154	wfo-0001026895	success	166	114	87	79	27	0.524	.5,0.5-1.2,0.5-1.5,0.5-2,0.8-1,1-1.5,1-5,1.4-2.1,1.5-2,2-2.3,2-2.5,2-3,2/3,3-12,4.5-5,along,anther,apex,apically,base,broadly,brown,calyx,capitate,cm,conical,corolla,dark,deltoid,dendritic,denser,dia,drying,elliptic,flattened,glabrate,glabrous,globose,green,hard,incrassate,internodal,lamina,leaf,lobe,lobed,margin,minutely,mm,mustard,narrowly,often,ovary,pale,pedicel,petiole,pitted,pointed,poricidal,pubescent,reddish,reniform,scattered,shape,shrub,shrublet,simple,size,small,soon,sparsely,stem,stigma,style,surface,swollen,tan,tip,trichome,tube,uniseriate,vein,way,white,woody,x,yellow	0-0.5,0.5-1,2.5-3.2,5-6,5-8-flowered,abaxial,acute,adaxial,anthesi,apical,appearing,attenuate,ba,bark,berry,borne,broad,campanulate,closely,contracted,deflexed,differing,difoliate,eaf,edicel,eed,ellipsoid,elongate,erect,filament,filiform,free,fruiting,geminat,lateral,like,lon,long,long-exserted,lower,main,major,middle,minor,minute,nflorescence,obovate,older,overlappin,pair,papillo,pericarp,pore,portion,present,projection,reddish-brow,ruit,scar,shaped,shoot,short,side,somewhat,spaced,swollen-based,tall,tear-drop,thin,toothed,tub,tuft,type,ud,unit,usually,widest,ympodial,young	adhesion,arrangement,colour,diameter,form,fruit,growth,height,history,inflorescence,length,life,na,number,peduncle,plant,position,presence,pubescence,ray,reddish-brown,reproduction,rugulose,seed,staman,stellate,texture
155	wfo-0001026905	success	204	125	92	112	33	0.451	0-2,0.15,0.3-0.4,0.4-1,0.5-0.7,0.5-1.5,0.6-0.7,0.75-1.1,0.9-1.3,1-2,1-2.5,1-3.7,1.9-2.5,1/2-3/4,1/3,2.5-2.9,2.5-3.5,3-5,3-8,6-8,7-8,abaxially,acute,anther,apex,apically,attenuate,base,berry,blade,calyx,chartaceous,cm,connivent,cream,dark,deltate,densely,diameter,dull,erect,flattened-reniform,fruit,glabrous,green,inflorescence,lateral,leaf,length,lobe,lobed,long,lower,margin,marking,maturity,mauve,midpoint,mm,moderately,orange,orange-brown,pale,pedicel,peduncle,petiole,poricidal,ray,red,rounded,shallowly,shrub,sometimes,sparsely,spherical,stellate,stellate-pubescent,stem,style,subentire,surface,tapering,tip,tube,upper,usually,way,weakly,white,wide,yellow,young	-1.5,-10,-2,-2/3,-3,-4,.2,.5,0,0-20,0-25,0.1,0.2-0.3,0.2-0.5,0.4,0.4-0.9,0.7-1.4,1,1-20,1-4,1-6,1/4,1/5-1/3,2-3,2/3-3/,5-6,5-merous,acuminat,alyx,ame,apar,apart,apparently,articulated,bark,branched,brow,c.,cell,curved,difoliate,discolorous,distance,drying,eaf,eed,elongating,equal,extending,eye,filament,flower,free,fruiting,geminat,gray-green,infructescence,longer,mature,midvein,naked,oblong,older,one,open,orolla,oung,outline,ovate,pair,pendulous,per,perfec,pericarp,pit,porrect,portion,prickl,prickle,prickly,primary,raised,reduced,ruit,scar,sessile,shorter,side,slender,small,smooth,somewhat,spaced,spreading,stalk,stalked,straight,tamen,terete,tertiary,time,trichome,unarmed,unit,variously,vary,vein,venation,visible,woody,yellow-green,ympodial	2/3-3/4,acuminate,adhesion,arrangement,climate,colour,corolla,form,glandular,growth,hair,height,history,life,na,number,ovary,perennial,plant,position,presence,pubescence,reproduction,rugulose,seed,shape,size,staman,stigma,stipe,texture,unknown,ye
156	wfo-0001026923	success	177	121	91	86	30	0.514	0-5,0.25-0.5,0.5-1,0.6-0.8,0.8-1,1,1-1.5,1-7,10,2,2-6,3-5,4-18,5-10,5-15,5-9,abaxially,acuminate,acute,adaxially,anther,apart,apex,articulated,base,black,blade,brown,calyx,chartaceous,cm,cuneate,curved,deltate,densely,diameter,elliptic,elliptic-ovate,entire,erect,flattened,flower,fruit,glabrescent,glabrous,glandular,globose,green,hair,leaf,leaf-opposed,light,lobe,margin,midpoint,mm,moderately,oblong,orange,pedicel,peduncle,petiole,possibly,pubescence,pubescent,purple,ray,red,ripening,rounded,rugulose,shrub,simple,small,sometimes,spaced,sparsely,stellate,stem,stigma,straight,strongly,style,surface,tip,tree,tube,white,x,yellow,yellowish	-5,.1-0.3,.5,0.5,1-3,1-4,1.5-2,1.5-4,2-2.5,2-3,20-50,3-4,4-5-,5-6,absent,accrescent,adaxiall,ag,apparently,axe,ba,branched,capitat,center,connivent,covering,cylindrical,denser,directed,distally,eaf,eed,eglandular,equal,filament,forked,frui,fruiting,fused,geminate,gland-tippe,held,intermediate,lanceolate,large,lateral,like,long,longitudinal,lower,many-foliate,midvein,much,multangulate,nearly,nflorescence,opening,orolla,paired,peltate,perfect,pore,rachi,relatively,ruit,scale,sessile,short,slightly,slit,smaller,somewhat,ste,subtending,tal,tamen,tem,time,trichome,unit,uprigh,usually,vary,whitish,wide,ympodial	0.1-0.3,adhesion,arrangement,capitate,climate,colour,corolla,dense,form,gland-tipped,growth,height,history,inflorescence,length,life,na,number,ovary,plant,position,presence,reproduction,seed,shape,size,staman,stipe,texture,ye
157	wfo-0001026924	success	190	108	80	110	28	0.421	0-0.2,0-2.3,0.2-0.4,0.5-0.6,0.5-0.7,0.5-6,0.8-2.6,0.9-1.3,1-1.5,1-4,1.1-4.2,2-4,2.8-8.5,4.3-6.2,5-7,7-8,8-9,acute,adaxially,anther,apex,base,blade,brown,calyx,chartaceous,cm,cordate,cuneate,densely,diameter,drab,drying,entire,extra-axillary,finally,fruit,glabrous,globose,green,grey,grey-green,herbaceous,inflorescence,lanceolate,length,light,lobe,lobed,long,margin,mm,narrowly,obtuse,ovate,pale,pedicel,peduncle,petiole,present,purple,ray,resprouter,rostrate,rusty,shallowly,simple,sparsely,stellate,stellate-pubescent,stem,stigma,style,surface,triangular,truncate,tube,x,yellow,yellowish	%,-4,0-1.5,0-2,0.05-0.1,0.05-0.2,0.1-0.3,0.4-0.5,0.5-0.8,0.5-1.5,0.7-1.1,0.7-1.2,0.8-1.2,1-6,10-13,17-40,2-,2-2.5,2-foliate,3,3-6,4-7,5,5-merou,6-8,7-10,abaxially,absen,absent,accrescent,acicular,across,adaxiall,alyx,apart,apparently,appearance,axe,capitat,connivent,curved,cylindrical,d.,directed,distall,distally,distributed,dult,eaf,eed,eglandular,erect,finger,first,flower,fruiting,geminat,glabrou,gland-tipped,hair,half,lamina,lateral,less,longer,lower,markedly,mature,mid-poin,midpoint,minute,minutely,nflorescence,oblique,orolla,part,per,perfect,pore,porrect,prickle,pseudo-racemose,rachi,raisin-like,ruit,short,slightly,spaced,stage,stalk,stellae,straight,tal,tamen,thick,thicker,thicknes,throughout,time,unarme,unarmed,unbranched,undulate,unit,unknow,uvenile,vary,white,wide,ympodial	adhesion,arrangement,capitate,colour,corolla,form,growth,height,history,leaf,life,na,number,ovary,perennial,plant,position,presence,pubescence,reproduction,rugulose,seed,shape,size,staman,stipe,texture,unknown
158	wfo-0001026925	success	215	120	91	124	29	0.423	.5,0.1-0.3,0.5-1.5,0.9-1.8,1-1.4,1-25,1-3.5,1.8-2,1/3,1/3-1/2,2.4-2.6,2.4-3,3-7,4-14,4-7,5-8,6-10,6-17,6-8,7-12,abaxially,acute,andromonoecious,anther,apex,attenuate,base,berry,blade,calyx,chartaceous,cm,connivent,cream,dark,deltate,diameter,elliptic,equal,erect,flattened-reniform,fruit,glabrescent,glabrous,green,hair,lateral,leaf,length,lobe,lobed,long,lower,margin,marking,maturity,mauve,membranous,midpoint,mm,moderately,narrow-deltate,orange-brown,ovate,pale,pedicel,peduncle,petiole,plant,poricidal,ray,shrub,sparsely,spherical,stellate,stellate-pubescent,stem,stout,style,surface,tapering,terminal,tip,tube,upper,way,white,wide,yellow,yellow-orange,young	-2,/6,0,0-10,0-20,0-5,0-7,0.1,0.1-0.2,0.2,0.5-4,0.7-1.8,00-200,1-1.3,1-3,1-4,1.5-2,1.5-2.5,1.5-4.5,1.8-2.5,1/4-2/3,1/6-1/3,2-4,2-5,2.5-6,2/,3-20,4-10,4-5,5-6,5-merous,5.5-10,acuminat,alyx,ame,apar,apart,apically,apparently,articulated,bark,branched,broad-deltate,brow,c.,concolorous,curved,distal,distance,drying,eaf,eed,elongating,extending,filament,flattened,flower,free,fruiting,gently,green-brown,hermaphrodite,heterostylous,infructescence,lobing,long-styled,longer,lowermost,mature,midvein,minute,nflorescence,oblong,older,one,open,orolla,oung,pair,pendent,pendulous,per,pericarp,plurifoliat,porrect,portion,prickl,prickle,prickly,primary,rarely,red-brown,reduced,reflexed,rounded,ruit,scar,secondary,sessile,short-styled,side,simple,smooth,sometimes,spaced,spreading,stalk,stalked,staminat,straight,tamen,terete,tertiary,time,translucent,trichome,unarmed,unit,vary,vein,venation,visible,woody,ympodial	2/3,adhesion,arrangement,climate,colour,corolla,form,glandular,growth,height,history,inflorescence,life,na,number,ovary,perennial,position,presence,present,pubescence,reproduction,seed,shape,size,staman,stigma,stipe,texture
159	wfo-0001026946	success	205	103	79	126	24	0.385	0.5-2,1-2,1-4,1.5-2,1.6-3.7,10-39,12-23,2-15,2.5-10.5,3.5-10,5-7,6-24,8-15,abaxially,acute,adaxially,anther,attenuate,axillary,brownish,bud,chartaceous,clavate,cm,condition,corolla,creamy,deeply,densely,diameter,drying,elliptic,fresh,fruit,glabrous,globose,green,greenish,hair,herb,lanceolate,like,lobe,long,membranous,minutely,mm,mottled,odd-pinnate,ovate,ovoid,pedicel,peduncle,pentagonal,petiole,plant,puberulent,pubescent,pure,purple,ripe,seed,short,short-pubescent,size,slightly,stellate,stem,stigma,streak,style,subtending,terminal,tube,white,whitish,x,yellow,yellow-white	0-20,0-5,0.9-3.5,0.9-4.3,1,1-10,2,2-5,2.7-9,3-20,3-5,3-6,4-7,4.1-9.4,5-merou,8-25,acumen,acuminate,ag,along,alyx,apart,apex,apparently,articulation,axe,base,berry,blade,borne,broadly,capitat,cell,ciliate,connivent,covering,digestion,distal,dorsally,dot,eaf,edge,eed,end,enzyme,erec,especially,exceeding,except,extremely,filament,flat,flower,folded,forked,geminat,generally,glabrou,greatly,green-white,hair-like,half,homostylous,honeycomb-shaped,interjected,lateral,leaflet,lengthening,living,lower,make,margin,midrib,mucilaginous,narrowly,nflorescence,oblique,often,orbicular,orolla,pair,perfect,petiolulate,petiolule,plurifoliate,pore,poricidal,proximal,pubescen,reduced,removed,rounded,ruit,scattered,sessile,seudostipule,singly,slit,spaced,specimen,stamen,ste,stolo,straight,subequal,tall,tamen,tem,testal,thick,thir,throughout,tip,tri-,truncate,tuber,typically,unit,unwinged,usually,variable,vary,wall,wet,wing,ympodial	adhesion,arrangement,calyx,capitate,colour,form,growth,height,history,inflorescence,leaf,length,life,na,ovary,perennial,position,pubescence,reproduction,rugulose,shape,staman,surface,texture
160	wfo-0001026962	success	205	116	83	122	33	0.405	.05,0.3-0.7,0.5-1,1,1-1.2,1-1.5,1-3,1-6,1.5-17,1.5-2,1.5-5,10-12,15-22,2-2.5,2-6,2/3-3/4,3-3.5,4-5,6-7,acute,anther,apex,base,blade,broadly,calyx,chartaceous,cm,corolla,deltate,diameter,difoliate,dry,elliptic,entire,flattened-reniform,flower,fruit,glabrous,globose,green,inflorescence,internodal,leaf,lobe,lobed,margin,material,mm,narrowly,obconic,oblong,occasionally,opposite,pale,pedicel,peduncle,petiole,purplish,rounded,sagittate,shrub,size,slightly,small,sometimes,somewhat,stellate,stem,stigma,style,surface,tinged,tip,tree,triangular,tube,unifoliate,way,white,x,yellow,yellowish	.5,0,0.5,0.5-0.8,0.5-1.5,0.8-1,1-2,1-4.5,1.5-3,10-20,2-5,3-6,9-12,9-17,abaxially,abrupt,abruptly,accrescent,adaxially,ag,alyx,anthesi,apparently,appearing,arising,articulated,axe,bark,basebud,becoming,beneath,brittle,bud,capitat,cell,closely,composed,connivent,constricted,cucullat,cylindrical,darker,deflexed,densely,denser,differing,dimorphic,eaf,eed,elongate,evenly,except,exerted,filament,free,fruiting,geminat,glabrate,glabrou,ilament,incrassate,later,lateral,like,long,longitudinal,main,major,minor,minutely,nflorescence,obovoid,often,older,one,opening,orolla,oung,outline,ovate-lanceolate,overlapping,packed,pair,papillose,paten,pendent,perfect,pitted,pore,portion,prominent,pubescen,pubescent,rachi,raised,reflexed,remaining,rest,rounder,ruit,shaped,simple,slender,slit,soon,straight,tal,tapering,tear-drop,tooth,trichome,trunk,unarmed,unbranched,uniseriate,unit,vary,vein,whit,woody,ympodial,young	adhesion,arrangement,capitate,climate,colour,dense,form,geminate,glandular,growth,hair,height,history,length,life,midpoint,na,number,ovary,perennial,plant,position,presence,pubescence,ray,reproduction,rugulose,seed,shape,staman,stipe,texture,ye
161	wfo-0001026963	success	151	100	70	81	30	0.464	.4,0.2-0.6,0.8-3,1-1.5,1.2-1.5,1.5-4.5,1.5-6,2-2.5,2-4.5,3-5,6-7,abaxially,abruptly,acute,anther,apex,apical,base,c.,calyx,capitate,cm,conical,coriaceous,corolla,cup-shaped,diameter,elliptic,elongate,flower,glabrous,growth,herb,heterostylous,inflorescence,internodal,lobe,lobed,long-styled,long-triangular,margin,membranous,midpoint,minute,mm,ovary,ovate,pedicel,peduncle,petiole,pubescent,ray,shallowly,short-styled,simple,sparsely,stellate,stem,stigma,style,subshrub,surface,tapering,tooth,truncate,tube,way,white,x,yellowish	-5,.5,0.5,0.5-0.6,1-2,1.1-1.4,3-5-rayed,4,4-5,5-6,<,absent,acicular,anthesi,armed,articulated,bark,brow,closely,clustered,creeping,curved,dark,deep,densely,eaf,eed,ellipsoid,elongating,filament,free,included,inflorescenc,know,known,like,long,lower,markedly,mature,minutely,new,nflorescence,nodding,node,oblique,older,outline,pair,papillo,per,plurifoliat,pore,poricidal,porrect,portion,prickle,prickly,primary,prominent,reddish,reflexed,rooting,rootstock,ruit,scar,scattered,sessile,side,slit,small,sometimes,spaced,tip,trichome,ud,unarmed,unit,vein,woody,ympodial	adhesion,arrangement,blade,climate,colour,form,fruit,glandular,hair,height,history,leaf,length,life,na,number,perennial,plant,position,presence,present,pubescence,reproduction,rugulose,seed,shape,size,staman,stipe,texture
162	wfo-0001026964	success	128	101	64	64	37	0.5	.2,.5,0,0.5,0.5-1,10,10-30,2-2.5,3-5,7-8,acuminate,acute,along,anther,apex,attenuate,axillary,base,calyx,cm,conical,corolla,diameter,elliptic,filiform,glabrous,green,greenish,herb,horizontal,lightly,lobe,lobed,long,margin,minutely,mm,nearly,obovate,ovary,papillate,pedicel,petiole,pinnate,poricidal,pubescent,purple,rugose,shape,simple,size,smooth,somewhat,sparsely,stigma,style,surface,tip,trichome,tube,uniseriate,winged,x,yellow	1-1.2,1-2.5,2-4,3.5-7,4.5-8.5,?,anthesi,basal,beak,bearing,berry,capitat,conspicuously,differentiated,distinct,eaf,edicel,equal,erec,exserted,filament,fleshy,flower,free,fruiting,glabrou,globose,immature,known,lateral,leaflet,lenticellate,line,long-attenuate,lower,nflorescence,noddin,often,one,onto,open,ot,pair,petiolule,portion,primary,purpli,rachi,reflexed,ruit,scar,side,slender,small,tal,tem,terminal,time,tub,ud,unifoliat,unit,vein,ympodial	adhesion,arrangement,blade,capitate,climate,colour,form,fruit,glandular,growth,hair,height,history,inflorescence,leaf,length,life,midpoint,na,nodding,number,peduncle,perennial,plant,position,presence,pubescence,purplish,ray,reproduction,rugulose,seed,staman,stellate,stem,stipe,texture
163	wfo-0001026965	success	157	103	66	91	37	0.42	-2.5,.6,0.5-,0.6-2,0.7-1,0.7-1.5,0.8-1.25,1.1-1.65,1.3-2,1.5-2,1.5-4,1.7-2,1.9-2.4,2.5-4,2/3,abundant,acute,anther,antrorse,apex,basal,base,berry,broadly,calyx,campanulate,capitate,cm,cuneate-attenuate,diameter,ellipsoidal,elliptic,elliptical,glabrous,glandular,globose,herb,lobe,margin,mm,narrowly,obovate,ovate,pale,papillae,petiole,pinnatifid,pinnatipartite,pubescent,seed,short,simple,stem,stigma,striate,style,subglobose,surface,trans-ovoidal,trichome,tube,uniseriate,violet,white,x,yellow	.3,.5,0.2,0.4,0.5-1.5,0.6-1.1,0.7-1.1,25,3-,3-4,3.5-6.2,3.5-9,5-15,6.4-12,8-17,abaxially,accrescent,adaxially,ag,appressed,articulated,c.,coat,coiled,connectival,covering,cylindrical,difoliat,dorsal,eaf,eed,eglandular,embryo,evident,exserted,filament,flexuose,fruiting,herbaceous,hig,latitudinally,long,longer,longitudinal,longitudinally,lower,mixed,multi-seeded,non-glandular,noticeable,opening,opposite,orolla,outer,ovat,pair,papery-scarious,papillose,partially,pore,poricidal,portion,procumbent,prolongation,prostrate,ree,reticulate,ridged,rounded,ruit,segment,similar,slightly,slit,small,smooth,straight,strongly,styl,tem,time,tip,tuberculate,unequal,unifoliate,unit,vary,venation,wider,winged,ympodial	3-15,adhesion,arrangement,blade,climate,colour,corolla,form,fruit,growth,hair,height,history,inflorescence,leaf,length,life,midpoint,na,number,ovary,pedicel,peduncle,perennial,plant,position,presence,pubescence,ray,reproduction,rugulose,shape,size,staman,stellate,stipe,texture
164	wfo-0001026981	success	252	95	73	179	22	0.29	-0.8,-35,0.05-0.1,0.3-0.5,0.4-0.5,0.5,0.5-30,0.6-1.4,0.6-2,0.8-1.2,1-3.3,1.5-2.0,1.5-8.5,1.8-2.8,2-3-branched,3.5-14,4,6-10,7.5,<,abaxially,adaxially,anther,brown,calyx,capitate,cm,conical,corolla,densely,diameter,fruit,glabrescent,glandular,globose,green,herb,imparipinnate,interrupted,leaf,lobe,long,minutely,mm,obovate,orange,orbicular,ovary,ovate,pale,pedicel,peduncle,pentagonal,perennial,petiole,plant,present,pubescence,pubescent,simple,sometimes,sparsely,stem,stigma,style,surface,thick,tube,variously,velvety,villous,wide,yellow	-0.4,-14,-2,-2.5,-4,-8,.2,.2-0.2,0-5,0.1-0.2,0.1-0.3,0.15-0.2,0.2,0.2-0.4,0.2-2,0.25-0.4,0.3.6,0.4-0.7,0.4-2,0.45-1.3,0.5-0.3,0.7-0.8,0.8-6,0.9-1.4,0.9-1.5,1,1-2,1-2-cellular,1-3,1-3-celled,1-4,1.5-5,1/3,11,196.,2-3,2-locular,3-foliate,4-8,4-celled,absen,absent,abundant,academy,accrescent,acute,adpressed,along,amongst,angled,anthesi,apex,apical,appearance,appendage,appressed,articulated,articulation,asymmetric,axi,base,basiscopically,bay,beak,becoming,bract,bracteole-like,cell,citrus-like,coastal,column,composed,cone,cordate,d,dark,deltate,distal,eaf,ebracteate,edicel,eed,entire,erect,exserted,filament,flower,fruiting,giving,gree,hair-like,half,halfway,head,included,initially,interjected,internode,irregularly,jointles,larger,later,lateral,leaflet,less,like,lime,linear,lobed,lon,lower,mainly,margin,maturity,mixed,much,multicellular,narrowly,nflorescence,occasionally,outgrowth,pair,patent,per,petiolule,population,primary,procumbent,pronounced,proximal,pseudostipule,rachi,reflexed,rick,robust,rounded,ruit,scen,secondary,see,sessile,several,shaggy,shaped,short,shorter,silky,slender,smaller,sparser,specimen,spreadin,staminal,sterile,straight,strong,tangled,tem,terminal,tertiary,testa,tightly,transparent,trichome,tub,type,uni-,unicellular,uniseriate,unit,upto,usually,viny,wall,winged,without,ympodial,‘,’	0.3-0.6,adhesion,arrangement,colour,form,growth,height,history,inflorescence,length,life,na,position,presence,reproduction,rugulose,seed,shape,size,staman,stellate,texture
165	wfo-0001026987	success	214	120	94	120	26	0.439	0-1,0.2-0.4,0.2-0.5,0.4-1,0.5-0.7,0.5-2,0.7-0.8,0.7-1.5,1-2,1-3,1-4,1.1-6,1.5-2,2.5-11,3.5-3.8,3.5-5,4-6,5-10,5.5-7,7-10,8-12,absent,acute,adaxially,anther,apex,base,bent,blade,calyx,chartaceous,cm,connivent,cordate,cuneate,deltate,densely,diameter,entire,extra-axillary,flower,fruit,glabrous,glandular,glandular-hairy,globose,grey,hair,hastate,inflorescence,lanceolate,lateral,leaf,length,lilac,lobe,lobed,long,loosely,margin,mm,obtuse,often,ovate,pale,pedicel,peduncle,perennial,petiole,present,purple,ray,red,rhizomatous,shallowly,shrub,simple,sparsely,stellate,stellate-pubescent,stigma,style,summit,surface,thin,time,toward,triangular,tube,twisted,unarmed,white,x,yellow	%,0-0.1,0-0.2,0-10,0-4,0.05-0.1,0.2-1,0.25-0.4,0.4-0.5,0.4-0.7,0.5-1,0.5-2.5,0.7-1,1-11,1.1-2.6,1.4-3,15-35,2-5,2-7,2.5-6.5,4-7,4.5-6,5-8,5-merou,6-20,8-10,8-11.5,8-13,abaxially,absen,abundant,accrescent,across,adaxiall,adult,alyx,apart,articulated,ascending,axe,ba,basal,berry,branch,branche,broad-based,capitat,curved,cylindrical,decimetre,deflexed,directed,distall,distributed,dm,eaf,eed,eglandular,erect,filament,finger,fruiting,gland-tipped,green,half,homostylous,interpetalar,juicy,juvenile,lacking,lamina,less,longer,lower,mature,mesocarp,mid-point,midpoint,minute,narrowly,nflorescence,oblique,orolla,pair,part,per,perfect,pore,porrect,prickle,rachi,ruit,scarcely,sessile,shallowly-lobed,short,slightly,spaced,sparse,stalk,stellae,straight,succulen,tal,tamen,tem,thick,thickened,throughout,tissue,unarme,unbranched,unit,unknow,upper,upward,vary,wide,yellowish,ympodial	adhesion,arrangement,capitate,colour,corolla,form,growth,height,history,life,na,number,ovary,plant,position,presence,pubescence,reproduction,rugulose,seed,shape,size,staman,stem,stipe,texture
166	wfo-0001026992	success	243	108	87	156	21	0.358	0.2-0.5,0.25-0.45,0.5-1.2,0.6-1.5,0.8-3.4,1-4,1.2-1.4,1.2-1.7,1.3-2.6,1.3-4.3,1.4-1.9,1.7-1.9,1.7-2.4,1.7-4.3,12-33,2-10,2.8-4.7,3-4,5-15,5.3-12.1,6-10,8,8-14,abaxial,abaxially,adaxially,anther,base,blunt-tipped,broadly,brown,calyx,chartaceous,cm,corolla,dark,deltoid,diameter,drying,elliptic,flower,fruit,globose,granular-tomentose,greenish,inserted,lance-ovate,lanceolate,leaf,length,lobe,mm,moderately,orange-tan,ovate,pedicel,peduncle,petiole,plant,pubescence,pubescent,rachi,reniform,reticulate-punctate,ripe,scabridulous-,shrub,simple,size,small,stellate,stem,stigma,style,surface,tan,terminal,tomentose,tree,tube,velutinous,violet,white,whitish,x,yellow,yellowish	-2.5,/7,00-170,1.4-1.6,1.5-3.4,1/2,10-12,2-5.6,2.3-3.3,2.6-4.6,2.8-4.6,3.3-5.5,3.3-5.6,4-8,5-merou,8-11,abruptly,accrescent,acuminate,acute,adaxiall,ag,along,alyx,angled,anthesi,apart,apex,apparently,appressed,approximately,around,articulated,attenuate,axe,axillary,ba,bark,berry,blade,branch,branched,capitat,completely,coriaceous,covering,crown,cylindrical,densely,directed,distally,eaf,echinoi,echinoid,edge,eed,entire,enveloping,equal,evident,exserted,farinose,filament,flat-topped,fleshy,forming,free,fruiting,geminate,glabrescen,glabrous,grooved,hair,high,homostylous,immature,lacking,lateral,lengthening,less,line,lobed,long,long-stalked,longitudinal,longitudinally,lower,m.,main,many,margin,mature,maturity,midrib,minute,mostly,multangulate,nearly,nflorescence,oblong,obtuse,occasional,occasionally,often,older,orolla,ovate-lanceolate,overlapping,perfect,plurifoliate,pore,poricidal,porrect-stellate,rare,rather,ruit,runk,semi-ovate,sessile,short,short-,short-stalked,shorter,side,slit,sometimes,somewhat,spaced,sparingly,split,spreading,stalked,stamen,stout-stalked,subcampanulate,subglobose,suture,tamen,terete,thin-textured,time,tip,ud,unarme,unarmed,unequal,unit,usually,vary,vein,way,weakly,wide,ympodial,young,½	adhesion,arrangement,capitate,colour,form,glabrescent,growth,height,history,inflorescence,life,na,ovary,perennial,position,reproduction,seed,shape,sparing,staman,texture
167	wfo-0001026994	success	266	119	90	176	29	0.338	-10,-20,-30,.5,0.05-0.1,0.5-0.6,0.5-0.7,0.5-0.8,0.5-2,1,1-1.4,1-1.5,1-1.6,1.2-1.6,2-,2-2.6,2.2-3.2,2.5-6.5,4,4-15,5-,6-20,7-13,8-12,acuminate,acute,anther,apex,base,bright,broadly,brown,calyx,capitate,cm,corolla,crenate,dark,deeply,densely,diameter,elliptic,fruit,glabrous,glandular,globose,grayish,green,greenish,herb,imparipinnate,inflorescence,interrupted,irregularly,lanceolate,leaf,lobe,lobed,long,margin,minutely,mm,moderately,narrowly,obovate,ovary,pedicel,peduncle,perennial,petiole,puberulent,pubescent,purple,rotate-stellate,simple,size,sparsely,stem,stigma,stripe,style,surface,thick,trichome,tube,uniseriate,velvety,white,wide,yellow	-0.7,-foliate,.2,0.05-0.2,0.1,0.1-0.2,0.1-0.3,0.15-0.2,0.2-0.4,0.2-0.5,0.25,0.3-0.4,0.4-0.5,0.4-1.2,0.5,0.5-0.9,0.5-1.2,0.5-1.3,0.7-2.5,0.9-1.2,0.9-1.3,1-1.2,1-2,1.2-3.5,1.4-2.1,10-20,12-,2,2-4,2-5-locular,20-50,3,3-branched,4-celled,5,5-7,8,abaxially,absent,abundant,acroscopically,additional,adpressed,along,also,amongst,andscattered,anthesi,apical,apically,appearance,appendage,articulate,articulation,basal,basally,basiscopically,becoming,beneath,bent,berry,bifurcate,bifurcation,bract,bracteate,branched,broader,cell,celled,column,conical,crenat,crowded,darker,decreasing,decumbent,decurrent,developed,distal,eaf,ebracteate,edicel,eed,eglandular,erect,especially,essentially,exserted,fewer,filament,flower,fruiting,giving,gree,habitat,hair-like,hal,half,halfway,head,interjected,internode,investing,lamina,large,larger,largest,lateral,leaflet,leave,less,like,locule,lon,loosely,lower,markedly,medial,midvein,much,narrower,narrowing,nearly,nflorescence,node,oblique,occasionally,often,outgrowth,pair,paler,papillate,petiolule,present,primary,pseudostipule,rachi,rarely,reflexed,regularly,ripe,robust,rocky,secondary,sessile,set,shaggy,short,silky,sinus,slightly,sometimes,specimen,spreadin,spreading,staminal,sterile,straight,tall,tem,terminal,tertiary,testa,tip,toward,ud,unicellular,unit,usually,wall,weak-walled,well,winged,woody,ympodial,young	adhesion,arrangement,blade,climate,colour,decurren,form,growth,hair,height,history,length,life,midpoint,na,number,plant,position,presence,pubescence,ray,reproduction,rugulose,seed,shape,staman,stellate,stipe,texture
168	wfo-0001026996	success	188	93	67	121	26	0.356	0.6-1,1-3,1.2-1.8,1.8-4.4,15-28,2-3,3-10,3.3-6,3.8-14.1,4-8,4.5-10.5,5-8,6-8,8.7-18.6,abaxially,acumen,adaxially,anther,axillary,blue,brownish,bud,clavate,cm,condition,coriaceous,corolla,dark,deep,diameter,drying,elliptic,fresh,fruit,glabrous,globose,green,greenish,herb,lanceolate,leaf,lilac,lobe,medium,mm,mottled,odd-pinnate,ovate,ovoid,pedicel,peduncle,pentagonal,plant,purple,rotate,seed,size,stigma,stripe,style,subtending,terminal,tube,white,whitish,x,yellow	0-6,0.9-2.7,1-2,1-4,1-5,1.3-7.7,14-33,3-5,3-7,4-4.4,5-merou,6.9-10.9,abaxiall,acuminate,acute,ag,along,alyx,apart,apex,apparently,arranged,articulated,asymmetric,attenuate,axe,base,basiscopic,bead,berry,blade,capitat,cell,connivent,considerably,covering,decreasing,digestion,distal,dorsally,eaf,edge,eed,enzyme,erec,exceeding,filament,flat,flower,folded,forked,geminat,generally,glabrou,green-white,hair-like,half,homostylous,honeycomb-shaped,interjected,larger,lateral,leaflet,lengthening,like,linear,living,long,lower,make,middl,moniliform,mucilaginous,multiple,necklace,nflorescence,orbicular,orolla,pair,perfect,petiole,petiolulate,plurifoliate,pore,poricidal,removed,ripe,rounded,ruit,sessile,seudostipule,side,slightly,slit,sometimes,spaced,specimen,stamen,stolon,straight,subglabrou,symmetric,tall,tamen,tem,testal,thick,throughout,tip,tissue,toward,tri-,tuber,typically,unit,unwinged,usually,vary,wall,wet,ympodial	adhesion,arrangement,calyx,capitate,colour,form,growth,height,history,inflorescence,length,life,na,ovary,perennial,position,pseudostipule,pubescence,reproduction,rugulose,shape,staman,stem,subglabrous,surface,texture
169	wfo-0001027009	success	226	120	93	133	27	0.412	0-0.2,0-0.3,0.4-1,0.7-1,0.7-1.3,0.8-1.3,0.8-2.1,1.4-4,2-3,2.3-3,3-3.5,3-5,3.3-3.6,4-6.5,4-9.5,5-23,6-9,6.5-11,7-12.5,7-8,absent,acute,adaxially,andromonoecious,anther,apex,attenuate,base,black,blade,broadly,brown,calyx,capitate,chartaceous,cm,connivent,cuneate,deeply,deltate,densely,diameter,elliptical,erect,extra-axillary,fruit,glabrous,glandular,globose,green,grey,grey-green,hair,incised,inflorescence,lanceolate,length,lobe,lobed,margin,midpoint,mm,obtuse,ovate,pale,pedicel,peduncle,perennial,petiole,plant,present,purple,ray,rhizomatous,ripe,rotate,shallowly,shrub,simple,slightly,stellate-pubescent,stem,stigma,strongly,style,surface,throughout,tip,tube,white,x,yellow,yellowish-green	%,0-0.5,0-1.2,0-1.5,0-15,0-5,0-8,0.1-0.2,0.15-0.3,0.5-2,0.7-0.9,0.8-1.2,1-1.5,1-1.8,1-2,1-2.5,1-3,1-5,1-9,1.3-2.2,1.6-3.5,10-15,10-20,2-4,2-6,2-foliate,20-30,23-48,3-10,35-400,40-125,5,5-7,5-merous,6-8,7-11,abaxially,abundant,accrescent,acicular,adaxiall,alyx,apart,armed,articulated,ascending,axe,ba,basal,bilobe,bisexual,broad-based,curved,cylindrical,d.,deflexed,dimorphic,directed,distal,distall,distributed,dult,eaf,eed,eglandular,entire,filament,finger,flower,fruiting,functional,geminate,gland-tipped,half,heterostylous,index,interpetalar,juic,lamina,larger,lateral,lobing,lon,long,longer,lower,male,markedly,mature,mesocarp,midvein,minute,minutely,moist,nflorescence,oblique,orolla,part,per,pore,porrect,presen,prickle,pricklie,probably,pseudo-racemose,rarely,reticulate,ridged,ruit,short,side,spaced,stage,stalk,stellae,straight,tal,tamen,terete,thick,time,tissue,unarmed,unbranched,unit,unknow,uvenile,vary,vein,wide,yellowish,ympodial	adhesion,arrangement,bilobed,climate,colour,corolla,form,growth,height,history,leaf,life,na,number,ovary,position,presence,pubescence,reproduction,rugulose,seed,shape,size,staman,stellate,stipe,texture
170	wfo-0001027010	success	198	114	90	108	24	0.455	0.4-5.1,0.5-1.5,1.2-1.7,1.2-1.9,14-46,2.1-4.3,2.2-12.9,3-10,3-6,3-8,4-12,4-8,4.4-29,4.9-31,5-14,abaxially,acute,adaxially,anther,articulated,axillary,brownish,bud,cell,clavate,cm,condition,connivent,coriaceous,corolla,covering,deep,diameter,distal,drying,elliptic,fresh,fruit,glabrescent,glabrous,green,green-white,greenish,hair,hair-like,half,herb,high,lanceolate,lateral,leaf,light,lobe,long,make,mm,mucilaginous,occasionally,odd-pinnate,ovate,ovoid,pedicel,peduncle,pentagonal,petiole,plant,purple,ripe,rotate,scabrous,seed,short,size,stigma,stripe,style,subtending,terminal,testal,thick,throughout,tube,usually,wall,wet,white,whitish,wide,x,yellow	0-2,0-2.5,0-3,1-10,1-2,1-4,1-7,1.4-6.9,10-60,2-6,2-9.4,2.1-15.3,3-5,3.5-13.6,5-13,5-merou,acumen,acuminate,adaxiall,ag,along,alyx,apart,apex,apparently,arranged,asymmetric,attenuate,axe,base,basiscopic,bead,blade,capitat,coloration,decreasing,digestion,dorsally,eaf,edge,eed,enzyme,erec,exceeding,filament,flat,flower,folded,forked,geminat,generally,glabrescen,glabrou,hal,homostylous,honeycomb-shaped,interjected,larger,leaflet,lengthening,like,living,lower,moniliform,multiple,narrow,necklace,nflorescence,orbicular,orolla,pair,perfect,petiolulate,plurifoliate,pore,poricidal,present,removed,rounded,ruit,scabrou,sessile,seudostipule,side,slightly,slit,sometimes,spaced,specimen,spot,stamen,stolon,straight,subequal,tall,tamen,tem,tip,tissue,toward,tri-,tuber,typically,unit,vary,wing,winged,ympodial	adhesion,arrangement,calyx,capitate,colour,form,growth,height,history,inflorescence,length,life,na,ovary,perennial,position,pubescence,reproduction,rugulose,shape,staman,stem,surface,texture
171	wfo-0001027019	success	142	109	74	68	35	0.521	/4,0.5-1,1-1.5,1-2,1.5-2,1.5-3,12-30,2-3,2-8,4-5,7-14,abaxially,acute,adaxially,along,anther,apex,attenuate,base,branched,bright,calyx,capitate,cm,corolla,cyathiform,deltoid,densely,dia,flattened,glabrous,globose,golden,green,inflorescence,leaf,like,live,lobe,lobed,long,midrib,minutely,mm,obovate,onto,opposite,ovary,ovoid-reniform,pale,papillose,pedicel,petiole,pitted,plant,poricidal,pubescent,shrub,small,somewhat,sparsely,stem,stigma,style,surface,tan,tip,tree,trichome,tube,way,white,winged,x	.5,0-0.5,1/2,10,10-40-flowered,2-5,4-8.5,abaxial,abruptly,anthesi,apparent,ba,bark,berry,constriction,deflexed,difoliate,distal,eaf,edicel,eed,ellipsoid,elliptic,erect,even,exserted,filament,fleshy,free,fruiting,geminat,glabrate,inflorescenc,largely,later,lon,lower,major,minor,narrowed,nflorescence,older,overlapping,papillo,planar,pore,portion,reddish-brow,rest,ruit,scar,shaped,spaced,straight,strongly,tall,tapering,tear-drop,third,tub,ud,unit,waxy,widest,wing,woody,ympodial,young	adhesion,arrangement,blade,climate,colour,diameter,form,fruit,glandular,growth,hair,height,history,length,life,margin,midpoint,na,number,peduncle,perennial,position,presence,pubescence,ray,reddish-brown,reproduction,rugulose,seed,shape,size,staman,stellate,stipe,texture
172	wfo-0001027030	success	234	90	68	166	22	0.291	.5,0.05-0.1,0.4-0.5,0.5-0.7,0.6-0.7,0.7-1,0.8-0.9,1,1-1.3,1-3,1.2-1.6,1.6-2,2-6,2.2-3.2,5-12,abaxially,anther,branched,bright,brown,calyx,capitate,cm,corolla,densely,denser,diameter,elliptic,fruit,globose,grayish,green,herb,imparipinnate,inflorescence,interrupted,lobe,long,minutely,mm,narrowly,obovate,ovary,pale,papillate,pedicel,peduncle,perennial,petiole,pubescence,pubescent,rotate-stellate,simple,size,soft,sometimes,sparsely,stem,stigma,straight,style,surface,tall,tube,velvety,white,wide,yellow	-11,-15,.2,0-4,0.1-0.7,0.1-0.9,0.15-0.2,0.2,0.2-0.3,0.2-1,0.3-,0.3-0.5,0.3-0.7,0.4-0.8,0.4-1.5,0.5,0.5-,0.5-0.8,0.5-1,0.6-0.8,0.6-1.8,0.8-1,0.9-1.1,1-,1-1.2,1-3.4,1.5-,2-,2-3,2-4,2-4.8,2-7,2-foliate,2-locular,3-4-celled,3-8,3-9,4-celled,8-celled,abaxial,absent,abundant,acuminate,acute,adaxially,adpressed,angled,anthesi,apex,apical,appearance,appendage,articulated,articulation,axi,basal,base,basiscopically,beneath,berry,beyond,bract,cell,column,conical,crenat,crenate,crenation,dark,darker,decurrent,deeper,deeply,diamete,distal,due,eaf,edicel,eed,eglandular,entire,evenly,exserted,extremely,filament,flower,fruiting,giving,gland,glandular,gree,growt,hair-like,hal,half,halfway,interjected,internode,interspersed,investing,irregularly,lamina,lanceolate,larger,lateral,leaflet,less,like,lon,longer,loosely,lower,margin,multicellular,near,nflorescence,node,oblique,occasionally,often,outgrowth,pair,paler,petiolule,present,primary,pseudostipule,reflexed,robust,ruit,secondary,sessile,silky,similar,slender,slightly,small,smaller,somewhat,spread,spreadin,spreading,staminal,sterile,stripe,tem,terminal,tertiary,testa,thick,tiny,trailing,trichome,truncate,ud,unicellular,uniseriate,unit,usually,vein,wall,weak,winged,woody,ympodial,young	1-4,2-9,adhesion,arrangement,colour,dioecious,form,growth,height,history,leaf,length,life,plant,position,reproduction,rugulose,seed,shape,staman,texture,ye
173	wfo-0001027035	success	199	113	90	109	23	0.452	0.1-0.9,0.3-2.3,0.4-12.8,0.5-7,0.9-3.1,1-3,1-3.4,1.8-5.2,10-80,2.8-10.3,3-10,4-18.5,4.9-23.5,abaxially,adaxially,anther,articulated,axillary,blue,brownish,bud,cell,clavate,cm,completely,condition,corolla,covering,deep,diameter,distal,drying,elliptic,fresh,fruit,glabrescent,glabrous,globose,green,green-white,greenish,hair,hair-like,half,herb,high,lanceolate,lateral,leaf,light,lilac,lobe,long,make,medium,mm,mucilaginous,odd-pinnate,ovate,ovoid,pedicel,peduncle,pentagonal,petiole,plant,purple,ripe,rotate,seed,shape,short,size,sometimes,stigma,stripe,style,subtending,terminal,testal,thick,throughout,tube,usually,wall,wet,white,whitish,wide,x,yellow	0-36,0-7,0.5-3.4,0.5-5,0.8-3,0.8-4.2,1-2,1-8,1.5-5.9,1.7-8,2-38,2-7,3-5,4-18,5-merou,acumen,acuminate,acute,adaxiall,ag,along,alyx,apart,apex,apparently,arranged,asymmetric,attenuate,axe,base,basiscopic,bead,blade,capitat,coloration,connivent,decreasing,digestion,dorsally,eaf,edge,eed,enzyme,erec,exceeding,filament,flat,flower,folded,forked,geminat,generally,glabrescen,glabrou,hal,homostylous,honeycomb,interjected,larger,leaflet,lengthening,like,living,lower,moniliform,multiple,necklace,nflorescence,orbicular,orolla,pair,perfect,petiolulate,plurifoliate,pore,poricidal,present,removed,rounded,ruit,second,sessile,seudostipule,shaped,side,slightly,slit,smaller,spaced,specimen,stamen,stolon,straight,subequal,subglabrous,tall,tamen,tem,tip,tissue,toward,tri-,tuber,typically,unit,unwinged,variable,vary,ympodial	adhesion,arrangement,calyx,capitate,colour,form,growth,height,history,inflorescence,length,life,na,ovary,perennial,position,pubescence,reproduction,rugulose,staman,stem,surface,texture
174	wfo-0001027050	success	244	126	99	145	27	0.406	-12,-9,/3,0.1-0.3,0.3-1.5,0.5-3,1-1.5,1.5-6,10-13.5,2-2.5,2-5,2-8,2.5-3,3-5,4-20,4-8,5-10,5-9,6-8,8-26,acuminate,acute,anther,apex,base,blade,broadly,brown,calyx,capitate,chartaceous,cm,coarsely,conical,cordate,cuneate,densely,diameter,elliptic,entire,equal,erect,ferruginous,flattened-reniform,fruit,glabrous,glandular-puberulent,green,growth,hair,inflorescence,lanceolate,lateral,leaf,leaf-opposed,length,lobe,lobed,long,margin,midpoint,minutely,mm,moderately,narrowly,obtuse,ovate,pale,pedicel,peduncle,pericarp,petiole,plant,present,pubescent,ray,ripe,rounded,shallowly,shiny,shrub,small,sparsely,spherical,stellate,stellate-pubescent,stem,stigma,style,toothed,tree,triangular,truncate,tube,way,white,wide,yellow,yellowish-green	.2,.5,0-0.2,0-3,0.1-3,0.2-0.5,0.2-1,0.8,0.9-2.1,1,1-2,1.5-2,12-15,15-50+,2-3,2-4,5,5-6,5-7,5-merous,50,7-30+,abaxial,abaxially,absen,absent,abundant,adaxial,adaxiall,adult,alyx,andromonoeciou,apar,arme,articulated,axe,bark,basal,berry,branch,branched,broad,broad-based,brow,closely,connivent,curved,deeply,difoliate,directed,distal,distall,distally,drying,eaf,eed,eglandular,erec,except,filament,flattened,flower,free,fruiting,geminat,half,heterostylous,infructescence,inside,interpetalar,juicy,juvenile,larger,least,less,like,long-styled,longer,lower,markedly,mature,mid-way,midrib,midvein,minute,moist,mucilaginous,multiseriate,near,nflorescence,numerous,oblique,occasionally,often,older,orolla,oung,ovate-lanceolate,papillat,per,pore,poricidal,porrect,portion,prickle,pricklier,prickly,rest,ruit,scar,scattered,secondary,sessile,several,short-stalked,short-styled,shorter,side,slightly,somewhat,spaced,stalk,stalked,straight,surface,tall,tamen,terete,thicker,time,tip,tissue,touching,trichome,unarmed,unbranched,unit,usually,vary,weakly,whitish,woody,ympodial,young,younger	adhesion,alternate,andromonoecious,arrangement,climate,colour,corolla,form,glandular,height,history,life,na,number,ovary,papillate,perennial,position,presence,pubescence,reproduction,seed,shape,size,staman,stipe,texture
175	wfo-0001027050	success	234	123	99	135	24	0.423	0.2-0.6,0.2-1,0.5-1,0.5-3,1-1.5,1.5-2,1.5-6,10-13.5,2-10,2-2.5,2-3,2-5,2-8,2.5-3,3-15,3-5,4-40,4-8,5-9,6-8,8-40+,abaxially,acuminate,acute,adaxially,andromonoecious,anther,apex,base,blade,broadly,brown,calyx,chartaceous,cm,coarsely,cordate,cuneate,densely,diameter,drying,elliptic,entire,extra-axillary,ferruginous,flattened,fruit,glabrous,glandular-puberulent,globose,green,growth,hair,inflorescence,lanceolate,leaf,leaf-opposed,length,like,lobe,lobed,margin,minutely,mm,moderately,narrowly,obtuse,often,ovate,pale,pedicel,peduncle,petiole,pitted,plant,present,ray,rounded,shallowly,shrub,simple,small,sparsely,stellate,stellate-pubescent,stem,stigma,style,surface,toothed,tree,triangular,truncate,tube,white,whitish,x,yellow,yellowish-green	.2,0-0.2,0-0.5,0-1,0-3,0.1-3,0.3-0.6,0.4-1,0.5-0.8,0.8,1-2,1-5,10-30,11-21,12-15,14-20,15-50+,16-40,2-3-locular,2-4,2-6,2-foliate,23-40+,4-19,5,5-10,5-6,5-7,5-merous,7-30+,8-26,absen,absent,abundant,accrescent,across,adaxiall,adult,anvil-shape,apart,armed,articulated,axe,ba,branche,branched,broad-based,capitat,connivent,contiguous,cross-section,curved,cylindrical,deeply,directed,distall,distally,distributed,eaf,eed,eglandular,erect,except,exocarp,filament,flower,forked,fruiting,functional,geminat,half,held,interpetalar,juicy,juvenile,lateral,less,long,longer,lower,markedly,mature,mesocarp,midpoint,midvein,minute,moist,mucilaginous,multiseriate,nearly,nflorescence,oblique,orolla,ovate-lanceolate,pair,per,pinnatifid,placenta,pore,porrect,prickle,rachi,ruit,scattered,sessile,shorter,side,slightly,somewhat,spaced,stalk,stalked,stellae,straight,tal,tamen,tem,thick,thicker,throughout,time,tip,tissue,unarme,unarmed,unbranched,unit,upper,upright,usually,vary,weakly,wide,ympodial,younger	adhesion,arrangement,capitate,colour,corolla,form,height,history,life,na,number,ovary,perennial,position,presence,pubescence,reproduction,rugulose,seed,shape,size,staman,stipe,texture
176	wfo-0001027067	success	228	125	101	127	24	0.443	0-1.8,0-7,0.2-0.4,0.3-1,0.35-0.5,0.5-1.5,0.8-1,1.2-1.4,1.5-2,1.7-2.8,1.7-3.3,15-27,2-3,2.5-3.8,2.5-4,2.9-3.7,3.5-9,4-5.5,5-12.5,6-10,6-8,7-16,8-14,absent,acute,adaxially,anther,apex,articulated,attenuate,base,black,blade,broadly,brown,calyx,chartaceous,cm,cuneate,dark,deeply,densely,diameter,extra-axillary,finally,firm,flattened,flower,fruit,glabrous,globose,green,grey,hair,inflorescence,lanceolate,lateral,leaf,length,lobe,lobed,long,margin,mid-point,mm,obtuse,ovate,pale,papery,pedicel,peduncle,perennial,petiole,pink,plant,present,purple,ray,rhizomatous,rotate,scattered,shrub,simple,skin,slightly,sparsely,stellate,stellate-pubescent,stem,stigma,streak,style,thick,throughout,time,truncate,tube,twisted,x,yellow,yellowish-green	%,.05,0-0.1,0-0.2,0-0.5,0-12,0-6,0.4-0.5,0.4-0.7,0.5-1,0.5-2,0.9-2.5,1-2,1-4,1-7,1.4-2.5,11-16,11-20,13-65,15-60,2-10,2-4.5,2-7,2-foliate,2-locular,2.7-5,20-45,20-50,20-65,3-10,3-4,3-5,3-6,3.5-5.5,4-9,5-6,5-9.5,5-merou,5.5-12.5,6-7,7-11,7-8,abaxial,abaxially,abundant,accrescent,acicular,across,adaxiall,adult,alyx,andromonoecious,apart,armed,axe,ba,bilobe,broad-based,connivent,curved,cylindrical,decimetr,directed,distall,dult,eaf,eed,eglandular,erect,exocarp,filament,finger,fruiting,functional,geminate,gland-tipped,half,heterostylous,hig,index,interpetalar,juic,juvenile,less,lobing,lon,longer,lower,mature,mesocarp,midpoint,midvein,minute,moist,nflorescence,oblique,orolla,part,per,pore,porrect,presen,prickle,pseudo-racemose,rachi,ruit,sessile,short,side,somewhat,spaced,sprawling,stalk,stellae,straight,tamen,tissue,transparent,unbranched,unit,vary,vein,weakly,white,wide,yellowish,ympodial	adhesion,arrangement,bilobed,colour,corolla,form,glandular,growth,height,history,life,na,number,ovary,position,presence,pubescence,reproduction,seed,shape,size,staman,stipe,texture
177	wfo-0001027069	success	200	111	85	115	26	0.425	0.15-0.8,0.5-1.5,0.5-5,0.8-3.3,1-2,1-2.5,1-5,1-7.7,1.5-12,1.5-5,10-25,3-19,3.5-6,4-9,7-10,abaxially,adaxially,along,anther,axillary,blotch,brown,brownish,bud,chartaceous,ciliate,cm,condition,corolla,darker,diameter,drying,elliptic,elliptical-conical,especially,fresh,fruit,glabrescent,glabrous,green,greenish,hair,herb,lanceolate,light,like,linear,lobe,long,margin,membranous,midrib,minutely,mm,narrowly,odd-pinnate,ovate,ovoid,pedicel,peduncle,petiole,plant,puberulent,pubescent,purple,seed,short,simple,size,sparsely,stellate,stem,stigma,stripe,style,subtending,terminal,tip,tube,vertical,white,whitish,wide,x,yellow	0-4,0.2-3,0.5-5.5,1-10,1.5-3,1.5-6,2-5,2-6,2.5-12,3-11,4-8,5-merou,acumen,acuminate,acute,ag,alyx,apart,apex,apparently,articulated,axe,base,berry,blade,borne,broadly,capitat,cell,connivent,cordate,covering,cuneate,decreasing,decurrent,digestion,distal,dorsally,eaf,edge,eed,end,enzyme,erect,exceeding,filament,flat,flower,folded,forked,geminat,generally,glabrou,green-white,hair-like,half,homostylous,honeycomb-shaped,interjected,lateral,lax,leaflet,lengthening,living,lower,make,middl,mucilaginous,nflorescence,obtuse,orolla,pair,perfect,petiolule,plurifoliate,pore,poricidal,pubescen,rachi,rare,rarely,removed,ruit,seudostipule,singly,slightly,slit,sometimes,spaced,specimen,stamen,ste,stolo,straight,subequal,tall,talle,tamen,tem,testal,thick,throughout,toward,tri-,truncate,tuber,typically,unequal,unit,unwinged,usually,vary,wall,wet,ympodial	adhesion,arrangement,calyx,capitate,colour,form,growth,height,hermaphroditic,history,inflorescence,leaf,length,life,na,ovary,perennial,position,pubescence,reproduction,rugulose,shape,staman,surface,texture,ye
178	wfo-0001027091	success	142	97	62	80	35	0.437	0.8,1-1.6,1.1-1.6,1.8-2.6,1/2-2/3,2.3-2.9,2.5-3.5,3-8,3-9,4-10,5-11,8.5-11.5,along,annual,anther,arcuate,blade,blue,bristly,broadly,brown,calyx,campanulate,cm,dark,densely,developing,dm,dry,glabrous,glandular,green,hair,herb,internodal,invested,lenticular,long,main,maturity,mm,ovate,petiole,pinnatifid,prickly,simple,sometimes,sparsely,spherical,splitting,stellate-pentagonal,stem,strait,surface,tapering,terminally,tightly,tube,twice,variously,vein,violet	.3,0.7,30-60,6-10,6-10-flowere,9-13,accrescent,across,acute-tipped,alyx,anthesi,armed,base,beneath,berry,branched,capitate-glandular,cauline,deltoid,dia,difoliate,divided,eaf,eed,enveloped,extended,few-rayed,fully,geminat,gland,high,linear-lanceolate,lobe,lon,longer,low,mostly,narrowly,near,nflorescence,obtuse,occasionally,oriented,orolla,pedicel,per,pinnatisect,radially,reticulately,ridge,rounded,ruit,scattered,sessile,short,short-stipitate,slende,somewhat,spreadingly,ste,stellae,suffused,tamen,taprooted,terete,tigma,tub,tyle,undulate,unexpande,uniseriate,unit,usually,vary,vestiture,wholly,wrinkled,yello,ympodial,younger	0.3,adhesion,arrangement,colour,corolla,diameter,form,fruit,growth,height,history,inflorescence,leaf,length,life,na,ovary,plant,position,presence,pubescence,reproduction,rugulose,seed,shape,size,slender,staman,stellate,stigma,style,texture,unexpanded,ye,yellow
179	wfo-0001027102	success	167	99	73	94	26	0.437	.5,0.2-2,0.5-2,0.5-3,1-1.5,1-2,1-2.5,1.5-2,10-20,3,3-12,3-4,4-5,abaxially,acuman,acuminate,acute,adaxial,almost,anther,apex,base,broadly,calyx,chartaceous,cm,connivent,cuneate,deltate,densely,diameter,elliptic,entire,flattened,fruit,glabrous,globose,lanceolate,leaf,leaf-opposed,lobe,long-tapered,margin,mm,moderately,narrowly,oblong,orange,pedicel,peduncle,petiole,pubescent,ripe,rugulose,shrub,simple,size,small,somewhat,stellate,stem,stigma,style,subcoriaceous,surface,tip,tomentose,truncate,tube,white,x,yellow,yellow-brown	.5-6,0.5,0.5-1,1-3,1-4,1-6,15,15-35,2-2.5,2-3,3-5,4-7,5-12,<,absen,absent,accrescent,adaxiall,adaxially,ag,aggregate,alyx,apart,appearance,articulated,axe,ba,blade,broad,cell,channe,ciliate,congested,corky,curved,cylindrical,differing,difoliate,dimorphic,directed,distally,eaf,eed,few-,filament,flower,forked,free,fruiting,geminat,giving,hair,ilament,long,longitudinal,m.,major,minor,multiseriate,nflorescence,obtuse,often,one,opening,orolla,ovate,per,perfect,pore,portion,rachi,rarely,roughened,ruit,short,slender,slit,spaced,sparsely,stone,straight,tal,tem,time,triangular,truncat,unarme,unbranched,unit,usually,vary,wide,ympodial,young	abaxial,adhesion,arrangement,colour,corolla,form,growth,height,hermaphroditic,history,inflorescence,length,life,na,ovary,perennial,plant,position,presence,present,pubescence,reproduction,seed,shape,staman,texture
180	wfo-0001027104	success	141	72	46	95	26	0.326	0.15-0.35,0.5-0.8,1-3,1.2-6,1.5-2.3,1.5-4.2,10-15,2-3,2-6,2.2-5,3-5.5,6-7.5,calyx,cm,connate,corolla,diameter,distal,finely,forked,globose,green,green-white,half,herbaceous,long,mm,odd-pinnate,ovate,ovoid,pedicel,peduncle,perennial,petiole,plant,pubescent,seed,stellate,stigma,style,throughout,tone,white,wide,yellow,yellow-green	1-1.5,1-4,3-6-foliat,4-15,5-15,abaxially,acumen,acuminate,acute,adaxially,apex,apical,apically,articulate,attenuate,base,branched,cell,condition,cordate,covering,cyme,dehiscent,dichasial,dichasially,digestion,dorsally,eaf,ebracteate,edge,eed,emoval,enzyme,epiphyti,epiphytic-like,exceeding,filament,flat,flower,folded,generally,globo,growing,hair-like,honeycomb,introrse,lateral,linear,living,lobe,lon,lower,make,maturing,monochasial,mos,mucilaginous,mucronate,narrowly,nflorescence,nther,often,orolla,ovat,pattern,perfect,plan,poricidally,proximal,rarely,reveal,ruit,seudostipule,short,simple,slit,specimen,stamen,straight,tall,tem,terrestrial,testal,thick,throughou,truncate,tuber-bearing,typically,unit,vary,viole,wall,without,ympodial,¼	anther,arrangement,colour,form,fruit,growth,height,history,inflorescence,leaf,length,life,na,ovary,position,pubescence,reproduction,rugulose,shape,size,stem,surface,texture,true,tube,violet
181	wfo-0001027114	success	154	109	76	78	33	0.494	-17,-2,-30,.5,0.5-1,1-1.1,1-1.2,1-1.5,1.5-2,1/2,13-21,2-2.5,2-3,3-4,3-7,6-8,6-9,abaxial,abaxially,acute,anther,apex,appearing,base,calyx,capitate,cm,conical,corolla,dark,deltate,dendritic,densely,dia,elliptic,flattened-reniform,glabrous,globose,green,inflorescence,leaf,lobe,lobed,long,margin,minute,minutely,mm,occasionally,opposite,ovary,pedicel,petiole,pitted,poricidal,pubescent,reddish,reddish-brown,scattered,shoot-terminal,shrub,simple,size,soft,stem,stigma,style,surface,thickened,tip,trichome,tube,uniseriate,way,white,wide	1-2,1.5-1.7,20-40,5,7-10,7-9,adaxially,along,alternating,anthesi,apar,axillary,ba,bark,berry,branched,bushy,closely,commonly,differing,difoliate,drying,due,eaf,edicel,eed,erect,exserted,filament,flowered,free,fruiting,geminate,glabrou,growt,halfway,inflorescenc,investing,lamina,lateral,like,lon,lower,main,major,many,minor,nflorescence,older,opening,pair,papillo,planar,plurifoliate,pore,portion,projection,rapid,rest,ruit,scar,several,shoot,slit,spaced,tall,tapering,time,triangular,tub,ud,unevenly,unit,vein,woody,yellowish,ympodial,young	adhesion,arrangement,blade,climate,colour,diameter,form,fruit,glandular,growth,hair,height,history,length,life,midpoint,na,number,peduncle,perennial,plant,position,presence,pubescence,ray,reproduction,rugulose,seed,shape,staman,stellate,stipe,texture
182	wfo-0001027117	success	235	107	74	161	33	0.315	0-5,0.1-0.7,0.6-0.9,0.7-1.3,0.7-1.5,0.8-,1-2,1.5-,1.5-2.3,1.5-6.5,1.7-2.5,2-3,2.3-2.8,4-6.5,4.5-6.5,5-11,5-14,6-10,acute,almost,anther,apex,attenuate,base,black,blade,brown,calyx,chartaceous,cm,cordate,dark,densely,diameter,evenly,flattened-reniform,fruit,green,herb,lateral,leaf,length,lobe,lobed,long,margin,maturity,mauve,midpoint,mm,moderately,narrow-deltate,oblong,pale,pedicel,peduncle,petiole,ray,rounded,shallowly,smooth,sparsely,spherical,staman,stellate,stellate-pubescent,stem,style,surface,tapering,tube,wide,yellow,young	-1.5,-11,-12,-2.8,-3/4,.5,/3,0-10,0-15,0-20,0-25,0-40,0.1,0.1-,0.15-0.25,0.15-0.35,0.2,0.2-0.45,0.5,0.5-1.5,0.7-0.9,1-4,1-6,1.2,1.8-2.5,1/,1/3,1/4,1/8-1/2,10-20,2-6,2-8,25-100,3-10,3-15,3-6,4-7,4-8,4.5-8,5-merous,6-9,7-,8,abaxially,accrescent,acicular,alyx,ame,apar,apart,apically,apparently,articulated,bark,berry,beyond,branched,brittle,c.,cell,concolorous,connivent,curved,deltate,discolorous,distance,drying,eaf,eed,elongating,enclosing,erect,extending,fifth,filament,fine,flower,four,free,fruiting,gently,glabrescent,glabrous,gra,herbarium,infructescence,irregularly,less,lon,long-acuminat,longer,lower,mature,membranous,midvein,narrow-elliptic,narrow-lanceolate,nflorescence,obovate,older,one,open,orolla,oung,outline,ovate,pair,pendulous,per,perfec,pericarp,perpendicular,pit,plurifoliat,poricidal,porrect,portion,prickl,prickle,prickly,primary,raised,red-brown,reduced,reflexed,ruit,scar,sessile,shiny,shorter,side,small,sometimes,spaced,specimen,spreading,stalk,stalked,straight,tamen,tearing,terete,tertiary,time,tip,tissue,translucent,trichome,unequal,unit,upper,variously,vary,vein,venation,visible,way,weakly,woody,yellow-green,ympodial	0.1-0.45,7-8,adhesion,arrangement,climate,colour,corolla,form,glandular,growth,hair,height,history,inflorescence,life,na,number,ovary,perennial,plant,position,presence,pubescence,reproduction,rugulose,seed,shape,size,stigma,stipe,texture,unknown,ye
183	wfo-0001027123	success	181	118	86	95	32	0.475	-10,.3,.5,0.7-3.5,0.8-1.3,1,1-1.2,1-1.5,1.5-2,2-2.6,2-5.5,2-lobed,2.5-10.4,2.5-4,2.5-6,3-4,4-5,5-6,acute,anther,apex,attenuate,base,branched,bright,broadly,brown,calyx,clavate,cm,commonly,conical,corolla,cup-shaped,dark,deltate,dendritic,densely,diameter,elliptic,flattened,glabrous,glandular,green,inflorescence,leaf,less,lobe,lobed,long,loosely,margin,mauve-purple,minute,minutely,mm,narrowly,ovary,papillate,pedicel,peduncle,petiole,pitted,pubescent,reddish,reniform,revolute,shiny,simple,sparsely,stellate,stem,stigma,strongly,style,subshrub,surface,terminal,tip,trichome,tube,violet,way,white,x,¾	-20,0.3-1.6cm,0.5,0.5-0.8,0.9-1.3,2-2.2,2-2.5,2-3,3-15,4-6,5-10,abaxial,adaxial,adaxially,along,anthesi,appearing,axe,axi,bark,campanulate,cell,completely,constricted,coriaceous,darker,denser,drying,eaf,edge,eed,enlarged,erect,exerted,fide,filament,flower,free,fruiting,globose,inserted,lamina,lax,lewi,like,lon,loose,lower,midvein,monopodia,nflorescence,nodding,older,outline,pair,papillae,perfect,perhaps,petal,planar,plurifoliate,portion,primary,prominent,scar,scatted,scattered,shin,shinin,shining,short,sinuate,sleeve,slightly,sometimes,soon,spaced,stoutish,straight,testal,thick,time,trailing,tub,turned,ud,unit,upper,usually,vein,warty,widely,wood,ympodial,young	0.3-1.6,adhesion,arrangement,blade,climate,colour,form,fruit,growth,hair,height,hermaphroditic,history,length,life,midpoint,na,number,perennial,plant,position,presence,pubescence,ray,reproduction,rugulose,seed,shape,size,staman,stipe,texture
184	wfo-0001027125	success	155	116	83	72	33	0.535	.5,0,0.5,1,3,4,5,50,6,abaxially,acuminate,acute,adaxially,anther,anthesi,apex,armed,articulated,base,becoming,blue,brown,calyx,campanulate,clavate,clustered,cm,completely,connivent,coriaceous,corolla,diameter,elliptic,elongating,entire,equal,flattened,fleshy,fruit,glabrous,globose,green,lateral,light,lobe,major,margin,midrib,minutely,mm,mostly,narrowly,oblong,papillate,pedicel,peduncle,petiole,prickle,recurved,rounded,rugose,side,simple,slender,somewhat,spreading,stem,stigma,strongly,style,subwoody,surface,terminal,terminally,thick,tip,truncate,tube,vein,vine,yellow,×,–9	/4,0.3,0.3-0.6,0.8,1.2-2,10–,10–15,12,12–17,1–,25–50,3–,3–10,3–5,3–7,4–6,5–10,5–7,6–,6–9,?,absent,ag,alyx,apiculate,axe,ba,bilobe,blade,branched,bud,cucullat,deeply,dr.,eaf,eed,ellipsoid,exserted,filament,flower,foveolate,internode,lengthening,lobed,long,long-styled,lower,middle,nflorescence,orolla,plurifoliat,pore,poricidal,rachi,recurve,robust,ruit,slit,stellate,stout,tamen,thickened,time,triangular,unit,vary,way,wide,widest,woody,ympodial,youn	0.3-0.8,1-7,10-15,10-25-50,12-17,3-5,4-6,5-7,6-9,abaxial,adhesion,arrangement,bilobed,colour,dry,form,growth,hair,inflorescence,leaf,length,na,ovary,position,presence,pubescence,rugulose,seed,shape,size,staman,texture,true
185	wfo-0001027131	success	186	102	75	111	27	0.403	0-0.1,0.4-0.8,0.5-1,0.9-2.5,1-1.2,1-1.5,1-4,1.4-2,1.5-3.3,1.7-3.5,2.6-3,3-4,3-9,4.5-8.5,5.5-6.5,7-11,7-8,9.5-11.5,absent,acute,anther,apex,attenuate,base,black,blade,brown,calyx,chartaceous,cm,cordate,cylindrical,dark,densely,diameter,entire,extra-axillary,fruit,gland-tipped,globose,green,hair,inflorescence,juicy,length,lobe,margin,midpoint,mm,moist,obtuse,ovate,pale,pedicel,peduncle,perennial,petiole,plant,present,purple,ray,rhizomatous,rotate,rusty,short,shrub,simple,stellate-pubescent,stem,streak,style,tube,x,yellow,yellowish-green	%,.05,.7,0-0.3,0-2,0-3,0-5,0.2-2.2,0.4-1,0.5-0.8,0.7-2.5,1-2,1-3,12-20,17-35,2-5,2.3-2.7,4-10,4-7,4-8,4-locular,5-merou,7-9,abaxially,absen,across,adaxiall,adaxially,alyx,andromonoecious,anvil-shape,apart,articulated,ascending,axe,ba,broad-based,circular,cross-section,d.,directed,distall,distally,distributed,dult,eaf,eed,eglandular,elliptical,erect,exocarp,finger,flower,fruiting,functional,geminat,grey,half,heterostylous,hig,lamina,lateral,less,long,longer,lower,markedly,mature,mesocarp,mid-point,minute,nflorescence,oblique,onl,orolla,part,per,placenta,plurifoliate,pore,porrect,possibly,prickle,pseudo-racemose,ridged,ruit,spaced,stage,stalk,stalked,stellae,straight,tamen,terete,thick,thicker,thicknes,throughout,time,unarme,unarmed,unbranched,unit,unknow,uvenile,vary,weakly,white,wide,yellowish,ympodial	adhesion,arrangement,climate,colour,corolla,form,glandular,growth,height,history,leaf,life,na,number,ovary,position,presence,pubescence,reproduction,seed,shape,size,staman,stellate,stigma,stipe,texture
186	wfo-0001027146	success	213	129	104	109	25	0.488	0.3-2.2,0.7-2.4,0.8,1-2,1-2.5,10,13-36,2-13,2-4.2,3.3-6.1,3.5-22,4-12.5,4-8,6-10,6-17.5,6.5-52,abaxially,adaxially,along,anther,attenuate,axillary,berry,brownish,bud,cell,chartaceous,ciliate,clavate,cm,coarsely,condition,conical,corolla,covering,deep,diameter,drying,elliptic,especially,finely,flower,fresh,fruit,glabrous,green,green-white,greenish,hair,hair-like,herb,lanceolate,lateral,leaf,like,lobe,long,make,margin,medium,membranous,midrib,minute,minutely,mm,mottled,mucilaginous,odd-pinnate,ovate,ovoid,pedicel,peduncle,pentagonal,plant,puberulent,pubescent,purple,ripe,rotate,seed,simple,size,stem,stigma,style,subglabrous,subtending,terminal,testal,thick,throughout,tinged,tip,tube,unwinged,violet,wall,wet,white,whitish,wide,wing,x,yellow	0-11,0.5-3.2,0.6-3.3,0.8-3.1,0.8-5.8,1-10,1-9.5,1.9-10,2-12.2,2-5,4-11,4-38,5-merou,6,acumen,acuminate,ag,alyx,apart,apex,apparently,arranged,articulated,asymmetrical,axe,base,basiscopic,bead,blade,capitat,commonly,connivent,dark,darker,decreasing,digestion,distal,dorsally,eaf,edge,eed,enzyme,erec,exceeding,filament,flat,folded,forked,fourt,fourth,geminat,generally,glabrou,gradually,half,homostylous,honeycomb-shaped,interjected,leaflet,lengthening,living,lower,moniliform,multiple,necklace,nflorescence,orbicular,orolla,pair,perfect,petiole,petiolule,plurifoliate,pore,poricidal,proximal,rarely,ray,removed,ruit,secondary,semierect,sessile,seudostipule,side,slit,sometimes,spaced,specimen,stamen,ste,stolon,straight,subequal,subglabrou,subsessile,symmetrical,tall,tamen,tem,tissue,toward,tri-,tuber,typically,unit,usually,vary,ympodial	adhesion,arrangement,calyx,capitate,colour,form,growth,height,hermaphroditic,history,inflorescence,length,life,na,ovary,perennial,position,pseudostipule,pubescence,reproduction,rugulose,shape,staman,surface,texture
187	wfo-0001027154	success	215	115	75	140	40	0.349	.5,.6,0.2,0.4-0.5,1-1.3,1.9,2.9,5,abaxially,adaxially,anther,apex,attenuate,calyx,chartaceous,clavate,cm,connivent,densely,diameter,extra-axillary,ferruginous,flattened,flower,fruit,globose,green,highly,immature,lanceolate,leaf,length,linear,lobe,margin,mature,mm,nearly,ovate,paler,pedicel,peduncle,petiole,plant,pubescent,ray,reniform,rotate-pentagonal,rounded,sessile,shape,shrub,simple,size,slightly,sometimes,stellae,stellate-tomentose,stem,stigma,stipe,style,sulcate,surface,tan,tardily,tomentose,tube,unknown,variable,white,x,yellow,yellowish,young	-15,-16,.2,0,0.3–0.6,1.5–2.5,1.5–3,17–19,1–2,2,2-6,2.5-5,23,26,2–2.5,2–4,3-7,35,3–10,4.5–5,4.5–8,4–8,6–8,6–9-rayed,7.5-11,7–20,8,8-11,absent,accrescent,acute,adaxiall,ag,alyx,ample,apart,armed,articulated,axe,ba,basal,base,berry,blade,branch,branched,broad,broad-based,capitat,color,curved,cylindrical,deltate,difoliate,directed,distally,eaf,eed,entire,evidently,except,filament,finer,flowering,foveolate,free,fruiting,geminat,glabrescen,glabrous,hair,ilament,interpetalar,irregularly,juvenile,larger,less,lighter,like,lobed,lognitudinal,long,m.,major,midpoint,midrib,minute,minutely,mostly,much,near,nflorescence,normally,oblique,often,older,opening,orolla,outline,part,per,perfect,pinnately,pore,prickle,rachi,rarely,reaching,recurved,reflexed,repand,ruit,shiny,side,sinus,slit,smaller,spaced,sprout,ste,stipitate,stout,straight,tal,tem,third,three,tissue,truncate,unarme,unarmed,underside,uniform,unit,usually,vary,vein,within,ympodial,–4	0.3-0.6,0.6,1-2,1.5-3,10,17-19,2-2.5,3-10,4-8,4.5-5,4.5-8,6-8,6-9,7-20,adhesion,arrangement,capitate,colour,corolla,form,glabrescent,growth,height,history,inflorescence,life,na,number,ovary,perennial,position,presence,pubescence,reproduction,rugulose,seed,staman,stellate,texture,ye
188	wfo-0001027157	success	207	98	73	134	25	0.353	0.15-0.3,0.9-2.8,1,1-2,1-3,1-6,1.5-6.5,10-30,2-15,2-2.5,2-3,2.5-3,3.3-7.8,4-5,6.5-14.5,9-12,abaxially,acute,adaxially,anther,attenuate,broadly,brownish,chartaceous,clavate,cm,condition,conical,corolla,deeply,densely,diameter,drying,elliptic,fresh,fruit,glabrous,green,greenish,herb,lanceolate,leaf,lobe,long,membranous,minutely,mm,odd-pinnate,ovate,ovoid,pedicel,peduncle,petiole,plant,puberulent,pubescent,ripe,seed,size,sometimes,stellate,stem,stigma,style,terminal,tinged,tube,violet,white,whitish,wide,x,yellow	0-3,0.7-2,1-10,1-3.8,2,2-5,2.3-4,3-12,3-7,3.8-8.3,5-merou,absent,acumen,acuminate,ag,along,alyx,among,apart,apex,apparently,articulated,axe,axillary,base,berry,blade,bud,capitat,cell,ciliate,connivent,cordate,covering,cuneate,decreasing,decurrent,digestion,distal,dorsally,eaf,edge,eed,end,enzyme,erec,especially,exceeding,filament,flat,flower,folded,forked,geminat,generally,glabrou,grassland,greatly,green-white,hair,hair-like,half,homostylous,honeycomb-shaped,interjected,lateral,leaflet,lengthening,like,living,low-growing,lower,make,margin,markedly,middl,midrib,mucilaginous,narrowly,nflorescence,oblique,obtuse,one,orbicular,orolla,pair,perfect,petiolulate,petiolule,placed,plurifoliate,pore,poricidal,rarely,removed,rounded,ruit,semi-rosette,sessile,seudostipule,shady,short,situation,slightly,slit,spaced,specimen,stamen,ste,stolo,straight,subsessile,subtending,sunny,tall,tamen,tem,testal,thick,throughout,tip,toward,tri-,tuber,typically,unequal,unit,unwinged,usually,vary,wall,wet,woodland,ympodial	adhesion,arrangement,calyx,capitate,colour,form,growth,height,hermaphroditic,history,inflorescence,length,life,na,ovary,perennial,position,pubescence,reproduction,rugulose,shape,staman,surface,texture,ye
189	wfo-0001027184	success	219	144	120	99	24	0.548	.5,.7,.8,0.2-0.4,0.4-2,0.4–0.9,0.5-2,0.8,1.5-5,13–18,19,1–2,1–4,2,2–4-celled,3-foliolate,3–,3–4-celled,4,4–12,7,abaxially,acute,adaxially,along,anther,apex,articulated,axi,axillary,base,blade,blue,borne,bract-like,branch,brown,calyx,chartaceous,cm,connivent,covered,densely,diameter,entire,epidermal,especially,extension,flattened,fleshy,flower,fruit,generally,glabrescent,glabrous,globose,grading,hair,hairlike,half,herbaceous,imparipinnate,lanceolate,leaf,leaflet,leafy,least,light,lobe,long,lower,margin,membranous,midrib,minutely,mm,mostly,oblong,obtuse,older,orange,pedicel,peduncle,petiole,pilose,prominently,puberulent,pubescent,raised,rarely,red,reticulate,revolute,ripe,shape,shoot,short,simple,size,slightly,small,somewhat,sparsely,stellate,stem,stigma,style,surface,tertiary,tip,tube,vein,vine,wall,weak,white,x,yellow,young,–9	.3,0-,0-0.2,0.8–1.6,0–3,1-2,1.5,1.8–3.5,1–2.5,2.8–4.1,3-4-,3.5–8,5,5-7,9,absent,accrescent,adaxiall,adventitious,ag,always,alyx,apart,appressed,axe,ba,basal,broad,broadly,cell,clavat,cluster,cordat,cylindrical,directed,eaf,eed,elliptic,fasciculate,filament,foliaceous,free,fruiting,geminat,glabrou,ilament,introrsely,larger,largest,lateral,less,like,longitudinal,m.,meter,much,narrowly,nearly,nflorescence,node,often,opening,opposite,orolla,ovate,ower,per,petiolule,plurifoliate,pore,portion,prominent,pseudostipule,rachi,root,ruit,scarcely,secondary,several,slit,soft-woody,spaced,straight,subopposite,sulcate,terminal,tightly,tree,truncate,trunk,unarme,unbranched,unequal,uniform,unit,usually,vary,visible,ympodial	adhesion,arrangement,clavate,climate,colour,corolla,form,glandular,growth,inflorescence,length,midpoint,na,number,ovary,position,presence,pubescence,ray,rugulose,seed,staman,stipe,texture
190	wfo-0001027186	success	168	119	94	74	25	0.56	.4,.5,0.5-1,1-1.5,1-2.5,1.4-1.6,1.5,1.5-2,1.5-2.5,1.6-5,15,2-6,2-lobed,3.5-4,4-15,4-9,5-10,6-7,?,abaxially,adaxially,age,anther,apex,base,berry,branch,broadly,calyx,clavate,cm,conical,corolla,deltate,dendritic,diameter,dry,elliptic,entire,fruit,glabrescent,glabrous,globose,golden,green,growth,immature,lamina,lengthening,lobe,lobed,loose,margin,maturity,minutely,mm,narrowly,occasionally,ovary,ovoid,pale,pedicel,peduncle,petiole,pore,poridical,pubescent,reniform,scattered,seed,shiny,short,simple,slightly,slit,soon,sparsely,stalk,stem,stigma,style,surface,terminal,tip,tree,trichome,tube,uniseriate,variably,way,white,woody,x,yellow	-6,2.5-3,3-4,30-40,9-10,abaxial,acute,always,anthesi,apart,apparently,attenuate,axil,bark,branched,brown,dark,dbh,deflexed,denditic,densely,denser,eaf,ellipsoid,enlarging,exerted,filament,filiform,flower,free,fruiting,incrassat,irregularly,keeled,less,like,longer,lower,m.,midrib,much,new,nflorescence,pair,papillat,papillate,pendent,perfect,pericarp,pitted,planar,plane,plurifoliat,pointed,portion,primary,pubescen,rachi,reddish,rough,ruit,scar,small,spaced,spreading,straight,strongly,time,treelet,tub,ud,unit,vein,ympodial	adhesion,arrangement,colour,form,height,hermaphroditic,history,inflorescence,leaf,length,life,na,perennial,plant,position,presence,present,pubescence,reproduction,rugulose,shape,size,staman,stellate,texture
191	wfo-0001027187	success	224	112	83	141	29	0.371	.5,0.2,0.3–1,0.6,0.8–2,1.0,1.2,1.5–3.5,1–1.5,1–1.8,1–2,1–3,2.5–4,2.5–6,2–2.5,2–3,2–7,3.5–10,3–10.5,3–7,5–11,5–15,7–12,anther,apex,blue,broadly,calyx,cm,darker,deltate-lanceolate,deltoid-ovate,densely,diameter,extra-axillary,finely,flattened-reniform,foveolate,fruit,glabrous,glandular-puberulent,globose,green,herb,hermaphroditic,irregularly,lanceolate,leaf,lenticular,light,lobe,lobed,margin,maturity,minutely,mm,moderately,mottling,narrowly,obtuse,pedicel,peduncle,perennial,petiole,ray,rotate-stellate,rounded,serrate,shallowly,simple,sky,sparsely,stellate,stellate-pubescent,stem,stigma,style,subglobose,surface,tube,yellow,young,×	0,0.05–0.1,0.15–0.4,0.4,0.5,0.5–1,0.5–1.5,1,1-celled,12,13–18,1–3-celled,2,2-,2–5,3-foliate,3.2,3–10,3–6,4,4.5–8,4–5,5,5-merous,5.4,5.5,5–10,5–6,5–8,6,6–8,7,7–15,9,abaxially,accrescent,acute,acute-acuminate,adaxiall,adaxially,alyx,andromonoecious,apart,armed,articulated,axe,base,berry,blade,branched,bud,capitat,central,chartaceous,completely,connivent,continuum,cordate,covering,cuneate,cylindrical,decumbent,deflexed,deltate,directed,distal,distall,downward,eaf,eed,equal,erect,exserted,filament,flower,forked,fruiting,geminat,grading,hair,lateral,like,lon,long,long-stalked,lower,major,morphology,nflorescence,node,offset,often,one,open,orolla,outline,perfect,plurifoliate,pore,prickle,prickle-like,producing,proximal,pubescent,rarely,rind,root,rooting,ruit,sessile,short-stalked,showing,side,sinus,small,sometimes,spaced,spreading,stalk,staminate,stout,straight,strongly,subequal,subsessile,tall,tamen,tapered,tem,toug,triangular,truncate,unbranched,unequal,unit,usually,vary,vein,weakly,wide,ympodial	4–8,adhesion,arrangement,capitate,colour,corolla,form,growth,height,history,inflorescence,length,life,na,number,ovary,plant,position,presence,present,pubescence,reproduction,rugulose,seed,shape,size,staman,stipe,texture
192	wfo-0001027198	success	191	109	84	107	25	0.44	.5,0.05-1.0,0.5-1,0.8-1,1-1.5,1-10,1.5-10,1.5-2,11-20,3/4,5-6,7.5-9,anther,axil,base,beneath,bushy,calyx,channeled,clavate,cm,corolla,cyathiform,deltoid,dendritic,densely,dia,elliptic,entire,flower,glabrous,globose,golden,green,inflorescence,leaf,like,lobe,lobed,long,medium,minute,minutely,mm,obovate,often,opposite,ovary,ovoid-reniform,pale,paler,pedicel,petiole,pitted,plant,poricidal,puberulent,pubescence,pubescent,rounded,shining,short,shrub,simple,size,slender,slightly,small,stem,stigma,straight,style,styled,surface,tannish-yellow,tip,tree,trichome,tube,uniseriate,vein,way,white,x	.4,0.5-0.75,0.7-1,1-5,10-11,2-5.5,4-9,5-120-flowered,abruptly,acuminate,acute,always,anthesi,apart,apex,attenuate,ba,beginning,berry,broadening,caly,closely,complex,constriction,corky,corresponding,decurrent,differing,difoliate,dry,eaf,edge,edicel,eed,erect,evenly,exserted,extremely,eye,female,filament,found,free,fruiting,furcate,geminat,glabrate,impressed,inflorescenc,invisible,large,lateral,live,lon,lower,main,major,male,many,margin,meet,middle,minor,naked,nearly,nflorescence,older,overlapping,ovoid,papillo,papillose,pendan,planar,pore,portion,rather,reddi,reflexed,rest,ruit,scar,sessile,set,shaped,soon,spaced,speciman,specimen,strong,tall,tear-drop,testae,thickened,thin,time,top,two,type,ud,undersurface,unit,usually,widest,woody,yellowish,ympodial,young	0.5,5,adhesion,arrangement,colour,diameter,form,fruit,growth,height,history,length,life,na,peduncle,position,presence,reddish,reproduction,rugulose,seed,shape,staman,stellate,texture
193	wfo-0001027200	success	139	103	70	69	33	0.504	0.5-1,0.6-1,1-1.4,1-1.5,1.2-1.5,1.5-2,1.5-5,2.5-3,3-3.5,3.5-6,6-8,8-15,acute,anther,apex,base,beneath,broadly,brown,calyx,capitate,cm,conical,corolla,dark,deeply,deltoid,densely,dia,elliptic,glabrous,globose,green,grey-brown,inflorescence,leaf,lobe,lobed,margin,minute,minutely,mm,nearly,ovary,ovoid-reniform,papillose,pedicel,petiole,pitted,poricidal,puberulent,shrub,size,small,sparsely,stem,stigma,style,surface,tip,tree,trichome,tube,unicellular,unifoliate,uniseriate,vein,white,x,young	0.05-0.25,0.25-0.5,0.5-0.75,0.7-2.5,1.6-6,2-3,9-11,across,anthesi,aspec,ba,bark,berry,branch,branche,converging,decurrent,deflexed,differing,eaf,eed,except,filament,flattened,free,fruiting,geminate,giving,golden,horizontally,impressed,lateral,lightly,like,lon,long,lower,main,major,middle,minor,near,node,non-reproductive,occasionally,older,onto,papillo,planar,pore,portion,prominent,reflexed,rest,ruit,shaped,slightly,sparse,spreading,straight,tall,tear-drop,unit,widened,widest,winged,woody,yellowish,ympodial	adhesion,arrangement,blade,climate,colour,diameter,form,fruit,glandular,growth,hair,height,history,length,life,midpoint,na,number,peduncle,perennial,plant,position,presence,pubescence,ray,reproduction,rugulose,seed,shape,staman,stellate,stipe,texture
194	wfo-0001027204	success	154	111	81	73	30	0.526	-8,.5-1,.8-2,0.5-4,1-3.5,1-7,1.5-3.5,1.5-6.5,1.5-9,2-2.5,2-4,3-20,3-5,4-6,5-19,5-30,5-9,6-10,abaxially,acuminate,acute,adaxially,angled,apex,base,branched,brown,calyx,chartaceous,cm,cuneate,decurrent,densely,diameter,eglandular,elliptic,entire,except,forked,fruit,glabrous,glandular,globose,greenish,hair,lanceolate,lobe,margin,midrib,mm,moderately,nearly,orange,ovate,pedicel,peduncle,petiole,pink,puberulent,pubescent,pubescent-pilose,purplish,reddish,shrub,simple,sparsely,stellate,stellate-campanulate,stigma,style,subcoriaceous,tip,triangular-deltate,tube,twice,unbranched,violet,white,x,yellow,yellowish	-4.5,-40,1,1-10,1-14,15-35,2-5,2-8,4-5-foliat,6-12,8-15,absen,adaxial,aggregate,along,apart,articulated,axe,blade,cell,channe,connivent,cylindrical,dense,denser,directed,distall,distally,eaf,eed,especially,expanded,flower,glabrate,leaving,lon,long,lower,membranaceous,narrowed,narrowly,near,nflorescence,nther,obtuse,often,orolla,peg,perfect,pore,present,pseudohair,pubescen,rachi,radiu,ripe,rugose,ruit,scar,short,spaced,stone,subacute,tal,tem,time,triangular,truncat,unit,vary,wide,x1-2,ympodial	1-2,anther,arrangement,colour,corolla,form,growth,height,hermaphroditic,history,inflorescence,leaf,length,life,na,ovary,perennial,plant,position,pubescence,reproduction,rugulose,seed,shape,size,stem,surface,texture,truncate,ye
195	wfo-0001027213	success	231	141	111	120	30	0.481	-19,-3.3,0-2.5,0.2-0.4,0.2-0.5,0.8-1.8,1-5,1.1-1.7,1.2-1.6,1.2-1.7,1.2-2.5,1.3-2.2,1.7-3.6,1.7-3.9,1.8-3.2,10-24,12.3-16.3,2-5,2.9-3.8,2.9-4.8,2/3,3.5-8,4-9.5,5.7-6.2,8-24,abaxially,acuminate,acute,adaxially,anther,apart,apex,articulated,attenuate,basal,base,blade,blunt-tipped,broadly,brown,calyx,cm,conical,corolla,cuneate,dark,deltoid,diameter,drying,elliptic,entire,eventually,flower,fruit,glabrescent,glabrous,globose,granular,grayish-brown,green,hair,immature,inserted,lanceolate,leaf,length,lobe,long-stalked,margin,mm,multangulate,oblanceolate,obtuse,ovate,ovate-lanceolate,pale,pedicel,peduncle,petiole,porrect-stellate,pseudo-terminal,pubescence,pubescent,reniform,scabrous,short-,short-attenuate,shrub,simple,sometimes,spaced,sparsely,stellate,stem,stigma,style,subcampanulate,surface,tomentose,tomentose-pubescent,tree,tube,violet,white,whitish,whitish-green,x,yellow,yellow-green,yellow-tan,yellowish	-230,-4.5,/10,0-160,0.7-2.3,1-2,1.8-2.8,1/2-2/3,2.4-4.7,2.5-5.1,3.5-5,4.2-5.9,5-7.5,5-8,5-merou,8.2-10.5,9-13,accrescent,ag,along,alyx,anthesi,apparently,ark,around,axe,axillary,ba,branch,branched,capitat,cell,completely,covering,cylindrical,decurrent,directed,distally,eaf,early,edge,eed,enveloping,epidermal,exserted,farinose,few-rayed,filament,free,fruiting,glabrescen,group,high,homostylous,lackin,lateral,lengthening,lobed,long,long-,longitudinal,lower,m.,main,many,midrib,mixed,moderately,mostly,multangulat,nearly,nflorescence,obovate,obscured,often,older,orbicular,orolla,partly,perfect,plurifoliate,pore,poricidal,porrect-stellat,prominent,rachi,rather,relatively,reticulate-punctate,ruit,sessile,short,short-stalked,side,slit,somewhat,stamen,suture,tamen,terete,thick,thick-stalked,thin-stalked,ti,time,tip,tomentu,touching,ud,unarme,unarmed,unit,unwinged,vary,vein,vestigial-rayed,way,wide,ympodial,young	adhesion,arrangement,capitate,climate,colour,form,glandular,growth,height,history,inflorescence,life,midpoint,na,number,ovary,perennial,plant,position,presence,ray,reproduction,rugulose,seed,shape,size,staman,stipe,texture,ye
196	wfo-0001027214	success	181	87	66	115	21	0.365	-20,-38,0.5-0.8,0.5-1,0.7-2,0.7-2.5,1-2.8,1.2-3,1.5,1.5-1.8,1.5-6,10-13,15-25,2,2-9,6-12,7-12,abaxially,adaxially,anther,anticlinal,basal,calyx,cm,conical,corolla,densely,diameter,elliptic,flattened-round,fruit,glabrous,green,greenish,height,herb,inflorescence,irregular,lateral,leaflet,length,long-conical,mm,occasionally,once-branched,ovary,pedicel,petiole,pinnate,pointed,projection,pubescent,rachi,rugose,seed,sharply,simple,sinuous,style,surface,terminal,thickening,tube,white,without,x	-9,..,.25,.5,0,0-16,0.25,0.3-1.5,0.3-1.7,0.8-1,1-1.5,10-,12-17,3-,3-6,4-5,5-6,6-,8-9,absent,acuminate,acute,along,anthesi,apex,apical,base,berry,broadly,capitat,cell,climbing,composed,conspicuously,decurrent,deltate,dr.,drying,eaf,edicel,eed,epidermal,erect,exserted,extending,filament,finely,flower,free,fruiting,globose,groove,grown,horizontal,inflorescenc,lamina,lanceolate,less,like,lobe,lobed,lon,long,long-acuminate,lower,margin,markedly,midrib,minutely,narrowly,nearly,nflorescence,noddin,nodding,oblique,obovate,often,onto,open,opposite,pair,paired,papilla,papillate,per,perfectly,petiolule,poricidal,portion,reflexed,rest,rugosity,ruit,scar,scattered,scrambling,smaller,somewhat,stigma,tem,time,tip,triangular,trichome,truncate,tub,ud,unevenly,unifoliat,uniseriate,unit,vein,white-lenticellate,whitish,ympodial	.0,0.5,2.0,6-12-17,arrangement,colour,form,growth,history,leaf,life,na,perennial,plant,position,pubescence,reproduction,shape,size,stem,texture
197	wfo-0001027219	success	143	110	77	66	33	0.538	/4,0.3,0.4-0.6,0.5-0.8,1,1-2,1.5-2,1.5-2.5,2,2-2.5,2-3.5,2-4,3-5,3-6,6-8,acuminate,acute,anther,apex,axillary,base,berry,bright,broadly,brown,calyx,capitate,cm,conical,corolla,cup-shaped,deltate,densely,diameter,elliptic,entire,flower,glabrescent,glabrous,green,greyish,growth,hard,leaf-opposed,less,lobe,lobed,long-conical,long-styled,margin,maturity,mm,ovary,pale,papillose-pubescent,pedicel,peduncle,petiole,poricidal,purple,shoot,short,short-styled,shrub,simple,stem,stigma,style,surface,terminal,tip,tube,violet,way,white,x,–1/3	.5,0.5,1-15,1-3,2-3,7-8,absent,age,anthesi,bark,berr,c.,closely,completely,drying,eaf,edge,eed,erect,exerte,exfoliatin,filament,free,fruiting,glabrou,globose,heterostylous,known,lengthening,lower,minutely,new,nflorescence,overlappin,pair,papillo,pendent,pericarp,planar,plurifoliat,pointed,pore,portion,primary,pubescent,ruit,scar,sharply,slightly,slit,sometimes,somewhat,soon,spaced,stout,thickened,trichome,tuft,ud,uniseriate,unit,vein,weight,woody,yellowish,ympodial	adhesion,arrangement,blade,climate,colour,form,fruit,glandular,hair,height,history,inflorescence,leaf,length,life,midpoint,na,number,perennial,plant,position,presence,pubescence,ray,reproduction,rugulose,seed,shape,size,staman,stellate,stipe,texture
198	wfo-0001027221	success	261	109	62	199	47	0.238	.5,0.3-0.6,1,1.4-2,4,acute,andromonoecious,anther,apex,attenuate,base,berry,blade,blue,bright,calyx,cm,diameter,extra-axillary,flattened-reniform,flower,fruit,glabrous,glandular-pubescent,globose,hair,intensity,lanceolate,leaf,light,lobe,margin,midpoint,mm,orange,outline,ovate,pale,pedicel,peduncle,persistently,petiole,plant,ray,rounded,shrub,simple,size,stellate,stellate-pubescent,stellate-tomentose,stem,stigma,style,subcordate,surface,triangular-caudate,tube,variable,violet,x,yellow	-9.5,0,0.4,0.4–0.6,0.5–2,0.8–1,1-4,1.5-2,1.6–2,11-17,11–14,13–16,14–17,1–2,2,2.2-3.2,2.5–2.8,2.5–5,2.9–3.6,2/3,25-30,2–2.5,2–3,2–5,3.1-4.8,3–6,4.5–11,4–8-rayed,5-8,5-merou,6-8,6.5–7,8.5–18,9,abaxial,abaxiall,abaxially,acicular,actually,acutely,adaxially,along,also,always,alyx,ample,apart,apparent,apparently,appear,armed,aromatic,articulated,ba,becoming,blunt-tipped,branched,broad-based,bud,capitat,caudate,central,chartaceous,clavate,closely,common,contrasting,coroll,curved,cylindrical,darker,deeply,delicate,dense,densely,development,difoliate,directed,discrete,distally,eaf,eed,entire,equal,eventually,evidently,exceeding,expanded,fewer,filament,frequently,fresh,fruiting,geminat,glabrescent,gland,half,herbarium,hermaphrodite,homostylous,interpetalar,juic,lateral,least,like,likely,lobed,long,lower,main,major,material,microscope,midrib,midvein,minor,minutely,mostly,much,nearly,nerve,nflorescence,obtuse,often,older,orolla,ovate-oblong,ovate-triangular,pair,paired,per,perfect,perhaps,peripherally,pitted,plurifoliate,pore,predominately,prickle,probably,rachi,rarely,reflexed,repand,ruit,sessile,short-stalked,side,similar,sinus,slightly,smaller,sometimes,somewhat,soon,source,spaced,sparsely,specimen,splitting,sprout,stalk,stalked,stamen,stellae,straight,sulcate,tal,tapered,tem,thick-textured,thickened,time,tip,tissue,tomentose,toward,unarmed,unbranched,underside,unequal,unit,unpleasantly,usually,vary,vein,viscid,viscidity,way,weakly,white,wide,ympodial,youn,young,–11.5,–15,–3,–4	0.4-0.6,0.5-2,0.8-1,1-2,11-14,11.5,13-16,15,2-2.5,2.5-2.8,2.5-5,2.9-3.6,3-6,4-8,4.5-11,6.5-7,8.5-18,adhesion,arrangement,capitate,climate,colour,corolla,form,glandular,growth,height,history,inflorescence,juicy,length,life,na,number,ovary,perennial,position,presence,pubescence,reproduction,rugulose,seed,shape,staman,stipe,texture,ye
199	wfo-0001027223	success	189	112	79	110	33	0.418	.5,0.19-0.75,0.3-1.2,1-3,1.8-3.5,16-41,3-10,3-5.2,3.5-4,3.7-9.3,5-8,5.9-12.2,9-15,9-22,abaxially,acuminate,adaxially,anther,apex,articulated,attenuate,axillary,base,blade,brownish,bud,clavate,cm,condition,conical,corolla,deep,densely,diameter,distal,dot,drying,fresh,fruit,glabrous,green,greenish,hair,half,herb,hyaline,lanceolate,leaf,lobe,long,middle,mm,odd-pinnate,ovate,ovoid,pedicel,peduncle,pentagonal,petiole,plant,pubescent,purple,ripe,rotate,rounded,seed,size,sometimes,stigma,stripe,style,subtending,terminal,tube,white,whitish,wide,x,yellow	1-2,1.3-2,1.5-3.5,2-4,2-7,3-11,3-5,3.5-6,3.5-7,4-6,5-10,5-21,5-merou,9-35,acumen,adaxiall,ag,alyx,apart,apparently,asymmetric,axe,basiscopic,berry,capitat,cell,connivent,covering,decreasing,digestion,dorsally,eaf,edge,eed,elliptic,end,enzyme,erec,exceeding,filament,flat,flower,folded,forked,geminat,generally,glabrou,green-white,hair-like,hal,homostylous,honeycomb-shaped,interjected,larger,lateral,leaflet,lengthening,light,like,living,lower,make,mucilaginous,nflorescence,one,orbicular,orolla,pair,perfect,petiolulate,placed,plurifoliate,pore,poricidal,present,removed,ruit,sessile,seudostipule,short,shortly,side,slightly,slit,spaced,specimen,stamen,ste,stolo,straight,subequal,tall,tamen,tem,testal,thick,throughout,tip,tissue,toward,tri-,tuber,typically,unit,unwinged,usually,vary,wall,wet,ympodial	adhesion,arrangement,calyx,capitate,climate,colour,form,glandular,growth,height,history,inflorescence,length,life,margin,midpoint,na,number,ovary,perennial,position,presence,pubescence,ray,reproduction,rugulose,shape,staman,stellate,stem,stipe,surface,texture
200	wfo-0001027229	success	206	114	85	121	29	0.413	0-0.2,0.1-3,0.2-0.4,0.2-2,0.5-0.9,0.6-1,1-1.5,1-2,1.5-2.5,1.5-3,1.8-2.7,3-6,3.5-5,3.5-6,4-10,4-5,4-6,4-7,5-15,5-6,5-9,7-11,abaxially,acute,adaxially,anther,apex,attenuate,base,blade,broadly,calyx,chartaceous,cm,cordate,cylindrical,densely,diameter,extra-axillary,flower,fruit,glabrous,glandular,globose,green,hair,herbaceous,inflorescence,lanceolate,length,lilac,lobe,lobed,long,margin,mid-point,midpoint,mm,moderately,obtuse,ovate,pale,pedicel,peduncle,pentagonal,petiole,present,ray,reniform,resprouter,shallowly,simple,sparsely,stellate,stellate-pubescent,stigma,style,surface,tan,thick,throughout,triangular,tube,x,yellow	%,0-0.1,0-8,0.1-0.3,0.1-0.6,0.1-1,0.1-1.4,0.2-1.7,0.5-0.7,0.5-3,0.6-0.7,1-6,1-7,1-8,1.1-1.2,1.3-1.7,12-17,2-10,2-4,2-5,2-foliate,2-locular,2.5-6,20-65,25-35,30-145,30-300,40-55,5-merou,8-12,8.5-12,absen,absent,abundant,accrescent,acicular,across,adaxiall,adult,alyx,apart,armed,articulated,axe,ba,branche,capitat,circular,cross-section,decimetre,directed,distall,eaf,eed,eglandular,elliptica,erect,especially,exceeding,exocarp,filament,finger,flattened,fruiting,geminat,gland-tipped,homostylous,index,interpetalar,juicy,lamina,lateral,lobing,lon,longer,lower,mature,mesocarp,midvein,minute,minutely,moist,nflorescence,oblique,orolla,part,per,perfect,placenta,pore,porrect,presen,prickle,prostrate,pseudo-racemose,rachi,reticulate,ruit,short,side,spaced,sprawling,stage,stalk,stalked,stellae,straight,tal,tamen,tem,time,tissue,toward,transparent,unbranched,unit,uvenile,vary,vein,wide,ympodial	adhesion,arrangement,capitate,climate,colour,corolla,form,growth,height,history,leaf,life,na,number,ovary,perennial,plant,position,presence,pubescence,reproduction,rugulose,seed,shape,size,staman,stem,stipe,texture
201	wfo-0001027232	success	195	114	84	111	30	0.431	0.3-0.4,0.3-0.45,0.3-0.5,0.6-0.9,0.7-1.5,1.5-2.5,1.5-3,1.8-3.9,2-3.4,2.1-2.8,2.5-3,3.5-10,4-5.5,4-6,4-8,4.5-6.5,5-11.5,5-8,absent,acute,adaxially,anther,apex,base,black,blade,bluntly,broadly,brown,calyx,chartaceous,cm,cordate,cylindrical,deeply,deltate,diameter,discoid,erect,extra-axillary,flattened,fruit,glabrous,gland-tipped,globose,green,hair,inflorescence,irregularly,lancolate,length,lilac,lobe,lobed,margin,midpoint,mm,obtuse,orbicular,ovate,pale,pedicel,peduncle,perennial,petiole,present,purple,ray,rhizomatous,rostrate,short,shrub,simple,sparsely,stellate,stellate-pubescent,stigma,style,surface,throughout,triangular,tube,x,yellow	%,0-0.1,0-7,0.15-0.3,0.25-0.4,0.4-0.8,0.45-0.6,0.5-0.8,0.7-1.3,0.8-3.2,0.9-7.5,1-10,1-locular,1.1-1.5,10-30,14-18,14-30,15-100,2-25,25-35,3-5,3-9,350-800,4-10,5-merous,6-8,7-9,abaxially,absen,accrescent,acicular,across,adaxiall,adult,apart,apparen,armed,articulated,axe,ba,branche,capitat,confined,decimetre,directed,distall,distributed,eaf,eed,eglandular,exocarp,filament,finger,flower,forked,fruiting,half,incomplete,index,juicy,lamina,lateral,less,lobing,long,longer,lower,mature,mesocarp,mid-point,midrib,midvein,minute,minutely,moderately,nflorescence,oblique,orolla,outline,part,per,perfect,placenta,pore,porrect,prickle,reticulate,ruit,septum,sessile,side,spaced,sparse,stalk,stellae,straight,succulent,tal,tamen,tem,thick,time,transparent,unarme,unbranched,unit,unknow,vary,vein,wide,ympodial	adhesion,arrangement,capitate,climate,colour,corolla,form,glandular,growth,height,history,leaf,life,na,number,ovary,plant,position,presence,pubescence,reproduction,rugulose,seed,shape,size,staman,stem,stipe,texture,unknown
202	wfo-0001027234	success	206	123	92	114	31	0.447	-0.15,-3,-3.5,0.05-0.1,0.2-1.3,0.3-1,0.5-2,0.5-3,0.6-0.8,0.7-1.3,0.7-1.5,0.8-0.9,0.9-1.6,1-2,1.5-2.2,1.5-4,1.8-3,12-18,2-4,2/3-4/5,3-5,8-16,abaxially,acute,almost,anther,apex,attenuate,base,berry,black,blade,broad-deltate,brown,calyx,cm,cordate,dark,diameter,entire,erect,flattened-reniform,fruit,glabrescent,glabrous,herb,lateral,leaf,length,lobe,lobed,long,margin,maturity,mauve,membranous,midpoint,mm,moderately,near,oblong,orbicular,ovate,pale,pedicel,peduncle,petiole,poricidal,purple,ray,red,rounded,scandent,shrub,simple,smooth,sometimes,sparsely,spherical,spreading,stellate,stellate-pubescent,stem,style,surface,tapering,tip,trichome,tube,way,wide,yellow	-1.5,-2,-6,.5,0-20,0-4,0.1,0.1-2,0.15,0.3-0.4,0.5-0.7,1,1-4,1.2-2,1.5-3.5,1/3,1/4-1/3,3-10,3-6.5,4-5-merous,8-15,absent,acuminat,alyx,apar,apart,apically,apparently,articulated,bark,beyond,blac,branched,cell,concolorous,curved,deltate,difoliate,dot,drying,eaf,eed,elongating,equal,eye,filament,filiform,flower,free,fruiting,geminat,glabrou,glan,gland,globular,gray,green,herbaceous,infructescence,longer,lower,mature,multangulate,naked,narrowly,nflorescence,obtuse,older,one,open,orolla,oung,outline,pair,pendulous,per,perfec,pericarp,perpendicular,pit,porrect,portion,prickle,prickly,primary,protruding,raised,reduced,reflexed,ruit,scar,scattered,sessile,shorter,slightly,spaced,stalk,stalked,straight,tamen,terete,tertiary,time,unarme,unarmed,unit,vary,vein,venation,visible,white,winged,yellowish,ympodial	adhesion,arrangement,climate,colour,corolla,form,glandular,growth,hair,height,history,inflorescence,life,na,number,ovary,perfect,plant,position,presence,present,pubescence,reproduction,rugulose,seed,shape,size,staman,stigma,stipe,texture
203	wfo-0001027235	success	189	103	74	115	29	0.392	.5,0.5,1,1.2,1.5,10,11,12,14,18,2,2.5,3,35,4,8,9,?,anther,apex,base,black,blade,brown,calyx,chartaceous,chocolate-brown,cm,deeply,diameter,difoliate,extra-axillary,flower,fruit,glabrous,globose,green,hair,herb,leaf,length,linear-lanceolate,lobe,lobed,margin,midpoint,mm,moderately,narrowly,nearly,obtuse,pedicel,peduncle,petiole,pinnatifid,pinnatisect,pubescent,ray,reniform,rotate-stellate,rounded,sparsely,stellate,stem,stigma,style,surface,tan,triangular,tube,turning,white,yellow,×	13,30,40,5,5-merous,6,abaxial,abaxially,absent,abundant,accrescent,acicular,acute,adaxial,adaxially,alternating,alyx,apart,armed,articulated,asymmetrical,axe,ba,berry,burr-like,c.,completely,cordate,covering,creating,curved,cylindrical,densely,dimorphic,directed,distally,dry,drying,eaf,eed,enantiostylou,filament,four,fruiting,geminate,glabrou,gland-tipped,interpetalar,introrsely,invested,irregularly,larger,left-handed,like,lon,long,longitudinal,lower,lowermost,maturity,midrib,midvein,multicellular,multiseriate,nflorescence,occasional,occasionally,often,one,opening,opposite,orolla,pair,per,pinnate,pore,prickle,prickly,rachi,raised,ridge,right,ruit,secondary,shallowly,side,simple,slightly,slit,spaced,stalk,ste,straight,strongly,tamen,tapering,tearing,tem,tightly,tissue,unbranched,undulate,unequa,unicellular,uniseriate,unit,upper,upward,usually,vary,vein,venation,wid,ympodial,zygomorphic	adhesion,arrangement,climate,colour,corolla,form,glandular,growth,height,history,inflorescence,life,na,number,ovary,perennial,plant,position,presence,present,pubescence,reproduction,rugulose,seed,shape,size,staman,stipe,texture
204	wfo-0001027236	success	199	109	95	104	14	0.477	-4.5,/6,1,1-1.5,1-2.5,1-3,1.5-2,10,10-20,2-2.5,2-3,2-5,2-6,2.5-,3-3.5,3-4,5-,5-6,5-9,7-14,8-10,abaxially,adaxially,anther,anthesi,basal,becoming,berry,blue,branched,brown,calyx,chartaceous,clavate-truncate,cm,cordate,corolla,densely,diameter,flattened,flower,foveolate,fruit,glabrous,glandular,glandular-hirsute,globose,green,growth,internodal,lanceolate,length,like,long-styled,midpoint,minutely,mm,ovary,ovate-cordate,pedicel,peduncle,petiole,plant,pubescence,pubescent,ray,reniform,reticulate,ripe,runcinate,rusty,shrub,simple,sparsely,stellate,stellate-pilose,stem,stigma,style,subcoriaceous,subglobose,suborbicular,surface,tapering,terete,trichome,tube,unarmed,villous-glandular,violet,woody,x,yellow,yellow-orange,¼	-5,-82,0.2-0.3,0.6-0.7,1-2,1.2-1.5,2-,3-8,30-50,4-5,5-8,acute,apex,armed,articulated,asymmetric,bark,base,brow,caly,closely,compressed,dark,discolorous,distal,eaf,eed,eglandular,erect,exserted,filament,free,fruiting,fused,glabrescent,gland-tipped,heterostylous,lateral,lengthening,light,lobe,lobed,lobed-angulate,long,lower,margin,middle,minute,mixed,multangulate,nearly,new,nflorescence,obverse,ochraceous,older,ovate-turbinate,papillo,partially,per,perfect,pericarp,plurifoliat,pore,poricidal,porrect,portion,prickle,prickly,raise,recurved,reflexe,rounded,ruit,scandent,scar,sessile,short-styled,slightly,slit,smooth,somewhat,space,stalked,staminate,stellate-glandular,striped,subsagittate,tall,testa,tiny,tip,ud,unevenly,unit,upper,velutinous,villous,viscid,viscid-tomentose,woolly,ympodial,young,½	colour,form,height,inflorescence,leaf,number,papillose,position,presence,present,seed,shape,size,texture
205	wfo-0001027237	success	122	89	53	69	36	0.434	0.5-1,1-1.2,1.5-2,1.5-2.5,2-3,3-3.5,3-4,6-11,6-8,8,anther,base,black,broadly,brown,calyx,clavate,cm,corolla,cup-shaped,dark,deltoid,flattened,glabrous,globose,green,greenish-white,inflorescence,internodal,leaf,lobe,lobed,margin,minutely,mm,ovary,paler,pedicel,pitted,regularly,reniform,shaped,shrub,small,stem,stigma,style,surface,tear-drop,tree,tube,white,x	.5,/4,30-100-flowered,5,anthesi,apart,apiculae,apiculate,appearing,ba,bark,berry,blac,branc,branched,completely,cucullate,deflexed,dia,difoliate,drying,edicel,eed,ellipsoid,erect,exsertion,filament,free,fruiting,geminate,greyi,later,long,lower,many,nflorescence,occasionally,older,papillate,papillo,papillose,part,plurifoliat,pore,poricidal,portion,reflexed,regulary,ruit,scar,shining,slender,spaced,straight,tall,tapering,terminal,time,tip,ud,unit,upper,usually,way,widely,woody,x.,ympodial,young	0.5,adhesion,apex,arrangement,blade,climate,colour,diameter,form,fruit,glandular,growth,hair,height,history,length,life,midpoint,na,number,peduncle,petiole,plant,position,presence,pubescence,ray,reproduction,rugulose,seed,shape,size,staman,stellate,stipe,texture
206	wfo-0001027238	success	204	129	98	106	31	0.48	.3,0-1,0-1.5,0.3-0.5,0.3-0.8,0.3-1,0.3-5,0.5-1,0.5-16,1-1.5,1.5-3,1.5-4,15-30,2-4,3-4,3-6,4-10,5-15,abaxially,acuminate,acute,adaxially,anther,apex,base,black,blade,brown,calyx,chartaceous,cm,connivent,cuneate,deltate,densely,diameter,elliptic,elliptic-ovate,entire,equal,extra-axillary,flattened,flower,foliaceous,fruit,glabrescent,glabrous,globose,hair,lavender,leaf,light,like,lobe,margin,membranaceous,midpoint,mm,multangulate,near,oblique,oblong,obtuse,outline,pale,pedicel,peduncle,petiole,porrect-stellate,pubescent,purple,ray,reniform,ripe,rounded,shiny,shrub,simple,small,sometimes,sparsely,stellate,stellate-pubescent,stem,stigma,strongly,style,surface,tip,toward,tree,tube,unequal,white,whitish,x,yellow,yellowish	-25,-5,.5,0-0.7,0.5-2,1-2,1.5-7,10,2-3,3-5,4-,4-16,4-5,4-8,5-7,5-merou,6-15,6-8,accrescent,adaxiall,ag,alyx,apparently,articulated,axe,ba,berry,branch,capitat,contiguous,covering,cylindrical,dark,differentiated,directed,discolorous,distally,eaf,eed,filament,fleshy,fork,free,frui,fruiting,geminate,gland,gland-tipped,green,greenish,growt,homostylous,interpetalar,introrsely,juic,large,lighter,long,longitudinal,lower,major,minor,minutely,mixed,narrowly,nearly,new,nflorescence,often,one,opening,orolla,paired,part,perfect,pericarp,pitted,plurifoliate,pore,rachi,ruit,scandent,sessile,short-stalked,side,similar,slit,somewhat,sparse,sprawling,ste,straight,subtending,tamen,tem,time,tissue,triangular,unarme,unbranched,unit,vary,vein,wide,without,ympodial	adhesion,arrangement,capitate,climate,colour,corolla,form,glandular,growth,height,history,inflorescence,length,life,na,number,ovary,perennial,plant,position,presence,present,pubescence,reproduction,rugulose,seed,shape,size,staman,stipe,texture
207	wfo-0001027242	success	238	117	90	148	27	0.378	0-0.7,0.15-0.25,0.25-0.5,0.3-0.5,0.3-1.1,0.6-3,0.7-1.2,1-1.5,1-2.5,1.5,1.5-2,1.5-3,1.9-5,2.5-3,2.8-3.7,4-5.5,4.5-11,5.5-7,6-21,7-8,abaxially,absent,acute,adaxially,anther,apex,base,blade,calyx,chartaceous,cm,cuneate,deltate,densely,diameter,entire,extra-axillary,flattened,fruit,glabrous,gland-tipped,globose,hair,inflorescence,leaf,length,light,lobe,lobed,margin,midpoint,minutely,mm,moderately,narrowly,nearly,orange,ovate,pale,pedicel,peduncle,perennial,petiole,pink,plant,present,purple,ray,red,reticulate,rhizomatous,rostrate,shallowly,short,shrub,simple,smooth,sparsely,stellate,stellate-pubescent,stigma,style,subcoriaceous,surface,toward,tube,white,whitish,x,yellow	%,.05,.2,0-1.5,0-15,0-20,0-5,0.2-0.7,0.2-1,0.5-1,0.6-0.9,1-1.2,1-2,1-locular,10-22,12-16,15-25,2,2-2.9,2-3,3-12,3-4.5,3-6,3-7,3.5-4.5,4-30,4-7,4.5-10.5,5-merou,6-14,6-7,6-8,8-15,9-11,absen,accrescent,acicular,across,adult,alyx,andromonoecious,apart,apparen,articulated,axe,ba,bract-like,branch,branche,capitat,confined,connivent,contiguous,cylindrical,directed,distall,dm,eaf,eed,erect,exocarp,filament,finger,flower,forked,fruiting,geminate,green,half,heterostylous,incomplete,index,interpetalar,juicy,juvenile,lamina,lateral,less,lobing,long,longer,loosely,lower,mature,mesocarp,mid-point,midrib,midvein,minute,mixed,much,nflorescence,oblique,obtuse,occasionally,often,one,orolla,pair,part,per,perfect,placenta,plurifoliate,pore,porrect,prickle,pseudo-racemose,pseudo-umbellate,rachi,rooting,rounde,ruit,septum,sessile,side,slightly,smaller,spaced,sparse,sprawling,stellae,straight,strongly,succulent,tall,tamen,tapered,tem,thick,throughout,time,tip,tissu,tissue,triangular,unarme,unarmed,unbranched,unit,upper,usually,vary,vein,weakly,wide,yellowish,ympodial	adhesion,arrangement,capitate,climate,colour,corolla,form,glandular,growth,height,history,life,na,number,ovary,position,presence,pubescence,reproduction,rugulose,seed,shape,size,staman,stem,stipe,texture
208	wfo-0001027244	success	294	129	102	192	27	0.347	-12,-2,-3.2,.5,0.05,0.2-1,0.3-0.6,0.45-0.6,0.5,0.5-0.8,0.7-1.5,0.9-1.3,1,1.1-1.3,1.2-1.6,1.5-2.4,1.5-6.5,1.7-3.0,2.1-8,3.5-13,4-12,7-12,acute,anther,apex,base,bifurcate,branched,broadly,brown,calyx,capitate,cell,cm,cordate,corolla,crenate,curved,dark,deltate,densely,dentate,diameter,elliptic,fruit,glabrous,glandular,globose,green,greenish,hair-like,herb,imparipinnate,inflorescence,interrupted,irregularly,lanceolate,lateral,length,lobe,lobed,long,margin,minute,mm,narrowly,obovate,often,orbicular,outgrowth,ovary,pedicel,peduncle,perennial,petiole,present,pubescent,purple,rotate-stellate,rounded,simple,size,slender,sparsely,stem,stigma,stripe,strongly,style,testa,thick,trichome,truncate,tube,uniseriate,velvety,vivid,wall,white,wide,woody,yellow	-1.2,0-,0.02-,0.04-,0.05-1,0.07-0.15,0.1-,0.1-0.3,0.1-0.5,0.1-0.6,0.15-0.2,0.2,0.2-,0.25-0.4,0.3,0.3-0.4,0.3-0.5,0.3-0.8,0.4-,0.4-0.6,0.4-1,0.5-1,0.6-0.9,0.6-09,0.7-1,0.7-2,0.7-3,0.8-1.2,0.9-1.7,1-2-celled,1-2.5,1-3.5,1-celled,1.5-2,1.5-2.1,1/2,2-,2-4,2-4-celled,2-9,2-foliate,2-locular,3-5,3/4,4-celled,5-,5-10,5-9-celled,8-16,8-celled,abaxially,absent,abundance,abundant,acroscopically,acuminate,adaxially,adpressed,alfway,along,also,always,amongst,angled,anthesi,apical,apparently,appearance,appendage,arequipa,around,articulated,articulatio,articulation,axi,basal,berr,berry,bract,bracteate,c.,cage,column,common,conical,deciduous,decumbent,decurrent,deeper,dense,density,developed,diamete,distal,eaf,edicel,eed,eglandular,either,elliptical,erect,exserted,extremely,filament,flower,flushed,forming,fruiting,general,giving,glabrescent,gland,gree,half,halfway,head,hyaline,interjected,internode,investing,lamina,larger,largest,leaflet,leave,like,lobing,lon,longer,lower,middle,midvein,mixed,mixture,multicellular,near,node,oblique,occasionally,onto,pair,papillate-pubescent,patent,petiolule,population,primary,pseudostipule,rachi,reflexed,rest,ripe,ruit,scattered,secondary,sessile,shaggy,short,shorter,silky,sinus,small,sometimes,somewhat,sparse,sparser,spreading,staminal,sterile,stout,straight,surface,tall,tem,terminal,tertiary,tiny,tip,tipped,toward,two,ud,undulate,unicellular,unit,united,upper,usually,variable,variety,vein,winged,ympodial	adhesion,arrangement,blade,climate,colour,form,growth,hair,height,history,leaf,life,midpoint,na,number,plant,position,presence,pubescence,ray,reproduction,seed,shape,staman,stellate,stipe,texture
209	wfo-0001027248	success	158	105	78	80	27	0.494	.5,0.5-1,0.5-2.5,0.7-1.2,1-1.5,1-2,1-3,1-5,3-4,3-7,3.5-4,5-5.5,6-13,6.5-8,abaxially,adaxially,anther,arachnoid,arachnoid-pubescent,area,base,beige,broadened,broadly,brown,calyx,cm,conical,corolla,dark,deltate,densely,dia,difoliate,dirty,elliptic,fruit,geminate,glabrous,globose,green,leaf,lobe,lobed,long,merely,minutely,mm,nearly,occasionally,opposite,ovary,ovoid-reniform,pale,patch,pedicel,petiole,pitted,poricidal,pubescence,pubescent,scattered,shrub,size,small,sparsely,stem,stigma,style,surface,tip,top,tree,trichome,tube,unifoliate,white,wide	0,2-2.5,2-4.5,3-7-flowered,4-8,7-9,abaxial,acute,along,anthesi,ape,apex,appearing,arachnoid-pubescen,bark,beneath,berry,brownish,brownish-gra,closely,deflexed,denser,differing,eaf,edicel,eed,ellipsoid,erect,exserted,felty,filament,fleshy,free,fruiting,glabrescent,grayish-green,impressed,lamina,later,lateral,lightly,lower,main,major,margin,minor,nflorescence,node,older,overlappin,pair,papillo,papillose,per,planar,pore,portion,present,ruit,scar,shaped,shoot,simple,somewhat,soon,spaced,specimen,strongly,tall,tear-drop,thick,tub,ud,unit,vein,wid,winged,woody,ympodial,young	adhesion,arrangement,brownish-gray,colour,diameter,form,growth,height,history,inflorescence,length,life,na,number,peduncle,perennial,plant,position,presence,ray,reproduction,rugulose,seed,shape,staman,stellate,texture
210	wfo-0001027258	success	178	111	83	95	28	0.466	/4,0.25-0.5,0.6-2,0.9-1.3,1-2.3,1.5-1.6,2-2.5,3-4,3-6,3.5-4,4-5,4.5-5,6-8,7-13,abaxially,adaxially,age,along,anther,apical,base,broadly,calyx,capitate,cm,corolla,decurrent,deltate,densely,dia,elliptic,entire,flattened-reniform,fruit,glabrous,globose,green,greenish-yellow,internodal,leaf,length,lengthening,lobe,lobed,margin,minutely,mm,occasionally,opposite,ovary,ovate,pale,papillose,pedicel,petiole,pitted,pore,poricidal,projection,prominent,pubescent,shrub,simple,size,slit,small,sparsely,stem,stigma,style,surface,tip,treelet,trichome,tube,tuft,uniseriate,urceolate,way,white,winged,x,yellowish-tan	.25,.5,0.5-1,1-1.5,1-4,1.2-2,2.5-8,5-10-flowered,7-9,abruptly,acuminate,acute,anthesi,apar,apex,apiculae,attenuate,axil,ba,bark,beneath,berry,crystal,darker,deflexed,dense,deposit,differing,difoliate,dissecting,drying,eaf,edicel,eed,ellipsoid,enlarge,evenly,exserted,extending,fide,filament,fragrant,free,fruiting,geminat,glabrou,incrassate,lamina,large,lateral,lenticel,long,lower,main,major,microscope,middle,minor,minute,nee,nflorescence,often,older,onto,pair,papillo,planar,portion,red-papillose,reddish,ruit,sand,scar,scattered,slender,slightly,spaced,speck,straight,strongly,sweetly,swollen,tall,tiny,tub,ud,unit,vein,visible,widening,widest,woody,yellowish,ympodial,young	0.25,adhesion,alternate,arrangement,colour,diameter,form,growth,height,history,inflorescence,life,na,number,peduncle,perennial,plant,position,presence,pubescence,ray,reproduction,rugulose,seed,shape,staman,stellate,texture
211	wfo-0001027260	success	176	118	83	93	35	0.472	0.25-1,0.5-3,0.5-6.5,0.8-2,1-3,1-6,1-7,1.5-13,1.5-2,10-25,2-10,2-18,2-2.5,2.5-3.5,3-4.5,3-6,3.5-25,4-32,6-20,abaxially,acuminate,acute,adaxially,age,also,apex,basal,base,blade,chartaceous,clavate,cm,cordate,darker,densely,diameter,ellipsoidal,elliptic,elliptic-ovate,entire,fading,flattened,fruit,glabrate,glabrous,globose,greenish,hair,lanceolate,lavender,lobe,longitudinal,margin,mm,moderately,often,ovate,pedicel,peduncle,petiole,pilose,pink,puberulent,puberulent-pubescent,pubescent,purple,shrub,simple,small,sparsely,stellate,stigma,stripe,style,subcoriaceous,tree,truncate,tube,white,x,yellow,yellow-green,yellowish	-17,-2,-60,-7,0.5-1,0.75-1,1-,1-2,1-4,15-30,2-,2.5-14,3-,3-10,3-11,4-25,4-5-foliat,4-6,4.5-14,5-,5-25,5-40,5-merous,absent,acute-,aggregate,alyx,apart,ape,articulated,axe,berry,beyond,branched,cell,connective,connivent,cylindrical,diamete,directed,distally,eaf,eed,eglandular,equal,exceeding,exserted,flower,leaving,lon,long,lower,membranaceous,narrowly,nearly,nflorescence,nther,obtuse,orolla,pedicellar,perfec,perfect,pilo,pore,presen,puberulent-pubescen,pubescent-pilose,rachi,radiu,remnant,ruit,shorter,slightly,spaced,stamen,stone,strongly,tal,tapered,tem,thecae,time,tomento,triangular,ud,unbranched,unit,usually,vary,vein,wide,yellow-orang,ympodial	adhesion,anther,arrangement,calyx,climate,colour,corolla,form,glandular,growth,height,history,inflorescence,leaf,length,life,midpoint,na,number,ovary,plant,position,presence,pubescence,ray,reproduction,rugulose,seed,shape,size,staman,stem,stipe,surface,texture
212	wfo-0001027265	success	159	91	55	104	36	0.346	0.2-0.4,0.5-1,1.2-2,2,2-3,2/3,abaxially,acute,anther,apex,calyx,chartaceous,cm,diameter,entire,extra-axillary,flattened-reniform,fruit,glabrous,globose,herb,hermaphroditic,leaf-opposed,light,lobe,lower,margin,minutely,mm,nearly,oblong,orange,ovate-lanceolate,pedicel,peduncle,petiole,pitted,puberulent,pubescent,purple,red,rotate-stellate,seed,sparsely,stigma,style,subcoriaceous,surface,tip,triangular,tube,white,white-puberulent,x,yellow	-2.5,.2,.3,.5,0.1–2,0.5,0.5–0.6,1-1.3,1-2.5,1-3,1.2-1.3,1.2–1.4,1.5-2.5,1.5–1.8,1.5–2,1.5–4,2-,2-4,20-30,2–2.5,2–3,3-,3-lobed,30–50,4-5,4.5–8,4–6,4–7-branched,5-merou,58409,accrescent,adaxiall,adaxially,alyx,apart,apparently,articulated,axe,ba,base,berry,blade,broad,capitat,ciliate,connivent,covering,croat,cylindrical,dehiscent,eaf,eed,erect,filament,flower,foliate,frui,fruiting,geminat,granule,hair,juic,larger,lon,long,long-attenuate,longitudinall,low,mesocarp,near,nflorescence,node,numerous,obtuse,orolla,paired,partially,pore,present,prominent,rachi,rarely,recurved,ripe,rooting,ruit,scarcely,sclerotic,simple,slightly,sometimes,somewhat,spaced,tall,tamen,tem,time,unit,usually,vary,weak,wide,winged,ympodial	0.1-2,0.5-0.6,1.2-1.4,1.5-1.8,1.5-4,2-2.5,30-50,4-6,4.5-8,abaxial,adaxial,adhesion,capitate,colour,corolla,form,growth,height,history,inflorescence,leaf,length,life,na,ovary,perennial,plant,position,pubescence,reproduction,rugulose,shape,size,staman,stem,texture
213	wfo-0001027265	success	156	95	58	98	37	0.372	0.2-0.4,0.5-1,1.2-2,2,2-3,2/3,abaxially,acute,anther,apex,base,calyx,chartaceous,cm,diameter,entire,extra-axillary,flattened-reniform,fruit,glabrous,globose,herb,hermaphroditic,leaf-opposed,light,lobe,lower,margin,minutely,mm,nearly,oblong,orange,ovate-lanceolate,pedicel,peduncle,petiole,pitted,puberulent,pubescent,purple,rachi,recurved,red,rotate-stellate,seed,sparsely,stigma,style,subcoriaceous,surface,tip,triangular,tube,white,white-puberulent,x,yellow	-2.5,.2,.3,.5,0.1–2,0.5,0.5–0.6,1-1.3,1-2.5,1-3,1.2-1.3,1.2–1.4,1.5-2.5,1.5–1.8,1.5–2,1.5–4,2-,2-4,20-30,2–2.5,2–3,3-,3-lobed,30–50,4-5,4.5–8,4–6,4–7-branched,5-merou,58409,accrescent,adaxiall,adaxially,alyx,apart,apparently,articulated,axe,ba,blade,broad,capitat,ciliate,connivent,covering,croat,cylindrical,dehiscent,eaf,eed,erect,filament,flower,foliate,frui,fruiting,geminat,granule,hair,juic,larger,lon,long,long-attenuate,longitudinall,low,mesocarp,near,nflorescence,node,numerous,obtuse,orolla,paired,partially,pore,prominent,rarely,ripe,rooting,ruit,scarcely,sclerotic,simple,slightly,sometimes,somewhat,spaced,tall,tamen,tem,time,unit,vary,weak,wide,winged,ympodial	0.1-2,0.5-0.6,1.2-1.4,1.5-1.8,1.5-2,1.5-4,2-2.5,30-50,4-6,4.5-8,abaxial,adaxial,adhesion,capitate,colour,corolla,form,growth,height,history,inflorescence,leaf,length,life,na,ovary,perennial,plant,position,pubescence,reproduction,rugulose,shape,size,staman,stem,texture
214	wfo-0001027276	success	219	119	79	140	40	0.361	-22,.5,1,1.5,10,2,6,7,80,acute,alternate,anther,apex,armed,base,bifid,black-green,brown,calyx,clonal,cm,cone,conspicuously,corolla,dense,diameter,drying,entire,fruit,glabrous,globular,gray-green,green,growth,indumentum,inflorescence,lanceolate,least,length,linear,lobe,lobed,long,loose,margin,minutely,mm,new,oblong-lanceolate,ovary,pedicel,petiole,plant,prickle,prickly,purple,rarely,reticulate,scabrous,short,slightly,small,somewhat,sparsely,staman,stellate,stellate-funnelform,stem,stigma,style,subshrub,surface,tapered,tapering,trichome,unequal,wavy,yellow-green,×	0,0.5,0.5–1,1.2–1.5,1.5–2,1–1.5,1–2,2–5,2–6,4–5,4–9,5,5-merous,5–10,5–12mm,5–7,9–12,absent,acuman,acumen,ale,along,alyx,anthesi,apparently,around,aspect,ba,becoming,beneath,berry,beyond,boht,borne,branche,broadly,c.,caly,central,covered,cyme,dark,densely,detaching,different,dioeciou,drop,eaf,eduncle,eed,ending,erect,even,eventually,except,expanding,exserted,extending,falling,female,filament,filiform,fine,flower,following,functionally,fused,gra,growt,hermaphrodite,inaperturate,including,ingle,largest,lighter,lon,lower,mostly,mout,near,newer,next,older,open,opening,orphologically,petal,plurifoliat,pollen,poricidal,porrect-stellate,producing,proportion,ra,red-tinged,remaining,resprout,retained,rickle,rotate,ruit,ruiting,scarcely-rooted,scattered,seaso,shed,shor,side,slender,solitary,splitting,stalked,stamen,staminate,stellate-pubescent,stigmatic,stolon,straight,successively,surrounding,suture,taminate,tem,tending,throughout,time,tip,toward,type,unarme,underground,unit,verall,vestigial,wide,widened,without,woody,ympodial,–	-,1-1.5,1.2-1.5,1.5-2,2-5,4-5,4-9,5-10,5-7,adhesion,arrangement,blade,climate,colour,dioecious,form,glandular,hair,height,history,leaf,life,midpoint,na,number,peduncle,position,presence,present,pubescence,ray,reproduction,rugulose,seed,shape,size,stipe,texture,tube,unarmed
215	wfo-0001027284	success	172	120	86	86	34	0.5	.3,0.1–0.5,0.7–0.9,0.7–1,1.2–1.5,1.5–2,1.5–2.5,1.5–8,1.8–2,1–3,2.5–3,2–2.2,3.5–14,3–4,4,4–12,4–6,9–18,abaxially,acuminate,acute,adaxially,anther,apex,axillary,base,blade,brownish,calyx,cm,cordate,deltoid,diameter,elliptic,entire,extra-axillary,fine,flattened-reniform,flower,fruit,glabrous,globose,green,inflorescence,lobe,long,margin,maturity,midvein,minutely,mm,near,nearly,oblique,orangish,ovate,ovoid,pale,pedicel,peduncle,petiole,pubescence,pubescent,rarely,reticulate-rugulose,rounded,scandent,shortly,shrub,simple,size,sometimes,soon,sparsely,stellate,stem-terminal,stigma,style,surface,tan,tip,truncate,tube,vine,white,x	0.1–2,0.2–,1.5–5.5,1–1.5,1–2,2.5–3.5,2–16,5-merous,5–7,5–8,accrescent,alyx,anthesi,axe,berry,branch,branched,c.,capitat,ciliat,climbing,conspicuous,contiguousl,cylindrical,deflected,densely,distally,eaf,eed,enlarged,filament,flattened,fleshy,fruiting,glabrescen,glabrou,gradually,herbaceous,immature,leafy,lower,m.,nflorescence,nternode,one,orolla,pair,pendulou,perfec,pink,pinnate,planar,plurifoliate,pointed,prominent,rachi,reduced,ruit,sand-punctat,sand-punctate,scar,secondary,seen,side,slightly,somewhat,spaced,spreading,tamen,tem,thickened,thickly,time,toward,tree,unbranched,understory,unifoliat,unit,vary,vein,venation,weakly,wide,woody,ympodial	0.2–1.5,adhesion,arrangement,capitate,climate,colour,corolla,form,glabrescent,glandular,growth,hair,height,history,leaf,length,life,midpoint,na,number,ovary,perfect,plant,position,presence,ray,reproduction,rugulose,seed,shape,staman,stem,stipe,texture
216	wfo-0001027289	success	194	103	76	118	27	0.392	0-0.7,0.25-0.7,0.3-1,0.5-0.7,0.5-1.4,0.8-2.6,1.1-1.5,1.4-1.8,1.5-3.5,10.5-12.5,2.5-2.8,3.5-5,3.5-7.5,4-11,4-7,5.5-7.5,6-8,6-9,absent,acute,adaxially,anther,apex,base,black,blade,broadly,brown,calyx,chartaceous,cm,connivent,cordate,deltate,densely,diameter,eglandular,entire,fruit,glabrous,globose,green,grey,hair,inflorescence,lanceolate,leaf-opposed,length,lobe,lobed,margin,midpoint,mm,obtuse,ovate,pedicel,peduncle,perennial,petiole,pink,plant,present,purple,ray,rhizomatous,rusty,shallowly,shrub,simple,stellate,stellate-pubescent,style,tube,x,yellow,yellowish-green	%,.05,0-1,0-3,0.05-0.1,0.3-0.9,0.4-0.8,1,1-2,1-5,1.2-2.5,1.3-1.5,1.5-2,1.5-2.3,10-16,12-17,16-35,2-foliate,2.4-3,30-160,4-locular,5-merou,7-10,7-13,7-8,abaxially,absen,accrescent,acicular,across,adaxiall,alyx,andromonoecious,apart,articulated,ascending,axe,ba,bark,circular,cork,cross-section,cylindrical,directed,distall,distally,distributed,dm,eaf,eed,elliptica,erect,exocarp,finger,flower,fruiting,functional,furrowed,geminate,glabrou,gland-tipped,half,heterostylous,juicy,lamina,lateral,less,long,longer,lower,markedly,mature,mesocarp,mid-point,minute,moist,nflorescence,oblique,orolla,part,per,placenta,pore,porrect,prickle,probably,pseudo-racemose,ruit,short,solitary,spaced,stage,stalk,stalked,stellae,straight,strongly,tal,tamen,tem,thick,thicker,thicknes,throughout,time,transparent,unarme,unarmed,unbranched,unit,unknow,uvenile,vary,weakly,white,wide,yellowish,ympodial	adhesion,arrangement,climate,colour,corolla,form,glandular,growth,height,history,leaf,life,na,number,ovary,position,presence,pubescence,reproduction,seed,shape,size,staman,stem,stigma,stipe,texture
217	wfo-0001027290	success	165	103	71	94	32	0.43	.8,0-2.5,0.1-0.9,0.3-0.5,0.8-1.2,0.9-1.2,1.1-4.4,1.4-1.6,1.5-2,2.8-5.5,3.5-5,4-6,5-9.5,6-8,7-8,absent,adaxially,anther,apex,attenuate,base,blade,broadly,calyx,chartaceous,cm,cordate,densely,diameter,entire,erect,extra-axillary,flower,fruit,glabrous,gland-tipped,globose,green,grey-green,hair,inflorescence,length,lobe,lobed,margin,midpoint,mm,moist,obtuse,ovate,pedicel,peduncle,perennial,petiole,present,purple,ray,rhizomatous,rusty,shallowly,short,shrub,simple,sparsely,stellate-pubescent,style,tube,unknown,x,yellow,yellowish-green	%,0-0.7,0-1,0-3,0.05-0.25,0.2-0.4,0.7-0.9,0.7-1.2,1-1.7,1-2,1-5,1.5-1.8,1.6-1.8,11-15,180-420,2-11,2-6,20-45,3-35,3-5,3-6,5-20,5-merou,50-70,8-10,8-9,abaxially,acicular,across,adaxiall,alyx,apart,armed,articulated,ascending,axe,ba,cylindrical,d.,directed,distall,distributed,eaf,eed,eglandular,finger,fruiting,functional,half,juic,lamina,lateral,lon,long,longer,lower,mature,mesocarp,mid-point,midvein,minute,nflorescence,oblique,onl,orolla,part,per,pore,porrect,presen,prickle,pseudo-racemose,ruit,spaced,stage,stalk,stellae,straight,tal,tamen,tem,thick,throughout,time,unbranched,unit,unknow,uvenile,vary,vein,white,wide,yellowish,ympodial	adhesion,arrangement,climate,colour,corolla,form,glandular,growth,height,history,juicy,leaf,life,na,number,ovary,plant,position,presence,pubescence,reproduction,rugulose,seed,shape,size,staman,stellate,stem,stigma,stipe,surface,texture
218	wfo-0001027299	success	237	139	91	146	48	0.384	2.7,5.2,abaxially,acuminate,anther,apex,asymmetric,base,becoming,blade,calyx,campanulate,cm,composed,cordate,deltoid,densely,diameter,distally,elongating,entire,erect,expanded,flower,fruit,glabrous,globose,hair,hirsute,inflorescence,initially,intense,interwoven,lanceolate,lateral,leaf,length,lenticular,linear,lobe,long,margin,minutely,mm,narrowly,obtuse,orange,ovate,overtopped,pedicel,peduncle,pentagonal,petiole,pitted,plump,pubescence,pubescent,purplish,ray,reniform,repand,rotate,short-stalked,shrub,similar,simple,slightly,somewhat,soon,stalked,stellae,stellate,stellate-pubescent,stellate-tomentose,stem,stigma,style,sun,surface,tan,terminal,thick-textured,truncate,tube,undulate,usually,violet,weakly,yellow,young,×	.5,0.2–3,0.3–0.8,0.5–1.5,0.8–1,0.8–1.2,0–10,1.2–1.5,1.3–1.7,1.5,1.5–3,1.5–4,11–17,15,15–19,1–2,1–3.5,1–4,2.5–4,2.5–5,25-30,2–13,2–2.7,3–3.5,4.5–13,4–10,5,5-merou,5–10,5–12,6,6–10,6–8,6–9,7–11,7–9,8–13,8–20,9–25,abaxial,accrescent,acicular,adaxially,along,alyx,apart,apiculate,apparently,appearing,articulated,ascending,axe,barely,branch,branched,bristle,bristle-like,broadly,c.,cauline,common,conduplicate,contiguous,coriaceous,deciduou,delicate,deltate,dense,densest,developed,directed,distall,eaf,eed,equalling,erry,exceeding,falcate,filament,filiform,fruiting,geminat,glabrou,intergrading,internode,intervening,like,long-stalked,lower,maturit,midpoint,midvein,midzone,mixed,nearly,nflorescence,often,one,orolla,ovoid,perfect,plurifoliate,pore,prickle,prickly,principal,racemose,rachise,rarely,reaching,ripe,secondary,short,shorter,side,slender,smaller,sometimes,some­what,spaced,sparse,spreading,spreadingly,stalk,stipitate-stellate,straight,styl,tall,tamen,tapering,tardily,tem,tippe,ud,ultimate,unarme,unarmed,vary,varying,vein,well,wooll,woolly,ympodia,–7,–9	0-10,0.5-1.5,1-2,1.2-1.5,1.3-1.7,1.5-3,1.5-4,11-17,2-2.7,2.5-4,2.5-5,3-3.5,4.5-13,5-10,5-12,6-8,7-11,7-9,8-20,9,9-25,adhesion,arrangement,colour,corolla,form,glandular,growth,height,history,life,maturity,na,number,ovary,perennial,plant,position,presence,present,reproduction,rugulose,seed,shape,size,staman,stipe,texture
219	wfo-0001027302	success	188	137	105	83	32	0.559	.5,0.4-5,0.5-1,0.6-1,0.8-1,1-1.3,1-1.5,1-3,1.2-2.5,1.5-2,10,2,2-3,2-6,2.2,2.7-7.5,3.5-5,3/4,7,7/8,abaxially,acuminate,acute,age,along,anther,apex,appearing,base,becoming,blade,branching,bright,brownish-yellow,calyx,capitate,clavate,cm,conical,cordate,corolla,crispate,deltoid,dendritic,densely,diameter,elliptic,entire,flattened,free,glabrous,globose,growth,later,lateral,leaf,length,lenticular,lobe,lobed,long-triangular,main,margin,minutely,mm,monochasial,narrowly,occasionally,ovary,ovate,pale,pericarp,petiole,pitted,plant,plurifoliate,pore,poridical,puberulent,pubescent,red,reddish-brown,scattered,shrub,simple,slit-like,small,somewhat,stem,stigma,style,surface,terminal,thin,tiny,tip,tree,trichome,truncate,tube,undulate,vein,violet,way,x	0.5,1,1-2,1.2-1.6,10-20,5-7,6-12,abaxial,adaxial,adaxially,anthesi,apical,ba,bark,basal,berry,broader,cultivation,decurrent,deflexed,denser,dichasia,discussion,eaf,edicel,eed,especially,ew,exserted,filament,fine,flat-topped,flower,fruiting,growing,inserted,juvenile,larger,lax,less,like,lon,long,lower,m.,nflorescence,nodding,older,otherwise,overtopping,pair,papillo,pedicle,per,planar,portion,prominent,pyramidal,reflexed,ruit,scar,scrambling,secondary,see,shade,shin,shoot,sleeve,sparsely,stamen,strongly,tall,tapering,time,tub,ud,unit,usually,wide,winged,woody,ympodial,young	adhesion,arrangement,climate,colour,dichasial,form,fruit,glandular,hair,height,history,inflorescence,life,midpoint,na,number,pedicel,peduncle,perennial,position,presence,pubescence,ray,reproduction,rugulose,seed,shape,size,staman,stellate,stipe,texture
220	wfo-0001027310	success	215	125	95	120	30	0.442	-2.2,-20,/3,0.05-0.15,0.7-2,0.9-0.17,1-1.2,1-1.7,1-6,1.1-1.5,11-16,2-3.1,2-4,2.2-2.5,2.8-3,20-60,4-9,4.5-5.5,5-7,9-13,abaxially,acute,andromonoecious,anther,apex,apically,base,berry,blade,calyx,chartaceous,cm,connivent,cuneate,dark,deltate,densely,diameter,entire,equal,erect,evenly,flattened-reniform,fruit,glabrous,glaucous,green,hair,lanceolate,lateral,leaf,length,lobe,lobed,long,margin,maturity,mauve,midpoint,minutely,mm,moderately,orange-brown,pedicel,peduncle,petiole,pitted,plant,poricidal,purple,ray,red,rounded,shallowly,shrub,simple,sometimes,sparse,spherical,stellate,stellate-pubescent,stem,style,surface,tapering,terminal,tip,toward,tree,truncate,tube,way,wide,yellow,young	.8,0,0-20,0-5,0.05,0.1,0.1-0.2,0.15-0.3,0.6-1,1.5-2.2,1.5-5,1/10-1/6,1/3-1/2,1/3-3/4,2-10,2-5,2/3,22-30,3-15,4-10,4.5-7,5-10,5-20,5-merous,6-8,7-10,8-10,abaxial,acut,adaxial,alyx,apar,apart,apparently,articulated,bark,branched,branching,broadly,curved,discolorous,distal,drying,eaf,eed,elongating,faint,filament,flattened,flower,foliaceous,free,fruiting,fused,gently,glabrescent,glabrou,gray,green-brown,hermaphrodite,heterostylous,inflated,infructescence,less,long-styled,longer,lower,lowermost,mature,nflorescence,older,one,open,orolla,oung,pair,pale,pendulous,per,pericarp,plurifoliat,porrect,porrect-lepidote,portion,prickle,prickly,primary,pubescent,reddi,reflexed,ruit,scar,secondary,sessile,short-styled,shorter,smooth,spaced,sparsely,spreading,stalk,stalked,staminat,stout,straight,strongly,tamen,terete,tertiary,time,trichome,unarme,unarmed,unit,vary,vein,venation,visible,woody,ympodial	adhesion,arrangement,climate,colour,corolla,form,glandular,growth,height,history,inflorescence,life,na,number,ovary,perennial,plurifoliate,position,presence,present,pubescence,reproduction,rugulose,seed,shape,size,staman,stigma,stipe,texture
221	wfo-0001027313	success	173	110	68	105	42	0.393	.7,0.15,1.5,4,5,abaxially,adaxially,anther,attenuate,base,cm,dbh,densely,diameter,dull,flower,fruit,glabrous,globose,hair,half,high,interpetalar,lanceolate,lateral,leaf,little,lobe,long,loosely,lower,minutely,mm,ovate,pedicel,peduncle,persistently,petiole,pitted,purplish,ray,shrub,simple,slender,small,sparse,stellate,stellate-pubescent,stellate-tomentose,stem,stigma,style,surface,thick-chartaceous,tissue,tomentose,tree,triangular,tube,unarmed,violet,weak,whitish,whitish-tomentose,yellow,yellowish,×,–12	.5,0.1–0.3,0.5–0.6,0.8–1,1.2–1.3,1.2–1.4,1.5–2,1–1.3,1–2,1–4,2–3-branched,2–4.5,2–8.5,3–3.5,3–4,3–5.5,3–9,4.5–5,5-merou,5.5–16,5.5–7,50,5–6,6–11,6–8,acute,adaxiall,along,alyx,apar,apex,apical,apparently,articulated,atenuate,axe,blade,branch,branched,broadbased,capitat,cordate,difoliate,directed,distall,eaf,eed,entire,filament,filiform,finely,geminat,green,homostylous,immature,internode,irregularly,like,lon,margin,maturing,midpoint,midvein,minute,much,narrowly,nearly,nflorescence,obtuse,orolla,ovoid,perfect,pore,porrect,prickle,principal,rarely,ruit,scar,sessile-stellate,short-stalked,short-stipitate,shorter,side,similar,sinuate,sinus,sometimes,splitting,stalk,stellae,stellate-tomento,tamen,tem,time,ud,unarme,undulate,usually,vary,vein,vigorous,wide,ympodia,–3	0.5-0.6,1-1.3,1-2,1-4,1.2-1.3,1.2-1.4,2,3-5.5,3-9,4.5-5,5.5-16,5.5-7,6-11,6-8,adhesion,arrangement,calyx,capitate,colour,corolla,form,growth,height,history,inflorescence,length,life,na,number,ovary,plant,position,presence,pubescence,reproduction,rugulose,seed,shape,size,staman,texture,ye
222	wfo-0001027315	success	217	102	72	145	30	0.332	0.15-0.2,0.2-0.5,0.3-0.6,0.3-1,0.4-0.7,0.5,0.6-0.8,1.3-3,10-20,2,2-2.5,2-5,2-7.5,3,acute,anther,apex,base,blue-green,brown,calyx,capitate,cm,conical,corolla,deltate,densely,diameter,dioecious,echinoid,elliptic,entire,flattened,glabrous,globose,growth,inflorescence,internodal,length,lobe,margin,midpoint,minutely,mm,ovary,paler,pedicel,peduncle,petiole,pitted,plant,poricidal,present,pubescent,purple,ray,reddish,reniform,ripe,shiny,shrub,simple,stellate,stem,stigma,style,surface,thin,tube,white,x,young	.15,.5,.5x,.9,0.2,0.25-0.4,0.3-0.5,0.6-0.6,0.6-0.7,0365,1-1.3,1-1.5,1-2,1.5-1.7,1.5-2,1.5-3,2/3,3-3.5,3-5,3-7,5-7,8,<,?,abaxially,adaxially,age,almost,along,anthesi,arching,armed,articulated,bark,berry,broad-based,consisting,correlated,dark,dense,difoliate,discolorous,drying,eaf,eed,ekman,ellipsoid,especially,exerted,female,fide,filament,filiform,flower,free,fruiting,fused,geminat,glabrescen,globular,greyish-white,half,hangin,highly,immature,impressed,lamina,lengthening,lepidote,like,lobed,long,lower,male,marginal,markedly,midrib,minute,mixture,new,nflorescence,oblique,obscuring,occasionally,often,older,overlappin,packed,pair,pale,papillo,pentagonal,per,pericarp,pistillate,plan,planar,pore,porrect,portion,prickle,pricklines,primary,prominent,rest,rhachi,rounded,ruit,scar,scattered,sessile,shoot,short,short-stalked,shorter,similar,slit,smaller,solitary,somewhat,sparse,sparsely,stalked,staminate,stellate-lepidote,straight,strongly,throughout,tightly,tip,trichome,ud,unarmed,unisexual,unit,vein,venation,vestigial,visible,way,without,woody,yellowish,ympodial,½	0.9,1,3.5,adhesion,arrangement,blade,climate,colour,form,fruit,glandular,hair,height,history,leaf,life,na,number,perennial,position,presence,pubescence,reproduction,rugulose,seed,shape,size,staman,stipe,texture
223	wfo-0001027317	success	144	103	68	76	35	0.472	.25,0.1-0.2,0.4-1.5,0.5-1,0.8-3.5,1,1-1.5,1-2,1.4-1.6,2-9,3-3.5,4.5-5,?,acuminate,acute,adaxially,along,anther,apex,base,bilobed,broadly,calyx,cm,conical,corolla,deltoid,dia,elliptic,erect,fruit,glabrous,globose,golden,green,leaf,like,lobe,lobed,long,margin,minute,mm,nearly,offset,opposite,ovary,pale,pedicel,petiole,poricidal,pubescent,rest,shrub,simple,size,slightly,stem,stigma,style,surface,tip,trichome,tube,uniseriate,vein,white,x	.5,0.3-1,0.5-3,1-5,1.5-2,2-3-flowered,7-9,abaxial,anthesi,apical,apically,arch,ba,bark,beneath,berry,closely,cucullate,deciduous,deflexed,densely,differing,difoliate,drying,eaf,edicel,eed,ellipsoid,elongated,expanded,filament,filiform,free,fruiting,geminat,greyish-whit,immature,inflorescenc,joined,known,lateral,lon,long-exserted,lower,main,major,mature,minor,minutely,nflorescence,older,overlappin,pair,papillo,papillose,pointed,pore,portion,projection,prominent,reflexed,ruit,scar,series,shaped,soon,spaced,sparsely,strongly,tall,tear-drop,tub,ud,woody,ympodia,young	adhesion,alternate,arrangement,blade,climate,colour,diameter,form,glandular,greyish-white,growth,hair,height,history,inflorescence,length,life,midpoint,na,number,peduncle,perennial,plant,position,presence,pubescence,ray,reproduction,rugulose,seed,shape,staman,stellate,stipe,texture
224	wfo-0001027323	success	175	92	59	116	33	0.337	1-1.5,1.2-1.5,14-21,2-3,2-6,2.5-3,20-45,3-5,5-7,acute,anther,apex,area,attenuate,base,broadened,calyx,campanulate,cm,corolla,densely,dia,elliptic,fleshy,fruit,glabrous,globose,grey,leaf,lobe,lobed,long-triangular-deltoid,margin,minutely,mm,opposite,ovary,ovoid-reniform,papillose,pedicel,petiole,pinkish-grey,pitted,plant,poricidal,red-papillose,reddish-grey,size,stem,stigma,style,surface,tan,tip,treelet,tube,white,winged,x	.75,/3,0.5-1,1-2,10-15,5-20-flowered,6-11,7-9,adaxial,along,anthesi,apparent,appearing,arising,asymmetric,ba,bark,berry,bud,character,closed,closely,cork,decurrent,deflexed,differing,difoliate,dried,dry,eaf,edicel,eed,elongate,entire,erect,erose,exserted,filament,five-pointed,flopping,flower,free,fruiting,furcate,geminat,glabrate,growing,held,higher,hood,hooded,immature,interpetalar,lateral,like,live,lon,long,lower,main,major,matte,mature,measured,middle,minor,nflorescence,occasionally,older,one,onto,overlapping,ovoid,pair,papillae,papillo,partially,persistent,planar,pore,portion,prominent,proximal,rather,rest,ridge,ruit,scar,secondary,seen,shaped,sinus,slightly,small,smoot,soon,spaced,specimen,straight,tall,tear-drop,thickened,thin,tiny,trunk,two,ud,unit,upper,vein,visible,way,widest,woody,ympodial,young	0.75,adhesion,arrangement,blade,climate,colour,diameter,form,glandular,growth,hair,height,history,inflorescence,length,life,midpoint,na,number,peduncle,perennial,position,presence,pubescence,ray,reproduction,rugulose,seed,shape,staman,stellate,stipe,texture
225	wfo-0001027340	success	189	95	70	119	25	0.37	0.5-0.9,1-2,10-16,16-22,2-3,2-4,3.5-5,3.5-9,4-7.5,5-11,5-6,7-18,7-8,8-9.5,abaxially,adaxially,anther,axillary,brownish,bud,chartaceous,cm,condition,corolla,diameter,distal,drying,elliptic,fresh,fruit,glabrous,globose,green,greenish,half,herb,lanceolate,lilac-purple,lobe,long,membranous,minutely,mm,odd-pinnate,ovate,ovoid,papillose,pedicel,peduncle,petiole,plant,puberulent,pubescent,purple,ripe,rotate,seed,size,sparsely,splotched,stem,stigma,style,subtending,terminal,tinged,tube,whitish,x,yellow	1-10,1-3,1.5-2.7,2-3.5,2.5-4.5,2.7-4.5,3-4,4-6,5-merou,6-8.5,8-14,abruptly,absent,acumen,acuminate,ag,along,alyx,apart,apex,apparently,articulated,articulation,auriculate,axe,base,berry,blade,capitat,cell,ciliate,connivent,cordate,covering,dark,decreasing,developing,digestion,distinct,dorsally,eaf,edge,eed,enzyme,especially,exceeding,filament,flat,flower,folded,forked,geminat,generally,glabrou,green-white,hair,hair-like,hal,high,homostylous,honeycomb-shaped,indistinct,interjected,lateral,leaflet,lengthening,like,living,lower,make,margin,midrib,minute,mucilaginous,narrow,narrowed,nflorescence,orolla,pair,perfect,petiolulate,plurifoliate,pointed,pore,poricidal,purpl,removed,rounded,ruit,semi-erec,semi-rosette,sessile,seudostipule,short,shortly,slightly,slit,spaced,specimen,stamen,ste,straight,tall,tamen,tem,testal,thick,throughout,tip,tri-,truncate,unit,usually,vary,wall,wet,wing,ympodial,young	adhesion,arrangement,calyx,capitate,colour,form,growth,height,hermaphroditic,history,inflorescence,leaf,length,life,na,ovary,perennial,position,pubescence,reproduction,rugulose,shape,staman,surface,texture
226	wfo-0001027354	success	166	116	86	80	30	0.518	0.5,0.5-2,0.7-1.3,1,1-1.2,1-7,1.5-1.8,1.5-2,1.7-5,2.5-3.5,3-4,3.4-4,3/4,4-10,5-7,6.5-13,abaxially,acute,along,anther,apex,appearing,base,bi-lobed,blade,branch,calyx,cm,conical,corolla,dark,deltoid,dendritic,densely,diameter,elliptic,entire,flattened,fork,free,fruit,glabrate,glabrous,globose,golden,growth,later,lateral,leaf,length,lenticular,lobe,lobed,minutely,mm,narrowly,occasionally,ovary,pedicel,pericarp,petiole,pitted,plurifoliate,poricidal,pubescent,purplish-black,reddish-brown,shrub,small,sparsely,stem,stigma,style,surface,terminal,thin,tiny,tip,tree,tree-like,trichome,tube,violet,way,white,x	.5,0,1-1.5,10,10-20,8-12,abaxial,absent,adaxial,age,anthesi,apical,ba,bark,basal,becoming,belo,berry,branching,covered,denser,dichasia,drying,eaf,edicel,eed,erect,ew,exserted,filament,flower,fruiting,inserted,less,like,long,loose,loosely,lower,m.,monochasial,mostly,near,nflorescence,nodding,older,pair,papillo,per,planar,pore,portion,pubescen,pyramidal,raised,ruit,scar,secondary,side,simple,sleeve,slightly,slit-like,somewhat,stamen,strongly,tall,tapering,thecalyx,time,tub,type,ud,unit,vein,wide,winged,woody,ympodial,young	adhesion,arrangement,climate,colour,form,glandular,hair,height,history,inflorescence,life,margin,midpoint,na,number,peduncle,plant,position,presence,pubescence,ray,reproduction,rugulose,seed,shape,size,staman,stellate,stipe,texture
227	wfo-0001027359	success	224	136	104	120	32	0.464	-0.25,-2,/3,0-9,0.1-0.2,0.3-1.2,0.5-2,0.6-1,1-1.2,1-2,1.2-1.5,1.5-2.5,1.8-3.2,2-4,2.5-3.5,2.5-5.5,4-,5-6.5,6-8,abaxially,acute,anther,apex,apically,base,berry,blade,bright,calyx,cell,chartaceous,cm,cream,cuneate,dark,deltate,densely,diameter,dull,entire,erect,flattened-reniform,fruit,glabrescent,glabrous,green,lateral,leaf,length,lobe,lobed,long,margin,marking,maturity,membranous,midpoint,minutely,mm,moderately,near,obtuse,occasional,orange-brown,outline,ovate,pale,pedicel,peduncle,petiole,pit,poricidal,purple,raised,ray,red,reticulate,scandent,shallowly,shrub,simple,small,smooth,sometimes,sparsely,spherical,spreading,stellate,stellate-pubescent,stem,style,surface,tapering,terminal,tip,trichome,tube,undulate,way,white,wide,yellow,yellow-brown,young	-20,-3,-4,-7,-9,.1,.2,.5,/4,0,0-2,0-3,0-5,0.1,0.1-1.5,0.3-0.5,0.5,0.5-1,0.6-0.8,1-3,1-4,1-5,1.2-2,1.5-2,1/5-1/4,2-10,2-3,3-10,4-5,5-,5-merous,7-8,acut,alyx,apar,apart,apparently,articulated,ba,bark,branched,brow,concolorous,coroll,curved,difoliate,distinctive,drying,eaf,eed,elongate,elongating,equal,eye,filament,filiform,flattened,flower,free,fruiting,geminat,gray,herbaceous,infructescence,less,like,longer,lower,mature,naked,narrow-deltate,narrow-ovate,nflorescence,often,older,one,open,orolla,oung,ovoid,pair,per,perfec,pericarp,porrect,portion,prickle,prickly,primary,rachi,rarely,reflexed,ruit,scar,sessile,shorter,slender,slightly,spaced,stalk,stalked,stump,tamen,terete,tertiary,time,tinge,ud,unarme,unarmed,unit,usually,variously,vary,vein,venation,visible,weakly,woody,ympodial	adhesion,alternate,arrangement,climate,colour,corolla,form,glandular,growth,hair,height,history,inflorescence,life,na,number,ovary,perennial,plant,position,presence,present,pubescence,reproduction,rugulose,seed,shape,size,staman,stigma,stipe,texture
228	wfo-0001027365	success	233	115	78	155	37	0.335	.5,0,2,2.8,3,abaxial,adaxial,adaxially,andromonoecious,anther,apparently,blue,broadly,brown,calyx,capitate,chartaceous,cm,congested,dark,densely,diameter,elliptic,equal,extraaxillary,flattened,flower,fruit,glabrous,glandular,globose,golden-tan,green,hair,inflorescence,juicy,lanceolate,leaf,length,light,lighter,lobe,maturity,mm,moderately,mostly,nearly,obtuse,orange,outline,pedicel,peduncle,petiole,plant,pubescent,reflexed,reniform,rotate-stellate,shiny,simple,slightly,somewhat,sparsely,stalked,stellate,stem,stigma,strongly,style,subcoriaceous,surface,tapered,tree,truncate,tube,violet,yellow,×	.1,.1–0.3,.2,0.1–0.3,0.2–0.5,0–0.03,0–0.1,1,1.1–1.4,1.5–1.8,10–15,11–14,14–15,15–30,1–1.9,1–4,2.2–2.3,2.3–4.2,2.5–4.5,2.6–3,2–,2–5,3–10,3–3.5,3–3.9,4.5–5,4–4.5,4–5,5-merous,5–5.5,5–8,6–7.5,7–1,7–15,8–15,8–9,abaxially,absent,acuminate,acute,ag,along,alyx,andromonoeciou,anthesi,apart,apex,articulated,axe,ba,bark,base,becoming,berry,bilobe,blade,branched,broad-based,central,column,connivent,cuneate,curved,cylindrical,db,difoliate,directed,discolorous,distally,dried,eaf,eed,eglandular,either,emergent,entire,filament,flowering,free,fresh,frui,fruiting,functionally,geminat,half,hermaphroditic,heterstylous,included,inflated,interpetalar,knobby,like,lobed,long,longitudinal,lower,major,margin,membranaceous,midpoint,midvein,moderate,mpodial,multangulate,multangulate-stellate,multiseriate,multiseriate-stalked,nflorescence,oblique,often,one,opening,orolla,part,pericarp,pore,porrect-stellate,portion,prickle,pronounced,rachi,ray,reduced-stellate,repand,rugose,ruit,runk,sessile,shallowly,sharp,short-stalked,side,slit,spaced,stalk,staminate,stellate-pubescent,stout,straight,subtending,tamen,tan,thi,time,tissue,unarmed,unbranched,unit,vary,vein,wide,within,young,–2,–20	0.2-0.5,1-1.9,10-15,14-15,15-30,2-5,2.5-4.5,2.6-3,20,3-10,4-5,4.5-5,7-15,adhesion,arrangement,bilobed,colour,corolla,dbh,form,growth,height,history,life,na,ovary,perennial,position,pubescence,reproduction,rugulose,seed,shape,size,staman,texture,true
229	wfo-0001027366	success	136	104	66	70	38	0.485	/4,0.7-1,1-1.5,1-2,1-3,11-21,2-2.5,4-4.5,4-5,5-7,6-19,abaxially,acute,adaxially,anther,apex,base,bright,broadly,brown,calyx,capitate,cm,conical,corolla,dark,deltate,dia,drying,elliptic,glabrous,globose,golden,green,greenish-white,internodal,leaf,lobe,lobed,long,long-triangular,margin,minutely,mm,opposite,orbicular,ovary,ovoid-reniform,pale,pedicel,petiole,pitted,poridical,rounded,shining,shrub,sometimes,somewhat,stem,stigma,style,surface,tip,tube,way,wide	.5,/2,0.25-0.5,0.5-1,1.5-2,3-10-flowered,3-9,603,anthesi,ape,axe,ba,bark,berry,closely,conspicuously,deflexed,eaf,edicel,eed,erect,et,except,exserted,fide,filament,free,fruiting,lamina,lateral,less,lon,lower,main,middle,nflorescence,older,overlappin,ovoid,packed,pair,papillo,papillose,parallel,planar,pointed,pore,portion,ramo,reddish,ruit,scar,secondary,shaped,simple,straight,tall,tear-drop,trichome,tub,ud,unifoliat,unit,vein,venation,widest,woody,yellowish-gre,ympodial,young	0.5,adhesion,arrangement,blade,climate,colour,diameter,form,fruit,glandular,growth,hair,height,history,inflorescence,length,life,midpoint,na,number,peduncle,perennial,plant,position,presence,pubescence,ray,reproduction,rugulose,seed,shape,size,staman,stellate,stipe,texture,unifoliate,yellowish-grey
230	wfo-0001027368	success	145	113	77	68	36	0.531	-20,-5,.5,0.3-2.5,0.5-3.5,0.5-5,0.8-2,1-2,1-6,1.5-2,1.5-2.5,2,2-2.5,2-3,3-12.5,4-6,5-15,5-6,abaxially,abruptly,acuminate,acute,adaxially,apex,base,blade,calyx,chartaceous,cm,cuneate,decurrent,deltate,densely,diameter,distally,ellipsiodal,elliptic,elliptic-ovate,entire,glabrous,globose,hair,lanceolate,lenticular,lobe,margin,mm,moderately,narrowed,narrowly,oblong,occasionally,often,ovoid-fusiform,pedicel,peduncle,petiole,puberulent,pubescent,purple,ray,shrub,simple,small,sparsely,stellate,stigma,style,subcoriaceous,subhastate,triangular,truncate,tube,unknown,white,x,yellow	-10,-15,-2,1-15-flower,2-4,2-9,3,4-many-foliat,5-10,8-13,absen,adaxiall,aggregate,also,apart,articulated,axe,ba,branched,cell,color,connivent,contiguous,cylindrical,darker,dendritically,denser,directed,eaf,eed,except,forked,gland,lighter,long,long-stalked,lower,midvein,nearly,nflorescence,nther,obtuse,orolla,otherwise,pore,pubescen,rachi,radiu,ruit,sometimes,spaced,stalked,star,stone,subcapitat,tal,tem,terminal,three,time,tip,unbranched,unit,usually,vary,vein,wide,ympodial	adhesion,anther,arrangement,climate,colour,corolla,form,fruit,glandular,growth,height,history,inflorescence,leaf,length,life,midpoint,na,number,ovary,perennial,plant,position,presence,pubescence,reproduction,rugulose,seed,shape,size,staman,stem,stipe,subcapitate,surface,texture
231	wfo-0001027369	success	191	103	73	118	30	0.382	-11,.5,.7,0-1,0.1,0.25-0.4,0.6-0.8,1-2.5,1.2-2.5,1.2-3,1.5-2,2-5,3-4,4-8,7-15,abaxially,almost,anther,apex,apically,base,berry,blade,calyx,cm,cordate,densely,diameter,fruit,glabrous,hair,known,lanceolate,lateral,leaf,length,lobe,lobed,long,margin,mauve,membranous,midpoint,mm,moderately,orbicular,pale,pedicel,peduncle,petiole,poricidal,ray,reniform,rounded,scandent,shrub,simple,smooth,sparsely,spherical,spreading,stellate,stellate-pubescent,stem,style,surface,tapering,terminal,tip,tube,unequal,wide,yellow	-1,-10,-2,.1,.4,/4,0,0-15,0-3,0-5,0-6,0.05-0.15,0.1-0.2,0.1-0.3,0.2-0.5,0.3-1.5,0.5,0.5-0.8,0.5-1.5,1-,1-2,1-3,1-4,1/3,2-3,2-4,3,3-10,4-5,5,5-merous,acut,alyx,ame,apar,apart,apparently,articulated,bark,branched,broad-deltate,c.,color,concolorous,curved,deltate,difoliate,distance,drying,eaf,eed,elongating,equal,erect,extending,eye,filament,filiform,flower,free,fruiting,geminat,glabrou,glaucous,gra,green,herbaceous,infructescence,know,less,lon,lower,mature,midvein,multangulate,naked,narrowly,nflorescence,older,one,open,orolla,oung,pendulous,per,perfec,pericarp,perpendicular,porrect,portion,prickl,prickle,prickly,reflexed,ruit,scar,sessile,side,slender,slightly,spaced,stalk,stalked,straight,strongly,tamen,terete,time,trichome,unarmed,unit,vary,venation,visible,way,wider,winged,ympodial	acute,adhesion,arrangement,climate,colour,corolla,form,glandular,growth,height,history,inflorescence,life,na,number,ovary,plant,position,presence,present,pubescence,reproduction,rugulose,seed,shape,size,staman,stigma,stipe,texture
232	wfo-0001027378	success	149	101	70	79	31	0.47	.2,0.5–1,1.2–1.5,1.2–1.8,1.5–1.8,1.5–8,15–35,1–1.5,1–3,2.5–7,2–11,2–2.2,2–2.5,3–5,4–6,5–13,abaxially,acute,adaxially,anther,blue,broadly,calyx,chartaceous,cm,deltoid,diameter,extra-axillary,fleshy,flower,fruit,glabrous,half,herbaceous,lanceolate,leaf,light,lobe,long,lower,minutely,mm,moderately,narrowly,ovate,ovoid,papillose,pedicel,peduncle,pentagonal,petiole,pubescent,rotate-stellate,rounded,simple,slender,somewhat,sparsely,stem,stigma,style,terrestrial,tip,trichome,tube,unknown,vein,vine,white,x	0.7–1,0.8–2.5,2.3–5,3–4.5,3–6,4–9,5-8,5-merous,5–10,5–7,6–10,6–7,acuminate,adaxial,alyx,apar,apex,apicall,axe,base,berry,blade,c.,capitat,ciliate,clavate,climbin,color,cordate,cylindrical,deeply,densely,eaf,eed,filament,flattened,fruiting,glabrou,hair,hair-tipped,like,lon,longer,m.,margin,markedly,membranous,nflorescence,nternode,obscure,often,orolla,palmate,perfec,plurifoliat,pointed,primary,rachi,revolute,ruit,sand-punctat,sand-punctate,scattered,short,side,slightly,small,spaced,tamen,tem,tooth,unbranched,unit,unknow,vary,venation,wide,widely,ympodial	0.2,adhesion,arrangement,capitate,climate,climbing,colour,corolla,form,growth,history,inflorescence,length,life,midpoint,na,number,ovary,position,presence,pubescence,ray,rugulose,seed,shape,size,staman,stellate,stipe,surface,texture
233	wfo-0001027378	success	141	103	69	72	34	0.489	.2,1-1.5,1-3,1.2-1.5,1.5-1.8,1.5-8,15-35,2-11,2-2.2,2-4,2.5-7,3-5,4-6,5-13,abaxially,acuminate,adaxially,anther,apex,basally,base,blade,blue,broadly,calyx,chartaceous,climbing,cm,cordate,deeply,diameter,extra-axillary,fleshy,flower,fruit,glabrous,hair,herb,lanceolate,leaf,light,lobe,margin,minutely,mm,oblong,ovate,pedicel,peduncle,petiole,pubescent,revolute,rotate-pentagonal,rounded,simple,small,somewhat,spaced,sparsely,stigma,style,terrestrial,tooth,tube,unknown,white,widely,x,yellow	0.7-1,0.8-2.5,2.3-5,3-4.5,3-6,4-9,5-8,5-merou,6-10,6-7,acute,ag,alyx,apart,apicall,apparently,articulated,axe,ba,capitat,ciliate,clavate,connivent,cylindrical,deltoid,densely,directed,distally,eaf,eed,equal,filament,fruiting,geminat,hair-tipped,large,long,longer,longitudinal,lower,moderately,multicellular,narrowly,nflorescence,node,obscure,often,opening,orolla,perfect,plurifoliate,pore,pubescen,rachi,rooting,scattered,short,slender,slightly,slit,tamen,tem,tip,trailing,unbranched,unit,unknow,vary,vein,weakly,wide,ympodial	adhesion,arrangement,capitate,climate,colour,corolla,form,glandular,growth,height,history,inflorescence,length,life,midpoint,na,number,ovary,plant,position,presence,pubescence,ray,reproduction,rugulose,seed,shape,size,staman,stellate,stem,stipe,surface,texture
234	wfo-0001027380	success	134	112	77	57	35	0.575	.5,0,1-1.5,11-17,2-3,2-3.5,2.5-3,3-4,30-35,4-6.5,5,5-8,?,abaxially,acuminate,adaxially,almost,anther,apex,articulated,base,berry,blade,broadly,calyx,chartaceous,cm,conical,deeply,developed,diameter,distally,entire,erect,extra-axillary,flattened,flower,fruit,glabrous,globose,hair,leaf,len,lobe,long,margin,minute,minutely,mm,oblique,orange-red,ovate-lanceolate,pedicel,peduncle,petiole,pubescent,red,reticulate,rounded,scarcely,shallow,shrub,simple,slender,slightly,small,sparsely,stellate,stem,stigma,style,thickening,tree,truncate,visible,white,x	1136.,5-merous,9-10,accrescen,adaxiall,alyx,apparently,armed,axe,ba,bark,brown,capitat,drying,eaf,eed,filament,forked,fruiting,geminate,greenish-brown,hartley,homostylous,hooked,lon,loose,lower,mpodial,nflorescence,occasionally,open,orolla,oung,pair,paler,perfec,perfect,prickle,primary,rachi,rip,ruit,scattered,scramblin,smooth,somewhat,sparse,structure,tall,tamen,testa,triangular,unarmed,unbranched,unknown,vary,vein	adhesion,arrangement,capitate,climate,colour,corolla,form,glandular,growth,height,history,inflorescence,length,life,midpoint,na,number,ovary,plant,position,presence,pubescence,ray,reproduction,ripe,rugulose,seed,shape,size,staman,stipe,surface,texture,tube,ye
235	wfo-0001027381	success	262	96	73	189	23	0.279	.8,0-1,0-1.5,0.5,0.5-0.6,0.5-1,0.6-0.7,1-2,1-2.5,1.5-4,1/3-1/2,2-6,3-4,3-7.5,3.5-4,4-5,5-11,almost,anther,calyx,capitate,chartaceous,clavate,cm,diameter,distributed,elliptic,erect,evenly,filiform,free,fruit,glabrous,globose,grey,lateral,leaf,length,less,light,lobe,lobed,long-deltoid,maturity,mauve,mm,obconical,oblong,orange,ovate,pale,pedicel,peduncle,petiole,plant,present,shiny,shrub,size,smooth,stellate,stellate-pubescent,stem,stigma,style,surface,tapering,thin,tube,white,x,yellow,yellowish	.3,.4,/5,0.1,0.2,0.3-0.5,0.4-0.6,0.5-0.7,0°,1-1.5,1/4-1/3,2,2-2.5,2-3,2-4,3-5,4-8,5-8,5-merou,7-8,8-10,abaxially,absent,accrescent,acute,adaxially,age,along,alyx,angle,apex,apically,apparently,area,articulated,attachment,bark,base,berry,blackish,blade,branch,branched,brown,clearly,concolorous,cordate,covering,cream,curved,dark,delineated,deltoid,densely,density,difoliate,dilated,distance,divided,drying,dull,eaf,eed,ellipsoi,elongated,elongating,epidermi,equal,even,exserted,extending,eye,faint,fertile,filament,flat,flattened,flower,fruiting,geminat,gland,green,greyi,higher,inconspicuous,indumentum,infructescence,irregula,known,lamina,lanceolate,lengthening,like,long,longer,longitudinal,lower,main,margin,marking,mature,midpoint,midvein,minute,mostly,naked,never,nflorescence,oblique,obscuring,obtuse,often,orange-green,orolla,pair,papillose,part,pendulous,per,perfect,pericarp,point,pore,poricidal,porrect,portion,prickle,primary,prominently,protruding,puffy,rachi,raised,rarely,ray,reduced,region,rest,right,rounded,ruit,scar,sessile,shallow,side,simple,sinus,slender,slightly,slit,small,smoot,sometimes,sparse,sparsely,spreading,stalk,straight,striate,stump,surrounded,tamen,terminal,tertiary,time,tip,tissue,translucent,trichome,truncate,ud,unarme,unarmed,unit,usually,variable,variously,vary,vein,venation,visibl,visible,wide,widening,without,woody,yellow-green,ympodial,young	adhesion,arrangement,colour,corolla,form,greyish,growth,height,history,inflorescence,life,na,ovary,perennial,position,presence,pubescence,reproduction,rugulose,seed,shape,staman,texture
236	wfo-0001027384	success	155	83	59	96	24	0.381	0.4-1.1,0.5-1,0.9-1,1-1.3,1-3,1-4,1.5-2,2.5-6.5,3-3.5,3-4,3/4,5-5.5,7-14,7.5-8,anther,base,broadly,brown,calyx,capitate,clavate,cm,corolla,dia,flattened-reniform,glabrous,globose,green,hard,leaf,lobe,lobed,minutely,mm,narrowly,obovate,opposite,ovary,papillose,pedicel,petiole,pitted,pseudo-terminal,reddish-purple,shaped,shrub,small,stem,stigma,style,sulcate,surface,tear-drop,tree,triangular,tube,way,white,x	.25,.5,.75,/3,1-1.5,4-7,5-15-flowered,abov,acute,anothe,anthesi,apart,apex,ba,bark,beginning,beneath,berry,breaking,bud,closely,cuneate,deep,difoliate,distal,drying,eaf,edicel,eed,ellipsoid,equal,erect,filament,free,fruiting,geminate,herbarium,incrassate,inflorescenc,later,lateral,long,long-exserted,lower,main,margin,member,middle,mustard,nflorescence,occasionally,older,overlapping,pair,pale,paler,papillo,peeling,planar,pore,poricidal,portion,prominent,rarely,rounded,ruit,scar,section,shining,simple,siz,slender,spaced,specimen,straight,subcoriaceous-fleshy,tall,tapering,thick,tip,transverse,trichome,tub,tuft,ud,uniseriate,unit,vein,widely,widest,without,woody,yellow,yellowish,ympodial,young	0.75,arrangement,colour,diameter,form,fruit,growth,height,history,inflorescence,length,life,na,peduncle,perennial,plant,position,pubescence,reproduction,rugulose,seed,shape,size,texture
237	wfo-0001027389	success	154	99	64	90	35	0.416	.25,.5,0.25-0.5,0.5-1.5,0.6-1,1-1.5,11-14,2-2.5,3-3.5,3-4.5,5-7,acuminate,acute,anther,apex,base,broadening,broadly,brown,calyx,cm,conical,corolla,dark,decurrent,deltoid,dia,elliptic,glabrous,globose,green,hispidulous,inflorescence,leaf,lobe,lobed,margin,minutely,mm,nearly,opposite,ovary,ovate,ovoid-reniform,pedicel,petiole,pitted,puberulent,reddish-golden,shaped,shrub,slight,sparsely,stem,stigma,style,surface,tear-drop,top,truncate,tube,white,winged,x	.1,0.25-0.3,0.5-0.75,1,1-2,1.8-1.9,4-5-flowered,7-8,along,anthesi,apart,ba,bark,beneath,berry,bud,deflexed,dry,eaf,edicel,eed,ellipsoid,erect,evenly,except,expanded,exserted,filament,filiform,foetid,foliage,free,fruiting,geminate,lateral,like,lon,long,lower,main,making,material,middle,nflorescence,node,non-reproductive,obovoi,occasionally,often,older,one,pair,paler,papillo,papillose,pore,poricidal,portion,prominent,prominently,proximal,raise,raised,reflexed,rest,ruit,scar,shin,side,simple,slender,slightly,soon,spaced,straight,tall,tapering,thread-like,tip,trichome,ud,unifoliat,uniseriate,unit,vein,widest,woody,yellowish,ympodial,young	adhesion,arrangement,blade,climate,colour,diameter,form,fruit,glandular,growth,hair,height,history,length,life,midpoint,na,number,peduncle,perennial,plant,position,presence,pubescence,ray,reproduction,rugulose,seed,shape,size,staman,stellate,stipe,texture,unifoliate
238	wfo-0001027395	success	153	107	74	79	33	0.484	.5,0.25-0.5,0.6-1.1,0.75-1,1-1.5,1-2,1-5,1.1-1.5,1.5-1.9,1.5-2.5,1.6-2.9,12.5-17.3,2-3,2.2-7,3.5-4,5-6.5,8,acute,anther,apex,apiculate,attenuate,base,beneath,black,calyx,capitate,cm,conical,corolla,deltoid,densely,dia,fruit,glabrous,globose,green,immature,large,leaf,lobe,lobed,long,major,margin,minor,minutely,mm,narrowly,nearly,obovate,occasionally,opposite,ovary,pedicel,petiole,poricidal,primary,pubescent,rusty-papillate,secondary,shiny,shrub,size,stem,stigma,style,tip,trichome,tube,uniseriate,vein,white,x	.25,10-20-flowered,11-15,4-6,anthesi,apically,bark,becoming,beginning,berry,caly,closely,constricted,cucullate,decurrent,deflexed,depressed,differing,difoliate,drying,eaf,edicel,eed,enlarging,erect,exfoliating,exserted,filament,fleshy,free,fruiting,geminat,imperceptibly,inflorescenc,known,lateral,lon,lower,main,midrib,nflorescence,older,once-furcate,overlapping,ovoid,pair,papillo,papillose,partially,piece,planar,pointed,pore,portion,raised,restricted,robust,ruit,scar,shaped,shining,simple,small,somewhat,spaced,straight,tall,tapering,tear-drop,thick,thickened,transverse,ud,unit,within,without,woody,ympodial,young	adhesion,arrangement,blade,climate,colour,diameter,form,glandular,growth,hair,height,history,inflorescence,length,life,midpoint,na,number,peduncle,plant,position,presence,pubescence,ray,reproduction,rugulose,seed,shape,staman,stellate,stipe,surface,texture
239	wfo-0001027396	success	244	121	104	140	17	0.426	0-3,0-4,0.5-1,0.5-1.5,0.7-2.5,0.8-1.3,1.5-3.5,1/4-1/3,10-30,10-35,2-3,2-3.5,2-7,2.5-4,2.8-4.5,3.5-6,4-7,5-50,5-8,5.5-7.5,6-20,6.5-7.5,8-20,abaxial,acute,adaxial,almost,anther,apart,apex,attenuate,base,black,brown,calyx,chartaceous,cm,concolorous,cream,cuneate,dark,densely,diameter,discolorous,drying,elliptic,elongate,equal,flattened,flattened-reniform,flower,fruit,glabrous,glandular,green,herb,leaf,length,lobed,long,long-styled,margin,marking,maturity,mauve,mm,near,obtuse,often,orange,pair,pale,pedicel,peduncle,perpendicular,petiole,plant,prickle,primary,pubescent,purple,rotate,short-styled,shrub,simple,sometimes,somewhat,spaced,sparsely,spherical,stellate-pubescent,stem,straight,style,tearing,trichome,tube,vein,way,white,wide,yellow,yellowish,young	-2,-5,-6,/3,0-100,0-30,0-5,0.1-0.5,0.1-1,0.4-0.7,0.5-2,0.5-2.5,0.8,1,1-4,1.2-2,1.5-3,1.8-3,1/2-2/3,1/3,1/6,10-15,10-25,12-25,15-40,20-100,3-,3-9,4,4-5,4-6,5-10,5-20,5-30,5-merous,7-10,7-15,abaxially,alyx,ame,andromonoecious,apar,apically,apparently,articulated,ba,bark,berry,blade,broad,broad-deltate,bulbous,c.,connivent,curved,decurrent,deltate,difoliate,distal,distance,eaf,eed,elongating,erect,extending,extensive,fewer,filament,free,fruiting,fully,geminat,glabrescent,gray-brow,hair,hermaphrodite,heterostylous,infructescence,lateral,less,lignified,lobe,lobing,lon,long-acuminat,longer,lower,lowermost,mature,midpoint,midvein,moderately,nflorescence,older,one,open,opening,orolla,oung,pendulous,per,pericarp,poricidal,porrect,portion,prickl,prickly,ray,red-brown,reflexed,ruit,scar,secondary,sessile,side,smooth,spreading,stalk,stalked,staminat,stout,surface,tamen,tapering,terete,tertiary,time,tip,unarmed,unbranched,unit,upper,usually,variously,vary,venation,visible,woody,yellow-green,ympodial	adhesion,colour,corolla,form,growth,height,inflorescence,na,ovary,pubescence,seed,shape,size,staman,stellate,stigma,texture
240	wfo-0001027416	success	137	95	62	75	33	0.453	0.2-0.4,0.3-0.5,0.5-1.0,1.3-2.0,1.5-2.0,2.6-3.0,4-7,4-8,5-10,5.5-8.5,8-10,accrescent,acute,annual,anther,apically,blue,broadly,brown,calyx,campanulate,capitate,cm,dark,developing,dm,dry,enveloped,foveolate,glabrous,green,herb,heteromorphic,incurved,internodal,invested,lenticular,linear,lobe,long,maturity,minutely,mm,otherwise,ovary,ovate,pentagonal-stellate,prickly,slender,slightly,smooth,spherical,splitting,stem,strigulose,tightly,tube,violet,viscid-villous,weakly,wholly,yellow	.5,1.0,1/2-2/3,3-7,4.0-5.5,5-9-flowere,across,along,alyx,anthesi,appearance,base,beneath,berry,blade,borne,branching,capitate-glandular,cauline,deltoid,dia,difoliate,divided,eaf,eed,erect,externally,few-rayed,fine,geminat,gland,hair,lanceolate,lon,main,much-dissected,narrowly,nflorescence,often,orolla,pedicel,pinnatifid,prickle,quantity,reticulately,ruit,scattered,sessile,short,short-stipitate,simple,slende,somewhat,spreading,stellae,straight,strait,tall,tamen,taprooted,terete,thrice,tigma,tub,twice,tyle,ultimate,uniseriate,unit,usually,varying,vein,villous,wrinkled,ympodial	adhesion,arrangement,colour,corolla,diam,diameter,form,fruit,growth,height,history,inflorescence,leaf,length,life,na,peduncle,plant,position,presence,present,pubescence,reproduction,rugulose,seed,shape,size,staman,stellate,stigma,style,surface,texture
241	wfo-0001027432	success	215	130	105	110	25	0.488	0.1,0.5-1,1-1.5,1-3,1.4-2,1.5-,1.5-2,1/4,10-22,2-2.5,2-3-lobed,3-10,3-4,3-7,3.5-4.5,4.5-,6-10,6-7,7-,8-10,8-16,abaxially,acute,angulate,anther,apex,apical,attenuate,base,blade,brownish,c.,calyx,campanulate,chartaceous,clavate,cm,coriaceous,corolla,cream,cuspidate,densely,diameter,entire,ferruginous,flower,fruit,glabrous,glandular,glandular-pubescent,globose,green,greenish,growth,heterostylous,hirsute,irregularly,leaf,light,lobe,lobed,margin,maturing,midpoint,mm,near,ovary,ovate,ovate-elliptic,pedicel,peduncle,perfect,petiole,plant,poricidal,puberulent,rarely,ray,reniform,reticulate,scabrous,shrub,simple,somewhat,stellate,stem,stigma,style,sub-coriaceous,subglobose,tan,tapering,terminal,tip,tomentose,trichome,tube,velutinous,way,white,woody,x,yellow,yellowish,young	-1.5,.5,0.2-0.3,0.3-0.4,0.3-1.0,0.3-3.5,0.5-0.1,0.8-1.0,1-multicellular,1/3,20-30,3,3-5,3-6,30,4-5,5-10,acicular,adaxially,apart,armed,articulate,bark,basal,berry,branched,branching,brow,confined,conical,curved,distal,eaf,eed,eglandular,epidermi,erect,especially,exserte,fewer,filament,flattened,free,fruiting,glabrescent,juvenile,laterally,leave,lengthening,like,linear-lanceolate,long,long-styled,lower,many,many-celled,minute,much,mucilaginous,multangulate,multiangulate,new,nflorescence,ochraceous,older,one,partially,per,pericarp,plurifoliat,pore,porrect,porrect-stellate,portion,prickle,prickly,prominent,pubescent,raise,recurved,ruit,sessile,short-styled,similar,slightly,spaced,sparsely,staminate,stellate-pubescen,stellate-pubescent,stellate-tomentose,stipitate,straight,subsessile,surface,terete,testa,thick,time,tomentose-floccose,tomentose-scabrous,ud,unarmed,unevenly,unicellular,unit,upper,villose,visible,ympodial	adhesion,arrangement,climate,colour,form,hair,height,history,inflorescence,length,life,na,number,perennial,position,presence,pubescence,reproduction,seed,shape,size,staman,stipe,texture,ye
242	wfo-0001027437	success	193	112	84	109	28	0.435	0,0.2-0.4,1-1.5,1-2,1-4,2-2.5,2-3,2-4.5,2.5,2.8-6,4,4-4.5,4-5,5-12,5-6,6-8,7-17,abaxially,acuminate,acute,anther,apex,attenuate,base,beige,berry,brown,calyx,chartaceous,clavate,cm,cordate,corolla,diameter,elliptic,entire,erect,fruit,glandular,glandular-viscous,globose,growth,hirsute,internodal,lateral,lenticulate,like,linear-lanceolate,lobe,lobed,margin,middle,midpoint,mm,oblanceolate,ovary,pedicel,peduncle,petiole,puberulent,pubescence,pubescent,ray,reddish,rusty,scabrous,shrub,sparsely,stellate,stellate-rotate,stem,stigma,style,subcampanulate,subreniform,subspherical,surface,tomentose,triangular-lanceolate,tube,velutinous,white,woody,x	0.4-0.5,1,1-3,1.2-1.5,2-2.5mm,2-several,30,adaxially,anthesi,antrorse,armed,articulated,bark,basal,beneath,branched,compressed,corymbose,curved,cyme,dark,decurrent,densely,diamete,discolorous,distal,eaf,eed,egalndular,elongate,erec,exceeding,filament,flower,free,fruiting,glabrous,green,heterostylous,impressed,inserted,laterally,leaving,lengthening,long,long-styled,lower,minute,mixed,mixture,near,nerve,new,nflorescence,oblong,older,one,ovate,partially,perfect,pericarp,plurifoliat,pore,poricidal,porrect,portion,prickle,prickly,prominent,raise,recurved,reduced,reflexed,reticulate,rugose,ruit,scar,scarce,sessile,short-styled,simple,slightly,slit,spaced,sparse,stalked,staminate,stipitate,straight,strongly,tall,terete,testa,thick,three,time,tinge,tip,trichome,ud,unarmed,unevenly,unicellular,unit,upper,venation,within,yellow,ympodial	adhesion,arrangement,blade,climate,colour,form,hair,height,history,inflorescence,leaf,length,life,na,number,plant,plurifoliate,position,presence,present,reproduction,rugulose,seed,shape,size,staman,stipe,texture
243	wfo-0001027447	success	197	108	83	114	25	0.421	0-0.4,0.15-0.25,0.2-1,0.25-0.5,0.4-0.6,0.6-0.8,0.6-1,1-2.5,1.3-1.7,1.5-3,17-28,2.3-5,3-4.5,3.5-4.5,3.8-4.3,4-8,7-14,7-8,abaxially,absent,acuminate,acute,adaxially,andromonoecious,anther,apex,base,blade,brown,calyx,chartaceous,cm,cuneate,densely,diameter,elliptical,entire,erect,extra-axillary,flower,fruit,glabrous,globose,green,hair,inflorescence,leaf,length,lobe,lobed,long,margin,midpoint,mm,moderately,obtuse,ovate,pale,pedicel,peduncle,perennial,petiole,plant,present,pubescence,ray,red,rhizomatous,rostrate,shallowly,shrub,simple,sparsely,stellate,stellate-pubescent,style,succulent,thick,throughout,tube,white,x,yellow	%,.25,0-0.5,0-1,0-10,0-2.5,0-4,0.2-0.6,0.25-0.3,0.5-1.7,1-1.4,1-10,1-2,1-locular,1.2-1.7,10-20,13-18,2.1-3.2,2.5-4,25-30,3-6,4-6,4-9,5-13,5-8,5-merou,6-10,7-10,7-14.5,8-13,absen,acicular,across,adaxiall,adult,alyx,apart,articulated,axe,ba,branch,branche,confined,cross-section,cylindrical,decimetre,directed,distall,distally,dm,eaf,eed,eglandular,elliptica,exocarp,finger,fruiting,functional,gland-tipped,half,heterostylous,incomplete,index,juicy,juvenile,lamina,lateral,less,lobing,longer,lower,markedly,mature,mesocarp,midrib,midvein,minute,nflorescence,oblique,orolla,pair,part,per,placenta,pore,porrect,prickle,pseudo-racemose,ruit,septum,sessile,short,side,spaced,stellae,straight,surface,tal,tamen,tem,thicker,time,transparent,unarme,unarmed,unbranched,unit,unknow,upper,vary,vein,weakly,wide,ympodial	adhesion,arrangement,climate,colour,corolla,form,glandular,growth,height,history,life,na,number,ovary,position,presence,reproduction,seed,shape,size,staman,stem,stigma,stipe,texture
244	wfo-0001027449	success	160	105	72	88	33	0.45	.5,/3,0.5-1,0.5-1.5,0.8-1.5,0.9-1.1,1.4-1.5,2-4,3,3-3.5,3-7,5-6,8-15,acuminate,acute,anther,apex,area,base,beneath,brown,calyx,cm,corolla,dark,dia,dry,elliptic,fruit,glabrous,globose,green,inflorescence,leaf,lobe,lobed,long,long-triangular,material,minutely,mm,narrowly,obconic,oblique,often,opposite,ovary,ovoid-reniform,pale,papillose,pedicel,petiole,pitted,poricidal,pubescent,red-papillose,shrub,size,small,stem,stigma,style,surface,tip,tree,trichome,tube,tuft,uniseriate,way,white,x	.4,.75,1.2-1.5,1.5-2.5,10-15-flowered,2-3,4-6,anthesi,appearing,arising,around,axil,bark,becoming,beginning,berry,bud,closely,cup,deciduous,deflexed,dense,densely,density,differing,difoliate,eaf,edicel,eed,ellipsoid,erect,exserted,extreme,filament,forming,free,frui,fruiting,geminat,glabrate,inflorescenc,lamina,later,lateral,like,lon,long-acuminate,lower,main,major,minor,nflorescence,older,one,orangish,overlapping,packed,pair,persistent,pointed,pore,portion,prominent,raised,reddish-brow,reflexed,rest,ruit,scar,shaped,simple,slender,soon,sparse,sparsely,straight,styl,tall,tapering,tear-drop,trunk,ud,unit,varying,vein,woody,ympodial,young	adhesion,arrangement,blade,climate,colour,diameter,form,glandular,growth,hair,height,history,length,life,margin,midpoint,na,number,peduncle,plant,position,presence,pubescence,ray,reddish-brown,reproduction,rugulose,seed,shape,staman,stellate,stipe,texture
245	wfo-0001027452	success	152	97	62	90	35	0.408	.5,0.5-1,0.5-1.5,0.5-2,0.5-2.5,1-3,1-4.5,1.5,1.5-3,10-20,2-6,2-foliate,4,4-6,5-12,acute,anther,apex,base,blade,brown,calyx,chartaceous,ciliate,cm,densely,diameter,dm,drying,elliptic,elliptic-ovoid,entire,flower,fruit,glabrous,globose,hair,herb,immature,linear-lanceolate,lobe,margin,membranaceous,mm,moderately,oblong,obtuse,pedicel,peduncle,petiole,pubescent,rotate,rounded,seed,semitransparent,sparsely,stigma,style,tube,white,x,yellow	1,1-2,1-5,2-4,3-6,3-9,5-20,abaxially,absent,abundant,adaxiall,adaxially,along,axe,berry,beyond,branched,cell,celled,center,connected,cordate,decurrent,dehiscing,denser,eaf,eed,emarginat,equal,explosively,exserted,filament,flat,frui,geminat,growt,held,interpetalar,large,long,lower,lying,maturing,maturit,mesocarp,nearly,new,nfloresence,notched,often,one-,orolla,outer,parallel,per,perpendicular,placenta,pressure,pubescen,rachi,raised,ridge,ruit,running,short,significantly,single,slightly,smaller,smoother,sometimes,stamen,straight,swollen,tal,tamen,tem,tissue,triangular,two-celled,unbranched,unit,usually,vary,vein,wall,watery,wid,woody,ympodial	adhesion,arrangement,climate,colour,corolla,form,glandular,growth,height,history,inflorescence,leaf,length,life,midpoint,na,number,ovary,perennial,plant,position,presence,pubescence,ray,reproduction,rugulose,shape,size,staman,stellate,stem,stipe,surface,texture,ye
246	wfo-0001027471	success	165	97	75	90	22	0.455	/4,0.1-0.2,0.2-0.5,0.4-1,0.5,0.5-0.6,0.5-1.5,0.9-1,1-1.2,1-1.5,1.4-3,2-2.5,2-3,2-lobed,3-4,3-7,4-5,anther,apex,base,bifid,brittle,calyx,cm,conical,corolla,diameter,elliptic,flattened,glabrous,globose,growth,herb,inflorescence,internodal,leaf,leaf-opposed,less,lobe,lobed,long-triangular,maturity,mm,open-conical,ovary,ovate,pale,pedicel,peduncle,perfect,petiole,poridical,pubescent,red-orange,reniform,shape,shrub,simple,size,small,somewhat,sparsely,stem,stigma,style,subshrub,surface,tan,thin,tip,tube,way,white,x,yellowish	.5,0.2-0.4,0.5-0.7,0.7-0.9,1-1.6,1.5-2,6-7,abaxially,acute,adaxially,age,along,anthesi,appressed,ascending,bark,berry,branched,c.,closely,deltate,dendritic,densely,desnsely,differing,difoliate,distant,drying,eaf,eed,entire,erec,erect,especially,filament,flower,free,fruiting,furcate-dendritic,geminate,included,lamina,lengthening,like,lower,major,margin,midvein,minor,minutely,mixture,new,nflorescence,nodding,node,occasionally,orbicular,overlapping,pair,papillat,pericarp,petal,pitted,planar,plane,pore,portion,primary,pubscent,rachi,reflexed,ruit,scar,scattered,similar,slender,slightly,slit,spaced,straight,thickened,trichome,trifoliat,ud,uniseriate,unit,usually,vein,woody,ympodial	adhesion,arrangement,colour,dense,form,fruit,height,history,length,life,na,plant,position,presence,present,pubescence,reproduction,rugulose,seed,staman,stellate,texture
247	wfo-0001027473	success	138	113	78	60	35	0.565	.25,/2,0.5-1,0.8-1,1-1.5,1-2,1.3-2,1.5-2,2-2.5,2.5-3,3.5-5,4.5-13,8.5-37,?,abaxially,acute,adaxially,anther,apex,base,berry,brown,calyx,clavate,cm,conical,corolla,decurrent,dendritic,densely,di-,dia,flattened-reniform,glabrous,globose,green,incrassate,later,leaf,like,lobe,lobed,long,long-triangular,margin,minutely,mm,near,obovate,occasionally,ovary,pale,pedicel,petiole,pitted,pointed,pubescent,pubesent,rootstock,rusty,sessile,shape,shrub,somewhat,sparsely,stem,stigma,style,subshrub,surface,trichome,trifoliate,tube,way,white,wide,woody,young	0.25-0.5,1.8-2,1/3,5,6-9,absen,along,anthesi,ape,apparently,bark,deccurent,deep,deflexed,denser,differing,drying,eaf,eed,empty,erect,filament,free,fruiting,geminat,giving,lateral,less,lower,main,major,middle,minor,minute,older,overall,pair,papillo,planar,pore,poricidal,portion,ruit,sac,shaped,sterile,strongly,tall,tear-drop,thick,tip,unit,usually,vein,widest,wing,winged,yellowish,yellowish-brow,ympodial	absent,adhesion,arrangement,blade,climate,colour,diameter,form,fruit,glandular,growth,hair,height,history,inflorescence,length,life,midpoint,na,number,peduncle,plant,position,presence,pubescence,ray,reproduction,rugulose,seed,size,staman,stellate,stipe,texture,yellowish-brown
248	wfo-0001027483	success	164	70	52	112	18	0.317	0.2-1.9,0.6,1-2.5,1.2-2.5,1.5-10,1.5-2.6,1.5-3,2-4,2-4.5,3-15,3-6,3.5-20,4.5-8,calyx,cm,coarsely,connate,corolla,diameter,distal,elliptical,finely,globose,green,green-white,half,herbaceous,lateral,leaf,leaflet,light,long,medium,mm,odd-pinnate,ovate,ovoid,pedicel,peduncle,perennial,petiole,plant,pubescent,rotate,seed,size,terminal,throughout,violet,violet-purple,wide,yellow	0-1.,1,1-2,1-4,1-5,2,2-3,3-6-foliat,5-10,5-6,abaxially,acumen,acute,adaxially,apex,apical,apically,articulate,basal,base,branched,cell,covering,cuneate,cyme,decurrent,dehiscent,dichasial,dichasially,digestion,diminishing,dorsally,dot,eaf,ebracteate,edge,eed,emoval,enzyme,erec,exceeding,filament,flat,flower,folded,forked,generally,globo,gradually,hair-like,honeycomb,interjected,interpetiolar,introrse,lighter,living,lobe,lon,lower,lunat,make,maturing,minute,monochasial,mucilaginous,nflorescence,nther,obtuse,often,orolla,pair,pattern,perfect,petiolule,plan,poricidally,proximal,purple,rachi,ray,reveal,rosette,rounded,ruit,sessile,seudostipule,short,slit,smooth,sometimes,specimen,stamen,stigma,straight,style,subsessile,tall,tem,testal,thick,tissu,toward,tuber-bearing,typically,uniform,unit,vary,varying,wall,white,ympodial,¼	anther,arrangement,colour,form,fruit,growth,height,history,inflorescence,length,life,na,ovary,position,reproduction,shape,stem,texture
249	wfo-0001027503	success	197	139	123	74	16	0.624	.5,0.2,0.4-0.7,0.5,0.5-0.6,0.5-0.7,0.8-1,1,1-1.2,1-3,1.2-2.5,10,2-3,2.5-5.5,4,8-11,<,abaxially,acute,adaxially,age,along,anther,apex,articulated,bark,base,beige,beneath,berry,bluntly,broad-based,broadly,calyx,clavate,cm,common,conical,coriaceous,corolla,deltate,dense,densely,diameter,dioecious,distally,due,echinoid,elliptic,entire,fruit,glabrous,globose,greenish,grey,growth,inflorescence,juvenile,lanceolate,leaf,lengthening,lepidote,less,like,lobe,lobed,long,lower,margin,midrib,mixture,mm,narrowly,nearly,occasionally,often,ovary,pair,pale,pedicel,peduncle,petiole,plant,pore,poricidal,porrect,prickle,prickly,primary,prominent,pubescence,pubescent,ray,ripe,shiny,shrub,small,sparsely,stellate,stem,stigma,straight,style,surface,tan,thick,thin,time,tiny,tip,tree,trichome,truncate,tube,unarmed,underside,vein,visible,white,without,x,yellowish,½	0.15-0.2,0.6-0.7,0.9-1.2,1.1-1.5,2.5-3,20-40,549,almost,anthesi,armed,berr,branched,consisting,deflexed,eaf,eed,ellipsoid,elongate,enclosing,erect,expanding,female,fide,filament,flower,foliose,free,fruiting,glabrescen,greatly,included,internodal,known,lamina,large,likely,male,minutely,new,nflorescence,older,overlappin,packed,papillo,partially,peguero,pericarp,pistillate,planar,plurifoliat,portion,rest,rhachi,rounded,rudimentary,ruit,scar,seen,shoot,short,similar,simple,slit,solitary,somewhat,staminate,stout,tightly,tubular,ud,unarme,unisexual,unit,ympodial	branching,colour,form,glabrescent,height,history,length,life,na,perennial,reproduction,rugulose,seed,shape,size,texture
250	wfo-0001027506	success	215	133	103	112	30	0.479	-0.35,-20,-7,-7.5,.2,/6,0-10,0.1-0.3,0.5-1.5,0.5-6,0.7-1.3,1.2-1.5,1.8,1/3,2-3.2,2.2-3.5,2.5-5,3-5,3-6,3.5-5,6.5-10,7-8,8-10,abaxially,acuminate,acute,andromonoecious,anther,apex,apically,base,becoming,berry,blade,brown,calyx,chartaceous,cm,connivent,cordate,cream,cuneate,dark,densely,diameter,dry,entire,equal,flattened-reniform,fruit,glabrous,green,hard,lateral,leaf,length,lobe,lobed,long,margin,marking,maturity,mauve,midpoint,mm,moderately,narrow-deltate,occasionally,orange,orange-brown,ovate,pale,pedicel,peduncle,petiole,plant,poricidal,purple,ray,shrub,simple,small,smooth,sometimes,spherical,stellate,stellate-pubescent,stem,style,subentire,surface,tapering,terminal,tip,tree,truncate,tube,upper,way,wide,woody,yellow,young	-1,-3,.5,/2,0,0-2,0-6,0-60,0.1-,0.2,0.2-0.3,0.25,0.8-1.5,1-2,1-3,1-4,1.5-2.2,1/6-1/4,10-40,2.5-8,3-10,5-10,5-7,5-merous,6-13,7-9,9-13,acuminat,alyx,ame,apar,apart,apparently,articulated,bark,branched,brow,c.,cell,concolorous,curved,distal,drying,eaf,eed,elongating,erect,filament,fine,flattened,flower,free,fruiting,glabrescent,hermaphrodite,heterostylous,infructescence,lengt,long-styled,longer,lower,lowermost,mature,multangulate,nflorescence,older,one,open,orolla,oung,outline,pair,pendulous,per,pericarp,pit,plurifoliat,porrect,portion,prickl,prickle,prickly,primary,raised,reddish,reduced,reflexed,ruit,scar,sessile,short-styled,spaced,spreading,stalk,stalked,staminat,stout,tamen,terete,tertiary,time,trichome,twice,unarmed,unit,variously,vary,vein,venation,visible,yellow-green,ympodial	adhesion,arrangement,climate,colour,corolla,form,glandular,growth,hair,height,history,inflorescence,life,na,number,ovary,perennial,position,presence,present,pubescence,reproduction,rugulose,seed,shape,size,staman,stigma,stipe,texture
251	wfo-0001027510	success	195	110	82	113	28	0.421	.5,.7,0-0.4,0-0.5,0.2-0.4,0.4-0.9,0.5-0.6,0.5-1.1,0.7-1.5,0.9-3.4,1.5-2,1.5-2.5,2-2.2,2.5-3,2.6-6,3-5,4-5.5,4-6,4-9,5-10,6-13,6-7.5,abaxially,acute,adaxially,anther,apex,base,blade,broadly,calyx,capitate,chartaceous,cm,connivent,cordate,densely,diameter,elliptic,entire,erect,extra-axillary,fruit,glabrous,gland-tipped,globose,green,grey,hair,inflorescence,interpetalar,lanceolate,leaf,length,lobe,margin,mm,obtuse,ovate,pale,pedicel,peduncle,perennial,petiole,purple,ray,red,rhizomatous,rotate-stellate,short,shrub,simple,stellate,stellate-pubescent,stigma,style,succulent,surface,tissue,tube,x,yellow	%,0-0.9,0-2,0-5,0.1-0.3,0.7-1.6,0.8-1.8,1-2,1-3,1-locular,1.5-3,1.5-4,1.6-2,10-12,10-13,10-15,17-35,2-3,2-5,2-foliate,2.6-5.5,3-6,4-5,4-8,5-merou,6,6-8,9-12,absen,absent,abundant,accrescent,across,adult,alyx,apart,apparen,articulated,axe,ba,contiguous,cylindrical,deltate,directed,distall,distributed,eaf,eed,eglandular,exceeding,filament,finger,flower,forke,fruiting,geminat,homostylous,incomplete,juicy,juvenile,lamina,lateral,leafy,lobed,long,lower,mature,mesocarp,midpoint,minute,minutely,nearly,nflorescence,oblique,orolla,pair,part,per,perfect,placenta,pore,porrect,prickle,pseudo-umbellate,pubescent,rachi,reticulate,ruit,septum,sessile,shallowly,soliary,spaced,stalk,stellae,tal,tamen,tem,thick,throughout,time,tissu,transparent,unarme,unarmed,unbranched,unit,upper,usually,vary,wide,without,ympodial	adhesion,arrangement,colour,corolla,dioecious,forked,form,growth,height,history,life,na,number,ovary,plant,position,presence,present,pubescence,reproduction,rugulose,seed,shape,size,staman,stem,stipe,texture
252	wfo-0001027536	success	200	129	99	101	30	0.495	-3,0.4-2.0,1-1.5,1-2,1.5-2,2-10,2-2.5,2-3,2-5,3-3.5,3-5,4,4-10,4-12,4-5,4-8,5-6,5-7,8-10,abaxially,acute,adaxially,anther,apart,apex,apiculate,articulated,base,blade,brown,calyx,cm,connivent,curved,decurrent,densely,depressed-globose,diameter,eglandular,elliptic,entire,ferruginous,flower,fruit,glabrous,gland-tipped,glandular,glandular-stellate,globose,hair,inflorescence,leaf,leathery,lenticular,linear-lanceolate,lobe,long,lower,margin,midpoint,mixed,mm,multiseriate-stalked,oblanceolate,pedicel,peduncle,perennial,persistently,petiole,pubescent,reddish,sessile,short,shrub,similar,simple,slender,slightly,spaced,stellate,stem,stigma,straight,style,subcampanulate,subcoriaceous,subreniform,surface,tip,tomentose,trichome,tube,unbranched,velutinous,villose,white,x,yellow,zygomorphic	-15,2-,2-4,20,3-4,3-forked,30-50,5-10,8-,accrescent,adaxiall,alyx,ape,apical,armed,asymmetric,axe,ba,basal,berry,bicolored,bisexua,branch,branched,chartaceous,clavate-truncat,compressed,dark,distal,dry,eaf,eed,enlarged,epicarp,equal,erect,exceeding,ferruginous-tomentose,filament,fine,fleshy,free,fruiting,gynoecia,held,impressed,introrse,laterally,like,longer,many-foliat,maturit,mostly,multiseriate,nflorescence,one,opening,ornamentation,orolla,part,per,perfect,persistent,pore,prickle,primary,prominent,rachi,recurved,reduced,reflexed,reticulated,ruit,single,small,somewhat,sparsely,splitting,stalk,stamen,staminate,subulate,surrounded,tal,tamen,tem,terete,thick,time,unarme,unarmed,unisexual,unit,upper,upright,usually,vary,vein,wide,yellowish,ympodial	adhesion,arrangement,bisexual,clavate-truncate,climate,colour,corolla,form,growth,height,history,length,life,na,number,ovary,plant,position,presence,present,pubescence,ray,reproduction,rugulose,seed,shape,size,staman,stipe,texture
253	wfo-0001027538	success	137	93	59	78	34	0.431	.5,.9,0-0.1,0.3-0.4,0.4-0.5,0.4-0.85,0.9-1,0.9-1.2,0.9-1.8,1.5-3.5,4-5,8,8-13,absent,acute,adaxially,anther,apex,attenuate,base,blade,brown,calyx,chartaceous,cm,cordate,densely,diameter,entire,extra-axillary,flower,fruit,glabrous,grey-green,hair,inflorescence,length,lobe,margin,mid-point,midpoint,mm,obtuse,ovate,pedicel,peduncle,petiole,present,prostrate,ray,rusty,simple,stellate,stellate-pubescent,thick,tube,unarmed,x,yellow	%,0-1.5,0-2,0.05-0.15,0.1-0.2,0.3-0.45,0.5,0.5-1,0.5-1.5,0.6-1,1,1-4,1.9-2.4,2-4,20-25,5-merou,7-12,?,abaxially,absen,acicular,across,adaxiall,alyx,apart,armed,articulated,axe,ba,directed,distall,distributed,eaf,eed,eglandular,finger,fruiting,gland-tipped,globo,half,lamina,lateral,less,lon,long,lower,mature,midvein,minute,nflorescence,oblique,orolla,part,per,pore,porrect,prickle,ruit,sessile,short,shru,spaced,stage,stalk,stellae,straight,tamen,tem,throughout,time,unbranched,unit,unknow,unknown,uvenile,wide,yellowish,ympodial	-12,adhesion,arrangement,climate,colour,corolla,form,glandular,globose,growth,height,history,leaf,life,na,number,ovary,plant,position,presence,pubescence,reproduction,rugulose,seed,shape,shrub,size,staman,stem,stigma,stipe,style,surface,texture
254	wfo-0001027548	success	216	132	103	113	29	0.477	-11.5,.3,0.3-1.2,0.5-2,1,1-1.5,1-2.5,1-3.5,1.2,1.5-2.5,3-7,4-8,4.5,6-9,acuminate,acute,almost,along,also,anther,apex,attenuate,base,berry,black,brown,c.,calyx,capitate,cm,conical,connivent,corolla,dark,deltate,dendritic,densely,diameter,dull,ellipsoid,elliptic,elongate,entire,flattened-reniform,glabrous,glandular,globose,green,growth,immature,inflorescence,lamina,leaf,like,lilac,lobe,lobed,loose,loosely,margin,matte,membranous,minutely,mm,narrowly,pale,papillae,papillate,pedicel,peduncle,petiole,pitted,puberulent,pubescent,reddish,ripe,scattered,simple,size,sparse,sparsely,stellate,stem,stigma,style,surface,terminal,thickened,tinged,tiny,tip,trichome,tube,uniseriate,upper,usually,vein,vine,way,white,woody,x,yellow	0.2,0.5,1-10,1.5,1.5-2,10-12,10-50,4-6,5-merou,7-10,8-9,abaxiall,adaxially,ag,although,alyx,anthesi,apart,apical,apparently,appearing,area,ark,articulated,articulation,axi,basal,beneath,bent,branch,branched,branching,bu,cell,darker,deflexe,denser,depressed-elliptic,drying,eaf,early,eed,em,exserted,extending,filament,flexuous,flower,free,fruiting,geminat,glabrescen,half,herbarium,ilament,irregularly,leaving,lengthening,less,lon,long,long-styled,lower,many,minute,mixed,near,new,nflorescence,occasionally,older,orolla,outline,pair,papillo,per,perfect,pericarp,planar,plurifoliate,point,pore,poricidal,portion,primary,prominent,rachi,rectangular,revolute,ruit,scar,slender,slit,small,sometimes,somewhat,spaced,specimen,spreading,strongly,swollen,tapering,testal,thin,time,transparent,twinin,type,ud,unit,vary,warty,ympodial	8,adhesion,arrangement,blade,climate,colour,form,fruit,hair,height,history,length,life,midpoint,na,number,ovary,plant,position,presence,pubescence,ray,reproduction,rugulose,seed,shape,staman,stipe,texture
255	wfo-0001027581	success	200	106	65	135	41	0.325	acute,anther,apex,base,berry,broadly,brown,calyx,clavate,cm,connivent,corolla,cup-shaped,dark,deltate,densely,diameter,ellipsoidal,elliptic,entire,evenly,flattened-reniform,globose,golden,green,growth,inflorescence,leaf,length,lobe,lobed,long,loosely,margin,minutely,mm,moderately,pedicel,peduncle,petiole,pitted,plane,pubescent,purple,ray,reddish,ripe,shiny,shrub,simple,size,small,sparsely,stellate,stem,stigma,style,surface,terminal,thin,tree,tube,unevenly,wide,yellow	0.2–0.3,0.3,0.3–1,0.5–1,0.5–1.5,1,1.2–1.5,1.3–1.5,1.5,1.5–2,1.5–3,10,100+,10–16,12,12–30,15–20,1–1.5,1–3-rayed,2.5–3,200,3.5–4.5,3–3.5,4.5–16,4–8,5-merou,6–7,7–10,7–9,8,8–10,9–11,9–9.5,>,abaxial,abaxially,adaxial,ag,along,alyx,anthesi,apar,ark,articulated,axe,beneath,branched,branching,brow,bulbous,c.,clearly,closely,dichasia,discolorous,distally,drying,eaf,echinoid,eed,erec,exserted,filament,flower,free,fruiting,glabrescent,glabrous,gradually,greyish,ilament,lamina,largest,lengthening,less,like,longest,lower,many,midvei,minute,mixed,multangulate,multiseriate,narrowing,near,new,nflorescence,nodding,older,orolla,pair,papillo,part,per,perfect,pericarp,plurifoliate,pore,poricidal,porrect-stellate,portion,primary,reflexed,rhachi,ruit,scar,scarcely,sessile,short-stalked,slit,smaller,spaced,spreading,stalk,stout,tall,tem,time,tip,trichome,ud,undersurface,unit,upper,vary,varying,vein,visible,way,weak,whit,woody,yellowish,ympodial	1-1.5,1.3-1.5,1.5-2,1.5-3,12-30,15-20,2.5-3,3-3.5,4-8,4.5-16,7-10,7-9,9-9.5,adhesion,arrangement,blade,climate,colour,form,fruit,glandular,hair,height,history,life,midpoint,na,number,ovary,plant,position,presence,present,pubescence,reproduction,rugulose,seed,shape,staman,stipe,texture
256	wfo-0001027584	success	144	96	67	77	29	0.465	-2,0.5-1,0.5-1.5,0.9-1,0.9-2.5,1-1.2,1.5-2,1.6-1.9,11.5-45,2-10,3-.,4-6,4-7,4.5-20,anther,base,broadly,calyx,cm,conical,corolla,darker,deltate,densely,diameter,ellipsoid,elliptic,flattened,four,fruit,glabrous,green,herb,lamina,lobe,lobed,long,margin,minutely,mm,nearly,ovary,ovate,pale,papillate,pedicel,peduncle,petiole,reddish,reniform,scattered,shrub,smooth,sparsely,stem,stigma,stripe,style,suffruticose,surface,tan,tip,trichome,tube,uniseriate,white,x	-16,..,.5,1.2-1.4,1.5-8,10-15,100,2,2.5-3,3,7-10,8-9,abruptly,absent,acuminate,anthesi,apex,apical,attenuate,bark,becoming,beginning,beneath,branch,branched,brittle,brow,c.,capitat,cell,cucullate,deflexe,dry,eaf,edicel,eed,erec,filament,flower,fruiting,irregular,lower,markedly,narrowly,nflorescence,open,outer,outline,pair,per,pericarp,planar,plurifoliat,pointed,present,primary,regularly,ruit,scar,single,single-stemmed,sinuate,small,sparse,striate,testal,thickening,thin,time,triangular,tuft,ud,unit,vein,wall,without,ympdoial	adhesion,arrangement,brown,capitate,colour,deflexed,form,growth,height,history,inflorescence,leaf,length,life,na,perennial,plant,plurifoliate,position,presence,pubescence,reproduction,rugulose,seed,shape,size,staman,stellate,texture
257	wfo-0001027585	success	217	119	94	123	25	0.433	0-0.5,0-1,0-2,0.15-0.25,0.25-0.35,0.6-0.9,0.9-1.8,1-3,1-4,10-25,12-23,2-5,2.3-2.8,29-40,3-3.5,3-4,4.5-20,5-8,7-10,7-9,absent,acuminate,acute,anther,apex,base,blade,brown,calyx,chartaceous,cm,connivent,cuneate,cylindrical,deltate,densely,diameter,elliptic,entire,erect,extra-axillary,flattened,flower,fruit,glabrous,globose,green,hair,inflorescence,lanceolate,lateral,leaf,length,lilac,lobe,lobed,long,loosely,margin,mid-point,midpoint,mm,oblate,ovate,pale,pedicel,peduncle,perennial,petiole,plant,present,pubescent,ray,rhizomatous,ripe,rounded,shallowly,shrub,simple,sparsely,sprawling,stellate,stellate-pubescent,stigma,style,thick,throughout,time,tube,unbranched,unripe,vine,x,yellow	%,.05,0,0-15,0-4,0.2-0.3,0.2-0.4,0.5-1,0.7-4.5,1,1.9-2.5,11-15,13-18,15-20,15-30,2-3,2-6,2-foliate,2-locular,22-25,3-7,3.8-4.2,4-8,5-17,5-7,5-merou,6-7,6-8,7-14.5,8-10,8-14,abaxially,absen,accrescent,acicular,across,adaxiall,adaxially,adult,alyx,andromonoecious,anvil-shape,apart,articulated,axe,ba,branch,branche,broad-based,capitat,confined,cross-section,curved,decimetre,directed,distall,distributed,dm,eaf,eed,eglandular,exocarp,finger,fruiting,functional,geminat,gland-tipped,half,heterostylous,interpetalar,juicy,juvenile,lamina,less,longer,lower,mature,mesocarp,midrib,midvein,minute,moist,narrowly,nflorescence,oblique,orolla,pair,part,per,placenta,pore,porrect,prickle,purple,rachi,ruit,scarcely,sessile,short,side,spaced,sparse,stalked,stellae,straight,surface,tal,tamen,tem,tissue,transparent,triangular,unarme,unarmed,unit,upper,vary,vein,weakly,white,wide,yellowish,ympodial	adhesion,arrangement,capitate,climate,colour,corolla,form,glandular,growth,height,history,life,na,number,ovary,position,presence,pubescence,reproduction,seed,shape,size,staman,stem,texture
258	wfo-0001027594	success	168	93	68	100	25	0.405	.5,0.3-1.2,0.7-1,0.7-1.2,1-2,1.5-2,10-15,2.5,2.5-4,3-4,3/4,4-5,anther,base,berry,bright,brown,calyx,capitate,cm,corolla,dark,decurrent,deltoid,dia,flattened-reniform,fleshy,glabrous,glandular,globose,green,hard,immature,lavendar,leaf,lobe,lobed,maroon,minutely,mm,oblanceolate,occasionally,often,opposite,orange,ovary,pale,papillose,pedicel,petiole,pitted,puberulent,ripe,seed,shaped,shrub,stem,stigma,style,surface,tear-drop,tinged,tube,way,white,winged,x,yellow-tan	.1,.2,0.6-1.4,0.9-2.5,1,2-2.2,2-3,2-5,4.7-6.8,5-20-flowered,across,acute,age,anthesi,apex,attenuate,ba,bark,becoming,bi-lobed,body,branch,closely,constriction,curved,difoliate,distal,eaf,edicel,eed,elliptic,erect,especially,extending,filament,free,fruiting,geminat,geminate,incrassate,interpetalar,junction,lateral,lenticellat,less,locule,lon,long,lower,main,major,margin,middle,minor,minute,nflorescence,non-reproductive,oblong,obovate,obovoid,older,one,ovate,overlappin,pair,paler,papillo,pore,poricidal,portion,prominent,raised,reflexed,reproductive,rounded,ruit,scar,shoot,simple,sinus,slender,slightly,small,spaced,straggly,straight,tall,tapering,thin,tip,trichome,two,ud,uniseriate,unit,vein,widest,woody,ympodial,young	adhesion,arrangement,colour,diameter,form,fruit,growth,height,history,inflorescence,length,life,na,peduncle,perennial,plant,position,pubescence,reproduction,rugulose,shape,size,staman,sympodial,texture
259	wfo-0001027600	success	185	144	107	78	37	0.578	0.5-1.5,1,1-14,1-4,1-5,1.5-2,10-,15-25,2-18,2-3,2-3.5,2-4,2-4.5,2-6,2.5-21,2.5-6,20-30,3-15,3-5,3-5-lobed,abaxially,acuminate,acute,adaxial,adaxially,along,apex,apical,basal,base,beyond,blade,calyx,campanulate,cm,collection,concave,cordate,cuneate,deltate,densely,diameter,dilated,distally,ellipsoidal,entire,especially,except,exserted,fading,flattened,fruit,glabrescent,glabrous,gland,glandular-puberulent,greenish-white,leaf,lobe,lobed,main,margin,mature,midrib,minutely,mm,moderately,obconical,oblong,obtuse,occasionally,older,orange,papillose,pedicel,peduncle,petiole,pilose,pinnately,puberulence,puberulent,pubescent,purple,purplish,rarely,rounded,simple,slightly,sparsely,stamen,stigma,strongly,style,subcoriaceous,surface,tip,tree,truncate,tube,two,unlobed,vein,white,x,yellow,yellow-green,young	-10,-3,0.5-1,1-2,1.5-2.5,1/2-3/4,10-20,2-11,2-5,3-6,4-6,4-foliat,5-13,8-17,abruptly,absen,absent,adpressed,aggregate,apart,ape,apiculate,articulated,axe,brow,cell,channe,connective,coriaceous,cream,directed,divided,eaf,eed,elliptic,exceeding,fleshy,flower,forked,laterally,leaving,lon,long,lower,narrowed,nflorescence,nther,orolla,ovate,ovoid,pedicellar,perfect,pilo,pore,puberulen,rachi,radiu,remnant,ruit,shorter,sinus,small,somewhat,spaced,stone,tal,tem,thecae,time,tomento,triangular,ud,unbranched,unit,vary,wide,yellowish,ympodial	adhesion,anther,arrangement,channel,climate,colour,corolla,form,glandular,growth,hair,height,history,inflorescence,length,life,midpoint,na,number,ovary,perennial,plant,position,presence,pubescence,ray,reproduction,rugulose,seed,shape,size,staman,stellate,stem,stipe,texture,tomentose
260	wfo-0001027601	success	204	124	95	109	29	0.466	%,0-0.1,0-3,0.1-0.5,0.2-0.4,0.25-0.4,0.3-0.5,0.4-2,0.5-1.5,0.5-2,1-1.4,1.5-2,1.6-5,13-25,2-15,2.5-3,2.5-6,2.6-4,4-10,7-18,7-8,8-9,acuminate,acute,adaxially,andromonoecious,angularly,anther,apex,base,blade,brown,buff,calyx,chartaceous,cm,connivent,cuneate,deltate,densely,diameter,ellipsoidal,elliptical,entire,erect,extra-axillary,flattened,flower,fruit,glabrous,globose,green,hair,inflorescence,lamina,lanceolate,lateral,leaf-opposed,length,lilac,lobe,lobed,long,margin,midpoint,mm,ovate,pale,pedicel,peduncle,perennial,petiole,plant,present,ray,red,reniform,rhizomatous,shallowly,shrub,simple,sparsely,stellate,stellate-pubescent,stigma,style,surface,throughout,time,toward,tube,white,x,yellow,yellowish	.05,0-10,0-7,0.2-0.8,0.4-0.5,0.5-0.8,0.5-1,1-1.3,1-2,1-locular,10-16,2-6,2.3-4.3,3-5,3-6,3-7,3-foliate,5-merou,6-8,7-20,abaxially,absen,absent,accrescent,acicular,across,adaxiall,adult,alyx,apart,apparen,around,articulated,axe,ba,branche,capitat,confined,congested,contiguous,cylindrical,decimetre,directed,distall,eaf,eed,eglandular,exocarp,filament,finger,fruiting,functional,geminate,gland-tipped,half,heterostylous,incomplete,index,juicy,less,lobing,longer,lower,mature,mesocarp,midrib,midvein,minute,narrow,nearly,nflorescence,oblique,obtuse,orolla,outer,part,per,placenta,pore,porrect,prickle,pseudo-racemose,rachi,reticulate,ruit,septum,sessile,short,side,spaced,stalk,stellae,straight,strongly,succulent,tal,tamen,tem,thick,unarme,unarmed,unbranched,unit,vary,vein,weakly,wide,wing,ympodial	abaxial,adaxial,adhesion,arrangement,capitate,climate,colour,corolla,form,growth,height,history,leaf,life,na,number,ovary,position,presence,pubescence,reproduction,rugulose,seed,shape,size,staman,stem,stipe,texture
261	wfo-0001027606	success	192	106	79	113	27	0.411	0-0.2,0.2-4,0.3-0.8,0.3-1.2,0.4-0.5,0.5-0.75,0.7-0.9,1-1.5,1-2,1-2.5,10-19,2-7,2.5-4,3-4.1,4-6.5,6-8,abaxially,absent,acute,anther,apex,base,blade,broadly,brown,calyx,chartaceous,cm,cuneate,cylindrical,deeply,depression,diameter,entire,extra-axillary,flattened,flower,fruit,glabrous,globose,grey,hair,inflorescence,lanceolate,leaf,length,lilac,lobe,lobed,long,margin,midpoint,mm,narrowly,obtuse,ovate,pale,pedicel,peduncle,perennial,petiole,pinkish,present,pubescence,red,reniform,rhizomatous,rostrate,shrub,simple,stellate,stigma,style,throughout,triangular,tube,vein,x,yellow	%,-10,0-1.5,0-4,0.2-0.3,0.2-2.5,0.5-1,1,1-5,1-7,1-locular,1.5-2.9,12-25,2,2-,2-3,2-4,2-5,2-5.5,3-10,3-4,3-foliate,4-11,5-merou,5.5-7,6-9,7-10,7-22,9-13,absen,accrescent,acicular,adaxiall,adaxially,adult,alyx,apart,apparen,apparently,articulated,axe,ba,branch,branche,branched,directed,distall,distally,dm,eaf,eed,erect,exocarp,filament,finger,fruiting,geminat,gland-tipped,green,half,incomplete,index,juicy,juvenile,lamina,less,lobing,longer,lower,markedly,mature,mesocarp,mid-point,midvein,minute,nflorescence,oblique,occasionally,orolla,pair,part,per,perfect,placenta,pore,prickle,pseudo-racemose,rachi,ruit,scarcely,septum,short,side,spaced,straight,succulent,surface,tal,tamen,tem,thick,thicker,time,truncat,unarme,unarmed,unbranched,unit,upper,usually,vary,wide,ympodial	adhesion,arrangement,climate,colour,corolla,form,glandular,growth,height,history,life,na,number,ovary,plant,position,presence,ray,reproduction,seed,shape,size,staman,stem,stipe,texture,truncate
262	wfo-0001027607	success	167	96	74	93	22	0.443	.1,.5,0.5,0.5-1,0.8-1,1,1-4,1.5-3,2-2.5,2-3,2-4,2.5-3,3-3.5,3/4,5-10,8-9,anther,area,base,brown,calyx,cm,corolla,curling,dark,dia,dry,elliptic,glabrous,globose,golden,green,leaf,less,like,lobed,long,material,minutely,mm,narrowly,occasionally,opposite,ovary,ovoid-reniform,papillose,pedicel,petiole,pitted,plant,poricidal,present,prominent,reddish-brown,shrub,slight,stem,stigma,style,surface,tan,tip,treelet,trichome,tube,unifoliate,uniseriate,vein,way,white,widened,widening,x,yellowish	.25,0.25-0.5,1.2-1.5,4-10-flowered,5-7,acuminate,acute,age,anthesi,apar,apex,arching,aspect,ba,bark,basal,becoming,berry,branch,branche,corky,decurrent,deflexed,deltoid,densely,eaf,edicel,eed,ellipsoid,elongate,erect,evenly,except,exserted,f,filament,filiform,flattened,free,fruiting,geminate,gently,giving,glabrate,lamina,lateral,lenticellat,lobe,lon,lower,m.,main,middle,midrib,minute,narrow,nflorescence,non-reproductive,obovoid,older,pagoda-like,pair,pore,portion,pubescent,raised,rarely,reflexed,ruit,scar,shaped,short,simple,slender,slightly,small,soon,spaced,straight,strongly,styl,tall,tapering,tear-drop,tub,ud,unit,widest,winged,woody,ympodial,young,zig-zag	arrangement,colour,diameter,form,fruit,growth,height,history,inflorescence,length,life,na,peduncle,perennial,position,pubescence,reproduction,rugulose,seed,shape,size,texture
263	wfo-0001027613	success	238	125	99	139	26	0.416	.5,0.1-0.6,0.2-1.6,0.4-1,0.5-0.6,0.5-0.7,1.5-2,1.5-3,2-2.2,2-2.5,2-3,2-5.6,2.3-2.6,3-4,3-5,4-5,4-8,4.5-9.5,5-18,5-8,6-12.5,9-10.5,acute,andromonoecious,anther,apex,attenuate,base,blade,broadly,brown,calyx,campanulate,chartaceous,circular,cm,connivent,cordate,corolla,dark,deltate,densely,diameter,extra-axillary,fruit,glabrous,gland-tipped,glandular,globose,green,hair,herbaceous,inflorescence,inserted,length,lilac,lobe,lobed,margin,midpoint,minutely,mm,moderately,nearly,obtuse,ovate,pale,pedicel,peduncle,petiole,plant,present,prostrate,pubescent,purple,ray,reniform,resprouter,reticulate,rotate,shallowly,short,simple,somewhat,sparsely,sprawling,stellate,stellate-pubescent,stigma,streak,style,surface,tan,throughout,tube,weakly,x,yellow,yellowish-green	%,0-0.1,0.1-0.7,0.3-0.4,0.3-1,0.4-0.5,0.4-1.2,0.4-1.5,0.7-1.5,0.8-1.7,1-1.5,1-1.7,1-10,1-2,1-7,1.2-1.4,1.2-2,1.3-1.8,10-17,12-15,15-100,15-28,2-5,2-7,2-8,2-foliate,2-locular,20-50,3-6,30-100,36-70,4-7,5,5-6,5-merou,7-12,7-8,80-180,9-17,abaxially,absen,absent,abundant,accrescent,acicular,across,adaxially,adult,alyx,and/or,anvil-shape,apart,armed,articulated,axe,ba,bitter,branche,capitat,clear,contiguous,cross-section,curved,cylindrical,decimetre,directed,distall,distally,distributed,eaf,eed,eglandular,exocarp,filament,finger,flattened,flower,fruiting,functional,geminat,half,heterostylous,index,interpetalar,juicy,lamina,lateral,less,lobing,lon,lonf,long,longer,lower,markedly,mature,mesocarp,mid-point,midvein,minute,moist,nflorescence,oblique,orolla,part,per,placenta,pore,porrect,presen,prickle,rachi,ruit,sessile,side,spaced,stage,stalk,stalked,stellae,straight,tal,tamen,tem,thick,thicker,time,tissu,tissue,transparent,triangular,unbranched,unit,uvenile,vary,vein,watery,wide,ympodial	adhesion,arrangement,capitate,climate,colour,form,growth,height,history,leaf,life,na,number,ovary,position,presence,pubescence,reproduction,rugulose,seed,shape,size,staman,stem,stipe,texture
264	wfo-0001027618	success	202	119	93	109	26	0.46	-pubescent,0.5-1,1,1-1.5,1-14,1-23,1-3,1-5,11-16,11-pinnate,15-35,2-11.5,2-27,2-5,2-8.5,2.5-6,3-30,4,5-30,5-7.5,5.5-12,8-35,abaxially,adaxially,also,apex,basal,base,branched,campanulate,capitate,chartaceous,cm,compound,cordate,cuneate,cylindrical,densely,diameter,dilated,distally,ellipsoidal,elliptic-ovate,entire,flower,fruit,fusiform,glabrous,globose,greenish,leaf,length,lobe,long,margin,membranaceous,minutely,mm,oblong,obtuse,orange,papillose,pedicel,peduncle,per,petiole,pilose,pinnately,puberulent,puberulent-pubescent,pubescent-pilose,purple,rachi,reticulate,ripe,shrub,simple,slightly,sometimes,sparsely,stigma,style,sympodial,tomentose,tree,truncate,unbranched,unit,urceolate,white,wide,x,yellow	-10,0-10,0.5,0.5-6,1-,1-13,1-9,1.4-4,1.5-13,1.5-3,1.5-7,1.5-8.5,11-22,12-27,15-30,2-11,2-12,2-9,3-18,3-5,3-7,3-7-pinnate,3.5-6,4-8,5-18,5-20,5-merous,6-25,6-40,7-25,8-16,acuminat,acut,acute,aggregate,alyx,apart,ape,articulated,ascending,axe,beyond,blade,bud,cell,connective,darker,deltate,dia,diamete,directed,eaf,eed,elliptic,exceeding,exserted,fleshy,lateral,laterally,leaflet,leaving,less,lon,longitudinal,lower,mesocarp,moderately,near,nflorescence,nther,obovate,obtu,often,orolla,ovate,pedicellar,perfec,perfect,petiolule,pilo,pore,presen,puberulent-pilo,pubescent,radiu,ranch,ratio,remnant,rown,ruit,runk,shallowly,shorter,small,somewhat,spaced,spreading,stamen,stone,stripe,tal,terminal,thecae,triangular,tube,uni,vary,width,without	abaxial,acuminate,adaxial,anther,arrangement,branch,colour,corolla,form,growth,height,hermaphroditic,history,inflorescence,life,ovary,perennial,plant,position,pubescence,reproduction,seed,shape,size,texture,trunk
265	wfo-0001027622	success	203	113	85	118	28	0.419	0.3-10,1,1-2,1.5-3.5,12-23,2-25,2-6,2.5-3.5,3-4,3.5-11,6-17,6-7,8-16,abaxially,adaxially,along,anther,axillary,blue,blue-purple,broadly,brownish,bud,chartaceous,ciliate,clavate,cm,condition,corolla,diameter,drying,elliptical,especially,fresh,fruit,glabrescent,glabrous,globose,green,greenish,hair,herb,lanceolate,light,like,lobe,long,margin,membranous,middle,midrib,minutely,mm,mottled,narrowly,odd-pinnate,ovate,ovate-lanceolate,ovoid,pale,pedicel,peduncle,pentagonal,petal,plant,puberulent,pubescent,purple,seed,size,slightly,star,stellate,stem,stigma,striped,style,subglabrous,subtending,terminal,tip,tube,whitish,x,yellow	.5,0-14,0-16,1-10,1.5-4.2,1.6-4.5,1/,2-3,3-16,3-4.5,4-5,4-9.5,5-11,5-merou,8-20,acumen,acuminate,acute,ag,alyx,apart,apex,apparently,articulated,axe,base,berry,blade,borne,capitat,cell,connivent,covering,decumben,different,digestion,distal,dorsally,eaf,edge,eed,elliptic,end,enzyme,erect,exceeding,except,filament,flat,flower,folded,forked,geminat,generally,glabrou,greatly,green-white,hair-like,half,homostylous,honeycomb-shaped,interjected,lateral,leaflet,lengthening,living,lower,make,mucilaginous,nflorescence,oblique,often,orolla,pair,perfect,petiole,petiolule,plurifoliate,population,pore,poricidal,proximal,reduced,removed,rounded,ruit,seudostipule,shortly,singly,slit,sometimes,spaced,specimen,stamen,ste,stolo,straight,subequal,tall,tamen,tem,testal,thick,throughout,tri-,truncate,tuber,typically,unit,unwinged,usually,vary,varying,wall,wet,wide,wing,ympodial	1.5,10-14,2,adhesion,arrangement,calyx,capitate,colour,form,growth,height,history,inflorescence,leaf,length,life,na,ovary,perennial,position,pseudostipule,pubescence,reproduction,rugulose,shape,staman,surface,texture
266	wfo-0001027624	success	189	102	77	112	25	0.407	0.1-0.9,0.3-1,1-3,1.1-8.4,1.2-2.6,1.3-2.9,2.4-4.8,3-10,3-11,3-4,4-15.2,4-8,5-9,6-18.5,9-41,acumen,anther,axillary,brownish,bud,cell,clavate,cm,condition,connivent,corolla,covering,deep,densely,diameter,drying,elliptic,entirely,fresh,fruit,glabrous,globose,green,greenish,hair,hair-like,herb,lanceolate,lateral,leaf,like,lobe,long,mm,mottled,odd-pinnate,ovate,ovoid,pedicel,peduncle,pentagonal,plant,pubescent,purple,rotate,seed,short,size,stigma,style,subtending,terminal,testal,thick,tube,usually,wall,white,whitish,wide,x,yellow	0-3,0-7,0.4-3,0.5-1.5,0.8-5.6,1-2,1-5,1.5-6.6,2-20,2-5,2-7,2.9-12,3-5,4-7,5-merou,abaxially,acuman,acuminate,acute,adaxially,ag,along,alyx,apart,apex,apparently,arranged,articulated,axe,base,bead,berry,blade,capitat,considerably,cuneate,decreasing,decumben,decurrent,digestion,distal,dorsally,eaf,edge,eed,enzyme,erect,exceeding,filament,flat,flower,folded,forked,geminat,glabrou,green-white,half,homostylous,honeycomb-shaped,interjected,larger,leaflet,leave,lengthening,light,living,lower,make,middl,moniliform,mucilaginous,multiple,necklace,nflorescence,onto,orbicular,orolla,pair,perfect,petiole,plurifoliate,pore,poricidal,present,rachi,removed,ruit,sessile,seudostipule,slightly,slit,sometimes,spaced,specimen,stamen,stolon,straight,tall,tamen,tem,throughout,tip,toward,tri-,tuber,typically,unit,unwinged,vary,wet,widely,ympodial	adhesion,arrangement,calyx,capitate,colour,form,growth,height,history,inflorescence,length,life,na,ovary,perennial,position,pseudostipule,pubescence,reproduction,rugulose,shape,staman,stem,surface,texture
267	wfo-0001027626	success	152	115	79	73	36	0.52	.3,.5,0.2–0.6,0.5–1,0.7–1,1,1.3–4.5,13–14,2–5,3–4,3–55,4.4–11,4–6,5–6,8,9–18,abaxially,acuminate,adaxially,along,anther,apex,arrangement,base,blade,broadly,calyx,center,chartaceous,cm,cordate,coriaceous,diameter,distichous,elliptical,entire,extra-axillary,fleshy,flower,fruit,glabrous,greenish-white,leaf-opposed,liana,lobe,long,margin,membranous,midvein,minutely,mm,moderately,nearly,oblique,ovate,pedicel,peduncle,petal,petiole,possibly,pubescent,rounded,sand-punctate,scandent,shortly,shrub,somewhat,sparsely,spindle-shaped,stellate,stigma,style,terminal,tip,tube,unknown,white,wiry-woody,x	0.1–0.2,0.5-1,0.7–2.8,1.5–2,1.5–8,14–116,2–3,2–49,3–4.5,3–5,5-merous,accrescen,acute,alyx,apar,axe,berry,c.,capitat,ciliat,clavate,climbing,color,densely,distant,distinct,eaf,eed,filament,frequently,fruiting,glabrou,immature,lamina,lanceolate,line,lower,m.,maturity,mor,nflorescence,nternode,orolla,pair,perfec,pinnate,plurifoliat,pointed,rachi,reflexed,ruit,sand-punctat,scar,secondary,seen,side,simple,slender,spaced,ste,tamen,tem,time,trichome,truncate,two,unbranched,unit,vary,vein,venation,wide,ympodial	adhesion,capitate,climate,colour,corolla,form,glandular,growth,hair,height,history,inflorescence,leaf,length,life,midpoint,na,number,ovary,perennial,perfect,plant,position,presence,pubescence,ray,reproduction,rugulose,seed,shape,size,staman,stem,stipe,surface,texture
268	wfo-0001027627	success	245	138	90	155	48	0.367	.1,1.5,abaxially,acuminate,adaxially,anther,apex,band,base,becoming,blade,broadly,brown,calyx,chartaceous,cm,cordate,corolla,densely,diameter,entire,extra-axillary,flattened-reniform,free,fruit,glabrescent,glabrous,globose,green,hair,half,interpetalar,lateral,lavender,leaf,lighter,linear,linear-lanceolate,lobe,loosely,lower,margin,midpoint,mm,narrow,narrowly,oblong,obtuse,ovary,ovate,pedicel,peduncle,petiole,present,pubescence,pubescent,purple,ray,rounded,shallowly,shrub,simple,sinuate,sinus,slender,small,sometimes,sparsely,splitting,stellate,stellate-pubescent,stellate-tomentose,stem,stigma,stipe,style,surface,tapering,tardily,thick,tissue,tomentose,tree,triangular,tube,usually,velvety,violet,yellow,×	.5,0.05–0.25,0.1–1,0.3,0.4,0.6–1,0–,1.5–2,1.5–2.5,1.8–2.5,11–14,12–25,13–17,1–1.5,1–5,2,2.5–4,2–15,2–4,2–5,2–6,3.5,3–3.5,3–6,4–,4–12,5-angled,5-merou,5–7,6–,6–15,7–10,7–15,9,9–13,9–15,abundant,accrescent,across,along,alyx,ampliate,apart,apparently,articulated,ascending,axe,ba,based,berry,bifurcate,borne,branch,branched,briefly,broad,bud,c.,capitat,caudate,central,contiguous,dense,difoliate,distal,distally,eaf,eed,erect,evident,except,exposed,extensively,fertile,filament,filiform,flower,flowering,geminat,grayish,growt,high,homostylous,internode,interwoven,juvenile,larger,like,line,long,longer,major,middle,midvein,minor,minute,minutely,mostly,much,near,nearly,nflorescence,numerous,occasionally,often,ovoid,paired,par,pitted,portion,prickle,principal,prominently,recurved,reduced,ruit,scattered,short,shorter,side,single,smaller,somewhat,spaced,sparse,spreading,stalk,stalked,stellae,stellate-tomento,stellate-velvety,stemmed,stout,subeaqually,tamen,tawny,thickened,time,tip,trunk,ud,unarmed,unequally,vein,visible,weakly,wide,yello,ympodia,young,zone,×1.5–1.7,–2.5,–30,–5	0-2-15,0.1-1,0.3-0.4,0.6-1,1-1.5,1-5,1.5-1.7,1.5-2.5,1.8-2.5,12-25,2-4,2-6,2.5-4,3-3.5,3-6,4-,4-12,5,6-9,7-10,7-15,9-13,adhesion,arrangement,capitate,climate,colour,form,glandular,growth,height,history,inflorescence,length,life,na,number,perennial,plant,position,presence,reproduction,rugulose,seed,shape,size,staman,texture
269	wfo-0001027630	success	149	91	77	72	14	0.517	.1,.5,0.05-0.1,0.5-1.2,0.5-2,1-5,1.4-1.7,1.5-2,3/4,4-6,5.5-11.2,8-9,acute,anther,apex,bark,base,berry,blunt,broadly,calyx,ciliate,climbing,cm,corolla,decurrent,deltoid,dia,erose,extreme,fruit,glabrate,glabrous,globose,golden,green,hirsute,internodal,knob-like,lanceolate,leaf,linear,lobe,lobed,long,long-acuminate,margin,minutely,mm,near,occasionally,opposite,ovary,papillose,partially,pedicel,petiole,puberulent,pubescent,rounded,shaped,shrub,slender,sparsely,stem,stigma,style,swollen,tear-drop,tip,trichome,tube,uniseriate,way,white,winged,x	.2,0.5-1,1-1.5,2-3,2-6-flowered,6-10,also,anthesi,apart,arising,beginning,branchlet,de,deflexed,densely,distinguishable,eaf,edicel,eed,elongat,except,filament,free,fruiting,globo,immature,indistinct,inflorescenc,irregularly,known,lateral,lon,lower,main,middle,midrib,nflorescence,novo,older,pair,paler,pore,poricidal,portion,prominent,proximal,raised,reflexed,rest,ruit,scar,seen,simple,spaced,straight,strongly,tall,tapering,terminal,thickened,ti,ud,ultimate,unifoliat,unit,vein,wide,widest,wing,yellowish,ympodial,young	colour,diameter,form,growth,height,inflorescence,length,na,plant,position,pubescence,shape,size,texture
270	wfo-0001027646	success	166	93	63	103	30	0.38	0-0.1,0.15-0.25,0.2-1.1,0.4-0.5,0.4-0.6,0.6-0.7,1-3,2-4,3.5-4,5-10,6-13,6-8,absent,acuminate,acute,adaxially,anther,apex,base,blade,brown,calyx,chartaceous,cm,cuneate,densely,diameter,entire,extra-axillary,flattened,fruit,glabrous,gland-tipped,globose,green,grey,hair,inflorescence,length,lobe,margin,midpoint,mm,obtuse,ovate,pale,pedicel,peduncle,perennial,petiole,present,ray,red,reniform,short,shrub,simple,sparsely,stellate,stellate-pubescent,style,x,yellow	%,.4,0-0.2,0-1,0-10,0-2,0.1-0.25,0.5-0.6,0.7-1.2,0.7-1.5,0.7-2,1,1-2,1-6,1-locular,10-18,15-20,2-6,2-foliate,2.1-3.2,4-11,5-merou,6-7,abaxially,absen,acicular,across,adaxiall,adult,alyx,apart,articulated,axe,ba,branche,confined,cylindrical,directed,distall,dm,eaf,eed,eglandular,erect,finger,flower,fruiting,functional,geminat,half,incomplete,juicy,lamina,lateral,less,long,longer,lower,mature,mesocarp,midrib,midvein,minute,moderately,multiradiate,nflorescence,oblique,onl,orolla,part,per,pore,porrect,prickle,probably,pseudo-umbellate,rhizomatous,ruit,septum,solitary,spaced,stage,stalk,stellae,straight,succulen,tal,tamen,tem,thick,throughout,time,transparent,unarme,unarmed,unbranched,unit,unknow,uvenile,vary,wide,yellowish,ympodial	adhesion,arrangement,climate,colour,corolla,form,glandular,growth,height,history,leaf,life,na,number,ovary,plant,position,presence,pubescence,reproduction,seed,shape,size,staman,stem,stigma,stipe,succulent,texture,tube
271	wfo-0001027661	success	222	139	111	111	28	0.5	+,0.5,0.5-,0.5-2,0.6-1.1,0.6-1.5,1-1.5,1-7,1.2-6,1.5,1.5-2,2.5-7,4-15,4.5-6,5-9,6-12,<,abaxially,acuminate,acute,anther,anthesi,apex,base,branch,bright,broadly,calyx,capitate,cm,column,conical,connivent,cordate,corolla,deeply,dendritic,densely,diameter,ellipsoid,entire,extremely,flattened,fused,glabrous,globose,grey,growth,herbaceous,lamina,lateral,leaf,like,lobe,lobed,long,margin,membraneous,minutely,mixture,mm,occasionally,pale,papillate,pedicel,peduncle,petiole,pinnatifid,pitted,pubescence,pubescent,purple,rarely,red,reniform,ripe,shape,shiny,short,simple,single,size,stellate,stem,stigma,style,surface,tan,terminal,ternately,thin,tightly,tip,triangular,trichome,truncate,tube,two,type,uniseriate,variable,vein,vine,violet,way,white,wide,woody,yellow,yellowish,¾	-10,1-,1-5,1.3,2,2.5-3,30,4-8-celled,40,5-merou,6-8,6-9,8-10,>,adaxiall,ag,along,alyx,apart,ark,articulate,axi,basal,berry,branched,cell,commonly,creeping,denser,density,eaf,eed,elliptic,even,filament,flower,free,fruiting,gre,green,ground,hue,ilament,irregularly,leaf-opposed,leaving,lengthening,long-exserted,lower,many,markedly,minute,moderately,narrowing,near,new,nflorescence,often,older,open,orolla,outline,ovate,pair,papillat,papillo,peg,pentagonal,per,perfect,pericarp,plurifoliat,pointed,pore,poricidal,portion,primary,prominent,pubescen,purplish,rachi,reflexed,ruit,scar,sinus,sleeve,slender,slit,small,spaced,sparsely,spot,spreadin,spreading,strongly,swollen,tangled,tem,testa,time,trailing,turbinate,ud,underground,unieriate,unit,upper,usually,vary,ympodial,zig-za	adhesion,arrangement,blade,climate,colour,form,fruit,glandular,hair,height,history,inflorescence,length,life,midpoint,na,number,ovary,plant,position,presence,ray,reproduction,rugulose,seed,staman,stipe,texture
272	wfo-0001027714	success	251	143	131	120	12	0.522	+,.5,/3,0.5,1-,1-1.5,1-1.6,1-2,1.5-2,1.5-5,14-16,2-,2-2.5,2-8,2.5-,2.5-4,3-3.5,4-10,4-5,4.5-5,5,5-6,6-7,7-20,abaxial,abaxially,acuminate,acute,adaxial,adaxially,almost,anther,apex,basal,base,berry,bright,brown,calyx,capitate,cm,conical,connected,cordate,corky,corolla,cucullate,deep,dendritic,densely,diameter,ellipsoid,elliptic,elongate,entire,filament,flattened,fleshy,fruit,furcate,glabrate,glabrous,globose,growth,individual,inflorescence,juicy,lateral,leaf,like,lobe,lobed,long,margin,marginal,minutely,mm,obovate,occasionally,often,otherwise,ovary,pair,pale,papillate,pedicel,peduncle,petiole,pinnatifid,primary,prominent,pubescence,pubescent,purple,red,reddish,reniform,ripe,seed,shiny,similar,simple,slender,slightly,small,somewhat,sparsely,stellate-rotate,stem,stigma,style,surface,tangled,terminal,thick,tip,trichome,truncate,tube,uniseriate,upper,usually,vein,vine,violet,way,weak,woody,x,yellow,yellowish	0,0.4,0.5-0.7,0.6-0.7,0.9-1.5,1,1.5-2.5,1.5-3,2373.,5-10,5-merou,80,<,age,aid,along,alyx,angle,anthesi,apar,apice,appearance,ark,around,articulated,axi,branched,canop,cell,channelled,climbin,confined,connivent,creating,cupped,deflexed,denser,drying,eaf,eed,enlarged,especially,exserted,fide,flower,free,fruiting,giving,glabrou,groove,hairy,hanging,ilament,immature,inflated,irregularly,lamina,large,leaving,lengthening,lon,longer,loosely,lower,many,mature,mere,minute,mpodial,nee,new,nflorescence,nodding,older,orolla,outline,papillo,peg,per,perfect,pericarp,petal,petiolule,pitted,plat,plurifoliat,pore,poricidal,portion,reaching,rectangular,rim,ruit,scar,showy,sleeve,slit,spaced,spreading,strongly,tem,testa,testal,thecae,thickened,thin,third,time,tiny,tooth,twining,ud,uniformly,unit,visible,wall,weight,widest,wing,younger	arrangement,bark,colour,form,furcation,length,pattern,position,shape,size,texture,type
273	wfo-0001027719	success	172	98	72	100	26	0.419	%,0-0.15,0.15-0.4,0.25-0.6,0.3-0.5,0.3-0.7,0.6-2.8,0.9-1.1,1.6-1.9,13-25,2-2.3,3-5,3-7.5,4-5,4-6,4-7,4.5-12.5,5-6,5-8,8-13,acute,adaxially,andromonoecious,anther,apex,attenuate,broadly,brown,calyx,chartaceous,cm,densely,diameter,entire,extra-axillary,fruit,gland-tipped,globose,green,hair,herbaceous,inflorescence,lamina,length,lilac,lobe,lobed,long,margin,mm,moist,obtuse,ovate,pale,pedicel,peduncle,petiole,plant,present,ray,resprouter,shallowly,short,simple,sparsely,stellate,stellate-pubescent,stem,style,tube,x,yellow	.25,0-0.2,0-1,0-20,0-7,0.25-0.4,0.4-1.7,0.6-0.8,0.8-1,1-1.5,1-2,1-3,1.1-2,10-24,13-20,3-7,30-70,5-merou,6-10,6-8,7-11,abaxially,absent,acicular,across,adaxiall,alyx,apart,armed,articulated,axe,ba,base,blade,cuneate,d.,difoliate,directed,distall,distributed,dult,eaf,eed,eglandular,erect,exocarp,finger,flower,fruiting,functional,geminat,greenish-white,half,heterostylous,hig,juic,lateral,less,longer,lower,mature,mesocarp,mid-point,midpoint,midvein,minute,nflorescence,oblique,orolla,part,per,pore,porrect,presen,prickle,pseudo-racemose,ruit,sessile,solitary,spaced,sprawling,stage,stalk,stellae,straight,strongly,tamen,thick,throughout,time,unarme,unbranched,unit,unknow,uvenile,vary,vein,white,wide,ympodial	adhesion,arrangement,colour,corolla,form,growth,height,history,juicy,leaf,life,na,number,ovary,perennial,position,presence,pubescence,reproduction,seed,shape,size,staman,stigma,stipe,texture
274	wfo-0001027720	success	184	104	81	103	23	0.44	%,0.25-0.35,0.3-5,0.4-0.7,0.5-0.8,0.8-1,1-2,1-3.5,1.5-2,13-35,2-3,2-4,4-5.5,4-7,4.3-15,7-10,7-8,8-16,acute,adaxially,anther,apex,base,blade,brown,calyx,chartaceous,cm,connivent,cuneate,deltate,densely,diameter,elliptic,entire,erect,extra-axillary,flattened,flower,fruit,glabrous,globose,hair,inflorescence,lamina,lanceolate,leaf,length,lilac,lobe,long,loosely,margin,mm,narrowly,notched,ovate,pale,pedicel,peduncle,perennial,perfect,petiole,present,pubescent,red,rhizomatous,shrub,simple,slightly,sparsely,stellate,stellate-pubescent,stigma,style,subreniform,toward,triangular,tube,x,yellow	.25-0.3,0,0-15,0.15-0.25,0.4-0.8,0.5-1,0.6-1.2,1-1.5,1-locular,13-23,15-25,2-7,2-branched,2-foliate,2.8-3.1,23-35,3-13,4-,4.3-7.5,5-merous,6,7-9,8-11,9-15,abaxially,absen,absent,adaxiall,adult,alyx,apparently,articulated,axe,ba,berry,capitat,confined,cylindrical,directed,distall,distally,eaf,eed,eglandular,filament,finger,fruiting,geminat,gland-tipped,green,half,hig,homostylous,incomplete,intepetalar,juicy,juvenile,lateral,less,lower,markedly,mature,mesocarp,mid-point,midpoint,midrib,minute,nflorescence,oblique,orolla,part,per,perfec,pore,porrect,prickle,rachi,ray,ruit,scarce,septum,sessile,short,stellae,straight,succulen,surface,tamen,tem,thick,thicker,time,tissue,unarme,unarmed,unit,upper,vary,white,wide,without,yellowi,ympodial	adhesion,arrangement,capitate,colour,corolla,form,growth,height,history,life,na,ovary,plant,position,presence,pubescence,reproduction,seed,shape,size,staman,stem,texture
275	wfo-0001027720	success	272	141	89	183	52	0.327	0.9,2.0,acuminate,acute,adnate,anther,apex,apiculate,attachment,attenuate,base,becoming,bilobed,blade,calyx,cancellate,capitate,cm,conical,corolla,cream,dentate,developed,diameter,elliptic,entire,extra-axillary,flattened-irregular,flattened-orbicular,flattened-reniform,flower,fruit,glabrous,glandular,globose,growth,hair,interpetalar,lateral,lavender,leaf,lobe,long,margin,midpoint,minute,mm,moderately,nearly,notched,orange,ovate,pedicel,peduncle,petiole,point,poorly,porrect,pubescent,ray,red,sessile,short,shrub,simple,slightly,small,stellae,stellate,stem,stigma,straight,style,subacute,subcoriaceous,surface,tip,tissue,toward,tree,truncate,tube,violet,wavy,way,white,yellow,yellow-ferruginous,yellow-tan	.0,.04,.2,.3,.5,.9,0,0.1–0.6,0.2–0.4,0.3–0.4,0.7–0.9,0.7–1.1,0.7–1.2,0.8–1.3,0.8–1.9,0.8–2.0,1.4–1.9,1.5–1.7,1.5–2.0,1.5–2.5,1.5–3.3,1.5–9.0,1.7–1.8,1.7–2.0,1.7–2.5,1.8–2.0,1.9–2.2,1/2,1/3,1/3–1/2,10.0,10.8–18.2,12–16,13.0,19.7–30.0,2.5,2.5–2.8,2.5–2.9,2–3,3.2,3.6,3.7–5.7,3.9,4.0–12.6,4.0–18.0,4–5-merou,5.1–18.6,6.5–9.5,6–8,8.0,8.0–11.9,8.2–10.5,8.5–9.4,9.5–16.0,abaxially,adaxially,aequilateral,alyx,anthesi,apical,apparently,appearing,armed,articulated,axe,ba,berry,branch,broad,broad-based,brochidodromous,bud,channel,channeled,colore,concave,congested,connivent,crisped,curved,deciduous,dehiscence,densely,difoliate,distally,dorsally,dry,eaf,eed,either,emerging,endocarp,erect,especially,exocarp,fertile,filament,filiform,free,geminat,glossy,gradually,heavily,homostylous,hooked,inclined,increasing,internode,intersepalar,juic,juvenile,lamina,large,least,like,line,lon,longer,lower,m.,major,mature,midrib,midvein,minor,narrowly,nflorescence,oblique,oblong,occasionally,often,orolla,part,per,perforate,pore,porrect-stellate,portion,potentially,presumably,prickle,proximal,raised,reflexed,rigid,rip,row,ruit,scattered,shorter,side,sinus,soon,sparsely,splitting,spread,stamen,stellate-pubescen,stellate-pubescent,suture,tall,tamen,tem,thin,time,translucent,triangular,twice-branched,two,ud,unarmed,upper,vary,vein,weakly,wide,yellow-ferruginou,ympodia,young,youngest,±equal,×,–4	0.04,0.1-0.6,0.2,0.2-0.4,0.3-0.4,0.7-1.1,0.8-2.0,1.3,1.4-1.9,1.5,1.5-2.5,1.5-3.3,1.5-9.0,1.7-2.5,1.8-2.0,1/3-1/2,19.7-30.0,2-4,3.7-5.7,4.0-12.6,4.0-18.0,5.1-18.6,6-8,6.5-9.5,8.0-11.9,adhesion,arrangement,climate,colored,colour,form,height,history,inflorescence,length,life,na,number,ovary,perennial,plant,position,presence,present,pubescence,reproduction,seed,shape,size,staman,stipe,texture
276	wfo-0001027735	success	166	100	69	97	31	0.416	.7,.75,0.25-0.5,0.5-3,1.3-3.5,1.7-3.5,2-2.5,2-3.5,2.5-3,3.5-5,4-5,4-8,5,5-5.8,7-10.5,8-11,absent,acuminate,acute,anther,apex,attenuate,base,blade,brown,calyx,chartaceous,cm,diameter,erect,extra-axillary,flower,fruit,hair,inflorescence,lateral,length,lobe,lobed,long,margin,mid-point,mm,obtuse,ovate,pale,pedicel,peduncle,perennial,petiole,pinkish,present,ray,rhizomatous,rotate-stellate,shallowly,shrub,simple,sparsely,stellate,stellate-pubescent,style,thick,throughout,time,tube,white,x,yellow	%,0-0.1,0-1,0-4,0-5,0.15-0.2,0.3-0.6,0.4-0.8,0.5-0.8,1,1-2,1.3-1.6,1.9-2.2,10-14,11-17,12-15,2-8,20-35,25-50,3-8,30-50,4-6,5-merou,9-12,abaxially,abundant,acicular,across,adaxially,adult,alyx,apart,armed,articulated,axe,ba,branche,directed,distall,distributed,dm,eaf,eed,eglandular,finger,fruiting,geminat,glabrou,gland-tipped,globo,green,half,index,lamina,less,lobing,longer,lower,mature,midpoint,midvein,minute,moderately,nflorescence,oblique,orolla,part,per,pore,porrect,presen,prickle,pseudo-racemose,purpl,ruit,sessile,short,side,spaced,sparse,stage,stalk,stellae,straight,tal,tamen,tem,transparent,unarme,unbranched,unctional,unit,unknow,uvenile,vein,wide,ympodial	.3-0.6,adhesion,arrangement,colour,corolla,form,glabrous,glandular,globose,growth,height,history,leaf,life,na,number,ovary,plant,position,presence,pubescence,purple,reproduction,seed,shape,size,staman,stem,stigma,stipe,texture
277	wfo-0001027742	success	239	119	89	150	30	0.372	0-0.2,0.1-0.5,0.4-0.8,0.5-5,0.6-0.8,1-1.2,1-2,2-2.5,2-3,2-6,2.5-5,3-6,3-9,3.5-10,4-6,4-lobed,7-10,7-8,7-9,absent,acute,adaxially,annual,anther,apex,attenuate,base,black,blade,broadly,brown,calyx,chartaceous,cm,connivent,cordate,densely,depressed,diameter,drying,entire,extra-axillary,finally,fruit,glabrous,globose,grey-green,hair,inflorescence,ivory-green,lanceolate,length,lilac,lobe,lobed,loosely,margin,midpoint,mm,moderately,obtuse,ovate,ovate-lancelate,pale,pedicel,peduncle,perennial,petiole,present,purple,ray,rhizomatous,rostrate,rusty,shallowly,shrub,simple,somewhat,square,stellate-pentagonal,stellate-pubescent,stem,stigma,style,surface,truncate,tube,yellow,yellowish-green	%,-13,-20,-8,-9,0-0.8,0-1.1,0-12,0-3.5,0-9,0.05-0.1,0.1-0.4,0.6-0.9,0.7-0.9,0.8-1.8,1-,1-1.1,1-1.5,1-1.8,1-3,1-4,1-5,1-8,1.7-2,10-18,10-20,2-,2-2.3,2-5,2-5.5,2-foliate,200-660,25-55,3-4,3-5,3.5-9.5,4-locular,5-12,5-merou,60-300,9-14,abaxially,abundant,accrescent,acicular,adaxiall,alyx,anthesi,anvil-shape,apart,armed,articulated,axe,ba,bent,broad,capitat,cone,cross-section,curved,cylindrical,decimetr,directed,distall,distally,distributed,dult,eaf,eed,eglandular,enclosing,erect,especially,exceeding,exocarp,filament,finger,flower,fruiting,geminat,gland-tipped,homostylous,index,interpetalar,juicy,lamina,lateral,lobing,lon,long,longer,lower,markedly,mature,mesocarp,mid-point,midvein,minute,minutely,moist,nflorescence,oblique,one,orolla,outside,part,per,perfect,placenta,pore,porrect,presen,prickle,prostrate,pseudo-racemose,rachi,reticulate,rounded,ruit,short,side,slightly,spaced,stage,stalk,stalked,stellae,straight,strongly,tal,tamen,thick,thicker,thicknes,throughout,time,tip,tissue,toward,unbranched,unit,unknow,uvenile,vary,vein,white,wide,x,yellowish,ympodial	2-9.5,adhesion,arrangement,capitate,climate,colour,corolla,form,glandular,growth,height,history,leaf,life,na,number,ovary,plant,position,presence,pubescence,reproduction,rugulose,seed,shape,size,staman,stellate,stipe,texture
278	wfo-0001027757	success	186	87	49	137	38	0.263	anther,anthesi,axillary,blue,brown,calyx,campanulate,clavate,cm,colour,dark,deeply,diameter,equal,erect,flattened,fruit,glabrous,globose,leaf,lilac,mm,moderately,oblong,ovate,pale,pedicel,peduncle,perennial,petiole,pitted,pubescent,rotate,shrub,simple,sparsely,stigma,style,surface,tube,unknown,violet,x,yellow,–19,–2.7,–3.2,–5.5,–6	0.2,0.2–0.3,0.3–2.0,0.5,0.6,0.6–1.0,0.7,0–1.4,1.0–1.1,1.0–2.5,1.2–4.0,1.5–1.6,1.5–2.5,1.6–2.4,1.9–2.7,12,1–1.5,1–11,1–2,1–3,2,2.5,2.5–4,2.5–5.5,2.5–7,2–,2–10,3–12,3–5,4–9,5,5–,60–100,6–9,7–8,8–16,abaxially,absen,accrescent,acute,adaxiall,adaxially,ag,along,apart,apex,apical,arising,articulated,axe,ba,basal,base,blade,borne,branching,cell,chartaceous,concave,connivent,convex,cylindrical,decurrent,densely,directed,distally,eaf,eed,elliptic,entire,erose,filament,fleshy,flower,geminat,glabrescen,glabrou,hair,irregularly,lanceolate,leafy,lobe,lobed,lon,long,longitudinal,lower,m.,margin,multicellular,narrowly,nflorescence,obtuse,occasionally,often,opening,opposed,orolla,pair,perfect,plurifoliate,pore,poricidal,primary,probably,regularly,rootstock,ruit,secondary,serrate,shoot,side,slit,smaller,sometimes,spaced,stone,straight,tall,tamen,tem,thic,thickened,time,tip,toward,unbranched,unicellular,uniseriate,unit,vary,white,wide,woody,ympodial,–4.0,–9	0-1.4,0.2-0.3,0.3-2.0,1-1.5,1-3,1.0-1.1,1.2-4.0,1.5-1.6,1.5-2.5,2-10,2.5-4,2.5-5.5,4-9,6-9,60-100,8-16,adhesion,arrangement,corolla,form,growth,height,history,inflorescence,length,life,na,ovary,plant,position,pubescence,rugulose,seed,shape,size,staman,stem,texture
279	wfo-0001027765	success	167	82	61	106	21	0.365	-30,-44,0.8,1,1-10,1-11.5,1-5,1.5-6,10-13,2-2.5,2-3,2-4,2.5-4.2,20-30,3-12,5-6,5-8,abaxially,calyx,cm,connate,corolla,diameter,distal,forked,glandular,globose,green,green-white,hair,half,herbaceous,interjected,lateral,leaf,leaflet,light,long,mm,odd-pinnate,ovate,ovate-lanceolate,ovoid,pedicel,peduncle,perennial,petiole,pilose,plant,seed,simple,size,stellate,stigma,style,terminal,tone,violet,white,wide,yellow	-4,0-.,1-,1-2,1-4,2.5-4,3-,3-20,3-6-foliat,5,5-15,7-20,abaxial,abruptly,acumen,acuminate,acute,apex,apical,apically,apiculate,articulate,base,branched,cell,cordate,covering,cuneate,cyme,dehiscent,dichasial,dichasially,digestion,diminishing,dorsally,eaf,ebracteate,edge,eed,elliptic,elliptic-lanceolate,emoval,enzyme,exceeding,filament,flat,flower,folded,generally,globo,hair-like,honeycomb,introrse,living,lobe,lon,lower,lunat,make,maturing,monochasial,mucilaginous,nflorescence,nther,oblique,obtuse,often,orolla,ovate-elliptic,pair,pattern,perfect,petiolate,petiolule,plan,poricidally,proximal,reveal,rounded,ruit,sessile,seudostipule,short,side,slightly,slit,specimen,stamen,straight,tal,tem,testal,thick,throughou,throughout,tip,toward,truncate,tuber-bearing,typically,unit,vary,wall,without,ympodial,¼	0-2,3-15,anther,arrangement,colour,form,fruit,growth,height,history,inflorescence,length,life,na,number,ovary,position,reproduction,shape,stem,texture
280	wfo-0001027767	success	184	109	77	107	32	0.418	1,1-1.5,1.0-2,1.5-1.8,1.5-2,10-20,3,3.5-5,4-5,5-6,5-8,7-8,acute,anther,apex,attenuate,base,beige,blade,brown,calyx,campanulate,clavate,cm,coriaceous,dark,dark-green,deeply,diameter,entire,ferruginous,fruit,glabrous,glandular,glandular-stalked,globose,hirsute-glandular,irregularly,lanuginose,leaf,lobe,lobed,long,minutely,mm,oblanceolate,oblong-lanceolate,oval-elliptic,parted,pedicel,peduncle,petiole,plant,pubescent,ray,reniform,shiny,shrub,similar,solitary,stellate,stem,stigma,style,sub-globose,sub-truncate,subcoriaceous,subreniform,terminal,thick,trichome,tube,villous,white,wide,within,yellowish	0.3-0.5,1-2,10-12,15-25,2-2.5,2-3,2.6-3,3-6-branched,30-many-flowered,4-many-celled,5-7,5-merous,8-9,abaxial,accrescent,across,along,alyx,anthesi,armed,articulate,attenuat,bicolorous,branch,central,curved,cyme,distal,eaf,eed,enlarged,epicarp,equal,erect-branched,exceeding,filament,floral,flower,free,fruiting,geminat,glandular-stalke,glandular-stellate,gynoeci,helicoid,indument,long-exserted,longer,lower,many-celled,midrib,multiangulate,nflorescence,numerous,orolla,papillo,part,peduncl,pendent,perennia,perfect,persistent,persistently,plurifoliate,porrect-stellate,prickle,primary,prominent,rachi,ranch,recurved,reduced,reflexed,rugose,ruit,secondary,sessile,short,small,somewhat,sparse,sparsely,stalked,stamen,staminate,straight,sub-conic,sub-sessile,surfac,surrounded,tall,tamen,terete,tomentose,unarmed,uniseriate,unit,vary,vein,viscid-glandular,viscid-villous,winged,withi,without,yellow,ympodial,young	adhesion,arrangement,climate,colour,corolla,form,growth,hair,height,history,inflorescence,length,life,margin,midpoint,na,number,oblancoate,ovary,papillose,perennial,position,presence,present,pubescence,reproduction,seed,shape,size,staman,stipe,texture
281	wfo-0001027768	success	214	124	97	117	27	0.453	.5,0-0.1,0-0.2,0-0.3,0.1-0.3,0.1-0.4,0.15-0.25,0.15-0.3,0.3-1.5,0.5-3.4,0.6-0.9,1-2.5,1.2-1.4,1.5-2,2-2.5,2.9-3.7,3-15,4-5,6-6.5,8-10,abaxially,absent,adaxially,anther,apex,attenuate,base,black,blade,brown,calyx,chartaceous,cm,cuneate,dark,deltate,densely,diameter,elliptical,entire,flattened,fruit,glabrous,gland-tipped,globose,green,grey,hair,inflorescence,lanceolate,lateral,leaf,leaf-opposed,length,light,lobe,long,margin,midpoint,minutely,mm,nearly,oblique,obtuse,pale,part,pear-shaped,pedicel,peduncle,perennial,petiole,present,purple,ray,reticulate,rhizomatous,short,shrub,simple,smooth,sparsely,stellate,stellate-pubescent,stigma,streak,style,subcoriaceous,surface,time,toward,tube,turning,unarmed,violet,white,x,yellow	%,0,0-2,0.2-0.3,0.25-1,0.3-0.6,0.3-0.7,0.5-1.5,0.6-1.5,1,1-2,1.2-1.8,1.2-3.4,1.7-2.6,10-15,11-14,15-50,18-35,2-7,2-locular,3,3-4.5,4-,5-7,5-merou,6-12,6-15,7-10,8-12,8-16,abaxiallly,accrescent,acicular,across,adaxiall,adult,alyx,apart,articulated,axe,ba,branchlet,capitat,confined,connivent,contiguous,curved,cylindrical,difoliate,directed,distall,distributed,dm,eaf,eed,eglandular,erect,exocarp,filament,finger,flower,fruiting,geminat,greenish-white,grey-green,half,hig,juicy,juvenile,lamina,less,longer,loosely,lower,mature,mesocarp,mid-point,midrib,midvein,minute,moist,narrowly,nflorescence,orolla,per,perfect,placenta,pore,porrect,prickle,pseudo-racemose,pubescent,rachi,reddish,ruit,semi-circula,sessile,solitary,somewhat,spaced,spongy,sprawling,stellae,straight,tamen,tem,thick,throughout,triangular,unarme,unbranched,unit,vary,wide,winged,yellowish,ympodial	adhesion,arrangement,capitate,climate,colour,corolla,form,glandular,growth,height,history,life,na,number,ovary,plant,position,presence,pubescence,reproduction,rugulose,seed,shape,size,staman,stem,texture
282	wfo-0001027770	success	242	125	97	145	28	0.401	0.1-0.3,0.2-2,0.3,0.6-1.2,0.8-2.5,1-2,1-3,1.5,10-14,12,12-14,16,2,2-3,2-4,2.5-3,3,3-5,3-6,4,4-8,6,6-10,7-15,9,abaxially,adaxially,anther,apex,base,berry,blade,calyx,clavate,cm,cuneate,cuspidate,dark,densely,diameter,elliptic,entire,equal,flattened,fruit,glabrous,globose,herbaceous,lateral,leaf,length,lobe,lobed,long,margin,maturity,midpoint,mm,mostly,narrowly,obtuse,orange,orange-brown,ovoid,pale,pedicel,peduncle,petiole,plant,present,pubescent,ray,reniform,rounded,sessile,shallowly,simple,smooth,spherical,spreading,stellate,stellate-pubescent,stem,stigma,style,subsessile,tapering,terminal,thin,trichome,tube,usually,violet,white,wide,woody,yellow	0-45°,0.1-0.15,0.15,0.3-2,0.5,0.5-1,0.5-2,0.8-1.5,1-2.5,1-5,1.5-2,1/2-1/6,2-6,2/3,20,3-4,4-6,4-7,5-30,5-merous,50,7,acute,ag,almost,alyx,anthesi,apart,apically,apparently,armed,articulated,bark,branching,brown,c.,concolorous,deltate,dense,difoliate,dilated,distance,drying,eaf,eed,elongating,erect,extending,eye,filament,filiform,flat,flower,free,fruiting,geminat,gray,green,horizontal,infructescence,irregular,lanceolate,lengthening,less,like,lon,longer,lower,markedly,mature,midvein,naked,nflorescence,oblique,obscured,often,older,orolla,oung,ovate,pair,papillate,papillo,pendulous,per,perfect,pericarp,pore,poricidal,porrect,portion,prickle,prickly,primary,prominent,pubescenc,raised,rare,rarely,red,reduced,reduced-multangulat,reflexed,ruit,scar,short-styled,side,slightly,small,sometimes,somewhat,spaced,sparse,sparsely,stalk,staminat,stolon,straight,stump,surface,tall,tamen,terete,tertiary,throughout,time,tip,toward,unarme,unarmed,underground,uniform,unit,variously,vary,vein,venation,visibl,visible,way,white-green,yellow-green,ympodial,young,½	20-50,adhesion,arrangement,climate,colour,corolla,form,glandular,growth,hair,height,history,inflorescence,life,na,number,ovary,papillose,position,presence,pubescence,reproduction,seed,shape,size,staman,stipe,texture
283	wfo-0001027807	success	116	91	52	64	39	0.448	0-0.2,0.1-1,0.2-0.3,0.2-0.9,0.3-0.4,0.9-1,0.9-2.5,2-5,3.5-9,acuminate,acute,apex,attenuate,base,brown,cm,decurrent,diameter,dry,elliptic,flattened,glabrous,globose,grayish,green,growth,internodal,lanceolate,leaf,leaf-opposed,margin,material,minutely,mm,narrowly,occasionally,pedicel,peduncle,petiole,pitted,reddish,reniform,revolute,shrub,simple,slightly,small,stem,surface,tree,winged,x	.5,1-1.5,15-30,2-6,abaxially,adaxially,almost,barely,bark,berry,brittle,bud,closely,deflexe,deflexed,difoliate,drying,eaf,eed,ellipti,flower,fruiting,geminat,gray,know,known,maturity,midrib,new,nflorescence,older,ot,overlapping,pair,pale,paler,papillae,papillate,parallel,plane,primary,prominent,rachi,reddi,reproductive,ruit,scar,seemingly,shoot,slender,somewhat,spaced,sparsely,thickened,ud,unifoliate,unit,usually,vein,visible,white,yellowish,ympodial,young	adhesion,anther,arrangement,blade,calyx,climate,colour,corolla,form,fruit,glandular,hair,height,history,inflorescence,length,life,lobe,midpoint,na,number,ovary,plant,position,presence,pubescence,ray,reproduction,rugulose,seed,shape,size,staman,stellate,stigma,stipe,style,texture,tube
284	wfo-0001027808	success	178	96	68	110	28	0.382	.5,.7,0.2-0.3,0.2-0.35,0.5-0.6,0.5-3,0.6-1.2,1-2,1.6-3,1.9-2.4,12-18,2.5-3.5,5-7.5,5.5-6.5,7-8,8-12,absent,acuminate,acute,adaxially,andromonoecious,anther,apex,base,blade,broadly,brown,calyx,chartaceous,cm,cuneate,deltate,densely,diameter,extra-axillary,fruit,globose,hair,inflorescence,lavender,length,lobe,lobed,long,margin,midpoint,mm,ovate,pale,pedicel,peduncle,perennial,petiole,plant,present,ray,rostrate,shallowly,simple,sparsely,stellate,stellate-pubescent,stigma,style,tube,vine,x,yellow	%,.2,0-0.1,0-7,0.05-0.2,0.25-0.35,0.3-0.6,0.4-0.8,0.4-1,0.5-1,0.6-1.4,1,1-1.3,1.1-1.3,1.4-1.8,15-30,2-4,2-foliate,2.5-4,20-30,23-28,3-11,40-120,5-7,5-merou,6-8,7-10,70-90,9-14,abaxially,acicular,across,adaxiall,alyx,apart,armed,articulated,axe,ba,broad-based,capitat,curved,d.,directed,distall,distributed,eaf,eed,eglandular,finger,flower,fruiting,functional,geminat,gland-tipped,green,half,heterostylous,index,lamina,lateral,less,lobing,longer,lower,mature,mid-point,midvein,minute,nflorescence,oblique,orang,orolla,part,per,pore,porrect,presen,prickle,pseudo-racemose,purple,ruit,sessile,short,side,spaced,sprawling,stage,stalk,stellae,straight,tal,tamen,tem,thick,throughout,time,unarme,unarmed,unbranched,unit,unknow,uvenile,vary,vein,weakly,white,wide,yellowish,ympodial	adhesion,arrangement,capitate,climate,colour,corolla,form,glandular,growth,height,history,leaf,life,na,number,orange,ovary,position,presence,pubescence,reproduction,seed,shape,size,staman,stem,stipe,texture
285	wfo-0001027816	success	187	113	83	104	30	0.444	0.5-1,0.5-2,0.6-0.8,0.7-1,1,1-1.5,1-3,1.5-2,1.8-6,2-4,3-3.5,3.5-4,4-5,acuminate,acute,anther,apex,attenuate,base,becoming,berry,bluish,brown,calyx,capitate,cm,conical,connivent,corolla,dark,densely,diameter,ellipsoid,entire,flattened,fleshy,glabrous,gland-tipped,glandular,globose,growth,inflorescence,lanceolate,lateral,leaf,less,linear,lobe,lobed,loosely,margin,minutely,mm,occasionally,orange,pedicel,peduncle,petiole,pitted,plant,pubescent,purple,reddish,reniform,ripe,shiny,shrub,simple,slightly,sometimes,sparsely,stellate,stem,stigma,style,surface,terminal,thin,triangular,tube,uniformly,x,yellowish	..,.5,0.2,0.5,1-1,1-4,1.2-2,12-14,2-2.5,2/3,5-30,5-merou,6-9,<,ag,almost,along,alyx,anthesi,apar,ark,articulated,axi,branched,cell,confined,cupped,dense,drying,eaf,eed,em,erect,exserted,filament,filiform,flower,free,fruiting,half,ilament,irregularly,leaving,lengthening,like,lower,m.,markedly,minute,new,nflorescence,nodding,often,older,orolla,pair,papillo,patent,peg,per,perfect,perhaps,pericarp,plurifoliat,pore,poricidal,portion,primary,prominen,pubescen,rectangular,red,rounded,ruit,scar,several,sleeve,slit,small,somewhat,spaced,sparse,spreadin,spreading,square,testal,time,tip,trichome,twinin,ud,ultimate,uniseriate,unit,upper,usually,variable,vary,vein,viscous,way,woody,ympodial,½	adhesion,arrangement,blade,climate,colour,form,fruit,hair,height,hermaphroditic,history,length,life,midpoint,na,number,ovary,perennial,position,presence,pubescence,ray,reproduction,rugulose,seed,shape,size,staman,stipe,texture
286	wfo-0001027819	success	199	113	88	111	25	0.442	0.5-1,1-2,10-20,10-50,12-21,16-25,2-15,2-3,20-35,22-35,3-40,3-5,4,4-10,4-5,5-6,8-10,9-12,abaxially,acute,adaxially,apex,apical,base,cm,concave,cordate,cuneate,densely,diameter,eglandular-pilose,ellipsoidal,entire,especially,fading,finely,fleshy,forked,fruit,glabrous,globose,green,leaf,length,lobe,lobed,long,margin,mm,moderately,narrowly,oblong,occasionally,pedicel,peduncle,per,perfect,petiole,probably,protuberance,puberulent,purple,purplish,rachi,rugose,simple,sparsely,stellate,stigma,style,subcoriaceous,sympodial,tree,triangular,truncate,tube,two,umbrella-shaped,unbranched,unit,unknown,unlobed,villous,whitish,wide,x,yellow,young	-100,1,1-,1-5,1.5-2,15-22,2,2-,20-25,20-40,25-35,3-5-lobed,4-15,4-25,5,5-merous,aggregate,also,alyx,apart,ape,apiculat,articulated,axe,ba,basal,beyond,blade,branched,cell,ciliate,color,connective,cylindrical,deeply,denser,dia,diamete,dilated,directed,distally,divided,eaf,eed,eglandular,elliptic,elliptic-ovate,equal,exceeding,except,exserted,flower,hair,halfway,leaving,lon,lower,main,mesocarp,midrib,narrow,near,nflorescence,nther,oblique,obtu,obtuse,often,orolla,ovate,pedicellar,perfec,pilose,pinnately,pore,present,prominent,puberulen,puberulence,radiu,ranch,rarely,ratio,remnant,ripe,rounded,rown,ruit,runk,shallowly,short-acuminat,shorter,sinus,slightly,small,sometimes,spaced,stamen,stone,strongly,swelling,tal,thecae,toward,ud,uni,usually,vary,vein,width,without	anther,apiculate,arrangement,branch,calyx,colour,corolla,form,growth,height,history,inflorescence,life,na,ovary,perennial,plant,position,pubescence,reproduction,seed,shape,short-acuminate,size,texture
287	wfo-0001027829	success	197	108	80	117	28	0.406	0.1-0.8,0.5,0.6-0.7,0.6-0.9,0.7,1-,1-1.5,1.5,1.5-2,1.7-2,12,3-7,4-6,5,5-18,5-8,5.5-6,6-6.5,acuminate,acute,anther,apex,base,black,bright,calyx,clavate,cm,conical,corolla,dense,diameter,elliptic,elongate,entire,evenly,flattened,glabrous,globose,growth,inflorescence,lateral,length,lobe,margin,midpoint,mm,narrowly,oblique,orange,ovary,pale,pedicel,peduncle,petiole,pubescence,pubescent,ray,reniform,shiny,shrub,simple,small,somewhat,sparsely,stellate,stem,stigma,style,surface,tan,tapering,thin,tree,triangular,truncate,tube,white,x,yellowish	.1,.5,0.7-0.8,1,1-3,1.5-2.5,1/3,10-20,2,20-31,30,8-10,abaxially,adaxially,along,anthesi,apar,armed,articulated,axi,bark,beneath,bent,berry,brown,cell,commonly,densely,denser,directed,distally,drying,eaf,eed,enmeshing,equal,erect,exceeding,exserted,filament,filiform,flower,free,fruiting,glabrescen,gland-tipped,hang,larger,like,lobed,long,lower,midrib,midvein,minute,minutely,mixed,mixture,multicellular,nearly,new,nflorescence,nodding,often,older,one,open,pair,papillat,per,perfect,pericarp,pitted,plurifoliat,pointed,pore,porect,poricidal,porrect,portion,prickle,primary,prominent,rectangular,reddish,reflexed,regular,ripe,ruit,scar,scattered,sessile,sharply,short,short-stalked,shorter,side,sinuate,spaced,straight,strongly,tangled,testal,time,tip,trichome,twice,ud,un,unarmed,unit,upper,usually,vein,weak,within,ympodial	0.1,adhesion,arrangement,blade,climate,colour,form,fruit,glandular,hair,height,history,leaf,life,na,number,plant,position,presence,reproduction,rugulose,seed,shape,size,staman,stipe,texture,ye
288	wfo-0001027834	success	236	123	100	136	23	0.424	-6.1,0.2-0.3,0.2-0.4,0.2-0.6,0.9-1.8,1-1.6,1-10,1.1-1.6,1.1-1.8,1.4-2,1.8-4.9,10-25,2-3.8,2-8,2.2-4.3,2.3-3.4,25,3-15,4-5.2,5-20,6.9-18.1,abaxial,acuminate,acute,adaxial,anther,apex,attenuate,base,blunt-tipped,brown,calyx,cm,connivent,corolla,cylindrical,deltoid,diameter,discolorous,drying,ellipsoid,entire,finely,fleshy,flower,fruit,glabrous,globose,granular-tomentose,gray,leaf,lenticular,light,lobe,margin,mm,obovate,obtuse,orbicular,ovate,ovate-elliptic,pedicel,peduncle,petiole,pseudo-terminal,pubescence,rarely,reticulate-punctate,ripe,rounded,scabridulous,semi-ovate,semi-spherical,short,shrub,simple,small,soft,sometimes,sparsely,stellate,stellate-pubescent,stem,stigma,style,subcampanulate,subcoriaceous,surface,tomentose,tree,tube,velutinous-tomentose,white,whitish,whitish-tomentose,x,yellow,yellowish,yellowish-tan,yellowish-tomentose	.5-3,0-110,0.4-1.1,0.5-2,1-1.9,1-2.5,1.6-2.7,1/2,2.4-6.2,2.7-7.3,2.9-4.2,3-4.3,4-6,4.8-6.9,5-merous,5.1-8,9-11.9,9-13,abaxially,absent,accrescent,adaxially,ag,alyx,angled,anthesi,apar,apical,around,articulated,axillary,ba,bark,becoming,berry,blade,branch,branched,branching,bud,capitat,closely,completely,concentrated,coriaceous,covering,crown,dendritic-echinoi,dendritic-echinoid,densely,dichasia,directed,distally,eaf,echinoi,echinoid,edge,eed,enclosing,enveloping,equal,erec,exserted,farinose,filament,flat-topped,forming,fruiting,glabrescent,grooved,hair,high,included,inserted,lengthening,less,lobed,long,long-stalked,longitudinal,longitudinally,lower,many,mostly,multangulat,multangulate,near,nflorescence,numerous,obscured,older,orolla,ovate-lanceolate,pair,perfec,persistent,plurifoliate,pore,poricidal,porrect-stellate,primary,pubescent,rachi,ray,ruit,runk,scar,sessile,short-stalked,slit,somewhat,spaced,spreading,stalked,stamen,suture,tamen,though,time,tip,tomentu,tomentum,toward,trichome,turbinoid,ud,unarme,unit,usually,vary,vein,villous,way,wide,ympodial,young	adhesion,arrangement,capitate,colour,form,growth,height,hermaphroditic,history,inflorescence,length,life,ovary,perennial,plant,position,reproduction,rugulose,seed,shape,size,staman,texture
289	wfo-0001027843	success	154	89	53	101	36	0.344	0.5-0.75,0.5-1,0.8-3.5,1-1.2,1-1.3,1-1.5,1.2-1.5,2-2.5,3-6,5-6,6-13,6-9,acute,anther,apex,base,broadly,calyx,clavate,cm,conical,corolla,deltoid,erose,glabrous,globose,green,leaf,lobe,lobed,long,long-acuminate,margin,mm,opposite,ovary,ovate,pedicel,petiole,poricidal,shape,shrub,size,stem,stigma,style,surface,tip,trichome,tube,uniseriate,white,x	.5,.75,/3,1.2-2.5,2-4,3-15-flowered,along,anthesi,apart,apiculate,ba,bark,bearing,becoming,beginning,beneath,berry,coroll,curly,deflexed,densely,denser,dia,differing,difoliate,distally,eaf,edicel,eed,ellipsoid,exsertion,filament,flower,free,fruiting,geminat,glabrate,hairy,impressed,irregularly,known,lamina,larger,later,lateral,like,lon,lower,main,major,middle,minor,minutely,near,nearly,nflorescence,occasionally,older,one,orbicular,pair,papillo,papillose,pleated,pore,portion,prominent,proximal,pubescent,reddish-gre,reflexed,rounded,ruit,scar,shaped,simple,sinus,slender,slightly,somewhat,spaced,sparsely,sparser,stiff,straight,strongly,tall,tapering,tear-drop,time,tipped,two,ud,unit,vein,way,widest,winged,woody,ympodial,young	0.5,1,adhesion,arrangement,blade,climate,colour,diameter,form,fruit,glandular,growth,hair,height,history,inflorescence,length,life,midpoint,na,number,peduncle,perennial,plant,position,presence,pubescence,ray,reddish-grey,reproduction,rugulose,seed,staman,stellate,stipe,texture
290	wfo-0001027847	success	219	122	96	123	26	0.438	-2.5,-4,-6,/3,0-2,0.1-0.4,0.4-1,0.8-0.9,0.8-1.2,1-2.5,1.5-2,1.5-2.5,1.9-2.3,1/4,2-2.8,2-5,2.2-3,2.5-3.5,3-6,5.5-8,6-8,abaxially,acute,anther,apex,base,berry,blade,calyx,chartaceous,cm,connivent,cordate,deltate,densely,diameter,dull,elliptic,equal,erect,evenly,flattened-reniform,fruit,glabrous,gray,green,lateral,leaf,length,lobe,lobed,long,lower,margin,maturity,mauve,midpoint,mm,moderately,narrow-deltate,orange,orange-brown,ovate,pedicel,peduncle,petiole,poricidal,purple,ray,red,red-brown,rounded,scandent,seed,shrub,simple,size,smooth,sometimes,sparsely,spherical,stellate,stellate-pubescent,stem,style,surface,tapering,terminal,tip,tube,upper,way,white,wide,yellow,young	-0.8,-2,-3,-5,.35,.7,/2,0,0-7,0.15-0.2,0.2,0.5,0.5-1,0.8,1,1-2,1.5-5,1/2,1/6-1/3,2-3,2-4,2/,3-15,3-5,3.5-6,4-5-merous,5-25,5-6,6-11,7-10,almost,alyx,ame,apar,apart,apically,apparently,articulated,bark,branched,broadly,brow,c.,curved,dimorphic,discolorous,distance,drying,eaf,edge,eed,elongating,extending,faint,filament,filiform,filiform-acuminat,finely,flattened,flower,free,fruiting,geminate,glabrescent,increasing,infructescence,lon,longer,mature,middle,midvein,minor,nflorescence,older,one,open,orbicular,orolla,oung,pair,pendulous,per,perfec,pericarp,perpendicular,pit,pitted,plurifoliat,porrect,portion,prickl,prickle,prickly,primary,reddish,retrorse,ruit,scar,sessile,side,slender,spaced,spreading,stalk,stalked,straight,strongly,tamen,terete,tertiary,time,toward,trichome,unarmed,unit,usually,variously,vary,vein,venation,visible,weakly,ympodial	2/3,adhesion,arrangement,climate,colour,corolla,form,glandular,growth,hair,height,inflorescence,na,number,ovary,plant,position,presence,present,pubescence,rugulose,shape,staman,stigma,stipe,texture
291	wfo-0001027850	success	221	142	114	107	28	0.516	-22,-4,-5,-6,0.2-0.5,0.6-1,1-1.5,1-2,1-3,1-4,1.5-2,2-2.5,2-4,2-5,2.5-3,3-4,3.5-13,4-5,4-6,6-7,7-18,8-10,abaxially,acuminate,acute,adaxially,adult,anther,apex,basal,base,berry,blue,branched,brown,calyx,charataceous,clavate,cm,coriaceous,corolla,dark,diameter,elliptic,entire,flattened,flower,foliaceous,glabrous,glandular,globose,green,growth,heterostylous,hirsute,inflorescence,internodal,juvenile,laxly,length,like,linear,lobe,lobed-angulate,long-styled,loosely,margin,mature,midpoint,minutely,mm,oblong,oblong-lanceolate,obovate,ovary,ovate-lanceolate,pedicel,peduncle,petiole,plant,porrect,pubescence,purple,reddish,reniform,rounded,rusty,rusty-pubescent,sagittate,scabrous,sessile,short-styled,shrub,simple,sparse,stellate,stellate-apiculate,stem,stigma,style,subglobose,subreniform,subsessile,subtruncate,surface,tapered,tomentose,triangular-lanceolate,trichome,tube,woody,x,yellowish,¼	-10,0.3-0.35,0.5-1,1,1-multicellular,2-3,2-6,3-6,3-7,50,6-10,<,>,almost,angled,anthesi,apart,armed,articulated,bark,brow,caly,cell,channelled,curved,discolorous,distal,dry,eaf,eed,eglandular,enclosed,erect,expanding,filament,flowering,free,fruiting,glabrescent,impressed,leaving,lengthening,lobed,long,longer,lower,material,minute,mixed,mixture,multicellular,new,nflorescence,obliqu,obverse,occasionally,older,one,ornamented,papillo,partially,per,perfect,pericarp,persistent,plurifoliat,pore,poricidal,portion,prickle,prickly,prominent,pubescent,raised,reduced,reflexed,rest,reticulate,rugose,ruit,scandent,scar,single,slightly,slit,spaced,sparsely,stalked,staminate,straight,strongly,tall,testa,time,tip,turbinate,ud,unevenly,unit,upper,vein,velutinous,venation,whitish,wood,yellow,ympodial	adhesion,arrangement,blade,climate,colour,form,fruit,hair,height,history,leaf,life,na,number,papillose,perennial,position,presence,present,ray,reproduction,rugulose,seed,shape,size,staman,stipe,texture
292	wfo-0001027864	success	222	126	97	125	29	0.437	0-0.1,0.1-0.4,0.25-0.5,0.4-0.7,0.4-1.4,0.6-0.7,0.7-0.9,0.7-1.4,1-2,1-3.5,1.2-1.5,1.4-4,1.5-8,2-3,2.5-3,3-10,3-4.2,3.5-5,5-9,6-12,6-7,8-12,abaxially,absent,acute,adaxially,anther,apex,attenuate,base,blade,brown,calyx,chartaceous,cm,connivent,cuneate,densely,diameter,ellipsoidal,entire,extra-axillary,finely,fruit,glabrous,globose,green,grey,grey-green,hair,herbaceous,inflorescence,interpetalar,lanceolate,length,lilac,linear,lobe,lobed,loosely,margin,midpoint,mm,moderately,nearly,oblong,obtuse,pale,pedicel,peduncle,petiole,present,purple,ray,reniform,resprouter,reticulate,rostrate,scattered,shallowly,simple,slightly,smooth,stellate,stellate-pubescent,stem,stigma,style,surface,tapered,tissue,tube,white,x,yellow,yellowish,yellowish-green	%,0-0.2,0-100,0-2,0-3,0.05-0.4,0.3-1,0.5-0.7,0.5-0.8,0.5-1,0.7-1,0.9-1.1,1-1.1,1-1.3,1-1.5,1-3,1-4,13-20,2-foliate,2-locular,3-4,3-5,3-5.5,3-6,3.8-14,4,4-,5-merou,6-8,6-9,7-10,7-20,8-13,8-14,absen,abundant,accrescent,acicular,alyx,anvil-shape,apart,articulated,axe,ba,broad-based,capitat,cross-section,curved,cylindrical,decimetr,deflexed,deltate,directed,distall,distributed,dult,eaf,eed,eglandular,erect,exocarp,filament,finger,flattened,flower,fruiting,geminate,gland-tipped,half,homostylous,index,juicy,lamina,lateral,less,lobing,lon,long,longer,lower,mature,mesocarp,mid-point,minute,moist,nflorescence,oblique,orolla,part,per,perfect,placenta,pore,porrect,prickle,pseudo-racemose,rachi,ridged,ruit,rusty-brown,sessile,short,side,spaced,sprawling,stage,stalk,stalked,stellae,straight,tal,tamen,terete,thick,throughout,time,tip,tissu,unarmed,unbranched,unit,uvenile,vary,wide,ympodial	adhesion,arrangement,capitate,climate,colour,corolla,form,glandular,growth,height,history,leaf,life,na,number,ovary,perennial,plant,position,presence,pubescence,reproduction,rugulose,seed,shape,size,staman,stipe,texture
293	wfo-0001027872	success	190	75	52	138	23	0.274	1,1-8,1.0-1.3,10,15,2,2-3,2.2-3.5,35,5-7,5-8,6-20,ca,calyx,cm,deep,densely,diameter,distal,elliptic,forked,glabrescent,glandular,glandular-pubescent,globose,gray-green,green,green-white,half,herbaceous,homogeneously,lanceolate,light,long,mm,moderately,narrowly,odd-pinnate,ovate,ovoid,pedicel,peduncle,perennial,plant,purple,rhizomatous,rotate,seed,shape,size,wide,yellowish-green	0.5,1-1.2,1-4,1.5-4,12-35,2.8,20,3-6-foliat,4-6,5-10,5-lobed,8-11,abaxially,acumen,acuminate,acute,adaxially,angular,apex,apical,apically,apiculate,articulate,b,ba,basal,base,becoming,branched,caudate,cell,celled,clasping,commonly,connate,cordate,covering,cuneate,cyme,decreasing,dehiscent,dichasial,dichasially,digestion,eaf,ebracteate,eed,emoval,enzyme,erect,exceeding,externally,filament,flower,four-celled,generally,gland,globo,hair-like,honeycomb,interjected,introrse,lateral,leaflet,living,lobe,lon,longer,lower,make,maturing,middle,monochasial,mottled,mucilaginous,nearly,nflorescence,nther,obliquely,oblong,often,orolla,pair,pattern,pentagonal,perfect,petiolate,petiolulate,petiolule,poricidally,puberulent,pubescent,purpl,rarely,reduced,reveal,rhizome,rotate-,rounded,ruit,semi-lunate,sessile,seudostipule,short,single,slightly,slit,sometimes,somewhat,specimen,stamen,ste,stigma,straight,style,subequal,symmetrically,tem,terete,terminal,testal,thick,tinged,tip,trailing,type,typically,unbranched,uniformly,unit,usually,vary,viole,wall,wid,wider,yellow,ympodial	anther,arrangement,colour,corolla,form,fruit,growth,height,history,inflorescence,leaf,length,life,ovary,petiole,position,pubescence,reproduction,rotate-pentagonal,stem,texture,tube,violet
294	wfo-0001027880	success	185	121	92	93	29	0.497	.25,0.3-3,0.5-1.5,0.5-5,0.6-1,0.6-1.5,0.8-1.5,1-15,1-2,1-2.5,1-3,1.5-2,10-15,2-3,4-10,4-6,abaxially,acuminate,acute,adaxially,anther,apex,apiculate,base,blade,calyx,clavate,cm,conical,cordate,coriaceous,deltate,densely,diameter,distichous,entire,epiphytic,extra-axillary,flattened,flower,fruit,glabrous,globose,greenish,hair,inflorescence,leaf,leaf-opposed,lobe,margin,midvein,minutely,mm,nearly,oblique,oblong,oblong-ovate,often,ovate,ovoid,papillose,pedicel,peduncle,perfect,petiole,pink,pubescent,purple,red-brown,revolute,ripe,rounded,rugulose,shrub,size,slightly,sometimes,somewhat,stellate,stigma,style,surface,tan,tip,trailing,truncate,tube,undulate,vine,white,x,yellow	-3,-3.5,1-14,1.5-3,2-80,2/,3-4,5-11,5-8,5-merou,8,absen,accrescen,ag,aggregate,along,alyx,apart,apparently,articulated,axe,ba,branch,branching,cell,chartaceous,ciliat,connivent,contiguously,curled,cylindrical,dense,diminishing,directed,discolorous,distally,distinct,distinctly,eaf,eed,equal,filament,fruiting,geminat,green,growing,increasing,internode,line,long,longer,longitudinal,lower,multicellular,nflorescence,node,occasionally,opening,orolla,pair,pale,plurifoliate,point,pore,pubescen,rachi,reddish,rooting,ruit,scar,secondary,simple,slender,slit,spaced,sparsely,ste,stone,tamen,tem,thickened,time,tree,trunk,typically,unbranched,uniseriate,unit,usually,vary,vein,wide,ympodial	adhesion,arrangement,climate,colour,corolla,form,glandular,growth,height,history,length,life,midpoint,na,number,ovary,plant,position,presence,pubescence,ray,reproduction,seed,shape,staman,stem,stipe,texture,true
295	wfo-0001027880	success	170	122	89	81	33	0.524	.25,0.3–3,0.5,0.5–1.5,0.5–5,0.6–1,0.6–1.5,0.8–1.5,1.5–2,10–15,1–15,1–2,1–2.5,2/3,2–3,4–10,4–6,abaxially,absent,acuminate,acute,adaxially,anther,apex,apiculate,arrangement,base,blade,bluish-purple,calyx,chartaceous,cm,conical,cordate,coriaceous,deltate,densely,diameter,distichous,entire,extra-axillary,flattened,flower,fruit,glabrous,globose,greenish,hair,leaf,leaf-opposed,lobe,lower,margin,minutely,mm,nearly,oblique,oblong-ovate,often,ovate,ovoid,papillose,pedicel,peduncle,petiole,pink,pubescent,red,reddish-brown,revolute,rounded,rugulose,shrubby,slightly,sometimes,somewhat,stellate,stigma,style,surface,tan,tip,truncate,tube,undulate,vine,white,woody,x	0.2-0.5,1.5–3,1–14,1–3,2-80,3–4,5-merous,5–11,5–8,8,accrescen,along,alyx,apar,axe,berry,c.,capitat,ciliat,clavate,climbing,contiguously,curled,cylindrical,dense,discolored,distinct,distinctly,eaf,eed,filament,fruiting,green,lanceolate,line,long,longer,m.,membranous,midvein,mottled,nflorescence,nternode,occasionally,orolla,pair,pale,perfec,pinnate,plurifoliat,rachi,reddish,rip,ruit,sand-punctat,sand-punctate,scar,secondary,simple,slender,spaced,sparsely,ste,tamen,tem,thickened,time,tree,trichome,trunk,typically,unbranched,uniseriate,unit,vary,vegetatio,vein,venation,wide,ympodial,–3.5	adhesion,capitate,climate,colour,corolla,form,glandular,growth,height,history,inflorescence,length,life,midpoint,na,number,ovary,perfect,plant,position,presence,pubescence,ray,reproduction,ripe,seed,shape,size,staman,stem,stipe,texture,true
296	wfo-0001027881	success	215	100	63	152	37	0.293	-3,acute,almost,anther,apex,articulated,attenuate,base,calyx,camptodromous,chartaceous,cm,connivent,contiguous,cordate,cordiform,cylindrical,densely,diameter,entire,erect,extra-axillary,flattened,flower,fruit,glabrous,glandular,globose,greenish,hair,herb,immature,lateral,leaf,lobe,margin,maturity,membranaceous,mm,moderately,ovate-elliptic,pedicel,petiole,pubescence,reniform,rotate,seed,short,similar,size,sparsely,staman,stem,stigma,style,subopposite,surface,translucent,tube,unbranched,venation,white,yellow	.3–0.5,0.5–2.2,0.8–1.5,1-celled,1.3–2,1.8–2.9,10–25,1–2,1–2-celled,1–2.5,1–2.6,1–3,1–3-celled,1–4,2.5–3.6,20–40,2–4,2–6,2–7,4–6,4–9.5,5,5-merous,6–10,7–14,7–9,8,abaxially,absent,abundant,accrescent,acuminate,adaxiall,adaxially,alyx,appressed,asymmetric,axe,ba,barely,berry,blackish,blade,bulge,capitat,case,central,ciliate,closely,commonly,connected,curved,decurrent,dehiscing,denser,difoliate,directed,dorsally,drying,eaf,ed,eglandular,emarginate,emerging,equal,exceeding,exclusively,explosively,eye,few-,fewer,filament,forming,frequent,geminate,giving,groove,half,held,hollow,impression,interpetalar,introrsely,larger,less,light-brown,like,long,longer,longitudinal,lower,mainly,many-branched,maturit,mesocarp,mixed,much,multicelled,multicellular,naked,near,netlike,nflorescence,normally,one,opening,orolla,other,pair,parallel,part,peduncle,per,perfec,placenta,pore,pressure,primary,projection,prominent,pubescent,rachi,raised,ruit,secondary,sessile,side,simple,slightly,slit,small,smaller,solitary,sometimes,stalk,stamen,subapically,tal,tamen,tem,tissue,triangular,two,unit,vary,vein,visible,watery,winged,woody,ympodial,×	0.3-0.5,0.5-2.2,0.8-1.5,1-2,1-2-celled,1-2.5,1-4,2-6,2.5-3.6,20-40,4-6,4-9.5,6-10,7-14,7-9,capitate,colour,corolla,form,growth,height,hermaphroditic,history,inflorescence,length,life,na,ovary,perennial,plant,position,presence,present,reproduction,rugulose,shape,texture
297	wfo-0001027882	success	184	131	97	87	34	0.527	0.1,0.5-1,1,1-1.5,1-5,1.5-,1.5-2,1.5-2.2,1.5-6,10-25,2-3,2-lobed,2.1-2.6,3.2-6,3.5-4,3.5-5,4-5,6-9,7-,abaxially,acuminate,adaxially,along,anther,apex,apparently,appearing,attenuate,axil,base,berry,branch,broadly,c.,calyx,clavate,cm,completely,conical,corolla,cucullate,dark,deltate,densely,diameter,elliptic,entire,flattened,fork,glabrous,globose,green,growth,hairy,hooked,inflorescence,leaf-opposed,less,lobe,lobed,margin,maturity,midrib,mm,occasionally,ovary,ovoid,pale,papillate,pedicel,peduncle,petiole,poricidal,rarely,reddish,reniform,shiny,shrub,simple,small,sometimes,sparse,stem,sticky,stigma,style,surface,tip,tree,trichome,tube,uniseriate,vein,way,white,x,yellow	.25,.5,06a,1.6-2.2,10-40,2-6,2.5-3,3-4,9-13,absent,age,anthesi,apart,bark,branched,branching,brown,caly,dense,difoliate,dry,drying,eaf,eed,erect,et,exerted,fide,filament,flower,free,fruiting,fusiform,geminat,glabrou,hollow,irregularly,junction,kallunki,lamina,lengthening,lower,markedly,minutely,new,nflorescence,nodding,pair,papillat,paulo,penden,perfect,pitted,planar,plane,pointed,population,pore,portion,primary,pulp,rachi,red-papillat,ruit,scar,shattering,slender,slit,spaced,sparsely,specimen,stout,straight,strongly,structurally,sweet-scented,swollen,são,thickened,time,tuft,ud,unit,usually,woody,yellowish,ympodial	1.5-4,adhesion,arrangement,blade,climate,colour,form,fruit,glandular,hair,height,history,leaf,length,life,midpoint,na,number,perennial,plant,position,presence,pubescence,ray,reproduction,rugulose,seed,shape,size,staman,stellate,stipe,texture,unknown
298	wfo-0001027889	success	151	101	68	83	33	0.45	0.5-1,0.5-11,0.7-2,1-10,1-3.5,1.5,1.5-2,10-12,2-20,2-3,3-4,3-9,abaxially,acuminate,acute,adaxially,apex,apiculate,calyx,chartaceous,cm,connivent,deltate,densely,diameter,eglandular-puberulent,eglandular-pubescent,elliptic,finely,fruit,glabrous,glandular-,green,greenish,immature,length,light,lobe,mm,moderately,ovate,ovoid,pedicel,peduncle,petiole,probably,puberulent,puberulent-pubescent,ripe,shrub,simple,somewhat,sparsely,stellate,stigma,style,subcoriaceous,tip,tomentose,tree,triangular,truncate,tube,unknown,violet,white,x,yellowish	-2.5,-pubescent,.5,.5-2,0,1,1-3,10-20,10-30,3-8,4-foliat,5-10,acute-acuminate,aggregate,apart,ape,articulated,axe,basal,base,beyond,blade,capitat,cell,color,connective,cylindrical,darker,dilated,directed,distally,eaf,eed,entire,equal,exceeding,exserted,extending,flower,introrse,laterally,leaving,lon,long,longitudinal,lower,margin,narrow,nflorescence,nther,oblong,orolla,pedicellar,perfect,pore,presen,present,puberulen,puberulent-pubescen,rachi,radiu,remnant,ruit,slightly,small,spaced,stamen,stone,stripe,subcordate,swelling,tal,tem,thecae,time,tomento,ud,unbranched,unit,vary,wide,yello,ympodial	1-2.5,adhesion,anther,arrangement,capitate,colour,corolla,form,growth,height,hermaphroditic,history,inflorescence,leaf,life,na,number,ovary,perennial,plant,position,presence,pubescence,ray,reproduction,rugulose,seed,shape,size,staman,stem,surface,texture
299	wfo-0001027900	success	227	117	93	134	24	0.41	0,0.2–0.5,14–15,18–22,1–3,1–4,2,2.8,2–3,3,3.5–4.5,3–9.5,4–10,5–7.5,7–17,9–25,abaxial,acute,adaxially,andromonoecious,anther,apart,articulated,base,blue,brown,calyx,capitate,cm,congested,connivent,coriaceous,densely,diameter,equal,extraaxillary,fruit,glabrous,glandular,globose,golden-tan,green,grey-brown,hair,half,inflorescence,lanceolate,leaf,length,light,likely,lobe,lower,maturity,mm,moderately,multangulate,multangulate-stellate,multiseriate-stalked,pedicel,peduncle,plant,porrect-stellate,powdery,pubescence,pubescent,reddish-dark,rotate-stellate,sessile,short-stalked,shrub,simple,slightly,small,spaced,sparsely,stalked,stellate,stem,stigma,style,surface,tan,tapered,tree,tube,unbranched,violet,yellow,young,×,–4,–5	.1,.1–0.2,.1–0.3,.5,0.1–0.3,0.2–0.4,0–0.1,1.5–1.8,16–19,16–23,1–,2–8,3.5–4,3–5,3–8,5-merous,5–,5–10,5–6,6–8.2,7–10,7–10+,7–15,7–8,8–15,abaxially,absent,abundant,abundantly,accrescent,adaxial,age,alyx,anthesi,apex,armed,axe,ba,bark,becoming,beneath,berry,bilobe,blade,broad-based,connective,cordate,curved,cylindrical,db,deeply,deltate,difoliate,directed,discolorous,distally,dried,eaf,eed,either,enclosing,entire,falcate,filament,flower,flowering,free,fresh,frui,fruiting,functionally,geminat,hermaphroditic,heterstylou,interpetalar,lighter,like,lobed,long,long-stalked,longitudinal,major,margin,membranaceous,midpoint,midvein,mixed,multiseriate,nearly,nflorescence,oblique,obtuse,often,older,one,opening,orolla,part,petiole,pore,prickle,pronounced,rachi,ray,reflexed,repand,roughened,ruit,runk,sharp,short,side,slit,smooth,stalk,staminate,stellate-pubescen,stellate-pubescent,stout,strongly,subtending,tamen,thickened,time,tissue,unarmed,unit,unknown,vary,vein,vestigial,wide,ympodial,–6.2	adhesion,arrangement,bilobed,colour,corolla,dbh,form,growth,height,history,life,na,ovary,perennial,position,presence,present,reproduction,rugulose,seed,shape,size,staman,texture
300	wfo-0001027901	success	156	106	71	85	35	0.455	.5,0.3-1.2,0.8-1,1-1.5,1-2.5,1.8-4.5,2.5-3,3-5,4-5,4.7-12,abaxially,acuminate,acute,adaxially,anther,apex,area,attenuate,base,bright,broadened,brown,calyx,cm,conical,corolla,dark,densely,dia,dry,elliptic,fresh,glabrous,globose,green,inflorescence,leaf,lobe,lobed,material,minutely,mm,nearly,opposite,ovary,ovoid-reniform,pedicel,petiole,pitted,poricidal,pubescent,ripe,shape,shiny,shrub,simple,size,sparsely,stem,stigma,style,surface,tip,translucent,triangular,trichome,tube,uniseriate,white,x,yellow	.25,0.5-1,0.8-2,0.9-2.3,1-2,1.5-1.8,4-10-flowered,6-7,?,abaxial,anthesi,ba,bark,beneath,berry,brow,closely,curled,deflexed,differing,difoliate,direction,drying,eaf,edicel,eed,ellipsoid,exserted,filament,firm,fleshy,free,fruiting,geminat,imbedded,immature,keeled,later,lateral,like,lon,long,lower,main,major,matrix,middle,midrib,minor,nflorescence,older,orbicular,oriented,overlappin,pair,papillo,papillose,planar,pore,portion,prominently,reddish,reflexed,rest,rounded,ruit,scar,shaped,single,slender,spaced,straight,strongly,swollen,tall,tear-drop,tub,ud,unit,usually,vein,widest,woody,ympodial,young	0.5,1,adhesion,arrangement,blade,climate,colour,diameter,form,fruit,glandular,growth,hair,height,history,length,life,margin,midpoint,na,number,peduncle,perennial,plant,position,presence,pubescence,ray,reproduction,rugulose,seed,staman,stellate,stipe,texture
301	wfo-0001027902	success	128	99	71	57	28	0.555	-2.5,0.5-1,1-1.5,10-20,2,2-15,2-3,2-8,3-4,3-5,4-25,4-5,5-20,6-37,7-9,abaxially,acuminate,acute,adaxially,angled,apex,base,calyx,chartaceous,cm,cordate,deeply,densely,diameter,distally,eglandular,entire,fruit,glabrous,glandular,globose,hair,inflated,lobe,margin,mm,moderately,narrowly,nearly,ovate,pedicel,peduncle,petiole,puberulent,pubescent,purple,purplish,reticulate,shrub,simple,small,sparsely,stellate,stigma,style,subcoriaceous,tip,tree,triangular,truncate,tube,unbranched,unknown,whitish,x,yellow	1-2,1-6,1.5-3,10-15,15-30,2-12,2-9,20-50,3-foliat,8-13,absen,adaxiall,aggregate,apart,articulated,axe,blade,branched,cell,color,connivent,cylindrical,directed,distall,eaf,eed,flower,forked,leaving,like,lon,long,lower,nflorescence,nther,obtuse,orolla,pedicellar,pore,pubescen,rachi,radiu,remnant,ripe,ruit,spaced,ste,stone,tal,tem,time,truncat,unit,usually,vary,wide,ympodial	abaxial,adaxial,anther,arrangement,colour,corolla,form,growth,height,history,inflorescence,leaf,length,life,na,ovary,plant,position,presence,pubescence,reproduction,rugulose,seed,shape,size,stem,surface,texture
302	wfo-0001027920	success	228	117	89	139	28	0.39	0.1-0.5,0.2-0.8,0.5-1,1.4-2.5,2-5,2-7,20-40,25-45,3-5,3.5-4,3.5-4.5,4-11,4-7,4.5-7,5-7,7-11,7-18,8-12,8-18,acute,adaxially,almost,anther,apex,attenuate,base,black,blade,bristly,bristly-hirsute,broadly,brown,calyx,campanulate,cm,coarsely,connivent,dark,deltoid,densely,dentate,diameter,ellipsoidal,extra-axillary,flower,fruit,hair,hirsute,indument,inflorescence,lanceolate,leaf,length,lenticular,lobe,long,margin,mm,oblong,obovoid,obtuse,orange,outline,ovate,pedicel,peduncle,perennial,persistently,petiole,prickly,ray,ripe,simple,singled-stemmed,small,smaller,stellate,stellate-pubescent,stem,stigma,style,surface,thin-textured,tree,truncate,tube,white,x,yellow	-25,-3,.1-1.4,0.1-0.2,1-2,1-2.5,1-4,1.5-3,1/5-1/3,11-28,12-18,12-25,17-25,2-,2-8,2-foliate,4-10,4-6,4-locular,8-30,abaxially,acicular,acute-,acute-tipped,adaxiall,along,apart,appressed,approximately,articulated,ascending,axe,ba,basally,bristle-like,broad-based,bulbou,capitat,cauline,class,close,concealed,concentrated,cylindrical,depressed-deltoid,descending,directed,distal,distall,distinct,divergently,eaf,eed,elongate,enlarging,entire,equaling,erect,female-sterile,few-branched,flesh,frui,geminat,glabrous,green,inserted,interlobal,intermixed,large,larger,lateral,less,lignescent,locule,long-stalked,longitudinal,lower,major,midpoint,minute,minutely,much,multiseriate,narrowly,nearly,nflorescence,obtuse-tipped,occasionally,often,one,orolla,ovate-lanceolate,pair,per,persistent,pitted,pore,prickle,principal,proliferation,pubescent,rachi,radiu,receptacular,recurved,rigid,ruit,scattered,section,sessile,short,side,similar,sinus,spaced,sparse,spreading,stalk,stalked,stella,stellae,swollen,tal,tamen,tawny,tem,termination,time,trichome,two,unbranched,unit,usually,vary,vein,vestitur,weakly,wide,ympodial	2-10,adhesion,arrangement,capitate,colour,corolla,form,glandular,growth,height,history,life,na,number,ovary,plant,position,presence,pubescence,reproduction,rugulose,seed,shape,size,staman,stipe,texture,ye
303	wfo-0001027929	success	193	78	56	137	22	0.29	1,1-10,1.0-1.3,10,2,2-3,2.0-3.0,20,35,4-5,5-6,6-15,along,calyx,cm,corolla,deep,diameter,distal,elliptic,except,forked,generally,glabrous,globose,green,green-white,hair,half,herbaceous,lanceolate,long,mm,narrowly,occasional,odd-pinnate,ovate,ovoid,pedicel,peduncle,perennial,plant,puberulent,purple,rhizomatous,rotate,seed,shape,size,sometimes,spot,tinged,vein,violet,violet-blue,wide	0.2-0.9,1-4,1-8,1.5-4,15,3-6-foliat,3.5-5,4-30,4-6,5-10,5-lobed,abaxially,acumen,acuminate,acute,adaxially,angular,apex,apical,apically,apiculate,articulate,ba,basal,base,becoming,beyond,branched,caudate,cell,cente,center,clasping,coat,color,connate,cordate,covering,cuneate,cyme,dark,darker-violet-blue,decreasing,dehiscent,dichasial,dichasially,digestion,eaf,ebracteate,eed,embryo,emoval,enzyme,erect,exceeding,filament,flower,formed,globo,hair-like,honeycomb,included,interjected,introrse,lateral,leaflet,light,living,lobe,lon,lower,make,maturing,middle,monochasial,mostly,mucilaginous,nearly,nflorescence,nther,obliquely,oblong,often,orolla,pair,pattern,pentagonal,perfect,petiolate,petiolulate,petiolule,poricidally,purpl,radiating,rarely,reduced,reveal,rhizome,rotate-,rounded,ruit,semi-lunate,sessile,seudostipule,short,slightly,slit,somewhat,specimen,stamen,star,ste,stigma,straight,style,subequal,symmetrically,tem,terete,terminal,testal,thick,tip,trailing,typically,unbranched,unit,usually,vary,visible,wall,white,wid,wider,without,yellow,ympodial	anther,arrangement,colour,form,fruit,growth,height,history,inflorescence,leaf,length,life,na,ovary,petiole,position,pubescence,reproduction,rotate-pentagonal,stem,texture,tube
304	wfo-0001027930	success	210	116	92	118	24	0.438	%,0-0.7,0-1,0-2,0.2-0.4,0.2-1.2,0.25-0.35,0.25-0.4,0.4-1,0.4-1.5,0.6-0.9,0.7-1.5,1-2,2-2.5,3-12,3-3.6,3.5-5.5,4-8,4.5-6.5,6-13,7-8,8-20,acute,adaxially,and/or,andromonoecious,anther,apex,basal,base,blade,brown,calyx,chartaceous,cm,connivent,cuneate,deltate,densely,diameter,entire,erect,extra-axillary,flower,fruit,glabrous,gland-tipped,globose,grey,hair,hastate,inflorescence,lamina,lanceolate,lateral,leaf,length,lilac,linear,linear-hastate,lobe,long,loosely,margin,mm,obtuse,pale,pedicel,peduncle,perennial,perfect,petiole,plant,present,ray,red,rhizomatous,rostrate,scattered,short,shrub,simple,sparsely,stellate,stellate-pubescent,stigma,style,time,tube,white,x,yellow	-2,.1,.4,0,0-0.5,0-0.8,0-4,0.05-0.7,0.2-0.7,0.3-0.5,0.4-0.8,0.5-0.6,0.5-1,0.8-1.2,1-4,1-locular,13-16,15-60,2-10,2-3,2-6,2-9,2-foliate,3-7.5,4-,5-merou,6-12,6-8,7-12,9-13,9-26,abaxially,absen,absent,acicular,across,adaxiall,adult,alyx,apart,apparen,articulated,axe,ba,branch,branche,capitat,confined,cylindrical,decimetre,directed,distall,distributed,dm,eaf,eed,eglandular,exocarp,filament,finger,fruiting,functional,geminat,green,half,heterostylous,homo-,incomplete,interpetalar,juicy,juvenile,less,longer,lower,mature,mesocarp,mid-point,midpoint,midrib,midvein,minute,moderately,narrowly,nflorescence,oblique,orolla,part,per,placenta,pore,porrect,prickle,rachi,ruit,septum,sessile,spaced,sparse,stellae,straight,strongly,succulent,tal,tamen,tem,thick,throughout,tissue,triangular,unarme,unarmed,unbranched,unit,vary,weakly,wide,yellowish,ympodial	adhesion,arrangement,capitate,colour,corolla,form,growth,height,history,life,na,number,ovary,position,presence,pubescence,reproduction,seed,shape,size,staman,stem,stipe,texture
305	wfo-0001027943	success	208	111	86	122	25	0.413	-4,0.2-2,0.3-0.5,0.5-1,0.5-6,0.8-1.5,1-1.5,1-3,1-4,2-14,2-2.5,2-3,2-3-lobed,2-4,3-15,3-20,5-9,7-10,acute,andromonoecious,anther,apex,brown,brownish,calyx,chartaceous,cm,coarsely,diameter,elliptic,elliptic-ovate,entire,equal,extra-axillary,fruit,glabrescent,glabrous,glandular,globose,green,hair,inflorescence,initially,leaf,linear-acuminate,linear-apiculate,lobe,margin,mature,membanaceous,minutely,mm,nearly,outline,pedicel,peduncle,petiole,plant,pubescent,rarely,ray,reniform,ripe,rugulose,shallowly,shrub,slightly,smooth,sparsely,stellate,stellate-pubescent,stem,stigma,style,surface,tan,tapered,tip,truncate,tube,turning,unbranched,white,x,yellow,young	-1.5,.1,.5,0,0.5-1.5,0.5-4,1-5,1.5-3,10-15,2-10,3-8,4-20,4-6,4-7,5-8,5-merou,6-.,7-15,abaxially,accrescent,adaxially,ag,alyx,apart,armed,articulated,axe,ba,base,berry,blade,broad,broad-based,capitat,connivent,covering,curved,cylindrical,densely,difoliate,directed,distally,eaf,eed,erect,ferruginous,filament,flattened,flower,forked,free,frui,fruiting,geminat,gland-tipped,half,heterostylous,homo-,interpetalar,interspersed,interwoven,like,long,longitudinal,lower,major,midline,midpoint,midrib,moderately,narrowly,nflorescence,numerous,oblique,obtuse,often,opening,orolla,part,perfect,pericarp,pore,porrect-stellate,prickle,rachi,recurved,reflexed,rounded,ruit,sessile,short,short-stalked,side,simple,sinus,slit,small,somewhat,spaced,sparse,splitting,staminate,straight,strongly,subtending,tamen,tem,thi,time,tissu,tissue,toward,triangular,unarme,unarmed,unit,vary,vein,whitish,wide,woody,ympodial	6-8,adhesion,capitate,colour,corolla,form,growth,height,history,length,life,na,number,ovary,perennial,position,presence,present,pubescence,reproduction,seed,shape,size,staman,texture
306	wfo-0001027944	success	175	97	70	105	27	0.4	%,0-0.3,0.25-0.4,0.3-0.4,0.4-0.8,0.5-1.2,0.9-1.2,1-2,1.5-2,15-23,2-4.5,3-3.5,3-4.5,3-7,4-7,5-7,7-8,7.5-14,acute,anther,apex,base,brown,calyx,chartaceous,cm,cuneate,deltate,densely,diameter,entire,erect,extra-axillary,flower,fruit,glabrous,globose,green,inflorescence,lamina,lanceolate,lavender,length,lobe,lobed,long,margin,mm,ovate,pale,pedicel,peduncle,perennial,petiole,present,ray,red,rhizomatous,rusty,shallowly,shrub,simple,stellate,stellate-pubescent,stigma,style,tube,x,yellow,yellowish	.8,0-4,0.1-0.2,0.2-0.3,0.2-0.4,0.4-0.5,0.5-0.8,0.5-1,1-1.2,1-3,1-locular,13-16,2-3,2-6,2-foliate,2.5-5.2,3-20,3-4,3-5,5-merou,7-20,abaxially,absen,absent,acicular,across,adaxiall,adaxially,adult,alyx,apart,apparen,articulated,axe,ba,blade,branche,capitat,confined,cylindrical,directed,distall,dm,eaf,eed,eglandular,exocarp,finger,fruiting,geminat,gland-tipped,hair,half,incomplete,index,juicy,lateral,less,lobing,longer,lower,mature,mesocarp,mid-point,midpoint,midrib,minute,nflorescence,oblique,obtuse,orolla,part,per,perfect,placenta,pore,porrect,prickle,pseudo-racemose,ruit,septum,sessile,short,side,spaced,stage,stellae,straight,succulent,tal,tamen,tem,thick,throughout,time,unarme,unarmed,unbranched,unit,unknow,uvenile,vary,white,wide,ympodial	abaxial,adaxial,adhesion,arrangement,capitate,colour,corolla,form,growth,height,history,leaf,life,number,ovary,plant,position,presence,pubescence,reproduction,seed,shape,size,staman,stem,texture,unknown
307	wfo-0001027948	success	186	101	65	121	36	0.349	-16,-6,.5,0.5-2,1-1.2,1.3-1.8,1.5-4.5,2.2-,3-8.2,3.7-4,5-,7-15,7.5-10,abundant,acuminate,anther,apex,articulate,attenuate,base,calyx,campanulate,cm,corolla,diameter,ellipsoidal,elliptical,flexuous,glabrous,glandular,globose,herb,leaf,length,light,lobe,long,margin,mm,narrow,narrowly,non-glandular,ovate,ovoid,patent,petiole,pubescence,pubescent,purple,seed,serrulate,simple,slightly,stem,stigma,style,sub-shrub,triangular,trichome,tube,unequal,ventrifixed,violet,viscid-pubescent,x	-15,0-,0.4,0.5-0.7,0.6,0.8-,1-2,1.2-2.2,1.6,1/10,10-14,13,14,2-,2.5-,3.2-5.2,3.5,5,6-celled,7,8-celled,abaxially,accrescen,adaxially,ag,aggregate,antrorse,ape,ature,basal,berry,bicellular,branch,c.,cell,connectival,crushed,cuticle,dark,delicate,diamete,difoliate,directed,dorsally,eaf,edentate,erect,filament,finely,fragrance,free,fruiting,generally,head,herbaceous,hig,hollow,ill-smelling,inconspicuous,inserted,lamina,long-stalked,longer,longitudinal,longitudinally,lower,many-,midvein,near,occasionally,odorles,opening,orolla,pair,papillate,pericarp,pore,poricidal,portion,prolongation,reduced,ree,ridged,ruit,saddle-shape,scarce,scarcely,secondary,seeded,seen,separated,short-stalked,shorter,single-celled,sinus,slit,small,smooth,solitary,spur-like,stalk,stone,straight,striat,striate,sub-opposite,tem,thecae,thickened,time,tip,tooth,twice,unit,upward,vary,vein,verrucate,ympodial,¼,½	0.8-2.2,2.5-5.2,adhesion,arrangement,blade,climate,colour,form,fruit,growth,hair,height,history,inflorescence,life,midpoint,na,number,ovary,pedicel,peduncle,perennial,plant,position,presence,ray,reproduction,rugulose,saddle-shaped,shape,size,staman,stellate,stipe,surface,texture
308	wfo-0001027961	success	177	104	71	106	33	0.401	0.5-1,0.9-1,1-1.5,1-4,1-5,1-9,2-2.5,2.3-2.5,2.5-9,4.5-5,8-10,?,abaxially,acute,anther,apex,base,broadly,calyx,clavate,cm,conical,cordate,corolla,deltate,densely,diameter,ellipsoid,elliptic,entire,fading,glabrous,globose,green,growth,immature,inflorescence,lateral,lobe,lobed,margin,membranous,mm,obovate,occasionally,pedicel,peduncle,petiole,pinnatifid,pubescent,purple,reddish,rotate-stellate,simple,slightly,sparsely,stem,stigma,style,surface,terminal,triangular,truncate,tube,vine,violet,white,white-pubescent,woody,x,yellow	.5,0.25,0.25-0.5,1,1-3,10-50,3-3.5,5-8,5-merou,6-9,7-9,<,adaxiall,adaxially,age,always,alyx,anthesi,apar,ark,articulated,asymmetric,axil,berry,branched,brow,c.,clear,connivent,curling,distributed,eaf,early,eed,equalling,exserted,filament,flower,free,fruiting,fusiform,geminat,ilament,irregularly,lamina,lengthening,lon,long,loosely,lower,many,mature,maturity,midrib,minute,minutely,new,nflorescence,observed,often,older,one,orolla,other,pair,papillo,pendan,perfect,pericarp,pinched,planar,plurifoliate,pore,poricidal,portion,present,primary,probably,pubescen,ruit,scar,shiny,sleeve,slender,slit,small,spaced,spreading,tem,thin,time,tip,transition,trichome,tuft,twinin,twining,ud,unequal,uniseriate,unit,upper,vary,vein,way,ympodial	adhesion,arrangement,blade,brown,climate,colour,form,fruit,glandular,hair,height,history,leaf,length,life,midpoint,na,number,ovary,plant,position,presence,pubescence,ray,reproduction,rugulose,seed,shape,size,staman,stellate,stipe,texture
309	wfo-0001027965	success	265	135	108	157	27	0.408	.25,.9,/3,0.1-0.2,0.15-0.3,0.4,0.5,0.6-0.9,0.8-1.6,1.2,1.5-2,1.5-3.2,1/3-1/4,2-2.5,2-3,2-3.5,2-4,2.2-2.6,2.8-3.3,3.5,3.5-10,4-7,4.5,6-9,7-8,abaxially,acuminate,acute,adaxially,almost,along,anther,apex,apically,base,berry,branch,brown,calyx,capitate,chartaceous,clavate,clustered,cm,cordate,corolla,cupular,densely,density,diameter,distributed,drying,dull,entire,evenly,filiform,flattened,free,fruit,glabrous,grey-brown,increasing,lateral,leaf,length,liana,like,lobe,lobed,midpoint,mixture,mm,obconical,oblong,orange,orange-brown,outside,ovate,pedicel,peduncle,petiole,present,pubescent,ray,red-brown,reniform,rounded,shiny,shrub,simple,somewhat,sparsely,spheroidal,stellate,stellate-pubescent,stem,stigma,style,surface,tapering,tip,toward,trichome,tube,white,wrinkled,x,young	-2,.1,.2,.3,.5,.7,0.15,0.2,0.3,0.4-0.5,0.5-3,0°,1,1-2,1-8,1.5-2.5,1/3-2/3,1/4-1/3,4-merou,abaxial,absent,accrescent,acicular,adaxial,adjacent,age,alternate,alyx,ame,anthesi,apar,ape,apparently,armed,articulated,bark,becoming,beneath,branched,brown-green,c.,canaliculate,covered,curved,deltoid,dense,detaching,development,discolorous,divided,dry,eaf,early,eed,ellipsoi,elongated,equal,erect,even,except,extending,fairly,fasciculate,filament,finely,fissure,flat,flexuous,flower,forming,fruiting,glabrescent,green,indumentum,inside,leave,lengt,lengthening,less,long,loop,lower,m.,main,mature,maturity,midvein,minor,nflorescence,nther,oblique,occasional,often,orolla,pair,pale,papillose,patch,pendulous,perfect,pericarp,pit,pitted,plurifoliat,pore,poricidal,porrect,portion,prickle,primary,protruding,rachi,raised,reduced,regular,remnant,ridged,ruit,scar,series,sessile,short,sinus,small,smooth,sometimes,sparse,spreading,stalk,stalked,straight,strongly,stump,tearing,terete,tertiary,thin,throughout,translucent,transverse,ud,unarme,unarmed,underneath,unequal,uneven,unit,usually,variable,vary,vein,venation,visible,wide,widening,ympodial,youngest	adhesion,arrangement,blade,climate,colour,form,glandular,growth,hair,height,inflorescence,margin,na,number,ovary,plant,position,presence,pubescence,reproduction,rugulose,seed,shape,size,staman,stipe,texture
310	wfo-0001027966	success	207	97	73	134	24	0.353	0.4-0.5,1-1.8,1-2,1-4.2,1-5,1.3-2.2,10-30,2.2-2.9,2.5-10.5,3-4,3-5,3-7,40-80,5-6,5-9.5,5.5-14,abaxially,adaxially,anther,attenuate,axillary,blue-violet,brownish,bud,chartaceous,ciliate,cm,condition,conical,corolla,densely,diameter,drying,elliptic,fresh,fruit,glabrous,green,greenish,herb,lanceolate,leaf,light,lobe,long,margin,membranous,mm,mottled,odd-pinnate,ovate,ovoid,pedicel,peduncle,pentagonal,petiole,plant,pubescent,purple,ripe,rotate,seed,size,sparsely,stem,stigma,subtending,terminal,tube,whitish,wide,x,yellow	0.7-3,0.8,0.8-2.5,1-10,1-3,1.2-4.5,1.5-3,1.5-5.2,10,2.8-9,4,5-10,5-merou,6-11,absent,acumen,acuminate,ag,along,alyx,apart,apex,apparently,arranged,articulated,asymmetrical,axe,base,basiscopic,bead,berry,blade,capitat,cell,commonly,connivent,covering,decreasing,digestion,distal,dorsally,eaf,edge,eed,enzyme,erec,especially,exceeding,filament,flat,flower,folded,forked,geminat,generally,glabrou,gradually,green-white,hair,hair-like,half,homostylous,honeycomb-shaped,interjected,larger,lateral,leaflet,lengthening,less,like,living,lower,make,medium,middle,minute,moniliform,mucilaginous,multiple,narrow,necklace,nflorescence,orbicular,orolla,pair,pale,perfect,petiolule,plurifoliate,pore,poricidal,proximal,rarely,ray,removed,ruit,secondary,semierect,sessile,seudostipule,shorter,side,slightly,slit,somewhat,spaced,specimen,stamen,ste,stolon,straight,subequal,subsessile,symmetrical,tall,tamen,tem,testal,thick,throughout,tip,tissue,tri-,tuber,tyle,typically,unit,usually,violet,wall,wet,white,wing,ympodial	adhesion,arrangement,calyx,capitate,colour,form,growth,height,history,inflorescence,length,life,na,ovary,perennial,position,pubescence,reproduction,rugulose,shape,staman,style,surface,texture
311	wfo-0001027978	success	197	129	101	96	28	0.513	0.2-0.5,0.5-1,1-2,1-3,1-6,1.5-2.5,10-14,11,2-2.5,2-3,2.5-3,3-5,3-6,4-10,4-5,4-6,4-8,5-8,6,7-10,7-9,abaxially,absent,acute,adaxially,andromonoecious,anther,apex,attenuate,base,becoming,blade,brown,calyx,chartaceous,cm,connivent,cylindrical,densely,diameter,distal,end,entire,extra-axillary,filiform,flower,fruit,functionally,glabrous,globose,green,hair,hermaphroditic,immature,leaf,length,like,lilac,lobe,lobed,male,margin,mature,midpoint,mm,moderately,narrowly,nearly,obtuse,orange,orange-red,ovary,ovate,pedicel,peduncle,per,petiole,plant,porrect-stellate,proximal,pubescent,ray,round,shrub,side,simple,spaced,stellate,stem,stigma,style,surface,tan,tapering,thin-skinned,triangular,tube,white,wide,x,yellow	0.5-1x,1,1-1.5,1.5,1/6,2.5-5.5,20-40,6-10,8-12,abaxial,absen,accrescent,adaxial,along,alyx,andormonoeciou,apar,apical,apparently,armed,asymmetrical,axe,berry,beyond,cordate,cut,dark,difoliate,directed,discolorous,eaf,eed,either,except,exserted,filament,flattened,frui,fruiting,geminate,glabrou,gree,heteromorphic,initially,introrsel,less,long,lower,major,many,midrib,midvei,midvein,multicellular,multiseriate,netlike,nflorescence,occasionally,often,orolla,pair,pit,pore,prickle,rachi,raised,recurved,reflexed,ridge,roselike,ruit,scandent,scattered,separated,short,sinus,slightly,small,sparsely,stalk,stamen,staminate,ste,straight,tamen,tem,unarmed,unbranched,unequa,unicellular,unit,vary,vegetatio,vein,way,ympodial	adhesion,apart,arrangement,climate,colour,corolla,form,glandular,growth,height,history,inflorescence,life,na,number,perennial,position,presence,present,pubescence,reproduction,rugulose,seed,shape,size,staman,stipe,texture
312	wfo-0001027997	success	174	105	70	104	35	0.402	.2,.5,0.2-2,0.9-1,1,1-2,1-4,1.5-1.7,1.5-2,10-23,2,3.5-10,acute,anther,apex,attenuate,auriculate,base,becoming,bi-lobed,black,blade,calyx,cm,corolla,deltoid,dia,dirty,dry,glabrous,globose,green,greenish-yellow,inflorescence,leaf,live,lobe,lobed,long-acuminate-triangular,margin,mm,obovate,occasionally,opposite,ovary,ovoid-reniform,pale,pedicel,petiole,plant,poricidal,pubescent,ribbed,ripe,shrub,small,somewhat,sparsely,specimen,stem,stigma,strongly,style,surface,tan,tip,tree,tube,white,x	.1,.6,0.1-0.7,0.1-0.8,1.5-1.8,10-20-flowered,7-10,7/8,abaxially,along,anthesi,apar,ba,bark,beneath,berry,breaking,bright,brittle,consisting,corky,decurrent,deflexed,dense,densely,denser,distal,eaf,edicel,eed,entire,erect,even,evenly,exserted,filament,free,fruiting,glabrate,impressed,inflorescenc,keel,keeled,later,lateral,like,living,long,long-ellipsoid,lower,main,middle,minutely,nflorescence,often,old,older,onto,ovoid,pair,papillose,partially,pitted,planar,pore,portion,prominent,pubesent,raised,reddish-brown,remaining,rest,ruit,scar,scattered,sessile,shaped,short,simple,slender,slightly,soft,soon,spaced,straight,tall,tapering,tear-drop,trichome,trunk,ud,ultimately,unifoliat,uniseriate,unit,vasculature,vein,way,widest,wing,winged,woody,ympodial,young	0.5,adhesion,arrangement,climate,colour,diameter,form,fruit,glandular,growth,hair,height,history,length,life,midpoint,na,number,peduncle,perennial,position,presence,pubescence,ray,reproduction,rugulose,seed,shape,size,staman,stellate,stipe,texture,unifoliate,ye
313	wfo-0001028014	success	222	121	91	131	30	0.41	-1,-15,-2.5,-4,-6,/5,0.2-0.4,0.2-1,0.2-1.6,0.5-1,0.5-2,0.5-3,0.6-0.9,0.9-1.2,1-4,1.3-2.4,1.8-3,2-4.5,2-6.5,2.5-4,4.5-7,6-10,abaxially,almost,anther,apex,apically,base,berry,black,blade,brown,calyx,chartaceous,cm,connivent,cordate,deltate,densely,diameter,equal,erect,flattened-reniform,fruit,glabrescent,glabrous,lateral,leaf,length,lobe,lobed,long,margin,maturity,mauve,membranous,midpoint,mm,moderately,obtuse,orange,ovate,pale,pedicel,peduncle,petiole,poricidal,purple,ray,red,rounded,scandent,seed,shrub,simple,smooth,spherical,spreading,stellate,stellate-pubescent,stem,style,surface,tapering,terminal,tip,tube,way,weakly,wide,yellow	-0.5,-1/2,-10,-3,-5,.5,0,0.1-0.2,0.15,0.15-0.3,0.2,0.25,0.3-0.4,0.5,0.5-1.5,0.7-1,0.7-1.6,1-,1-10,1-2,1-3,1.5,1.5-2,1/4,1/4-2/3,2,2-20,2-3,3-10,4-10,5-merous,6-11,acuminat,alyx,ame,apar,apart,apparently,around,articulated,bark,branched,broad-deltate,brown-green,c.,cell,concolorous,curved,decurrent,difoliate,discolorous,distance,drying,eaf,edge,eed,elongating,extending,eye,filament,flattened,flower,free,fruiting,geminat,glabrou,gland,globular,gray,gray-green,herbaceous,infructescence,lon,longer,lower,mature,midvein,naked,nflorescence,occasionally,older,one,open,orange-gra,orolla,oung,outer,outline,pair,pendulous,per,perfec,pericarp,pit,porrect,portion,prickl,prickle,prickly,primary,raised,reduced,reflexed,rough,ruit,scar,sessile,shiny,shorter,side,slender,sometimes,spaced,stalk,stalked,straight,strongly,tamen,terete,tertiary,time,trichome,unit,vary,vein,venation,visible,visibly,winged,yellow-green,ympodial	acuminate,adhesion,arrangement,climate,colour,corolla,form,glandular,growth,hair,height,history,inflorescence,life,na,number,ovary,plant,position,presence,pubescence,reproduction,rugulose,shape,size,staman,stigma,stipe,texture,ye
314	wfo-0001028017	success	158	102	72	86	30	0.456	-2.5,0.3-1,1.5-2,10-22,13-40,15-35,2,2-3,2-4,2.5-5,3,3-12,3-14,5-7,5-9,6-8,abaxially,acute,adaxially,apex,apiculate,base,brown,calyx,clavate,cm,connivent,cuneate,densely,diameter,eglandular-puberulent,ellipsoidal,elliptic,entire,flattened,fruit,fusiform,glabrous,glandular-,glandular-puberulent,green,greenish,immature,lanceolate,lobe,margin,mm,moderately,oblique,obtuse,ovate,pedicel,peduncle,petiole,pubescent,purplish,ripe,short-acuminate,simple,sometimes,stellate,stellate-campanulate,stigma,style,subcoriaceous,tip,tree,truncate,tube,white,x,yellow	1,1-10,1-2,1-3,15-50-flower,3-4,3-foliat,40-50,5,6-7,9-11,absen,absent,acuminate,aggregate,apart,ape,articulated,axe,basal,beyond,blade,cell,chartaceous,ciliat,connective,cream,cylindrical,directed,distally,eaf,eed,eglandular,eglandular-pubescent,exceeding,exserted,fleshy,flower,forked,glandular,hair,introrse,leaving,lon,long,lower,narrowly,near,nflorescence,nther,orolla,ovoid,pedicellar,perfect,pointed,pore,puberulen,purple,rachi,radiu,rarely,remnant,ruit,shorter,slightly,small,spaced,sparsely,stamen,stone,tal,tan,tem,thecae,time,tomentose,triangular,truncat,ud,unbranched,unit,vary,vein,wide,without,ympodial	abaxial,adaxial,adhesion,anther,arrangement,colour,corolla,form,growth,height,hermaphroditic,history,inflorescence,leaf,length,life,na,ovary,perennial,plant,position,puberulent,pubescence,reproduction,seed,shape,size,staman,stem,texture
315	wfo-0001028025	success	182	98	71	111	27	0.39	.8,0,0.1-2.2,0.15-0.25,0.2-0.3,0.5-0.7,1.4-2.2,1.5-7,1.6-3.5,13-21,2-2.3,2.5-4,3.5-4.5,5-7,6.5-10,7-13,7-9,absent,acute,anther,apex,attenuate,base,blade,brown,calyx,chartaceous,cm,cordate,diameter,erect,extra-axillary,fruit,glabrous,gland-tipped,globose,green,hair,inflorescence,lavender,length,lobe,lobed,margin,midpoint,mm,obtuse,ovate,pale,pedicel,peduncle,perennial,perfect,petiole,present,ray,rhizomatous,shallowly,short,shrub,simple,sparsely,stellate,stellate-pubescent,stem,style,tube,white,x,yellow,yellowish-green	%,0-0.5,0-11,0.2-0.7,0.3-0.8,0.3-1,0.4-3,0.9-1.2,1-1.4,1-8,1.1-1.4,1.9-2.4,10-140,11-18,12-17,16-23,2-6,2-locular,3-5,3-6,4-10,4-8,5-,5-11,5-20,50-90,6-,7-8,9-14,abaxially,absen,acicular,across,adaxiall,adaxially,alyx,anvil-shape,apart,armed,articulated,axe,ba,broad-based,cross-section,cylindrical,d.,directed,distall,distributed,dult,eaf,eed,eglandular,exocarp,finger,flower,fruiting,half,hig,index,juicy,lamina,lateral,less,lobing,lon,long,longer,lower,mature,merou,mesocarp,mid-point,midvein,minute,moderately,moist,nflorescence,oblique,onl,orolla,part,per,placenta,pore,porrect,prickle,pseudo-racemose,ridged,ruit,sessile,side,spaced,stage,stalked,stellae,straight,tamen,thick,throughout,time,transparent,unarmed,unbranched,unit,unknow,uvenile,vary,vein,wide,ympodial	adhesion,arrangement,climate,colour,corolla,form,glandular,growth,height,history,leaf,life,na,number,ovary,plant,position,presence,pubescence,reproduction,seed,shape,size,staman,stigma,stipe,texture
316	wfo-0001028033	success	157	83	59	98	24	0.376	.6,1.4–1.8,1–5,2–4,3–11,3–4,4–12,4–5,50,6–12,abaxially,anther,brown,calyx,chartaceous,cm,densely,diameter,elliptic,flower,fruit,glabrescent,glabrous,green,growth,herb,hispid-pubescent,lateral,length,light,like,linear-lanceolate,lobe,long,mm,oblong,ovate-lanceolate,pedicel,petiole,pubescence,pubescent,rhizomatous,shrub,simple,solitary,sparsely,spreading,stellate,stem,stigma,style,surface,trichome,tube,uniseriate,upright,white,yellow,×	1.5,1–4,2–3,2–foliate,3,3–5,5-merou,5–7,acuminate,acute,adaxiall,adaxially,along,alyx,anthesi,apex,ark,ascending,attenuate,base,becoming,blade,branch,brochidodromous,capitat,cell,ciliate,connivent,contiguou,cordate,cylindrical,cyme,darker,decurrent,deeply,denser,directed,discolorous,drying,eaf,eed,emarginate,entire,equal,eye,few-branched,filament,florescence,geminat,greenish,high,introrsely,know,known,lobed,longitudinal,lower,mainly,margin,membranaceous,midrib,naked,nearly,new,older,onto,opening,order,orolla,perfect,pore,poricidal,prominent,prostrat,recurved,ruit,secondary,sessile,shin,shiny,shorter,slightly,slit,straight,strongly,subapical,tamen,tem,unbranched,unit,unknown,vary,vein,venation,visible,wide,woody,ympodial	adhesion,arrangement,capitate,colour,corolla,form,height,history,inflorescence,leaf,life,na,ovary,peduncle,plant,position,presence,reproduction,rugulose,seed,shape,size,staman,texture
317	wfo-0001028035	success	172	112	76	96	36	0.442	1,1.3-1.8,1/4-1/3,2,2.5-3.1,2.5-4,3-6,4.2-5.5,5-10,6-13,9-13,along,annual,anther,armed,base,blade,bristly,broadly,brown,calyx,campanulate,capitate,cm,dark,developing,diameter,dry,felty,flattened-ovoid,flower,foveolate,fruit,glabrous,herb,internodal,invested,lanceolate,leaf,lobe,long,long-rayed,main,maturity,midpoint,minutely,mm,narrowly,oblong,ovate,pedicel,pentagonal,petiole,pigmentation,prickly,purple,ray,red,reticulately,seed,short,slightly,spherical,splitting,stellae,stellate,stellate-pubescent,stem,suffused,surface,tightly,tube,undulate,vein,wrinkled,yellow	1.5,2/3,3,3.7-4.2,4-8,5,50-90,7-10,7-10-flowered,accrescent,acicular,across,almost,alyx,ample,anthesi,apically,berry,bristle,broad,broad-based,cauline,closely,confluent,congested,da,dark-based,deep,densely,dia,difoliate,distinct,divided,eaf,erect,exceeding,externall,flattened,geminat,hardly,hilum,incurved,interpetalar,lon,m.,markedly,n,nflorescence,notch,noticeably,numerous,often,one,orolla,other,per,pinnatifid,plicate,prickle,prominent,reaching,recurved,rounded,ruit,scattered,shorter,slende,sometimes,somewhat,spaced,spreading,stalk,stellate-wooll,stout,styl,sunken,symmetrically,tall,tamen,tapering,taprooted,terminal,tigma,tissue,tub,twice,tyle,ultimate,unit,upper,usually,vary,well,wide,yello,ympodial	adhesion,apex,arrangement,climate,colour,corolla,externally,form,glandular,growth,hair,height,history,inflorescence,length,life,margin,na,number,ovary,peduncle,plant,position,presence,present,pubescence,reproduction,rugulose,shape,size,slender,staman,stigma,stipe,style,texture
318	wfo-0001028044	success	195	97	65	130	32	0.333	.9,0.3,0.4-0.5,1.2-1.4,1.5-2,19-22,2-3,2-4,2.7-4,20-21,3-4,3-6,3.4-4.3,31-46,9.5-13,acute,anther,apex,attenuate,base,black,blade,calyx,cm,corolla,creamy,diameter,drying,entire,fleshy,fruit,glabrate,globose,hair,leaf,length,lobe,long-attenuate,margin,mm,oblong,obovate-elliptic,pale,pedicel,peduncle,petiole,pubescent,rough-granular,seed,semi-obtuse,shrub,simple,sparsely,stellate,stigma,style,subcampanulate,surface,thin-textured,tomentose,tube,white,x,yellow,yellow-brown	-3.5,-5,.6,1.3-2.2,1.4-1.6,1/3-1/2,11-13,11-16,16,2.8-3.3,3.5-4.6,4-5,5-merou,50,6-8,6.5-7.2,7.5-9,abaxial,abaxially,accrescent,adaxiall,adaxially,ag,along,alyx,anthesi,apart,around,articulated,ature,axe,axillary,becoming,berry,blunt-tipped,branch,branched,brown,bud,bulbous-based,capitat,closely,concentrated,connivent,cylindrical,dark,decurrent,dendritic,directed,distally,eaf,edge,except,exserted,few-rayed,filament,flower,frui,fruiting,geminate,glabrescen,glabrous,green,greenish,high,homostylous,immature,lackin,lateral,lengthening,lobed,long,long-stalked,longitudinal,lower,main,many,midrib,moderately,mostly,much,multangulat,multangulate,nearly,nflorescence,obscured,obtuse,occur,orolla,ovate-lanceolate,plurifoliate,pore,poricidal,porrect-stellate,presumably,rachi,rather,resorption,ruit,runk,side,slender,slit,somewhat,spaced,sparse,stalked,stamen,suture,tamen,terete,thick,thick-stalked,time,tip,tissue,tomentu,unarme,unbranched,unit,unknown,vary,vein,way,weakly,wide,winged,yellowish,ympodial,young	0.6,adhesion,arrangement,capitate,climate,colour,form,glandular,growth,height,history,inflorescence,life,midpoint,na,number,ovary,perennial,plant,position,presence,present,pubescence,ray,reproduction,rugulose,shape,size,staman,stem,stipe,texture
319	wfo-0001028046	success	186	104	78	108	26	0.419	0.5-1,1-1.5,1-7,1.5-2,12-13,13-38,2-3,2-4,2.5-3,3-12,4-5,5-18,6-7,8-9,acuminate,acute,anther,apex,attenuate,base,blue,brown,calyx,campanulate,chartaceous,clavate,cm,coriaceous,corolla,diameter,elliptic,entire,flattened,flower,foliaceous,glabrous,glandular,globose,green,growth,inflorescence,lanceolate-subulate,leaf,length,like,lilac,lobe,long-styled,margin,midpoint,mm,obovate,opposite,ovary,pedicel,peduncle,petiole,pubescence,pubescent,ray,reniform,rest,shrub,simple,slightly,stellate,stem,stigma,style,sub,subglobose,subhirsute,surface,tapering,truncate,tube,x,yellow	0.2-0.3,0.3-0.5,0.4-0.5,1-1.3,1-multicellular,1.2-1.5,10,10-15,20,abaxially,adaxially,anthesi,approximately,armed,articulated,bark,basal,berry,c.,compressed,cylindrical,dark-brown,decurrent,deflexe,densely,denser,difoliat,distal,eaf,eed,erect,exserted,filament,foveolate,free,fruiting,glabrescent,gland-tipped,grayish,half,heterostylous,large,lengthening,lightly,lobed,long,lower,minute,minutely,mixed,multangulate,multicellular,nearly,new,nflorescence,obverse,occasionally,older,ovoid,papillo,per,perfect,pericarp,pore,poricidal,porrect,portion,prickle,prickly,prominent,raise,red,reduced,reflexed,rigid,ruit,rusty,rusty-red,scabrous,scar,sessile,short-styled,slit,somewhat,spaced,sparse,sparsely,stalked,staminate,subcordate,subscandent,subsessile,tall,testa,thick,tip,tomentose,tomentose-scabrous,trichome,ud,unarmed,unevenly,unicellular,unit,upper,winged,ympodial,¼	adhesion,arrangement,blade,climate,colour,form,fruit,hair,height,history,life,na,number,perennial,plant,position,presence,present,reproduction,rugulose,seed,shape,size,staman,stipe,texture
320	wfo-0001028059	success	221	113	88	133	25	0.398	-4.5,0-0.3,0-1.2,0-2,0.1-0.3,0.4-0.8,0.4-0.9,0.5-0.7,0.5-1.3,1-3,1.1-12,1.5-2,1.5-2.1,1.5-3.5,2-10,2-5,2.5-2.6,2.5-3.5,3-17,4-7,4-8,4.5-7,8.5-10,acuminate,acute,adaxially,andromonoecious,anther,apex,attenuate,base,blade,brown,brownish,calyx,chartaceous,cm,connivent,cuneate,deltate,densely,diameter,elliptic,entire,erect,fruit,glabrous,glandular,globose,green,hair,inflorescence,leaf,leaf-opposed,length,lilac,lobe,loosely,margin,midpoint,mm,moderately,oblate,oblong,obtuse,ovate,pale,pedicel,peduncle,perennial,petiole,plant,present,purple,ray,rhizomatous,shrub,simple,sparsely,stellate,stellate-pubescent,style,toward,tube,weakly,x,yellow,yellowish-green	%,.4,0-0.2,0-15,0-7,0.1-0.6,0.1-0.7,0.4-0.7,0.5-0.8,0.6-0.8,0.6-1,1,1-1.5,1-2,1.1-4.5,15,2-2.6,2-3,2-foliate,2-locular,2.1-2.7,2.5-12,3-10,3-11.5,4-10,5-7,5-9,5-merou,6-17,60-90,8-18,9-12,9-17,abaxially,absen,absent,accrescent,acicular,across,adaxiall,adult,alyx,anvil-shape,apart,articulated,ascending,axe,ba,bark,branch,branche,contiguous,corky,cross-section,cylindrical,decimetre,directed,distall,distributed,dm,eaf,eed,eglandular,exocarp,filament,finger,flower,fruiting,functional,furrowed,geminat,gland-tipped,half,heterostylous,interpetalar,juicy,juvenile,lamina,lateral,less,lobed,long,longer,lower,mature,mesocarp,mid-point,midvein,minute,moist,nearly,nflorescence,oblique,often,orolla,pair,part,per,placenta,pore,porrect,prickle,pseudo-racemose,rachi,ruit,rusty,shallowly,short,somewhat,spaced,sparse,stalk,stalked,stellae,straight,surface,tal,tamen,tem,thick,throughout,time,tissue,transparent,unarme,unarmed,unbranched,unit,upper,vary,wide,yellowish,ympodial	adhesion,arrangement,climate,colour,corolla,form,growth,height,history,life,na,number,ovary,position,presence,pubescence,reproduction,seed,shape,size,staman,stem,stigma,stipe,texture
321	wfo-0001028067	success	139	103	70	69	33	0.504	0.5-1,0.5-1.5,0.5-2,1-2,1-3,1-7,1.5-2.5,10-25,2,2-2.5,2.5-3,3-17,3-5,3-7,5-7,6-18,7-11-compound,7-20,7-9,abaxially,acuminate,acute,adaxially,apex,base,blade,calyx,cm,connivent,cuneate,dark,diameter,elliptic-fusiform,elliptic-ovate,entire,flattened,fruit,glabrous,hair,leaf,lobe,margin,mm,moderately,narrowly,pedicel,peduncle,petiole,pink,pinnately,puberulent,purple,rarely,ripe,shrub,simple,sparsely,stellate,stigma,strongly,style,subcoriaceous,tomentulose,triangular,triangular-deltate,truncate,tube,unknown,x,yellow	-30,1,1-10,1-11,2-3,3-4,4-foliat,6-12,8-13,adaxiall,aggregate,along,apart,articulated,axe,basiscopically,cell,chartaceous,color,compound,cylindrical,decurrent,directed,distall,eaf,eed,especially,flower,glabrou,lateral,leaflet,leaving,lon,long,lower,midrib,nearly,nflorescence,nther,obtuse,often,orolla,pedicellar,per,pore,puberulen,rachi,radiu,remnant,ruit,several,slightly,smal,spaced,stone,tal,tem,time,tip,truncat,unbranched,unequal,unit,upper,usually,vary,wide,ympodial,zigzag	adhesion,anther,arrangement,climate,colour,corolla,form,glandular,growth,height,history,inflorescence,length,life,midpoint,na,number,ovary,plant,position,presence,pubescence,ray,reproduction,rugulose,seed,shape,size,staman,stem,stipe,surface,texture
322	wfo-0001028069	success	253	96	74	179	22	0.292	0.05-0.1,0.3-0.45,0.3-0.6,0.4-0.5,0.4-0.8,0.5,0.5-1.8,0.6-1.1,0.6-4,0.8-1.2,1-3.5,1.5-2.0,1.6-3.2,10,10-12,2-17,3,5-25,along,anther,brown,calyx,cm,composed,conical,corolla,deep,dense,densely,diameter,fruit,glabrescent,glandular,glandular-villous,globose,green,herb,imparipinnate,interrupted,leaf,length,less,linear,lobe,long,midvein,minute,minutely,mm,obovate,orange,ovary,ovate,pale,pedicel,peduncle,pentagonal,perennial,petiole,plant,pubescence,pubescent,simple,size,stem,stigma,style,surface,thick,trichome,tube,uniseriate,wide,yellow	-0.4,-30,-6,.1,.1-0.2,.2,.5,0.1-0.15,0.1-0.2,0.1-0.3,0.1-0.5,0.1-0.6,0.2-0.3,0.2-0.5,0.3,0.3-0.4,0.3-0.7,0.3-1,0.4,0.4-1,0.5-0.7,0.5-2,0.7-1,0.7-1.3,0.7-1.5,1-2-celled,1-2.7,1-4.5,1.4,1.5-3.5,10-30,12,2-3-branched,2-4,2-7,2-locular,3-,3-foliate,4-celled,5-22,6-,<,abaxially,absen,abundant,accrescent,acute,adjacent,adpressed,alternate,always,among,anthesi,apex,apical,appearance,appendage,appressed,articulated,axi,ba,basal,base,basioscopically,becoming,berry,bilaterally,bract,bracteole-like,bright,cell,citru,column,cone-shaped,cordate,cuneate,curving,decurrent,deeply,due,eaf,ebracteate,edicel,eed,eglandular,erect,exserted,filament,flower,forming,fruiting,fusion,giving,gland,gland-tippe,gland-tipped,gree,hair-like,half,halfway,head,included,initially,interjected,internode,larger,later,lateral,leaflet,like,lime,lobed,lon,longer,longest,lower,margin,maturity,middl,multicellular,narrowly,nflorescence,oblique,occasionally,often,one,outgrowth,pair,patent,per,petiolule,population,present,primary,procumbent,pseudostipule,quaternary,rarely,reflexed,robust,rounded,ruit,scarcely,scent,secondary,sessile,several,shaggy,short,shorter,silky,single-celled,slender,smaller,somewhat,staminal,sterile,straight,strong,subopposite,symmetric,tangled,tem,terminal,tertiary,testa,tightly,toward,transparent,ud,unicellular,unit,usually,varying,viny,wall,weak,winged,ympodial	adhesion,arrangement,colour,form,growth,height,history,inflorescence,life,na,number,position,presence,ray,reproduction,rugulose,seed,shape,staman,stellate,texture,ye
323	wfo-0001028070	success	185	120	94	91	26	0.508	0-0.15,0-0.4,0-2,0.2-0.3,0.3-0.6,0.35-0.5,0.4-0.6,0.4-0.8,0.5-0.9,0.5-1.5,1-1.5,1-2,1.5-2.5,3.5-4,4-5.5,4-6,4-7,5-9,7-11,7-8,8-9.5,absent,acute,adaxially,andromonoecious,anther,apex,articulated,base,blade,brown,calyx,chartaceous,cm,connivent,cuneate,cylindrical,dark,deltate,densely,diameter,entire,erect,extra-axillary,flower,fruit,gland-tipped,globose,green,hair,inflorescence,juicy,lanceolate,lateral,lavender,length,linear,lobe,long,margin,mid-point,midpoint,mm,moderately,moist,oblique,obtuse,pale,part,pedicel,peduncle,perennial,petiole,plant,present,ray,rhizomatous,rusty,short,shrub,simple,sparsely,stellate,stellate-pubescent,stem,stigma,streak,style,thick,time,tube,white,x,yellow	%,.05,0-0.1,0-6,0.15-0.4,0.25-0.35,0.3-0.4,0.4-0.5,0.5-1,0.6-1.4,0.7-1.3,1-4,1-locular,1.5-7,10-40,3-7,3-8,4-9,5-7,5-merou,8-13,8-9,8.5-17,abaxially,absen,accrescent,acicular,across,adaxiall,alyx,apart,axe,ba,cross-section,d.,directed,distall,distributed,dult,eaf,eed,eglandular,exocarp,finger,fruiting,functional,geminat,half,heterostylous,hig,incomplete,lamina,less,longer,lower,mature,mesocarp,midvein,minute,nflorescence,orolla,per,placenta,pore,porrect,prickle,pseudo-racemose,pseudo-umbellate,purple,ruit,semi-circula,septum,sessile,spaced,stage,stalk,stellae,straight,tamen,throughout,truncat,unarme,unarmed,unbranched,unit,unknow,uvenile,vary,weakly,wide,ympodial	adhesion,arrangement,climate,colour,corolla,form,glandular,growth,height,history,leaf,life,na,number,ovary,position,presence,pubescence,reproduction,seed,shape,size,staman,stipe,texture,truncate
324	wfo-0001028075	success	196	113	79	117	34	0.403	1-2,1.5-2.5,1.6-2.7,10-35,2-4.5,2-6,3-23.5,4-7,5-17,5-7,5-9,7-30,8-12,abaxially,acuminate,acute,adaxially,anther,apex,axillary,base,blade,broadly,brownish,bud,chartaceous,ciliate,cm,condition,corolla,dark,diameter,drying,elliptic-lanceolate,fresh,fruit,glabrescent,glabrous,globose,green,greenish,herb,lanceolate,leaf,light,lobe,long,margin,membranous,minutely,mm,oblique,obtuse,odd-pinnate,ovate,ovate-elliptic,ovoid,pale,pedicel,peduncle,pentagonal,petiole,plant,puberulent,rotate,rounded,seed,size,stigma,style,subcordate,subtending,terminal,tube,white,whitish,wide,x,yellow	.5,1-10,1-2.7,1-3,1.5-7,2-3,2.5-10,3-11,4-12,5-12,5-14,5-8,5-merou,7-13,absent,acuman,acumen,ag,along,alyx,apart,apparently,articulated,axe,berry,borne,capitat,cell,connivent,covering,cuneate,decreasing,differentiated,digestion,distal,distally,distinctively,dorsally,dot,eaf,edge,eed,end,enzyme,erec,especially,exceeding,filament,flat,flower,folded,forked,geminat,generally,glabrescen,green-white,hair-like,half,homostylous,honeycomb-shaped,interjected,larger,lateral,leaflet,lengthening,ligulate,living,lower,make,middl,midrib,much,mucilaginous,narrow,nflorescence,often,orolla,pair,perfect,petiolule,plurifoliate,pore,poricidal,purple,reflexed,removed,ruit,scattered,seudostipule,singly,slightly,slit,sometimes,spaced,specimen,stamen,star,stolo,straight,tall,tamen,tem,testal,thick,throughout,tip,toward,tri-,tuber,typically,unit,usually,vary,wall,wet,wing,ympodial	adhesion,arrangement,calyx,capitate,climate,colour,form,glandular,growth,hair,height,hermaphroditic,history,inflorescence,length,life,midpoint,na,number,ovary,perennial,position,presence,pubescence,ray,reproduction,rugulose,shape,staman,stellate,stem,stipe,surface,texture
325	wfo-0001028076	success	195	94	70	125	24	0.359	.5,0.4-0.5,1-1.3,1-2,1.8-2.2,110,12-22,13-14,2-5.4,2.2-2.6,2.5-4,4-5,5-20,5-6,5-6.5,7-8,abaxially,adaxially,anther,attenuate,axillary,brownish,bud,chartaceous,cm,condition,conical,corolla,diameter,drying,elliptic,fresh,fruit,glabrous,green,greenish,herb,lanceolate,leaf,less,light,lobe,long,membranous,mm,odd-pinnate,ovate,ovoid,pedicel,peduncle,pentagonal,petiole,plant,pubescent,purple,rarely,ripe,rotate,seed,size,stem,stigma,style,subtending,terminal,tube,whitish,wide,x,yellow	0.5,1-10,1-3,1.2-2.2,2-12,2-3,2.2-3.7,2.5-3,2.6-3.8,4.5-7,5,5-merou,?,absent,acumen,acuminate,ag,alyx,apart,apex,apparently,articulated,axe,base,berry,blade,borne,capitat,cell,ciliate,connivent,covering,decreasing,densely,digestion,distal,dorsally,eaf,edge,eed,end,enzyme,erec,especially,exceeding,filament,flat,flower,folded,forked,geminat,generally,glabrou,gradually,green-white,hair,hair-like,half,homostylous,honeycomb-shaped,interjected,larger,lateral,leaflet,lengthening,like,living,lower,make,margin,medium,minute,mucilaginous,nflorescence,obtuse,orolla,pair,perfect,petiolule,plurifoliate,pore,poricidal,proximal,pubescen,ray,removed,round,ruit,secondary,semierect,sessile,seudostipule,singly,slightly,slit,spaced,specimen,stamen,ste,stolo,straight,subequal,subsessile,symmetrical,tall,tamen,tem,testal,thick,thir,throughout,tip,toward,tri-,tuber,typically,unit,unwinged,usually,vary,wall,wet,white,wing,ympodial	adhesion,arrangement,calyx,capitate,colour,dense,form,growth,height,history,inflorescence,length,life,na,ovary,perennial,position,pubescence,reproduction,rugulose,shape,staman,surface,texture
326	wfo-0001028080	success	187	113	85	102	28	0.455	0.25-0.5,0.5-1.5,0.5-2,0.5-3,1,1-1.5,1.5-2,1.5-5,2-2.5,2-8,2.5-3,2.5-9,20-30,3-4,30-40,5-12,6-7,8-10,abaxially,acute,adaxially,andromonoecious,anther,apex,armed,base,blade,brown,calyx,chartaceous,clavate,cm,densely,diameter,ellipsoidal,entire,equal,extra-axillary,flattened,flower,form,fruit,glabrous,glandular,green,hair,lanceolate,leaf-opposed,linear-lanceolate,lobe,margin,midpoint,mm,moderately,outline,ovate,ovoid,pedicel,peduncle,pendent,perfect,petiole,plant,puberulent,pubescent,ray,reniform,rugulose,shrub,simple,sparsely,stellate,stellate-pubescent,stem,stigma,style,subcordate,surface,truncate,tube,unbranched,white,white-pubescent,x,yellow	0.2-1.5,1-2,1-3,2-10,2-3,2-5,4-6,5-6,5-merous,absent,accrescen,acuminate,adaxiall,alyx,andromonoeciou,apart,articulated,axe,ba,bark,berry,branch,brownish,capitat,connivent,cylindrical,directed,distally,eaf,eed,eglandular,filament,fine,fissure,formed,free,fruiting,geminat,gradually,hermaphroditic,heteromorphic,interpetalar,lateral,like,long,long-,long-stalked,longitudinal,lower,lowering,major,midvein,multangulate,narrowly,needle-like,nflorescence,opening,orolla,part,pericarp,persistent,plurifoliate,pore,porrect-stellate,prickle,projection,rachi,recurved,ruit,scandent,sessile,short-,short-stalked,short-styled,shorter,side,slit,small,sometimes,spaced,staminate,stellate-multangulate,straight,strongly,tall,tamen,tapered,thi,time,tissue,triangular,unarmed,unequal,unit,vary,vein,vertical,weakly,whitish,wide,without,ympodial	adhesion,arrangement,capitate,climate,colour,corolla,growth,height,history,inflorescence,leaf,length,life,na,number,ovary,perennial,position,presence,pubescence,reproduction,seed,shape,size,staman,stipe,texture,ye
327	wfo-0001028105	success	150	123	90	60	33	0.6	.4,.5,0.3-1.5,0.5,0.5-1,0.5-2,0.6-1,1-1.2,1-1.5,1-2.5,1.5,1.5-1.8,1.5-2,1.5-4.5,2,2-2.2,2-5,3-5-celled,3-6,3.5-4,9.5-15,abaxially,acuminate,adaxially,anther,apex,apical,attenuate,axil,base,bilobed,calyx,clavate,cm,conical,corolla,dark,dense,dia,distinct,elliptic,flattened-reniform,glabrous,glandular,globose,green,incrassate,leaf,lobe,lobed,long,major,margin,minor,minutely,mm,nearly,opposite,ovary,pale,pedicel,petiole,pitted,pore,poricidal,projection,pubescent,quadrate,reddish-brown,scattered,shaped,shrub,simple,size,slightly,small,stem,stigma,style,surface,tear-drop,tip,tree,trichome,tube,tuft,uniseriate,vein,white,x	.1,5-7-flowered,6-7,acute,anthesi,apar,axi,ba,bark,berry,deflexed,differing,difoliate,drying,eaf,edicel,eed,ellipsoid,erect,evenly,exserted,filament,filiform,free,fruiting,geminat,greenish-yello,lamina,lateral,like,lon,lower,main,middle,nflorescence,occasionally,older,olive-green,pair,papillo,papillose,planar,portion,reflexed,ruit,scar,spaced,sparsely,spreading,straight,strongly,tall,tub,ud,unit,widest,woody,yellowish,ympodial,young	adhesion,arrangement,blade,climate,colour,diameter,form,fruit,greenish-yellow,growth,hair,height,history,inflorescence,length,life,midpoint,na,number,peduncle,plant,position,presence,pubescence,ray,reproduction,rugulose,seed,shape,staman,stellate,stipe,texture
328	wfo-0001028109	success	205	124	93	112	31	0.454	-20,-4,-7,0.1-0.2,0.4-1.5,0.45-0.65,0.5-2.5,0.6-0.8,0.8-1.5,1.5-2.5,1.5-5.5,10-25,12-40,2-4,2.3-2.9,2.5-3,2.5-5,2/3-3/4,20-60,3-,4-13,5-13,8-25,abaxially,acuminate,acute,almost,anther,apex,apically,base,berry,blade,bright,calyx,chartaceous,cm,connivent,cuneate,deltate,densely,diameter,dull,elliptic,entire,equal,evenly,flattened-reniform,fruit,glabrescent,glabrous,green,lateral,leaf,length,lobe,lobed,long,margin,maturity,mauve,midpoint,mm,moderately,obtuse,orange-brown,pedicel,peduncle,petiole,poricidal,ray,red,shrub,simple,small,smooth,sometimes,spherical,stellate,stellate-pubescent,stem,style,tapering,terminal,tip,tree,tube,way,weakly,white,wide,yellow,young	.5,/3,0.05-0.15,0.05-0.2,0.1,0.3,0.4-0.8,0.5-1.2,0.7,0.8-1.6,1.5-10,1/8-1/4,10-30,15-100,2-15,3-7,3.5-6,3/4,30-150,4-5-merous,5-30,8-12,8-15,abaxial,acut,adaxial,alyx,ame,apar,apart,apparently,articulated,bark,branching,brow,c.,curved,dimorphic,discolorous,drying,eaf,eed,elongating,erect,filament,flower,free,fruiting,fully,geminate,gently,glabrou,gray-green,green-brown,infructescence,light,long-styled,longer,lower,mature,minor,multangulate,nflorescence,occasionally,older,one,open,opening,orolla,oung,pair,per,perfec,pericarp,perpendicular,plurifoliat,porrect,portion,prickl,prickle,prickly,primary,recurved,red-brown,reflexed,ruit,scar,secondary,sessile,slender,spaced,spreading,stalk,stalked,straight,strongly,surface,tamen,terete,tertiary,time,trichome,unarme,unarmed,unit,usually,vary,vein,venation,visible,woody,ympodial	adhesion,arrangement,climate,colour,corolla,form,glandular,growth,hair,height,history,inflorescence,life,na,number,ovary,perennial,plant,position,presence,present,pubescence,reproduction,seed,shape,size,staman,stigma,stipe,texture,unknown
329	wfo-0001028115	success	165	113	74	91	39	0.448	0.42,0.7-0.8,1.1-1.8,1.4-1.7,1.7-2.2,1.8-3.5,2-3.2,5-15,6-10,abaxially,abundant,acute,adaxially,anther,antrorse,apex,attenuate,basal,base,blade,blue,calyx,campanulate,capitate,cm,diameter,ellipsoidal,elliptical,entire,filament,glabrescent,glabrous,glandular,globose,half,herb,length,light,linear,lobe,long,margin,mixed,mm,moderately,narrowly,non-glandular,one,ovate,pale,petiole,pinnatifid,pinnatipartite,pinnatisect,prostrate,pubescent,rarely,scarce,seed,similar,small,stem,stigma,style,trans-ovoidal,triangular,trichome,tube,tuberculate,unifoliate,violet,wide,x,yellow	-1.1,-2.5,-5.2,.2,.6,0.2-0.3,0.5,0.6-0.7,0.8-,1-2.4,1-3,1.3-1.8,12-13.5,2-,2.5-,3-4.5,3-5,3-6.5,4.7-,5-8.5,7-7.5,9-17,accrescent,acuminat,ag,alternate,amply,annular,articulate,berry,coat,connectival,curved,difoliat,dorsal,eaf,eed,embryo,especially,evident,exceeding,fruiting,growing,herbaceous,hig,inflated,longer,longitudinal,longitudinally,lower,much,multi-seeded,near,nerve,oblong,opening,opposite,orolla,pair,papery-scarious,papillo,pore,poricidal,portion,prolongation,ree,reticulate,ridged,ruit,segment,simple,slender,slightly,slit,smooth,sometimes,strongly,styl,subsessil,tem,time,tip,unequal,uniseriate,unit,vary,venation,wider,width,winged,ympodial	0.6,2-6.5,2.5-4.5,adhesion,arrangement,climate,colour,corolla,difoliate,form,fruit,growth,hair,height,history,inflorescence,leaf,life,midpoint,na,number,ovary,pedicel,peduncle,perennial,plant,position,presence,pubescence,ray,reproduction,rugulose,shape,size,staman,stellate,stipe,surface,texture
330	wfo-0001028131	success	208	111	79	129	32	0.38	.5,0.1-0.15,0.2-1.5,0.3-0.7,0.4-0.8,0.5-1.1,0.8-1.1,1.5-3,1.8-2.2,2-2.8,2-4,2-6.5,4-6,5-6.5,5-8,absent,anther,apex,attenuate,base,blade,calyx,chartaceous,cm,connivent,cream,dark,deltate,densely,diameter,dull,equal,flattened-reniform,fruit,glabrescent,glabrous,green,herb,lateral,leaf,length,lobe,lobed,long,margin,marking,mature,mauve,membranous,midpoint,mm,moderately,narrow-obovate,narrow-ovate,oblong,obtuse,orange,orange-brown,pale,pedicel,peduncle,petiole,purple,ray,red,rounded,simple,sparsely,spherical,spreading,stellate,stellate-pubescent,stem,style,surface,tube,wide,yellow,young	-1.2,.1,/5,0-0.6,0-2,0-3,0-30,0-4,0.05-0.2,0.1-0.3,0.7-1.1,0.8-1,1-10,1-3,1-4,1-5,1.5-5,1.8-2,1/4-2/3,1/5,2-5,2/3,3-6,5-merous,6-7,7-8,abaxial,abaxially,acuminat,adaxial,alyx,apar,apart,apically,apparently,articulated,bark,berry,branched,broad-deltate,cell,concolorous,curved,difoliate,distance,drying,eaf,eed,elongating,epidermi,erect,extending,eye,filament,filiform,flattened,flower,free,fruiting,geminat,gland,infructescence,lanceolate,lengt,like,longer,lower,maturity,midvein,naked,nflorescence,often,older,one,open,orolla,oung,outline,pair,pale-brown,pale-gra,pendulous,per,perfec,pericarp,pit,poricidal,porrect,portion,prickl,prickle,prickly,primary,raised,reduced,reflexed,ruit,scar,sessil,sessile,shiny,shorter,side,small,smooth,sometimes,spaced,straight,strongly,sunk,tamen,tapering,terete,tertiary,time,tip,trichome,unarme,unarmed,unit,upper,vary,vein,venation,visible,way,woody,yellow-green,ympodial	adhesion,arrangement,climate,colour,corolla,form,glandular,growth,hair,height,hermaphroditic,history,inflorescence,life,na,number,ovary,perennial,plant,position,presence,present,pubescence,reproduction,rugulose,seed,shape,size,staman,stigma,stipe,texture
331	wfo-0001028147	success	185	103	83	102	20	0.449	.5,0.25,0.5,0.6,1.5–2,1.5–5.5,15–20,1–2,1–4,2–4,3-5,3.5–9,4-5,5–10,6–9,7–10,abaxially,adaxially,anther,anthesi,articulated,base,broadly,brown,calyx,campanulate,chartaceous,cm,connivent,corolla,dark,deltate,diameter,dry,except,flattened-reniform,glabrous,globose,green,herbaceous,immature,lanceolate,lateral,light,lobe,long,mature,mm,mottled,narrowly,oblong,orange,ovate,ovoid,pale,pedicel,peduncle,petiole,puberulent,rugose,seed,shape,simple,slender,somewhat,stellate,stem,stigma,style,surface,terminal,tip,tube,turning,vine,white,wide,woody,x,yellow,yellow-green,yellowish-orange,×	1.6–2.3,10–15,1–5,2–7,2–8,3.5–4.5,3–4,3–6,5–12,absent,acuminate,acute,ag,alyx,apex,appearing,armed,axe,becoming,berry,blade,branched,break,bud,cell,cuneate,deciduous,decurrent,dr.,eaf,eed,ellipsoid,elongate,elongating,entire,equal,exserted,fifth,filament,five,flower,four,fruiting,hairy,internode,interpetalar,larger,lengthening,lobed,long-styled,longer,lower,major,margin,midrib,minutely,nearly,nflorescence,often,one,orange-red,orolla,outer,paired,pentagonal,pericarp,pitted,plurifoliat,pore,poricidal,prickle,pulp,rachi,rarely,recurve,recurved,robust,ruit,season,seen,shallowly,short-styled,side,slightly,slit,spine,spreading,stout,straight,subcaudate,tamen,testal,time,tissue,truncat,unequal,unit,vary,vein,wall,wood,ympodial	adhesion,arrangement,colour,form,fruit,growth,inflorescence,leaf,length,na,ovary,position,presence,pubescence,rugulose,size,staman,texture,truncate,ye
332	wfo-0001028148	success	157	129	98	59	31	0.624	-6,0.25-0.5,0.5-1.5,0.6-3.5,0.75-2,1-3.5,1.5,1.5-2.5,12-15,2,2-3,2.5-4,3.5-4,3.5-9,5,5-7,6-18,abaxially,acute,adaxially,angled,apex,apiculate,articulated,base,blue-black,branched,broadly,calyx,cm,connivent,cylindrical,dark,deltate,densely,diameter,distal,elliptic,especially,except,fleshy,fresh,fruit,glabrous,glaucous,globose,hair,highly,less,light-colored,lobe,material,mature,minute,mm,moderately,narrowly,obtuse,often,orange,ovate,part,pedicel,peduncle,petiole,pink,plicae,plicate,puberulent,puberulent-pubescent,purple,rarely,rhizomatous,ridge,ripe,rotate-stellate,scalloped,shrub,simple,slender,slightly,smooth,sometimes,sparse,stigma,style,succulent,surface,tip,treelet,triangular,tube,unbranched,violet,whitish,x,yellow,young	.5-4,1-15,10-30,15,2-7,20-50,4-10,4.5-10,5-10,5-20,5-8,absen,aggregate,apart,axe,ba,blade,cell,central,chartaceous,decurrent,directed,distall,eaf,eed,entire,flower,long,lower,many-foliat,margi,margin,midrib,nflorescence,nther,orolla,perfect,pore,puberulence,rachi,radiu,ruit,smoot,spaced,star,stone,tal,tapered,tem,thickened,time,truncat,unit,usually,vary,white,wide,winge,ympodial	0.5-4,adhesion,anther,arrangement,colour,corolla,form,growth,height,history,inflorescence,leaf,length,life,na,ovary,plant,position,presence,pubescence,reproduction,rugulose,seed,shape,size,staman,stellate,stem,texture,truncate,winged
333	wfo-0001028161	success	124	100	62	62	38	0.5	.5,0.1-0.25,1-1.3,1-1.5,1.5-4.5,2-9,2.5-3,3-4,3-7,4-5,7.5-12,abaxially,acuminate,acute,adaxially,apex,attenuate,base,branched,brown,calyx,cell,closely,cm,corolla,dendritic,densely,dia,elliptic,globose,green,incrassate,lanceolate,leaf,like,long,margin,minutely,mm,narrowly,opposite,outline,ovoid-reniform,pale,pedicel,petiole,pitted,pubescence,pubescent,reddish-brown,rest,shape,shrub,sinuate,size,somewhat,sparsely,stem,surface,tan,trichome,x	0.25-0.5,0.7-1.7,1-2,1-2.3,1/3,2-5-flowered,6-9,9-11,along,anthesi,arising,ba,bark,berry,branch,congested,consisting,deflexed,denser,differing,difoliate,distal,eaf,edicel,eed,exserted,fruiting,geminat,glabrescen,inflorescenc,later,lateral,lon,main,major,middle,minor,nflorescence,obovoid,often,older,orbicular,overlappin,pair,probably,rounded,ruit,scar,short,simple,spaced,strongly,tall,tapering,thin,tub,ud,unit,vein,widest,ympodial,young	adhesion,anther,arrangement,blade,climate,colour,diameter,form,fruit,glandular,growth,hair,height,history,inflorescence,length,life,lobe,midpoint,na,number,ovary,peduncle,perennial,plant,position,presence,ray,reproduction,rugulose,seed,staman,stellate,stigma,stipe,style,texture,tube
334	wfo-0001028164	success	197	129	104	93	25	0.528	-1,-14,-6,/4,0.05-0.2,0.4-0.8,0.5-0.8,0.5-1,0.7-1.1,0.9-1.6,1-4.5,1.8-2.5,1/3,2.5-4,2.5-4.5,2.8-4,3-17,3-7,3.6-4.8,4-8,8-17,abaxially,acuminate,acute,anther,apex,apically,attenuate,base,berry,blade,bright,calyx,cm,connivent,deltate,densely,diameter,dull,elliptic,entire,equal,erect,evenly,flattened-reniform,fruit,glabrescent,glabrous,glandular,gray,green,hair,lateral,leaf,length,lobe,lobed,long,margin,maturity,mauve,membranous,midpoint,midvein,minute,mm,moderately,multangulate,obtuse,orange-brown,pale,pedicel,peduncle,petiole,poricidal,porrect,ray,red,sessile,shallowly,shrub,simple,sometimes,sparsely,spherical,spreading,stellate,stellate-pubescent,stem,style,surface,tapering,terminal,tip,trichome,tube,unarmed,undulate,upper,way,white,wide,yellow,young	-8,0-20,0.05-1.5,0.1,0.3-0.8,0.8-1.5,1,1-1.5,1.5-2.5,1/6-1/4,12-20,2-2.5,4-13,4-5-merous,4-7,6-8,8-15,abaxial,almost,alyx,ame,apar,apparently,articulated,bark,branched,c.,concolorous,curved,dark,difoliate,drying,eaf,eed,elongating,eye,filament,filiform,flower,free,fruiting,geminat,glabrescen,glabrou,infructescence,less,long-acuminat,longer,lower,mature,naked,narrow-deltate,nflorescence,often,older,one,open,orolla,oung,pair,per,perfec,pericarp,portion,primary,recurved,red-brown,reflexe,ruit,scar,shorte,shorter,side,smooth,spaced,stalk,stalked,straight,tamen,terete,tertiary,time,unarme,unit,variously,vary,vein,venation,visible,woody,yellow-gra,yellow-green,ympodial	adhesion,arrangement,climate,colour,corolla,form,growth,height,inflorescence,long-acuminate,na,number,ovary,plant,position,presence,pubescence,seed,shape,size,staman,stigma,stipe,texture,yellow-gray
335	wfo-0001028180	success	147	91	68	79	23	0.463	.5,1-1.2,1-1.5,1-1.8,1-3,15-28,2-3,2.5-3,3-4,4.5-5,5-6,5-8,7,along,anther,base,calyx,capitate,cm,conical,corolla,darker,deltate,densely,dia,drying,elliptic,glabrous,globose,golden,green,irregularly,leaf,lobe,lobed,long,margin,minutely,mm,nearly,opposite,ovary,ovoid-reniform,pale,papillose,pedicel,petiole,pinkish-white,pitted,poricidal,puberulent,pubescent,shiny,size,sparsely,stem,stigma,style,surface,tan,tip,tree,trichome,tube,uniseriate,white,x,yellow-gray	.05,/2,0.7-1,1.5-5,2-2.2,20-30-flowered,3-10,8-10,abaxially,acute,adaxially,anthesi,apex,attenuate,ba,bark,beginning,berry,c.,closely,cucullate,dark,deflexed,differing,difoliate,distinctly,eaf,eed,elongate,erect,falcate,filament,fleshy,four-angled,free,fruiting,geminat,glabrat,gold,know,larger,lateral,leathery,lon,lower,main,major,midrib,minor,nflorescence,obscure,older,onto,overlappin,pair,planar,pore,portion,ruit,scar,shaped,simple,small,somewhat,spaced,straight,styl,tall,tear-drop,thick,ud,underside,unit,vein,way,winged,woody,ympodial,young	arrangement,colour,diameter,form,fruit,glabrate,growth,height,history,inflorescence,length,life,na,peduncle,perennial,plant,position,pubescence,reproduction,rugulose,seed,shape,texture
336	wfo-0001028182	success	150	102	68	82	34	0.453	0.5,0.5-1,0.8-1,0.9-1,1-1.5,2-2.5,2-6.5,3-5,6-9,along,anther,apex,apiculate,base,beneath,black,blade,calyx,capitate,ciliate,cm,conical,cordate,corolla,deltoid,dry,glabrous,hemiepiphyte,inflorescence,internodal,leaf,less,like,lobe,lobed,long,long-acuminate,margin,material,midrib,minutely,mm,narrowly,nearly,opposite,ovary,ovate,papillose,pedicel,petiole,poricidal,pubescent,shiny,shrub,simple,somewhat,sparsely,stem,stigma,style,surface,tip,trichome,truncate,tube,uniseriate,white,x	.5,0-90,0.1-0.2,0.5-0.6,2,3,4-6,5-15-flowered,5-ribbed,anthesi,apart,apiculae,arching,axi,bark,bending,branch,brown,deflexed,densely,dia,eaf,edicel,eed,ellipsoid,evenly,except,extreme,filament,filiform,flower,free,globose,gre,keeled,know,known,later,lateral,lax,lower,main,minute,nflorescence,obovoid,older,pair,papillo,planar,pore,portion,present,prominent,proximal,purplish,reflexed,rib,rounded,ruit,sca,scar,shaped,slender,slightly,spaced,sparser,specimen,spindly,still,strongly,tapering,tear-drop,third,time,ud,unifoliat,unit,vein,widest,ympodial,young,zig-zag	adhesion,arrangement,climate,colour,diameter,form,fruit,glandular,grey,growth,hair,height,history,length,life,midpoint,na,number,peduncle,plant,position,presence,pubescence,ray,reproduction,rugulose,seed,shape,size,staman,stellate,stipe,texture,unifoliate
337	wfo-0001028183	success	237	141	111	126	30	0.468	-10,0.2-0.3,0.2-0.4,0.2-0.5,0.5,0.5-2.5,0.7-1.2,0.8-1.4,1.1-1.8,1.2-1.4,1.3-1.7,1.4-2.8,1.5-3.4,1.9-3.7,10-15,11-30,2-4.2,2-5,2.8-4.2,4.5-9,5.2-6.2,6.6-20,7.5-23,abaxial,abaxially,acute,adaxially,along,anther,apex,attenuate,axi,bark,base,blade,blunt-tipped,branch,brown,calyx,capitate,central,chartaceous,cm,corolla,cuneate,dark,deltoid,diameter,drying,dull,elliptic,elongated,entire,flower,fruit,glabrescent,glabrous,globose,hair,half,inserted,lanceolate,leaf,lobe,long,lower,margin,mm,narrowly,nearly,oblong,orangish-tan,ovate-lanceolate,pedicel,peduncle,petiole,porrect-stellate,pseudoterminal,pubescence,pubescent,purple,reportedly,reticulate-punctate,ripe,scabrous,shrub,simple,small,soon,sparingly,spherical,stellate,stem,stigma,streak,style,sub-lenticular,subcampanulate,surface,tan,tomentose,tree,tube,upper,usually,violet,white,whitish,x,yellow,yellowish	-5.3,.5-3,0.1,0.1-0.2,0.1-0.4,0.1-0.9,0.6,0.7-2,0.8-3.1,1.3-1.4,1.6-2.3,1.7-2.7,1/3-1/2,2.2-5.7,2.5-4.1,2.6-4.4,3.2-,3.5-6.6,4.6-6.4,5-8,5-8.5,50-400,8-9.1,9-13,accrescent,ag,alyx,anthesi,apart,apparently,around,articulated,axillary,berry,branched,bud,cell,closely,cylindrical,dendritic-multangulate,directed,distally,distantly,eaf,earl,edge,eed,epidermal,especially,evident,except,exserted,farinose,few-rayed,filament,free,fruiting,glabrescen,granular-punctate,group,high,lackin,lateral,lengthening,lobed,lon,long-decurrent,longitudinal,m.,main,many,midrib,multangulate,nflorescence,obovoid,older,open,orolla,overlapping,perfec,plurifoliate,pore,poricidal,porrect-stellat,present,prominent,rachi,rarely,relatively,ruit,runk,sessile,short,short-,side,slit,somewhat,spaced,sparse,splitting,stage,stalk,stamen,stipitate-glandular,stout,strongly,suture,tamen,terete,thick,thin,thin-textured,time,tip,touching,translucent,ud,unarme,unit,vary,vein,way,wide,yellowish-tomentose,ympodial,young	0.3,3.2-6.4,adhesion,arrangement,colour,form,growth,height,history,inflorescence,length,life,na,number,ovary,perennial,plant,position,presence,ray,reproduction,rugulose,seed,shape,size,sparely,staman,stipe,texture,ye
338	wfo-0001028226	success	185	109	81	104	28	0.438	.5,0-0.1,0.1-0.3,0.15-0.3,0.15-0.45,0.25-0.5,0.3-1,0.4-0.6,0.5-1,0.6-1.3,0.7-0.9,1.2-2.6,15-27,2-5.5,2.5-3,2.7-3.2,3.5-4.5,5-8,5.5-8.5,9-15,absent,adaxially,andromonoecious,anther,apex,articulated,base,blade,brown,calyx,chartaceous,cm,cuneate,deeply,deltate,densely,diameter,elliptical,extra-axillary,flower,fruit,glabrous,gland-tipped,globose,green,hair,herbaceous,inflorescence,lateral,lavender,leaf-opposed,length,lobe,lobed,long,margin,midpoint,mm,obtuse,ovate,pale,pedicel,peduncle,petiole,plant,present,ray,resprouter,rostrate,shallowly,short,simple,sparsely,stellate,stellate-pubescent,style,throughout,time,tube,x,yellow	%,0-1,0-2,0.2-0.3,0.25-0.4,0.3-0.7,0.4-0.7,0.5-1.2,1,1-2,1-3,1-5,1.5-3,1.5-5,1.6-2.4,10-16,10-45,13-22,18-50,2-3,2-5,2.5-9,5-merou,6-8,7-8,9-14,abaxially,absen,accrescent,acicular,across,adaxiall,adult,alyx,apart,apparently,armed,axe,ba,branche,confined,cylindrical,directed,distall,distributed,dm,eaf,eed,eglandular,finger,fruiting,functional,geminat,half,heterostylous,index,juic,lamina,less,lobing,lon,longer,lower,mature,mesocarp,midrib,midvein,minute,moderately,moist,nflorescence,oblique,onl,orolla,part,per,plurifoliate,pore,porrect,prickle,prostrate,pseudo-umbellate,ruit,sessile,side,solitary,somewhat,spaced,sprawling,stage,stellae,straight,strongly,tal,tamen,tem,thick,transparent,unbranched,unit,uvenile,vary,wide,ympodial	adhesion,arrangement,climate,colour,corolla,form,glandular,growth,height,history,leaf,life,na,number,ovary,perennial,position,presence,pubescence,reproduction,seed,shape,size,staman,stem,stigma,stipe,texture
339	wfo-0001028227	success	236	145	122	114	23	0.517	-6.2,0.2,0.2-0.3,0.2-0.4,0.4,0.5,0.9,0.9-1.2,0.9-1.4,1-1.7,1-2.5,1-4.2,1.2-2,1.3-4,1.4,1.4-2.6,1.5-2.3,1.7-2.8,1/2-3/4,10,10-24,2-12,2-3.8,2.5-7.8,3-4.9,3.7-7,4.8-7.6,6-16,6.7-15,8.5-22,abaxial,abaxially,acute,adaxially,age,along,anther,apex,appressed,base,becoming,blunt-tipped,brown,brownish,bud,calyx,cm,corolla,dark,deltoid,dendritic-echinoid,diameter,drying,echinoid,elliptic,elongate,farinose,fleshy,flower,fruit,glabrescent,glabrous,globose,granular-tomentose,gray,green,hair,inserted,leaf,less,lobe,long,midvein,mm,mostly,multangulate,oblong,oblong-lanceolate,occasionally,older,orangish-tan,pale,pedicel,peduncle,petiole,porrect-stellate,pseudoterminal,pubescence,pubescent,purple,quarter,relatively,reticulate-punctate,ripe,rounded,scabridulous,sessile,shrub,simple,sparsely,stalk,stellate,stem,stigma,style,subcampanulate,sublenticular,subspherical,surface,thick,thin,tomentose,tree,tube,upper,velutinous,violet,way,well,x,yellow,yellowish	-2/3,.5-4,0-250,0.1,0.2-0.5,0.3,0.7-2.1,0.8,0.8-1.4,1,1.1-3.1,1.9,1.9-4.2,1.9-5.8,1/2,11-15,2.6-5.9,2.9-4.7,3.7-6.3,4-13,5-7.5,8.1-18,accrescent,acuminate,ag,alyx,anthesi,apart,apparently,around,articulated,attenuate,axillary,bark,berry,blade,blunt-tippe,branch,branched,c.,closely,cuneate,cylindrical,decurrent,directed,distally,eaf,early,echinoi,edge,eed,ength,entire,exserted,filament,free,fruiting,grayish,high,lacking,lanceolate,lateral,lengthening,lobed,lon,longitudinal,lower,m.,main,many,margin,midrib,nflorescence,obscured,obtuse,often,orbicular,orolla,ovate-lanceolate,ovate-orbicula,overlapping,perfec,plurifoliate,pore,poricidal,present,prominent,rachi,ruit,runk,side,slightly,slit,somewhat,spaced,stamen,stout,sulcate,suture,tamen,thicker,time,tip,tomentu,touching,ud,unarme,unit,usually,vary,vein,wide,ympodial,young	adhesion,arrangement,colour,form,growth,height,history,inflorescence,length,life,na,ovary,perennial,perfect,plant,position,reproduction,rugulose,seed,shape,size,staman,texture
340	wfo-0001028228	success	143	87	60	83	27	0.42	0.1-1.7,1-1.5,1.1-1.2,1.2-1.8,1.5-2,2,2-8,2.8-6.5,3/4,6-7,7.5-12.5,anther,area,base,brown,calyx,campanulate,cm,coriaceous,corolla,dark,dia,elliptic,glabrous,globose,green,greenish-yellow,leaf,lobe,lobed,margin,minute,minutely,mm,obovate,occasionally,opposite,ovary,ovoid-reniform,pale,papillose,pedicel,petiole,reticulate,shaped,shining,shrub,small,stem,stigma,style,surface,tear-drop,thickened,tip,tree,tube,way,white,x	.5,0.75,1.1-2.5,1.8-3.4,10-30-flowered,2-5,2.1-4.2,6-8,abruptly,acute,age,anthesi,apex,ba,bark,becoming,beginning,beneath,berry,caly,clavate,closely,deflexed,deltoid,difoliate,distal,dry,eaf,edicel,eed,erect,exserted,filament,fragrant,free,fruiting,geminat,impressed,inflorescenc,lateral,lon,long,lower,main,major,material,middle,minor,narrowing,nflorescence,older,overlapping,ovoid,pair,planar,pore,poricidal,portion,prominent,rounded,ruit,scar,shinin,simple,slender,slightly,spaced,straight,styl,sweetly,tall,tapering,terminal,thick-margined,ud,unit,usually,vein,weight,widest,woody,ympodial,young	0.5,1.5,3,3.5,arrangement,colour,diameter,form,fruit,growth,height,history,inflorescence,length,life,na,peduncle,perennial,plant,position,pubescence,reproduction,rugulose,seed,shape,size,texture
341	wfo-0001028234	success	155	81	54	101	27	0.348	/3,0.15-0.35,0.5-1.0,1-2.5,1.0-1.8,2.6.3.2,3-10,5-11,520,8-11,across,along,annual,anther,blade,broadly,brown,calyx,capitate,capitate-glandular,cm,dark,dia,dm,glabrous,gland,green,hair,herb,heteromorphic,internodal,leaf,long,main,mm,ovate,petiole,pinnatifid,plump,prickly,purplish-tinged,sessile,short-stipitate,simple,spherical,stellate,stem,strait,tube,unexpanded,unicellular,uniseriate,vein,white	/2,0.25-0.5,15-30,3.5-7,4-10,5-20-flowere,accrescent,acro,acute,alyx,and,anthesi,armed,around,basally,base,beneath,berry,black,blue-tinged,branched,caly,campanulate,cauline,central,closely,deltoid,density,developing,difoliate,dissected,divergently,divided,dry,eaf,earliest,eed,enveloped,erect,extended,few-rayed,fleshy,fully,geminat,high,invested,largest,later,linear-lanceolate,lobe,lon,many,margin,marking,maturity,mostly,narrowly,nflorescence,occasionally,often,one,orolla,pedicel,per,persisting,prickle,purple,radially,reduced,ridged,ruit,scattered,second,short,slende,somewhat,spaced,splitting,starlike,ste,stellae,stipitate,stout,subulate,tamen,taprooted,thrice,tightly,tigma,triangular,tub,twice,tyle,ultimate,unit,vary,varying,wholly,year,yello,ympodial	adhesion,arrangement,colour,corolla,diameter,form,fruit,growth,height,history,inflorescence,length,life,na,ovary,plant,position,presence,pubescence,reproduction,seed,shape,size,staman,stigma,style,texture
342	wfo-0001028250	success	256	120	96	160	24	0.375	.2,.4,.8,0.2–0.6,0.3–0.5,0.3–0.6,0.3–3.9,0.5–1.3,0.7–0.8,1,1.0–2.0,1.1–1.6,1.2–1.7,1.2–6.3,1.6–1.8,1.8–2.2,12.5,2.3–2.5,2.3–5.1,2.7,3.9–12.2,4–11,5.0,5.8–6.6,6–10,8.3–18.0,abaxially,adaxially,adnate,anther,apex,apically,apiculate,attachment,calyx,caudate,chartaceous,cm,corolla,deltate,diameter,dry,egandular,extra-axillary,flattened-orbicular,flower,fruit,glabrous,glandular,globose,hair,interpetalar,lateral,leaf,lobe,mature,mm,moderately,nearly,notched,oblong,occasionally,ovate,pedicel,peduncle,petiole,point,poorly-developed,porrect,pubescent,ray,red,sessile,shrub,simple,small,sparsely,stellae,stellate,stigma,straight,style,surface,tip,tissue,toward,tree,truncate,tube,unarmed,white,yellow,yellow-tan,×,–1.6,–3	.3,.7,0.08,0.13,0.17,0.4–0.8,0.5–1.0,0.6–0.7,0.8–1.0,0.8–1.3,0.9–1.3,1.0–1.6,1.3–1.6,1.3–2.0,1.5,1.5–3.4,1.7,1.7–2.5,1.8,1.9–2.2,1/3,1/4–3/4,1–3,2.1,2.2–2.9,2.8,4–6,4–8,5-merou,5.1–6.2,5.7–7.7,90°,95,acute,aequilateral,alyx,anthesi,apart,apical,apparently,appearing,appressed,articulate,axe,ba,base,berry,blade,branch,branched,broad,brochidodromous,bud,channeled,climate,clinate,congested,continuing,cuneate,curved,densely,dentate,depression,development,difoliate,directed,disc-shape,distinct,eaf,edge,eed,either,emerging,endocarp,entir,entire,erect,evenly,exocarp,fertile,filament,filiform,free,frui,geminate,glabrescent,glossy,growt,homostylous,hooked,increasing,internode,intersepalar,juic,lanceolate,large,less,lobed,lon,long,longer,lower,major,margin,midpoint,midrib,midvein,minor,minute,new,nflorescence,oblique,opaque,orolla,overlapping,per,pore,portion,potentially,raised,restricted,rigid,rounded,row,ruit,shallow,short-stipitate,shorter,side,sinuate,sinus,smoot,split,splitting,spread,spreading,stamen,stella,stellate-pubescent,stipe,suture,tamen,tardily,tem,thin,time,two,typically,ud,upper,upright,vary,vein,weakly,wide,yellow-ferruginous,ympodia,young,±equal,±smooth	adhesion,arrangement,colour,dense,disc-shaped,form,growth,height,inflorescence,length,number,ovary,plant,position,presence,present,pubescence,rugulose,seed,shape,size,staman,stem,texture
343	wfo-0001028263	success	156	69	50	106	19	0.321	0.25,1-3,11-13,11-23,14-44,2.6,3,3.4,4,6,abaxially,adaxially,broadly,calyx,cm,conical,connate,corolla,darker,deep,diameter,distal,elliptical,green,green-white,half,herbaceous,leaf,light,long,medium,mm,odd-pinnate,ovate,ovoid,pedicel,peduncle,perennial,petiole,plant,puberulent,pubescent,rotate,seed,size,strigose,throughout,violet,wide,yellow	1-2,1-4,2,2-3,2-4,3-6-foliat,3.5-4.2,4-5,5-7,5-7.5,6-8,8-1.,8-14,9,abaxiall,acumen,acuminate,acute,apex,apical,apically,articulate,atenuate,base,branched,cell,cordate,covering,cuneate,cyme,dehiscent,dichasial,dichasially,digestion,diminishing,dorsally,eaf,ebracteate,edge,eed,emoval,enzyme,equal,exceeding,filament,first,flat,flower,folded,forked,generally,globo,gradually,hair-like,honeycomb,interjected,introrse,lateral,leaflet,living,lobe,lon,lower,lunat,make,maturing,monochasial,mucilaginous,nflorescence,nther,oblique,often,orolla,pair,pattern,perfect,plan,poricidally,proximal,reveal,ruit,sessile,seudostipule,short,slit,specimen,stamen,stigma,straight,style,tal,tem,terminal,testal,thick,throughou,toward,truncate,tuber-bearing,two,typically,unit,vary,wall,ympodial,¼	anther,arrangement,colour,form,fruit,growth,height,history,inflorescence,length,life,na,ovary,position,reproduction,shape,stem,texture,tube
344	wfo-0001028273	success	225	121	97	128	24	0.431	-2,-8,.5,0,0.4-0.5,0.4-1,0.5,0.5-1,0.6-0.8,1.5-,1.5-2,2,2-3,2-6,2.3-3,2.5-,2.5-6,2.6-5,3-5,4-11,4-7-lobed,4-8.5,5-8,6-8,acute,anther,apex,armed,base,brown,calyx,cm,conical,coriaceous,corolla,dense,densely,diameter,elliptic,flattened,flower,fruit,globose,growth,height,holly-like,inflorescence,leaf,less,linear,lobe,lobed,long-styled,long-triangular,margin,markedly,midpoint,minutely,mm,mucronate,ovary,ovate,pedicel,peduncle,petiole,pitted,puberulent,pubescence,pubescent,ray,reddish,reniform,shallowly,shiny,shrub,simple,size,sparse,sparsely,stellate,stem,stigma,style,surface,tapering,terminal,toothed,trichome,truncate,tube,unknown,urceolate,way,white,x,yellow,½-2/3	0.1,0.2,0.4,0.6-1,1,1-1.5,1-2,1-4,1.2,30,4,4-10,4-7,<,>,?,abaxial,abaxially,abruptly,absent,acicular,adaxial,adaxially,age,alfway,along,also,anthesi,apart,articulated,bark,basal,beneath,berry,branched,broad-based,c.,cell,closer,color,deep,discolorous,distall,eaf,eed,equalling,erect,evenly,exfoliatin,exserted,filament,free,fruiting,glabrous,greyish,heterostylous,impressed,known,like,lon,long,long-stalked,longer,lower,major,midvein,minute,mixture,multangulate,multiseriate,new,nflorescence,nodding,occasionally,often,older,orange,pair,papillae,per,pericarp,persisting,planar,plurifoliat,poricidal,porrect,portion,prickle,prickly,primary,rachi,rest,rim,ruit,scar,scattered,sessile,short,shorter,sinuate,slightly,small,smaller,sometimes,spaced,splitting,spreading-campanulate,stalk,stalked,stellate-pubescent,stout,straight,styled,terminating,testal,time,tip,together,tooth,truncat,ud,unicellular,unit,variable,vein,widely,woody,ympodial	adhesion,arrangement,blade,climate,colour,form,glandular,hair,history,length,life,na,number,plant,position,presence,present,reproduction,rugulose,seed,shape,staman,stipe,texture
345	wfo-0001028278	success	219	139	112	107	27	0.511	0-0.15,0.4-2.1,0.45-0.7,0.5-0.75,0.5-0.9,0.5-1.5,0.7-1.2,0.8-3,1,1-5,1.2-1.6,1.5,1.5-2,1.5-3,2,2-3,2.2-7,2.5-9,2.7-2.9,4-12,4.5-6,5-10,6-11,6-8,7-12,7-15,abaxially,acute,adaxially,andromonoecious,anther,apex,articulated,base,blade,broadly,brown,calyx,chartaceous,cm,connivent,cordate,cylindrical,densely,diameter,ellipsoidal,elliptic,entire,erect,extra-axillary,flattened,flower,fruit,glabrous,gland-tipped,glandular,green,grey-green,hair,inflorescence,interpetalar,lanceolate,leaf,length,light,lobe,lobed,long,margin,mid-point,midpoint,midrib,mm,obtuse,ovate,pale,pedicel,peduncle,perennial,perfect,petiole,pink,present,pseudo-racemose,purple,ray,red,reniform,rhizomatous,shallowly,shallowly-lobed,shape,short,shrub,simple,somewhat,sparsely,stellate,stellate-pubescent,stigma,style,surface,thick,throughout,tissue,truncate,tube,unbranched,weakly,white,x,yellow	%,.5,0-0.7,0-1,0-3,0.1-0.25,0.1-0.5,0.2-0.3,0.5-2.5,0.7-1,0.8-1.3,0.8-2,1-1.2,1-10,1-2,1-3,1-4,1-locular,1.4-1.9,11-15,17-30,2-4,2.5-3,3-4,3-5,3-7,4,4-,4-5,5-11,5-merou,7-10,7-8,8-10,absen,absent,accrescent,across,adult,alyx,apart,apparen,ascending,axe,ba,bilobe,dense,difoliate,directed,distall,eaf,eed,exceeding,exocarp,filament,finger,fruiting,functional,geminat,heterostylous,incomplete,index,juicy,juvenile,lamina,lateral,leave,lobing,lower,mature,mesocarp,minute,nflorescence,oblique,orolla,pair,part,per,placenta,pore,porrect,prickle,rachi,rugose,ruit,septum,side,spaced,sparse,stalk,stellae,succulent,tal,tamen,tem,time,tissu,transparent,triangular,unarme,unarmed,unit,upper,vary,wide,without,ympodial	adhesion,arrangement,bilobed,climate,colour,corolla,form,growth,height,history,life,na,number,ovary,plant,position,presence,pubescence,reproduction,rugulose,seed,size,staman,stem,stipe,tall,texture
346	wfo-0001028280	success	87	76	31	56	45	0.356	.5,0.7-1,1-2,1.5-2.7,2-3,6-9,acuminate,apex,attenuate,base,ciliate,cm,dark,dia,elliptic,glabrous,globose,green,lanceolate,leaf,margin,minutely,mm,narrowly,opposite,pedicel,petiole,shrub,stem,surface,x	1-2-flowered,2-2.5,7-8,almost,anthesi,ape,arching,axil,bark,berry,branch,brow,closely,completely,decurrent,eaf,eed,flattened,fruiting,immature,know,known,lateral,lon,long,lower,main,middle,new,nflorescence,older,onto,pair,papillae,pendant,present,rounded,ruit,scar,sessil,simple,small,somewhat,spaced,tall,tip,ud,ultimate,unifoliat,unit,vein,widest,winged,woody,ympodial,young	adhesion,anther,arrangement,blade,brown,calyx,climate,colour,corolla,diameter,form,fruit,glandular,growth,hair,height,history,inflorescence,length,life,lobe,midpoint,na,number,ovary,peduncle,perennial,plant,position,presence,pubescence,ray,reproduction,rugulose,seed,shape,size,staman,stellate,stigma,stipe,style,texture,tube,unifoliate
347	wfo-0001028281	success	267	133	112	155	21	0.419	-1,-20,-3,-36,-45,-5,.4,.5,0.1-0.15,0.2-0.5,0.3-1,0.5-0.7,0.5-1,0.7-1.2,0.75-1,1-1.5,1-3,1.0-1.6,1.1-1.4,10-30,2-4,2.1-3.0,3-16,5-8-celled,6,7-30,abaxially,acuminate,acute,almost,anther,apex,base,basiscopically,blade,broadly,brown,calyx,capitate,cm,conical,corolla,dark,deep,densely,diameter,distal,doubly,eglandular,elliptic,elongate-triangular,entire,extended,form,fruit,glabrous,glandular,globose,golden,green,half,head,imparipinnate,inflorescence,interrupted,leaf,like,lobe,long,margin,mm,multi-cellular,narrowly,oblique,obovate,occasionally,once-branched,ovary,ovate,pale,patent,pedicel,peduncle,petiole,present,proximal,pubescent,regularly,rotate,serrate,shorter,shrub,size,small,sometimes,sparsely,stem,stigma,straight,stripe,style,surface,thick,tip,trichome,tube,uniseriate,usually,vine,weak,wide,yellow	+,-0.9,-10,-7,-8,.2,0.05-0.4,0.15-0.2,0.2-0.3,0.2-0.7,0.3-0.5,0.5-,0.5-0.6,0.5-1.1,0.5-1.2,0.7-,0.7-2.5,0.8-1,1,1-,1-5,1.1-2.4,1.2-1.5,1.2-1.6,1.4-4,1.5-2,1.5-6,1.7-2.5,10-18,2-13,2-4-celled,2-6.5,2-locular,2.5-,20-30,3-5,3-8.5,3-foliate,6-15,abaxial,absent,adaxial,alternate,anthesi,apical,appearance,appendage,appressed,arising,articulation,autogamous,axi,bent,berr,bract,bracteate,branching,cell,column,composed,covering,darker,decreasing,decurrent,developed,dry,eaf,edicel,eed,either,elongate,enclosing,exerted,exserted,filament,flower,fragile,free,fruiting,generally,giving,gland,gree,hair-like,hal,halfway,included,interjected,internode,large,largest,lateral,leaflet,less,lon,longest,lower,material,medial,midvein,minute,mixture,multi-celled,multicellular,nflorescence,node,opposite,orbicular,other,outgrowth,pair,paler,petiolule,point,population,portion,primarily,primary,probably,pseudostipule,rachi,rest,ruit,secondary,serrat,sessile,set,silky,smaller,smooth,sparser,sprawling,staminal,sterile,stiff,strongly,subopposite,tem,terminal,tertiary,testa,thin,three,toward,transparent,type,ud,unicellular,unit,vein,wall,weak-walled,well,winged,ympodial	1-2,2.5-6-15,adhesion,arrangement,colour,growth,height,length,na,number,plant,position,presence,pubescence,ray,rugulose,seed,shape,staman,stellate,texture
348	wfo-0001028294	success	222	98	74	148	24	0.333	0-1,0.25-0.4,0.3-0.4,0.5-0.6,0.5-2,0.7-1.2,1.3-1.5,1.5-3.5,1.5-7,1.9-7,11-22,2-2.5,2-3.5,2-5,4.5-6,5-13,6-8,7-10,8-10,8-18,andromonoecious,anther,broadly,brown,calyx,chartaceous,cm,connivent,cylindrical,deltate,densely,diameter,extra-axillary,fruit,glabrous,globose,green,grey,hair,inflorescence,lanceolate,lateral,leaf,length,lilac,lobe,lobed,long,loosely,mm,ovate,pale,pedicel,peduncle,perennial,petiole,plant,present,ray,rusty,scattered,shallowly,simple,sparsely,stellate,stellate-pubescent,stigma,style,time,tube,vine,x,yellow,yellowish-green	%,0-0.2,0-0.4,0-10,0-6,0.1-0.15,0.2-0.3,0.25-0.5,0.3-0.5,0.5-1,0.7-1.5,0.8-1,0.8-1.2,1,1-2,1-2.5,1-3.5,1-6,1.7-2.4,11-15,17-25,18-22,18-40,2-3,2-foliate,2-locular,2.5-7,30-40,4-6,4-8,5-12,5-8,5-merou,50-100,50-140,7-8,9-13,9-15,abaxially,absent,accrescent,across,acuminate,acute,adaxiall,adaxially,adult,alyx,anvil-shape,apart,apex,armed,articulated,ascending,axe,ba,base,blade,branch,branche,broad-based,capitat,cordate,cross-section,cuneate,curved,decimetre,directed,distall,distally,distributed,dm,eaf,eed,eglandular,elliptic,entire,erect,exocarp,finger,flower,fruiting,functional,geminat,gland-tipped,grey-green,half,heterostylous,juicy,juvenile,lamina,less,longer,lower,margin,markedly,mature,mesocarp,mid-point,midpoint,midvein,minute,moist,nflorescence,oblique,obtuse,orolla,pair,part,per,placenta,pore,porrect,presen,prickle,rachi,repand,ruit,scrambling,semi-circular,sessile,short,slightly,spaced,stalk,stalked,stellae,straight,surface,tal,tamen,tem,thick,thicker,throughout,toward,unarme,unarmed,unbranched,unit,upper,vary,vein,weakly,white,wide,yellowish,ympodial	adhesion,arrangement,capitate,colour,corolla,form,growth,height,history,life,na,number,ovary,position,presence,pubescence,reproduction,seed,shape,size,staman,stem,stipe,texture
349	wfo-0001028298	success	188	112	82	106	30	0.436	0.15-0.3,0.25-0.4,0.3-0.4,0.4-0.65,0.5-1,0.6-0.7,0.8-1.7,1-1.5,1-2,1.5-2,1.5-3.5,2-7,2.2-2.5,2.5-3,3-7,4-5,4.5-8,5-8,6-8,7-8,abaxially,absent,acute,adaxially,anther,apex,base,blade,brown,calyx,chartaceous,cm,cordate,densely,diameter,elliptic,entire,extra-axillary,fruit,glabrous,gland-tipped,globose,grey-green,hair,inflorescence,lanceolate,leaf,length,lilac,lobe,lobed,margin,midpoint,mm,moderately,obtuse,ovate,pale,pedicel,peduncle,perennial,petiole,present,ray,red,reniform,rhizomatous,rotate-stellate,shallowly,short,shrub,simple,stellate-pubescent,stigma,style,surface,truncate,tube,white,x,yellow,yellowish	%,.5,0-0.1,0.1-0.2,0.2-0.4,0.3-0.5,0.4-0.5,0.7-1,1-3,1-4,1-locular,1.9-2.5,10-11,17-25,2-3,2-foliate,3-5,4-9,5-6,5-7,5-merou,7-12,8-11,9-10,absen,accrescent,across,acuminate,adult,alyx,apart,apparen,articulated,axe,ba,broadly,capitat,connivent,contiguous,cylindrical,deltate,directed,distall,distributed,eaf,eed,eglandular,erect,exceeding,exocarp,filament,finger,flower,fruiting,geminat,incomplete,interpetalar,juicy,juvenile,lamina,lateral,long,lower,mature,mesocarp,minute,nearly,nflorescence,oblique,orolla,part,per,perfect,placenta,pore,porrect,prickle,probably,pseudo-umbellate,rachi,reticulate,ruit,septum,sessile,soliary,somewhat,spaced,stalk,stellae,succulent,tal,tamen,tem,thick,throughout,time,tissu,tissue,transparent,unarme,unarmed,unbranched,unit,vary,wide,ympodial	0.5,adhesion,arrangement,capitate,climate,colour,corolla,form,glandular,growth,height,history,life,na,number,ovary,plant,position,presence,pubescence,reproduction,rugulose,seed,shape,size,staman,stellate,stem,stipe,texture
350	wfo-0001028317	success	204	122	90	114	32	0.441	-1.5,0.1-0.4,0.3-1,0.6-0.8,0.6-1.2,0.6-1.5,0.8-2.5,1-1.3,1-3,1.4-2,1/5,2-2.8,2-4.5,2.5-6.5,2.8-3.3,4-6,4-8,5-8,abaxially,acute,anther,apex,apically,base,berry,blade,bright,brown,calyx,chartaceous,cm,cream,cuneate,dark,deltate,densely,diameter,dull,flattened-reniform,fruit,glabrous,gray,green,hair,herb,lanceolate,lateral,leaf,length,lobe,lobed,long,lower,margin,marking,maturity,mauve,midpoint,mm,moderately,obtuse,orange-brown,ovate,pale,pedicel,peduncle,petiole,poricidal,purple,ray,red,shrub,simple,sometimes,sparsely,spherical,spreading,stellate,stellate-pubescent,stem,style,tapering,terminal,tip,tube,upper,white,wide,yellow,young	-5,/5,0,0-1,0-5,0.1,0.1-0.25,0.1-0.3,0.3-0.4,0.5-3.5,0.8-1.1,1-4,1.1-1.9,1.8-2.5,1/,1/3-1/4,1/4-2/3,2-4,2/3,3-10,3-4,3-5,4-5-merous,6-10,absent,acuminat,almost,alyx,apar,apart,apparently,articulated,bark,branched,broad-deltate,brow,concolorous,curved,difoliate,distance,drying,eaf,eed,elongating,equal,erect,extending,eye,filament,filiform,flower,free,fruiting,geminat,herbaceous,infructescence,longer,mature,midvein,minute,naked,nflorescence,oblong,older,one,open,orolla,oung,pair,pendulous,per,perfec,pericarp,porrect,portion,prickl,prickle,prickly,primary,reduced,reflexed,rounded,ruit,scandent,scar,sessile,shorter,side,smooth,spaced,stalk,stalked,straight,subsessile,surface,tamen,terete,tertiary,time,toward,translucent,trichome,truncate,unarme,unarmed,unit,variously,vary,vein,venation,visible,way,yellow-green,ympodial	1/2,acuminate,adhesion,arrangement,climate,colour,corolla,form,glandular,growth,height,hermaphroditic,history,inflorescence,life,na,number,ovary,perennial,plant,position,presence,present,pubescence,reproduction,seed,shape,size,staman,stigma,stipe,texture
351	wfo-0001028323	success	164	128	95	69	33	0.579	0.2-0.5,0.2-1,0.4-1.3,0.6-1,0.8,0.9-1.2,1-1.2,1-2,1.1-4.5,1.5,1.5-2.5,2-3,2-9,3,3-5,3.5-4,7.5-9,abaxially,acute,along,anther,anthesi,apex,attenuate,base,blue-green,brown,c.,calyx,cm,conical,coriaceous,corolla,cup-shaped,dark,densely,diameter,ellipsoid,elliptic,entire,fading,fleshy,glabrescent,glabrous,grey,growth,inflorescence,internodal,lanceolate,leaf-opposed,like,lobe,lobed,margin,maturity,minutely,mm,ovary,ovoid,pale,papillose,pedicel,peduncle,perfect,petiole,pitted,poricidal,pubescent,reddish,revolute,rounded,shiny,shoot,short,shrub,simple,sinus,soft,sometimes,somewhat,sparsely,stem,stigma,style,surface,tearing,thick,tip,trichome,tube,uniseriate,violet,way,white,x	-2,0.5,0.5-1,1,1-1.5,3-6,5-6,abscissio,absent,apart,apparently,appressed,articulated,ba,bark,berry,capiatate,cell,deltate,dendritic,drying,eaf,eed,erect,filament,flower,free,fruiting,glabrescen,globose,included,lengthening,less,longer,lower,main,minute,new,nflorescence,occasionally,ovate,pair,papillat,peg,pericarp,planar,plurifoliat,pore,portion,primary,proceed,remaining,ruit,scar,scattered,small,soon,sparely,splitting,straight,testal,thin,tuft,ud,unit,vein,wall,woody,ympodial	adhesion,arrangement,blade,capitate,climate,colour,form,fruit,glandular,hair,height,history,leaf,length,life,midpoint,na,number,perennial,plant,position,presence,pubescence,ray,reproduction,rugulose,seed,shape,size,staman,stellate,stipe,texture
352	wfo-0001028328	success	215	139	111	104	28	0.516	-15,0-0.3,0-4,0.2-0.5,0.5-1,1-1.5,1-2,1-6,1.5-2,15-20,16-30,2-10,2-2.5,2-4-lobed,2-9,2.5-3,20-35,3-4,5-10,5-7,7-9,abaxially,abundantly,acuminate,acute,andromonoecious,anther,apart,apex,apiculate,apparently,armed,base,blade,broad-based,brown,calyx,chartaceous,cm,coarsely,compressed,congested,connivent,dark,densely,diameter,elliptic,elliptic-ovate,entire,equal,extra-axillary,flattened,flower,fruit,glabrous,globose,green,hair,half,inflorescence,leaf,leaf-opposed,light,lobe,lobed,long,lower,margin,membanaceous,minutely,mm,moderately,nearly,oblique,obtuse,outline,pedicel,peduncle,petiole,plant,prickle,ray,reflexed,reniform,ripe,rounded,rugulose,shallowly,simple,slightly,small,smooth,spaced,stellate,stellate-pubescent,stem,stigma,straight,strongly,style,subcoriaceous,subcuneate,surface,tapered,tip,tree,truncate,tube,white,x,yellow	.2,.5-2,1,1-7,14,2-3,2-4,20-30,4-7,5-merou,50,6-18,6-8,7-.,7-10,7-14,7-30,8-18,absent,accrescent,adaxiall,adaxially,ag,alyx,articulated,axe,ba,berry,branched,capitat,covering,cylindrical,differentiated,difoliate,directed,discolorous,distally,eaf,eed,except,ferruginous,filament,flowering,forked,free,frui,fruiting,geminat,heterostylous,highly,interpetalar,juvenile,leave,lighter,like,longitudinal,major,midpoint,minor,multangulate,narrowly,nflorescence,often,one,opening,orolla,paired,part,perfect,perhaps,pericarp,pore,porrect,pubescent,rachi,ruit,runk,sessile,sharp,shiny,short,short-stalked,side,slit,somewhat,sparse,stalk,staminate,subtending,tamen,thi,time,tissue,tomentose,triangular,tubevery,unarmed,unit,vary,vein,whitish,wide,ympodial,young	7-8,adhesion,arrangement,capitate,colour,corolla,form,glandular,growth,height,history,length,life,na,number,ovary,perennial,position,presence,pubescence,reproduction,seed,shape,size,staman,stipe,texture,ye
353	wfo-0001028329	success	215	134	109	106	25	0.507	.5-3,0.2-0.3,0.8-1.1,0.8-1.4,1-6,1.0-1.4,1.1-2.5,1.3-1.8,1.3-2,1.5-2.3,1.5-2.75,1.5-3.5,10-34,12,2-3,2.2-3.9,2.6-5,3-14,3-8,4-15,5-10,6-8,7-19,abaxially,adaxially,anther,apart,apex,articulated,asperous,base,becoming,blunt-tipped,brown,calyx,chartaceous,closely,cm,conical,continued,corolla,deltoid,diameter,due,finely,flower,fruit,glabrous,granular-tomentose,gray,green,growth,hair,honeycombed,inserted,lateral,leaf,length,lobe,minutely,mm,moderately,mostly,multangulate,obelliptic,oblong,obovate,obtuse,occasional,ovate,ovate-elliptic,pale,pedicel,peduncle,petiole,porrect-stellate,pseudo-terminal,pubescent,reniform,reticulate-punctate,ripe,shrub,simple,slightly,small,sometimes,spaced,sparsely,stellate,stellate-pubescent,stellate-rotate,stelliform,stem,stigma,style,subglobose,suborbicular,tomentose,toward,tree,tube,turning,velutinous,vestigial,white,whitish,x,yellow,yellowish	.75-2,.75-5.75,/10-3/10,0-100,0.9-1.3,1.5-8,2-4,2.75-4.5,3.75-7,3/4,4-5,6-11,6-9,absen,acuminate,acute,ag,angled,anthesi,apical-lateral,apparently,axe,axillary,ba,bark,berry,blade,branch,branched,bud,cylindrical,dehiscing,dendritic-echinoi,dendritic-echinoid,dichotomously,distantly,distinct,eaf,echinoid,eed,entire,filament,fleshy,free,glabrescen,granular,grooved,high,introrse,large,lengthening,lobed,long,long-attenuate,longitudinally,lower,main,margin,midvein,multangulat,nflorescence,obscured,older,orbicular,orolla,perfect,plurifoliate,pore,present,rachi,rather,receptacle,relatively,ruit,runk,sessil,sessile,several,short-,short-stalked,side,slit,sparse,stalked,stellat,subcapitat,suture,swollen,tamen,testa,thick,thickened,thin,time,tomentu,touching,unarme,unarmed,unit,usually,vary,vein,way,wide,ympodial,young	adhesion,arrangement,colour,form,glabrescent,height,history,inflorescence,life,na,ovary,perennial,plant,position,presence,pubescence,reproduction,rugulose,seed,shape,size,staman,subcapitate,surface,texture
354	wfo-0001028337	success	195	121	91	104	30	0.467	-2,-2.5,-4,-6,/3,0,0.05-0.15,0.3-0.5,0.4-0.7,0.4-0.8,0.7-0.9,0.7-1,1-1.8,1-2,1.5-3,1.8-2,11-16,2-2.2,2-4,4-5,5-6,abaxially,anther,apex,apically,base,berry,blade,calyx,chartaceous,cm,connivent,cuneate,dark,deltate,densely,diameter,entire,erect,evenly,flattened-reniform,fruit,glabrescent,glabrous,glaucous,gray-brown,green,hair,inflorescence,lateral,leaf,length,lobe,lobed,long,margin,marking,mauve,midpoint,minutely,mm,moderately,narrow-oblong,orange-brown,pedicel,peduncle,petiole,pitted,poricidal,ray,rounded,shallowly,shrub,simple,smooth,sparse,spherical,stellate,stellate-pubescent,stem,style,surface,tapering,terminal,tip,toward,tube,way,white,wide,young	.5,.8,0.05-1,0.1-0.3,1,1-3,1.5-4,1/2,1/3-2/3,1/4-1/3,1/8-1/4,15-50,3-4,5-25,5-8,5-merous,6-7,8-10,8-14,abaxial,acut,adaxial,alyx,apar,apart,ape,apparently,articulated,bark,branched,color,conical,curved,discolorous,drying,eaf,eed,elongating,equal,eye,filament,flower,free,fruiting,fused,gently,glabrou,gray,green-brown,infructescence,juvenil,juvenile,known,long-styled,longer,lower,mature,naked,nflorescence,occasionally,older,one,open,orolla,oung,pale,per,perfect,pericarp,plurifoliat,porrect,porrect-lepidote,portion,prickle,prickly,primary,reddish,reflexed,ruit,scar,sessile,shoot,short,short-styled,shorter,slender,small,spaced,staminate,stout,straight,strongly,tamen,terete,time,trichome,unarme,unarmed,unit,usually,vary,vein,visible,ympodial	acute,adhesion,arrangement,climate,colour,corolla,form,glandular,growth,height,history,life,na,number,ovary,perennial,plant,position,presence,pubescence,reproduction,rugulose,seed,shape,size,staman,stigma,stipe,texture,ye
355	wfo-0001028339	success	195	131	98	97	33	0.503	.5,1-1.2,1-2,1-5,1.1-1.4,1.2-1.5,1.5,1.5-2,1.7-3.2,10.2-18.5,2.5-5,3.5-4,5-7,5.8-7.9,8182,acuminate,acute,anther,apex,appressed,base,beneath,berry,blue,broadly,brown,bud,calyx,capitate,cm,connate,corolla,cuneate,cup-shaped,dark,decurrent,dia,dried,dry,flattened,flower,glabrous,globose,greyish-brown,growth,later,leaf,little,lobe,lobed,long-triangular,margin,minutely,mm,mustard,nearly,oblique,opposite,ovary,ovate,ovoid-reniform,papillate,papillose,pedicel,petiole,pitted,pulp,schwarz,shaped,shrub,size,slightly,small,somewhat,sparsely,specimen,stem,stigma,strongly,style,surface,tear-drop,texture,tightly,tip,tree,trichome,tube,uniseriate,urceolate,vein,white,white-speckled,winged,woody,x,yellow,young	0.05-0.1,0.8-1.2,1-1.5,10-30-flowered,3.4-5.5,43191,5-angled,7-11,8-10,across,almost,anthesi,appearance,appearing,attenuate,bark,becoming,carinate,carpel,closely,covered,crystalline,deflexed,densely,differing,difoliate,distinctly,eaf,edicel,eed,enclosed,epidermi,erect,evenly,exserted,fide,filament,filiform,first,floccose,free,frui,fruiting,geminat,glabrate,grainy,irregular,large-celled,lateral,leave,like,lon,long,lower,main,major,middle,minor,nee,nflorescence,obscure,occasionally,older,one,overlappin,ovoid,papery,planar,pore,poricidal,portion,proximal,red-brown,reflexed,ruit,scar,secondary,septum,shining,simple,slender,spaced,speckled,straight,strong,tall,tapering,tub,ud,unit,venation,white-lenticellat,white-papillo,wide,widest,yellowish,ympodial	adhesion,arrangement,blade,climate,colour,diameter,form,fruit,glandular,hair,height,history,inflorescence,length,life,midpoint,na,number,peduncle,perennial,plant,position,presence,pubescence,ray,reproduction,rugulose,seed,shape,staman,stellate,stipe,white-papillose
356	wfo-0001028351	success	175	109	81	94	28	0.463	.2,0,0.1,0.2,0.5,1.0–2.0,1.4–1.5,2.0–2.5,2.1–3.5,2/3,2–2.5,3,3.4–5.0,3–4,40,5.0,5.0–5.5,6.5–8.5,6–12,8–15,abaxially,adaxially,along,annual,anther,anthesi,articulated,base,blue,brown,calyx,capitate,clavate,cm,colour,densely,diameter,equal,flattened,fruit,glabrous,globose,green,hair,herb,lanceolate,leaf,like,lobe,long,lower,midvein,mm,moderately,multicellular,oblong,opposed,ovate,pale,pedicel,peduncle,pentagonal,perennial,petiole,pitted,pubescent,shallowly,shiny,simple,stem,stigma,style,surface,tube,unicellular,uniseriate,unknown,velutinous,white,x,–3.0	.8,.8–1.0,0.6,0–,1.0–,1.0–1.6,1.0–2.5,1.5–4.0,1.6–,10,2,2.0–5.0,2–4,4,5,5.5–10.5,5–7,absent,acute,adaxiall,ag,apart,apex,apical,axe,ba,basal,becoming,blade,branching,cell,chartaceous,connivent,convex,cylindrical,directed,distally,eaf,eed,erect,filament,fleshy,flower,geminat,glandular,indumentum,lamin,lobed,lon,longitudinal,m.,margin,narrowly,nfloresence,number,obtuse,occasionally,opening,orolla,pair,perfect,plurifoliate,pore,present,probably,regularly,ruit,serrate,shaped,side,slender,slit,smaller,spaced,sparsely,stone,straight,tal,tamen,tardily,teardrop,tem,time,truncate,unbranched,unit,vary,wide,wing,winged,woody,ympodial,young,–	0–2.5,1.0–4.0,1.5,1.6–5.0,adhesion,arrangement,corolla,form,growth,height,history,inflorescence,lamina,length,life,na,ovary,plant,position,presence,pubescence,rugulose,seed,shape,size,staman,stellate,texture
357	wfo-0001028353	success	177	125	94	83	31	0.531	0.2-0.4,0.5,0.5-,0.9-1.2,1,1-2,1-4,1.4-2,1.5-5,2-4,3-5,6-8,7,8-10,abaxially,acute,anther,apex,base,becoming,beneath,bluntly,bright,calyx,campanulate,capitate,cell,centre,clasping,cm,coarsely,conical,cordate,corolla,cup-shaped,dark,deep,deeply,densely,diameter,elliptic,fracturing,glabrous,globose,green,greenish,herb,honey-comb,internodal,leaf,less,like,lobe,margin,midrib,minutely,mm,often,open,ovary,ovoid,pale,papery,papillose,pedicel,peduncle,petiole,pitted,plant,plump,pubescent,purple,rhomboid,ripe,scattered,simple,size,somewhat,sparsely,stem,stigma,style,surface,tan,testal,thin,toothed,trichome,truncate,tube,uniseriate,vein,x,yellow	.5,/3,1.5-2,2,2-3,3,4-7,accrescent,age,along,anthesi,apart,area,berry,ciliate,curved,decreasing,decumben,difoliate,distally,dry,drying,eaf,edicel,eed,ellipsoid,emarginated,erect,exerted,filament,fleshy,flower,free,frui,fruiting,geminat,gree,growing,heteromorphic,hollow,horn,horned,inserted,lengthening,lon,long,lower,m.,material,minute,nflorescence,nodding,outline,pair,papillate,pericarp,point,pore,poricidal,portion,primary,principal,reddish,ruit,scar,sessil,sessile,shallow,short,sleeve,slender,slightly,slit,straight,strongly,tip,toward,ud,unit,wall,way,wrinkled,ympodial	adhesion,arrangement,blade,climate,colour,form,fruit,glandular,growth,hair,height,history,inflorescence,length,life,midpoint,na,number,perennial,position,presence,pubescence,ray,reproduction,rugulose,seed,shape,staman,stellate,stipe,texture
358	wfo-0001028367	success	178	106	74	104	32	0.416	0.2–0.4,0.4–2.3,1.0–1.8,1.2–3.0,1.3–9.0,1.4–2.0,1.5,1–1.5,2.0–4.5,2.8–3.1,3.5–6.9,4–10,6.5–8.5,60,6–9,8.5–9.5,8–17,anther,apex,base,black,blade,blue,brown,calyx,cm,colour,cuneate,dark,deeply,densely,diameter,flattened,fruit,glabrous,globose,hair,lanceolate,leaf,lobe,lobed,margin,mm,moderately,narrowly,oblong,obtuse,opposed,ovate,pale,pedicel,peduncle,pentagonal,perennial,petiole,pitted,purple,regularly,rounded,shrub,stigma,style,surface,texture,tube,unifoliate,unknown,white,x,yellow,–10.0,–25,–5.0,–5.5	0.2,0.5,0.5–3,0.8–0.9,1,1.5–1.7,1–,1–2,2.0–4.2,2–10,2–3,3–3.5,3–5,4–7,5,5–5.8,5–6,6–8,7–15,8–23,abaxially,absen,accrescent,adaxiall,adaxially,ag,anthesi,apart,apical,arising,articulated,axe,ba,basal,branched,cell,chartaceous,concave,connivent,cylindrical,diamete,directed,eaf,eed,equal,erect,filament,flower,geminat,glabrescen,grey-green,half,laterally,lon,long,longer,longitudinal,lower,marking,multicellular,nflorescence,obliquely,opening,orolla,pair,perfect,pore,poricidal,primary,probably,pubescent,ruit,secondary,shiny,shorter,side,simple,slit,smaller,spaced,stone,straight,strongly,tal,tamen,tapering,tem,three,time,tip,tomentose,toward,two,unequal,unicellular,uniseriate,unit,usually,vary,wide,width,woody,ympodial,–7	absent,adhesion,arrangement,climate,corolla,dense,form,glandular,growth,height,history,inflorescence,length,life,midpoint,na,number,ovary,plant,position,presence,pubescence,ray,reproduction,rugulose,seed,shape,size,staman,stellate,stem,stipe
359	wfo-0001028370	success	147	106	67	80	39	0.456	1.0-1.7,1.5-2.2,1/2-2/3,2.5-2.9,3-5,3-7,3.5-5.0,4-10,4-11,9-12,across,along,annual,anther,armed,base,blade,blue,broadly,brown,calyx,campanulate,capitate,cm,dark,deltoid,dia,dm,dry,eglandular,extended,foveolate,fully,glabrous,gland-tipped,glandular,green,hair,herb,internodal,lanceolate,lenticular,lobe,long,main,maturity,minutely,mm,oblong,often,ovate,pentagonal,petiole,prickly,purple-tinged,ridged,seed,simple,spherical,splitting,stem,strait,tube,variously,vein,violet,viscid	-0.6,/3,0.2-0.4,0.8,2-4,2-8,40-70,5-9-flowere,accrescent,acicular,acro,alyx,ample,anthesi,attenuate,ature,beneath,berry,branched,broad,bud,coarsely,densely,developing,difoliate,distinct,divided,eaf,few-rayed,geminat,gland,hardly,high,incurved,interpetalar,invested,lon,markedly,narrowly,near,nflorescence,obovoid,obtuse,one,orolla,per,pinnatifid,pinnatisect,plicat,prickle,rounded,ruit,scattered,sessile,short,short-stipitate,slende,slightly,somewhat,sparsely,spreadingly,stellae,subulate,surrounding,tamen,taprooted,terete,terminal,tightly,tigma,tissue,tub,twice,tyle,ultimate,unti,usually,vary,yellow,ympodial	adhesion,apex,arrangement,climate,colour,corolla,diameter,form,fruit,growth,height,history,inflorescence,leaf,length,life,margin,midpoint,na,number,ovary,pedicel,peduncle,plant,position,presence,pubescence,ray,reproduction,rugulose,shape,size,staman,stellate,stigma,stipe,style,surface,texture
360	wfo-0001028390	success	147	107	76	71	31	0.517	0.5,0.5-1,0.5-1.5,0.5-2.5,1-2.5,1-3,1.5-2,1.5-3.5,1.5-5.5,10-15,3-4,3-5,4-11,4-5,5-7,7-8,abaxially,acute,adaxially,angled,apex,articulated,base,branched,calyx,chartaceous,cm,cuneate,deltate,dendritically,dense,densely,diameter,divided,eglandular,elliptic,entire,felty-pubescent,forked,glabrous,globose,hair,lanceolate,lobe,margin,mm,moderately,near,often,orange,ovate,pedicel,peduncle,petiole,pseudohair,puberulent,pubescent,rachi,radiu,rarely,short,shrub,simple,sparsely,stellate,stigma,style,subcordate,subcoriaceous,truncate,unbranched,unequally,violet,white,x,yellow	-10,.5-3.3,0,1,1-5,2,2.5,6-many-foliat,7,9,absen,adaxiall,aggregate,apart,apiculate,axe,blade,cell,connivent,curled,cylindrical,dendritically-branched,directed,distall,eaf,eed,flower,gland,leaving,less,like,lon,long,lower,midvein,mixed,mostly,narrowly,nflorescence,nther,obtuse,occasionally,orolla,peg,perfect,pore,presen,pubescen,ripe,ruit,scar,slightly,small,spaced,stalked,ste,stone,subcapitat,subclavate,tal,tem,time,tip,triangular,tube,unit,usually,vary,white-pubescent,wide,ympodial	abaxial,adaxial,anther,arrangement,branching,colour,corolla,form,fruit,growth,height,history,inflorescence,leaf,length,life,na,ovary,perennial,plant,pubescence,reproduction,rugulose,seed,shape,size,stem,subcapitate,surface,texture,type
361	wfo-0001028399	success	273	126	81	192	45	0.297	0.13,4.3,9.1,9.8,abaxially,absent,adaxially,adnate,age,anther,apex,apiculate,attachment,bark,base,brown,calyx,chartaceous,cm,corolla,densely,developed,diameter,dry,elliptic,extra-axillary,flattened-orbicular,flattened-reniform,flower,fruit,glabrous,glandular,globose,hair,incurved,interpetalar,lateral,layer,leaf,length,lobe,long,mature,mm,moderately,nearly,notched,oblong,orange,ovate,pedicel,peduncle,petiole,point,position,pubescent,ray,red,reddish,scattered,short,shrub,simple,sloughing,somewhat,sparse,stellae,stellate,stem,stigma,style,surface,tip,tissue,toward,transparent,truncate,tube,well,yellow-tan,young	.3,.4,.5,.5–2.4,.8,/3,0.04,0.06,0.2–0.3,0.3–0.4,0.3–0.5,0.3–0.6,0.4–0.5,0.4–0.6,0.4–0.7,0.4–0.9,0.5–1.1,0.5–1.3,0.7–1.0,0.7–2.3,0.8–2.5,0.9–1.9,1.0–5.5,1.1–1.4,1.1–1.7,1.2–1.5,1.2–1.7,1.2–2.0,1.3–2.0,1.4–2.4,1.5–2.1,1.6–2.3,1.6–2.5,1.7–2.7,1/2–2/3,1/3–1/2,1/4–1/3,2.0–3.9,2.2–2.6,2.2–2.8,2.2–2.9,2.4–3.2,2.5–11.2,2.8–3.0,3.1–3.8,3.2–3.8,3.4–3.6,4.0–5.4,4.2,4.4,5,5-merou,5.0,5.2–17.8,5.4,5–8,5–9,6.0–6.6,7.0,7–11,8–120,acute,aequilateral,alyx,anthe,anthesi,apart,apparently,appearing,appressed,arching,articulate,attenuate,axe,ba,basal,based,becoming,berry,blade,branch,branching,broad,broad-based,brochidodromous,bud,capitat,channeled,cunate,deciduous,dehiscent,deltoid,dentate,difoliate,distal,distinct,eaf,eed,either,emerging,entire,erect,exocarp,extending,fertile,filament,filiform,flexed,free,geminat,glossy,gradually,heterostylous,increasing,internodal,internode,intersepalar,juic,lanceolate,large,lobed,lon,longer,longitudinally,lower,major,many,margin,midpoint,midrib,midvein,minor,minute,narrowly,nflorescence,oblique,orolla,per,porrect,porrect-stellate,portion,potentially,prickle,primary,probably,raised,red-orang,reflexe,restricted,reticulate,ridge,rigid,rounded,row,ruit,secondary,sessile,shorter,side,sinuate,sinus,slit,soon,spaced,splitting,spread,spreading,stamen,stellate-pubescent,stipe,stipitate,straight,tamen,tem,thin,time,translucent,triangular,two,ud,unarmed,upper,various,vary,vein,weakly,wide,yellow-ferruginous,ympodia,±90°,±equal,×	0.2-0.3,0.3-0.5,0.3-0.6,0.4-0.5,0.4-0.6,0.4-0.7,0.4-0.9,0.5,0.7-2.3,0.9-1.9,1.0-5.5,1.1-1.4,1.2-1.7,1.2-2.0,1.3,1.3-2.0,1.4-2.4,1.5-2.1,2.0-3.9,2.2-2.9,2.8-3.0,3.8,5-8,5-9,5.2-17.8,adhesion,arrangement,breadth,capitate,colour,form,growth,inflorescence,na,number,ovary,presence,present,pubescence,rugulose,seed,shape,size,staman,texture
362	wfo-0001028405	success	149	94	58	91	36	0.389	0.4-0.5,1-9,1.5-6.5,10-11,2,2-2.5,2-4,3-4,4-11.5,4-6,6-7,7-14.5,8-15,abaxially,acumen,acute,adaxially,apex,apiculate,base,calyx,cm,conical,connate,corolla,diameter,distal,elliptic,elliptic-lanceolate,green,green-white,half,herbaceous,lanceolate,leaf,lobe,long,mm,oblique,oblong,odd-pinnate,ovate-elliptic,ovoid,pedicel,peduncle,perennial,petiole,plant,puberulent,seed,short-acuminate,size,stellate,stigma,style,throughout,wide,yellow	0.5-3,1-4,1.3-8,2-3,3-20,3-6-foliat,3.5-10,3.5-6.5,9-15,absen,apical,apically,articulate,attenuate,branched,cell,covering,cyme,decurrent,dehiscent,dichasial,dichasially,digestion,diminishing,dorsally,eaf,ebracteate,edge,eed,emoval,enzyme,exceeding,filament,flat,flower,folded,forked,generally,globo,gradually,hair-like,honeycomb,interjected,introrse,lateral,leaflet,living,lon,lower,lunat,make,maturing,monochasial,mucilaginous,nflorescence,nther,often,orolla,pair,pattern,perfect,plan,poricidally,proximal,rachi,reveal,ruit,seudostipule,short,short-petiolate,slit,specimen,stamen,straight,subsessile,tal,tem,terminal,testal,thick,throughou,toward,tuber-bearing,typically,unit,vary,wall,whit,without,ympodial,¼	adhesion,anther,arrangement,blade,climate,colour,form,fruit,glandular,globose,growth,hair,height,history,inflorescence,length,life,margin,midpoint,na,number,ovary,position,presence,pubescence,ray,reproduction,rugulose,shape,staman,stem,stipe,surface,texture,tube,white
363	wfo-0001028424	success	253	132	108	145	24	0.427	-0.8,-28,-3,-9,0-1,0.15-0.4,0.2-0.35,0.5,0.7-2,1.5-2.5,1.8-3,2-2.5,2-3,2-4,3,3-12,3-16,3-7,4-5,5-10,5-15,5-22,5-8,5.5-10,abaxially,acute,acute-,adaxially,anther,apex,attenuate,base,blade,broadly,calyx,campanulate,cm,coarsely,connivent,deeply,deltoid,deltoid-orbicular,densely,dentate,depressed-deltoid,diameter,diverging,elongate-lanceolate,extra-axillary,felty,fruit,glabrous,glandular,globose,hair,inflorescence,leaf-opposed,length,lenticular,less,light,like,lobe,margin,midpoint,minutely,mm,narrower,obtuse,obtuse-,occasionally,orange,outline,ovate,pedicel,peduncle,pentagonal-stellate,perennial,persistently,petiole,prickle,pubescent,ray,ripe,round-tipped,sessile,simple,size,somewhat,spreading-hirsute,stellate,stellate-puberulent,stellate-pubescent,stem,stigma,style,subcordate,suffrutescent,surface,tan,thin-textured,truncate,tube,weakly,white,white-pubescent,x,yellow	-1.2,0-0.5,0.1-0.2,0.2-0.7,0.3-0.6,0.3-0.7,1,1-3,1-7,1/3-1/2,10-16,12,12-19,2,2-foliate,3-5,3-6,3-8,4-12,4-6,4-7,8-15,8-25,accrescent,acicular,adaxiall,almost,along,and/or,apart,articulated,ascending,axe,ba,branched,broad-based,broader,capitat,capitate-glandular,cauline,closely,commonly,conspicuously,convex,covering,curved,cylindrical,dense,diffusely,directed,distal,distally,distributed,divergently,eaf,eed,elongate,entire,equaling,exceeding,female-sterile,filament,flexuous,flower,fruiting,geminat,gland-tipped,inserted,interlobal,larger,lateral,laterall,long,longer,lower,major,midrib,mixture,mostly,much,multiple-stemmed,multiseriate,nflorescence,numerous,obsolete,often,orolla,ovate-lanceolate,per,perfect,pitted,pore,prickly,principal,puberulent,rachi,radiu,rarely,recurved,reduced,reflexe,resembling,ruit,scattered,section,short,short-styled,shorter,side,similar,single-,sinus,slender,small,smaller,sometimes,spaced,sparsely,species,stalk,stalked,ste,stellae,stout,strongly,tal,tamen,tem,termination,thickened,time,tip,trichome,typically,unarmed,unbranched,unit,upward,usually,variable,vary,vein,wide,widely,ympodial	adhesion,arrangement,capitate,climate,colour,corolla,form,growth,height,leaf,na,number,ovary,plant,position,presence,pubescence,reproduction,rugulose,seed,shape,staman,texture,ye
364	wfo-0001028429	success	162	88	64	98	24	0.395	0.2-0.4,0.8-1.2,1.5-3,10-11,10-27,10.5-21,2-3,2.5-12,2.5-7.5,2.7-3.6,3-6,5-12,6-28,abaxially,acute,adaxially,broadly,calyx,cm,connate,corolla,darker,diameter,distal,elliptical,forked,glabrescent,glabrous,globose,green,green-white,greenish,hair,half,herbaceous,leaf,light,long,long-attenuate,medium,mm,narrowly,odd-pinnate,ovate,ovoid,pedicel,peduncle,pentagonal,perennial,petiole,plant,rotate,scattered,seed,size,slightly,spot,stigma,style,throughout,violet,white,wide,yellow	0.9-2.3,1-2.5,1-4,1.5-4,2-1.,2-4,2-8,2.5-4,3-6-foliat,4-14,6-18,7-7,abaxiall,acumen,acuminate,apex,apical,apically,articulate,base,branched,cell,cordate,covering,cuneate,cyme,dehiscent,dichasial,dichasially,digestion,diminishing,dorsally,eaf,ebracteate,edge,eed,emoval,enzyme,especially,exceeding,filament,flat,flower,folded,generally,globo,gradually,hair-like,honeycomb,interjected,introrse,lateral,leaflet,living,lobe,lon,lower,lunat,make,maturing,monochasial,mucilaginous,nflorescence,nther,oblique,obovate,often,orolla,pair,pattern,perfect,petiolule,plan,poricidally,proximal,reveal,ruit,seudostipule,short,slit,specimen,stamen,straight,tal,tem,terminal,testal,thick,throughou,toward,tuber-bearing,typically,unit,vary,vein,wall,ympodial,¼	anther,arrangement,colour,form,fruit,growth,height,history,inflorescence,length,life,na,ovary,position,presence,pubescence,reproduction,rugulose,shape,stellate,stem,surface,texture,tube
365	wfo-0001028436	success	150	95	62	88	33	0.413	0.2-0.4,0.5-1,1-2,1.5,1.5-2,1.5-2.5,10-20,2-3,2.5-3,4,5-10,5-12,5-8,8-12,abaxially,absent,acute,anther,apex,base,blade,brown,calyx,chartaceous,ciliate,cm,diameter,dm,dried,elliptic,entire,flower,fruit,glabrous,globose,hair,leaf,linear,linear-lancolate,lobe,margin,membranaceous,mm,moderately,nearly,oblong,pedicel,peduncle,petiole,presence,pubescent,rotate,shrub,sparsely,stem,stigma,style,surface,tube,unifoliate,white,x	.5,0.5,0.8-1.5,1-2-celled,1-3,1st,2-4,2nd,5-15,7,abundant,adaxiall,adaxially,along,apically,appearance,appearing,axe,berry,beyond,cell,center,connected,cordat,decurrent,deflated,dehiscent,difficult,due,eaf,edge,eed,evaluat,explosively,exserted,filament,fine,flat,frui,fruiting,geniculate,glabrescen,interpetalar,lengt,like,long,lower,lying,much-branched,nflorescence,notch,often,older,orolla,oung,parallel,per,placenta,pointing,pubescen,rachi,radiating,raised,reaching,rhizomatous,ridge,ruit,running,shallow,small,stamen,structure,swollen,tal,tamen,taproot,tear,thick,tissue,triangular,two-celled,unbranched,unit,vary,wid,woody,wrinkled,ympodial	2.5,adhesion,arrangement,climate,colour,corolla,form,glandular,growth,height,history,inflorescence,length,life,midpoint,na,number,ovary,perennial,plant,position,pubescence,ray,reproduction,rugulose,seed,shape,size,staman,stellate,stipe,texture,ye
366	wfo-0001028465	success	159	82	62	97	20	0.39	0.75,1.2-2,1.5-2.9,10-24,11-23,2-3,2-6,2-9.3,2.4-2.8,3-4,3-5,4-8,4.5-5.5,5-7,7-15,8-10,broadly,calyx,cm,connate,corolla,diameter,distal,elliptical,forked,generally,globose,green,green-white,half,herbaceous,interjected,interpetalar,lateral,leaf,leaflet,long,medium,mm,odd-pinnate,ovoid,pair,pedicel,peduncle,perennial,petiole,plant,puberulent,pubescent,purple,rotate,seed,size,spot,stigma,strigose,style,terminal,throughout,white,wide,yellow	1-2,1-4,10,2,2-4,2.5-4,3-6-foliat,3-8,3.8-7,4-1.,9-19,abaxially,acumen,acuminate,acute,adaxially,apex,apical,apically,articulate,attenuate,base,branched,cell,covering,cuneate,cyme,decurrent,dehiscent,dichasial,dichasially,digestion,diminishing,dorsally,eaf,ebracteate,edge,eed,emoval,enzyme,equal,exceeding,filament,first,flat,flower,folded,globo,gradually,hair-like,honeycomb,introrse,living,lobe,lon,lower,lunat,make,maturing,monochasial,mucilaginous,nflorescence,nther,oblique,often,orolla,pattern,perfect,petiolule,plan,poricidally,proximal,rachi,rarely,reveal,ruit,sessile,seudostipule,short,slit,specimen,stamen,straight,tal,tem,testal,thick,tissu,toward,tuber-bearing,two,typically,unit,vary,wall,ympodial,¼	4-18,anther,arrangement,colour,form,fruit,growth,height,history,inflorescence,length,life,na,ovary,position,reproduction,shape,stem,texture,tissue
367	wfo-0001028468	success	255	127	100	155	27	0.392	-5.5,.5,.5-1.6,.6-1,/10-1/5,0.05,0.1,0.2-0.3,0.4-1,0.4-4,0.5-2,0.6-1.2,0.7-2.5,1,1.2-1.5,1.3-2,1/5-1/2,16,2,2-9,2.2-3,2.8-4.1,2/3-3/4,5-21,5-9,6-9,acute,anther,apex,base,berry,blade,blue,brown,calyx,campanulate,chartaceous,clavate,cm,corolla,densely,diameter,distally,extra-axillary,flattened,flower,fruit,glabrous,gradually,gray,greenish,increasing,inserted,length,light,lobe,lobed,longer,margin,midpoint,mm,moderately,narrowly,oblique,oblong-conical,oblong-lanceolate,orange,orangish,pale,pedicel,peduncle,petiole,proximal,pubescence,purple,ray,rhombic,rotate-stellate,shallowly,shrub,sparsely,stellate-pubescent,stelliform,stem,stigma,style,subcapitate,subelliptic,subglobose,sublenticular,subreniform,subshrub,surface,terete,thicknes,time,tube,x,yellow,yellowish	-1.3,-10,-3,-4,-7,.1-0.2,.1-0.3,.1-0.4,.2,.2-0.4,.3,.3-0.4,.5-1.5,/4-1/3,0.2-0.6,0.2-1.5,0.5-3,0.5-3.3,0.5-3.5,0.5-8,0.6-2,0.8-3.5,1.5-2.2,1.5-3.1,1.6,1/3-1/2,2.5-4,20,3-4,4-6,4-9,6-10,abaxially,accrescent,acuminate,adaxially,along,apart,appressed,ark,armed,articulated,attenuate,axe,becoming,beyond,broad-based,broadly,bu,bud,c.,cauline,central,commonly,compresse,compressed,connivent,d.,dark,decreasing,density,directed,distal,distantly,dry,eaf,eed,ellipsoid,equal,exserted,filament,foveate,fruiting,geminat,glabrescent,green,hair,half,interpetalar,introrsel,lamin,lateral,laterally,long,lower,m.,main,midvein,minutely,mixed,mostly,multangulat,multangulate,nflorescence,obtuse,occasionally,older,orolla,ovate,overlapping,ovoid,pair,papillo,per,perfect,pore,porrect-stellate,prickle,pubescent,rachi,recurved,reduced,relatively,reticulate,ruit,sessile,short,short-,short-stalked,side,similar,similarly,simple,slightly,somewhat,spaced,specimen,stalk,stamen,straight,subacuminate,subchartaceous,subcuneate,subsessile,tal,tamen,testa,thick,thick-stalked,tissue,touching,toward,triangular,unarmed,unbranched,unifoliate,unit,upper,usually,vary,vein,way,wide,ympodial,young	0-1.3,0.1-0.2,0.3,0.5-1.5,adhesion,bark,color,form,growth,height,inflorescence,leaf,na,number,ovary,plant,position,presence,present,rugulose,seed,shape,size,staman,stellate,stipe,texture
368	wfo-0001028470	success	185	104	78	107	26	0.422	0.25-0.75,0.9-2.2,0.9-2.3,1-12.3,1-2,1-3,11.8-21,12-44,2-10,2-7,2-8,2.1-3.9,3-10,3.5-16,4-7,5.5-11.6,abaxially,adaxially,anther,articulated,axillary,brownish,bud,chartaceous,clavate,cm,condition,corolla,deep,diameter,distal,dot,drying,elliptic,fresh,fruit,glabrescent,glabrous,green,greenish,hair,half,herb,high,lanceolate,leaf,lobe,long,medium,mm,mottled,odd-pinnate,ovate,ovoid,pedicel,peduncle,pentagonal,petiole,plant,purple,ripe,scarce,seed,short,size,sometimes,stigma,style,substellate,subtending,terminal,tube,usually,white,whitish,wide,x,yellow	0-18,1.5-2.8,1.6-3.2,2-5,3-5,3.2-5.5,3.5-7,4-6,5-merou,6-33,acumen,acute,adaxiall,ag,alyx,apart,apex,apparently,asymmetric,attenuate,axe,base,basiscopic,berry,blade,capitat,cell,connivent,covering,dark,decreasing,digestion,dorsally,eaf,edge,eed,end,enzyme,erec,exceeding,filament,flat,flower,folded,forked,geminat,generally,glabrou,green-white,hair-like,hal,homostylous,honeycomb-shaped,interjected,lateral,leaflet,lengthening,light,living,lower,make,mucilaginous,nflorescence,one,orbicular,orolla,pair,perfect,petiolulate,placed,plurifoliate,pore,poricidal,pubescent,removed,rounded,ruit,sessile,seudostipule,side,slit,spaced,specimen,stamen,stolo,straight,subequal,subglabrou,tall,tamen,tem,testal,thick,throughout,tip,tissue,toward,tri-,tuber,typically,unit,unwinged,vary,wall,wet,wing,ympodial	adhesion,arrangement,calyx,capitate,colour,form,growth,height,history,inflorescence,length,life,na,ovary,perennial,position,pseudostipule,pubescence,reproduction,rugulose,shape,staman,stem,subglabrous,surface,texture
369	wfo-0001028476	success	246	90	69	177	21	0.28	-16,-6,-8,.05-0.1,0.25-0.5,0.4-0.6,0.5-0.6,0.8-1.2,0.8-1.6,1,1-1.4,1-4,1-6,1.1-1.5,1.8-2.5,2.4-3,3.5-13,5-15,7-10,abaxially,abundant,anther,branched,brown,calyx,capitate,cm,conical,corolla,dark,diameter,elliptic,fruit,globose,green,herb,imparipinnate,inflorescence,interrupted,leaf,lobe,long,minutely,mm,narrowly,obovate,ovary,pale,pedicel,peduncle,perennial,petiole,present,puberulent,pubescence,pubescent,purple,sparsely,stellate,stem,stigma,stripe,style,surface,thick,tube,uniformly,wide,yellow	-1,-20,.5,0-,0-0.5,0.1-0.15,0.1-0.4,0.15-0.2,0.15-0.4,0.2-0.3,0.2-0.5,0.2-0.6,0.25-0.4,0.3-0.4,0.3-0.5,0.3-0.7,0.3-1.2,0.4-0.5,0.4-1.5,0.5,0.5-1.7,0.7-2.5,1-1.2,1-1.5,1-2,1-2-celled,1-celled,1.1-1.6,1.2-2.5,12-30,2,2-6,2-foliate,2-locular,3-12,3-7,3-foliate,4-celled,6-,8-30,absent,acroscopically,acuminate,acute,age,almost,along,also,alternate,anthesi,ape,apex,apical,appearance,appendage,articulated,axi,basal,base,basiscopically,becoming,bifurcate,bifurcation,bract,bracteate,bright,cell,column,curved,decurrent,deeply,diamete,distal,eaf,ebracteate,edicel,eed,elongate,entire,especially,exserted,filament,first,flower,fortaleza,fruiting,give,glabrescent,glandular,gradually,gree,hair-like,hal,half,head,hyaline,incurved,interjected,internode,irregularly,lanceolate,largest,lateral,leaflet,less,like,lobed,lon,lower,main,margin,maturity,midvein,minute,mixed,nflorescence,node,numerous,oblique,occasionally,often,outgrowth,pair,petiolule,population,primary,prominent,pseudostipule,rachi,rarely,recurve,reflexed,regularly,rest,rounded,ruit,río,scattered,secondary,sessile,set,short,silky,simple,sinus,slightly,smaller,sprawling,spreading,staminal,sterile,stiff,straight,subopposite,tall,tem,terminal,tertiary,testa,tip,toward,trichome,truncate,ud,unicellular,uniseriate,unit,unpaired,usually,vein,wall,weak-walled,white,wid,winged,woody,ympodial	6-30,adhesion,arrangement,colour,form,growth,height,history,length,life,na,plant,position,presence,reproduction,rugulose,seed,shape,size,staman,texture
370	wfo-0001028478	success	267	145	118	149	27	0.442	.04,.3,.5,.8,.9,0.0,0.1,0.2–0.4,0.3–0.5,0.4–0.5,0.5–0.6,0.5–0.8,0.5–0.9,0.6–1.3,0.9–1.1,1.0–1.5,1.1–1.6,1.4–2.3,1.4–4.4,1.8–2.0,2,2.0–11.0,2.1–2.3,2.2–4.0,2.5,4,4.6–7.0,4–6,7.7–9.2,abaxially,acuminate,adaxially,adnate,anther,apex,attachment,attenuate,base,bilobed,blade,brown,calyx,cm,corolla,densely,developed,diameter,distinctly,dry,elliptic,entire,filiform,flattened-orbicular,flower,fruit,glabrous,glandular,globose,hair,incurved,interpetalar,lanceolate,leaf,length,lobe,lobed,margin,markedly,mature,mm,moderately,nearly,notched,obtuse,occasionally,orange-red,ovate,pedicel,peduncle,petiole,point,poorly,pubescent,ray,reddish,rounded,scattered,shoot,short,shrub,sigmoid,simple,sinuate,slightly,somewhat,sparsely,spatulate,stellate,stem,stigma,stipe,style,sub-cordate,sub-coriaceous,suborbicular,surface,terminal,tip,tissue,toward,truncate,tube,typically,white,yellow,yellow-tan,×,–10	.0,.2,0.2,0.3–0.4,0.4,1.0–1.3,1.3–1.6,1.5–2.4,1.5–4,1/2–1/3,2.3,3.3–4.9,3.4,3–6,4.6,4.8,4–7,5-merou,5.5–6.6,7,adjacent,aequilateral,ag,alyx,anthesi,apart,apical,apparently,appearing,appresse,around,articulate,axe,ba,bark,based,berry,borne,broad,broad-based,broadly,brochidodromous,bud,capitat,channeled,clinate,connivent,deciduous,deeply,deflexed,deltate,development,difoliate,directed,distal,distally,distinct,eaf,edge,eed,either,emerging,endocarp,erect,exocarp,extending,fertile,filament,flexed,free,geminat,glossy,gradually,hort,increasing,individually,internode,intersepalar,juic,lateral,layer,lon,long,longer,lower,midpoint,midrib,midvein,minute,nflorescence,oblique,oblong,opaque,orolla,per,perforated,pitted,pore,porrect,porrect-stellate,portion,potentially,presen,prickle,probably,raised,retrorse,rigid,row,ruit,seen,sessile,shallowly,side,sinus,sloughing,smoot,soon,spaced,splitting,spread,stamen,stellae,stellate-pubescent,stipitate,straight,strongly,suture,tamen,tem,thin,time,transparent,triangular,two,ud,unarmed,unbranched,various,vary,vein,well,wide,yellow-ferruginou,ympodia,young,±45°,±90°,±equal	adhesion,arrangement,capitate,colour,form,growth,height,history,inflorescence,life,na,number,ovary,perennial,plant,position,presence,present,pubescence,reproduction,rugulose,seed,shape,size,staman,texture,unknown
371	wfo-0001028481	success	194	117	100	94	17	0.515	.1,.5,0.6-1,0°,1-3,1-4,1.5,1.8-2.5,2.5-3,3-4,3-6,5.5-7.5,8,acuminate,acute,almost,along,anther,apex,apically,attenuate,bark,base,branch,branched,brown,chartaceous,clavate,cm,colour,conical,corolla,cuneate,cupular,deltoid,dendritic,dendritic-pubescent,diameter,discolorous,distributed,drying,elliptic,entire,evenly,flaking,glabrous,green,leaf,length,less,liana,like,lobe,lobed,long,long-acuminate,longitudinally,main,margin,midvein,mm,narrowly,oblong,occasional,often,orange-brown,pair,pedicel,peduncle,petiole,primary,pubescent,ray,reddish,ridged,scar,shortly,shrub,side,size,slender,small,sparsely,stem,stigma,stump,style,terminal,tertiary,thickly,trichome,unarmed,unknown,vein,venation,visible,white,x,yellowish,young	.3,0-2,0.1-0.2,0.15,0.5-1,1-1.4,1-2,1.5-2,1/2-2/3,2-3,3,3-3.5,3-4.5,abaxially,absent,adaxially,age,alyx,anthesi,apar,apparently,articulated,canaliculate,clearly,close,deeply,delineated,density,different,dilated,divided,domatia,dorsifixed,dry,eaf,eed,ellipsoi,equal,erect,except,extending,extent,eye,faint,filament,flat,flexuous,flower,free,increasing,know,known,lamina,lengthening,linear,lon,longer,lower,m.,mostly,naked,nflorescence,nther,oblique,orolla,ovate,perfec,plurifoliat,pore,poricidal,portion,protruding,rachi,raised,ribbed,ruit,see,simple,sinus,smoot,smoothly,spreading,surface,tearing,tip,together,toward,tube,ud,uneven,unit,vary,wide,ympodial	angle,apart,arrangement,branching,calyx,form,fruit,growth,inflorescence,na,number,ovary,position,seed,shape,smooth,texture
372	wfo-0001028482	success	224	132	102	122	30	0.455	.5,/3,0.5-1,0.5-5,00,1-1.5,1-11,1-2,1-4,1.1-5,1.2-1.6,1.5-2,10,2-3,2-celled,3-12,3-4,4-5,5-25,abaxially,acuminate,acute,anther,apex,asymmetric,base,bilobed,broadly,brownish,calyx,campanulate,capitate,chartaceous,cm,coriaceous,corolla,creamy,deltate,densely,diameter,difoliate,dry,elliptic,emarginate,entire,flattened-reniform,fresh,fruit,glabrous,glandular,globose,green,growth,hard,internodal,leaf-opposed,lobe,lobed,long,margin,material,maturity,minute,minutely,mm,obovate,ovary,pale,pedicel,peduncle,petiole,pitted,poricidal,pubescent,revolute,short,simple,size,slightly,somewhat,stem,stigma,style,subcoriaceous,subglobose,subpyramidal,surface,tan,tip,tree,trichome,truncate,tube,unifoliate,uniseriate,way,white,x,yellow,yellowish,young,µm	.1,0,0.2,0.5,0.7-1.1,1.5-3,6-50,7-14,adaxially,age,alternate,angled,anthesi,apiculae,ascending,bark,basal,becoming,berr,berry,bifid,bifurcate,branched,bright,brochiodromous,bud,channeled,circinate,closely,constriction,corky,corrugated,cucullate,curved,cymose,deciduous,deflexed,diffusely,discolorous,distally,distinct,drying,eaf,eed,ellipsoid,embryo,enlarged,exerted,exfoliating,expanding,filament,fleshy,flower,free,fruiting,geminat,glabrou,golden,grayish,halfway,heterostylous,impressed,incrassate,individual,investing,irregular,keeled,lengthening,less,lower,markedly,materia,midrib,midvein,new,nflorescence,nodding,occasionally,olive,overlappin,pair,papillat,pentamerous,per,pericarp,petal,pore,portion,primary,reddish,row,ruit,scandent,scar,shaped,shiny,slit,small,sometimes,soon,spaced,sparsely,stout,straight,tear-drop,tightly,tiny,transparent,transversely,tub,tuberculate,tuft,twice,two,ud,unit,usually,vegetative,vein,venation,woody,ympodial	adhesion,arrangement,blade,climate,colour,form,hair,height,history,inflorescence,leaf,length,life,midpoint,na,number,perennial,plant,position,presence,pubescence,ray,reproduction,rugulose,seed,shape,staman,stellate,stipe,texture
373	wfo-0001028487	success	195	100	74	121	26	0.379	0.3-0.7,0.9-3,1-3,1.1-1.5,1.4-1.7,10-4.3,15-28,2-4,2-6,2.5-3.5,3-10,3-19,4.6-13.6,5-6,7.8-16.4,abaxially,acumen,adaxially,anther,axillary,brownish,bud,central,clavate,cm,condition,coriaceous,corolla,deep,diameter,drying,elliptic,fresh,fruit,glabrescent,glabrous,green,greenish,hair,herb,lanceolate,leaf,light,lobe,long,medium,mm,odd-pinnate,ovate,ovoid,pedicel,peduncle,pentagonal,petiole,plant,purple,ripe,scabrous,scarce,seed,short,size,star,stigma,style,substellate,subtending,terminal,tube,white,whitish,wide,x,yellow	0-9,0.4-1.5,1-2,1-3.2,1.7-7,10-41,2-4.8,3-4,3-5,3.4-7.8,4-7,5-merou,acuminate,acute,adaxiall,ag,along,alyx,apart,apex,apparently,arranged,articulated,asymmetric,attenuate,axe,base,basiscopic,bead,berry,blade,capitat,cell,connivent,considerably,covering,dark,decreasing,digestion,distal,dorsally,eaf,edge,eed,enzyme,erec,exceeding,filament,flat,flower,folded,forked,geminat,generally,glabrou,green-white,hair-like,hal,half,high,homostylous,honeycomb-shaped,interjected,lateral,leaflet,lengthening,like,living,lower,make,moniliform,mucilaginous,multiple,narrow,necklace,nflorescence,orbicular,orolla,pair,perfect,petiolulate,plurifoliate,pore,poricidal,removed,rounded,ruit,second,sessile,seudostipule,side,slit,smaller,sometimes,spaced,specimen,stamen,stolon,straight,subequal,subglabrou,tall,tamen,tem,testal,thick,throughout,tip,tissue,toward,tri-,tuber,typically,unit,unwinged,usually,vary,wall,wet,wing,ympodial	adhesion,arrangement,calyx,capitate,colour,form,growth,height,history,inflorescence,length,life,na,ovary,perennial,position,presence,pubescence,reproduction,rugulose,shape,staman,stellate,stem,surface,texture
374	wfo-0001028489	success	224	138	106	118	32	0.473	-0.6,-10,-2.5,-6,/4,0-3,0.2-0.4,0.3-1,0.3-1.2,0.5-1.1,0.5-1.5,0.6-1.2,0.7-3,1-3,1-4,1.5-4,1.8-2.2,1.8-4,1/3,2-3,2.1-3,3-7,3.5-6,4-8,5-8,7.5,abaxially,acute,anther,apex,apically,base,berry,blade,calyx,chartaceous,cm,connivent,cordate,cream,cuneate,dark,deltate,densely,diameter,dull,elliptic,erect,flattened-reniform,fruit,glabrous,gray,green,hair,lateral,leaf,length,lobe,lobed,long,margin,marking,maturity,mauve,membranous,midpoint,mm,moderately,obtuse,orange,orange-brown,ovate,pale,pedicel,peduncle,petiole,poricidal,purple,ray,rounded,shrub,side,simple,smooth,sometimes,sparsely,spherical,stellate,stellate-pubescent,stem,style,surface,tapering,tip,toward,trichome,truncate,tube,upper,way,weakly,white,wide,yellow,yellow-orange,young	-4,-5,0-10,0-15,0-20,0-50,0.1,0.1-0.6,0.2,0.2-,0.2-0.5,0.2-0.6,0.2-0.7,0.3-0.5,0.3-0.7,0.4-0.8,0.5-0.8,0.5-1,1-6,1-7,1.5-3,1.8-5.5,1/3-1/2,1/4-1/2,2-4,2-6,4-10,4-13,5-25,5-merous,acicular,alyx,apar,apart,apparently,articulated,ba,bark,beyond,branched,broad-deltate,caudat,cell,concolorous,curved,difoliate,distance,drying,eaf,eed,elongating,equal,extending,eye,filament,flower,free,fruiting,geminat,herbaceous,infructescence,less,lon,longer,lower,mature,midvein,minute,naked,nflorescence,occasionally,often,older,one,open,orange-green,orolla,oung,outline,pair,pendulous,per,perfec,pericarp,perpendicular,porrect,portion,prickle,prickly,primary,protruding,raised,red-brown,ruit,scar,sessile,shiny,slender,spaced,spreading,stalk,straight,subsessile,tamen,terete,tertiary,time,unarme,unarmed,unit,vary,vein,venation,visible,white-gra,woody,yellow-green,ympodial	adhesion,arrangement,caudate,climate,colour,corolla,form,glandular,growth,height,history,inflorescence,life,na,number,ovary,perennial,plant,position,presence,present,pubescence,reproduction,rugulose,seed,shape,size,staman,stigma,stipe,texture,unknown
375	wfo-0001028492	success	130	94	57	73	37	0.438	0.5-1,1-2.5,1-4,1.5-2.5,1.5-3,1.5-6,2-2.5,2-3,2-5,2.5-9,3,4,5-15,5-8,6-11,acute,angled,apex,base,blade,calyx,cm,dark,deltate,diameter,elliptic-ovate,entire,fruit,glabrous,globose,hair,herb,lobe,margin,mm,narrowly,pedicel,peduncle,petiole,purple,reticulate,rounded,shrub,simple,somewhat,stellate,stigma,style,subcordate,subcoriaceous,succulent,triangular,tube,unknown,white-punctate,whitish,x	-5-foliat,0.2-2,1-5,1.75-3.5,15-20,2-4,3-6,5-25-flower,6-12,8-15,abaxially,absen,adaxially,aggregate,apart,apiculate,articulated,axe,axi,cell,chartaceous,ciliolate,color,colored,connivent,containing,crystal,cylindrical,directed,distall,eaf,eed,except,forked,glabrou,irregularly,leaving,long,lower,nflorescence,nther,obtuse,orolla,pore,pubescent,punctate,rachi,radiu,rarely,ripe,ruit,san,sand-punctate,scar,spaced,sparse,splitting,stone,tal,tem,time,tip,triangular-ovate,truncat,unbranched,unevenly,unit,vary,veiny,white,wide,x1-3,ympodial	1-3,adhesion,anther,arrangement,climate,colour,corolla,form,glandular,growth,height,history,inflorescence,leaf,length,life,midpoint,na,number,ovary,perennial,plant,position,presence,pubescence,ray,reproduction,rugulose,seed,shape,size,staman,stem,stipe,surface,texture,truncate
376	wfo-0001028501	success	195	99	73	122	26	0.374	0-3.2,0.3-0.7,0.8-1.6,0.8-1.7,1-8,1.8-10.7,13-41,2-4,2.8-18,2.8-4.9,3-10,3-7,3.1-12,4-8,6.6-21.1,abaxially,adaxially,anther,axillary,brownish,bud,clavate,cm,condition,coriaceous,corolla,diameter,drying,elliptic,fresh,fruit,glabrescent,glabrous,green,greenish,hair,herb,lanceolate,leaf,light,lobe,long,medium,mm,mottled,odd-pinnate,ovate,ovoid,pedicel,peduncle,petiole,plant,purple,pyriform,ripe,rotate,scarce,seed,short,simple,size,sometimes,spot,stigma,style,subtending,terminal,tube,white,whitish,wide,x,yellow	0-3,0-4,0.3-3.3,0.6-5.8,1,1-2,1-3,2-5,3-5,3.1-10.4,4.8-18,5-merou,8-10,8-34,acumen,acuminate,acute,adaxiall,ag,along,alyx,apart,apex,apparently,arranged,articulated,attenuate,axe,base,bead,berry,blade,broadly,capitat,cell,connivent,considerably,covering,dark,decreasing,decurrent,digestion,distal,dorsally,eaf,edge,eed,enzyme,erec,exceeding,filament,flat,flower,folded,forked,geminat,generally,glabrou,green-white,hair-like,hal,half,high,homostylous,honeycomb-shaped,interjected,larger,lateral,leaflet,lengthening,like,linear,living,lower,make,moniliform,mucilaginous,multiple,narrow,narrowly,necklace,nflorescence,onto,orbicular,orolla,pair,perfect,plurifoliate,pore,poricidal,present,rachi,removed,ruit,sessile,seudostipule,slit,spaced,specimen,stamen,stolon,straight,subglabrou,tall,tamen,tem,testal,thick,throughout,tip,toward,tri-,tuber,typically,unit,unwinged,usually,vary,wall,wet,wing,ympodial	adhesion,arrangement,calyx,capitate,colour,form,growth,height,history,inflorescence,length,life,na,ovary,perennial,position,presence,pubescence,reproduction,rugulose,shape,staman,stellate,stem,surface,texture
377	wfo-0001028502	success	158	97	60	98	37	0.38	0.5-1,1-2,1.5-2.5,1.5-3,1.5-6,1.6-2.4,2-4,2-7,2-8,3.5-15,3.5-4,abaxially,acute,adaxially,anther,apex,base,blade,brown,calyx,campanulate,clavate,cm,corolla,dark,deltate,densely,elliptic,flattened-reniform,glabrous,globose,inflorescence,later,lateral,leaf,lobe,lobed,long,margin,mm,obovate,ovary,pedicel,petiole,pubescent,reddish-brown,seed,shining,shrub,small,stem,stigma,style,surface,terminal,tree,tube,white,wide,woody	.5,/2,1.5-2,2-2.5,2-5,5-15,5-6,6-8,?,abaxial,age,along,anthesi,apar,ba,bark,beige,body,branch,branched,cazalet,christmas-tree-like,closely,cone,congested,constricted,dendritic,denser,dia,eaf,edicel,eed,erect,exserted,fawn,fide,filament,flat,fleshy,flower,free,fruiting,glabrat,heteromorphic,impressed,included,incrassate,inflorescenc,lengthening,light,like,lon,long-styled,lower,main,matted,middle,minutely,narrower,nflorescence,often,older,packed,pair,papillo,papillose,pitted,planar,plurifoliat,pore,poricidal,portion,prominent,rest,ruit,scar,scattered,short-styled,slit,spaced,structure,tall,thick,time,tip,tree-like,trichome,tub,ud,unclear,unevenly,vein,warty,way,widest,within,ympodia,young	1,4-6,adhesion,arrangement,climate,colour,dense,diameter,form,fruit,glandular,growth,hair,height,history,length,life,midpoint,na,number,peduncle,perennial,plant,plurifoliate,position,presence,present,pubescence,ray,reproduction,rugulose,shape,size,staman,stellate,stipe,texture
378	wfo-0001028505	success	168	76	59	109	17	0.351	.01,.1,.5,/3,0.25-0.5,0.8-1,0.8-1.5,1,1-3,10-15,2,3.5-5,anther,base,broadly,calyx,cm,conical,corolla,dia,drying,erect,glabrous,globose,green,grey,leaf,lobed,long,minutely,mm,narrowly,opposite,ovary,ovate,ovoid-reniform,pale,pedicel,petiole,pitted,plant,poricidal,pubescent,seed,shape,shrub,size,stem,stigma,style,surface,tip,trichome,tube,unicellular,uniseriate,way,white,x	.3,1.2-2.5,1/3,10-14-flowered,2.5-4.5,3-5,7-8,acuminate,acute,anthesi,apex,aspect,ba,barely,bark,basal,beneath,berry,black,blade,body,branch,bright,bud,characteristic,darker,deciduous,decurrent,deflexed,delicate,deltoid,differentiated,differing,difoliate,distance,distinct,dried,dry,eaf,edicel,eed,elliptic,expanded,exserted,exsertion,f,filament,flattened,free,fruiting,geminat,gently,greatly,incrassate,lateral,live,lobe,lon,lower,m.,main,major,margin,materia,material,member,minor,minute,nflorescence,obovoid,obvious,older,overlapping,pair,papillose,pore,portion,prominent,proximal,purple,reflexed,rounded,ruit,scar,shaped,short,simple,slightly,somewhat,soon,specimen,straight,strongly,tall,tan,tapering,tear-drop,touching,truncate,ud,unit,usually,vein,whit,widest,woody,yellowish,ympodial,young	arrangement,colour,diameter,form,fruit,growth,height,history,inflorescence,length,life,perennial,position,pubescence,reproduction,sympodial,texture
379	wfo-0001028513	success	240	113	87	153	26	0.362	-17,0.1-0.15,0.2-0.8,0.5-0.6,1-2.5,1-4,1.5-5,2-4,2-5,2.75-3.25,20-35,25-45,3-4,3-4.5,3.5-4,4-6,4-8,5-10,5-9,7-11,8-11,8-15,acute,anther,apex,apiculate,attenuate,base,blade,broad,broadly,brown,calyx,campanulate,cm,coarsely,dentate,diameter,ellipsoidal,extra-axillary,fruit,globose,hair,inflorescence,lavender,leaf,length,lenticular,light,linear-lanceolate,lobe,margin,mm,obtuse,orange,outline,ovate,pedicel,peduncle,perennial,petiole,pitted,present,pubescent,ray,ripe,rounded,short,simple,small,somewhat,stellate,stellate-pubescent,stigma,style,subcordate,surface,texture,thin-textured,tree,trichome,truncate,tube,variable,white,x,yellow	-0.7,-0.8,-5,-6,.1-1.3,.2,.3-0.5,/3,0-0.4,0.1-0.4,0.3-0.5,0.5-2,1,1-2,1-3,1/5-1/3,15-40,2,2-4.5,2-6,2-foliate,30,4-locular,4.5-6,5-6,8-16,8-25,9-11,abaxially,accrescent,acute-,acute-tipped,adaxiall,adaxially,along,apart,appearing,appressed,approaching,approximately,armed,articulated,axe,ba,berr,bristly,broad-based,bud,capitat,cauline,close,closely,commonly,compresse,connivent,cylindrical,deciduous,deltoid,densely,depressed-deltoid,directed,distal,distall,doubling,eaf,eed,enclosing,entire,erect,exceeding,female-sterile,filament,flexible,flower,fruiting,geminat,glabrous,horizontal,inserted,interlobal,large,larger,lateral,laterally,less,lignescent,long,lower,major,many,mature,midpoint,minute,near,nflorescence,numerous,obtuse-,often,one,oriented,orolla,ovate-lanceolate,pair,partially,per,pericarp,persisting,plane,pore,prickl,prickle,prickly,principal,purple,rachi,radiu,rarely,reaching,recurved,rigid,round-tipped,ruit,rust-colored,scabrous,scattered,sessile,short-stalked,side,silvery-gray,sinus,siz,smaller,soft,spaced,sparsely,stalk,stellae,tal,tamen,tem,termination,time,tooth-like,unarmed,unbranched,underdeveloped,unit,usually,vary,vein,weakly,wide,ympodial	adhesion,arrangement,capitate,colour,corolla,form,glandular,growth,height,history,life,na,number,ovary,plant,position,presence,pubescence,reproduction,rugulose,seed,shape,size,staman,stem,stipe
380	wfo-0001028524	success	236	118	91	145	27	0.386	0.3,1-5,1.1-1.2,1.2-1.3,1.5-1.6,1.5-3,1.8-2.5,10-20,11,2-3.8,2-6,2.5-4,2.8-3.5,3-10,3-15,3-4.3,3.4-3.6,4-6,4-8,8-13,9-14,acute,adaxially,anther,becoming,blunt-tipped,brown,calyx,chartaceous,cm,conical,corolla,cream,dark,deltoid,densely,diameter,dm,ferrugineous,fleshy,flower,fruit,glabrescent,granular-tomentose,gray,green,greenish,growth,honeycombed,inserted,lanceolate,lateral,leaf,length,lobe,mm,oblong,ovate,pale,pedicel,peduncle,persistent,petiole,probably,pseudo-terminal,pubescent,rather,reniform,reticulate-punctate,ripe,scabridulous,simple,small,somewhat,sparsely,stellate,stelliform,stem,stigma,style,subcoriaceous,subglobose,suborbicular,tomentose,tree,tube,velutinous,x,yellow,yellowish,yellowish-green	-2.7,-3,.5-1,/10-3/10,0-150,0.3-0.8,0.5-3.5,0.6-1.4,1/3-2/3,2.5-3.4,2.5-3.8,3.3-4,4.3-6,6-7,6-9,7-10,7-11,abaxially,accrescent,acuminate,ag,along,anthesi,apart,apex,apical-lateral,apparently,articulated,ascending,axe,axillary,ba,bark,base,berry,blade,branch,branched,bud,capitat,closely,continued,dehiscing,distal,due,eaf,echinoi,echinoid,eed,elliptic,entire,exserted,extend,few-,few-rayed,filament,first,free,fruiting,glabrescen,glabrous,hair,half,high,indument,interpetalar,introrse,lacking,lanceolat,large,late,later,lobed,long,longitudinal,lower,m.,main,many-rayed,margin,matted,midvei,midvein,mixed,multangulate,nearly,nflorescence,obscured,obtuse,often,older,orbicular,orolla,ovate-lanceolate,overlapping,partly,perfect,plurifoliate,pore,porrect-stellate,present,prominent,rachi,ray,relatively,rounded,ruit,runk,sessile,short,short-stalked,side,slightly,slit,spaced,sparingly,stalked,stamen,stout-stalked,strongly,sulcate,suture,tamen,terete,testa,thick,thick-stalked,thin,thin-stalked,time,tissue,tomentu,touching,translucent,unarme,unarmed,unit,usually,vary,vein,warty,way,wide,ympodial,young	abaxial,adaxial,adhesion,arrangement,capitate,colour,form,height,history,inflorescence,life,na,ovary,perennial,plant,position,pubescence,reproduction,rugulose,seed,shape,size,sparing,staman,surface,texture,unknown
381	wfo-0001028525	success	257	133	116	141	17	0.451	0.2-0.3,0.5,0.5-1.5,0.5-2.5,0°,1.1-1.7,1.2-1.6,1/3-3/4,10,10-13,2,2-2.5,2.5-5,3,3-5,3-7,4-15,4-5,4-7,6,7,acuminate,acute,almost,anther,anthesi,apex,attenuate,bark,base,black,branch,branching,broadly,brown,calyx,capitate,chartaceous,clavate,cm,conical,cordate,corolla,curved,dark,deltoid,dendritic-pubescent,density,developed,diameter,drying,elongated,entire,flat,flattened,flexuous,form,fruit,glabrous,green-brown,grey,increasing,lateral,laterally,leaf,liana,light,linear,lobe,lobed,long,longitudinally,lumpy,main,margin,mature,mauve,membranous,midvein,mm,obconical,oblong,orange-brown,ovate,pair,partly,pedicel,peduncle,petiole,primary,pubescent,pyriform,ray,red-brown,ridged,shrub,side,simple,size,slender,spheroidal,stem,stigma,style,terete,terminal,thick,toward,trichome,truncate,unarmed,vein,weakly,whitish,x,young	.25,.4,0.2-0.6,1-1.5,1-2,1-2.5,1-4,1.5,1.5-3,1mm,2-3,4,7-13,7.5,accrescent,age,along,alternate,alyx,apar,apart,apically,apice,apparently,around,articulated,axil,becoming,berry,brachyblast,branched,centre,clearly,clum,clustered,cup,deeply,delineated,dendritic,densely,detaching,developing,dilated,discolorous,divided,domatia-like,dorsal,dorsifixed,eaf,eed,ellipsoi,equal,erect,eye,fertilisation,fewer,filament,fine,flexible,flower,formed,forming,free,frequently,frui,fruiting,glabrescent,inside,known,lamina,leave,lengthening,less,like,longer,loop,loose,lower,m.,minute,much,multicellular-dendritic,naked,narrowly,nflorescence,nther,obscuring,often,one,orolla,outside,overlapping,ovoid,pendulous,perfec,pericarp,plurifoliat,pore,poricidal,portion,prominent,protruding,puberulous,rachi,rounded,ruit,scar,scattered,sessile,sinus,slightly,small,smaller,smoot,smooth,sometimes,somewhat,soon,sparsely,spreading,stripe,structure,stump,surface,tangling,tearing,tertiary,thin,tip,tube,ud,uneven,unit,vary,venation,visible,well-developed,white,wide,wider,ympodial	0.25,angle,arrangement,colour,frequent,growth,inflorescence,length,number,ovary,position,pubescence,ridging,shape,texture,width,ye
382	wfo-0001028528	success	155	130	97	58	33	0.626	.5,0.9-1.2,1-2,1.1-1.2,2-4,2.5-3,3.5-4,3.5-6,3/4,4-5,4-6,8-9,?,acuminate,acute,adaxially,age,along,anther,apex,apical,attenuate,base,becoming,berry,bi-lobed,blackish,branch,branching,calyx,cm,conical,coriaceous,corolla,decurrent,dendritic,densely,denser,diameter,elliptic,erect,flattened,fork,free,glabrous,glandular,globose,growth,immature,later,leaf,lobe,lobed,long,margin,midvein,minutely,mm,mucronate,narrowly,obovate,occasionally,outline,ovary,pedicel,per,pericarp,petal,petiole,pitted,plurifoliate,pore,poricidal,pubescent,reddish-brown,revolute,round,shiny,shrub,slit-like,sparsely,stem,stigma,strongly,style,surface,terminal,thin,tip,triangular,trichome,tube,vein,violet,way,white,x	1.5,1.8-2,2-3,6-10,6-7,abaxial,absent,adaxial,anthesi,ba,bark,basal,dichasia,eaf,edicel,eed,ew,except,exserted,filament,flower,fruiting,glabrat,impressed,inserted,leave,like,lower,m.,minute,nflorescence,nodding,older,pair,papillo,planar,portion,prominent,pyramidal,ruit,scar,secondary,short,sleeve,somewhat,stamen,ste,tall,tapering,time,tub,ud,unit,wide,winged,woody,ympodial,young	adhesion,arrangement,blade,climate,colour,dichasial,form,fruit,hair,height,history,inflorescence,length,life,midpoint,na,number,peduncle,perennial,plant,position,presence,pubescence,ray,reproduction,rugulose,seed,shape,size,staman,stellate,stipe,texture
383	wfo-0001028529	success	164	108	74	90	34	0.451	0.5,0.5-2,0.8-1.3,0.8-3.2,1,1-1.2,1-1.5,1.5,2.5-3,2/3,5-6,8-14,acuminate,anther,apex,apiculate,attenuate,base,bluish,brown,calyx,capitate,cast,cm,corolla,dark,decurrent,deltoid,dia,erect,glabrous,globose,green,hyaline,internodal,lanceolate,leaf,less,lobe,lobed,metallic,minute,minutely,mm,narrowly,nearly,oblanceolate,occasionally,opposite,ovary,ovoid-reniform,papillae,papillose,pedicel,petiole,poricidal,scattered,shape,shrub,size,slightly,smooth,somewhat,stem,stigma,style,subshrub,surface,tip,tube,way,white,winged,x	.2,0.1,0.8-3,3-40-flowered,3-5,6-9,7-8,across,acute,age,anthesi,apart,bark,becoming,beginning,beneath,berry,bud,close,cork,course,deflexe,distal,eaf,edicel,eed,ellipsoi,elliptic,evenly,exfoliating,exserted,filament,flower,free,fruiting,furcate,growing,heterostylous,hrub,immature,indistinct,inflorescenc,lateral,lenticellat,linear,lon,long,lower,main,major,middle,minor,much,nflorescence,older,one,pair,paler,papillo,pitted,planar,pore,portion,present,prominent,range,reflexed,river,ruit,scar,shaped,short,simple,slender,small,soon,spaced,species,straight,tall,tapering,tear-drop,ud,umbonate,variable,vein,widest,woody,yellowish,young	adhesion,arrangement,blade,climate,colour,deflexed,diameter,form,fruit,glandular,growth,hair,height,history,inflorescence,length,life,margin,midpoint,na,number,peduncle,plant,position,presence,pubescence,ray,reproduction,rugulose,seed,staman,stellate,stipe,texture
384	wfo-0001028532	success	186	91	66	120	25	0.355	0.2-1,1-1.7,1-3,1.3-8.7,17-42,2-3,2-8,2.2-4.2,3-10,4-7,5-9,5.5-15,6.5-9.2,7.5-15.2,abaxially,adaxially,anther,axillary,brownish,bud,chartaceous,clavate,cm,condition,corolla,deep,diameter,drying,fresh,fruit,glabrous,globose,green,greenish,herb,lanceolate,leaf,lobe,medium,mm,mottled,odd-pinnate,ovate,ovate-lanceolate,ovoid,pedicel,peduncle,pentagonal,petiole,plant,purple,ripe,rotate,seed,size,sometimes,spot,stigma,style,subtending,terminal,tube,white,whitish,x,yellow	0-19,1-1.6,1-2,1-5,1.4-1.6,15-36,2-6,3-5,3-7,3.3-4.4,3.9-5,5-merou,abaxiall,acumen,acuminate,acute,ag,along,alyx,apart,apex,apparently,arranged,articulated,asymmetric,attenuate,axe,base,basiscopic,bead,berry,blade,capitat,cell,connivent,covering,dark,decreasing,digestion,distal,dorsally,eaf,edge,eed,enzyme,erec,exceeding,filament,flat,flower,folded,forked,geminat,generally,glabrou,green-white,hair-like,half,homostylous,honeycomb-shaped,interjected,larger,lateral,leaflet,lengthening,like,linear,living,long,lower,make,middl,moniliform,mucilaginous,multiple,necklace,nflorescence,orbicular,orolla,pair,perfect,petiolulate,plurifoliate,pore,poricidal,removed,rounded,ruit,second,sessile,seudostipule,side,slightly,slit,spaced,specimen,stamen,stolon,straight,subequal,symmetric,tall,tamen,tem,testal,thick,throughout,tip,tissue,toward,tri-,tuber,typically,unit,unwinged,usually,vary,wall,wet,ympodial	adhesion,arrangement,calyx,capitate,colour,form,growth,height,history,inflorescence,length,life,na,ovary,perennial,position,pseudostipule,pubescence,reproduction,rugulose,shape,staman,stem,surface,texture
385	wfo-0001028546	success	239	115	92	147	23	0.385	0-1,0.4-0.5,0.5-0.75,0.5-1,0.5-1.5,1-3,1-3.5,1.1-1.8,1.1-2.2,1.5-1.75,1.5-2,2-3.5,2.5-3,2.6-3.4,3-4,3.5-19,4-8,4-9,4.5-6,7-24,7.5-10,9.5-24,acuminate,acute,anther,apex,attenuate,base,blade,brown,calyx,capitate,chartaceous,cm,cuneate,cylindrical,diameter,ellipsoidal,elliptical,extra-axillary,finely,flattened,fruit,glabrous,gland-tipped,globose,hair,inflorescence,lanceolate,lateral,leaf,length,lobe,lobed,long,margin,mm,obtuse,ovate,pale,pedicel,peduncle,perennial,petiole,pinkish,plant,present,purple,ray,red,reticulate,rhizomatous,rotate,shallowly,short,shrub,simple,slightly,sparsely,stellate,stellate-pubescent,stigma,style,surface,tan,throughout,time,triangular,tube,white,x,yellow	%,0-0.1,0-0.5,0-18,0-9,0.15-0.25,0.3-0.5,0.3-1,0.5-1.3,0.5-2,0.6-2,0.8-1.4,1-2,1-4,1-7,1-locular,1.5-6,10-14,10-22,100-150,11-12,120-400,16-24,2-,2-4,2-9,2.3-2.7,26-38,3-,3-11,3-5,3-7,3.5-7.5,4-13,5-10,5-55,5-8,5-merou,6-10,8-15,8-40,9-16,9.5-19,abaxially,absen,absent,accrescent,acicular,across,adaxially,adult,also,alyx,ample,andromonoecious,apart,apparen,articulated,axe,ba,bilobe,branch,branche,connivent,deeply,directed,distall,distally,distributed,dm,eaf,eed,eglandular,erect,exocarp,filament,finger,flower,foliate,fruiting,functional,geminat,green,half,heterostylous,incomplete,index,interpetalar,juicy,juvenile,lamina,less,lobing,longer,lower,main,markedly,mature,mesocarp,mid-point,midpoint,midvein,minute,moderately,nflorescence,oblique,often,orolla,pair,part,pendent,per,placenta,pore,porrect,prickle,pseudo-racemose,rachi,ruit,septum,sessile,side,somewhat,spaced,stalk,stellae,straight,succulent,tal,tamen,tem,thick,thicker,thicknes,tissu,tissue,unarme,unarmed,unbranched,unit,upper,usually,vary,vein,weakly,wide,ympodial	adhesion,arrangement,bilobed,colour,corolla,form,growth,height,na,number,ovary,position,presence,pubescence,reproduction,rugulose,seed,shape,size,staman,stem,stipe,texture
386	wfo-0001028547	success	224	113	81	143	32	0.362	-13,-6,.2,.5,.8,0.2-0.35,1-2.5,1.2-1.4,1.7-2,2.5-2.8,2.8-3.2,3-5,3.5-4.5,4-6,6-8,7-10,7-9,acute,anther,apex,apically,base,berry,blade,bright,calyx,chartaceous,cm,connivent,cuneate,densely,diameter,dull,entire,flattened-reniform,fruit,glabrous,inflorescence,lateral,leaf,length,lobe,lobed,long,long-acuminate,margin,maturity,mauve,midpoint,mm,moderately,narrow-deltate,orange,orange-brown,ovate,pedicel,peduncle,petiole,poricidal,purple,ray,red,reddish,scandent,shallowly,shrub,simple,somewhat,spherical,stellate,stellate-pubescent,stem,style,surface,tapering,terminal,tip,truncate,tube,wide,yellow	-1/2,-3,.7,/2,/5,0,0-1,0-10,0-15,0-2,0-30,0-5,0.05-0.15,0.1-0.2,0.15,0.3-0.4,0.5-,0.7-1,0.8-1,1-2,1-4,1-5,1.5-2.5,1/3,1/5-1/4,10-12,2-1.5,2-2.5,2-4,2-6,4-5,5-merous,abaxial,abaxially,absent,adaxial,alyx,apar,apart,ape,apparently,appearing,articulated,bark,branched,branching,bulbous,cell,conical,cream,curved,dark,deltate,discolorous,distance,drying,eaf,eed,elongate,elongating,equal,erect,extending,faint,filament,flattened,flower,free,fruiting,gently,glabrescent,glabrou,gray-brow,green,infructescence,lon,long-styled,longer,lower,marking,mature,midvein,nflorescence,oblong,occasionally,often,older,one,open,orolla,oung,outline,pair,pale,pendulous,per,perfect,pericarp,pit,plurifoliat,porrect,portion,prickl,prickle,prickly,primary,raised,reflexed,rounded,ruit,scar,sessile,short-styled,side,slender,small,smooth,sometimes,spaced,spreading,stalk,stalked,staminate,straight,subsessile,tamen,terete,tertiary,thin-acuminat,time,trichome,unit,usually,vary,vein,venation,villous,way,woody,yellow-green,yellow-orange,ympodial,young	8,adhesion,arrangement,climate,colour,corolla,form,glandular,gray-brown,growth,hair,height,history,life,na,number,ovary,plant,position,presence,pubescence,reproduction,rugulose,seed,shape,size,staman,stigma,stipe,texture,thin-acuminate,ye
387	wfo-0001028548	success	266	127	80	186	47	0.301	0.6,1/3,2.8,3.1,4.9,acuminate,adnate,anther,apex,apiculate,attachment,attenuate,base,blade,brown,calyx,chartaceous,cm,corolla,cuneate,developed,diameter,dry,entire,extra-axillary,flattened-orbicular,flower,fruit,glabrous,glandular,globose,growth,hair,incurved,internode,lanceolate,lateral,leaf,length,lobe,lobed,long,margin,midpoint,mm,nearly,notched,oblong,occasionally,ovate,pedicel,peduncle,petiole,point,poorly,probably,pubescent,ray,reddish,rounded,short,shortly,shrub,simple,somewhat,sparsely,stellate,stem,stigma,stipe,style,surface,tip,truncate,tube,unknown,upper,wave,white,yellow	.2,.4,.6,.7,.8,.8–2.4,.9,/3,0,0.06,0.3–0.8,0.4,0.4–0.5,0.4–0.6,0.4–0.7,0.7–0.8,0.7–1.7,0.8–1.2,0.8–1.9,0.8–2.0,0.8–2.9,0.9–1.2,1.0–4.1,1.1–1.2,1.1–1.4,1.1–1.5,1.3–1.6,1.4–2.3,1.6–2.7,1.7–2.1,1/3–1/2,2.0,2.2–2.8,2.3,2.4–2.7,3.1–3.8,3.6–8.1,3.7–4.0,3.8–4.6,4,4–8,5-merou,5.5–6.6,5.6,6.4–19.8,6–10,6–9,90°,abaxially,absent,acute,adaxially,aequilateral,ag,alyx,anthesi,apart,apical,apparently,appearing,arching,area,around,articulate,axe,ba,bark,berry,branch,branching,broad,brochidodromous,bud,capitat,central,channeled,clinate,color,congested,deciduous,deltoid,densely,dentate,development,difolate,directed,distal,distinct,eaf,edge,eed,either,elliptic,emerging,endocarp,erect,exocarp,extending,fertile,filament,filiform,flexed,free,geminat,glossy,gradually,heterostylous,increasing,intact,interpetalar,intersepalar,juic,juvenile,large,layer,less,lon,longer,lower,major,many,mature,midrib,midvein,minor,minute,moderately,nflorescence,oblique,opaque,orolla,per,pitted,pore,porrect,porrect-stellate,portion,potentially,pubescenc,raised,reflexe,remaining,rigid,row,scarcely,seen,sessile,short-stipitate,shorter,side,sinus,sloughing,smoot,smooth,soon,splitting,spread,spreading,stamen,stellae,stellate-pubescent,straight,suture,swelling,tamen,tem,thin,time,tissue,transparent,two,ud,unarmed,unbranched,various,vary,vein,weakly,wide,yellow-ferruginous,ympodia,young,±90°,±equal,±glabrous,×	0.2,0.3-0.8,0.4-0.5,0.4-0.6,0.4-0.7,0.7-0.8,0.7-1.7,0.8-1.9,0.8-2.9,0.9,1.0-4.1,1.1-1.2,1.1-1.4,1.1-1.5,1.3-1.6,2.2-2.8,3.8,4-8,6-9,6.4-19.8,adhesion,arrangement,capitate,climate,colour,dense,form,height,history,inflorescence,life,na,number,ovary,perennial,plant,position,presence,present,pubescence,reproduction,rugulose,seed,shape,size,staman,texture
388	wfo-0001028551	success	243	142	108	135	34	0.444	.0,.06,.1,.3–0.5,.5,.8,0.4–0.5,0.7–2.3,0.8–1.4,1.0,1.0–1.6,1.1–2.2,1.4–2.0,1.5–1.8,1.6–1.7,1.8–2.5,1/3,2,2.0–2.6,2.0–3.5,2.0–3.7,2.2–7.5,4.2–5.9,8.0–12.0,8.5–20.5,abaxially,acuminate,adaxially,adnate,anther,apex,apiculate,attachment,attenuate,base,becoming,blade,calyx,caudate,chartaceous,cm,corolla,cuneate,dark,densely,diameter,distinctly,dry,elliptic,entire,extra-axillary,flattened-suborbicular,flower,fruit,glabrous,glandular,globose,green,hair,internode,lacking,lanceolate,lateral,leaf,lilac,lobe,lobed,long,margin,markedly,mature,maturing,minute,mm,nearly,notched,oblong,occasionally,pedicel,petiole,point,porrect,pubescent,red,shiny,shrub,simple,slender,somewhat,stellae,stellate,stigma,style,subcoriaceous,tan,tip,toward,tree,tube,upper,violet,wavy,white,yellow,young,±globose,×,–4.8	.6,0,0.5–0.6,0.7–1.0,1.0–1.5,1.1,1.1–1.4,1.3,1.5–1.9,1.7,1.7–2.6,2.2–3.4,2.2–5.2,2.3–3.4,2.5,2.75–4.0,3/4,4.5–7.0,4–6-merou,5–11,7.5–10.5,8.0–11.4,9.0,aequilateral,almost,alveolate,alyx,anthesi,apart,apical,apparently,appearing,area,armed,articulated,axe,ba,berry,branch,broad-based,brochidodromous,bud,capitat,central,channeled,closely,conical,connivent,continuing,dehiscence,deltate,dentate,development,difoliate,distally,dorsally,eaf,eed,either,endocarp,enlargement,entir,equal,exocarp,fertile,filament,filiform,forking,free,frui,geminat,glabrou,gradually,homostylous,immature,inclined,increasing,interpetalar,juic,large,line,lon,longer,lower,major,midrib,midvein,minor,narrowly,nflorescence,numerous,oblique,orolla,outline,poorly-developed,pore,portion,potentially,prickle,prominent,pseudo-peduncle,ripe,row,ruit,scattered,side,sinus,smooth,spaced,split,splitting,spread,stamen,stellate-pubescent,straight,suture,tamen,tem,thin,time,tissue,triangular,two,typically,ud,unarme,unarmed,unbranched,vary,vein,weakly,wide,yellow-ferruginou,ympodia,±appressed	adhesion,arrangement,capitate,climate,colour,form,growth,height,history,inflorescence,length,life,midpoint,na,number,ovary,peduncle,plant,position,presence,present,pubescence,ray,reproduction,rugulose,seed,shape,size,staman,stem,stipe,surface,texture,yellow-ferruginous
389	wfo-0001028558	success	224	118	87	137	31	0.388	0.4-1.5,0.8-1.5,1-1.3,1-4,1-9,1.8-2.3,1/3-1/2,1/4,2.2-2.8,2.4-3,2.5-3.5,2.5-5,3-8,4-15,6-10,6-20,6-22,6-7.5,8-12,acute,almost,andromonoecious,anther,apex,base,berry,blade,calyx,chartaceous,cm,connivent,cordate,cream,dark,deltate,densely,diameter,dull,entire,equal,flattened-reniform,fruit,glabrous,green,herb,lateral,leaf,length,lobe,lobed,long,lower,margin,marking,maturity,mauve,midpoint,mm,moderately,narrow-deltate,often,orange-brown,ovate,pale,pedicel,peduncle,petiole,plant,poricidal,ray,rounded,shrub,simple,spherical,stellate,stellate-pubescent,stem,style,tapering,terminal,tip,tube,upper,way,wide,yellow,young	-2,-5,.5,/6,0-10,0-30,0-4,0-5,0.1,0.1-0.3,0.1-0.4,0.15-0.5,0.2,0.5-0.9,0.5-2,0.6,00-200,1,1-3,1.3-1.8,1.5-2.3,1.5-2.5,1.5-3,1.5-6,1/3,1/4-1/3,15-60,2-5,3-,3-50,3-9,3/,4,4.2-7,4.5-8,5-10,5-60,5-7,5-merous,6-9,7-10,abaxially,adaxially,alyx,ame,apar,apart,apically,apparently,articulated,bark,branched,broad-deltate,c.,clearly,concolorous,conical,curved,discolorous,distal,distance,drying,eaf,eed,elongated,elongating,erect,extending,filament,flattened,flower,free,fruiting,gently,glabrescent,gra,hermaphrodite,heterostylous,infructescence,least,long-styled,longer,lowermost,mature,midvein,multangulate,nflorescence,obtu,older,one,open,orolla,oung,pair,pendent,pendulous,per,pericarp,plurifoliat,porrect,portion,prickl,prickle,prickly,primary,reflexed,ruit,scar,sessile,short-styled,side,smooth,spaced,sparsely,spreading,stalk,stalked,staminat,stout,straight,surface,tamen,terete,tertiary,time,trichome,unarmed,unit,variously,vary,vein,venation,visible,weakly,woody,yellowish,ympodial	0.1-0.5,3/4,adhesion,arrangement,climate,colour,corolla,form,glandular,growth,hair,height,history,inflorescence,life,na,number,ovary,perennial,position,presence,present,pubescence,reproduction,seed,shape,size,staman,stigma,stipe,texture
390	wfo-0001028571	success	230	114	67	163	47	0.291	.1,0.4,1,2.5,abaxially,acute,anther,apex,base,blade,broadly,brown,calyx,cm,cordate,dark,dense,diameter,elongated,entire,extra-axillary,fertile,flattened,flower,free,fruit,gland-tipped,glandular-puberulent,globose,hair,highly,lanceolate,length,light,linear,lobe,lobed,long,margin,minutely,mm,nearly,ovate,pale,pedicel,peduncle,petiole,pubescence,ray,shrub,similar,simple,size,somewhat,stellate,stem,stigma,style,summit,surface,thin-textured,tip,tube,variable,white,x,yellow	'',.2,.5,/3,0.2–0.4,0.3–0.4,0.3–0.6,0.4–0.8,0.5–1,0.6–0.8,0.6–1.4,0.75–4,0.9–1.7,0–,1.1-1.4,1.5–2.4,1.7–2.6,1/2,1/3,10–21,11–12,12,13–25,18,1–1.4,1–1.5,1–2,1–5,2,2-foliate,2.5–15,2–10,2–3.4,3,3.4–3.7,3.5–16,3–13,3–5-celled,3–7.5,3–8,4-rayed,40–80,4–10,4–15,5,5.2–9.2,5–15,5–8,62,7–16,8–12,8–14,8–15,9,=,``,absent,accrescent,acicular,adaxially,almost,also,apical,average,axe,ba,bacca,capitat,cell,compressed,contiguou,cover,curved,cylindrical,densely,differing,dilated,dimorphic,directed,distall,divided,eaf,eed,enlarged,erect,especially,exclusively,extreme,fewer,filament,finely,fruiting,geminat,geminate,glabrou,gland,glaziou,half,hyaline,interlocking,larger,longer,longest,lower,lutea,marginal,matura,maturing,merely,minute,multangulate,n,narrowly,near,nflorescence,one,orolla,p,pair,per,perhaps,pore,prickle,proportion,pubescent,rachi,recurved,rounded,ruit,scattered,sessile,shallow,slender,small,smaller,sparsely,spreading,stellae,stipitate,stout,straight,surrounded,tal,tamen,tem,terete,time,tomentose,triangular,unarmed,unbranched,undulate,unit,usually,vary,varying,vestigial,visible,wide,wing,ympodial,–1.6,–19	0.2-0.4,0.3-0.6,0.5-1,0.6-0.8,0.75-4,1-1.5,1.7-2.6,11-12,13-25,2.5-15,3-7.5,3-8,3.4-3.7,3.5-16,5.2-9.2,8-15,adhesion,arrangement,capitate,climate,colour,corolla,form,glabrous,glandular,growth,height,history,inflorescence,leaf,life,midpoint,na,number,ovary,perennial,plant,position,presence,reproduction,rugulose,seed,shape,staman,stipe,texture,ye
391	wfo-0001028583	success	294	141	97	197	44	0.33	.0,.2,.5,2/3,abaxially,acute,adaxially,adnate,anther,ape,apex,basal,base,blade,brown,calyx,capitate,chartaceous,cm,corolla,cuneate,deltate,deltoid,densely,developed,diameter,dry,erect,evenly,extra-axillary,flattened-reniform,fruit,glabrous,glandular,globose,green,hair,heterostylous,immature,incurved,interpetalar,lateral,leaf,lobe,lobed,long,margin,mature,midpoint,minute,mm,moderately,nearly,oblong,orange,ovate,pedicel,peduncle,petiole,poorly,porrect,portion,present,pubescence,pubescent,purple,ray,red,red-brown,reddish,restricted,rounded,scattered,sessile,short,shrub,simple,sinuate,somewhat,sparsely,stellae,stellate,stem,stigma,stipe,style,subacute,subcoriaceous,tip,tissue,toward,triangular,truncate,tube,vein,white,yellow	.6,.9,0,0.01,0.06,0.08,0.13,0.2–0.6,0.3–0.6,0.4,0.4–0.6,0.6,0.6–0.9,0.6–1.0,0.6–1.3,0.6–2.2,0.8–1.2,0.8–1.4,0.8–1.5,0.9–1.3,0.9–1.5,1.0–1.2,1.0–2.1,1.1–7.7,1.2–1.9,1.4,1.4–1.5,1.4–1.9,1.4–4.7,1.5–2.4,1.5–3.1,1.8–2.3,1.9–2.6,1.9–3.2,1/2,1/3,1/3–1/2,2.0,2.2–3.1,2.3,2.3–6.8,2.5–2.9,2.6,2.6–3.7,2.6–4.8,3.1–4.0,3.2–6.2,3.5–3.8,4,4.3,4–8,5-merou,5.1–15.4,5.2,5.2–6.3,5.7,5–9,6.3,6.5–16.0,6.9–9.2,6–8,7.0–1.4,absent,aequilateral,ag,alyx,anthesi,apart,apical,apparently,appearing,appressed,around,articulate,attenuate,axe,ba,bark,based,bent,berry,borne,branch,branching,broad,bud,central,channeled,congested,craspedodromous,deciduous,deeply,dentate,difoliate,directed,distal,distinct,eaf,edge,eed,either,emerging,endocarp,exocarp,extending,ferruginous,fertile,filament,filiform,flexed,flower,free,geminate,glossy,gradually,gree,immediately,increasing,individually,intact,internode,intersepalar,juic,lanceolate,large,layer,lightly,lon,longer,lower,major,many,midrib,midvein,minor,narrowly,nflorescence,oblique,occasionally,opaque,orolla,per,perforated,pitted,pore,porrect-stellate,potentially,prickle,primary,raised,red-orang,reflexed,remaining,ridge,rigid,row,ruit,secondary,semicraspedodromous,several,shorter,shot,side,sinus,slightly,sloughing,spaced,splitting,spread,spreading,stamen,stellate-pubescent,stipitate,straight,surface,suture,tamen,tardily,tem,thin,time,transparent,two,ud,unarmed,unbranched,upper,vary,well,wide,yellow-ferruginous,ympodia,young,±90°,±equal,±erect,×	0.01-0.08,0.06-0.4,0.3-0.6,0.4-0.6,0.6-1.0,0.8-1.4,0.8-1.5,0.9-1.5,1.1-7.7,1.4-1.5,1.4-1.9,1.4-4.7,1.8-2.3,2.5-2.9,4-8,4.9,5.1-15.4,6-8,6.5-16.0,7.0-14.0,adhesion,arrangement,climate,colour,form,growth,height,history,inflorescence,length,life,na,number,ovary,perennial,plant,position,presence,reproduction,seed,shape,size,staman,texture
392	wfo-0001028587	success	178	101	66	112	35	0.371	.5,0.3-1,0.5,0.5-1,0.8-1.8,1-1.3,1-2,1-4,2-5,2.1-6.9,2.5,6-8,6.5-17.7,acuminate,acute,anther,apex,base,becoming,brown,calyx,cm,corolla,dia,fruit,geminate,glabrous,globose,green,greenish-white,leaf,length,lobe,lobed,long,minutely,mm,nearly,obovate,often,opposite,ovary,ovate,ovoid-reniform,papillose,pedicel,petiole,pitted,poricidal,puberulent,pubescence,pubescent,pubesent,seed,shrub,stem,stiff,stigma,style,surface,tip,trichome,tube,uniseriate,white,x	.4,.75,0,0.3,0.7-1.2,0.8-1.6,0.8-2.9,1-1.5,1.3-5.1,1/4,3-8,8-10,8-10-flowered,abruptly,accrescent,across,anthesi,bark,baseflower,berry,ca,chartaceou,closely,coat,cracking,cup,deflexed,degree,densely,different,difoliate,distal,drying,eaf,edicel,eed,ellipsoid,erect,filament,flower,forming,free,fruiting,geminat,impressed,keeled,lamina,lateral,layer,like,lon,long-styled,lower,main,major,middle,midrib,minor,minute,narrowing,nflorescence,obe,obovoid,occasionally,older,open,outer,overlappin,pair,paler,papillo,peeling,per,persistent,pore,portion,reflexed,ruit,scar,scattered,short,simple,slender,slightly,slit-like,spaced,sparsely,straight,straw-colored,subumbellate,tall,terminal,thickened,thin,transversel,triangular,two,type,ud,umbonate,unicellular,unit,upon,upper,usually,variable,vein,wide,widest,woody,ympodial,young	1,6,adhesion,arrangement,blade,chartaceous,climate,colour,diameter,form,glandular,growth,hair,height,history,inflorescence,life,margin,midpoint,na,number,peduncle,perennial,plant,position,presence,ray,reproduction,rugulose,shape,size,staman,stellate,stipe,texture
393	wfo-0001028594	success	142	82	58	84	24	0.408	.5,0.8-1.8,1-1.2,1-1.3,1-2,1.5-9,12,12-14,2,3-4,3-9,6-20,abaxially,anther,axillary,black,bottle-shaped,calyx,cm,conical,corolla,densely,diameter,drying,elliptic,flattened-reniform,fruit,glabrous,globose,green,herb,immature,inflorescence,leaf,length,maturity,minutely,mm,orange-brown,ovary,ovate,pedicel,petiole,planar,pubescent,purple,reddish,reflexed,slightly,smooth,somewhat,sparsely,stigma,style,surface,tube,violet,x	0-100,0.3-1.0,1-1.5,1-3,3-6,5-6,6-7,acuminate,acute,adaxially,along,anthesi,apex,axil,base,bearing,becoming,berry,capitat,cell,climbing,denser,eaf,edicel,eed,ellipsoid,epidermal,especially,exserted,filament,floo,flower,forest,free,fruiting,glabrat,hair-like,inflorescenc,lax,like,lobe,lon,long,lower,margin,minute,nflorescence,noddin,obtuse,often,open,pair,papillate,pendent,per,portion,primary,projection,quit,rectangular,regular,rest,rounded,ruit,scar,scattered,side,simple,soft,spreading,strait,strongly,tem,time,tip,trailing,trichome,tub,ud,unifoliat,uniseriate,unit,vein,ympodial	arrangement,capitate,colour,form,growth,height,history,life,na,peduncle,perennial,plant,position,presence,pubescence,reproduction,rugulose,seed,shape,size,stellate,stem,texture,unifoliate
394	wfo-0001028660	success	204	118	86	118	32	0.422	0.5-2.8,0.5-5.5,0.8-1,0.9-2.5,1-2,1.5-2.8,1.5-4,1.5-7.6,2-9,3-30,3-7,3.8-13,4-6,7-10,abaxially,acute,adaxially,anther,apex,attenuate,axillary,base,blade,blue,broadly,brownish,bud,chartaceous,ciliate,clavate,cm,condition,corolla,decurrent,densely,diameter,drying,elliptic,entirely,fresh,fruit,glabrous,globose,green,greenish,hair,herb,lanceolate,like,linear,lobe,long,margin,membranous,minutely,mm,narrowly,oblique,obtuse,odd-pinnate,ovoid,pedicel,peduncle,pentagonal,petiole,plant,puberulent,pubescent,purple,ripe,rotate,seed,size,sparsely,stem,stigma,style,substellate,subtending,terminal,tinged,tube,white,whitish,x,yellow	0-5,0.1-0.3,0.2-1.1,0.3-1.1,0.7-4.2,1-10,2-11,2-5,2-6,20,3-5,3-9,5-8,5-merou,6,absent,acumen,ag,along,alyx,apart,apparently,articulated,axe,berry,borne,capitat,cell,connivent,covering,decumbent,digestion,distal,dorsally,dot,eaf,edge,eed,end,enzyme,erec,especially,exceeding,except,filament,flat,flower,folded,forked,geminat,generally,glabrou,greatly,green-white,hair-like,half,homostylous,honeycomb-shaped,interjected,lateral,leaflet,lengthening,less,living,lower,make,middl,midrib,mucilaginous,nflorescence,often,orbicular,orolla,ovate,pair,perfect,petiolulate,petiolule,plurifoliate,pore,poricidal,proximal,rarely,reduced,removed,ruit,scabrous,scattered,sessile,seudostipule,short,singly,slit,spaced,specimen,stamen,ste,stolo,straight,subequal,sunny,tall,tamen,tem,testal,thick,throughout,tip,tri-,tuber,typically,unit,unwinged,usually,vary,wall,wet,ympodial	adhesion,arrangement,calyx,capitate,climate,colour,form,glandular,growth,height,history,inflorescence,leaf,length,life,midpoint,na,number,ovary,perennial,position,presence,pubescence,ray,reproduction,rugulose,shape,staman,stellate,stipe,surface,texture
395	wfo-0001028666	success	159	107	78	81	29	0.491	0-0.1,0.2-0.3,0.25-0.4,0.3-0.45,0.3-0.6,0.4-0.8,0.7-0.8,0.8-2,1-1.5,2.2-2.3,2.5-7,3-4.5,4-5,4-5.5,5-11,7-8,abaxially,absent,acute,adaxially,anther,apex,base,blade,brown,calyx,chartaceous,cm,connivent,cordate,cylindrical,densely,diameter,ellipsoidal,elliptic,entire,erect,extra-axillary,fruit,glabrous,gland-tipped,grey-green,hair,inflorescence,lanceolate,lavender,length,lobe,margin,midpoint,mm,moderately,obtuse,ovate,pale,pedicel,peduncle,perennial,perfect,petiole,pubescent,purple,ray,red,rhizomatous,short,shrub,simple,stellate,stellate-pubescent,stigma,style,succulent,tube,white,x,yellow,yellowish	%,0-2,0.05-0.1,0.1-0.15,0.2-0.25,1,1-2,1-locular,11-19,2.5-5,2.6-4.2,3-4,3-6,4-5-merou,7-11,7-9,absen,accrescent,across,adaxiall,alyx,apart,apparen,articulated,axe,ba,capitat,directed,distall,distributed,eaf,eed,eglandular,exceeding,exocarp,finger,flower,fruiting,incomplete,juicy,lamina,lateral,long,lower,mature,mesocarp,minute,nflorescence,oblique,orolla,part,per,placenta,pore,porrect,prickle,pseudo-umbellate,ruit,scattered,septum,sessile,solitary,somewhat,spaced,stalk,stellae,tal,tamen,tem,thick,throughout,time,transparent,unarme,unarmed,unbranched,unit,unknow,vary,wide,ympodial	adhesion,arrangement,capitate,climate,colour,corolla,form,glandular,growth,height,history,leaf,life,na,number,ovary,plant,position,presence,present,pubescence,reproduction,seed,shape,size,staman,stem,stipe,texture
396	wfo-0001028667	success	129	93	59	70	34	0.457	-2.6,.5,0.4-0.7,0.7-4,1-1.5,1-4.5,1-6,1.3-2,3,3-11,acute,apex,axillary,base,calyx,cm,completely,conical,coriaceous,corolla,creamy,diameter,dry,elliptic,entire,flattened,glabrous,growth,inflorescence,leaf,lobe,margin,minutely,mm,narrowly,pale,pedicel,peduncle,petiole,pitted,reniform,revolute,shiny,shoot,short,simple,stem,straw-colored,strongly,surface,terminal,triangular,tube,vine,white,woody,wrinkling,x,yellow	1-2-1.5,5,5-20,5-merou,8-10,aid,alyx,anthesi,apar,appearing,ark,around,articulated,berry,branch,branched,cell,climbin,climbing,clustered,curling,deciduous,discolorous,eaf,eed,ellipsoid,exfoliatin,exfoliating,exserted,fide,flower,fragrant,fruiting,irregularly,like,long,lower,mentz,midrib,new,nflorescence,occasionally,older,orolla,other,outer,papilla,papillat,pendan,per,perfect,plurifoliat,primary,scar,sleeve,slender,slightly,small,soon,spaced,support,tem,tip,twice,twining,ud,unit,vein,visible,ympodial	adhesion,anther,arrangement,blade,climate,colour,form,fruit,glandular,hair,height,history,length,life,midpoint,na,number,ovary,plant,position,presence,pubescence,ray,reproduction,rugulose,seed,shape,size,staman,stellate,stigma,stipe,style,texture
397	wfo-0001028672	success	207	107	83	124	24	0.401	.5,/4,0-13,0.2,0.5-0.7,0.5-1,0.7-3,0.8-1,1.3-8,1.5-3,1.8-2.2,1.8-2.5,1/4,2.4-2.8,2.5-12,2.5-3.5,4-6,5-10,5-8,6-12,abaxially,acute,almost,anther,apex,apically,base,berry,blade,branched,calyx,chartaceous,cm,connivent,deltate,diameter,equal,erect,flattened-reniform,fruit,glabrescent,lateral,leaf,length,lobe,lobed,long,lower,margin,maturity,mauve,mm,moderately,obtuse,orange-brown,ovate,pedicel,peduncle,petiole,plant,poricidal,ray,rotate,rounded,shrub,simple,smooth,sometimes,sparsely,spherical,stellate-pubescent,stem,style,surface,tapering,terminal,tip,truncate,tube,upper,way,wide,yellow	-6,-merous,0,0-15,0-150,0-5,0.2-0.4,0.2-0.7,0.3-1,0.5-1.2,0.5-5,1,1-2,1-3,1.5-2.2,1/,1/4-1/3,2-10,2-20,2-3,2-30,3-5,3-8,4-8,5,9-15,acut,adaxially,alyx,ame,andromonoecious,apar,apart,apparently,articulated,bark,black,broad,broad-deltate,brow,c.,concolorous,cream,dark,difoliate,discolorous,distal,distance,drying,eaf,eed,elongated,elongating,extending,filament,flattened,flower,free,fruiting,geminat,glabrous,gray,green,hair,hermaphrodite,heterostylous,infructescence,long-styled,longer,lowermost,marking,mature,midpoint,midvein,minute,nflorescence,older,one,open,orolla,oung,pair,pale,pendulous,per,pericarp,porrect,portion,prickl,prickle,prickly,primary,reflexed,ruit,scar,sessile,short-styled,side,spaced,spreading,stalk,stalked,staminat,straight,tamen,terete,tertiary,time,translucent,trichome,unarmed,unit,usually,variously,vary,vein,venation,visible,weakly,woody,yellow-green,yellow-orange,ympodial,young	1/2,adhesion,arrangement,colour,corolla,form,growth,height,inflorescence,na,number,ovary,position,presence,pubescence,seed,shape,size,staman,stellate,stigma,stipe,texture,ye
398	wfo-0001028674	success	196	133	107	89	26	0.546	0.1,0.7-1,1-1.5,1-2,1-3,1.5-3,1/4,10-15,2-2.5,2-3,2-5.5,2.5-3,3-10,3-11,3-3.5,3-4-lobed,4-4.2,4-5,5-7,abaxially,acuminate,acute,adaxially,angulate,anther,apex,apiculate,attenuate,basal,base,berry,blade,brown,c.,calyx,campanulate,chartaceous,cm,coriaceous,corolla,densely,diameter,elliptic,entire,flattened,flower,fruit,glabrescent,glabrous,glandular,glandular-puberulent,glandular-pubescent,globose,green,greenish,growth,heterostylous,hirsute,leaf,leaf-opposed,lenticular,like,lobe,lobed,margin,maturing,midpoint,mm,mucilaginous,ovary,pedicel,peduncle,perfect,petiole,plant,poricidal,porrect,ray,reddish,reniform,rounded,rusty,scattered,shrub,simple,sparsely,stellate,stem,stigma,style,subcapitate,subglobose,surface,tapering,terete,tip,tomentose,triangular-lanceolate,trichome,tube,variegated,way,white,woody,x,yellow,young	-1,0.2-0.25,0.2-0.3,0.5-0.7,0.5-0.8,0.7-1.0,1/3,10-30,5-6,8-10,adaxial,armed,articulate,bark,branched,branching,brow,caly,confined,conical,cream,curved,dark,directed,distal,distally,eaf,eed,eglandular,erec,erect,especially,exserted,face,fewer,filament,free,fruiting,juvenile,larger,lateral,laterally,leave,lengthening,linear-lanceolate,long-styled,lower,minute,much,new,nflorescence,ochraceous,older,one,partially,pericarp,plurifoliat,pore,portion,prickle,prickly,pubescent,raise,recurved,reduced,reticulate,ruit,scar,sessile,shallowly,short-styled,similar,slightly,staminate,stellate-pubescent,stellate-tomentose,straight,subsessile,testa,thick,time,ud,unarmed,unicellular,unit,upper,whitish,yellowish,ympodial	adhesion,arrangement,climate,colour,form,hair,height,history,inflorescence,length,life,na,number,perennial,position,presence,present,pubescence,reproduction,rugulose,seed,shape,size,staman,stipe,texture
399	wfo-0001028680	success	236	131	100	136	31	0.424	.0,.2,.3,.5,.8,0.2–0.3,0.3–2.1,0.5–0.8,0.5–2.3,1,1.1,1.1–6.5,1.4–1.8,1.9–2.4,1/2,2.2–2.5,3.8–4.6,6–8,abaxially,acuminate,adnate,aequilateral,anther,apex,apiculate,appearing,attachment,attenuate,base,blade,brown,calyx,cm,coriaceous,corolla,deltoid,diameter,dry,elliptic,entire,extra-axillary,fast,flattened-orbicular,flattened-reniform,fruit,glabrous,glandular,globose,growth,hair,lanceolate,lateral,lobe,lower,margin,markedly,mature,midpoint,mm,nearly,notched,obtuse,occasionally,ovate,pedicel,petiole,point,pubescent,ray,reddish,revolute,rounded,shoot,short,shortly,shrub,simple,sinuate,slightly,sometimes,sparsely,stellate,stem,stigma,style,sub-cordate,surface,terminal,tip,toward,truncate,tube,typically,white,yellow,yellow-tan,±glabrous,±straight,×,–1.75	0.4,0.9,0.9–1.0,0.9–1.2,1.2,1.2–2.2,1.6–2.5,1.7–2.1,1.7–2.2,1/3,1/4–1/3,1–2,2.1–3.0,2.2–3.0,2–3,3.2–3.5,4.3–5.9,4–5,4–5-merou,5.2–7.2,?,adaxially,ag,alyx,anthesi,apical,apparently,appresse,around,articulate,ba,bark,based,berry,borne,broad,brochidodromous,capitat,channeled,connivent,dentate,developed,development,directed,distal,distally,distinct,eaf,edge,eed,either,emerging,endocarp,exocarp,extending,fertile,filament,filiform,flexed,flower,free,glossy,gradually,homostylous,hort,increasing,individually,intact,internode,interpetalar,intersepalar,isolated,juic,layer,limp,lon,long,longer,many,middle,midrib,midvein,minute,nflorescence,opaque,orolla,per,perforated,pitted,plurifoliate,poorly,pore,porrect,portion,potentially,presen,prickle,rachi,raised,remaining,retrorse,ruit,scattered,see,sessile,shorter,side,sinus,sloughing,splitting,spread,stamen,stellae,straight,suture,tamen,tem,thin,time,tissue,transparent,ud,unarmed,unbranched,vary,vein,weakly,wide,yellow-ferruginou,ympodia,young,±90°,±absent,±equal,–3,–6	adhesion,arrangement,capitate,climate,colour,form,height,history,inflorescence,leaf,length,life,na,number,ovary,peduncle,perennial,plant,position,presence,present,pubescence,reproduction,rugulose,seed,shape,size,staman,stipe,texture,unknown
400	wfo-0001028688	success	137	74	49	88	25	0.358	.5,0.4-1,0.5,0.5-0.75,0.9-1,1-5,1.1-1.2,1.4-2.8,2-3,5-11,5-6,anther,area,base,beneath,calyx,cm,corolla,curl-tipped,glabrous,golden,lanceolate,leaf,lobed,mm,near,nearly,opposite,ovary,overtopping,papillose,pedicel,petiole,pilose,reddish-brown,shaped,shoot,shrub,size,stem,stigma,style,tear-drop,tip,trichome,tube,uniseriate,white,x	0.5-1,0.5-1.5,1-1.5,1-1.8,1-3,2.2-4.8,across,acuminate,acute,along,anthesi,apar,apex,bark,bi-cellular,branch,clavate,deciduous,decreasing,deflexed,deltoid,densely,densest,dia,differing,difoliate,eaf,edicel,eed,elliptic,exfoliatin,exserted,filament,free,furcate,geminat,globose,interpetalar,irregularly,know,known,like,lobe,lon,long,lower,major,markedly,membraneous,middle,minor,minutely,nflorescence,occasionally,often,older,paler,planar,pore,poricidal,portion,proximal,pubescent,ruit,scar,shiny,sinus,slender,slightly,soon,spaced,sparsely,straight,styl,tall,tapering,terminal,thickened,thin,tub,ud,unit,usually,vein,wide,widest,ympodial,young	alternate,arrangement,colour,diameter,form,fruit,growth,height,history,inflorescence,length,life,na,peduncle,plant,position,presence,pubescence,reproduction,rugulose,seed,shape,stellate,surface,texture
401	wfo-0001028690	success	191	111	83	108	28	0.435	0-0.5,0.1-0.2,0.15-0.25,0.3-0.5,0.3-2.5,0.5-0.8,0.5-1,0.8-2,1-5,1.3-6.5,1.5-1.7,2.3-2.8,3-4.5,4-10,4-9,4.5-16.5,6-8,8-9,abaxially,absent,acute,adaxially,andromonoecious,anther,apex,attenuate,base,blade,calyx,chartaceous,cm,connivent,cuneate,cylindrical,densely,diameter,entire,erect,extra-axillary,fruit,glabrous,gland-tipped,globose,green,hair,inflorescence,lanceolate,lateral,leaf,length,lobe,lobed,long,margin,midpoint,mm,moderately,obtuse,ovate,pale,pedicel,peduncle,perennial,petiole,plant,present,purple,ray,rhizomatous,shallowly,short,shrub,simple,sparsely,stellate,stellate-pubescent,stigma,style,time,tube,white,x,yellow	%,.3,0-0.1,0-0.2,0-5,0-7,0.05-0.1,0.2-0.6,0.25-0.4,0.3-0.7,0.4-0.6,0.5-6,0.8-1,1-2,1-7,2-3,2-7,2-locular,2.1-4.5,30-50,4-5.5.5,4-7,5-6,5-merou,5.5-6,7-10,7-30,7-8,9-13,9.5-14,absen,accrescent,across,adaxiall,adult,alyx,apart,articulated,ascending,axe,ba,branch,branche,broad-based,capitat,cross-section,directed,distall,distributed,dm,eaf,eed,eglandular,exocarp,finger,flower,fruiting,functional,geminat,grey-green,half,heterostylous,juicy,juvenile,lamina,less,linea,longer,lower,mature,mesocarp,mid-point,minute,moist,nflorescence,oblique,orolla,pair,part,per,placenta,pore,porrect,prickle,pseudo-racemose,pseudo-umbellate,ruit,sessile,somewhat,spaced,stalk,stellae,straight,surface,tal,tamen,tem,thick,throughout,unarme,unarmed,unbranched,unit,upper,vary,weakly,wide,ympodial	4-5.5,adhesion,arrangement,capitate,climate,colour,corolla,form,glandular,growth,height,history,life,linear,na,number,ovary,position,presence,pubescence,reproduction,seed,shape,size,staman,stem,stipe,texture
402	wfo-0001028696	success	224	130	87	137	43	0.388	.5,2.4,5,abaxially,acuminate,adaxially,anther,apex,asymmetric,attenuate,base,blade,blue,broadly,calyx,cm,coarsely,color,connivent,cordate,densely,diameter,entire,finely,flower,fruit,glabrous,gland-tipped,glandular,globose,hair,hirsute,known,lateral,lavender,length,lenticular,linear-caudate,linear-lanceolate,lobe,lobed,long,margin,mature,mm,narrowly,oblong,obtuse,orange,ovate,overtopped,ovoid,pedicel,peduncle,petiole,pilose,pitted,plump,pubescence,pubescent,ray,reflexed,reniform,repand,rotate-pentagonal,shiny,shrub,simple,sinuate,soon,stellate,stellate-pilose,stellate-pubescent,stem,stigma,style,subterminal,surface,tan,truncate,tube,weakly,well,widely,yellow,young,×	0.8–,1.5–4,12–20,15–17,15–30,1–2,1–4,1–6,2.5,2.8–3.5,2–2.3,2–5,2–7,3.5–5.5,3–5,3–6.5,4–5,4–7,5-merou,5–15,6–13,6–8,7–8,7–9,8–13,8–20,9–10,9–12,accrescent,acicular,adaxiall,along,alyx,ample,anthesi,apart,apparently,armed,articulated,ascending,axe,ba,bifi,borne,branch,branched,bristle,bristle-like,bristly,chartaceous,deltoid,density,developed,difoliate,directed,distally,diverse,drie,eaf,eed,elongate,erect,filament,fruiting,geminat,glabrou,gland,homostylous,intergrading,intermixed,internode,interpetalar,lamina,larger,like,lon,long-stipitate,longitudinally,lower,middle,midpoint,midvein,midzone,moderately,near,nflorescence,numerous,occasionally,often,one,orolla,per,perfect,pericarp,pore,prickle,prickly,principal,prominent,resembling,ruit,scattered,sessile,several-celled,short,short-,shorter,side,slender,slightly,small,smaller,sometimes,somewhat,spaced,sparser,splitting,spreading,stalked,stellae,stellate-hirsute,tall,tamen,tem,tippe,tipped,tissue,toothed,trichome,ud,ultimate,vary,varying,vein,wide,woolly,ympodia	1-2,1-6,1.5-4,12-20,2-2.3,2.8-3.5,3.5-5.5,4-7,5-15,6-13,6-8,7-8,8-13,8-20,9-10,adhesion,arrangement,bifid,colour,corolla,form,growth,height,history,inflorescence,leaf,life,na,number,ovary,perennial,plant,position,presence,present,reproduction,rugulose,seed,shape,size,staman,stipe,texture
403	wfo-0001028698	success	166	78	58	108	20	0.349	0.3-0.75,1-2,1-9.8,1.9-4,13-25,2-10,2-4,3-5,5-6,5-8,6-13,6-27,9-35,broadly,calyx,cm,conical,connate,corolla,dark,diameter,distal,ellipsoid,elliptical,green,green-white,half,herbaceous,interjected,lateral,leaf,leaflet,light,long,medium,mm,odd-pinnate,ovate,ovoid,pair,pedicel,peduncle,pentagonal,perennial,petiole,plant,puberulent,pubescent,rotate,seed,size,strigose,terminal,throughout,violet,white,wide,yellow	0-1.,1-4,1.8-5,2-3,3-17,3-6-foliat,3.5,4-14,5-15,6,8-10,abaxiall,abaxially,acumen,acuminate,acute,adaxially,apex,apical,apically,articulate,base,branched,cell,commonly,covering,cuneate,cyme,darker,decurrent,dehiscent,dichasial,dichasially,digestion,diminishing,dorsally,dot,eaf,ebracteate,edge,eed,emoval,enzyme,equal,exceeding,filament,first,flat,flower,folded,forked,generally,globo,gradually,hair-like,honeycomb,introrse,living,lobe,lon,long-attenuate,lower,lunat,make,maturing,minute,monochasial,mucilaginous,nflorescence,nther,oblique,often,orolla,pattern,perfect,petiolule,plan,poricidally,proximal,rachi,raised,rarely,reveal,ruit,sessile,seudostipule,short,slit,smooth,specimen,stamen,stigma,straight,style,tal,tem,testal,thick,toward,tuber-bearing,two,typically,unit,usually,vary,wall,ympodial,¼	0-10,anther,arrangement,colour,form,fruit,growth,height,history,inflorescence,length,life,na,ovary,position,reproduction,shape,stem,texture,tube
404	wfo-0001028716	success	145	83	48	97	35	0.331	.5,0.6-1.9,0.75,1-2,11-16.4,2.5-8,3.6-8.8,7-8,8-9,acuminate,anther,apex,base,brown,calyx,cm,corolla,cuneate,dark,fruit,glabrous,glandular,hirsute,leaf,lobe,lobed,minutely,mm,opposite,ovary,ovate,papillose,pedicel,petiole,shape,shaped,shrub,size,stem,style,tear-drop,triangular,trichome,truncate,tube,uniseriate,white,x	.2,0.5,1.9-5.5,10-40-flowered,2-4,2.2-7.9,5-6,9-10,across,anisophyllou,anthesi,apart,appearing,asymmetric,ba,bark,becoming,beginning,beneath,bi-cellular,branched,decurrent,deflexed,dia,differing,difoliate,eaf,edicel,eed,ellipsoid,elliptic,evenly,except,fertilization,fifth,filament,filiform,free,geminate,inflorescenc,intermediate,know,known,lateral,lengthening,lenticellat,less,like,lon,long,long-triangular,lower,main,major,markedly,middle,minor,much,nearly,nflorescence,node,often,older,one,orbicular,pair,pointed,pore,poricidal,portion,prominent,proximal,puberulent,pubescent,raised,reflexed,remaining,rounded,ruit,scar,simple,slightly,spaced,sparsely,stigm,straight,strongly,tall,tip,two,ud,unit,vein,widening,widest,ympodial,young	0.2,adhesion,arrangement,blade,climate,colour,diameter,form,growth,hair,height,history,inflorescence,length,life,margin,midpoint,na,number,peduncle,perennial,plant,position,presence,pubescence,ray,reproduction,rugulose,seed,staman,stellate,stigma,stipe,surface,texture
405	wfo-0001028723	success	211	153	132	79	21	0.626	-1.5,.3,.5,0.2,0.8-1,0.8-2,0°,1-1.5,1-1.8,1-2.2,1-2.5,1/5-1/3,10-15,2-2.5,2-2.7,2-4,3.5-4,4,4-5,5,5-6,5-7,abaxial,abaxially,acute,adaxially,almost,anther,anthesi,apex,apically,apparently,bark,base,brachyblast,branch,branched,branching,broadly,brown,calyx,capitate,clustered,cm,concolorous,corolla,curved,dark,decurrent,deltoid,dendritic,densely,density,developed,diameter,dilated,drying,elliptic,entire,equal,except,faint,filament,fine,flat,flexuous,flower,glabrous,gradual,green,leaf,length,liana,lobe,lobed,long,long-attenuate,longitudinally,main,margin,membranous,midvein,minutely,mm,mostly,multiply,obconical,oblong,obovate,obtuse,occasional,orange-brown,overlapping,pair,pedicel,peduncle,petiole,poorly,pore,primary,pubescent,raised,ray,ridged,scar,short,shrub,simple,slender,small,smooth,sparsely,stem,stigma,stump,style,surface,tertiary,tip,transition,trichome,tube,unarmed,unevenly,vein,venation,white,wide,widely,wrinkled,x,youngest	0-0.5,1,1/3-1/2,10-16,2.5,3-4,age,alternate,alyx,another,apar,apice,articulated,becoming,clearly,common,conical,delineated,divided,domatia,dorsifixed,eaf,eed,ellipsoi,ey,formed,free,frequent,increasing,inner,junction,know,known,lengthening,less,like,lower,m.,middle,much,naked,narrowly,nflorescence,nther,one,orolla,outer,ovate,pale,papillo,perfec,plurifoliat,poricidal,portion,prominent,protruding,rachi,region,regular,ruit,separated,side,sinus,smaller,spreading,surrounding,tearing,terminal,tissu,toward,tuft,ud,uneven,unit,vary,visible,yellow,ympodial,young	adaxial,angle,apart,arrangement,bud,colour,ellipsoid,form,growth,inflorescence,number,papillose,perfect,presence,pubescence,ridging,shape,size,texture,type,width
406	wfo-0001028725	success	197	123	96	101	27	0.487	-10,0.1-0.2,0.6-1,1-2,1.5-1.7,1.5-2,1.5-4,10-12,2.5-3,2.5-8,3-4,3-6,4-12,4-5,7-8,acute,anther,apex,basal,base,berry,brown,bud,calyx,chartaceous,clavate-truncate,cm,connate,cordate,corolla,densely,depressed,diameter,elliptic-ovate,entire,flattened,flower,glabrous,glandular,glandular-pubescent,glandular-tomentose,glandular-villose,globose,green,growth,inflorescence,internodal,lanceolate-subulate,leaf,leathery,like,linear-lanceolate,lobe,long-styled,margin,midpoint,minutely,mm,moderately,oblique,ovary,ovate,pedicel,peduncle,persistently,petiole,pubescence,pubescent,ray,recurved,reniform,repand-angular,rest,rounded,rusty,rusty-brown,rusty-tomentose,short-styled,shrub,simple,size,slender,stellate,stem,stigma,style,surface,tapering,terete,terminal,tomentose,trichome,tube,unarmed,violet,x	.1,0.2-0.5,0.3-0.4,1-1.5,1.2-1.5,1/4,2,3-plurifoliat,4-6-celled,4-locular,5-10,7,abaxially,acicular,adaxially,anthesi,armed,articulated,bark,clearly,closely,curved,denser,discolorous,distal,eaf,eed,eglandular,elongate,enlarged,exserted,filament,finely,free,fruiting,glabrescent,gland-tipped,greatly,greyish,heterostylous,inconspicuous,lengthening,lobed,long,longer,lower,midrib,minute,mixed,multicellular,nearly,new,nflorescence,obverse,older,papillo,perfect,pericarp,pore,poricidal,porrect,portion,prickle,prickly,reduced,reflexe,reflexed,reticulate,ruit,scar,sessile,short-talked,similar,slightly,slit,small,somewhat,space,sparsely,stalked,staminate,stellate-tomentose,straight,strongly,tall,testa,tip,turbinate,ud,undulate,unevenly,unit,upper,varying,vein,velutinous,viscid,whit,yellow,yellowish,ympodial	adhesion,arrangement,blade,climate,colour,dense,form,fruit,hair,height,history,length,life,na,number,papillose,plant,position,presence,present,reproduction,rugulose,seed,shape,staman,stipe,texture
407	wfo-0001028736	success	180	120	91	89	29	0.506	0.2-0.4,0.5,0.5-1,0.5-1.5,0.5-2,1,1-1.5,1-2,1-3,10-15,2-5,3-5,3.5-5,4-12,4-6,5-10,6-13x3-8,6-8,abaxially,absent,acute,anther,apex,attenuate,base,blade,brown,calyx,chartaceous,cm,connivent,contiguous,cylindrical,densely,diameter,either,extra-axillary,filiform,flower,fruit,glabrous,glandular,globose,green,hair,immature,leaf,length,like,lobe,lobed,long,mature,midpoint,mm,moderately,mottled,multicellular,narrowly,nearly,obtuse,orange,pedicel,peduncle,per,petiole,porrect-stellate,pubescent,ray,red,reniform,rhombic,shrub,side,simple,spaced,sparsely,stellate,stem,stigma,style,surface,tapering,triangular,tube,uniseriate,unlobed,white,x,yellow,yellow-white	0.5-1mm,1.5,1.5-3,1/6,2-4,2-7,3-6,3-8,4-9,40-70,5-15,5-merou,accrescent,adaxiall,adaxially,alyx,apar,apical,apparently,armed,axe,berry,beyond,cordate,created,cut,dark,decurrent,difoliate,directed,discolorous,eaf,eed,exserted,filament,flattened,frui,fruiting,geminate,glabrou,gree,introsel,less,light,lower,m.,major,many,midrib,midvein,multiseriate,netlike,nflorescence,occasional,occasionally,onto,orolla,pair,perfect,pit,pore,prickle,purple,rachi,raised,recurved,ridge,roselike,ruit,scanden,sinus,slightly,small,stalk,stamen,ste,tamen,tem,thin-skinned,unarmed,unbranched,unequa,unicellular,unit,vary,vein,way,wide,ympodial	adhesion,apart,arrangement,climate,colour,corolla,form,growth,height,history,inflorescence,life,margin,na,number,ovary,plant,position,presence,present,pubescence,reproduction,rugulose,seed,shape,size,staman,stipe,texture
408	wfo-0001028737	success	151	90	55	96	35	0.364	0.2-0.5,1,1-2.5,1-6,1.5-3.5,12-14,16-30,2-5,2.8-3.5,4-9,6,7-15,acuminate,acute,apex,apiculate,base,calyx,caudate,cm,connate,corolla,dehiscent,diameter,distal,elliptic-lanceolate,glabrescent,glandular,globose,green,green-white,half,herbaceous,lanceolate,leaf,lobe,long,mm,oblique,oblong,odd-pinnate,ovoid,pedicel,peduncle,perennial,petiole,plant,seed,size,stellate,stigma,style,throughout,wide,yellow	0.7-2,1-4,10,2-3,3-4,3-5,3-6-foliat,4-10,4-6.5,5-6,abaxially,absen,acumen,adaxially,apical,apically,articulate,attenuate,branched,cell,covering,cyme,decurrent,dichasial,dichasially,digestion,diminishing,dorsally,eaf,ebracteate,edge,eed,emoval,enzyme,exceeding,filament,flat,flower,folded,forked,generally,globo,gradually,hair-like,honeycomb,interjected,introrse,larger,lateral,leaflet,living,lon,lower,make,maturing,monochasial,mucilaginous,nflorescence,nther,often,orolla,pair,pattern,perfect,pinnatifi,plan,poricidally,proximal,rachi,reveal,ruit,second,sessile,seudostipule,short,slit,specimen,stamen,straight,strongly,tal,tem,terminal,testal,thick,throughou,toward,tuber-bearing,typically,unit,vary,wall,whit,without,ympodial,¼	adhesion,anther,apicidally,arrangement,blade,climate,colour,form,fruit,growth,hair,height,history,inflorescence,length,life,margin,midpoint,na,number,ovary,position,presence,pubescence,ray,reproduction,rugulose,shape,staman,stem,stipe,surface,texture,tube,white
409	wfo-0001028773	success	169	104	75	94	29	0.444	0-0.2,0.15-0.3,0.15-0.35,0.4-0.5,0.5-0.58,0.8-0.9,0.9-2.8,1-3,1-4.3,2-6,2.2-2.8,3-4.5,4-6.5,4-7,5-6.5,7-9,abaxially,absent,adaxially,anther,apex,base,blade,broadly,brown,calyx,chartaceous,cm,cordate,densely,diameter,elliptic,entire,erect,extra-axillary,flower,fruit,glabrous,gland-tipped,glandular,globose,greenish-white,grey,hair,inflorescence,leaf,length,lilac,lobe,long,margin,midpoint,mm,obtuse,ovate,pale,pedicel,peduncle,perennial,petiole,ray,red,rhizomatous,rotate,rotate-stellate,rusty,short,shrub,simple,stellate-pubescent,style,tube,white,x,yellow	%,.7,0-1,0.1-0.2,0.15-0.25,0.3-0.4,0.3-0.5,0.3-0.6,1-2,1-locular,1.4-2,10-16,2,2-5,2-foliate,3-5,3.3-3.8,30-55,4.5-5.5,5-merou,6-11,7-8,absen,accrescent,across,adaxiall,adult,alyx,apart,apparen,articulated,axe,ba,directed,distall,distributed,eaf,eed,eglandular,exceeding,exocarp,finger,fruiting,geminate,green,homostylous,incomplete,juicy,juvenile,lamina,lateral,lobed,lower,mature,mesocarp,minute,nflorescence,oblique,onl,orolla,pair,part,per,perfect,placenta,pore,porrect,prickle,probably,pseudo-racemose,ruit,septum,sessile,shallowly,solitary,spaced,stellae,succulent,surface,tal,tamen,tem,thick,throughout,time,unarme,unarmed,unbranched,unit,upper,vary,wide,without,ympodial	0-16,adhesion,arrangement,climate,colour,corolla,form,growth,height,history,life,na,number,ovary,plant,position,presence,present,pubescence,reproduction,seed,shape,size,staman,stellate,stem,stigma,stipe,texture
410	wfo-0001028774	success	141	70	43	98	27	0.305	1.4-1.8,1/2-2/3,10-20,2.5-3.5,2.5-4.0,2.7-3.3,3-8,4-8,5-9,9-12,anther,arcuate,blade,bright,broadly,calyx,campanulate,chocolate-brown,cm,dm,dry,erect,foveolate,glabrous,grayish-green,hetermorphic,lenticular,long,minutely,mm,ovate,pentagonal-stellate,perennial,petiole,spherical,splitting,spreading,stellate-pubescent,stem,surface,tube,velvety-farinaceous,yellow	0.4-0.7,0.5-0.8,12-20-rayed,3-5,3-7,30-60,6-10-flowere,8-12,accrescent,acro,almost,along,alyx,annually,anthesi,appearance,armed,base,beneath,berry,broad,closely,deeply,density,developing,dia,difoliate,distinctive,divided,eaf,eed,elongate,emerging,extended,externally,fine,fully,geminat,giving,hair,herb,herbage,internodal,invested,irregular,least,lengt,linear-lanceolate,lobe,lon,lowermost,margin,maturity,merely,midvein,nflorescence,numerous,often,orolla,otherwise,per,pinnatifid,prickle,prickly,rounded,ruit,scattered,separated,short,short-stipitate,slende,smooth,somewhat,spaced,stellate,stellate-woolly,stout,straight,strait-yellow,surrounding,tall,tamen,thick,tightly,tigma,tub,tyle,unarmed,undulate,unexpande,unit,vary,varying,vestiture,weakly,woody,ympodial,zygomorphic	adhesion,colour,corolla,diameter,form,fruit,growth,height,history,inflorescence,leaf,length,life,na,ovary,plant,pubescence,reproduction,seed,shape,size,slender,staman,stigma,style,texture,unexpanded
411	wfo-0001028777	success	205	124	95	110	29	0.463	-12,-2.5,-4,.9,0-2,0.1-0.3,0.4-0.8,0.5-1.3,0.6-1,0.7-1.2,0.8-2.2,1-2.5,1.5-3,1.5-4,1.8-2.5,2.5,2.5-5,3/4-4/5,4.5-8,8,8-15,abaxially,acute,anther,apex,apically,attenuate,base,berry,blade,calyx,chartaceous,cm,connivent,dark,deltate,diameter,entire,flattened-reniform,fruit,glabrescent,glabrous,green,inflorescence,leaf,length,lobe,lobed,long,margin,marking,maturity,mauve,midpoint,minute,mm,moderately,obovate,orange,orange-brown,ovate,pale,pedicel,peduncle,petiole,poricidal,present,ray,red-brown,retuse,rounded,shoot,short,shrub,simple,small,sometimes,sparsely,spherical,stellate,stellate-pubescent,stem,style,tapering,terminal,tip,tree,trichome,truncate,tube,way,white,whole,wide,young	-10,-3,.5,.8,0-30,0.1-0.2,0.2,0.7-1.3,0.8-1,1,1-2,1-3,1.5,1/4,1/4-1/2,2-,2.5-3,3,3.5-5,4-5-merous,6-10,7-11,acuminat,alyx,ame,apar,ape,articulated,bark,branched,briefly,c.,concolorous,curved,deciduou,discolorous,drying,eaf,eed,elongating,equal,erect,faint,filament,flower,free,fruiting,glabrescen,green-brown,infructescence,lengt,less,long-styled,longer,lower,mature,multangulate,narrow-deltate,nflorescence,occasionally,older,one,open,orolla,oung,pair,per,perfect,pericarp,plurifoliat,porrect,portion,primary,recurved,reflexe,reflexed,ruit,scar,sessile,short-styled,shorte,shorter,smooth,somewhat,soon,spaced,spreading,stalk,stalked,staminate,stout,strongly,surface,tamen,terete,tertiary,time,unarme,unarmed,unit,usually,variously,vary,vein,venation,visible,wider,woody,yellow-green,ympodial	acuminate,adhesion,arrangement,climate,colour,corolla,form,glandular,growth,hair,height,history,life,na,number,ovary,perennial,plant,position,presence,pubescence,reproduction,seed,shape,size,staman,stigma,stipe,texture
412	wfo-0001028788	success	189	123	97	92	26	0.513	%,0.15-0.4,0.2-0.4,0.4-1.3,0.5-1,0.6-1.2,0.7-1.3,0.7-1.8,1-10,1-2,1.1-2.3,1.4-1.6,10-20,2-3,2.5-3.5,2.5-4.5,2.5-8.5,3-10,4.5-6.5,5-15,6-8,8-10,8-11,acute,adaxially,andromonoecious,anther,apart,apex,attenuate,base,black,blade,brown,calyx,chartaceous,cm,cordate,cylindrical,dark,densely,diameter,entire,erect,extra-axillary,flower,fruit,gland-tipped,globose,green,grey,grey-green,hair,inflorescence,juicy,lamina,lanceolate,lateral,length,lilac,lobe,long,margin,mid-point,midpoint,mm,moist,obtuse,ovate,pale,pedicel,peduncle,perennial,petiole,plant,present,purple,ray,rhizomatous,rostrate,rusty,short,shrub,simple,stellate,stellate-pubescent,stem,straight,streak,style,thick,throughout,time,tube,x,yellow,yellowish-green	0-0.3,0-0.4,0-10,0-3.5,0.05-0.1,0.1-0.4,0.3-0.5,0.7-1.4,0.8-1.1,0.8-1.5,0.8=2.5,1,1-1.5,10-14,2-5,2.3-3.6,4-locular,5-merou,6-10,6-14,7-10,7-9,abaxially,absen,absent,acicular,across,adaxiall,alyx,anvil-shape,articulated,ascending,axe,ba,broad-based,cross-section,decimetr,directed,distall,distally,distributed,dult,eaf,eed,eglandular,exocarp,finger,fruiting,functional,half,heterostylous,hig,less,longer,lower,markedly,mature,mesocarp,minute,multiradiate,nflorescence,oblique,onl,orolla,part,per,placenta,pore,porrect,prickle,pseudo-racemose,ruit,sessile,spaced,stage,stalk,stalked,stellae,tamen,thicker,unarme,unarmed,unbranched,unit,unknow,uvenile,vary,weakly,white,wide,yellowish,ympodial	0.8-2.5,adhesion,arrangement,colour,corolla,form,glandular,growth,height,history,leaf,life,na,number,ovary,position,presence,pubescence,reproduction,seed,shape,size,staman,stigma,stipe,texture
413	wfo-0001028791	success	257	107	79	178	28	0.307	+,0.3-0.4,0.4-0.65,0.45-0.55,0.5,0.8-1,0.8-1.3,1-1.5,1-3-celled,1.5-2,1.7-2.1,1.8-3.3,10,2-7,2.8-3.0,5-15,5-22,50-80,9-30,9-35,acuminate,acute,anther,apex,base,broadly,brown,calyx,capitate,cm,conical,corolla,deltate,densely,diameter,elliptic,entire,free,fruit,glabrous,glandular,globose,green,imparipinnate,interrupted,leaf,less,liana,lobe,long,margin,mm,oblique,obovate,ovary,pale,pedicel,peduncle,petiole,plant,present,pubescence,pubescent,seed,somewhat,sparsely,stellate,stem,stigma,style,surface,trichome,truncate,tube,vine,white,wide,woody,yellow	-0.6,-1.5,-9,.5,0-6,0.05,0.05-0.2,0.2-0.3,0.2-0.4,0.2-0.8,0.25-0.3,0.3-0.5,0.3-0.6,0.3-0.8,0.4-0.5,0.4-0.6,0.4-1.1,0.6-0.8,0.6-0.9,0.7-1.5,1-2,1-2-celled,1-3,1-celled,1.5-,1.6-4.5,100,2-3,2-3.5,2-7-celled,2-locular,2.5-4.5,20-to,3-,3-4,4-11.5,4-15,4-5+,4-celled,5-,5-10,5-plurifoliate,8-10-celled,abaxially,absen,absent,abundant,adaxially,addition,ag,along,anthesi,apical,appearance,appendage,articulated,articulation,basal,basiscopically,beneath,berr,border,branched,breaking,bullate,cell,clambering,colo.,column,consistently,dark,darker,deciduous,densest,developed,dichotomously,eaf,ebracteate,edicel,eed,eglandular,elongating,enlarged,even,exserted,extended,filament,flower,fruiting,give,glabrescent,gree,grow,growing,hair-like,half,halfway,head,interjected,internode,lamina,large,lateral,leaflet,leaving,like,lon,lower,many,middle,midvein,minutely,mixture,much,multicellular,near,nflorescence,occasionally,often,outgrowth,pair,paler,papillate,per,petiolule,poorly,primary,protuberance,pseudostipule,rachi,reflexed,rest,rough,round,ruit,sandpapery,scandent,secondary,sessile,short,shorter,silky,simple,single,slightly,small,smaller,sometimes,sparse,spreading,stamen,staminal,sterile,stiff,straight,tal,tem,terminal,tertiary,testa,thick,thickened,time,tip,touch,transparent,ud,unicellular,uniseriate,unit,upper,usually,vegetation,vein,wall,winged,ympodial,–1-2-celled	adhesion,arrangement,blade,climate,colour,form,growth,hair,height,history,inflorescence,length,life,midpoint,na,number,perennial,position,presence,ray,reproduction,rugulose,shape,size,staman,stipe,tall,texture
414	wfo-0001028798	success	214	129	97	117	32	0.453	0-1,0.2-0.4,1-3,1-4.5,1.1-2,1.5-1.8,1/20,10,2-3.75,2-6,2-7,2.4-4.4,2.6-4,2/3,3-5,3.3-5.6,5-8,7-8,8-18,abaxially,acuminate,acute,adaxially,anther,apex,attenuate,base,becoming,blade,calyx,chartaceous,cm,conical,corolla,decurrent,densely,diameter,dm,entire,fleshy,flower,fruit,granular,greenish,growth,hair,inserted,lanceolate,lateral,leaf,length,less,lobe,long,margin,minutely,mm,multangulate,oblanceolate,oblong,obovate,obtuse,pale,pedicel,peduncle,persistent,petiole,porrect-stellate,present,probably,pseudo-terminal,pubescent,rather,ray,ripe,rotate-stellate,rough,rough-granular,semi-ovate,shrub,simple,slightly,stellate-pubescent,stem,stigma,style,subcampanulate,subcoriaceous,subglobose,tomentose,toward,tube,velutinous,way,x,yellow,yellowish	.5-5,0-60,0.5-2,0.9-1.2,1-6,1/2-2/3,15-19,2-3,2.5-3.5,3-4,3.8-4.2,4-5.4,5.25-7.5,6-10,6-8,8.5-13,accrescent,ag,anthesi,apart,apical-lateral,apparently,articulated,axe,axillary,ba,berry,blunt-tipped,boat-shaped,branch,branched,bud,capitat,continued,curved,cylindrical,dehiscing,distal,downward,due,eaf,echinoi,echinoid,eed,exserted,extend,filament,free,fruiting,glabrous,granular-tomentose,green,hal,high,included,introrse,irregularly,lacking,large,lined,lobed,longitudinal,lower,m.,main,many,midvein,mixed,multangulat,nearly,nflorescence,oblanceolat,obscured,often,orbicular,orolla,oung,ovate-lanceolate,overlapping,perfect,persistently,plurifoliate,pore,prominent,quite,rachi,ruit,sessile,short,short-stalked,side,slit,small,somewhat,spaced,sparingly,splitting,stalked,stamen,strongly,sulcate,suture,tamen,thick,time,tip,tomentu,tomentum,translucent,unarme,unarmed,unit,unknow,vary,vein,wide,ympodial	adhesion,arrangement,capitate,climate,colour,form,glandular,height,hermaphroditic,history,inflorescence,life,midpoint,na,number,ovary,perennial,plant,position,presence,pubescence,reproduction,rugulose,seed,shape,size,sparing,staman,stellate,stipe,surface,texture
415	wfo-0001028803	success	204	112	88	116	24	0.431	.5,0.5,0.5–3,10,12–14,1–1.2,1–2,1–3.5,2–10,2–3,3–4,4–10,4–7,5–8,8–12,8–14,abaxial,absent,acute,adaxial,anther,anthesi,apex,attenuate,base,blade,brown,bud,calyx,chartaceous,cm,connivent,cupular,densely,diameter,entire,erect,extra-axillary,flower,fruit,functionally,glabrous,glandular,globose,green,hair,hermaphroditic,leaf,length,liana,light,like,lobe,long,male,margin,midpoint,mm,moderately,nearly,obtuse,ovate,pedicel,peduncle,petiole,plant,pubescent,purple,ray,reniform,rounded,scandent,shrub,small,spreading,stellate,stem,stigma,style,surface,tan,tapering,tree,violet,weakly,white,yellow,×	0.5–1,1,14–20,1–1.5,1–3,2,2–3.5,2–4,3–10,3–6,5,5-merous,6–10,75-120,8-12,actinomorphic,ag,alyx,andromonoecious,apart,apical,apparently,appearing,armed,articulated,asymmetrical,axe,ba,bearing,becoming,berry,branch,branched,cordate,curve,curved,curving,cylindrical,darker,developed,difoliate,distal,downward,due,eaf,early,eed,elongated,em,end,exceeding,field,filament,flowering,fruiting,geminate,glabrou,held,herbarium,infructescenc,lacking,late,lobed,longitudinal,main,midrib,midvein,multiseriate,narrowly,nflorescence,occasional,often,older,opening,orolla,ower,pair,per,pinnate,pore,prickle,proximally,rachi,recurved,ruit,secondary,sheet,side,simple,slightly,slit,spaced,sparsely,splitting,stalk,ste,stellate-pubescent,surfac,tamen,tomentose,triangula,triangular,typically,unarmed,unequa,unit,upright,upward,usually,vary,vein,venation,wid,ympodial,young,zygomorphic	1–20,adhesion,climate,colour,corolla,form,growth,height,inflorescence,na,number,ovary,position,presence,present,pubescence,seed,shape,size,staman,stipe,texture,tube,wide
416	wfo-0001028815	success	196	101	77	119	24	0.393	0.4-0.8,0.5-1,1-2,10-15,14-28,2-4,2-9,22-35,3-4,3-5,5-6,6-10,6-8,7-16,abaxially,adaxially,anther,axillary,broadly,brownish,bud,chartaceous,cm,condition,corolla,dark,diameter,distal,drying,elliptic,elliptic-lanceolate,fresh,fruit,glabrous,globose,green,greenish,half,herb,lanceolate,lilac-purple,lobe,long,medium,membranous,minutely,mm,odd-pinnate,ovate,ovoid,papillose,pedicel,peduncle,petiole,plant,puberulent,pubescent,purple,red-purple,ripe,rotate,rugose,seed,size,sparsely,splotched,stem,stigma,style,subtending,terminal,tinged,triangular-lanceolate,tube,whitish,x,yellow	1-10,1-3.5,1-4,1-5,2-4.5,2.5-6.5,3-7,4-10,5-7,5-merou,acumen,acute,ag,along,alyx,apart,apex,apparently,articulated,articulation,auriculate,axe,base,basiscopic,berry,blade,capitat,cell,ciliate,connivent,covering,cuneate,decreasing,decurrent,developing,digestion,distinct,dorsally,eaf,edge,eed,enzyme,especially,exceeding,filament,flat,flower,folded,forked,geminat,generally,glabrou,green-white,hair,hair-like,hal,high,homostylous,honeycomb-shaped,indistinct,interjected,lateral,leaflet,lengthening,like,living,lower,make,margin,midrib,mucilaginous,narrowly,nflorescence,obtuse,onto,orolla,pair,perfect,petiolulate,plurifoliate,pointed,pore,poricidal,purpl,rachi,removed,rounded,ruit,semi-erec,semi-rosette,sessile,seudostipule,short,side,slightly,slit,spaced,specimen,stamen,ste,straight,tall,tamen,tem,terminated,testal,thick,throughout,tip,tri-,unit,unwinged,usually,vary,wall,wet,winged,ympodial,young	adhesion,arrangement,calyx,capitate,colour,form,growth,height,history,inflorescence,leaf,length,life,na,ovary,perennial,position,pubescence,reproduction,rugulose,shape,staman,surface,texture
417	wfo-0001028876	success	127	105	70	57	35	0.551	.5,/4,0.4-1,0.5-2,1-2,1.5-2,1.5-3,2-2.3,3-8,4-5,5-6,abaxial,abaxially,acute,adaxially,along,anther,apex,attenuate,base,branched,brown,calyx,capitate,cm,conical,corolla,dark,dendritic,densely,elliptic,glabrous,internodal,leaf,like,lobe,lobed,long,long-triangular,midrib,mm,occasionally,opposite,ovary,papillae,papillose,pedicel,petiole,pubescent,rest,rounded,sagittate,shining,shrub,simple,small,sparsely,speciman,stem,stigma,style,subshrub,surface,trichome,tube,type,uniseriate,way,white,x	3-5,4-8,anthesi,bark,closely,dia,difoliate,drying,eaf,edicel,eed,ellipsoid,filament,flower,free,geminat,glabrat,golden,hroughout,included,inflorescenc,know,known,lamina,lateral,leave,lower,main,middle,minutely,nflorescence,nodding,older,overlappin,pair,papillo,planar,pore,poricidal,portion,reddish,ruti,scar,shaped,slender,spaced,straight,tall,tear-drop,tip,tub,ud,unit,vein,widest,ympodial,young	adhesion,arrangement,blade,climate,colour,diameter,form,fruit,glandular,growth,hair,height,history,inflorescence,length,life,margin,midpoint,na,number,peduncle,plant,position,presence,pubescence,ray,reproduction,rugulose,seed,shape,size,staman,stellate,stipe,texture
418	wfo-0001028883	success	207	107	70	137	37	0.338	1,4,5,50,acute,anther,apex,articulated,attenuate,base,blade,calyx,capitate,chartaceous,cm,coriaceous,cylindrical,dark,deltate,diameter,drying,dull,elliptic,entire,equal,flower,fruit,glabrescent,glabrous,glandular,globose,green,greenish,growth,herb,lateral,leaf,length,less,light,lobe,margin,mm,moderately,narrowly,oblong,pedicel,peduncle,petiole,present,pubescence,pubescent,reniform,ripe,seed,similar,simple,size,slightly,sparsely,stellate,stem,stigma,straight,style,subopposite,surface,white,yellow,×	0.3–0.6,0.4–1.2,0.5–2,0.6,1.5–7,1–2,1–6,2,2–3,2–5,3–5,4–6,5-merou,6,6–10,6–12,abaxially,absent,accrescent,acuminate,adaxiall,adaxially,almost,along,alyx,antrorse,antrorsely,apar,arched,ark,ascending,axi,becoming,berry,branch,brochidodromous,brow,capitat,cell,ciliate,circular,common,completely,concolorous,connivent,curved,cyme,decurrent,densely,differing,directed,eaf,eed,elliptic-ovate,emarginate,erect,exfoliating,eye,filament,flattened,frui,geminate,geniculat,glabrou,head,hilum,hollow,impressed,introrsely,like,long,longitudinal,lower,lying,membranaceous,midrib,minor,multicellular,naked,new,nflorescence,normally,notably,obtuse,often,older,onto,opening,orolla,ovate-lanceolate,parallel,pendan,per,perfect,plurifoliate,pore,poricidal,primarily,prominent,rachi,rarely,region,rounded,ruit,secondary,sessile,shap,shiny,shrub,single,single-celled,slit,small,sometimes,spaced,sparse,spreading,stalk,subapical,subsessile,swollen,tall,tamen,tem,trichome,unbranched,undulate,uniseriate,unit,vary,vein,venation,visible,whitish,wide,woody,ympodial	1-2,1.5-7,2-3,2-5,3-5,4-6,6-10,6-12,adhesion,arrangement,brown,climate,colour,corolla,form,hair,height,hermaphroditic,history,inflorescence,life,midpoint,na,number,ovary,perennial,plant,position,presence,ray,reproduction,rugulose,shape,staman,stipe,texture,tube
419	wfo-0001028885	success	214	106	76	138	30	0.355	0.5-1,0.7-2,1-1.2,1-3,1.5-3.5,2-2.5,2.3-2.5,2.5-3.5,3.5-4.5,7-8,9-11,acute,adaxially,anther,apex,apiculate,attenuate,base,berry,black,broadly,calyx,capitate,cm,corolla,cup-shaped,deltate,densely,diameter,ellipsoid,elliptic,entire,fleshy,glabrous,glandular,globose,growth,height,immature,inflorescence,lanceolate,lateral,leaf,lobe,lobed,long,margin,mm,narrowly,pedicel,peduncle,petiole,plant,pubescent,purple,revolute,ripe,scandent,shiny,shrub,simple,slightly,sometimes,sparsely,stellate,stem,stigma,style,surface,terminal,thin,tip,tube,vine,wide,woody	-1,.5,0.3-0.5,0.5-5,1-1.5,1-2,1.5-1.7,10-20,2,2-,2/3,3-5,3.5-8.5,4-5,5-merou,7-9,9-12,?,abaxial,adaxial,ag,along,alyx,anthesi,apart,apparently,archin,ark,articulated,basal,blackish,branch,branched,brown,cell,collapsing,connivent,dark,dark-pigmented,decurrent,dendriti,distal,dried,drying,eaf,eed,erect,exserted,extending,filament,flower,free,fruiting,furcate,glabrescent,glabrou,golden,gradually,groove,groupe,ilament,inserted,irregularly,known,lamina,leaving,lengthening,less,like,live,loosely,lower,material,midvein,minute,minutely,mostly,multicellular,narrowing,new,nflorescence,noddin,nodding,occasionally,often,older,orolla,pair,papillo,part,peg,perfect,pericarp,pigmentation,plurifoliat,pore,poricidal,portion,primary,quarter,recorded,reddish,retaining,rhachi,ruit,scar,scattered,shin,short,sleeve,slender,slit,small,smaller,spaced,spheroidal,spreading,strongly,tangled,tem,third,time,trichome,twinin,ud,uniseriate,unit,upper,usually,vary,vein,wall,way,weak,weak-walled,winged,ympodial,¾	1,2-8.5,abaxially,adhesion,arrangement,blade,climate,colour,form,fruit,hair,history,length,life,midpoint,na,number,ovary,position,presence,pubescence,ray,reproduction,rugulose,seed,shape,size,staman,stipe,texture
420	wfo-0001028888	success	207	110	86	121	24	0.415	0-3.5,0.15-0.5,1-1.5,1-2,10-25,12.5-25,2-6,2.3-7,2.5-3.3,3-4,5-10,5-7,8-11,8-13.5,abaxially,acute,adaxially,along,anther,apiculate,axillary,broadly,brownish,bud,center,chartaceous,clavate,cm,condition,corolla,covered,diameter,dot,drying,elliptic,especially,fresh,fruit,glabrous,globose,green,greenish,hair,herb,lanceolate,like,lobe,long,membranous,midrib,minutely,mm,mottled,odd-pinnate,often,ovate,ovoid,pedicel,peduncle,pentagonal,petiole,plant,puberulent,pubescent,purple,ripe,scattered,seed,short,size,slightly,sparsely,stem,stigma,streak,style,subglabrous,substellate,subtending,terminal,tube,violet,white,whitish,x,yellow	0-5,0-7,1,1-10,1-3,1.5-4,2-5,2.3-5,3-5,3.6-12.5,3.8-8.3,4-25,4-7,5-merou,6-11,acumen,acuminate,ag,alyx,apart,apex,apparently,articulated,axe,base,berry,blade,capitat,cell,central,ciliate,connivent,covering,cuneate,digestion,distal,dorsally,eaf,edge,eed,end,enzyme,erec,exceeding,except,filament,flat,flower,folded,forked,geminat,generally,glabrou,glaucous,greatly,green-white,hair-like,hal,half,homostylous,honeycomb-shaped,interjected,lateral,leaflet,lengthening,less,living,low,lower,make,margin,middle,mucilaginous,nflorescence,oblique,one,orbicular,orolla,pair,perfect,petiolulate,petiolule,placed,plurifoliate,pore,poricidal,proximal,reduced,removed,rounded,ruit,sessile,seudostipule,slit,sometimes,spaced,specimen,stamen,ste,stolo,straight,subequal,tall,tamen,tem,testal,thick,throughout,tip,tri-,truncate,tuber,typically,unit,unwinged,usually,vary,wall,wet,wing,ympodial	adhesion,arrangement,calyx,capitate,colour,form,growth,height,history,inflorescence,leaf,length,life,na,ovary,perennial,position,pubescence,reproduction,rugulose,shape,staman,surface,texture
421	wfo-0001028905	success	210	108	86	124	22	0.41	1,1-3,1.5-2,1.5-3,10,10-15,15-30,2.5-3,3-4,3-5,4,5-15,6-9,anther,appressed,axil,bilobed,bluntly,broadly,brown,bud,calyx,capitate,cm,concentrically,conical,corolla,deep,deeply,dia,distinctly,enlarged,except,floral,fork,form,glabrescent,glabrous,glandular,green,growing,hair,lasting,later,leaf,line,minute,mm,oblong,obovoid,orange-yellow,ovary,ovate,ovoid,paling,pedicel,peduncle,petiole,pinnatisect,plant,purple-blue,reddish,reticulate,rhachi,rotate,rugose,seedling,several,shortly,shrub,simple,size,soft-wooded,soon,sparse,stem,stigma,style,succulent,surface,tip,tube,x,year,yellow,young	-20,-3.5,-4,-5,-9,1-,1.5,10-20,2,2-2.5,2-3,200-300,38/1-38/2,40-60,5,5-,7,acuman,acumen,acuminate,adult,age,almost,also,apex,appearing,aspect,aster,base,becoming,berry,blunt,broad,cell,close,completely,continued,covering,cuneate,cyme,developed,distance,eaf,eed,ellipsoid,emarginate,entire,equal,even,exceeding,exerted,facetted,filament,firming,first,flower,forked,free,frui,fruiting,general,herbarium,inadequate,interacuminal,intermediate,lanceolate,lengthening,less,lobe,lobed,lobing,lon,long,lower,main,margin,may,midrib,mucronate,narrowly,nflorescence,occur,often,pair,papillo,pedicellate,plurifoliat,pore,poricidal,purpli,range,rarely,reaching,readily,rh,ripe,rounded,ruit,ruiting,scarious,scorpioid,shed,short,show,showy,sinus,slende,slit,smaller,specimen,spreading,stone,straggly,suffused,tall,tissue,tub,ud,unit,usually,variable,violet,well,ympodial	adhesion,arrangement,colour,diameter,fruit,growth,height,history,inflorescence,length,life,na,papillose,plurifoliate,position,pubescence,reproduction,rugulose,seed,shape,staman,texture
422	wfo-0001028916	success	212	119	92	120	27	0.434	0-0.5,0.2-0.3,0.2-0.4,0.25-0.3,0.4-0.8,0.5-3.2,0.5-3.5,1-1.5,1-2,1-4.6,1-7,1.5-2.5,1.5-3,2-12,3-4,3.5-4.5,5-7.5,7-10,7-18,absent,adaxially,andromonoecious,anther,apex,base,blade,brown,calyx,chartaceous,cm,connivent,cuneate,deeply,deltate,densely,depressed-globose,diameter,ellipsoidal,elliptical,extra-axillary,fruit,glabrous,gland-tipped,globose,green,grey,hair,herbaceous,inflorescence,later,lateral,length,light,lilac,lobe,lobed,long,loosely,marbled,margin,midpoint,mm,moderately,oblong-attenuate,obtuse,ovate,pale,pedicel,peduncle,petiole,plant,present,prostrate,purple,ray,resprouter,rotate,rotate-pentagonal,short,simple,sparsely,sprawling,stellate,stellate-pubescent,stigma,style,surface,throughout,time,tube,x,yellow	%,-8,0-0.4,0-2,0.05-0.1,0.25-0.35,0.3-0.4,0.4-1.3,0.5-3,0.5-5,0.9-1.1,1-3,1-4,1.8-2.2,10-16,14-21,15-25,2-5,2.5-5,3-5,35-50,35-55,4-,4-8,5-10,5-12,5-35,5-9,5-merou,6-20,7-8,8-10,8-9,abaxially,absen,abundant,accrescent,acicular,across,adaxiall,adult,alyx,apart,armed,articulated,axe,ba,branche,broad-based,broadly,cut,cylindrical,decimetre,deflexed,directed,distall,distributed,eaf,eed,eglandular,filament,finger,flower,fruiting,functional,half,heterostylous,index,interpetalar,lamina,less,lobing,lon,longer,lower,mature,mesocarp,midvein,minute,minutely,nflorescence,notably,oblique,orolla,part,per,pitted,pore,porrect,presen,prickle,rachi,ruit,sessile,shallowly,side,somewhat,spaced,stage,stellae,straight,succulen,tal,tamen,tem,thick,tissue,triangular,truncat,unbranched,unit,unknow,uvenile,vary,vein,weakly,white,wide,winged,ympodial	adhesion,arrangement,climate,colour,corolla,form,glandular,growth,height,history,leaf,life,na,number,ovary,position,presence,pubescence,reproduction,rugulose,seed,shape,size,staman,stem,texture,truncate
423	wfo-0001028920	success	152	119	84	68	35	0.553	.25,.5,0.2-1,0.5-1,0.8-1.1,1-1.2,1-1.5,1-3,2-2.5,2-7,3-3.5,6-15,6-6.5,abaxially,acuminate,acute,adaxially,anther,apex,arachnoid,arachnoid-pubescent,area,attenuate,base,broadly,brown,brownish,calyx,cm,conical,corolla,dark,decurrent,deltate,dendritic,dense,densely,dia,difoliate,elliptic,glabrous,globose,green,leaf,lightly,lobe,lobed,long-styled,minutely,mm,nearly,obovate,occasionally,opposite,ovary,ovoid-reniform,papillose,pedicel,petiole,pitted,poricidal,pubescence,pubescent,shape,short-styled,shrub,simple,size,small,sparsely,stem,stigma,style,surface,tip,tree,trichome,tube,tuft,unifoliate,uniseriate,white,winged,x	1-2.4,1.5-2,3-15-flowered,3-4,5-9,anthesi,axil,ba,bark,berry,closely,congested,cucullate,deflexed,differing,eaf,edicel,eed,ellipsoid,erect,exserted,felty,filament,fleshy,flower,free,fruiting,geminat,glabrate,gray-brow,later,lateral,lon,long,lower,main,major,middle,minor,nflorescence,obovoid,older,overlappin,pair,planar,pore,portion,present,ruit,scar,shaped,somewhat,soon,spaced,strongly,styl,tall,tapering,tear-drop,thick,tub,ud,unit,vein,widest,woody,ympodial,young	adhesion,arrangement,blade,climate,colour,diameter,form,fruit,geminate,glandular,gray-brown,growth,hair,height,history,inflorescence,length,life,margin,midpoint,na,number,peduncle,perennial,plant,position,presence,ray,reproduction,rugulose,seed,staman,stellate,stipe,texture
424	wfo-0001028929	success	210	96	73	137	23	0.348	.7,.9,0-3,0.2-0.3,0.2-0.4,0.4-0.8,0.5-1.5,0.5-2,0.7-1,0.7-2,1-1.1,1/4-1/3,2-3,2.2-2.3,2.5-4,2.7-3,4-6,5-6,5-7.5,6-8,acute,anther,apex,base,blade,calyx,chartaceous,cm,cuneate,densely,diameter,dull,elliptic,equal,erect,flattened-reniform,fruit,glabrescent,glabrous,hair,inflorescence,lateral,leaf,length,lobe,lobed,long,margin,maturity,midpoint,mm,oblong,obovate,obtuse,orange-brown,pedicel,peduncle,petiole,ray,red,shrub,smooth,spherical,stellate,stellate-pubescent,stem,style,surface,tapering,tube,white,wide,yellow	-2,-2/3,.5,/5,0,0-1,0-10,0-20,0.1,0.15-0.3,0.2-0.8,0.3-0.6,0.8-1,1,1-3,1.5-2.4,1/2,2-4,2-6,2-9,2/3-3/4,3-20,3-4,5-25,5-merous,7-9,8-10,abaxial,abaxially,acicular,adaxial,alyx,apar,apart,ape,apically,apparently,articulated,bark,berry,branched,cell,concolorous,connivent,curved,difoliate,discolorous,distance,drying,eaf,eed,elongating,extending,filament,flower,foliaceous,free,fruiting,geminat,gently,glabrou,gra,infructescence,lon,long-styled,longer,lower,mature,midvein,minute,minutely,narrow-deltate,narrow-ovate,nflorescence,obtu,occasionally,older,one,open,orolla,oung,outline,pair,pale,patch,pendulous,per,perfect,pericarp,perpendicular,pit,poricidal,porrect,portion,prickl,prickle,prickly,primary,raised,red-brown,red-green,reticulate,rounded,ruit,scar,sessile,short-styled,side,simple,slender,small,sometimes,spaced,spreading,stalk,stalked,staminate,straight,subsessile,tamen,terete,tertiary,time,tip,trichome,unarmed,unit,usually,variously,vary,vein,venation,visible,way,woody,yellow-green,ympodial	adhesion,climate,colour,corolla,form,glandular,growth,height,na,number,ovary,plant,position,presence,present,pubescence,rugulose,seed,shape,size,staman,stigma,texture
425	wfo-0001028934	success	177	105	78	99	27	0.441	0.5-0.75,0.5-1,0.5-1.5,0.5-2,1-2,1-3,1.5,1.5-2,10-30,2-2.5,2-3,3-7,5-10,5-6,5-8,6-9,8-14,abaxially,acute,anther,apex,attenuate,base,blade,brown,bud,calyx,chartaceous,cm,connivent,dark,densely,diameter,extra-axillary,flower,fruit,glabrous,globose,green,hair,immature,leaf,leathery,lobe,lobed,margin,mature,midpoint,mm,moderately,narrowly,orange,ovate,pedicel,peduncle,petiole,pubescent,ray,red,reniform,simple,skinned,spreading,stellate,stem,stigma,style,surface,tan,tapering,triangular,tube,unlobed,vine,white,wide,x,yellow	0.5,1,1-.,1.5-2.5,15-25,2-4,3-5,3-6,5-15,5-merou,6-7,absent,accrescent,adaxiall,adaxially,alyx,apar,apical,apparently,armed,asymmetrical,axe,berry,beyond,cordate,created,cylindrical,difoliate,directed,discolorous,distally,eaf,eed,either,em,expanded,exserted,filament,filiform,flattened,frui,fruiting,geminate,glabrou,gree,introrsel,lanceolate,light,like,long,lower,m.,major,many,midrib,midvein,multicellular,multiseriate,nearly,netlike,nflorescence,obscure,obtuse,often,orolla,pair,per,perfect,pirckle,pit,pore,porrect-stellate,prickle,rachi,raised,recurved,reflexed,ridge,roselike,ruit,secondary,side,slightly,small,spaced,stalk,stamen,ste,tamen,thin,unarmed,unbranched,unequa,unicellular,unit,vary,vein,x1-3,ympodial	1-4,adhesion,arrangement,climate,colour,corolla,form,glandular,growth,height,inflorescence,length,na,number,ovary,plant,position,presence,pubescence,rugulose,seed,shape,size,staman,stipe,texture,ye
426	wfo-0001028944	success	212	146	117	95	29	0.552	0.5-0.75,0.5-1,0.8-1.5,0.8-5,1-1.5,1-3,1-3-lobed,1-4,10-20,2-15,2-2.5,2-3,2.5-4,3-4,4-6,4-8,5-10,5-25,6-15,6-8,8-13,abaxially,acute,adaxially,anther,apex,base,blade,branched,brown,brownish,calyx,chartaceous,cm,coarsely,cordate,cuneate,dark,densely,diameter,discolorous,elliptic,entire,equal,erect,especially,extra-axillary,ferruginous,flower,forked,fruit,glabrescent,glabrous,globose,green,growth,hair,highly,lanceolate,leaf,light,like,linear-acuminate,lobe,long,margin,mature,midpoint,mm,moderately,multangulate,narrowly,nearly,oblique,occasionally,often,outline,ovate,pedicel,peduncle,petiole,porrect-stellate,pubescent,purple,ray,reniform,ripe,rotate-stellate,rounded,sessile,shallowly,short-stalked,shrub,side,simple,slightly,small,smooth,stellate,stellate-pubescent,stem,stigma,style,surface,tapered,tip,toward,tree,triangular,tube,unbranched,white,whitish,x,yellow,yellowish,young	.5-2.5,0.5-1.5,0.75-1.25,1-2,1-5,1.5-7,2.5-10,20-50,4-5,5-merou,6-7,7-17,8-10,abundant,accrescent,ag,alyx,apart,apparently,armed,articulated,axe,ba,berry,bright,broad,broad-based,capitat,connivent,covering,curved,cylindrical,deltate,denser,difoliate,directed,distally,divided,eaf,eed,filament,flattened,free,frui,fruiting,geminate,glabrou,halfway,homostylous,interpetalar,long-stalked,longitudinal,lower,main,major,membanaceous,midrib,mucilaginou,nflorescence,numerous,obtuse,opening,orolla,part,perfect,pericarp,pore,prickle,rachi,recurved,ruit,short-,shorter,slit,sometimes,spaced,sparse,sparsely,stalk,straight,strongly,subtending,tal,tamen,tem,thin,time,tissue,unarmed,unit,vary,vein,white-pubescent,wide,ympodial	adhesion,arrangement,capitate,climate,colour,corolla,form,glandular,height,history,inflorescence,length,life,na,number,ovary,plant,position,presence,present,pubescence,reproduction,rugulose,seed,shape,size,staman,stipe,texture
427	wfo-0001028963	success	197	103	81	116	22	0.411	.5,/2,0-2,0.3-1,0.3-1.5,0.45-0.6,0.6-0.9,0.6-1,0.9-1.5,1.5-2,1/5,2-2.3,2-4,2-9,2.4-2.8,3.5-4.2,abaxially,anther,apically,base,berry,bright,broad-deltate,brown,calyx,cell,chartaceous,cm,connivent,densely,diameter,equal,evenly,flattened-reniform,glabrous,green,herb,inflorescence,lanceolate,lateral,leaf,length,light,lobe,lobed,long,lower,maturity,mauve,mm,moderately,narrow-elliptic,orange,outline,pale,pedicel,peduncle,pit,poricidal,purple,raised,red,shrub,simple,small,smooth,spherical,stellate,stellate-pubescent,stem,style,surface,tapering,terminal,tip,tube,upper,way,wide,yellow-orange,young	0-0.4,0.1,0.1-0.2,0.1-0.25,0.15-0.3,0.3-0.6,0.3-0.7,0.8-1.8,1-4,1/,1/4-1/3,1/6,2-3,2-5,3-4.5,4-10,4-8,5-25,5-merous,6-10,7-8,acute,alyx,apar,ape,apex,apparently,articulated,attenuate,bark,becoming,blade,concolorous,curved,cuspidat,deltate,difoliate,discolorous,drying,dull,eaf,eed,elongating,entire,erect,eye,filament,flower,free,frui,fruiting,geminat,glabrescent,gra,gray-green,herbaceous,infructescence,less,long-styled,longer,margin,mature,midpoint,naked,narrow-cuneate,narrowly,nflorescence,obtuse,occasionally,older,one,open,orolla,oung,pair,pendulous,per,perfect,pericarp,petiole,porrect,portion,primary,ray,ruit,scar,sessile,short-styled,shorter,slender,slightly,spaced,spreading,stalk,stalked,staminate,straight,subsessile,tamen,terete,tertiary,time,trichome,unarme,unarmed,unbranched,unit,usually,variously,vary,vein,venation,visible,winged,woody,ympodial	1/2,adhesion,arrangement,colour,corolla,cuspidate,form,fruit,gray,growth,height,na,ovary,plant,position,pubescence,rugulose,seed,shape,size,staman,texture
428	wfo-0001028971	success	225	123	96	129	27	0.427	0.1-0.4,0.1-0.5,0.25-0.6,0.4-0.9,1-2,1.5-2.2,1.75-2.5,10-15,15-30,2-5,2.2-3.5,2.5-3.5,2.5-4.5,2.5-5,20-35,3-14,3-5,4-9,5-10,5-8,6-8.5,abaxially,acute,adaxially,anther,apex,appearance,attenuate,base,blade,branched,broadly,calyx,campanulate,cm,coarsely,connivent,deltoid,densely,dentate,diameter,erect,essentially,extra-axillary,farinaceous,flower,form,fruit,glabrous,globose,hair,inflorescence,leaf,length,lenticular,linear-lanceolate,lobe,margin,midpoint,minutely,mixture,mm,obtuse,orange,outline,ovate,ovate-apiculate,pedicel,peduncle,perennial,petiole,pitted,pubescent,ray,reniform-ovate,ripe,sericeous,sessile,simple,spreading-hirsute,spreadingly,stellate,stellate-pubescent,stem,stigma,stipitate,style,surface,tan,thin-textured,trichome,truncate,tube,white,x,yellow	-0.8,-1.4,.1-0.2,0.2-0.5,0.25-1.25,0.3-0.6,0.4-1.5,0.8-2.5,05-2.5,1-5,1.5-4,1/5-1/2,2-foliate,3-6,4-5,5-15,6-16,6-9,7-16,acute-,adaxiall,along,also,apart,appearing,armed,articulated,ascending,axe,ba,bearing,becoming,broad-based,capitat,cauline,close,compressed,cylindrical,delicate,directed,distal,distall,eaf,eed,elongate,elongate-deltoid,entire,felty,felty-pubescent,female-sterile,filament,frequently,geminat,grading,growt,inserted,interlobal,invested,lanceolate,largest,later,lateral,laterally,least,lignescent,like,lon,long,longer,longest,lower,major,manifestly,maturit,midrib,minute,much,multiseriate,narrowly,nflorescence,numerous,occasionally,often,one,orolla,other,ovate-lanceolate,pair,per,persistent,pore,prickle,prickly,principal,rachi,reduced,round-tipped,ruit,scattered,short,short-stalked,shorter,side,similar,sinus,smaller,sometimes,spaced,sparse,stalk,ste,stellae,tal,tamen,tem,termination,time,tooth-like,unbranched,underdeveloped,unit,usually,variable,variously,vary,vein,well-developed,wide,ympodial	adhesion,arrangement,capitate,climate,colour,corolla,glandular,growth,height,history,life,na,number,ovary,plant,position,presence,pubescence,reproduction,rugulose,seed,shape,size,staman,stipe,texture,ye
429	wfo-0001028975	success	163	101	66	97	35	0.405	0.5-1,1,1-3,1-5,1.2-1.5,1.5-2,3-3.5,3-6.5,6-6.5,7.5-15,8-9,acuminate,acute,anther,apex,area,base,broad,brown,calyx,cm,conically,corolla,cup-shaped,dark,dia,elliptic,fruit,glabrous,globose,golden,green,immature,leaf,length,lobe,lobed,long,margin,minutely,mm,narrowly,opposite,ovary,ovoid-reniform,pedicel,petiole,pitted,poricidal,pubescent,shiny,shrub,size,small,sparsely,stem,stigma,style,surface,tip,tree,triangular,tube,white,wide,x	.2,.5,0.1-1,1.5-1.8,2.2-6,3-10-flowered,5-ribbed,5.5-10,?,along,anthesi,apart,appearing,bark,beneath,berry,closely,conical,corky,decurrent,deflexed,densely,denser,differing,difoliate,eaf,edicel,eed,entire,epidermi,equal,erect,exserted,extension,filament,free,fruiting,geminat,hyaline,large-celled,late,lateral,like,lon,lower,main,mainly,major,member,mere,middle,minor,nearly,nflorescence,obscured,occasionally,older,once-furcate,one,pair,papillo,pore,portion,prominent,pubescenc,raised,reddi,reflexed,remaining,rib,ruit,scar,shaped,short,simple,sinus,slender,slightly,somewhat,spaced,straight,strongly,tall,tapering,tear-drop,trichome,tub,ud,uniseriate,unit,upper,varying,vein,widest,woody,ympodial,young	0.5,9,adhesion,arrangement,blade,climate,colour,dense,diameter,form,glandular,growth,hair,height,history,inflorescence,life,midpoint,na,number,peduncle,perennial,plant,position,presence,pubescence,ray,reproduction,rugulose,seed,shape,staman,stellate,stipe,texture
430	wfo-0001028980	success	168	106	73	95	33	0.435	0.5-1.5,1-1.2,1.2-1.8,1.5-1.8,1.5-2,1.5-6,2.5,3-4,4-5,5-6,6,7-12,acuminate,acute,anther,anthesi,apex,base,broadly,calyx,capitate,cm,coarsely,conical,corolla,deltoid,dia,elliptic,flattened-reniform,fleshy,glabrate,glabrous,glandular,globose,green,leaf,lobe,long,margin,minutely,mm,opposite,ovary,ovate,pedicel,peduncle,petiole,pitted,planar,poricidal,pubescent,reddish,reflexed,seed,sharply,shrub,size,slightly,small,soon,stem,stigma,style,surface,tall,tip,tree,trichome,tube,uniseriate,white,x,yellowish	.1,.5,.75,/3,1.2-3,2.5-5,20-25-flowered,3/4,5-8,6-8,along,apart,axil,bark,basal,beginning,beneath,berry,black,clearly,corky,cucullate,deflexed,densely,differentiated,differing,difoliate,dry,drying,eaf,edicel,eed,expanded,exserted,extending,f,filament,free,frui,fruiting,furcate,geminat,impressed,incrassate,inflorescenc,lamina,lateral,lenticellat,like,lobed,lon,lower,m.,main,major,material,member,middle,minor,nflorescence,occasionally,older,one,ovoid,pair,pale,paler,papillose,pit,pore,portion,prominent,ruit,scar,scarious,shaped,shining,simple,sparsely,speciman,strongly,tapering,tear-drop,thick,ti,type,ud,unit,usually,vein,way,widest,woody,ympodial,young	1.5,2,adhesion,arrangement,blade,climate,colour,diameter,form,fruit,growth,hair,height,history,inflorescence,length,life,midpoint,na,number,perennial,plant,position,presence,pubescence,ray,reproduction,rugulose,shape,staman,stellate,stipe,texture
431	wfo-0001028982	success	213	109	82	131	27	0.385	.5,0-0.2,0.25-0.5,0.3-0.6,0.35-0.5,0.4-0.65,0.4-1.1,0.5-1.3,1-1.5,1.5-2,1.5-2.5,1.5-4.5,1.6-2.3,3-4.5,4-6,4-7,8-18,absent,acute,anther,apex,attemuate,base,blade,calyx,chartaceous,cm,connivent,cuneate,diameter,entire,extra-axillary,fruit,glabrous,gland-tipped,globose,green,hair,hastate,inflorescence,lanceolate,leaf,length,lilac,linear-hastate,lobe,lobed,loosely,margin,midpoint,mm,moderately,narrowly,obtuse,pale,pedicel,peduncle,perennial,petiole,present,ray,red,reniform,rhizomatous,scattered,shallowly,shape,short,shrub,simple,sparsely,stellate,stellate-pubescent,stigma,style,surface,tan,triangular,truncate,tube,x,yellow	%,.3,0-2.5,0-3,0.2-0.3,0.2-0.4,0.3-0.7,0.3-0.8,0.3-2,0.5-0.6,0.5-1,0.8-1.5,0.8-2.5,1,1-2,1-3,1-locular,1.5-3,13-18,14-24,15-30,2-6,2.5-4.5,35-50,4-,4-5,4.5-7.5,5-6,5-9,5-merou,6-8,8-16,9-16,abaxially,absen,accrescent,acicular,across,adaxially,adult,alyx,angled,apart,apparen,armed,articulated,axe,ba,basal,branch,branche,capitat,confined,contiguous,cylindrical,decimetre,deeply,directed,distall,distributed,dm,eaf,eed,eglandular,erect,exocarp,filament,finger,flower,fruiting,geminat,half,hig,homostylous,incomplete,interpetalar,juicy,juvenile,lamina,lateral,less,long,longer,lower,mature,mesocarp,mid-point,midrib,midvein,minute,nearly,nflorescence,oblique,orolla,overall,pair,part,per,perfect,placenta,pore,porrect,prickle,pseudo-umbellate,rachi,rugose,ruit,septum,sessile,solitary,spaced,sparse,stellae,straight,succulent,tamen,tem,thick,throughout,time,tissu,tissue,transparent,unarme,unarmed,unbranched,unit,upper,vary,wide,ympodial	adhesion,arrangement,capitate,climate,colour,corolla,form,glandular,growth,height,history,life,na,number,ovary,plant,position,presence,pubescence,reproduction,rugulose,seed,size,staman,stem,stipe,texture
432	wfo-0001028984	success	180	108	81	99	27	0.45	-2,-3,0.5-,1,1-1.7,1-6,1-9,1.2-4,1.5,10-20,2,2-16,2-2.5,2-3,3-6,4-30,4-5,4-6,4-6.3,5-10,7-14,abaxially,acuminate,age,also,apex,apical,basal,base,broadly,calyx,campanulate,chartaceous,cm,concave,cordate,densely,diameter,eglandular,ellipsoid-fusiform,entire,especially,fruit,glabrous,gland,glandular-puberulent,greenish,hair,lanceolate,lobe,long,margin,mm,moderately,often,ovate,pale,pedicel,peduncle,petiole,pilose,puberulent,puberulent-pubescent,pubescent-pilose,purple,shrub,simple,small,sparsely,stigma,style,subcoriaceous,toward,tree,tube,turning,two,unknown,violet,x,yellow	-14,-2.5,-6,-65,-9,1-,1-2,1-2.5,12-20,15-35,2-,2-4,20-40,3-10,3-26,3-28,4-7,4-foliat,5,8-15,abruptly,absen,acute,adaxially,adpressed,aggregate,almost,apart,ape,articulated,axe,blade,broad,cell,color,connective,dilated,directed,distally,eaf,eed,equalling,exceeding,fleshy,flower,forked,globose,laterally,leaving,lon,longer,lower,minutely,narrowed,near,nflorescence,nther,obconical,obtuse,orolla,ovoid,papillose,pedicellar,perfect,pilo,pore,possibly,presence,present,pubescent-pilo,rachi,radiu,rarely,remnant,ripe,ruit,shorter,slightly,spaced,stamen,stone,strongly,swelling,tal,tem,thecae,time,tip,tomento,tomentose,triangular,truncate,ud,unbranched,unit,unknow,vary,wide,ympodial	abaxial,adaxial,anther,arrangement,colour,corolla,form,growth,height,history,inflorescence,leaf,length,life,na,ovary,plant,position,pubescence,reproduction,rugulose,seed,shape,size,stem,surface,texture
433	wfo-0001028997	success	136	104	68	68	36	0.5	0.5-0.7,0.5-1,0.8-1.1,1-1.2,1-1.5,2-3.5,3-4,3.3.5,4-10,4-4.5,5-6,6-10,acute,anther,apex,appearing,area,attenuate,base,broadened,calyx,cm,conical,coriaceous,corolla,dia,difoliate,dry,elliptic-obovate,flattened-reniform,glabrous,globose,green,height,leaf,lobe,lobed,margin,minutely,mm,mustard,nearly,opposite,ovary,pale,papillose,pedicel,pericarp,petiole,pitted,poricidal,quadrate,revolute,shrub,stem,stigma,style,surface,tan,terminal,thick,tip,trifoliate,tube,unknown,white,x,yellow	.5,0.5-1.5,2-2.5,20-50-flowered,4-angled,6-7,abaxially,adaxially,anthesi,apar,ba,bark,berry,branched,cucullate,deflexed,drying,eaf,edicel,eed,elliptic,erect,exserted,filament,filiform,fragrant,free,fruiting,geminat,glabrou,golden,greenish-brow,incrassate,later,lateral,lon,long,lower,main,many,matte,merely,middle,nflorescence,older,pair,partially,pore,portion,ruit,scar,shaped,shiny,spaced,specimen,strongly,styl,tear-drop,thickened,time,tub,ud,unevenly,vein,widest,woody,ympodia,young	0.5,adhesion,arrangement,blade,climate,colour,diameter,form,fruit,glandular,greenish-brown,growth,hair,history,inflorescence,length,life,midpoint,na,number,peduncle,plant,position,presence,pubescence,ray,reproduction,rugulose,seed,shape,size,staman,stellate,stipe,sympodia,texture
434	wfo-0001029003	success	207	99	75	132	24	0.362	0.3-0.5,0.5,1-2,1.2-1.9,1.2-2.5,1.5-2.3,11-32,12.2-30,2.5-10,3,3-20,4-8,5-10.5,5-12.5,7-15.5,7-9,abaxially,adaxially,anther,attenuate,axillary,blue-violet,brownish,bud,chartaceous,cm,condition,conical,corolla,diameter,drying,elliptic,fresh,fruit,glabrous,green,greenish,herb,lanceolate,leaf,light,lobe,long,membranous,mm,mottled,odd-pinnate,ovoid,pale,pedicel,peduncle,pentagonal,petiole,plant,pubescent,purple,ripe,rotate,seed,size,sparsely,stem,stigma,style,subcapitate,subglabrous,subtending,terminal,tube,usually,violet,whitish,wide,x,yellow	0-6,0.4-3,1,1-10,1-2.5,1-3,1-5,13-36,2-6,2.5-7.5,3-5,3.5-7.5,5,5-merou,9-14,absent,acumen,acuminate,ag,alyx,apart,apex,apparently,articulated,axe,base,berry,blade,capitat,cell,ciliate,connivent,covering,decreasing,digestion,distal,dorsally,eaf,edge,eed,elongated,end,enzyme,equal,erec,especially,exceeding,filament,flat,flower,folded,forked,fourth,geminat,generally,glabrou,gradually,green-white,hair,hair-like,hal,half,highly,homostylous,honeycomb-shaped,interjected,larger,lateral,leaflet,lengthening,like,living,lower,make,margin,medium,middle,minute,mucilaginous,nflorescence,obtuse,one,orbicular,orolla,ovate,pair,perfect,petiolule,pigmentation,placed,plurifoliate,pore,poricidal,prostrate,proximal,rarely,ray,removed,rounded,ruit,secondary,sessile,seudostipule,slightly,slit,sometimes,spaced,specimen,stamen,ste,stolo,straight,subequal,symmetrical,tall,tamen,tem,testal,thick,throughout,tip,toward,tri-,tuber,typically,unit,vary,wall,wet,white,wing,ympodial	adhesion,arrangement,calyx,capitate,colour,form,growth,height,hermaphroditic,history,inflorescence,length,life,na,ovary,perennial,position,pubescence,reproduction,rugulose,shape,staman,surface,texture
435	wfo-0001029006	success	217	161	128	89	33	0.59	-+,0.2,0.4-2.5,0.5,0.5-2,0.5-4,1,1-1.5,1-5,1.8-2.2,10,2.5,3.5-4,5,7-8,<,>,abaxially,acuminate,acute,adaxial,along,anther,apex,area,asymmetrical,axil,basal,base,berry,beyond,bilobed,blackish,c.,calyx,cell,chartaceous,cm,conical,connivent,corolla,deeply,deltate,dense,diameter,ellipsoid,elliptic,elongate,entire,exserted,extending,flattened,glabrous,globose,green,groove,growth,inflorescence,lamina,later,lateral,lobe,lobed,long,loosely,lower,margin,membranous,midrib,minutely,mm,narrowly,nearly,oblique,occasionally,often,one,pale,papillate,pedicel,peduncle,pentagonal,petiole,pinnatifid,pitted,poricidal,puberulent,pubescent,purple,purplish,reaching,reddish,reniform,ripe,rotate-stellate,sagittate,shiny,simple,size,smaller,sometimes,somewhat,sparsely,stem,stigma,style,surface,tan,terminal,testal,thin,tiny,tip,trichome,truncate,tube,tuft,uniseriate,variously,vein,vine,violet,way,white,within,woody,x,young	.5,1-4,1.2-1.5,1/3,10-20,2-3,2-6,4-6,5-6,5-merou,50,7-9,adaxiall,ag,age,alyx,anthesi,apar,ark,articulated,axi,black,branched,bright,broadest,clavat,depending,drying,eaf,eed,filament,filiform,flower,free,fruiting,growing,ilament,inflated,intramarginal,irregular,irregularly,keeled,leaving,lengthening,many,markedly,minute,new,nflorescence,nodding,obvious,older,orolla,pair,part,peg,pendan,per,perfect,pericarp,planar,plurifoliat,pore,portion,primary,puberulen,ruit,scar,sleeve,slit,small,spaced,spreading,strong,strongly,sunligh,tem,time,twinin,twining,ud,unit,upper,usually,variable,vary,widest,ympodial,zig-zag	adaxially,adhesion,arrangement,blade,clavate,climate,colour,form,fruit,glandular,hair,height,history,leaf,length,life,midpoint,na,number,ovary,plant,position,presence,pubescence,ray,reproduction,rugulose,seed,shape,staman,stellate,stipe,texture
436	wfo-0001029021	success	161	126	93	68	33	0.578	0.5-1,0.8-1,0.8-1.2,0.8-2.1,1-2,1-3.4,1.1-1.3,1.5-2,1.5-3,1.8-2,2,2-2.5,3,3.5,3/4,5.5-6,abaxially,acute,along,anther,apex,appearing,base,bi-lobed,black,blade,branching,broadly,calyx,caudate,cm,conical,coriaceous,corolla,darker,decurrent,dendritic,densely,diameter,elliptic,flattened,fleshy,fruit,glabrate,glabrous,globose,grey-brown,growth,lamina,lateral,leaf,lenticular,lobe,lobed,long,long-triangular,loosely,margin,minutely,mm,ovary,ovate,overtopping,pedicel,pericarp,petiole,pitted,plurifoliate,poricidal,pubescent,purple,reddish-brown,revolute,shiny,shoot,shrub,sparsely,stem,stigma,strongly,style,surface,terminal,thin,tiny,tip,trichome,tube,vein,violet,way,winged,x	1-1.5,1-4,3-6,8-10,abaxial,absent,adaxial,adaxially,age,anthesi,apical,axi,ba,bark,basal,becoming,berry,deciduous,deflexed,denser,eaf,edicel,eed,ew,exserted,filament,flower,free,fruiting,im.,impressed,inserted,later,lax,loose,lower,m.,monochasia,nflorescence,nodding,older,outline,pair,papillo,per,planar,pore,portion,prominently,raised,ruit,scar,scattered,secondary,simple,sleeve,slit-like,stamen,ste,tapering,time,tub,ud,unit,wide,woody,ympodial,young	adhesion,arrangement,climate,colour,form,glandular,hair,height,history,im,inflorescence,length,life,midpoint,monochasial,na,number,peduncle,perennial,plant,position,presence,pubescence,ray,reproduction,rugulose,seed,shape,size,staman,stellate,stipe,texture
437	wfo-0001029031	success	213	114	90	123	24	0.423	-11.4,-12.3,-8,0.1-0.5,0.5-1.5,0.6-1.2,0.7-1.1,1-1.5,1-2.5,1-3,1-5,1-9.4,1.8-2.7,13.5,2-10.7,2-3,2-3.3,2.5-5.5,3-10,5-17,6-21,abaxially,acuminate,acute,anther,apex,black,bluish,brown,calyx,capitate,chartaceous,cm,corolla,deltate,densely,diameter,elliptic,elliptic-ovate,erect,flattened,flower,fruit,glabrescent,glabrous,globose,green,immature,inserted,leaf,leaf-opposed,length,light,lobe,mm,oblong,obtuse,occasionally,orange,outline,pedicel,peduncle,peltate-stellate,petiole,possibly,pubescence,pubescent,rarely,reniform,ripening,rugulose,shrub,simple,small,sparsely,stellate,stellate-pubescent,stem,stigma,strongly,style,suborbicular,surface,tip,tree,tube,usually,white,x,yellow	-3.6,.1-0.3,.5-1.2,0-5,0.5,0.5-4,1-2,1-2.6,1.3-3.3,1.5-2.8,1.5-3.5,1.8-4,1/3,10,2-5,2.5-5.6,20-150,4-5-,4-7.5,6-12,absent,accrescent,adaxiall,adaxially,ag,angle,apart,apexacute,apparently,around,articulated,axe,ba,base,becoming,berry,bilobe,blade,branched,center,connivent,covering,cuneate,curved,cylindrical,denser,directed,distally,eaf,edge,eed,eglandula,eglandular,entire,equal,farinose,filament,fleshy,forked,frui,fruiting,fused,geminate,hair,held,impressed,lanceolate,large,lateral,least,like,long,longitudinal,lower,major,many-foliate,margin,midpoint,midvein,nearly,nflorescence,opening,orolla,paired,peltate,perfect,pore,porrect-stellate,prominent,pseudoterminal,pubescen,rachi,ray,rounded,ruit,sessile,short,short-stalked,side,silvery,slightly,slit,smaller,sometimes,somewhat,spaced,ste,straight,subtending,tall,tamen,tem,time,trichome,unarme,unbranched,unit,vary,vein,whitish,wide,yellowish,ympodial	adhesion,arrangement,bilobed,colour,form,growth,height,history,inflorescence,life,na,ovary,perennial,plant,position,presence,present,reproduction,seed,shape,size,staman,texture,unarmed
438	wfo-0001029047	success	168	111	77	91	34	0.458	.25,.5,0.1-0.5,0.5-1,0.7-1,0.7-3,1-1.2,1-4,1.25,2.5,3-5,3.6-8.5,4-5,6-7,9.5-19.6,acuminate,acute,anther,apex,back,base,beneath,broadly,brown,calyx,campanulate,cm,corolla,deltoid,dia,elliptic,glabrous,globose,green,herbarium,leaf,like,lobe,lobed,long,margin,midrib,minutely,mm,mustard,nearly,opposite,ovary,ovate,ovoid-reniform,pale,papillose,pedicel,petiole,pitted,poricidal,principal,pubescent,reddish-brown,shape,shrub,soft,somewhat,specimen,stem,stigma,style,surface,tip,trichome,tube,uniseriate,vein,white,x,yellow,young	'',0-2,0.05-0.5,0.1-0.75,0.3-1.9,0.5-2,1,10-11,2.1-2.6,5-20-flowered,5-9,8365,``,across,amd,anisophyllou,anthesi,arching,aspec,ba,bark,bearing,beginning,berry,branch,bud,deflexed,differing,difoliate,distinctly,eaf,edicel,eed,evenly,filament,filiform,flattened,flower,free,fruiting,geminate,giving,glabrou,herb,impressed,inflorescenc,kruckoff,lateral,lenticellate,lon,lower,main,major,markedly,middle,minor,much-branched,nflorescence,occasionally,older,orbicular,part,pically,pore,portion,prominent,reflexed,rounded,ruit,scar,shaped,shining,shorter,simple,slender,smaller,smooth,spaced,sparsely,strongly,styl,tall,tapering,tear-drop,thread-like,time,ud,unit,widest,woody,ympodial	adhesion,arrangement,blade,climate,colour,diameter,form,fruit,glandular,growth,hair,height,history,inflorescence,length,life,midpoint,na,number,peduncle,perennial,plant,position,presence,pubescence,ray,reproduction,rugulose,seed,size,staman,stellate,stipe,texture
439	wfo-0001029048	success	162	105	71	91	34	0.438	.2,.5,/3,0.5-1,0.5-1.7,0.8-1,1-2,1-8,1.5-2,11,14,2,26,3-4,4-6,5-8,9-15,acuminate,anther,apex,attenuate,base,blade,bright,broadly,calyx,cm,conical,corolla,decurrent,elliptic,glabrous,globose,green,greenish-white,greenish-yellow,hispidulous,leaf,lobe,lobed,margin,matte,minutely,mm,obtuse,opposite,ovary,ovoid-reniform,pale,papillose,pedicel,petiole,pitted,puberulent,rounded,shaped,sharply,shrub,slightly,small-capitate,stem,stigma,style,surface,tan,tear-drop,tube,unifoliate,way,winged,x	.01,0.5,1,25,3-7,3.5-4,8-10,angle,another,anthesi,apar,apparent,arching,basal,bearing,becoming,beneath,berry,bicellular,branch,dia,eaf,edicel,eed,elongated,except,expanded,f,filament,filiform,flower,free,fruiting,geminate,glabrate,golden,greatly,greenish-yello,hanging,incrassate,lateral,less,like,live,long,lower,main,middle,midrib,minute,much,nflorescence,node,non-reproductive,obovoid,older,one,pair,papillo,parallel,planar,pore,poricidal,portion,reflexed,right,ripe,ruit,scar,slender,somewhat,spaced,specimen,straight,tall,tapering,thread-like,time,tip,translucent,trichome,ud,unevenly,uni-,unit,vein,widely,widest,ympodial,young,zig-zag	adhesion,arrangement,climate,colour,diameter,form,fruit,glandular,growth,hair,height,history,inflorescence,length,life,midpoint,na,number,peduncle,perennial,plant,position,presence,pubescence,ray,reproduction,rugulose,seed,shape,size,staman,stellate,stipe,texture
440	wfo-0001029053	success	275	125	86	189	39	0.313	.04,.3,.9,2.5,3.5,4.9,across,acuminate,acute,adnate,aequilateral,along,anther,apex,apiculate,attachment,attenuate,base,blade,calyx,caudate,cm,corolla,densely,diameter,dry,entire,extra-axillary,flattened-oval,flower,fruit,glabrous,glandular,glandular-pubescent,globose,hair,interpetalar,lanceolate,lateral,length,lobe,long,margin,markedly,mature,mm,moderately,nearly,notched,oblique,oblong,orange,ovate,pedicel,peduncle,petiole,point,porrect,probably,pubescence,pubescent,red,rounded,semisucculent,short,shrub,slightly,stellae,stellate,stellate-pubescent,stem,stigma,straight,style,surface,tip,tissue,truncate,tube,unarmed,vein,well-developed,white,yellow,yellow-tan,×	.7,0.1,0.2,0.2–0.6,0.3–0.4,0.3–0.7,0.4–0.8,0.5–0.6,0.5–1.1,0.6–1.3,0.7–1.0,0.7–1.1,0.7–1.2,0.7–1.3,0.7–1.7,0.7–3.4,0.8–1.0,0.8–1.2,1.0–1.6,1.1–1.3,1.3–2.0,1.4–2.0,1.5,1.5–2.5,1.5–2.7,1.6–9.2,1.7–1.8,1/2–2/3,1/3,1/3–1/2,2.0–2.3,2.0–2.8,2.1–2.4,2.1–3.8,2.4–2.8,2.4–5.1,21,3.5–7.2,4.5–6.2,5-merou,5.4–7.1,5–8,6.6,6.8–15.2,6–12,7.1–9.7,7–8,8,8.0–14.5,8.5–15.8,90°,abaxially,accrescent,adaxially,ag,alyx,anthesi,apart,apical,apparently,appearing,appressed,around,articulate,axe,ba,bark,basal,becoming,beneath,bent,berry,borne,branch,broad,brochidodromous,bud,capitat,channeled,clinate,coat,congested,criss-cros,deciduous,deltoid,dentate,development,difoliate,directed,distal,distally,distinct,eaf,edge,eed,either,emerging,endocarp,erect,exocarp,extending,fertile,filament,filiform,free,geminat,glossy,gradually,heterostylous,increasing,individually,intact,internode,intersepalar,juic,lacking,layer,less,lon,longer,lower,main,many,midpoint,midrib,midvein,minute,much,nflorescence,opaque,ove,overlapping,pattern,per,perforated,pore,portion,potentially,raised,ray,remaining,revealing,rigid,row,ruit,seen,sessile,short-stipitate,shorter,side,simple,sinus,sloughing,smoot,smooth,sometimes,soon,spaced,sparsely,splitting,spread,spreading,stamen,stipe,subopposite,suture,tamen,tem,thin,time,transparent,twice-branched,two,ud,unbranched,unit,upper,various,vary,weakly,well,wide,yellow-ferruginous,ympodial,young,±90°,±equal,±glabrous,–10	0.3-0.4,0.5-0.6,0.5-1.1,0.6-1.3,0.7-1.0,0.7-1.2,0.8-1.0,0.8-1.2,1.0-1.6,1.4-2.0,1.6-9.2,1.7-1.8,2.0-2.3,2.4-2.8,2.4-5.1,5.4-7.1,6.8-15.2,8.0-14.5,8.5-15.8,adhesion,capitate,colour,form,growth,height,inflorescence,leaf,na,ovary,plant,position,presence,present,rugulose,seed,shape,size,staman,texture
441	wfo-0001029055	success	169	92	69	100	23	0.408	0.4-1.5,1-2.6,1-5,1.6-3.5,1.8-3.5,14-50,2.2-3,2.5-8,4-10,4-6,4-7,5.5-9,6-14,8-9,9-22,abaxially,adaxially,calyx,cm,connate,corolla,covered,dark,densely,diameter,distal,elliptical,gland,green,green-white,hair,half,herbaceous,interjected,lateral,leaf,leaflet,long,longitudional,mm,odd-pinnate,outline,ovate,ovoid,pedicel,peduncle,pentagonal,perennial,petiole,pilose,plant,pubescent,purple,rotate,seed,short,short-stalked,size,sometimes,spreading,stigma,stripe,style,terminal,throughout,triangular,type,wide,yellow	1-4,1.7-2.2,2-1.,2-3,2-4,3,3-10,3-6,3-6-foliat,5-24,acumen,acuminate,acute,apex,apical,apically,articulate,attenuate,base,branched,cell,cordate,covering,cuneate,cyme,decurrent,dehiscent,dichasial,dichasially,digestion,diminishing,dorsally,eaf,ebracteate,edge,eed,elliptcal,emoval,enzyme,exceeding,filament,first,flat,flower,folded,forked,generally,globo,hair-like,honeycomb,introrse,living,lobe,lon,long-attenuate,longer,lower,lunat,make,maturing,monochasial,mucilaginous,near,nflorescence,nther,oblique,often,orolla,pair,pattern,perfect,plan,poricidally,proximal,rarely,reveal,ruit,second,sessile,seudostipule,short-petiolate,slit,specimen,stamen,straight,tal,tem,testal,thick,time,toward,tuber-bearing,typically,unit,vary,wall,whit,widest,ympodial,¼	2-11,anther,arrangement,colour,form,fruit,globose,growth,height,history,inflorescence,length,life,na,number,ovary,position,pubescence,reproduction,shape,stem,texture,white
442	wfo-0001029056	success	140	105	65	75	40	0.464	.2,.5,0.3-0.5,1/3-1/2,3-5-lobed,3-5-rayed,3-6,6-10,7-10,across,acute,annual,anther,anthesi,attenuate,basally,base,blade,broadly,calyx,campanulate,capitate,cm,coarsely,densely,dentate,developing,dm,externally,glabrous,glandular,green,hair,herb,invested,irregularly,length,linear-lanceolate,lobe,long,midpoint,mm,obtuse,ovate,petiole,pinnately,ray,scattered,sessile,sharply,simple,slender,stellate,stellate-pubescent,stem,strongly,surface,swollen,terminally,tightly,tip,tube,uniseriate,upturned,white	-5,0,0.7-1.0,4,5-9,6-8-flowere,along,also,alyx,ample,black,branched,cauline,central,consisting,dia,difoliate,divided,eaf,eed,elongated,erect,externall,flanking,geminat,gland,intermixed,internod,know,known,lacking,large,lon,lower,major,marking,much,nflorescence,numerous,occasional,often,one,orolla,present,prickle,prickly,purplish,reduced,ruit,separated,short-stipitate,shorte,side,slende,somewhat,sparse,spreading,starlike,stellae,strait,subulate,tall,tamen,taprooted,terete,tigma,tub,tyle,unit,vary,vein,vestiture,villous,yellow,ympodial	0.2,3-5,adhesion,apex,arrangement,climate,colour,corolla,diam,diameter,form,fruit,growth,height,history,inflorescence,internodal,leaf,life,margin,na,number,ovary,pedicel,peduncle,plant,position,presence,pubescence,reproduction,rugulose,seed,shape,size,staman,stigma,stipe,style,texture,ye
443	wfo-0001029059	success	199	133	101	98	32	0.508	.5,0.1-0.5,0.1-1,0.2,0.5,0.5-1,1-1.5,1-3,1-4,1-6,1.2-3,1.3-1.7,1.5-2,1.5-2.8,10-19,3-3.5,3.5-6,4-10.5,7-9,acute,along,anther,anthesi,apex,apiculate,base,berry,branched,calyx,clavate,cm,connivent,corolla,cuneate,deep,deltoid,dense,densely,dia,dirty,elliptic,extremely,flattened-reniform,glabrous,globose,hispidulous,inflorescence,leaf,lobe,lobed,long,major,margin,minute,minutely,mm,nearly,oblique,occasionally,often,opposite,orange,orangish-yellow,ovary,pale,papillose,pedicel,petiole,pitted,pubescence,pubescent,purplish,ripe,shallowly,shape,shaped,shrub,size,small,sparse,stem,stigma,style,surface,tear-drop,tightly,tinge,tip,tree,trichome,tube,unicellular,uniseriate,usually,variable,vein,waxy,white,x,yellowish-green,yellowish-tan	0.2-0.5,1-1.2,2.5,3-6.5,3.5-8,5,5-15-flowered,6-10,anisophyllou,apar,ape,apiculae,arising,bark,beneath,bout,bud,closely,coiba,cordate,covered,de,deflexed,differing,difoliate,eaf,edicel,eed,ellipsoid,expanded,exserted,extending,filament,foetid,free,fruiting,geminate,glabrate,greatly,impressed,incrassate,interpetalar,isla,lamina,lateral,lon,longest,lower,main,member,membranous,middle,minor,narrowly,nflorescence,older,one,orbiculate,pair,paler,panama,papillo,partially,planar,pointed,population,pore,poricidal,portion,prominent,reddish-gre,rest,rounded,ruit,scar,simple,sinus,slender,somewhat,soon,spaced,specimen,straight,tall,tapering,terminal,thickened,ti,triangular,ud,underside,unit,wide,widest,woody,yellowish,ympodial,young	adhesion,arrangement,blade,climate,colour,diameter,form,fruit,glandular,growth,hair,height,history,length,life,midpoint,na,number,peduncle,perennial,plant,position,presence,ray,reddish-grey,reproduction,rugulose,seed,staman,stellate,stipe,texture
444	wfo-0001029065	success	202	120	93	109	27	0.46	0.2-0.4,0.5-1,0.5-1.5,0.5-4,1-2.5,1-3,1.5-2,1.5-2.5,10-20,2,2-15,2-2.5,2-3,3-6,3-7,4-8,5-15,5-7,7-10,8-20,abaxially,absent,acute,adaxially,andromonoecious,anther,apex,attenuate,base,blade,brown,calyx,chartaceous,cm,connivent,cylindrical,densely,diameter,extra-axillary,flower,fruit,functionally,glabrous,glandular,globose,green,hair,hermaphroditic,immature,leaf,like,lobe,lobed,long,male,margin,mature,midpoint,mm,moderately,multicellular,nearly,obtuse,orange,ovary,ovate,pedicel,peduncle,per,petiole,plant,pubescent,ray,red,reniform,side,simple,sparsely,stellate,stem,stigma,style,surface,tapering,triangular,tube,uniseriate,unlobed,vine,white,woody,x,yellow	0.5,0.5-1mm,1,1-2,1-5,1-6,1.,1.5-3,1/3,2-4,2-5,2-ranke,30-60,4-7,5,5-10,8,8-12,abaxial,accrescent,adaxial,adaxiall,alyx,apar,apical,armed,asymmetrical,axe,berry,beyond,charteacous,contiguous,cordate,cut,dark,difoliate,directed,discolorous,eaf,eed,either,em,exserted,filament,flattened,frui,fruiting,geminate,generally,glabrou,gree,green-brown,heteromorphic,introsel,leathery,less,light,long-styeld,lower,m.,major,many,merou,midrib,midvein,multiseriate,narrowly,netlike,nflorescence,often,older,orolla,pair,pit,pore,porrect-stellate,prickle,rachi,raised,recurved,ridge,roselike,ruit,separated,sessile,short-styled,sinus,slightly,small,spaced,stalk,stamen,staminate,straight,strongly,tamen,unarmed,unbranched,unequa,unicellular,unit,usually,vary,vein,way,wide,ympodial,young,¼	10,adhesion,arrangement,climate,colour,corolla,form,growth,height,history,inflorescence,length,life,na,number,position,presence,present,pubescence,reproduction,rugulose,seed,shape,size,staman,stipe,texture
445	wfo-0001029072	success	235	119	91	144	28	0.387	0.2-0.4,0.4-0.9,0.5-2,0.8-1.5,1-1.2,1-25,1.5-2.6,1/3,2-5,2-7,2.2-2.5,2.2-3.2,2.5-3.5,2.5-4.5,3-20,3-8,3.5-6,4.2-6.5,4.5-9,5-7,7-15,8-27,acute,andromonoecious,anther,apex,base,blade,bright,calyx,chartaceous,cm,connivent,cordate,cream,cuneate,dark,deltate,densely,diameter,dull,equal,flattened-reniform,fruit,glabrous,green,herb,lateral,leaf,length,lobe,lobed,long,long-styled,lower,margin,marking,maturity,mauve,midpoint,mm,moderately,narrow-deltate,orange-brown,ovate,pale,pedicel,peduncle,petiole,plant,poricidal,ray,rounded,short-styled,shrub,simple,sometimes,spherical,stellate,stellate-pubescent,stem,style,tapering,terminal,tip,tube,upper,white,wide,yellow,young	-1/2,-15,-2.5,.5,/6,0,0-2,0-20,0-4,0-8,0.1-0.4,0.2-0.3,0.3,0.5-3,0.7,0.8,00-200,1,1-1.5,1-3,1.5-2.5,1.5-3.2,1/4-1/2,1/4-1/3,12-19,2-10,2-8,2.5-3.8,20-50,3-10,3-5,3-50,3/,4-,4-10,5-10,5-50,5-9,5-merous,7-10,8-20,abaxial,abaxially,adaxial,adaxially,alyx,ame,angled,apar,apart,apically,apparently,articulated,bark,berry,branched,broad-deltate,broadly,c.,clearly,conical,curved,dirty,discolorous,distal,distance,drying,eaf,eed,elongated,elongating,erect,extending,filament,flattened,flower,free,fruiting,gently,gra,green-brown,hermaphrodite,heterostylous,infructescence,least,longer,longitudinal,lowermost,mature,midvein,multangulate,nflorescence,obtu,older,one,open,orolla,oung,pair,pendent,pendulous,per,pericarp,plurifoliat,porrect,portion,prickl,prickle,prickly,primary,raised,reflexed,ridge,ruit,scar,sessile,side,smooth,spaced,sparsely,spreading,stalk,stalked,staminat,stout,straight,strongly,surface,tamen,tertiary,time,trichome,unarmed,unit,variously,vary,vein,venation,visible,way,weakly,whitish,woody,ympodial	3/4,8-15,adhesion,arrangement,climate,colour,corolla,form,glandular,growth,hair,height,inflorescence,na,number,ovary,position,presence,present,pubescence,reproduction,seed,shape,size,staman,stigma,stipe,texture
446	wfo-0001029073	success	211	139	110	101	29	0.521	.5,.7,0.3-1,0.5-1,0.6-2,1-1.5,1-2.5,1.1-1.5,10-16,2,2-3,2-4,2/3,3.5-9,4-5,4-6,5-6,7-10,abaxially,acuminate,acute,adaxially,along,anther,apex,awn-like,base,berry,brown,calyx,chartaceous,cm,conical,corolla,dark,darker,dense,densely,diameter,elliptic,entire,except,flattened,glabrous,globose,golden,growth,inflorescence,internodal,interpetalar,lanceolate,leaf,length,like,linear,lobe,lobed,long,margin,maturity,midpoint,midvein,minutely,mm,narrowly,oblique,occasionally,opposite,orange,pale,papillose,pedicel,peduncle,perfect,petiole,poricidal,porrect,pubescence,pubescent,purple,ray,reniform,sessile,shallowly,shiny,short-stalked,shrub,simple,sinuate,slightly,sparsely,stellate,stem,stigma,style,surface,tan,tapering,thin,tip,tissue,trichome,truncate,tube,unequally,unisexual,way,x,yellowish,½	0.5,0.6-0.7,1-1.2,1-3,1.2-1.6,1.5-2,10-15,5-8,5-merous,6-9,8-14,another,anthesi,apart,armed,articulated,away,ba,bark,basal,beneath,broad-based,cell,cream,curved,difoliate,dimorphic,discolorous,drying,eaf,eed,enlarged,equal,erect,exserted,filament,flower,four,free,frui,fruiting,geminat,gre,hooked,lamina,lengthening,long-styled,lower,mixture,multangulate,new,nflorescence,nodding,older,one,pair,paler,per,pericarp,planar,plurifoliate,pore,portion,prickle,prickly,primary,rectangular,reticulate,ruit,scar,short,shorter,slit,sometimes,somewhat,spaced,splitting,straight,strongly,styled,testal,three,ti,triangular,two,ud,unarmed,underside,unequal,unit,upper,upward,vein,visible,wall,whitish,wide,woody,yellow,ympodial,zygomorphic	adhesion,arrangement,blade,climate,colour,form,fruit,glandular,grey,hair,height,history,life,na,number,ovary,perennial,plant,position,presence,present,reproduction,rugulose,seed,shape,size,staman,stipe,texture
447	wfo-0001029074	success	174	109	79	95	30	0.454	0.2-1,0.3-0.8,0.5-1,0.5-1.2,0.7-0.8,1,1-1.2,1-1.5,1.4-1.8,1.5-4,2-4,2-5,2-7,3.5-5,5-6,acute,anther,apex,apparently,base,black,broadly,calyx,capitate,cm,conical,corolla,cuneate,densely,diameter,entire,flattened,glabrous,globose,green,grey,growth,herb,immature,internodal,leaf,less,lobe,margin,midpoint,mm,opposite,ovary,ovate,pale,pedicel,peduncle,petiole,pubescent,pulp,purplish,ray,reniform,ripening,rounded,sagittate,simple,sparsely,stellate,stellate-pubescent,stem,stigma,style,subshrub,surface,thin,triangular,truncate,tube,uniformly,watery,white,x,yellowish	.1,.5,0,0.3-0.4,0.7-0.95,1-,1-2,1.5-2,11,2-2.3,3-,3-6,5-7,abaxially,absent,adaxially,age,almost,along,anthesi,apart,appearing,articulation,bark,basa,berry,deflexed,denser,eaf,eed,ellipsoid,exerted,expanding,filament,flower,free,frui,fruiting,glabrescen,lacking,lengthening,lignescent,like,lobed,longest,lower,markedly,midvein,minutely,mixture,new,nflorescence,obscuring,often,older,pair,papillat,per,perfect,pericarp,petal,pitted,planar,plurifoliat,pore,poricidal,portion,primary,prominent,reflexed,ruit,scar,scattered,sessile,slit,small,somewhat,stalk,stalked,strongly,swollen,tip,trichome,tub,ud,underside,uniseriate,unit,usually,vein,way,woody,yellow,ympodial,¾	2,adhesion,arrangement,blade,climate,colour,form,fruit,glandular,hair,height,history,inflorescence,length,life,na,number,plant,position,presence,present,pubescence,reproduction,rugulose,seed,shape,size,staman,stipe,texture
448	wfo-0001029075	success	217	119	95	122	24	0.438	.3,.5,0.8-1.5,1-2,10-20,2-5,2.5-3,30-60,4-14,4-7,4.5-6.5,5-10,5-8,7-17,8-9,abaxially,adaxially,along,anther,articulated,axillary,berry,broadly,brown,brownish,bud,canescent,cell,cm,condition,connivent,corolla,covering,dark,densely,diameter,dot,drying,elliptic-lanceolate,especially,flecked,fresh,fruit,glabrescent,glabrous,glandular-pilose,glandular-puberulent,green,greenish,hair-like,herb,lanceolate,lateral,leaf,lobe,long,long-spatulate,make,midrib,minutely,mm,mucilaginous,narrowly,odd-pinnate,ovoid,pedicel,peduncle,pentagonal,petiole,plant,puberulent,pubescent,seed,short,size,slightly,small,stem,stigma,style,subquadrate,substellate,subtending,terminal,testal,thick,tube,wall,wet,white,whitish,wide,x,yellow,yellowish-white	0-3,0-8,0.5-0.8,0.8-1.2,1-10,1-2.5,1-3,2-4,2.7-4.2,4-10,4-5,5-8.5,5-merou,6-12,7-9,abruptly,acumen,ag,alyx,apart,apex,apparently,attenuate-acuminate,atypically,axe,base,blade,ciliate,clavifor,cuneate,decreasing,decurrent,digestion,distal,dorsally,eaf,edge,eed,end,enzyme,erect,erect-ascendin,etota,exceeding,filament,flat,flower,folded,forked,geminat,generally,glabrou,gradually,gray-green,greatly,green-white,hair,half,homostylous,honeycomb-shaped,interjected,larger,leaflet,lengthening,light,like,living,lower,margin,middl,narrowed,nflorescence,orbicular,orne,orolla,ovate,pair,perfect,petal,petiolulate,petiolule,plurifoliate,pointed,pore,poricidal,purple,rachi,removed,rounded,ruit,sec,sessile,seudostipule,singly,slit,sometimes,spaced,specimen,stamen,ste,stolo,straight,subequal,subobtuse,tall,tamen,tem,throughout,tip,toward,tri-,tuber,typically,unit,unwinged,upper,usually,vary,whitish-gray,woody,yellow-green,ympodial	adhesion,arrangement,calyx,claviform,colour,form,growth,height,history,inflorescence,length,life,middle,na,ovary,perennial,position,pubescence,reproduction,rugulose,shape,staman,surface,texture
449	wfo-0001029084	success	192	91	67	125	24	0.349	.5,0.8-2.1,1-2,1.1-2.2,10-50,2-3.5,3-6,3.5-7.5,3.5-8,4-7,4.5-10,4.5-6.5,6-13,7-9,8-23,abaxially,acuminate,adaxially,anther,brownish,chartaceous,cm,condition,conical,corolla,diameter,drying,fresh,fruit,glabrous,green,greenish,herb,lanceolate,leaf,light,lilac,lobe,long,minutely,mm,mottled,odd-pinnate,ovate-lanceolate,ovoid,pedicel,peduncle,petiole,pilose,plant,puberulent,pubescent,purple,ripe,rotate,seed,size,sparsely,stigma,style,subglabrous,terminal,tube,whitish,wide,x,yellow	0.8-2,1-10,1-3,1-4,1.5-2.5,2-4,2-5,4-17,5,5-7,5-merou,absent,acumen,ag,along,alyx,apart,apex,apparently,arranged,articulated,axe,axillary,base,bead,berry,blade,bud,capitat,cell,ciliate,connivent,covering,darker,decreasing,digestion,distal,dorsally,eaf,edge,eed,enzyme,especially,exceeding,filament,flat,flower,folded,forked,geminat,generally,glabrou,gradually,green-white,hair-like,half,homostylous,honeycomb-shaped,interjected,interpetalar,larger,lateral,leaflet,lengthening,like,living,lon,lower,make,margin,middle,midrib,minute,moniliform,mucilaginous,multiple,narrow,necklace,nflorescence,obtuse,orolla,pair,perfect,petiolule,plurifoliate,pore,poricidal,proximal,ray,removed,ruit,secondary,semierec,seudostipule,slit,spaced,specimen,stamen,stolon,subequal,subglabrou,subsessile,subtending,symmetrical,tall,tamen,tem,testal,thick,thir,throughout,tip,tissue,toward,tri-,tuber,typically,unit,unwinged,usually,vary,wall,wet,wing,ympodial	adhesion,arrangement,calyx,capitate,colour,form,growth,height,history,inflorescence,length,life,na,ovary,perennial,position,pubescence,reproduction,rugulose,shape,staman,stem,surface,texture
450	wfo-0001029087	success	226	121	92	134	29	0.407	0-0.5,0.25-0.4,0.3-0.5,0.3-0.8,0.5-0.75,0.5-2.3,0.7-0.9,0.7-2.2,0.9-8,1.4-1.7,1.5-1.75,11-20,2-3,2.5-4,2.7-2.9,3-5,3.5-5.5,6-8,6.5-13,8-12,abaxially,absent,acute,adaxially,andromonoecious,anther,apex,attenuate,base,blade,calyx,chartaceous,cm,dark,deltate,densely,diameter,entire,extra-axillary,finely,flattened,fruit,glabrous,gland-tipped,globose,green,grey,hair,half,herbaceous,inflorescence,lanceolate,lateral,leaf,length,lobe,long,margin,mm,moderately,obtuse,ovate,pale,pedicel,peduncle,petiole,plant,present,proximal,purple,ray,resprouter,reticulate,rhizomatous,rotate,rotate-stellate,rusty,short,simple,sparsely,stellate,stellate-pubescent,stigma,streak,style,surface,time,tube,weakly,white,x,yellow	%,.05,.5,0-0.1,0-14,0-2,0-6,0-7,0.1-2,0.2-0.6,0.3-0.4,0.3-0.45,0.35-0.45,0.5-1,0.9-1.7,1-1.5,1-3,1-3.5,1-4,1-6,1.3-1.6,10-30,16-20,2-,2-7,2-locular,3,3-7,3-8,3-foliate,4.5-8,4.5-8.5,5-15,5-merou,6-7,7-10.5,7-8,7-9,8-20,8-30,8-9,9-15,absen,accrescent,acicular,across,adult,alyx,ample,anvil-shape,apart,articulated,axe,ba,branchlet,broadly,capitat,connivent,cross-section,cylindrical,deeply,directed,distall,distributed,dm,eaf,eed,eglandular,erect,exocarp,filament,finger,flower,fruiting,functional,geminat,grey-green,heterostylous,interpetalar,juicy,juvenile,lamina,less,lobed,longer,lower,mature,mesocarp,mid-point,midpoint,midvein,minute,moist,narrowly,nflorescence,oblique,orolla,pair,part,pendent,per,placenta,pore,porrect,prickle,pseudo-racemose,rachi,ruit,sessile,shallowly,slightly,spaced,stalk,stalked,stellae,straight,tal,tamen,tem,thick,throughout,tissu,tissue,transparent,triangular,unarme,unarmed,unbranched,unit,upper,vary,wide,yellowish,ympodial	adhesion,arrangement,capitate,colour,corolla,form,glandular,growth,height,history,life,na,number,ovary,peltate,perennial,position,presence,pubescence,reproduction,rugulose,seed,shape,size,staman,stelate,stem,stipe,texture
451	wfo-0001029088	success	149	117	85	64	32	0.57	.2,.3,0.1,0.6–3.2,1.3–4.5,1.5–2,15–25,1–1.5,1–1.6,1–3,25–30,2–2.5,3.5–7,3.5–8,3–16,4–8,<,acuminate,anther,apex,base,blade,bronze-brown,calyx,capitate,climbing,cm,cordate,diameter,entire,extra-axillary,flattened,fleshy,flower,fruit,glabrous,greenish-brown,hair,half,herbaceous,immature,leaf,lenticular,light,lobe,long,lower,margin,mature,membranous,minutely,mm,moderately,near,obtuse,ovoid-rhomboid,papillose,pedicel,peduncle,petiole,pubescent,purplish,reddish-brown,revolute,rounded,rugose,sand-punctate,shortly,simple,slender,slightly,somewhat,sparsely,stellate,stigma,stout,style,surface,terrestrial,tip,tube,vine,white,wider,x	0.9–1.5,1.5–3,1–1.2,2-lobe,2.5–20,2.5–4.2,2–3,5,5-merous,5–8,6-10,abaxially,accrescent,acute,adaxially,alyx,apar,apicall,axe,berry,c.,ciliate,cylindrical,densely,eaf,eed,emarginate,filament,flavor,fragrant,fruiting,glabrou,groun,heavy,juicy,lanceolate,m.,narrowly,nflorescence,nternode,orolla,palmate,perfec,plurifoliat,primary,rachi,ruit,scent,spaced,straight,strongly,swee,sweet,tamen,tem,truncate,truncate-acuminat,unbranched,unit,vary,vein,venation,ympodial,–7	2-lobed,adhesion,arrangement,climate,colour,corolla,form,glandular,ground,growth,height,history,inflorescence,length,life,midpoint,na,number,ovary,plant,position,presence,pubescence,ray,rugulose,seed,shape,size,staman,stem,stipe,texture
452	wfo-0001029089	success	177	82	54	123	28	0.305	0.8-1,1,1-1.5,1.5-2,1.5-6,10-25,4.5-5,5-10,5-9,6-7,anther,bilobed,calyx,campanulate,caniculate,cm,corolla,densely,dia,elliptic,flattened-reniform,glabrous,globose,green,leaf,lobe,lobed,minutely,mm,opposite,ovary,pedicel,petiole,pitted,poricidal,pubescent,purplish,reddish-grey,resinous,rounded-deltoid,shiny,shrub,size,small,stem,stigma,style,surface,tan,tip,tree,tube,white,x	.5,.75,/4,0.1-0.25,0.5-0.6,0.5-1,0.8-1.2,1/2,2.5-3.5,5-20-flowered,5-6,8-9,abrupt,acute,along,anthesi,apart,apex,apiculate,axil,ba,bark,base,beginning,beneath,berry,branched,bud,closely,completely,covered,covering,cracking,dark,decurrent,deflexed,differing,difoliate,drying,eaf,edicel,eed,either,enclosed,entire,erect,expand,exserted,filament,free,fruiting,furcate,geminat,glabrou,golden,impressed,incrassate,inflorescenc,lamina,later,lateral,like,lon,long,lower,main,major,margin,material,member,middle,minor,nflorescence,obovoid,occasionally,older,one,otherwise,overlapping,pair,papillo,papillose,part,peeling,persistent,pinkish,planar,pore,portion,primary,prominent,resinou,rounded,ruit,scar,secretion,shaped,simple,slightly,smooth,somewhat,spaced,still,straight,tall,tapering,tear-drop,trichome,tub,ud,underside,uniseriate,unit,usually,varnish,varnished,vein,way,widening,widest,woody,ympodial,young	0.75,adhesion,arrangement,colour,diameter,form,fruit,growth,height,history,inflorescence,length,life,na,number,peduncle,plant,position,presence,pubescence,ray,reproduction,rugulose,seed,shape,staman,stellate,texture
453	wfo-0001029091	success	212	106	80	132	26	0.377	-4,-4.5,1-2,1.5-,1.5-2,10,10-20,15-40,2-2.5,2-3,2.5-,3-4,4,7-8,anther,aromatic,axil,broadly,buff,calyx,campanulate,capitate,cm,colour,corolla,dia,discoidal,elliptic,flushed,fork,glandular,globular,grey,hair,intense,irregular,irregularly,larger,lavender,leaf,light,long,minutely,mm,oblong,obovate,ochre-yellow,ovate,overlain,ovoid,pale,pattern,pedicel,peduncle,pentagonal,petiolate,petiole,pubescent,reddish-purple,relatively,reticulate-concentric,ridge,ridged,shortly,shrub,simple,slender,slightly,soft,sparsely,speckled,stellate-rotate,stem,stigma,style,succulent,surface,transverse,violet-purple,x	-1,-15,0.3-,0.5-0.8,0.5-1,1,1-10,10-toothed,170-210,2-12,20-30,3,3-,3-11-lobed,46/1,5,5-7,635/1,acuminate,acute,age,apex,appearing,articulated,articulation,aspect,ba,base,becoming,berry,blunt,bluntly,brownish,cell,clonal,close,common,conspicuous,cuneate,cut,cyme,dark,deeply,develop,developed,downward,eed,effect,ellipsoid,emarginated,erect,exceeding,exerted,filament,flattened,floral,flower,forked,fresh,fruiting,general,giving,globose,gree,growing,half,interacuminal,juvenile,lacking,lasting,later,lateral,lavende,lengthening,line,linear,linear-lanceolate,lobe,long-triangular,lower,may,mid-vein,mineral,narrowly,nflorescence,obscure,occasionally,ower,pedicellate,petiol,plurifoliat,point,pore,poricidal,rachi,raised,readily,rh,ripe,rounded,ruit,scarcely,separate,several,shallowly,shed,sigmoid,sinus,slit,soft-wooded,soon,stone,straggly,subulate,swollen,tall,tip,tissue,toward,triangular,tub,ud,unit,upper,usually,violet,well,winged,without,woody,year,ympodial	adhesion,arrangement,diameter,form,fruit,green,growth,height,history,inflorescence,length,life,na,ovary,perennial,plant,position,pubescence,reproduction,rugulose,seed,shape,size,staman,texture,tube
454	wfo-0001029101	success	233	127	98	135	29	0.421	-15,.5,0-2,0.1-0.7,0.4-1.5,0.5-1,1-3,1.3-2,1.5-2.5,1.8-3,10-14,2.5-3.5,2.5-6,2.8-3.3,3-,3-4,5-,5-6,5-7,5-8,5-9,5.5-8,7-13,abaxial,abaxially,adaxial,andromonoecious,anther,apex,base,berry,blade,broad-deltate,calyx,chartaceous,cm,connivent,cream,cuneate,dark,deltate,diameter,dull,elliptic,erect,flattened-reniform,flower,fruit,glabrescent,glabrous,green,lateral,leaf,length,lobe,lobed,long,long-styled,margin,marking,maturity,mauve,midpoint,mm,moderately,obovate,obtuse,orange-brown,ovate,pale,pedicel,peduncle,petiole,plant,poricidal,present,ray,rounded,short-styled,shrub,simple,smooth,sometimes,sparsely,spherical,spreading,stellate,stellate-pubescent,stem,style,surface,tapering,tip,tube,wide,yellow,yellow-orange,young	-3,/3,/4,0-100,0-20,0-5,0-8,0.1,0.1-0.4,0.1-0.5,0.1-1,0.2,0.7-,0.8-3.5,00-200,1,1-1.5,1-4,1-8,1.3-2.6,1.4-2.2,1.5-2,1.7,1/5-1/4,10-20,2-,2-20,2-6,2/3-3/4,3-10,3-7,30-100,4-12,4-7,5-20,5-merous,6-8,8-15,acute,almost,always,alyx,apar,apart,apically,apparently,articulated,bark,branched,brown-green,cell,concolorous,darker,discolorous,distal,distance,drying,eaf,eed,elongating,equal,extending,filament,flattened,free,fruiting,green-brow,hermaphrodite,heterostylous,infructescence,lengt,like,lon,longer,lower,lowermost,mature,midvein,multangulate,narrow-deltate,nflorescence,oblong,often,older,one,open,orolla,oung,outline,pair,pendulous,per,pericarp,pit,plurifoliat,porrect,portion,prickl,prickle,prickly,primary,raised,rarely,reduced,reflexed,rounde,ruit,scar,secondary,sessile,side,small,spaced,stalk,stalked,staminat,straight,suborbicular,tamen,terete,tertiary,thick,time,trichome,unit,variously,vary,vein,venation,visible,way,well-developed,woody,yellow-green,ympodial	adhesion,arrangement,climate,colour,corolla,form,glandular,growth,hair,height,history,inflorescence,life,na,number,ovary,perennial,position,presence,pubescence,reproduction,rugulose,seed,shape,size,staman,stigma,stipe,texture
455	wfo-0001029106	success	200	118	87	113	31	0.435	.5,/3,0.2-0.4,0.2-1,0.25-0.7,0.5-0.9,0.9-1.2,1.5-2,1.5-3.5,2-5.5,2-8,2.2-3,3-3.5,3-4,4-8,6-8,abaxially,acute,anther,apex,apically,base,berry,blade,calyx,cm,concolorous,cuneate,deltate,densely,diameter,discolorous,drying,elliptic,flattened-reniform,fruit,glabrescent,glabrous,lateral,leaf,length,lobe,lobed,long,lower,margin,maturity,mauve,membranous,midpoint,mm,obtuse,orange,orange-brown,orbicular,ovate,pale,pedicel,peduncle,petiole,poricidal,ray,red,rounded,scandent,shrub,simple,size,smooth,sometimes,sparsely,spherical,spreading,stellate,stellate-pubescent,stem,style,subentire,surface,tapering,tip,tube,way,weakly,white,wide,yellow-orange	-6,.1,0,0-0.3,0-10,0-2,0-20,0-5,0-6,0.1,0.5,0.5-0.8,0.5-1,0.5-2.5,1-1.6,1-2,1-5,1.5-1.8,1/4,1/5-1/4,2-3.5,2-4,2-6,2/,3-25,4-6,5-14,5-8,5-merous,acuminat,alyx,ame,apar,apart,apparently,appearing,articulated,bark,branched,c.,cell,curved,distance,eaf,eed,elongating,equal,erect,extending,eye,filament,flattened,flower,free,fruiting,gently,infructescence,light,lon,longer,mature,midvein,naked,nflorescence,older,one,open,orange-brow,orolla,oung,outline,pair,pendulous,per,perfec,pericarp,pit,plurifoliat,porrect,portion,prickl,prickle,prickly,primary,raised,reflexed,scar,sessile,shallow,shiny,shorter,side,slender,small,spaced,stalk,stalked,straight,tamen,terete,tertiary,time,trichome,uit,unit,variously,vary,vein,venation,visible,woody,yellowish-green,ympodial	2/3,acuminate,adhesion,arrangement,climate,colour,corolla,form,glandular,growth,hair,height,history,inflorescence,life,na,number,ovary,plant,position,presence,pubescence,reproduction,rugulose,seed,shape,staman,stigma,stipe,texture,ye
456	wfo-0001029112	success	190	117	91	99	26	0.479	0-2,0.9-1.7,1-2,1.4-2.5,10-21,2.5-4.5,2.6-3,2.7-5.7,20,3-7,3.5-4.5,3.5-7,5,5-8,6.5-5.5,9.5-13,abaxially,acuminate,adaxially,anther,articulated,axillary,brownish,bud,cell,chartaceous,ciliate,cm,condition,conical,connivent,corolla,covering,densely,diameter,distal,drying,elliptic-lanceolate,exceeding,fresh,fruit,glabrous,green,green-white,greenish,hair,hair-like,herb,lanceolate,lateral,leaf,light,like,lobe,long,make,margin,middle,minute,mm,mottled,mucilaginous,odd-pinnate,ovate,ovoid,pale,pedicel,peduncle,plant,pubescent,purple,ripe,rotate,seed,size,stamen,stigma,style,subtending,terminal,testal,thick,throughout,tube,violet,wall,wet,whitish,wide,x,yellow	0.5,1-10,1-3,1-4,1.5-1.8,1.5-2,10-17,2-3.5,2.7-3.5,2.7-4.2,3-4,3-5,3-6,5-merou,acumen,ag,along,alyx,apart,apex,apparently,arranged,axe,base,bead,berry,blade,capitat,decreasing,digestion,dorsally,eaf,edge,eed,enzyme,equal,especially,filament,flat,flower,folded,forked,geminat,generally,glabrou,gradually,half,homostylous,honeycomb-shaped,interjected,larger,leaflet,lengthening,living,lower,moniliform,multiple,narrow,necklace,nflorescence,obtuse,orolla,pair,perfect,petiole,petiolule,plurifoliate,pore,poricidal,present,pubescen,ray,removed,ruit,secondary,semierec,seudostipule,slightly,slit,spaced,specimen,ste,stolon,subequal,symmetrical,tall,tamen,tem,thir,tip,toward,tri-,tuber,typically,unit,usually,vary,wing,ympodial	adhesion,arrangement,calyx,capitate,colour,form,growth,height,history,inflorescence,length,life,na,ovary,perennial,position,pseudostipule,pubescence,reproduction,rugulose,shape,staman,stem,surface,texture,third
457	wfo-0001029120	success	168	100	64	104	36	0.381	.5,0.7-1,1-1.5,1.1-1.5,1.1-2,2.5-3.5,2.6-7,3-3.5,6-8,6.5-16.5,acuminate,acute,anther,apex,base,bud,calyx,cm,corolla,dark,decurrent,erose,fleshy,glabrous,golden,greenish-brown,hirsute,internodal,leaf,lobe,lobed,long-triangular,margin,minutely,mm,narrowly,nearly,opposite,ovary,ovate,paler,pedicel,peduncle,petiole,pubescent,rest,shaped,shrub,slightly,sparsely,stem,stigma,style,surface,tear-drop,trichome,tube,unifoliate,uniseriate,urceolate,vein,white,x,young	.05,.75,/2,0.1-0.5,0.5-1.5,5-10-flowered,5-8,8511,abrupt,anthesi,apart,bark,basal,beginning,beneath,black,bullate,cell,deflexed,densely,dia,difoliate,dry,drying,eaf,edicel,eed,epidermi,especially,evenly,f,fide,filament,free,geminat,globose,inflorescenc,infloresence,know,known,lanceolate,large,larger,later,lateral,lehmann,like,lon,long,lower,main,middle,midrib,minor,narrow,narrower,nflorescence,occasionally,often,older,outer,pair,pale,papillose,peduncl,petaloid,point,pore,poricidal,portion,present,prominently,proximal,raised,reproductive,ruit,scar,scattered,simple,slender,spaced,specimen,speckle,straight,sympodial,tall,tapering,terminal,thickened,tip,tub,ud,unbranched,unit,upper,venation,way,white-papillo,wide,widening,widest,yellow,yellow-green,ympodial	adhesion,arrangement,blade,climate,colour,decument,diameter,form,fruit,glandular,growth,hair,height,history,inflorescence,length,life,midpoint,na,number,perennial,plant,position,presence,pubescence,ray,reproduction,rugulose,seed,shape,size,staman,stellate,stipe,texture,white-papillose
458	wfo-0001029121	success	161	76	52	109	24	0.323	0.2-2,1-5,1.1-3.9,15-30,2-13,2-3,2-3-celled,3.8-11,4-10,4-5.5,5-20,5-8,9-33,blue,calyx,cm,conical,connate,corolla,deep,diameter,distal,elliptical,glabrous,green,green-white,hair,half,herbaceous,leaf,long,medium,mm,narrowly,odd-pinnate,ovate,ovoid,pedicel,peduncle,perennial,petiole,plant,purple,rotate,scattered,seed,short,size,stigma,style,wide,yellow	-6,0,0-2,1-4,1.2-2.5,1.2-3.3,10,2-,2-10,3-5,3-6-foliat,3.6-9,4.5-10.0,8-16,abaxiall,abaxially,acumen,acuminate,acute,adaxially,apex,apical,apically,articulate,attenuate,base,branched,cell,commonly,covering,cuneate,cyme,dehiscent,dichasial,dichasially,digestion,diminishing,dorsally,eaf,ebracteate,edge,eed,emoval,enzyme,exceeding,filament,flat,flower,folded,forked,generally,globo,gradually,hair-like,honeycomb,interjected,introrse,lateral,leaflet,living,lobe,lon,lower,lunat,make,maturing,monochasial,mucilaginous,nflorescence,nther,oblique,obtuse,often,orolla,pair,pattern,perfect,petiolule,plan,poricidally,proximal,rarely,reveal,rounded,ruit,sessile,seudostipule,short-attenuate,slit,specimen,stamen,straight,subequal,tal,tem,terminal,testal,thick,throughou,throughout,tip,toward,tuber-bearing,typically,unit,vary,wall,ympodial,¼	anther,arrangement,colour,form,fruit,globose,growth,height,history,inflorescence,length,life,na,ovary,position,pubescence,reproduction,rugulose,shape,stem,surface,texture,true,tube
459	wfo-0001029125	success	197	107	67	130	40	0.34	abaxially,acute,adaxially,anther,apex,appressed,berry,black,brownish,calyx,central,cm,concave-reniform,corolla,deltate,densely,diameter,ellipsoid,fruit,glabrous,globose,green,herb,internodal,lateral,leaf,live,lobe,long,lower,maturity,minutely,mm,orange,ovary,ovate-lanceolate,pale,papillate,pedicel,peduncle,petiole,plant,pubescent,purple,purple-tinged,purplish,ripe,seed,shiny,simple,small,sparsely,star,stellate,stem,stigma,style,subshrub,surface,trichome,tube,turning,uniseriate,white,wide,yellow,¼	.0–3.5,.1,.1–1.4,.2,.4,.5–2.0,.6,0.5,0.5–0.6,0.5–1.0,0.8–0.9,0.9,1,1.0–1.2,1.0–1.5,1.0–4.0,1.5–2.0,1.5–3.0,1.7-,1.8–3.5,1–2-celled,2.5–12.0,2/3,20–100,2–3-celled,2–4,3.0–3.4,3.5–4,35–45,3–5,3–5-celled,4–8,5-merous,5–6,6,6–7,abaxial,acuminate,adaxial,age,along,anthesi,apar,apparently,arising,articulated,attenuate,ba,base,beyond,branching,cell,closely,cone,conical,cuneate,delicate,difoliate,eaf,eed,end,entire,especially,exerted,filament,flower,free,fruiting,geminat,growt,hilum,later,lengthening,like,lobed,lon,margin,maximum,narrower,nearly,nflorescence,oblique,occasionally,often,one,outline,pair,pentagonal,per,perfect,place,pore,poricidal,portion,positioned,primary,reflexe,reflexed,ridged,ruit,scar,scattered,shorter,single,slightly,slit,spaced,spreading,stemmed,stone,straight,strongly,sub-lateral,tall,tem,terete,testal,tinged,tip,toward,traingular,ud,unequal,unit,usually,vein,whitewith,woody,ympodial,young	0.4-0.5,0.5-0.6,0.5-1.0,1-2-celled,1.0-1.5,1.0-4.0,1.1,1.2,1.5-2.0,1.5-3.0,1.7-3.4,2-4,2.5-12.0,20-100,3.5-4,5-6,6-7,adhesion,arrangement,colour,form,growth,height,history,inflorescence,length,life,na,perennial,position,presence,present,pubescence,reproduction,rugulose,shape,size,staman,texture,triangular
460	wfo-0001029138	success	170	101	71	99	30	0.418	0-0.1,0.15-0.3,0.5-0.9,0.6-0.8,0.6-1.1,1-2.5,1.7-4,2-locular,2.4-5.5,2.5-3.5,20-30,3-8,3.5-4.5,3.5-6.7,4-6,6-6.5,6-8,7-8,abaxially,absent,acute,adaxially,anther,apex,base,blade,broadly,brown,calyx,chartaceous,cm,cuneate,deltate,densely,diameter,entire,extra-axillary,flower,fruit,glabrous,hair,inflorescence,length,lobe,margin,midpoint,mm,oblate,obtuse,ovate,pedicel,peduncle,perennial,petiole,present,prostrate,purple,ray,rhizomatous,rotate,rusty,shrub,simple,sparsely,stellate-pubescent,stem,style,tube,x,yellow,yellowish	%,0,0-0.6,0-1.5,0-5,0.25-0.5,0.6-0.7,0.8-1.5,0.9-1.2,1-1.5,1-1.8,1-2,1-5,1.6-2.1,2-foliate,20-100,3-4,3-80,5-8,5-merou,6-10,65-115,7-10,absen,accrescent,acicular,adaxiall,alyx,apart,apparently,armed,articulated,axe,ba,broad-based,cylindrical,d.,directed,distall,distally,distributed,dult,eaf,eed,eglandular,enclosing,finger,fruiting,functional,geminat,glabrou,gland-tipped,green,grey-green,juic,lamina,lateral,lon,long,longer,lower,markedly,mature,mesocarp,mid-point,midvein,minute,moist,nflorescence,oblique,orolla,part,per,pore,porrect,prickle,pseudo-racemose,ruit,short,spaced,stage,stalk,stellae,straight,tal,tamen,thick,thicker,thicknes,throughout,time,unbranched,unit,unknow,unknown,uvenile,vary,wide,ympodial	adhesion,arrangement,climate,colour,corolla,form,glandular,growth,height,history,leaf,life,na,number,ovary,plant,position,presence,pubescence,reproduction,rugulose,seed,shape,size,staman,stellate,stigma,stipe,surface,texture
461	wfo-0001029150	success	177	109	84	93	25	0.475	.5,0.3,0.3–0.5,0.5–1.1,0.8–1,0.8–3.5,1.2–1.5,1.5,1.5–2.2,15,1–1.5,1–11,1–5,2.5–3,2.5–5,2.5–8,3–10,6,8-shaped,9–12,acute,adaxially,anther,apex,apically,apiculate,base,calyx,ciliate,cm,conical,cros,cylindrical,diameter,ellipsoidal,elliptical,entire,except,extra-axillary,flower,fruit,glabrous,larger,leaf,light,margin,membranaceous,midvein,minutely,mm,nearly,oblique,opposed,ovate,pedicel,peduncle,petiole,pinnate,pubescent,rounded,rounded-deltoid,rugose,section,shortly,simple,slender,somewhat,sparsely,stellate,stem,stigma,style,surface,tan,teardrop-shaped,thickened,tip,truncate,tube,venation,vine,white,woody,x	0.3-0.5,0.8-1,0.8–1.5,1.5–2,1–2,1–6,2–10,2–2.5,2–3,3-5,3–4,3–50,5-merous,7–8,abaxially,accrescent,across,adaxiall,alyx,apar,apicall,attenuate,axe,berry,blade,branched,c.,canopy,capitat,climbing,color,delicate,distant,dried,eaf,eed,enlarged,filament,flattened,fleshy,flush,fruiting,glabrou,inconspicuous,lamina,lanceolate,living,lobe,lon,long,lower,m.,material,moderately,mor,nflorescence,nternode,older,orolla,pair,pale,perfec,pinkish-white,plurifoliat,pointed,rachi,rarely,reaching,ruit,sand-punctate,scar,secondary,side,slightly,small,spaced,specimen,strong,tamen,tem,thick,time,translucent,tree,trichome,understory,unit,vary,vegetation,vein,wide,wiry,ympodial	3,abaxial,adhesion,arrangement,capitate,colour,corolla,form,growth,height,history,inflorescence,internode,length,life,ovary,perennial,plant,position,reproduction,seed,shape,size,staman,texture
462	wfo-0001029151	success	197	94	65	132	29	0.33	-10,0.2-0.6,0.25-0.5,0.5-1,1-1.5,1-2,1-2.5,1-5,1-6,1.5-2,1.5-6,10-15,2-2.5,2-4,3.5-5,4-10,4.5-5,7-10,8-10,8-15,acute,annual,anther,apex,brown,calyx,chartaceous,cm,connivent,dark,diameter,elliptic,entire,fruit,glabrous,globose,green,herb,leaf,leaf-opposed,lobe,loosely,margin,mm,narrowly,oblong,obtuse,ovate,pedicel,peduncle,perfect,petiole,purple,ray,reniform,stellate,stem,stigma,style,surface,truncate,tube,undulate,x,yellow	0-0.5,0.1-0.3,1.5-3,15-20,2-15,2-3,2-6,2-8,5,5-10,5-7,5-8,6-10,7-9,8,abaxially,abundantly,accrescent,acicular,acro,acumen,adaxial,adaxially,apart,apparently,armed,articulated,axe,ba,base,blade,capitat,close,completely,cone,covered,covering,curved,cylindrical,deflexed,densely,developed,difoliate,directed,discolorous,distall,downward,eaf,eed,eglandular,equal,filament,flattened,flower,forked,frui,fruiting,geminat,hair,held,high,interpetalar,juic,juvenile,larger,lateral,like,lon,long,lower,main,markedly,mesocarp,midpoint,midrib,minute,minutely,moderately,moist,multangulate,nearly,nflorescence,oblique,orolla,outside,pale,pore,porrect,prickle,prickly,probably,pubescent,rachi,rarely,reticulate,rounded,ruit,scarcely,shallow,shorter,side,silvery,simple,small,spaced,sparse,sparsely,sparser,spiny,sprawling,stalk,stellate-pubescent,straight,subcordate,tamen,tem,time,tissu,tissue,triangular,unarmed,unbranched,unit,usually,vary,vein,vigorous,white,whitish,wide,yellowish,ympodial	7-8,adhesion,capitate,colour,corolla,dense,form,growth,height,history,inflorescence,length,life,na,number,ovary,plant,position,presence,pubescence,reproduction,rugulose,seed,shape,size,staman,texture,width,ye
463	wfo-0001029152	success	197	103	82	115	21	0.416	.1,0.25-0.5,0.5-1,0.8-1,0.9-1.3,1,1-1.5,1-4,1.1-1.3,1.5-2,2-2.5,2-5,2.5-3,3-5,8.5-16,anther,appressed,area,base,broadened,broadly,brown,calyx,cm,conical,corolla,dark,deciduous,deep,deltoid,densely,dia,dry,elliptic,fruit,glabrous,globose,green,greyish-red,inflorescence,leaf,lightly,lobe,lobed,long,material,minutely,mm,nearly,obovate,opposite,ovary,ovoid-reniform,pale,papillose,pedicel,petiole,pitted,plant,pore,poricidal,red-floccose,reddish-floccose,shape,shaped,shiny,shrub,size,small,soon,stem,stigma,style,surface,tear-drop,tip,tree,tube,weak,white,winged,x	.5,0.75-1,1-2,1-3,1.5-1.7,2-3,2-4,3-8-flowered,4-6,6-8,61-25,acuminate,acute,anthesi,apex,appearanc,appearing,attenuate,ba,bark,beginning,beneath,berry,blade,branch,bud,citronella,closely,completely,corky,cuneate,decurrent,deflexed,differing,difoliate,distal,eaf,edicel,eed,ellipsoi,enclosing,erect,et,exsertion,fide,filament,flattened,floccose,flower,fragrance,free,fruiting,geminat,giving,held,hyaline,inflorescenc,keeled,large-lenticellate,late,lateral,live,lon,long-styled,longer,lower,main,major,margin,middle,midrib,minor,nflorescence,often,older,one,overlapping,pair,per,planar,plane,portion,prominent,prominently,quite,red,reddish,reflexed,reminiscent,rounded,ruit,scar,short-styled,simple,single,slender,slightly,somewhat,spaced,straight,styl,tall,tapering,terminal,third,tillett,trichome,ud,unit,usually,vein,widest,woody,ympodial,young	1.5-4-6,adhesion,arrangement,colour,diameter,form,growth,height,history,length,life,na,peduncle,perennial,position,pubescence,reproduction,rugulose,seed,staman,texture
464	wfo-0001029156	success	65	70	26	39	44	0.4	1.5-2,4-6,6,6-8,apex,cm,diameter,glabrous,growth,liana,long,margin,minutely,mm,pale,pedicel,pitted,reniform,seed,shiny,stem,surface,tan,vine,wide,woody	-3,0.5,1,10-12,2,<,almost,apparently,bark,berry,cell,center,completely,deeply,eed,epiphytic,exfoliating,fide,flattened,fruiting,golden,lateral,markedly,minute,multiseriate,nee,new,noddin,occasionally,older,per,rectangular,rib-like,shreddy,sinuate,testal,thickening,trichome,wall	2-3,adhesion,anther,arrangement,base,blade,calyx,climate,colour,corolla,form,fruit,glandular,hair,height,history,inflorescence,leaf,length,life,lobe,midpoint,na,nodding,number,ovary,peduncle,petiole,plant,position,presence,pubescence,ray,reproduction,rugulose,shape,size,staman,stellate,stigma,stipe,style,texture,tube
465	wfo-0001029156	success	65	70	50	15	20	0.769	0.5,1,1.5-2,10-12,2,4-6,6-8,<,almost,berry,cell,center,cm,completely,deeply,diameter,exfoliating,flattened,fruiting,glabrous,golden,growth,lateral,liana,margin,minute,minutely,mm,multiseriate,new,pale,pedicel,per,pitted,rectangular,reniform,rib-like,seed,shiny,sinuate,stem,surface,tan,testal,thickening,trichome,vine,wall,woody,x	-3,apex,apparently,ark,eed,em,epiphytic,fide,lon,markedly,nee,noddin,occasionally,older,shreddy	2-3,6,bark,colour,form,height,history,length,life,long,na,nodding,number,perennial,plant,pubescence,reproduction,shape,size,texture
466	wfo-0001029160	success	150	113	71	79	42	0.473	/2,0.5,0.7,1.3-1.8,1.8-2.2,2-7,3-8,3.0-3.5,5-13,6-8,6.5-8.6,across,annual,anther,base,beneath,blade,bristly,broadly,brown,calyx,campanulate,capitate,cm,dark,developing,dia,dm,dry,eglandular,few-rayed,fully,glabrous,gland,hair,herb,including,incurved,internodal,invested,less,linear-lanceolate,lobe,long,maturity,mm,occasionally,ovate,petiole,plump,prickly,purple,radially,ridged,scattered,sessile,short-stipitate,size,sometimes,spherical,splitting,stellae,stellate,stem,strait,terminally,tightly,tinged,tube,vestiture,yellow	0.35-0.50,1.11.4,1.3-1.6,20-40,4-8,4.5-6.0,5.6-7.5,6-10-flowered,accrescent,acicular,acro,acute,adjacent,also,alyx,among,anthesi,appearance,armed,berry,branched,deep,deltoi,difoliate,divergently,divided,eaf,eed,enveloped,erect,exceeding,extende,finer,geminat,giving,heteromorphic,hilum,lon,lowermost,main,many,mostly,much,much-dissected,narrowly,nflorescence,notch,often,one,orolla,ovoid,pair,pinnatifid,prickle,ruit,shorter,shortest,slende,somewhat,spreading,stout,straigh,sunken,tall,tamen,three,thrice,tigma,tub,twice,tyle,ultimate,unit,uppermost,vary,vein,whitish-tinged,wholly,ympodial	1.1-1.4,adhesion,apex,arrangement,climate,colour,corolla,diameter,extended,form,fruit,glandular,growth,height,history,inflorescence,leaf,length,life,margin,midpoint,na,number,ovary,pedicel,peduncle,plant,position,presence,pubescence,ray,reproduction,rugulose,seed,shape,slender,staman,stigma,stipe,style,surface,texture
467	wfo-0001029163	success	149	102	71	78	31	0.477	-9,0.3-2.5,0.5-1,1-2,1.5-2.5,1.5-3,10-,2,2-3,2-6,2-7,2.5-3,20-30,3-4,4-20,4.5-23,5-8,7-9,acuminate,acute,apex,base,blade,calyx,chartaceous,cm,connivent,cuneate,decurrent,deltate,densely,diameter,elliptic,elliptic-ovate,entire,free,fruit,glabrous,glandular,globose,hair,herb,lanceolate,lenticular,lobe,margin,mm,moderately,narrowed,nearly,pedicel,peduncle,perennial,petiole,puberulent-pubescent,pubescence,purple,simple,sparsely,stellate,stem,stigma,style,subcoriaceous,surface,tip,tube,unknown,white,x,yellow	-25,-4,1,1.5-2,13-18,2-18,3-14,3-5,4-5-foliat,4-6,5-12,9-15,abaxial,abaxially,absen,adaxiall,adaxially,aggregate,apart,articulated,axe,band,cell,color,cylindrical,denser,directed,distall,distally,eaf,eed,eglandular,flower,leaving,like,lon,long,lower,narrowly,nflorescence,nther,obtuse,orolla,papillose,pedicellar,pore,projection,pseudohair,puberulent,puberulent-pubescen,rachi,radiu,remnant,ripe,roughened,ruit,scale-like,shrub,slightly,small,sometimes,spaced,stalked,stone,subapical,tal,tem,thickened,time,triangular,truncat,unbranched,unit,vary,vein,whitish,wide,ympodial	adhesion,anther,arrangement,climate,colour,corolla,form,growth,height,history,inflorescence,leaf,length,life,midpoint,na,number,ovary,plant,position,presence,ray,reproduction,rugulose,seed,shape,size,staman,stipe,texture,truncate
468	wfo-0001029171	success	137	108	73	64	35	0.533	-15,0.5,1-3,1-4.5,1.5-2,1.5-7.5,10-25,2-3,3-4,3.5-18,3.5-6.5,4-10,4-5,5-6,5-8,7-9,abruptly,acuminate,acute,angled,apex,base,blade,calyx,chartaceous,cm,connivent,cuneate,decurrent,deltate,densely,diameter,elliptic,entire,fruit,glabrous,glandular,globose,hair,lanceolate,lobe,margin,mm,moderately,narrowed,often,orange,ovate-elliptic,pedicel,peduncle,petiole,puberulent,pubescent,purple,rarely,red,ripe,rugose,shrub,simple,slightly,smooth,sometimes,sparsely,stellate,stigma,style,tip,tube,usually,white,x,yellow	-,-10,1-5,10-35,11-20,6-,8-17,abaxially,absen,adaxially,aggregate,also,and/or,apart,articulated,axe,ba,branched,cell,cylindrical,dendritically,dense,directed,distall,eaf,eed,eglandular,except,flower,forked,gland,glandula,like,long,lower,many-foliat,midrib,narrowly,near,nearly,nflorescence,nther,obtuse,orolla,perfect,pore,rachi,radiu,ruit,shoot,short-stalked,spaced,ste,stone,tal,tem,time,triangular,truncat,unbranched,unit,vary,wide,ympodial	adhesion,anther,arrangement,climate,colour,corolla,form,growth,height,history,inflorescence,leaf,length,life,midpoint,na,number,ovary,perennial,plant,position,presence,pubescence,ray,reproduction,rugulose,seed,shape,size,staman,stem,stipe,surface,texture,truncate
469	wfo-0001029215	success	49	48	25	24	23	0.51	0.3-0.5,0.5-0.7,0.5-2.5,1,2.3-2.9,brown,calyx,cm,coarse,diameter,hair-like,herb,lobe,mm,narrowly,obovate,outgrowth,pubescent,shrub,small,smelling,strong,surface,winged,woody	-1.8-2.3,.2,appearance,border,cell,eed,elongating,entire,fide,fruit,give,lateral,long,markedly,round,silky,spreadin,tall,testa,thick,wall,weigend,wide,xyledecor	0.2,1.8-2.3,colour,form,growth,height,history,length,life,na,perennial,plant,reproduction,rugulose,scent,seed,shape,spreading,texture,thicknes,width,wing,ye
470	wfo-0001029216	success	243	107	79	164	28	0.325	0.4-0.5,0.5,0.6-1,1-1.2,1-2,1.2-6,1.5-2.3,1.5-2.5,10,10-14,2.5-3.3,20-35,3,acute,annual,anther,apex,attenuate,base,basiscopically,biennial,bright,brown,calyx,capitate,cm,conical,corolla,crenate,decurrent,deep,dentate,diameter,elliptic,fruit,glabrescent,glandular,globose,green,herb,imparipinnate,inflorescence,interrupted,length,less,like,linear,lobe,long,margin,minute,minutely,mm,oblique,obovate,orange,ovary,ovate,pale,pedicel,peduncle,pentagonal,perennial,petiole,plant,present,pubescent,red,shape,sparsely,stem,stigma,style,surface,tube,usually,villous,wide,yellow	+,-0.5,-10,-5,.5,.8-1,0.1-0.3,0.1-0.5,0.1-0.6,0.1-0.8,0.2-0.25,0.2-0.3,0.2-0.4,0.2-0.8,0.3-0.4,0.3-0.5,0.3-2,0.4,0.5-0.8,0.5-1.5,0.5-2,0.6-0.8,0.8-2.5,1-3,1-4,1-6,1.5-3,1/,10-,2,2-4.5,2-locular,3-,3-4,3-5,3-7,3-foliate,4,5,5-15-flower,6-10,7-10,<,absen,absent,accrescent,acroscopically,adpressed,allogamous,always,and/or,angeld,anthesi,apical,appearance,appendage,articulated,articulation,axi,basal,becoming,branch,cell,cente,column,composed,cone,cordate,cultivar,deeply,distal,eaf,edicel,eed,entire,erect,exserted,extending,facultatively,fasciated,filament,fruited,fruiting,giving,gland-tipped,gree,hair-like,half,halfway,included,initially,interjected,internode,lanceolate,large,larger,later,lateral,leaflet,lobulate,lon,longer,lower,mainly,maturity,mixture,multicellular,multilocular,narrowly,near,nflorescence,numerous,often,one,outgrowth,pair,particularly,petiolule,population,primary,procumbent,pseudostipule,rarely,reflexe,ruit,scen,secondary,sessile,shaggy,shaped,short,silky,simple,sometimes,somewhat,sparse,spreading,staminal,sterile,straight,strong,strongly,tangled,tem,terminal,tertiary,testa,thick,thickening,tip,total,toward,trichome,truncate,ud,unicellular,uniseriate,unit,variety,varying,viny,wall,winged,ympodial	3-10,adhesion,arrangement,blade,climate,colour,form,growth,hair,height,history,leaf,life,midpoint,na,number,position,presence,pubescence,ray,reproduction,rugulose,seed,size,staman,stellate,stipe,texture
471	wfo-0001029226	success	206	119	88	118	31	0.427	-7,-9,.5,0-1,0.5-5,1-1.5,1-3,2-6,2.5-10,3-3.5,4,5-7,7-11,8-13,acuminate,acute,anther,apex,base,black,blue,bright,calyx,capitate,cm,conical,cordate,corolla,dark,deltate,densely,diameter,ellipsoid,enation,entire,flattened,glabrous,glandular,globose,growth,herbaceous,lateral,lavender,leaf,like,lobe,lobed,long,lyrate,margin,membranous,mere,mm,pale,pedicel,peduncle,perfect,petiole,pinnatifid,pubescent,red,reniform,rim,ripe,seed,shiny,short-glandular,shrub,simple,sparsely,stellate,stem,stigma,style,surface,tan,terminal,thin,translucent,tube,uniformly,vine,way,white,wide,woody,yellowish,¾	.75,0.5,1-2,1-celled,10-40+,2,2-3,2-9,3-6,30,4-6,5-merou,>,ag,alyx,anthesi,apart,apparently,ark,articulated,ba,basal,berry,branched,breaking,cell,completely,congested,connivent,decurrent,distall,divided,dry,eaf,eed,elongate,exserted,filament,flexuous,flower,free,fruiting,glabrescent,gland,green,hairy,ilament,irregularly,juice,lengthening,longer,loosely,lower,many,material,mature,minute,minutely,new,nflorescence,occasionally,often,older,one,open,orolla,overtopping,pair,papillat,papillate,papillo,per,pinnate,pitted,plurifoliat,pore,poricidal,portion,primary,reflexed,remainin,ruit,sagittate,scar,scarlet,shorter,sleeve,slender,slit,small,sometimes,spaced,spot,sprawling,spreadin,spreading,staining,strongly,tangled,tem,testal,third,time,tip,trichome,truncate,twinin,ud,uniseriate,unit,usually,vary,vein,wall,weak,widest,winged,ympodial	adhesion,arrangement,blade,climate,colour,form,fruit,hair,height,history,inflorescence,length,life,midpoint,na,number,ovary,papillose,plant,position,presence,present,pubescence,ray,reproduction,rugulose,shape,size,staman,stipe,texture
472	wfo-0001029234	success	204	118	89	115	29	0.436	%,0-1,0-2,0-2.5,0.1-0.5,0.2-0.3,0.3-0.9,0.4-0.7,0.5-1,0.5-2,0.8-1.1,0.9-2.1,1-1.5,1.1-1.5,1.5-2.5,11-23,2-2.5,2-6,3-3.7,3-5,4-8,5-9.5,5.5-7,9-24,acute,anther,apex,attenuate,base,blade,brown,calyx,capitate,chartaceous,cm,connivent,cuneate,diameter,entire,erect,flattened,fruit,glabrous,gland-tipped,glandular-puberulent,globose,hair,inflorescence,lamina,lanceolate,lateral,leaf-opposed,length,lobe,long,loosely,margin,midpoint,mm,moderately,narrowly,ovate,pale,pedicel,peduncle,perennial,perfect,petiole,present,pubescent,purple,ray,red,rhizomatous,rotate-stellate,short,shrub,simple,sparsely,stellate,stellate-pubescent,stigma,style,surface,time,triangular,tube,x,yellow	0-0.1,0-3,0-4,0-6,0.15-0.3,0.4-0.5,0.5-1.5,0.5-5,0.6-0.8,1-10,1-4,1-locular,1.5-2,18-24,2-3,20-,3-7,3-8,4-,4-7.5,4.7-7,5-merou,7-10,7-11,abaxially,absen,absent,accrescent,acicular,across,adaxiall,adaxially,adult,alyx,apart,apparen,articulated,axe,ba,bilobe,branche,confined,cylindrical,dense,directed,distall,distally,dm,eaf,eed,eglandular,exocarp,few-,filament,finger,flower,fruiting,geminat,green,half,incomplete,juicy,less,longer,lower,markedly,mature,mesocarp,mid-point,midrib,midvein,minute,nflorescence,oblique,orolla,part,per,placenta,plurifoliate,pore,porrect,prickle,pseudo-racemose,rachi,rugose,ruit,seeded,septum,sessile,spaced,sparse,stage,stalk,stellae,straight,succulent,tal,tamen,tem,thick,thicker,thicknes,throughout,tip,toward,unarme,unarmed,unbranched,unit,unknow,uvenile,vary,white,wide,ympodial	adhesion,arrangement,bilobed,climate,colour,corolla,form,glandular,growth,height,history,leaf,life,na,number,ovary,plant,position,presence,pubescence,reproduction,rugulose,seed,shape,size,staman,stem,stipe,texture
473	wfo-0001029236	success	159	118	86	73	32	0.541	.5,0.2-0.7,0.2-1,0.45-0.5,0.5,0.9-2.3,1-1.5,1-2,1.4-1.7,1/2,3,6-9,abaxially,absent,adaxial,age,anther,anthesi,apex,apically,base,becoming,broadly,calyx,cm,conical,coriaceous,corolla,cupulate,deltate,dendritic,densely,diameter,elliptic,except,flattened,fleshy,fruit,glabrous,globose,grey-brown,growth,leaf,lenticular,lobe,lobed,margin,middle,midvein,minutely,mm,narrowly,near,obscurely,occasionally,ovary,pale,pedicel,pericarp,petiole,pitted,pointed,poricidal,pubescent,purplish-black,reddish-brown,revolute,scattered,short,shrub,slightly,slit-like,stem,stigma,strongly,style,surface,terminal,thin,tip,trichome,tube,usually,violet,way,x	0.5-1.5,2-4,2-5,apical,apparently,appearing,axi,ba,bark,basal,berry,bi-lobe,branch,branching,branchlet,compact,completely,decurrent,deflexed,dichasial,eaf,edicel,eed,erect,ew,exserted,filament,flower,free,fruiting,inserted,later,lateral,less,long,lower,m.,many,nflorescence,nodding,obscure,older,overtopping,packe,per,persistent,plurifoliate,pore,portion,prominent,purplish,ruit,scar,secondary,shiny,shoot,simple,sleeve,sparsely,stamen,tall,tapering,time,trongly,tub,ud,unit,venation,wide,winged,woody,ympodial,young	adhesion,arrangement,bi-lobed,blade,climate,colour,form,glandular,hair,height,history,inflorescence,length,life,midpoint,na,number,peduncle,plant,position,presence,pubescence,ray,reproduction,rugulose,seed,shape,size,staman,stellate,stipe,texture
474	wfo-0001029244	success	233	113	88	145	25	0.378	0-0.5,0-2,0-2.5,0.15-0.25,0.2-0.3,0.4-0.7,1-4,1.4-6,1.5-2.5,1.8-3.5,2-3,2-4,2.5-3.6,3-10,4-5.5,5-7,6-12,6-8,9-25,adaxially,andromonoecious,anther,brown,calyx,chartaceous,cm,connivent,cylindrical,deltate,densely,diameter,elliptic,erect,extra-axillary,fruit,gland-tipped,globose,green,hair,inflorescence,juicy,lanceolate,lateral,leaf,length,lilac,lobe,long,loosely,lower,midpoint,mm,moist,obovate,occasionally,orange,ovate,pale,part,pedicel,peduncle,perennial,petiole,plant,present,purple,ray,red,reniform,rhizomatous,rostrate,rusty,short,shrub,simple,sparsely,stellate,stellate-pubescent,stigma,style,summit,surface,time,toward,tube,weakly,x,yellow	%,0-0.2,0-0.3,0-1,0-16,0-55,0-80,0-9,0.2-0.25,0.2-0.5,0.25-0.4,0.5-2,0.8-5,1-1.5,1-2,1.1-1.8,10-18,100-150,12-25,2-12,2-foliate,2-locular,2.1-3.2,22-31,3-5,3-7,3-7.5,3-8,4-7,4.7-5,5-10,5-merou,6-9,7-10,7-12,7-30,7-9,8-10,9-16,90-200,abaxially,absen,absent,accrescent,acicular,across,acuminate,acute,adaxiall,adult,alyx,anvil-shape,apart,apex,apiculate,articulated,axe,ba,base,blade,branch,branche,capitat,confined,contiguous,cross-section,cuneate,decimetre,directed,distall,distally,distributed,dm,eaf,eed,eglandular,entire,especially,exocarp,filament,finger,flattened,flower,fruiting,functional,geminat,half,hetereostylous,juvenile,lamina,less,lobed,longer,margin,markedly,mature,mesocarp,mid-point,midrib,midvein,minute,minutely,moderately,narrowly,nearly,nflorescence,oblique,obtuse,orolla,pair,per,placenta,pore,porrect,prickle,rachi,rugose,ruit,scarcely,sessile,shallowly,side,sometimes,spaced,stalked,stellae,straight,tal,tamen,tem,thick,thicker,throughout,tip,transparent,triangular,unarme,unarmed,unbranched,unit,upper,vary,vein,wide,ympodial	adhesion,arrangement,capitate,climate,colour,corolla,form,growth,height,history,life,na,number,ovary,position,presence,pubescence,reproduction,rugulose,seed,shape,size,staman,stem,texture
475	wfo-0001029246	success	209	118	87	122	31	0.416	-1.5,/5,0.1-0.4,0.3-0.5,0.7-1.3,0.7-2,0.8-1.1,0.8-3,0.9-1.3,1.5-2.3,1.5-2.5,1.7-6,1/3,2,2.5-3.2,2.8-4,3.5-5,4-6,6-8,7-12,abaxially,acuminate,acute,anther,apex,apically,base,berry,blade,calyx,chartaceous,cm,connivent,cuneate,deltate,diameter,dull,elliptic,entire,equal,flattened-reniform,fruit,glabrescent,glabrous,lateral,leaf,length,less,lobe,lobed,long,lower,margin,maturity,mauve,midpoint,midvein,mm,moderately,obtuse,orange-brown,orange-red,pale,pedicel,peduncle,petiole,poricidal,purple,ray,shrub,simple,sometimes,sparsely,spherical,stellate,stellate-pubescent,stem,style,tapering,tip,tube,upper,way,white,wide,yellow,yellow-orange	-1,-4,0,0-15,0-5,0.1-0.3,0.15-0.3,0.2-1.5,0.3-0.8,0.5,0.5-1.5,0.7-1.5,1-1.5,1-1.8,1-10,1-3,1-4,1-5,1-8,1.2-2,1.5-6,1.8-3,1/10-1/5,2-3,2-3.5,2-5,2/3,2/3-3/,3-20,3-5,5-,5-20,5-merous,6-10,8-16,abaxial,acuminat,adaxial,almost,alyx,apar,apart,apparently,articulated,bark,broad-deltate,c.,concolorous,curved,densely,discolorous,distance,drying,eaf,eed,elongating,erect,extending,eye,filament,flattened,flower,free,fruiting,infructescence,lon,longer,mature,naked,narrow-deltate,narrow-ovate,nflorescence,oblong,older,one,open,orange-brow,orolla,oung,pair,pendulous,per,perfec,pericarp,plurifoliat,porrect,portion,prickl,prickle,prickly,primary,procumbent,pubescent,recurved,rounded,ruit,scar,sessile,side,smooth,spaced,spreading,stout,straight,strongly,surface,tamen,terete,tertiary,time,trichome,unarmed,unbranched,unit,usually,vary,vein,venation,visible,woody,ympodial,¼	2/3-3/4,adhesion,arrangement,climate,colour,corolla,form,glandular,growth,hair,height,hermaphroditic,history,inflorescence,life,na,number,ovary,perennial,plant,position,presence,present,pubescence,reproduction,seed,shape,size,staman,stipe,texture
476	wfo-0001029263	success	211	136	106	105	30	0.502	0-2.5,0-5,0.3-1,0.5-1,0.6-1.5,1.2-2.5,1/2,1/4-1/3,10-35,12-35,2-3,2.2-3.2,2.8-3.8,3-5,3.5-5,4-10,4-6,4-7,6-20,6-30,acute,almost,andromonoecious,anther,apex,apically,attenuate,base,berry,black,blade,calyx,cell,chartaceous,cm,connivent,corolla,cream,cultivar,cuneate,dark,deep,deltate,diameter,dull,elliptic,entire,equal,evenly,flattened-reniform,flower,fruit,glabrous,glandular,green,hair,herb,lateral,leaf,length,lobe,lobed,long,long-styled,margin,marking,maturity,mauve,minute,mm,obtuse,often,orange,orange-brown,outline,pale,pedicel,peduncle,petiole,pit,plant,poricidal,purple,raised,rotate,short-styled,simple,small,smooth,sometimes,spherical,stem,style,surface,tapering,tearing,tip,trichome,tube,upper,usually,way,white,wide,yellow,young	-2,0-100,0.5-1.5,1,1-10,1-4,1-7,1/3-2/3,1/3-3/4,1/6,10-20,2-4,30-60,5-10,5-8,5-merous,7-10,alyx,apar,apparently,articulated,ba,bark,becoming,broad,broad-deltate,concolorous,curved,decurren,difoliate,distal,distance,drying,eaf,eed,elongating,erect,extending,extensive,filament,foliaceou,free,fruiting,fully,geminat,glabrescent,hermaphrodite,heterostylous,infructescence,less,lobing,long-acuminat,longer,lower,lowermost,mature,midvein,near,nflorescence,older,one,onl,open,opening,orolla,oung,ovoi,pair,part,pendulous,per,pericarp,portion,primary,red-brown,reddi,reflexed,rounded,ruit,scar,secondary,side,spaced,sparsely,spreading,staminat,stellate-pubescent,stout,straight,tamen,terete,tertiary,time,ud,unarme,unarmed,unbranched,unit,vary,vein,venation,visible,wider,woody,ympodial	adhesion,arrangement,climate,colour,form,growth,height,history,inflorescence,life,long-acuminate,midpoint,na,number,ovary,perennial,position,presence,pubescence,ray,reproduction,rugulose,seed,shape,size,staman,stellate,stigma,stipe,texture
477	wfo-0001029286	success	224	106	76	148	30	0.339	.5,1-2,1.5-2,1.5-4,1/8,2.5-3,3-4,4-5,4.5,4.5-7,5,5-6,6-8,6-9,7-10,acute,almost,anther,anthesi,apex,apically,apiculate,attenuate,base,branch,broadly,capitate,chartaceous,clustered,cm,conical,corolla,cuspidate,deltoid,diameter,drying,entire,free,glabrescent,glabrous,grey,hair,inside,leaf,length,less,liana,light,lilac,lobe,lobed,long,margin,mauve,membranous,minutely,mm,obconical,oblong,obovate,outside,pedicel,peduncle,petiole,rounded,slender,stem,stigma,style,surface,terminal,tip,tube,widely,x,yellowish	.4,0-0.5,0.1,0.15-0.4,0.4-1.2,0.6-1.2,0.8,0°,1-1.5,1.5-8,15-50,2-3,4-6,abaxial,abaxially,abscising,adaxially,age,along,altered,alyx,another,apar,apart,apice,apparently,arising,around,articulated,articulation,axil,bark,becoming,branched,branching,brown,canaliculate,clearly,closer,concave,concolorous,crenulate,curved,delineated,dendritic,density,dilated,distributed,domatia,eaf,eed,equal,except,extending,faint,fertilization,filament,flat,flexuous,flower,formed,forming,fresh,globo,green,increasing,inflorescenc,isolated,junction,know,known,lamina,lengthening,lower,m.,main,margi,mas,meeting,middle,midvein,much,multicellular,narrowly,nflorescence,nther,occasional,often,one,orolla,ovate,pair,papillo,perfec,plurifoliat,pore,poricidal,portion,primary,prominent,protruding,rachi,raised,rarely,regular,ruit,scar,separated,shallowly,side,simple,smaller,smooth,sometimes,somewhat,soon,sparsely,specimen,spreading,stretchy,stump,tangled,tearing,terete,tertiary,textur,thick,thickened,thinner,time,tissue,together,toward,translucent,translucent-violet,trichome,tuft,ud,unarmed,uneven,unit,vary,vein,venation,visible,wide,ympodial,young	adhesion,arrangement,blade,calyx,climate,colour,form,fruit,glandular,growth,height,inflorescence,midpoint,na,number,ovary,papillose,plant,position,presence,pubescence,ray,rugulose,seed,shape,size,staman,stellate,stipe,texture
478	wfo-0001029289	success	292	122	99	193	23	0.339	0.4-1.1,0.4-2,0.5-1,0.5-1.2,1-2,1-2.5,1.5-4,1.5-5,1/6-1/3,1mm,2.5-4,4-9,6-12,almost,along,always,anther,anthesi,apically,apparently,base,berry,black,branch,broadly,brown,calyx,capitate,chartaceous,clavate,close,cm,collapsing,conical,corolla,covering,cupular,cuspidate,deltoid,dendritic,development,diameter,distributed,drying,evenly,flattened,free,glabrescent,glabrous,green,inside,leaf,length,liana,lobe,lobed,long,maturity,midvein,mm,obconical,oblong,obovate,orange,outline,outside,pale,pedicel,peduncle,petiole,puberulous,pubescent,reddish,reniform,reveal,rounded,seed,shape,size,sometimes,sparse,spheroidal,stem,stigma,style,surface,terminal,thick,thin,thin-coriaceous,together,trichome,tube,usually,violet,white,x,yellow,young	.05,.2,.5,0-2,0.15-0.25,0.2-1.5,0.4-1,0.5,0.5-0.7,1-1.2,1-4,1.2,1.5-2,100,12,15,15-45,2-3,2.5,25,3,3-7,4.5,5-12,5-20,60-90°,8,abaxially,accrescent,acuminate,acute,adaxial,adaxially,age,alyx,apar,apex,apice,appendage,arachnoid,arising,aristate,around,articulated,articulation,attenuate,bark,becoming,boundary,branched,branching,canaliculate,clear,clearly,complex-dendritic,complexity,concolorous,crenulate,cuneate,curved,deeply,delineated,dense,detaching,developing,dilated,discolorous,domatia,dorsally,eaf,eed,ellipsoi,elongated,entire,equal,erect,eye,faint,fertilisation,filament,finely,flexuous,flower,forming,found,fruiting,globose,hair,half,hard,honeycomb,indumentum,inner,irregular,lamina,leave,lengthening,less,light-coloured,line,linear,longitudinally,loop,lower,m.,main,margi,margin,may,middle,minute,minutely,mixture,multicellular,naked,narrowly,nflorescence,nther,often,one,orolla,outer,pair,papillae,papillo,papillose,pattern,pendulous,perfec,pericarp,pili,pit,pitted,plurifoliat,point,pointed,pore,poricidal,portion,primary,prominent,pronounced,protruding,rachi,raised,rarely,ridged,rising,ruit,scar,see,shallow,shallowly,shiny,short,side,simple,sinus,slightly,smooth,somewhat,soon,sparsely,spreading,straight,strongly,stump,sturdy,sunken,tearing,terete,tertiary,thickened,time,tip,toward,truncate,tuft,ud,unarmed,undulate,unicellular,unit,variable,various,vary,vein,venation,visible,wide,widely,yellowish,ympodial	2.5-20,adhesion,arrangement,climate,colour,form,fruit,growth,inflorescence,midpoint,na,number,ovary,position,presence,present,pubescence,ray,rugulose,staman,stellate,stipe,texture
479	wfo-0001029295	success	191	127	96	95	31	0.503	-5,-9,.5,0.5,0.7-1,1-1.5,1.2-3.5,2-3,2.5-3.5,2.5-6,2/3,3/4,4-4.5,5-6,6-8,<,acuminate,acute,along,anther,anthesi,apex,attenuate,base,calyx,capitate,cm,corolla,cup-shaped,diameter,drying,elliptic,entire,fide,fruit,glabrescent,glabrous,globose,green,grey,height,herb,internodal,irregular,known,lateral,leaf,length,lobe,lobed,margin,membranous,midrib,minutely,mm,narrowly,obtusely,ovary,ovoid,pale,papillate,pedicel,peduncle,petiole,pitted,pointed,prolonged,purple,red,reniform,rhomboidal,rim,ripe,scattered,shallowly,shrub,simple,sinuate,slightly,small,stem,stigma,style,surface,tan,thin,tip,trichome,tube,undulation,uniseriate,urban,way,whitish,x,yellowish	0,1,2,2-4,4-5-celled,4-6,4-merous,?,abaxial,apparently,appearing,articulated,bark,become,berry,cell,closely,continuous,crystal,dark,deciduous,defined,defoliate,dense,distal,eaf,eed,ellipsoid,elongate,erect,essentially,exserted,filament,flower,free,fruiting,geminat,glabrou,half,lamina,lengthen,lobe-lik,long,lower,minute,nflorescence,nodding,older,opening,orientation,outline,pair,papillat,peduncl,peelin,pentagonal,per,perfect,pericarp,pore,portion,primary,puberulent,pubescent,rooting,rounded,ruit,sand,scar,seen,sessile,short,slit,soon,spaced,sparsely,splitting,sprawling,strongly,testal,tissue,top,ud,unarmed,unifoliate,unit,upper,usually,vein,widest,wing,wiry,woody,ympodial,young	adhesion,arrangement,blade,climate,colour,form,glandular,growth,hair,history,inflorescence,life,midpoint,na,number,perennial,plant,position,presence,pubescence,ray,reproduction,rugulose,seed,shape,size,staman,stellate,stipe,texture,unknown
480	wfo-0001029299	success	201	104	80	121	24	0.398	0.5-1.5,1-2,1-4,10-21,16-28.6,2.3-3.3,3-12,3-4.5,3-7.5,4-10,4-16,5-15,7-8,8.5-19,abaxially,acute,adaxially,anther,articulated,attenuate,axillary,broadly,brownish,bud,chartaceous,clavate,cm,condition,corolla,dense,diameter,drying,elliptic,fresh,fruit,glabrous,glandular,green,greenish,hair,herb,lanceolate,leaf,like,lobe,medium,membranous,minutely,mm,moderately,mottled,multicellular,non-glandular,odd-pinnate,ovate,ovoid,pedicel,peduncle,pentagonal,petiole,plant,puberulent,pubescence,pubescent,purple,rotate,seed,size,slightly,stem,stigma,style,subtending,terminal,trichome,tube,white,whitish,x,yellow	0-3,0-5,1-10,1.6-5,10-16,2-4,3,3-13,3-5,3.5-7.5,5-merou,6-5-15.3,acumen,acuminate,ag,along,alyx,apart,apex,apparently,axe,base,blade,borne,capitat,cell,ciliate,connate,cordate,covering,cuneate,decreasing,decurrent,digestion,distal,dorsally,eaf,edge,eed,end,enzyme,erec,especially,exceeding,filament,flat,flower,folded,forked,geminat,generally,grading,gradually,green-white,hair-like,half,homostylous,honeycomb-shaped,interjected,invested,lateral,leaflet,lengthening,living,long,lower,make,margin,middl,midrib,mucilaginous,nflorescence,oblique,orbicular,orolla,pair,perfect,petiolulate,petiolule,plurifoliate,pore,poricidal,removed,rounded,ruit,sessile,seudostipule,shallowly,short,singly,slit,spaced,specimen,spreading,stamen,ste,stolo,straight,subsessile,tall,tamen,tem,testal,thick,throughout,tip,tissue,toward,tri-,truncate,tuber,typically,unit,unknow,usually,vary,wall,wet,wide,wing,ympodial	adhesion,arrangement,calyx,capitate,colour,form,growth,height,history,inflorescence,length,life,middle,na,ovary,perennial,position,pseudostipule,reproduction,rugulose,shape,staman,surface,texture
481	wfo-0001029308	success	221	109	84	137	25	0.38	0.2-0.3,0.2-1.5,0.4-0.7,1-5,1.5-2.5,1.5-2.7,1.5-4,2-6,2.5-3,2.7-3.1,3-4,3.5-4.5,4-15,4-8,6-8,7-8,9-18,absent,acuminate,acute,adaxially,andromonoecious,anther,apex,base,blade,brown,calyx,chartaceous,cm,connivent,cuneate,deltate,densely,diameter,elliptical,entire,erect,extra-axillary,flattened,fruit,glabrous,globose,hair,inflorescence,lanceolate,leaf,length,lilac,lobe,lobed,loosely,margin,midpoint,mm,ovate,pale,pedicel,peduncle,perennial,petiole,plant,present,purple,ray,rhizomatous,rotate-stellate,rusty,seed,shallowly,shrub,simple,sparsely,stellate,stellate-pubescent,stigma,style,surface,throughout,tube,weakly,x,yellow,yellowish-green	%,0-10,0-25,0-4.5,0.05-0.3,0.25-0.3,0.25-0.35,0.25-0.4,0.25-1,1,1-4,1.2-2.5,1.5-3,1.5-5.5,168,19-30,1981,2-5,2-foliate,2-locular,2.2-2.7,20-40,3-6,30-50,4-5,4-6,4.3-15,4.5-6,5-merou,6-11,6-18,7-10,8-19,9.5-28,abaxially,absen,acicular,across,adaxiall,adult,alyx,anvil-shape,apart,articulated,axe,ba,branch,branche,broad-based,broadly,capitat,confined,counted,cross-section,cylindrical,decimetre,directed,distall,distributed,dm,eaf,eed,eglandular,elliptic,exocarp,finger,flower,fruiting,functional,furrowed,geminat,gland-tipped,green,half,heterostylous,interpetalar,juicy,juvenile,lamina,lateral,less,long,longer,lower,margi,mature,mesocarp,mid-point,midrib,midvein,minute,minutely,moderately,moist,nearly,nflorescence,oblique,one,orolla,pair,part,per,placenta,pore,porrect,prickle,rachi,reticulate,ruit,sessile,short,side,spaced,stalked,star,stellae,straight,tal,tamen,tem,thick,thickened,time,tissue,toward,triangular,unarme,unarmed,unbranched,unit,upper,vary,vein,wide,yellowish,ymon,ympodial	adhesion,arrangement,capitate,climate,colour,corolla,form,glandular,growth,height,history,life,na,number,ovary,position,presence,pubescence,reproduction,rugulose,shape,size,staman,stem,texture
482	wfo-0001029310	success	216	120	90	126	30	0.417	-16,-25,0.2-0.3,0.6-1.1,1-1.5,1.2-1.5,1.8-3,10-13,10-15,15-20,2-3.5,2-4,3-4,3.5,4-8,5-12,5-6,5-7,6-8,7-12,8,abaxially,acute,andromonoecious,anther,apex,apically,base,berry,blade,brown,calyx,cm,connivent,cordate,dark,deltate,diameter,dull,elliptic,equal,flattened-reniform,flower,fruit,glabrescent,hair,herb,lateral,leaf,length,lobe,lobed,long,long-styled,lower,margin,maturity,mauve,membranous,midpoint,mm,narrow-deltate,ornately,pedicel,peduncle,petiole,pinnatifid,plant,poricidal,ray,short-styled,shrub,simple,smooth,sparsely,spherical,spreading,stellate,stellate-pubescent,stem,stout,style,surface,tapering,tip,toward,truncate,tube,wide,yellow	.1,.5,.6,/4,/6,0-20,0-5,0.1-0.2,0.2-0.8,0.5,0.5-3,00,1,1-2,1-4,1/,10,10-20,2.5-6,2/3-3/4,20-40,20-60,200-500,3-5,4-10,45-60,5,5-10,5-20,5-30,5-8,5-merous,7-13,accrescent,alyx,ame,apar,apart,apparently,articulated,bark,beyond,branched,c.,concolorous,conical,difoliate,distal,distance,drying,eaf,eed,elongating,enclosing,erect,extending,filament,filifor,free,fruiting,geminat,gently,glabrous,gray,hermaphrodite,heterostylous,inflated,infructescence,lobing,lon,longer,lowermost,mature,midvein,minute,moderately,nflorescence,older,one,open,orange-green,orolla,oung,pair,pendent,pendulous,per,pericarp,perpendicular,porrect,portion,prickl,prickle,prickly,primary,recurved,red-brow,retrorse,ruit,scar,secondary,sessile,shorter,side,sometimes,spaced,stalk,stalked,staminat,straight,strongly,tamen,terete,tertiary,time,tissue,trichome,unit,variously,vary,vein,venation,visible,way,woody,ympodial	1/3,adhesion,arrangement,climate,colour,corolla,filiform,form,glandular,growth,height,history,inflorescence,life,na,number,ovary,perennial,position,presence,present,pubescence,reproduction,seed,shape,size,staman,stigma,stipe,texture
483	wfo-0001029317	success	151	98	63	88	35	0.417	0.5,0.5-0.75,0.5-1,0.8-1,1,1-1.5,10-16,2-3,2.5-5,7-8,8-9,acuminate,anther,apex,area,attenuate,base,broadly,ca,calyx,cm,corolla,cup-like,deltoid,densely,dia,glabrous,grayish,inflorescence,leaf,lobe,lobed,long,margin,minutely,mm,narrowly,nearly,opposite,ovary,ovate,paler,papillose,pedicel,petiole,poricidal,probably,pubescent,rounded,shrub,size,slightly,sparsely,stem,stigma,style,thickened,tip,trichome,tube,uniseriate,white,x	.5,0.25,1.5-3.5,10-30-flowered,11-14,6-8,6.5-11,along,anthesi,apar,barely,beneath,brow,bud,channeled,closely,deciduou,deflexed,denser,differing,difoliate,dry,eaf,edicel,eed,ellipsoi,epidermi,erect,exserted,extreme,filament,free,frui,fruiting,geminate,glabrate,globose,immature,known,lateral,like,lon,lower,main,major,middle,minor,nflorescence,occasionally,often,older,one,otherwise,overlapping,ovoid,pair,pore,portion,prominent,proximal,rachi,raised,reflexed,remaining,rest,ruit,scar,shaped,simple,slender,soft,soon,spaced,specimen,straight,styl,tall,tapering,tear-drop,tuft,ud,unit,vein,visible,widest,yellowish,ympodial,young	adhesion,arrangement,blade,brown,climate,colour,diameter,form,fruit,glandular,growth,hair,height,history,length,life,midpoint,na,number,peduncle,perennial,plant,position,presence,pubescence,ray,reproduction,rugulose,seed,shape,staman,stellate,stipe,surface,texture
484	wfo-0001029332	success	197	110	80	117	30	0.406	0.15-0.2,0.5-1,1-2,1-4,1.3-1.5,1.5-2,1/2,2,2-2.5,2.5-3.5,2.8-3.7,2/3-3/4,3-4,3-6,3.5-5,5-8,6-8,8.5-9.5,abaxially,andromonoecious,anther,apex,apically,base,berry,blade,calyx,chartaceous,cm,connivent,cordate,diameter,equal,erect,flattened-reniform,fruit,glabrescent,glabrous,lateral,leaf,length,lobe,lobed,long,lower,margin,maturity,mauve,midpoint,mm,narrow-deltate,orange-brown,ovate,pale,pedicel,peduncle,petiole,plant,poricidal,ray,rounded,scandent,shrub,simple,smooth,spherical,spreading,stellate,stellate-pubescent,stem,style,tapering,terminal,tip,tube,upper,way,weakly,wide,yellow	-5,.5,/3,0,0-0.5,0-100,0-2,0-20,0-4,0-5,0.1,0.1-0.2,0.15-0.25,0.8-1,1-1.5,1-3,1/3,1/4,1/4-1/3,10-30,2-4,2/,4-10,4-15,5-6,5-merous,abaxial,adaxial,alyx,apar,apart,apparently,articulated,bark,becoming,broad-deltate,concolorous,conical,curved,densely,difoliate,distal,distance,drying,eaf,eed,elongating,extending,filament,flattened,flower,free,fruiting,geminat,gland,globular,grayi,herbaceous,hermaphrodite,heterostylous,infructescence,less,long-acuminat,long-styled,longer,lowermost,mature,midvein,moderately,nflorescence,often,older,one,open,orolla,oung,pair,pendulous,per,pericarp,porrect,portion,prickl,prickle,prickly,primary,pubescent,reduced,ruit,scar,sessile,short-styled,shorter,side,slender,spaced,stalk,stalked,staminat,subsessile,surface,tamen,terete,tertiary,time,trichome,unbranched,unit,variously,vary,vein,venation,visible,woody,yellow-green,yellow-orange,ympodial	2/3,8,adaxially,adhesion,arrangement,climate,colour,corolla,form,glandular,growth,hair,height,inflorescence,long-acuminate,na,number,ovary,position,presence,present,pubescence,reproduction,seed,shape,size,staman,stigma,stipe,texture
485	wfo-0001029333	success	155	107	75	80	32	0.484	.5,/4,0.5,0.7-1,1-1.2,1-1.5,1-15,1-3,1-7,1.5-2.5,1.5-3,17-26,2-2.5,5-6,8-15,abaxially,acuminate,acute,adaxially,anther,apex,base,broadly,calyx,clavate,cm,conical,corolla,dendritic,dendritic-pubescent,densely,dia,elliptic-obovate,flattened-reniform,glabrous,globose,green,leaf,lobe,lobed,long,long-styled,margin,minutely,mm,obovate,opposite,ovary,pale,pedicel,petiole,pitted,pubescence,pubescent,reddish-brown,sessile,shape,shaped,shining,short-styled,shrub,size,small,stem,stigma,style,surface,tear-drop,tree,triangular,trichome,truncate,tube,way,wide	.25,0.5-1,1-2,1.5-2,10-15-flowered,100,3-7,3-7.5,9-13,abaxial,along,anisophyllou,anthesi,auriculate,ba,bark,beige,beneath,berry,contracted,deflexed,denser,differing,difoliate,dry,eaf,edicel,eed,erect,exserted,filament,flower,free,fresh,fruiting,geminate,golden,heteromorphic,incrassate,inflorescenc,lateral,like,lon,lower,main,major,minor,nflorescence,occasionally,older,orbicular,overlappin,pair,paler,papillo,planar,pore,poricidal,portion,present,rest,rounded,ruit,scar,simple,slender,somewhat,spaced,sparsely,strongly,tall,time,tip,type,ud,unit,vein,woody,ympodial,young	adhesion,arrangement,blade,climate,colour,diameter,form,fruit,glandular,growth,hair,height,history,inflorescence,length,life,midpoint,na,number,peduncle,perennial,plant,position,presence,ray,reproduction,rugulose,seed,staman,stellate,stipe,texture
486	wfo-0001029334	success	211	98	74	137	24	0.351	0.15-0.3,1,1-2,1-3,1-6,1.3-4.5,1.5-6,1.8-2.9,2-2.5,2.5-3,4-5.5,4-8.5,5-10,7.5-15.5,8-30,9-12,abaxially,acute,adaxially,almost,anther,attenuate,axillary,brownish,bud,chartaceous,clavate,cm,condition,corolla,densely,diameter,drying,fresh,fruit,glabrous,globose,green,greenish,herb,lanceolate,lobe,long,membranous,minutely,mm,odd-pinnate,orbicular,ovate,ovoid,pedicel,peduncle,petiole,plant,puberulent,pubescent,pure,ripe,seed,size,stellate,stem,stigma,style,subtending,terminal,tinged,tube,violet,white,whitish,wide,x,yellow	.2,0-4,1-10,1.5-3.9,2,2-4,2-5,2-8,3-5,3-7,3.2-5.8,3.3-6.5,5-merou,absent,acumen,ag,along,alyx,among,apart,apex,apparently,articulated,axe,base,berry,blade,borne,broadly,capitat,cell,ciliate,connivent,cordate,covering,cuneate,decreasing,decurrent,digestion,distal,dorsally,eaf,edge,eed,elliptic,end,enzyme,erect,especially,exceeding,except,filament,flat,flower,folded,forked,geminat,generally,glabrou,gradually,grassland,greatly,green-white,hair,hair-like,half,homostylous,honeycomb-shaped,interjected,lateral,leaflet,lengthening,like,living,low-growin,lower,make,margin,middl,midrib,mucilaginous,narrowly,nflorescence,oblique,obtuse,often,orolla,pair,perfect,petiolulate,petiolule,plurifoliate,pore,poricidal,proximal,rarely,reduced,removed,rounded,ruit,semi-rosette,sessile,seudostipule,shady,short,singly,situation,slightly,slit,spaced,specimen,stamen,ste,stolo,straight,subequal,subsessile,sunny,tall,tamen,tem,testal,thick,throughout,tip,toward,tri-,tuber,typically,unit,unwinged,usually,vary,wall,wet,woodland,ympodial	adhesion,arrangement,calyx,capitate,colour,form,growth,height,history,inflorescence,leaf,length,life,na,ovary,perennial,position,pubescence,reproduction,rugulose,shape,staman,surface,texture
487	wfo-0001029340	success	286	115	75	211	40	0.262	1-2,2,4,abruptly,acute,anther,apex,base,blade,bluish,bright,brown,calyx,capitate,cm,conical,connivent,cordate,curved,densely,depressed-spherical,diameter,expanded,flattened-reniform,fruit,glabrous,gland,glandular,green,hair,lanceolate,lateral,leaf,lobe,lobed,long,margin,midpoint,minute,mm,narrowed,narrowly,orange-yellow,pale,pedicel,peduncle,petiole,pilose,purple,ray,shiny,shrub,simple,size,soft,soft-pilose,somewhat,spherical,spreading,spreading-pilose,stellate,stem,stigma,stipitate,style,suborbicular,surface,thin-textured,tinged,tough,tube,variously,wide,yellow,yellowish	'',-celled,.05,.2,.2–1.6,0,0.15–0.6,0.2–0.5,0.4,0.5,0.5–2,0.5–2.5,0.8–3.2,0–,1,1.2–2.0,1.2–2.2,1.4–1.8,1.5-3,1/2,1/4,10,100,13–15,1–,1–1.2,1–2,1–2-celled,2.5,20,2–10,2–2.2,2–3,2–3.2,2–5-celled,2–8,3,3.5–5.5,3–3.5,3–5-celled,3–5.3,3–6-celled,3–7,4–4.5,4–8,5,5-merous,5°,5–12,8–12.5,8–17,9–20,>,``,abaxial,abaxially,absent,acicular,adaxial,age,almost,alyx,angle,anthesi,apical,apicall,armed,around,articulated,ba,basal,becoming,berry,bilobed,branched,broad-based,coarse,column,compressed,concentrated,curving,cylindrical,darker,developin,difoliate,directed,duller,eaf,eed,elongate,embedded,equal,evenly,exceeding,exceptionally,expanding,extending,falling,fertile,filament,flower,foveolate,free,frui,fruiting,geminat,geminate,gland-tipped,glandular-puberulent,grading,gradually,greater,greenish,held,heterostylous,hyaline,infructescence,irregularly,larger,largest,less,light,like,linea,lon,long-styled,lower,lowermost,main,major,many,mature,maturity,mesocarp,midrib,minutely,mixture,mostly,much,near,nearly,nflorescence,nipple,occasionally,often,one,orange,orolla,oung,ovoid,pair,papillat,per,pericarp,perpendicular,pore,poricidal,portion,prickle,prickly,pulp,rarely,recurved,reflexed,ruit,secondary,senescent,sessile,sharp,short,short-styled,shorter,shrivelling,similar,single,slightly,small,smaller,smooth,soon,sparsely,spongy,ste,stipitate-glandular,stout,straight,strongly,tall,tamen,tapering,terete,thin,tip,tooth,triangular,trichome,twice,two,unarme,unarmed,unbranched,uniseriate,unit,usually,vary,vein,viciously,way,white,whole,ympodial	0.2-0.5,0.5-2,12,3-3.5,3-5.3,3.5-5.5,4-4.5,4-8,5-12,8-12.5,8-17,9-20,adhesion,arrangement,climate,colour,corolla,form,growth,height,history,inflorescence,length,life,na,number,ovary,perennial,plant,position,presence,present,pubescence,reproduction,rugulose,seed,shape,staman,stipe,texture
488	wfo-0001029344	success	147	102	71	76	31	0.483	0.4-1,0.5-1,0.5-1.5,0.5-3,1,1-3,1-6,1.5,1.5-3,1.5-4,10-20,2-4,2-7,4-6,5-12,5-15,absent,acute,anther,apex,base,brown,calyx,chartaceous,ciliate,cm,densely,diameter,dm,drying,elliptic,elliptic-ovoid,entire,filament,flower,fruit,glabrous,globose,hair,herb,immature,linear-lanceolate,lobe,long,margin,maturing,membranaceous,mm,moderately,nearly,oblong,obtuse,one-,pedicel,peduncle,petiole,pubescent,rotate,rounded,semitransparent,sparsely,stigma,straight,style,surface,tube,two-celled,unbranched,white,x,yellow	.5,1-2,1-5,10-35,2-3,2-3-celled,3-10,abaxially,abundant,adaxiall,adaxially,along,axe,berry,beyond,blade,center,connected,cordate,decurrent,dehiscing,denser,difoliate,eaf,edge,eed,emarginat,equal,explosively,exserted,fine,flat,frui,geminat,held,interpetalar,lacking,lower,lying,maturit,mesocarp,nflorescence,notch,obvious,often,orolla,parallel,per,placenta,pressure,pubescen,rachi,radiating,raised,rhizomatous,ridge,ruit,running,shallow,short,slightly,sometimes,stamen,swollen,tal,tamen,tem,tissue,triangular,unit,vary,vein,watery,wid,woody,ympodial	2.5,abaxial,adaxial,arrangement,colour,corolla,form,geminate,growth,height,history,inflorescence,leaf,length,life,na,ovary,perennial,plant,position,pubescence,reproduction,rugulose,seed,shape,size,staman,stem,texture,type,ye
489	wfo-0001029363	success	152	85	63	89	22	0.414	.25,/4,0.1-0.5,0.2-1.1,1-1.2,1.5-3.5,2-6,3-7,4-11,6-7,6-8,anther,base,beneath,berry,bi-lobed,calyx,capitate,cm,corolla,cup-shaped,deep,dia,elliptic,fruit,glabrous,globose,green,greyish,immature,internodal,leaf,lobed,long,maroon,minutely,mm,narrowly,occasionally,opposite,ovary,pedicel,petiole,poricidal,pubescent,shiny,shrub,small,somewhat,stem,stigma,style,surface,tip,tree,trichome,tube,tuft,uniseriate,way,white,white-papillose,wide	.75,0-0.1,0.5,0.5-1,1,1.5-1.7,5-7-flowered,7-10,acuminate,acute,anthesi,apex,axil,ba,bark,becoming,beginning,bud,closely,coroll,deflexed,deltoid,densely,drying,eaf,edge,edicel,eed,erect,except,exsertion,filament,free,fruiting,inflorescenc,known,lamina,larger,later,lateral,lobe,lon,lower,main,margin,mature,meeting,middle,minute,much,near,nflorescence,obtuse,often,older,overlapping,pair,pale,paler,papillo,papillose,pore,portion,prominent,reflexed,ruit,scar,simple,slender,slit-like,spaced,sparse,sparsely,straight,tall,tapering,terminal,thickened,ud,unifoliat,unit,upon,usually,vein,widest,woody,yellowish,ympodial,young	arrangement,colour,diameter,form,growth,height,history,inflorescence,length,life,na,perennial,plant,position,pubescence,reproduction,rugulose,seed,shape,size,texture,unifoliate
490	wfo-0001029364	success	153	110	73	80	37	0.477	0.2-0.5,1-3,1-5,1.5-2,10-27,2,2-6,3-4,4-9,5-9,6-8,?,abaxially,acuminate,adaxially,anther,apex,base,blade,calyx,chartaceous,cm,corolla,cream,cuneate,curled,diameter,distally,elliptic,entire,extra-axillary,finger,fruit,glabrous,gland-tipped,globose,green,greenish,hair,herb,immature,lobe,margin,minutely,mm,moderately,narrowly,nearly,obtuse,ovate,pedicel,peduncle,petiole,presence,puberulent,pubescent,sagittate,shallow,shrub,simple,sparsely,spot,stellate,stigma,strongly,style,tapered,triangular,tube,unknown,white,x,yellow	-2,-3,-6,.5,1,1-,1-4,191.,2-,2-foliat,4-12,5-,5-11,7-9,8-10,8-15,according,acute,aggregate,apart,around,articulated,axe,ba,bitter,blue,cell,center,color,connivent,cylindrical,darker,deep,directed,distall,eaf,ed,fide,filament,flower,free,glandular-puberulen,inserted,long,lower,major,membranaceous,mesocarp,nflorescence,orolla,part,perfect,pore,present,puberulen,rachi,radiu,ripe,ruit,rusby,short-tomentose,shorter,side,small,spaced,stone,tal,tamen,tem,thecae,tightly,time,tomento,truncat,unbranched,unit,vary,vein,wide,ympodial	1-2,2-12,4-6,6,adhesion,arrangement,climate,colour,form,glandular,growth,height,history,inflorescence,leaf,length,life,midpoint,na,number,ovary,perennial,plant,position,pubescence,ray,reproduction,rugulose,seed,shape,size,staman,stem,stipe,surface,texture,truncate
491	wfo-0001029368	success	139	74	50	89	24	0.36	.2,0.5-2,0.9-1,1.5-1.6,1.5-2,1.5-3,1.5-4,11-13,16-25,2-5,2.5-4,5-6,abaxially,anther,broadly,calyx,capitate,cm,conical,corolla,densely,dia,elliptic,fruit,glabrous,globose,green,herb,inflorescence,internodal,lanceolate,leaf,lobe,minutely,mm,opposite,ovary,pedicel,petiole,poricidal,puberulent,shrub,somewhat,stem,stigma,style,tip,tube,white,x	.25,.5,0,?,acuminate,acute,adaxially,along,anthesi,apex,apparently,bark,base,bearing,berry,bitter,borne,breaking,brow,closely,coarse,crumpled,cup,deflexed,distal,eaf,edicel,eed,erect,exserted,few-branched,fide,filament,flattened,flower,free,fruiting,golden,half,indistinct,inflorescenc,known,lamina,lateral,leaving,like,long,lower,main,margi,margin,middle,midrib,minute,nflorescence,non-flower,obtuse,older,one,overlappin,pair,papillo,papillose,parallel,pore,portion,reflexed,rest,ruit,scar,shaped,simple,spaced,straight,strongly,tall,tear-drop,trichome,ud,unifoliat,uniseriate,unit,upper,vein,widest,winged,woody,ympodial,young	arrangement,brown,colour,diameter,form,growth,height,history,length,life,na,peduncle,perennial,plant,position,pubescence,reproduction,rugulose,seed,shape,size,surface,texture,unifoliate
492	wfo-0001029370	success	224	119	86	138	33	0.384	-20,.3,0-35,0.1-0.15,0.5-2.2,1-2,1.5-6,1.8-2.8,1/4-1/3,10-17,12-17,2.5-3.5,3-4,3.5-4,3.5-8,4-7,5.5-7,7-13,8-23,abaxially,almost,andromonoecious,anther,apex,apically,base,berry,blade,broad-deltate,calyx,chartaceous,cm,connivent,cordate,cream,dark,densely,diameter,flattened-reniform,fruit,glabrescent,glabrous,green,herb,lateral,leaf,length,lobe,lobed,long,lower,margin,marking,maturity,mauve,midpoint,mm,moderately,obtuse,orange,orange-brown,ovate,pale,pedicel,peduncle,petiole,plant,poricidal,ray,rotate,rounded,shrub,simple,spherical,stellate-pubescent,stem,style,surface,tapering,tip,tube,way,white,wide,yellow,young	-32,.1,.5,/4,0-10,0-100,0-3,0.1,0.2,0.3,0.5-1,1,1-3,1-4,1.8-2.5,1/3-1/2,10-40,10-50,15-30,2-10,2-20,2-3,2-6,3/,4-6,4-9,5-10,5-12,5-merous,6-15,7-11,8-14,8-20,abaxial,acut,adaxial,alyx,ame,apar,apart,apparently,articulated,bark,basal,branched,c.,clearly,conical,curved,discolorous,distal,distance,drying,eaf,eed,elongate,elongating,equal,erect,extending,fewer,filament,fine,flattened,flower,free,fruiting,fully,gently,greenish,hermaphrodite,heterostylous,infructescence,long-styled,longer,lowermost,mature,midvein,mixture,multangulate,nflorescence,often,older,one,open,opening,ornate,orolla,oung,overlapping,pair,pattern,pendulous,per,pericarp,perpendicular,plurifoliat,porrect,portion,prickl,prickle,prickly,primary,red-brown,reticulate,ruit,scar,sessile,shiny,short-styled,side,slightly,smooth,sometimes,spaced,spreading,stalk,stalked,staminat,stout,straight,strongly,tamen,terete,tertiary,time,trichome,unarmed,unit,variously,vary,vein,venation,visible,white-gra,whitish,woody,ympodial	3/4,acute,adhesion,arrangement,climate,colour,corolla,form,glandular,growth,hair,height,history,inflorescence,life,na,number,ovary,perennial,position,presence,pubescence,reproduction,rugulose,seed,shape,size,staman,stellate,stigma,stipe,texture,ye
493	wfo-0001029373	success	199	90	47	152	43	0.236	6.8,anther,berry,broadly,calyx,clavate,cm,conical,corolla,deltate,densely,diameter,ellipsoid,flattened-reniform,fruit,glabrous,green,growth,hair,herb,internodal,lateral,leaf,lobe,long,mm,moderately,ovary,ovate-lanceolate,pedicel,peduncle,petiole,plant,pubescent,shallowly,shape,stellate,stem,stigma,style,surface,tube,white,wide,yellow,yellow-green,yellowish	.0–1.2,.2,.3,.5,.5–2.0,0.3–0.5,0.4–1.6,0.5–1.2,0.5–1.8,0.6–0.7,1.0–1.2,1.0–1.6,1.2–1.5,1.3–2.2,1.4–3.5,1.5–2.0,1.5–2.5,1.5–2.7,1.8–2.0,1.8–2.3,180°,2-celled,2.0–2.5,2.7–3.0,20–30,2–4-celled,3,3.5–4.0,30–40,3–5,4–5,4–6,5,5-merous,5–6,8–9,abaxial,abaxially,accrescent,acuminate,acute,adaxial,adaxially,age,anthesi,apar,apex,appearanc,appressed,arising,articulated,bark,basal,base,bayonet,beyond,bud,capped,cell,cone,curved,developing,distal,eaf,eed,elongate,enclosed,enclosing,entire,exerted,filament,finger,flower,free,fruiting,fully,geminat,glandular-tipped,globose,grey-brown,half,halfway,hilum,immature,individual,laterally,lengthening,less,like,live,lobed,lon,lower,margin,mature,mesocarp,middle,minute,minutely,mouth,new,nflorescence,node,obtuse,older,outline,pair,papillate,pentagonal,per,perfect,pitted,plurifoliate,pore,poricidal,portion,positioned,primary,reflexed,resembling,root,rounded,ruit,scar,seen,seudostipule,short,simple,slightly,slit,smoot,spaced,spreading,still,straight,tall,tem,terete,testal,thicker-walled,tip,trailing,trichome,tub,ud,uniseriate,unit,upper,vein,woody,ympodial,–5	0.3,0.4-1.6,0.5-1.2,0.6-0.7,1.0-1.2,1.0-1.6,1.2-1.5,1.4-3.5,1.5-2.0,1.5-2.5,1.5-2.7,2.0-2.5,2.7-3.0,20-30,5-6,8-9,adhesion,climate,colour,dioecious,form,glandular,height,history,inflorescence,length,life,midpoint,na,number,perennial,position,presence,present,pubescence,ray,reproduction,rugulose,seed,size,staman,stipe,texture
494	wfo-0001029402	success	113	84	49	64	35	0.434	0.5-1,0.5-2,1-2.5,2,2-3,3-6,4-6,5-25,6-16,7-8,7-9,8-15,acute,apex,base,blade,calyx,ciliolate,cm,connivent,deltate,diameter,elliptic,free,glabrous,hair,lanceolate,lobe,margin,mm,moderately,narrowly,pedicel,peduncle,petiole,pubescence,pubescent,shrub,simple,sparsely,stellate,stigma,style,surface,tapered,tube,unknown,violet,x	11-17,15-30,2-10,3-4,3-5,4-7,4-8,7-11,abaxial,abaxially,acuminate,adaxially,apart,articulated,axe,band,branched,chartaceous,color,cylindrical,denser,directed,distall,eaf,eed,fleshy,flower,forked,glabrate,glabrou,inrolled,leaving,long,lower,many-foliat,narrowed,nearly,nflorescence,nther,often,orolla,papillose,pore,rachi,rachise,radiu,roughened,ruit,scale-like,scar,somewhat,spaced,tal,tem,thickened,time,tip,triangular,truncat,unit,unknow,vary,wide,ympodial	adhesion,anther,arrangement,climate,colour,corolla,form,fruit,glandular,growth,height,history,inflorescence,leaf,length,life,midpoint,na,number,ovary,perennial,plant,position,presence,ray,reproduction,rugulose,seed,shape,size,staman,stem,stipe,texture,truncate
495	wfo-0001029404	success	154	116	87	67	29	0.565	0.5-1,1-4,2,2-3,2-5,2-8,2.5-22,2.5-3,20-35,3-4,3-8.5,5-10,5-20,5-24,5-6,6-8,6-9,6.5-34,abaxially,acuminate,acute,adaxially,anther,apex,apiculate,articulated,auriculate,base,branched,calyx,center,chartaceous,cm,connivent,cordate,cream,dark,darker,deltate,densely,diameter,eglandular,ellipsoidal,entire,flattened,fruit,glabrous,glandular,green,hair,lanceolate,leaving,light,lobe,long,longitudinal,margin,mm,moderately,mottling,orange,ovate,pedicel,pedicellar,peduncle,petiole,pink,puberulent,purple,rachi,remnant,shrub,simple,somewhat,star,stellate,stigma,style,subcoriaceous,toward,tree,tube,unbranched,vein,white,x,yellow	-1.5,-10,-3,-5,0-60-flower,1,1.5-2,15-25,2-4,3-5,4-foliat,8-12,absent,aggregate,apart,ape,axe,basal,beyond,blade,cell,connective,cylindrical,directed,distally,eaf,eed,exserted,fleshy,flower,glandular-puberulen,lemon,less,lon,lower,narrowly,nflorescence,nther,obtuse,orang,orolla,ovoid,perfect,pore,presen,pubescent,radiu,ripe,ruit,shorter,slightly,small,spaced,sparsely,stone,tal,tem,thecae,time,tomento,triangular,truncat,ud,unit,vary,wide,ympodial	arrangement,colour,corolla,form,growth,height,history,inflorescence,leaf,length,life,na,ovary,perennial,plant,position,presence,present,pubescence,reproduction,rugulose,seed,shape,size,stem,surface,texture,tomentose,truncate
496	wfo-0001029406	success	136	92	63	73	29	0.463	0.6-1,0.7-1.5,1-1.5,1-10,1-2,1.5-2.2,2,2-11,2-3,2.5-3.5,28,30,4-18,4-6,anther,arachnoid-pubescent,broadly,brown,calyx,clavate,cm,conical,corolla,dark,deltate,dia,elliptic,glabrous,globose,grayish-brown,grayish-green,green,greenish-white,leaf,lobe,lobed,long,maturity,minutely,mm,often,ovary,ovoid,ovoid-reniform,pedicel,petiole,pitted,poricidal,shiny,shrub,size,slightly,small,stem,stigma,style,surface,tip,tree,tube,waxy,white,wide	.5,0.3-1,0.5-1,1.5-2.5,1.5-5,3-9,7-12,abaxially,acute,adaxially,along,anthesi,apex,arachnoid,ba,bark,base,berry,brownish,bullate,conspicuously,deciduous,deflexed,densely,differing,difoliate,dry,eaf,eed,felt-like,filament,free,fruiting,geminat,impressed,large,lateral,lenticel,lilac,lon,lower,main,major,margin,matted,middle,minor,nearly,occasionally,older,pair,pale,papillo,papillose,planar,pointed,population,pore,portion,pubescent,ruit,shaped,soon,tall,tear-drop,tinge,trichome,unit,vein,widest,woody,ympodial,young	adhesion,alternate,arrangement,colour,diameter,form,fruit,growth,height,history,inflorescence,length,life,na,number,peduncle,perennial,plant,position,presence,pubescence,ray,reproduction,rugulose,seed,shape,staman,stellate,texture
497	wfo-0001029407	success	208	77	61	147	16	0.293	-25,-6,-7,.5,0-5,0.4-0.7,0.5-0.7,0.5-1.5,0.5-2,0.6-0.9,1-1.4,1-4,1-4.5,1.8-2.5,1/5,2.5-3,3-4,3-6,4-15,abaxial,adaxial,anther,berry,bright-red,calyx,chartaceous,cm,densely,diameter,equal,erect,evenly,flattened-reniform,fruit,green,lateral,leaf,length,long,maturity,mauve,mm,moderately,orange,ovate,pedicel,peduncle,petiole,prickle,prickly,shrub,smooth,spherical,stellate-pubescent,stem,style,surface,upper,white,wide,young	-10,-2,-4,/3,0,0-15,0-2,0-4,0.1-0.2,0.1-0.25,0.15-0.4,0.2-0.3,0.4-1,0.6,0.7-1.2,1,1-2,1-3,1.5,1/3,1/3-1/2,1/8-1/5,2-3,2-4,2-5,3.5-4.5,4-9,4.5-6,5-7,5-merous,6-13,6-20,7-8,abaxially,acut,acute,almost,alyx,apar,apart,apex,apically,apparently,articulated,bark,base,blade,brow,connivent,cuneate,curved,dark,deltate,difoliate,discolorous,drying,dull,eaf,eed,elliptic,elongating,entire,filament,flattened,flower,free,fruiting,geminat,geminate,glabrescent,glabrous,gray-greenish,green-brown,infructescence,lengt,lobe,lobed,longer,lower,margin,mature,midpoint,nflorescence,obtuse,occasionally,older,one,open,orange-brown,orolla,oung,pair,pale,pendulous,per,perfec,pericarp,poricidal,porrect,portion,prickl,primary,pubescent,rarely,ray,recurved,reflexed,rounded,ruit,scar,sessile,shorter,side,simple,slender,sometimes,spaced,sparsely,spreading,stalk,stalked,stellate,stout,straight,straw-yellow,strongly,tamen,tapering,terete,tertiary,thick,time,tip,trichome,tube,unbranched,unit,vary,vein,venation,visible,way,weakly,woody,yellow,yellow-green,ympodial	adhesion,colour,corolla,form,growth,height,inflorescence,ovary,plant,position,pubescence,seed,shape,size,staman,texture
498	wfo-0001029408	success	244	112	89	155	23	0.365	0,0.2-0.3,0.7-1.2,0.9-1.3,1-8,1.1-1.5,1.4-1.9,1.6-2.8,1.7-2.4,11-31,2-12,2-4,2-5,2.2-3.7,2.5-7,4-14,4-20,5-24,5-6.5,abaxially,acute,adaxially,anther,becoming,blunt-tipped,broadly,brown,calyx,clavate,cm,conical,corolla,deltoid,diameter,elliptic,fleshy,fruit,glabrous,globose,gray,growth,honeycombed,inserted,lanate,lanceolate,lateral,leaf,length,lilac,lobe,mm,moderately,mostly,oblong,ovate,pale,pedicel,peduncle,perfect,persistent,petiole,plurifoliate,pseudo-terminal,pubescent,purplish,rarely,rather,reniform,reticulate-punctate,ripe,rotate-stellate,shrub,small,stelliform,stem,stigma,style,subcampanulate,suborbicular,thick-textured,tomentose,tree,tube,velutinous,white,whitish,x,yellow,yellowish	-1.5,-10.5,-4.5,.2-3.5,/10,0-100,0.3-5,0.5-2.5,0.9-1.6,1.5-3,1.8-3.5,1/2,1/2-3/4,1/4,2-3.5,2/3,3-5,3.5-5,4-7.5,5-6,5-8,5-merou,7-12,accrescent,acuminate,adaxiall,ag,alyx,anthesi,apart,apex,apical-lateral,articulated,axe,axillary,ba,barely,bark,base,berry,blade,branch,branched,bud,capitat,chartaceous,continued,cuneate,dark,decurrent,dehiscing,dendritic-echinoi,dendritic-multangulate,densely,develope,directed,distal,distall,due,eaf,echinoi,echinoid,eed,entire,exserted,extend,faintly,few-rayed,filament,flower,free,fruiting,green,hair,high,homostylous,indument,interpetalar,introrse,lacking,large,lobed,long,long-,long-attenuate,long-stalked,longitudinal,lower,m.,main,many,margin,midvein,mixed,multangulate,near,nearly,nflorescence,obscured,obtuse,often,older,orbicular,orolla,ovate-lanceolate,overlapping,part,partly,pore,porrect-stellate,present,rachi,ray,relatively,ribbed,ruit,runk,sessile,short-,short-attenuate,short-stalked,side,simple,slightly,slit,sometimes,spaced,stamen,subovate,suture,tamen,terete,testa,thick,thick-stalked,thin-stalked,time,tissue,tomentu,tomentum,top,touching,toward,turbinate,unarme,unarmed,unit,usually,vary,vein,way,well,wide,ympodial,young	adhesion,arrangement,capitate,colour,form,height,history,inflorescence,life,na,ovary,perennial,plant,position,pubescence,reproduction,rugulose,seed,shape,size,staman,surface,texture
499	wfo-0001029417	success	213	119	95	118	24	0.446	.5,0.2-0.6,0.7-3,1-2,1.3-8,1.5-1.8,1.5-8,2.5-10,2.8-3.5,3-5,4-7,5-15,8-15,8-9,abaxially,adaxially,along,anther,attenuate,axillary,blue,broadly,brownish,bud,chartaceous,clavate,cm,coarsely,condition,corolla,dark,deep,diameter,dot,drying,erect,especially,fresh,fruit,glabrous,globose,green,greenish,hair,herb,lanceolate,like,linear,lobe,long,medium,membranous,midrib,minutely,mm,moderately,narrowly,non-glandular,odd-pinnate,often,orbicular,ovate,ovoid,pedicel,peduncle,pentagonal,petiole,pilose,plant,puberulent,pubescent,purple,rarely,ripe,rotate,scattered,seed,size,slightly,sometimes,stem,stigma,style,subtending,terminal,tinged,trichome,tube,typically,violet,white,whitish,wide,x,yellow	0-7,0.4-8,1,1-1.5,1-10,1-4,1-8,1.5-10,12,2-4,3-14,5-merou,6-11,acumen,acuminate,acute,ag,alyx,apart,apex,apiculate,apparently,articulated,axe,base,basiscopic,berry,blade,borne,capitat,cell,central,ciliate,connivent,covering,decreasing,decurrent,digestion,distal,dorsally,eaf,edge,eed,end,enzyme,erec,exceeding,filament,flat,flower,folded,forked,geminat,generally,glabrou,greatly,green-white,hair-like,hal,half,homostylous,honeycomb-shaped,interjected,lateral,leaflet,lengthening,living,lower,lunate,make,margin,minute,mucilaginous,nflorescence,orolla,pair,perfect,petiolulate,plurifoliate,pore,poricidal,rapidly,removed,rounded,ruit,sessile,seudostipule,short,short-petiolulate,side,singly,slit,spaced,specimen,stamen,star,ste,stolo,straight,subequal,tall,tamen,tem,testal,thick,throughout,tip,tri-,tuber,unit,unwinged,usually,vary,wall,wet,widely,wing,ympodial	adhesion,arrangement,calyx,capitate,colour,form,growth,height,history,inflorescence,leaf,length,life,na,ovary,perennial,position,pubescence,reproduction,rugulose,shape,staman,surface,texture
500	wfo-0001029437	success	198	128	101	97	27	0.51	1,1-1.5,1-3,1.5-2,10-12,2-3,2.5-3.5,2.5-5,3-3.5,3-5,5-9,6-8,7-10,acute,anther,apex,axi,basal,base,beige,berry,blue,branched,brownish,calyx,chartaceous,clavate-truncate,cm,cordate,coriaceous,corolla,dark-green,diameter,elliptic,elliptic-lanceolate,entire,flattened,flower,glandular,globose,green,growth,heterostylous,hirsute,inflorescence,internodal,irregularly,lamina,leaf,like,linear-oblong,lobe,lobed-angulate,long-styled,margin,maturity,membranous,midpoint,mm,oblong,oblong-lanceolate,orange,ovary,ovate,ovate-elliptic,pedicel,peduncle,persistently,petiole,plant,pubescence,pubescent,reniform,rest,rounded,rusty,shrub,similar,simple,stellate,stellate-pubescent,stem,stigma,style,subcordate,subglobose,suborbicular,subscabrous,subulate,surface,tapering,tomentose,trichome,tube,velutinous,villous,violet,visible,woody,x,¼	-10,.5,0.5-1,1-2,1/3,3-7,30-50,4-5,9-13,abaxially,acicular,adaxially,anthesi,antrorse,apar,apical,armed,articulated,bark,brow,c.,compressed,cylindrical,densely,distal,eaf,eed,eglandular,enclosed,erect,except,filament,free,fruiting,glabrescent,glabrous,gland,golden,greyish,juvenile,leaving,lengthening,lobed,long,loose,lower,minute,minutely,multangulate,multicellular,near,nearly,new,nflorescence,obverse,older,ovoid,packed,papillo,per,perfect,pericarp,plurifoliat,pore,poricidal,porrect,portion,prickle,prickly,recurved,reticulate,rotate,ruit,scar,sessile,short-styled,slit,spaced,sparsely,stalked,staminate,subscandent,tall,testa,thick,tip,triangular,ud,unarmed,unevenly,unicellular,unit,upper,whitish,without,yellow,ympodial	adhesion,arrangement,blade,climate,colour,form,fruit,hair,height,history,length,life,na,number,perennial,position,presence,present,ray,reproduction,rugulose,seed,shape,size,staman,stipe,texture
501	wfo-0001029440	success	218	134	104	114	30	0.477	-10,0.5-0.6,0.9-1,1,1-1.2,1-1.5,1-2,1.5-2,2-2.5,2-3,2-4,2-6,2.5-7,4-6,5-15,5-5.5,6.5-8,8-10,>,abaxial,across,acute,adpressed,anther,apex,armed,articulate,base,beige,bicolorous,blade,brown,calyx,canaliculate,clavate,cm,coriaceous,curved,deeply,diameter,enlarged,entire,ferruginous,flower,fruit,glabrous,glandular-pubescent,glandular-stellate,glandular-tipped,globose,lanceolate-attenuate,leaf,leathery,length,lobe,lobed,long,minutely,mm,oblong-elliptic,oval-elliptic,papillose,parted,pedicel,peduncle,perennial,perfect,petiole,plant,prickle,rarely,ray,reddish,rounded,rugose,scabrous,shiny,shrub,similar,slender,small,solitary,staminate,stellate,stellate-glandular,stem,stigma,straight,strigose,style,sub-coriaceous,sub-truncate,subcampanulate,subreniform,subsagittate,surface,terete,terminal,triangular,trichome,tube,white,wide,within	0.2-0.3,0.3-1,1-2-celled,1-nerved,2,20,30,4-5,4-6-forked,4-8,5-6,5-merous,9-10,9-12,<,accrescent,acicular,along,alyx,anthesi,ape,apical,bark,basal,branch,brow,caly,central,compressed,cyme,dark,dark-green,deciduous,distal,eaf,eed,elongate,enclosed,epicarp,equal,erect,exceeding,exserted,filament,finely,floral,free,fruiting,functional,fused,geminat,glabrescent,gynoeci,held,indument,lanate,leaving,longer,lower,midrib,mucilaginous,nflorescence,numerous,oblong-lanceolate,obver,older,orolla,part,partially,peg,persistent,petiol,plurifoliate,pore,porrect-stellate,primary,prominent,rachi,recurved,reduced,reflexed,reticulated,ruit,secondary,sepal,sessile,short,somewhat,sparse,sparsely,stalked,stamen,stiff,strongly,sub-terete,surfac,tall,tamen,testa,tomentose,touch,tri-,unarmed,unit,upright,vary,vein,velutinous,without,yellowish,ympodial,young,¼,¾	adhesion,arrangement,climate,colour,corolla,form,glandular,growth,hair,height,history,inflorescence,life,margin,midpoint,na,number,ovary,position,presence,present,pubescence,reproduction,rugulose,seed,shape,size,staman,stipe,texture
502	wfo-0001029461	success	217	120	90	127	30	0.415	-1.5,-14,-3,-3.2,-4.5,-5,0.1,0.1-0.25,0.6-1,1-1.6,1.2-1.8,1.3-2.2,1.5-,1/3,2-2.4,2-2.8,2-3,2-4,2.5-3,4-10,4-6.5,4.5-7,8-9,abaxially,almost,andromonoecious,anther,apex,attenuate,base,becoming,berry,black,blade,broad-deltate,brown,calyx,chartaceous,cm,cuneate,densely,diameter,elliptic,erect,evenly,flattened-reniform,fruit,green,leaf,length,lobe,lobed,long,margin,maturity,mauve,midpoint,mm,moderately,oblong,orange,ovate,pedicel,petiole,plant,poricidal,ray,rounded,shiny,shrub,simple,smooth,sparsely,spherical,staman,stellate,stellate-pubescent,stem,style,subentire,surface,tip,tube,unequal,upper,weakly,wide,yellow,young,zygomorphic	-2,-3/4,-4,.5,0,0.15-0.25,0.7-1,0.8,0.8-1.5,1-,1-2,1-3,1-4,1-6,1.2-1.7,1.5-2,1/3-2/3,1/4,1/4-1/2,3-20,3-6,4-7,4.7-7.2,5-10,5-25,5-merous,7-10,7-12,acuminat,alyx,ame,apart,apically,bark,breaking,brittle,c.,cell,concolorous,curved,dark,discolorous,distal,distance,drying,dull,eaf,eed,elongating,extending,faint,fifth,filament,fine,flattened,flower,four,free,fruiting,glabrescent,glabrous,gra,hermaphrodite,heterostylous,infructescence,lengt,long-styled,longer,lower,lowermost,mature,midvein,obovate,obtuse,older,orolla,oung,outline,pair,pendulous,per,pericarp,pit,plurifoliat,porrect,portion,prickl,prickle,prickly,primary,raised,reddish,reduced,reflexed,ruit,sessile,shallow,short-styled,shorter,side,slender,slightly,small,sometimes,spaced,spreading,stalk,stalked,staminat,straight,strongly,tamen,terete,tertiary,time,trichome,unarme,unarmed,unit,variously,vary,vein,venation,visible,way,woody,ympodial	adhesion,arrangement,climate,colour,corolla,form,glandular,growth,hair,height,history,inflorescence,life,na,number,ovary,peduncle,perennial,position,presence,present,pubescence,reproduction,rugulose,seed,shape,size,stigma,stipe,texture
503	wfo-0001029462	success	166	103	76	90	27	0.458	-4,0.5-1,0.5-2,1-3,1-6,1.5-2,1.5-7,10-,15-25,2-6.5,2.5-3.5,2.5-5.5,3-18,3-4,5-30,6-9,7-8,abaxially,acuminate,acute,adaxially,apex,base,calyx,campanulate,chartaceous,cm,connivent,cuneate,dark,densely,diameter,ellipsoidal,elliptic,entire,flattened,fruit,glabrous,green,lanceolate,laterally,light,lobe,longitudinal,margin,membranaceous,minutely,mm,moderately,occasionally,ovate,pedicel,peduncle,petiole,puberulent,pubescent,pubescent-pilose,purplish,reticulate,rounded,simple,somewhat,sparsely,stellate-,stigma,stripe,style,tip,tree,triangular,truncate,tube,unbranched,white,x,yellow	-2,-30,-5,1,1-,1-2,1.5,1.5-3,10-22,2-3,20-35,3,3-27,3-5,3-6,3-7,4-15,4-20,4-foliat,7-19,8-9,abruptly,absent,aggregate,apart,ape,articulated,axe,basal,beyond,blade,broad,cell,ciliate,connective,constricted,curled,cylindrical,dentate,directed,eaf,eed,eglandular,equal,exceeding,exserted,flower,hair,leaving,lon,long,lower,m.,narrowly,near,nflorescence,nther,obtuse,often,orolla,oval,ovoid,pedicellar,perfect,pore,pubescent-pilo,purpl,rachi,radiu,remnant,ruit,shorter,slightly,small,smooth,spaced,stamen,stone,tal,tem,thecae,time,tomentose,truncat,ud,unit,vary,wide,without,ympodial	anther,arrangement,colour,corolla,form,growth,height,hermaphroditic,history,inflorescence,leaf,length,life,na,ovary,perennial,plant,position,pubescence,reproduction,rugulose,seed,shape,size,stem,surface,texture
504	wfo-0001029464	success	235	107	88	147	19	0.374	.9,0-80,0.2-0.5,0.8-2,1/4,1/4-1/2,10-23,10-40,2-3.5,2.2-2.5,2.4-4,2.5-5,2.9-3.2,3-20,3-7,5.5-6,5.5-7.5,6-15,7-10,9-15,abaxially,annual,anther,base,black,brown,calyx,chartaceous,cm,connivent,curved,dark,diameter,ellipsoid,equal,erect,flattened-reniform,flower,fruit,glabrescent,globular,green,herb,lateral,leaf,length,lobed,long,long-styled,lower,maroon,maturity,mauve,mm,moderately,mottled,oblong,orange-brown,ovate,ovoid,pedicel,peduncle,pink,plant,poricidal,purple,short-styled,simple,smooth,sometimes,sparsely,stellate,stellate-pubescent,stem,striped,style,tapering,terminal,tip,tube,upper,usually,variously,way,white,wide,yellow-orange,young	-2/3,-3,-30,-5,0,0-2,0.2,0.2-0.7,0.3-0.7,0.3-1,0.5,0.5-2,00-200,1,1-10,1-3,1-8,1.2-3,1.5-2,1/,1/4-1/3,10-15,10-50,12-50,2,2-3,2-4,2.5-8,3-5,3.5-5,4-7,4-8,4-8-merous,5-17,5-8,8-13,8-15,abaxial,acicular,acute,adaxial,alyx,ame,andromonoecious,apar,apart,apex,apically,apparently,around,articulated,bark,berry,blade,branched,broad,broad-deltate,brow,c.,cordate,cultivar,cup-shaped,deltate,difoliate,discolorous,distal,distance,drying,eaf,eed,elongated,elongating,extending,filament,free,fruiting,fully,geminat,glabrous,glaucous,green-brown,hair,hermaphrodite,heterostylous,infructescence,less,lobe,long-acuminat,longer,lowermost,margin,mature,midpoint,midvein,minute,narrow-deltate,nflorescence,obtuse,occasionally,often,older,one,open,opening,orolla,oung,pair,pendent,pendulous,per,pericarp,petiole,porrect,portion,prickl,prickle,prickly,primary,ray,red-brown,rounded,ruit,scar,sessile,side,spaced,spreading,stalk,stalked,staminat,straight,surface,tamen,terete,tertiary,time,translucent,trichome,unarmed,unit,vary,vein,venation,visible,woody,yellow-green,ympodial	1/2,adhesion,arrangement,colour,corolla,form,growth,height,inflorescence,na,ovary,position,pubescence,seed,shape,size,staman,stigma,texture
505	wfo-0001029505	success	169	103	75	94	28	0.444	.1,0-0.3,0.15-0.2,0.2-0.3,0.3-0.5,0.5-1.1,1-1.2,1-3,2-4,2.4-3.2,2.7-4,4.5-5.5,5-7.5,5.5-7,6-18,6-8,7-8,absent,adaxially,andromonoecious,anther,apex,base,blade,brown,calyx,chartaceous,cm,deltate,densely,diameter,elliptic,elliptical,entire,extra-axillary,fruit,glabrous,gland-tipped,globose,green,hair,inflorescence,juicy,length,lobe,long,margin,midpoint,mm,moist,obtuse,ovate,pale,pedicel,peduncle,perennial,petiole,plant,present,prostrate,ray,red,rotate-stellate,short,shrub,simple,sparsely,stellate,stellate-pubescent,stoloniferous,style,tube,white,x,yellow	%,.05,0-10,0-3,0-3.5,0.15-0.25,0.8-1,1-6,1-locular,1.5-2.2,2-5,2-7,22-25,5-merou,7-12,7-20,8-10,abaxially,absen,acicular,across,adaxiall,adult,alyx,apart,articulated,axe,ba,branche,confined,cross-section,cuneateor,cylindrical,decimetre,directed,distall,eaf,eed,elliptica,exocarp,finger,flower,fruiting,functional,half,heterostylous,incomplete,lamina,lateral,less,longer,lower,mature,mesocarp,midrib,midvein,minute,moderately,nflorescence,oblique,onl,orolla,part,per,placenta,pore,porrect,prickle,pseudo-racemose,ruit,semi-circular,septum,sessile,solitary,spaced,stellae,straight,tal,tamen,tem,thick,throughout,time,transparent,unarme,unarmed,unbranched,unit,unknow,vary,weakly,wide,yellowish,ympodial	adhesion,arrangement,climate,colour,corolla,cuneate,form,glandular,growth,height,history,leaf,life,na,number,ovary,position,presence,pubescence,reproduction,seed,shape,size,staman,stem,stigma,stipe,texture
506	wfo-0001029524	success	212	133	103	109	30	0.486	-5,-6,-8,.5,0.1-0.3,0.7-0.8,1-,1-2,1-3,1.2-1.5,1.5-2,12-25,2-,2-2.5,2-4,3-,3-3.5,3-8,4-4.5,4-6,4-7,5-15,6-7,7-9,acicular,acuminate,acute,angulate,anther,apex,base,beige,calyx,campanulate,cm,corolla,diameter,eglandular,entire,flattened,flower,foliaceous,glandular,glandular-hirsute,globose,green,growth,internodal,lanate,linear-oblong,lobe,lobed,long,long-styled,margin,maturity,membranous,midpoint,mixture,mm,oblique,obtuse,ovary,ovate,ovate-elliptic,ovate-lanceolate,pedicel,peduncle,petiole,plant,prickle,pubescence,reniform,rounded,rusty,short-styled,shrub,size,slightly,somewhat,stellate,stem,stigma,style,sub-cordate,subcordate,subcoriaceous,suborbicular,subscabrous,subspherical,surface,tapering,tiny,triangular-lanceolate,trichome,tube,unarmed,villous,viscid,white,woody,x,yellowish	0.2-0.3,0.9-1.2,1-1.5,10,2-3,25,6,9-10,abaxially,adaxially,adult,anthesi,articulated,bark,basal,berry,branched,brown,cell,channelled,clavate-truncat,congested,corymbose,cyme,decumbent,densely,discolorous,distal,distall,doubling,eaf,eed,elongating,erec,erect,exceeding,exserted,filament,filamentous,flexuous,flowering,free,fruiting,glabrescen,glabrous,grey,heterostylous,impressed,leaving,light,like,long-stalked,loosely,lower,m.,minute,multicellular,new,nflorescence,numerous,oblong,oblong-lanceolate,obverse,occasionally,older,one,partially,perfect,pericarp,plurifoliat,pore,poricidal,porrect,portion,prickly,pubescent,recurved,reticulate,rugose,ruit,scar,sessile,single,slit,spaced,sparsely,stalked,staminate,stellate-pilose,stellate-pubescent,subbsessile,tall,testa,time,tip,tomentose,turbinate,ud,unevenly,unit,upper,vein,velvety,venation,way,yellow,yellow-green,ympodial,¾	adhesion,arrangement,blade,clavate-truncate,climate,colour,form,fruit,hair,height,history,inflorescence,leaf,length,life,na,number,perennial,plurifoliate,position,presence,ray,reproduction,rugulose,seed,shape,staman,stipe,texture,ye
507	wfo-0001029546	success	203	115	90	113	25	0.443	0.3-1,1-2,1-4.5,1.5-2,1.5-6.2,2.2-2.8,3.5-5,4-10,4.5-12.5,5-8,7-10,8-17,8-19.5,abaxially,adaxially,anther,apiculate,articulated,attenuate,axillary,blue,broadly,brownish,bud,chartaceous,clavate,cm,condition,corolla,covered,densely,diameter,dot,drying,elliptic,frequently,fresh,fruit,glabrous,glandular,globose,green,greenish,hair,herb,lanceolate,leaf,like,lobe,long,longer,membranous,minutely,mm,nearly,non-glandular,odd-pinnate,often,orbicular,ovate,ovoid,pedicel,peduncle,pentagonal,petiole,plant,pubescent,purple,rarely,ripe,rotate-pentagonal,seed,short,simple,size,slightly,soft,sometimes,stem,stigma,style,subtending,terminal,tinged,trichome,tube,white,whitish,x,yellow	0-2,1-10,1-3.2,1-5,1.6-6.5,2-4,2-9,3-8,4.5-7,5,5-10,5-18,5-merou,6.3-19.5,8,absent,acumen,acuminate,acute,adaxiall,ag,alyx,apart,apex,apparently,axe,base,berry,blade,capitat,cell,connivent,cordate,covering,curved,decreasing,decumben,decurrent,digestion,distal,dorsally,eaf,edge,eed,elliptical,enzyme,erect,exceeding,filament,flat,flower,folded,forked,geminat,generally,glabrou,greatly,green-white,hair-like,half,homostylous,honeycomb-shaped,interjected,lateral,leaflet,lengthening,living,lower,lunate,make,middl,mottle,mucilaginous,nflorescence,oblique,pair,perfect,petiolule,plurifoliate,pore,poricidal,rachi,regular,removed,ruit,sessile,seudostipule,slit,spaced,specimen,stamen,ste,straight,subequal,tall,tamen,tem,testal,thick,throughout,tip,tri-,truncate,typically,unit,unwinged,usually,vary,wall,wet,wide,wing,ympodial	adhesion,arrangement,calyx,capitate,colour,form,growth,height,history,inflorescence,length,life,middle,mottled,na,ovary,perennial,position,pubescence,reproduction,rugulose,shape,staman,surface,texture
508	wfo-0001029552	success	161	113	79	82	34	0.491	0.1-0.5,0.5,0.6-1,1-1.3,1-1.5,1-3,1-5,1.5-2,10-20,12,2-2.5,2.5-3,5.5-8,abaxially,acuminate,acute,adaxially,along,anther,apex,area,base,broadened,broadly,calyx,cm,conical,corolla,deltate,dendritic,densely,dia,elliptic,flattened-reniform,glabrous,globose,green,incrassate,inflorescence,leaf,lobe,lobed,long,long-styled,main,margin,minutely,mm,nearly,opposite,ovary,pale,paler,pedicel,petiole,pitted,poricidal,pubescent,shape,shining,short-styled,shrub,size,small,sparsely,stem,stigma,style,surface,tan,tip,tree,tree-like,trichome,tube,vein,white,wide,x	.25,.5,1-2,1.5-6.5,2-9,5-10-flowered,6-9,abaxial,abruptly,anthesi,bark,berry,branched,clavate,closely,contracted,decurrent,deflexed,denser,differing,difoliate,drying,eaf,edicel,eed,erect,exserted,filament,flower,free,fruiting,geminat,greyish-brow,heteromorphic,inflorescenc,lamina,later,lateral,like,lon,lower,major,middle,minor,minute,nflorescence,occasionally,older,onto,orbicular,overlappin,pair,papillo,persistent,planar,pore,portion,present,reflexed,rest,rounded,ruit,scar,scattered,shaped,simple,slender,slightly,somewhat,spaced,strongly,swollen,tall,tear-drop,tub,ud,unit,widest,woody,yellowish,ympodial,young	adhesion,arrangement,blade,climate,colour,dense,diameter,form,fruit,glandular,greyish-brown,growth,hair,height,history,length,life,midpoint,na,number,peduncle,perennial,plant,position,presence,pubescence,ray,reproduction,rugulose,seed,staman,stellate,stipe,texture
509	wfo-0001029558	success	184	116	88	96	28	0.478	.5,0.05-0.1,0.1-0.2,0.1-0.9,0.3-0.5,1,1-1.1,1-1.5,1.5-2,2-4,2.5-3.5,6-9,abaxially,acute,anther,apex,base,berry,calyx,capitate,cm,conical,corolla,densely,diameter,elongate,entire,equal,flattened,geminate,glabrous,globose,growth,inflorescence,internodal,leaf,lobe,lobed,long,long-triangular,margin,mere,midpoint,minutely,mixture,mm,narrowly,nearly,obovate,obspathulate,obtuse,occasionally,ovary,pale,pedicel,peduncle,petiole,poricidal,porrect,pubescent,ray,red,reddish,reniform,rhombic,rounded,sessile,shape,shiny,short-stalked,shrub,size,sparsely,stellate,stem,stigma,style,surface,tan,tapering,thin,tip,trichome,tube,usually,white,widening,x	0.1-,0.15-0.2,0.2-,0.4,0.4-0.6,0.4-1.1,0.5,0.5-2,1-3,1-4,10-16,2,2-3,4-merous,6-10,<,?,adaxially,along,anthesi,armed,articulated,bark,bearing,branched,cell,closely,deflexe,difoliate,divaricately,eaf,easily,eed,ellipsoid,elliptic,enclosed,erect,filament,filiform,flower,free,fruiting,geminat,glabrescent,gre,highly,hyaline,including,interlocking,larger,later,leave,lengthening,like,lower,midvein,new,nflorescence,node,older,overlapping,pair,paired,papillo,per,perfect,pericarp,pitted,planar,pore,portion,prickle,prickly,primary,rest,rhachi,ruit,scar,shorter,simple,sinus,slit,small,spaced,square,stalked,straight,testal,tiny,ud,unit,upper,vein,visible,wall,ympodial	0.1-1.1,0.2-2,adhesion,arrangement,blade,climate,colour,form,fruit,height,hermaphroditic,history,length,life,number,papillose,perennial,plant,position,presence,present,pubescence,reproduction,rugulose,seed,staman,stipe,texture
510	wfo-0001029569	success	265	105	64	201	41	0.242	.0,.2,.3,1.6,2,3.2,4.9,8.1,abaxially,across,acuminate,adaxially,adnate,along,anther,apiculate,calyx,chartaceous,cm,corolla,densely,diameter,dry,elliptic,extra-axillary,flattened-reniform,flower,fruit,glabrous,globose,lamina,lateral,length,lobe,mature,mm,nearly,orange,ovate,pedicel,peduncle,petiole,probably,pubescent,ray,red,shrub,simple,sparsely,stellate,stem,stigma,straight,style,surface,tip,truncate,tube,unarmed,vein,white,yellow,yellow-tan,×	.4,.9,/2,/3,0.03,0.05,0.1,0.2,0.2–0.5,0.3–0.5,0.4–0.6,0.5–0.8,0.6–0.8,0.6–0.9,0.7–0.9,0.8–1.0,0.9,0.9–1.3,0.9–1.4,0.9–2.0,1.0–1.3,1.3–1.8,1.4–2.4,1.5–1.7,1.6–4.5,1.7–2.3,1.8–2.5,1/2–2/3,1/3,130,14.6–16.5,2.0–3.2,2.3–3.0,2.3–4.4,3.2–3.8,3.4–3.7,4.0,4.5,4–6,5-merou,5.0,5.1,5.3–16.6,5.7–6.6,6.3–18.5,6.8–7.8,6–12,6–8,7.4–9.1,7–10,90°,aequilateral,ag,alyx,anthesi,apart,apex,apical,apparently,appearing,around,articulate,attenuate,axe,ba,bark,basal,base,becoming,berry,blade,branch,branching,broad,brochidodromous,bud,capitat,channeled,clinate,cuneate,deciduous,dentate,development,difoliate,directed,distal,distally,distinct,eaf,edge,eed,either,emerging,endocarp,entire,evenly,exocarp,extending,fertile,filament,filiform,flexed,free,geminat,glandular,glossy,gradually,hair,homostylous,increasing,intact,internode,interpetalar,intersepalar,juic,lacking,layer,less,light,lon,long,longer,lower,many,margin,middle,midpoint,midrib,midvein,minute,moderately,nflorescence,oblique,oblong,orolla,ove,per,perforated,pore,porrect,porrect-stellate,portion,potentially,raised,reduced,reflexe,remaining,restricted,reticulate,rigid,rounded,row,ruit,scarcely,sessile,short,short-stipitate,shorter,side,sinuate,sinus,sloughing,smoot,spaced,splitting,spread,spreading,stamen,stellae,stellate-pubescent,stipe,stipitate,suture,tamen,tardily,tem,terete,thin,time,tissue,toward,translucent,transparent,triangular,two,ud,unit,upper,various,vary,weakly,well,well-developed,wide,yellow-ferruginous,ympodial,young,±90°,±equal,±glabrous,±well	0.2-0.4,0.3-0.5,0.5-0.8,0.6-0.9,0.7-0.9,0.9-1.3,0.9-2.0,1.3-1.8,1.5-1.7,14.6-16.5,2.0-3.2,3.2-3.8,5.3-16.6,5.7-6.6,6-12,6-8,6.3-18.5,adhesion,arrangement,capitate,colour,dense,form,growth,height,inflorescence,leaf,number,ovary,plant,position,presence,present,pubescence,rugulose,seed,shape,size,sparse,staman,texture
511	wfo-0001029584	success	180	92	68	112	24	0.378	1,1-6,1.5-6.5,16.2-33,2-3,2-4,3-10,3-7,4-5,4.5-11.5,6-7,8-15,9.7-23.4,abaxially,adaxially,anther,axillary,brownish,bud,clavate,cm,condition,coriaceous,corolla,densely,diameter,drying,elliptic,fresh,fruit,glabrescent,glabrous,green,greenish,hair,herb,leaf,lobe,long,mm,mucilaginous,oblong-lanceolate,odd-pinnate,ovate,ovoid,pedicel,peduncle,pentagonal,petiole,plant,pubescent,purple,seed,short,simple,size,stigma,style,substellate,subtending,terminal,tube,usually,wet,white,whitish,x,yellow	0-30,1-2,1-3,2.4-6.3,3-5,4-14,4-15,5-merou,5.3-13.3,6.1-9.4,7-14,9.8-17,acumen,acuminate,acute,ag,alyx,apart,apex,apparently,articulated,asymmetric,attenuate,axe,base,basiscopic,blade,borne,capitat,cell,connivent,considerably,covering,dark,decreasing,dense,digestion,distal,dorsally,eaf,edge,eed,end,enzyme,erry,filament,finer,flat,flower,folded,forked,geminat,generally,green-white,hair-like,hal,half,homostylous,honeycomb-shaped,interjected,larger,lateral,leaflet,lengthening,light,linear,living,lower,make,margin,middle,nflorescence,orbicular,orolla,pair,perfect,petiolulate,plurifoliate,pore,poricidal,present,proximal,removed,second,semi-erec,sessile,seudostipule,side,singly,slit,spaced,specimen,stolo,straight,tall,tamen,tem,testal,thick,throughout,tip,tissue,toward,tri-,tuber,typically,unit,unknow,unwinged,vary,wall,ympodial	adhesion,arrangement,calyx,capitate,colour,form,growth,height,history,inflorescence,length,life,na,ovary,perennial,position,pubescence,reproduction,rugulose,shape,staman,stem,surface,texture
512	wfo-0001029592	success	207	108	80	127	28	0.386	0-0.1,0.25-0.7,0.3-0.6,0.4-0.7,0.5-1.5,0.5-1.8,0.8-0.9,1.1-2.8,1.8-2.4,1.8-8,2-3.5,2.1-4,3-6,3.5-5.5,4-8,5.5-11.5,6-8,6.5-8.5,acute,adaxially,anther,apex,attenuate,base,black,blade,brown,calyx,chartaceous,cm,cordate,deltate,densely,depression,diameter,entire,erect,extra-axillary,flower,fruit,glabrous,globose,green,hair,hemispherical,inflorescence,leaf,length,lobe,lobed,long,margin,mid-point,midpoint,mm,moderately,obtuse,ovate,pedicel,peduncle,perennial,petiole,present,purple,ray,rhizomatous,shallowly,shrub,simple,sparsely,stellate,stellate-pubescent,style,surface,thick,throughout,tube,vein,x,yellow	%,.05,.4,0,0-0.15,0-0.3,0-3.5,0.1-0.2,0.25-0.5,0.5-0.8,0.5-1,0.8-1.2,0.8-1.5,1-1.5,1-1.9,1-10,1-3,1-8,1-locular,1.5,1.5-3,1.8-6.5,14-20,18-30,2-10,2-3-branched,2-foliate,240-1400,3-4,5-8,5-merou,5.5-10.5,7-10,7-17,7-25,7-9,8,8-10,8-20,abaxially,absent,acicular,across,adaxiall,adult,alyx,apart,apparen,apparently,armed,articulated,axe,ba,branch,branche,decimetre,deeply,directed,distall,distally,distributed,dm,eaf,eed,eglandular,exocarp,finger,fruiting,geminat,gland-tipped,half,homostylous,incomplete,index,juicy,juvenile,lamina,lateral,less,lobing,longer,lower,markedly,mature,mesocarp,midvein,minute,nflorescence,oblique,orolla,pair,part,per,perfect,placenta,pore,porrect,presen,prickle,ridged,ruit,septum,sessile,short,side,spaced,sparse,stalk,stellae,straight,succulent,tal,tamen,tem,terete,thicker,thicknes,time,transparent,unarme,unbranched,unit,upper,vary,white,wide,ympodial	adhesion,arrangement,climate,colour,corolla,form,glandular,growth,height,history,life,na,number,ovary,plant,position,presence,pubescence,reproduction,rugulose,seed,shape,size,staman,stem,stigma,stipe,texture
513	wfo-0001029593	success	181	70	53	128	17	0.293	0.5-5,0.8-1.2,1,1-1.2,1-1.5,1-2,1.6-2.3,10-50,2.3-3.0,3-4,4-6,5-15,7-25,anther,axillary,broadly,brown,calyx,capitate,cm,conical,deltate,densely,diameter,elliptic,fruit,glabrous,globose,green,leaf,long,mm,obovate,ovary,ovoid-reniform,pedicel,petiole,pinnate,plant,pubescence,pubescent,seed,shape,shrub,simple,slightly,smooth,stigma,style,trichome,tube,uniseriate,x	-10,0.05,0.5-1,0.8-1,1-8,100,2,2-14,2-3,2-5,2.3,3.5-8,35-60,5-10,7.5-15,9-15,abaxially,abruptly,acuminate,acute,adaxially,age,always,anthesi,anticlinal,apex,apically,arising,attenuate,axil,basal,base,basiscopically,bearing,berry,cateniform,cell,clavat,colony,cone,decurrent,dry,drying,eaf,edicel,eed,enlarged,entire,epidermal,exserted,extremely,filament,filiform,flower,free,fruiting,glabrescent,growing,half,hollow,included,irregular,lamina,large,lateral,leaflet,lobe,lower,markedly,minutely,much,narrowing,nflorescence,noddin,oblique,occasionally,often,once-branched,onto,open,opposite,pair,papillose,per,perfectly,petiolule,place,pointed,poricidal,portion,primary,projection,pubescen,purple,rachi,rarely,reflecting,rest,ruit,scar,short-styled,similar,single-stemmed,sinuous,small,smaller,somewhat,sparsely,surface,tall,tem,terminal,thickening,tip,tub,ud,unifoliat,unit,usually,variable,vein,white,white-lenticellate,wider,winged,without,woody,ympodial	arrangement,clavate,colour,form,growth,height,history,inflorescence,length,life,na,perennial,position,reproduction,size,stem,texture
514	wfo-0001029601	success	187	87	61	126	26	0.326	0.2-0.8,0.5-5.8,1-3,1-4,1.1-2.7,2-9,2.3-5.9,3-10,4-13.5,5-41,6-10,6.6-22,6.8-14.5,abaxially,adaxially,anther,brownish,clavate,cm,condition,coriaceous,corolla,dark,diameter,dot,drying,elliptic,fresh,fruit,glabrescent,glabrous,globose,green,greenish,herb,lanceolate,leaf,light,lobe,mm,odd-pinnate,ovate,ovoid,pedicel,peduncle,pentagonal,petiole,plant,puberulent,rotate,seed,size,small,stigma,style,terminal,tube,white,whitish,x,yellow	0-37,0.5-8,1-2,1-53,1.2-2.3,1.7-6.5,2,2-12,2-3,2-7,2.2-4.5,2.8-10.5,3-5,3-7,5-merou,abaxiall,acumen,acuminate,acute,ag,alyx,apart,apex,apparently,articulated,asymmetric,attenuate,axe,axillary,base,basiscopic,berry,blade,borne,bud,capitat,cell,connivent,covering,decreasing,digestion,distal,dorsally,eaf,edge,eed,end,enzyme,erec,exceeding,filament,flat,flower,folded,forked,geminat,generally,glabrou,green-white,hair,hair-like,half,homostylous,honeycomb-shaped,interjected,larger,lateral,leaflet,lengthening,linear,living,long,lower,make,middl,middle,mucilaginous,narrow,nflorescence,orbicular,orolla,pair,perfect,petiolulate,plurifoliate,pore,poricidal,removed,ripe,rounded,ruit,sessile,seudostipule,short,side,singly,slightly,slit,spaced,specimen,stamen,stolo,straight,subequal,subglabrou,subtending,tall,tamen,tem,testal,thick,throughout,tip,tissue,toward,tri-,tuber,typically,unit,unwinged,usually,vary,wall,wet,wing,ympodial	abaxial,adaxial,adhesion,arrangement,calyx,capitate,colour,form,growth,height,history,inflorescence,length,life,na,ovary,perennial,position,pubescence,reproduction,rugulose,shape,staman,stem,surface,texture
515	wfo-0001029606	success	179	121	93	86	28	0.52	.5,/2,0.2-0.5,0.4-0.5,0.5-1,1,1.5-2,1.5-3.5,1.8-2.5,2-3,3,3-9,4-8,4.5-5,5,5-6,7-9,abaxially,aciculate,acuminate,acute,adaxially,anther,apex,base,beneath,berry,bilobed,broadly,brownish,calyx,cm,coriaceous,corolla,densely,diameter,elliptic,elongate,entire,flattened,flower,form,glabrous,globose,growth,heterostylous,inflorescence,internodal,leaf,lobe,lobed,long,long-stalked,long-styled,margin,midpoint,minutely,mixture,mm,multangulate,narrowly,oblong,orbicular,pedicel,peduncle,petiole,porrect,pubescence,pubescent,ray,reddish,reniform,revolute,sessile,shiny,shrub,simple,stalked,stellate,stem,stigma,style,surface,tapering,terminal,thin,triangular,trichome,tube,urceolate,way,white,x	0.5,1.5-3,15,2-2.5,4-5,4-6,7,along,anthesi,apparently,arching,armed,articulated,bark,brown,cell,closely,color,deciduous,defoliate,dense,eaf,eed,ellipsoidal,elongation,equalling,erect,especially,exerted,filament,free,fruiting,geminat,gre,herbarium,impressed,inshort-styled,known,lengthening,like,lower,m.,many,marginal,midrib,multiseriate,new,nflorescence,nodding,older,once-branched,pair,papillat,per,pericarp,pore,poricidal,portion,prickle,primary,prominent,red,redder,ruit,rusty,scar,slightly,slit,sometimes,soon,space,specimen,stalk,stellate-pubescent,straggling,straight,strongly,testal,tip,ud,unit,usually,vein,woody,yellowish,ympodial	adhesion,arrangement,blade,climate,colour,fruit,glandular,hair,height,history,length,life,na,number,ovary,perennial,plant,position,presence,present,reproduction,rugulose,seed,shape,size,staman,stipe,texture
516	wfo-0001029619	success	188	114	86	102	28	0.457	0.25-0.75,0.5-1,0.5-1.5,0.5-2,1,1-1.5,1-2,1-5,1.5-2,10-12,2-11,2-3,3-4,4-6,5-20,6-10,7,8-12,abaxially,acute,adaxially,anther,apex,attenuate,base,blade,brown,bud,calyx,chartaceous,cm,connivent,densely,diameter,extra-axillary,flower,fruit,glabrous,glandular,globose,green,hair,immature,leaf,leaf-opposed,length,like,lobe,lobed,margin,mature,midpoint,mm,moderately,nearly,obtuse,orange,ovate,pedicel,peduncle,per,petiole,porrect-stellate,pubescent,ray,reniform,rusty,scandent,shrub,side,simple,sparsely,spreading,stellate,stem,stigma,style,surface,tan,tapering,triangular,tube,unlobed,white,x,yellow	1-.,1-2.5,1-3,1-3.5,2,2-5,25-40,3-8,5-merou,6,6-8,7-10,7-12,absent,accrescent,adaxiall,alyx,andromonoecy,apar,apart,apical,apparently,appearing,armed,axe,berry,beyond,clavat,contiguous,cordate,cut,cylindrical,dark,difoliate,directed,discolorous,eaf,eed,either,elongated,em,exserted,filament,flattedned,frui,fruiting,geminate,glabrou,gland-tipped,implying,introrsel,less,long,lower,m.,major,many,midrib,midvein,multicellular,multiseriate,narrowly,netlike,nflorescence,occasionally,often,orolla,pair,perfect,pit,pore,prickle,rachi,raised,recurved,reduced,ridge,roselike,ruit,separated,sinus,slightly,small,spaced,sparse,stalk,stamen,ste,tamen,unarmed,unbranched,unequa,unicellular,unit,usually,vary,vein,way,whitish,wide,ympodial,¼	adhesion,arrangement,clavate,climate,colour,corolla,form,growth,height,history,inflorescence,life,na,number,ovary,plant,position,presence,present,pubescence,reproduction,rugulose,seed,shape,size,staman,stipe,texture
517	wfo-0001029621	success	165	107	72	93	35	0.436	0.5-1,0.7-1.1,0.8-1,0.8-4.5,1-1.5,1.5-2,1.5-2.5,1.5-5,2.5-3,3-3.5,3.5-4.5,6-20,7-9,acute,anther,apex,area,attenuate,base,becoming,brown,calyx,cm,corolla,cup-shaped,dark,decurrent,deltoid,dry,fleshy,fruit,glabrous,globose,green,irregularly,lanceolate,later,lateral,leaf,live,lobe,lobed,margin,material,merely,minutely,mm,oblanceolate,ovary,ovoid-reniform,pale,pedicel,pitted,plant,poricidal,puberulent,ripe,sessile,shrub,stem,stigma,style,surface,tan,terminal,tip,tube,white,whorl-like,widened,x,yellowish	.1,0.5-0.75,0.5-1.2,0.5-1.5,1-2,1/3,2/3,5-20-flowered,6-8,accrescent,along,anthesi,apar,appearing,appressed,bark,beneath,berry,borne,branched,caudate,cluster,completely,constricted,course,densely,dia,distal,eaf,edicel,eed,ellipsoid,elongate,enclosed,erect,exsertio,filament,free,fruiting,geminate,glabrate,late,like,lon,long,lower,main,many,middle,nflorescence,occasionally,often,older,onto,pair,papillate,papillo,papillose,planar,plurifoliat,pore,portion,prominent,quite,rarely,reddish,reddish-gre,river,ruit,scar,shaped,shiny,small,somewhat,spaced,ste,straight,tall,tapering,tear-drop,thick,time,trichome,ud,uniseriate,unit,vein,way,widest,woody,yellow,ympodial,young	adhesion,arrangement,blade,climate,colour,diameter,form,glandular,growth,hair,height,history,inflorescence,length,life,midpoint,na,number,peduncle,perennial,petiole,position,presence,pubescence,ray,reddish-grey,reproduction,rugulose,seed,shape,size,staman,stellate,stipe,texture
518	wfo-0001029622	success	182	95	69	113	26	0.379	.1,.5,/3,0.5-1,0.8-1,1-1.2,1-1.5,1-4,1.5,2-11,2.5-3,3-4,3-5,30-35,abaxially,adaxially,anther,base,brown,calyx,chartaceous,cm,connivent,corolla,deflexed,diameter,elliptic,except,fruit,glabrous,globose,green,inflorescence,internodal,leaf,lobe,lobed,long-triangular,minutely,mm,narrowly,obconic,oblong,occasionally,opposite,ovate,papillose,pedicel,peduncle,petiole,reddish,sagittate,shiny,shrub,simple,size,slightly,somewhat,stellate,stem,stigma,style,tapering,tip,tube,way,white,x,yellow	.2,0.3,0.5,0.5-0.7,0.6-0.9,1-2.7,2-4,2-5,4-6.5,40,45-50,5-6,7-11,absent,accrescent,acute,ag,alyx,anthesi,apex,apparently,appearing,arising,attenuate,axe,axil,bark,beneath,blade,bud,capitat,consisting,cylindrical,deciduous,differing,difoliate,dimorphic,eaf,eed,elongate,entire,filament,flower,free,fruiting,geminate,glabrou,ilament,immature,included,interlaced,jointed,known,lamina,lateral,less,long,long-acuminate,longitudinal,m.,main,major,margin,mature,measured,midrib,minor,minute,nflorescence,often,older,one,onto,opening,orolla,oung,ovate-lanceolate,pair,pendent,pore,portion,present,probably,rachi,raised,reflexed,remaining,rounded,ruit,scar,second,shaped,single,slende,slender,slit,straight,tal,tear-drop,thin,thus,trichome,tuft,ud,unarme,unifoliat,uniseriate,unit,vary,vein,within,ympodial,young	adhesion,arrangement,capitate,colour,form,growth,height,history,length,life,na,number,ovary,perennial,plant,position,presence,pubescence,ray,reproduction,rugulose,seed,shape,staman,surface,texture
519	wfo-0001029625	success	168	104	69	99	35	0.411	..,0.5-1,0.5-1.3,0.8-1.4,1-1.5,1-2,1.2-1.6,3-,3-3.5,4-10,4-4,4-9,5,5-6,5-8,9-25,anther,base,beneath,calyx,cm,conical,corolla,darker,deltate,densely,diameter,elliptic,flattened,four,fruit,glabrous,glandular,globose,green,greenish,growth,herb,inflorescence,lobe,lobed,long,margin,mm,nearly,occasionally,ovary,ovate-reniform,pale,pedicel,peduncle,pubescent,purplish,reddish,smooth,sparsely,stem,stigma,stripe,style,surface,tan,tinged,trichome,tube,uniseriate,white,x,young	-15,.1-0.2,.5,0.5-2,0.5-2mm,0.8-1.8,1-3,100,2,2.5-.,3,3-3,4-5-celled,4-7-celled,5-10,6-9,8-13,abaxial,along,anthesi,apical,bark,branc,branch,branched,brittle,brow,capitat,cel,cell,cucullate,deflexe,deflexed,denser,distinct,dry,eaf,edicel,eed,erect,filament,flower,frui,fruiting,glabrescent,gland,gland-tipped,hyaline,lamina,later,lighter,like,lower,markedly,middle,midline,minute,mixed,narrowly,new,nflorescence,open,outer,outline,pair,papillate,per,pericarp,planar,plurifoliat,point,pointed,primary,rarely,regularly,ruit,scar,scattered,shrub,single,single-stemmed,sinuate,slightly,small,striate,strongly,testa,thin,time,tip,triangular,tuft,ud,unit,vein,wall,weight,without,ympodial	adhesion,apex,arrangement,blade,brown,capitate,climate,colour,form,hair,height,history,leaf,length,life,midpoint,na,number,perennial,petiole,plant,plurifoliate,position,presence,pubescence,ray,reproduction,rugulose,seed,shape,size,staman,stellate,stipe,texture
520	wfo-0001029630	success	286	135	105	181	30	0.367	.5,.8,/6,0-5,0.4,0.5-1.5,1.5-4,12-17,2-6,2.5,2.5-3,3.5-5,4-8,5-9,6-8,7-10,8-9,abaxially,acuminate,acute,almost,along,anther,apex,apically,apparently,base,berry,blade,brachyblast,calyx,capitate,chartaceous,clavate,climber,cm,corolla,cuneate,cupular,dark,densely,diameter,discolorous,distributed,drying,dull-yellow,elliptic,entire,equal,evenly,finely,flattened-reniform,free,fruit,glabrous,globose,green-brown,grey-brown,lateral,leaf,length,like,lobe,lobed,margin,maturity,mauve,midpoint,mm,oblique,often,orange,orange-brown,ovate,papillose,pedicel,peduncle,petiole,purple,ray,red-brown,rounded,shiny,side,smooth,sometimes,somewhat,stellate,stellate-pubescent,stem,stigma,strongly,style,suborbicular,surface,tapering,terminal,thin,tube,unequal,unequal-deltoid,weakly,yellow-brown,young,×	.1,.15,.7,/2,0,0-10,0-8,0.1-0.2,0.15-0.3,0.2-0.3,0.2-0.4,0.2-0.7,0.3-0.5,0.5,0.5-1,0.5-2,0.5-4.5,0.6-0.8,1,1-3,1.2-1.5,1.5-2,1/3,1/3-1/5,1/3-2/3,10-30,12-15,2.5-6,3-10,4-5,45-60°,5,5-20,5-merou,8,abaxial,accrescent,across,adaxially,age,always,alyx,apar,apart,area,armed,articulated,ascendant,attachment,bark,beyond,branch,branched,broadly,brown,cell,clearly,coroll,curved,delineated,deltoid,development,difoliate,distance,divided,downward,eaf,eed,ellpsoid,elongating,exserted,extending,eye,fertile,filament,flat,flattened,flower,fruiting,geminat,glabrescent,glaucous,greyi,hooked,infructescence,irregula,lengthening,less,lighter,lon,long,longer,longitudinal,lower,main,mature,midvein,mostly,naked,narrow-ovate,nflorescence,orolla,outline,ovoid,pair,pale,papillo,patchily,pendulous,per,perfect,pericarp,pit,point,pore,poricidal,porrect,portion,prickle,primary,prominently,rachi,raised,recurved,reduced,reflexe,relatively,rest,robust,ruit,scar,secondary,shorter,simple,sinus,slender,slit,small,spaced,sparsely,species,spherical,spreading,stalk,stalked,stout,straight,strong,stump,sunk,tamen,terete,tertiary,thicker,throughout,time,tip,toward,translucent,trichome,ud,undulate,uniform,unit,usually,variously,vary,vein,venation,visibl,visible,visibly,white,white-translucent,wide,widest,woody,yellow,yellow-green,yellow-translucent,ympodial	adhesion,arrangement,climate,colour,form,glandular,greyish,growth,hair,height,history,inflorescence,life,na,number,ovary,perennial,plant,position,presence,present,pubescence,reproduction,rugulose,seed,shape,size,staman,stipe,texture
521	wfo-0001029632	success	202	135	101	101	34	0.5	.5,0.2,0.5–1.4,0.6–1.1,0.8–,0.8–1.0,0–1.5,1.0–2.0,1.0–3.5,1.0–6.0,1.1–,1.2–1.4,1.5–,1.5–2.6,1.7–8.5,11–25,2.0–11.5,2.0–2.2,2.7–3.5,2–3,3.5–5.0,3–8,4.5–6.0,abaxially,acute,along,anther,anthesi,apex,arising,associated,base,black,blade,brown,calyx,clavate,cm,dark,decurrent,deeply,densely,diameter,elliptic,equal,especially,flattened,fruit,glabrous,globose,green,hair,herb,leaf,like,lilac,lobe,lobed,margin,marking,midrib,midvein,midway,mm,moderately,oblong,ovate,pair,pale,pedicel,peduncle,pentagonal,perennial,petiole,pitted,pubescent,purple,rarely,semi-succulent,simple,sometimes,sparsely,stigma,style,subentire,succulent,surface,tube,violet,white,whitish,x,yellow,–11.0,–11.5,–13.5,–19.0,–2.0,–4.5,–5.2,–50	.0,0.3–2.0,0.4–1.0,0.5,0.5–0.7,0.7,0.8–1.5,0.8–2.2,0.9,1,1.0–1.5,1.2,1.2–2.5,10–30,2,4–8,5,5.5–9.5,5–10,6–13,7.5–13,75,abaxial,absent,adaxiall,adaxially,ag,angular,apart,appressed,articulated,axe,ba,branching,caudex,cell,chartaceous,connivent,cylindrical,eaf,eed,elongate,filament,flower,geminat,indistinct,lamin,lon,long,longitudinal,lower,m.,multicellular,nflorescence,obtuse,occasionally,often,opening,orolla,particularly,perfect,pore,poricidal,present,prostrate,purplish,rapidly,ruit,scandent,shaped,side,slender,slit,spaced,spheroidal,stone,straight,subterranean,swollen,tall,tamen,tear-drop,tem,time,tip,unbranched,unicellular,unifoliate,uniseriate,unit,vary,vein,wide,wing,ympodial,–1.4,–10,–15,–2.2,–4.0,–40	10-30,adhesion,arrangement,climate,colour,corolla,form,glandular,growth,height,history,inflorescence,lamina,length,life,midpoint,na,number,ovary,plant,position,presence,pubescence,ray,reproduction,rugulose,seed,shape,size,staman,stellate,stem,stipe,texture
522	wfo-0001029645	success	160	109	81	79	28	0.506	0.2-0.5,0.3-0.5,0.5-2.5,0.5-7,1,1-1.5,1-2,1.3-7,1.5,2.5-17,2.5-4,3-15,3-7,337,6-12,7-12,750,?,abaxially,acute,adaxially,anther,apex,base,blue,brown,calyx,chartaceous,cm,corolla,diameter,distally,et,extra-axillary,fide,finger,flattened,fruit,glabrous,gland-tipped,globose,green,greenish,hair,herb,immature,kayap,line,lobe,membranaceous,minutely,mm,moderately,obtuse,ovate,ovate-elliptic,pedicel,peduncle,petiole,puberulent,purple,rarely,red,rotate-stellate,sagittate,short-tomentose,simple,smith,sparsely,stigma,strongly,style,tapered,triangular,truncate,tube,white,wide,x,yellow,±	-1,.5-1,1-4,1.5-2,2-3-foliat,2-4,3-10,3.5-4,4-5,4-8,5,5-8,abundantly,acuminate,aggregate,along,apart,around,articulated,axe,ba,blade,cell,connivent,cuneate,cylindrical,decurrent,deltate,directed,distall,eaf,eed,entire,except,filament,flower,free,glabrou,inserted,knapp,long,lower,major,margin,mesocarp,nearly,nflorescence,orolla,part,perfect,pore,puberulen,rachi,radiu,rugose-verrucate,ruit,sand-punctate,short,shorter,shru,side,small,spaced,stone,subcordate,tal,tamen,tem,thecae,tightly,time,tomento,truncat,unbranched,unit,vary,vein,veiny,ympodial	0.5-1,adhesion,arrangement,colour,form,growth,height,history,inflorescence,leaf,length,life,na,ovary,plant,position,pubescence,reproduction,rugulose,seed,shape,shrub,size,staman,stem,surface,texture,verrucate
523	wfo-0001029646	success	141	93	57	84	36	0.404	0.1-0.6,0.5,0.5-0.8,0.7-2.2,1-4,1.5-2,1.5-4.9,10-15,2-3,3-14,4-5.5,6-8,abaxially,acuminate,acute,adaxially,apex,attenuate,base,calyx,cm,corolla,diameter,distal,elliptic,finely,free,globose,green,green-white,half,herbaceous,leaf,lobe,long,mm,mucronate,narrowly,ovate,ovoid,pedicel,peduncle,perennial,petiole,plant,pubescent,seed,simple,stellate,stigma,style,throughout,tone,white,wide,yellow,yellow-green	3-6-foliat,5-15,7-15,acumen,apical,apically,articulate,branched,cell,commonly,covering,cyme,dehiscent,dichasial,dichasially,digestion,dorsally,eaf,ebracteate,edge,eed,emoval,enzyme,epiphytic,equaling,filament,flat,flower,folded,forked,generally,globo,ground,growing,hair-like,honeycomb,introrse,lateral,linear,living,lon,lower,make,maturing,monochasial,mos,mould,mucilaginous,nflorescence,nther,oak,often,orolla,ovat,pattern,perfect,pine,plan,poricidally,proximal,rarely,reveal,ruit,seudostipule,short,slit,specimen,stamen,straight,tall,tem,testal,thick,throughou,tree,tuber-bearing,typically,unit,vary,viole,wall,without,ympodial,¼	adhesion,anther,arrangement,blade,climate,colour,form,fruit,glandular,growth,hair,height,history,inflorescence,length,life,margin,midpoint,na,number,ovary,position,presence,pubescence,ray,reproduction,rugulose,shape,size,staman,stem,stipe,surface,texture,tube,violet
524	wfo-0001029652	success	160	119	85	75	34	0.531	.25,.5,0.5-1,0.5-4,0.75-1,0.8-1,1-3,1.5-2,2-2.5,2-4,2.5-3,3.5-4,3/4,4-4.5,6-15,abaxially,adaxially,along,anther,apex,apical,attenuate,base,broadly,calyx,cm,conical,corolla,curling,deltate,dia,elliptic-ovate,flower,glabrous,globose,golden,green,greenish-white,hard,hispid,leaf,lobe,lobed,long,long-acuminate,long-styled,margin,maturity,minutely,mm,narrowly,occasionally,opposite,ovary,ovoid-reniform,pale,papillose,pedicel,petiole,pitted,pore,poricidal,projection,pubescent,reddish-brown,shaped,short-styled,shrub,size,stem,stigma,style,surface,swollen,tan,tear-drop,tip,trichome,tube,undulate,uniseriate,vein,way,white,x	.3,1,1-2,2,25,7-9,anthesi,apar,ape,arch,arching,ba,bark,bearing,berry,cone,deciduous,deflexed,denser,differing,difoliate,drying,eaf,edicel,eed,evenly,exserted,filament,filiform,free,fruiting,geminat,golden-red,heteromorphic,included,joining,lamina,lateral,like,lon,lower,main,major,middle,midrib,minor,minute,near,nflorescence,older,pair,papillo,pericarp,portion,reflexed,ruit,scar,series,simple,slende,slender,slightly,soon,spaced,sparsely,tall,thickened,time,tub,ud,unit,widest,within,ympodial,young	adhesion,arrangement,blade,climate,colour,diameter,form,fruit,glandular,growth,hair,height,history,inflorescence,length,life,midpoint,na,number,peduncle,perennial,plant,position,presence,pubescence,ray,reproduction,rugulose,seed,shape,staman,stellate,stipe,texture
525	wfo-0001029662	success	181	128	102	79	26	0.564	.3,.5,0.5,0.7–1,0.7–3,1,1.4,1.5,1.7–3.5,15,20,2–3,2–3-celled,3.5–6,3–4,4-rayed,5-6,5–7.5,7-14,9–11,abaxially,adaxially,andromonecious,anther,apart,apex,armed,articulated,base,blade,calyx,campanulate,caudate,chartaceous,cm,cylindrical,diameter,distally,expanded,extra-axillary,flower,fruit,glabrous,hair,herb,including,lateral,leaf,like,linear-tapered,lobe,lobed,long,margin,midpoint,mm,nearly,oblong-ovate,oblong-ovoid,obtuse,opposite,ovate,pedicel,peduncle,petiole,pilose,plant,prickle,pubescent,ray,recurved,repand,sessile,shallowly,shape,shorter,simple,size,small,somewhat,spaced,sparsely,stellae,stellate,stellate-pentagonal,stem,stigma,striaght,style,subcordate,thickened,tip,tomentose,truncate,tube,unknown,vine,white,wide,widely,x,yellow	12,1–3.5,2,2-,3-foliate,3.2,3.5,4–5,6-7,absent,accrescent,acicular,adaxiall,ag,axe,ba,capitat,color,connivent,creeping,curve,directed,eaf,eed,equal,erect,fertile,filament,fragrant,free,fruiting,geminat,glabrou,half,ilament,immature,less,lightly,longitudinal,lower,lowest,m.,major,minute,nflorescence,node,offset,one,opening,orolla,per,perhaps,pore,portion,probably,rachi,reflexed,ripe,rooting,rounded,ruit,side,slender,slightly,slit,straight,tal,tem,triangular,two,unarmed,unbranched,unequal,uniform,unit,vary,vein,way,ympodial	adhesion,arrangement,capitate,colour,corolla,form,growth,height,history,inflorescence,length,life,na,number,ovary,perennial,position,presence,pubescence,reproduction,rugulose,seed,staman,stipe,surface,texture
526	wfo-0001029673	success	159	112	79	80	33	0.497	.5,0.7-1.1,0.75-1,0.8-1,1-10,1-2,1-5,1.2-3.5,1.5-2,2-2.5,2.5,4-6,5.5-15,acuminate,acute,anther,anthesi,apex,appearing,base,black,blade,branch,calyx,clavate,cm,conical,corolla,deep,deltoid,dendritic,diameter,elliptic,fork,fruit,glabrous,globose,greyish-yellow,growth,later,lateral,leaf,length,lenticular,lobe,long,minutely,mm,narrowly,occasionally,ovary,overtopping,pedicel,pericarp,petiole,pitted,planar,plurifoliate,poricidal,purple,reddish-brown,reflexed,shoot,shrub,slightly,small,stem,stigma,style,surface,terminal,thin,tip,tree,triangular,trichome,tube,violet,x	0.5-1,1.5-1.8,10-20,2-3,2-4,3-5,3/4,5-25,abaxial,abaxially,absent,accrescent,adaxial,adaxially,age,along,apical,bark,basal,becoming,berry,branching,broadly,decurrent,deflexed,densely,denser,dichasia,eaf,edicel,eed,ew,exserted,filament,flower,free,fruiting,greyish,greyish-yello,individual,inserted,lamina,like,lon,longer,lower,m.,monochasial,nflorescence,nodding,older,pair,papillo,petal,pore,portion,prominent,pubescent,pyramidal,ruit,scar,secondary,sleeve,slit-like,somewhat,sparsely,stamen,strongly,tall,tapering,time,tub,ud,unit,vein,wide,winged,woody,ympodial,young	adhesion,arrangement,climate,colour,dense,form,glandular,hair,height,history,inflorescence,life,margin,midpoint,na,number,peduncle,perennial,plant,position,presence,pubescence,ray,reproduction,rugulose,seed,shape,size,sparse,staman,stellate,stipe,texture
527	wfo-0001029680	success	212	140	109	103	31	0.514	0.1,0.5–1.5,0.6–1.2,0.6–2.0,1,1.0,1.0–1.1,1.0–1.8,1.1–1.2,1.4–7.5,1.7–7,1.8–3.8,11–16,11–25,12,2.2–4.2,3.0–4.2,3–6,4.0–16,4.0–6.5,4.5–20,4.5–7.0,50,5–11,abaxially,acute,adaxially,annual,anther,anthesi,apex,axillary,base,becoming,bipinnate,blade,blue,brown,calyx,clavate,cm,densely,diameter,divided,equal,flattened,fleshy,fruit,glabrous,globose,green,hair,herb,indistinct,leaf,length,light,lobe,long,margin,mm,moderately,multicellular,oblong,obovate,obtuse,ovate,pair,pale,pedicel,peduncle,pentagonal,petiole,pinnae,pinnate,pitted,primary,pubescent,purple,rarely,red,ripe,rotate,shallowly,shoot,simple,size,sometimes,sparsely,stem,stigma,style,subglabrous,surface,terminal,tripinnate,tube,turning,unicellular,uniseriate,violet,white,winged,woody,x,yellow,–10,–12.5,–19	.0,0.4,0.6,0.9–1.0,1.0–1.5,1.4–2.5,1.5,1.6–2.7,10,1–2,1–3,1–6,1–8,2–20,3.3–5.5,3–22,4–10,4–30,5,5.5–8.5,7–10,8–32,absen,adaxiall,ag,along,apart,appressed,arequipa,arranged,articulated,asymmetrically,axe,ba,beyond,borne,branched,cell,connivent,cylindrical,decreasing,decurrent,difoliate,eaf,eed,entire,erect,extending,filament,flange,flower,forming,geminat,irregularly,lon,longitudinal,lower,m.,midrib,narrow,nflorescence,node,occasionally,often,opening,orolla,parallel,pendant,perfect,plurifoliate,pore,poricidal,prostrate,rapidly,ruit,running,secondary,shaped,side,spaced,specimen,split,stone,straight,tacna,tal,tamen,tear-drop,tem,tertiary,time,tip,unit,usually,vary,wide,wing,winge,ympodial,–3,–3.2,–46,–48	adhesion,arrangement,climate,colour,corolla,decurred,form,glandular,growth,height,hermaphroditic,history,inflorescence,life,midpoint,na,number,ovary,plant,position,presence,pubescence,ray,reproduction,rugulose,seed,shape,staman,stellate,stipe,texture
528	wfo-0001029685	success	288	112	88	200	24	0.306	.2,.4,0.1-0.2,0.2-0.8,0.5-1.5,0.7-1.5,0.7-1.8,1-4,1-5,1.3-1.5,1/6-1/3,2-3,2-6,2.1-3,2.5-3.7,3-7,3.5-16,3.5-4,4-9,5-20,5.5-7,6-8,6.5-9,acute,anther,apex,apically,armed,base,berry,blade,bright,brown,calyx,chartaceous,clavate,cm,corolla,cuneate,cupular,densely,diameter,drying,equal,erect,flattened-reniform,free,fruit,globose,lateral,leaf,length,lobe,lobed,long,long-acuminate,long-deltate,margin,maturity,mauve,midpoint,mm,obconical,orange,orange-brown,ovate,ovoid,pedicel,peduncle,petiole,ray,red-brown,shiny,shrub,simple,smooth,stellate,stellate-pubescent,stem,stigma,style,surface,tapering,thin,truncate,tube,yellow,×	.5,.8,/3,0-15,0.1,0.1-0.3,0.2,0.5,0.5-1,1-1.3,1-2,1-7,1.5,1.5-5,1.5-6,1/2-2/3,1/3,1/3-2/3,1/3-4/5,10,10-20,2.5-3,20,3,3-20,3-5,3-6,3.5,3/4-1/2,30-60°,4,4-10,4-7,4.5-6,5,5-11,5-merou,abaxially,accrescent,adaxially,age,almost,alyx,apar,apart,apparently,articulated,axe,bark,beyond,black,branched,breaking,brittle,broad-deltate,cell,clearly,clump,covering,curved,dark,deep,deltate,dense,development,difoliate,discolorous,distance,divided,dorsal,downward,eaf,eed,elongating,exserted,extending,faint,filament,filiform,finely,finger-hair,flat,flattened,flower,fruiting,geminat,glabrescent,glabrous,grey-brow,growing,inflated,infructescence,irregula,irregular,lengthening,less,longer,longitudinal,lower,mature,midvein,minute,mixture,moderately,much,nflorescence,oblique,obovate,often,older,one,open,opening,orange-translucent,orolla,oung,outline,ovoi,pair,papillae,papillo,partly,patch,per,perfect,pericarp,persisting,pit,point,pore,poricidal,porrect,portion,prickle,primary,pronounced,pubescent,rachi,raised,rarely,reduced,reflexed,regular,rest,ri,ridged,robust,rounded,ruit,scar,secondary,sessile,side,sinus,slender,slightly,slit,small,sometimes,somewhat,spaced,sparsely,specimen,spherical,spreading,stalk,stalked,stout,straight,strongly,stump,tamen,terete,terminal,tertiary,thick,throughout,time,tip,toward,translucent,trichome,ud,unarmed,unbranched,unit,upper,usually,variously,vary,vein,venation,visible,well-developed,wide,widest,woody,x1.5-2,yellow-green,ympodial	adhesion,arrangement,climate,colour,form,growth,height,inflorescence,na,number,ovary,papillose,plant,position,presence,present,pubescence,reproduction,rugulose,seed,shape,size,staman,texture
529	wfo-0001029691	success	223	131	103	120	28	0.462	-8,0.2-0.4,0.25-0.45,0.3-0.45,0.5-0.8,1.2-1.7,1.4-2,1.6-2.1,1.7-2.7,11-14,18-23,2.5-4,2.5-8,3-4,3-6,3-7,3.3-3.5,5-8,6.5-10,6.5-8.5,8-14,abaxially,absent,acute,adaxially,andromonoecious,anther,apex,articulated,attenuate,base,blade,broadly,brown,bursting,calyx,chartaceous,cm,connivent,cuneate,cylindrical,densely,diameter,entire,extra-axillary,flower,fruit,glabrous,gland-tipped,globose,green,hair,herbaceous,inflorescence,lanceolate,length,lilac,lobe,lobed,long,margin,maturity,mid-point,midpoint,minutely,mm,moderately,obtuse,orbicular,ovate,pale,pedicel,peduncle,petiole,plant,present,prostrate,ray,readily,resprouter,reticulate,rotate,shallowly,shape,short,simple,sparsely,sprawling,stellate,stellate-pubescent,stigma,style,summit,surface,thick,throughout,toward,tube,weakly,white,x,yellow,yellowish-green	%,0-0.1,0-6,0.3-0.7,0.3-1.4,0.4-0.5,0.5-0.7,0.5-1,0.8-1.2,0.8-1.6,0.8-2.5,1-1.1,1-2,1-5,1-6,1-locular,1.1-2.1,1.5-4,10,100-400,13-18,13-20,13-25,140-320,2-3,36-50,4-8,40-250,5-,5-merou,5.5-9,6-10,6-8,absen,abundant,accrescent,acicular,across,adaxiall,adult,alyx,apart,armed,axe,ba,branche,cone,cross-section,curved,decimetre,directed,distall,eaf,eed,eglandular,elliptica,equalling,exocarp,filament,finger,fruiting,functional,half,heterostylous,included,incomplete,index,interpetalar,juicy,lamina,lateral,less,lobing,lon,longer,lower,mature,mesocarp,midvein,minute,moist,nflorescence,oblique,orolla,part,per,petal,placenta,pore,porrect,presen,prickle,rachi,rounded,ruit,septum,sessile,side,slightly,spaced,stage,stalk,stellae,straight,tal,tamen,tem,time,tip,tissue,transparent,truncat,unbranched,unit,unknow,uvenile,vary,vein,wide,ympodial	adhesion,arrangement,climate,colour,corolla,elliptical,form,glandular,growth,height,history,leaf,life,na,number,ovary,position,presence,pubescence,reproduction,rugulose,seed,size,staman,stem,stipe,texture,truncate
530	wfo-0001029704	success	146	97	72	74	25	0.493	0-1.5,1,1.5-2.5,1.5-3,15-25,2-2.5,2-3,3-4-celled,4,4-7,7-10,9-20,acuman,along,anther,base,blue,branch,broadly,brown,calyx,cm,conical,corolla,dark,deeply,dia,ellipsoid,extra-axillary,fork,glabrous,globose,green,halfway,leaf,less,lobed,minute,minutely,mm,mottled,obovate,occasionally,one,ovary,pedicel,peduncle,petiole,pinnatisect,poricidal,pubescent,purple,record,reddish,reticulate,rounded,short,shrub,simple,stellate,stigma,stout,striped,style,subdiscoidal,surface,tip,trichome,tube,vein,white,x	-17,-3,.5,0.5,1-2,1-4,1.5,10-14,1000-1200,140-185,2-5,3-5,5,7-,acuminate,acute,also,anthesi,apex,apparently,aspect,axi,berry,c.,cell,composed,cunate,cuneate,cut,deflexed,diam,eaf,eed,enlarged,erect,especially,exerted,few-flowered,filament,flower,flowering,fruiting,gradually,lanceolate,lengthening,lobe,long,lower,midrib,moderately,nflorescence,obovoid,plurifoliat,pore,ruit,shoot,single,sinus,slit,sombre,sprawling,stone,straight,subglobo,swollen,tub,twig,ud,unit,variable,variously,within,ympodial,young	arrangement,colour,diameter,form,fruit,growth,height,history,inflorescence,length,life,na,perennial,plant,plurifoliate,position,pubescence,reproduction,rugulose,seed,shape,size,stem,subglobose,texture
531	wfo-0001029727	success	260	130	101	159	29	0.388	-1/3,-10,-3,/3,0-4,0.2-0.5,0.4-1,1-1.2,1-4,1.5-5.5,1.6-3,1/8-1/5,2.5-3.2,2.5-5.5,2.8-4,3-11,3-7,4.5,5-8,5.5-7,6-11,acuminate,acute,anther,apex,apically,base,berry,blade,calyx,chartaceous,clavate,climber,cm,colourles,connivent,cordate,corolla,cupular,deltoid,densely,diameter,drying,erect,filiform,finely,flattened-reniform,glabrous,inside,lateral,leaf,length,lobe,lobed,long,lower,margin,mauve,midpoint,mixture,mm,moderately,obconical,oblong,orange-brown,outside,ovate,papillose,pedicel,peduncle,petiole,poricidal,ray,red-brown,regular,rounded,scandent,seed,shallowly,shape,shrub,simple,size,smooth,stellate,stellate-pubescent,stem,stigma,strongly,style,subentire,surface,tapering,terminal,tip,toward,trichome,tube,uneven,wide,yellowish	.5,0-15,0-2,0-20,0-30,0-40,0-5,0-8,0.1-5,0.15-0.2,0.15-0.3,0.2,0.2-2.5,0.3,0.4,0.5,0.5-1.2,0.5-3,0.7-0.9,0.7-1,1,1-,1-2,1.2-2,1.5-2.3,1.5-2.5,1.5-3,1/2-2/3,1/3-1/2,1/4,2-5,2.5,3-6,3/,4-7,4-merou,4-merous,4.5-,5-12,5-9,7-10,abaxial,abaxially,acicular,adaxial,age,almost,along,alternate,alyx,ame,anthesi,apar,apart,apparently,articulated,bark,branched,bristle,brown,c.,covered,curved,darker,deltate,developing,different,dimorphic,discolorous,divided,eaf,edge,eed,elongating,equal,except,extending,ferrugineous,filament,filiform-acuminat,fissure,flower,free,geminate,increasing,lengthening,less,like,lon,longer,m.,mature,middle,midvein,minor,minutely,narrow-deltate,nflorescence,nther,occasional,older,one,open,orolla,oung,pair,papillo,per,perfec,perfect,pit,pitted,plurifoliat,pore,porrect,portion,prickl,prickle,prickly,primary,protruding,pubescent,raised,rarely,red-brow,reddish,reduced,scar,series,sessile,short,sinus,sometimes,spaced,spreading,stalk,stalked,straight,tamen,tearing,terete,tertiary,time,translucent,transverse,unarmed,unit,upper,variable,variously,vary,vein,venation,violet,visible,way,x,ympodial,young	3/4,adhesion,arrangement,climate,colour,dioecious,form,fruit,glandular,growth,hair,height,history,inflorescence,life,na,number,ovary,perennial,plant,position,presence,present,pubescence,reproduction,rugulose,staman,stipe,texture
532	wfo-0001029728	success	238	107	65	173	42	0.273	0.5-1.5,2.7-3.1,absent,abundantly,acute,anther,anthesi,apex,broadly,brownish,bud,calyx,cm,cylindrical,diameter,early,extra-axillary,flattened-reniform,flower,free,fruit,generally,glabrous,glandular,glandular-pilose,globose,golden,green,lanceolate,late,leaf,length,light,lobe,lobed,margin,mature,maturity,minutely,mm,narrowly,nearly,ovate,pedicel,peduncle,petiole,pubescence,pubescent,ray,shallowly,shrub,size,stellate,stem,stigma,style,suborbicular,surface,tan,thin-textured,tube,white,x,yellow,yellowish	.6,0.2,0.3,0.3–0.4,0.4–2,0.5–0.9,0.6–1.5,0.7–1.2,0.8,0.8–1.6,0.8–2.5,0–0.5,1.2–2.3,1.5–2,1.6,1.7–2.5,1/3,11,12–20,1–,1–2,1–2-celled,2,2-foliate,2.4–3.6,2.8,200-310,260,2–3,2–4,2–4-celled,3,3.4–4.5,3.5–5.5,3–18,3–5,4,4.5-5.5,4–10,4–14cm,4–15,4–6-rayed,5,6.2–8.1,7,7-10,7–12,7–14,7–15,8–10.5,9,=,abaxially,accrescent,acicular,adaxiall,adaxially,admixture,armed,around,ascending,auxiliary,axe,base,becoming,blade,branche,capitat,cell,column,compressed,contiguou,curled,curved,densely,differing,dimorphic,directed,distall,eaf,eed,enlarged,erect,exceeding,fallen,fertile,fewer,filament,frui,fruiting,geminate,glabrou,gland-tipped,grading,hair,half,horizontally,hyaline,intermixed,larger,least,long,longer,lower,lowermost,main,major,many,midpoint,minute,mixed,much,n,nflorescence,numerous,obtuse,often,one,orolla,pair,per,pilose,pitted,plane,pore,prickle,rachi,recurved,reflexed,relatively,ruit,scarcely,scattered,sessile,short-pilose,shorter,similar,similarly,simple,single-stemmed,slender,slightly,small,smaller,sparsely,spine,spreading,stellae,stout,straight,subcordate,tall,tamen,tem,terete,terminal,tip,triangular,triangular-lanceolate,truncate,unbranched,undulate,unit,usually,various,vary,vein,wid,wide,withered,ympodial,–4,–5	0-0.5,0.3-0.4,0.5-0.9,1-2,1.2-2.3,1.7-2.5,12-20,2-3,2.4-3.6,4-10,4-14,4-15,4-6,6.2-8.1,7-12,abaxial,adaxial,adhesion,capitate,colour,corolla,form,growth,height,history,inflorescence,life,monoecious,na,number,ovary,perennial,plant,position,presence,present,reproduction,rugulose,seed,shape,staman,texture
533	wfo-0001029731	success	246	82	63	183	19	0.256	0.1-0.8,1,1-2,1-2.5,1.5,1.5-2.5,10-20,2.5,2.5-4.5,3-4,4,4-9,6-7,7-11,8-9,acquiring,anther,black,brown,calyx,clavate,cm,conical,coriaceous,corolla,diameter,distributed,elliptic,epiphyte,evenly,filiform,fleshy,fruit,glabrous,leaf,less,liana,linear,lobed,long,long-ellipsoid,mauve,midvein,mm,obconical,oblong,obovate,pedicel,peduncle,petiole,pyriform,stem,stigma,style,succulent,surface,terminal,thick,tube,white,widely,woody,x	.5,.6,0.05,0.25-0.3,1-1.5,1.5-3,1/3,1994,2,2-3,2-6,3,3-10,31,4-5,6,abaxially,accrescent,acuminate,acute,adaxially,age,almost,along,alyx,anthesi,apar,apex,apically,apparently,arcy,articulated,bark,basal,basally,base,beak,becoming,berry,boundary,branch,branched,branching,broadly,bumpy,clearly,concolorous,connate,crinkled,cuneate,darker,delimited,delineated,deltoid,dense,development,different,dilated,domatia,dorsal,dorsifixed,dry,drying,dull,eaf,early,elongating,enlarge,entire,equal,erect,even,exserted,faint,filament,fine,finely,flaring,flattened,flower,free,fruiting,ground,hair,iscoid,lamina,large,later,lateral,lengthening,like,lobe,lon,longitudinal,longitudinally,lower,main,margin,mature,maturity,much,narrowly,nflorescence,nther,obtuse,occasionally,often,orange-brown,orolla,pair,papillae,papillose,part,pendulous,perfec,pericarp,persisting,plurifoliat,pore,poricidal,portion,primary,prominent,protruding,rachi,raised,rakotozafy,rarely,reflexed,reported,revolute,ribbed,ridge,ridged,rounded,ruit,scar,see,several,shallowly,shorter,simple,sinus,slender,slightly,small,smaller,smoot,sometimes,sparsely,straight,stretched,stump,sunk,tearing,thickened,thinner,though,time,tip,toward,trichome,tub,tuft,ud,unit,usually,vary,vein,venation,ventral,visibl,visible,well-developed,wide,wing,winged,wrinkling,yellow,yellow-green,ympodial,young,’	arrangement,colour,form,growth,height,inflorescence,length,na,ovary,plant,position,pubescence,reproduction,rugulose,seed,shape,size,texture,width
534	wfo-0001029741	success	137	79	56	81	23	0.409	0.9-1.2,1-1.5,1-3.5,1.1-1.3,1.5,1.5-4,1.5-6,2.5-7.8,9.5-22.5,?,age,anther,apiculate,base,becoming,calyx,capitate,cm,completely,corolla,dark,deltoid,dia,elliptic,fruit,glabrous,globose,green,growth,inflorescence,leaf,lenticellate,lighter,lobe,lobed,minutely,mm,nearly,opposite,ovary,ovate,papillose,pedicel,petiole,poricidal,shrub,size,stem,stigma,style,tip,tree,tube,weak,white,x	.4,.5,0.5-1.5,0.8-3.5,10-50-flowered,2-2.5,2.2-9,3,accrescent,acute,anthesi,apex,attenuate,berry,black,branched,ca,caly,closely,deflexed,differing,difoliate,divisio,dry,drying,eaf,early,edicel,eed,erect,exserted,filament,flower,free,fruiting,furcate,geminat,glabrou,immature,known,lateral,lon,long,lower,main,major,middle,minor,new,nflorescence,overlapping,pair,papillo,planar,pore,portion,produced,prominent,proximal,quite,raised,reddish-brown,ruit,scar,shaped,slender,slightly,spaced,straight,tall,tapering,tear-drop,ud,unit,usually,variable,vein,widest,wood,woody,ympodial	0.5,1.4,3.5,7.5,arrangement,colour,diameter,form,height,history,length,life,na,peduncle,plant,position,pubescence,reproduction,rugulose,seed,shape,surface,texture
535	wfo-0001029744	success	113	96	57	56	39	0.504	0.3-0.6,1.5-3.2,2,5-8,50,7-15,abaxially,acute,adaxially,apex,base,blunt,calyx,cm,deltate,dendritic,densely,elliptic,entire,extreme,flattened,form,fruit,glabrous,golden,lanceolate,leaf,lobe,long-acuminate,margin,minutely,mm,narrowly,oblanceolate,oblique,opposite,ovoid-reniform,pale,pedicel,petiole,pitted,pubescence,pubescent,revolute,shape,shrub,slightly,sometimes,somewhat,stem,surface,tip,trichome,unifoliate,uniseriate,white,x	0.5-1,1,1.5,2-4,8-10-flowered,8-11,along,apart,bark,beginning,branch,brow,denser,difoliate,distinct,eaf,eed,examined,fide,flexuous,geminate,glabrescent,incrassate,inflorescenc,lamina,leave,looping,lower,major,marginal,mature,minor,nflorescence,node,non-reproductive,occasionally,older,pair,primary,scar,see,similar,simple,single-celled,small,smaller,smith,spaced,thee,thin,ud,unicellular,unit,vein,ympodial,young	3,adhesion,anther,arrangement,blade,brown,climate,colour,corolla,diameter,glandular,growth,hair,height,history,inflorescence,length,life,midpoint,na,number,ovary,peduncle,perennial,plant,position,presence,ray,reproduction,rugulose,seed,size,staman,stellate,stigma,stipe,style,texture,tube
536	wfo-0001029746	success	179	109	77	102	32	0.43	0.3-2,0.7-1,1,1-1.3,1-1.5,2-2.5,2-7,2-8,3,3-4,4-9,8-10,8-11,acuminate,acute,anther,apex,base,blackish,broadly,brown,calyx,capitate,centre,cm,conical,cordate,corolla,cup-shaped,dark,darker,densely,diameter,elliptic,entire,flattened,fruit,glabrous,glandular,globose,greenish,herb,inflorescence,internodal,leaf,lobe,margin,minutely,mm,narrowly,orange,ovary,ovate,ovoid,pale,papillose,pedicel,peduncle,petiole,poricidal,principal,pubescent,purple,red,reddish,simple,stem,stigma,style,subshrub,surface,thin,tip,triangular,tube,vein,x	.5,0.5-1,1.2-1.5,1.5,2,2-4,3-4-pluri-foliate,3-4.5,3-6,6,6-7,abaxially,adaxially,age,anthesi,apart,bearing,becoming,berry,c.,cell,ciliate,color,crenate,crowded,curved,eaf,edicel,eed,ellipsoid,enlarged,erect,exerted,filament,fleshy,flower,flush,free,fruiting,gland-tipped,growing,heteromorphic,hollow,horn,irregularly,lamina,lengthening,less,lon,long,longer,longest,lower,markedly,mature,maturit,mid-length,mixed,near,nflorescence,nodding,occasionally,pair,papillo,pericarp,pitted,plan,pore,portion,primary,pubescen,rachi,reflexed,ruit,scar,shallowly,shortest,single,slender,slightly,slit,somewhat,spaced,sparse,sparsely,spreading,straight,strongly,testal,third,trichome,ud,uniseriate,unit,upper,upward,wall,widely,widest,woody,ympodial,–3	1.5-3,adhesion,annual,arrangement,blade,climate,colour,form,growth,hair,height,history,length,life,midpoint,na,number,perennial,plant,position,presence,pubescence,ray,reproduction,rugulose,seed,shape,size,staman,stellate,stipe,texture
537	wfo-0001029751	success	158	118	98	60	20	0.62	.5,0.6–1.6,1,1.2,1.7,1.8–4,10–11,10–19,1–2,2.2–2.5,2.5–5,2–4-celled,2–5,3,3–9,4,5–10,6,8–9,9–18,acicular,anther,armed,attenuate,broad-based,calyx,capitate,celled,central,clavate,cm,compressed,corolla,covered,deltoid,diam,diameter,eglandular,extra-axillary,fruit,geminate,glandular,globose,globose-ellipsoid,hair,immature,lateral,leaf,length,linear,linear-lanceolate,little,long,longer,lower,membranaceous,midpoint,midvein,mm,moderately,needlelike,orbicular,ovary,pedicel,peduncle,petiole,prickle,pubescent,ray,recurved,ripe,sessile,short,short-stalked,shrub,simple,size,small,solitary,sometimes,sparsely,spreading,stalked,stellate,stigma,straight,style,surface,trichome,upper,variegated,white,whitish,wide,winged,yellow,±,×	1.3–2.6,12–14,1–3,2,2–3,4.5–6,5-merous,5–25-flowered,also,apex,apical,base,blade,broadly,cuneate,di-,eaf,eed,elongate,enlarged,equal,geminat,glabrous,gree,inner,lanceolate,lobe,lon,nflorescence,one,opening,outside,pair,pedunculate,perfect,planar,pore,prickly,ruit,scorpioid,shallow,shorter,smaller,somewhat,subcordate,subtended,tal,tem,tooth,toward,triangular,trifoliate,truncate,twice,unarmed,unbranched,unequal,unit,usually,ympodial	armature,arrangement,colour,form,green,growth,height,history,inflorescence,life,na,plant,position,pubescence,reproduction,seed,shape,stem,texture,tube
538	wfo-0001029758	success	261	144	121	140	23	0.464	.2,.5,0.2,0.5–0.7,0.6–0.9,0.7–1.3,0.8–1.3,0.9–1.0,0.9–1.2,0.9–1.5,1.0–3.4,1.1–1.5,1.1–1.8,1.2–1.4,1.2–1.9,1.3–1.7,1.7–2.8,10.3–14.5,2.1–6.2,2.2–2.9,2.3–3.3,2.3–6.4,2.8–2.9,3.6,5.8,7.6,7–9,8.0–33.1,abaxially,acuminate,adaxially,adnate,anther,apex,appearing,arcuate,attachment,attenuate,base,black,blade,calyx,capitate,chartaceous,cm,cordate,corolla,curved,dark,deltoid,densely,diameter,dry,entire,erect,evenly,extra-axillary,flattened-orbicular,flattened-reniform,flower,fruit,glabrous,globose,green,interpetalar,lateral,length,lobe,lobed,long,margin,markedly,mature,midpoint,mm,moderately,nearly,notched,observed,obtuse,occasionally,orbicular,oval,ovate,pedicel,peduncle,petalar,petiole,point,porrect,prostrate,pubescent,purple,ray,red-brown,reticulate,rounded,short-stipitate,shorter,shrub,simple,stellae,stellate,stem,stigma,stipe,style,sub-coriaceous,surface,tissue,toward,tube,unarmed,vein,well-developed,white,yellow,yellow-brown,yellow-ferruginous,young,×	.3,/4,0.4–1.2,0.7–0.8,0.8–1.1,1.8,1.9–2.6,1.9–2.7,1/3,1/4–1/3,2.8–4.2,3.1–3.8,3.2–3.5,3.5–4.8,4.1–6.3,4.3–4.8,4.3–6.2,4–6,5-merou,5.7–7.8,7–17,8–11,absent,aequilateral,ag,alyx,anthesi,apart,apical,apparently,appresse,arching,around,articulate,axe,ba,basal,bent,berry,broad,brochidodromous,bud,bulge,channeled,cream,cylindrical,dentate,development,directed,directly,distal,distally,distinct,eaf,edge,eed,either,emerging,endocarp,equal,exocarp,extending,fertile,filament,filiform,flexed,free,geminat,glossy,gradually,gree,heterostylous,immature,increasing,intact,internode,intersepalar,juic,lanceolate,layer,least,lon,longer,lower,many,midrib,midvein,minute,nflorescence,often,opaque,orolla,ove,per,perforated,persistent,pore,portion,potentially,presumably,raised,remaining,ridge,rigid,row,ruit,short,side,sinus,sloughing,spaced,splitting,spread,spreading,stamen,stellate-pubescent,stipitate,straight,suture,tamen,tem,tetrafoliate,thin,though,tip,transparent,trifoliate,two,ud,unbranched,unit,various,vary,weakly,well,wide,ympodial,±90°,±a,¼	adhesion,arrangement,climate,colour,form,glandular,growth,hair,inflorescence,leaf,na,number,ovary,position,presence,present,pubescence,rugulose,seed,shape,size,staman,texture
539	wfo-0001029769	success	142	81	58	84	23	0.408	.25,.5,0.5-1.5,1-3,1.5-2.5,2.5-3,2.5-8,3.5-4,5-8,6-17,7-8,8.5-17,anther,base,brown,calyx,capitate,cm,conical,corolla,cyathiform,dark,densely,dia,elliptic,fresh,glabrous,globose,green,hen,internodal,leaf,lobed,minutely,mm,nearly,opposite,ovary,ovoid-reniform,papillose,pedicel,petiole,pitted,poricidal,pubescent,shrub,smooth,somewhat,sparsely,stem,stigma,style,surface,swollen,tip,tube,white,x	1-1.2,1.5-2,30-60-flowered,4,4-5,8-9,abaxially,acuminate,acute,adaxially,along,anthesi,apar,ape,apex,archin,ba,bark,bearing,berry,branch,brochidodromu,cerro,curl-tipped,deflexed,deltoid,eaf,edicel,eed,exserted,filament,filiform,flower,free,fruiting,golden,horizontally,inglé,lateral,less,like,lobe,lon,long,lower,main,margin,midrib,nflorescence,older,onto,pair,papillo,pore,portion,puberulent,reflexed,ried,ruit,scar,scattered,shaped,simple,spaced,straight,tall,tear-drop,three,time,trichome,tub,two,ud,unevenly,unifoliat,uniseriate,unit,vein,wide,widely,winged,woody,ympodial,young	arrangement,colour,diameter,form,fruit,growth,height,history,inflorescence,length,life,na,perennial,plant,position,pubescence,reproduction,rugulose,seed,shape,size,texture,unifoliate
540	wfo-0001029771	success	196	107	79	117	28	0.403	.5,0-0.5,0.1-0.3,0.3-0.6,0.3-1,0.4-0.7,0.4-1.4,0.45-0.9,0.9-1,1-1.5,1-2,1.2-2.8,2-2.3,2-3,2.5-10,2.5-7,3-4,4-7,5.5-8,7-8,absent,acute,anther,apex,base,blade,calyx,chartaceous,cm,connivent,cordate,densely,diameter,elliptic,entire,extra-axillary,fruit,glabrous,gland-tipped,globose,grey,hair,inflorescence,lanceolate,leaf,length,lilac,lobe,margin,mm,obtuse,ovate,pale,pedicel,peduncle,perennial,petiole,present,pubescent,purple,ray,red,reniform,reticulate,rhizomatous,rotate,rotate-stellate,scattered,short,shrub,simple,stellate-pubescent,stigma,style,surface,tube,white,x,yellow	%,0-0.25,0-0.6,0-3,0-4,0-5,0.05-0.15,0.2-0.25,0.2-0.4,0.4-1,0.5-0.7,0.5-1.2,0.7-1.2,0.7-1.8,0.8-1.2,1,1-5,1-locular,1.8-3,15-35,2,2-3-foliate,4-,4.5-12,5-10,5-9,5-merou,6-11,7-10,abaxially,absen,accrescent,across,adaxially,adult,alyx,apart,apparen,articulated,axe,ba,branch,capitat,contiguous,curved,cylindrical,deltate,directed,distall,distributed,dm,eaf,eed,eglandular,erect,exceeding,exocarp,filament,finger,flower,fruiting,geminate,green,grey-green,incomplete,interpetalar,juicy,juvenile,lamina,lateral,lon,long,lower,mature,mesocarp,mid-point,midpoint,minute,nearly,nflorescence,oblique,orolla,part,per,perfect,placenta,pore,porrect,prickle,pseudo-umbellate,rachi,ruit,septum,slightly,somewhat,spaced,stalk,stellae,straight,succulent,tal,tamen,tem,thick,throughout,time,tissu,tissue,unarme,unarmed,unbranched,unit,upper,vary,wide,yellowish,ympodial	adhesion,arrangement,capitate,colour,corolla,form,glandular,growth,height,history,life,na,number,ovary,plant,position,presence,pubescence,reproduction,rugulose,seed,shape,size,staman,stellate,stem,stipe,texture
541	wfo-0001029775	success	54	71	27	27	44	0.5	0.25-1.5,0.5-4,3-4,4-5.5,alveolate,base,brown,cm,diameter,flattened,glabrous,globose,light,margin,mm,orange,perennial,puberulent,sparsely,stigma,strongly,subshrub,surface,unifoliate,vine,x,yellow	2-6,2-8,6-16,absen,aggregate,ecuador,eed,hollow,internode,long,prickle,recurve,ripe,robust,ruit,shin,straight,tal,tem,thickened,tone-cell,trichome,truncat,unbranched,unit,wide,ympodial	adhesion,anther,apex,arrangement,blade,calyx,climate,colour,corolla,form,fruit,glandular,growth,hair,height,history,inflorescence,leaf,length,life,lobe,midpoint,na,number,ovary,pedicel,peduncle,petiole,plant,position,presence,pubescence,ray,rugulose,seed,shape,size,staman,stellate,stem,stipe,style,texture,tube
542	wfo-0001029780	success	204	118	87	117	31	0.426	1-1.2,1-2,11-24,15-22,15-45,2-2.8,2-3.5,2-5.5,3.5-7.3,4-6,5.5-13,50-70,8-12,?,abaxially,acute,adaxially,anther,apex,articulated,attenuate,axillary,base,blade,brownish,bud,chartaceous,cm,condition,cordate,corolla,cuneate,dark,densely,diameter,distal,drying,fresh,fruit,glabrous,glandular,globose,green,greenish,hair,half,herb,high,invested,lanceolate,length,lobe,margin,membranous,minutely,mm,non-glandular,obtuse,odd-pinnate,ovate,ovoid,pale,pedicel,peduncle,petiole,pinkish,plant,puberulent,pubescent,rotate,seed,short,size,stem,stigma,streak,stripe,style,subtending,terminal,trichome,truncate,tube,white,whitish,x,yellow	1-10,1.4-1.9,1.5-2,120-210,2-12,2-2.5,2.4-4.2,20-60,3,3-6,4.5-6,5-7,5-merou,5.5,600-950,absent,acumen,ag,along,alyx,apart,apparently,axe,berry,borne,capitat,cell,ciliate,connivent,covering,decumbent,digestion,dorsally,eaf,edge,eed,end,enzyme,erec,especially,exceeding,except,filament,flat,flower,folded,forked,geminat,generally,glabrou,gland,greatly,green-white,hair-like,hal,head,homostylous,honeycomb-shaped,interjected,lateral,leaflet,lengthening,like,living,long,longer,lower,make,midrib,minute,mucilaginous,nflorescence,often,orbicular,orolla,pair,perfect,petiolulate,petiolule,plurifoliate,pore,poricidal,proximal,rarely,reduced,removed,ripe,ruit,sessile,seudostipule,singly,slit,spaced,specimen,stamen,ste,stolo,straight,subequal,tall,tamen,tem,testal,tetralobulate,thick,throughout,tip,tri-,tuber,typically,unit,unwinged,usually,vary,wall,wet,ympodial	adhesion,arrangement,calyx,capitate,climate,colour,form,growth,height,history,inflorescence,leaf,life,midpoint,na,number,ovary,perennial,position,presence,present,pubescence,ray,reproduction,rugulose,shape,staman,stellate,stipe,surface,texture
543	wfo-0001029784	success	237	99	75	162	24	0.316	-5,.1,.5,0.25-0.3,0.4-0.45,0.4-0.6,0.5-1.5,0.6-1,1-1.1,1-1.2,1-4,1.0-1.3,1.5-,1.7-2.6,2,2-,2-2.5,2/3,3-,3-5,5-14,5-8,abaxially,anther,brown,calyx,capitate,cm,corolla,dark,densely,diameter,eglandular,elliptic,fruit,glabrous,globose,golden,green,herb,imparipinnate,inflorescence,interrupted,lanceolate,like,lobe,long,mm,narrowly,obovate,ovary,pale,pedicel,peduncle,pentagonal,perennial,petiole,plant,proximal,pubescence,pubescent,soft,sparsely,stem,stigma,stripe,style,surface,thick,trichome,tube,velvety,white,wide,yellow	-12,.2,0-4,0.1-,0.1-0.15,0.1-0.5,0.2,0.2-,0.2-0.3,0.2-0.5,0.3-0.35,0.3-0.4,0.3-0.5,0.3-1,0.4-,0.4-0.5,0.5,0.5-,0.7-1.2,0.9-1.2,1,1-,1-1.5,1-2,1-2-celled,1.2-2.5,1/3,2-3-celled,2-4,2-4.5,2-foliate,2-locular,2.5-3.5,5-10,abaxial,absent,abundant,acuminate,acute,adaxially,adpressed,along,angled,anthesi,apex,apical,appearance,appendage,arising,articulated,articulation,axi,basal,base,basicopically,beneath,berry,bract,broadly,cell,column,conical,crenate-serrate,crenation,decurrent,deeper,developed,distal,distributed,due,eaf,edicel,eed,enclosing,entire,evenly,exserted,filament,flower,fruiting,giving,glabrescent,glandular,gree,hair-like,hal,half,halfway,head,included,interjected,internode,interspersed,irregularly,lamina,larger,lateral,leaflet,live,lon,long-acuminate,loosely,lower,margin,markedly,maturing,mostly,multicellular,nflorescence,node,northern,occasionally,often,orbicular,outgrowth,pair,paler,patent,petiolule,population,present,primary,pseudostipule,rarely,reflexed,ripe,robust,ruit,scattered,secondary,sessile,silky,simple,smaller,sometimes,somewhat,sparse,spreadin,staminal,sterile,stout,straight,strongly,tem,terminal,tertiary,testa,trailing,truncate,ud,undulate,unicellular,uniseriate,unit,unseriate,usually,vein,wall,winged,woody,x,ympodial	adhesion,arrangement,colour,form,growth,height,history,leaf,length,life,na,number,position,presence,ray,reproduction,rugulose,seed,shape,size,staman,stellate,texture,ye
544	wfo-0001029785	success	223	116	93	130	23	0.417	0.1-0.5,0.8-1,1-1.2,1-2,1-5,1.2-3.2,1.5-3.6,1.8-3.5,10-26,2-4,3.5-5,3.8-7.2,5-16,5-9,8-11,abaxially,acute,adaxially,along,anther,attenuate,axillary,broadly,brownish,bud,chartaceous,clavate,cm,commonly,condition,corolla,dark,darker,denser,diameter,drying,especially,fresh,fruit,glabrous,globose,green,greenish,hair,herb,invested,lanceolate,leaf,like,lobe,long,margin,medium,membranous,midrib,minutely,mm,mottled,multiple-celled,non-glandular,odd-pinnate,outer,ovate,ovoid,pedicel,peduncle,pentagonal,petiole,plant,puberulent,pubescent,purple,ripe,rotate,seed,short,size,slightly,sparsely,stem,stigma,style,subglabrous,subtending,terminal,tube,unbranched,vein,violet,whitish,wide,x,yellow	0-2,0-3,0.3-2.2,0.4-4.9,1-10,1.8-7,3-4,3-6,3-8,4-10.5,5-merou,6,absent,acumen,ag,alyx,apart,apex,apparently,articulation,axe,base,berry,blade,borne,capitat,cell,connivent,cordate,covering,cuneate,decreasing,decumbent,digestion,distal,dorsally,eaf,edge,eed,elliptic,end,enzyme,erec,exceeding,filament,flat,flower,folded,forked,geminat,generally,glabrou,greatly,green-white,hair-like,half,homostylous,honeycomb-shaped,interjected,larger,lateral,leaflet,lengthening,living,lower,make,markedly,middle,minute,much,mucilaginous,nflorescence,oblique,obovate,obtuse,one-quarte,orbicular,orolla,pair,pale,perfect,petiolulate,petiolule,plurifoliate,point,pore,poricidal,present,purple-tinged,quite,rarely,removed,rounded,ruit,scale-like,sessile,seudostipule,shallowly,singly,slit,sometimes,spaced,specimen,stamen,ste,stolo,straight,stripe,tall,tamen,tem,testal,thick,throughout,tip,toward,tri-,truncate,tuber,typically,unequal,unit,unwinged,usually,variable,vary,wall,wet,white,ympodial	adhesion,arrangement,calyx,capitate,colour,form,growth,height,history,inflorescence,length,life,na,ovary,perennial,position,pubescence,reproduction,rugulose,shape,staman,surface,texture
545	wfo-0001029788	success	194	121	96	98	25	0.495	.7,0.5,1-10,1-2,1.2-2,12-15,2-2.5,25-30,3.5-6,4,4-5,5-13,6,6.5-7,7-21,abaxially,adaxially,along,anther,apart,articulated,attenuate,axillary,berry,brownish,bud,cell,chartaceous,ciliate,cm,condition,conical,connivent,corolla,covering,densely,diameter,distal,drying,especially,fresh,glabrous,green,green-white,greenish,hair-like,half,herb,lanceolate,lateral,leaf,light,lobe,long,make,margin,midrib,minutely,mm,mottled,mucilaginous,narrow,odd-pinnate,ovoid,pedicel,peduncle,petiole,plant,puberulent,pubescent,purple,ripe,rotate,seed,size,spaced,sparsely,stigma,straight,style,subtending,terminal,testal,thick,throughout,tip,tube,unwinged,violet,wall,wet,whitish,wide,wing,x,yellow	.4,0-5,0.7-2,1.5-2,2-4,2.4-5.5,3-4,4-6,4.5-5,5,5-merou,absent,acumen,acuminate,ag,alyx,apex,asymmetrical,axe,base,basiscopic,blade,borne,c.,capitat,commonly,decreasing,digestion,dorsally,eaf,edge,eed,elliptic,elliptic-lanceolate,end,enzyme,equal,erec,filament,flat,flower,folded,forked,geminat,generally,glabrou,gradually,hal,homostylous,honeycomb-shaped,increasing,interjected,larger,leaflet,lengthening,living,lon,lower,middle,minute,nflorescence,orbicular,orolla,pair,petiolule,pilo,plurifoliate,pore,poricidal,ray,removed,ruit,secondary,semierect,sessile,seudostipule,side,singly,slightly,slit,specimen,stolo,subequal,subsessile,symmetrical,tall,tamen,tem,tissue,toward,tri-,tuber,typically,unit,usually,vary,white,ympodial	adhesion,arrangement,calyx,capitate,colour,form,fruit,growth,height,history,inflorescence,length,life,na,ovary,perennial,position,pubescence,reproduction,rugulose,shape,staman,stem,surface,texture
546	wfo-0001029789	success	167	99	72	95	27	0.431	0.2-0.5,1-2,1-3,12,2-6,2-6.5,2.7-4.7,3-8.5,4-10,4-13,5-7,6,7-16.6,7-21,8-9,abaxially,adaxially,anther,axillary,blue,broadly,bud,chartaceous,clavate,cm,connivent,corolla,dark,diameter,fruit,glabrous,green,hair,herb,lanceolate,leaf,light,lilac,linear,lobe,long-attenuate,lunate,membranous,minute,minutely,mm,narrowly,odd-pinnate,ovary,ovate,pedicel,peduncle,pentagonal,petiole,plant,pubescent,rachi,rarely,rotate,simple,size,sparsely,stigma,style,subglabrous,subtending,terminal,tinged,tube,white,x,yellow	0-2,0.5-2.8,0.8-3.5,1-10,1.5-2,1.7-8.5,1.8-6.5,2-25,2-3,3-5,5-merou,6-7,acumen,acuminate,acute,adaxiall,ag,alyx,apart,apex,apparently,articulated,attenuate,axe,base,basiscopic,blade,capitat,decreasing,decurrent,distal,dorsally,eaf,edge,eed,erec,exceeding,filament,flat,flower,folded,forked,formed,geminat,generally,greatly,hal,half,homostylous,interjected,lant,lateral,leaflet,lengthening,like,long,lower,maturing,mottled,never,nflorescence,orbicular,orolla,pair,perfect,petiolulate,plurifoliate,pore,poricidal,pubescen,purpl,sessile,seudostipule,short,side,slightly,slit,spaced,stamen,star,ste,sterile,straight,subequal,tall,tamen,tem,tip,toward,tri-,typically,unit,usually,vary,ympodial	adhesion,arrangement,calyx,capitate,colour,form,growth,height,hermaphroditic,history,inflorescence,length,life,na,perennial,position,pseudostipule,pubescence,purple,reproduction,rugulose,seed,shape,staman,stem,surface,texture
547	wfo-0001029810	success	149	102	81	68	21	0.544	.5,0.5-3,1-1.3,1-1.5,1-10,1-2,1.1-2.3,1.5-3,2.5-3,3-3.5,3-4,3-6,5-16,5-6,adaxially,along,anther,apically,arachnoid,base,brown,calyx,capitate,cm,compact,compressed,conical,corolla,dark,dendritic,densely,dia,elliptic,glabrous,globose,green,inflorescence,internodal,leaf,like,lobed,long,margin,minutely,mm,narrowly,nearly,occasionally,opposite,ovary,ovoid-reniform,pale,papillose,pedicel,petiole,pitted,pointed,pore,poricidal,pubescent,reddish-brown,rest,shaped,shining,shrub,size,small,sparsely,stem,stigma,style,surface,tan,tear-drop,tip,tree,trichome,tube,vein,white,wide	.25,0.5-1,1-3,2-3,2-5,4-10,5-15-flowered,8-12,abaxially,acuminate,acute,anthesi,ape,apex,attenuate,bark,berry,closely,congested,deflexed,deltate,differing,difoliate,drying,eaf,edicel,eed,ellipsoid,exserted,filament,fleshy,free,fruiting,geminat,glabrou,large,later,lateral,lenticel,less,lobe,lon,lower,main,major,middle,minor,nflorescence,older,overlappin,papillo,planar,portion,ruit,scar,simple,slender,spaced,tall,tapering,tub,ud,unit,widest,woody,yellowish,ympodial,young	arrangement,colour,diameter,form,fruit,growth,height,history,length,life,na,peduncle,perennial,plant,position,pubescence,reproduction,rugulose,seed,shape,texture
548	wfo-0001029811	success	225	125	96	129	29	0.427	-3,0-35,0.1-0.4,0.3-1,1.3-1.7,1.5-6,1/3,13-20,2-2.5,2.5-3,2.8-3.2,3-5.5,4-8,4.5-5,5-11,5-17,6-12,7-9,8-12,abaxially,andromonoecious,anther,apex,apically,base,berry,blade,brown,calyx,cell,chartaceous,cm,connivent,cordate,cream,cuneate,dark,diameter,elongate,flattened-reniform,fruit,glabrous,glandular,green,hair,herb,lateral,leaf,length,lobe,lobed,long,lower,margin,marking,maturity,mauve,midpoint,minute,mm,moderately,narrow-deltate,obtuse,often,orange-brown,outline,ovate,pale,pedicel,peduncle,petiole,pit,plant,poricidal,raised,ray,scandent,shrub,simple,small,smooth,sometimes,sparsely,spherical,stellate,stellate-pubescent,stem,style,surface,tapering,tip,tube,upper,wide,yellow,young	-6,-merous,.5,/3,0,0-30,0.1-0.3,0.2,0.2-0.6,0.3-1.5,0.5-2,0.8-1.5,1,1-1.5,1-2.5,1-3,1.5-2.5,1/,1/2-2/3,1/3-2/3,10-22,15-23,15-50,2-5,2-5.5,20-100,3-5,3-7,3.5-4.5,5,5-40,5-9,7-18,8-18,abaxial,acicular,adaxial,alyx,apar,apart,apparently,articulated,bark,broad-deltate,densely,discolorous,distal,distance,drying,eaf,eed,elongating,equal,erect,extending,eye,faint,fewer,filament,flattened,flower,free,fruiting,green-brow,hermaphrodite,heterostylous,inflated,infructescence,less,lobing,long-acuminat,long-styled,longer,lowermost,mature,midvein,multangulate,naked,nflorescence,older,one,open,orolla,oung,pair,pendulous,per,pericarp,perpendicular,plurifoliat,porrect,portion,prickl,prickle,prickly,primary,ruit,scar,secondary,sessile,short,short-styled,shorter,side,slightly,spaced,spreading,stalk,stalked,staminat,stout,straight,tamen,terete,tertiary,time,trichome,unarmed,unbranched,unit,usually,vary,vein,venation,visible,way,woody,yellow-green,ympodial	1/2,adhesion,arrangement,climate,colour,corolla,form,growth,height,history,inflorescence,life,long-acuminate,na,number,ovary,position,presence,present,pubescence,reproduction,rugulose,seed,shape,size,staman,stigma,stipe,texture
549	wfo-0001029938	success	179	126	97	82	29	0.542	0.5,0.7-1,0.7-1.2,1,1-1.5,1-2.5,1-3,1-4,1.5-2,1.5-2.5,12,2-2.5,2.5-3,3-7,3/4,5,6-8,6-9,abaxially,acute,along,anther,apex,appearing,base,becoming,berry,black,blade,bright,calyx,capitate,clavate,cm,conical,corolla,deltoid,dendritic,densely,diameter,elliptic,entire,fine,flattened,free,fruit,glabrate,glabrous,globose,greenish,grey,growth,later,lateral,leaf,length,lenticular,lobe,long-triangular,margin,maturity,minutely,mm,narrowly,near,occasionally,ovary,pedicel,pericarp,petiole,pitted,plane,plant,plurifoliate,poricidal,pubescent,red,reddish-brown,shrub,small,somewhat,sparsely,stem,stigma,style,surface,terminal,thin,tip,tree,trichome,tube,violet,way,white,winged,x	.5,0,1.2-1.5,1/2,10-20,12-15,4,8-10,absent,accrescent,adaxially,anthesi,apical,ba,bark,basal,branching,broader,deciduous,deflexed,denser,dichasia,discussion,drying,eaf,edicel,eed,elliptical,ew,exserted,filament,flower,fruiting,glabrou,growing,horizontal,inserted,larger,lon,long,lower,m.,monochasial,nflorescence,older,overtopping,pair,papillo,parallel,per,perhaps,planar,pore,portion,prominent,pyramidal,raised,ruit,scar,secondary,see,shade,shoot,sleeve,slit-like,soon,specimen,stamen,strongly,tall,tapering,time,tub,ud,unit,upon,upper,vein,wide,woody,ympodial,young	adhesion,arrangement,climate,colour,form,glandular,hair,height,history,inflorescence,life,midpoint,na,number,peduncle,perennial,position,presence,pubescence,ray,reproduction,rugulose,seed,shape,size,staman,stellate,stipe,texture
550	wfo-0001029945	success	211	114	91	120	23	0.431	0-0.6,0.15-0.25,0.2-0.3,0.4-0.5,0.7-1.2,1.3-3.5,1.5-4,1.8-2.4,10-17,15-24,2.1-3.3,2.5-2.8,3-17,3-6,4-5.5,5-8,6-8,7-24,9-10,absent,acute,adaxially,andromonoecious,anther,apex,attenuate,base,blade,broadly,calyx,chartaceous,cm,cordate,cylindrical,dark,deeply,densely,diameter,erect,extra-axillary,flower,fruit,glabrous,gland-tipped,globose,green,grey,hair,inflorescence,lanceolate,leaf,length,lobe,lobed,long,margin,mid-point,mixed,mm,oblique,obtuse,ovate,pale,pedicel,peduncle,perennial,petiole,plant,present,purple,ray,rhizomatous,rotate,shallowly,short,shrub,simple,sparsely,stellate,stellate-pubescent,stem,stigma,streak,style,thick,throughout,triangular,tube,white,x,yellow	%,.05,0,0-0.3,0-0.5,0-1,0-10,0-2,0.35-0.45,0.4-0.7,0.5,0.8-1,1-1.3,1-1.5,1-3,1-8,1.2-1.6,1.4-2.7,1.7-4,17-26,2-30,2-4,2-5,2-locular,3-5,3-9,4-10,4-7,4-9,5-merou,5.5-17,6-10,6-7,7-14,7-9,9-24,abaxial,abaxially,absen,accrescent,acicular,across,adaxial,adaxiall,adult,alyx,anvil-shape,apart,armed,articulated,ba,broad-based,connivent,cross-section,d.,directed,distall,distally,dult,eaf,eed,eglandular,exocarp,filament,finger,fruiting,functional,geminate,half,heterostylous,hig,index,juicy,juvenile,lateral,less,lobing,lon,longer,lower,markedly,mature,mesocarp,midpoint,midvein,minute,moist,nflorescence,orolla,pair,part,per,placenta,pore,porrect,prickle,pseudo-racemose,ruit,sessile,side,stalk,stalked,stellae,straight,surface,tamen,thicker,time,transparent,truncat,unarmed,unbranched,unit,upper,vary,vein,weakly,wide,yellowish,ympodial	adhesion,arrangement,colour,corolla,form,glandular,growth,height,history,life,na,number,ovary,position,presence,pubescence,reproduction,seed,shape,size,staman,texture,truncate
551	wfo-0001029968	success	299	140	114	185	26	0.381	.25,/3,0.1-0.25,0.2-0.4,0.25-0.3,0.3-1,0.4,0.7-0.9,0.7-2,0.8-1.2,1-2.5,1.2-5.5,1.5-2.5,2-2.3,2-3,2.5-3.5,2.8-3,3-11,3-4,4-6,6-8,7-9,abaxially,acuminate,acute,adaxially,along,anther,apex,base,becoming,berry,black,branch,brown,calyx,capitate,chartaceous,clavate,clustered,cm,corolla,cuneate,cupular,dark,deltoid,densely,diameter,distributed,dry,entire,evenly,flattened-reniform,free,fruit,glabrous,gray,inflorescence,large,lateral,leaf,length,like,lobe,lobed,long,margin,mature,midpoint,mixture,mm,obconical,oblique,oblong,orange,orange-brown,outside,ovate,pale,pedicel,peduncle,petiole,present,pubescent,ray,regular,rounded,rounded-undulate,seed,shoot,shrub,simple,size,small,sparsely,spheroidal,stellate,stellate-pubescent,stem,stigma,strongly,style,surface,tapering,terminal,thin,tip,toward,trichome,tube,uneven,wrinkled,x,young	-2,-3,.2,.5,.7,0,0.15,0.25,0.3,0.3-0.4,0.4-0.6,0.5,0.7-1,0°,1,1-3,1.5,1.5-3,1/4-1/3,1/6-1/8,2.5-4,2.5-5.5,4,4-7,4-8,4-merou,absent,accrescent,acicular,adjacent,age,almost,alternate,alyx,anthesi,apart,apically,apparently,area,arising,armed,articulated,articulation,bark,basally,brachyblast,branched,branching,ca,canaliculate,central,cordate,covered,curved,dehiscence,detaching,development,dilated,discolorous,divided,drying,eaf,early,edge,eed,ellipsoi,elongating,equal,erect,except,extending,fasciculate,filament,filiform,finely,flat,flattened,flexuous,flower,forming,fruiting,glabrescent,grey-green,greyish,increasing,indumentum,inside,invisible,irregular,irregularly,large-leaved,leave,leaved,lengt,lengthening,less,line,lobing,looping,lower,m.,main,maturity,middle,midvein,minor,network,nflorescence,nther,obscured,obscurely,occasionally,often,opposite,orolla,ovoid,pair,paler,papillose,patch,pendulous,per,perfect,pericarp,pit,pitted,plurifoliat,pore,poricidal,porrect,portion,prickle,primary,prior,prominent,protruding,rachi,raised,red,reddish,reduced,remnant,ridged,ruit,scar,secondary,seemingly,seen,sessile,shiny,shorter,sinus,small-leaved,smoot,smooth,sometimes,somewhat,sparse,specimen,spreading,stalk,stalked,straight,stump,tearing,terete,tertiary,thicker,translucent,ud,unarme,unarmed,undulate,unit,usually,variable,vary,vein,venation,virtually,visible,white,wide,widening,ympodial	adhesion,arrangement,blade,climate,colour,form,glandular,growth,hair,height,history,life,na,number,ovary,perennial,plant,position,presence,pubescence,reproduction,rugulose,shape,staman,stipe,texture
552	wfo-0001029978	success	208	107	84	124	23	0.404	0.3-0.4,0.5-0.6,1-2,1.3-1.5,1.4-1.5,1.5-3.1,15-27,3-5,3-7,3.2-2.5,3.5-9.5,3.7-8.1,4-7,4.2-5.2,5-16.5,8-10,abaxially,adaxially,along,anther,attenuate,axillary,brownish,bud,chartaceous,ciliate,clavate,cm,coarsely,condition,conical,corolla,diameter,drying,elliptic,especially,finely,fresh,fruit,glabrous,green,greenish,hair,herb,lanceolate,leaf,light,like,lobe,long,margin,membranous,midrib,minutely,mm,mottled,odd-pinnate,ovate,ovoid,pedicel,peduncle,pentagonal,petiole,plant,puberulent,pubescent,purple,ripe,rotate,seed,simple,size,sparsely,stem,stigma,style,subtending,terminal,tip,tube,whitish,wide,x,yellow	0.3-0.7,0.7-1.9,0.8,0.9-2.3,1-10,1.8-5,11-19,2-4,3.1-6.3,4-11,5,5-merou,acumen,acuminate,ag,alyx,apart,apex,apparently,arranged,articulated,asymmetrical,axe,base,basiscopic,bead,berry,blade,capitat,cell,commonly,connivent,covering,dark,darker,decreasing,digestion,distal,dorsally,eaf,edge,eed,enzyme,erec,exceeding,filament,flat,flower,folded,forked,fourt,geminat,generally,glabrou,gradually,green-white,hair-like,half,homostylous,honeycomb-shaped,interjected,larger,lateral,leaflet,lengthening,less,living,lower,make,medium,middle,minute,moniliform,mucilaginous,multiple,narrow,necklace,nflorescence,orbicular,orolla,pair,perfect,petiolule,plurifoliate,pore,poricidal,pubescen,ray,removed,ruit,secondary,semierect,sessile,seudostipule,side,slightly,slit,spaced,specimen,stamen,ste,stolon,straight,subequal,subsessile,symmetrical,tall,tamen,tem,testal,thick,throughout,tissue,toward,tri-,tuber,typically,unit,usually,vary,wall,wet,wing,ympodial	adhesion,arrangement,calyx,capitate,colour,form,growth,height,history,inflorescence,length,life,na,ovary,perennial,position,pubescence,reproduction,rugulose,shape,staman,surface,texture
553	wfo-0001029980	success	173	94	68	105	26	0.393	0.25-0.5,0.25-1,0.5-1.2,0.5-2.5,0.5-5,0.7-1.3,0.8-1.2,1-1.5,1.2-2.5,1.5-2,2-5,2/3,3-4,3-9,6.4-17,anther,base,bright,calyx,cm,conical,corolla,deflexed,deltoid,dia,elliptic,flattened-reniform,glabrous,globose,gray,green,greenish-white,leaf,lobe,lobed,minutely,mm,opposite,ovary,ovate,pale,papillose,pedicel,petiole,pitted,plant,poricidal,puberulent,shape,shiny,shrub,size,slightly,small-capitate,stem,stigma,style,surface,tan,tip,trichome,tube,tuft,uniseriate,way,white,winged,x	.1,.5,0.1-0.25,0.5-1,0.9-4.5,1-1.7,1.5-6,2-6,5-10,5-50-flowered,abaxially,acute,adaxially,anthesi,apar,apex,appearing,appressed,axil,ba,bark,berry,black,brown,bud,closely,curved,dark,decurrent,density,differing,difoliate,dried,drying,eaf,edicel,eed,elevation,especially,exserted,filament,five,free,fruiting,geminat,greatly,high,impressed,incrassate,knob,lateral,live,lon,long,lower,main,major,margin,material,middle,minor,near,nflorescence,node,often,older,one,onto,orbicular,overlapping,pair,paler,pore,portion,prominent,proximal,race,reflexed,rounded,ruit,scar,shaped,side,simple,slender,somewhat,soon,spaced,specimen,straight,tall,tapering,tear-drop,ud,unicellular,unit,varying,vein,venezuelan,whit,widest,woody,yellowish,ympodial,young	adhesion,arrangement,colour,diameter,form,fruit,growth,height,history,inflorescence,length,life,na,number,peduncle,perennial,position,presence,pubescence,ray,reproduction,rugulose,seed,staman,stellate,texture
554	wfo-0001029989	success	161	107	79	82	28	0.491	0.25-0.5,0.5-1,0.5-1.5,1-1.5,1-2.5,1-4,1.3-2.3,2.5-3,3-5,3-8,3.5-8,4-4.5,5-6,7-20,abaxially,adaxially,anther,apex,base,broadly,calyx,capitate,cm,congested,conical,corolla,deltoid,dendritic,densely,dia,difoliate,elliptic,flattened,glabrous,globose,golden,gray,green,greenish-black,incrassate,inflorescence,internodal,leaf,lenticular,lobe,lobed,long,margin,minutely,mm,nearly,occasionally,opposite,ovary,pedicel,petiole,pitted,poricidal,pubescence,pubescent,reddish-brown,shining,short-style,shrub,small,sparsely,stem,stigma,style,surface,tip,tree,tree-like,trichome,tube,unifoliate,white,wide,x	.2,.5,/2,1-2,1.5-2.5,10-14,5-10-flowered,abaxial,acute,anthesi,bark,berry,branch,branched,brownish-re,central,closely,collection,deflexed,dense,described,dimaeter,discussion,drying,due,eaf,edicel,eed,erect,exserted,filament,fleshy,free,fruiting,geminat,heteromorphic,inflorescenc,lamina,lateral,like,lon,lower,main,middle,nflorescence,nodding,northern,older,overlappin,pair,papillo,peru,peruvian,perú,petal,petaloid,planar,population,pore,portion,probably,reddish,rest,ruit,scar,scattered,see,shaped,simple,somewhat,spaced,tall,tear-drop,ud,unit,vein,way,widest,woody,yellow,ympodial,young	2.5,adhesion,arrangement,brownish-red,colour,diameter,form,fruit,growth,height,history,length,life,na,number,peduncle,plant,position,presence,ray,reproduction,rugulose,seed,shape,size,staman,stellate,texture
555	wfo-0001030000	success	155	151	122	33	29	0.787	-4,-5,-50,-7,0.5-,0.5-1,0.5-14,0.5-3,1,1-,1-10,1-2,1.5-,1.5-2,15-25,2-2.5,2-3,2-4,2-5,2.5-,2.5-3,2.5-3.5,25-30,3-16,3-4,3.5-5,4,4-4.5,4-5,7-15,abaxially,absent,acute,adaxially,also,apart,apex,apiculate,articulated,base,calyx,chartaceous,cm,connective,connivent,conspicuous,coriaceous,cucullate,deltate,densely,dia,diameter,dilated,directed,distally,eglandular,ellipsoidal,equal,exceeding,flattened,fruit,glabrous,globose,green,hair,immature,laterally,leaving,lobe,long,margin,mature,mm,moderately,narrowly,oblong,obtuse,occasionally,orange,ovoid,pedicel,pedicellar,peduncle,pilose,pore,produced,puberulent,pubescent,purplish,rachi,radiu,rarely,remnant,scar,shorter,shrub,slightly,small,sparsely,spotted,stellate,stigma,strongly,style,subcoriaceous,swelling,thecae,tinge,tip,tomentose,tree,triangular,truncate,tube,umbrella-shaped,unbranched,white,wide,x,yellow,yellow-brown,yellowish	-pilose,10-,10-20,3-,30-50,4-foliat,aggregate,ape,axe,biglandula,cell,ciliat,creamy-whit,eed,flower,lon,lower,nflorescence,nther,orolla,perfect,pubescen,ruit,smal,spaced,stamen,stone,tal,tem,ud,unit,vary,ympodial	anther,articulation,biglandular,bud,ciliate,colour,corolla,creamy-white,direction,form,growth,height,history,inflorescence,length,life,na,ovary,plant,position,pubescence,reproduction,seed,shape,size,spacing,stem,texture,theca
556	wfo-0001030000	success	178	113	84	94	29	0.472	-7,-pilose,0.5-,0.5-1,0.5-13,0.5-3,1-10,1-5,1.5-,15-25,2-,2-2.5,2-3,2.5-,2.5-3.5,3-,3-16,3-4,3.5-5,4-25,4-4.5,4-5,5-25,abaxially,acuminate,acute,adaxially,also,apex,apiculate,basal,base,calyx,cm,cordate,deltate,densely,diameter,ellipsoidal,entire,flattened,fruit,glabrescent,glabrous,globose,green,immature,lobe,margin,mature,mm,moderately,oblique,oblong,occasionally,often,orange,ovate,pedicel,peduncle,petiole,pilose,puberulent,purplish,shrub,simple,small,sparsely,spotted,stellate,stigma,style,subcoriaceous,tinge,tip,tree,truncate,tube,vein,white,x,yellow,yellow-brown,yellowish	-2,-4,-5,-50,0.5-14,1,1-,1-1.5,1-2,1.5-2,10-,10-20,2-4,2-5,2.5-3,25-30,30-50,4,4-foliat,7-15,absent,aggregate,apart,ape,articulated,axe,biglandula,blade,cell,chartaceous,ciliat,connective,connivent,conspicuous,coriaceous,creamy-whit,cucullate,dia,dilated,directed,distally,eaf,eed,eglandular,elliptic,equal,exceeding,flower,hair,laterally,leaving,lon,long,lower,narrowly,nflorescence,nther,obtuse,orolla,ovoid,pedicellar,perfect,pilo,pore,produced,pubescen,pubescent,rachi,radiu,rarely,remnant,ruit,scar,shorter,slightly,smal,spaced,stamen,stone,strongly,swelling,tal,tem,thecae,time,tomentose,triangular,ud,umbrella-shaped,unbranched,unit,vary,wide,ympodial	0.5-2.5,adhesion,anther,arrangement,biglandular,colour,corolla,form,growth,height,history,inflorescence,leaf,length,life,na,ovary,plant,position,pubescence,reproduction,rugulose,seed,shape,size,staman,stem,surface,texture
557	wfo-0001030004	success	177	110	79	98	31	0.446	0-1.5,0.2-1,0.3-1,1-1.5,1-2,1.2-2,1.5-2.5,2-20,3-3.5,3-4,3.5-5,4-15,5-25,9-30,acuminate,acute,adaxially,anther,apex,base,blade,broadly,calyx,capitate,cm,conical,corolla,deltate,dendritic,dia,elliptic,flattened-reniform,glabrous,globose,green,hard,inflorescence,later,lateral,leaf,lobe,lobed,long,loose,margin,mm,nearly,obovate,occasionally,ovary,pale,pedicel,petiole,plant,plurifoliate,pubescence,pubescent,seed,sessile,shaped,shrub,small,sparsely,stem,stigma,style,surface,tan,tear-drop,terminal,translucent,tree,trichome,tube,white,wide,woody,x,yellowish-green	.3,0-0.5,0.8-1.1,15,15-20,20-200-flowered,abaxial,abaxially,across,along,always,anthesi,apar,appearanc,axillary,barely,bark,basal,berry,body,branched,branching,bushy,collection,cone,crotaloid,decurrent,dense,densely,denser,diamete,distal,drying,eaf,edicel,eed,erect,especially,exserted,filament,flat,fleshy,free,fruiting,giving,greenish-yello,incrassate,juvenile,knob,lamina,large,like,lower,main,many,middle,minutely,much,nflorescence,obovoid,often,older,onto,pair,papillate,papillo,pericarp,pitted,planar,pore,poricidal,portion,possessing,prominent,rest,ruit,scar,simple,spaced,stout,strongly,surpassing,tall,thick,thin,time,tip,tub,tuft,ud,unevenly,variously,vein,widest,winged,yellowish,ympodia,young	adhesion,arrangement,climate,colour,diameter,form,fruit,glandular,greenish-yellow,growth,hair,height,history,length,life,midpoint,na,number,peduncle,perennial,position,presence,ray,reproduction,rugulose,shape,size,staman,stellate,stipe,texture
558	wfo-0001030007	success	168	107	82	86	25	0.488	.5,0.2-1,0.5-1,0.8-1,1-1.5,1-15,1-2,1.6-2.2,15-20,2-4,3/4,4.5-5,7-10,7-9,abrupt,along,anther,base,beneath,broadly,brown,calyx,campanulate,clavate,cm,corolla,decurrent,deltoid,densely,dia,dry,elliptic,flattened,fleshy,glabrous,globose,golden,golden-pubescent,green,leaf,live,lobe,lobed,long,material,midrib,minutely,mm,opposite,ovary,pale,papillose,pedicel,petiole,pitted,plant,poricidal,pubescent,reniform,shrub,slender,small,soft,stem,stigma,straight,style,surface,tapering,thick,tip,tree,trichome,tube,two,type,uniseriate,way,white,widening,winged,x	.05,.4,0.1-0.5,1.5-5,2-7,3-5,6-10-flowered,acuminate,acute,anthesi,apart,apex,ba,bark,becoming,berry,branched,bud,closely,cork,dark,difoliate,edicel,eed,erect,exserted,filament,free,fruiting,geminateleaf,glabrate,gre,hooded,impressed,incrassate,inflorescenc,lateral,like,lon,longer,lower,main,major,margin,middle,minor,nflorescence,oblique,obovoid,occasionally,older,one,onto,outline,pair,papillo,planar,pore,portion,prominent,raised,rest,rounded,ruit,scar,shaped,short,shorter,simple,slightly,soon,spaced,sparsely,specimen,tall,tear-drop,thickened,trunk,tub,ud,unit,vein,widest,woody,ympodial,young	0.5,adhesion,arrangement,colour,diameter,form,fruit,growth,height,history,inflorescence,length,life,na,peduncle,perennial,position,pubescence,reproduction,rugulose,seed,shape,size,staman,texture
559	wfo-0001030010	success	156	106	87	69	19	0.558	.75,/4,0.5-5,0.9-1.1,1-1.3,1-2,1.2-1.5,1.5-2,10-15,2-2.2,2-7,2.5,20-40,4-4.5,5-7,anther,area,bark,basal,base,beneath,brown,calyx,cm,corolla,cyathiform,dark,deciduous,decurrent,deflexed,deltate,dia,f,fruit,glabrate,glabrous,globose,green,grey,leaf,lobe,lobed,long,midrib,minute,minutely,mm,near,nearly,obovate,occasionally,older,opposite,ovary,ovoid-reniform,papillose,pedicel,petiole,pitted,pore,poricidal,puberulent,reddish,shaped,shrub,size,slightly,small,smooth,soon,stem,stigma,straight,style,surface,tapering,tear-drop,tiny,tip,tree,trichome,tube,uniseriate,way,white,winged,x	.5,0.7-1,1-1.5,10-50-flowered,11-12,3-5,7-10,acuminate,acute,anthesi,apex,appearing,attenuate,berry,bud,closely,differing,difoliate,distal,dry,eaf,edicel,eed,ellipsoid,exserted,filament,fleshy,free,fruiting,furcate,geminat,hooded,lateral,lon,lower,m.,main,major,margin,materia,material,middle,minor,nflorescence,often,one,orange,overlappin,pair,persistent,planar,portion,prominent,rather,ruit,scar,shin,simple,spaced,styl,tall,trunk,ud,unit,vein,widest,woody,ympodial,young	colour,diameter,form,growth,height,history,inflorescence,length,life,na,perennial,plant,position,pubescence,reproduction,seed,shape,shiny,texture
560	wfo-0001030023	success	171	112	85	86	27	0.497	0.5-1,1,1-8,1.5-7,10-25,2,2-3,2.5-3.5,20-30,3-4.5,3-5,30-50+,4,4-12,5,5-16,5-6,6-26,6-7,7-9,abaxially,acute,adaxially,apex,articulated,basal,base,branched,calyx,cm,cordate,cuneate,deeply,densely,diameter,ellipsoidal,elliptic,entire,especially,finely,flattened,fruit,glabrous,glandular-puberulent,globose,greenish-white,highly,leaving,lobe,long,margin,mm,moderately,narrowly,near,oblique,oblong,occasionally,often,ovate,pedicel,pedicellar,peduncle,peltiform,petiole,puberulent,pubescence,pubescent,purplish-,radiu,remnant,short-acuminate,simple,sparsely,stellate,stigma,style,subcoriaceous,tree,triangular,truncate,villous,x,yellowish,young	-,0-100+,1-,1-2,1.5-2,10-,11-40+,12-18,13-20,4-10,4-foliat,5-,aggregate,apart,ape,apiculate,axe,beyond,blade,capitat,cell,ciliate,color,connective,connivent,cylindrical,denser,dilated,directed,distally,eaf,eed,exceeding,except,exserted,fleshy,flower,forked,glandular-puberulen,hair,lanceolate,lon,loosely,lower,main,membranaceous,narrow,nflorescence,nther,obtuse,orolla,perfect,pore,presen,present,probably,prominent,pubescen,pubescent-pilo,rachi,ripe,ruit,shorter,slightly,small,somewhat,spaced,stamen,stone,swelling,tal,tem,thecae,time,tip,tube,ud,unbranched,unit,unknow,unknown,usually,vary,vein,wide,ympodial	abaxial,adaxial,anther,arrangement,capitate,colour,corolla,form,growth,height,hermaphroditic,history,inflorescence,leaf,length,life,ovary,perennial,plant,position,pubescent-pilose,reproduction,seed,shape,size,stem,texture
561	wfo-0001030032	success	250	118	88	162	30	0.352	0.2-0.5,0.25-0.4,0.5-0.6,0.5-0.7,0.8-1.0,1-1.3,1-1.5,11-20,13-35,2-3-locular,2-4,2-5,2-lobed,2.4-3.5,3.0-3.5,3.5-12,30,4.3-5.0,60-80,8-10,8-20,acuminate,acute,anther,apex,base,bright,brown,calyx,capitate,cm,completely,conical,corolla,decurrent,deltate,densely,diameter,elliptic,entire,free,fruit,glabrous,glandular,golden,green,greenish-brown,imparipinnate,interrupted,irregularly,leaf,length,lobe,long,margin,mm,oblanceolate,obovate,occasionally,orbicular,ovary,pale,pedicel,peduncle,petiole,present,pubescence,pubescent,rotate,rotate-stellate,seed,simple,somewhat,splitting,stem,stigma,style,surface,thick,trichome,truncate,tube,uniseriate,vine,white,wide,woody,yellow	+,.05,.5,0.1-0.4,0.1-0.5,0.2,0.2-0.3,0.4-1.5,0.5,0.5-1,0.5-1.5,0.5-2,0.6-1.1,0.7-0.8,0.8-1.1,1-2-celled,1-3,1-celled,1.5-2,1.5-2.5,2,2-10,2-3.5,2-60,3,3-5,4-5,4-6-celled,4-celled,5-plurifoliate,6-11,7-16,7.5-10,8-10-celled,abaxially,absent,abundant,adaxial,adaxially,along,also,anthesi,apical,appearance,appendage,articulated,articulation,basal,basally,basiscopically,bent,border,branche,branched,breaking,cell,clambering,column,conspicuou,dark,densest,desne,dry,eaf,ebracteate,edicel,eed,exserted,filament,flower,fruiting,give,gree,hair-like,halfway,hea,head,herbarium,interjected,internode,lamina,large,larger,lateral,leaflet,leave,like,longest,lower,many,markedly,middle,midvein,mixed,moderately,much,multicellular,nflorescence,node,oblique,often,older,onto,opposite,outgrowth,pair,paler,patent,petiolule,pithy,primary,pseudostipule,rachi,reflexed,rest,rough,round,ruit,secondary,set,shorter,silky,slightly,smaller,soft,sometimes,sparsely,sparser,specimen,spreading,stamen,staminal,sterile,straight,subopposite,swollen,tall,tangled,tem,terminal,tertiary,testa,thickened,time,tiny,tip,touch,transparent,ud,unicellular,unit,usually,vegetatio,vein,venation,wall,weaker-walled,well-developed,winged,ympodial,younger,½-3/4	0.05,adhesion,arrangement,blade,climate,colour,dense,form,growth,hair,height,history,inflorescence,life,midpoint,na,number,perennial,plant,position,presence,ray,reproduction,rugulose,shape,size,staman,stellate,stipe,texture
562	wfo-0001030048	success	156	115	79	77	36	0.506	0.5-1.5,1-1.5,1-2,1.2-2,1.3-1.6,1.5-7,2-3,2-5,3-3.5,3-5,4-15,4-4.5,5-8,abaxially,acute,adaxially,along,anther,apex,apically,arachnoid,base,bi-lobed,blue,broadly,calyx,clavate,cm,conical,corolla,deltate,densely,dia,elliptic,felt-like,glabrous,globose,green,greyish,internodal,leaf,lobe,lobed,long,main,margin,matted,minutely,mm,nearly,occasionally,opposite,ovary,ovoid-reniform,pale,pedicel,petiole,pitted,pointed,pubescent,reddish-brown,shaped,shiny,shrub,small,sparsely,stem,stigma,style,surface,tan,tear-drop,thickened,tree,trichome,tube,vein,white,wide	.5,1.5-3.5,10-16,5-10-flowered,5973,abaxial,anthesi,ape,apparently,bark,becoming,berry,bi-colored,brown,closely,completely,covered,decurrent,deflexed,difoliate,drying,eaf,edicel,eed,ellipsoid,exserted,fide,filament,fleshy,four-angle,free,fruiting,geminat,glabrate,golden,impressed,inflorescenc,lamina,lateral,lightly,like,lon,lower,middle,nflorescence,older,onto,overlappin,pair,papillo,papillose,planar,pore,poricidal,portion,prominent,rather,rest,ruit,scar,simple,solomon,somewhat,spaced,strongly,tall,thick,tip,trifoliate,tub,ud,unit,widest,woody,yellowish,ympodial,young	adhesion,arrangement,blade,climate,colour,diameter,form,fruit,geminate,glandular,growth,hair,height,history,inflorescence,length,life,midpoint,na,number,peduncle,perennial,plant,position,presence,pubescence,ray,reproduction,rugulose,seed,shape,size,staman,stellate,stipe,texture
563	wfo-0001030053	success	141	92	56	85	36	0.397	0.5,0.5-1,1-1.3,1-13,1.3-3.5,1.8-2,2-2.5,2.5-3,3.5-4,<,abruptly,acuminate,acute,apex,base,brown,calyx,cm,coriaceous,corolla,cyathiform,decurrent,diameter,elliptic,entire,flattened,glabrous,greenish,growth,inflorescence,irregularly,lobe,lobed,margin,minutely,mm,pale,pedicel,peduncle,petiole,pitted,reniform,revolute,shallowly,simple,slightly,stem,surface,terminal,truncate,tube,vine,white,woody,x,yellowish	1.5-5.5,10-20,100,4-,5,5-merou,7-11,7-9,abscission,aiding,alyx,anthesi,apart,apical,apiculae,ark,around,articulated,berry,bfeore,branch,branched,cell,climbin,completely,eaf,eed,exserted,far,fide,filiform,fine,flower,fragrant,frui,fruiting,hyaline,leaving,long,lower,many,mentz,near,new,nflorescence,nipple,older,orolla,pair,papilla,papillo,parallel,peg,pendant,per,perfect,plurifoliat,primary,rectangular,rim,scar,secondary,shin,shining,shiny,sleeve,small,spaced,spreadin,spreading,strongly,support,tem,testal,time,tiny,tip,turbinate,twining,ud,unit,usually,vein,venation,ympodial	4-11,adhesion,anther,arrangement,blade,climate,colour,form,fruit,glandular,hair,height,history,leaf,length,life,midpoint,na,number,ovary,plant,position,presence,pubescence,ray,reproduction,rugulose,seed,shape,size,staman,stellate,stigma,stipe,style,texture
564	wfo-0001030057	success	141	88	67	74	21	0.475	-2,2-3-celled,2-4,2-4.5,20-30,20-80,4-10,7-14,8-19,abaxially,adaxially,articulated,axillary,brownish,bud,cell,chartaceous,cm,condition,covering,diameter,distal,drying,elliptic,fresh,fruit,globose,green,green-white,greenish,hair,hair-like,herb,high,lateral,leaf,like,long,make,membranous,mm,mottled,mucilaginous,odd-pinnate,ovate,ovoid,pedicel,peduncle,petiole,plant,pubescent,purple,seed,short,size,sometimes,stem,subglabrous,subtending,terminal,testal,thick,throughout,wall,wet,whitish,x	1-10,1-2,2-6,2.1-4.1,3-5,3.5-8,4.3-8.2,5.5-12,8,absent,acuminate,acute,apart,apex,apparently,axe,base,berry,blade,borne,broadly,cordate,cuneate,decreasing,digestion,eaf,eed,end,enzyme,erec,extremely,flower,forked,geminat,generally,glabrou,greatly,half,honeycomb-shaped,interjected,larger,leaflet,living,lunate,narrow,nflorescence,pair,perfect,petiolule,plurifoliate,removed,ruit,scale-like,seudostipule,singly,small,spaced,specimen,ste,stolo,suborbicular,tall,tem,thir,toward,tri-,truncate,tuber,typically,unit,unwinged,usually,wing,ympodial	arrangement,colour,form,glabrous,growth,height,hermaphrodite,history,inflorescence,length,life,na,perennial,position,pubescence,reproduction,rugulose,shape,surface,texture,third
565	wfo-0001030057	success	197	104	82	115	22	0.416	-10,-2,.5-3.5,1-2,2-3-celled,2-4,2-4.5,20-30,20-80,4-10,5-6,7-14,8-19,abaxially,adaxially,along,anther,axillary,brownish,bud,chartaceous,ciliate,cm,condition,corolla,diameter,drying,elliptic,especially,fresh,fruit,glabrous,globose,green,greenish,greenish-yellow,hair,herb,lanceolate,leaf,like,linear,lobe,margin,membranous,middle,midrib,minutely,mm,mottled,odd-pinnate,ovate,ovate-lanceolate,ovoid,pedicel,peduncle,pentagonal,petal,petiole,plant,puberulent,pubescent,purple,rotate,seed,short,size,sometimes,star,stem,stigma,striped,style,subglabrous,subtending,terminal,tip,tube,white,whitish,x,yellow	1-10,2-3,2-5,2-6,2.1-4.1,3-5,3.5-8,4.3-8.2,5-10,5-merou,5.5-12,8,absent,acumen,acuminate,acute,ag,alyx,apart,apex,apparently,articulated,axe,base,berry,blade,borne,broadly,cell,connivent,cordate,covering,cuneate,decreasing,digestion,distal,dorsally,eaf,edge,eed,end,enzyme,erec,exceeding,extremely,filament,flat,flower,folded,forked,geminat,generally,glabrou,globo,greatly,green-white,hair-like,half,high,homostylous,honeycomb-shaped,interjected,larger,lateral,leaflet,lengthening,living,long,lower,lunate,make,mucilaginous,narrow,nflorescence,orolla,pair,perfect,petiolule,plurifoliate,pore,poricidal,removed,ruit,scale-like,seudostipule,singly,slit,small,spaced,specimen,stamen,ste,stolo,straight,suborbicular,tall,tamen,tem,testal,thick,thir,throughout,toward,tri-,truncate,tuber,typically,unit,unwinged,usually,vary,wall,wet,wing,ympodial	adhesion,arrangement,calyx,colour,form,growth,height,history,inflorescence,length,life,na,ovary,perennial,position,pubescence,reproduction,rugulose,shape,staman,surface,texture
566	wfo-0001030067	success	206	116	86	120	30	0.417	0-1,0-1.5,0.1-0.3,0.15-0.3,0.2-0.4,0.2-1,0.4-1.1,0.5-0.8,0.9-2.8,1-3,12-16,13-15,2-2.5,2-3,2.5-3.5,2.5-7,3.5-5.5,3.6-5.3,7-8,absent,adaxially,anther,apex,basal,base,black,blade,broad,broadly,brown,calyx,chartaceous,cm,connivent,cordate,deltate,densely,depressed-globose,diameter,entire,extra-axillary,fruit,glabrous,gland-tipped,globose,grey,hair,herbaceous,inflorescence,length,lobe,loosely,margin,midpoint,mm,moderately,obscure,obtuse,orbicular,ovate,ovate-oblong,pedicel,peduncle,perennial,petiole,present,pseudo-racemose,purple,ray,resprouter,rhizomatous,rotate,shallow,short,shrub,simple,stellate-pubescent,stem,stigma,style,tube,unbranched,undulate,white,x,yellow	%,.05,.5,0-0.1,0-0.2,0-0.7,0-2,0-30,0.1-0.25,0.1-0.5,0.2-0.35,0.3-0.4,0.3-0.8,0.5-13,0.6-0.9,0.7-1.3,0.8-1.4,1-6,1-7,10-16,2-foliate,3-8,4.5-6,5-merou,6-18,8-11,9-18,?,abaxially,absen,abundant,accrescent,acicular,adaxiall,alyx,apart,armed,articulated,axe,ba,capitat,coating,cylindrical,decimetr,directed,distall,distinct,distributed,dult,eaf,eed,eglandular,equal,erect,filament,finger,flower,frequently,fruiting,functional,geminat,green,half,homostylous,interpetalar,juic,lamina,lateral,less,long,longer,lower,mature,mesocarp,mid-point,midvein,minute,moist,multiradiate,nflorescence,oblique,obscured,often,orolla,part,per,perfect,petal,pore,porrect,prickle,probably,pubescent,rachi,recurved,resinous,ruit,sessile,slightly,spaced,stage,stalk,stellae,straight,tal,tamen,thick,thickened,throughout,time,tip,tissue,triangular,unarmed,unit,unknow,uvenile,vary,wide,ympodial	adhesion,arrangement,capitate,climate,colour,corolla,form,glandular,growth,height,history,leaf,life,na,number,ovary,plant,position,presence,pubescence,reproduction,rugulose,seed,shape,size,staman,stellate,stipe,surface,texture
567	wfo-0001030080	success	186	98	71	115	27	0.382	0.3-7,0.4-1.5,0.5-4,1.5-2,1.5-2.5,2-3,2-4,2.1-7.1,3-10,4-12,5-13.5,5-7,6.5-18.6,8-23,9.9-33,abaxially,adaxially,anther,brownish,clavate,cm,condition,coriaceous,corolla,dark,diameter,dot,drying,elliptic,fresh,fruit,glabrescent,glabrous,green,greenish,hair,herb,lanceolate,leaf,light,lobe,long,medium,mm,mottled,odd-pinnate,ovate,ovoid,pedicel,peduncle,petiole,plant,purple,pyriform,seed,size,sometimes,stellate,stigma,style,terminal,throughout,tiny,tube,unknown,white,whitish,width,winged,x,yellow	1-2,1-3,1.8-4.5,1999,3-5,3.3-7.7,4-7,5-merou,5.5-9.9,8-16,abaxiall,absent,acumen,acuminate,ag,along,alyx,apart,apex,apparently,arranged,articulated,axe,axillary,base,bead,berry,blade,bud,capitat,ccording,cell,connivent,covering,cuneate,decreasing,decurrent,digestion,distal,dorsally,eaf,edge,eed,enzyme,erec,exceeding,filament,flat,flower,folded,forked,geminat,generally,glabrou,green-white,hair-like,hal,half,high,homostylous,honeycomb-shaped,inconspicuous,interjected,larger,lateral,leaflet,lengthening,like,linear,living,lower,make,moniliform,mucilaginous,multiple,necklace,nflorescence,ochoa,onto,orolla,pair,perfect,plurifoliate,pore,poricidal,rachi,removed,second,seudostipule,slightly,slit,spaced,specimen,stamen,stolon,straight,strongly,subequal,subtending,tall,tamen,tem,testal,thick,tip,toward,tri-,tuber,typically,unit,usually,vary,wall,wet,ympodial	abaxial,adaxial,adhesion,arrangement,calyx,capitate,colour,form,growth,height,history,inflorescence,length,life,na,ovary,perennial,position,pseudostipule,pubescence,reproduction,rugulose,shape,staman,stem,surface,texture
568	wfo-0001030081	success	157	99	64	93	35	0.408	.5,0.5-1,0.5-1.5,0.5-2.5,1-3,1-4,1.5,1.5-3,1.5-7,10-20,2-7,4-6,5-12,5-15,abaxially,acute,adaxially,anther,apex,base,blade,brown,calyx,chartaceous,ciliate,cm,densely,diameter,dm,drying,elliptic,elliptic-ovoid,entire,flower,fruit,glabrous,globose,hair,herb,immature,linear-lanceolate,lobe,margin,maturing,membranaceous,mm,moderately,oblong,obtuse,pedicel,peduncle,petiole,pubescent,rotate,rounded,semitransparent,sparsely,stigma,style,surface,tube,white,x,yellow	0.25-0.5,1,1-2,1-2-celled,1-5,10-35,1st,2-4,2-foliate,2nd,3-10,3-6,absent,abundant,adaxiall,along,apically,axe,berry,beyond,cell,center,connected,cordate,decurrent,dehiscing,denser,eaf,edge,eed,emarginat,equal,explosively,exserted,few-branched,filament,fine,flat,frui,geminat,geniculate,held,interpetalar,long,longer,lower,lying,maturit,mesocarp,nearly,nfloresence,notch,often,one,orolla,other,parallel,per,placenta,pointing,pressure,pubescen,rachi,radiating,raised,rarely,ridge,ruit,running,shallow,short,single-,slightly,small,sometimes,stamen,straight,swollen,tal,tamen,tem,tissue,triangular,two-celled,unbranched,unit,usually,vary,vein,watery,wid,woody,ympodial	adhesion,arrangement,climate,colour,corolla,form,glandular,growth,height,history,inflorescence,leaf,length,life,midpoint,na,number,ovary,perennial,plant,position,presence,pubescence,ray,reproduction,rugulose,seed,shape,size,staman,stellate,stem,stipe,texture,ye
569	wfo-0001030083	success	146	109	71	75	38	0.486	.5,0.25-0.5,0.5-1,0.5-2,0.8-1,0.8-3,1-1.5,1-2,1.5-3,10-30,2,3/4,4-15,4-6,acute,anther,apex,base,broadly,calyx,cm,corolla,cup-shaped,decurrent,deeply,deltoid,drying,elliptic,fruit,glabrous,globose,green,greenish-white,internodal,leaf,lobe,lobed,long-acuminate,long-styled,membranous,minutely,mm,narrowly,opposite,ovary,ovate,ovoid-reniform,pale,papillose,pedicel,petiole,pitted,poricidal,red-papillose,shallowly,short-styled,shrub,small-capitate,stem,stigma,strongly,style,surface,tan,thin,tip,tube,way,white,winged,x	.75,0.1,2-3,2-5-flowered,3-4,9-11,accrescent,anthesi,bark,beginning,berry,closely,dar,deciduous,deflexed,dia,dry,eaf,edicel,eed,elongate,exserted,fleshy,flower,fruiting,greyish-re,hyaline,inflorescenc,lateral,lon,long,lower,main,middle,near,nflorescence,older,onto,overlapping,pair,paler,papillae,pore,prominent,proximal,raised,reddish-gold,reflexed,ruit,scar,shaped,simple,single-stemmed,slender,slightly,somewhat,soon,spaced,specimen,straight,tall,tapering,tear-drop,terminal,thickened,translucent,tub,ud,unifoliat,unit,vein,widest,woody,ympodial,young	adhesion,arrangement,blade,climate,colour,dark,diameter,form,glandular,greyish-red,growth,hair,height,history,inflorescence,length,life,margin,midpoint,na,number,peduncle,perennial,plant,position,presence,pubescence,ray,reproduction,rugulose,seed,shape,size,staman,stellate,stipe,texture,unifoliate
570	wfo-0001030093	success	181	110	75	106	35	0.414	0.2-1,0.5-1.1,0.75-1,1-1.5,1-12,1-5,2-2.5,3-4,3.5-12,4-6,7-30,8-9,acuminate,acute,anther,apex,attenuate,base,brownish-tan,calyx,campanulate,clavate,cm,corolla,cuneate,deltoid,densely,dia,elliptic,glabrous,globose,golden,green,greenish-white,growth,hirsutulous,leaf,lobe,lobed,margin,minutely,mm,narrowly,nearly,obovate,often,opposite,ovary,ovoid-reniform,pale,pedicel,petiole,pitted,plant,puberulent,pubescent,shaped,shiny,shrub,simple,size,slightly,small,stem,stigma,style,surface,tear-drop,tree,trichome,tube,uniseriate,vein,white,x	.2,.5,0,0.1-0.3,0.2,0.2-0.5,0.6-1.5,1.3-4.5,2.5-11,5-50-flowered,5-8,7-9,anthesi,apar,bark,becoming,beneath,berry,branched,case,closely,collection,commonly,continues,deflexed,differing,difoliate,eaf,edicel,eed,ellipsoid,erect,especially,evenly,except,expanded,exserted,filament,flower,forest,free,fruiting,furcate,geminat,greyish-brow,guyanese,hyaline,impressed,inundated,lateral,like,lon,long,long-styled,lower,main,major,many,member,middle,minor,new,nflorescence,occasionally,older,one,onto,open,orbicular,pair,paler,papillo,persisting,population,pore,poricidal,portion,present,quite,reflexed,remaining,ruit,scar,shoot,short-styled,slender,soon,southern,spaced,straight,tall,tapering,terminal,thickened,time,tiny,tip,tub,ud,underside,unit,widest,woody,yellowish,ympodial,young	0.5,1.5-4,adhesion,arrangement,blade,climate,colour,diameter,form,fruit,glandular,greyish-brown,hair,height,history,inflorescence,length,life,midpoint,na,number,peduncle,perennial,position,presence,pubescence,ray,reproduction,rugulose,seed,shape,staman,stellate,stipe,texture
571	wfo-0001030115	success	192	128	100	92	28	0.521	-30,.2,.5,0.2,0.5,1-1.2,1.5-2,1.5-3,12,12-22,2.5-3,3,3-4,3.5-5,5-10,5-5.5,5-8,abaxially,acuminate,acute,anther,apex,base,berry,c.,calyx,cm,conical,cordate,corolla,densely,diameter,echinoid,echinoid-stellate,elliptic,entire,flower,glabrescent,glandular,globose,green,growth,inflorescence,irregular,lanceolate-elliptic,leaf,like,linear,lobe,lobed,long,long-styled,long-triangular,margin,midpoint,minutely,mm,near,oblique,ovary,pale,papillate,pedicel,peduncle,pentagonal,petiole,poricidal,pubescent,purple,ray,scattered,shallowly,shiny,short-styled,shrub,simple,slightly,small,somewhat,sparsely,stellate,stem,stigma,style,surface,tapering,terminal,thin,tip,tree,trichome,truncate,tube,underside,undulate,violet,way,white,x,yellowish	-100,0.1,0.5-0.6,1,10,10-,30-60,4,7,9-11,<,>,adaxially,anthesi,apart,armed,bark,basal,basall,beneath,branched,broad-based,brow,closely,completely,curved,dark,deep,discolorous,distant,drying,eaf,eed,ellipsoid,equalling,erect,exserted,filament,free,fruiting,glabrous,heterostylous,impressed,included,irregularl,know,known,lamina,later,lengthening,lower,many,new,nflorescence,obscured,obvious,occasionally,often,older,pair,papillo,pericarp,planar,plurifoliat,pore,portion,prickle,prickly,primary,prominent,reddish,ruit,scar,sessile,sinus,slit,spaced,splitting,stout,strongly,tearing,time,translucent,trichoem,ud,unarmed,unit,upper,usually,vein,ympodial,young	adhesion,arrangement,blade,climate,colour,form,fruit,hair,height,history,length,life,na,number,papillose,plant,position,presence,pubescence,reproduction,rugulose,seed,shape,size,staman,stipe,texture,ye
572	wfo-0001030145	success	153	95	69	84	26	0.451	-3,0.2-2,0.3-,0.5-1,0.5-4,1,1-1.5,1-2,1-2.5,1-3,1.5,1.5-2,1.5-7,2-3,2.5-6.5,3-10,3-4,3-5,abaxially,adaxially,also,apex,base,calyx,campanulate,cm,color,compound,deltate,densely,diameter,ellipsoidal,elliptic-ovate,fruit,glabrous,glandular,globose,hair,herb,leaf,lobe,long,margin,mm,moderately,narrowly,ovate-elliptic,pedicel,peduncle,petiole,pilose,puberulent,ripe,shrub,simple,slightly,sparsely,stigma,style,subcoriaceous,ternately,toward,triangular,truncate,tube,unknown,violet,x,yellow	-2,0.5,1-5,1.5-4.5,10-12,2-4,3,4-5,4-8,4-foliat,6-40,8-11,absent,acute,adpressed,aggregate,apart,ape,articulated,axe,basal,beyond,blade,cell,chartaceous,connective,cuneate,cylindrical,directed,distally,dunal,eaf,eed,elliptic,entire,exceeding,exserted,fide,fleshy,flower,forked,lanceolate,larger,lateral,leaflet,leaving,less,lon,lower,near,nflorescence,nther,obtuse,orolla,pedicellar,pore,presen,puberulen,rachi,radiu,reddish,remnant,ruit,shorter,sinuate,slender,somewhat,spaced,stamen,stone,subcordate,tal,tem,terminal,thecae,time,tomento,truncat,ud,unbranched,unit,vary,wide,ympodial	anther,arrangement,colour,corolla,form,growth,height,inflorescence,length,na,number,ovary,plant,position,presence,pubescence,ray,rugulose,seed,shape,size,stellate,stem,surface,texture,tomentose
573	wfo-0001030146	success	210	92	55	155	37	0.262	0.5,anther,bright,brown,calyx,capitate,cm,connivent,coriaceous,corolla,cup-shaped,deltate,densely,diameter,ellipsoidal,elliptic,flattened-reniform,globose,golden,green,growth,inflorescence,leaf,length,lobe,lobed,long,loosely,many,mm,narrowly,pedicel,peduncle,perfect,petiole,plant,pubescence,pubescent,ray,reddish,shiny,simple,small,stellate,stem,stigma,style,terminal,thin,tree,treelet,tube,white,wide,yellow	.1,.2,.5,0.2–0.4,0.5–1,0.6–0.7,0.6–2,0.9–1,1.2–1.5,1.5–2,16–20,1–1.1,1–1.5,2.5–9,20,20–30,2–5,3–4,3–6,40–50,4–30,4–4.5,5-merou,5–8,6.5–16,60+,6–7,8–15,9–9.5,>,abaxial,abaxially,absent,acuminate,acute,adaxial,ag,almost,along,alyx,anthesi,apar,apex,appearing,ark,articulated,axe,base,beig,beneath,berry,branched,branching,brownish,c.,cell,center,closely,covered,dark,deeply,dense,dichasia,discolorous,drying,eaf,echinoid,edge,eed,elongate,entire,erec,exserted,filament,flower,free,fresh,fruiting,fused,glabrous,gradually,halfway,ilament,impressed,lamina,layer,lengthening,less,like,lower,margin,midpoint,minutely,multangulate,narrowing,new,nflorescence,nodding,older,olive,orolla,pair,pale,papillose,part,peltate,per,pericarp,persistent,pitted,plurifoliate,pore,poricidal,portion,primary,projection,reflexed,regularly,revolute,rhachi,ripe,ruit,scar,scurfy,sessile,short-stalked,slit,spaced,sparsely,stout,strongly,subtended,surface,tall,tan,tangled,tem,testal,time,tiny,tip,trichome,ud,undersurface,unevenly,unit,upper,vary,varying,vein,visible,way,woody,ympodial,–18	0.2-0.4,0.6-0.7,0.6-2,0.9-1,1.2-1.5,1.5-2,18,2-5,2.5-9,20-30,3-4,3-6,5-8,6.5-16,8-15,9-9.5,adhesion,arrangement,colour,form,fruit,height,history,life,na,number,ovary,perennial,position,presence,present,reproduction,seed,shape,size,staman,texture
574	wfo-0001030147	success	158	79	57	101	22	0.361	-8,0.5-2,1-5,1.0-2.2,10-19,14-35,15-30,2-10.5,2-13,2-3,2-5,4-5.5,4.2-7.5,4.5-10,abaxially,adaxially,blue,calyx,cm,conical,connate,corolla,deep,diameter,distal,elliptical,finely,forked,green,green-white,half,herbaceous,interjected,lateral,leaf,leaflet,long,medium,mm,narrowly,odd-pinnate,ovate,ovoid,pair,pedicel,peduncle,perennial,petiole,plant,pubescent,purple,rotate,seed,size,terminal,wide,yellow	0-5,1-4,1.0-2.0,2,2-10,2.5-7.5,3-,3-6-foliat,4-3.,5-7,5-8,8-38,abaxiall,acumen,acuminate,acute,apex,apical,apically,articulate,attenuate,base,branched,cell,covering,cuneate,cyme,dehiscent,dichasial,dichasially,digestion,diminishing,dorsally,eaf,ebracteate,edge,eed,emoval,enzyme,exceeding,filament,flat,flower,folded,generally,globo,gradually,hair-like,honeycomb,introrse,living,lobe,lon,long-attenuate,lower,lunat,make,maturing,monochasial,mucilaginous,nflorescence,nther,oblique,obtuse,often,orolla,pattern,perfect,petiolule,plan,poricidally,proximal,reveal,rounded,ruit,sessile,seudostipule,short,slit,specimen,stamen,stigma,straight,style,subequal,subsessile,tal,tem,testal,thick,throughou,throughout,tip,toward,tuber-bearing,typically,unit,vary,wall,ympodial,¼	3-7,4-31,anther,arrangement,colour,form,fruit,growth,height,history,inflorescence,length,life,na,ovary,position,reproduction,rugulose,shape,stem,surface,texture
575	wfo-0001030151	success	175	107	75	100	32	0.429	0.2-0.5,0.5-1,1-1.5,1-17,1-2,1-3,1.5-2.5,10-25,2-25,2-6,2-7-compound,3-14,3-5,3.5-32,4-5,5-6,6-9,abaxially,acuminate,acute,adaxially,apex,apiculate,base,blade,blotch,calyx,chartaceous,cm,cordate,cuneate,deltate,diameter,elliptic,entire,fruit,glabrate,glabrous,glandular,glandular-puberulent,globose,hair,leaf,lilac-tinged,lobe,longitudinal,margin,membranaceous,mm,narrowly,oblong,obovate,pedicel,peduncle,petiole,pinnately,presence,pyriform,shallowly,simple,sometimes,stellate,stigma,stripe,style,surface,tip,tree,truncate,tube,white,white-puberulent,x,yellow,yellow-green	-3,-50,0.3-0.5,0.5,1,1-5,1.5-2,10-20,15-35,2-11,2-3,20-30,4-foliat,?,absent,abundantly,adaxial,aggregate,apart,ape,around,articulated,axe,basal,beyond,cell,channe,ciliat,compound,connate,connective,cylindrical,decurrent,directed,distally,eaf,eed,eglandular,exceeding,except,exserted,flower,lanceolate,leaflet,leaving,less,line,lon,long,lower,near,nflorescence,nther,oblique,obtuse,often,orolla,pedicellar,perfect,pore,probably,puberulent,purplish,rachi,radiu,remnant,ring,ripe,ruit,sand-punctat,sand-punctate,scattered,short,shorter,slender,slightly,small,somewhat,spaced,sparsely,stalked,stamen,stone,tal,tem,thecae,time,toward,triangular,truncat,ud,unbranched,unit,unknow,vary,vein,veiny,whitish,wide,ympodial	adhesion,anther,arrangement,climate,colour,corolla,form,growth,height,history,inflorescence,length,life,midpoint,na,number,ovary,perennial,plant,position,pubescence,ray,reproduction,rugulose,seed,shape,size,staman,stem,stipe,texture,truncated
576	wfo-0001030153	success	147	115	82	65	33	0.558	.1,.2,/3,0.2-1,0.8-0.9,1-1.2,1-1.5,1-2,1-2.5,1.3-1.5,1.3-1.9,1.5-2,2-8,2-lobed,2.5-4,3-5,3.5-10.5,5-6,abaxially,acuminate,acute,adaxially,anther,anthesi,apex,apiculate,apparently,attenuate,axil,base,berry,calyx,campanulate,clavate,cm,conical,corolla,dark,deltate,diameter,distinct,domatia,elliptic,entire,glabrous,globose,green,growth,internodal,lanceolate,lobe,lobed,margin,mm,narrowly,older,ovary,pedicel,peduncle,petiole,pit-like,poricidal,revolute,ripe,simple,slightly,small,stem,stigma,style,surface,terminal,tip,tree,treelet,tube,vein,way,white,x,yellowish,young	0.8-1.3,1-10,3-4,3-50,6-8,absent,age,apart,ape,bark,branched,brittle,broadly,caly,densely,dot,dry,eaf,ellipsoid,enlarged,erect,exerted,filament,flower,free,fruiting,glabrou,impressed,irregularly,known,lengthening,less,lower,markedly,membranous,minutely,new,nflorescence,nodding,occasionally,ot,pair,paler,papillat,papillate,perfect,plane,plurifoliat,pore,portion,primary,rachi,resinous,ruit,scar,slit,spaced,specimen,straight,strongly,thin,time,ud,unit,ympodial	adhesion,arrangement,blade,climate,colour,form,fruit,glandular,hair,height,history,inflorescence,leaf,length,life,midpoint,na,number,perennial,plant,position,presence,pubescence,ray,reproduction,rugulose,seed,shape,size,staman,stellate,stipe,texture
577	wfo-0001030155	success	183	87	56	127	31	0.306	0,0.5,2,2-4,2.5-3,3.5,4,anther,anthesi,armed,berry,brown,calyx,campanulate,chartaceous,cm,corolla,deltate,diameter,flattened,fruit,glabrous,globose,immature,imparipinnately,lateral,leaflet,light,lobe,mature,minutely,mm,oblong,pedicel,peduncle,petiole,pinnatifid,pitted,prickle,purple,recurved,size,spreading,stellate,stem,stigma,strongly,style,surface,tapering,terminal,tube,vine,white,yellow,×	0.2,0.4,0.5-0.6,0.5–1.2,0.7,1-1.2,1/2,12–19,12–20,1–2,2.5,2/3,2–,2–3,3,3–5,4–5,4–6,4–8,4–9,5–10,5–6,5–8,607,6–8,abaxially,acuminate,acute,ag,alyx,apex,articulated,ba,basal,basally,base,becoming,blade,branched,bud,cell,central,clustered,confluent,connecting,connivent,corresponding,decurrent,deeply,degree,densely,eaf,eed,ellipsoid,elongating,entire,equal,et,exserted,filament,flower,fresh,glabrou,green,internode,knob,lengthening,lobed,long,long-styled,lower,major,margin,middle,midrib,narrowly,nflorescence,often,orolla,outline,papillate,part,pericarp,petiolulate,plant,plurifoliat,pore,poricidal,present,prominent,protuberant,rachi,rectangular,recurve,robust,rodriguez,rounde,rounded,ruit,side,slender,slit,soon,stout,straight,subwoody,tamen,terminally,testal,third,time,tip,tissue,truncat,ttriangular,tub,unit,vary,vein,way,wide,widest,wing,woody,ympodial,–17,–27	0.4-0.7,1-2,12-19,12-20,17,2-3,27,3-5,4-5,5-10,5-6,5-8,adhesion,arrangement,colour,form,growth,inflorescence,leaf,length,na,ovary,position,presence,pubescence,rugulose,seed,shape,staman,texture,truncate
578	wfo-0001030160	success	177	130	103	74	27	0.582	.2,.5,.8,0.2,1,1-1.5,1-2,1-3,1-5,1.5-4.5,3,3-11,3-3.5,3-4,4-rayed,5-6,?,acuminate,acute,anther,apex,base,bluish-violet,calyx,cm,conical,coriaceous,corolla,densely,diameter,dioecious,dry,elliptic,elongate,entire,female,flower,fruit,glabrous,globose,growth,height,inflorescence,internodal,irregularly,like,lobe,lobed,long,long-triangular,male,margin,midpoint,minutely,mm,narrowly,near,nearly,oblique,occasionally,orange-red,ovary,pale,pedicel,peduncle,petiole,pitted,plant,prickle,pubescent,ray,red,reniform,scattered,several,shallow,shiny,short-stalked,shrub,simple,sometimes,sparsely,stellate,stem,stiff,stigma,strongly,style,surface,terete,terminating,thin,tip,triangular,trichome,truncate,tube,undulate-toothed,unknown,usually,winged,x,yellow	00,1.5-2,1030.,10300,2,2.5-3,7-10,8-9,absent,acicular,almost,amshoff,apart,apparently,armed,bark,beneath,berry,broad-based,bud,capitat,closely,completely,consisting,conspicuous,eaf,eed,ekman,exserted,fide,filament,flattened,flowered,forming,free,fruiting,glabrescen,m.,marginal,markedly,mere,midrib,minute,new,nflorescence,often,older,other,ower,pair,per,pericarp,plurifoliat,poricidal,portion,primary,prominent,ruit,scar,single,small,somewhat,spaced,stub,ti,tiny,ud,unisexual,unit,vein,vestigial,woody,ympodial,young	adhesion,arrangement,blade,capitate,climate,colour,form,glandular,hair,history,leaf,length,life,na,number,position,presence,present,pubescence,reproduction,rugulose,seed,shape,size,staman,stipe,texture
579	wfo-0001030161	success	179	115	86	93	29	0.48	0.1-0.2,0.2-0.5,0.2-1.3,0.4-0.8,0.5,0.8-1,1.1-1.3,1.5-2,1.5-5,2-2.5,2.5-3,3-15,3-3.5,4,4-5,8-9,9-10,acuminate,acute,almost,anther,apex,base,berry,calyx,clavate,cm,conical,coriaceous,corolla,densely,diameter,elliptic,entire,flattened,fruit,glabrous,globose,growth,internodal,leaf,lepidote,lobe,lobed,long-triangular,margin,midpoint,minutely,mm,narrowly,nearly,occasionally,orange,ovary,pale,pedicel,peduncle,petiole,pitted,porrect,pubescent,ray,red,reddish,reniform,scattered,sessile,shiny,simple,slightly,somewhat,sparsely,stellate,stem,stigma,style,surface,tapering,thick,treelet,trichome,tube,undulate-toothed,white,x,yellowish	.1,.2,.25,.5,0,0.1,0.5-0.6,1,12-16,2-3,4-20,5197,<,?,abaxially,adaxially,anthesi,apar,apparently,articulated,bark,bearing,beneath,breaking,broad-based,cell,curved,difoliate,eaf,eed,egger,ellipsoid,erect,especially,exserted,fide,filament,filiform,flower,free,fruiting,furcate,fused,geminat,glabrescent,impressed,irregularly,later,leave,lengthening,like,long,looping,lower,marginal,midvein,near,new,nflorescence,older,outline,pair,papillo,per,perfect,pericarp,planar,pore,poricidal,portion,prickle,prickly,primary,prominent,rhomboid,ruit,scar,shorter,slit,small,spaced,stalked,straight,strongly,testal,tip,tooth,tub,ud,unit,vein,woody,ympodial	adhesion,arrangement,blade,climate,colour,form,glandular,hair,height,history,inflorescence,length,life,na,number,perennial,plant,position,presence,present,pubescence,reproduction,rugulose,seed,shape,size,staman,stipe,texture
580	wfo-0001030167	success	141	102	66	75	36	0.468	.9,0.1–0.2,0.5–0.6,0.5–0.7,0.6,0.7–1.2,0.8–1,1.5–2,14–19,15–20,1–1.5,2–4.5,4.5–8,4–10,4–4.5,8–10,abaxially,acuminate,adaxially,anther,apex,base,blade,calyx,chartaceous,cm,densely,diameter,entire,extra-axillary,flattened,flower,fruit,glabrous,green,herbaceous,lanceolate,lobe,margin,membranaceous,membranous,mm,near,obtuse,ovate,ovoid,pedicel,peduncle,petal,petiole,pointed,rounded,sand-punctate,simple,somewhat,stellate,stigma,style,subequal,thinly,tip,tube,vine,weakly,white,x	.8,0.6–0.8,1.2–2.5,1.5–7,12,17–58,1–1.2,2–3,4–5,4–7,5-merous,accrescent,acute,along,alyx,apar,apically,axe,berry,branch,c.,ciliat,ciliate,clavate,climbing,contiguously,eaf,eed,enlarged,fertile,filament,fruiting,gap,glabrou,immature,less,long,lower,m.,maturity,minutely,moderately,nearly,nflorescence,nternode,orolla,pair,penden,perfec,pinnate,plurifoliat,rachi,reflexed,ruit,scar,secondary,seen,slender,slightly,spaced,sparsely,symmetrical,tamen,tem,time,truncat,unbranched,unit,unknown,vary,vegetation,vein,venation,wide,ympodial	adhesion,arrangement,climate,colour,corolla,form,glandular,growth,hair,height,history,inflorescence,leaf,length,life,midpoint,na,number,ovary,perfect,plant,position,presence,pubescence,ray,reproduction,rugulose,seed,shape,size,staman,stem,stipe,surface,texture,truncate
581	wfo-0001030170	success	230	112	71	159	41	0.309	0,1,2,8.5,abaxially,acute,anther,apex,around,base,blade,blue,calyx,cm,connivent,cordate,densely,diameter,extra-axillary,flattened,flower,fruit,glabrous,gland-tipped,glandular,glandular-puberulent,globose,hair,lanceolate,leaf,less,lobe,margin,maturity,minutely,mm,nearly,oblong-apiculate,obtuse,orbicular,pair,pedicel,peduncle,perennial,petiole,puberulent,pubescence,rarely,ray,reniform,shrub,similar,simple,size,smooth,stellate,stem,stigma,stipitate-glandular,style,subdeltoid,surface,thin-textured,triangular,truncate,tube,violet,white,x,yellow,yellowish	-6,.2,/2,0.1,0.15–0.35,0.2–0.5,0.2–2,0.5–15,0.5–2,0–30,1.5,10–15,12.5,15–20,1–2-celled,1–2.5,1–4.5,2-foliate,2.5–3,20–25,20–30,2–3-celled,2–4,2–5,2–8,3,3.5–4,3.5–4.4,3–10,4,4–13-rayed,4–22,5,5–10,5–12,5–15,5–apiculate,absent,accrescent,acicular,adaxially,also,apart,appearing,articulated,axe,ba,bud,capitat,coarse,confined,conspicuously,curved,cylindrical,directed,disappearing,distall,eaf,eed,enlarged,entire,erect,eventually,falling,fertile,few-branched,few-rayed,filament,flexuous,frui,fruiting,geminat,geminate,gland,ground,horizontal,hyaline,interpetalar,larger,like,lobed,lon,long,longer,longest,lower,lowest,major,male,many,mesocarp,minute,mostly,multangulate,near,nflorescence,numerous,oblique,often,one,orolla,perfect,pore,prickle,pubescent,rachi,ranging,rare,reflexed,rootstock,ruit,scarcely,scattered,senescent,sessile,shallow,short-puberulent,shorter,single,slightly,small,solitary,sometimes,somewhat,spaced,spongy,spreading,stella,stellae,sterile,stiffly,stipitate,stout,straight,strongly,surfac,tall,tamen,tem,thic,thick,tissue,tooth,toward,twice,ultimately,unbranched,unit,upper,usually,various,vary,vein,vestigial,way,wide,without,ympodial,–4	-4,0.2-0.5,0.2-2,10-15,2-4,2-5,2-8,2.5-3,3.5-4,3.5-4.4,5-12,5-15,adhesion,arrangement,capitate,climate,colour,corolla,form,growth,height,history,inflorescence,length,life,midpoint,na,number,ovary,plant,position,presence,present,reproduction,rugulose,seed,shape,staman,stipe,texture,unknown
582	wfo-0001030176	success	171	101	72	99	29	0.421	-6.25,.2,.7,0.5-2,0.6-0.9,0.7-1.4,0.7–0.8,1.2,1.2-2.5,1.5-2,1.6,1/3,1/6,2.25-3.25,3-5,3-lobed,3.75-5,6-8,6–8,abaxially,acute,anther,apex,base,bilobed,blade,broadly,calyx,chartaceous,cm,depressed-globose,diameter,especially,extra-axillary,flattened-reniform,flower,fruit,glabrous,herb,hermaphroditic,lanceolate-oblong,light,lobe,long,margin,minutely,mm,nearly,oblong,ovate,pale,pedicel,peduncle,petiole,plant,pubescent,rarely,ripe,rotate-stellate,slightly,sparsely,stigma,style,tip,tube,violet,white,white-puberulent,x,yellow,yellow-orange,young	-1.4,-4.25,.75-1.5,0.4-1.5,0.5,1,1-2,1-5,1.5-2.5,2-3,2-foliate,2.5,2.5–7.5,2.5–9,2–3,4-9,5-merou,accrescent,adaxiall,adaxially,alyx,angulate,apart,apparently,articulated,asymmetrically,attenuate,axe,ba,basal,berry,bi-lobed,branch,broad,capitat,ciliate,connivent,contact,covering,cylindrical,decumbent,dehiscent,downward,eaf,eed,erec,few-branched,filament,forming,fruiting,geminat,hair,hold,interlobal,juic,lance-ovate,lateral,line,lon,longitudinall,lower,major,mesocarp,midrib,near,nflorescence,node,numerous,often,orolla,partially,patch,perfect,pore,prostrate,rachi,recurve,recurved,rooting,round,ruit,simple,sinus,soil,sometimes,somewhat,spaced,tamen,tem,terminal,time,triangular,unbranched,unit,vary,vein,wide,winged,ympodial	0.75-1.5,2.5-7.5,2.5-9,abaxial,adaxial,adhesion,capitate,colour,corolla,form,growth,height,history,inflorescence,leaf,length,life,na,ovary,perennial,position,pubescence,reproduction,seed,shape,size,staman,stem,texture
583	wfo-0001030180	success	135	87	53	82	34	0.393	.75,0.5-1,0.8-2,0.9-1.8,1-1.5,1.1-1.2,3-8,4.5-5,6,8.5-23,abruptly,anther,apex,attenuate,base,calyx,clavate,cm,corolla,dark,deltoid,fruit,glabrous,globose,green,height,leaf,linear,lobe,lobed,long-acuminate,minutely,mm,narrowing,opposite,ovary,papillose,pedicel,petiole,poricidal,puberulent,shrub,sparsely,stem,stigma,style,surface,tube,unknown,white,widely,winged,x	.1,.5,0.05-1,10-30-flowered,3-4,8-10,?,accrescent,anthesi,apart,apiculate,appearing,bark,becoming,berry,clu,decurrent,deflexe,dia,eaf,edicel,eed,ellipsoid,erect,exserted,filament,free,fruiting,furcate,glabrate,immature,inflorescenc,interpetalar,known,lateral,lenticellat,lon,long,lower,main,middle,minute,nearly,nflorescence,occasionally,older,overlapping,pair,papillate,peduncl,planar,plurifoliat,pore,portion,prominent,proximal,raised,rounded,ruit,scar,shaped,sinus,slender,slightly,soon,spaced,straight,tear-drop,terminal,thin,tip,trichome,ud,unevenly,uniseriate,unit,vein,widest,woody,yellowish,ympodial,young	adhesion,arrangement,blade,climate,colour,diameter,form,glandular,growth,hair,history,inflorescence,length,life,margin,midpoint,na,number,peduncle,plant,plurifoliate,position,presence,pubescence,ray,reproduction,rugulose,seed,shape,size,staman,stellate,stipe,texture
584	wfo-0001030182	success	205	120	97	108	23	0.473	-12,0.2-0.3,0.5-1,1-4.5,1.2-1.5,12-15,15-20,2-2.2,2-3,2-5,2.4-2.5,3-12,3-4,3-5,3-8,4-10,abaxially,acute,angulate-lobed,anther,apex,basal,base,berry,blue,brown,brownish,calyx,clavate-truncate,cm,coriaceous,corolla,diameter,elliptic,entire,flattened,fruit,glabrescent,glandular,globose,green,growth,heterostylous,hirsute,internodal,leaf,like,linear-lanceolate,lobe,margin,midpoint,mixed,mm,oblique,obtuse,ovary,ovate,ovate-elliptic,papillose,pedicel,peduncle,petiole,plant,porrect,pubescence,pubescent,ray,red,reddish,repand,ripe,rounded,rusty,sessile,shrub,simple,sparsely,stellate,stellate-glandular,stem,stigma,style,subcoriaceous,subreniform,subsessile,surface,tapering,terminal,tomentose,treelet,triangular-lanceolate,trichome,tube,violet,x,yellowish,¼	0.3-0.5,1,1-1.5,1-1.7,1-celle,1-celled,1-multicellular,1-nerved,1.5-2,1/4,2-15,2-8,4-5,accrescent,adaxially,adult,anthesi,armed,articulated,asymmetric,bark,branched,cell,closely,dark,den,discolorous,distal,e,eaf,eed,eglandular,erect,evident,exserted,ferruginous-tomentose,filament,finely,flower,free,fruiting,immature,juvenile,later,lengthening,lobed,long,long-styled,lower,many,microscope,midrib,minute,minutely,mixture,multangulat,multicellular,nearly,new,nflorescence,older,one,ovoid,papillo,per,perfect,pericarp,plurifoliat,pore,poricidal,porrect-,porrect-stellate,portion,prickle,prickly,recurved,reduced,reflexed,reticulate,ruit,scar,seen,short,short-styled,similar,slightly,slit,space,sparse,stalked,staminate,strongly,tall,testa,tip,tub,turbinate,ud,unarmed,uniseriate,unit,upper,variegated,vein,velutinous,wood,yellow,ympodial	adhesion,arrangement,blade,climate,colour,form,hair,height,inflorescence,length,na,number,position,presence,present,reproduction,rugulose,seed,shape,size,staman,stipe,texture
585	wfo-0001030185	success	206	96	76	130	20	0.369	1,1-10,1.0-1.3,10,2-3,2.0-3.0,21,3.5-4.2,35,5-7,5-lobed,8-11,9-18,beyond,blue,blue-violet,calyx,center,cm,commonly,corolla,dark,darker,deep,densely,diameter,distal,elliptic,forked,generally,glabrescent,glabrous,glandular-pubescent,globose,green,green-white,hair,half,herbaceous,lanceolate,light,long,medium,middle,mm,moderately,narrowly,occasional,odd-pinnate,ovate,ovoid,pedicel,peduncle,perennial,plant,puberulent,purple,rhizomatous,rotate,scarcely,seed,shape,size,sometimes,spot,star,stem,stigma,style,symmetrically,tinged,violet,white,wide,without,yellow	-0.5-1.3,0.2,1-4,1-8,1.5-4,1.7,15,2,20-65,25,3-6-foliat,4,4-7,5-10,abaxially,acumen,acuminate,acute,adaxially,angular,apex,apical,apically,apiculate,articulate,b,ba,basal,base,becoming,branched,caudate,cell,cente,clasping,coat,collection,color,connate,cordate,covering,cuneate,cyme,decreasing,dehiscent,dichasial,dichasially,digestion,eaf,ebracteate,eed,embryo,emoval,enzyme,erect,exceeding,filament,flower,formed,gland,globo,hair-like,honeycomb,interjected,introrse,lateral,leaflet,living,lobe,lon,lower,make,maturing,monochasial,mucilaginous,nearly,nflorescence,nther,obliquely,oblong,often,one,orolla,pair,pattern,pentagonal,perfect,petiolate,petiolulate,petiolule,poricidally,purpl,radiating,rare,reduced,reveal,rhizome,rotate-,rounded,ruit,semi-lunate,sessile,seudostipule,short,slightly,slit,somewhat,specimen,stamen,ste,straight,subequal,tem,terete,terminal,testal,thick,tip,trailing,type,typically,unbranched,unit,usually,vary,visible,wall,wid,wider,ympodial	anther,arrangement,colour,form,fruit,growth,height,history,inflorescence,leaf,length,life,ovary,petiole,position,pubescence,reproduction,rotate-pentagonal,texture,tube
586	wfo-0001030189	success	188	95	71	117	24	0.378	-4,0-1,0.5-1.6,0.9-1.1,1,1-1.5,1.1-2.7,1.3-4.2,1.5-5,1/3,2-5.5,2.5-4,3.2-4.5,4-5.5,5-10,5-6,6-12,abaxially,anther,calyx,chartaceous,cm,densely,diameter,dull,elliptic,equal,evenly,flattened-reniform,fruit,glabrescent,glabrous,gray,green,lateral,leaf,length,lobe,lobed,long,lower,maturity,mauve,mm,moderately,oblong,orange,ovate,pedicel,peduncle,petiole,poricidal,purple,red,scandent,shrub,simple,sparsely,spherical,stellate,stellate-pubescent,stem,style,tapering,terminal,tip,tube,upper,wide,yellow,young	-1/2,.2,/3,0-15,0-30,0.1,0.1-0.2,0.2-0.3,0.2-0.5,1-2,1-3-cellular,1-4-cellula,1-4-cellular,1.5-2,1.5-4.5,1/,1/6-1/3,2,2-3,3-4,4-13,5-,5-merous,6-10,8,8-10,8-18,acut,alyx,apar,apex,apically,apparently,appressed,articulated,bark,base,berry,blade,branched,concolorous,connivent,cordate,curved,deltate,drying,eaf,eed,elongating,entire,erect,faint,filament,flower,foliaceous,free,frui,fruiting,glabrescen,gland-tipped,infructescence,longer,margin,mature,midpoint,nflorescence,obtuse,often,older,one,open,orolla,oung,pair,per,perfec,pericarp,plurifoliat,porrect,portion,primary,ray,recurved,red-brow,reflexed,rounded,ruit,scar,sessile,shorter,slender,smooth,sometimes,somewhat,spaced,spreading,stalk,stalked,strongly,surface,tamen,terete,tertiary,time,trichome,unarme,unarmed,unit,variously,vary,vein,venation,visible,way,woody,yellow-green,ympodial	1/4,adhesion,arrangement,colour,corolla,form,growth,height,history,inflorescence,life,na,ovary,plant,position,presence,present,pubescence,red-brown,seed,shape,size,staman,texture
587	wfo-0001030195	success	255	104	62	193	42	0.243	2,acuminate,adnate,anther,apex,apiculate,base,blade,brown,calyx,capitate,chartaceous,cm,corolla,cuneate,densely,diameter,entire,flattened-orbicular,fruit,glabrous,glandular,globose,green,hair,lateral,leaf,lobe,long,margin,minute,mm,moderately,notched,oblong,obtuse,ovate,pedicel,petiole,pubescent,ray,red,reddish,rounded,shoot,short,shot,shrub,simple,spatulate,stellate,stellate-pubescent,stem,stigma,style,subcoriaceous,surface,terminal,tube,white,yellow,yellow-tan	.2,.3,.5,.6,.7,/3,0.1–0.2,0.2–0.3,0.2–0.5,0.2–1.0,0.3–0.7,0.5,0.5–0.6,0.5–1.3,0.5–4.0,0.7–1.0,0.8,0.8–0.9,0.9–4.8,1,1.0,1.0–1.4,1.0–1.5,1.2–1.6,1.3–1.5,1.3–2.6,1.4–1.6,1.5–1.7,1.5–1.9,1.7–2.2,1.7–3.2,1.8–2.0,1.8–2.5,1/3,2.2–2.7,2.3,3.8–4.8,3–6,3–7.3,4-merou,4.9–7.0,5.5–6.5,6.3–7.7,6–8,6–9,abaxially,adaxial,adaxially,aequilateral,ag,along,alyx,anthesi,apical,apparently,appearing,appresse,around,articulate,attachment,attenuate,ba,bark,based,berry,borne,broad,broad-based,brochidodromous,bud,channeled,connivent,dark,deltate,dentate,developed,directed,distal,distally,distinct,dry,eaf,edge,eed,either,elliptic,emerging,endocarp,evenly,exocarp,extending,extra-axillary,fertile,filament,filiform,flat,flattened-irregular,flexed,flower,free,glossy,gradually,gree,homostylous,hort,immature,increasing,indistinct,individually,intact,internode,interpetalar,intersepalar,isolated,juic,layer,laying,light,lon,longer,lower,m.,many,markedly,mature,middle,midpoint,midrib,midvein,mottled,narrowly,nearly,nflorescence,nodding,oblique,occasionally,opaque,orolla,per,perforated,pitted,plurifoliat,point,poorly,pore,porrect,portion,potentially,presen,prickle,raised,reflexed,remaining,restricted,ruit,scattered,sessile,side,sinus,slightly,sloughing,smoot,sparsely,splitting,stamen,stellae,straight,striped,suture,tamen,tem,thin,time,tip,tissue,transparent,truncate,typically,ud,unarmed,unit,vary,vein,weakly,wide,yellow-ferruginou,yellow-ferruginous,ympodial,young,±90°,±equal,±glabrous,×	0.1-0.2,0.2,0.2-0.3,0.2-0.5,0.3,0.5-0.6,0.5-4.0,0.6,0.9-4.8,1.0-1.5,1.2-1.6,1.3-2.6,1.5-1.9,3.8-4.8,5.5-6.5,6-8,adhesion,arrangement,colour,form,growth,height,history,inflorescence,length,life,na,number,ovary,peduncle,plant,position,presence,present,pubescence,reproduction,rugulose,seed,shape,size,staman,texture
588	wfo-0001030198	success	234	122	71	163	51	0.303	0.8,1,16,abaxially,acute,angulate,anther,apex,attenuate,base,blade,calyx,closely,cm,deltoid,densely,diameter,entire,flattened-reniform,flower,fruit,glabrate,glabrous,globose,green,hair,initially,interpetalar,irregularly,lateral,leaf,lilac,lobe,lobed,margin,midpoint,minute,mm,orange,overtopped,pedicel,peduncle,petiole,purple,ray,rounded,shrub,simple,sinuate,soon,stellae,stellate,stellate-tomentose,stem,stigma,style,surface,tan,terminal,tissue,tomentose,truncate,tube,turning,weak,well-developed,whitish,whitish-tomentose,yellow,yellowish,×	.2,0.6,0.7–,0.7–0.8,0.7–0.9,0.7–1.1,0.8–1.4,0.9–1.7,0.9–2,1.2,1.4–1.6,1.5–3.5,1.5–6.5,10–12,13–20,1–2.5,2,2.5,2.5–14,2.5–3.0,2–2.8,2–3,2–3-lobed,3.4–4.0,3.5–7,3–3.5,3–4,3–9,4,4.5,4–12-branched,5-merou,5.3–7,5.5–13,5–12,60–150,6–10,7.5–10,acicular,adaxiall,adaxially,alyx,ampliate,apart,apical,apparently,appearing,articulated,axe,basal,berry,black,branch,broad,broadly,capitat,caudate,contrasting,cordate,coroll,dark,darker,deeply,directed,distall,distally,drying,eaf,eed,except,extra-axillary,fewer,filament,filiform,finely,formed,free,frui,geminat,glabrescent,gland-tipped,gradually,hal,high,homostylous,immature,internode,interwoven,larger,like,lon,long,lower,major,many,midri,midrib,midvein,midzone,minutely,much,near,nearly,nflorescence,oblong-lanceolate,often,one,orolla,ovate,ovoid,part,perfect,persistently,pitted,plurifoliate,pore,porrect,prickle,principal,recurved,reflexed,relatively,ruit,sessile,shiny,short-stalked,shorter,side,sinus,slightly,sometimes,somewhat,spaced,sparse,splitting,spreading,stalk,stella,stout,straight,strongly,tamen,tem,thickened,time,tip,triangular,ud,unarmed,unit,upper,usually,vary,vein,white,white-tomentose,wide,ympodial,–17,–18,–20,–3,–3.5	0.7-1.5-3.5,0.8-1.4,0.9-1.7,1-2.5,10-12,17,18,2-2.8,2-3,2.5-14,2.5-3.0,20,3,3.4-4.0,3.5,5-12,5.3-7,5.5-13,6-10,7.5-10,adhesion,arrangement,capitate,climate,colour,corolla,form,glandular,growth,height,history,inflorescence,length,life,na,number,ovary,perennial,plant,position,presence,pubescence,reproduction,rugulose,seed,shape,size,staman,stipe,texture,ye
589	wfo-0001030212	success	188	94	69	119	25	0.367	0.2-0.4,0.5-0.6,1-1.2,1-1.5,1.2-1.8,1.5-2,2-2.5,2-4,2-5,2.1-3.4,2.4-3.3,2.5-6,2.6-6.5,3.5-5,4-23,4-9,4.5-6,absent,andromonoecious,anther,attenuate,broadly,brown,calyx,capitate,chartaceous,cm,compound,cylindrical,deltate,depressed-globose,diameter,fruit,glabrous,gland-tipped,glandular-puberulent,green,hair,herbaceous,inflorescence,leaf-opposed,length,lobe,mm,narrowly,ovate,pedicel,peduncle,petiole,pinnately,plant,prostrate,purple,resprouter,rotate,rotate-stellate,short,simple,slightly,sparsely,sprawling,stigma,style,surface,triangular,tube,x,yellow,yellowish-green	%,0-4,0.5-1,0.5-7,0.9-1.3,1-15,1-2,1-3,1-5,1-6,1.4-1.8,12-40,15-40,20-50,25-60,28-37,3-5,30-150,4-27,4-6,5-merou,6-9,7-11,8-9,9-10,abaxial,abaxially,absen,abundant,accrescent,acicular,acute,adaxial,adaxiall,adaxially,alyx,apart,apex,apparently,armed,articulated,axe,ba,base,bilobe,blade,bristle-like,center,connivent,cuneate,d.,deeply,directed,distall,divided,eaf,eed,filament,finger,flower,fruiting,functional,geminat,half,heterostylous,index,interpetalar,juic,lamina,lateral,lobed,lobing,lon,long,lower,margin,mature,mesocarp,mid-point,midvein,minute,moist,nflorescence,oblique,orolla,part,per,plurifoliate,pore,presen,present,pricke,prickle,rachi,ruit,side,spaced,sparse,stage,straight,strongly,tal,tamen,tem,thick,throughout,time,tissue,toothed,unbranched,unit,unknown,uvenile,vary,vein,weakly,wide,winged,ympodial	adhesion,arrangement,bilobed,colour,corolla,form,growth,height,history,leaf,life,na,ovary,position,presence,pubescence,reproduction,rugulose,seed,shape,size,staman,stellate,stem,texture
590	wfo-0001030219	success	191	123	68	123	55	0.356	0.5,1.5,60,abaxially,acute,adaxially,anther,anthesi,apex,base,black,blade,blue,brown,calyx,cm,decurrent,deeply,densely,diameter,elliptic,flattened,fruit,glabrous,globose,green,hair,incised,lanceolate,leaf,lilac,lobe,long,margin,marking,mm,moderately,multicellular,number,oblong,opposed,ovate,pair,pale,pedicel,peduncle,pentagonal,perennial,petiole,pitted,pubescent,purple,regularly,shallowly,shrub,simple,size,spaced,sparsely,stigma,style,surface,tube,uniseriate,velutinous,woody,x,yellow	0.1–0.3,0.2–2.3,0.4–1.0,0.5–,0.7–1.1,0.8–3.0,0–,1.0–1.2,1.0–1.5,1.0–2.0,1.0–2.2,1.3–2.9,1.4–2.8,1.6–,10,15,1–2.5,2.0–2.5,2.0–3.2,2.0–5.5,2.4–6.0,2–,2–2.5,2–3,2–4.5,3,4.5–5.5,4.8–11.5,4–5,4–7,5,5–,5–8,6–,6–10,6–8,7–11,8–18,9–10,9–12,abaxiall,acut,adaxiall,adnate,ag,along,anisophyllous,apart,apical,apparently,appearing,arising,arranged,articulated,axe,ba,basal,bract–like,branched,cell,chartaceous,clavat,concave,connivent,convex,cylindrical,decreasing,diamete,difoliate,directed,distally,eaf,eed,equal,erect,filament,flower,geminat,glabrescent,indistinct,internode,longitudinal,lower,nflorescence,olive,opening,oppositely,orolla,paler,perfect,pore,present,procumbent,rapidly,red–purple,rounded,ruit,serrate,sessile,sid,side,smaller,split,stone,straight,stripe,strongly,tal,tamen,tem,time,two,unicellular,unit,vary,white,wide,wing,winged,ympodial,–3.0,–7.0,–9.5	-3.0,-7.0,-9.5,0.1-0.3,0.2-2.3,0.5-,0.7-1.1,1.0-1.2,1.0-2.0,1.0-2.2,1.6-,2-,2-4.5,2.0-3.2,2.0-5.5,2.4-6.0,4-5,4-7,4.5-5.5,4.8-11.5,5-,7-11,9-10,adhesion,arrangement,clavate,climate,colour,corolla,form,glandular,growth,height,history,inflorescence,length,life,midpoint,na,opposite,ovary,plant,position,presence,pubescence,ray,reproduction,rugulose,seed,shape,staman,stellate,stem,stipe,texture
591	wfo-0001030224	success	191	110	79	112	31	0.414	0.5-1,0.5-1.5,1-2,1-3.5,12-14,14-17,2-10,2-4,2.5-4,2.5-4.5,2.5-8,4-10,4-4.5,4.5-5,6-15,7-10,abaxially,acute,adaxially,andromonoecious,anther,apex,armed,base,black,blade,brown,calyx,chartaceous,clavate,cm,connivent,dark,densely,diameter,elliptic,extra-axillary,ferruginous,finely,flattened,form,fruit,glabrous,globose,greyish,hair,linear-lanceolate,lobe,midpoint,mm,moderately,orange,outline,pedicel,peduncle,petiole,pink,plant,pubescent,purple,ray,red,reniform,scandent,shrub,simple,sparsely,stellate,stellate-pubescent,stem,stigma,style,subcoriaceous,suborbicular,surface,tightly,tube,x,yellow	-2.5,.25,.5,0.5-3,1-1.5,1.5-9,10-20,2-3-celled,2-5,20-25,3-4-foliate,4-6,5-10,5-merous,6-10,6-8,8-12,absent,accrescen,acuminate,adaxiall,ag,alyx,andromonoeciou,apart,articulated,axe,ba,bark,berry,broad-based,capitat,cell,cylindrical,deflexed,directed,distally,dry,eaf,eed,eglandular,equal,filament,fissure,flower,forked,free,fruiting,functionally,geminat,gradually,green,hermaphroditic,heteromorphic,interpetalar,lateral,lighter,like,long,long-,longer,longitudinal,lower,lowering,major,mature,maturit,midvein,narrowly,nflorescence,occasionally,one,opening,orolla,other,part,perfect,pericarp,pore,prickle,pseudohair,rachi,recurved,reddish-brown,reflexed,ruit,sessile,shiny,short-styled,side,slit,small,spaced,sparse,staminate,strongly,tamen,tan,tapered,testal,time,tissue,triangular,unbranched,unit,vary,vein,wall,wide,wtih,yellowish,ympodial	adhesion,arrangement,capitate,climate,colour,corolla,fissured,glandular,growth,height,history,inflorescence,leaf,length,life,margin,na,number,ovary,position,presence,pubescence,reproduction,rugulose,seed,shape,size,staman,stipe,texture,ye
592	wfo-0001030225	success	155	114	80	75	34	0.516	-30,-4,-7,.5-2.5,1,1-4,1-6,1.5-2.5,10-15,2,2-18,2-2.5,2-3,2-6,3-11-compound,3-20,3-4,3-5,4-5,abaxially,acuminate,acute,adaxially,apex,apical,basal,base,bilobed,blade,calyx,campanulate,cm,conivent,cordate,cuneate,deltate,densely,diameter,elliptic-ovate,entire,especially,expanded,fruit,glabrous,gland,globose,leaf,lobe,long,margin,mm,moderately,oblong,obtuse,papillose,pedicel,peduncle,petiole,pinnately,possibly,puberulent,purple,shallowly,shrub,simple,small,somewhat,sparsely,stellate,stigma,style,succulent,tip,toward,tree,truncate,tube,two,unknown,x	-1.5,-11,-45,.5,0,0-20,0-5,1.5,10-30,3-foliat,8-15,absent,apart,ape,apically,articulated,ature,axe,beyond,color,compound,connective,coriaceous,cylindrical,dilated,directed,distally,eaf,eed,equal,exceeding,exserted,fleshy,flower,forked,glabrate,immature,laterally,leaflet,leaving,less,lower,minutely,narrowly,nflorescence,nther,one,orolla,perfect,pore,prominent,puberulen,rachi,radiu,scar,see,seen,slightly,spaced,stalked,stamen,strongly,tal,tem,thecae,time,tomento,triangular,ud,unbranched,unit,unknow,vary,wide,ympodial	adhesion,anther,arrangement,climate,colour,corolla,form,glandular,growth,hair,height,history,inflorescence,length,life,midpoint,na,number,ovary,plant,position,presence,pubescence,ray,reproduction,rugulose,seed,shape,size,staman,stem,stipe,surface,texture
593	wfo-0001030244	success	226	131	102	124	29	0.451	%,0-0.1,0-0.6,0-1,0.1-1.5,0.2-0.6,0.2-1.3,0.25-0.5,0.3-0.5,0.4-0.7,0.5-1,0.5-1.2,0.5-3.5,0.6-0.8,0.8-1.2,1-1.5,1-5,1.5-2,1.5-2.3,1.5-3,2.5-6.5,3.5-9,7-16,7-24,7-8,abaxially,absent,acute,adaxially,anther,apex,articulated,attenuate,base,blade,blue,brown,calyx,chartaceous,cm,connivent,cuneate,cylindrical,deltate,densely,diameter,entire,erect,extra-axillary,fruit,glabrous,gland-tipped,globose,green,grey,hair,inflorescence,lamina,lanceolate,lateral,length,linear,lobe,long,margin,midpoint,mm,moderately,narrow,narrowly,oblong,obtuse,pale,pedicel,peduncle,perennial,petiole,plant,present,purple,ray,red,reniform,rhizomatous,rotate,scattered,short,shrub,simple,sparsely,stellate,stellate-pubescent,stigma,style,surface,tan,throughout,time,tube,white,x,yellow	.05,.3,0-0.3,0-3,0.2,0.2-0.5,0.2-1,0.25-0.4,0.3-0.4,0.3-5,0.5-7,1-2,1-20,1-6,1-8,1-locular,1.5-,11-33,2-2.5,2-4,2-foliate,2.5-13.5,3.3-7.5,4-5,4-5-merou,4-6,5-6,6-8,7-15,7-9,8-18,absen,accrescent,acicular,across,alyx,andromonoecious,apart,apparen,axe,ba,capitat,common,confined,decimetre,directed,distall,distally,distributed,eaf,eed,eglandular,exocarp,filament,finger,flower,fruiting,geminat,half,heterostylous,homostylous,incomplete,interpetalar,juicy,less,longer,lower,markedly,mature,mesocarp,mid-point,midrib,minute,nflorescence,oblique,orolla,part,per,perfect,placenta,plump,pore,porrect,prickle,pseudo-racemose,pubescent,rachi,reticulate,ruit,septum,sessile,slightly,solitary,spaced,sparse,stage,stalk,stalked,stellae,straight,strongly,succulent,tal,tamen,tem,thick,thicker,thicknes,tissu,tissue,triangular,unarme,unarmed,unbranched,unit,unknow,usually,uvenile,vary,weakly,wid,wide,yellowish,ympodial	1.5-13.5,adhesion,arrangement,capitate,climate,colour,corolla,form,glandular,growth,height,history,leaf,life,na,number,ovary,position,presence,pubescence,reproduction,rugulose,seed,shape,size,staman,stem,stipe,texture
594	wfo-0001030250	success	169	92	59	110	33	0.349	.5,0.5-1,1-1.5,1-3,1.1-1.2,1.4-1.5,1.7-7,11.2-22,11.3,2-2.5,2.5-3.25,25,3.4-6.6,3.5-4,5-6,anther,apex,base,broadly,brown,calyx,capitate,cm,corolla,cup-shaped,elliptic-ovate,glabrous,globose,green,greenish-white,greenish-yellow,inflorescence,leaf,lobe,lobed,long-acuminate,minutely,mm,opposite,orbiculate,ovary,ovoid-reniform,pale,pedicel,petiole,pitted,seed,shape,shaped,shrub,size,stem,stigma,style,surface,tan,tear-drop,tube,x	/4,0-seeded,1.1-3.5,1.25-1.5,1.9-2.6,2.1-6,3-5,4-7,5-50-flowered,6-8,across,anthesi,apart,appearing,arching,attenuate,bark,beginning,beneath,berry,bullate,carinate-hooded,conical,consisting,cuneate,curved,dark,decurrent,deflexed,dia,differing,difoliate,dry,eaf,edicel,eed,elliptic,exerted,filament,five,free,fresh,fruiting,geminat,glabrou,horizontally,inflorescenc,irregularly,lateral,lon,long,lower,main,major,maturity,middle,minor,n,nflorescence,node,occasionally,older,one,orbicular,pair,paler,papillo,papillose,pendulous,pit,pore,poricidal,portion,projection,prominent,proximal,raised,reflexed,rim,ruit,scar,sea-green,shallow,simple,slender,slightly,smooth,soon,spaced,specimen,spreading,straight,tall,tapering,tip,translucent,translucent-green,two,ud,unit,usually,vein,way,white-lenticellat,white-lenticellate,wide,widest,winged,woody,ympodial	adhesion,arrangement,blade,climate,colour,decurren,diameter,form,fruit,glandular,growth,hair,height,history,length,life,margin,midpoint,na,number,peduncle,perennial,plant,position,presence,pubescence,ray,reproduction,rugulose,staman,stellate,stipe,texture
595	wfo-0001030271	success	195	98	72	123	26	0.369	0.15-0.75,0.7-9.5,0.9-2.5,1-2.5,1-3,1-7,1.4-2.1,1.9-6.6,15-61,2-4,2.4-5.6,3-10,4-7,5.6-12.3,6-15,anther,axillary,blue,brownish,bud,clavate,cm,coloration,completely,condition,coriaceous,corolla,dark,deep,diameter,drying,elliptic,fresh,fruit,glabrous,green,greenish,herb,lanceolate,leaf,light,lilac,lobe,long,medium,mm,mottled,odd-pinnate,ovate,ovoid,pedicel,peduncle,pentagonal,petiole,plant,purple,ripe,rotate,seed,size,spot,stigma,style,subtending,terminal,tube,vein,white,whitish,wide,x,yellow	0-2,0.5-1.2,0.9-3.6,1-2,1-4,1-6,2-2.7,2-3,2-6,3-5,3.4-7.5,4-22,5-8,5-merou,abaxially,acumen,acute,adaxiall,adaxially,ag,along,alyx,apart,apex,apparently,arranged,articulated,asymmetric,attenuate,axe,base,basiscopic,bead,berry,blade,capitat,cell,connivent,considerably,covering,decreasing,digestion,distal,dorsally,eaf,edge,eed,enzyme,erect,exceeding,filament,flat,flower,folded,forked,geminat,generally,glabrou,green-white,habi,hair-like,half,homostylous,honeycomb-shaped,interjected,larger,lateral,leaflet,lengthening,like,linear,living,lower,make,middl,moniliform,mucilaginous,multiple,necklace,nflorescence,orbicular,orolla,pair,perfect,petiolulate,plurifoliate,pore,poricidal,removed,rosette,rounded,ruit,sessile,seudostipule,side,slightly,slit,sometimes,spaced,specimen,stamen,stolon,straight,symmetric,tall,tamen,tem,testal,thick,throughout,tip,tissue,toward,tri-,tuber,typically,unit,unwinged,usually,vary,wall,wet,ympodial	abaxial,adaxial,adhesion,arrangement,calyx,capitate,colour,form,growth,height,history,inflorescence,length,life,na,ovary,perennial,position,pubescence,reproduction,rugulose,shape,staman,stem,surface,texture
596	wfo-0001030272	success	179	121	97	82	24	0.542	-6,/4,0.05-1.5,0.5-1.5,0.5-2,0.6-0.9,0.65-1,0.7-2.5,0.8-1.5,1,1-2.8,1.2-1.8,1.5-2.5,1/3,2-6.5,2.5-3,2.5-3.5,2.8-3.5,3.5-5,4-15,abaxially,acute,anther,apex,apically,base,berry,blade,bright,calyx,cm,connivent,deltate,densely,diameter,elliptic,entire,equal,erect,evenly,flattened-reniform,fruit,glabrescent,glabrous,glandular,green,hair,lateral,leaf,length,less,lobe,lobed,long,long-attenuate,margin,maturity,mauve,membranous,midpoint,minute,mm,multangulate,near,obtuse,orange-brown,pedicel,peduncle,petiole,poricidal,porrect,ray,red,rounded,sessile,shallowly,shrub,simple,sometimes,sparsely,spherical,spreading,stellate,stellate-pubescent,stem,style,surface,tapering,terminal,tip,trichome,tube,undulate,upper,way,wide,young	.3,.5,0-20,0.05-0.1,0.5-1,1-1.5,1.5-3,1/3-2/3,10-20,2-2.5,3-8,4-10,4-6,4-8,5-7,5-merous,acut,almost,alyx,ame,apar,apparently,articulated,ba,bark,c.,concolorous,difoliate,drying,eaf,eed,elongating,filament,flower,free,fruiting,geminat,glabrescen,gland,gra,infructescence,longer,lower,mature,moderately,narrow-deltate,nflorescence,older,one,open,orolla,oung,pair,per,perfec,pericarp,portion,primary,red-brown,reduced,reflexe,ruit,scar,shorte,slender,smooth,spaced,straight,tamen,terete,tertiary,time,unarme,unarmed,unbranched,unit,vary,vein,venation,visible,woody,ympodial	adhesion,arrangement,climate,colour,corolla,form,gray,growth,height,inflorescence,na,number,ovary,plant,position,presence,pubescence,seed,shape,size,staman,stigma,stipe,texture
597	wfo-0001030278	success	235	166	139	96	27	0.591	0-0.2,0.6-1,1-2,10-30,12-25,2,2-6,2.5-3,3-4,3-5,3-7,3.5-5,4-8,5-20,6-12,7-10,7-12,8-30,9-18,abaxially,achlorophyllous,acute,acute-,adaxial,adaxially,along,also,anther,apex,articulated,ascending,attenuate,base,blade,branched,broadly,brown,calyx,capitate-glandular,closely,cm,coarsely,collection,concentrated,connivent,contiguous,cordate,corolla,cylindrical,dark,deltoid,densely,dentate,diameter,divergently,ellipsoid,elliptic,elongate,erect,extra-axillary,fine,flexuous,flower,fruit,glabrous,hair,hermaphroditic,hirsute,inflorescence,intermixed,lateral,length,lenticular,lignescent,linear-lanceolate,lobe,long,longer,margin,midpoint,minutely,mixed,mm,moderately,narrowly,nearly,obtuse,obtuse-tipped,occasionally,open-campanulate,orange,outline,ovate,pedicel,peduncle,perennial,petiole,pitted,prickle,prickly,pubescent,ray,resembling,rigid,ripe,sessile,short-stalked,similar,simple,slender,smaller,sometimes,somewhat,spaced,sparsely,spreading,stalked,stellae,stellate,stem,stigma,straight,style,subglobose,surface,tan,termination,thin-textured,tip,trichome,truncate,tube,unbranched,uniseriate,vein,weakly,white,x,yellow	0-1,0.1-0.3,1-several,1/3-1/2,10-20,15-20,2-4,2-7,2-foliate,3.5-7,4-12,4-locular,5-8,6-18,7-20,absent,accrescent,adaxiall,armed,axe,ba,basally,breaking,broad-based,capitat,cauline,commonly,completely,compressed,covering,density,directed,distal,distall,eaf,eed,entire,female-sterile,filament,finally,flesh,fruiting,geminat,glabrou,gland-tipped,glandular-puberulen,immature,inserted,interlobal,large,laterally,less,lower,major,maturit,medium-sized,midrib,mostly,much,nflorescence,numerous,often,orolla,ovate-lanceolate,pale,per,petaloid,pore,principal,prominent,rachi,recurved,reduced,ruit,section,short-styled,side,sinus,small,spreading-hirsute,ste,straighter,subequal,surrounding,tal,tamen,tem,toothlike,unarmed,unit,usually,vary,varying,wide,widely,ympodial	adhesion,arrangement,capitate,climate,colour,form,glandular,growth,height,history,leaf,life,na,number,ovary,plant,position,presence,pubescence,reproduction,rugulose,seed,shape,size,staman,stipe,texture
598	wfo-0001030281	success	193	116	98	95	18	0.508	0.5-1,0.5-1.0,0.5-1.5,0.5-3,1,1-2,1.5,10-13,10-14,12-16,12-20,2-4,2-4.5,2-5,2.5-3,2.5-3.5,2.5-5,3-6,4-7,5-10,5-16,abaxially,absent,adaxially,anther,armed,attenuate,base,brown,calyx,capitate,chartaceous,cm,connivent,dark,densely,diameter,extra-axillary,flower,fruit,functionally,glabrous,glandular,globose,green,hair,hermaphroditic,leaf,leathery,like,lobe,lobed,male,many,mature,midpoint,mm,moderately,nearly,netlike,orange,ovate,pedicel,peduncle,petiole,pit,porrect-stellate,prickle,pubescent,rachi,raised,recurved,red,reniform,ridge,roselike,rusty,separated,short,simple,slightly,small,sparsely,stellate,stem,stigma,style,surface,tan,tapering,tube,unbranched,unlobed,vine,white,whitish-green,x,yellow	0.2-0.8,0.5,1-.,1-2.5,1.5-3,10-25,20-30,3-12,4-6,4-8,5-merou,6-8,abaxial,absen,accrescent,acute,adaxial,adaxiall,alyx,andromonoecious,anthesi,apar,apex,apical,asymmetrical,axe,berry,beyond,blade,cordate,curved,cylindrical,difoliate,directed,discolorous,distally,eaf,eed,either,em,expanded,exserted,filament,flattened,frui,fruiting,geminate,glabrou,gree,heteromorphic,interpetelar,introrsel,lacking,long,long-styeld,lower,major,midrib,midvein,multicellular,multiseriate,narrowly,nflorescence,obtuse,often,older,orolla,pair,per,planst,plant,pore,ray,reflexed,ruit,short0styled,side,spaced,stalk,stamen,staminate,ste,tamen,tissue,triangular,unarmed,unequa,unicellular,unit,usually,vary,vein,wide,ympodial,young	armature,arrangement,colour,corolla,form,growth,inflorescence,length,ovary,position,presence,present,pubescence,seed,shape,size,staman,texture
599	wfo-0001030285	success	279	131	110	169	21	0.394	.1,0.1–1.1,0.2–0.3,0.3–0.4,0.3–0.6,0.4–0.6,0.5–0.7,0.6–0.9,0.7–1.5,1.0–2.2,1.3–1.8,1.4–1.9,1.6–2.3,1.6–5.0,1/3,13.5,15.0–25.5,2.2–4.8,3.5–6.0,3.7–5.4,4,4.0–7.0,4.3–11.8,5,6.0–9.0,6–10,9.9–14.9,abaxially,adaxially,adnate,anther,apex,apiculate,attenuate,basal,base,becoming,calyx,capitate,chartaceous,cm,corolla,densely,diameter,dry,elliptic,erect,extra-axillary,flattened-irregular,flattened-orbicular,flattened-reniform,flower,fruit,glabrous,globose,green,growth,hair,interpetalar,lateral,lavender,leaf,lobe,long,maturing,minute,mm,moderately,nearly,obovate,ovoid,pedicel,peduncle,petiole,poorly-developed,porrect,porrect-stellate,protuberance,pubescence,pubescent,purple,ray,red,reduced,sessile,shrub,simple,slightly,small,sparse,sparsely,stellae,stellate,stem,stigma,style,surface,tall,tip,tissue,toward,tree,truncate,tube,white,yellow,yellow-ferruginous,young,±glabrous,×	.04,.4,.6,.8,0.3–0.7,0.4–0.5,0.7–1.1,0.7–1.3,0.7–1.7,0.9–1.5,1.0–1.3,1.2–2.1,1.2–2.3,1.4–2.0,1.9–4.0,10.8–12.3,10–14,1984,2.4–3.2,2.8–3.1,3/4,4.6–8.8,45,4–5-merou,5.7–6.5,6–8-ray,9.2–15.2,90°,acuminate,adaxial,aequilateral,age,alveolate,alyx,anthesi,apart,apical,apparently,appearing,appressed,area,armed,articulated,attached,attachment,axe,ba,berry,bilobe,blade,branch,brochidodromous,bu,bud,central,channel,channeled,clinate,congested,conical,connivent,cuneate,deciduous,dehiscence,dentate,difoliate,distally,dorsally,eaf,eed,either,emerging,enclosing,endocarp,entire,exocarp,fertile,filament,filiform,flat,flexed,fork,forking,free,frui,fully,geminat,glandular,gradually,homostylous,immature,inclined,increasing,internode,intersepalar,juic,lanceolate,large,laying,less,line,lon,lower,major,many-flowered,margin,mature,midpoint,midrib,midvein,minor,moderate,nflorescence,notched,oblique,occasionally,often,orolla,peekel,per,perforate,point,pore,portion,potentially,prickle,raised,reported,restricted,rigid,ripe,rounded,row,ruit,shiny,shorter,side,single,sinus,smooth,soon,splitting,spread,stellate-pubescent,straight,suture,tamen,tem,thin,time,transparent,triangular,two,ud,unarme,unarmed,unbranched,upper,vary,vein,vigorous,wavy,weakly,wide,ympodia,±90°,±90°and,±equal,±overlapping	6–8,adhesion,arrangement,bilobed,colour,form,height,inflorescence,length,number,ovary,plant,position,presence,present,rugulose,seed,shape,size,staman,texture
600	wfo-0001030287	success	150	99	70	80	29	0.467	-11,0-15,0.5-1,1-2,1-2.5,1-3,1-4,1-5.5,1.5-10,1.5-2.5,1966,2,2-,2-10,2-12,2-5,3-9,4-5,4.5-6,abaxially,acute,adaxially,bluish,calyx,chartaceous,cm,compound,deltate,dendritically,densely,diameter,down,ellipsoidal,elliptic-ovate,fide,flattened,glabrous,herb,lanceolate,leaf,lilac,lobe,mm,moderately,narrowly,oblong,ovoid,pedicel,peduncle,petiole,pinnately,puberulent,pubescent,purple,rugulose,shrub,simple,smith,sparsely,stellate,stigma,strongly,style,subcoriaceous,tip,truncate,tube,unknown,x,yellow	-40,-foliat,-many,.5-2.5,1,1-10,1-15,2.5-4,3,4-6,5-10,8-13,?,adaxiall,aggregate,apart,apex,articulated,axe,base,basiscopically,blade,branched,cell,color,connivent,cylindrical,decurrent,dendritic,dendritic-pubescen,directed,distall,eaf,eed,eglandular,entire,flower,forked,gland,glandular,hair,lateral,leaflet,leaving,lon,long,long-stalked,lower,margin,membranaceous,nflorescence,nther,obtuse,often,orolla,pedicellar,pore,presen,rachi,radiu,ruit,scar,scattered,slightly,spaced,sparser,stalked,stone,subcapitat,subcordate,tal,tem,time,triangular,unbranched,unit,upper,vary,wide,ympodial	anther,arrangement,colour,corolla,dendritic-pubescent,form,fruit,growth,height,history,inflorescence,length,life,na,ovary,perennial,plant,position,presence,pubescence,reproduction,seed,shape,size,stem,subcapitate,surface,texture,ye
601	wfo-0001030299	success	179	120	94	85	26	0.525	-50,-6,1-1.5,1-10,1-3,1-5,1.5-2,1.5-3,10-20,2,2-,2-10,2-20,2-4,20-30,3,3-13,3-30,3-4,3-9-compound,4,4-5,4-6,4-8,5-40,6-22,6-9,?,acuminate,adaxially,apart,apex,articulated,basal,base,calyx,campanulate,capitate,chartaceous,cm,cordate,cylindrical,densely,diameter,dilated,distally,ellipsoidal,entire,flattened,forked,fruit,glabrous,hair,leaf,leaving,lobe,long,margin,mm,moderately,narrowly,ovate,pedicel,pedicellar,peduncle,petiole,pilose-hirsute,pink,pinnately,pubescent,pubescent-pilose,purple,remnant,rugose-reticulate,shrub,simple,slightly,small,spaced,sparsely,stigma,style,thickened,tomentose,tree,triangular,truncate,tube,unbranched,urceolate-,violet,white,x,yellow	-2,-40,.5-2,0.5-1,1-2,1.5-4,10-16,2.5-12,25-50,3-5,4-foliat,5-10,5-8,abaxially,absen,absent,acute,aggregate,also,ape,apiculate,axe,basiscopically,beyond,blade,cell,color,compound,connective,connivent,coriaceous,decurrent,diamete,directed,eaf,eed,equal,exceeding,expanded,exserted,fide,flower,globose,lateral,laterally,leaflet,lon,lower,midnerve,nflorescence,nther,obtuse,often,orolla,pavón,perfect,perhaps,pore,present,prominent,puberulent-pubescen,puberulent-pubescent,pubescent-pilo,rachi,radiu,ruit,ruiz,shorter,stamen,stone,tal,tem,thecae,time,tip,tomento,toward,ud,unequal,unit,unknow,upper,vary,wide,ympodial	abaxial,anther,arrangement,colour,corolla,form,growth,height,history,inflorescence,length,life,na,ovary,pilose,plant,position,presence,pubescence,reproduction,seed,shape,size,stem,surface,texture
602	wfo-0001030300	success	235	59	42	193	17	0.179	0.5-0.6,0.5-4,0.7-1.2,1,1-1.3,1.2-,1.4-2.4,1.5-,2.2-7.5,3.5-13,4-11,9-12,broadly,brown,cm,densely,diameter,elliptical,fruit,globose,green,herb,imparipinnate,inflorescence,interrupted,like,long,mm,obovate,orbicular,pale,perennial,petiole,plant,pubescence,pubescent,sparsely,stem,surface,thick,wide,yellowish-green	-0.9,-1,-7,.5,0.1,0.1-0.15,0.15-1,0.2,0.2-0.5,0.2-1.5,0.4-0.5,0.4-1.5,0.4-4.5,0.5,0.5-1,0.5-5,0.6-0.7,0.6-0.8,0.7-0.8,0.7-1.5,0.8-1,0.8-3,0.8-4,0.9-1,1-2,1-2-celled,1-4,1-6,1-celled,1.5-2.5,2-2.1,2-2.5,2-3,2-4,2-foliate,2-locular,3/4,4-celled,6-15,6-8-celled,abaxially,absent,abundant,acute,adaxial,adaxially,almost,although,always,anther,anthesi,apex,apical,appearance,appendage,articulated,articulation,ba,basal,base,bent,beyond,bifid,bract,bracteate,brittle,calyx,capitate,cell,coherent,column,cordate,corolla,crenat,crenate,curved,deltate,developed,diamete,distal,eaf,edicel,eed,eglandular,ellipsoidal,elongate,entire,even,exserted,face,filament,finely,flower,frequently,fruiting,give,glabrous,glandular,glutinous-viscose,golden,gree,hair-like,halfway,head,interjected,internode,introrse,irregularly,lamina,large,larger,lateral,leaflet,leave,less,lobe,lon,longer,margin,markedly,midvein,minute,moderately,multicellular,narrowly,nflorescence,node,oblique,occasionally,once-branched,outgrowth,ovary,pair,papillae,partially,pedicel,peduncle,pentagonal,petal,petiolule,pith,population,pore,present,primary,pseudostipule,reflexed,rest,rounded,ruit,secondary,silky,simple,slightly,spathulate,spreadin,spreading,staminal,sterile,stigma,straight,strongly,style,tall,tem,terminal,tertiary,testa,tip,triangular,trichome,tube,two,ud,underlying,unicellular,uniseriate,unit,united,upper,usually,vein,velvety,wall,weak,well,wider,winged,woody,yellow,yellowish,ympodial,zygomorphic	arrangement,colour,form,growth,height,history,leaf,length,life,na,reproduction,rugulose,seed,shape,size,texture,ye
603	wfo-0001030311	success	182	116	85	97	31	0.467	.2,0.5–0.8,0.5–1,0.8–1.2,1.2–7,1.5–5.5,1.5–8,1.8–2,15–22,1–1.2,1–1.5,1–2.5,2.2–2.5,2.2–3,2–2.5,2–6,3–5,3–7,5-pinnate,5–10,abaxially,acuminate,acute,adaxially,anther,apex,base,blade,brown,calyx,chartaceous,clavate,cm,cordate,deltoid,densely,diameter,entire,extra-axillary,flattened,flower,fruit,glabrous,granular,green,hair,half,herbaceous,lenticular,lobe,lower,margin,membranaceous,membranous,minutely,mm,oblique,obtuse,orangish,ovoid-rhomboid,papillose,pedicel,peduncle,petiole,pubescence,pubescent,purplish,rounded,sand-punctate,slender,slightly,sparsely,stellate,stem,stigma,style,surface,tan,terrestrial,thickened,tip,tube,vine,white,x	.5,.5–1.8,0.1,0.1–0.2,0.3–1.5,0.4–2,0.5–2,0.5–2.5,0.6–1,0.6–2.4,0.8–4,0.8–4.5,1.5–2,1.5–3,1.5–6,1–2,1–3,2.5–9,2–10,<,accrescent,adaxial,along,alyx,apar,apical,appearance,axe,basal,berry,c.,capitat,ciliat,ciliate,color,cuneate,dense,distal,eaf,eed,elliptical,especially,falcate,fallen,filament,fruiting,giving,glabrou,groov,groove,ground,lanceolate,lateral,leaflet,like,log,lon,long,m.,midvein,nflorescence,nternode,obovate,occasionally,orolla,pair,petiolulate,petiolule,plurifoliat,present,proximal,rachi,rhomboid,ruit,scattered,sessile,short,shortly,side,smaller,spaced,strongly,tamen,tem,thick,thinner,trailing,trichome,unbranched,unit,upper,vary,vein,wide,wide-diameter,widely,ympodial	adhesion,arrangement,capitate,climate,colour,corolla,form,glandular,growth,height,history,inflorescence,leaf,length,life,midpoint,na,number,ovary,plant,position,presence,ray,reproduction,rugulose,seed,shape,size,staman,stipe,texture
604	wfo-0001030311	success	203	115	80	123	35	0.394	.2,0.5-0.8,0.5-1,0.8-1.2,1-1.2,1-1.5,1-2.5,1-3,1.2-7,1.5-5.5,1.5-8,1.8-2,15-22,2-2.5,2-6,2.2-2.5,2.2-3,3-5,3-7,5-10,5-pinnate,abaxially,acuminate,acute,adaxially,anther,apex,basally,base,blade,brown,chartaceous,cm,cordate,deltoid,densely,diameter,entire,flattened,flower,fruit,glabrous,granular,green,hair,half,herb,lenticular,lobe,lower,margin,membranaceous,minutely,mm,oblique,oblong,obtuse,orangish,ovoid-rhomboid,papillose,pedicel,peduncle,petiole,pubescent,purplish,rounded,slightly,sparsely,stellate,stem,stigma,style,surface,tan,thickened,tip,tube,white,x,yellow	.5,.5-1.8,0-2.5,0.1,0.4-2,0.5-2,0.6-1,0.6-2.4,0.8-4,0.8-4.5,1.5-2,1.5-3,1.5-6,2-10,2224,5-merou,8031,<,[,],absen,absent,accrescent,adaxial,ag,aggregate,along,alyx,apart,apical,apparently,appearance,articulated,axe,ba,basal,capitat,cell,ciliat,ciliate,clavate,color,connivent,cuneate,dense,dig,directed,distal,distally,eaf,eed,elliptical,equal,especially,falcate,fallen,filament,formation,g,geminat,gh,giving,groov,groove,ground,interjected,large,lateral,leaflet,like,log,lon,long,longitudinal,m.,midvein,nflorescence,node,obovate,occasionally,opening,orolla,pair,perfect,petiolulate,petiolule,pittier,plurifoliate,pore,present,proximal,rachi,rhomboid,rooting,ruit,scattered,sessile,short,shortly,side,simple,sinple,slender,slit,smaller,spaced,stone,strongly,tamayo,tamen,tem,thick,thinner,trailing,unbranched,uniseriate,unit,upper,vary,vein,wide,widely,ympodial	adhesion,arrangement,calyx,capitate,climate,colour,corolla,form,glandular,growth,height,hermaphroditic,history,inflorescence,leaf,length,life,midpoint,na,number,ovary,perennial,plant,position,presence,pubescence,ray,reproduction,rugulose,seed,shape,size,staman,stipe,texture
605	wfo-0001030335	success	153	121	84	69	37	0.549	.1,.25,.5,0-5,0.05-0.2,0.5-1,0.7-1,1-1.5,1-2,1.1-1.4,1.1.5,2-2.5,2-4.5,2-5,2.5-3,3/4,5-6,7-13,acuminate,acute,along,anther,apex,base,beneath,bi-lobed,calyx,cm,conical,corolla,dark,decurrent,deltoid,densely,dia,dry,elliptic,erect,glabrous,globose,green,greyish-red,leaf,like,lobe,lobed,long,material,minute,minutely,mm,narrowly,onto,opposite,ovary,ovoid-reniform,pale,papillose,pedicel,petiole,pitted,pore,poricidal,puberulent,pubescent,ripe,shaped,shrub,sparsely,stem,stigma,style,surface,tan,tear-drop,tip,trichome,tube,uniseriate,vein,way,white,x,yellowish-green	.75,0.1-0.5,0.25-0.5,1-3-flowered,2-2.2,5-7,anthesi,aspec,ba,bark,berry,branch,bud,deciduous,deflexed,eaf,edicel,eed,except,expanded,exserted,filament,filiform,flattened,free,fruiting,geminate,gently,giving,horizontally,lamina,lateral,lenticellate,lightly,lon,lower,main,middle,nflorescence,obovoid,occasionally,often,older,pair,papillo,portion,prominent,puberulen,raised,reflexed,ruit,simple,slightly,soon,spreading,straight,strongly,tall,tapering,ud,underside,unifoliat,unit,widest,winged,woody,yellow,ympodial,young	adhesion,arrangement,blade,climate,colour,diameter,form,fruit,glandular,growth,hair,height,history,inflorescence,length,life,margin,midpoint,na,number,peduncle,perennial,plant,position,presence,pubescence,ray,reproduction,rugulose,seed,shape,size,staman,stellate,stipe,texture,unifoliate
606	wfo-0001030336	success	266	118	95	171	23	0.357	-10,-19,.5,0.5,0.5-0.7,1,1-1.5,1-3,1.0-1.4,1.6-7,1.7-2.3,1.8-3.0,2/3,3-5,4-10,4-celled,almost,anther,apex,basal,bifurcate,bright,brown,calyx,capitate,cm,completely,conical,corolla,dark,densely,diameter,elliptic,entire,flushed,fruit,glandular,globose,grayish,green,greenish,head,herb,imparipinnate,inflorescence,interrupted,lanceolate,leaf,lobe,long,margin,minute,minutely,mixed,mm,obovate,occasionally,once-branched,orbicular,ovary,pale,pedicel,peduncle,perennial,petiole,puberulent,pubescent,purple,rotate,scattered,shorter,shrub,simple,slightly,small,soft,sparse,stellate,stem,stigma,style,surface,ten,thick,tip,trichome,tube,uniformly,uniseriate,united,velvety,weak-walled,white,wide,yellow	-1.5,-2,0-,0.1-0.3,0.1-0.5,0.1-0.7,0.1-1,0.15-0.2,0.15-0.9,0.2,0.2-0.25,0.2-0.8,0.2-1,0.2-1.5,0.3-0.4,0.3-1.1,0.5-1,0.5-1.5,0.6-0.8,0.6-1.5,0.8-0.9,0.8-1.2,0.8-1.3,0.8-3,1-1.4,1-celled,1.5-,1.5-2,1.5-3.5,1.5-5,1/4-1/3,10,2-4,2-9,2-foliate,2-locular,4,4-,6,8-16,8-20,8-celled,absent,acute,adpressed,amongst,anthesi,apical,appearance,appearing,appendage,articulated,articulation,base,basiscopically,bent,berry,bluntly,bract,bracteate,branch,cell,clavat,coat,column,cordate,crenate,curved,darker,decurrent,deeply,developed,diamete,distal,divided,eaf,edicel,eed,eglandular,elongate,entir,erect,essentially,exserted,extremely,filament,first,flower,fruiting,giving,glandula,hair-like,half,halfway,interjected,internode,investing,large,larger,largest,lateral,leaflet,leave,less,like,lobed,lon,longer,loosely,lower,markedly,maturity,mere,middl,midvein,mostly,narrowing,narrowly,nflorescence,node,oblique,often,outgrowth,pair,papillate,part,petiolule,population,present,primary,proximal,pseudostipule,rachi,range,reflexed,rest,rounded,ruit,secondary,sessile,shaggy,silky,sinus,sometimes,southern,spreadin,spreading,staminal,sterile,straight,stripe,strongly,surrounding,tall,tem,terminal,tertiary,testa,truncate,two,ud,unicellular,unit,upper,usually,wall,way,winged,woody,ympodial,young	1.5-10,4-16,adhesion,arrangement,clavate,colour,form,growth,height,history,length,life,na,plant,position,pubescence,reproduction,rugulose,seed,shape,size,staman,texture
607	wfo-0001030342	success	155	113	79	76	34	0.51	.2,.5,0.1–0.2,0.3–1.2,0.5–1,0.8–1.5,1.5,1.5–13,1.5–5,1.5–7.5,10–25,1–1.5,1–2.5,1–7,2–2.5,2–4,3-pinnate,3–12,4–5,abaxially,acuminate,acute,adaxially,anther,apex,base,blade,brown,calyx,chartaceous,cm,cordate,cuneate,deltoid,dense,diameter,entire,extra-axillary,fruit,glabrous,greenish,herbaceous,leaf,lenticular,light,lobe,long,margin,membranous,mm,mottled,oblique,obtuse,often,ovoid-rhomboid,pedicel,peduncle,petiole,pubescent,rarely,sand-punctate,scattered,slender,smooth,stellate,stem,stigma,style,surface,trichome,truncate,tube,undulate,vine,white,wide-diameter,widely,x,yellowish	0.5–3,0.5–5,0.8–4,1-5,1-6.5,1.2–3,1.5–2,1–1.2,1–3,1–5.5,1–6,2–,3,4–8,5-merous,6–7,abundant,accrescent,along,alyx,apar,apical,apiculate,axe,berry,broadly,c.,capitat,ciliat,cylindrical,eaf,eed,elliptical,filament,flattened,flower,fruiting,glabrou,lanceolate,lateral,leaflet,like,lon,lower,m.,minutely,nflorescence,nternode,orolla,perfec,petiolule,plurifoliat,pointed,proximal,pubescen,rachi,revolute,rhomboid,rounded,ruit,side,slightly,spaced,sparsely,tamen,tem,terrestria,tip,truncate-acuminat,unbranched,unit,vary,vein,wide,ympodial,–7	adhesion,arrangement,capitate,climate,colour,corolla,form,glandular,growth,hair,height,history,inflorescence,length,life,midpoint,na,number,ovary,plant,position,presence,pubescence,ray,reproduction,rugulose,seed,shape,size,sparingly,staman,stipe,terrestrial,texture
608	wfo-0001030342	success	153	109	76	77	33	0.497	.2,.5,0.5-1,1-1.5,1-7,1.5-13,1.5-5,1.5-7.5,10-25,2-2.5,2-3,3-12,3-pinnate,4-5,abaxially,acuminate,acute,adaxially,anther,apex,apiculate,basally,base,blade,brown,calyx,chartaceous,cm,cordate,cuneate,deltoid,diameter,entire,extra-axillary,flower,fruit,glabrous,hair,herb,leaf,lenticular,light,lobe,margin,membraceous,minutely,mm,oblique,oblong,obtuse,pedicel,peduncle,petiole,pubescent,rarely,revolute,sagittate,scattered,simple,smooth,stellate,stigma,style,surface,terrestrial,tip,trailing,truncate,tube,unbranched,undulate,uniseriate,white,widely,x,yellow	-7,0.5-3,0.5-5,0.8-4,1-1.2,1-3,1-5,1-5.5,1-6,1-6.5,1.2-3,1.5-2,2-,3,4-8,5-merou,6-7,absent,abundant,accrescent,ag,along,alyx,apart,apical,apparently,articulated,axe,ba,broadly,capitat,ciliat,connivent,cylindrical,directed,distally,eaf,eed,elliptical,equal,filament,fruiting,geminat,interjected,lanceolate,lateral,leaflet,long,longitudinal,lower,nflorescence,node,opening,orolla,perfect,petiolule,plurifoliate,pore,proximal,pubescen,rachi,rhomboid,rooting,rounded,side,slender,slightly,slit,spaced,tamen,tem,truncate-acuminat,unit,vary,vein,wide,ympodial	adhesion,arrangement,capitate,climate,colour,corolla,form,glandular,growth,height,history,inflorescence,length,life,midpoint,na,number,ovary,perennial,plant,position,presence,pubescence,ray,reproduction,rugulose,seed,shape,size,staman,stem,stipe,texture
609	wfo-0001030353	success	227	120	92	135	28	0.405	-5,.7,0-6,0.1-0.2,0.15-0.3,0.5-0.9,1-3,1-6,1.8-2.2,1.8-3,1/2-2/3,1/3,1/5,11-16,2.5-4,3-4,3-5.5,3.5-4,4-4.5,5,6-8,7-10,abaxially,acute,andromonoecious,anther,apex,apically,base,berry,blade,brown,calyx,chartaceous,cm,connivent,cuneate,densely,diameter,ellipsoid,elliptic,equal,evenly,flattened-reniform,fruit,glabrescent,green,lateral,leaf,length,lobe,lobed,long,lower,margin,maturity,mauve,midpoint,mm,moderately,narrow-deltate,orange-brown,pedicel,peduncle,petiole,plant,poricidal,ray,shape,shrub,simple,small,smooth,sometimes,stellate,stellate-pubescent,stem,stout,style,subentire,tapering,terminal,tip,tree,tube,upper,warty,way,weakly,wide,yellow,young	-0.2,-1.5,-1/2,-2,-3,-6,-merous,.1,.2,.5,0,0-15,0-2,0.1-0.3,0.5,0.8,0.8-1.2,1,1-2,1-7,1.2-1.8,1/,1/6,1/6-1/4,10-15,2-10,2-7,2.8-3.7,20-200,4-,4-5,5-6,6,6-15,8-15,abaxial,adaxial,almost,alyx,apar,apart,apiculat,apparently,articulated,bark,broad-deltate,c.,conical,curved,deltate,development,discolorous,distal,distance,drying,eaf,eed,elongating,erect,extending,filament,flattened,flower,free,fruiting,glabrous,half,hermaphrodite,heterostylous,infructescence,less,long-styled,longer,lowermost,mature,midvein,multangulate,nflorescence,older,one,open,orolla,oung,pair,patch,pendulous,per,pericarp,plurifoliat,pointed,porrect,portion,prickle,prickly,primary,red-brown,reddish-green,reflexed,retaining,rounded,ruit,scar,sessile,short-styled,shorter,side,somewhat,spaced,sparsely,spreading,stalk,stalked,staminat,straight,strongly,surface,tamen,terete,tertiary,throughout,time,trichome,unarme,unarmed,unbranched,unit,vary,vein,venation,visible,whit,white-gray,wo,woody,ympodial	adhesion,apiculate,arrangement,climate,colour,corolla,form,glandular,growth,hair,height,history,inflorescence,life,na,number,ovary,perennial,position,presence,present,pubescence,reproduction,seed,size,staman,stipe,texture
610	wfo-0001030407	success	182	113	87	95	26	0.478	.2,.5,1-2,12-14,2-2.5,2-5,3-6.5,3-9,3.5-9.5,30-60,4-5,5,6.5-18.5,7-8,abaxially,acuminate,adaxially,anther,articulated,axillary,berry,brownish,bud,cell,chartaceous,ciliate,cm,condition,conical,corolla,covering,densely,diameter,drying,elliptic-lanceolate,exceeding,fresh,fruit,glabrous,green,green-white,greenish,hair,hair-like,herb,lanceolate,lateral,leaf,light,like,lobe,long,make,margin,middle,minute,mm,mottled,mucilaginous,odd-pinnate,ovate,ovoid,pedicel,peduncle,pentagonal,plant,proximal,pubescent,purple,ripe,seed,size,stamen,stigma,style,subtending,terminal,testal,thick,throughout,tube,wall,wet,whitish,wide,x,yellow	0.7-3.2,1-10,1-3,1-4,1.5-5,12-15,2-6.7,2-7,3-10.5,3-4,5-merou,6-7,absent,acumen,ag,alyx,apart,apex,apparently,axe,base,blade,capitat,connivent,decreasing,digestion,distal,dorsally,eaf,edge,eed,end,enzyme,especially,filament,flat,flower,folded,forked,geminat,generally,glabrou,gradually,half,homostylous,honeycomb-shaped,interjected,larger,leaflet,lengthening,living,lower,nflorescence,obtuse,one,orolla,pair,perfect,petiole,petiolule,placed,plurifoliate,pore,poricidal,pubescen,ray,removed,round,ruit,secondary,semierec,seudostipule,slit,spaced,specimen,ste,stolo,subequal,subsessile,symmetrical,tall,tamen,tem,thir,tip,toward,tri-,tuber,typically,unit,unwinged,usually,vary,white,ympodial	adhesion,arrangement,calyx,capitate,colour,form,growth,height,history,inflorescence,length,life,na,ovary,perennial,position,pseudostipule,pubescence,reproduction,rugulose,shape,staman,stem,surface,texture,third
611	wfo-0001030417	success	242	131	103	139	28	0.426	-5,.5,0.05-0.1,0.25-0.5,0.5-0.7,0.5-0.8,0.7-1,1-1.3,1-2.3,1.2-3,1.5-8,1/3,2-3,4-12,4-25,8-11,abaxially,abundant,acuminate,acute,along,annual,anther,apex,basal,base,basiscopically,biennial,bright,broadly,brown,calyx,capitate,cm,conical,cordate,corolla,densely,dentate,diameter,elliptic,entire,extended,fruit,glabrous,glandular,globose,green,head,herb,imparipinnate,inflorescence,interrupted,lanceolate,leaf,length,like,lobe,long,margin,mm,multicellular,narrowly,oblique,obovate,occasionally,ovary,ovate,pale,pedicel,peduncle,perennial,petiole,proximal,pubescence,pubescent,rarely,red,ripe,round-crenate,rounded,short,size,slightly,somewhat,sparsely,stellate,stem,stigma,style,surface,thick,third,trichome,truncate,tube,uniseriate,vein,velvety,white,wide,winged,yellow	0.1-0.25,0.2,0.2-0.4,0.2-0.7,0.25-0.4,0.3-0.4,0.5-1,0.5-1.2,0.5-2,0.8,1,1-1.2,1-1.5,1-2,1-2-celled,1-3.5,1-4,1.5-2,1.5-3.5,1.5-5,2-4,2-8,2-locular,2.5-5,2/3,3,3-foliate,3/4,7-30,absen,absent,also,anthesi,apical,appearance,appendage,articulation,bent,branch,cell,cente,column,common,crenate,decreasing,decurrent,distal,eaf,ebracteate,edicel,eed,eglandular,elongate,erect,exserted,extending,extremely,filament,flower,free,fruiting,generally,giving,gree,hair-like,hal,hybrid,included,initially,interjected,internode,larger,largest,later,lateral,leaflet,lon,lower,maturation,mature,minute,minutely,mixture,nflorescence,northern,often,once-branched,outgrowth,pair,parallel,part,patent,pedice,peruvian,petiolule,point,population,portion,primary,procumbent,pseudostipule,putatively,rachi,range,reflexed,rest,robust,ruit,scattered,secondary,sessile,several,shaggy,silky,simple,sometimes,species,staminal,sterile,straight,strongly,tem,terminal,tertiary,testa,theseadpressed,thin,tip,toward,type,ud,unicellular,unit,usually,variable,viny,wall,way,ympodial	0.5,0.8-5,adhesion,arrangement,blade,climate,colour,form,growth,hair,height,history,life,midpoint,na,number,plant,position,presence,present,ray,reproduction,rugulose,seed,shape,staman,stipe,texture
612	wfo-0001030420	success	170	123	89	81	34	0.524	-2,-30,-pubescent,0.5-,0.5-1,0.5-4,0.5-8,1,1-1.5,1-2,1-3,1-4,1-7.5,1.5-3,1.5-5,10-,15-25,2-,2-14.5,2-3,2-9,3-lobed,4-7,5-,6-7,abaxially,acuminate,acute,adaxially,also,apex,basal,base,blade,calyx,chartaceous,cm,connivent,cordate,deltate,densely,diameter,eglandular,ellipsoidal,elongated,entire,fruit,glabrate,glabrous,glandular-,glandular-puberulent,hair,lanceolate,leaf,lobe,lobed,long,margin,mm,moderately,often,pedicel,peduncle,petiole,pilose,pinnately,puberulent,puberulent-pubescent,pubescent,pubescent-pilose,purple,ripe,shrub,simple,small,sparsely,stellate,stigma,style,subcoriaceous,tip,tree,truncate,tube,unknown,unlobed,vein,x,yellow	-20,-35,-4,-9,1-,1-6,1/2,10-25,2-5,2-6,3-7,4-foliat,5-15,5-6,7-19,7-22,7/8,absent,aggregate,apart,ape,articulated,axe,beyond,cell,color,connective,cylindrical,dark,directed,distally,divided,eaf,eed,eglandular-pilo,eglandular-puberulent,elliptic-ovate,equal,exserted,flower,forked,leaving,lon,lower,midrib,narrowly,nearly,nflorescence,nther,obtuse,orolla,ovate,pedicellar,perfect,pore,presen,pubescent-pilo,rachi,radiu,rarely,remnant,ruit,shorter,sinus,spaced,stamen,stone,tal,tem,thecae,time,tomento,triangular,truncat,ud,unbranched,unit,vary,wide,yello,ympodial	adhesion,anther,arrangement,climate,colour,corolla,eglandular-pilose,form,glandular,growth,height,history,inflorescence,length,life,midpoint,na,number,ovary,plant,position,presence,pubescence,ray,reproduction,rugulose,seed,shape,size,staman,stem,stipe,surface,texture
613	wfo-0001030426	success	158	72	53	105	19	0.335	-30,0.3-7,0.3-8,0.4-0.7,1-4.2,1.5-3,1.7-3.2,15-25,2,2-3,2.5-4,2.5-6,3-6,4-10,4-6.5,6-11.5,6-8,calyx,cm,connate,corolla,diameter,distal,forked,generally,glandular,globose,green,green-white,half,heart-shaped,herbaceous,lateral,leaf,leaflet,long,mm,odd-pinnate,ovoid,pedicel,peduncle,perennial,petiole,pilose,plant,seed,size,stellate,terminal,throughout,white,wide,yellow	1-4,1.5-6.5,10,3-12,3-4,3-6-foliat,9,abaxially,absen,acumen,acute,adaxially,apex,apical,apically,apiculate,articulate,base,branched,caudate,cell,covering,cyme,decurrent,dehiscent,dichasial,dichasially,digestion,diminishing,dorsally,eaf,ebracteate,edge,eed,elliptic-lanceolate,emoval,enzyme,exceeding,filament,flat,flower,folded,globo,gradually,hair-like,honeycomb,interjected,introrse,lanceolate,larger,linear,linear-lanceolate,linear-oblong,living,lobe,lon,lower,make,maturing,monochasial,mucilaginous,nflorescence,nther,oblique,oblong,obtuse,often,orolla,pair,pattern,perfect,pinnatifi,plan,poricidally,proximal,rachi,reveal,rounded,ruit,second,sessile,seudostipule,short,slit,specimen,spot,stamen,stigma,straight,stripe,style,tal,tem,testal,thick,toward,tuber-bearing,typically,unit,vary,wall,whit,without,ympodial,¼	anther,arrangement,colour,form,fruit,growth,height,history,inflorescence,length,life,na,ovary,pinnatifid,position,reproduction,shape,stem,texture
614	wfo-0001030430	success	171	120	75	96	45	0.439	.2,0.5,0.6,abaxially,acute,anther,anthesi,apex,appressed,axillary,base,blade,blue,brittle,brown,bud,calyx,capitate,clavate,cm,densely,diameter,elliptic,equal,erect,especially,flattened,fleshy,fruit,glabrous,globose,green,hair,indumentum,leaf,lobe,lobed,long,margin,mm,moderately,multicellular,oblong,occasionally,ovate,pair,pale,pedicel,peduncle,pentagonal,perennial,petiole,pitted,pubescent,purple,regularly,rounded,shallowly,shoot,shrub,simple,stigma,style,subglabrous,surface,terminal,toward,tube,unifoliate,uniseriate,violet,white,woody,x,yellow	.5,0.25,0.3,0.4,0.5–12,0.6–0.8,0.6–1.0,0.8–3.0,0.8–5.6,0.9–1.0,0–20,1.0–1.2,1.0–1.5,1.0–2.0,1.2–2.0,1.3–8.0,1.4–1.5,1.5–1.7,1.6–1.8,1.8–5.0,12–20,12–30,1–3,1–9,2.0–3.0,2.0–4.2,2–3,3.0–4.5,30–200,3–17,3–24,3–4,3–5,3–8,5,5.5–12,5–10,5–6,6–10,abundant,adaxiall,adaxially,ag,apart,apical,articulated,axe,ba,basal,borne,branched,cell,chartaceous,connivent,convex,cylindrical,decurrent,dentate,diamete,eaf,eed,few-seeded,filament,flower,geminat,lon,longitudinal,lower,m.,nflorescence,opening,orolla,perfect,pore,poricidal,present,ruit,serrate,shaped,side,slit,spaced,stone,straight,tal,tamen,tear-drop,tem,time,tip,unit,vary,wide,ympodial,–2.7,–40	0-20,0.5-12,0.6-1.0,0.8-3.0,0.8-5.6,1.0-1.5,1.3-8.0,1.4-1.5,1.5-1.7,1.6-1.8,12-20,2.0-3.0,2.0-4.2,3-17,3-4,3-5,3-8,3.0-4.5,30-200,5-10,5-6,adhesion,arrangement,colour,corolla,decurren,form,growth,height,history,inflorescence,length,life,na,ovary,plant,position,pubescence,rugulose,seed,shape,size,staman,stem,texture
615	wfo-0001030441	success	178	104	76	102	28	0.427	.5,0.5,0.5-1,0.5-3,1,1-1.4,2,2-10,2-5.5,2.5,3-4,4-5,5-14,5-7.5,6-11,anther,apex,base,bright,c.,calyx,capitate,cell,cm,corolla,deltate,diameter,ellipsoid,elliptic,flattened,glabrous,glandular,globose,green,growth,hair,juicy,lateral,lobe,lobed,long,margin,membranous,minutely,mm,narrowly,pale,papillose,pedicel,peduncle,petiole,plant,pubescent,red,reniform,shrub,simple,spot,stellate,stem,stigma,style,surface,terminal,tip,triangular,trichome,tube,vine,violet,wall,way,white,wide,woody,yellow	+,0.5-0.75,1-1.5,1-2-celled,1.2-1.4,1.5-2,10-40,2-3,30,5-6,5-7,5-merou,<,>,acuminate,acute,ag,along,alyx,anthesi,apart,ark,articulated,attenuate,berry,branched,brow,closely,decurrent,distall,eaf,eed,entire,exerted,eye,filament,flexuous,flower,free,fruiting,glabrou,glandula,ilament,impressed,irregularly,leaving,lengthening,lon,lower,making,many,markedly,midvein,new,nflorescence,occasionally,older,onto,open,orolla,otherwise,pair,papillat,peg,per,perfect,pericarp,plurifoliat,pore,poricidal,portion,primary,reflexed,ridged,ripe,ruit,scandent,scar,shiny,short,shrubby,slightly,slit,small,somewhat,spaced,spreadin,spreading,strongly,tem,thin,time,trailing,ud,undulate,uniseriate,unit,upper,usually,vary,vein,ympodial	adhesion,arrangement,brown,colour,form,fruit,height,hermaphroditic,history,inflorescence,leaf,length,life,na,number,ovary,perennial,position,presence,pubescence,ray,reproduction,rugulose,seed,shape,size,staman,texture
616	wfo-0001030444	success	196	96	70	126	26	0.357	0.15-0.8,0.8-2,1-10,1-2,1-4,1.2-1.8,11-45,2-8,2.4-3.8,3-10,4-7,6.1-12.8,7.1-17.5,9.4-20.1,acuminate,acute,anther,apex,attenuate,base,blue,brownish,ciliate,clavate,cm,condition,coriaceous,corolla,dark,deep,diameter,drying,elliptic,fresh,fruit,glabrous,green,greenish,herb,lanceolate,leaf,light,lilac,lobe,long,margin,medium,mm,odd-pinnate,ovate,ovoid,pedicel,peduncle,pentagonal,petiole,petiolulate,plant,purple,rotate,rounded,seed,size,stigma,style,terminal,tube,whitish,wide,x,yellow	0-24,1,1-5,1.1-2.7,2-3,2-6,2.3-3.6,3-5,3.7-6.8,4-17,4-39,5-merou,5.3-9,abaxiall,abaxially,acumen,adaxially,ag,along,alyx,apart,apparently,arranged,articulated,asymmetric,axe,axillary,basiscopic,bead,berry,blade,bud,capitat,cell,connivent,covering,decreasing,digestion,distal,dorsally,dot,eaf,edge,eed,enzyme,erec,exceeding,filament,flat,flower,folded,forked,geminat,general,generally,glabrou,green-white,hair-like,hal,half,high,homostylous,honeycomb-shaped,interjected,larger,lateral,leaflet,lengthening,like,linear,living,lower,make,moniliform,mucilaginous,multiple,narrow,necklace,nflorescence,orbicular,orolla,pair,perfect,plurifoliate,pore,poricidal,removed,ripe,rough,ruit,sessile,seudostipule,shortly,side,slit,sometimes,spaced,specimen,stamen,stolon,straight,subequal,subtending,symmetric,tall,tamen,tem,testal,thick,throughout,tip,tissue,touch,toward,tri-,tuber,typically,unit,unwinged,usually,vary,wall,wet,white,wing,ympodial	abaxial,adaxial,adhesion,arrangement,calyx,capitate,colour,form,growth,height,history,inflorescence,length,life,na,ovary,perennial,position,pubescence,reproduction,rugulose,shape,staman,stem,surface,texture
617	wfo-0001030445	success	226	128	99	127	29	0.438	0.2-0.4,0.2-0.5,0.6-2.2,0.7,1-1.3,1-7,1.1-4.3,1.3,1.5-2.1,1.6-2,1.7-2.4,14,15-35,2.2-2.9,2.2-3.5,2.4-4.7,3.5-4.2,4.1-8.7,4.2-10,5.9-15,6.1-9.1,7.5-16,8.2-18,abaxially,acute,adaxially,anther,around,base,black,blunt-tipped,brown,brownish-yellow,bud,bulbous-based,calyx,capitate,cm,corolla,deltoid-reniform,diameter,drying,elliptic,elliptical,elongated,ferruginous-granular,ferruginous-tomentose,flower,fruit,glabrate,glabrous,globose,green,greyish-tan,hair,inserted,leaf,lobe,long,mm,mostly,oblong,oblong-lanceolate,orange,orangish-tan,pedicel,peduncle,petiole,porrect-stellate,pseudoterminal,pubescence,pubescent,ray,relatively,reniform,reticulate-punctate,semi-spherical,sessile,shrub,simple,small,sparse,stellate,stem,stigma,style,subcampanulate,surface,thick-textured,thin,thin-,tomentose,tree,tube,white,x,yellow,yellowish,yellowish-tan	.1,.5,/5-2/3,0.1-0.7,0.2,0.2-0.7,0.3,0.4,0.5,0.6-3.5,0.8,1,1.3-1.8,1.3-2,1.8-3.5,10-14,10-16,2.1-5.2,3-5.4,3.1-5,3.4-5.6,5-125,5-merou,5.2-7.1,5.9-8.3,8.1-10,abaxial,accrescent,acuminate,ag,along,alyx,apart,apex,appressed,articulated,axillary,bark,berry,blade,blunt-tippe,branch,branched,concentrated,cylindrical,decurrent,directed,distally,eaf,earl,edge,eed,entire,erect,exserted,ferruginous,filament,free,fruiting,geminate,glabrescen,high,homostylous,intermediate,lackin,lateral,lengthening,lobed,lon,longitudinal,lower,m.,main,many,margin,midrib,midvein,multangulat,multangulate,nflorescence,obovate,obscured,obtuse,older,open,orbicular,orolla,ovate,ovate-lanceolate,plurifoliate,pore,poricidal,porrect-stellat,rachi,resorption,rounded,ruit,runk,side,slightly,slit,somewhat,soon,spaced,sparsely,splitting,stalk,stamen,stout,sulcate,suture,tamen,thick,thicknes,time,tip,tissue,tomentum,unarme,unit,vary,vein,vestigial-rayed,way,wide,ympodial,young	adhesion,arrangement,climate,colour,form,glabrescent,growth,height,history,inflorescence,length,life,midpoint,na,number,ovary,perennial,plant,position,presence,present,reproduction,rugulose,seed,shape,size,staman,stipe,texture
618	wfo-0001030447	success	276	120	93	183	27	0.337	.3,.5,0.2,0.2-0.4,0.5-0.65,0.5-10,0.7-1,0.8-3.5,1-1.5,1-2,1.8-2.5,1/3-2/3,2-4,2.2-2.8,2.5-6.5,3-4.5,3-5,6-10,6-8,6.5-9,7-8,abaxially,acute,anther,apex,apically,base,berry,blade,calyx,chartaceous,clavate,cm,corolla,cuneate,cupular,deltate,densely,diameter,drying,filiform,flattened-reniform,fruit,glabrous,globose,lateral,leaf,length,lobe,lobed,lower,margin,maturity,midvein,mm,moderately,obconical,oblong,orange,orange-brown,orange-red,ovate,pale,pedicel,peduncle,petiole,purple,ray,red-brown,rounded,shallowly,shiny,shrub,simple,slender,smooth,sometimes,sparsely,stellate,stellate-pubescent,stem,stigma,stout,straw-yellow,style,surface,tapering,thin,tube,white,x,yellow,×	.2,/5,0,0.1,0.1-0.3,0.15-0.3,0.4-0.7,0.4-0.9,0.5,0.5-3,0.8-1.7,1,1-10,1-2.5,1-3,1-5,1-6,1.5,1.5-2.5,1.5-7,1/3,1/3-1/2,1/4-1/3,2.5-10,3,30-45°,4-8,5,5-15,5-merou,6,6-16,6-7,6-9,8,accrescent,adaxially,age,always,alyx,apar,apart,apical,apparently,armed,articulated,axe,bark,beyond,branche,broad-deltate,c.,cell,characteristically,covering,curved,dark,development,difoliate,discolorous,distance,divided,eaf,eed,elongating,equal,erect,exserted,extending,filament,fine,finely,finger-hair,flat,flattened,flower,free,fruiting,geminat,gently,glabrescent,herbaceous,infructescence,irregula,irregular,lengthening,less,long,long-ovoi,long-styled,longer,longitudinal,mature,midpoint,minute,mostly,narrow-deltate,nflorescence,oblique,obtuse,often,older,one,open,opening,orange-translucent,orolla,oung,outline,pair,papillo,pendulous,per,perfect,pericarp,persisting,pit,point,pore,poricidal,porrect,portion,prickle,primary,pronounced,prostrate,pubescent,rachi,raised,reduced,rest,ri,ridge,ridged,ruit,scar,sessile,shallow,short-styled,shorter,shortly,side,sinus,slit,small,somewhat,spaced,sparse,spherical,spreading,stalk,stalked,straight,stump,subsessile,tamen,terete,terminal,tertiary,thick,throughout,time,tip,toward,translucent,trichome,ud,unarmed,unbranched,unequal,unit,usually,variously,vary,vein,venation,visible,weakly,wide,widest,woody,yellow-orange,ympodial	adhesion,arrangement,colour,form,growth,height,history,inflorescence,life,na,number,ovary,papillose,perennial,plant,position,presence,present,pubescence,reproduction,rugulose,seed,shape,size,staman,stipe,texture
619	wfo-0001030452	success	199	113	82	117	31	0.412	0.2–0.3,0.4,1.5–3,10–15,1–4,2.5–3,20–30,2–2.5,3.7–5.2,4,5,5–6,80,abaxially,acuminate,acute,anther,apex,attenuate,base,black,blade,broadly,calyx,cm,collected,cordate,diameter,drying,dull,flower,free,fruit,glabrous,glandular-puberulent,globose,hair,immature,leaf,less,lobe,long,margin,mature,minutely,mm,narrowly,nearly,opposite,orbicular,ovate,pedicel,petiole,pilose,pubescence,ray,reddish,shape,shrub,similar,simple,sinuate,size,slightly,smooth,somewhat,stellate,stem,stigma,style,subopposite,surface,thin-textured,tip,triangular,truncate,tube,white,x,yellow,yellowish,–9	.5–4.5,.6,0.1–0.4,0.6,0.7,0.8,1.2,1.2–1.6,100,1–1.3,1–2,1–3-celled,2,2.5–4,2.5–6,2–4,2–5.5,2–foliate,3,4–5-rayed,5–7,6–12,8–11,911,absent,accrescent,adaxially,also,apparently,appressed,axe,broad,canthophora,capitat,central,contiguou,counted,curved,cylindrical,deflexed,dense,developing,directed,distall,eaf,eed,eglandular,enlarged,enlarging,f,filament,flattened,fruiting,fully,geminat,glabrou,gland-tipped,gland–tipped,gradually,half,herter,hig,hyaline,imple,initially,internode,larger,lon,longer,lower,major,matur,maturity,moderately,nflorescence,numerous,often,one,orolla,per,pore,prickle,probably,proximal,pubescent,rachi,reflexed,ruit,sec,sessile,short,small,sof,sometimes,sparse,sprawling,spreading,ste,stellae,straight,strongly,sulcate,tamen,tem,terete,thin–textured,toward,ultimately,uniform,unit,usual,various,vary,vein,wide,wing,ympodial	2.5–4.5,adhesion,arrangement,capitate,climate,colour,corolla,form,glandular,growth,height,history,inflorescence,length,life,midpoint,na,number,ovary,peduncle,perennial,plant,position,presence,present,reproduction,rugulose,seed,staman,stipe,texture
620	wfo-0001030453	success	127	100	63	64	37	0.496	.5,/4,0.25-0.5,0.8-1.5,1-1.3,1-1.5,1.5-1.6,1.5-2.5,3-3.5,4-5,9-14,abaxially,acuminate,acute,adaxially,anther,apex,arachnoid,arachnoid-pubescent,attenuate,base,broadly,calyx,clavate,cm,corolla,cup-shaped,dark,deltate,divided,elliptic,flat,glabrous,leaf,lobe,long,margin,mm,narrowly,nearly,occasionally,opposite,ovary,pedicel,petiole,pore,poricidal,pubescent,shaped,shiny,shrub,sparsely,stem,stigma,style,surface,tear-drop,tip,trichome,tube,way,white,wide	.25,9-12,along,anthesi,axi,bark,closely,deflexed,delicate,dendritic,densely,dia,eaf,edicel,eed,ellipsoid,especially,exserted,filament,fine,floccose,free,glabrate,know,known,later,lateral,less,lon,lower,main,middle,midrib,minute,minutely,near,nflorescence,older,overlappin,pair,papillat,papillose,planar,portion,reddish,reddish-brow,rounded,ruit,scar,simple,slender,soon,spaced,straight,strongly,tall,tub,ud,unifoliat,unit,vein,widest,ympodial,young	adhesion,arrangement,blade,climate,colour,diameter,form,fruit,glandular,growth,hair,height,history,inflorescence,length,life,midpoint,na,number,peduncle,perennial,plant,position,presence,pubescence,ray,reddish-brown,reproduction,rugulose,seed,shape,size,staman,stellate,stipe,texture,unifoliate
621	wfo-0001030486	success	141	93	65	76	28	0.461	1-1.5,1-5,1.1-1.4,1.5-2,1.7-2,10-14.5,2-3,3-3.5,3/4,4-4.5,4-6.5,4.5-5,6-7,anther,base,brown,calyx,clavate,cm,completely,conical,corolla,dark,deltate,dia,dry,drying,elliptic,erect,fleshy,fresh,glabrous,globose,green,internodal,leaf,lobe,lobed,material,minutely,mm,opposite,ovary,ovoid-reniform,papillose,pedicel,petiole,pitted,poricidal,shrub,size,slightly,small,stem,stigma,style,surface,tan,tip,treelet,tube,way,white,x,yellow-green	.5,0.8-2.2,1/2,1/4,10-12,2-5.5,3-5,5-8-flowered,abaxially,acute,adaxially,anthesi,apex,ba,bark,basal,beneath,berry,closely,clustered,deflexed,differing,difoliate,distal,eaf,edicel,eed,ellipsoid,exserted,f,filament,free,fruiting,geminat,inflorescenc,later,lateral,lon,long,lower,m.,main,major,margin,middle,minor,nflorescence,older,overlapping,pair,pale,papillo,planar,pore,portion,reddish,ruit,scar,shaped,shin,simple,spaced,stout,tall,tapering,tear-drop,thickened,tub,ud,unit,usually,vein,widest,woody,ympodial,young	adhesion,arrangement,colour,diameter,form,fruit,growth,height,history,inflorescence,length,life,na,number,peduncle,perennial,plant,position,presence,pubescence,ray,reproduction,rugulose,seed,shape,staman,stellate,texture
622	wfo-0001030489	success	196	136	103	93	33	0.526	-6.5,0.25-0.4,0.5-3,0.6-0.9,0.75-0.9,0.9-1.1,1-1.3,1-3,1.1-1.3,1.2-1.6,1.7-2,1.75-2,1.9-2.6,12-24,2.1-2.9,3-8,4-8,5,6-8,7-15,abaxially,abruptly,acute,adaxially,anther,apart,apex,appressed-pubescent,articulated,attenuate,base,becoming,blade,blunt-tipped,broadly,brown,calyx,chartaceous,cinereous,closely,cm,conical,corolla,deltoid,densely,diameter,echinoid,elliptic,entire,fleshy,fruit,glabrate,greenish,growth,hair,honeycombed,inserted,lateral,leaf,length,lobe,long-acuminate,margin,minutely,mm,multangulate,narrowly,oblong,obtuse,ovate,ovate-lanceolate,pedicel,peduncle,petiole,probably,pseudo-terminal,pubescent,pulverulent,reniform,reticulate-punctate,ripe,short,shrub,simple,small,somewhat,spaced,stellate-pubescent,stellate-rotate,stem,stigma,style,subcampanulate,subglobose,suborbicular,tomentose,toward,tree,tube,white,x,yellow,yellowish	.5-2.8,.5-3,.75-5.25,1-3.75,1.2-1.5,1.6-2.1,1/3-1/2,1/5-1/2,100,3-6,4.5-9,5-6,absen,acuminate,adaxiall,ag,anthesi,apical-lateral,apparently,appressed,axe,axillary,ba,bark,berry,branch,branched,bud,continued,cylindrical,dehiscing,dichotomously,due,eaf,echinoi,eed,elongate,filament,flower,free,glabrous,globose,high,introrse,large,lobed,long,long-exserted,longitudinal,lower,main,midvein,minute,mostly,nflorescence,older,orolla,pale,perfect,plurifoliate,pore,porrect-stellate,puberulent,pulverulen,rachi,ruit,runk,sessile,several,short-stalked,side,slender,slit,smooth,sparingly,sparse,subcapitat,tamen,terete,testa,thick,time,turn,unarme,unarmed,unit,usually,vary,vein,way,wide,ympodial,young	adhesion,arrangement,climate,colour,form,glandular,height,history,inflorescence,life,midpoint,na,number,ovary,perennial,plant,position,presence,present,pubescence,ray,reproduction,rugulose,seed,shape,size,staman,stellate,stipe,subcapitate,surface,texture,unknown
623	wfo-0001030492	success	221	123	98	123	25	0.443	.5,0.1-0.5,0.25-0.5,1-1.5,1.5-2,1.5-6,10-35+,15-20,2,2-3,2-4,2-5,3-10,3-8,4,4-6,4-8,5-30+,5-7,9-11,?,abaxially,acute,adaxially,anther,apart,apex,articulated,base,blade,brown,calyx,caudate-acuminate,chartaceous,cm,coarsely,connivent,densely,diameter,elliptic,entire,extra-axillary,ferruginous-pubescent,flattened,flower,fruit,fully,glabrous,glandular,glandular-puberulent,globose,green,hair,leaf,light,lobe,margin,maturity,mm,moderately,near,ovate,pedicel,peduncle,perfect,perhaps,petiole,pinnatifid,plant,pubescent,ray,ripe,sessile,shape,short-stalked,shrub,simple,size,small,spaced,sparsely,stellate,stellate-pubescent,stem,stigma,style,subcordate,surface,tapered,tip,toothed,tree,truncate,tube,white,x,yellow,yellowish	-2,.1,0.1-1,0.3-0.5,0.5-1,1,1-8,1.5,10,10-50+,12-25,2-2.5,25-50+,3-5,3-7,30-40+,4-7,5-6,7-18,accrescent,adaxiall,also,apparently,armed,axe,ba,branched,broad-based,capitat,coarse,covering,cylindrical,deeply,difoliate,directed,distall,divided,eaf,eed,eglandular,emerging,erect,female-sterile,ferruginous,filament,first,forked,frui,fruiting,geminat,gland,halfway,held,interpetalar,juvenile,lanceolate,larger,later,lateral,less,like,lobed,lon,long,longer,lower,lowering,major,midpoint,midrib,midvein,minutely,mostly,much,narrow,nearly,nflorescence,oblique,occasionally,often,orolla,pair,part,pitted,pore,prickle,rachi,rectangular,recurved,ruit,rusty,scattered,short,shorter,similar,sinus,slightly,sometimes,somewhat,sparse,splitting,sprout,stalk,ste,stellae,straight,tal,tamen,time,tissue,unarmed,unbranched,uniform,unit,upper,uprigh,vary,vein,wide,woody,ympodial,younger,youngest	adhesion,arrangement,capitate,colour,corolla,form,growth,height,history,inflorescence,length,life,na,number,ovary,position,presence,pubescence,reproduction,rugulose,seed,staman,stipe,texture,ye
624	wfo-0001030509	success	220	110	84	136	26	0.382	0-5,0.1-0.3,0.3-2.5,0.8-1.2,1-1.5,1-2,1-4,1.3-2,1/4,2-2.5,2-4.2,2-4.5,2-6,2.8-3,2/3-3/4,4.5-12,4.5-8,7-9,8-16,andromonoecious,anther,apex,base,berry,blade,calyx,chartaceous,cm,connivent,cordate,cuneate,densely,diameter,entire,equal,flattened-reniform,fruit,herb,lateral,leaf,length,lobe,lobed,long,lower,margin,maturity,mauve,mm,moderately,narrow-deltate,narrow-oblong,obtuse,orange,orange-brown,ovate,pale,pedicel,peduncle,petiole,plant,poricidal,purple,ray,rounded,shrub,simple,smooth,sometimes,sparsely,spherical,stellate,stellate-pubescent,stem,style,surface,tapering,terminal,tip,tube,way,weakly,wide,yellow	-10,-2,-6,/3,0,0-0.3,0-100,0-15,0-3,0.1,0.1-0.2,0.1-0.25,0.2,0.5-1.5,0.6-1,0.8-4,1,1-3,1-6,1.5-2,1.7-2,1/,1/3-2/3,2-3,3-10,3-4,4.5-10,5-10,5-merous,7-15,abaxially,alyx,apar,apart,apical,apically,apparently,articulated,bark,becoming,broad-deltate,brow,cream,curved,dark,difoliate,discolorous,distal,distance,drying,eaf,eed,elongating,erect,extending,eye,filament,flower,free,fruiting,geminat,glabrescent,glabrous,gland,globular,gray,green,half,herbaceous,hermaphrodite,heterostylous,inflated,infructescence,long-acuminat,long-styled,longer,lowermost,marking,mature,midpoint,midvein,naked,nflorescence,occasional,occasionally,often,older,one,open,orolla,oung,pair,pendulous,per,pericarp,perpendicular,porrect,portion,prickle,prickly,primary,reduced,ruit,scar,short-styled,shorte,shorter,side,slender,spaced,spreading,stalk,stalked,staminat,straight,subsessile,tamen,terete,tertiary,time,trichome,unarme,unarmed,unbranched,unit,upper,usually,variously,vary,vein,venation,visible,woody,yellow-green,ympodial,young	adhesion,arrangement,colour,corolla,form,growth,height,history,inflorescence,life,na,number,ovary,perennial,position,presence,present,pubescence,reproduction,seed,shape,size,staman,stigma,stipe,texture
625	wfo-0001030511	success	166	107	78	88	29	0.47	-6,.5,0.1-0.15,0.4-0.5,0.5,0.5-0.6,0.5-1,0.8-1,1.5,1.5-4,4-7,5-9,anther,apex,attenuate,base,bright,calyx,cm,conical,corolla,deltate,densely,diameter,entire,flattened,glabrous,globose,growth,inflorescence,internodal,lanceolate,leaf,less,linear,lobe,lobed,long,margin,membranous,midpoint,minute,mm,nearly,ovary,pale,pedicel,peduncle,petiole,plant,poricidal,porrect,pubescent,ray,red,reniform,rounded,sessile,shiny,shrub,simple,sparsely,stellate,stem,stigma,style,surface,tan,tapering,thin,tip,triangular,trichome,tube,violet,white,x,yellowish	0.1,1,1-2,4-8,4-merous,5-7,6-8,?,abaxially,absent,acicular,adaxially,almost,along,also,anthesi,arising,articulated,barely,bark,berry,brow,cell,closely,curved,deeply,difoliate,eaf,eed,either,ellipsoid,erect,especially,exserted,filament,filiform,flower,free,fruiting,geminat,leave,lengthening,like,lower,midrib,midvein,minutely,new,nflorescence,noddin,nodding,older,overlappin,pair,papillo,per,perfect,pericarp,pitted,planar,pore,portion,prickle,prickly,primary,rarely,rest,ripe,ruit,scar,short-stalked,sinuate,sometimes,spaced,strongly,tall,testal,toward,ud,unit,upper,vein,visible,woody,yellow,ympodial,½,¾	adhesion,arrangement,blade,climate,colour,form,fruit,glandular,hair,height,hermaphroditic,history,length,life,na,number,perennial,position,presence,pubescence,reproduction,rugulose,seed,shape,size,staman,stipe,texture,ye
626	wfo-0001030516	invalid_json	172	101	70	102	31	0.407	0.4-1.5,1-7,1.1-3.5,1.1-4.1,1.5-2,1.8-2.4,3-8,3-9.8,4-22,4-6,4-7,4.2-10.7,6-15,8-9,9-22,abaxially,adaxially,calyx,cm,connate,corolla,covered,darker,densely,diameter,distal,elliptical,gland,globose,green,green-white,hair,half,herbaceous,interjected,lateral,leaf,leaflet,light,long,mm,odd-pinnate,outline,ovate,ovoid,pedicel,peduncle,pentagonal,perennial,petiole,pilose,plant,puberulent,pubescent,rotate,seed,short-stalked,size,slightly,sometimes,spreading,stigma,stripe,style,terminal,throughout,triangular,tuber-bearing,wide,yellow	1-2.5,1-4,1.7,2-12,2-2.,2-3,2-4,3-6,3-6-foliat,4-4,9-32,acumen,acuminate,acute,apex,apical,apically,articulate,base,branched,cell,cordate,covering,cuneate,cyme,decurrent,dehiscent,dichasial,dichasially,digestion,diminished,dorsally,eaf,ebracteate,edge,eed,emoval,enzyme,exceeding,filament,first,flat,flower,folded,forked,generally,globo,gradually,hair-like,honeycomb,introrse,less,living,lobe,lon,long-attenuate,longer,lower,lunat,make,maturing,monochasial,mucilaginous,nflorescence,nther,oblique,often,orolla,pair,pattern,perfect,plan,poricidally,proximal,rarely,reveal,ruit,second,sessile,seudostipule,short,short-petiolate,slit,specimen,stamen,straight,tal,tem,testal,thick,time,toward,triangulat,type,typically,unit,vary,wall,whit,ympodial,¼,’	'','type,2-21,[,],``,anther,arrangement,characteristic,colour,form,fruit,growth,height,history,inflorescence,length,life,na,number,ovary,position,pubescence,reproduction,shape,stem,texture,value,white,{,}
627	wfo-0001030522	success	192	114	87	105	27	0.453	-4,-8,0.3-0.7,0.5-0.6,1,1-1.4,1-1.5,1.7-3,2-lobed,2.5-6,3,3-4.5,3-5,4,4-9,7-10,abaxially,absent,acute,adaxially,almost,anther,apex,base,berry,brown,calyx,cm,completely,cordate,corolla,cup-shaped,densely,diameter,dioecious,elliptic,entire,flattened,fleshy,fruit,glabrous,globose,green,growth,inflorescence,internodal,leaf,lobe,lobed,margin,membranous,midpoint,minutely,mm,obtuse,orange,orbicular,ovary,ovate,pedicel,petiole,pitted,plant,poricidal,porrect,pubescence,pubescent,ray,reddish,reniform,ripening,rounded,sessile,shrub,small,stellate,stem,stigma,style,surface,tip,treelet,trichome,tube,vestigial,white,x	.2,.5,.7,/4,0,0.05-0.15,0.3-0.4,0.5,0.5-1,0.7,0.9-1.3,1-5-2,1.5,2,2.5-2.8,20-30,3-4,4-10,5-10,6-7,also,anthesi,apart,armed,articulated,ba,bark,bearing,broad-based,brow,cell,conical,consisting,dark,darker,dense,diamete,difoliate,directed,eaf,eed,ellipsoid,erect,female,filament,flower,free,fruiting,geminat,impressed,included,irregularly,juvenile,lamina,le,less,like,lon,long,lower,male,mature,minute,mixture,new,nflorescence,notably,oblique,obscured,occasionally,often,pair,per,pericarp,pistillate,planar,pollen-bearing,pore,portion,prickle,primary,ruit,scar,shallowly,short-stalked,single,somewhat,sparsely,sparser,staminate,straight,testal,thin,toward,ud,unarmed,unisexual,unit,upper,upwardly,usually,vein,way,woody,ynpodial	adhesion,arrangement,blade,climate,colour,form,glandular,hair,height,history,length,life,na,number,peduncle,perennial,position,presence,present,reproduction,rugulose,seed,shape,size,staman,stipe,texture
628	wfo-0001030551	success	167	115	85	82	30	0.509	-30,0-2,0.5-1,0.6-1.5,1-10,1-2,1-2.5,1-3.5,1-4,1-5,1.5-2.5,10-20,2,20-25,3-,3-12,3-8,4-,4-5,4-7,5-6,abaxially,acuminate,acute,adaxially,also,apex,articulated,basal,base,blue,calyx,campanulate,chartaceous,cm,concave,cordate,densely,diameter,ellipsoidal,entire,fading,fruit,glabrous,glandular-puberulent,globose,lanceolate,leaving,lobe,long,margin,mm,moderately,oblong-fusiform,obtuse,often,ovate,ovate-elliptic,ovoid,papillose,pedicel,pedicellar,peduncle,petiole,pilose,puberulent,pubescent-pilose,rachi,radiu,remnant,shrub,simple,sparsely,stellate,stigma,style,subcoriaceous,tip,triangular-elliptic,truncate,unbranched,unknown,violet,x,yellowish	-12,-5,1,1-,1.5-,10-40,13.,2-3,2-6,2.5-4,2.5-5,3-5,4-foliat,5-17,9-20,abruptly,absent,adpressed,aggregate,apart,ape,axe,beyond,bilobe,blade,broad,cell,clavate,color,connective,dia,dilated,directed,distally,eaf,ed,equal,et,exceeding,exserted,fleshy,flower,hair,laterally,lon,lower,martinelli,narrow,narrowed,narrowly,nflorescence,nther,orolla,perfect,pore,puberulen,puberulent-pubescent,pubescent-pilo,ripe,round,ruit,seen,shorter,slightly,small,spaced,stamen,stone,tal,tem,thecae,time,tomento,triangular,tube,ud,unit,unknow,vary,wide,widening,ympodial	anther,arrangement,bilobed,bud,colour,corolla,form,glandular,growth,height,history,inflorescence,leaf,length,life,na,ovary,perennial,pilosity,plant,position,pubescence,reproduction,rugulose,seed,shape,size,stem,surface,texture
629	wfo-0001030570	success	173	98	69	104	29	0.399	0.3-0.5,1-4,1-8,10-25,2-3,2-5,2-8,2.5-22,3-10,3-5,3-6,3.5-5,4-25,4-5,4-7,abaxially,acuminate,acute,adaxially,apex,base,calyx,campanulate,cm,cordate,cylindrical,diameter,ellipsoidal,elliptic-oblong,entire,flattened,forked,fruit,glabrous,glandular-puberulent,globose,green,lanceolate,leaf,lobe,lobed,margin,mm,narrowly,ovate,pedicel,peduncle,petiole,pilose,pinnately,purplish,rarely,rounded,simple,sparsely,stellate,stigma,style,subcoriaceous,tree,triangular,truncate,tube,unbranched,unknown,vein,white,x,yellow	-1,.3-0.5,0-,0.5-,0.5-1,1,1-,1-1.5,1-2,1-3,1-5,1.5,1.5-2.5,1/2,10-17,15-20,15-35,2-2.5,2-4,2-7,2-7-lobed,20-30,4-foliat,4/5,5-,8-,absent,aggregate,apart,ape,apiculate,articulated,axe,basal,beyond,blade,cell,color,connective,connivent,dilated,directed,distally,divided,eaf,eed,eglandular,exceeding,exserted,fleshy,flower,glabrat,hair,leaving,lon,long,lower,midrib,near,nflorescence,nther,obtuse,occasionally,often,orolla,ovoid,pedicellar,perfect,pilo,pore,presen,pubescent,punctate,purpl,rachi,radiu,remnant,ripe,rugose,ruit,shorter,sinus,slightly,small,sometimes,somewhat,spaced,stamen,stone,submarginally,tal,tem,thecae,time,tip,tomento,truncat,ud,unequal,unit,unlobed,vary,wide,ympodial	abaxial,anther,arrangement,colour,corolla,form,growth,height,hermaphroditic,history,inflorescence,length,life,na,ovary,perennial,plant,position,presence,present,pubescence,reproduction,rugulose,seed,shape,size,stem,surface,texture
630	wfo-0001030580	success	230	103	57	173	46	0.248	2,abaxially,acute,adaxially,adnate,anther,apex,attenuate,base,black,blade,brown,bud,calyx,chartaceous,cm,corolla,deltoid,densely,diameter,elliptic,entire,extra-axillary,flattened-orbicular,flattened-reniform,fruit,glabrous,globose,hair,lateral,leaf,lobe,margin,mm,moderately,ovate,pedicel,petiole,porrect,pubescent,ray,rounded,scattered,sessile,shrub,simple,sparsely,stellae,stellate,stem,stigma,straight,style,surface,tube,white,yellow	.0,.0–6.2,.2,.3,.5,.7,/2,/3,0.2–0.3,0.3–0.4,0.3–0.7,0.4–0.5,0.4–0.7,0.6–1.1,0.6–2.1,0.7–0.8,0.9–1.2,1.2–1.5,1.3–1.5,1.3–3.0,1.5–,1.5–2.0,1.5–4.0,1.5–9.0,1.6–1.8,1.6–2.5,1.7–1.8,1/3,1–2,2.0–2.2,2.0–3.1,2.3–5.5,3,3.7–5.4,3–5,4–6,4–8,5-merou,5–5.4,6–8,8.3–10.0,ag,along,alyx,anthesi,apical,apparently,appearing,appresse,arching,area,around,articulate,attachment,ba,becoming,berry,broad,brochidodromous,capitat,caudate,central,channeled,connivent,curved,dentate,developed,difoliate,directed,distal,distally,distinct,dramatically,dry,eaf,edge,eed,either,emerging,endocarp,erect,exocarp,extending,ferruginous,fertile,filament,filiform,flat,flexed,flower,free,geminat,glabrescent,glossy,gradually,homostylous,increasing,indistinct,inter-sepalar,internode,interpetalar,intersepalar,juic,laying,lon,long,longer,lower,mainly,many,mature,middle,midpoint,midrib,midvein,minute,much,nearly,nflorescence,notched,oblong,orolla,per,perforate,persistent,pitted,point,pore,portion,potentially,probably,raised,ruit,sepal,side,sinus,slightly,smoot,smooth,sometimes,splitting,spread,stamen,stellate-pubescent,strongly,suture,tamen,tardily,tem,thin,though,time,tip,tissue,toward,translucent,truncate,typically,ud,unarmed,unit,vary,vein,weakly,well,wide,ympodial,young,±90°,±aequilateral,×,–2.5,–8	0.2-0.3,0.3,0.3-0.4,0.3-0.7,0.4-0.7,1.0,1.3-3.0,1.5-2.0,1.5-4.0,1.5-9.0,1.6-1.8,2.0,2.0-2.2,3.7-5.4,4-6,4-8,7.0,adhesion,age,arrangement,capitate,colour,form,growth,height,history,inflorescence,length,life,na,number,ovary,peduncle,perennial,plant,position,presence,present,pubescence,reproduction,rugulose,seed,shape,size,staman,texture
631	wfo-0001030581	success	187	108	63	124	45	0.337	.5,acute,anther,apex,base,berry,black,bright,calyx,capitate,central,cm,conical,corolla,decurrent,diameter,ellipsoid,elliptic,entire,flattened-reniform,fruit,glabrous,globose,green,growth,herb,inflorescence,intermodal,lateral,leaf,lobe,long,margin,markedly,maturity,mm,occasionally,ovary,ovate,pedicel,peduncle,petiole,plant,portion,pubescent,purplish,ripe,rounded,shallow,shiny,simple,sparsely,stellate,stem,stigma,style,surface,tube,turning,white,wide,yellow,yellowish	.3,0.2–0.8,0.4–0.6,0.4–1.6,0.5,0.5–0.7,0.5–2.5,0.6–0.7,0.7–0.8,0.9–1,1,1-4-celled,1.2–1.5,1.8–8,1–2,1–2-celled,1–2.5,1–4-celled,2,20–50,2–3-celled,35–45,3–4,3–5,4.5–12,4–7,4–9,5-merous,5–6,5–8,9,abaxial,abaxially,adaxial,adaxially,aggregate,along,angle,angled,anthesi,apar,appressed,articulated,basal,becoming,beyond,branched,cell,clustered,cone,densely,denser,difoliate,drop,eaf,eed,exserted,filament,florescence,flower,free,fruiting,geminat,halfway,individual,lacking,later,leave,less,like,live,lobed,lon,lower,minute,minutely,narrowly,near,new,often,once-branched,outline,pair,papillate,pentagonal,per,perfect,pitted,primary,rachi,reflexe,reflexed,remaining,ridge,ruit,scar,shorter,slightly,somewhat,spaced,sprawlin,spreading,stone,straight,strongly,tall,tangled,tem,terete,testal,third,translucent,trichome,ud,uniseriate,unit,upper,usually,vein,winged,woody,ympodial,–15,–5	0.3,0.4-1.6,0.5-0.7,0.5-2.5,0.6-0.7,0.9-1,1-2.5,1.2-1.5,1.8-8,15,20-50,3-4,4-9,4.5-12,5,5-6,adhesion,arrangement,blade,climate,colour,form,glandular,hair,height,history,length,life,midpoint,na,number,perennial,position,presence,present,pubescence,ray,reproduction,rugulose,seed,shape,size,staman,stipe,texture
632	wfo-0001030582	success	190	103	55	135	48	0.289	.5,0.1,1.5,acute,anther,apex,attenuate,base,blade,blue,brown,cm,cordate,diameter,entire,flattened-reniform,fruit,glabrous,globose,hair,lateral,leaf,light,linear-attenuate,lobe,margin,midpoint,mm,moderately,narrowly,obscurely,orange,ovate-lanceolate,pedicel,peduncle,petiole,red,rounded,shrub,simple,sinuate,stellate-pentagonal,stellate-tomentose,stem,stigma,stipe,style,surface,terminal,thick-chartaceous,tomentose,triangular,tube,yellow,×	.1,0,0.2,0.4,0.4–0.5,0.4–1,0.6,0.8–1,1.4–2,1.5–3,10,10–12,12,1–1.5,2.5–3,2–10-branched,2–2.5,2–4.5,3.5–9.5,3–3.2,3–3.5,3–5,4–4.5,4–9-rayed,5,5-merou,5–8,6–8-rayed,7–11,7–20,abaxially,adaxiall,adaxially,age,alyx,apart,apparently,articulated,axe,ba,becoming,branch,branched,broad,c.,capitat,caudate,closely,dark,densely,dichotomously,directed,distall,eaf,eed,ellipsoid,evenly,except,extra-axillary,filament,filiform,finely,flower,free,geminat,glabrescent,gland-tipped,homostylous,initially,internode,interpetalar,larger,later,lea,less,lighter-colored,like,lon,long,lower,maturit,midzone,minute,minutely,nearly,nflorescence,numerous,often,orolla,overtopped,ovoid,part,per,perfect,pitted,plurifoliate,pore,principal,probably,ripe,ruit,sessile,shiny,short,short-stipitate,side,sinus,slender,somewhat,soon,spaced,sparsely,splitting,stellae,stellate-tomento,tall,taller,tamen,tardily,tem,tip,tissue,truncate,ud,ultimate,unarme,unarmed,underside,vary,vein,visible,well-developed,wide,ympodia,young	0.4-0.5,0.4-1,0.8-1,1-1.5,1.4-2,10-12,2-2.5,2-4.5,3-3.2,3.5-9.5,4-4.5,4-9,6-8,7-11,7-20,adhesion,arrangement,calyx,capitate,climate,colour,corolla,form,glandular,growth,height,history,inflorescence,length,life,na,number,ovary,perennial,plant,position,presence,pubescence,ray,reproduction,rugulose,seed,shape,size,staman,stellate,texture,ye
633	wfo-0001030583	success	166	121	89	77	32	0.536	.5,0.1-0.5,0.2-1,0.3-1,0.7-4.5,1,1-1.5,1-2,1.5-4,1/2,2.5,2.5-3,2.5-9,3-4,3/4,5-6,abaxial,abaxially,acute,adaxially,anther,apex,base,calyx,cm,conical,corolla,crisped,cultivar,cultivated,dark,deep,dendritic,densely,elliptic,especially,flattened-reniform,form,fruit,glabrous,globose,golden,green,immature,incrassate,irregular,leaf,live,lobe,lobed,long,long-triangular,margin,minutely,mm,narrowly,occasionally,opposite,orange-red,ovary,pale,papery,papillose,pedicel,petiole,pitted,plant,pubescent,ripe,rounded,shaped,shrub,size,small-capitate,spathulate,stem,stigma,style,surface,tan,tear-drop,thin,tip,trichome,tube,way,white,x,yellow	.2,0.4-2.7,0.5-1,0.8-1,0.9-3.5,1-8,4-6,5-7,6-7,along,anthesi,ba,bark,berry,brow,cell,closely,corky,deflexed,dia,differing,difoliate,dry,eaf,edicel,eed,ellipsoid,enlarged,erect,filament,flower,free,frui,fruiting,geminat,included,lateral,leave,like,lon,long-rectangular,lower,main,major,midvein,minor,nflorescence,often,older,outline,overlapping,pair,papillo,pericarp,planar,pore,poricidal,portion,prostrate,rest,ruit,scar,simple,small,soon,spaced,specimen,stout,tall,testal,ud,uniseriate,unit,vein,woody,ympodial,young	adhesion,arrangement,blade,brown,climate,colour,diameter,glandular,growth,hair,height,history,inflorescence,length,life,midpoint,na,number,peduncle,perennial,position,presence,pubescence,ray,reproduction,rugulose,seed,shape,staman,stellate,stipe,texture
634	wfo-0001030605	success	144	124	89	55	35	0.618	.4,.5,0.3-0.5,1,1-4,1.5-2,1.5-5.5,1.7,2,2-3,2.5,5-12.5,7,abaxially,acute,adaxially,almost,along,anther,apex,area,attenuate,base,brown,calyx,cm,commonly,conical,coriaceous,corolla,dark,dendritic-echinoid,dia,difoliate,dry,glabrate,glabrous,globose,green,growth,inflorescence,internodal,leaf,less,lobe,lobed,margin,material,midrib,minutely,mm,nearly,obovate,obtuse,occasionally,opposite,otherwise,ovary,ovate,ovoid-reniform,papillate,pedicel,peduncle,petiole,pore,poricidal,pubescent,revolute,rounded,scattered,shaped,shiny,shrub,slightly,smooth,sparsely,stigma,style,surface,tear-drop,thickened,tip,trichome,tube,unifoliate,vein,way,white,x	0.1,1/3-1/2,12-19-flowered,anthesi,apart,ape,apical,beginning,beneath,berry,branch,branched,cinereous,covered,cylindrical,deflexed,densely,drying,eaf,edicel,eed,ellipsoid,entire,exerted,filament,free,fruiting,geminat,gold,inflorescenc,light,long,lower,new,nflorescence,olive,overlapping,papillosefruit,pitted,portion,rarely,reflexed,scar,simple,slender,somewhat,soon,sparesly,tinged,tub,ud,unit,woody,yellow,ympodial	adhesion,arrangement,blade,climate,colour,diameter,form,fruit,geminate,glandular,hair,height,history,length,life,midpoint,na,number,papillose,perennial,plant,position,presence,pubescence,ray,reproduction,rugulose,seed,shape,size,staman,stellate,stem,stipe,texture
635	wfo-0001030611	success	217	119	89	128	30	0.41	-35,0,0-0.5,0.5,0.5-1.5,1.5-10,1.5-2,2,2-3.5,2-4,2-7,2.2-2.5,3.5-5.5,4-5,4-8,7-25,9-30,abaxially,acute,adaxially,anther,apex,articulated,base,blade,blunt-tipped,broadly,calyx,campanulate,cm,coarsely,connate,deltoid,densely,dentate,development,diameter,elliptic,elongated,erect,felty-pubescent,finally,flower,fruit,glabrous,globose,hair,inflorescence,leaf-opposed,length,lenticular,lobe,margin,midpoint,minutely,mm,oblong-tapering,obtuse,orange,outline,ovate,pedicel,peduncle,perennial,petiole,pitted,present,pubescent,ray,resembling,ripe,simple,slightly,spreading,spreading-hirsute,stellate,stellate-pubescent,stigma,style,surface,tan,thin-textured,truncate,tube,white,whitish,x,yellow,yellow-orange	-1.3,0.1-0.3,0.5-2.5,0.7-1.5,1,1-2,1-3,1.5-3,1/4-1/3,12-10,12-15,15,1mm,2-6,2-foliate,3,3-4,3-5,4-6,5-10,5-15,5-8,6-9,abaxiall,acicular,adaxiall,along,apart,appearing,attenuate,axe,ba,basally,branched,capitat,cauline,commonly,composed,connivent,crowded,cylindrical,depressed-deltoid,directed,distal,distally,divergently,eaf,eed,elongate,entire,equaling,exceeding,female-sterile,filament,flesh,free,geminat,glabrou,glandula,hermaphroditic,inserted,interlaced,interlobal,intermixed,lacking,larger,lateral,less,light,lon,long,long-stalked,longer,longest,lower,main,midrib,midvein,much,nflorescence,numerous,often,one,orolla,ovate-lanceolate,part,per,pore,predominantly,prickle,principal,prominent,rachi,radiu,reduced,round-tipped,ruit,section,sessile,short,short-stalked,short-styled,side,sinus,small,sometimes,somewhat,spaced,stalk,ste,stellae,stellate-woolly,stipitate,suffrutescent,tal,tamen,tem,termination,time,unarmed,unbranched,unit,usually,vary,vein,wide,widely,ympodial	adhesion,arrangement,capitate,climate,colour,corolla,dioecious,form,glandular,growth,height,history,leaf,life,na,number,ovary,plant,position,presence,pubescence,reproduction,rugulose,seed,shape,size,staman,stem,stipe,texture
636	wfo-0001030624	success	170	90	68	102	22	0.4	.5,0.9-1,1-3,1.2-1.8,1.2-2,1.5-2,2-10,2.5-5.5,3-3.5,3.5-4,6-13,anther,anthesi,axil,base,calyx,clavate,cm,corolla,dia,dry,elliptic,falcate,flattened-reniform,glabrate,glabrous,glandular,globose,green,greyish,lateral,leaf,lobed,long,main,material,minutely,mm,narrowly,nearly,opposite,ovary,papillose,pedicel,petiole,pitted,planar,puberulent,shrub,size,slender,small,soon,stem,stigma,style,surface,tapering,tree,trichome,tube,tuft,uniseriate,vein,white,x,yellowish,yellowish-green	.25,0.5,0.5-1,0.5-1.5,2,2-3,25-40-flowered,3,4.5-8,7-9,acute,apart,apex,apiculate,appearing,attenuate,ba,bark,beginning,berry,branch,caly,cell,decurrent,deflexed,differing,difoliate,dimorphic,distal,eaf,edicel,eed,ellipsoid,end,erect,except,expanded,exserted,extreme,filament,free,fruiting,furcate,geminat,hyaline,incrassate,inflorescenc,large,later,like,lobe,lon,longitudinally,lower,major,margin,middle,midrib,minor,near,nflorescence,occasionally,older,one,outer,pair,pale,pore,poricidal,portion,prominent,raised,remaining,round,rugo,ruit,scar,shining,short,simple,slightly,somewhat,spaced,square,straight,tall,thickened,three,ti,tip,trunk,two,ud,unevenly,unit,wall,widest,woody,yellow,yellowish-grey,ympodial,young	arrangement,colour,diameter,form,fruit,growth,height,history,inflorescence,length,life,na,peduncle,perennial,plant,position,pubescence,reproduction,rugulose,seed,shape,texture
637	wfo-0001030628	success	229	131	93	136	38	0.406	.1,.5,1,4,abaxial,adaxial,adaxially,age,andromonoecious,anther,apart,articulated,base,becoming,brown,calyx,capitate,chartaceous,cm,congested,connivent,dark,densely,diameter,ellipsoidal,elliptical,extra-axillary,flattened,flower,fruit,glabrous,glandular,green,hair,hermaphroditic,inflorescence,interpetalar,juicy,lanceolate,leaf,length,light,like,lobe,maturity,mm,moderate,moderately,multangulate,multangulate-stellate,ovary,ovate,pedicel,peduncle,petiole,plant,porrect-stellate,pubescent,purple,reddish,reddish-tan,reniform,rotate-stellate,sessile,similar,simple,slightly,spaced,sparsely,stalked,stellate,stem,stigma,strongly,style,surface,tapered,tissue,tree,tube,turbinate,unequal,violet,whitish-,whitish-golden,yellow,yellowish-green,young,×,–30,–5,–50,–9	.2,.5–1.7,0.1–0.3,0.5–3,0.7–0.9,10+,10–20,10–40,10–55,11–16,12–20,16–18,1–1.5,1–10,1–2,2.5–8,20–35,2–10,2–3,3.5–4,3.5–5,4–4.4,4–6,4–6.5,4–8,5-merous,5–,5–6,5–8.5,6–10,6–8,7–25,7–40,8–1,8–25,abaxially,acuminate,acute,along,alyx,andromoneciou,anthesi,apex,axe,ba,bark,berry,bilobe,blade,branched,broad-based,broadly,central,cordate,curved,cylindrical,db,difoliate,directed,discolorous,distally,dried,eaf,eed,eglandular,either,entire,filament,fissure,flowering,free,fresh,frui,fruiting,functionally,geminat,half,heterstylous,inclusion,inflated,knobby,lobed,long,longitudinal,lower,major,margin,maturit,membranaceous,midpoint,midvein,multiseriate,near,nearly,nflorescence,oblique,often,one,opening,orolla,part,pericarp,point,pore,portion,prickle,rachi,ratio,ray,remaining,rounded,rugose,ruit,runk,sclerified,shallow,shallowly,sharp,side,slit,stalk,staminate,stellate-pubescent,stout,straight,subtending,tamen,thick,thin,unarmed,unit,vary,vein,width,woody,ympodial	1-2,10-20,10-40,10-55,11-16,16-18,2-10,2-3,3.5-4,4-6.5,5-6,5-8.5,6-10,7-25,7-40,8-25,adhesion,arrangement,bilobed,colour,corolla,form,growth,height,history,life,na,perennial,position,pubescence,reproduction,rugulose,seed,shape,size,staman,texture,true
638	wfo-0001030638	success	177	76	56	121	20	0.316	0.5-1.5,0.7-1.5,1-1.2,1-2,1.4-1.7,1.5-2,1.6-2.2,2-5,3-10,3-13,4-6,8,8-9,anther,broadly,calyx,cm,corolla,cup-shaped,dia,elliptic,fruit,glabrous,glandular,globose,green,inflorescence,leaf,lobed,mm,obovate,opposite,ovary,pale,papillose,pedicel,petiole,poricidal,red,red-glandular,rugose,seed,shape,shrub,size,stem,stigma,style,surface,terminal,thickening,tip,tree,tube,white,x	0.1,0.5,0.5-0.7,0.5-1,0.5-2,1-1.5,2-3,2-7-flowered,2.5-4,8-11,acute,along,anthesi,apex,apically,appear,appearing,axi,axil,ba,bark,base,beginning,beneath,berry,blade,branched,bud,closely,conspicuously,corky,cucullate,deflexed,deltoid,densely,differing,difoliate,dry,eaf,eed,entire,erect,exfoliating,extending,filament,flattened,fleshy,free,fruiting,geminat,geminate,glabrate,gre,impressed,irregular,known,lamina,large,later,lateral,less,like,lobe,lon,long,lower,main,major,margin,material,middle,minor,minutely,near,nearly,nflorescence,occasionally,often,older,one,open,overlapping,ovoi,pair,paler,papillae,papillo,persistent,planar,pore,portion,present,prominent,rather,reddish,rest,roundish,ruit,scar,shaped,simple,soon,spaced,speciman,straight,tall,tapering,tear-drop,thick,thickened,transversely,trichome,uniseriate,unit,usually,vein,wall,widest,woody,ympodial,young	1,alternate,arrangement,colour,diameter,form,grey,growth,height,history,length,life,na,perennial,plant,position,pubescence,reproduction,rugulose,texture
639	wfo-0001030661	success	183	119	87	96	32	0.475	.5,0.5-0.6,0.5-0.75,0.5-2,0.7-0.8,1-,1-1.3,1-1.4,1.2-7,1.5-2,1.5-7,2-,2-2.5,3-20,3-3.5,4-15,5-5.5,acute,anther,apex,attenuate,base,brown,calyx,capitate,cm,conical,connivent,corolla,deltate,densely,diameter,ellipsoid,elliptic,entire,flattened,glabrous,globose,growth,inflorescence,lateral,leaf,lobe,lobed,loosely,margin,mature,membranous,minutely,mm,narrowly,occasionally,pale,pedicel,peduncle,perfect,petiole,pitted,pubescent,red,reddish,reniform,shiny,shrub,simple,small,sparsely,stellate,stem,stigma,style,surface,terminal,thin,tinged,tip,tree,trichome,tube,uniseriate,violet,way,white,x,yellowish,½,¾	-24,.2,0,1-.,1-1.2,1-1.5,12-16,3-4,4-6,5-10,5-merou,50-100+,ag,along,alyx,anthesi,ark,articulated,berry,branch,branched,brow,cell,clustered,dar,denser,drying,eaf,eed,em,erec,erect,exserted,extending,filament,flower,free,fruiting,glabrescent,glabrou,group,ilament,insertion,lamina,lengthening,lon,long,lower,many,midrib,minute,near,never,new,nflorescence,nodding,older,onto,orolla,otherwise,pair,papillo,per,pericarp,planar,platform,plurifoliat,point,pore,poricidal,portion,primary,rectangular,ruit,scar,scattered,sleeve,slender,slightly,slit,spreading,strongly,tangled,testal,time,twinin,ud,unit,upper,usually,vary,vein,winged,woody,yellow,ympodial	1-5,adhesion,arrangement,blade,climate,colour,form,fruit,glandular,hair,height,history,length,life,midpoint,na,number,ovary,perennial,plant,position,presence,pubescence,ray,reproduction,rugulose,seed,shape,size,staman,stipe,texture
640	wfo-0001030665	success	191	102	75	116	27	0.393	-5,-7,0.2-0.4,0.2-0.6,0.4-0.6,0.5-1,0.5-2,0.7-1,0.8-1.1,1-2,1.1-2.8,1.5-2.5,1.6-4.5,2.5-3.5,3-3.8,3-5,5-8,adaxially,anther,brown,calyx,campanulate,chartaceous,cm,deflexed,deltate,depressed-globose,depression,diameter,ellipoidal,elliptical,extra-axillary,finally,flower,flushed,fruit,glabrous,gland-tipped,globose,greenish,grey,hair,herbaceous,inflorescence,leaf-opposed,length,light,lilac,lobe,long,minutely,mm,ovate,pale,papery,pedicel,peduncle,petiole,present,puberulent,purple,resprouter,reticulate,rotate,short,simple,sparsely,stigma,style,surface,thick,tube,vein,x,yellow	%,0.5-11,1-17,1-4,1.4-1.7,1.5-2,1.5-3,10-200,2-16,2-3,2-5,2-6,2-8,2.3-10,2.5-9,20-30,3-10,4-5,5-merou,6-8,abaxially,absen,absent,abundant,accrescent,acicular,acute,adaxiall,adult,alyx,apex,appearance,appessed,armed,articulated,axe,ba,base,blade,branche,broad,broad-based,capitat,cordate,cut,cylindrical,decimetre,deeply,directed,distall,dr.,eaf,eed,filament,finger,folded,fruiting,geminat,give,green,grey-green,half,homostylous,index,interpetalar,inward,lamina,lateral,less,lobed,lobing,lon,longer,lower,margin,mature,mesocarp,midvein,minute,nflorescence,oblique,obtuse,orolla,part,per,perfect,pore,prickle,prostrate,rachi,rather,reflexed,rounded,ruit,scarcely,side,sinus,sprawling,stage,stellate-campanulate,straight,tal,tamen,tem,thin,throughout,time,tissue,unbranched,unifoliate,unit,uvenile,vary,wide,ympodial,¾	adhesion,arrangement,capitate,colour,corolla,form,growth,height,history,leaf,life,na,ovary,perennial,plant,position,presence,pubescence,reproduction,rugulose,seed,shape,size,staman,stellate,stem,texture
641	wfo-0001030676	success	220	139	116	104	23	0.527	-1.6,-3.9,0.4,0.6-1.2,1,1-3,1.1-1.4,1.1-1.9,1.2-1.3,1.3-1.5,1.7-2,14-17,16,19-35,2.1-2.3,2.1-2.6,2.4-3.1,2.75-3.25,3-5,3-6,4-6,7-8,8-10,8-12,abaxially,acute,adaxially,along,anther,anthesi,apart,appressed-tomentose,articulated,base,becoming,blunt-tipped,brown,calyx,chartaceous,closely,cm,conical,continued,corolla,deltoid,densely,diameter,due,echinoid,exserted,finely,flower,fruit,glabrescent,glabrous,granular-tomentose,green,greenish,growth,hair,honeycombed,initially,inserted,lateral,leaf,length,lined,lobe,longitudinally,midvein,minutely,mm,moderately,mostly,multangulate,oblong,oblong-elliptic,occasional,opening,ovate,pedicel,peduncle,probably,pseudo-terminal,pubescent,reniform,reticulate-punctate,ridged,ripe,scabrous,scattered,sessile,shrub,simple,small,spaced,sparsely,stellate,stellate-pubescent,stem,stigma,strongly,style,subcampanulate,subglobose,suborbicular,testa,tomentose,tree,tube,velutinous,white,whitish,x,yellow,yellowish	-2.5,-8.5,/10-1/5,0-100,1-1.2,1/4,11-14,2.2-5.7,2.5-5.5,3-3.5,4-6.5,7-10,7-9,abruptly,angled,apex,apical-lateral,apparently,appearing,axillary,ba,bark,berry,blade,branch,branched,bud,crown,cylindrical,dehiscing,dichotomously,eaf,echinoi,eed,elongate,entire,except,filament,flat-topped,fleshy,forming,free,glabrescen,globose,grooved,high,horizontal,introrse,lackin,lamina,large,lengthen,lobed,long,longitudinal,lower,main,margin,midvei,minute,nearly,nflorescence,oblique,obtuse,often,older,openly,orolla,ovate-lanceolate,parallel,perfect,petiole,plurifoliate,pore,pulverulent,rachi,rather,ray,ruit,runk,short-attenuate,short-stalked,side,slit,somewhat,spreading,subcapitat,tamen,tending,terete,thick,thin,time,tip,tuft,unarme,unit,usually,vary,vein,way,wide,ympodial,young	adhesion,arrangement,colour,form,height,history,inflorescence,life,na,ovary,perennial,plant,position,pubescence,reproduction,rugulose,seed,shape,size,staman,subcapitate,surface,texture
642	wfo-0001030686	success	182	118	91	91	27	0.5	.2,.5,1-1.1,1-1.2,1-1.5,1.2-1.5,1.5-4.5,1.6-3,15,2-2.5,2-6.5,2.5-4,2.5-8,3-3.5,5-12,5-25,5-6,abaxially,abruptly,acuminate,acute,anther,apex,basal,base,berry,bifid,brittle,brown,c.,calyx,cm,conical,corolla,cup-shaped,dark,deeply,densely,diameter,dry,elliptic,entire,flattened,form,fruit,globose,half,height,internodal,leaf,leaf-opposed,lepidote,lilac,lobe,lobed,long,margin,maturity,mm,orange,ovary,pale,pedicel,peduncle,petiole,pitted,plant,poricidal,pubescent,purple,scarious,seed,shallowly,shiny,short,simple,sparsely,spreading,stellate,stem,stigma,style,surface,thin,tip,tree,tube,uniformly,way,x,yellow	.5-1,0.5-1,1-2,1.5-2,1972,2-3,5-30,8-9,?,aborted,adam,adaxially,age,anthesi,apart,bark,beneath,black,branched,breast,bu,centre,closely,darker,denser,different,difoliate,discolorous,drying,eaf,edicel,eed,empty,erect,exerted,fide,filament,flower,fragrant,free,fruiting,geminat,glabrescen,glabrous,golden,heteromorphic,lamina,lengthening,less,lower,many,midrib,midvein,minutely,nflorescence,noddin,oblique,older,overlapping,pair,paler,papillae,papillose,pericarp,planar,pore,portion,primary,pubescen,rachi,ruit,scar,shallow,slightly,slit,somewhat,space,spaced,strongly,styl,time,tissue,trichome,ud,unit,usually,vein,visible,woody,ympodial,–	adhesion,arrangement,blade,climate,colour,glandular,growth,hair,history,inflorescence,length,life,midpoint,na,number,perennial,position,presence,pubescence,ray,reproduction,rugulose,shape,size,staman,stipe,texture
643	wfo-0001030696	success	202	101	74	128	27	0.366	.5,0.1-0.3,0.4-0.6,0.8-1.2,0.8-1.3,0.8-1.7,0.8-1.8,1-2.5,1-4,1.5-2,1.5-3,2-5.5,3-4,3-6,3.8-4,4-4.5,4-7,acute,andromonoecious,anther,apex,base,blade,brown,calyx,chartaceous,cm,cuneate,cylindrical,deeply,deltate,densely,diameter,elliptical,extra-axillary,fruit,glabrous,gland-tipped,globose,green,hair,herbaceous,inflorescence,lanceolate,length,lobe,lobed,long,margin,midpoint,mm,obtuse,ovate,pale,pedicel,peduncle,petiole,plant,present,prostrate,ray,resprouter,short,simple,sparsely,sprawling,stellate,stellate-pubescent,strongly,style,tube,white,x,yellow	%,0-0.1,0-3,0.05-0.2,0.1-0.4,0.2-1,0.3-1.1,0.5-3,0.7-1,0.7-1.1,0.8-1.5,0.9-1.5,1,1-1.5,1-3,1-9,1.6-2.2,10-16,10-50,12-18,2-3-foliate,2-4,2-8,2-locular,2.3-4,2.5-6,20-35,4-17,4-8,5-merou,7-10,8-18,abaxially,absen,absent,accrescent,acicular,across,adaxiall,adaxially,adult,alyx,apart,armed,articulated,ascending,axe,ba,branche,contiguous,cross-section,decimetre,directed,distall,distally,distributed,eaf,eed,eglandular,exocarp,filament,finger,flower,frui,fruiting,functional,geminate,half,heterostylous,index,juicy,lamina,lateral,less,lobing,longer,lower,markedly,mature,mesocarp,mid-point,midvein,minute,moderately,moist,nearly,nflorescence,oblique,onl,orolla,part,per,placenta,pore,porrect,prickle,probably,pseudo-umbellate,rachi,ruit,semi-circula,sessile,side,solitary,spaced,sparse,stage,stalk,stellae,straight,tal,tamen,tem,thick,thicker,thicknes,throughout,time,unbranched,unit,usuallu,uvenile,vary,vein,wide,winged,yellowish,ympodial	adhesion,arrangement,climate,colour,corolla,form,glandular,growth,height,history,leaf,life,na,number,ovary,position,presence,pubescence,reproduction,seed,shape,size,staman,stem,stigma,stipe,texture
644	wfo-0001030699	success	195	134	106	89	28	0.544	-13,-8.5,0.5-0.7,1-1.5,1-2,12-15,2-3,2.5-3,3-10,3-5,4-5,4-6,4-7,6-,8-10,9-11,acute,anther,antrorse,apex,apical,apically,basal,base,berry,blue,brown,calyx,clavate,cm,cordate,corolla,corymbose,cyme,diameter,elongate,entire,flower,foliaceous,glabrous,glandular,glandular-lanate,globose,green,greenish,grey,growth,half,heterostylous,hirsute,inflorescence,juvenile,lanate,length,like,linear-lanceolate,lobe,lobed,lobed-angulate,long,long-styled,margin,middle,midpoint,mixed,mm,multicellular,nearly,ovary,ovate,ovate-elliptic,ovate-lanceolate,pedicel,peduncle,petiole,plant,poricidal,porrect,prickle,pubescence,purple,ray,rusty,sessile,short-styled,shrub,simple,stalked,stellate,stellate-puberulent,stem,stigma,style,subcoriaceous,subrounded,surface,tapering,tip,tomentose-lanate,trichome,tube,velutinous,winged,x,yellow,¼	0,0.2-0.3,1.4-1,1.5-2,1/10,1/6,11-12,2-2.5,2-4,2-5,3-6,4-6-celled,5,5-6,abaxially,adaxially,anthesi,apart,armed,articulated,bark,branched,brow,cell,compressed,curved,decurrent,densely,discolorous,distal,eaf,eed,erect,exserted,filament,free,fruiting,golden,immersed,induman,known,lengthening,lower,many,minute,multangulate,new,nflorescence,older,onto,ovoid,papillat,partially,perfect,pericarp,plurifoliat,pore,portion,prickly,pubescent,rarely,red,reduced,reflexed,rotate,ruit,scar,single,slightly,slit,spaced,sparsely,staminate,straight,subscabrous,subscandent,subsessile,tall,time,ud,unevenly,unit,upper,vein,villous,without,wood,yellowish,ympodial	adhesion,arrangement,blade,climate,colour,dense,form,fruit,hair,height,history,leaf,life,na,number,papillate,perennial,position,presence,present,reproduction,rugulose,seed,shape,size,staman,stipe,texture
645	wfo-0001030709	success	217	112	83	134	29	0.382	-9,0.1-0.2,0.15-0.5,0.7-1,1-1.2,1-1.6,1-4.5,1.3-1.4,1.6-2.1,1.9-2.8,1/3-1/2,1/4,2-6,2.3-3,5-20,5-6,6-21,6-7,6-8,7-8,8-11,abaxially,acuminate,acute,anther,apex,apically,base,berry,blade,calyx,chartaceous,cm,connivent,cordate,diameter,dull,elliptic,erect,flattened-reniform,fruit,inflorescence,lateral,leaf,length,lobe,lobed,long,margin,maturity,mauve,midpoint,mm,moderately,narrow-deltate,orange-brown,pedicel,peduncle,petiole,poricidal,purple,ray,seed,shrub,simple,size,smooth,sparsely,spherical,stellate,stellate-pubescent,stem,style,surface,tapering,terminal,tip,truncate,tube,upper,way,wide,yellow	-2,-5,0,0-,0-20,0-30,0.2-0.5,0.3-1.5,0.4,0.8-4,0.9-1.5,1-6,1.4-2,1/2-2/3,1/4-1/3,10-14,10-50,2-4,2-5,2-8,2/3-3/4,3-,4-5-merous,5-10,5-7,5-9,6-10,7-9,8-15,adaxially,almost,alyx,ame,apar,apart,ape,apparently,articulated,bark,branched,bright,broad-deltate,brow,c.,conical,cuspidate,deltate,discolorous,distance,drying,eaf,edge,eed,elongating,equal,extending,filament,finely,flower,free,fruiting,glabrescent,glabrous,increasing,infructescence,lanceolate,lengt,lobing,lon,long-acuminat,longer,lower,mature,middle,midvein,nflorescence,occasionally,often,older,one,open,orolla,oung,pair,pendulous,per,perfect,pericarp,perpendicular,pit,pitted,plurifoliat,porrect,portion,prickl,prickle,prickly,primary,red-green,red-orange,reflexed,retrorse,rounded,ruit,scar,secondary,short-styled,shorter,side,slender,sometimes,spaced,spreading,stalk,stalked,straight,tamen,terete,tertiary,time,toward,trichome,unarmed,unit,usually,variously,vary,vein,venation,visible,weakly,woody,yellow-green,ympodial	adhesion,arrangement,climate,colour,corolla,form,glandular,growth,hair,height,history,life,long-acuminate,na,number,ovary,perennial,plant,position,presence,pubescence,reproduction,rugulose,shape,staman,stigma,stipe,texture,ye
646	wfo-0001030714	success	178	128	114	64	14	0.64	-3,.2,/3,0.1-0.3,0.5,0.5-0.8,0.5-1.9,0.7-0.8,1-1.2,1-1.3,1-2.5,1.2-1.5,1.2-4,1.4-3.5,1/3,2-2.5,2-2.6,3-3.5,3-7,7-17,abaxial,acuminate,acute,adaxially,age,along,anther,apex,articulating,bark,basal,base,becoming,beneath,berry,blue,blue-black,branching,clavate,cm,conical,cordate,corolla,dark,densely,denser,diameter,ellipsoid,elliptic,entire,especially,except,flattened,fruit,glabrous,globose,greyish,growth,herbaceous,leaving,lengthening,liana,lobed,long,many,margin,membranous,midrib,minute,minutely,mm,narrowly,new,node,ob-ellipsoid,ob-elliptic,oblique,ovary,overall,pale,papillate,pedicel,peduncle,peg,petiole,pitted,pore,poricidal,pubescent,reniform,ripe,scar,shape,simple,slightly,slit,sparsely,stellate,stem,stigma,style,surface,time,tip,trichome,truncate,uniseriate,vein,vine,violet,way,woody,x,yellow	.5,0.3-0.4,0.8-1,1-1.5,1.5-2,20,5-100,5-6,>,abaxially,aid,anthesi,apar,calyx,campanulate,climbin,cup,eaf,eed,exserted,fide,filament,flower,free,grading,gradually,gree,howard,joined,leaf-opposed,like,lobe,lower,narrow,nflorescence,nodding,occasionally,older,pair,paler,papillat,pedice,per,perfect,planar,plurifoliat,portion,primary,prominent,quadrate,ruit,spaced,strongly,submarginal,tapering,terminal,thickened,tub,tube,twining,ud,unit,widely,ympodial	apart,arrangement,bud,colour,form,green,inflorescence,leaf,length,pubescence,seed,size,spacing,texture
647	wfo-0001030730	success	205	121	94	111	27	0.459	0-1,0.1-0.3,0.5-1,0.6-1.2,0.8-4.4,1-1.2,1-1.7,1.1-1.9,1.5-4.5,11-17,2-2.5,2-2.9,2-4,2.3-6,2.5-7,3-15,4-11,5.5-14.5,5.5-6.5,7-8,9-10.5,acute,adaxially,anther,apex,articulated,attenuate,base,blade,bony,calyx,chartaceous,cm,connivent,cuneate,deltate,densely,depressed,diameter,drooping,entire,extra-axillary,finally,flower,fruit,glabrous,globose,green,grey,hard,herbaceous,inflorescence,lanceolate,later,length,light,lobe,lobed,long,loosely,marbled,margin,mid-point,mm,obtuse,ovate,pale,pedicel,peduncle,perennial,petiole,pink,present,purple,ray,resprouter,rhizomatous,rusty,shallowly,shrub,simple,spreading,stellate,stellate-pubescent,stigma,style,subcordate,surface,thick,tube,x,yellow,yellow-brown,yellowish-green	%,0-0.8,0-1.2,0-1.6,0-6,0.05-0.1,0.05-0.2,0.5-0.9,0.7-1.2,0.8-1.2,1-10,1-3,1-8,1.7-2.3,10,11-20,15-60,2-5,2-8,2-foliate,240-700,3-20,4-7,4-locular,5-40,5-merou,9-15,abaxially,absent,accrescent,acicular,across,adaxiall,alyx,apart,armed,ascending,axe,ba,curved,cylindrical,d.,directed,distall,distributed,eaf,eed,eglandular,filament,finger,first,fruiting,geminate,glabrou,gland-tipped,hair,half,lamina,lateral,less,lon,longer,lower,mature,midpoint,midvein,minute,minutely,nflorescence,oblique,orolla,part,per,perfect,pore,porrect,presen,prickle,probably,pseudo-racemose,rachi,ridged,rugose,ruit,short,slightly,smooth,spaced,sprawling,stage,stalk,stellae,straight,tal,tamen,tem,throughout,time,toward,truncat,unarmed,unbranched,unit,unknow,uvenile,vary,vein,white,wide,yellowish,ympodial	adhesion,arrangement,colour,corolla,form,growth,height,history,leaf,life,na,number,ovary,plant,position,presence,pubescence,reproduction,rugulose,seed,shape,size,staman,stem,stipe,texture,truncate
648	wfo-0001030733	success	130	94	55	75	39	0.423	1-1.2,1-1.5,1-2,1.5-5,2-2.5,3-4,3-5,4-15,4.5-5,6-7,acuminate,acute,anther,apex,base,bi-lobed,broadly,brown,calyx,capitate,cm,conical,coriaceous,corolla,dark,deltate,elliptic,glabrous,globose,green,leaf,lobe,lobed,margin,minutely,mm,narrowly,opposite,ovary,ovoid-reniform,pedicel,petiole,poricidal,shrub,somewhat,stem,stigma,style,surface,thick,tip,treelet,tube,white,x	.5,/4,0.5-1,1.7-2.7,5-8-flowered,6-9,?,abaxially,adaxially,along,anthesi,ape,bark,berry,clearly,closely,decurrent,densely,denser,dia,eaf,eed,ellipsoid,elongate,embryo,erect,exserted,filament,free,fruiting,grayish-brow,lamina,later,lateral,like,lon,long,lower,main,middle,moderately,nflorescence,older,onto,overlappin,pair,papillo,planar,pore,portion,pubescent,rounded,ruit,scar,shaped,simple,smooth,spaced,sparsely,strongly,tall,tear-drop,testa,trichome,ud,unifoliat,uniseriate,unit,vein,visible,way,widest,woody,ympodial,young	adhesion,arrangement,blade,climate,colour,dense,diameter,form,fruit,glandular,grayish-brown,growth,hair,height,history,inflorescence,length,life,midpoint,moderate,na,number,peduncle,perennial,plant,position,presence,pubescence,ray,reproduction,rugulose,seed,shape,size,staman,stellate,stipe,texture,unifoliate
649	wfo-0001030751	success	226	109	82	144	27	0.363	-7,0,0-0.5,0.5-1mm,1,1-2,1-3,11-40,13-50,2-3.5,2.5-4,3-5,3-6.5,5-15,5-8,6-9,7-13,7-15,abaxially,acute,adaxially,anther,apex,attenuate,base,blade,branched,broadly,calyx,campanulate,cm,coarsely,cordate,densely,dentate,diameter,divergently,elliptic,erect,felty-pubescent,form,fruit,glabrous,globose,hair,inflorescence,lanceolate,leaf-opposed,length,lenticular,light,lobe,margin,mm,orange,ovate,pedicel,peduncle,perennial,petiole,pubescence,pubescent,ray,ripe,shallowly,simple,spreading-hirsute,stellate,stellate-pubescent,stellate-woolly,stem,stigma,style,surface,tan,thin-textured,truncate,tube,white,x,yellow,young	-5,.2,.5,0-1,0.1-0.3,0.1-0.4,0.5-1.5,0.6-1.5,1-24,1-4,1/4-1/2,10-15,14-20,2,2-3,2-foliate,20-25,3.5-4.5,4-6,5-6,5-7,8-13,accrescent,acute-,adaxiall,along,also,among,apart,articulated,axe,ba,basally,broad,capitat,cast,cauline,clas,closely,commonly,completely,connivent,covering,cylindrical,deciduou,deltoid,depressed-deltoid,directed,distal,distall,distinct,divergent,dominant,eaf,eed,elongate,entire,equaling,especially,essentially,female-sterile,filament,finally,flesh,flower,foliar,frui,fruiting,geminat,green,inserted,interlobal,interwoven,larger,lateral,less,lignescent,like,long,longest,lower,major,midpoint,minutely,mixture,mostly,multiseriate,nflorescence,numerous,obtuse-tipped,occasionally,often,one,orolla,ovate-lanceolate,per,petaloid,pitted,pore,present,prickl,prickle,prickly,principal,prolonged,purplish,rachi,recurve,ruit,scattered,sessile,short,shorter,side,sinus,small,smaller,somewhat,spaced,sparsely,spreading,stalk,stalked,stellae,stipitate,straight,tal,tamen,tem,termination,tip,tooth-like,trichome,typically,unarmed,unbranched,unit,usually,variable,vary,vein,vivo,wide,ympodial	adhesion,arrangement,capitate,colour,corolla,dense,glandular,growth,height,history,leaf,life,na,number,ovary,plant,position,presence,reproduction,rugulose,seed,shape,size,staman,stipe,texture,ye
650	wfo-0001030772	success	155	90	58	97	32	0.374	-2,.5,0.2-0.8,0.5-1,0.75-1,0.9-1,1-2,1-2.5,1.4-1.6,1.5-2,3-3.5,3-5,4.2-6.5,5-6,9-15,acuminate,anther,apex,attenuate,base,calyx,capitate,cm,corolla,dia,elliptic,fruit,glabrous,globose,green,grey,leaf,lobe,lobed,long-acuminate,long-triangular,margin,minutely,mm,opposite,ovary,ovoid-reniform,pale,pedicel,petiole,pitted,poricidal,shape,shrub,size,stem,stigma,style,surface,tan,tube,white,x	.05,.2,.25,0.25-0.5,0.9-3.1,1.2-5,2-7,5-10-flowered,8-10,acute,anthesi,archin,ba,bark,becoming,beginning,beneath,berry,branch,bud,closely,dark,deflexed,differing,difoliate,eaf,edicel,eed,ellipsoid,erect,extreme,filament,free,fruiting,geminat,gently,impressed,inflorescenc,large,later,lateral,lenticellate,lon,long,lower,main,major,methyl,middle,minor,nearly,nflorescence,node,occasionally,older,one,overlapping,pair,paler,papillo,papillose,per,pore,portion,prominent,reflexed,ripe,rounded,ruit,salicylate,scar,shaped,shining,simple,slender,slightly,smelling,soon,spaced,straight,strongly,swollen,tall,tapering,tear-drop,tip,trichome,ud,uniseriate,unit,usually,vein,widest,wintergreen,woody,ympodial,young	adhesion,arrangement,blade,climate,colour,diameter,form,glandular,growth,hair,height,history,inflorescence,length,life,midpoint,na,number,peduncle,perennial,plant,position,presence,pubescence,ray,reproduction,rugulose,seed,staman,stellate,stipe,texture
651	wfo-0001030781	success	213	125	101	112	24	0.474	1-10,1-2,1-4,1.5-2,1.5-9,1.6-2.2,10-40,15-35,2-20,2.5-14,2.5-3.5,3-4,4-15,5-6,5-7,5-8,7.5-9,abaxially,adaxially,along,anther,apart,articulated,axillary,base,brown,brownish,bud,chartaceous,ciliate,cm,condition,corolla,deep,densely,diameter,distal,dot,drying,especially,finely,fresh,fruit,glabrous,glandular,globose,green,greenish,hair,half,herb,high,lanceolate,leaf,light,like,lobe,long,margin,membranous,midrib,minutely,mm,obovate,odd-pinnate,ovate,ovate-lanceolate,ovoid,papillose,pedicel,peduncle,pentagonal,pilose,plant,puberulent,pubescent,purple,rotate-pentagonal,scattered,seed,size,small,sometimes,somewhat,spaced,sparsely,stem,stigma,straight,style,subovoid,subtending,terminal,tip,tube,violet,white,whitish,wide,x,yellow	0-5,0.2-4,0.5-6,0.5-8,1-1.5,1-12,1-8,1.5-12,2-3,3-6,5-merou,6-7,abruptly,acumen,ag,alyx,apex,apiculate,apparently,axe,berry,blade,borne,broadly,caly,capitat,cell,connivent,covering,cuneate,dark,decreasing,decurrent,digestion,dorsally,eaf,edge,eed,elliptic,end,enzyme,erect,exceeding,filament,flat,flower,folded,forked,geminat,generally,glabrou,gradually,gray-green,green-white,hair-like,homostylous,honeycomb-shaped,interjected,larger,lateral,leaflet,lengthening,living,low-growin,lower,make,mucilaginous,narrowed,nflorescence,orbicular,orolla,pair,perfect,petiole,petiolulate,plurifoliate,pointed,pore,poricidal,rachi,rarely,removed,rounded,ruit,sessile,seudostipule,short,simple,singly,slightly,slit,specimen,stamen,ste,stolo,tall,tamen,tem,testal,thick,throughout,toward,tri-,tuber,typically,unit,unwinged,usually,vary,wall,wet,ympodial	adhesion,arrangement,calyx,capitate,colour,form,growth,height,history,inflorescence,length,life,na,ovary,perennial,position,pseudostipule,pubescence,reproduction,rugulose,shape,staman,surface,texture
652	wfo-0001030782	success	198	99	73	125	26	0.369	0.4-1.5,1-3,1.3-1.6,1.5-2,1.5-7.5,11-47,13-22,15,2,2.2-4,3-10,4.6-26,6-8,7-15.6,abaxially,adaxially,anther,axillary,brownish,bud,clavate,cm,condition,coriaceous,corolla,dark,deep,diameter,drying,elliptic,fresh,fruit,glabrescent,glabrous,globose,green,greenish,hair,herb,lanceolate,leaf,light,lilac,lobe,long,medium,mm,mottled,odd-pinnate,ovate,ovoid,pedicel,peduncle,pentagonal,petiole,plant,purple,ripe,rotate,scarce,seed,short,size,stigma,style,subtending,terminal,tube,white,whitish,wide,x,yellow	0-1,0-7,1-2,1-5,1-6,1.2-3.9,1.6-4.6,12-30,2-3,2.4-11.5,3-5,4-11.6,4-6,5-20,5-merou,abaxiall,acumen,acuminate,acute,ag,along,alyx,apart,apex,apparently,arranged,articulated,asymmetric,attenuate,axe,base,basiscopic,bead,berry,blade,broadly,capitat,cell,connivent,covering,cuneate,decreasing,digestion,distal,dorsally,eaf,edge,eed,enzyme,exceeding,filament,flat,flower,folded,forked,geminat,generally,glabrou,green-white,hair-like,hal,half,high,homostylous,honeycomb-shaped,inconspicuous,interjected,lateral,leaflet,lengthening,like,living,lower,make,moniliform,mucilaginous,multiple,necklace,nflorescence,orbicular,orolla,pair,perfect,petiolulate,plurifoliate,pore,poricidal,prominently,rachi,removed,rounded,ruit,second,sessile,seudostipule,side,slit,smaller,sometimes,spaced,specimen,stamen,stolon,straight,subequal,tal,tamen,tem,testal,thick,throughout,tip,tissue,totally,toward,tri-,tuber,typically,unit,usually,vary,wall,wet,winged,ympodial	abaxial,adaxial,adhesion,arrangement,calyx,capitate,colour,form,growth,height,history,inflorescence,length,life,na,ovary,perennial,position,pubescence,reproduction,rugulose,shape,staman,stem,surface,texture
653	wfo-0001030802	success	171	102	67	104	35	0.392	0.5-0.75,0.5-1,0.75-1,1,1-1.1,1-1.2,1-1.5,2-2.5,2-3,2-5,2.5-3,3-4,3-6,acuminate,acute,anther,apex,base,brown,calyx,cm,cordate,corolla,deeply,dia,difoliate,flattened-reniform,fruit,glabrous,glandular,globose,heart-shaped,internodal,leaf,length,lobe,lobed,long-triangular,margin,minutely,mm,obconic,ovary,ovoid,pale,papillate,pedicel,petiole,pitted,plant,poricidal,pubescent,red,shrub,somewhat,stem,stigma,style,subshrub,surface,tip,tube,unifoliate,white,x,yellow,yellowish	.3,.5,.5mm,0,0.25-0.4,0.5-1.5,0.7-1cm,0.9-1,3-3.5x,4-5mm,4-6,5-10-flowered,abaxially,abrupt,adaxially,along,anthesi,appearing,bark,basal,becoming,beginning,beneath,berry,bud,campanulate,cucullate,deflexed,densely,denser,dry,eaf,edicel,eed,ellipsoid,evenly,except,exerted,exudate,filament,filiform,free,fruiting,geminat,gland,glandurla,halfway,hanging,incrassate,inflorescenc,invest,irregularly,lamina,later,lateral,line,live,long,lower,m.,main,markedly,material,midvein,near,nflorescence,older,pair,palmate,papillose,per,persistently,pore,portion,prominent,pubescen,raised,reddish,ruit,scar,shaped,simple,single-celled,slender,soon,spaced,specimen,stigm,straight,strongly,tapering,tear-drop,tipped,trichoem,trichome,ud,uniseriate,unit,variable,vein,widely,woody,ympodial,young	0.7-1,3-3.5,4-5,adhesion,arrangement,blade,climate,colour,diameter,form,growth,hair,height,history,inflorescence,life,midpoint,na,number,peduncle,perennial,position,presence,present,pubescence,ray,reproduction,rugulose,seed,shape,size,staman,stellate,stipe,texture
654	wfo-0001030803	success	185	99	71	114	28	0.384	0.2,0.5,1.5,2.5,5,abaxially,adaxially,almost,anther,anthesi,base,broadly,brown,calyx,campanulate,chartaceous,cm,connivent,corolla,diameter,elliptic,flattened-reniform,glabrous,globose,green,hair,imparipinnately,leaf,light,lobe,lobed,long,minute,minutely,mm,ovate,papillae,pedicel,peduncle,pericarp,petiole,pinnatifid,pitted,puberulent,ranging,rarely,rounded,rugose,shape,simple,size,slender,spreading,stellate,stem,stigma,strongly,style,surface,tapering,terminal,truncate,tube,variable,vine,yellow,yellowish,×,–10,–16,–5	.5,0.2–0.3,0.3,0.4,0.5–1.5,0.75–1,0.9–1.5,1,1-,1.5-,1.5-3,1/3,10967,10–15,1–2.5,1–3,20–40,2–,3-6,3–10,3–4,3–5,4–10,6–12,6–8,7–9,?,absent,acuminate,acute,adaxiall,adjacent,ag,alyx,apex,armed,articulated,axe,basal,becoming,berry,blade,branched,bud,confluent,connecting,corresponding,dr.,eaf,eed,elongating,entire,equal,exserted,filament,flower,fruiting,hinton,internode,lanceolate,lateral,leaflet,lengthening,long-styled,lower,major,margin,middle,midri,midrib,narrowly,nflorescence,often,orolla,outline,petiolule,pinnate,plurifoliat,pointed,pore,poricidal,present,prickle,purple,rachi,recurve,recurved,ruit,sharply,side,slit,somewhat,stout,straight,subwoody,swolle,tamen,time,tip,tissue,triangular,truncat,turbinate,unit,usually,variously,vary,vein,wide,widest,wing,wood,woody,ympodial	-5,0.2-0.3,0.75-1,1-2.5,1-3,10-15,3-10,3-5,6-12,6-8,adhesion,arrangement,colour,dry,form,fruit,growth,inflorescence,length,na,ovary,position,presence,pubescence,rugulose,seed,staman,texture
655	wfo-0001030809	success	154	107	71	83	36	0.461	0.2,0.5-1,1-1.5,1.2-1.4,1.4-1.5,1.5-3.5,4.5-5,6-8,8,9.9-12,acute,anther,apex,appearing,base,beneath,broadly,calyx,clavate,cm,corolla,deltoid,dia,elliptic,falcate,fruit,glabrous,globose,golden,green,hair,lateral,leaf,like,lobe,lobed,long,long-papillose,main,midrib,mm,nearly,opposite,ovary,ovate,overtopping,pedicel,petiole,pubescent,scattered,shining,shoot,size,small,stem,stigma,style,terminal,tip,tomentose,tree,triangular,trichome,tube,underside,unequal,uniseriate,vein,white,x,yellow-brown	.5,1-1.25,1.5-2.4,2-2.5,2.3-5.5,20-60-flowered,5-8,across,along,also,anthesi,apar,bark,berry,branched,caly,campanulate,curl-tipped,curved,dark-papillo,deciduous,deflexed,dense,densely,difoliate,distally,eaf,edicel,eed,ellipsoid,erect,especially,evenly,exserted,filament,free,fruiting,geminat,hidden,interpetalar,known,large,leave,lon,lower,major,markedly,mature,membranous,middle,minor,minutely,nflorescence,older,one,planar,pore,poricidal,portion,present,round,ruit,scar,several,shinin,simple,sinus,slender,slightly,soon,spaced,straight,tall,tapering,three,time,two,ud,unit,wide,widest,ympodial,young	0.5,2,adhesion,arrangement,blade,climate,colour,dark-papillose,diameter,form,glandular,growth,height,history,inflorescence,length,life,margin,midpoint,na,number,peduncle,plant,position,presence,pubescence,ray,reproduction,rugulose,seed,shape,staman,stellate,stipe,surface,texture
656	wfo-0001030810	success	191	104	58	133	46	0.304	abaxially,acute,adaxially,anther,apex,axillary,base,bipinnate,blade,blue,brown,calyx,clavate,cm,colour,dark,densely,diameter,elliptic,elliptical,flattened,fleshy,fruit,glabrous,globose,green,hair,leaf,lobe,margin,mm,moderately,oblong,older,pale,pedicel,peduncle,pentagonal,petiole,pinnate,pitted,pubescent,rounded,shallowly,shrub,size,stem,stigma,style,subglabrous,surface,tomentose,tube,unknown,violet,woody,x,yellow	0.2,0.2–0.3,0.3,0.4,0.5–,0.5–0.8,0.6–1.0,0.7–1.4,0.8–5.5,0.95–2.0,0–,1,1.0–1.5,1.0–2.0,1.0–3.0,1.1–2.0,1.1–2.2,1.2–1.5,1.5–1.9,1–2,1–3,1–5,2.9–4.5,20–100,2–3,2–4,3.0–5.0,3.3–5.5,3.3–8.5,3.5–4.6,3–19,4–14,4–5,4–7,5,5–15,5–30,5–32,6–10,6–22,7–10,7–11,8–10,absen,accrescent,adaxiall,ag,along,anthesi,apart,articulated,axe,ba,borne,branched,cell,chartaceous,connivent,cylindrical,decreasing,denser,divided,eaf,eed,equal,erect,especially,filament,flower,geminat,greyish,half,hig,indumentum,irregular,leafy,lon,long,longitudinal,lower,m.,midrib,midvein,multicellular,narrow,nflorescence,obtu,occasionally,opening,opposed,orolla,oung,pair,perfect,pinnae,plurifoliate,pore,poricidal,primary,rarely,reflexed,ruit,secondary,shaped,shiny,shoot,side,simple,slit,sometimes,spaced,sparsely,stone,straight,tamen,tardily,tear-drop,time,tip,unicellular,uniseriate,unit,vary,white,wide,wing,ympodial,–2.5,–3,–3.4,–4.5,–5.0,–8	0.8-5.5,1.0-2.0,1.0-3.0,1.1-2.2,1.2-1.5,1.5-1.9,20-100,3.3-5.5,3.3-8.5,3.5-4.6,4-14,4-7,5-32,7-10,8-10,adhesion,arrangement,climate,corolla,form,glandular,growth,height,history,inflorescence,length,life,midpoint,na,number,ovary,perennial,plant,position,presence,pubescence,ray,reproduction,rugulose,seed,shape,staman,stellate,stipe,texture,young
657	wfo-0001030814	success	223	127	100	123	27	0.448	-0.5,.5,.5-3,0-0.2,0-0.3,0.1-0.2,0.1-0.3,0.3-0.6,0.4,0.5-1.5,1-4,1.5,1.5-2,1.8-3.5,1/8-1/3,10-12,15-20,16-30,2-3,23-31,3-5,4-5,5-15,5.5,6-15,6-9,7-11,almost,anther,apart,attenuate,base,becoming,blade,broadly,calyx,campanulate,cm,connivent,cultivated,cylindrical,densely,diameter,divided,elongating,extra-axillary,felty,flower,form,fruit,glabrescent,glabrous,globose,immature,inflorescence,interwoven,lanceolate,length,lenticular,lignescent,long,minutely,mm,narrower,oval,ovate,ovoid,pedicel,peduncle,perennial,petiole,pitted,pubescence,pubescent,ray,ripe,sericeous,sessile,short-stalked,simple,simple-,somewhat,soon,specimen,stellae,stellate,stellate-,stellate-pubescent,stem,stigma,style,tan,thin-textured,tube,unbranched,unknown,weakly,white,x,yellow	-1.5,-3.5,-4,1-2,10-25,14-15,15-16,2-foliate,3-7,4-,4-6,5,5-12,5-8,5-9,6-locular,7.5-11,abaxially,absent,acute,acute-tipped,adaxiall,adaxially,along,apex,apiculate,appressed,articulated,ascending,asymmetric,axe,ba,basal,become,branched,bulge,capitat,capitate-glandular,coarsely,dentate,depressed-deltoid,developed,diffusely,directly,distal,distall,divergently,eaf,eed,elongate,entire,essentially,female-sterile,filament,geminat,hair,hirsute,inserted,interlobal,intermixed,invested,lateral,less,lobe,lon,lower,major,margin,mature,midpoint,midvein,minute,much,nflorescence,obsolete,obtuse,obtuse-tipped,often,orolla,oung,ovate-lanceolate,per,pericarp,pore,prominent,rachi,replaced,rip,rounded,ruit,scattered,short,shorter,side,similar,simple-haired,sinus,slightly,small,sometimes,spaced,spreading,stalk,stellate-pubescen,strongly,swollen,tal,tamen,termination,time,trichome,truncate,unarme,unarmed,uniseriate,unit,usually,vary,vein,weak,wide,ympodial,young	abaxial,adaxial,adhesion,arrangement,capitate,colour,corolla,dioecious,growth,height,history,leaf,life,number,ovary,plant,position,presence,present,reproduction,rugulose,seed,shape,size,staman,surface,texture
658	wfo-0001030822	success	146	91	58	88	33	0.397	0-0.5,0.4,0.5-1.5,0.8-1,0.9-1,1-1.5,1.5-2,11-15.5,2-2.5,2-5,3-3.5,3.5-7,5-6,acute,anther,apex,attenuate,base,broadly,calyx,clavate,cm,corolla,cup,deltate,elliptic-obovate,flattened-reniform,glabrous,globose,green,inflorescence,internodal,leaf,lobe,lobed,margin,minutely,mm,open,ovary,pale,pedicel,petiole,pitted,revolute,shaped,shrub,size,stem,stigma,style,surface,tan,tear-drop,tube,white,x,yellowish-brown	.2,0.1-0.2,0.4-1,1-1.2,2-3.8,3-5,5-7,8-9,abaxially,adaxially,anthesi,ba,beneath,berry,closely,clustered,completely,cucullat,cucullate,decurrent,deflexed,dia,differing,difoliate,eaf,edicel,eed,erect,exserted,filament,filiform,fleshy,flower,free,fruiting,geminat,incrassate,inflorescenc,later,lateral,lon,long,long-ellipsoid,lower,main,major,middle,minor,minute,near,nearly,nflorescence,occasionally,older,onto,opposite,pair,papillo,papillose,perhaps,planar,pore,poricidal,portion,present,red-papillose,ruit,scar,shiny,simple,slightly,somewhat,spaced,sparsely,strongly,tall,tapering,tip,ud,unit,usually,vein,widest,winged,woody,yellowish,ympodial,young	adhesion,arrangement,blade,climate,colour,diameter,form,fruit,glandular,growth,hair,height,history,length,life,midpoint,na,number,peduncle,perennial,plant,position,presence,pubescence,ray,reproduction,rugulose,seed,shape,staman,stellate,stipe,texture
659	wfo-0001030846	success	214	127	101	113	26	0.472	-0.8,-11,-4,0.1,0.2-0.4,0.5-0.7,1-2,1-2.5,1-3,1-4,1.5-2,10-15,2.5-3,3-,3-3.5,3/4,4-4.5,4-6,5-15,5-8,6-18,8-10,abaxially,acute,adult,angulate,anther,apex,assymetric,basal,base,beige,berry,brown,calyx,chartaceous,clavate,cm,corolla,cuneate,dark-green,decurrent,diameter,elliptic,entire,flattened,flower,fruit,glandular,glandular-viscous,growth,heterostylous,hirsute,inflorescence,juvenile,leaf,like,linear-lanceolate,lobe,lobed,margin,midpoint,mm,nearly,oblanceolate,oblong,obovate,opposite,ovary,ovate-elliptic,pedicel,peduncle,perfect,petiole,plant,poridical,puberulent,pubescence,pubescent,ray,reddish,reniform,rhombic,rugose,rusty,scabrous,shrub,simple,slightly,stellate,stem,stigma,style,subglobose,surface,tip,tomentose,tube,white,x,¼	.3,0.1-0.3,0.2-0.5,0.8-1,1-1.2,1-1.5,1-2-celled,1-multicellular,2-10,2-3,4-5,6-8,abaxial,acuminate,adaxially,anthesi,anthesisflower,antrorse,apart,apical,armed,articulating,bark,branching,brownish,cream,curved,deciduous,densely,discolorous,distal,eaf,eed,erect,exserted,ferruginous,filament,free,fruiting,glabrescent,gland,golden,grey,lanceolate,larger,lateral,lengthening,linear,long,long-styled,longer,lower,many,midrib,mixture,much-branched,multiangulate,multicellular,near,new,nflorescence,obliqu,obverse,ochraceous,older,oval,papillat,pendant,pericarp,persistent,plurifoliat,pore,porrect,portion,prickle,prickly,prominent,rachi,raised,red,reflexed,relatively,rest,rotate,ruit,scar,sessile,short,short-styled,similar,slit,sometimes,sparsely,stalked,staminate,stipitate,straight,terete,testa,thick,time,tomentose-velutinous,trichome,ud,unarmed,undulate-reticulate,unit,upper,wide,without,yellowish,ympodial,young	adhesion,arrangement,blade,climate,colour,form,hair,height,history,length,life,na,number,papillate,perennial,position,presence,present,reproduction,rugulose,seed,shape,size,staman,stipe,texture
660	wfo-0001030850	success	240	115	89	151	26	0.371	0.1-0.2,0.1-0.3,1-2,1-2.5,1-8,1.2,1/3,2-25,3-3.7,3-5,3.5-6,4,5-12,5-13,6-11,6-8,7-15,7-22,8.5-11.5,abaxial,abaxially,acuminate,anther,apex,base,berry,blade,bright,calyx,chartaceous,climber,cm,connivent,cordate,cuneate,deltate,densely,diameter,elliptic,equal,flattened-reniform,fruit,glabrescent,lateral,leaf,length,lobe,lobed,long,margin,maturity,mauve,midpoint,mm,moderately,obtuse,orange,orange-brown,ovate,pale,pedicel,peduncle,petiole,plant,poricidal,purple,ray,red-brown,red-orange,scandent,shrub,simple,smooth,sometimes,sparsely,spherical,stellate,stellate-pubescent,stem,style,surface,tapering,terminal,tip,truncate,tube,upper,wide,yellow	-6,.5,/4,0-,0-0.5,0-30,0-40,0.1-0.4,0.1-0.5,0.2,0.5-2,00,1-,1-10,1-20,1-3,1-4,1-5,1.5,1.5-2.5,1/2,1/2-1/5,1/2-3/4,1/3-3/,1/3-3/4,10-100,10-20,15-20,2-15,2-3,2-4,2-6,3-10,3-15,3-4,3-6,4-8,5-10,5-merous,8-20,acuminat,acute,adaxial,alyx,andromonoecious,apar,apart,apically,apparently,articulated,bark,branched,broad-deltate,broadly,brow,cell,cream,curved,dark,difoliate,discolorous,distal,distance,drying,eaf,eed,elongate,elongated,elongating,entire,erect,extending,filament,flattened,flower,free,fruiting,geminat,gently,glabrous,gray,green,green-brown,hermaphrodite,heterostylous,infructescence,lobing,long-styled,longer,lower,lowermost,marking,mature,midvein,nflorescence,oblong,obovate,often,older,one,open,orolla,oung,outline,pair,pendulous,per,pericarp,pit,porrect,portion,prickl,prickle,prickly,primary,pubescent,raised,red-green,reduced,rounded,ruit,scar,secondary,sessile,short-styled,shorter,side,small,somewhat,spaced,spreading,stalk,stalked,staminat,stout,straight,tamen,terete,tertiary,time,trichome,unit,variously,vary,vein,venation,visible,way,woody,ympodial,young	adhesion,arrangement,climate,colour,corolla,form,glandular,growth,hair,height,inflorescence,na,number,ovary,position,presence,present,pubescence,rugulose,seed,shape,size,staman,stigma,stipe,texture
661	wfo-0001030867	success	259	126	107	152	19	0.413	.3,.5,0-,0.5,0.6-1.5,1-1.5,1-2,1-2.5,1.5-4.5,12-15,14,18,2.5-3,2.5-3.5,3-4,3.5-8.5,4-4.5,4-6,4.5-14,6-7,<,abaxially,abundant,acute,adaxially,anther,apex,attenuate,base,calyx,chartaceous,cm,corolla,cup-shaped,densely,diameter,elliptic,equal,expanded,flower,fruit,glabrous,globose,green,growth,herbaceous,immature,inflorescence,interpetalar,lateral,leaf,leathery,length,like,lobe,lobed,long-styled,margin,mature,membranous,midpoint,mm,mottled,narrowly,occasionally,opposite,ovary,ovoid,pale,pedicel,peduncle,pentagonal,petiole,plant,pubescent,ray,reniform,sessile,shallowly,short-stalked,short-styled,shrub,size,slightly,somewhat,sparsely,stellate,stellate-pubescent,stem,stigma,style,subshrub,tan,tapering,thick,tip,tissue,translucent,triangular,trichome,tube,violet,white,whitish,x,yellow,yellowish	-1/3,-6,.25,0.3,0.6,1,1-5,1.5,1/4,10,100,2-2.5,2-3,2-5,2-6,3-5,4,4-5,5-25,5-6,5-merous,6,>,acumen,alyx,andromonoecious,anthesi,apart,approximately,area,armed,articulated,band,bark,berry,bi-lobe,borne,branched,broad-based,brown,bud,cast,cell,concolorous,curve,curved,dark,decurrent,denser,difoliate,directed,distal,distall,distance,dry,drying,eaf,easily,eed,either,ellipsoid,elongate,erect,exposed,exserted,filament,flowering,free,fruiting,functionally,geminate,glabrescen,greatest,greyish,halfway,hermaphroditic,heterostylous,infructescence,internodal,lamina,larger,less,lon,long,longer,lower,lowermost,mal,markedly,maturing,maturit,midrib,midvein,near,new,nflorescence,nodding,often,older,onto,orolla,outline,pair,pendent,per,pericarp,petal,planar,pore,poricidal,portion,prickle,prickly,primary,re,reflexed,rest,ruit,scar,shap,side,simple,sinuate,small,spaced,splitting,still,stouter,straight,strongly,surface,tall,tamen,testal,thickened,thinne,type,ud,unevenly,unit,upper,usually,vary,varying,vein,visible,way,wide,winged,woody,ympodial,¼	adhesion,bi-lobed,blade,climate,colour,form,glandular,hair,height,na,number,position,presence,pubescence,seed,shape,staman,texture,ye
662	wfo-0001030871	success	248	141	109	139	32	0.44	0.2-0.4,0.3-4,0.7-1.3,0.7-2.5,1-1.3,1-18,1.3-2,1.3-3,1.5-6,1.8-2.6,1/2-3/4,2-3,2-8,3-32,3-4.4,3.5-14,30,4.5-6.5,5-33,6-40,abaxially,abruptly,acuminate,acute,adaxially,anther,apex,attenuate,base,becoming,berry,blade,blunt-tipped,brown,calyx,campanulate,chartaceous,cm,conical,continued,corolla,dark,deltoid,densely,diameter,due,echinoid,entire,fleshy,fruit,glabrescent,granular-tomentose,green,greenish,growth,hair,honeycombed,inserted,lateral,leaf,length,lobe,long,margin,mixed,mm,mostly,multangulate,narrowly,oblong,obtuse,orbicular,ovate,pale,pedicel,peduncle,petiole,present,probably,pubescent,purple,ray,reniform,reticulate-punctate,ripe,rotate-stellate,scabridulous,sessile,short,short-stalked,shrub,simple,stellate-tomentose,stem,stigma,style,suborbicular,terminal,tomentose,tree,tube,velutinous,violet,way,white,x,yellow,yellowish,young	.2-3,.8-3.5,.9-1.2,/30-1/5,0-120,0.4-1.8,0.6-1.5,1.4-2.7,1.5-3,1.8-3.5,1/2,1/4,1/4-1/3,11,2.8-4.5,3-5,3-6,4.8-9.5,5-7,7-12,9-13,accrescent,adaxial,ag,along,anthesi,apart,apical-lateral,apparently,appressed,appressed-tomentose,articulated,axe,axillary,ba,bark,branch,branched,bud,capitat,closely,decurrent,dehiscing,dendritic-echinoi,dendritic-echinoid,dendritic-multangulate,directed,distal,eaf,earl,early,echinoi,eed,elliptic,elongate,equal,erect,evident,exserted,extend,filament,flower,free,fruiting,glabrescen,glabrous,grayish,held,high,introrse,large,lobed,long-,long-stalked,longer,longitudinal,lower,m.,main,midvein,minute,multangulat,nearly,nflorescence,nodding,occasionally,often,older,open,orbicula,orolla,ovate-lanceolate,overlapping,partly,perfect,plait,plurifoliate,pore,porrect-stellate,prominent,rachi,rather,reflexed,relatively,ruit,runk,short-,side,slit,small,sometimes,somewhat,soon,spaced,sparingly,sparsely,splitting,stamen,striate,strongly,subglobose,sulcate,suture,tamen,terete,testa,thick,thick-stalked,thin-stalked,time,toward,unarme,unarmed,unit,usually,vary,vein,wide,ympodial	adhesion,arrangement,capitate,climate,colour,form,glandular,height,hermaphroditic,history,inflorescence,life,midpoint,na,number,ovary,perennial,plant,position,presence,pubescence,reproduction,rugulose,seed,shape,size,sparing,staman,stellate,stipe,surface,texture
663	wfo-0001030872	success	166	80	57	109	23	0.343	.5,0.5-1,0.8-1,1-1.2,1-1.5,1.2-1.5,1.5-5,12-18,2-5,4-6,5.5-7,6-12.5,anther,base,black,broadly,brown,calyx,cm,corolla,crateriform,dark,densely,dia,elliptic,glabrate,glabrous,globose,green,leaf,lobed,minutely,mm,nearly,opposite,ovary,ovate,papillose,pedicel,petiole,poricidal,puberulent,red-glandular-puberulent,reddish-glandular,reddish-glandular-puberulent,shining,size,small,soon,stem,style,tip,tree,treelet,tube,white,x	0.5,0.8-2,1-2,1.2-3,1.5-2,3-7,4-6-flowered,5-6,acuminate,acute,adaxial,age,along,anthesi,apex,appearing,area,bark,beginning,berry,caly,center,closed,closely,completely,consisting,corky,cucullate,darker,deflexed,deltoid,difoliate,dry,eaf,edicel,eed,ellipsoid-ovoid,erect,exserted,filament,fleshy,free,fruiting,full,geminat,hooded,incurved,inflorescenc,known,large,lenticel,lenticellate,less,like,live,lobe,lon,long,lower,major,margin,material,middle,minor,nerve,nflorescence,oblique,older,one,overlapping,pair,pale,paler,petal,planar,pore,portion,primary,prominent,proximal,raised,rather,relative,rest,ridge,rounded,ruit,scar,shaped,shorter,side,simple,slightly,spaced,specimen,stigma,straight,strongly,styl,tall,tapering,tear-drop,thickened,ud,unit,widest,woody,ympodial,young	arrangement,colour,diameter,form,fruit,growth,height,history,inflorescence,length,life,na,peduncle,perennial,plant,position,pubescence,reproduction,rugulose,seed,shape,surface,texture
664	wfo-0001030877	success	223	122	96	127	26	0.43	0.1-0.6,0.1-1,0.2-0.6,0.3-0.4,0.5-0.8,0.5-1,0.7-1.4,1-1.5,1-2,1.5-2.4,1.5-3,2,2-3,2.2-2.7,2.9-8,5-6,6-11,6-15,6-9,7-9,7.5-10,abaxially,absent,acute,adaxially,andromonoecious,anther,apex,attenuate,base,blade,broadly,calyx,chartaceous,cm,connivent,cuneate,cylindrical,densely,diameter,entire,erect,extra-axillary,flattened,fruit,glabrous,gland-tipped,globose,green,hair,inflorescence,lanceolate,leaf,length,lobe,lobed,loosely,margin,midpoint,midrib,minutely,mm,moderately,obtuse,ovate,pale,pedicel,peduncle,perennial,petiole,plant,present,pubescent,purple,ray,reticulate,rhizomatous,rotate-stellate,rusty,shallowly,short,shrub,simple,sparsely,stellate,stellate-pubescent,stem,stigma,style,surface,triangular,tube,weakly,x,yellow,yellowish-green	%,0-0.2,0-0.5,0-10,0-15,0-4,0-5,0.1-0.4,0.4-0.5,0.4-0.8,0.5-0.6,0.7-1.6,0.9-1.2,1-1.3,1-1.4,1-3,1.5-2,1.8-2.6,10-14,10-30,10-40,17-26,2-15,2-3-locular,2-foliate,2.9-4.8,3-10,4-10,4-6,4-8,5,5-11,5-merou,6-12,8-14,8-15,8-9,9-14,9-15,absen,abundant,accrescent,acicular,across,adult,alyx,anvil-shape,apart,articulated,ascending,axe,ba,branch,branche,brown,capitat,cross-section,directed,distall,distributed,dm,dult,eaf,eed,eglandular,exocarp,filament,finger,flower,fruiting,functional,geminat,half,heterostylous,index,interpetalar,juicy,juvenile,lamina,lateral,less,lobing,long,longer,lower,mature,mesocarp,mid-point,midvein,minute,moist,nflorescence,oblique,orolla,pair,part,per,placenta,pore,porrect,prickle,pseudo-racemose,rachi,ruit,side,spaced,stalk,stalked,stellae,straight,tal,tamen,thick,throughout,time,tissu,tissue,unarme,unarmed,unbranched,unit,upper,vary,vein,wide,yellowish,ympodial	adhesion,arrangement,capitate,climate,colour,corolla,form,glandular,growth,height,history,life,na,number,ovary,position,presence,pubescence,reproduction,rugulose,seed,shape,size,staman,stipe,texture
665	wfo-0001030882	success	144	97	63	81	34	0.438	0.5-1,0.5-1.1,0.8-1.1,0.9-1.1,1-1.3,1-1.5,1-4,2,2.2-4.6,3-3.5,3/4,6.5-15.6,acuminate,anther,apex,attenuate,base,calyx,capitate,cm,conical,corolla,crenulate,deltoid,dia,elliptic,fruit,glabrous,globose,green,leaf,lightly,lobe,lobed,margin,minutely,mm,narrowly,occasionally,opposite,ovary,ovoid-reniform,pale,papillose,pedicel,petiole,pitted,shaped,short,shrub,size,small,stem,stigma,style,surface,tan,tear-drop,tree,tube,way,white,x	.1,.5,0.5-0.75,0.75-1,0.8-2.4,1.6-2,2-5.4,2-6,8-12,?,accrescent,anthesi,bark,beginning,beneath,berry,closely,deflexed,differing,difoliate,eaf,edicel,eed,erect,exserted,extreme,filament,free,fruiting,geminat,inflorescenc,lateral,lon,long,lower,main,major,middle,minor,nearly,nflorescence,older,one,overlapping,ovoid,pair,paler,papillo,peelin,planar,pore,poricidal,portion,prominent,raised,ruguse,ruit,scar,simple,slender,slightly,soon,spaced,straight,tall,tapering,terminal,thick,thickened,tip,transversely,truncate,tub,ud,unit,vein,widest,woody,yellowish,ympodial,young	5.5,adhesion,arrangement,blade,climate,colour,diameter,form,glandular,growth,hair,height,history,inflorescence,length,life,midpoint,na,number,peduncle,perennial,plant,position,presence,pubescence,ray,reproduction,rugulose,seed,shape,staman,stellate,stipe,texture
666	wfo-0001030883	success	179	84	58	121	26	0.324	0.5-3,0.5-5,1-1.1,1-1.2,1-1.3,1-1.5,1.5-2,1.5-3.5,18-44.5,2-5,3-3.5,5-6,9.5-27.5,anther,brown,calyx,clavate,cm,corolla,dark,elliptic,fruit,glabrous,globose,green,hard,inflorescence,leaf,lobe,lobed,long-acuminate,minutely,mm,narrowly,opposite,ovary,ovate,ovoid-reniform,pedicel,petiole,pitted,plant,puberulent,russet,seed,shaped,shrub,size,stem,stigma,style,surface,tear-drop,triangular,tube,white,woody,x	-3,.05,.1,.5,1-4,10-18,20-50-flowered,3-4,3/4,accrescent,across,acuminate,acute,anthesi,apart,apex,appearing,approximatately,arching,bark,base,becoming,berry,branched,bu,cell,collapsed,collection,deflexed,dia,differing,difoliate,dry,eaf,edicel,eed,epidermal,erect,evenly,filament,finely,fleshy,free,fruiting,furcate,geminat,geminate,glandular,hollow,imbedded,laminar,large,later,lateral,lenticellat,less,like,little,live,living,lon,long,lower,main,malodorous,markedly,massive,material,middle,midrib,minute,nflorescence,oblique,occasionally,older,pair,pale,papillate,papillo,papillose,perpendicular,petaloid,placenta,pore,poricidal,portion,present,proximal,pulp,quite,rather,reflexed,reticulate,ruit,scar,slender,slightly,sometimes,soon,spaced,stout,straight,strongly,tall,tan,tapering,thick,time,tip,trichome,two,ud,uniseriate,unit,upper,vein,wall,way,widest,ympodial,young	0.5,2-3,adhesion,arrangement,colour,diameter,form,growth,height,history,length,life,na,number,peduncle,perennial,position,presence,pubescence,ray,reproduction,rugulose,shape,staman,stellate,texture
667	wfo-0001030884	success	218	109	83	135	26	0.381	0.4-3,0.5,0.5-1.2,0.8-1,0.9-5,1-1.5,1.5,1.5-2,1.5-2.5,2-5,4-13,4-5,4.5-5,5.5-7,6-25,6-8,9-11,abruptly,acute,anther,apex,base,berry,blade,brown,calyx,capitate,cm,conical,connivent,dark,densely,di-,diameter,elliptic,glandular,green,greenish,growth,inflorescence,lateral,leaf,length,lobe,lobed,long,long-triangular,margin,mature,midpoint,minutely,mm,moderately,ovary,ovoid-reniform,pedicel,peduncle,petiole,plant,present,prickly,pubescent,ray,reddish,sagittate,shallowly,shrub,simple,size,sparsely,spherical,stellate,stellate-pubescent,stem,stigma,style,tapering,treelet,trifoliate,tube,white,wide,yellow	.2,.5,.7,0.3,0.3-0.5,1,1-1.2,1-3,10,100,2,5,5-30,5-6,5-merous,6-10,7-8,>,abaxial,abaxially,adaxial,adaxiall,along,also,alyx,andromonoeciou,anthesi,apar,arme,articulated,bark,basal,broad-based,c.,curved,decurrent,differing,directed,discolorous,distal,eaf,eed,equal,extend,extending,filament,flower,flowering,free,fruiting,geminate,glabrous,gray-tinged,gree,half,herbaceous,heterostylous,infructescence,leafy,like,long-stalked,long-styled,lower,magnification,midrib,minute,mixture,new,nflorescence,node,occasionally,older,one,onto,open,orolla,oung,outlin,pair,pale,papillat,per,pore,poricidal,porrect,portion,prickle,primary,principal,red,reflexe,reflexed,regularly,rest,ruit,scar,scattered,sessile,shap,short,short-stalked,short-styled,similar,slender,spaced,spreading,stiff,still,strongly,surface,tall,tamen,tannish,time,tip,trichome,unarmed,unicellular,uniformly,uniseriate,unit,upward,usually,vary,varying,vein,visible,way,weakly,wing,winged,without,woody,ympodial,young	0.2,0.5-0.7,adhesion,arrangement,climate,colour,corolla,form,fruit,hair,height,history,life,na,number,papillate,perennial,position,presence,pubescence,reproduction,seed,shape,staman,stipe,texture
668	wfo-0001030899	success	146	99	63	83	36	0.432	.5-2,0.3-0.5,1-2,10-20,2,2-3,2-3.5,2.5-3.5,3-12,3-4,3-5,3.5-4,4-5,5-6.5,6.5-31,7-27,?,acuminate,apex,base,blade,bronze,calyx,chartaceous,cm,cordate,deeply,densely,diameter,ellipsoidal,end,entire,flattened,fruit,glabrous,glandular-puberulent,green,inside,lobe,margin,mm,mucronate,obconical,oblong,outside,ovate,pedicel,peduncle,petiole,puberulent,purple,shrub,simple,splotch,stellate,stigma,stripe,style,triangular,tube,white,x,yellow	-45,0.5,0.5-1,1,1-1.5,1-3,1-6,1.5-2,10-13,20-25,3-foliate,5-10,8-11,abaxially,absent,acute,adaxially,aggregate,apart,ape,articulated,axe,basal,beyond,cell,connective,connivent,coriaceous,desc,dilated,directed,distally,eaf,eed,ex,exceeding,exserted,extrorse,flower,globose,leaving,less,light,lon,long,lower,narrowly,nflorescence,nther,obtuse,orang,orolla,ovoid,pedicellar,peltifor,perfect,pore,presen,puberulen,pubescent,rachi,radiu,remnant,ruit,shorter,slightly,spaced,stamen,stone,strongly,tal,tem,thecae,time,tomento,ud,unbranched,unit,upward,vary,vein,wide,ympodial	adhesion,anther,arrangement,climate,colour,corolla,form,glandular,growth,hair,height,history,inflorescence,leaf,length,life,midpoint,na,number,ovary,peltiform,plant,position,presence,pubescence,ray,reproduction,rugulose,seed,shape,size,staman,stem,stipe,surface,texture
669	wfo-0001030902	success	159	116	80	79	36	0.503	-2,0.6-1.5,1-2,1-6,1.5-13,1.5-2.5,10-15,2,2-3,2-5,2.5,2.5-4,3-13,3-4,3.5-4,4-22,4-7,5-7,5-9,6-24,abaxially,acuminate,adaxially,along,angled,apex,apiculate,basal,base,blade,brown-pilose,calyx,cm,cordate,dark,deltate,densely,diameter,eglandular,ellipsoidal,entire,except,flattened,fruit,glabrescent,glabrous,glandular,globose,hair,lobe,long,margin,mature,mm,oblong,occasionally,orange,ovate,pedicel,peduncle,petiole,pinkish,present,puberulence,purple,purplish,reddish,simple,sparse,stellate,stigma,style,subcoriaceous,tip,tree,truncate,tube,vein,x,yellow	-20,-5,0-15,1.5-,1.5-2,15-50,3-20,30-50,4,4-6,4-foliat,8-14,absent,acute,aggregate,apart,ape,apically,articulated,axe,beyond,branched,brow,cell,connective,connivent,cylindrical,dilated,directed,distally,eaf,eed,equalling,exceeding,exserted,fleshy,flower,forked,glabrat,glandular-puberulen,laterally,leaving,lon,lower,narrowly,nflorescence,nther,obtuse,orolla,pedicellar,perfect,pore,presen,rachi,radiu,rarely,remnant,ruit,shorter,slightly,small,somewhat,spaced,sparsely,stamen,stone,subcapitat,tal,tem,thecae,time,tomento,triangular,ud,unbranched,unit,vary,wide,ympodial	adhesion,anther,arrangement,climate,colour,corolla,form,glabrate,growth,height,hermaphroditic,history,inflorescence,leaf,length,life,midpoint,na,number,ovary,perennial,plant,position,presence,pubescence,ray,reproduction,seed,shape,size,staman,stem,stipe,subcapitate,texture,tomentose
670	wfo-0001030906	success	134	102	61	73	41	0.455	1-1.4,1.0-1.4,1.5-2.5,1/3-2/3,2.0-2.6,2.3-3.5,4-11,6-10,7-16,8-13,9-12,along,annual,anther,arcuate,armed,base,blade,bristly,broadly,calyx,campanulate,cm,densely,developing,dry,flattened-ovoid,foveolate,glabrous,herb,internodal,invested,length,linear,lobe,long,main,maturity,minutely,mm,obtuse,ovate,pedicel,pentagonal,petiole,prickly,purple,red,rounded,seed,sometimes,spherical,splitting,stellate-pubescent,stellate-tomentose,stem,surface,tightly,tube,vein,yellow	1,38,40-80,6-8,7-12-flowere,accrescent,across,almost,alyx,ample,anthesi,ascending,bearing,berry,branched,broad-based,cauline,da,dia,difoliate,divided,eaf,essentially,exceeding,externall,faces,flat,geminat,interpetalar,lateral,long-stalked,n,near,nearly,nflorescence,numerous,often,orolla,partly,per,pinnatifid,pinnatisect,plicate,prickl,prickle,purpli,ruit,sessil,short,slender,slightly,somewhat,spreadingly,stellae,strait,subulate,suffused,tamen,taprooted,throughout,tigma,tissue,tub,twice,tyle,ultimate,undulate,unexpande,unit,usually,vary,yello,ympodial	adhesion,apex,arrangement,climate,colour,corolla,diameter,externally,form,fruit,glandular,growth,hair,height,history,inflorescence,leaf,life,margin,midpoint,na,number,ovary,peduncle,plant,position,presence,present,pubescence,ray,reproduction,rugulose,shape,size,staman,stellate,stigma,stipe,style,texture,unexpanded
671	wfo-0001030914	success	186	118	88	98	30	0.473	/4,0.5-1,0.7-1,1-1.5,1-2,1.2-1.5,1.5-3,1.5-8,2-10,2-2.5,2.5-3,3-4,3.5-17,7-8,9-35,acute,along,anther,apex,attenuate,base,beneath,berry,blade,calyx,campanulate,capitate,cm,corolla,dark,decurrent,deltoid,densely,dia,elliptic,erect,glabrous,globose,golden,green,inflorescence,leaf,lemon-yellow,length,lobe,lobed,long-styled,margin,minutely,mm,obovate,opposite,otherwise,ovary,ovoid-reniform,pale,papillose,pedicel,petiole,pitted,plant,poricidal,puberulent,pubescent,reddish-brown,ripe,shape,short-styled,shrub,size,small,sparsely,stem,stigma,style,surface,tan,tip,tree,trichome,tube,uniseriate,usually,vein,way,white,winged,x	.1,.5,0-0.25,0.1-0.5,0.8-1,0.8-1.3,1.5-2,2.5-11,5-17,5-25-flowered,7-10,anthesi,bark,bud,closely,constriction,deflexed,differing,difoliate,distal,dry,eaf,edicel,eed,ellipsoid,equal,even,evenly,exserted,filament,flower,free,fruiting,furcate,geminat,glabrate,greyish-brow,individual,later,lateral,like,live,lon,long,lower,main,major,many,middle,minor,narowly,nflorescence,occasionally,often,older,one,onto,overlappin,pair,papillo,planar,pore,portion,prominent,quite,raised,rest,rounded,ruit,scar,shaped,simple,slender,slightly,sometimes,soon,spaced,specimen,straight,tall,tapering,tear-drop,thick,third,ti,time,trunk,tub,ud,unit,variable,weight,widest,within,woody,yellow,ympodial,young	adhesion,arrangement,climate,colour,diameter,form,fruit,glandular,growth,hair,height,history,life,midpoint,na,narrowly,number,peduncle,perennial,position,presence,pubescence,ray,reproduction,rugulose,seed,staman,stellate,stipe,texture
672	wfo-0001030918	success	230	132	104	126	28	0.452	-3.2,-40,-6,-9,0.1,0.2-0.4,0.25-0.45,0.6,0.6-2.5,0.7-1.2,0.7-1.7,1,1-1.5,1.5-2.5,1.5-5.5,1/2-2/3,1/3,1/4-1/3,2-2.5,2-25,2-8,2.8-3,3-6.5,3.5-6,5-8,5.5-7,6-8,acute,ame,anther,apex,apically,base,berry,blade,c.,calyx,chartaceous,cm,connivent,cuneate,densely,diameter,dull,elliptic,equal,erect,evenly,flattened-reniform,fruit,glabrescent,glabrous,green,lateral,leaf,length,lobe,lobed,long,lower,margin,maturity,mauve,midpoint,mm,moderately,narrow-deltate,obtuse,orange,orange-brown,pedicel,peduncle,petiole,poricidal,pubescent,purple,ray,red,reduced,scandent,seed,shrub,simple,slender,smooth,sometimes,sparsely,spherical,spreading,stellate,stellate-pubescent,stem,style,surface,tapering,terminal,tip,tube,upper,way,weakly,wide,yellow,young	-12,-2.3,-4,-4.5,-5,.5,.7,0-10,0-20,0-25,0-4,0-6,0.1-0.25,0.3-1.5,0.5-0.7,0.5-2,0.5-2.5,1-1.8,1-2,1-4,1.5-2,1/2-3/4,1/3-,1/3-1/2,2-10,2-3,2-4,2-7,2/,3-15,3-4,3-7,4-7,5-7,5-merous,7-10,abaxial,abaxially,acicular,adaxial,alyx,apar,apart,apparently,articulated,bark,branched,brow,caudat,cell,curved,dark,deltate,difoliate,discolorous,distance,drying,eaf,elongated,elongating,extending,faint,filament,flattened,flower,free,fruiting,geminat,green-brown,infructescence,lobing,longer,mature,midvein,mixture,nflorescence,oblong,occasionally,older,one,open,orolla,oung,outline,pair,pale,pendulous,per,perfec,pericarp,perpendicular,pit,porrect,portion,prickl,prickle,prickly,primary,raised,red-brown,reflexed,ruit,scar,secondary,sessile,side,small,somewhat,spaced,stalk,stalked,straight,strongly,tamen,terete,tertiary,time,trichome,unit,usually,vary,vein,venation,visible,woody,ympodial	2/3,adhesion,arrangement,caudate,climate,colour,corolla,form,glandular,growth,hair,height,inflorescence,na,number,ovary,plant,position,presence,pubescence,rugulose,shape,size,staman,stigma,stipe,texture,ye
673	wfo-0001030919	success	219	110	64	155	46	0.292	12,2,2.5,3,acute,andromonoecious,anther,apex,base,blade,brown,calyx,chartaceous,cm,connivent,coriaceous,densely,diameter,elliptic,entire,extra-axillary,flower,fruit,glabrous,glandular,globose,green,hair,hard,leaf,length,linear-lanceolate,lobe,margin,maturity,midpoint,mm,moderately,obtuse,orange,ovate,pedicel,peduncle,petiole,plant,pubescent,ray,reniform,scandent,shrub,simple,stellate,stellate-pubescent,stem,stigma,style,subopposite,surface,tan,triangular,tube,white,yellow,×	.2–0.4,.2–0.6,0.1–0.2,0.1–0.3,0.3–0.6,0.5–1,0.5–1.5,0.5–3,1.2–2,1.5,10–13,10–14,10–20,12–16,12–18,1971,1–2,1–3,25–50,2–3,2–4,2–8,3–4,3–6,3–8,4–7,4–8,5-merous,5–10,5–7,5–8,7–10,7–11,8–12,abaxial,abaxially,absent,accrescent,adaxial,adaxially,alyx,anthesi,apart,apparently,armed,articulated,asymmetrical,attenuate,axe,ba,berry,beyond,branched,capitat,connected,cordate,covering,cylindrical,directed,discolorous,distally,eaf,eed,exserted,festooning,filament,flattened,frui,fruiting,functionally,fused,glabrou,hermaphroditic,horizontal,incompletely,interpetalar,introrsely,lateral,like,lobed,long,longitudinal,lower,male,midrib,midvein,moderate,multicellular,multiseriate,narrowly,nearly,nflorescence,notch,occasionally,often,older,opening,orolla,partially,per,perfec,petiolate,pinnate,placenta,plurifoliat,pore,porrect-stellate,positioning,prickle,protrusion,proximally,rachi,recurved,reddish,reflexed,roe,roselike,rugose,ruit,rusty,secondary,see,shortly,side,slightly,slit,small,spaced,sparsely,spine,stalk,stamen,ste,subsessile,swollen,tal,tamen,tapering,tem,terminology,tissue,triangular-ovate,twice,unarmed,unbranched,unicellular,uniseriate,unit,vary,vein,venation,whitish,wide,ympodial,young	0.2-0.4,0.2-0.6,0.3-0.6,0.5-1.5,0.5-3,1-2,1-3,10-13,10-20,12-18,2-3,3-4,3-6,3-8,4-7,5-10,5-8,7-10,7-11,adhesion,arrangement,capitate,climate,colour,corolla,form,growth,height,history,inflorescence,life,na,number,ovary,position,presence,present,pubescence,reproduction,rugulose,seed,shape,size,staman,stipe,texture
674	wfo-0001030921	success	185	111	82	103	29	0.443	0,0.4-0.5,1-1.5,1-3,2-2.5,3-3.5,3-4,3-5,3.5-5,4-10,6-7,7-8,9-15,acuminate,acute,anther,apex,asymmetric,basal,base,berry,brown,calyx,campanulate,cm,coriaceous,corolla,deep,diameter,elliptic,entire,flattened,fruit,globose,green,growth,half,inflorescence,internodal,lanceolate-elliptic,liana,like,linear-lanceolate,lobe,lobed,margin,midpoint,mm,nearly,ovary,pedicel,peduncle,petiole,porrect,puberulent,pubescence,pubescent,purple,ray,reniform,rusty,scabrous,sessile,stellate,stellate-pubescent,stem,stigma,style,subequal,subspherical,subtruncate,surface,tapering,tomentose,trichome,tube,unicellular,violet,white,woody,x,yellowish	.5,1-1.2,1-2,1/3,10,2-3,2-6,4-6,abaxially,adaxially,anthesi,antrorse,apart,appressed,armed,articulated,bark,branched,caly,channelled,compressed,congested,corymbose,curved,cyme,deeply,densely,diamete,discolorous,distal,eed,elongating,erec,erect,exceeding,exserted,filament,flower,free,fruiting,glabrescent,glabrous,grey,hermaphroditic,heterostylous,included,long,long-styled,longer,lower,many,minute,multicellular,near,new,nflorescence,oblong,obverse,older,one,ovoid-conical,partially,perfect,pericarp,plurifoliateleaf,pore,poricidal,porrect-stellate,portion,prickle,prickly,raise,recurved,reddish,reduced,reflexed,reticulate-undulate,rugose,ruit,scar,short-styled,shorter,shrub,slightly,slit,spaced,sparse,sparsely,staminate,straight,strongly,terete,testa,time,tip,triangular,ud,unevenly,unit,upper,velutinous,ympodial,young	adhesion,arrangement,blade,climate,colour,form,glandular,hair,height,history,leaf,length,life,na,number,perennial,plant,plurifoliate,position,presence,reproduction,rugulose,seed,shape,size,staman,stipe,texture,ye
675	wfo-0001030941	success	259	146	121	138	25	0.467	-1.5,.5-5,/50-1/15,0.02-0.06,0.02-0.25,0.02-0.3,0.04-0.5,0.1-0.3,0.8-1.1,0.8-1.3,1-9,1.1-1.7,1.1-2.8,1.2-2.1,1.2-2.2,1.3-2.5,1.4-1.6,1.5-4.5,10,10-25,2-3.2,2-5,3.5-10,3/4,4-12,4-6,6-22,7-23,9,abaxially,acuminate,acute,adaxially,anther,apart,apex,base,becoming,blade,blunt-tipped,brown,calyx,campanulate,chartaceous,cm,conical,corolla,decurrent,deltoid,diameter,elliptic,entire,flower,fruit,glabrescent,glabrous,glandular,globose,gray,growth,hair,honeycombed,inserted,lateral,leaf,length,lobe,long,long-attenuate,margin,midpoint,minutely,mm,moderately,mostly,multangulate,narrowly,oblong,obovate,obtuse,occasionally,ovoidal,pale,pedicel,peduncle,perfect,petiole,pubescent,ray,reticulate-punctate,ripe,scabridulous,scabrous,sessile,short,short-stalked,shrub,simple,small,sometimes,sparingly,sparsely,stelliform,stem,stigma,stipitate-glandular,style,subcoriaceous,suborbicular,subreniform,terete,terminal,testa,tomentose,tree,triangular,tube,white,x,yellow,yellowish	-16,-4,-6,.01-0.3,.03-0.25,.04-0.1,.04-0.12,.04-0.22,.04-0.4,.2-0.8,0-100,0.01-0.22,0.02-0.04,0.02-0.4,0.03-0.05,0.03-0.06,0.03-0.6,0.04-0.08,0.04-0.1,0.04-0.35,0.04-0.6,0.06-0.35,0.06-0.42,0.07-0.4,0.08-0.35,0.08-0.5,0.5-1.5,1-1.4,1.1-1.3,1.3-4.5,1.4-3.5,1.5-3.5,1/3-1/2,2-3.3,3-4.5,3-5,4-8,4-9,5-9,5-merou,6-10,6-9,7-10,absen,accrescent,ag,along,alyx,anthesi,apical-lateral,apparently,appressed-tomentose,articulated,axe,axillary,bark,berry,branch,branched,bud,color,continued,darker,dehiscing,dense,densely,directed,due,eaf,eed,ellipsoid,exserted,extend,few-rayed,filament,fleshy,free,fruiting,high,introrse,lanceolate,large,less,lobed,lon,longer,longitudinal,lower,m.,main,midvein,mixed,multangulat,multiseriate,nearly,nflorescence,obscured,often,older,orolla,ovate,plurifoliate,pore,porrect-stellat,porrect-stellate,rachi,rarely,rather,ruit,runk,side,slit,somewhat,spaced,sparse,stalk,stamen,strongly,subcapitat,suture,tamen,thick,thick-stalked,time,tomentu,touching,toward,unarme,unarmed,unit,usually,vary,vein,way,weakly,wide,ympodial,young	0.2-0.8,adhesion,climate,colour,form,height,history,inflorescence,life,number,ovary,perennial,plant,position,presence,present,pubescence,reproduction,seed,shape,size,staman,stellate,subcapitate,texture
676	wfo-0001030943	success	167	128	93	74	35	0.557	.5,0.5-1,1-1.2,1-1.5,1.1,1.8-2.2,1/2,12-15,2-6,3,3-4,3/4,4-4.5,4-5,4-6,7-13.5,abaxial,abaxially,acuminate,acute,adaxial,adaxially,age,along,anther,apex,base,becoming,bi-lobed,black,branching,calyx,cm,conical,corolla,dendritic,densely,diameter,drying,echinoid,elliptic,flattened,glabrous,globose,golden,golden-yellow,growth,im,lateral,leaf,lenticular,lobe,lobed,main,minutely,mm,narrowly,ovary,overtopping,pale,pedicel,pericarp,petiole,pitted,plurifoliate,pore,poricidal,pubescent,purplish-black,reddish-brown,scattered,shoot,shrub,slit-like,small,sparsely,stem,stigma,style,surface,terminal,thin,tip,tree,tree-like,triangular,trichome,tube,vein,violet,way,x,yellowish-white	0,0.5-3,1.5-2,10-25,7-8,8-10,absent,anthesi,apical,bark,basal,belo,berry,branch,cupulate,dark,decurrent,deflexed,denser,eaf,edicel,eed,elongate,erect,ew,exserted,fide,filament,flower,free,fruiting,glabrat,horizontal,inserted,large,lon,long,lower,m.,minute,monochasia,nflorescence,nodding,often,older,outline,pair,papillo,pearce,per,planar,portion,raised,ruit,scar,secondary,showy,sleeve,slightly,somewhat,stamen,strongly,tall,tapering,time,tub,ud,unit,upper,wide,woody,yellow,ympodial,young	adhesion,arrangement,blade,climate,colour,form,fruit,glandular,hair,height,history,inflorescence,length,life,margin,midpoint,monochasial,na,number,peduncle,perennial,plant,position,presence,pubescence,ray,reproduction,rugulose,seed,shape,size,staman,stellate,stipe,texture
677	wfo-0001030959	success	164	100	70	94	30	0.427	.05,.8,/5,0.5-1.5,0.7-1.2,1.2-1.8,1.5-3.5,10-15,2-4,2.5-4.5,2.5-5,5-6,5-9,9-12,abaxially,almost,anther,apex,apically,base,blade,brown,cm,color,connivent,cuneate,deltate,diameter,elliptic,fresh,glabrous,glandular,hair,inflorescence,known,lateral,leaf,length,lobe,lobed,long,long-acuminate,margin,membranous,midpoint,minute,mm,pedicel,peduncle,petiole,poricidal,present,ray,shrub,simple,sparsely,stellate,stellate-pubescent,stem,straw,style,subentire,surface,tapering,tip,toward,tube,way,wide,yellow	.2,0.5,1-10,1-2,1-7,1.5-2,1/5-1/10,2.5-4,4-6,4-8,5-merous,6-8,alyx,ame,apar,apart,apparently,armed,articulated,bark,branched,brown-green,c.,concolorous,curved,densely,difoliate,distributed,drying,eaf,eed,equal,erect,evenly,filament,flower,free,geminat,gently,glabrescent,glabrou,green-brow,know,less,like,long-acuminat,longer,lower,narrow-deltate,nflorescence,numerous,older,one,open,orolla,oung,pair,part,perfec,perpendicular,porrect,portion,prickl,prickle,prickly,primary,prominent,ruit,scar,scrambling,secondary,sessile,several,short,side,slender,spaced,spreading,straight,tamen,terete,tertiary,time,trichome,unarmed,unit,usually,vary,vein,venation,visible,whole,ympodial,youngest	adhesion,arrangement,calyx,climate,colour,corolla,form,fruit,growth,height,history,life,na,number,ovary,perennial,plant,position,presence,pubescence,reproduction,rugulose,seed,shape,size,staman,stigma,stipe,texture,unknown
678	wfo-0001030982	success	215	111	85	130	26	0.395	-2-2.5,0.05-0.5,0.2-3,0.5-0.9,0.5-1,1,1-1.5,1-8,1.5,1.5-2,1.5-3,2/3,3-21,4-5,6-8,acuminate,acute,anther,apex,base,berry,broadly,brown,brownish,calyx,capitate,chartaceous,cm,conic,conical,corolla,cuneate,deltate,diameter,dry,drying,elliptic,entire,flattened-reniform,fleshy,form,fresh,fruit,glabrous,glandular,globose,green,growth,leaf,live,lobe,lobed,margin,material,maturity,mm,opposite,ovary,ovate,pale,papillose,pedicel,peduncle,petiole,plant,poricidal,pubescent,reddish,rhizomatous,sagittate,seed,sinuate,size,slightly,sparsely,stem,stigma,style,subshrub,surface,tip,tube,way,white,x	.1,.2,.5,0.05,0.1,0.1-0.15,0.3-2,0.5,0.5-3,3-8,4-12,abaxially,adaxially,age,angular,anisophyllous,anthesi,ape,appressed,ba,beneath,bud,caducous,central,channelled,ciliate,closely,cream,cucullate,curved,dark,deflexed,differing,difoliate,distall,distally,distichou,eaf,edicel,eed,ellipsoid,enlarged,exerted,extension,external,filament,flower,foliage,free,fruiting,geminate,glabrescent,glandular-papillose,golden-green,greenish,hilum,impressed,inconspicuously,internal,isostylous,larger,later,lengthening,less,like,long,lower,major,materia,midvein,minor,minutely,mostly,near,new,nflorescence,oblique,obovate,occasionally,often,olive,one,overlappin,packed,pair,papillae,papillat,papillate,pitted,planar,pore,portion,primary,projection,prominent,prominently,puberulent,reflexed,rest,revolute,ruit,scar,separated,shoot,sigmoidally,simple,situated,slit,somewhat,stamen,straight,stripe,strongly,testa,tetramerous,tightly,time,transverse,trichome,tub,ud,uniseriate,unit,vegetative,vein,veined,weakly,yellowish,ympodial,young	adhesion,arrangement,blade,climate,colour,distichous,hair,height,history,inflorescence,length,life,midpoint,na,number,position,presence,pubescence,ray,reproduction,rugulose,shape,staman,stellate,stipe,texture
679	wfo-0001030989	success	177	85	60	117	25	0.339	.5,0.5-1,1-2,12-15,15-27.5,3-4,3-7.5,4-5,6-6.5,9-10,abaxially,adaxially,anther,berry,brownish,chartaceous,ciliate,cm,condition,conical,corolla,densely,diameter,drying,fresh,fruit,glabrous,green,greenish,herb,lanceolate,leaf,light,lobe,long,margin,mm,odd-pinnate,ovoid,pedicel,peduncle,petiole,plant,pubescent,ripe,rotate,seed,size,sparsely,stem,stigma,style,terminal,triangular,tube,violet,whitish,wide,x,yellow	1-1.5,1-10,2-3.5,3-20,3-5.5,4-7,4-8,5,5-merou,5.5-7.9,6-13,acuminate,ag,alyx,apart,apex,apparently,articulated,axe,axillary,base,blade,bud,capitat,cell,connivent,covering,decreasing,digestion,distal,dorsally,eaf,edge,eed,end,enzyme,erec,especially,filament,flat,flower,folded,forked,geminat,generally,glabrou,gradually,green-white,hair,hair-like,half,homostylous,honeycomb-shaped,interjected,larger,lateral,leaflet,lengthening,like,living,lower,make,minute,mucilaginous,nflorescence,obtuse,occurring,orbicular,orolla,ovate,ovate-lanceolate,pair,pale,perfect,petiolule,plurifoliate,pore,poricidal,present,proximal,pubescen,ray,removed,ruit,secondary,semierect,seudostipule,singly,slit,spaced,specimen,ste,stolo,subequal,subsessile,subtending,symmetrical,tall,tamen,tem,testal,thick,thir,throughout,tip,toward,tri-,tuber,typically,unit,unwinged,usually,vary,wall,wet,wider,ympodial	adhesion,arrangement,calyx,capitate,colour,form,growth,height,history,inflorescence,length,life,na,ovary,perennial,position,presence,pubescence,reproduction,rugulose,shape,staman,stellate,surface,texture
680	wfo-0001030991	success	204	120	90	114	30	0.441	.5,0.5-0.7,0.5-1.5,0.7-1.2,1-1.5,1-1.6,1-2.2,1-2.5,1-7,1.5,2.5-10,2.5-3,3-,3-5-lobed,5-5.5,9-11,absent,acuminate,acute,anther,apex,apparently,attenuate,base,brown,calyx,capitate,cm,conical,corolla,densely,diameter,ellipsoidal,elliptic,entire,flattened,glabrous,globose,grey,growth,herb,inflorescence,lanceolate,lateral,leaf,leaf-opposed,lobe,lobed,long-triangular,margin,minutely,mm,narrowly,nearly,occasionally,pedicel,peduncle,perfect,petiole,pinnatifid,pitted,pubescent,red,reniform,ripe,scattered,shiny,short,shrub,simple,small,sparsely,stellate,stem,stigma,style,suffrutescent,surface,terminal,thin,trichome,tube,uniformly,uniseriate,variably,violet,white,winged,x,yellowish	0,0.1,0.2,0.2-0.7,0.3-0.4,0.5,0.5-1,0.5-3.5,0.6-0.8,10-20,2-plurifoliat,2/3,4-10,5-merou,<,abaxially,adaxiall,adaxially,ag,along,alyx,angled,anthesi,appressed,arising,ark,articulated,ascending,basal,berry,bulbous,cell,color,connivent,different,distally,drying,eaf,eed,ellipsoid,elongate,enlarged,exerted,eye,filament,filiform,flower,free,frui,fruiting,furcate,fusiform,glabrescen,ilament,incised,leave,lengthening,less,like,loosely,lower,midrib,minute,new,nflorescence,nodding,often,older,orolla,outline,packed,pair,papillo,part,particularly,pendant,per,pericarp,platfor,pointing,pore,poricidal,portion,primary,pseudoumbel,rectangular,reflexed,rest,rootstoc,ruit,scar,shallowly,sleeve,slightly,slit,somewhat,spreading,strongly,tangled,tem,testal,tightly,tip,twinin,ud,unit,upper,vary,vein,weak,weight,woody,ympodial,young	adhesion,arrangement,blade,climate,colour,form,fruit,glandular,hair,height,history,length,life,midpoint,na,number,ovary,plant,position,presence,pubescence,ray,reproduction,rugulose,seed,shape,size,staman,stipe,texture
681	wfo-0001031005	success	231	114	88	143	26	0.381	.5,0.1,0.8,0.9,1-1.5,1-2,1-2.5,1-3,10,2-3.2,2.5,2.5-4,3-4,3-6.5,4-6,5,5-8,6-12,acuminate,acute,almost,anther,apex,apically,apparently,attenuate,base,berry,black,blue,brown,calyx,capitate,chartaceous,clustered,cm,conical,corolla,cupular,dark,deltoid,dendritic,dendritic-pubescent,diameter,drying,elliptic,elongated,entire,evenly,form,free,fruit,glabrous,leaf,length,liana,lobe,lobed,margin,membranous,mm,oblong,obovate,occasional,orange-brown,outside,ovoid,pedicel,peduncle,petiole,pubescent,purple,ray,seed,slender,sometimes,somewhat,stem,stigma,style,surface,terminal,thin,trichome,tube,usually,white,x	.4,/3-1/2,0-0.5,0.3-0.5,0.5-1.5,1,1.5-2.5,1.5-4,2.3-3,3-10,5-7,5°,abaxial,abaxially,accrescent,adaxially,age,along,alyx,anthesi,apar,articulated,bark,brachyblast,branch,branched,branching,clearly,clum,common,concolorous,curved,datum,deeply,delineated,denser,density,detaching,developing,dilated,discolorous,divided,domatia,eaf,ellipsoi,equal,extending,eye,fertilisation,filament,fine,flat,flattened,flexuous,flower,forming,fruiting,greenish,immature,increasing,inside,junction,known,lateral,leave,lengthening,like,linear,long,longitudinally,loop,lower,m.,main,midvein,minute,much,naked,network,nflorescence,nther,obscure,occasionally,often,older,onl,orolla,ou,ovate,pair,pendulous,perfec,pericarp,plurifoliat,pointed,pore,poricidal,portion,primary,prominent,protruding,rachi,raised,region,rest,ridged,ruit,scar,secondary,short,side,simple,smaller,smoot,smooth,soon,sparsely,spread,spreading,standing,strongly,stump,surrounding,tangling,tearing,terete,tertiary,thick-chartaceous,tip,toward,ud,unarmed,uneven,unit,vary,vein,venation,visible,weakly,well-developed,wide,ympodial,young	adhesion,arrangement,blade,climate,colour,glandular,growth,hair,height,inflorescence,midpoint,na,number,ovary,plant,position,presence,pubescence,rugulose,shape,size,staman,stellate,stipe,texture,ye
682	wfo-0001031007	success	207	148	128	79	20	0.618	.5,0.2,0.5-1,0.5-10,1,1-1.2,1-1.5,1-3.5,1.2-1.5,1.3-,1.6-2,15,2.5-,2.5-5,3-4,5-12,5.5-6,6,7-10,<,acute,alfway,almost,along,anther,apex,articulated,base,becoming,berry,bifid,black,branched,broad,brown,c.,capitate,cell,chartaceous,clustered,cm,completely,connivent,corolla,cuneate,dark,dendritic,densely,diameter,drying,dull,ellipsoid,elliptic,entire,extending,filament,flattened-reniform,fleshy,flower,fruit,fruiting,glabrous,globose,growth,herbarium,inflorescence,irregularly,lamina,lax,leaving,lilac,lobed,long,loose,loosely,many,margin,matte,midvein,minutely,mm,multi-celled,narrowly,new,occasionally,often,outline,papillate,pedicel,peduncle,peg,pericarp,petiole,pitted,prominent,pubescent,reddish,revolute,round-rectangular,sagittate,scar,shrub,sleeve,slightly,spaced,sparsely,specimen,stellate,stellate-pentagonal,stem,stigma,stout,style,surface,tangled,testal,thin,time,tip,trichome,tube,twining,usually,vein,vine,woody,x,yellow	0.5,0.75-1.5,1.5-2,1.9-3,1/3,11-14,4-6,4-7,4.5-5,5,5-merou,50-100,8-10,abaxiall,abruptly,ag,alyx,anthesi,apar,apparently,ark,beginning,branching,broadly,calyx,campanulate,cup-shaped,deltate,dilated,eaf,eed,exserted,free,geminat,glabrescen,glabrou,ilament,impressed,intramarginal,junction,lengthening,lobe,looping,lower,m.,markedly,narrowing,near,nflorescence,nodding,older,orolla,pale,papillat,per,perfect,planar,plurifoliate,pore,poricidal,portion,primary,rat,ruit,shiny,simple,slender,slit,splitting,spreading,strongly,terminal,tiny,ud,unit,upper,vary,way,ympodial	5-merous,abaxial,abaxially,adaxial,apart,bark,bud,colour,form,height,leaf,length,ovary,plant,pubescence,seed,shape,size,spacing,texture
683	wfo-0001031007	success	206	132	102	104	30	0.495	0.5-1,1,1-1.2,1-1.5,1-3.5,1.2-1.5,1.3-,1.5-2,1.9-3,15,2.5-,2.5-5,3-4,4.5-5,5-12,5.5-6,6,7-10,abruptly,acute,alfway,along,anther,apex,base,berry,bifid,black,broadly,brown,c.,calyx,capitate,chartaceous,cm,corolla,cuneate,cup-shaped,deltate,dendritic,densely,diameter,dull,elliptic,entire,extending,flattened,fleshy,fruit,glabrous,globose,growth,inflorescence,irregularly,lamina,lax,lilac,lobe,lobed,long,loose,lower,margin,matte,mm,narrowing,narrowly,occasionally,papillate,pedicel,peduncle,petiole,poricidal,pubescent,reddish,reniform,revolute,sagittate,shiny,shrub,simple,sparsely,splitting,stellate,stellate-rotate,stem,stigma,stout,style,surface,tall,tangled,terminal,thin,tip,trichome,tube,usually,vein,vine,wide,woody	.5,0.2,0.5,0.5-10,0.75-1.5,1.6-2,1/3,11-14,4-6,4-7,5,5-merou,50-100,8-10,<,abaxially,adaxial,ag,almost,alyx,anthesi,apar,apparently,articulated,bark,becoming,beginning,branched,branching,broad,campanulate,cell,clustered,completely,dark,dilated,drying,eaf,eed,ellipsoid,exserted,filament,flower,free,fruiting,glabrescen,glabrou,herbarium,ilament,impressed,intramarginal,junction,leaving,lengthening,looping,m.,many,markedly,midvein,minutely,multi-celled,near,new,nflorescence,nodding,often,older,orolla,outline,pale,papillat,peg,per,perfect,pericarp,pitted,planar,plurifoliat,pore,portion,primary,prominent,rat,round-rectangular,ruit,scar,sleeve,slender,slightly,slit,spaced,specimen,spreading,strongly,testal,time,tiny,twinin,ud,unit,upper,vary,way,ympodial	adhesion,arrangement,blade,climate,colour,form,glandular,hair,height,history,leaf,length,life,midpoint,na,number,ovary,plant,position,presence,pubescence,ray,reproduction,rugulose,seed,shape,size,staman,stipe,texture
684	wfo-0001031022	success	287	147	127	160	20	0.443	0.2–0.3,0.2–0.9,0.3–0.6,0.5–1.4,0.5–5.8,0.6–1.0,0.6–1.2,0.6–1.6,0.6–2.4,0.7,0.7–1.7,0.8–1.2,0.8–2.9,0.8–3.4,0.9–1.9,1.0–4.5,1.1–8.3,1.2–2.3,1.8–12.1,1.9–2.8,1/3,12.9,14.9,2.3–3.1,2/3,3.2–4.9,3.9–6.5,4.5–21.9,4–9,6.9,abaxially,acuminate,adaxially,adnate,anther,apex,apiculate,appearing,arcuate,attenuate,basal,base,becoming,black,calyx,capitate,caudate,channeled,chartaceous,cm,corolla,cream,densely,diameter,dry,emerging,erect,evenly,extra-axillary,ferruginous,flattened-reniform,flower,fruit,glabrous,glandular,globose,green,hair,internode,interpetalar,lanceolate,lateral,leaf,length,lobe,long,longer,markedly,mature,midpoint,minute,mm,moderately,nearly,oval,ovate,pedicel,peduncle,petiole,poorly,porrect,pubescent,purple,ray,sessile,short,shorter,shrub,simple,small,sometimes,sparsely,stellae,stellate,stem,stigma,stipe,stipitate,style,terete,tip,tissue,toward,tree,truncate,tube,unarmed,upper,vein,well-developed,white,yellow,yellow-ferruginous,yellow-tan,young,±glabrous,×	.04,0.1,0.3–0.8,0.4–0.5,0.4–1.2,0.4–1.3,0.5–1.5,0.5–2.2,0.6–2.6,0.8–1.3,1.0–2.6,1.1–3.4,1.2–2.6,1.4–4.0,1.5–2.5,1.6–4.8,1/4,1/4–1/3,10,10.5,17–145,2.8–6.3,3.2–7.0,3.8,4–6-merou,5.1–8.7,5.8–11.4,5–7,5–8,6–10,8.2,8.8,8.9,90°,absent,acute,aequilateral,along,alyx,anthesi,apart,apical,apparently,appressed,arching,area,around,articulate,axe,ba,bark,bent,berry,blade,branch,broad,brochidodromous,brown,bud,bulge,central,clinate,crea,cuneate,deciduous,dentate,development,difoliate,directed,directly,distal,distally,distinct,eaf,edge,eed,either,endocarp,entire,exocarp,extending,fertile,filament,filiform,forking,free,geminat,glossy,gradually,heterostylous,immature,increasing,intac,intersepalar,juic,large,layer,less,lobed,lon,lower,major,many,margin,midrib,midvein,minor,nflorescence,oblique,opaque,opposed,orolla,ove,per,perforated,pore,portion,potentially,raised,reddish,reflexe,remaining,reticulate,ridge,rigid,rounded,row,ruit,semicraspedodromous,several,side,sinus,sloughing,smooth,spaced,splitting,spread,spreading,stellate-pubescent,straight,surface,suture,tamen,tardily,tem,thin,time,transparent,two,ud,unbranched,unit,various,vary,weakly,well,wide,ympodial,±90°,±equal	adhesion,arrangement,climate,colour,form,growth,height,inflorescence,number,ovary,plant,position,presence,present,pubescence,seed,shape,size,staman,texture
685	wfo-0001031036	success	150	72	50	100	22	0.333	.25,.5,0.8-1,0.8-1.2,1-1.3,1-2.5,1.2-1.5,1.5-3,12-15,2-2.5,3-4,4.5-6.5,5-6,anther,bi-lobed,broadly,brown,calyx,cm,conical,corolla,dark,dia,elliptic,filiform,flattened-reniform,glabrous,globose,green,greenish-white,leaf,lobed,minutely,mm,opposite,ovary,pedicel,petiole,pitted,sagittate,shrub,size,slightly,stem,stigma,style,surface,tube,winged,x	.2,0.5-1,10-20-flowered,2.2-3.7,3-5,3.5-5.5,7-8,abaxially,acuminate,acute,adaxially,along,angle,anthesi,apex,arising,axil,ba,base,becoming,berry,closely,crisped,decurrent,deflexed,differing,difoliate,dry,drying,eaf,edicel,eed,ellipsoid,enlarged,erect,exserted,filament,fleshy,free,fresh,fruiting,geminat,knob-like,lamina,lateral,lobe,lon,long,lower,main,major,margin,material,middle,minor,nearly,nflorescence,oblique,older,onto,overlappin,pair,papillo,papillose,perhaps,planar,pointed,pore,poricidal,portion,rounded,ruit,scar,shaped,shiny,short,simple,sinus,soon,spaced,spathulate,strongly,tall,tapering,tear-drop,thickened,tip,trichome,tub,ud,uniseriate,unit,usually,vein,white,widest,woody,yellowish,ympodial,young	arrangement,colour,diameter,form,fruit,growth,height,history,inflorescence,length,life,na,peduncle,perennial,plant,position,pubescence,reproduction,rugulose,seed,shape,texture
686	wfo-0001031040	success	217	139	94	123	45	0.433	10,2,6,abaxially,acuminate,acute,adaxially,age,anther,apex,attenuate,base,blade,branch,broad-based,broadly,calyx,cm,deeply,diameter,dull,entire,flattened-reniform,flower,flowering,fruit,glabrescent,glabrous,gland-tipped,glandular,globose,hair,inflorescence,interpetalar,lanceolate,lateral,lavender,leaf,lighter,lobe,long,longer,margin,minute,mm,narrowly,older,ovate,pedicel,peduncle,petiole,pinnatifid,plant,porrect,prickle,purple,rarely,ray,rounded,scabrous,sessile,sessile-stellate,shape,shrub,simple,size,slightly,small,sometimes,somewhat,soon,sparse,sparsely,sprout,stellae,stellate,stem,stigma,straight,style,subcordate,subcoriaceous,surface,tissue,tree,triangular,triangular-attenuate,tube,unarmed,vigorous,violet,white,yellow,yellow-brown	.5,0.1–0.3,0.2–0.6,0.3–3,0.8–7.5,1.2–1.3,1.2–2.1,1.4–2.7,1.5–4,1.5–5,1.7,1.7–3.1,10–10.5,10–13,12–14,15–23,1–1.4,2.2–2.5,2.4–3,2.5–4,2.5–9,2–10,2–5-branched,3,3.5–5,3–26,3–4.5,3–5,4–6,5,5-merou,6.5–25,6–6.5,6–8,7–9,8–30,accrescent,adaxiall,also,alyx,anthesi,apart,apical,apparently,articulated,axe,ba,becoming,berry,capitat,contrasting,dark,densely,depending,difoliate,directed,distall,eaf,eed,either,especially,filament,filiform,finely,free,geminat,glabrou,green,highly,homostylous,immature,internode,larger,like,lobed,lon,lower,major,midpoint,midvein,midzone,minutely,much,nflorescence,numerous,orolla,outside,ovoid,pale,perfect,persistent,pitted,pore,principal,probably,recurved,ruit,scarcely,several-celled,short,side,similar,spaced,splitting,stellate-pubescent,tamen,tem,thickened,time,turning,ud,unit,upward,usually,variable,vary,vein,vigor,wide,yellowish-tawny,ympodial,×,–6	0.1-0.3,0.2-0.6,0.3-3,0.8-7.5,1-1.4,1.2-1.3,1.2-2.1,1.4-2.7,1.5-4,1.7-3.1,10-10.5,12-14,15-23,2-10,2.2-2.5,2.4-3,3-26,6-8,6.5-25,7-9,adhesion,arrangement,capitate,colour,corolla,form,growth,height,history,length,life,na,number,ovary,perennial,position,presence,pubescence,reproduction,rugulose,seed,staman,texture,x,ye
687	wfo-0001031062	success	216	119	79	137	40	0.366	-5.5,.5,0.5,1,2,2.5,20,4,?,abaxially,acute,adaxially,anther,apex,apiculate,appearing,base,blade,brownish,bud,calyx,campanulate,chartaceous,cm,connivent,cuneate,densely,diameter,entire,extra-axillary,ferruginous-tomentose,flattened-reniform,flower,fruit,fully,glabrous,globose,green,hair,leaf,lobe,margin,midrib,mm,ovate-lanceolate,pedicel,pentagonal,per,perhaps,petiole,plant,pubescent,ripe,rotate-stellate,shallow,shape,shub,side,simple,size,sparsely,stellate,stellate-tomentose,stem,stigma,style,surface,tapered,terminal,tip,tomentose,treelet,triangular,truncate,tube,usually,white,x,yellow	0,0.3,0.5–0.6,0.7–0.8,1.2–1.4,1/3,13–15,15,16,17,1–2.5,1–4,2-3.5,22,2–3,2–5.5,3,3-8,3–10,4–10,4–4.5,5,5–7-rayed,7,7–15,7–8-rayed,9–11,absent,accrescent,adaxiall,ag,ample,apart,armed,articulated,axe,ba,bottom,branch,capitat,clustered,colored,count,curved,cylindrical,diamete,difoliate,directed,distally,eaf,eed,even,eventually,except,fertile,filament,forked,foveolate,fragrance,fruiting,geminat,glabrou,grading,heavily,ilament,interpetalar,juvenile,larger,lateral,least,less,lighter,lobed,long,longitudinal,loosely,lower,m.,main,midpoint,minutely,much,nearly,nflorescence,numerous,obscuring,obsolete,often,one,opening,orolla,overtopped,part,partially,perfect,pore,prickle,rachi,rarely,recurved,rest,ruit,scabrous,sessile,short,short-stalked,slightly,slit,small,sometimes,spaced,sprout,stellae,stipitate,straight,sweet,tall,tem,thick,thick-based,tissue,toward,unarme,unarmed,unbranched,unifoliate,uniform,unit,uppermost,vary,vigorous,visible,wide,ympodial,young,younger,–3	0.5-0.6,0.7-0.8,1-2.5,1-4,1.2-1.4,13-15,2-5.5,4-10,4-4.5,5-7,7-15,7-8,9-11,adhesion,arrangement,capitate,colour,corolla,form,growth,height,history,inflorescence,length,life,na,number,ovary,peduncle,perennial,position,presence,present,pubescence,ray,reproduction,rugulose,seed,staman,texture
688	wfo-0001031064	success	179	109	87	92	22	0.486	.0-2.5,.5,0.5-0.7,1-2,1-3,1.2,1.5-2,1.7-4.2,10-12,10-12.5,10-17,2.5-3,3,3-5.5,3-7,3.5-4,5-10.5,5-6,6-16,7-16,abaxially,anther,anticlinal,arising,axil,basal,base,bright,calyx,cm,completely,conical,corolla,densely,diameter,elongate,fruit,glabrous,green,half,highly,inflorescence,irregular,lateral,leaf,leaflet,lightly,lobed,lower,margin,minutely,mm,nearly,obovate,ovary,ovoid-reniform,papillate,pedicel,petiole,pinnate,poricidal,projection,pubescent,purple,rachi,rugose,scattered,short-pubescent,shrub,simple,single,sinuous,sparsely,stem,stigma,style,surface,terminal,thickening,tip,trichome,tube,uniseriate,white,winged,without,x	.05,.5-1,0,0-15,0.5,0.5-0.8,1,1-1.2,2,4-5-celled,8-10-celled,acroscopic,acuminate,adaxially,along,anthesi,apex,attenuate,bearing,berry,blade,broader,cell,clavat,commentary,conspicuous,dark,deltate,denser,distal,dr.,eaf,edicel,eed,epidermal,erec,exserted,filament,fleshy,flower,free,fruiting,globose,irregularly,lamina,leave,lenticel,like,lobe,lon,long,lost,minute,narrower,near,nflorescence,nodding,node,occasionally,often,open,ovate,pair,per,petiolule,planar,portion,prominent,pubescen,ruit,scar,see,side,sinus,slender,smaller,somewhat,splitting,strongly,swollen,tal,tem,time,translucent,tub,ud,unifoliat,unit,usually,vein,wand-like,ympodial	adaxial,arrangement,clavate,colour,form,growth,height,history,length,life,na,peduncle,perennial,plant,position,pubescence,reproduction,seed,shape,size,texture,unifoliate
689	wfo-0001031065	success	140	88	56	84	32	0.4	.3,.4,.6,1-,1-celled,aculeate,almost,anther,attenuate,calyx,celled,chestnut,cm,corolla,deltate,dense,eglandular,externally,extra-axillary,ferruginous,fruit,glabrous,glandular,green,green-striate,herb,light,lilac,lobe,margin,mm,narrowly,non-glandular,nonglandular,ovary,ovate-lanceolate,ovoid,pale,pedicel,peduncle,petiole,puberulous,rarely,rough,simple,sometimes,sparse,spheroid,stellate,stem,stigma,style,subshrub,trichome,white,x	.1–0.3,.2,.5–2,0.2–1.1,0.5–1.6,0.5–5,0–30,1,1.8–7.8,2,4,4-merous,5-merous,accrescent,acicular,acuminate,acute,also,alyx,apex,apical,apparently,armed,asymmetrical,base,berry,beyond,cell,central,color,composed,concolorous,dia,difoliate,eaf,eed,either,entire,erect,filament,flower,frui,geminate,held,indumentum,lamina,lateral,lobed,lower,many,many-celled,midpoint,midvein,multi-celled,nflorescence,occasionally,orolla,per,perfec,perhaps,persistent,porrect-stellate,portion,radial,rare,rounded,ruit,scabrid,sessile,shor,short,short-pedunculate,slightly,solitary,spine,surface,tall,terete,umbelliform,unifoliat,unit,upper,usually,ympodial	.5-2,0-30,0.2-1.1,0.5-1.6,0.5-5,1.8-7.8,adhesion,annual,arrangement,colour,diameter,form,growth,height,history,inflorescence,leaf,length,life,na,plant,position,presence,present,pubescence,reproduction,seed,shape,size,staman,texture,tube
690	wfo-0001031071	success	186	94	69	117	25	0.371	0.2-0.8,1-1.5,1-2,1-3,2-8,2.1-3,2.4-3.4,3-10,3-6,4-6,5-9.4,6-8,7-16.5,8-28,abaxially,adaxially,anther,axillary,blue,brownish,bud,clavate,cm,condition,coriaceous,corolla,dark,deep,diameter,drying,elliptic,fresh,fruit,glabrous,globose,green,greenish,herb,lanceolate,leaf,lilac,lobe,long,medium,mm,mottled,odd-pinnate,ovate,ovoid,pedicel,peduncle,pentagonal,petiole,plant,purple,rotate,seed,size,spot,star,stigma,style,subtending,terminal,tube,white,whitish,x,yellow	0-10,0.4-2,1-7,1.5-2.2,2-3,2-5,3-5,3.8-5.4,4-25,5-merou,5.7-8.8,7-8,abaxiall,acumen,acute,ag,along,alyx,apart,apex,apparently,arranged,articulated,asymmetric,attenuate,axe,base,basiscopic,bead,berry,blade,capitat,cell,color,connivent,covering,decreasing,digestion,distal,dorsally,eaf,edge,eed,enzyme,erec,exceeding,filament,flat,flower,folded,forked,geminat,generally,glabrou,green-white,hair-like,half,homostylous,honeycomb-shaped,interjected,lateral,leaflet,lengthening,like,living,lower,make,middl,moniliform,mucilaginous,multiple,narrowly,necklace,nflorescence,orbicular,orolla,pair,perfect,petiolulate,plurifoliate,pore,poricidal,removed,ripe,round,ruit,sessile,seudostipule,short,side,slightly,slit,spaced,specimen,stamen,stolon,straight,subequal,tall,tamen,tem,testal,thick,throughout,tip,tissue,toward,tri-,tuber,typically,unit,usually,vary,wall,wet,winged,ympodial	adhesion,arrangement,calyx,capitate,colour,form,growth,height,history,inflorescence,length,life,na,ovary,perennial,position,pseudostipule,pubescence,reproduction,rugulose,shape,staman,stem,surface,texture
691	wfo-0001031097	success	174	80	62	112	18	0.356	0.45,1-4,1-4.5,1.6-5.5,1.8-2.5,13-30,2-3,2-3.3,2-4,3-5,3.7-8.4,4-6,5-12,5-9,9-21,abaxially,adaxially,calyx,cm,connate,corolla,darker,deep,diameter,distal,elliptical,forked,green,green-white,half,herbaceous,lateral,leaf,leaflet,light,long,medium,mm,obovate,odd-pinnate,ovate,ovoid,pair,pedicel,peduncle,pentagonal,perennial,petiole,plant,puberulent,pubescent,purple,rotate,seed,size,strigose,terminal,throughout,violet,violet-blue,wide,yellow	0.5,1,1-3,1.5,1.8-2.6,3-6-foliat,3.5-6,4-7,5-11,8-11,abaxial,acumen,acuminate,acute,along,apex,apical,apically,articulate,base,branched,cell,covering,cuneate,cyme,decurrent,dehiscent,dichasial,dichasially,digestion,diminishing,dorsally,dotted,eaf,ebracteate,edge,eed,emoval,enzyme,exceeding,filament,flat,flower,folded,frequently,generally,globo,gree,hair-like,highly,honeycomb,interjected,interpetalar,introrse,lighter,living,lobe,lon,lower,lunat,make,margin,maturing,monochasial,mottled,mucilaginous,narrow,nflorescence,noticeably,nther,oblique,often,orolla,pattern,perfect,petal,petiolulate,petiolule,plan,poricidally,proximal,rachi,rapidly,rarely,reveal,ruit,sessile,seudostipule,short,side,slit,sometimes,specimen,stamen,stigma,straight,style,tal,tem,testal,thick,tissu,toward,tuber-bearing,typically,unit,vary,vbase,wall,without,ympodial,¼	anther,arrangement,colour,form,fruit,growth,height,history,inflorescence,length,life,na,ovary,position,reproduction,shape,stem,texture
692	wfo-0001031101	success	197	121	87	110	34	0.442	-1,-16,-5,-8,/2,0.5-0.8,0.5-3,0.6-0.8,0.8-,1-2,1-2.3,1.3-2,1/4-1/2,2-2.8,2-4,2-6,2.5-3.8,3-15,3-8,3.5-4.5,abaxially,acuminate,anther,apex,apical,apically,base,blade,bright,calyx,cm,connivent,diameter,dull,entire,flattened-reniform,glabrescent,glabrous,glandular,hair,lateral,leaf,length,lobe,lobed,long,long-acute,margin,maturity,mauve,membranous,midpoint,minute,mm,moderately,narrow-deltate,near,obtuse,orange-brown,orange-red,ovate,pale,pedicel,peduncle,petiole,poricidal,ray,red,rounded,shrub,simple,smooth,sparsely,spherical,stellate,stellate-pubescent,stem,style,tapering,terminal,tip,trichome,tube,way,white,wide,yellow	-20,-30,/2-equal,0.05-0.2,0.1-0.2,0.1-0.3,0.3-0.5,0.7-0.8,1-,1-3,1.3-2.5,1.4-1.7,1.5-3,1/3-1/2,10-30,2-5,2.5-,2.5-3.5,3-10,4-10,4-5-merous,4-7,4.5-9,5-20,5-6,6-10,8-15,abaxial,adaxial,almost,alyx,ame,apar,apparently,articulated,ba,bark,berry,branched,c.,concolorous,deltate,difoliate,drying,eaf,eed,elongating,equal,erect,evenly,filament,filiform,flower,free,frui,fruiting,geminat,green,green-brown,herbaceous,infructescence,long-acuminat,longer,lower,mature,multangulate,nflorescence,often,older,one,open,orolla,oung,pair,pendulous,per,perfec,pericarp,porrect,portion,primary,red-brow,resembling,ruit,scandent,scar,sessile,spaced,spreading,stalk,stalked,stellate-pubescen,straight,surface,tamen,terete,tertiary,time,umbel,unarme,unarmed,unit,variously,vary,vein,venation,visible,yellow-green,ympodial,young	1-5,2.5-10,adhesion,arrangement,climate,colour,corolla,form,fruit,growth,height,history,inflorescence,life,long-acuminate,na,number,ovary,perennial,perfect,plant,position,presence,present,pubescence,red-brown,reproduction,seed,shape,size,staman,stigma,stipe,texture
693	wfo-0001031114	success	208	115	86	122	29	0.413	.2,0.3-0.5,0.5,0.7-1.5,0.8-1.2,1-10,1-2,1-7,2-17,2-3,2-7,2.5-3,3-10,3-4,4-10,4-8,4.5-6,5-10,abaxially,acuminate,acute,anther,apex,base,becoming,blade,brown,calyx,chartaceous,cm,connivent,deltate,densely,diameter,elliptic-ovate,entire,equal,first,flattened,fruit,globose,green,hair,leaf,leaf-opposed,light,lobe,margin,membanaceous,midpoint,mm,oblong,outline,ovate,pedicel,peduncle,petiole,pubescent,purple,ray,reniform,ripe,rounded,rugulose,shrub,simple,small,sparsely,stellate,stellate-pubescent,stem,stigma,strongly,style,subcoriaceous,subcuneate,surface,tip,tree,truncate,tube,white,white-pubescent,x,yellow,yellowish	.1,.5,0-0.3,0.5-1,1-1.5,1-4.5,1-8,1.5-2.5,1.5-4,10-15,2-4,2/3,25-50,3-5,3-7,4-5,5-8,5-merou,6-7,7-15,absen,accrescent,adaxiall,adaxially,ag,alyx,apart,apparently,articulated,axe,ba,berry,branched,capitat,covering,cylindrical,dark,differentiated,directed,discolorous,distal,distally,dried,eaf,echinoid,eed,erect,especially,filament,fleshy,flower,free,frui,fruiting,geminate,glabrous,highly,homostylous,impressed,interpetalar,introrsely,juic,lacking,large,like,long,long-stalked,longitudinal,lower,major,minor,multangulate,nearly,nflorescence,nodding,obtuse,often,one,opening,orolla,paired,part,perfect,pericarp,plurifoliate,pore,porrect,prominent,rachi,ruit,sessile,short,short-,short-stalked,side,slightly,slit,somewhat,spaced,stalk,ste,straight,subcucullate,subtending,tall,tamen,tem,thickened,thin,time,tissue,toward,triangular,unarme,unit,vary,vein,white-stellate,whitish,wide,without,ympodial	adhesion,arrangement,capitate,climate,colour,corolla,form,glandular,growth,height,history,inflorescence,length,life,na,number,ovary,plant,position,presence,pubescence,reproduction,seed,shape,size,staman,stipe,texture,ye
694	wfo-0001031116	success	191	115	85	106	30	0.445	.5,.8,/4,0.3-0.5,0.7-1,1-5,1/2,10-14,15-25,2-5,2.7-3.2,3.5-4,4-7,8-11,abaxially,acuminate,anther,apex,apically,base,berry,blade,broad-deltate,calyx,caudate,cm,connivent,densely,diameter,dirty-white,dull,elliptic,equal,evenly,flattened-reniform,fruit,glabrescent,glabrous,green,hair,lateral,leaf,length,lobe,lobed,long,lower,margin,maturity,mauve,membranous,midpoint,mm,moderately,obovate,obtuse,orange-brown,orange-red,pedicel,peduncle,petiole,poricidal,ray,rounded,sharply,shortly,shrub,simple,small,spherical,stellate,stellate-pubescent,stem,style,subentire,tapering,tip,tree,tube,upper,way,weakly,wide,yellow,young	-10,.2,0,0.05-0.15,0.1,0.4-0.7,0.7-0.9,1,1/3-2/,1/6-1/4,30-100,30-50,4-10,5,5-15,5-merous,9-13,abaxial,adaxial,almost,alyx,ame,apar,apart,apparently,arachnoid,articulated,attenuate,bark,branching,bristle,brow,c.,clearly,collapsed,discolorous,drying,eaf,eed,elongated,elongating,epidermi,erect,filament,flat,flexuous,flower,fragile,free,fruiting,glaucous-green,infructescence,less,longer,mature,minute,multangulate,narrow-deltate,nflorescence,obtu,often,older,one,open,orolla,oung,pair,per,perfec,pericarp,perpendicular,plurifoliat,portion,primary,recurved,red-brown,reflexed,ruit,scar,secondary,sessile,single,slender,smooth,soft,sometimes,spaced,sparsely,stalk,stalked,straight,surface,tamen,terete,tertiary,time,trichome,unarme,unarmed,unit,vary,vein,venation,visible,woody,ympodial	1/3-2/3,adhesion,arrangement,climate,colour,corolla,form,glandular,glaucous,growth,height,history,inflorescence,life,na,number,ovary,plant,position,presence,present,pubescence,reproduction,seed,shape,size,staman,stigma,stipe,texture
695	wfo-0001031127	success	196	120	94	102	26	0.48	+,0.5-1,0.5-1.3,0.8-2,1,1-1.5,1.5-2,1.5-2.5,1.5-3,2,2-3,2-lobed,3-4,3-5,3.5-4,3.5-7,4,6-6.5,7-30,8-16,abaxially,acute,adaxially,almost,anther,apex,attenuate,base,calyx,capitate,chartaceous,cm,conical,corolla,cupuliform,deep,densely,diameter,elliptic,elongate,flattened,flower,fruit,glabrous,globose,growth,inflorescence,internodal,lanceolate-elliptic,leaf,linear,lobe,lobed,long-styled,long-triangular,margin,membranous,midpoint,mm,number,opposite,ovary,pale,pedicel,peduncle,pentagonal,petiole,pinnatifid,poricidal,prickly,pubescent,purple,ray,red-violet,reniform,shallowly,shiny,short-styled,shrub,simple,somewhat,sparsely,stellate,stem,stigma,style,surface,tan,tapering,thin,tip,tube,x,yellowish	-2,.5,0.3-0.4,0.4-1.5,0.5,0.5-3,0.8-1,1-5-2,12268,3/4,30-100,5,5-8,8,?,acicular,anthesi,apar,apparently,armed,articulated,bark,berry,brown,cell,eaf,eed,ekman,ellipsoid,elongating,equal,even,extremely,fide,filament,free,fruiting,heterostylous,hyaline,included,individual,lamina,like,long,lower,m.,midrib,minute,minutely,near,new,nflorescence,nodding,older,open,outline,pair,papillat,per,pericarp,pitted,planar,plurifoliat,pore,porrect,portion,prickle,primary,prominent,rectangular,reddish,reduced,relatively,rest,ruit,scar,scattered,sessile,shin,short-stalked,sinuate,sinus,slightly,slit,sometimes,spaced,spreading,stout,testal,time,trichome,ud,unit,upper,variable,vein,way,widely,woody,yellow,ympodial,½	adhesion,arrangement,blade,climate,colour,form,glandular,hair,height,history,length,life,na,plant,position,presence,present,pubescence,reproduction,rugulose,seed,shape,size,staman,stipe,texture
696	wfo-0001031128	success	213	120	96	117	24	0.451	-100,-4.5,-6.5,/4,0.5-0.7,0.5-1.5,0.6-1,0.8-1.7,1-,1.5-3,1.5-3.5,2-5,2-9.5,2.3-,20-60,3-4,3.5-4.5,5-19,8-23,abaxially,acute,anther,apex,apically,base,berry,blade,calyx,cm,connivent,cuneate,deltate,densely,diameter,dull,elliptic,entire,equal,erect,evenly,flattened-reniform,fruit,glabrescent,glabrous,glandular,green,hair,inflorescence,lateral,leaf,length,lobe,lobed,long,long-acuminate,lower,margin,maturity,mauve,membranous,midpoint,minute,mm,moderately,near,orange-brown,pale,pedicel,peduncle,petiole,poricidal,purple-black,ray,red,shallowly,short-attenuate,shrub,simple,smooth,spherical,stellate,stellate-pubescent,stem,style,surface,tapering,terminal,tip,trichome,tube,undulate,way,white,wide,yellow,young	-10,0,0-30,0.05-0.2,0.05-0.25,0.2,0.2-0.4,0.3-0.8,0.5-0.8,0.5-5,1,1-1.6,1.2-2,1/,1/6-1/3,10-20,10-35,2.5-10,2.5-3.5,20-50,4-5-merous,4-7,5-,5-15,5-30,8-12,abaxial,almost,alyx,apar,apart,ape,apparently,articulated,bark,branched,branching,bristle,brown,concolorous,drying,eaf,eed,elongated,elongating,eye,filament,filiform,flexuous,flower,free,fruiting,gland,gra,infructescence,less,lon,long-acuminat,longer,mature,multangualte,multangulate,naked,narrow-deltate,nflorescence,occasionally,often,older,one,open,orolla,oung,pair,per,perfect,pericarp,perpendicular,plurifoliat,portion,primary,recurved,red-brown,reduced,reflexed,ruit,scar,secondary,sessile,short-styled,side,single,soft,spaced,spreading,stalk,stalked,staminate,straight,tamen,terete,tertiary,time,unarme,unarmed,unit,usually,variously,vary,vein,venation,visible,weakly,whitish,woody,yellow-brown,yellow-green,ympodial	1/3,adhesion,arrangement,climate,colour,corolla,form,growth,height,na,number,ovary,plant,position,presence,present,pubescence,seed,shape,size,staman,stigma,stipe,texture
697	wfo-0001031135	success	189	133	98	91	35	0.519	0-2,0.7-2,1-1.5,1-10,1-3,1.5-2,1.5-3,10-20,2,2-,2-2.5,2-23,2-3,2-3.5,2-4,2.5-28,3-4,3.5-12,4-5,5-9-pinnate,abaxially,acuminate,acute,adaxially,along,also,apex,basal,base,blade,calyx,campanulate,cm,compound,cordate,cuneate,darker,deltate,densely,diameter,eglandular-pubescent,ellipsoidal,entire,especially,fading,flattened,frequently,fruit,fusiform,glabrous,glandular-,green,hair,leaf,light,lobe,lobed,long,longitudinal,margin,midrib,mm,moderately,oblong,often,ovoid,papillose,pedicel,peduncle,peltiform,petiole,pilose,pink,pinnately,pinnatifid,puberulent,pubescent,purple,ripe,shrub,simple,sparsely,stigma,stripe,style,subcoriaceous,tip,toward,tree,truncate,tube,unlobed,violet,white,whitish,x,yellow-green,yellowish	-7,0.5-2,1-,1-2.5,1-4,1.5-9,2-5,3-10,3-5,4-foliat,5-11,5-30,7-15,absent,adpressed,aggregate,apart,ape,articulated,axe,basiscopically,beyond,biglandula,broad,cell,chartaceous,color,connective,coriaceous,cylindrical,decurrent,deflexed,dilated,directed,distally,eaf,eed,ellipsoida,elliptic,equal,exceeding,exserted,flower,interstitial,irregularly,lateral,laterally,leaflet,leaving,lon,lower,narrowed,nflorescence,nther,obconical,oblique,obtuse,occasionally,orolla,ovate,pedicellar,perfect,pilo,pore,present,rachi,radiu,remnant,ruit,shorter,slightly,small,smaller,spaced,stamen,stone,strongly,tal,tem,thecae,time,tomento,triangular,ud,unbranched,unit,unknow,upper,vary,wide,ympodial	adhesion,anther,arrangement,biglandular,climate,colour,corolla,form,glandular,growth,height,history,inflorescence,length,life,midpoint,na,number,ovary,plant,position,presence,pubescence,ray,reproduction,rugulose,seed,shape,size,staman,stellate,stem,stipe,surface,texture
698	wfo-0001031143	success	217	137	84	133	53	0.387	2,3,4,acute,anther,apex,attenuate,base,blade,broadly,cm,densely,diameter,elliptic,entire,evenly,extra-axillary,flattened-reniform,flower,free,fruit,glabrescent,glabrous,globose,green,hair,interpetalar,irregularly,lateral,leaf,length,like,lobe,margin,maturing,midpoint,minute,minutely,mm,moderately,narrowly,near,nearly,oblong,often,ovate,pale,pedicel,peduncle,per,petiole,pitted,ray,repand,sessile,shallow,short-caudate,shrub,side,simple,slender,smooth,soon,stellae,stellate,stellate-tomentose,stem,stigma,stipe,style,subcordate,surface,thick-chartaceous,tip,tissue,truncate,tube,usually,weak,well-developed,white,yellow,yellow-orange,×	0.3–0.5,0.3–0.8,0.4–0.8,0.4–1,0.7–0.9,0.9–1,0–50,1.1–2,1.4–1.7,1.5,1.5–1.9,1.5–2.5,1.5–3,1.5–5.5,10,10.5–11,15–23,1–1.2,1–1.5,1–4,2.3–2.5,2.5,2.5–4,2.5–4.5,2–2.5,2–3,2–3-branched,2–9,3–3.5,4–8-rayed,5,5-merou,5–7,6–8,7–12,8–10,9,abaxially,acicular,adaxially,alyx,apart,apical,apparently,appearing,armed,articulated,axe,ba,berry,bifoliate,blad,branch,broad,broad-based,bud,capitat,contrast,dark,directed,distall,dried,eaf,eed,except,fertile,filament,filiform,finely,forming,geminat,glabrou,half,high,homostylous,immature,internode,lanceolate,large,layer,leaving,lon,long,lower,major,material,midrib,midvei,midvein,minor,mixed,mostly,much,nflorescence,orolla,overlapping,ovoid,pore,porrect,potentially,prickle,principal,rarely,remaining,ruit,set,several,shorter,sinus,spaced,splitting,stellate-tomento,stipitate,straight,tamen,tardily,tem,time,tomentum,ud,unarme,unarmed,various,vary,vein,wide,yellow-ferruginous,ympodia,–11,–2.5,–4,–4.5,–8	0.3-0.5,0.3-0.8,0.4-0.8,1-1.2,1-1.5,1-4,1.1-2,1.4-1.7,1.5-1.9,1.5-2.5,1.5-3,15-23,2-2.5,2-3,2.3-2.5,2.5-4,2.5-4.5,4-8,4.5,6-8,7-12,8,8-10,adhesion,arrangement,calyx,capitate,climate,colour,corolla,form,glandular,growth,height,history,inflorescence,life,na,number,ovary,perennial,plant,position,presence,present,pubescence,reproduction,rugulose,seed,shape,size,staman,texture
699	wfo-0001031144	success	231	143	115	116	28	0.498	-11,-13,.2,.5,0.2,0.8-1.4,1-,1-4,1.1-2.5,2-,2-3,2-9,2.5-3,2/3,25,3-7,3.5-10,4-4.5,6,7-10,<,acuminate,acute,adaxially,anther,apex,apiculae,asymmetric,base,berry,bright,broadly,brown,calyx,capitate,cm,commonly,connivent,cordate,corolla,densely,diameter,ellipsoid,elliptic,entire,flattened,flattened-reniform,form,glabrous,globose,groove,growth,inflorescence,later,lateral,leaf,less,like,lobe,lobed,long,loosely,margin,membranous,mere,minutely,mm,number,oblique,occasionally,open,pale,pedicel,peduncle,petiole,pinnately,pinnatifid,pitted,pubescent,red,reddish,rim,ripe,seed,shiny,simple,slightly,sparsely,stellate-rotate,stem,stigma,style,surface,tan,terminal,tiny,tip,triangular,trichome,truncate,tube,tuft,uniseriate,upper,usually,vein,vine,violet,way,white,woody,x,yellow,yellowish,½	0.5,1-1.5,100,2,2-6,3-4.5,4,4-20,4-6,5,5-9,5-merou,ag,alyx,anthesi,apart,apicula,appearing,ark,around,articulated,away,axi,basal,basiscopically,blac,branch,branche,brow,cell,closer,corresponding,cupped,curved,divaricate,drying,eaf,eed,elongate,elongating,exserted,extending,filament,flower,four,free,fruiting,geminat,ilament,inflated,irregularly,lamina,larger,leaflet,leaving,lengthening,longer,longest,lower,many,markedly,minute,near,new,nflorescence,often,older,one,orolla,outline,pair,papillo,peg,pendant,pentagonal,per,perfect,pericarp,plurifoliate,pore,poricidal,portion,primary,progress,quite,ruit,scar,sleeve,slit,small,smaller,sometimes,spaced,spreading,strongly,tangle,tem,terete,testal,thin,third,together,twinin,twining,two,ud,unequal,unit,variable,vary,wall,weight,widest,wing,wood,ympodial	adhesion,arrangement,blade,climate,colour,fruit,glandular,hair,height,history,length,life,midpoint,na,ovary,plant,position,presence,pubescence,ray,reproduction,rugulose,shape,size,staman,stellate,stipe,texture
700	wfo-0001031152	success	232	123	98	134	25	0.422	-1.5,-10,.4,/100-1/16,0.2-0.3,0.2-1.5,1-3,1-6,1.1-2.2,1.2-1.8,1.4-2.6,1/2-3/4,11,13-27,2-5,2.5-7.5,2.7-3.7,4-19,4-6,4-8,8-20,abaxially,adaxially,anther,apart,basal,base,becoming,blade,blunt-tipped,brown,bullate,cm,conical,continued,corolla,deltoid,densely,diameter,due,flower,fruit,globose,granular-tomentose,greenish,growth,hair,honeycombed,inserted,lanceolate,lateral,lavender,leaf,length,lilac,mixed,mm,mostly,multangulate,oblanceolate,oblong,pale,pedicel,peduncle,persistently,petiole,pitted,probably,pubescent,reddish,reniform,reticulate-punctate,ripe,rotate-stellate,scabrous,sessile,short-,shrub,simple,sparsely,stellate-pubescent,stem,stigma,style,suborbicular,surface,terete,terminal,testa,thick-stalked,tomentose,tree,tube,violet,x,yellow,yellowish,young	-5.5,0-100,0.3-1.3,0.3-3,1-1.5,1.1-3,1.3-4,1.5-3,1.5-3.5,1/2-2/3,2.7-4.5,2.7-6,2.8-4,3.7-7,4-7,5-6,6.5-10,9-13,accrescent,acuminate,acute,ag,along,anthesi,apex,apical-lateral,apparently,articulated,attenuate,axe,axillary,ba,berry,blister,branch,branched,bud,calyx,capitat,chartaceous,closely,decurrent,dehiscing,directed,eaf,earl,eed,entire,evident,exserted,extend,few-rayed,filament,fleshy,free,fruiting,glabrescen,glabrous,green,high,introrse,lackin,large,less,lobe,lobed,long,long-,longer,longitudinal,lower,m.,main,margin,midvein,moderately,multangulat,narrowly,nearly,nflorescence,obtuse,occasionally,one,open,openly,orbicular,orolla,ovate,partly,perfect,plurifoliate,pore,porrect-stellate,rachi,rather,ray,reddish-brown,relatively,ruit,runk,short-stalked,side,slightly,slit,somewhat,soon,spaced,sparingly,splitting,stamen,stelliform,stipitate-glandular,stout-stalked,strongly,suture,swelling,tamen,thick,thin,thin-,thin-stalked,time,touching,toward,unarme,unarmed,unit,usually,variously,vary,vein,way,wide,ympodial	.3-3,adhesion,arrangement,capitate,colour,form,glabrescent,height,history,inflorescence,life,na,ovary,perennial,plant,position,pubescence,reproduction,rugulose,seed,shape,size,sparing,staman,texture
701	wfo-0001031155	success	193	116	86	107	30	0.446	0.2,0.5,1-1.2,1.5,1.5-2,1.5-5,2-5,2.5-3.2,4-,4-6,4.5-7,7-15,8.5-13,abaxially,acuminate,acute,almost,anther,apex,base,beneath,bilobed,calyx,climbing,cm,corolla,cream,cup-shaped,dark,deeply,deltate,densely,diameter,elliptic,evenly,glabrous,glandular,growth,height,inflorescence,internodal,lanceolate,leaf-opposed,like,lobe,lobed,margin,midpoint,minutely,mm,multangulate,narrowly,oblique,obtuse,open,orange,pedicel,peduncle,petiole,prickly,pubescent,ray,shallowly,shiny,short-stalked,shrub,simple,size,slightly,sparsely,stellate,stem,stigma,strongly,style,surface,tapering,terminal,tip,trichome,tube,unknown,white,whitish,x,yellowish	.5,0,0.1,0.2-1.2,0.3-0.4,0.7,0.7-1.5,1,1-1.5,1.5-1.6,3-4-foliate,5-20,5-7,adaxially,age,along,anthesi,apart,apparently,appearing,armed,articulate,axi,bark,broader,bullate,cell,central,closely,common,discolorous,distall,distally,due,eaf,echinoid,eed,enlarged,equal,exserted,ferrugineous,filament,fine,flower,glabrescen,globose,halfway,heavily,heterostylous,hub-like,intertwined,know,known,larger,leaving,lengthening,long,longer,los,lower,midrib,mixed,mixture,multiseriate,new,nflorescence,occasionally,older,once-branched,outline,pair,pale,papillat,part,peg,plurifoliate,pore,poricidal,porrect,prickle,primary,principal,purple,reddish,ruit,scar,seen,sessile,short-styled,small,somewhat,spaced,sparse,sparser,split,stalk,stout,straight,tan,ud,unevenly,unit,variable,vein,widely,within,ympodial	10,8,adhesion,arrangement,blade,climate,colour,form,fruit,hair,history,leaf,length,life,na,number,ovary,papillate,plant,position,presence,present,pubescence,reproduction,rugulose,seed,shape,staman,stipe,texture
702	wfo-0001031162	success	241	133	105	136	28	0.436	.5,0.1-0.15,0.15-0.4,0.4-0.8,0.5-0.7,0.5-0.8,0.7-5,0.8-1.2,1-1.5,1-15,1-2,1-5,1.5-2,1.5-2.5,1.5-3,1.7-4.5,2-2.8,3-10,3.5-10,3.5-5.5,4-6,4-8,5-10,7-17,7-9,8-14,abaxially,acute,adaxially,angled,anther,apart,apex,articulated,attenuate,base,black,blade,broadly,calyx,chartaceous,cm,cordate,cylindrical,deeply,deltate,densely,diameter,eglandular,erect,extra-axillary,flower,fruit,glabrous,gland-tipped,globose,green,hair,inflorescence,interpetalar,irregularly,lanceolate,leaf,length,lobe,lobed,long,margin,midpoint,minutely,mm,moderately,obtuse,outline,ovate,pale,pedicel,peduncle,perennial,petiole,present,pseudohair,pubescent,purple,ray,reniform,reticulate,rhizomatous,short,shrub,simple,spaced,sparsely,stellate,stellate-pubescent,stigma,style,surface,tan,thick,throughout,tissue,tube,x,yellow	%,-74,0,0-1.2,0-1.5,0-2.5,0-25,0.05-0.1,0.1-0.2,0.1-0.8,0.25,0.5-1.5,0.5-2,0.5-3,0.5-7,0.6-0.8,0.7-1.2,1-1.7,1-10,1-13,1-locular,1.2-1.4,1.5-1.9,1.5-8,10,10-12,10-30,15-20,2-,2-7,2-foliate,20-40,26-,3-4,3-branched,35-200,4-5,4-9,5-6,5-7,5-merou,6,6-7,6-8,60,600-1400,7-70,absent,accrescent,acicular,across,adult,alyx,apparen,armed,ascending,axe,ba,branch,branche,capitat,connivent,decimetre,directed,distall,distributed,dm,eaf,eed,exocarp,filament,finger,fruiting,geminat,generally,half,homostylous,incomplete,index,juicy,juvenile,lamina,lateral,less,lobing,lon,longer,lower,mature,mesocarp,mid-point,midvein,minute,moderate,narrow,nflorescence,oblique,orolla,pair,part,pendant,per,perfect,placenta,pore,porrect,presen,prickle,rachi,ruit,septum,sessile,side,somewhat,sparse,stalk,stellae,straight,succulent,tal,tamen,tem,time,tissu,transparent,triangular,unbranched,unit,upper,vary,vein,white,wide,wing,yellowish,ympodial	adhesion,arrangement,capitate,climate,colour,corolla,form,glandular,growth,height,history,life,na,number,ovary,plant,position,presence,pubescence,reproduction,rugulose,seed,shape,size,staman,stem,stipe,texture
703	wfo-0001031178	success	167	101	72	95	29	0.431	0-0.2,0-0.25,0.3-0.6,0.6-0.9,0.6-1,0.7-1.7,0.8-1.2,0.9-1.2,1.2-1.4,1.5-5.2,2-3.5,3.5-9,4-4.5,4-9,5-11,7-8,7.5-8.5,absent,acute,adaxially,anther,apex,attenuate,base,blade,brown,calyx,chartaceous,cm,cuneate,densely,diameter,entire,extra-axillary,fruit,glabrous,globose,green,grey,hair,inflorescence,lanceolate,lateral,length,lobe,lobed,long,margin,midpoint,mm,ovate,pedicel,peduncle,perennial,petiole,present,purple,ray,rusty,shallowly,shrub,simple,sparsely,stellate,stellate-pubescent,stem,style,time,tube,unknown,x,yellow	%,0-0.4,0-0.6,0-10,0-5,0-6,0.1-0.2,0.1-0.25,0.4-0.6,0.6-1.2,0.7-1,1-2,1-3,1-4,1.2-1.5,1.2-3.4,1.5-6,11-18,180-400,19-30,2-5,40-65,5-merou,6-14,6-8,7-11,abaxially,accrescent,acicular,across,adaxiall,alyx,apart,armed,articulated,ascending,axe,ba,cylindrical,d.,directed,distall,distributed,dult,eaf,eed,eglandular,erect,finger,flower,fruiting,glabrou,gland-tipped,half,hig,juic,lamina,lon,longer,lower,mature,mesocarp,midvein,minute,moist,nflorescence,oblique,orolla,part,per,pore,porrect,presen,prickle,pseudo-racemose,rhizomatous,ruit,short,solitary,spaced,stage,stalk,stellae,straight,tamen,thick,throughout,unbranched,unit,unknow,uvenile,vary,vein,wide,ympodial	adhesion,arrangement,climate,colour,corolla,form,glandular,growth,height,history,leaf,life,na,number,ovary,plant,position,presence,pubescence,reproduction,rugulose,seed,shape,size,staman,stigma,stipe,surface,texture
704	wfo-0001031185	success	213	129	105	108	24	0.493	-10,-8,.5,0.5-1.5,0.5-3,0.8-1,0.9-,1,1-,1-1.2,1-1.5,1-5,1.2-5,2-9,2.5-16,3-4,4.5-7.5,7-10,acuminate,acute,anther,apex,attenuate,base,blade,bright,broadly,brown,calyx,capitate,cm,conical,connivent,corolla,deeply,deltate,densely,diameter,dry,ellipsoid,entire,eye,flattened,glabrous,globose,green,growth,inflorescence,lateral,lax,leaf,living,lobe,lobed,long,loosely,margin,material,meter,minutely,mm,moderately,ovate,pale,papillate,pedicel,peduncle,petiole,pinnatifid,pubescent,red,reniform,ripe,rounded,seed,several,shape,shiny,shrub,simple,size,slightly,sparsely,stellate,stem,stigma,style,surface,tan,terminal,thin,tip,trichome,truncate,tube,ultimate,uniseriate,vine,violet,white,whitish,wide,woody,yellow,yellowish	.2,0.5,0.8-1.3,1-10,1-4,1.5-4,10-40,2/3,20,4-6,5-merou,>,ag,alyx,anthesi,apart,apically,appearing,appressed,ark,articulated,away,axi,basal,berry,branched,cell,closer,commonly,curved,distal,eaf,eed,elongate,exserted,extremely,filament,flower,free,fruiting,glabrescen,ilament,inflorescenc,irregular,irregularly,leaving,lengthening,like,lobbing,lon,lower,many,materia,mature,midrib,new,nflorescence,older,onto,open,orolla,outline,pair,part,particularly,peg,per,perfect,pericarp,pitted,plurifoliat,pointing,pore,poricidal,portion,reflexed,ruit,scar,sinus,slender,slit,small,spaced,spreadin,spreading,still,strongly,tem,thickened,third,time,toward,ud,unit,upper,usually,variable,variously,vary,visible,wall,way,weak,widest,winged,within,ympodial,½	adhesion,arrangement,climate,colour,form,fruit,glandular,hair,height,length,midpoint,na,number,ovary,plant,position,presence,pubescence,ray,rugulose,staman,stipe,texture,ye
705	wfo-0001031195	success	216	116	91	125	25	0.421	0-0.7,0.2-0.5,0.25-0.35,0.3,0.5-1,0.6-0.8,0.6-1.5,1,1-1.5,1.4-1.6,1.5-2.5,11-28,2-2.5,2.5-4,20-32,3-3.5,3.5-4,3.5-5.5,4-7,5.5-10,7-8,7.5-8,abaxially,adaxially,andromonoecious,anther,attenuate,base,broadly,calyx,chartaceous,cm,cylindrical,deeply,densely,diameter,distal,eglandular,ellipsoidal,extra-axillary,finely,flattened,flower,fruit,glabrous,gland-tipped,globose,green,grey,hair,half,inflorescence,leaf,length,lobe,lobed,midpoint,mm,moderately,narrowly,ovate,pale,pedicel,peduncle,perennial,petiole,plant,present,prostrate,purple,ray,reticulate,rusty,shallowly,short,shrub,simple,sparsely,stellate,stellate-pubescent,stigma,stoloniferous,style,surface,triangular,tube,weakly,whitish,x,yellow,yellowish-green	%,0-3,0-8,0.05-0.3,0.2-0.4,0.3-0.4,0.5-0.7,0.6-3,1-2,1-4,1-locular,1.4-2.9,10-13,10-14,10-19,15-35,2,2-4,2-5,3-4,3-5,3-6,4-5,4-9,5-9,5-merou,6-10,8-9,9-15,absen,absent,accrescent,acicular,across,acute,alyx,apart,apex,articulated,axe,ba,blade,capitat,center,confined,connivent,cuneate,d.,difoliate,directed,distall,distributed,eaf,eed,entire,exocarp,filament,filiform,finger,fruiting,functional,geminate,heterostylous,incomplete,interpetalar,irregularly,juic,lamina,lateral,less,long,longer,loosely,lower,margin,mature,mesocarp,midrib,midvein,minute,moist,nflorescence,oblique,obtuse,orolla,part,per,pore,porrect,presen,prickle,probably,pseudo-racemose,rachi,ruit,septum,sessile,solitary,spaced,sparse,splitting,stage,stellae,straight,tal,tamen,tem,thick,throughout,time,tip,tissu,tissue,transparent,unarme,unarmed,unbranched,unit,uvenile,vary,vein,white,wide,yellowish,ympodial	adhesion,arrangement,capitate,climate,colour,corolla,form,growth,height,history,life,na,number,ovary,position,presence,pubescence,reproduction,rugulose,seed,shape,size,staman,stem,texture
706	wfo-0001031202	success	198	123	91	107	32	0.46	0-1,0.5,0.6-1.1,0.8-1,1-1.5,1.5-2.5,15-40,2-3,2-8,2.5-3.5,2.5-4,2/3,3.5-4,6-25,9-20,acute,along,anther,apex,apiculate,base,beneath,broadly,calyx,capitate,cm,cordate,corolla,cup-shaped,deltoid,densely,dia,fleshy,fruit,glabrous,globose,golden,green,hard,inflorescence,later,lateral,leaf,lobe,lobed,margin,minute,minutely,mm,obovate,occasionally,opposite,ovary,overtopping,ovoid-reniform,pale,papillose,pedicel,petiole,pitted,plant,puberulent,pubescent,reddish-brown,sessile,shape,shaped,shoot,shrub,size,slightly,small,sparsely,stem,stigma,style,surface,tan,tear-drop,terminal,tip,tree,trichome,tube,uniseriate,variable,vein,way,white,woody,x	.1,.5,0-0.5,0.1-0.3,0.5-1,1-1.7,1-5,1.5-2,1.5-9,2.5-13,20-100-flowered,9-11,abrupt,accrescent,anthesi,apart,axi,bark,berry,bud,completely,complex,condition,corky,decurrent,deflexed,differing,difoliate,distal,dry,due,eaf,edicel,eed,enclosed,erect,exserted,extremely,filament,flower,free,frui,fruiting,furcate,geminat,glabrate,greenish-white,greyi,irregularly,large,like,live,lon,long,long-ellipsoid,long-styled,longer,lower,main,major,many,material,middle,minor,narrowing,nflorescence,occasional,often,older,one,orbicular,pair,paler,papillo,planar,pore,poricidal,portion,prominent,quite,raised,rounded,ruit,scar,scattered,short-styled,slender,spaced,specimen,straight,tall,tapering,thick,thickened,thicker,third,time,tub,ud,unit,usually,weight,whitish,widest,winged,ympodial,young	adhesion,arrangement,blade,climate,colour,diameter,form,glandular,greyish,growth,hair,height,history,length,life,midpoint,na,number,peduncle,perennial,position,presence,present,pubescence,ray,reproduction,rugulose,seed,staman,stellate,stipe,texture
707	wfo-0001031203	success	218	129	102	116	27	0.468	0-0.5,0.3-0.6,1-2,1-3,1.5-2.5,1.8-2.8,2-7,2.1-2.7,2.5-9.5,21-39,25-45,3-10,3.2-4,4-16,4-6.5,5-8.5,5.5-8,6.5-9.5,8-11,8-14,abaxially,acute,adaxially,almost,anther,apex,asymmetric,base,berry,blade,broadly,calyx,campanulate,cm,coarsely,connivent,deciduous,deep,densely,dentate,diameter,erect,essentially,extra-axillary,first,flower,foveolate,fruit,glabrous,globose,greenish-white,hair,inflorescence,lanceolate,length,lenticular,lignescent,linear-lanceolate,lobe,margin,maturity,midpoint,minutely,mm,obtuse,often,orange-red,outline,ovate,ovoid,pedicel,peduncle,per,perennial,perfect,petiole,present,pubescence,rarely,ray,red,reniform-ovate,ripe,sericeous,simple,smooth,somewhat,sparsely,spreading,stellate,stellate-pubescent,stem,stigma,style,surface,thin-textured,truncate,tube,usually,white,x,yellow	-1.5,-2,.2,.7-1,0-0.8,0-2.5,0.05-0.15,0.05-0.2,0.1,0.1-0.8,0.3,0.4-1,0.5-1.8,1-5,1/10-1/4,11-18,15-22,15-50,2-3.5,2-5,2-foliate,4-12,4-6-locular,5-7,5-8,5-9,6-16,abaxiall,acute-tipped,adaxiall,along,apart,apparently,articulated,attenuate,axe,ba,capitat,cinereous-tomentose,consisting,curved,cylindrical,deltoid,directed,distall,distributed,downcurved,eaf,eed,elongate,filament,flesh,geminat,interlobal,interwoven,invested,lateral,less,lon,long,longer,lower,lowermost,lying,major,midvein,much,nflorescence,numerous,obsolete,orolla,ovate-lanceolate,pair,parallel,plane,pore,prickl,projecting,prominent,rachi,reduced,relatively,ruit,sessile,short,short-stalked,shorter,side,sinus,smaller,spaced,stalk,stellae,stellate-pubescen,surfac,tal,tamen,tem,terete,termination,thickened,three,time,tip,tooth-like,unarmed,unbranched,unit,uppermost,upward,vary,vein,weakly,well-developed,wide,ympodial	adhesion,arrangement,capitate,climate,colour,corolla,form,glandular,growth,height,history,leaf,life,na,number,ovary,plant,position,presence,reproduction,rugulose,seed,shape,size,staman,stipe,texture
708	wfo-0001031207	success	219	112	84	135	28	0.384	-11,-4,-7,-8,0,0.1-0.2,0.5-1,0.6-0.9,0.6-1.2,0.7-2,0.85-1.4,1.4-2,1.5-5,1/4-1/3,2-3,2.1-2.3,2.8-3,3-5,3.5-7,5-8,6-8,anther,apex,base,blade,calyx,chartaceous,cm,cordate,densely,diameter,dull,evenly,flattened-reniform,fruit,gray,green,herb,lateral,leaf,length,lobe,lobed,long,lower,margin,maturity,mauve,mm,moderately,narrow-deltate,oblong,obtuse,orange-brown,ovate,pale,pedicel,peduncle,petiole,poricidal,ray,red,scandent,shrub,simple,smooth,sometimes,spherical,spreading,stellate,stellate-pubescent,stem,style,subentire,surface,tapering,terminal,tip,tube,upper,white,wide,yellow,young	-0.4,-1/2,-5,.1,/5,0-0.5,0-10,0-20,0.1-0.3,0.1-0.5,0.2,0.2-0.3,0.25-0.5,0.3-0.5,0.8,0.9-1.6,1,1-3,1-4,1-5,1/,1/3,1/3-equal,2-4,2.5-,5-merous,6.5-8,9,abaxially,acuminat,acute,alyx,ame,apar,apart,apically,apparently,articulated,bark,berry,branched,bristle,bristly,broad-deltate,brow,c.,cell,concolorous,curved,dark,difoliate,discolorous,distance,drying,eaf,eed,elongated,elongating,equal,erect,extending,eye,filament,filiform,flower,free,fruiting,geminat,gently,glabrescent,glabrous,herbaceous,infructescence,lanceolate,less,like,longer,mature,midpoint,midvein,multangulate,naked,nflorescence,occasionally,older,one,open,orolla,oung,outline,pair,pendulous,per,perfec,pericarp,perpendicular,persistent,pit,porrect,portion,prickl,prickle,prickly,primary,raised,reflexed,rounded,ruit,scar,sessile,shorter,side,small,spaced,stalk,stalked,straight,tamen,terete,tertiary,time,toward,trichome,unarmed,unit,usually,variously,vary,vein,venation,visible,way,weakly,yellow-green,ympodial	1/4,adhesion,arrangement,colour,corolla,form,growth,height,history,inflorescence,life,na,number,ovary,plant,position,presence,pubescence,reproduction,rugulose,seed,shape,size,staman,stigma,stipe,texture,ye
709	wfo-0001031217	success	222	118	92	130	26	0.414	.5,0.1-0.3,0.2-0.3,0.25-0.4,0.25-1.3,0.3-0.4,0.3-1,0.35-0.6,0.5-0.75,0.6-1.8,1-1.5,1-2,1.5-4.2,13-21,2-2.5,2-3,2.6-3,3.5-4.5,4-11,5.5-7,6-8,7-17,abaxially,absent,acuminate,acute,adaxially,anther,apex,base,blade,brown,calyx,chartaceous,cm,connivent,cuneate,cylindrical,densely,diameter,elliptic,elliptical,entire,erect,extra-axillary,flower,fruit,glabrous,gland-tipped,globose,hair,inflorescence,lanceolate,lateral,leaf,length,light,lobe,long,loosely,margin,mm,moderately,narrowly,ovate,pale,pedicel,peduncle,perennial,petiole,present,purple,ray,red,reticulate,rhizomatous,scattered,shape,short,shrub,simple,sparsely,stellate,stellate-pubescent,stigma,style,surface,time,tube,violet,x,yellow	%,.5-2,0-0.1,0-3.5,0-5,0-6,0.1-0.2,0.15-0.25,0.3-0.5,0.4-0.7,0.5-3,0.8-4,1,1-20,1-4,1-locular,1.5-2,1.5-4,2-5,2-8,2-9,2.5-4,3-4,3-4.2,4-6,5-12,5-7,5-merou,6-12,7-8,7-9,9-10,absen,accrescent,acicular,across,adult,alyx,apart,apparen,articulated,axe,ba,borwn,branch,branche,broad-based,confined,contiguous,directed,distall,distributed,dm,eaf,eed,eglandular,exocarp,filament,finger,fruiting,geminate,green,greenish-white,half,incomplete,interpetalar,juicy,juvenile,lamina,less,lobed,longer,lower,mature,mesocarp,mid-point,midpoint,midrib,midvein,minute,much,nearly,nflorescence,oblique,orolla,overlapping,pair,paired,part,pendent,per,perfect,placenta,plurifoliate,pore,porrect,prickle,pseudo-umbellate,rachi,ruit,scarcely,septum,sessile,shallowly,smaller,sometimes,spaced,sparse,stalk,stellae,straight,succulent,tal,tamen,tem,thick,throughout,tissu,tissue,transparent,triangular,truncat,unarme,unarmed,unbranched,unit,upper,vary,wide,ympodial	adhesion,arrangement,colour,corolla,form,glandular,growth,height,history,life,na,number,ovary,plant,position,presence,pubescence,reproduction,rugulose,seed,size,staman,stem,stipe,texture,truncate
710	wfo-0001031218	success	154	115	83	71	32	0.539	0.5-1,1-2,1-3,15-25,2-2.5,2-22,2-3,3,3-14,3-5,4-28,4-7,4-8,40,5-37,5.5-7,6-10,6-7,6-9,8-20,abaxially,acuminate,adaxially,apex,apiculate,base,branched,calyx,cm,connivent,cordate,coriaceous,dark,diameter,eglandular-pilose,ellipsoidal,entire,especially,flattened,fruit,glabrous,glandular,glandular-puberulent,globose,greenish-purple,hair,lanceolate,lavender,lobe,margin,minutely,mm,moderately,mottled,oblique,obtuse,orange,ovate,ovate-elliptic,ovoid,pedicel,peduncle,petiole,present,puberulent,purple,rachi,ripe,simple,sometimes,sparsely,stellate,stigma,style,subcoriaceous,succulent,tip,toward,tree,tube,violet,x,yellow	-5,0.5,1-4,10-19,2.5-3,4-5,4-foliat,40-100+,5-7,8-17,acute,aggregate,apart,ape,articulated,axe,basal,beyond,blade,cell,connective,cylindrical,densely,directed,distally,eaf,eed,eglandular,equal,exceeding,exserted,flower,glabrou,introrse,leaving,less,lon,long,lower,narrowly,nflorescence,nther,orolla,papillo,pedicellar,perfect,pore,presen,pubescent,purpl,radiu,remnant,ruit,shorter,slightly,small,spaced,stamen,stone,tal,tem,thecae,time,tomento,triangular,truncat,ud,unit,vary,wide,ympodial	abaxial,adaxial,anther,arrangement,colour,corolla,form,growth,height,hermaphroditic,history,inflorescence,leaf,length,life,na,ovary,papillose,perennial,plant,position,presence,pubescence,reproduction,rugulose,seed,shape,size,stem,surface,texture,truncate
711	wfo-0001031225	success	163	83	64	99	19	0.393	.5,0.2-0.75,0.7-6,0.75-1,0.8-1,1-1.5,1-5,2,2.5-3,3-9,3/4,5-6,7-9,9-16,along,anther,base,calyx,cm,corolla,dia,elliptic,glabrous,globose,green,growth,inflorescence,leaf,like,lobed,long,minutely,mm,opposite,ovary,ovate,ovoid-reniform,pale,papillose,pedicel,petiole,pitted,plant,poricidal,pubescent,shape,shrub,size,small,stem,stigma,style,surface,tan,tip,tree,trichome,tube,uniseriate,vein,way,white,x,young	.25,/3,0.1-0.75,0.2,0.5,0.5-1,1-1.7,1-3,1.5-5,5-50-flowered,6-8,acute,anthesi,apart,apex,bark,beginning,berry,broadly,bud,characteristic,closely,conspicuous,cup-shaped,darker,decurrent,deltoid,differentiated,differing,difoliate,dry,eaf,edicel,eed,ellipsoid,erect,exserted,filament,flattene,fragrant,free,fruiting,furcate,geminat,glabrate,greyish-brow,inflorescenc,lateral,less,live,lobe,lon,lower,main,major,margin,middle,minor,minute,much,narrowly,nflorescence,often,older,one,outline,pair,papillo,pore,portion,prominent,proximal,raised,red-papillose,reflexed,rest,rhomboidal,rounded,ruit,scar,shaped,slender,slightly,soon,spaced,specimen,straight,strongly,sweetly,swelling,tall,tapering,tear-drop,ud,unevenly,unit,widest,woody,ympodial	0.25,colour,diameter,form,fruit,height,history,length,life,na,perennial,position,presence,pubescence,reproduction,rugulose,seed,stellate,texture
712	wfo-0001031231	success	175	119	87	88	32	0.497	-2,.5,0.5-1.5,1-1.5,1-2,1.5-2,2-3,2.5-3,3-4,37/2,37/3,4-8,5-7,8-10,absent,acuminate,acute,almost,anther,apex,aromatic,axillary,base,blunt,branch,brown,calyx,campanula,campanulate,cm,colour,corolla,dark,discoidal,elliptic,entire,equal,erect,except,fork,glabrous,glandular,globose,green,greyish,hair,juvenile,lanceolate,leaf,len,less,lobe,long,loosely,marbled,margin,minute,mm,oblong,often,ovary,pedicel,peduncle,pentagonal,petal,pinnatisect,plant,purple,rh,ripe,ripening,rotate,rounded,seed,short,shrub,simple,sometimes,stigma,stout,style,succulent,surface,tinged,tip,violet,x	1-3,1-4,13,2-4,25-35,80-110,acumen,adherent,along,anthesi,aspect,axi,basal,becoming,berry,beyond,bluntly,branched,cell,clonal,cluster,declinate,developed,dia,eaf,eed,ellipsoid,exceeding,exerted,expanded,facetted,filament,fleshy,flower,flowering,folded,general,gree,habit,herbarium,interacuminal,lasting,lengthening,lon,lower,mature,mauve,midrib,nflorescence,occasionally,pedice,pedicellate,plurifoliat,pore,poricidal,projecting,rarely,readily,recurve,rugose-ruminate,ruit,sessile,several,shallow,shed,sinus,slightly,slit,small,soft,specimen,stone,stonrgly,tissue,toward,translucent,triangular,tub,ud,unit,usually,variable,vigorous,well,without,wooded,year,ympodial	adhesion,arrangement,blade,climate,diameter,form,fruit,growth,height,history,inflorescence,length,life,midpoint,na,number,perennial,petiole,position,presence,pubescence,ray,reproduction,rugulose,shape,size,staman,stellate,stem,stipe,texture,tube
713	wfo-0001031252	success	170	90	60	110	30	0.353	0.2-1.5,0.3-1.1,1-3,1.3-1.9,1.75-5.2,16-33,2-3,2.5-7,2.8-3.6,3-10,3-6,5-17,5-8,5-9,anther,axillary,brownish,bud,clavate,cm,condition,coriaceous,corolla,dark,deep,diameter,drying,elliptic,fresh,fruit,glabrous,globose,green,greenish,herb,lanceolate,lobe,medium,mm,mottled,ovate,ovoid,pedicel,peduncle,petiole,plant,purple,rotate,seed,simple,stigma,stripe,style,subtending,terminal,tube,white,whitish,x,yellow	0.4-3,1-2,12-20,3-5,5-merou,5.5-6.5,7-18,abaxially,absent,acumen,acute,adaxiall,adaxially,ag,along,alyx,apart,apex,apparently,arranged,articulated,attenuate,axe,base,bead,berry,blade,capitat,cell,ciliate,connivent,covering,cuneate,digestion,distal,dorsally,eaf,edge,eed,entire,enzyme,erec,exceeding,filament,flat,flower,folded,forked,geminat,generally,glabrou,green-white,hair-like,hal,half,high,homostylous,honeycomb-shaped,interjected,lateral,leaflet,lengthening,light,like,linear,living,long,lower,make,margin,moniliform,mucilaginous,multiple,necklace,nflorescence,orolla,perfect,plurifoliate,pore,poricidal,removed,ripe,rounded,ruit,serrate,seudostipule,slit,sometimes,spaced,specimen,stamen,stolon,straight,tall,tamen,tem,testal,thick,throughout,tip,tri-,tuber,typically,unit,unwinged,usually,vary,wall,wet,ympodial	adhesion,arrangement,calyx,capitate,colour,form,growth,height,history,inflorescence,leaf,length,life,na,number,ovary,perennial,position,presence,pubescence,ray,reproduction,rugulose,shape,size,staman,stellate,stem,surface,texture
714	wfo-0001031257	success	206	115	79	127	36	0.383	-12,-22.5,-5,-6,0.7-1,0.75-2.5,1-1.2,1-1.3,1.1-1.2,1.5-1.7,10-16,2-4.5,3.5-,3.5-5.7,4-4.5,4.5-,5-8.5,6-12,7-,7.5-9,abundant,acuminate,anther,anthesi,apex,attenuate,basal,base,blue-violet,bud,calyx,campanulate,cm,coarsely,corolla,cuneate,dark,dentate,diameter,ellipsoidal,flexuous,glabrous,glandular,globose,half,herb,leaf,length,light,lobe,long,margin,mm,narrowly,non-glandular,ovate,patent,petiole,pubescent,purple,ring,robust,seed,serrate,shrub,simple,stem,stigma,striate,style,subglobose,trans-ovoidal,triangular,trichome,tube,white,within,x,yellow	0,0.4,0.5,0.5-0.8,1.5,1.5-2,1/10,11.5-15,2-,3,4-10,5,5-,6-celled,8,8-celled,abaxially,accrescen,adaxially,ag,aggregate,antrorse,ascending,berry,bicellular,branch,broad,cell,coat,connectival,cotyledon,curved,cuticle,deep,densely,diamete,difoliate,directed,dorsally,eaf,edentate,eed,elliptical,embryo,endosperm,epidermal,erect,filament,finely,foliage,free,fruiting,geminat,hair-like,head,herbaceous,high,hollow,honey-combed,inconspicuous,inserted,lamina,lateral,like,little,lon,long-stalked,longer,longitudinal,longitudinally,lower,many-seeded,midvein,odorles,opening,orolla,outward,pair,papillate,pericarp,pore,poricidal,portion,prolongation,rarely,reduced,ree,rest,ridged,ruit,saddle-shape,scarce,scarcely,secondary,separated,short-stalked,shorter,single-celled,sinus,slightly,slit,small,smooth,solitary,somewhat,spur-like,stalk,stone,strand,tem,thecae,thickened,thickening,time,tip,tooth,unequal,unit,upward,vary,vein,ventrifixed,verrucate,viscid,viscid-pubescen,wall,ympodial	adhesion,arrangement,blade,climate,colour,form,fruit,growth,hair,height,history,inflorescence,life,midpoint,na,number,ovary,pedicel,peduncle,plant,position,presence,present,pubescence,ray,reproduction,rugulose,saddle-shaped,shape,size,staman,stellate,stipe,surface,texture,viscid-pubescent
715	wfo-0001031270	success	234	153	125	109	28	0.534	+,.5,0.4-1.5,1,1-1.2,1-4,1.2-1.6,1.5,1/3,10,10-12,2-2.5,2-3,2-4,2-7,2.5-3,3-10,3-5,4-5,5,5-15,6-17,9-10,abaxially,acute,anther,anthesi,apex,base,beginning,bipinnatifid,blade,bright,brown,calyx,capitate,clavate,cm,conical,connivent,deeply,densely,depressed-spherical,diameter,elliptic,few-rayed,flower,glabrous,glandular,glandular-pubescent,green,growth,herb,inflorescence,later,lateral,leaf,leaf-opposed,length,like,live,lobe,lobed,long,long-styled,loosely,margin,membranous,midpoint,minutely,mixture,mm,narrowly,obovate,ovoid,pale,pedicel,peduncle,petiole,pinnatifid,plant,poricidal,prickle,prickly,pubescent,ray,red,reddish,reniform,rest,ripe,rounded,scattered,sessile,shallowly,shining,short-stalked,short-styled,simple,size,slightly,sparsely,spherical,spreading,stellate,stem,stigma,straight,straw-colored,style,surface,tan,tapering,thin,tip,trichome,truncate,tube,uniseriate,way,white,wide,yellow,yellowish,½	0.5-1,1-3,1.5-2,100,2-20,3-20,5-10,5-6,5-merous,6-50,7-12,8,>,abaxial,accrescent,adaxial,adaxiall,along,alyx,apart,arme,articulated,associated,bark,basal,berry,brow,c.,cell,celled,colored,consistently,curved,differentiated,difoliate,directed,distal,eed,ellipti,entire,equal,erect,filament,free,frui,fruiting,geminat,gland,heavily,heterostylous,infructescence,investing,leafy,lon,longer,lower,midvein,minute,multangulate,multiseriate,new,nflorescence,occasionally,often,older,orolla,oung,outline,pair,papillo,per,pericarp,pitted,pore,portion,primary,rachi,reflexed,ruit,scar,secondary,shallow,shrub,single,sinuate,slender,small,stalk,staminat,strongly,tall,tamen,terete,testal,thus,tightly,tissue,unit,upward,usually,vary,varying,vein,well,wice,wid,wing,woody,ympodial	adaxially,adhesion,arrangement,climate,colour,corolla,dioecious,form,fruit,hair,height,history,life,na,number,ovary,perennial,position,presence,present,pubescence,reproduction,rugulose,seed,shape,staman,stipe,texture
716	wfo-0001031283	success	52	66	25	27	41	0.481	0.4-0.5,0.7,2.2-2.8,30-40,apex,base,brown,calyx,cell,cm,diameter,fruit,hair-like,lateral,lobe,mm,obovate,outgrowth,pale,pubescent,shrub,surface,testa,wall,woody	-0.25,.7-2.3,0.1-0.15,0.5-0.7,acute,appearance,eed,elongating,erect,fide,give,lo,long,markedly,moore,narrowly,pleasant,silky,small,smelling,somewhat,sprawling,spreadin,tall,thick,wide,winged	adhesion,anther,blade,climate,colour,corolla,form,glandular,growth,hair,height,history,inflorescence,leaf,length,life,margin,midpoint,na,number,ovary,pedicel,peduncle,petiole,plant,position,presence,pubescence,ray,reproduction,rugulose,seed,shape,size,staman,stellate,stigma,stipe,style,texture,tube
717	wfo-0001031287	success	147	115	79	68	36	0.537	.5,0.5-1.5,0.9-1,1,1-1.2,1-1.5,1-5,1.5-2,1.5-5.5,2-2.5,3-4,4-5,4.5-5,5-14,6-7,abaxially,acute,adaxially,anther,apex,attenuate,base,bi-lobed,calyx,cm,conical,corolla,dark,deltate,dendritic,densely,dia,divergently,elliptic,glabrous,globose,green,greenish-white,internodal,knob,leaf,lobe,lobed,margin,minutely,mm,nearly,onto,ovary,ovoid-reniform,pale,papillose,pedicel,petiole,pitted,pore,poricidal,pubescent,red-papillose,rounded,shaped,shoot,short,shrub,small,stem,stigma,strongly,style,surface,tan,tear-drop,tip,trichome,tube,tuft,white,winged,x	1-1.3,3-5,4-6,6-10-flowered,anthesi,apar,ape,axil,bark,bearing,berry,branch,connective,coriaceous,deflexed,difoliate,eaf,edicel,eed,ellipsoid,elongate,enlarged,erect,exserted,filament,fleshy,free,frui,fruiting,geminate,lamina,later,lateral,lon,long,lower,main,many,membranous,middle,nflorescence,occasionally,older,pair,papillo,planar,plurifoliate,pointed,portion,reddish-brow,reflexed,ruit,scar,simple,sinus,somewhat,spaced,thick,thin,tub,ud,unevenly,unit,vein,widest,woody,ympodial,young	adhesion,arrangement,blade,climate,colour,diameter,form,fruit,glandular,growth,hair,height,history,inflorescence,length,life,midpoint,na,number,peduncle,perennial,plant,position,presence,pubescence,ray,reddish-brown,reproduction,rugulose,seed,shape,size,staman,stellate,stipe,texture
718	wfo-0001031300	success	219	101	79	140	22	0.361	-2.2,/4,0.2-0.4,0.3,0.5-0.9,0.5-18,0.5-2,0.7-0.9,0.7-1.2,0.8-1.5,1-2,1.5-3.5,2-5.5,2.2-2.3,2.2-2.7,2.5-3.2,3-4,abaxially,acute,anther,apex,apically,base,berry,calyx,chartaceous,cm,connivent,creeping,deltate,densely,diameter,dull,equal,flattened-reniform,fruit,glabrescent,glabrous,lateral,leaf,length,lobe,lobed,long,maturity,membranous,mm,moderately,near,oblanceolate,orange,orange-brown,pale,pedicel,peduncle,petiole,poricidal,pubescent,rarely,red,shrub,simple,smooth,sparsely,spherical,stellate,stellate-pubescent,stem,style,surface,tapering,tip,trichome,tube,way,white,wide,yellow,yellow-orange	-4,-5,-6,.5,0-15,0-20,0-3,0-8,0.1,0.1-0.5,0.1-0.6,0.15-0.7,0.2-0.5,0.2-0.7,0.2-1,0.3-0.6,0.3-1.3,0.5-1.5,0.6-0.8,0.6-1,0.6-1.2,1-4,1-5,1.2-1.7,1.3-2,1/2-3/4,1/3-1/2,1/6-1/4,10-30,2-,2-3,2-4,2-6,3-,4,4.5-6,5-15,5-merous,6-8,absent,also,alyx,apar,apart,apparently,articulated,attenuate,ba,bark,blade,branched,brow,brown-green,bulbous,caudat,cell,concolorous,curved,difoliate,distance,drying,eaf,eed,elongating,erect,extending,eye,filament,filiform,flattened,flower,free,fruiting,geminat,geniculate,gray-green,hair,herbaceous,highly,infructescence,lon,longer,lower,margin,mature,midpoint,midvein,minute,naked,nflorescence,oblong,obtuse,older,one,open,orange-green,orolla,oung,outline,pair,pendulous,per,perfec,pericarp,pit,porrect,portion,prickl,prickle,prickly,primary,raised,ray,reduced,rounded,ruit,scar,sessile,side,small,spaced,spreading,stalk,stalked,tamen,terete,tertiary,thin,time,uniradiate,unit,vary,vein,venation,visible,weakly,wider,winged,yellow-green,ympodial	adhesion,arrangement,caudate,colour,corolla,form,growth,height,inflorescence,na,ovary,plant,position,presence,present,pubescence,rugulose,seed,shape,size,staman,texture
719	wfo-0001031310	success	203	106	83	120	23	0.409	.5,1-2,1-3,1-6,1.5-4,15-40,2-3,2.5-8.5,3-10,4.5-4.8,5-6,5.5-21,abaxially,adaxially,along,anther,axillary,blue,blue-purple,brown,brownish,bud,chartaceous,cm,condition,corolla,diameter,drying,especially,fresh,fruit,glabrous,globose,green,greenish,hair,herb,lanceolate,leaf,less,light,like,lobe,long,membranous,midrib,minutely,mm,mottled,multicellular,odd-pinnate,ovate,ovate-elliptic,ovate-lanceolate,ovoid,pale,pedicel,peduncle,petiole,pilose,plant,puberulent,pubescent,purple,rotate,seed,simple,size,slightly,sometimes,somewhat,sparsely,stem,stigma,streak,style,subtending,terminal,tube,white,whitish,x,yellow	0-3,0-4,0.5-3,1-10,1-5.5,2.5-5.5,4-10,4-12,5-7,5-merou,6-7,absent,acumen,acuminate,ag,alyx,apart,apex,apparently,articulated,attenuate,axe,base,berry,blade,borne,broadly,caly,cell,ciliate,connivent,conspicuously,covering,cuneate,decreasing,decurrent,digestion,distal,dorsally,eaf,edge,eed,elliptic,end,enzyme,erect-decumben,exceeding,extremely,filament,flat,flower,folded,forked,geminat,generally,glabrou,gradually,green-white,hair-like,half,high,homostylous,honeycomb-shaped,interjected,larger,lateral,leaflet,lengthening,living,lower,make,margin,mucilaginous,narrowly,nflorescence,obtuse,orolla,pair,perfect,petiolule,plurifoliate,pointed,pore,poricidal,rachi,removed,rosette-forming,ruit,seudostipule,shortly,singly,slit,small,spaced,specimen,stamen,ste,stolo,straight,subellipsoi,subrosette-forming,tall,tamen,tem,testal,thick,throughout,tip,tissue,toward,tri-,tuber,typically,unit,unwinged,usually,vary,wall,wet,ympodial	adhesion,arrangement,calyx,colour,form,growth,height,history,inflorescence,length,life,na,ovary,perennial,position,pubescence,reproduction,rugulose,shape,staman,subellipsoid,surface,texture
720	wfo-0001031316	success	207	117	86	121	31	0.415	-2,/3,0.3-1,0.5-2,0.8-1.2,0.8-1.8,0.9-1.3,1.3-3.5,1.5-3.5,2-3,2.5-8,3-8,3.5-3.8,3.8-5,4-7,5-10,5-8,abaxially,acuminate,acute,almost,anther,apex,apically,base,blade,blue-mauve,bright,calyx,cm,connivent,cream,dark,densely,diameter,dull,entire,flattened-reniform,fruit,glabrescent,glabrous,gray,green,hair,lateral,leaf,length,lobe,lobed,long,margin,marking,maturity,membranous,midpoint,mm,moderately,narrow-deltate,obtuse,orange,orange-brown,ovate,pale,pedicel,peduncle,petiole,purple,ray,red-brown,shrub,simple,sparsely,spherical,stellate,stellate-pubescent,stem,style,tapering,terminal,tube,unequal,way,white,wide,yellow,young	.1,0.05-0.1,0.05-0.15,0.1-0.2,0.4-0.6,0.4-0.8,0.6-1,1-5,1.2-2.1,1.5-,1.5-2,1.5-5,1/3-1/2,1/3-2/3,2-20,2-4,3-10,4,4-9,5-15,5-6,5-merous,6-20,8-11,8-12,8-25,abaxial,adaxial,alyx,ame,apar,apparently,articulated,bark,becoming,berry,branched,broad,c.,colored,concolorous,contrast,curved,difoliate,discolorous,drying,eaf,eed,elongating,erect,eye,fifth,filament,flower,foliaceou,four,free,fruiting,geminat,glabrou,held,herbaceous,infructescence,inward,long-acuminat,longer,lower,lowermost,mature,minute,multangulate,naked,nflorescence,older,one,open,orolla,oung,pair,pendulous,per,perfec,pericarp,poricidal,porrect,portion,primary,red-brow,reflexed,ruit,scar,sessile,slender,smooth,sometimes,spaced,spreading,stalk,stalked,stellate-pubescen,strongly,surface,tamen,terete,tertiary,time,tip,trichome,unarme,unarmed,unit,usually,variously,vary,vein,venation,visible,white-green,whitish,yellow-green,ympodial	adhesion,arrangement,climate,colour,corolla,form,glandular,growth,height,hermaphroditic,history,inflorescence,life,long-acuminate,na,number,ovary,perennial,plant,position,presence,present,pubescence,reproduction,seed,shape,size,staman,stigma,stipe,texture
721	wfo-0001031333	success	194	138	109	85	29	0.562	+,.5,0.1-0.5,0.5,1-1.5,1-4,1-5,1.2-2,1.5,1.5-1.7,1.5-2,2,2-3,2.5-3,2.7-7,3-4,7-10,7-9,<,?,acuminate,acute,almost,anther,apart,apex,articulated,base,berry,bilobed,broadly,brown,calyx,capitate,cell,cm,conical,densely,denser,diameter,ellipsoidal,elliptic,entire,exserted,filament,flattened,flower,free,fruting,glabrescent,glabrous,globose,golden,green,greenish,growth,immature,inflorescence,like,lobe,margin,matte,membranous,mere,minute,minutely,mm,narrowly,near,new,ovate,pale,pedicel,peduncle,pentagonal,perfect,petiole,pitted,primary,pubescent,pubescent-papillate,reniform,scar,simple,somewhat,soon,sparsely,stellate,stem,stigma,strongly,style,surface,terminal,thin,trichome,truncate,tube,undulation,unevenly,uniseriate,vein,vine,white,whitish,woody,x,yellow,yellowish	1/2,3/4,30-40,5-7,5-8,5-merou,50,>,abaxially,adaxiall,adaxially,adjacent,ag,alyx,anthesi,appearing,ark,branche,branched,clustered,collection,composed,crea,cupped,eaf,eed,glabrescen,half,high,ilament,lamina,leaving,lengthening,less,lobed,long,lower,m.,many,nflorescence,nodding,occasionally,older,orolla,outline,pair,papillat,peg,penden,per,pericarp,planar,plurifoliat,pore,poricidal,portion,quadrate,rest,rhachi,ruit,sinus,slightly,slit,small,splitting,ste,striped,tangled,tem,testal,thickened,time,tip,trailing,triangular,twining,ud,undersurface,unequal,unit,upper,vary,venation,way,ympodial	0.5-1,5-merous,abaxial,adaxial,arrangement,articulation,bark,bud,colour,composition,corolla,cream,density,exsertion,form,fruit,glabrescence,leaf,length,na,ovary,position,pubescence,seed,shape,size,spacing,texture,type
722	wfo-0001031333	success	194	125	108	86	17	0.557	+,.5,0.5,1-1.5,1-4,1-5,1-5-2,1.5,1.5-1.7,1.5-2,2,2.5-3,2.7-7,3-4,7-10,7-9,?,abaxially,acuminate,acute,adaxially,adjacent,almost,anther,apex,articulated,bark,base,berry,bilobed,broadly,brown,calyx,capitate,cm,conical,corolla,cream,densely,denser,diameter,ellipsoid,elliptic,entire,filament,flattened,fruiting,glabrescent,glabrous,globose,golden,green,greenish,growth,half,high,immature,inflorescence,lamina,leaving,like,long,lower,margin,matte,membranous,minute,minutely,mm,narrowly,near,new,ovate,pale,pedicel,peduncle,peg,petiole,pitted,primary,pubescent,pubescent-papillate,reniform,rest,rhachi,rotate-stellate,simple,small,somewhat,sparsely,stellate,stem,stigma,style,surface,terminal,thin,trichome,truncate,tube,uniseriate,vein,vine,white,whitish,wide,woody,yellowish	0.1-0.5,1/2,2-3,3,3/4,30-40,5-7,5-8,5-merou,50,<,>,adaxiall,ag,alyx,anthesi,apart,appearing,branche,branched,cell,clustered,composed,cupped,eaf,eed,exserted,flower,free,glabrescen,ilament,lengthening,less,lobe,lobed,m.,many,mere,nflorescence,nodding,occasionally,older,orolla,outline,pair,papillat,penden,per,perfect,pericarp,planar,plurifoliat,pore,poricidal,portion,quadrate,ruit,scar,sinus,slightly,slit,soon,spaced,splitting,striped,strongly,tangled,testal,thickened,time,tip,trailing,triangular,tub,twinin,ud,undersurface,undulation,unequal,unevenly,unit,upper,vary,venation,way,ympodial	abaxial,adaxial,arrangement,colour,form,fruit,leaf,length,ovary,papillate,position,pubescence,seed,shape,size,texture,twining
723	wfo-0001031359	success	166	104	69	97	35	0.416	/4,0.5-1,0.5-6,1-4,1.1-1.6,1.2-1.6,1.2-2.5,1.3-1.6,1.5-2,12-21,2.5-3,3-3.5,3.6-8.8,5-angled,6-7,acuminate,anther,apex,apiculate,attenuate,base,beneath,berry,bi-lobed,broadly,calyx,cm,corolla,dia,dull,elliptic,flattened-reniform,glabrous,globose,green,leaf,lobe,lobed,margin,mm,narrowly,nearly,opposite,outline,ovary,pedicel,petiole,plant,ripe,round,shaped,shrub,size,stem,stigma,style,surface,tan,tear-drop,triangular,trichome,tube,tuft,uniseriate,way,white,x,yellow,yellow-orange	.02,.25,.5,0.75-1,1.6-2.8,1.9-2.3,5-30-flowered,5-7,5.3-7.5,angle,anthesi,apart,appearing,axil,ba,bark,beginning,brown,curled,dark,deflexed,differing,difoliate,distal,dried,eaf,edicel,eed,evenly,extending,filament,free,fruiting,geminat,incrassate,inflorescenc,internodal,interpetalar,lamina,lateral,live,lon,long,lower,main,major,membraneous,middle,minor,minutely,near,nflorescence,obovoid,occasionally,often,older,one,originating,pair,paler,papillae,papillo,papillose,pit,pitted,planar,pore,poricidal,portion,reflexed,ridged,ruit,rusty,scar,shiny,simple,sinus,slender,slightly,somewhat,spaced,specimen,straight,strongly,tall,tapering,tip,tub,ud,undulate,unit,vein,white-lenticellat,widest,woody,ympodial,young	0.5,adhesion,arrangement,blade,climate,colour,diameter,form,fruit,glandular,growth,hair,height,history,inflorescence,length,life,midpoint,na,number,peduncle,perennial,position,presence,pubescence,ray,reproduction,rugulose,seed,shape,staman,stellate,stipe,texture,ye
724	wfo-0001031362	success	138	105	84	54	21	0.609	.2,.3,.5,0.4-0.5,0.5-1,1-1.1,1-1.5,1-3,1-4,1.5-2,2-2.5,3-6,?,abaxially,adaxially,along,anther,apex,base,brown,calyx,cell,cm,conical,corolla,dendritic,densely,denser,dia,flattened-reniform,glabrous,globose,golden,incrassate,internodal,lanceolate,leaf,like,lobe,lobed,long,long-triangular,margin,minutely,mm,nearly,opposite,orange-red,outline,ovary,pale,papillose,pedicel,pericarp,petiole,pitted,pore,poricidal,pubescent,pubesent,rectangular,red,rest,rounded,shaped,shiny,shrub,simple,small-capitate,sparsely,stem,stigma,style,subshrub,surface,tan,tear-drop,thin,tip,trichome,tube,vein,white,x	0.7-1,1-3-flowered,3-4,acute,anthesi,appearance,attenuate,bark,berry,branch,bushy,closely,eaf,edicel,eed,ellipsoid,erect,exceeding,exserted,filament,flattened,free,fruiting,giving,golden-brow,inflorescenc,lamina,lateral,lon,lower,main,middle,nflorescence,nodding,older,overlappin,packed,pair,papillo,planar,plurifoliat,portion,ruit,scar,slender,somewhat,spaced,straight,ud,unit,widest,woody,ympodial,young	arrangement,colour,diameter,form,fruit,golden-brown,growth,height,inflorescence,length,na,peduncle,plant,plurifoliate,position,pubescence,rugulose,seed,shape,size,texture
725	wfo-0001031363	success	198	103	74	124	29	0.374	0.3-0.6,0.5-0.8,1-2,1-2.2,1.1-1.6,1.5-4,10-11.5,2-3,2.5-7.5,3.5-6,4-8,4.5-7.5,5-10,5-8,6-13,6.5-11,abaxially,absent,acute,adaxially,anther,apex,attenuate,base,blade,broadly,brown,calyx,chartaceous,cm,deltate,densely,diameter,extra-axillary,flower,fruit,glabrous,globose,green,hair,inflorescence,leaf,length,lobe,lobed,long,margin,midpoint,mm,moderately,obtuse,ovate,pale,pedicel,peduncle,perennial,petiole,plant,present,purple,ray,rhizomatous,shallowly,shrub,simple,sparsely,stellate,stellate-pubescent,style,thick,throughout,tube,x,yellow	%,.3,.5,0-15,0-3,0-30,0-6,0.3-0.5,0.3-0.7,0.4-0.5,0.4-0.8,0.5-0.9,0.5-1,0.7-1.5,0.9-1.6,1-5,1-6,1-locular,1.1-1.4,1.6-2.1,10-12,13-25,2-foliate,2.3-2.5,3-4,3-5,3-7,3.5-5.5,30,4-7,5-6,5-7,5-merou,6-8,6.5-8.5,7-12,80-120,absen,acicular,across,adaxiall,adult,alyx,andromonoecious,apart,articulated,axe,ba,bark,branch,branche,corky,cross-section,cylindrica,decimetre,directed,distall,distributed,dm,eaf,eed,eglandular,erect,exocarp,finger,fruiting,functional,furrowed,geminat,gland-tipped,half,heterostylous,incomplete,index,juicy,juvenile,lamina,lateral,less,lobing,longer,lower,mature,mesocarp,midvein,minute,moist,nflorescence,oblique,orolla,pair,part,per,placenta,pore,porrect,prickle,pseudo-racemose,ruit,semi-circula,septum,sessile,short,side,spaced,stalks-0.1,stellae,straight,surface,tal,tamen,tem,time,transparent,unarme,unarmed,unbranched,unit,upper,vary,vein,weakly,wide,ympodial	0.1,0.4-0.9,2.5,adhesion,arrangement,climate,colour,corolla,form,glandular,growth,height,history,life,na,number,ovary,position,presence,pubescence,reproduction,seed,shape,size,staman,stem,stigma,stipe,texture
726	wfo-0001031372	success	192	109	76	116	33	0.396	0-15,0.2-0.8,1,1-2,1.5,10-14,10-30,2-2.5,2-5,2-7,2.5,2.5-4.5,3,5-10,6-9,7,7-10,8-10,8-15,acute,anther,apex,base,blade,broadly,brown,calyx,cm,coarsely,connivent,dark,densely,diameter,elliptic,extra-axillary,flattened,flower,fruit,glabrous,globose,green,hair,lanceolate,leaf-opposed,length,light,lilac,lobe,margin,midpoint,mm,obtuse,ovate,ovate-lanceolate,pedicel,peduncle,perennial,petiole,pubescent,ray,repand,several,simple,sparsely,stellate,stellate-pubescent,stelliform,stem,stigma,style,thin-textured,tube,ultimately,white,x,yellow	-1.5,0,0.05-0.2,0.4-0.6,1/4-1/3,10,10-12,2-foliate,25-30,4-5,5-20,abaxiall,abaxially,accrescent,acute-,adaxiall,adaxially,along,apart,armed,articulated,axe,ba,blunt-tipped,broad-based,capitat,central,closely,completely,compressed,concealing,covering,cylindrical,decurrent,deltoid,directed,distal,distally,eaf,eed,entirely,enveloping,female-sterile,filament,foliaceous,fruiting,geminat,glabrou,interwoven,large,lateral,laterally,lighter,long,longer,lower,m.,main,midrib,minute,minutely,mostly,much,multiseriate,nflorescence,often,onto,orolla,perfect,pitted,pore,present,prickle,prickly,probably,rachi,reaching,recurved,reddish,round-tipped,ruit,scattered,short,short-styled,shorter,side,similar,soft-wooded,somewhat,spaced,spreading,stalk,star,ste,stellae,stellate-woolly,stipitate,tal,tamen,tem,termination,time,unarmed,unbranched,unit,vary,vein,weakly,well-developed,whitish,wide,widely,winged,woolly,ympodial,young	adhesion,arrangement,capitate,climate,colour,corolla,decurren,form,glandular,growth,height,history,inflorescence,leaf,life,na,number,ovary,plant,position,presence,pubescence,reproduction,rugulose,seed,shape,size,staman,stipe,surface,tall,texture,ye
727	wfo-0001031389	success	242	129	102	140	27	0.421	0-2,0.25-0.75mm,0.3-0.5,0.3-0.8,0.4-0.6,0.4-1.8,0.5-1.5,0.5-3,0.65-1,0.8-2.5,0.9-4.5,1-1.5,1.5-2.5,1.5-3,1.9-2.2,14-30,2.5-13,4-5.5,4-8,5.5-8,7-8,8-15,abaxially,absent,acute,adaxially,almost,andromonoecious,anther,apex,base,blade,brown,calyx,chartaceous,cm,connivent,cuneate,cylindrical,dark,deltate,densely,diameter,eglandular,entire,extra-axillary,flower,fruit,glabrous,gland-tipped,globose,hair,inflorescence,lanceolate,leaf,length,lilac,lobe,lower,margin,midpoint,minutely,mm,obtuse,ovate,pale,part,pedicel,peduncle,perennial,perfect,petiole,pitted,plant,present,purple,ray,red,reniform,reticulate,reticulately,rhizomatous,rostrate,rotate-stellate,scattered,short,shrub,simple,sometimes,sparsely,stellate,stellate-pubescent,stigma,style,summit,surface,tip,tube,weakly,white,x,yellow	%,0-0.1,0-0.4,0-0.5,0-0.6,0-1,0-10,0-3,0.05-0.1,0.25-0.4,0.25-0.5,0.3-0.6,0.5-1,0.6-0.7,1-2,1-3,1-4,1-5,1-locular,1.3-2.4,1.5-4,1.5-5,1.8-3.5,11-16,14-18,2-6,2-foliate,20-60,4-5,4-7,5-8,5-merou,6-10,6-12,6-7,6-9,absen,accrescent,acicular,across,adult,alyx,apart,apparen,articulated,axe,ba,becoming,branch,branche,capitat,confined,decimetre,directed,distall,distally,distributed,dm,eaf,eed,erect,exocarp,filament,finger,first,fruiting,functional,geminat,green,half,heterostylous,homo-,incomplete,interpetalar,juicy,juvenile,lamina,lateral,less,lobed,long,longer,loosely,markedly,mature,mesocarp,mid-point,midrib,midvein,minute,moderate,narrowly,nflorescence,oblique,often,orolla,pair,per,placenta,plump,pore,porrect,prickle,pseudo-racemose,pseudo-umbellate,rachi,reddish,ruit,septum,sessile,shallowly,solitary,somewhat,spaced,sparse,stalk,stellae,straight,succulent,tal,tamen,tem,thick,thicker,thicknes,throughout,tightly,time,tissu,tissue,triangular,unarme,unarmed,unbranched,unit,upper,vary,wide,yellowish,ympodial	adhesion,arrangement,capitate,climate,colour,corolla,form,glandular,growth,height,history,life,na,number,ovary,position,presence,pubescence,reproduction,rugulose,seed,shape,size,staman,stem,stipe,texture
728	wfo-0001031394	success	217	112	66	151	46	0.304	0.5,abaxially,acute,alternate,anther,apex,apparently,base,blade,broadly,calyx,cm,crenulate,diameter,extra-axillary,finely,flattened,flower,free,fruit,glabrous,glandular-pubescent,globose,hair,lanceolate,length,light,lobe,margin,midpoint,mm,narrowly,ovate,pedicel,peduncle,petiole,pilose,pitted,plant,pubescence,pubescent,purple,red,rounded,short,similar,sometimes,stellate,stem,stigma,stipitate-glandular,style,subcordate,subreniform,subshrub,tan,taprooted,thin-textured,tooth,triangular,tube,usually,white,x,yellow,yellow-orange	-celled,-rayed,0.2–0.4,0.3,0.3–1.5,0.5–1,0.6–1.6,0.8,1,1.1–1.6,1.2–3.2,1.4–2.1,1.7–4.5,1/2,1/3,1–,1–1.5,1–2,1–3,1–4,2,2-foliat,2.2–2.5,2.5–3,2–3,2–3-celled,2–3.2,2–4,3,3.7–7.6,33–80,3–4,3–5,3–6,4,4–8,5,5–8,64,6–11,6–8,9–13,=,?,accrescent,acicular,adaxially,additional,almost,apart,appearing,armed,articulated,axe,ba,basal,beginning,bottom,branch,branched,bulbous,caudate,curved,cylindrical,densely,directed,distal,distall,eaf,eed,enlarging,even,eventually,fertile,filament,fruiting,glabrou,gland-tippe,gland-tipped,glandular-pilosulose,halfway,hyaline,investing,leafy,least,less,lon,long,longest,lower,main,male,many,maturity,midrib,minute,n,nflorescence,numerous,one,orolla,overtopped,per,pore,prickle,quite,rachi,reaching,recurved,reflexed,ruit,scattered,sessile,shorter,side,simple,single-celled,slightly,small,smaller,somewhat,spaced,sparse,spreadin,staminate,stellae,sterile,stout,straight,tall,taman,tem,terminal,thick,thickened,time,tip,truncat,unbranched,unit,variable,vary,vein,wide,ympodial,±,–1.5,–2,–3,–5,–6	0.2-0.4,0.3-1.5,0.5-1,1-1.5,1-2,1-3,1-4,1.4-2.1,2.2-2.5,2.5-3,3-5,3-6,3.7-7.6,4-8,5-8,6-8,adhesion,arrangement,climate,colour,corolla,form,glandular,growth,height,history,inflorescence,leaf,life,na,number,ovary,position,presence,present,ray,reproduction,rugulose,seed,shape,size,staman,stipe,surface,texture,truncate
729	wfo-0001031400	success	161	71	52	109	19	0.323	0.25-0.8,0.4-1.7,0.6-1.8,0.7-6,0.8-1.1,1.2-2,1.5-5,2-5,2-9,4-13,4-6.5,4-7,5-12.5,7-28,calyx,cm,connate,corolla,deeply,diameter,distal,globose,green-white,half,herbaceous,lateral,leaf,leaflet,linear,linear-lanceolate,long,mm,odd-pinnate,ovoid,pedicel,peduncle,perennial,petiole,plant,puberulent,seed,size,stellate,subglabrous,terminal,throughout,tone,tuber-bearing,violet,white,wide,yellow	-3,1,1-,1-4,10-11,2,2-3,3-6-foliat,4-,4-17,6-23,7-25,abaxial,abaxially,abruptly,absen,acumen,acute,adaxially,apex,apical,apically,apiculate,articulate,base,branched,cell,covering,cuneate,cyme,dark,decurrent,dehiscent,dichasial,dichasially,digestion,diminishing,dorsally,eaf,ebracteate,edge,eed,emoval,enzyme,exceeding,filament,flat,flower,folded,forked,forming,generally,globo,green,hair-like,honeycomb,interjected,introrse,living,lobe,lon,lower,lunat,make,maturing,monochasial,mucilaginous,nflorescence,nther,oblique,oblong,occasionally,often,orolla,pair,pattern,perfect,plan,poricidally,proximal,rachi,reveal,ruit,sessile,seudostipule,short,side,slit,specimen,stamen,stigma,straight,stripe,structure,style,tal,tem,testal,thick,tip,toward,trilobe,typically,unit,vary,wall,without,ympodial,¼	4-25,anther,arrangement,colour,form,fruit,growth,height,history,inflorescence,length,life,na,ovary,position,reproduction,shape,stem,texture
730	wfo-0001031401	success	182	109	77	105	32	0.423	0.5,0.6-1.2,1-1.4,1-6,1.1-3,2-2.4,2-5,2.5-4,3,3.5-4,5-9,7-9,acute,anther,apex,attenuate,base,bi-lobed,blade,brown,calyx,cm,conical,corolla,dark,deltoid,dendritic,diameter,elliptic,finely,flattened,fruit,glabrous,globose,golden,growth,leaf,lenticular,lobe,lobed,long-triangular,matted,minutely,mm,narrowly,occasionally,ovary,pedicel,pericarp,petiole,pitted,poricidal,puberulent,pubescent,purplish-black,reddish-brown,rounded,roundish,shrub,small,sparsely,stem,stigma,strongly,style,surface,terminal,thin,tip,tree,tree-like,trichome,tube,violet,white,winged,x	0.8-1.2,1,1-1.5,1.5-2,1/2,3/4,5,5-7,8-10,abaxial,abaxially,adaxial,adaxially,age,along,anthesi,apical,appearing,axi,bark,basal,becoming,berry,black,branch,branching,clearly,deciduous,deflexed,densely,denser,dichasial,differentiated,drying,eaf,ecuador,ecuadorian,edicel,eed,ew,exserted,filament,flower,fork,free,fruiting,golden-yellow,impressed,inserted,lateral,less,long,lower,m.,mesophyll,monochasia,near,new,nflorescence,noddin,nodding,node,often,older,outline,overtopping,pair,papillo,per,planar,plurifoliate,pore,portion,prominently,pubescen,pyramidal,raised,ruit,scar,secondary,shiny,shoot,short,sleev,slit-like,sometimes,somewhat,specimen,stamen,ste,tall,tapering,time,tub,ud,unit,usually,vein,visible,way,wide,woody,yellow,ympodial,young	adhesion,arrangement,climate,colour,form,glandular,hair,height,history,inflorescence,length,life,margin,midpoint,na,number,peduncle,perennial,plant,position,presence,pubescence,ray,reproduction,rugulose,seed,shape,size,staman,stellate,stipe,texture
731	wfo-0001031402	success	200	102	73	127	29	0.365	0-0.2,0-0.3,0.2-0.4,0.3-1.1,0.4-1.2,0.5-0.7,0.5-1,0.5-1.3,0.5-2.6,1-3,1.5-2,1.5-2.5,10-38,2-2.5,2-3,3-5,3-5.5,4-7,7.5-8.5,acute,andromonoecious,anther,apex,base,blade,calyx,cm,cuneate,deeply,deltate,diameter,entire,fruit,glabrous,gland-tipped,globose,green,hair,herbaceous,inflorescence,leaf,leaf-opposed,length,linear,lobe,lobed,margin,midpoint,mm,moderately,ovate,ovoid,pedicel,peduncle,petiole,plant,present,purple,ray,resprouter,rotate-stellate,shallowly,short,simple,sparsely,stellate-pubescent,stem,stigma,style,tube,unknown,x,yellow	%,0-3,0.3-0.6,0.6-1.2,0.7-1.4,0.8-2.5,0.8-3,1,1-15,1-2,1-4,1-5,10-15,10-18,14-18,2-4,2-6,2-8,2-foliate,2.2-12,3-15,3-4,4-8,5-40,5-merou,6-9,7-15,8-10,abaxially,absen,absent,abundant,accrescent,acicular,across,adaxiall,adaxially,adult,alyx,apart,armed,articulated,axe,ba,branche,capitat,chartaceous,color,confined,connivent,contiguous,cylindrical,densely,directed,distall,distributed,dm,dult,eaf,eed,eglandular,erect,filament,finger,flower,fruiting,functional,geminate,glabrou,half,heterostylous,index,interpetalar,lamina,lateral,lobing,lon,long,longer,lower,mature,midrib,midvein,minute,narrowly,nearly,nflorescence,oblique,obtuse,orolla,part,per,pore,porrect,possibly,prickle,projecting,pseudo-umbellate,rachi,ripe,ruit,sessile,shorter,side,single-flowered,spaced,sprawling,stage,stellae,straight,strongly,tal,tamen,thick,throughout,time,tissue,unarmed,unbranched,unit,uvenile,vary,vein,weakly,wide,winged,ympodial	adhesion,arrangement,capitate,climate,colour,corolla,form,glandular,growth,height,history,life,na,number,ovary,perennial,position,presence,pubescence,reproduction,rugulose,seed,shape,size,staman,stellate,stipe,surface,texture
732	wfo-0001031480	success	237	129	99	138	30	0.418	/3,0.1-0.3,0.15-0.3,0.5-2,0.8-1,1-1.3,1-1.5,1-3,1.7-2.2,1.8-3,1/3,2-2.7,2-3,2-6,3-7,3.5-7,4-6,6-13,6-8,abaxially,acute,andromonoecious,anther,apex,apically,base,berry,blade,bright,calyx,cm,cream,cuneate,dark,deltate,densely,diameter,dull,ellipsoid,entire,equal,flattened-reniform,fruit,glabrescent,glabrous,glandular,green,hair,lateral,leaf,length,lobe,lobed,long,margin,marking,maturity,mauve,midpoint,mm,moderately,near,obtuse,orange-brown,ovate,pale,pedicel,peduncle,petiole,plant,poricidal,purple,ray,red,red-brown,scandent,shallowly,shrub,simple,smooth,spherical,spreading,stellate,stellate-pubescent,stem,style,surface,tapering,terminal,thick-chartaceous,tip,trichome,truncate,tube,upper,way,wide,yellow,young	-0.25,-2,0,0-0.5,0-1,0-2,0-30,0-5,0.1,0.1-0.4,0.2-0.35,0.4,0.4-0.8,0.5-,0.6-0.8,0.7,0.8,1-2,1-4,1.5-2.2,1/2,1/4,1/6-1/5,2-,2-5,3,3-10,3-6,4-5,5-8,5-merous,6-30,7-8,8-12,abaxial,acuminat,adaxial,alyx,apar,apart,apparently,articulated,ba,bark,branched,branching,broad-deltate,cell,curved,difoliate,discolorous,distal,distance,drying,eaf,eed,elongate,elongating,erect,extending,eye,faint,filament,flattened,flower,free,fruiting,geminat,hermaphrodite,heterostylous,inconspicuous,infructescence,long-styled,longer,lower,lowermost,mature,midvein,minutely,naked,nflorescence,often,older,one,open,orolla,oung,outline,pair,pendulous,per,pericarp,persistent,pit,porrect,portion,prickle,prickly,primary,pubescent,raised,red-brow,red-green,red-yellow-green,reduced,reticulate,rounded,ruit,scar,sessile,short-styled,shorter,side,slender,slightly,small,somewhat,spaced,sparsely,stalk,stalked,staminat,straight,tamen,terete,tertiary,time,unarme,unarmed,unit,variously,vary,vein,venation,visible,weakly,woody,ympodial	8,acuminate,adhesion,arrangement,climate,colour,corolla,form,growth,height,history,inflorescence,life,na,number,ovary,perennial,position,presence,present,pubescence,reproduction,rugulose,seed,shape,size,staman,stigma,stipe,texture
733	wfo-0001031482	success	275	153	123	152	30	0.447	-0.2,-0.5,-0.6,-16,-18,.2-1.6,.5-5,0-0.2,0.02-0.03,0.02-0.04,0.03-0.3,0.2-0.3,0.7-1.3,1-4.5,1.2-1.5,1.2-3,1.3-4,1.4-2.2,1.6-2.8,1.9-2.5,2-3.3,2-4.7,2.5-10,2.5-4,3/4,4-13,4-5,4-6,6-16,8,abaxially,acuminate,acute,adaxially,anther,apart,apex,articulated,attenuate,base,becoming,blade,blue,blunt-tipped,brown,calyx,cm,commonly,continued,corolla,deltoid,densely,diameter,due,echinoid,elliptic,elongate,entire,flower,fruit,glabrous,granular-tomentose,grayish,growth,hair,inserted,irregular,lanceolate,lateral,leaf,length,lobe,margin,mixed,mm,moderately,mostly,multangulate,oblong,obtuse,often,pale,pedicel,peduncle,petiole,porrect-stellate,present,pubescence,pubescent,ray,reniform,ribbed,rotate-stellate,rounded,scabridulous,sessile,short-stalked,shrub,simple,slightly,small,somewhat,spaced,sparsely,stellate,stelliform,stem,stigma,style,subcampanulate,subcapitate,subconical,subglobose,suborbicular,subspherical,terminal,tomentose,tree,tube,velutinous,x,yellow,yellowish	-0.06,-0.4,-1.4,-150,-5,-5.3,-5.5,-6,.04-0.1,.04-0.35,.04-0.5,.06-1,.5-0.7,.5-3.5,/20-,0-0.3,0-0.4,0-0.6,0-0.7,0.02-0.06,0.03-0.04,0.04-0.3,0.04-0.4,0.04-0.5,0.04-0.6,0.04-1.4,0.3-0.5,0.5-1.5,0.6-1.8,1,1/10-1/4,1/2-2/3,2-3.5,2-4.6,2.5-4.5,3.5-4.8,3.7-8,4-7,4.5,5-7,5-80,5-merou,6-11,9-13,accrescent,adaxiall,ag,along,alyx,anthesi,ape,apical-lateral,apparently,appressed,axe,axillary,ba,bark,berry,beyond,branch,branched,bud,decurrent,dehiscing,directed,eaf,eed,ellipti,evident,exserted,extend,farinose,few-rayed,filament,free,fruiting,glabrescent,green,high,honeycombed,immature,interpetalar,introrse,lacking,large,later,line,lobed,long,long-stalked,longer,longitudinal,lower,m.,main,midvein,minute,multiseriate,narrowly,nearly,nflorescence,oblong-orbicular,occasionally,older,orolla,ovate,overlapping,perfect,persistent,plurifoliate,pore,possibly,prominent,rachi,rather,relatively,reticulate-punctate,ripe,ruit,runk,short-,side,slender,slit,sometimes,splitting,stalk,stamen,sulcate,suture,tamen,terete,testa,thick,thin,time,tissue,toward,unarme,unarmed,unevenly,unit,usually,vary,vein,way,weakly,white,wide,ympodial,young	0-0.06,0.04-0.35,0.5-3.5,1-1.4,adhesion,arrangement,climate,colour,form,glandular,height,history,inflorescence,life,midpoint,na,number,ovary,perennial,plant,position,presence,reproduction,seed,shape,size,staman,stipe,texture,unknown
734	wfo-0001031483	success	154	99	63	91	36	0.409	/2,0.5,0.5-2,1,1-2,1.7-5.5,11-20.5,2-2.5,3-4,6-10,acuminate,acute,almost,anther,anthesi,apex,attenuate,base,blade,calyx,clavate,cm,corolla,deltoid,dia,distal,dry,end,fresh,glabrous,green,indistinct,leaf,linear,lobe,lobed,mm,oblanceolate,obovate,opposite,ovary,ovoid-reniform,pale,paler,pedicel,petiole,poricidal,shape,short-triangular,shrub,slightly,stem,stigma,style,subshrub,tan,tapering,tip,tube,turbinate,way,white,x	.5,0,1.1-2.5,1.2-1.4,1/3,2-3,2.5-3.2,3-8-flowered,7-10,across,anew,apart,ba,bearing,beginning,beneath,berry,ca,caly,continuous,cork,corky,decurrent,deflexed,difoliate,eaf,edicel,eed,evenly,exserted,filament,filiform,flower,free,fruiting,fusiform,geminat,indistinc,internode,larger,lateral,lea,lenticellate,less,long,lower,main,major,markedly,minor,minutely,nflorescence,oblong,obovoid,often,orbiculate,pair,papillo,papillose,per,planar,pointed,pore,portion,prominent,quite,raised,rounded,ruit,scar,shaped,short,simple,slender,somewhat,soon,spaced,straight,strongly,tall,tear-drop,third,ud,unit,variable,vein,widest,wing,winged,woody,ympodial	1.5,2.5,5,adhesion,arrangement,climate,colour,diameter,form,fruit,glandular,growth,hair,height,history,inflorescence,length,life,margin,midpoint,na,number,peduncle,perennial,plant,position,presence,pubescence,ray,reproduction,seed,size,staman,stellate,stipe,texture
735	wfo-0001031486	success	166	96	75	91	21	0.452	0.2-0.7,0.9-1.7,1-2.2,1.5-4,1.8-3.3,11-37,2-3,2-3.5,2-6,2.5-3.2,2.8-6,3.4-10,3.5-6.5,3.5-8,5-10,7.5-22,9-37,abaxially,adaxially,almost,calyx,cm,commonly,connate,corolla,darker,deep,diameter,distal,elliptic,forked,globose,green,green-white,half,herbaceous,interjected,lateral,leaf,leaflet,less,light,lightly,long,mm,odd-pinnate,ovate,ovoid,pedicel,peduncle,pentagonal,perennial,petiole,plant,puberulent,pubescent,pure,purple,rotate,seed,size,sometimes,spot,stigma,strigose,stripe,style,terminal,throughout,tinged,tip,tuber-bearing,white,wide,yellow	0-1.,0-4.5,1-3,1-4,1.5-6,3-26,3-6-foliat,5-16,abruptly,acumen,acuminate,acute,apex,apical,apically,articulate,base,branched,cell,cordate,covering,cuneate,cyme,decurrent,dehiscent,dichasial,dichasially,digestion,diminishing,dorsally,eaf,ebracteate,edge,eed,emoval,enzyme,exceeding,filament,flat,flower,folded,generally,globo,hair-like,highly,honeycomb,introrse,living,lobe,lon,long-attenuate,lower,lunat,make,maturing,monochasial,mucilaginous,nflorescence,nther,oblique,obovate,often,orolla,pair,pattern,perfect,petiolule,plan,poricidally,proximal,reveal,ruit,seudostipule,short,slit,specimen,stamen,straight,tal,tem,testal,thick,throughou,toward,typically,unit,usually,vary,wall,ympodial,¼	0-15,anther,arrangement,colour,form,fruit,growth,height,history,inflorescence,length,life,na,ovary,position,presence,reproduction,shape,stem,texture,tube
736	wfo-0001031492	success	175	99	76	99	23	0.434	0.5,0.7-1.3,0.9-1.1,1-1.3,1-1.5,1.3-2,1.5-1.8,1.5-2.5,2-10,2-3,20,3-4,3-5,4-10,4-4.5,6-8,anther,bi-lobed,calyx,cm,conical,corolla,dark,deltoid,dendritic,diameter,drying,dull,echinoid,elliptic,flattened,free,fruit,glabrous,globose,golden,grey,growth,lateral,leaf,lenticular,lightly,lobe,lobed,medium,minutely,mm,narrowly,ovary,pedicel,pericarp,petiole,pitted,plurifoliate,poricidal,pubescent,purplish-black,reddish-brown,shiny,shrub,size,sometimes,sparsely,stem,stigma,style,surface,terminal,thin,tree,tree-like,trichome,tube,violet,winged,x	.5,/4,08,10-15,2-5,8-11,8-9,abaxially,absent,acuminate,acute,adaxially,age,anthesi,apex,apical,appearing,attenuate,axe,ba,bark,basal,base,becoming,beneath,berry,bitter,branching,dbh,deciduous,decurrent,densely,denser,distinguishable,eaf,edicel,eed,erect,ew,exserted,filament,flower,fruiting,inserted,juice,lamina,long,lower,m.,monochasia,nflorescence,nodding,occasionally,older,overtopping,pair,papillo,per,planar,pore,portion,predominantly,prominent,pyramidal,rather,remaining,ruit,scar,scarcely,scattered,secondary,shoot,short,sleeve,slightly,slit-like,somewhat,stamen,ste,sticky,strongly,sunken,tall,tapering,time,tip,tub,ud,undersurface,unit,upper,upturned,vein,way,wide,woody,ympodial,young,younger	adhesion,arrangement,colour,form,height,history,inflorescence,length,life,na,peduncle,plant,position,presence,present,pubescence,reproduction,rugulose,seed,shape,staman,stellate,texture
737	wfo-0001031497	success	264	115	87	177	28	0.33	0.05-0.2,0.1-0.2,0.1-0.8,0.2-0.5,0.5-2.5,1,1-2,1.2-2,1.2-2.4,1.5-2.5,2.25-3,2.5-4,2.8-3.5,3-10,3-5,3-9,4.5-7,5-8,6-13,6-9,abaxially,actinomorphic,acuminate,acute,adaxially,anther,apex,attenuate,base,blade,broadly,calyx,campanulate,cm,deeply,densely,diameter,erect,extra-axillary,flower,fruit,glabrous,globose,hair,incised,inflorescence,lanceolate,leaf,length,lenticular,light,lobe,margin,midpoint,mm,obtuse,orange,ovate,pedicel,peduncle,perennial,petiole,presence,present,pubescence,pubescent,ray,red,reniform-ovate,simple,spreading,stellate,stellate-puberulent,stellate-pubescent,stem,stigma,style,surface,tan,thin-textured,truncate,tube,weakly,white,x,yellow,zygomorphic	-1.4,-30,-35,-7,.1,.1-0.2,0.2-0.4,0.4-1,1.5-4,1/3,1/5-1/3,10-25,12-30,14-,15-,18-25,2-5,2-foliate,2.25-4.75,2.5-5,20-30,3-15,3-6,4-12,4-locular,4.5-9,5-15,7-12,along,apart,ape,appearance,appearing,appressed,articulated,axe,ba,berry,broa,c.,cast,cauline,clearly,close,closely,coarsely,compressed,connivent,curved,cylindrical,deciduous,deltoid,dense,denser,depressed-deltoid,directed,distal,distall,distributed,downcurved,due,eaf,eed,entire,equaling,essentially,external,falcate,female-sterile,filament,foliar,geminat,giving,glabrescent,green,high,interlobal,intermixed,large,largely,larger,lateral,laterally,less,lignescent,lon,long,longer,lower,main,major,mature,maturity,minute,minutely,nectary,never,nflorescence,numerous,oblique,obsolete,occasionally,often,one,orolla,other,otherwise,oung,outer,outline,ovate-lanceolate,pair,per,perfect,persistent,pigmented,pitted,pore,prickle,prickly,projecting,purple,purplish,rachi,readily,recurved,reduced,rigid,ring,ripe,ruit,scabrous,scattered,section,seldom,sessile,sharp-tipped,short,short-stalked,short-stipitate,side,similar,sinus,slightly,small,smaller,sometimes,somewhat,spaced,species,stalk,stellae,strongly,subcapitat,summi,tamen,thickened,three,time,tip,toothlike,two,type,unarmed,unbranched,unit,unlobed,uppermost,upward,usually,vary,varyingly,vein,vestiture,wide,widely,ympodial	0.1,14-25,15-30,adhesion,arrangement,climate,colour,corolla,form,glandular,growth,height,history,life,na,number,ovary,plant,position,reproduction,rugulose,seed,shape,size,staman,stipe,subcapitate,texture
738	wfo-0001031503	success	142	97	67	75	30	0.472	-10,-15,-25,-7,0.3-3,0.5-1,0.5-4,1-,1-2.5,1-3,1-5,1-7,1.5-2,1.5-3,1.5-7,1.5-8,2-3,2.5-10,3-15,3-4,3-5,3-6,6-7,7-10,angled,apart,apex,branched,calyx,chartaceous,cm,cylindrical,densely,diameter,elliptic,forked,glabrous,globose,lanceolate,lobe,mm,moderately,orange,ovate,pedicel,peduncle,petiole,puberulent,pubescent,rachi,radiu,rarely,reddish,ripe,rugose-pubescent,shrub,simple,sparsely,stellate,stigma,style,subclavate,truncate,unbranched,white,x,yellow	-30,-6,1.7-3.5,10-19,5613,6-many-foliat,7-15,abaxially,abruptly,absen,acuminate,acute,adaxially,aggregate,articulated,axe,ba,base,blade,cell,connivent,cuneate,curled,decurrent,deltate,directed,distall,distally,eaf,eed,eglandular,entire,except,fide,flower,gland,hair,long,lower,margin,mostly,narrowed,narrowly,nflorescence,nther,obtuse,occasionally,often,orolla,perfect,pore,present,rounded,ruit,slightly,spaced,stalked,stone,subcapitat,tal,tem,time,tip,toward,triangular,tube,unequal,uniseriate,unit,usually,vary,vein,venturi,wide,ympodial	abaxial,adaxial,anther,arrangement,colour,corolla,form,fruit,growth,height,hermaphroditic,history,inflorescence,leaf,length,life,ovary,perennial,plant,position,pubescence,reproduction,seed,shape,size,spacing,stem,subcapitate,surface,texture
739	wfo-0001031511	success	231	130	103	128	27	0.446	-12,-15,-3.5,-5,-7,0-0.3,0.3-0.8,0.4-0.7,0.5-0.7,0.5-0.9,0.7-2.1,0.8-2,1-1.5,1-2,1.8-2.6,10-25,2-4,2-6,2.2-4.3,2.5-3,2.8-3.5,3-5,4.5-7,4.5-9,6-8,6-9,7-11,abaxially,acute,adaxially,andromonoecious,anther,apex,base,black,blade,brown,calyx,chartaceous,cm,conspicuously,cordate,cuneate,deltate,densely,diameter,discoid,eglandular,ellipsoidal,entire,erect,extra-axillary,forked,fruit,glabrous,globose,green,hair,inflorescence,interpetalar,lanceolate,length,light,lobe,lobed,margin,midpoint,midrib,mm,moderately,obtuse,orange,ovate,pale,pedicel,peduncle,perennial,petiole,plant,present,pubescent,purple,ray,rhizomatous,ripe,rotate,shallowly,shrub,simple,sparsely,stellate-pubescent,stem,stigma,strongly,style,surface,tissue,tomentose,tube,violet,white,x,yellow	%,0,0-1.1,0-2,0-3,0.1-0.2,0.3-0.5,0.3-1.7,0.5-1,0.5-5,0.6-1.5,1,1-3,1-7,1.1-1.6,1.7-2.4,10-12,10-18,15-25,17-25,2-3,2-locular,2.2-3,25-45,4-10,5-10,5-15,5-6,5-7,5-9,5-merou,7-8,8-15,9-15,9-20,absen,absent,accrescent,acicular,across,adaxiall,alyx,ample,anvil-shape,apart,armed,articulated,axe,ba,basal,bisexual,broadly,connivent,contiguous,cross-section,cylindrical,dense,directed,distal,distall,dm,dult,eaf,eed,exocarp,filament,finger,flower,fruiting,functional,geminat,gland-tipped,half,heterostylous,hig,juicy,lamina,lateral,less,lon,long,longer,lower,male,mature,mesocarp,mid-point,midvein,minute,minutely,moist,nearly,nflorescence,oblique,orolla,part,per,pitted,placenta,plurifoliate,pore,porrect,prickle,pseudo-racemose,rachi,ruit,rusty,short,somewhat,spaced,stage,stalk,stalked,stellae,straight,tamen,thick,throughout,time,triangular,unbranched,unit,unknow,uvenile,vary,wid,wide,ympodial	adhesion,arrangement,climate,colour,corolla,form,glandular,growth,height,history,leaf,life,na,number,ovary,position,presence,pubescence,reproduction,rugulose,seed,shape,size,staman,stellate,stipe,texture
740	wfo-0001031512	success	199	129	102	97	27	0.513	-3,0.15-0.3,0.3-0.5,0.3-1,0.3-1.5,0.5-0.8,0.5-1.5,0.5-1.8,0.8-1,0.9-1.5,1-1.5,1-2.5,1.5-3,12-16,13-15,3-4,3-5.1,4-8,4.5-6,4.5-7,7-10,7-12,absent,acute,adaxially,and/or,andromonoecious,anther,apex,articulated,base,black,blade,brown,brownish-black,calyx,chartaceous,cm,connivent,cuneate,cylindrical,deltate,densely,diameter,entire,erect,extra-axillary,flat,flower,fruit,glabrous,gland-tipped,globose,green,grey,grey-green,hair,inflorescence,lanceolate,later,length,lilac,lobe,long,loosely,marbled,margin,mid-point,midpoint,mm,moderately,obtuse,pedicel,peduncle,perennial,petiole,plant,present,pubescent,purple,ray,rhizomatous,rotate-stellate,short,shrub,simple,slightly,sometimes,stellate,stellate-pubescent,stem,stigma,style,surface,thick,though,tube,twisted,undulate,white,x,yellow	%,0-10,0-3,0.05-0.1,0.1-0.2,0.15-0.2,0.15-0.25,0.2-0.3,0.5-0.6,1-2,1-3,12-15,13-16,15-25,2-6,2-foliate,3.8-5.7,5-12,5-7,5-merou,6-13,8-10,abaxially,absen,abundant,accrescent,adaxiall,alyx,apart,axe,ba,broad,broad-based,capitat,decimetr,directed,distall,distinct,distributed,dr.,dult,eaf,eed,filament,finger,first,fruiting,functional,geminat,half,heterostylous,interpetalar,lamina,lateral,less,longer,lower,mature,mesocarp,minute,nflorescence,oblique,orolla,part,per,pore,porrect,prickle,pseudo-racemose,rachi,raised,rounded,ruit,scarcely,sessile,smooth,spaced,stage,stellae,straight,strongly,tal,tamen,throughout,time,tissue,tubercle,unarmed,unbranched,unit,unknow,uvenile,vary,weakly,wide,yellowish,ympodial	adhesion,arrangement,capitate,climate,colour,corolla,form,glandular,growth,height,history,leaf,life,na,number,ovary,position,presence,pubescence,reproduction,rugulose,seed,shape,size,staman,stipe,texture
741	wfo-0001031586	success	167	78	57	110	21	0.341	-2,0.1-1,0.5-0.8,0.5-1,1-1.2,1-1.5,1-2,1.3-5,1.4-2.5,1.5-2,2,2-2.5,3-11,5-6,anther,base,broadly,calyx,capitate,cm,conical,corolla,cream-colored,deltate,elliptic,glabrous,green,greenish,inflorescence,leaf,lobe,lobed,mm,nearly,open,opposite,ovary,pale,paler,pedicel,petiole,poricidal,ridged,rounded,shiny,shrub,size,stem,stigma,straight,style,surface,tip,tube,white,x,yellow	.25,1,5-10,7-10-flowered,abrupt,absent,acute,anthesi,apart,apex,apparently,appearing,attenuate,bark,becoming,beneath,borne,branch,bright,bud,campanulate,closer,completely,cucullate,deflexed,dia,differing,difoliate,distance,drying,eaf,edicel,eed,ellipsoid,exerted,exfoliatin,filament,fleshy,flower,free,fresh,geminate,globose,gree,inflorescenc,know,known,later,lateral,leave,long,lower,main,major,margin,material,may,minor,minutely,mucro,near,new,nflorescence,notched,occasionally,older,olive,one,onto,overtopping,pair,papillate,papillose,planar,pore,portion,present,prominent,raised,remaining,ruit,scar,shap,shaped,shin,simple,slender,small,sometimes,somewhat,soon,spaced,sparsely,swollen,tall,tapering,tear-drop,thick,thickened,trichome,truncate,trunk,ud,uniseriate,unit,vein,widely,yellowish,ympodial,young	arrangement,colour,diameter,form,fruit,growth,height,history,length,life,na,peduncle,perennial,plant,position,pubescence,reproduction,rugulose,seed,shape,texture
742	wfo-0001031587	success	142	90	55	87	35	0.387	.5,0.8-1,1.5-2,1.7-2,12-16,17-30,2-2.5,2/3,3-4,5,6-7,abaxially,acute,anther,apex,attenuate,base,bi-lobed,broadly,calyx,clavate,cm,conical,corolla,deltate,dendritic,elliptic-ovoid,glabrous,inflorescence,irregular,leaf,lobe,lobed,minutely,mm,mostly,ovary,pedicel,petiole,pubescent,shape,size,stem,stigma,style,surface,thickened,tree,trichome,tube,verrucose,way,white,winged,x	1-1.5,10-15,2,2-9-celled,6-8,7-9,adaxially,along,anthesi,apart,axi,bark,closely,cone,decurrent,deflexed,densely,denser,dia,differing,drying,eaf,edicel,eed,elliptic,erect,evenly,exserted,fide,filament,fleshy,free,furcate,globose,golden-red,included,know,known,lamina,later,lateral,like,long,loose,lower,lowered,main,major,middle,minor,oblique,ocasionally,occasional,older,overlappin,pair,pale,papillate,papillo,parallel,perpendicular,persisten,pore,poricidal,portion,rarely,rect,reddish-grey,rest,ruit,scar,shaped,simple,soft,somewhat,spaced,steinbach,tall,tear-drop,thick,tip,tub,ud,uniseriate,vein,widest,young	adhesion,arrangement,blade,climate,colour,dense,diameter,form,fruit,glandular,growth,hair,height,history,length,life,margin,midpoint,na,number,papillose,peduncle,perennial,plant,position,presence,pubescence,ray,reproduction,rugulose,seed,staman,stellate,stipe,texture
743	wfo-0001031589	success	222	123	91	131	32	0.41	-15,-6.5,0.1-0.5,0.2-0.5,0.4,0.5-1,0.55-0.7,0.8-2.3,0.9-1.3,1-1.8,1.2-1.5,1.7-2.5,1.8-2.9,1/3,1/3-1/4,2-3.5,2.5-6,2.8-4,3/4,4-6.5,5-8,acute,anther,apex,apically,attenuate,base,berry,blade,bright,calyx,chartaceous,cm,connivent,deltate,densely,diameter,dull,elliptic,flattened-reniform,fruit,glabrescent,glabrous,lateral,leaf,length,lobe,lobed,long,long-obovate,lower,margin,maturity,mauve,membranous,midpoint,mm,moderately,narrow-cuneate,occasionally,often,orange-brown,pale,pedicel,petiole,plant,poricidal,ray,rounded,scandent,shrub,simple,smooth,sparsely,spherical,stellate,stellate-pubescent,stem,style,subentire,surface,tapering,tip,tube,upper,way,white,whole,wide,yellow,yellow-orange	-0.5,-6,.5,/6,0,0-1,0-10,0-3,0-30,0.1,0.15-0.3,0.2-0.4,0.2-3,0.6-1.2,0.7,0.9-1.6,1,1-5,1.5-5,1/3-1/2,10-30,2-,2-10,2.5-4.5,3-4,3-5,4/5,5-merous,6-8,8-14,8-30,abaxially,alyx,ame,apart,apparently,articulated,bark,broadly,brow,brown-green,c.,caudat,cell,concolorous,cream,dark,density,difoliate,discolorous,distance,drying,eed,elongating,equal,erect,extending,eye,filament,flower,free,fruiting,geminat,gray-green,green,higher,infructescence,lengt,lon,longer,marking,mature,midvein,multangulate,naked,narrow,nflorescence,oblong,obovate,older,orange-green,orolla,oung,outline,pair,part,pendulous,per,perfec,pericarp,pit,porrect,portion,prickl,prickle,prickly,primary,raised,reflexed,ruit,sessile,shiny,shorter,side,small,solitary,sometimes,somewhat,spaced,spreading,stalk,stalked,stout,straight,subsessile,tamen,terete,tertiary,time,trichome,unit,vary,vein,venation,visible,weakly,winged,woody,yellow-green,ympodial,young	8,adhesion,arrangement,caudate,climate,colour,corolla,form,glandular,growth,hair,height,history,inflorescence,life,na,number,ovary,peduncle,position,presence,pubescence,reproduction,rugulose,seed,shape,size,staman,stigma,stipe,texture,ye
744	wfo-0001031609	success	154	104	70	84	34	0.455	0.5-3,1-10,1-6,1.3-3,1.5-2,1.5-3,10-25,2-,2-3,2.5-4,3-24,3-5,3-9-lobed,4,4-5,4-6,4.5-60,abaxially,acute,adaxially,apex,around,base,blade,brownish,calyx,campanulate,cm,cuneate,deltate,dia,diameter,elliptic,entire,flattened,fruit,glabrous,globose,green,inflorescence,leaf,lobe,lobed,margin,mm,obovate,obtuse,orange,papillose,pedicel,peduncle,petiole,pinnately,puberulent,ripe,shallowly,shrub,simple,small,stellate,stigma,style,succulent,tree,triangular,truncate,tube,unlobed,x,yellow	.5,/4,0-30,0.4-3,0.5-1,2,20-25,3-foliat,5-25,5/6,8-20,absen,absent,aggregate,ape,apiculate,articulated,axe,barely,beyond,bilobe,branch,brow,cell,connective,connivent,conspicuous,contiguous,dark,dilated,directed,distally,divided,eaf,eed,ellipsoidal,elliptic-ovate,emerging,equal,exceeding,exserted,fleshy,flower,forked,glabrou,laterally,leaving,long,lower,midrib,minutely,nearly,nflorescence,nther,obconical,occasionally,orolla,pedicellar,point,pore,rachi,radiu,reticulate,rounded,ruit,scar,sinus,stamen,stone,strongly,succulen,tal,tem,thecae,time,tip,tomento,two,ud,unbranched,unit,vary,wide,ympodial	adhesion,anther,arrangement,bilobed,climate,colour,corolla,form,glandular,growth,hair,height,history,length,life,midpoint,na,number,ovary,plant,position,presence,pubescence,ray,reproduction,rugulose,seed,shape,size,staman,stem,stipe,surface,texture
745	wfo-0001031615	success	154	98	66	88	32	0.429	.5,0.8-1,0.9-1.1,1-1.6,1.3-1.8,1.5,1.5-5,11-15.5,4-6.5,5-6,acuminate,acute,anther,apex,attenuate,base,bilobed,brown,calyx,capitate,cm,corolla,decurrent,deltoid,dia,elliptic,flattened-reniform,fruit,glabrous,glandular,globose,green,inflorescence,leaf,lobe,lobed,margin,minutely,mm,nearly,opposite,ovary,papillose,pedicel,petiole,pitted,shaped,shrub,size,small,somewhat,stem,stigma,style,surface,tear-drop,tree,trichome,tube,tuft,unicellular,uniseriate,urceolate,white,winged,x	0,0.5,0.5-1,2-3,2-4.2,3.8-6.1,5-20-flowered,6-8,8-10,anthesi,arising,axil,ba,bark,becoming,berry,caly,closely,dark,dark-papillo,deep,deflexed,differing,difoliate,distal,eaf,edicel,eed,expanded,exserted,filament,free,fruiting,furcate,geminat,impressed,incrassate,interpetalar,lamina,lateral,less,lon,long,lower,main,major,maroo,middle,minor,minute,nflorescence,occasionally,older,one,overlappin,packed,pair,paler,papillae,per,pore,poricidal,portion,prominent,reflexed,ruit,scar,scarcely,shiny,simple,sinus,slender,slightly,straight,subumbellate,tall,tapering,terminal,thickened,thin,tip,ud,unit,vein,widest,woody,ympodial,young	adhesion,arrangement,blade,climate,colour,dark-papillose,diameter,form,growth,hair,height,history,length,life,midpoint,na,number,peduncle,perennial,plant,position,presence,pubescence,ray,reproduction,rugulose,seed,shape,staman,stellate,stipe,texture
746	wfo-0001031618	success	184	100	64	120	36	0.348	-2,0-3,1-1.5,1.5-2,10-18,2-2.5,2-3,3-4,3-8,4-5,5,acute,anther,apex,axil,base,branch,broadly,calyx,capitate,cm,corolla,darker,discoidal,equal,finely,glabrous,glandular,green,greyish,hair,lavender-purple,leaf,lobe,marbled,minute,mm,oblong,obovoid,ovary,ovate-lanceolate,ovoid,pale,pedicel,peduncle,petiole,purple,reddish-brown,reticulate,rotate,rounded,rugose,shrub,simple,somewhat,stem,stigma,stripe,succulent,surface,tinged,triangular,unequal,x	0.5-1.5,1-7,1.5-3.5,10-lobed,13,3,40-60,5-12,90-110,acuman,almost,also,anthesi,appearance,appearing,aspect,becoming,berry,beyond,blunt,bluntly,c.,cell,clonal,cluster,column,conical,covering,cuneate,cut,cyme,developed,dia,eaf,eed,ellipsoid,elliptic,emarginate,enlarged,erect,except,exerted,extending,facetted,filament,fleshy,floral,flower,fork,forked,frui,general,giving,greatly,gree,growing,habit,half,interacuminal,lanceolate,lasting,lengthening,less,lobed,lon,long,loosely,lower,maturity,mauve,may,mid-vein,midrib,narrowly,nflorescence,occasional,occur,often,pal,pedicellate,petal,pinatisect,plurifoliat,point,pore,poricidal,rarely,rhachi,ripe,ruit,scorpioid,sessile,several,shallowly,side,single,sinus,slit,soft-wooded,sometimes,specimen,stone,stout,strongly,styl,tapering,terete,tip,tissue,tub,ud,unit,variable,vigorous,way,well,year,ympodial,young,younger	adhesion,arrangement,blade,climate,colour,diameter,form,fruit,growth,height,history,inflorescence,length,life,margin,midpoint,na,number,perennial,plant,plurifoliate,position,presence,pubescence,ray,reproduction,rugulose,seed,shape,size,staman,stellate,stipe,style,texture,tube
747	wfo-0001031646	success	171	110	93	78	17	0.544	-7,-pinnate,.2,.5,0.8-1.5,1-1.8,1-10,1-6,1.2-2.5,1.5-3.5,15-25,2-2.5,2-3,2.5-10,20,3.5-4,4-18,4-20,4-5,5,5-7.5,7-8,8-15,abaxially,adaxially,anther,apart,articulated,base,blue,branched,brown,calyx,chartaceous,cm,covered,cylindrical,darker,densely,diameter,ellipsoidal,elliptic-lanceolate,equal,flattened,flower,fruit,glabrous,globose,green,hair,highly,immature,leaf,leaflet,light,lobe,long,maroon,mature,mm,multicellular,obliquely,oblong,ovate-lanceolate,part,pedicel,peduncle,petiole,present,pubescence,pubescent,red,rotate-pentagonal,rugulose,scandent,shrub,simple,size,smooth,spaced,spreading,stem,stigma,stout,style,surface,tawny,tube,uniseriate,vine,violet,x,yellow	0.2-0.8,0.5-2,1.5-4,18-38,1962,2-10,4-8,4-foliate,5-6,5-7,5-merou,absen,absent,accrescent,acuminate,acut,acute,aggregate,alyx,apex,apical,apparently,axe,ba,basally,berry,blade,cell,ciliat,climbing,connivent,correll,cuneate,decreasing,directed,distall,eaf,eed,elliptic,entire,fide,filament,fruiting,geminat,glandular,high,homostylous,hyaline,interjected,lateral,lower,margin,nflorescence,oblique,obtuse,orolla,ovate-lanceolat,perfect,petiolule,pore,pubescen,rachi,rounded,ruit,seudostipule,shortly,slightly,small,stone,tamen,tem,tip,toward,tree,truncat,unit,vary,ympodial	adhesion,arrangement,colour,corolla,form,growth,inflorescence,length,ovary,position,presence,pseudostipule,seed,shape,staman,texture,truncate
748	wfo-0001031651	success	201	118	83	118	35	0.413	-3.5,.6,/5,0.1-0.15,0.1-0.25,0.3-0.8,0.3-1.5,0.6-1,0.6-1.3,0.7-1,1-1.7,1.2-2,1.2-3,1/5,2-3.5,4-5,4-6,abaxially,acute,anther,apex,apically,base,berry,blade,brown,calyx,chartaceous,cm,cordate,deltate,densely,diameter,dull,elliptic,entire,flattened-reniform,fruit,gray,herb,lateral,leaf,length,lobe,lobed,long,lower,margin,maturity,midpoint,mm,obtuse,orange-brown,ovate,pedicel,peduncle,petiole,poricidal,purple,ray,red,rounded,shrub,simple,smooth,sometimes,spherical,spreading,stellate,stellate-pubescent,stem,style,subentire,surface,tapering,terminal,tip,tube,upper,way,white,wide,yellow	-2,-3,.1,.7,/3,0-20,0.1,0.1-0.2,0.15-0.2,0.2-0.5,0.3-0.5,1,1-2,1-4,1.3-1.6,1.5-2,1/6-1/4,2-10,2-3,2/3-3/,3-5,4.5-7,5-merous,abaxial,absent,acuminat,adaxial,alyx,ame,apar,apart,apparently,articulated,bark,branched,c.,cell,concolorous,curved,dark,difoliate,discolorous,drying,eaf,eed,elongating,equal,erect,eye,faint,filament,filiform,flower,free,fruiting,geminat,glabrescent,glabrous,gra,herbaceous,infructescence,lanceolate,longer,mature,naked,nflorescence,oblong,older,one,open,orolla,oung,outline,pair,pendulous,per,perfec,pericarp,persistent,pit,porrect,portion,prickl,prickle,prickly,primary,raised,red-green,reflexed,ruit,scandent,scar,shorter,small,spaced,stalk,stalked,straight,subsessile,tamen,terete,tertiary,thick,thick-stalked,time,toward,trichome,unarme,unarmed,unit,variously,vary,vein,venation,visible,weakly,yellow-green,ympodial	2/3-3/4,8,acuminate,adhesion,arrangement,climate,colour,corolla,form,glandular,growth,hair,height,hermaphroditic,history,inflorescence,life,na,number,ovary,perennial,plant,position,presence,present,pubescence,reproduction,rugulose,seed,shape,size,staman,stigma,stipe,texture
749	wfo-0001031654	success	191	104	84	107	20	0.44	0.5-0.75,0.5-2,1-1.5,1-2,1-4,1.5-2,1.5-2.0,2-5,2-6,4-16,4-6,4-7,5-8,abaxial,abaxially,adaxial,adaxially,anther,armed,attenuate,base,brown,bud,calyx,chartaceous,cm,connivent,cream,cylindrical,dark,densely,diameter,extra-axillary,flower,fruit,glabrous,globose,green,hair,immature,leaf,leaf-opposed,like,lobed,many,mature,mm,moderately,narrowly,nearly,netlike,ovate,pedicel,peduncle,petiole,pit,porrect-stellate,prickle,pubescent,raised,recurved,red,reniform,ridge,rusty,scandent,separated,shrub,simple,small,sparsely,spreading,stellate,stem,stigma,style,surface,tan,tapering,triangular,white,whitish,x,yellow	0.5,0.5-1,0.5-1.5,0.5-3.5,1,1-.,1-3,1.5-3,1/3-1/2,10-20,2-3,2-8,2-ranked,3,3-10,3-6,5-merou,8-15,absent,accrescent,acute,adaxiall,alyx,apar,apex,apical,apparently,axe,berry,beyond,blade,contiguous,cordate,cut,cylindrica,decurrent,difoliate,directed,discolorous,eaf,eed,either,em,equa,exserted,filament,flattened,frui,fruiting,geminate,glabrou,interpetaler,introrsel,lacking,less,lobe,long,lower,m.,major,margin,midpoint,midrib,midvein,multicellular,multiseriate,nflorescence,obscure,obtuse,occasional,occasionally,often,onto,orolla,pair,parallel,per,perfect,perpendicular,pore,rachi,ray,ruit,secondary,side,sinus,slightly,spaced,spine,stalk,stamen,ste,straight,tamen,thin-skinned,tissue,tube,unarmed,unbranched,unicellular,unit,usually,vary,vein,way,wide,ympodial	armature,arrangement,colour,corolla,form,growth,height,history,inflorescence,length,life,ovary,plant,position,pubescence,seed,shape,size,staman,texture
750	wfo-0001031656	success	154	81	55	99	26	0.357	/4,1-1.5,1-2.5,1.2-1.5,1.5-2,1.5-5,10-20,3-3.5,4-9,5-ribbed,6-8,anther,base,bright,calyx,capitate,cm,corolla,densely,dia,ellipsoid,elliptic,fruit,glabrous,globose,green,greyish,leaf,lobe,lobed,long-acuminate,minutely,mm,opposite,ovary,ovate,papillose,pedicel,petiole,plant,red-papillose,rib,ridged,shaped,shrub,size,stem,stigma,style,surface,tear-drop,tube,way,white,x	.5,0.5,0.5-1,1-2,2.5-3.5,3-5,5-7,acuminate,acute,also,anthesi,apex,arising,ba,bark,berry,closely,cork,differing,difoliate,directly,drying,eaf,edicel,eed,enclosing,erect,extremely,filament,fleshy,flower,free,fruiting,geminat,hooded,known,lateral,live,lon,long,lower,main,major,margin,matte,mature,middle,minor,minute,nflorescence,node,oblique,often,older,one,pair,pale,paler,papillo,peelin,persistent,planar,pore,poricidal,portion,prominent,proximal,rather,reddish,reflexed,rounded,ruit,scar,sessile,shiny,slightly,somewhat,spaced,specimen,straight,strongly,swollen,tall,terminal,thick,thickened,tip,top,transversely,ud,unit,upper,vein,visible,wide,widest,woody,ympodial,young	adhesion,arrangement,colour,diameter,form,growth,height,history,inflorescence,length,life,na,number,peduncle,perennial,position,presence,pubescence,ray,reproduction,rugulose,seed,shape,staman,stellate,texture
751	wfo-0001031667	success	153	73	53	100	20	0.346	0.6-1,0.6-1.5,1-1.5,1.4-3,1.5-2,10-13,12-35,2-3,2.5-5,3-13,3-5,5-9,6-10,8-15,calyx,cm,connate,corolla,dark,diameter,distal,elliptic-lanceolate,forked,globose,green,green-white,half,herbaceous,interjected,lanceolate,lateral,leaf,leaflet,long,mm,odd-pinnate,ovoid,pedicel,peduncle,perennial,petiole,pilose,plant,seed,size,spot,stellate,stripe,terminal,throughout,white,wide,yellow	1-4,2-5,2-6,3-6-foliat,3-8,4-1.,5-15,8-13,abaxially,abruptly,acumen,acuminate,acute,adaxially,apex,apical,apically,apiculate,articulate,base,branched,caudate,cell,cordate,covering,cuneate,cyme,dehiscent,dichasial,dichasially,digestion,diminishing,dorsally,eaf,ebracteate,edge,eed,emoval,enzyme,exceeding,filament,flat,flower,folded,generally,globo,hair-like,honeycomb,introrse,irregularly,living,lobe,lobed,lon,lower,lunat,make,maturing,monochasial,mucilaginous,nflorescence,nther,oblique,oblong,often,orolla,pair,pattern,perfect,petiolate,petiolule,plan,poricidally,proximal,reveal,rounded,ruit,sessile,seudostipule,short,slit,specimen,stamen,stigma,straight,style,tal,tem,testal,thick,toward,tuber-bearing,typically,unit,vary,wall,whit,without,ympodial,¼	4-10,anther,arrangement,colour,form,fruit,growth,height,history,inflorescence,length,life,na,number,ovary,position,reproduction,shape,stem,texture
752	wfo-0001031672	success	157	111	85	72	26	0.541	0-2,0.3-0.5,0.5-1.5,1,1-1.5,1-5,1.5-2,1.5-2.5,1.5-3.5,1.5-5,10-20,15-20,2-12,2-28,4,4-34,4.5-5,6,9-lobed,abaxially,acuminate,acute,adaxially,apart,apex,apiculate,articulated,basal,base,calyx,chartaceous,cm,cordate,densely,diameter,entire,flattened,fruit,glabrous,glandular-puberulent,globose,green,greenish-brown,leaf,leaving,lobe,lobed,long,margin,mature,mm,moderately,narrowly,near,often,ovate,ovoid,pedicel,pedicellar,peduncle,petiole,pilose,pinnately,puberulent,pubescent,remant,rounded,simple,spaced,sparsely,stellate,stigma,style,subcoriaceous,tip,toward,tree,triangular,truncate,tube,unbranched,white,whitish,x,yellow	0,0.5,0.5-1,1-,1-10,1-2,15-50,3-4-foliat,3/4,4/5,5-6,absent,aggregate,ape,aublet,axe,beyond,blade,cell,ciliat,connective,cylindrical,directed,distally,divided,eaf,eed,exceeding,exserted,fide,fleshy,flower,hair,lanceolate,lon,lower,membranaceous,midrib,nflorescence,nther,obtuse,occasionally,one,orolla,perfect,pilo,pore,presen,present,purple,rachi,radiu,represented,ruit,shorter,sinus,slightly,small,stamen,stone,tal,tem,thecae,time,truncat,ud,unit,unlobed,vary,wide,yello,ympodial	anther,arrangement,colour,corolla,form,growth,height,hermaphroditic,history,inflorescence,length,life,na,ovary,perennial,plant,position,pubescence,reproduction,rugulose,seed,shape,size,stem,surface,texture
753	wfo-0001031684	success	161	112	76	85	36	0.472	.25,.5,/4,0.4-1.5,0.5-0.8,0.5-1,0.7-1,0.75-1,1-1.2,1-5,2,2-9,3-30,4-17,acuminate,acute,anther,apex,base,calyx,clavate,cm,corolla,decurrent,densely,dia,difoliate,elliptic,geminate,glabrous,globose,green,inflorescence,internodal,leaf,like,lobe,lobed,long,long-triangular,minutely,mm,obconic,occasionally,opposite,ovary,ovoid-reniform,pale,papillose,pedicel,petiole,pitted,poricidal,pubescent,rest,short,shrub,size,slightly,small,sparsely,stem,stigma,style,surface,tan,tip,tree,trichome,tube,unifoliate,uniseriate,way,white,winged,x	.75,0.1,0.5-0.7,10-100,3-3.5,5-7,along,anthesi,apar,bark,bearing,beneath,berry,black,borne,branched,causing,curly,deflexed,denser,differing,drying,eaf,edicel,eed,elongated,except,expanded,exserted,extremely,filament,filiform,flower,free,fruiting,gre,greatly,irregularly,lateral,less,lon,lower,main,major,middle,midrib,minor,nflorescence,older,one,pair,papillo,persistently,planar,pore,portion,present,previously,pulled,raised,reflexe,reflexed,ruit,scar,shaped,single,siz,slender,soon,spaced,straight,tall,tapering,tear-drop,time,tipped,ud,unevenly,unit,varying,vein,widely,widest,ympodial,young	adhesion,arrangement,blade,climate,colour,dense,diameter,form,fruit,glandular,grey,growth,hair,height,history,length,life,margin,midpoint,na,number,peduncle,perennial,plant,position,presence,pubescence,ray,reproduction,rugulose,seed,shape,staman,stellate,stipe,texture
754	wfo-0001031690	success	140	118	81	59	37	0.579	1.2-2.0,1/2-2/3,2-3,2-5,2.5-3.5,2.7-3.6,4-9,7-10,accrescent,acute,along,anther,apex,apically,arcuate,base,bearing,beneath,berry,blade,blue,broadly,brown,calyx,campanulate,cm,da,dark,depressed-spherical,developing,dm,dry,eglandular,erect,foveolate,glabrate,glabrous,green,hair,herb,internodal,invested,lanceolate,length,linear,lobe,long,main,maturity,minutely,mm,numerous,often,ovate,pedicel,perennial,petiole,prickly,reflexed,reniform,sessile,shape,slender,slightly,splitting,spreading,stellae,stellate,stem,stipitate-glandular,strait,tapering,tightly,tube,uniseriate,vein,violet,violet-tinged,viscid-glandular,yellow,zygomorphic	.5,2-8,2/3,6-9-flowere,8-40,acro,always,alyx,anthesi,cauline,completely,corky,covered,difoliate,divided,eaf,eed,emerging,exceeded,geminat,least,lon,nflorescence,obtuse,orolla,per,persistent,pinnatifid,prickle,rarely,rhizome,root,rounded,ruit,scattered,separated,short,slende,somewhat,space,tall,tamen,terete,thrice,throughout,tigma,tub,twice,tyle,ultimate,unexpande,unit,usually,variable,vary,widely,yearly,ympodial,young	across,adhesion,arrangement,climate,colour,corolla,diameter,form,fruit,glandular,growth,height,history,inflorescence,leaf,life,margin,midpoint,na,number,ovary,peduncle,plant,position,presence,pubescence,ray,reproduction,seed,size,staman,stigma,stipe,style,texture,unexpanded,ye
755	wfo-0001031695	success	185	114	83	102	31	0.449	0.5-1,1-2,1-9,1.5-8,2-3,2-4,2-5,2.5-5,20-30,3-19,3-7,4-10,4-5,4-6,5-20,5-7,6-10,6-20,abaxially,abruptly,acuminate,adaxially,also,apex,articulated,base,calyx,campanulate,chartaceous,cm,cordate,dark,deep,densely,diameter,ellipsoidal,entire,flattened,fruit,glabrous,glandular-puberulent,green,greenish,immature,lavender,leaf,leaving,lobe,lobed,long,margin,mm,moderately,mottled,narrowly,oblique,oblong,ovate,pedicel,pedicellar,peduncle,petiole,pilose,pilose-hirsute,puberulent,puberulent-pubescent,pubescent,purple,purplish,remnant,shrub,simple,sometimes,sparsely,stigma,stripe,style,subcoriaceous,tree,triangular,tube,x,yellow	0.5-2,1,1-3,1.5-2,1/2,1/3,10-,10-15,10-35,15-20,3-,3-10,3-17,30-40,4-foliat,5,6-8,7-,?,acute,aggregate,apart,ape,apically,apiculate,axe,basal,beyond,blade,branched,broadened,capitat,cell,color,connective,connivent,cylindrical,d,dilated,directed,divided,eaf,eed,eglandular,eglandular-pilose,exceeding,exserted,fleshy,flower,glabrate,glabrescent,hair,hard,lanceolate,lateral,laterally,lilac,lon,lower,midrib,nflorescence,nther,obtuse,occasionally,often,orolla,ovoid,perfect,pilo,pilose-hirsut,pore,presen,present,rachi,radiu,ripe,rounded,ruit,shorter,sinus,slight,slightly,small,somewhat,spaced,stamen,stone,swelling,tal,tem,thecae,time,tip,tomento,unbranched,unequal,unit,unknown,unlobed,vary,wide,ympodial	abaxial,adhesion,anther,arrangement,capitate,colour,corolla,form,growth,height,history,inflorescence,length,life,na,ovary,perennial,plant,position,presence,pubescence,reproduction,rugulose,seed,shape,size,staman,stellate,stem,surface,texture
756	wfo-0001031697	success	185	101	64	121	37	0.346	.4,.5,.7,1,1.2,2-celled,3,4,4.5,?,abaxially,adaxially,anther,apex,attenuate,base,blade,calyx,cm,cordate,densely,diameter,entire,except,flower,free,fruit,glabrous,gland-tipped,globose,hair,herbaceous,lobe,margin,midpoint,minute,mm,mostly,ovate,ovate-lanceolate,pedicel,peduncle,petiole,pilose,plant,pubescence,purple,similar,simple,size,sparsely,stellate,stem,stigma,style,subreniform,subshrub,thin-textured,tip,tube,white,x,yellow,yellow-brown	-celled,.6,.8,0.1,0.3,0.4,0.5,0.6–1.0,0.8,1.2–2.5,1.4,1.5–7,10-celled,15,15–60,1–1.6,1–2,2-foliate,2.2,2–3,2–4,3.5,3–4,3–8,4-rayed,4–5,5,6–13,accrescent,acute,apparently,around,axe,branch,completely,consistently,covering,cylindrical,directed,distall,divergent,eaf,eed,especially,face,fertile,few-celled,filament,flattened,flowering,foveolate,frui,fruiting,geminat,glabrou,gland-tippe,hilum,hyaline,indentation,lacking,less,linear,lon,long,longer,longest,lower,lowermost,lowest,major,many,mixed,nflorescence,non-glandular,often,orolla,part,per,pigment,pore,prickle,pubescent,raised,ruit,scattered,sessile,several-celled,shallowly,sharp,shiny,short,shorter,single,slender,small,smaller,somewhat,ste,stellae,straight,tall,tamen,taproo,tem,terminal,thick,time,truncat,tuberculate,ultimate,unarme,unarmed,unbranched,unit,upper,vary,varying,vein,wide,ympodial,–3	1-1.6,1.2-2.5,15-60,3-4,3-8,4-5,6-13,adhesion,arrangement,climate,colour,corolla,form,glandular,growth,height,history,inflorescence,leaf,length,life,na,number,ovary,position,presence,present,ray,reproduction,rugulose,seed,shape,staman,stipe,surface,texture,truncate
757	wfo-0001031698	success	58	72	26	32	46	0.448	2-2.5,2.5,2.5-3,4-4.5,base,cm,elliptic,flattened,glabrous,green,leaf,margin,minutely,mm,pale,pedicel,pitted,reddish-brown,reniform,repandly,rugose,shrub,stem,surface,woody,x	'',``,ape,bark,branch,decurrent,deflexed,dia,difoliate,dull,eaf,eed,fide,fruiting,geminat,incrassate,long,maguire,older,otherwise,paler,papillae,persistin,stout,strongly,tall,unit,wing,winged,yellowish,ympodial,young	1,adhesion,anther,apex,arrangement,blade,calyx,climate,colour,corolla,diameter,form,fruit,glandular,growth,hair,height,history,inflorescence,length,life,lobe,midpoint,na,number,ovary,peduncle,perennial,petiole,plant,position,presence,pubescence,ray,reproduction,rugulose,seed,shape,size,staman,stellate,stigma,stipe,style,texture,tube
758	wfo-0001031707	success	178	104	76	102	28	0.427	.5,/4,1-1.2,1-1.3,1-1.5,1.2-1.8,1.2-2,1.5-2,1.5-6,16-20,2,2-4,2-6,4-5,6-7,8-12,9-15,almost,anther,apical,apically,axillary,base,brown,calyx,capitate,climbing,cm,conical,corolla,dense,densely,diameter,distinct,flattened,glabrous,globose,green,greenish,high,leaf,leaflet,lobe,lobed,long,mm,ovary,pair,pedicel,petiole,pink,pinnate,plant,pointed,pubescent,quadrate,reddish,round,sagittate,scattered,simple,slightly,smooth,sparsely,stigma,style,surface,ternate,trichome,tube,uniseriate,vine,way,white,woody,x	-3,0.5-1,1-3,1.5-1.7,1/3,2-10,2-3,24,3,4-6,5-10-celled,80-140,abaxially,absent,acuminate,acute,adaxially,along,anthesi,apex,attenuate,axil,basal,basiscopically,bearing,berry,c.,cateniform,cell,clavat,conspicuously,cucullate,distal,drying,eaf,edicel,eed,elliptic,endrophilum,enlarged,epidermal,erect,exserted,filament,flap-like,flat,fleshy,flower,four-lobed,free,fruiting,horizonta,inflorescenc,lanceolate,lateral,less,like,lon,lower,margin,minutely,narrower,narrowly,nflorescence,oblique,obovate,occasionally,open,papillate,penden,per,petiolule,planar,poricidal,portion,primary,quite,raised,regular,rest,ruit,scar,smaller,somewhat,spaced,stout,strongly,tem,terminal,thickening,time,tip,tub,type,ud,unifoliat,unit,usually,vein,white-lenticellate,widely,ympodial	adhesion,arrangement,clavate,colour,form,fruit,growth,height,history,inflorescence,length,life,na,number,peduncle,position,presence,pubescence,ray,reproduction,rugulose,seed,shape,size,staman,stellate,stem,texture
759	wfo-0001031714	success	201	119	92	109	27	0.458	-3.5,-6,-8,0.2-0.5,0.3-0.5,0.4-,0.5,0.5-,0.5-0.8,0.7-2.2,1,1-1.4,1-2,1-3,1-4,1.5-2,1.5-2.4,2-3,3-3.5,6-8.5,7-10,7-8,absent,anther,apex,base,berry,bright,broadly,calyx,capitate,cm,conical,corolla,cup-shaped,dense,diameter,elliptic,entire,equal,flattened,glabrous,globose,greyish,growth,inflorescence,leaf,less,lobe,lobed,margin,membranous,midpoint,minutely,mm,narrowly,nearly,oblique,often,orbicular,ovary,pale,pedicel,peduncle,petiole,pubescence,pubescent,rarely,ray,red,reniform,rounded,shallowly,shoot,short,shrub,simple,size,sparsely,stellate,stem,stigma,style,surface,tapered,terminal,thin,truncate,tube,white,x,yellow	.25,0.15-0.3,0.5-0.6,0.8-1.2,2,2-3.5,2-4,3-4,3-6,4-merous,6,7,<,?,abaxial,abaxially,adaxially,anthesi,appearing,arising,armed,articulated,axi,bark,basal,broad,broad-based,caly,cell,closely,densely,eaf,eed,ellipsoid,elongate,enlarged,erect,especially,exserted,extending,filament,flower,foliose,free,frui,fruiting,irregular,juicy,leafy,lengthening,like,lon,long,longer,lower,markedly,midrib,mixture,new,nflorescence,numerous,obvious,occasionally,older,pair,papillo,per,perfect,pericarp,pitted,planar,plate,plurifoliat,pore,poricidal,portion,prickle,prickly,primary,rectangular,ripe,ruit,scar,sessile,short-stalked,shorter,sinuate,slightly,slit,smaller,sometimes,spaced,spreading,stalked,stout,straight,strongly,testal,tiny,tip,trichome,ud,unarmed,unit,upper,usually,vein,woody,ympodial	adhesion,arrangement,blade,climate,colour,form,fruit,glandular,hair,height,history,length,life,na,number,perennial,plant,position,presence,reproduction,rugulose,seed,shape,staman,stipe,texture,ye
760	wfo-0001031721	success	208	118	91	117	27	0.438	%,0.1-0.5,0.2-0.5,0.25-0.5,0.3-1.1,0.4-0.6,0.4-2.2,0.6-1.2,0.8-1.3,1-1.5,1-3.5,1.1-3.2,1.2-1.7,11-30,2-4,2.5-3,2.7-3.5,3-4.5,3-7,5-20,5-7,6-9,7-8,8.5-12.5,absent,andromonoecious,anther,apex,base,black,blade,brown,calyx,chartaceous,cm,cuneate,dark,deltate,densely,diameter,elliptic,entire,extra-axillary,flattened,fruit,glabrous,globose,green,grey,hair,herbaceous,inflorescence,lamina,lanceolate,lateral,lavender,leaf-opposed,length,lobe,long,margin,minutely,mm,moderately,obtuse,ovate,pale,pedicel,peduncle,petiole,plant,present,purple,ray,resprouter,reticulate,simple,sparsely,stellate,stellate-pubescent,stem,stigma,streak,style,surface,throughout,time,tube,x,yellow,yellowish-green	.1,0-0.1,0-1,0-3,0-5,0.1-0.2,0.25-0.4,0.4-0.7,0.4-1.6,0.6-1.1,0.7-1.2,0.7-1.3,1,1-20,1-3,1.5,2.2-3.2,3-10,3-foliate,4-5,4-7,4-locular,5-11,5-merou,6-15,7-10,7-9,8-15,8-20,abaxially,absen,accrescent,acicular,across,adaxiall,adaxially,alyx,anvil-shape,apart,articulated,axe,ba,capitat,confined,connivent,cross-section,curved,cylindrical,d.,directed,distall,distributed,dult,eaf,eed,eglandular,erect,exocarp,filament,finger,flower,fruiting,functional,geminat,gland-tipped,half,heterostylous,hig,juicy,less,longer,lower,mature,mesocarp,mid-point,midpoint,midrib,midvein,minute,moist,nflorescence,oblique,orolla,part,per,placenta,pore,porrect,possibly,prickle,pseudo-racemose,rachi,ruit,semi-circular,sessile,short,solitary,somewhat,spaced,stage,stalk,stalked,stellae,straight,tamen,thick,unarme,unarmed,unbranched,unit,uvenile,vary,weakly,white,wide,yellowish,ympodial	adhesion,arrangement,capitate,colour,corolla,form,glandular,growth,height,history,leaf,life,na,number,ovary,perennial,position,presence,pubescence,reproduction,rugulose,seed,shape,size,staman,stipe,texture
761	wfo-0001031723	success	228	134	101	127	33	0.443	-1.5,-16,-5,-6.5,0.1-0.5,0.4-1,0.55-0.9,0.6-1,1-2,1-3,1.2-2,1.5-10,10-30,2-3.5,2.5-4.5,2.5-5,2/3-3/4,4-20,4-6,abaxial,abaxially,acuminate,acute,anther,apex,apically,base,berry,blade,brown,calyx,chartaceous,cm,connivent,cuneate,dark,deltate,densely,diameter,drying,dull,entire,erect,evenly,flattened-reniform,fruit,glabrescent,glabrous,glandular,green,hair,lateral,leaf,length,lobe,lobed,long,margin,marking,maturity,mauve,midpoint,minute,mm,moderately,near,obtuse,orange,orange-brown,ovate,pale,pedicel,peduncle,petiole,poricidal,ray,red,rounded,shrub,simple,smooth,sometimes,sparsely,spherical,stellate,stellate-pubescent,stem,style,subentire,surface,tapering,terminal,tip,trichome,tube,way,weakly,white,wide,yellow,young	-1/2,-15,-2,-6,-8,-merous,0,0.05-0.2,0.1-0.2,0.1-0.3,0.15,0.2-1,0.4,0.4-,0.4-0.9,0.7-1,0.8-1.5,1-,1-2.5,1-5,1.5-,1.5-2.5,1/3-1/2,1/4-1/3,1/6-,15-45,2-,2-5.5,2-7,2/3,3-10,3-15,4-,4-10,4-11,4-5,5-40,5-9,8-20,acut,adaxial,alyx,ame,apar,apart,apparently,articulated,ba,bark,branched,branching,brow,c.,conical,curved,discolorous,eaf,eed,elongated,elongating,equal,eye,filament,filiform,finely,flower,free,fruiting,gently,gland,gland-tipped,gray,herbaceous,inflated,infructescence,longer,lower,mature,multangulate,naked,narrow-deltate,nflorescence,older,one,open,orolla,oung,pair,per,perfec,pericarp,perpendicular,plurifoliat,porrect,portion,prickle,prickly,primary,recurved,reflexed,ruit,scar,secondary,sessile,spaced,spreading,stalk,stalked,straight,strongly,tamen,terete,tertiary,time,unarme,unarmed,unit,usually,variously,vary,vein,venation,visible,whitish,woody,yellow-green,ympodial	0.4-2.5,1-15-45,1-5.5,2-11,adhesion,arrangement,climate,colour,corolla,form,growth,height,history,inflorescence,life,na,number,ovary,perennial,plant,position,presence,present,pubescence,reproduction,seed,shape,size,staman,stigma,stipe,texture,unknown
762	wfo-0001031729	success	161	88	61	100	27	0.379	-2,-45,0.5-1,0.6-,1-1.5,1-2,1-2.5,1.5-2,11-30,2.5-5,3-4,4.1-16,5-6,5-7,anther,apiculate-deltate,base,calyx,cm,conical,corolla,dark,darker,deltate,diameter,elliptic,flattened,fruit,glabrous,globose,green,greenish,lobe,lobed,long,mm,mottling,nearly,obovate,occasionally,ovary,ovate-reniform,pale,pedicel,peduncle,petiole,pink,purplish,quadrate,reddish,shrub,smooth,somewhat,stem,stigma,stripe,surface,tan,tube,white,x	-0.5,..,0.5,0.5-4,1.0-1.3,1.5,10-20,12-13,2-2.5,2-3,2.5-,3-celled,3.5-4,5-,50,8-9,abruptly,acuminate,along,anthesi,apex,apicula,attenuate,beneath,branc,branch,branched,brittle,brow,c.,cell,cucullate,curve,dry,drying,eaf,edicel,eed,elongate,erec,filament,flattened-capitat,flower,fruiting,glandular,gradually,later,less,lower,markedly,membranous,middle,minute,minutely,narrowly,never,nflorescence,noddin,open,outer,outline,pair,papillae,papillate,papillose,per,pericarp,planar,plurifoliat,point,pointed,primary,regularly,ruit,scar,scattered,short,single,single-stemmed,sinuate,small,striate,testa,thin,thing,time,tip,toward,triangular,trichome,tuft,ud,unit,usually,vein,wall,wand-like,widening,ympodial,young	adhesion,arrangement,brown,colour,flattened-capitate,form,growth,height,history,inflorescence,leaf,length,life,na,perennial,plant,plurifoliate,position,pubescence,reproduction,rugulose,seed,shape,size,staman,style,texture
763	wfo-0001031738	success	231	124	92	139	32	0.398	-15,0.25-0.8,0.7-1.1,1-1.5,1-4,1.4-1.7,1.5-4,1/2-2/3,1/3,10-15,15-40,2.3-3,3.5-3.8,3.5-4.5,4-6,4-8,5-8,7-12.5,8-10,8-18,abaxially,acute,adaxially,andromonoecious,anther,apex,apically,auriculate,base,berry,blade,calyx,chartaceous,cm,connivent,cordate,densely,diameter,dull,equal,erect,evenly,flattened-reniform,fruit,glabrescent,green,lateral,leaf,length,lobe,lobed,long,lower,margin,maturity,midpoint,mm,narrow-deltate,orange,orange-brown,ovate,pale,pedicel,peduncle,petiole,plant,poricidal,ray,shrub,simple,small,smooth,sometimes,spherical,stellate,stellate-pubescent,stem,style,surface,tapering,terminal,tip,tree,truncate,tube,upper,way,weakly,white,wide,yellow,young	-5,-6,-merous,.5,0,0-2,0-3,0.1-0.25,0.2-0.3,0.3-1,0.7-1,0.9-2.1,1-1.8,1-3,1.5-,1/,1/3-2/3,1/4-1/3,1/6-1/4,2-,2-4,20-200,3-4,3-6,3-7,4,4-10,4-5,5,6-15,7-12,abaxial,acuminat,adaxial,almost,always,alyx,apar,apart,apparently,articulated,bark,branched,cell,curved,dark,deltate,discolorous,distal,distance,drying,eaf,eed,elongating,extending,filament,flattened,flower,free,frequently,fruiting,glabrous,gray,held,hermaphrodite,heterostylous,infructescence,inside,lobing,long-styled,longer,lowermost,mature,midvein,multangulate,nflorescence,oblong,obovate,often,older,one,open,orolla,oung,outline,pair,per,pericarp,pit,plurifoliat,poorly,porrect,portion,prickl,prickle,prickly,primary,prominent,pubescent,raised,reflexed,resin,rounded,ruit,scar,secondary,sessile,short-styled,shorter,side,spaced,sparsely,spreading,stalk,stalked,staminat,sticky,stout,straight,strongly,tamen,terete,tertiary,time,trichome,unarmed,unit,usually,variously,vary,vein,venation,visible,white-brow,woody,yellow-green,yellow-orange,yellowish,ympodial	1/4,acuminate,adhesion,arrangement,climate,colour,corolla,form,glandular,growth,hair,height,history,inflorescence,life,na,number,ovary,perennial,position,presence,present,pubescence,reproduction,rugulose,seed,shape,size,staman,stigma,stipe,texture
764	wfo-0001031752	success	172	135	110	62	25	0.64	-10,-47,-6,-pubescent,0.5-1,0.5-1.5,1,1-1.5,1-3,1-4,1.5-2,1.5-3,1.5-3.5,15-25,2-2.5,2-3,2-5,20-35,3-11.5,3-4,3-7,3.5-15,3.5-5,5-23,5-6,5-8,abaxially,acuminate,acute,adaxially,apart,apex,apiculate,articulated,basal,base,calyx,chartaceous,ciliate,cm,connivent,cuneate,darker,deltate,densely,diameter,ellipsoidal,elliptic,entire,flattened,fleshy,fruit,fusiform,glabrate,glabrescent,glabrous,gland,glandular-puberulent,green,immature,lanceolate,leaving,less,light,lobe,long,margin,membranaceous,mm,moderately,near,oblong,often,older,ovate,pedicel,pedicellar,peduncle,petiole,pink,puberulent,pubescent,purplish,remnant,ripe,rounded,rugose,shrub,simple,small,spaced,sparsely,stalked,stellate,stigma,stripe,style,subcordate,subcoriaceous,tip,tomentose,tree,truncate,tube,unbranched,white,wide,x,yellow,young	-100,-3,-44,1-,1-2,1.5-10.5,1.5-2.5,15-40,3-4-foliat,8-15,9-16,aggregate,ape,axe,beyond,blade,cell,ciliat,connective,cylindrical,directed,distally,eaf,eed,equal,exceeding,exserted,flower,glandular-puberulen,linear,lon,lower,narrowly,nearly,nflorescence,nther,obtuse,olde,orolla,ovoid,perfect,pore,presen,present,purpl,rachi,radiu,ruit,slightly,stamen,stone,swelling,tal,tem,thecae,time,triangular,truncat,ud,unit,vary,ympodial	abaxial,adaxial,anther,arrangement,colour,corolla,form,growth,height,history,inflorescence,leaf,length,life,na,ovary,plant,position,pubescence,reproduction,seed,shape,size,stem,texture
765	wfo-0001031756	success	186	85	68	118	17	0.366	.5,/2,0-2,0.4-1.6,0.5-1,0.5-1.3,0.6-1.2,0.7-1.7,0.8-1,1-4,1.5-2,1.5-3.5,1.8-2.5,4-5,anther,apex,base,berry,calyx,chartaceous,cm,color,connivent,densely,diameter,equal,erect,evenly,finely,flattened-reniform,fruit,glabrous,green,known,leaf,lobed,long,mature,mauve,mm,orange-brown,ovate,pale,pedicel,peduncle,petiole,pitted,poricidal,prickly,scandent,shoot,short,shrub,sparsely,spherical,stellate-pubescent,stem,style,surface,tapering,terminal,tip,tube,unarmed,way,white,wide,young	-1,-5,.1,.8,0,0-5,0.02-0.2,0.1,0.15-0.25,0.2,0.6-1.6,00,1-1.8,1-2,1-3,1/2,1/3,10,2-6,3-15,3-5,3-7,4.5,5-merous,6-9,7-10,9-14,abaxially,accrescent,acut,alyx,apar,apart,apically,apparently,articulated,bark,blade,branched,broad-deltate,concolorous,conical,cordate,curved,deltate,drying,eaf,eed,elongating,enclosing,entire,eye,filament,flower,free,fruiting,fully,glabrescent,glabrou,gray,herbaceous,inflated,infructescence,invested,lobe,longer,lower,margin,midpoint,moderately,naked,nflorescence,older,one,open,orolla,oung,pair,pendulous,per,perfec,pericarp,perpendicular,plurifoliat,porrect,portion,prickl,prickle,primary,ray,red-brown,rounded,ruit,scar,sessile,shorter,simple,slender,small,smooth,spaced,spreading,stalk,stalked,stellate,straight,tamen,terete,time,trichome,truncate,unit,variously,vary,vein,visible,yellow-green,ympodial	adhesion,colour,corolla,form,growth,height,inflorescence,length,ovary,plant,position,pubescence,seed,shape,size,staman,texture
766	wfo-0001031761	success	207	118	85	122	33	0.411	-6.5,0-12,0.2-0.4,0.3,0.3-2.8,0.5-0.7,0.7-1.3,0.75-1.7,0.9-2,1,1.5-4.2,1.5-6,1.8-2.3,1/2,1/2-2/3,1/3,2-3.5,2-8,2.5-3.1,2.5-5.5,3.2-3.5,7-9,abaxially,acute,anther,apex,base,berry,blade,calyx,cm,connivent,cordate,deltate,densely,diameter,dull,erect,flattened-reniform,fruit,glabrous,lateral,leaf,length,lobe,lobed,long,lower,margin,maturity,mauve,midpoint,mm,narrow-oblong,orange,orange-brown,ovate,pedicel,peduncle,petiole,poricidal,purple,ray,red,rounded,scandent,shrub,simple,smooth,sparsely,spherical,stellate,stellate-pubescent,stem,style,surface,tapering,thick-chartaceous,tip,tube,upper,way,weakly,wide,yellow	-12,-20,-3/,-7,.4,.5,0,0-0.4,0-10,0-15,0-25,0-4,0-5,0.3-0.4,0.5,0.5-1.5,0.6-1.2,0.7-1.6,1-3,1-4,1-8,1.5,1/3-2/3,1/4-1/3,2,2-4,3-15,3-5,4-6,4-7,5-merous,acicular,acut,alyx,ame,apar,apart,apically,apparently,articulated,bark,branched,brow,c.,cell,concolorous,curved,difoliate,discolorous,distance,drying,eaf,eed,elongating,equal,extending,faint,filament,flattened,flower,free,fruiting,fully,geminat,gray-green,infructescence,longer,mature,midvein,moderately,nflorescence,older,one,open,opening,orolla,oung,outline,pair,pale,per,perfec,pericarp,perpendicular,pit,porrect,portion,prickle,prickly,primary,raised,recurved,red-green,scar,sessile,shallow,side,slender,small,sometimes,spaced,spreading,stalk,stalked,straight,tamen,terete,tertiary,time,trichome,uit,unarme,unarmed,unit,variously,vary,vein,venation,visible,woody,yellow-green,ympodial	-3/4,adhesion,arrangement,climate,colour,corolla,form,glandular,growth,hair,height,history,inflorescence,life,na,number,ovary,perennial,plant,position,presence,pubescence,reproduction,rugulose,seed,shape,size,staman,stigma,stipe,texture,unknown,ye
767	wfo-0001031786	success	209	120	88	121	32	0.421	/3,0.2-2.5,0.25-0.5,0.5-1.5,0.7-1.6,0.8-1.2,1-3,1-6,1.2-1.6,1.5-2.5,2-3,2.5-3.5,3-4,4-5,6-8,abaxially,acute,anther,apex,apically,base,becoming,berry,blade,calyx,chartaceous,cm,connivent,cuneate,deep,deltate,densely,diameter,elliptic,evenly,flattened-reniform,fruit,glabrescent,glabrous,gray,green,herb,lateral,leaf,length,lobe,lobed,long,margin,maturity,mauve,membranous,midpoint,minute,mm,orange,orange-brown,ovate,pale,pedicel,peduncle,petiole,poricidal,ray,red,shrub,simple,smooth,sparsely,spherical,spreading,stellate,stellate-pubescent,stem,stigma,style,surface,tapering,tip,trichome,truncate,tube,way,weakly,white,wide,yellow-orange,young	-5,.4,.5,/2,0,0-2,0-20,0-3,0-5,0.1,0.1-0.4,0.2-0.3,0.7-1,0.7-4,0.8,1,1-2,1-4,1.5-1.9,1/3-1/2,2-13,2-7,2-8,3-5.5,5-7,5-merous,8-12,acut,almost,alyx,ame,apar,apart,apparently,articulated,bark,branched,c.,cell,clavat,concolorous,curved,dark,distance,drying,eaf,eed,elongating,equal,erect,extending,eye,filament,filiform,flattened,flower,free,fruiting,gray-brow,herbaceous,inconspicuous,infructescence,lon,longer,lower,mature,midvein,naked,nflorescence,obtuse,older,one,open,orolla,oung,outline,pair,pendulous,per,perfec,pericarp,pit,plurifoliat,porrect,portion,prickl,prickle,prickly,primary,raised,red-brown,reflexed,rounded,ruit,scandent,scar,sessile,shiny,shorter,side,slightly,small,sometimes,spaced,stalk,stalked,straight,tamen,terete,tertiary,thick,time,unarmed,unit,variously,vary,vein,venation,visible,woody,ympodial	4,adhesion,arrangement,clavate,climate,colour,corolla,form,glandular,growth,hair,height,history,inflorescence,life,na,number,ovary,perennial,plant,position,presence,present,pubescence,reproduction,rugulose,seed,shape,size,staman,stipe,texture
768	wfo-0001031791	success	288	123	78	210	45	0.271	.3,.5,.9,3,acute,adnate,anther,apex,apiculate,attenuate,base,blade,calyx,chartaceous,cm,cordate,corolla,densely,developed,diameter,dry,entire,erect,extra-axillary,flattened-reniform,flattened-suborbicular,fruit,glabrous,glandular,globose,green,hair,inflorescence,interpetalar,lanceolate,lateral,lavender,leaf,length,lobe,margin,maturing,midpoint,mm,nearly,orange-red,oval,pedicel,peduncle,petiole,poorly,pubescent,ray,rounded,shiny,shrub,simple,slender,small,somewhat,stellate,stem,stigma,stipe,style,subcoriaceous,surface,tip,tissue,tree,truncate,tube,wavy,white,yellow,yellow-brown,yellow-tan,×	.08,.2,.4,0.04,0.2,0.3–0.5,0.3–0.6,0.3–0.7,0.4–0.6,0.5,0.5–0.6,0.5–1.0,0.7,0.7–0.8,0.7–1.0,1.1–1.4,1.3–1.8,1.5,1.5–1.9,1.5–2.3,1.5–3.0,1.6,1.6–2.2,1.7–2.3,1.8,1.9–2.2,1/3,11–14,11–15,13.0–30.0,15.0,2.0–11.0,2.0–2.5,2.6–3.4,2.8–3.3,2/3,3.0,3.0–3.5,33–54,4.6–5.4,4.9,4.9–7.4,5-merou,6.0,6.0–14.0,6.2–8.5,7.0–9.0,7–10,7–8,8.0–11.0,8–12,9.0–16.0,abaxially,across,adaxiall,adaxially,alveolate,alyx,anthesi,apical,apparently,appearing,appressed,area,around,articulated,attachment,axe,ba,backward,berry,branch,broad,broad-based,brochidodromous,bud,capitat,central,channeled,congested,connivent,curved,dehiscence,dentate,development,difoliate,distally,distinct,dorsally,drying,eaf,eed,either,emerging,endocarp,entir,especially,fertile,filament,filiform,first,flexed,flower,fork,free,frui,geminat,glabrescent,gradually,homostylous,immature,inclined,increasing,internode,intersepalar,juic,juvenile,lamina,large,largest,light,like,line,lon,long,longer,lower,m.,major,material,mature,membranaceous,middle,midrib,midvein,minor,minute,moderately,multangulate,nflorescence,notched,numerous,oblique,obscured,often,one,orolla,oung,ovoid,particularly,persisting,point,pore,porrect,porrect-stellate,portion,potentially,preserved,prickle,project,raised,rigid,ripe,row,rugose,ruit,scarcely,scattered,sessile,short,shorter,side,single,sinus,slightly,smaller,smooth,sometimes,sparsely,splitting,stamen,stellae,stellate-pubescen,stipitate,straight,suture,tamen,tardily,thrice-branched,time,totally,translucent,triangular,twice,two,ud,unarmed,undulate,various,vary,vein,weakly,well,wide,ympodia,young,±90°at,±equal,±glabrous,±laterally	0.08,0.3-0.5,0.3-0.6,0.3-0.7,0.4-0.6,1.5-1.9,1.5-3.0,1.9-2.2,13.0-30.0,2.0-11.0,2.8-3.3,6.0-14.0,6.2-8.5,7-8,7.0-9.0,8-12,8.0-11.0,adhesion,arrangement,capitate,climate,colour,dense,form,growth,height,history,life,moderate,na,number,ovary,perennial,plant,position,presence,present,pubescence,reproduction,rugulose,seed,shape,size,staman,texture
769	wfo-0001031793	success	188	107	78	110	29	0.415	-4,1-1.5,1-2,1-8,1.5-4,10-15,13-20,15-20,2-3,2-5,8-11,acumen,acuminate,aging,almost,anther,apex,base,black,blade,broadly,brown,brownish,calyx,capitate,chartaceous,cm,cuneate,densely,diameter,elliptic,extra-axillary,flattened,flower,fruit,glandular,globose,hair,inflorescence,leaf,linear,lobe,long,margin,midpoint,minutely,mm,mucilaginous,oblong-lanceolate,orange-yellow,orbicular-ovate,pedicel,peduncle,petiole,pubescent,reddish,rounded,rusty,shallow,shrub,simple,size,small,stellate,stellate-pubescent,stem,stigma,style,surface,tree,triangular,trichome,tube,well-developed,white,x,yellow,yellow-brown	.5,0,1,1-3,1.5-2,1/3,1/4,1/5,20,26,3-4,3-8,3/4,4,40,5-merous,7,absent,abundant,accrescent,acute,adult,alyx,apparently,armed,articulated,aspect,axe,ba,berry,bilobe,branche,branched,broad,central,cut,difoliate,distal,eaf,eed,elongatin,erec,erect,evident,extreme,ferrugineous,filament,forked,fruiting,geminat,general,homostylou,interpetalar,larger,lobing,lon,lower,main,many,maturing,midrib,mostly,nflorescence,oblique,obtuse,often,older,orolla,ovate,per,perfect,pore,porocidal,porrect,prickle,principal,rachi,reduced,reticulation,ruit,scarcely,scattered,sessile,side,similar,single,sinus,smaller,sparsely,stellate-pubescen,stipitate,stout,tall,tamen,tem,testa,thickened,tip,tissue,triangular-acuminat,unarmed,unbranched,unit,upward,usually,uvenile,vary,way,woody,ympodial	adhesion,arrangement,bilobed,climate,colour,corolla,form,growth,height,history,length,life,na,number,ovary,perennial,plant,position,presence,present,pubescence,ray,reproduction,rugulose,seed,shape,staman,stipe,texture
770	wfo-0001031795	success	234	150	118	116	32	0.504	.2,0.5,0.5-2,1-1.2,1-1.3,1.5-2,1.5-4,10-12,2-2.5,2-6,2.5-3,2/3,3,3-4,4-6,6-8,9-17,abaxially,acuminate,acute,adaxial,along,anther,apex,around,base,berry,blade,brownish,calyx,capitate,cell,cm,conical,connivent,dark,deeply,densely,diameter,elliptic,entire,evenly,flattened,glabrous,gland-tipped,glandular,globose,grayish,green,growth,lateral,leaf,leaf-opposed,like,live,lobe,lobed,long,long-stalked,margin,matte,membranous,midpoint,midvein,minutely,mixture,mm,oblique,occasionally,outline,ovate,pale,pedicel,peduncle,petiole,pitted,plant,poricidal,porrect,prickle,pubescent,ray,reniform,ripe,sessile,shallowly,shape,shiny,short,short-,shrub,simple,sinuate,size,slightly,smooth,sparsely,stellate,stellate-pubescent,stem,stigma,style,surface,tan,tapering,testal,thin,tip,trichome,truncate,tube,unarmed,unicellular,way,white,wide,yellowish,½	..,.5,0.5-1,1,1-3,1-4,1/3,10,100,4-,4-5,5,5-12,5-40+,5-merous,5.5-,50,7-9,<,>,abaxial,absent,adaxiall,alf,almost,always,alyx,anthesi,apar,armed,articulated,bark,branched,broad-based,broadly,c.,caudate,clearly,curved,denser,differing,difoliate,directed,discolorous,distally,dry,eaf,eed,equal,filament,flower,free,fruiting,geminat,geminate,glabrescent,gra,infructescence,irregularly,lamina,lon,longer,lower,major,many-branched,midrib,minor,much,multangulate,multiseriate,never,new,nflorescence,often,older,orolla,oung,pair,papillat,pendant,per,perfec,pericarp,persistent,pore,portion,prickly,primary,reduced,reflexed,ruit,scar,scattered,short-stalked,slender,somewhat,spaced,spreading,stalk,straigh,tamen,terete,thicker,time,toward,triangular,unarme,unit,upward,usually,vary,vein,visible,woody,ympodial,young	4-12,adaxially,adhesion,arrangement,climate,colour,corolla,form,fruit,gray,hair,height,hermaphroditic,history,inflorescence,length,life,na,number,ovary,papillate,perennial,position,presence,present,pubescence,reproduction,rugulose,seed,staman,stipe,texture
771	wfo-0001031829	success	138	92	59	79	33	0.428	.5,0.7-1,1-2,1.3-1.5,1.5-2,1.5-2.5,1.5-3.5,2-4,3/4,4-4.5,4-8.5,acute,anther,apex,apiculae,base,broadly,calyx,capitate,cm,conical,corolla,densely,elliptic,globose,green,greenish-brown,growth,inflorescence,leaf,leathery,lobe,lobed,long,margin,minute,mm,opposite,ovary,pedicel,petiole,poricidal,pubescent,quadrate,revolute,shrub,size,somewhat,sparsely,stem,stigma,style,surface,thick,tip,tube,way,white,x	.25,0.5-2.1,1,1.5-4.5,3-5-flowered,7-10,abaxially,absent,adaxial,adaxially,along,anthesi,ape,bae,bark,berry,branched,crystalline,deflexed,denser,dia,differing,difoliate,drying,eaf,edicel,eed,epidermi,erect,exserted,filament,free,fruiting,geminat,glabrat,glabrous,immature,known,large-celled,lateral,like,lon,lower,main,major,minor,minutely,nflorescence,occasionally,often,older,overlappin,packed,pair,papillo,papillose,planar,pore,portion,ruit,scar,shaped,simple,soft,tall,tapering,tear-drop,trichome,tub,tuft,ud,uniseriate,unit,vein,waxy,woody,yellowish,ympodial,young	0.5-1,adhesion,arrangement,blade,climate,colour,diameter,form,fruit,glandular,hair,height,history,length,life,midpoint,na,number,peduncle,perennial,plant,position,presence,pubescence,ray,reproduction,rugulose,seed,shape,staman,stellate,stipe,texture
772	wfo-0001031832	success	232	131	109	123	22	0.47	.5-1,0.1-0.3,0.2-1.5,0.3-3,0.7-1.5,0.7-1.6,0.8-1.2,1-12,1.1-2.4,1.2-1.6,1.2-2,1.2-2.5,1.3-4.2,14,2-3.6,2-4,2-6,3-6.5,4-20,5-21,8-25,9,abaxially,acute,adaxially,anther,apart,articulated,basal,base,becoming,blunt-tipped,brown,brownish,bullate,calyx,closely,cm,conical,continued,corolla,dark,deltoid,diameter,due,ferrugineous,few-rayed,fleshy,flower,fruit,glabrescent,globose,granular-tomentose,green,greenish,growth,hair,half,honeycombed,inserted,lanceolate,lateral,leaf,length,lobe,mixed,mm,mostly,multangulate,oblanceolate,oblong,pale,pedicel,peduncle,persistent,petiole,porrect-stellate,probably,pubescence,reniform,reticulate-punctate,ripe,rotate-stellate,rough,scabrous,sessile,short-,short-stalked,shrub,simple,somewhat,spaced,sparse,stem,stigma,style,subcampanulate,suborbicular,surface,terminal,testa,thick-stalked,tree,tube,violet,white,x,yellow,yellowish	-8,/50-1/10,0-150,0.2-0.6,0.3-0.8,0.7-2,1.5-4,1.7-4,1.8-4,1/2-3/4,2.5-6.5,2.8-4.8,3-7,3.5-7,4-7,5.5-10,7-10,accrescent,acuminate,ag,anthesi,apex,apical-lateral,apice,apparently,attenuate,axe,axillary,ba,bark,berry,blade,blister,branch,branched,bud,capitat,chartaceous,connate,decurrent,dehiscing,directed,eaf,eed,entire,evident,exserted,extend,filament,forming,free,fruiting,glabrescen,glabrous,high,indument,introrse,lackin,large,line,lobed,long,long-,longer,longitudinal,lower,m.,main,margin,midvein,minute,nearly,nflorescence,obovoid,obtuse,occasionally,older,orbicular,orolla,ovate,partly,perfect,pitted,plurifoliate,pore,porrect-stellat,pubescent,rachi,rather,ray,relatively,ruit,runk,side,slit,smooth,sometimes,soon,sparingly,splitting,stamen,stellate-pubescent,stipitate-glandular,suture,swelling,tamen,terete,thick,time,toward,translucent,unarme,unarmed,unit,usually,vary,vein,way,weakly,whitish,wide,ympodial,young	adhesion,arrangement,capitate,colour,form,height,history,inflorescence,life,na,ovary,perennial,plant,position,reproduction,rugulose,seed,shape,size,sparing,staman,texture
773	wfo-0001031834	success	150	104	70	80	34	0.467	.5,0.5,0.5-1,0.5-3,0.5-3.5,0.6-1.4,0.8-1,0.8-1.3,1,1.5,1.6-2,1.9-6.5,2/3,6-7,6.5-14,acuminate,acute,anther,apex,base,calyx,cm,corolla,decurrent,deltoid,dia,flattened-reniform,fruit,glabrous,globose,green,greenish-yellow,hooked,leaf,less,lobe,lobed,long,margin,minute,minutely,mm,opposite,ovary,ovate,pale,papillose,pedicel,petiole,pitted,poricidal,pubescent,scabrous,short,shrub,sparsely,stem,stigma,style,surface,tan,tip,trichome,tube,uniseriate,upper,way,white,x,yellow	0.9-1.4,1.5-4,2.9-7,accrescent,across,anthesi,apar,apically,apiculate,appear,attenuate,berry,bi-cellular,borne,campanulate,covered,deciduou,deciduous,deflexed,depression,difoliate,eaf,edicel,eed,expanded,eye,few-flowered,filament,free,fruiting,geminat,glabrou,hook,incrassate,lamina,larger,leaving,like,lon,lower,major,markedly,middle,minor,mound-like,multicellular,naked,nflorescence,often,papillo,persistent,planar,pore,portion,proximal,ruit,scar,shaped,simple,slender,slightly,small,soon,spaced,speck,straight,tall,tapering,tear-drop,tufted,ud,unevenly,uni-,unit,usually,vein,widest,woody,ympodial,young	adhesion,arrangement,blade,climate,colour,diameter,form,glandular,growth,hair,height,history,inflorescence,length,life,midpoint,na,number,peduncle,perennial,plant,position,presence,pubescence,ray,reproduction,rugulose,seed,shape,size,staman,stellate,stipe,texture
774	wfo-0001031839	success	138	117	70	68	47	0.507	1-1.4,1.2-1.5,1/3-2/3,2.5-3.5,3-7,6-15,8-15,9-12,along,anther,apically,arcuate,armed,base,beneath,blade,blue,blue-tinged,broad,broadly,brown,calyx,campanulate,cm,dark,developing,dry,foveolate,glabrous,green,herb,internodal,invested,lenticular,linear-lanceolate,lobe,long,main,maturity,minutely,mm,olivaceous,otherwise,ovary,ovate,pale,perennial,petiole,pinnatifid,prickly,pubescent,purple,rounded,smooth,spherical,splitting,stellate-pentagonal,stellate-pubescent,stellate-tomentose,stem,tawny,tightly,tube,twice,vein,velvety-tomentose,weakly,white,whitish,yellow	.5,1,2/3,4-8,7-10,8-14-rayed,9-13-flowere,accrescent,across,alyx,annually,anthesi,becoming,berry,bristly,cauline,confluent,da,dark-based,deltoid,densely,density,dia,difoliate,divided,eaf,eed,emerging,erect,extended,externall,fully,geminat,ligneous,lon,long-stalked,long-stipitate,nearly,nflorescence,often,orolla,persisting,prickle,root,ruit,several,short,slende,somewhat,spreading,stella,stellae,stellate-tomento,stipitate,subulate,tamen,throughout,tigma,tub,tyle,ultimate,unexpande,unit,usually,varying,year,ympodial,zygomorphic	0.5,8-14,adhesion,apex,arrangement,climate,colour,corolla,diameter,externally,form,fruit,glandular,growth,hair,height,history,inflorescence,leaf,length,life,margin,midpoint,na,number,pedicel,peduncle,plant,position,presence,pubescence,ray,reproduction,rugulose,seed,shape,size,slender,staman,stellate,stigma,stipe,style,surface,texture,unexpanded,ye
775	wfo-0001031842	success	161	113	78	83	35	0.484	.5,0.6-1,0.7-1,1,1-1.5,1-1.8,10-20,2-10,2-3,2.5-3,2.5-6,3-8,3/4,4.5-6,7-9,9-15,acute,anther,apex,attenuate,base,beneath,bi-lobed,brown,calyx,capitate,cm,corolla,cup-shaped,cusp,dark,deeply,dia,dry,elliptic,flattened-reniform,glabrous,globose,green,leaf,lobe,lobed,long,margin,mm,near,new,often,opposite,ovary,overtopping,pale,pedicel,petiole,pitted,poricidal,quadrate,shiny,shoot,shrub,size,specimen,stem,stigma,strongly,style,surface,terminal,tip,tree,trichome,tube,tuft,uniseriate,way,white,woody,x	.1,.4,.75,0.1-0.5,0.5-1,0.5-2,1-3.5,1.5-2,10-12,10-30-flowered,anthesi,apart,axil,ba,bark,bearing,beginning,berry,decurrent,deflexed,densely,differing,difoliate,eaf,edicel,eed,ellipsoid,exserte,exsertion,filament,free,fruiting,geminat,incrassate,inflorescenc,irregularly,later,lateral,leaf-opposed,lon,lower,main,major,middle,minor,minutely,nflorescence,older,one,onto,pair,paler,papillo,papillose,pore,portion,prominent,pubescent,reddish,reddish-resinous,reflexed,ruit,scar,shaped,simple,slender,somewhat,soon,spaced,sparsely,straight,tall,tapering,tear-drop,time,ud,unit,vein,widest,yellowish,yellowish-whit,ympodial,young	0.4,adhesion,arrangement,blade,climate,colour,diameter,form,fruit,glandular,growth,hair,height,history,inflorescence,length,life,midpoint,na,number,peduncle,plant,position,presence,pubescence,ray,reproduction,rugulose,seed,shape,staman,stellate,stipe,texture,yellowish-white
776	wfo-0001031843	success	245	123	92	153	31	0.376	.5,0.6-1.2,0.7-2,1-7,1.2-2,1.2-2.2,1.5,1.8-2.5,1/6-1/4,1mm,2-3,2.5,3-4,5-10,5-12,6-9,acuminate,almost,along,anther,anthesi,apex,apically,apparently,base,berry,black,branch,broadly,brown,calyx,capitate,caudate,cm,completely,conical,corolla,cupular,curved,cuspidate,dark,deltoid,diameter,discoid,distributed,drying,dull,equal,erect,evenly,finely,free,glabrous,largely,leaf,length,liana,lobe,lobed,long,margin,mm,oblique,oblong,obovate,orange,orange-brown,orange-yellow,partly,pedicel,peduncle,petiole,present,pubescent,red,rounded,seed,shrub,side,slender,slightly,spheroidal,stem,stigma,style,surface,terminal,thick-chartaceous,tube,violet,x,young	.2,.3,.6,0-4,0.2-2,0.4-0.5,0.5-1,0.5-1.5,0.7-1.2,0.8-2,1-2,1.5-2,2-4,3-7,4-12,45-60°,abaxially,accrescent,adaxially,age,always,alyx,apar,apice,appressed,around,articulated,attenuate,bark,basal,becoming,branched,branching,canaliculate,clearly,collapsing,deeply,delineated,dendritic,density,detaching,dilated,discolorous,domatia,eaf,eed,ellipsoi,entire,even,eye,fertilisation,filament,fine,flat,flexuous,flower,forming,fruiting,green,hand,honeycomb,inner,leave,len,lengthening,lignified,like,longitudinally,loop,looping,lower,m.,main,midvein,much,multiseriate,naked,network,never,nflorescence,nther,obscure,older,opening,orolla,outline,ovate,pair,papillo,part,pattern,pendulous,perfec,pericarp,pit,pitted,plurifoliat,pore,poricidal,portion,primary,prominent,pronounced,protruding,rachi,raised,rarely,recurve,reddish,reveal,ribbed,ridged,ruit,scar,see,shallowly,shiny,shortly,simple,sinus,small,smaller,smooth,sometimes,soon,sparsely,spreading,straight,strongly,stump,surfac,tearing,tertiary,thickened,thin,tip,trichome,tuft,twice,ud,unarmed,unit,variable,vary,vein,venation,visible,weakly,white,wide,wider,without,ympodial	adhesion,arrangement,blade,climate,colour,form,fruit,glandular,growth,hair,height,inflorescence,midpoint,na,number,ovary,papillose,perfect,plant,position,presence,pubescence,ray,reproduction,rugulose,shape,size,staman,stellate,stipe,texture
777	wfo-0001031852	success	155	74	50	105	24	0.323	-8,0.1-1,1-4,1-4.2,1-9,1.3-2.5,1.4-3,12-35,2.6-9.5,4-5,4-6,5-15,7-,9-11,abaxially,adaxially,calyx,cm,conical,connate,corolla,diameter,distal,elliptic-lanceolate,green,green-white,half,herbaceous,lanceolate,leaf,light,long,mm,odd-pinnate,ovoid,pedicel,peduncle,perennial,petiole,plant,pubescent,seed,size,stellate,stigma,style,throughout,white,wide,yellow	0.5-1.3,0.5-3,1-,1.5-3,2-3,2-5.5,3-4,3-6-foliat,3-9,3.5-10,4-,4-10,abruptly,absen,acumen,acuminate,acute,apex,apical,apically,apiculate,articulate,attenuate,base,branched,cell,covering,cyme,decurrent,dehiscent,dichasial,dichasially,digestion,diminishing,dorsally,eaf,ebracteate,edge,eed,elliptic,emoval,enzyme,exceeding,filament,flat,flower,folded,forked,generally,globo,hair-like,honeycomb,interjected,introrse,lateral,leaflet,living,lobe,lon,lower,lunat,make,maturing,monochasial,mucilaginous,nflorescence,nther,oblique,oblong,often,orolla,ovate-elliptic,pair,pattern,perfect,plan,poricidally,proximal,rachi,reveal,ruit,sessile,seudostipule,short,shortly,slit,specimen,stamen,straight,tal,tem,terminal,testal,thick,throughou,toward,tuber-bearing,typically,unit,vary,wall,white-crea,without,ympodial,¼	anther,arrangement,colour,form,fruit,globose,growth,height,history,inflorescence,length,life,na,ovary,position,pubescence,reproduction,rugulose,shape,stem,surface,texture,tube,white-cream
778	wfo-0001031864	success	140	113	79	61	34	0.564	.25,.5,0.2-0.5,0.5-13.5,0.7-0.8,0.8-1,1-1.8,1-2,1-5,1-6.5,1.2-1.5,15-60,2.5-6,3-3.5,3-pinnate,abaxially,acute,adaxially,anther,apex,apiculate,base,blade,calyx,chartaceous,ciliate,cm,cuneate,deltoid,dense,diameter,emarginate,entire,extra-axillary,fine,flattened,fleshy,fruit,glabrous,hair,herbaceous,lenticular,lobe,long,margin,middle,minutely,mm,near,oblique,ovoid-deltoid,papillose,pedicel,peduncle,petiole,pointed,pubescence,pubescent,rotate,rounded,scattered,short,slender,slightly,sparsely,stem,stigma,style,surface,tip,trichome,truncate,tube,unknown,vine,violet,wide-diameter,widely,x	.2,0.4-3,0.5-4,0.6-3.5,0.6-4,1-1.2,1-3,1.5,1.5-10,1.5-2.5,2,2-3,5-15,5-9,5-merous,7.5-8,accrescent,acuminate,alyx,apar,apical,axe,berry,c.,capitat,clavate,color,densely,eaf,eed,filament,flower,fruiting,glabrou,lateral,leaflet,like,lon,lower,m.,moderately,nflorescence,nternode,orolla,perfec,petiolule,plurifoliat,pubescenc,rachi,ruit,sand-punctate,spaced,tamen,tem,terrestria,typical,unbranched,unit,vary,vein,ympodial	adhesion,arrangement,capitate,climate,colour,corolla,form,glandular,growth,height,history,inflorescence,leaf,length,life,midpoint,na,number,ovary,perfect,plant,position,presence,ray,reproduction,rugulose,seed,shape,size,staman,stellate,stipe,terrestrial,texture
779	wfo-0001031864	success	148	126	91	57	35	0.615	.2,.25,.5,0.5-13.5,1-1.2,1-1.8,1-2,1-3,1-5,1-6.5,1.2-1.5,15-60,2.5-6,3-3.5,3-5-celled,3-pinnate,5-15,abaxially,acute,adaxially,anther,apart,apex,apiculate,articulated,basally,base,blade,blue-purple,calyx,center,ciliate,cm,color,connivent,cordate,cuneate,deltoid,dense,diameter,emarginate,entire,equal,extra-axillary,filament,fine,fleshy,flower,fruit,glabrous,hair,herb,lenticular,lobe,long,margin,minutely,mm,near,oblique,oblong,papillose,pedicel,peduncle,pubescence,pubescent,rotate,rounded,scattered,short,simple,slender,somewhat,spaced,sparsely,stigma,style,surface,terrestrial,thick,tip,trailing,truncate,tube,unbranched,uniseriate,unknown,weakly,widely,x,yellow	0.4-3,0.5-4,0.6-3.5,0.6-4,1.5,1.5-2.5,2,2-3,5-9,5-merou,7.5-8,absent,accrescent,acuminate,ag,alyx,apical,apparently,axe,ba,capitat,clavate,densely,directed,distally,eaf,eed,etiole,fruiting,geminat,interjected,large,lateral,leaflet,longitudinal,lower,m.,nflorescence,node,opening,orolla,perfect,petiolule,plurifoliate,pore,pubescenc,rachi,rooting,slightly,slit,tamen,tem,unit,vary,wiry,woody,ympodial	adhesion,arrangement,capitate,climate,colour,corolla,form,glandular,growth,height,history,inflorescence,leaf,length,life,midpoint,na,number,ovary,perennial,petiole,plant,position,presence,ray,reproduction,rugulose,seed,shape,size,staman,stellate,stem,stipe,texture
780	wfo-0001031871	success	185	116	91	94	25	0.492	0.4-2,0.6-1.2,1.5-11,1.5-2,1.5-2.1,1.6-2.7,2-4,3-10,3.5-4,33-40,36-44,4-7,5.4-12.3,6-12,6-7,6.5-20.5,7.5-23,abaxially,adaxially,anther,axillary,brownish,bud,cell,chartaceous,clavate,cm,condition,connivent,corolla,covering,deep,diameter,dot,drying,elliptic,fresh,fruit,glabrous,globose,green,green-white,greenish,hair,hair-like,herb,interjected,lanceolate,lateral,leaflet,lobe,long,make,medium,mm,mottled,mucilaginous,narrowly,odd-pinnate,orbicular,ovate,ovoid,pedicel,peduncle,petiole,plant,pubescent,purple,ripe,rotate,seed,short,size,stigma,style,subglabrous,subtending,terminal,testal,thick,throughout,tiny,tube,wall,wet,white,whitish,wide,winged,x,yellow	1-2,1.4-2.1,14-22,2-3,2.9-6,3-4,3-5,4-6,5-merou,7-9,acumen,acute,adaxiall,ag,alyx,apart,apex,apparently,articulated,asymmetric,attenuate,axe,base,basiscopic,berry,blade,capitat,dark,digestion,distal,dorsally,eaf,edge,eed,end,enzyme,erec,exceeding,filament,flat,flower,folded,forked,geminat,generally,glabrou,hal,half,high,homostylous,honeycomb-shaped,lengthening,linear,living,lower,nflorescence,one,orolla,pair,perfect,petiolulate,placed,plurifoliate,pore,poricidal,removed,round,rounded,ruit,sessile,seudostipule,side,slit,sometimes,spaced,specimen,stamen,stolo,straight,subequal,subglabrou,symmetric,tall,tamen,tem,tip,tissue,tri-,tuber,typically,unit,usually,vary,ympodial	adhesion,arrangement,calyx,capitate,colour,form,growth,height,history,inflorescence,leaf,length,life,na,ovary,perennial,position,pubescence,reproduction,rugulose,shape,staman,stem,surface,texture
781	wfo-0001031874	success	197	117	88	109	29	0.447	-1.2,0.2,0.5-1,0.5-1.5,0.5–0.9,0.6-1,1.2,1.2-1.8,1.3–1.4,1.4–1.5,1.8–2.3,1/10,1/5,2-5,3-8,3-lobed,3–5,6–7,7–8,9–11,abaxially,acute,anther,apex,base,bilobed,blade,blue,broadly,calyx,chartaceous,ciliate,cm,completely,connivent,diameter,elliptic,especially,extra-axillary,flattened-reniform,flower,fruit,fully,glabrous,globose,green,herb,hermaphroditic,least,length,light,lobe,margin,midrib,minutely,mm,near,nearly,oblong,obtuse,orange,ovate,pedicel,peduncle,petiole,pitted,puberulent,pubescent,red,ripe,rotate-stellate,slightly,sometimes,somewhat,sparsely,stem,stigma,style,surface,tip,triangular,tube,violet,white,white-puberulent,x,yellow,young	-1.5,-3.5,-4,-7,.5-1.2,0.2–0.8,0.4,1-4,1.5-,1.8,1/3,2,2-3,2-3.5,2-4,2-foliate,2–2.5,2–9-branched,3.5–11,4.5-6,5,5-merou,accrescent,adaxiall,adaxially,always,alyx,angulate,apart,articulated,asymmetrically,axe,ba,barely,berr,bi-lobed,bifurcation,branch,broad,capitat,contact,covering,cylindrical,decumbent,dehiscent,downward,eaf,eed,erect,even,filament,fruiting,geminat,generally,hair,hold,juic,lanceolate,lateral,level,line,lobed,long,long-attenuate,longitudinall,lower,lowermost,main,mesocarp,nflorescence,node,numerous,often,one,orolla,ovate-triangular,partially,passing,petiol,pore,prostrate,rachi,rarely,recurved,rooting,ruit,several,short,side,simple,soil,spaced,spreading,swollen,tall,tamen,tem,terete,terminal,time,unit,usually,vary,vein,way,well,wide,winged,ympodial	0.5-1.2,1.5-4,3.5-11,abaxial,adaxial,adhesion,capitate,colour,corolla,form,growth,height,history,inflorescence,leaf,life,na,ovary,perennial,plant,position,pubescence,reproduction,rugulose,seed,shape,size,staman,texture
782	wfo-0001031876	success	140	90	53	87	37	0.379	.1,.5,0.8-1,1-1.5,1-1.6,1.5-2.2,27-35,9-15,acute,anther,apex,base,calyx,cm,corolla,cup-like,decurrent,dia,elliptic,glabrous,globose,granular,green,greenish-yellow,irregularity,leaf,lightly,lobe,lobed,long-acuminate,margin,minute,minutely,mm,nearly,oblanceolate,oblique,often,opposite,ovary,papillose,pedicel,petiole,present,shrub,slightly,stem,stigma,style,tube,white,winged,x	0-flowered,0.5,1,1-4,3,5,?,across,anthesi,apiculate,arc,arising,ba,bark,bearing,beneath,berry,bright,closely,convergence,corky,differing,eaf,edicel,eed,erect,family,filament,flower,free,fruiting,glabrou,immature,known,lateral,lenticellat,less,long,lower,main,major,melastomataceae,member,middle,nflorescence,otherwise,overlappin,pair,parallel,perpendicular,persistent,point,pore,poricidal,portion,primary,prominent,raised,recurved,reflexed,resemble,ruit,running,scar,secondary,shaped,simple,slender,spaced,straight,styl,tall,tapering,tear-drop,time,tip,ud,unifoliat,unit,vein,venation,wide,widest,woody,yellow,ympodial,young	adhesion,arrangement,blade,climate,colour,diameter,form,fruit,glandular,growth,hair,height,history,inflorescence,length,life,midpoint,na,number,peduncle,perennial,plant,position,presence,pubescence,ray,reproduction,rugulose,seed,shape,size,staman,stellate,stipe,surface,texture,unifoliate
783	wfo-0001031877	success	216	134	105	111	29	0.486	+,.5,0.3-,0.3-1,0.3-1.2,0.6-1.2,1-1.5,1-3,1-3.5,1.1-,1.5,1.5-1.9,1.5-2,1.8-5,2,2.5,3.5-4,6-8,abaxially,abruptly,acuminate,acute,adaxially,along,anther,apex,basally,base,bright,brown,calyx,capitate,clavate,cm,conical,connivent,corolla,deltate,diameter,distal,ellipsoid,ellipsoidal,entire,especially,flattened,fruit,glabrous,globose,greenish,growth,hastate,lateral,line,lobe,lobed,long,long-acuminate,loosely,margin,minutely,mm,nearly,often,outline,pale,pedicel,peduncle,perfect,petiole,pitted,plant,plump,pubescence,pubescent,purple,red,reddish,reniform,ripe,scrambler,seed,semi-woody,shiny,simple,slightly,somewhat,sparsely,stellate,stem,stigma,style,surface,terminal,thin,tinged,tip,triangular,trichome,truncate,tube,uniseriate,vein,vine,white,x	.3,0.2,0.5,0.5-1,0.8-0.9,1,1-4,2-,3-5,3-6,5-merou,6-10,adaxiall,ag,alyx,angled,anthesi,apar,apparently,ark,articulated,ascending,basal,berry,cell,deep,deflexed,densely,dried,eaf,eed,enlarged,erect,exposed,exserted,eye,filament,fleshy,flower,free,fruiting,furcate,green,ilament,impressed,internal,irregularly,lamina,later,lengthening,like,linear,lower,material,mature,midvein,minute,new,nflorescence,occasionally,older,orolla,pair,papillate,papillo,parallel,part,per,pericarp,plurifoliat,pointing,pore,poricidal,portion,primary,prominently,purplish,rectangular,reflexed,rest,rounded,ruit,scar,short,shorte,silky,sinuate,sleeve,slender,slit,sometimes,spaced,spreadin,strongly,subshru,tem,testal,twinin,ud,uniformly,unit,upper,usually,vary,visible,wall,weak,woody,yello,ympodial,young	adhesion,arrangement,blade,climate,colour,form,glandular,hair,height,history,inflorescence,leaf,length,life,midpoint,na,number,ovary,position,presence,ray,reproduction,rugulose,shape,size,staman,stipe,texture,yellow
784	wfo-0001031880	success	180	112	83	97	29	0.461	0.5-2,0.7-0.8,1,1-1.3,1-1.5,1.5,2-3,2-9,2.5-8,3-3.5,3-foliate,3-lobed,4,4-8,5-6,7-9,acuminate,acute,anther,apex,base,broadly,brown,calyx,capitate,cm,conical,cordate,corolla,cup-shaped,dark,densely,diameter,elliptic,entire,flattened,fleshy,fruit,glabrous,glandular,globose,green,herb,inflorescence,internodal,leaf,lobe,long,margin,minutely,mm,narrowly,orange,ovary,ovoid,pale,papillose,pedicel,peduncle,petiole,poricidal,pubescent,purple,red,reddish,shallowly,simple,stem,stigma,style,subshrub,surface,thin,tip,toothed,triangular,trichome,truncate,tube,uniseriate,x,yellow,–5	.5,0.5-1,1-2,2,2-4,3-4-pluri-foliate,5,6-9,abaxially,adaxially,age,anthesi,apart,basal,bearing,becoming,berry,c.,cell,ciliate,color,crenate,crowded,curved,eaf,edicel,eed,ellipsoid,enlarged,erect,exerted,filament,flower,flush,free,fruiting,gland,gland-tipped,growing,heteromorphic,hollow,horn,irregularly,lamina,lengthening,less,lon,longest,lower,markedly,mature,maturit,mid-length,middle,near,nflorescence,nodding,ovate,pair,papillo,pericarp,pitted,plan,pore,portion,primary,pubescen,rachi,reflexed,ruit,scar,shortest,single,slender,slightly,slit,sometimes,spaced,sparse,sparsely,spreading,straight,strongly,terminal,testal,ud,unicellula,unit,unlobed,upper,upward,vein,wall,widely,widest,woody,ympodial	adhesion,arrangement,blade,climate,colour,form,growth,hair,height,history,length,life,midpoint,na,number,plant,position,presence,pubescence,ray,reproduction,rugulose,seed,shape,size,staman,stellate,stipe,texture
785	wfo-0001031881	success	168	96	72	96	24	0.429	0.5-1,1-1.3,1-1.5,1-7,1.2-6,1.5-2.5,10-30,2,3.5-4,3/4,5-6,7-14,anther,base,beneath,branched,broadly,brown,calyx,campanulate,capitate,cm,corolla,dark,decurrent,deltoid,densely,dia,elliptic,fruit,glabrous,globose,golden-puberulent,golden-pubescent,green,inflorescence,leaf,lightly,lobe,lobed,minutely,mm,obovate,opposite,ovary,ovoid-reniform,papillose,pedicel,petiole,pitted,poricidal,puberulent,pubescent,rounded,shape,shrub,simple,size,small,sparsely,stem,stigma,style,surface,tip,tree,tube,uniseriate,way,white,winged,x	.5,0.1-0.5,0.2,0.2-0.6,0.4-1,0.5-0.7,1/3,10-12,2-9,3-19,absent,acute,along,anthesi,apar,apex,apparent,attenuate,axil,ba,bark,branch,bud,constriction,deflexed,differing,difoliate,distal,dry,drying,eaf,edicel,eed,either,ellipsoid,erect,evenly,exserted,filament,fleshy,free,fruiting,geminat,golden,greyish-brow,incrassate,inflorescenc,junction,lateral,like,lon,long,lower,main,major,margin,material,maturity,middle,midrib,minor,minute,nflorescence,occasionally,older,one,orbicular,pair,papillo,planar,pore,portion,puberulen,rest,ruit,scar,shaped,slender,slightly,somewhat,soon,spaced,straight,strong,tall,tapering,tear-drop,trichome,ud,unit,usually,vein,widest,woody,ympodial,young	0.5,2.5,adhesion,arrangement,colour,diameter,form,greyish-brown,growth,height,history,length,life,na,peduncle,perennial,plant,position,pubescence,reproduction,rugulose,seed,staman,texture
786	wfo-0001031886	success	169	96	66	103	30	0.391	-9,.5,0.5-1,1-1.5,1-4,1.2-2.5,10-40,2-2.5,2-5,2.0-2.5,3.0,5-10,5-6,9-10,anther,axillary,base,bright,broadly,brown,calyx,capitate,cm,completely,conical,corolla,deltate,diameter,elliptic,fleshy,free,fruit,glabrous,green,greenish,half,lobe,lobed,long,lower,margin,minutely,mm,nearly,occasionally,open-conical,ovary,ovoid-reniform,papillose,pedicel,petiole,pinnate,poricidal,rugose,seed,shape,shrub,somewhat,stigma,style,surface,tip,triangular,tube,white,x	-1.2,-25,-4,0,0.1,1.5-2,2,2-3,2-4,20-30,3-6,4,4-15,5-ridged,6-20,6-8,abaxially,abruptly,absent,acuminate,adaxially,along,anthesi,anticlinal,apex,arising,attenuate,axil,basal,beak,bearing,berry,bud,cell,clavat,commonly,distinctly,dry,eaf,earl,edicel,eed,either,em,epidermal,equal,erec,exserted,filament,flower,fruiting,irregular,lanceolate,lateral,le,leaflet,narrowed,near,nflorescence,noddin,node,oblique,pair,papillae,papillate,per,petiolule,portion,primary,projection,purple,rachi,raised,reddish,reflexed,ripe,ruit,scar,scattered,similar,simple,single,sinuous,smaller,smelling,sparse,specimen,strongly,terminal,thickening,time,trichome,tub,ud,unifoliat,uniseriate,unit,usually,vein,wintergreen,without,woody,ympodial	1,1-1.2,adhesion,arrangement,clavate,colour,form,growth,height,history,inflorescence,leaf,length,life,na,peduncle,perennial,plant,position,presence,pubescence,reproduction,rugulose,size,staman,stellate,stem,texture,unifoliate,ye
787	wfo-0001031895	success	160	123	90	70	33	0.562	-1.5,1-1.5,1.5-3,1.5-6,2-2.5,2.5-3,3-4,3-8,3.5-6,4,4-5,4.5-16.5,5,5-6,6-7,acute,anther,anthesi,apex,attenuate,base,beneath,berry,bluish,broadly,calyx,campanulate,capitate,cm,completely,conical,corolla,cup-shaped,dark,deltate,densely,diameter,elliptic,entire,glabrous,globose,green,growth,immature,leaf-opposed,leafy,lobe,lobed,margin,matte,minutely,mm,new,older,ovary,overlapping,ovoid,pale,papillate,pedicel,peduncle,petiole,pitted,planar,poricidal,reniform,revolute,shiny,shoot,short,shrub,simple,slightly,small,somewhat,stem,stigma,style,surface,tan,terminal,thin,tip,tree,tube,violet,way,white,x,¼-1/2	0.5,0.5-1,0.5-2,1.5-2,3-10,5-8,6-9,age,apparently,articulating,bark,blac,cell,drying,eaf,eed,ellipsoid,emarginated,enlarging,erec,erect,exerted,exfoliating,expand,filament,fleshy,flower,fragrant,free,fruiting,glabrou,inflorescenc,intensely,irregular,leaving,lengthening,less,lower,nflorescence,occasionally,once-branched,pair,papillat,part,patch,peeling,peg,perfect,pericarp,plurifoliat,pore,portion,primary,reddish,ruit,scar,sinuate,slender,slit,stout,straight,strongly,testal,thick,tub,ud,unit,vein,woody,ympodial	adhesion,arrangement,blade,climate,colour,form,fruit,glandular,hair,height,history,inflorescence,leaf,length,life,midpoint,na,number,perennial,plant,position,presence,pubescence,ray,reproduction,rugulose,seed,shape,size,staman,stellate,stipe,texture
788	wfo-0001031896	success	196	114	87	109	27	0.444	0.3-0.7,0.3-0.8,0.5-1,0.5-2,1-1.2,1-1.5,1-10,1-3,10-20,13,2-2.5,2-3,2-4.5,2-7,3-30+,3-5,4-7,5-15,5-9,6-30+,6-9,abaxially,acute,adaxially,anther,apex,base,blade,brown,calyx,chartaceous,cm,coarsely,densely,diameter,elliptic,entire,extra-axillary,ferruginous,flattened,flower,fruit,glabrous,glandular,glandular-puberulent,globose,green,hair,lobe,long-acuminate,margin,midpoint,mm,moderately,orange,pedicel,peduncle,perfect,petiole,pinnatifid,pubescence,pubescent,ray,rounded,shape,shrub,simple,size,small,sparsely,stellate,stellate-pubescent,stem,stigma,style,subcordate,surface,tapered,tip,toothed,tree,truncate,tube,white,whitish,x,yellow	-1.5,0-1.2,0.1-0.6,0.3-0.5,0.3-1,0.4-0.8,1-2,1.5,10-20+,15-20,2,2-5,5,5-10,5-6,6-10,7-10,9-18,accrescent,adaxiall,ample,apart,apparently,armed,articulated,axe,ba,branched,broad-based,capitat,connivent,conspicuously,contiguous,covering,curved,cylindrical,denser,difoliate,directed,distall,eaf,eed,eglandular,equal,erect,ferruginous-pubescent,filament,forked,frequently,frui,fruiting,geminate,gland-tipped,held,interpetalar,lanceolate,lateral,less,like,lon,long,long-stalked,longer,lower,midrib,midvein,minutely,mixed,mostly,multangulate,nearly,nflorescence,oblique,occasional,occasionally,often,orolla,pitted,pore,porrect,prickle,rachi,recurved,ruit,sessile,short,shorter,slightly,sometimes,spaced,stalk,stalked,ste,stellae,straight,tal,tamen,tem,time,tissue,unarmed,unbranched,uniform,unit,uprigh,vary,vein,wide,ympodial	adhesion,arrangement,capitate,climate,colour,corolla,form,growth,height,history,inflorescence,leaf,length,life,na,number,ovary,plant,position,presence,present,reproduction,rugulose,seed,staman,stipe,texture
789	wfo-0001031897	success	264	115	98	166	17	0.371	.5,0.1-0.5,0.4-1.1,0.5-3,0.6,1.1,1.3-2,1.5-8,1.7-3,13,2-4,5-6,6-9,abaxial,almost,along,anther,apex,base,berry,black,brachyblast,branch,brown,calyx,cell,chartaceous,clavate,clustered,cm,conical,coriaceous,corolla,dark,dense,diameter,distributed,drying,elliptic,enlarged,epiphyte,erect,evenly,except,fruit,glabrous,grey,hair,inner,inside,lanceolate,leaf,light,linear,lobe,lobed,margin,mauve,midvein,mm,multicellular,multiseriate,obconical,oblong,orange-brown,outside,ovate,ovoid,papillose,pedicel,peduncle,petiole,plant,pubescent,shrub,side,simple,smooth,sometimes,sparse,sparsely,stem,stigma,style,surface,terminal,thick,thin,toward,trichome,tube,unarmed,unbranched,unicellular,weakly,white,x,young	.1,.8,0-1,0.15,0.2-0.4,0.5-1,0.8-1.5,0°,1,1-1.5,1-2,1-2.5,1.5,2/3,4-5,462.,8,abaxially,absent,accrescent,acute,adaxial,adaxially,age,alyx,anthesi,apar,apically,apparently,appearing,appendage,arising,aristate,articulated,attenuate,axillary,bark,bendy,boiteau,branched,clearly,concolorous,condensed,connate,covering,cuneate,curved,datum,dehiscing,delineated,dendritic,densely,developed,developing,development,dilated,divided,domatia,dorsal,dorsifixed,dry,dull,eaf,earliest,ed,entire,equal,even,extending,eye,faint,filament,filiform,fine,flower,foliaceous,free,fruiting,green,immature,indistinc,known,lamina,larger,lateral,least,lengthening,like,long,longitudinal,longitudinally,looped,lower,m.,main,margi,membranous,minute,minutely,naked,never,nflorescence,nther,oblon,obtuse,occasional,occasionally,one,orange,orolla,overlapping,pair,part,partly,pendulous,perfec,pericarp,persisting,plurifoliat,pointed,pore,poricidal,portion,primary,prominent,pronounced,protruding,raised,rarely,reach,reddish,revolute,ribbed,ridge,ridged,ruit,scar,secondary,see,seen,shoot,short,sinus,slender,slightly,smaller,smoot,stump,subulate,sunk,tearing,terete,tertiary,tip,ud,unit,usually,vary,vein,venation,visible,well-developed,wide,winged,wrinkle,ympodial	arrangement,colour,form,growth,height,inflorescence,length,na,ovary,position,pubescence,reproduction,rugulose,seed,shape,size,texture
790	wfo-0001031908	success	213	116	94	119	22	0.441	0-22,0-9,0.4-1.4,1-2,1-4,10-35,2-6,3-8,5-11,5-13,5-19,8-22,9-13,abaxially,acute,adaxially,along,anther,attenuate,axillary,band,base,blue,broadly,brownish,bud,chartaceous,cm,condition,cordate,corolla,densely,diameter,distal,drying,dull,elliptic,elliptic-lanceolate,especially,fresh,fruit,glabrous,globose,green,greenish,hair,half,herb,lanceolate,leaf,like,lilac,lobe,long,membranous,midrib,minutely,mm,mucilaginous,nearly,odd-pinnate,ovate,ovoid,papillose,pedicel,peduncle,petiole,pink,plant,puberulent,pubescent,purple,red-purple,ripe,rotate,rotate-pentagonal,seed,shiny,short,size,spot,stem,stigma,style,subtending,surface,terminal,tinged,tube,wet,white,whitish,x,yellow	0-25,0-45,1-10,1-5.5,1-8,1.5-5.5,3-5,3.5-9,4-25,5,5-merou,7,absent-10,acumen,acuminate,ag,almost,alyx,apart,apex,apparently,approximately,articulated,ascending,auriculate,axe,berry,blade,capitat,cell,ciliate,color,connivent,covering,cuneate,dark,decreasing,decumbent,digestion,dorsally,eaf,edge,eed,enzyme,erect,exceeding,falcate,filament,flat,flower,folded,forked,geminat,generally,glabrou,green-white,hair-like,homostylous,honeycomb-shaped,interjected,lateral,leaflet,lengthening,living,lower,make,margin,medium,middle,mottle,nflorescence,oblique,often,orolla,pair,perfect,petiolulate,plurifoliate,pore,poricidal,prominent,prostrat,rarely,removed,rounded,ruit,secondary,semi-elliptic,semi-erect,sessile,seudostipule,shortly,slightly,slit,spaced,specimen,stamen,star,ste,stippled,straight,tall,tamen,tem,testal,thick,thir,throughout,tip,tri-,truncate,uniform,unit,unwinged,usually,vary,wall,wing,ympodial	adhesion,arrangement,calyx,capitate,colour,form,growth,height,history,inflorescence,length,life,mottled,na,ovary,perennial,position,pubescence,reproduction,shape,staman,texture
791	wfo-0001032157	success	136	71	50	86	21	0.368	.5,0.5-1,0.6-1,0.75-1,1-3,2-3,2.2,3-6,7-9,9-17,anther,base,bi-lobed,calyx,cm,completely,corolla,deltoid,dia,elliptic,glabrous,globose,green,leaf,lobe,lobed,minutely,mm,nearly,opposite,ovary,ovoid-reniform,papillose,pedicel,petiole,pitted,plant,poricidal,reddish,shrub,size,stem,stigma,style,surface,tip,tube,white,x,yellowish	.75,0.25,1.9-2.2,2-5,5-15-flowered,5-8,5-9,acute,anthesi,apart,apex,bark,becoming,beginning,beneath,berry,caly,crystalline,decurrent,deflexed,differing,difoliate,dry,eaf,edicel,eed,evenly,exserted,filament,free,frui,fruiting,geminat,glabrou,golden,incrassate,inflorescenc,lateral,less,live,living,lon,long,longitudinal,lower,main,major,margin,middle,minor,nflorescence,obscure,older,one,pair,paler,papillo,peeling,persistent,pore,portion,raised,reflexed,rounded,ruit,scar,shaped,shiny,simple,slender,slightly,soon,spaced,straight,strip,tall,tapering,tear-drop,translucen,ud,unit,vein,widest,woody,ympodial,young	arrangement,colour,diameter,form,fruit,growth,height,history,inflorescence,length,life,na,peduncle,perennial,position,pubescence,reproduction,rugulose,seed,shape,texture
792	wfo-0001032161	success	146	103	69	77	34	0.473	0.4-1.2,0.5-1,0.7-4,0.75-1,0.8-1,1-1.5,1-11,1-3,1.2-1.3,2-7,2.5-3,3.5-4,acute,anther,apex,area,base,calyx,cm,conical,coriaceous,corolla,dark,deltate,dia,drying,elliptic,glabrous,globose,golden,green,inflorescence,internodal,leaf,lobe,lobed,margin,minute,minutely,mm,mustard,opposite,ovary,ovoid-reniform,pale,papillose,pedicel,pericarp,petiole,pitted,plant,plurifoliate,poricidal,quadrate,revolute,shrub,stem,stigma,style,surface,tan,thin,tip,trichome,tube,uniseriate,white,x,yellow	.5,1.4-2,2-8-flowered,?,abaxially,adaxiall,adaxially,anthesi,apical,ba,bark,beneath,berry,branched,brownish-blac,closely,color,deflexed,delicate,dendritic,densely,difoliate,eaf,edicel,eed,ellipsoid,exserted,filament,filiform,free,fruiting,giving,hanging,lamina,later,like,long,lower,many,merely,middle,nearly,nflorescence,obovate,occasionally,older,overlappin,persistent,pore,portion,projection,pubescent,reflexed,rest,ruit,scar,shaped,shiny,shoot,short,simple,spaced,sparsely,strongly,styl,sulcate,tall,tear-drop,tub,ud,unit,usually,vein,widest,yellowish,ympodial,young	adhesion,arrangement,blade,brownish-black,climate,colour,diameter,form,fruit,glandular,growth,hair,height,history,length,life,midpoint,na,number,peduncle,perennial,position,presence,pubescence,ray,reproduction,rugulose,seed,shape,size,staman,stellate,stipe,texture
793	wfo-0001032165	success	197	107	77	120	30	0.391	0.3-1,0.75-1,1-1.2,1-1.5,1-2,1.5-4,10-25,2-2.5,2.5-3.5,3-6,5-15,5-6,5-7,acute,anther,apex,base,broadly,brown,calyx,capitate,center,cm,continued,corolla,cup-shaped,dark,deltoid,densely,dia,dry,due,dull,elliptic,glabrous,globose,golden,golden-puberulent,golden-pubescent,green,inflorescence,leaf,lobe,lobed,margin,minute,minutely,mm,obovate,ovary,ovoid-reniform,pedicel,petiole,pitted,plant,poricidal,presence,purplish,ripe,shape,size,small,specimen,stem,stigma,style,surface,terminal,tinged,tip,tree,trichome,tube,uniseriate,white,x,young	.25,.5,0.1,0.1-0.3,0.25-0.5,3-4,3.5-8.5,4-6,5-30-flowered,5-9.5,8-9,abaxial,adaxial,along,anthesi,apparent,appearing,ba,bark,beginning,beneath,berry,bud,closely,cucullate,deciduous,decurrent,denser,differing,difoliate,distal,eaf,edged,edicel,eed,ellipsoid,end,entire,erect,even,expansion,exserted,exsertion,filament,free,fruiting,geminat,greyish-brown,immature,inflorescenc,later,lateral,less,like,live,lon,long,lower,main,major,markedly,medial,middle,midrib,minor,near,nearly,nflorescence,node,occasionally,older,once-furcate,one,onto,opposite,orbicular,overlapping,pair,pale,paler,papillo,papillose,planar,pore,portion,prominent,puberulent,rather,rest,ridge,rounded,ruit,scar,shaepd,simple,single,slender,slightly,slow,smoot,spaced,stout,straight,stripe,strongly,swollen,tall,tapering,tear-drop,thickened,time,tub,ud,unit,vein,widest,winged,woody,yellowish,ympodial	adhesion,arrangement,blade,climate,colour,diameter,form,fruit,glandular,growth,hair,height,history,length,life,midpoint,na,number,peduncle,perennial,position,pubescence,ray,reproduction,rugulose,seed,staman,stellate,stipe,texture
794	wfo-0001032167	success	163	104	72	91	32	0.442	.5,0.5-1,0.5-1.5,0.5-2.5,0.75-3,1-2,1-2.5,1-3,1-7,1.5,10-20,12-20,2-4,2-7,4-6,5-15,7-10,abaxially,acute,adaxially,anther,apex,base,blade,brown,calyx,chartaceous,ciliate,cm,densely,diameter,dm,drying,elliptic,elliptic-ovoid,entire,flower,fruit,glabrous,globose,growth,hair,herb,immature,linear-lanceolate,lobe,margin,maturing,membranaceous,mm,moderately,oblong,obtuse,pedicel,peduncle,petiole,pubescent,purple,rotate,rounded,seed,semitransparent,sparsely,staman,stigma,style,surface,tube,twisted,white,x,yellow	1,1-2-celled,1-5,10-35,2-foliate,3-6,3-7,4-10,absent,abundant,adaxiall,along,appressed,axe,berry,cell,closely,common,connected,cordate,curved,decurrent,dehiscing,dense,denser,eaf,eed,emarginat,explosively,few-,filament,flat,flattened,forming,frui,geminat,geniculate,growt,held,interpetalar,larger,long,longer,lower,lowermost,lying,many-branched,maturit,mesocarp,near,nearly,netlike,new,nfloresence,notch,often,older,one-celled,orolla,per,placenta,pressure,projection,pubescen,rachi,raised,ruit,shorter,slightly,small,smaller,sometimes,stamen,straight,tal,tamen,tem,tissue,triangular,two-celled,unbranched,unit,upper,usually,vary,vein,wall,watery,wid,woody,ympodial	adhesion,arrangement,climate,colour,corolla,form,glandular,height,history,inflorescence,leaf,length,life,midpoint,na,number,ovary,perennial,plant,position,presence,pubescence,ray,reproduction,rugulose,shape,size,stellate,stem,stipe,texture,ye
795	wfo-0001032176	success	177	70	51	126	19	0.288	.5,0.5-0.7,0.8-6,1-1.2,1-10,1.5-1.6,1.5-2.5,2.5-10,3-15,3-3.5,3-4,6,6-10,7,anther,axillary,base,calyx,cm,conical,corolla,densely,diameter,elliptic,green,greenish,grey-brown,greyish,herb,leaf,lobed,mm,nearly,ovary,ovoid-reniform,pale,pedicel,petiole,pinnate,poricidal,pubescent,seed,size,sparsely,stem,stigma,style,tip,tube,white,x	0,0.42,0.5,0.5-0.75,0.5-1,0.8-1,1.5-6,1/2,100,2-3,3-7,5-6-celled,adaxially,adhering,along,anthesi,apart,apex,apical,arising,attaining,attenuate,axil,basal,beak,becoming,berry,branched,capitat,cateniform,cell,containing,copiously,creeping,cucullate,denser,drying,eaf,edicel,eed,ellipsoid,epidermal,equal,especially,exserted,fallen,filament,filiform,flower,free,fruiting,glabrous,globose,hangin,inflorescenc,lateral,leaflet,lengt,lengthening,like,lobe,log,long,long-papillose,lower,margin,minute,minutely,nflorescence,nodding,node,obovate,obtuse,occasionally,often,onto,open,pair,papillose,per,petiolule,pore,portion,projection,quadrate,rachi,reflexed,rest,rooting,rounded,ruit,scar,separate,simple,single,sinuous,slightly,slit,smaller,somewhat,soon,spaced,strait,strongly,tem,terminal,thickening,tightly,time,tree,trichome,truncate,trunk,tub,ud,ultimate,unevenly,unifoliat,uniseriate,unit,vein,wall,whit,winged,without,ympodial	arrangement,capitate,colour,form,fruit,growth,height,history,inflorescence,length,life,na,perennial,plant,position,pubescence,reproduction,shape,texture
796	wfo-0001032183	success	162	111	81	81	30	0.5	0-0.1,0.3-0.6,0.4-0.6,0.5-1,0.5-1.5,0.6-0.9,0.7-1.4,0.9-1,1.1-2.3,1.5-1.9,2.4-2.7,3.5-4.5,4-6,5-9,5.5-7,7-8,7-9,absent,acute,adaxially,anther,apex,base,blade,calyx,chartaceous,cm,cuneate,densely,diameter,distally,elliptic,entire,erect,extra-axillary,flower,fruit,glabrous,gland-tipped,globose,grey,hair,inflorescence,lanceolate,lateral,length,lobe,long,margin,markedly,mid-point,midpoint,mm,obtuse,ovate,pale,pedicel,peduncle,perennial,petiole,pubescent,purple,ray,red,rhizomatous,rotate-stellate,short,shrub,simple,sparsely,stellate-pubescent,stigma,style,thick,thicker,throughout,time,tube,white,x,yellow	%,0-1.5,0.1-0.2,0.2-0.8,0.25-0.4,0.4-0.5,0.4-0.8,0.4-4,1-2,1-3,16-23,2-foliate,2.7-3.6,4-,4.5-7,5-merou,7-12,8-9,abaxially,absen,accrescent,across,adaxiall,alyx,apart,articulated,axe,ba,capitat,confined,contiguous,cylindrical,directed,distall,distributed,eaf,eed,eglandular,exceeding,finger,fruiting,geminat,glaberous,green,homostylous,juicy,lamina,lower,mature,mesocarp,midrib,minute,nearly,nflorescence,oblique,orolla,part,per,perfect,pore,porrect,prickle,pseudo-umbellate,rachi,ruit,sessile,solitary,spaced,stalk,stellae,succulen,tal,tamen,tem,unarme,unarmed,unbranched,unit,vary,wide,ympodial	adhesion,arrangement,capitate,climate,colour,corolla,form,glandular,growth,height,history,leaf,life,na,number,ovary,plant,position,presence,present,pubescence,reproduction,seed,shape,size,staman,stellate,stem,stipe,texture
797	wfo-0001032187	success	139	109	73	66	36	0.525	-4,-4.2,-5,-9,0.1–1.4,0.5,0.5-,0.6–1.3,1.1–3.2,1.3–1.8,1.6–2.1,1.8–2,1.8–2.8,3.1–3.5,3–3.2,3–4,5–7,7–11,acuminate,acute,angular,anther,apex,appressed,aromatic,base,blade,broadly,brown,brownish,cm,corolla,dark,eglandular,elliptic,entire,glabrescent,globose,hair,herb,leaf,light,lobe,long,margin,marked,mm,obovate,ovate,pedicel,peduncle,pentagonal,persistent,petiole,plant,purple,ridge,simple,soft,sparse,stellate,stem,style,sub-glabrous,texture,triangular,truncate,well,yellow,yellowish,±,±1,×	-11,-2.1,0.5–1,100,1–1.7,22,24.6–26.3,2–9,5-merous,9,adherent,alyx,ape,berry,branch,changing,consisting,cyme,di-foliate,dia,dull,eaf,eed,equal,erect,filament,flowered,forked,fully,geminat,granule,green,hite,hooked,hydrated,lower,many,mature,nflorescence,numerous,occasionally,penden,per,perfec,petiolate,pollen,predominantly,presen,protruding,rarely,ruit,running,sclerotic,short,small,sometimes,spreading,stage,straight,tinged,tooth,unit,widest,wing,ympodial,µm	adhesion,arrangement,calyx,climate,colour,diameter,form,fruit,glandular,growth,height,hermaphroditic,history,inflorescence,length,life,midpoint,na,number,ovary,perennial,position,presence,pubescence,ray,reproduction,rugulose,seed,shape,size,staman,stigma,stipe,surface,tube,white
798	wfo-0001032190	success	230	143	108	122	35	0.47	-1,-3.4,0-0.6,0.2-0.3,0.5-3,0.7-1.1,0.8-1.1,1-1.5,1-1.7,1-6,1.2-2.1,1.2-3,1.3-5,1.5-3.5,1.8-3,1.9-4.5,10,2-6,2.5-10,3-21,4-5,5-22,7-28,abaxially,acuminate,acute,anther,apart,apex,attenuate,base,becoming,blade,blunt-tipped,brown,calyx,campanulate,closely,cm,conical,coriaceous,corolla,decurrent,deltoid,densely,diameter,elliptic,entire,few-rayed,fleshy,fruit,glabrescent,glabrous,globose,granular-pubescent,green,growth,hair,honeycombed,inserted,lanceolate,lateral,leaf,length,lobe,long-attenuate,margin,mm,moderately,mostly,multangulate,near,oblanceolate,oblong,occasional,pale,pedicel,peduncle,petiole,present,pubescent,reniform,reticulate-punctate,ripe,rotate-stellate,scabridulous,scabrous,shrub,simple,small,somewhat,spaced,sparsely,stelliform,stem,stigma,style,suborbicular,terminal,tomentose,tree,truncate,tube,white,whitish,x,yellow,yellowish	-6,.5-6,/100-1/20,0-80,0.4-1.5,0.6-1.5,1.5-4,1.6-4.4,1/2-3/4,2.5-4.3,2.7-6.8,3.5-8,4-6,4.5-7,6-11,6x,7-11,absent,accrescent,adaxially,ag,along,anthesi,apical-lateral,apparently,appressed-tomentose,articulated,axe,axillary,ba,bark,berry,branch,branched,bud,chartaceous,coarse-stalked,continued,dehiscing,due,eaf,eed,ellipsoid,evident,exserted,extend,filament,flower,free,fruiting,glabrou,high,hirsute,introrse,large,line,lobed,long,long-,long-stalked,longitudinal,lower,m.,magnification,main,midvein,minute,mixed,multangulat,multiseriate-stalked,nearly,nflorescence,obtuse,occasionally,older,openly,orolla,ovat,ovate,overlapping,partly,perfect,plurifoliate,pore,porrect-stellat,porrect-stellate,rachi,rarely,rather,relatively,ruit,runk,sessile,short-,short-stalked,side,slit,sparse,stamen,stipitate-glandular,strongly,subcapitat,subcoriaceous,suture,tamen,terete,testa,thick,thin-stalked,time,touching,toward,unarme,unarmed,unit,usually,vary,vein,way,wide,ympodial,young	abaxial,adaxial,adhesion,arrangement,climate,colour,dense,form,glandular,height,history,inflorescence,life,midpoint,na,number,ovary,perennial,plant,position,presence,pubescence,ray,reproduction,rugulose,seed,shape,size,staman,stellate,stipe,subcapitate,surface,texture,unknown
799	wfo-0001032206	success	216	127	97	119	30	0.449	-0.8,0.2–0.5,0.8–1.2,1.1–1.2,1.5–2.5,1/4–1/2,11–22,1–2.3,1–3,2.5–3.3,2.7–3.5,2–2.5,3.5–9,3–4,4.5–5.8,5–15,5–6,5–9,6–8,7–10,8–20,abaxially,acute,andromonoecious,anther,apex,base,berry,blade,calyx,chartaceous,cm,connivent,cream,cuneate,dark,deltate,diameter,elliptic,equal,flattened-reniform,flower,foliaceous,fruit,glabrescent,glabrous,green,lateral,leaf,length,lobe,lobed,long,long-styled,margin,marking,maturity,mauve,midpoint,midvein,mm,moderately,obtuse,orange-brown,ovate,pale,pedicel,peduncle,petiole,plant,poricidal,purple,ray,short-styled,shrub,smooth,sometimes,sparsely,spherical,stellate,stellate-pubescent,stem,stout,style,surface,tapering,tip,toward,trichome,truncate,tube,usually,white,wide,yellow,yellow-orange,young	-2,-20,-5,..,.2,.5,0,0.2,0.2–0.4,0.5–1,00–200,0–20,0–30,0–5,1,1.2–2.2,1.5–2,1/3,1/4–1/3,1/6,10–80,1–2,1–4,2–3,2–8,30–80,4–6,5-merous,5–20,5–8,6–10,6–15,accrescent,adaxially,alyx,apar,apart,apically,apparently,approximately,armed,articulated,bark,bluntly,branched,broad-deltate,brow,clearly,concolorous,covering,curved,discolorous,distal,distance,drying,eaf,eed,erect,extending,filament,flattened,free,fruiting,functionally,gently,green-brown,hermaphroditic,heterostylous,infructescence,lengt,lobing,longer,lowermost,mal,mature,nflorescence,often,older,one,open,orolla,ower,pair,pendent,pendulous,per,pericarp,plurifoliat,porrect,portion,prickle,primary,rarely,reflexed,scar,secondary,sessile,side,slender,spaced,spreading,stalk,stalked,straight,tamen,tertiary,time,uit,unarmed,ung,unit,variously,vary,vein,venation,visible,weakly,woody,ympodial	0.5–1.5,adhesion,arrangement,climate,colour,corolla,form,glandular,growth,hair,height,history,inflorescence,life,na,number,ovary,perennial,position,presence,present,pubescence,reproduction,seed,shape,size,staman,stigma,stipe,texture
