	coreid	status	nwords_original	nwords_result	nwords_recovered	nwords_omitted	nwords_created	prop_recovered	common_words	original_only	result_only
0	wfo-0001025652	success	156	144	128	28	16	0.821	.3,.5,0.5-1,1,1-1.5,1.5-2,10-20,15-17,15-19,2-3,2-5,2-6,20-50,3-3.5,3-5,4,4-6,4-7,9-11,acuminate,acute,anther,anthesi,apex,bark,base,bilobed,blade,broad,calyx,campanulate,closed,cm,completely,connate,corolla,decurrent,densely,dia,difoliate,dry,elliptic,emerge,envelope,filament,fleshy,flower,free,fruit,furcate,glabrate,glabrous,green,greyish,growing,growth,irregular,lateral,leaf,like,live,lobe,lobed,long,major,margin,matte,middle,minor,minute,minutely,mm,nearly,new,occasionally,older,onto,opposite,ovary,ovoid,ovoid-reniform,pair,pale,paler,papillae,papillose,parallel,pedicel,petiole,pinkish-grey,pitted,plant,pore,poricidal,rather,red-papillose,scar,shape,shaped,shiny,shrub,simple,size,small,specimen,stem,stigma,strongly,style,surface,tall,tan,tear,tear-drop,thick,tightly,tip,tree,tube,unit,vein,white,wider,widest,wing,winged,x,young	3-5-flowered,abruptly,appearing,closely,differing,eaf,edicel,eed,geminat,greyi,lon,lower,main,narrowing,nflorescence,one,overlappin,papillo,planar,portion,ry,soon,spaced,straight,tapering,thicker,ud,ympodial	appearance,bud,color,count,diameter,geminate,habitat,inflorescence,length,null,position,seed,structure,sympodial,texture,width
1	wfo-0001025657	success	239	210	187	52	23	0.782	-2,/3,0.1-0.4,0.2-0.4,0.5-2.5,1-1.3,1-3,1.2-1.5,1.3-2,1.5-1.8,12x,2-10,2-3.5,2.2-5.5,2.5-9.3,2/3,25-60,3-4,3-4.8,3-6,3.2-6,4-4.4,4-4.5,4-7,5-14,5-16,6-12,6-8,6.5-10,7-27,7-9,7-9.5,8.3-12,abaxially,accrescent,acute,adaxially,also,anther,anthesi,apart,apex,apparently,appearing,articulated,ascending,axe,axillary,base,blade,bluish,blunt-tipped,branch,branched,broadly,brown,bud,calyx,central,chartaceous,closely,cm,conical,cordate,corolla,dark,deltoid,dendritic-multangulate,dense,densely,diameter,due,earl,elliptic,especially,evident,expanded,filament,flower,free,fruit,fruiting,glandular,granular,green,hair,lanate-pubescent,lanceolate,lateral,leaf,length,light,lobe,lobed,long,long-stalked,lower,magnification,main,margin,midrib,minutely,mixed,mm,multangulate,narrowly,nearly,oblong,often,older,open,ovate,ovate-lanceolate,overlapping,pale,part,parted,partly,pedicel,peduncle,perfect,persistently,petiole,plurifoliate,porrect-stellate,present,pseudo-terminal,pubescence,pubescent,rachi,ray,reportedly,reticulate-punctate,scented,semi-ovate,sessile,short,short-,short-stalked,shrub,side,simple,slightly,soft,somewhat,spaced,splitting,stellate,stellate-pubescent,stem,stigma,stipitate-glandular,stipitate-multangulate,strongly,style,subcampanulate,subcoriaceous,suborbicular,surface,suture,tall,tan,terete,thick-stalked,thickened,thin-stalked,time,tip,tomentose,tomentose-pubescent,transparent,tree,tube,two-third,unarmed,unit,upper,usually,vein,velutinous-pubescent,way,white,wide,x,yellow,yellowish,young	1-1.1,1-1.6,1.7-1.9,2.7-4.3,8-10.5,ag,ark,around,ba,berry,capitat,cylindrical,dendritic-multangulat,directed,distally,dried,eaf,edge,eed,entire,exerted,exserted,farinose,few-rayed,fleshy,glabrous,glandula,half,inserted,lengthening,longitudinal,m.,nflorescence,obtuse,occasional,orbicular,orolla,ovat,persistent,pore,poricidal,ripe,ruit,slit,stamen,tamen,tomentum,ud,unarme,vary,weakly,ympodial	appearance,bark,capitate,color,count,growth,habitat,inflorescence,major,mentioned,minor,new,ovary,position,scar,seed,shape,size,structure,sympodial,texture,width,wing
2	wfo-0001025669	success	216	147	113	103	34	0.523	.5,0.1-0.3,1-2,1-4,1.4-2.5,13-35,2,2-4,2.2-6,2.2-6.5,3-7,9-24.5,abaxially,acuminate,acute,adaxially,along,anther,apex,apparently,base,blue,broadly,cell,chartaceous,ciliate,clavate,cm,connivent,corolla,covering,cuneate,decurrent,diameter,digestion,discussion,distal,distinct,enzyme,especially,filament,flower,forming,glabrous,green,green-white,hair,half,herb,honeycomb-shaped,lanceolate,lateral,like,lobe,long,make,margin,membranous,midrib,minutely,mm,moderately,monochasium,mottled,mucilaginous,multicellular,near,oblique,obtuse,odd-pinnate,often,ovoid,pedicel,perfect,petiole,petiolulate,petiolule,plant,plurifoliate,puberulent,pubescent,purple,rarely,removed,rosette,rounded,see,seed,sessile,short,size,sometimes,species,stem,stigma,streaked,style,subglabrous,tall,testal,thick,throughout,tip,tri-,tube,typically,unbranched,unit,unwinged,wall,wet,white,x	'',0-1,0-5,0-7,0.8-2.4,1,1-10,1-2.2,1-3,1.3-4.2,1.6-4.4,2-3,2.4-7,3-5,4-6,5-merou,``,absen,absent,acumen,ag,alyx,apart,articulation,axe,berry,blade,brownish,capitat,clearly,condition,contracted,dorsally,drying,eaf,edge,eed,elliptic,end,erec,exceeding,except,extra,flat,flowered,folded,fresh,fruit,geminat,glabrou,globose,greatly,greenish,hair-like,highly,homostylous,interjected,larger,leaflet,lengthening,living,lower,minute,nflorescence,obovate,one,orbicular,orolla,ovate,pair,peduncle,placed,pore,poricidal,proximal,reduced,ripe,rotate,ruit,scale-like,seudostipule,single,slightly,slit,spaced,specimen,stamen,ste,stolo,straight,subequal,tamen,tem,terminal,tinged,truncate,tuber,unequal,vary,whitish,wide,yellow,ympodial	'extra,'hair-like,anthesi,appearance,bark,bud,calyx,capitate,color,count,erect,free,geminate,growth,habitat,inflorescence,leaf,length,major,mentioned,minor,new,ovary,position,scar,shape,structure,surface,sympodial,texture,vein,width,wing,young
3	wfo-0001025697	success	181	128	93	88	35	0.514	-9,0-14,0.15-0.75,1-1.7,1-2,1-3,10-26,25-35,3-10,3-4,3.3-11,5.5-11.5,6.5-13.5,abaxially,acumen,acuminate,acute,adaxially,anther,apex,articulated,asymmetric,attenuate,axillary,base,basiscopic,blue,bud,cell,clavate,cm,connivent,corolla,covering,dark,diameter,distal,filament,flower,forked,generally,glabrous,green,green-white,half,herb,high,lanceolate,lateral,leaf,light,lilac,linear,lobe,long,make,mm,mucilaginous,odd-pinnate,orbicular,ovate,ovoid,pedicel,pentagonal,petiole,petiolulate,plant,plurifoliate,rotate,rounded,seed,sessile,short,side,size,stigma,style,subtending,tall,terminal,testal,thick,throughout,tip,tissue,tri-,tube,unit,unwinged,usually,wall,wet,x	0.6-3.5,0.8-2,1.5-1.8,1.7-8.6,2-10.5,2-2.6,2-4,2-6,3-5,3-6,4-7.5,5-merou,adaxiall,ag,alyx,apart,apparently,axe,berry,blade,brownish,capitat,condition,coriaceous,decreasing,decurrent,deep,digestion,dorsally,drying,eaf,edge,eed,elliptic,enzyme,erec,exceeding,flat,folded,fresh,fruit,geminat,glabrescent,glabrou,globose,greenish,hair,hair-like,hal,homostylous,honeycomb-shaped,interjected,leaflet,lengthening,living,lower,medium,nflorescence,orolla,pair,peduncle,perfect,pore,poricidal,purple,rachi,removed,ripe,ruit,seudostipule,slightly,slit,spaced,specimen,stamen,straight,stripe,subequal,subglabrou,tamen,tem,toward,typically,vary,whitish,wood,yellow,ympodial	'hair-like,anthesi,appearance,bark,calyx,capitate,color,count,description,erect,free,geminate,growth,habitat,inflorescence,length,major,margin,mentioned,minor,new,ovary,position,scar,shape,stem,structure,surface,sympodial,texture,vein,width,wing,woody,young
4	wfo-0001025699	success	181	152	133	48	19	0.735	0.5,1,1-1.5,1-2,1-2.5,1-3,1.5-2,10,15-20,2,2-2.5,2-6,3-15,3-3.5,3-5.5,3-8,4-5,5-8,5.5-14,8-9,abaxially,acute,adaxially,age,anther,anthesi,apart,apex,appearing,articulating,attenuate,bark,base,branching,brown,calyx,campanulate,capitate,cm,completely,continuing,corolla,crystal,cup-shaped,dark,darker,deltate,densely,diameter,difoliate,dorsal,dry,drying,ellipsoid,elliptic,erect,face,filament,flower,free,glabrous,green,grey-brown,growth,immature,inclusion,inflorescence,irregularly,lanceolate,leaf,leaf-opposed,leafy,leaving,lengthening,less,lobe,margin,minutely,mm,narrowly,new,older,one,onto,ovary,oxalate,pair,pale,papillose,pedicel,peg,per,petiole,plurifoliate,pore,poricidal,red,reddish,reniform,reticulate-pitted,rounded,rounded-sagittate,sand,scar,shoot,short,simple,slightly,slit,small,somewhat,spaced,stem,stigma,style,surface,tangled,thickened,time,tip,tree,triangular,trichome,tube,unit,vein,white,white-spotted,wing,winged,x,yellow,young	.2,.5,1.5,1/3,2cm,499,5-winged,absent,almost,apparently,becoming,berry,c.,conical,conspicuously,corrugate,eaf,eed,entire,exerted,fide,fruiting,glabrou,globose,included,inflorescenc,lobed,lower,markedly,midrib,nflorescence,nodding,papillat,peduncle,penden,perfect,portion,primary,ruit,stearn,straight,strongly,ud,way,wide,woody,ympodial,Â½	appearance,bud,color,count,habitat,lateral,length,major,minor,null,papillate,position,seed,shape,size,structure,sympodial,texture,width
5	wfo-0001025700	success	189	130	96	93	34	0.508	0.30-2.0,0.5-2,0.8-2.6,1-2,1-3,10-40,10.5-12,15-40,2-7,2.5-4,5.3-17.5,5.5-18,9-31,abaxially,acumen,acuminate,acute,adaxially,anther,apex,apiculate,asymmetric,attenuate,axillary,basal,base,basiscopic,bud,cell,clavate,cm,connivent,corolla,covering,diameter,distal,dot,filament,flower,forked,generally,glabrous,green,green-white,hair,half,herb,lanceolate,lateral,leaf,light,lilac,linear,lobe,long,make,medium,mm,mucilaginous,narrowly,odd-pinnate,ovate,ovoid,pedicel,petiole,petiolulate,plant,plurifoliate,purple,rounded,seed,short,side,size,sometimes,stigma,style,subtending,tall,terminal,testal,thick,throughout,tip,tissue,tri-,tube,typically,unit,unwinged,usually,wall,wet,white,winged,x	0-16,0.7-2.7,0.8-4,1.1-2.3,1.5-2,2-12,3-4,3-8,3.5-10.5,3.7-8.6,4-5,5-15,5-20,5-merou,5.5-8,acuman,ag,alyx,apparently,articulated,axe,berry,blade,brownish,capitat,chartaceous,condition,considerably,decrease,decreasing,digestion,dorsally,drying,eaf,edge,eed,elliptic,enzyme,erec,exceeding,except,flat,folded,fresh,fruit,geminat,glabrescent,glabrou,globose,greenish,hair-like,hal,high,homostylous,honeycomb-shaped,interjected,larger,leaflet,lengthening,living,lower,nflorescence,orbicular,orolla,pair,par,peduncle,pentagonal,perfect,pore,poricidal,proximal,removed,ripe,rotate-pentagonal,ruit,sessile,seudostipule,slightly,slit,specimen,stamen,straight,subequal,subglabrou,tamen,tem,toward,vary,whitish,whose,yellow,ympodial	'hair-like,anthesi,appearance,bark,calyx,capitate,color,count,erect,free,geminate,growth,habitat,inflorescence,length,major,margin,mentioned,minor,new,ovary,part,position,scar,shape,stem,structure,surface,sympodial,texture,vein,width,wing,young
6	wfo-0001025704	success	248	189	164	84	25	0.661	-5,/6,0-100,0-2,0.1,0.1-0.3,0.1-0.5,0.15-0.8,0.3-0.8,0.5-1.5,0.7-1,1,1-3.5,1-6,1.2-3,1.5-2,1.5-3.2,1/2-4/5,1/5,2,2-10,2-3,2-5,2-7,2.7-4,3-10,3-6,4-12,4-5,4.5-6.5,5-20,6-12,6-15,8-12,8-15,8-17,abaxial,abaxially,acute,adaxial,almost,anther,apart,apex,apically,apiculate,apparently,auriculate,bark,base,berry,blade,branched,broad-deltate,calyx,cell,cm,connivent,cordate,curved,deltate,densely,diameter,elliptic,erect,filament,flattened,flattened-reniform,flower,free,glabrescent,glabrous,gray,half,irregular,lateral,leaf,length,lobe,lobed,long,long-styled,longer,lower,margin,mauve,midpoint,mm,multangulate,occasionally,often,older,one,open,orange,orange-brown,outline,ovate,pair,pale,pedicel,per,petiole,pit,poricidal,porrect,prickle,prickly,primary,prominent,raised,rarely,ray,red-brown,red-green,round,scar,sessile,shape,short-styled,shorter,shrub,small,smooth,sometimes,somewhat,spaced,sparsely,spreading,stalk,stalked,stellate,stellate-pubescent,stem,straight,strongly,style,surface,tapering,terete,terminal,tertiary,time,tip,tree,trichome,truncate,tube,unarmed,unbranched,unit,upper,variously,vein,venation,visible,way,white,white-gray,wide,yellow-green,yellowish,young,Ã	-10,-2,-3,0,0-3.5,0-5,1-4,1.5-4.5,1.8-3.5,1/4-3/4,2-4.5,2.5-4.5,3-15,3-5,5-merous,age,alyx,andromonoecious,apar,articulated,axe,ba,brow,chartaceous,covering,development,discolorous,distal,distance,drying,eaf,eed,ellipsoid,elongating,end,equal,evenly,extending,fruit,fruiting,green,green-yellow,hermaphrodite,heterostylous,infructescence,less,lobing,lowermost,mature,maturity,midvein,moderately,near,nflorescence,obtuse,orolla,oung,peduncle,pendulous,pericarp,plant,plurifoliat,portion,prickl,recurved,reflexed,retaining,rounded,ruit,secondary,side,slender,spherical,staminat,stellate-pubescen,stout,tamen,throughout,vary,warty,widening,woody,yellow,ympodial	anthesi,appearance,brown,bud,color,corolla,count,growth,habitat,inflorescence,major,mentioned,minor,new,ovary,plurifoliate,position,seed,size,stigma,structure,sympodial,texture,width,wing
7	wfo-0001025729	success	177	136	115	62	21	0.65	-20,.5,0.25-0.5,0.7-1.2,1-1.5,1-5,1.1-1.5,1.2-1.8,1.5-2,1.75,2-3.5,20,3-6,4-5,4-8,5-50-flowered,6-8,7-8,9-17,abaxial,acute,along,anther,anthesi,apex,apiculate,appearing,axil,bark,base,blackish,branched,bristly,bud,calyx,cm,corolla,covered,covering,cyathiform,deltoid,densely,denser,diam,difoliate,drying,elliptic,filament,flattened-reniform,fleshy,free,glabrous,globose,greyish-brown,growing,lamina,lateral,leaf,live,lobe,long,main,major,margin,member,minor,minutely,mm,oblique,occasionally,often,opposite,ovary,overlapping,overtopping,pair,pale,papillose,partially,pedicel,petiole,pit,pitted,plant,prominent,raised,reflexed,rounded,scar,shiny,short,simple,size,sparsely,stem,stigma,stout,style,surface,tall,terminal,tip,touching,tree,treelet,trichome,tube,tuft,uniseriate,unit,usually,vein,white,x,young	/4,2,abaxially,abrupt,adaxially,apar,apical,basal,berry,black,bright,dark,deflexed,dia,differing,dirty,eaf,edicel,eed,enclosed,expanded,f,fruiting,furcate,geminat,gently,glabrou,green,greenish-yellow,incrassate,lat,like,lobed,lon,lower,m.,mainly,middle,minute,nflorescence,older,one,papillo,pore,poricidal,portion,pubescent,quite,ripening,ruit,shaped,straight,tapering,tear-drop,tub,ud,way,widening,widest,woody,yellow,ympodial	apart,appearance,color,count,diameter,flower,geminate,growth,habitat,inflorescence,length,mentioned,new,position,seed,shape,structure,sympodial,texture,width,wing
8	wfo-0001025749	success	217	121	95	122	26	0.438	.5,0.2-1.5,0.5-0.8,0.5-0.9,0.6-4.5,0.8-0.9,1-10,1-13,1-2,1-3,1-8.5,1-9,1.5-2,1.5-2.5,2-10,3-5,4-8,abaxially,acute,anther,apart,apex,apparently,bark,base,branched,calyx,cm,cuneate,densely,diameter,difoliate,dull,erect,filament,filiform,flattened-reniform,flower,free,glabrescent,glabrous,gray,lateral,leaf,length,light,lobe,long,long-ovate,margin,mauve,midvein,mm,moderately,narrow-deltate,narrow-ovate,one,open,orange-brown,orbicular,ovate,pair,pedicel,petiole,prickly,procumbent,purple,rarely,recurved,rounded,scar,shrub,sometimes,spaced,sparsely,spreading,stellate,stellate-pubescent,stem,straight,style,surface,tapering,terete,time,tip,toward,trichome,tube,unit,vein,white,wide,yellow,yellowish	-1,-12,/5,0-10,0-3,0-5,0-6,0-8,0.1,0.1-0.2,0.1-0.3,0.1-0.4,0.2,0.3-1.5,0.4-0.7,0.5,0.5-1.3,0.5-3,1,1-6,1.5,1/4-1/3,1/5-1/2,2-2.5,2.5-6,2/3,3-20,5-,5-10,5-20,5-merous,6-8,abaxial,acuminat,adaxial,adaxially,adnate,almost,alyx,apar,apically,articulated,berry,blade,broad-deltate,chartaceous,concolorous,curved,dark,discolorous,distance,drying,eaf,eed,elongating,equal,extending,flattened,fruit,fruiting,geminat,gently,green-brown,herbaceous,indistinct,infructescence,lobed,lon,longer,lower,magnification,markedly,mature,maturity,midpoint,nflorescence,oblong,obtuse,occasionally,older,orange-brow,orange-red,orolla,oung,pale,peduncle,pendulous,per,perfec,pericarp,poricidal,porrect,portion,prickl,prickle,primary,ray,red-brown,reduced,ruit,sessile,shorter,side,smooth,spherical,stalk,stalked,straw-yellow,strongly,tamen,tertiary,usually,variously,vary,venation,visible,way,without,yellow-green,yellow-orange,ympodial,Â½-2/	anthesi,appearance,bud,color,corolla,count,geminate,growth,habitat,inflorescence,major,minor,new,null,ovary,position,seed,shape,size,stigma,structure,sympodial,texture,width,wing,young
9	wfo-0001025754	success	164	162	126	38	36	0.768	-celled,.5,0.1-0.2,0.5-1,0.5-1.5,1,1-2,1-3,1-3.5,1.5,1.5-3,1.5-4,10-20,2-5-celled,2-7,2-foliate,3-10,3-5,3-6,4,4-6,5-15,abaxially,absent,abundant,acuminate,acute,adaxially,along,anther,apex,asymmetrical,axe,barely,base,beyond,blade,branch,calyx,center,chartaceous,cm,connected,cordate,cordiform,decumbent,decurrent,densely,denser,diameter,dm,dried,eaf,edge,eglandular,equal,erect,exserted,filament,fine,flat,flower,fruit,glabrous,glandular,hair,herb,interpetalar,leaf,leaving,like,linear-lanceolate,lobe,long,lying,main,margin,material,membranaceous,mixed,mm,moderately,much-branched,nearly,notch,oblong,often,palmately,parallel,pedicel,peduncle,petiole,placenta,pubescent,rachi,radiating,raised,ridge,rotate,running,shallow,short,slightly,small,solitary,sometimes,sparsely,stamen,stem,stigma,straight,style,surface,swollen,tissue,triangular,truncate,tube,unbranched,unit,upright,vein,visible,white,woody,x	10-35,2-4,5-12,adaxiall,berry,brown,ciliate,dehiscing,drying,eed,emarginat,entire,explosively,geminat,globose,held,immature,lower,maturing,maturit,mesocarp,nfloresence,orolla,penden,per,pressure,probably,pubescen,ruit,semitransparent,tal,tamen,tem,vary,watery,wid,yellow,ympodial	anthesi,appearance,bark,bud,color,corolla,count,description,emarginate,free,geminate,growth,habitat,inflorescence,lateral,length,major,mentioned,minor,new,ovary,pendent,position,scar,seed,shape,size,structure,sympodial,tall,texture,tip,wide,width,wing,young
10	wfo-0001025760	success	210	130	105	105	25	0.5	-10,.5,/3,0.4-0.8,0.45-0.9,0.5-2,0.8-1.8,1-1.8,1-2,1-4,1.5-4.5,1.5-5,1/4-1/3,1/5,2.5-10,2.5-8,3-6,3.5-9,5-18,abaxially,acute,annual,anther,apex,apically,apparently,bark,base,blade,broad-deltate,calyx,cm,connivent,cuneate,dark,deltate,diameter,difoliate,dull,elliptic,erect,filament,flattened-reniform,flower,free,geminate,glabrescent,glabrous,herb,lateral,leaf,length,lobe,lobed,long,margin,mm,moderately,older,orange,orange-brown,ovate,pair,pedicel,perennial,petiole,porrect,primary,recurved,rounded,scar,sessile,shape,shrub,slender,sometimes,spaced,spreading,stalked,stellate,stellate-pubescent,stem,stout,straight,style,subentire,surface,tapering,terete,thick-stalked,tip,trichome,tube,unarmed,unbranched,unit,upper,variously,vein,way,weakly,white,wide,yellow,young	-12,-3,-5,-6,0-0.5,0-100,0.1,0.1-0.2,0.15-0.3,0.2-0.35,0.3-1,0.5-1.5,0.7-2.5,1,1-,1.5,1.5-2.5,1/4,1/4-1/2,2-2.5,2-3,2.1-3.5,2.3-4,2/3,3,3.5-17,5-10-merous,8-10,abaxial,acut,adaxial,almost,alyx,apar,articulated,berry,black,brow,chartaceous,concolorous,cream,cultivar,curved,discolorous,distance,drying,eaf,eed,elongating,equal,extending,fruit,fruiting,geminat,gently,green,hair,infructescence,lengt,longer,lower,marking,mature,maturity,membranous,midpoint,midvein,minute,nflorescence,often,one,open,orolla,oung,pale,peduncle,pendulous,per,perfec,pericarp,poricidal,portion,ray,red-brown,reflexe,ruit,shorter,side,simple,smooth,spherical,stalk,stellate-pubescen,tamen,tertiary,time,unarme,usually,various,vary,venation,visible,woody,yellow-green,ympodial	anthesi,apart,appearance,brown,bud,color,corolla,count,growth,habitat,inflorescence,major,minor,new,null,ovary,position,seed,size,stigma,structure,sympodial,texture,width,wing
11	wfo-0001025782	success	200	168	143	57	25	0.715	-2,.5,0-10,0.1-0.15,0.1-0.2,0.1-0.25,0.3-1,0.4-0.6,0.5-1,0.55-0.75,0.9-1.3,1,1-2,1-2.5,1-4,1.2-6,1.3-1.6,1.5-3,1/4-1/2,2-3,2-5,2-7,2.5-3.5,2/3-3/4,20,3-4,3-5,4,4.5-9,5-6.5,5-8,6-14,6-8,abaxial,abaxially,acuminate,adaxial,also,anther,apart,apex,apically,apparently,articulated,bark,base,blade,brown,calyx,chartaceous,climbing,cm,concolorous,conical,connivent,cuneate,curved,deltate,densely,diameter,difoliate,discolorous,drying,dull,eaf,elliptic,elongated,filament,flattened,flattened-reniform,flower,free,geminate,gently,glabrescent,glabrous,green-brown,hair,lateral,leaf,length,lobe,lobed,long,long-styled,longer,margin,membranous,midpoint,minute,mm,moderately,occasionally,older,one,open,orange-brown,pair,pedicel,petiole,poricidal,porrect,prickle,prickly,primary,ray,red-brow,reduced,scar,sessile,shorter,shrub,simple,spaced,sparsely,spreading,stellate,stellate-pubescent,stem,stout,straight,style,surface,tapering,terete,tertiary,time,tip,toward,trichome,tube,unbranched,unit,vein,venation,visible,way,weakly,white,wide,yellow,yellow-green,young	0-5,1-1.7,1/4-1/3,1/6,10-13,2-10,2-2.5,4-4.5,5-20,5-merous,5.5-6,acuminat,alyx,andromonoecious,apar,berry,distal,distance,eed,elongating,equal,evenly,extending,fruit,fruiting,geminat,green,hermaphrodite,heterostylous,infructescence,lengt,less,lower,lowermost,mature,maturity,midvein,nflorescence,orolla,oung,peduncle,pendulous,per,pericarp,plant,portion,prickl,ruit,short-styled,side,smooth,spherical,staminat,tamen,vary,woody,ympodial	anthesi,appearance,bud,color,corolla,count,growth,habitat,inflorescence,major,mentioned,minor,new,ovary,position,red-brown,seed,shape,size,stigma,structure,sympodial,texture,width,wing
12	wfo-0001025783	success	179	150	122	57	28	0.682	.5,0.5,0.5-1,0.5-1.5,0.8-3.5,1-1.2,1-1.5,1-3,2,2-3+,2-5,2-6.5,3-4,5,7-10,<,abaxially,acute,adaxially,along,anther,anthesi,apart,apex,axil,base,branched,branching,brown,bud,c.,calyx,cell,cluster,cm,completely,confined,conical,corolla,dendritic,densely,diameter,ellipsoid,elliptic,exposed,flattened,flexuous,flower,free,glabrous,green,greyish,groove,growth,keeled,known,lateral,lax,lobe,lobed,long,long/tall,margin,mature,midrib,midvein,minutely,mm,narrowly,near,new,obscured,obtuse,occasionally,pair,pale,pedicel,pentagonal,petiole,pitted,point,possibly,primary,pubescent,reniform,sagittate,scar,scarious,shiny,shoot,short,shrub,simple,spaced,sparse,sparsely,stem,stigma,style,surface,terminal,testal,thin,time,transparent,triangular,trichome,truncate,tube,tuft,type,uniseriate,unit,upper,vein,vine,violet,way,weak,wide,woody,yellowish	1.8-2,5-merou,abaxiall,adaxiall,alyx,ape,ark,articulated,berry,coriaceous,eaf,eed,entire,erect,expanded,exserted,filiform,fleshy,fruiting,glabrou,globose,hromosome,ilament,inserted,less,lower,minute,mmm,nflorescence,nodding,number,older,orolla,outlin,peduncle,penden,perfect,pericarp,plurifoliat,portion,purple,revolute,ripe,ruit,see,sleeve,slightly,sometimes,somewhat,stellate,strongly,suture,twinin,ud,vary,within,ympodial	3,bark,color,count,filament,habitat,inflorescence,leaf,length,major,minor,null,outline,ovary,plurifoliate,position,seed,seen,shape,size,structure,sympodial,texture,tip,twining,width,wing,young
13	wfo-0001025788	success	158	108	72	86	36	0.456	0-6,0.5-2,1-4,1-5,10-24,14-48,15-30,2-3,4-5.5,4.5-12.5,5-8,8-38,abaxially,acuminate,acute,adaxially,apex,base,blue,branched,calyx,cell,cm,connate,corolla,covering,cuneate,cyme,diameter,dichasial,dichasially,distal,ebracteate,filament,finely,flower,forked,generally,half,herbaceous,lateral,leaf,lobe,long,long-attenuate,make,mm,monochasial,mucilaginous,oblique,odd-pinnate,ovoid,pedicel,perennial,petiole,plant,pubescent,purple,rounded,seed,size,stigma,style,testal,thick,tip,tuber-bearing,typically,unit,wall,wide,yellow	-8,1.8-2.7,1.8-3.9,2-10,2-13,2-5,2.8-9.5,2m,3-,3-6-foliat,4-3.,4.5-10.1,6-7,6.2-12.5,abaxiall,acumen,apical,apically,articulate,attenuate,conical,deep,dehiscent,digestion,diminishing,dorsally,eaf,edge,eed,elliptical,emoval,enzyme,exceeding,flat,folded,globo,gradually,green,green-white,hair-like,honeycomb,interjected,introrse,leaflet,living,lon,lower,lunat,maturing,medium,narrowly,nflorescence,nther,obtuse,often,orolla,ovate,pair,pattern,peduncle,perfect,petiolule,plan,poricidally,proximal,reveal,rotate,ruit,sessile,seudostipule,short,slit,specimen,stamen,straight,subequal,subsessile,tal,tem,terminal,throughou,throughout,toward,vary,ympodial,Â¼	'hair-like,3-6-foliate,anther,anthesi,appearance,bark,bud,color,count,free,globose,growth,habitat,inflorescence,length,major,margin,mentioned,minor,new,ovary,position,scar,shape,stem,structure,surface,sympodial,tall,texture,tube,vein,wet,width,wing,young
14	wfo-0001025792	success	203	133	102	101	31	0.502	0.4-0.7,1-2,1-3,2-11,2-3.5,2.5-3.5,21-28,3-5,3.5-6,4.5-7,5-10,7-10,7.5-8,9-12,abaxially,acuminate,acute,adaxially,along,anther,apex,axillary,base,blade,blue-mauve,blue-purple,bud,cell,chartaceous,ciliate,cm,corolla,covering,dark,densely,developing,diameter,distal,distinctly,elliptic,especially,filament,flower,forked,generally,glabrous,green,green-white,hair,half,herb,lanceolate,lateral,like,lobe,make,margin,mauve,membranous,midrib,minutely,mm,mucilaginous,narrow,narrowly,oblique,odd-pinnate,ovoid,pedicel,petiole,plant,plurifoliate,puberulent,pubescent,purple,rounded,seed,semi-rosette,shortly,size,stem,stigma,streak,style,sub-rosette,subtending,tall,terminal,testal,thick,throughout,tip,tri-,tube,unit,usually,wall,wet,white,wing,x,young	1-10,1-4,10-15,2-3,2.5-4,3-4,4-12,4-6,5,5-6,5-9,5-merou,8-10,acumen,ag,alyx,apart,apparently,articulated,articulation,auriculate,axe,basiscopic,berry,broadly,brownish,capitat,condition,connivent,decurrent,digestion,distinct,dorsally,drying,eaf,edge,eed,enzyme,exceeding,except,flat,folded,fresh,fruit,geminat,glabrou,globose,greatly,greenish,hair-like,hal,high,homostylous,honeycomb-shaped,indistinct,interjected,leaflet,lengthening,living,long,lower,minute,mottle,nflorescence,often,onto,orolla,pair,papillose,peduncle,perfect,petiolulate,pore,poricidal,proximal,rachi,reduced,removed,ripe,rotate-pentagonal,ruit,semi-erec,sessile,seudostipule,short,side,slightly,slit,spaced,specimen,stamen,ste,straight,subequal,tamen,tem,tinged,vary,whitish,yellow,ympodial	'hair-like,anthesi,appearance,bark,calyx,capitate,color,count,free,geminate,growth,habitat,inflorescence,leaf,length,major,minor,mottled,new,ovary,position,scar,semi-erect,shape,specified,structure,surface,sympodial,texture,vein,width
15	wfo-0001025804	success	155	143	121	34	22	0.781	.25,.5,0.5-1,1-1.5,1-3,1.2-1.5,1.4-1.7,1.5-2,10-20,11-20,16-35,2.5-4,3-4.5,3.5-12,4-10,5,6-8,7-10,?,abaxially,acute,adaxially,anther,anthesi,apex,apiculate,attenuate,bark,base,berry,bilobed,branched,calyx,cm,conical,corolla,covered,cream,cucullate,dark,decurrent,deflexed,densely,difoliate,drying,ellipsoid,elliptic,erect,filament,flattened,fleshy,flower,free,fruiting,glabrous,glandular,globose,green,incrassate,internodal,later,lateral,leaf,light,lobe,lobed,major,many,margin,mere,minor,minute,minutely,mm,near,nearly,obovate,occasionally,often,older,onto,opposite,ovary,pair,paler,papillae,papillate,pedicel,pitted,planar,plurifoliate,projection,red,red-papillose,reddish-brown,regularly,reniform,rim,scar,sessile,shrub,size,somewhat,spaced,stem,stigma,style,surface,tall,thick,time,tip,tube,unit,vein,white,whitish-green,wing,woody,x,young	2-2.5,age,apar,ape,ba,c.,clavate,dia,differing,eaf,edicel,eed,exserted,geminat,lengthening,long,lower,main,middle,nflorescence,papillat,papillose,pore,poricidal,portion,reddish-brow,ruit,slit,strongly,tub,ud,widest,winged,ympodial	apart,appearance,bud,color,count,diameter,fruit,geminate,growth,habitat,inflorescence,length,mentioned,new,petiole,position,seed,shape,structure,sympodial,texture,width
16	wfo-0001025813	success	197	142	108	89	34	0.548	0-2,1-1.5,1-2,1-4,1.5-1.8,1.5-6.5,15-30,3-5,3-6,3-7,5-18.5,6-7,abaxially,acumen,acuminate,acute,adaxially,along,anther,apex,articulated,base,berry,blue,brownish,cell,chartaceous,ciliate,cm,condition,connivent,corolla,covering,dark,decurrent,densely,diameter,distal,distinct,drying,especially,filament,flower,fresh,fruit,glabrous,globose,green,green-white,greenish,hair,herb,lanceolate,lateral,light,like,lobe,long,longer,make,margin,membranous,midrib,minutely,mm,monochasium,mucilaginous,obtuse,odd-pinnate,orbicular,ovate,ovoid,pedicel,petiole,petiolulate,pilose,plant,plurifoliate,puberulent,pubescent,rachi,rarely,seed,sessile,short,size,species,stem,stigma,strongly,style,testal,thick,throughout,tip,tri-,tube,typically,unforked,unit,unwinged,vein,violet,wall,wet,white,whitish,x	'',0.7-1.7,1-10,1.2-4.5,1.3-7,1.5-2,2-3,2-4,2-5,3-3.5,3-4,5-6,5-merou,``,absent,ag,alyx,apart,apparently,axe,blade,borne,broadly,contracted,cuneate,decreasing,digestion,discussion,dorsally,eaf,edge,eed,elliptic,end,enzyme,exceeding,extra,flat,folded,geminat,glabrou,hair-like,half,highly,homostylous,honeycomb-shaped,interjected,larger,leaflet,lengthening,living,lower,minute,near,nflorescence,often,orolla,ovoi,pair,peduncle,perfect,pore,poricidal,removed,rosette-formin,rotate,ruit,see,seudostipule,single-flowered,singly,slit,sometimes,spaced,specimen,stamen,ste,stolo,straight,suborbicular,tamen,tem,terminal,thir,toward,tuber,vary,yellow,ympodial	'extra,'hair-like,anthesi,appearance,bark,bud,calyx,color,count,free,fruiting,geminate,growth,habitat,inflorescence,leaf,length,major,mentioned,minor,new,ovary,position,rosette-forming,scar,shape,structure,surface,sympodial,texture,third,width,wing,young
17	wfo-0001025825	success	187	139	106	81	33	0.567	0-0.21,0.4-1,1-2,1-3,1-5.5,1.1-1.4,10-24,10.5-26,2-3.7,2-5,22-86,3-10,3-5,6-10,6.6-14,abaxially,acuminate,acute,adaxially,anther,apex,asymmetric,attenuate,axillary,back,base,basiscopic,berry,blade,bud,cell,clavate,cm,coriaceous,corolla,covering,dark,decurrent,diameter,distal,eaf,filament,flower,forked,fruit,generally,glabrescent,glabrou,glabrous,green,green-white,hair,half,herb,lanceolate,lateral,leaf,light,lilac,lobe,make,medium,mm,mucilaginous,odd-pinnate,ovate,ovoid,pedicel,pentagonal,petiole,petiolulate,plant,plurifoliate,rachi,rotate-pentagonal,rounded,seed,sessile,shiny,short,side,size,slightly,stigma,streak,style,subtending,tall,terminal,testal,thick,throughout,tip,tissue,tri-,tube,unit,unwinged,usually,wall,wet,white,wide,wing,winged,x	0.4-3,0.5-0.8,0.5-10.4,0.7-2.2,0.9-2,0.9-4,14-85,3-8.5,3.7-6.5,4-8,4-9,5-10,5-7,5-merou,acumen,adaxiall,ag,alyx,apart,apparently,articulated,axe,brownish,capitat,condition,connivent,cuneate,decreasing,digestion,dorsally,drying,edge,eed,elliptic,enzyme,erec,exceeding,flat,folded,fresh,geminat,greenish,hair-like,hal,high,homostylous,honeycomb-shaped,increasing,interjected,leaflet,lengthening,living,long,lower,middle,nflorescence,orbicular,orolla,pair,peduncle,perfect,pore,poricidal,removed,ruit,seudostipule,slit,smaller,spaced,specimen,stamen,straight,subequal,subglabrou,tamen,tem,toward,vary,whitish,yellow,ympodial	'hair-like,anthesi,appearance,bark,calyx,capitate,color,count,erect,free,fruiting,geminate,growth,habitat,inflorescence,length,major,margin,mentioned,minor,new,ovary,position,scar,shape,stem,structure,surface,sympodial,texture,vein,width,young
18	wfo-0001025838	success	217	177	151	66	26	0.696	-20,0.5,0.5-1,0.7-2,1-1.2,1.2-5,1.5-1.7,1.5-2,1.5-2.5,1.5-5,1.8-2,10-15,10-60,2-5,2/3,3.5-,4-15,5,6-15,6.5-7,abruptly,acuminate,along,anther,anthesi,apart,apex,apiculate,appearing,attenuate,axil,base,black,branch,branched,broad,brown,calyx,capitate,cell,clavate,clustered,cm,corolla,cucullate,cup-shaped,dark,dendritic,dense,densely,diameter,disintegrating,drying,ellipsoidal,elliptic,extending,filament,flattened,flower,free,fruit,fruiting,glabrescent,glabrous,globose,greenish,growth,hairy,inflorescence,irregularly,keeled,lamina,lanceolate,lateral,leaf,less,like,lobe,lobed,long,many,margin,midrib,minute,minutely,mm,mostly,narrowing,narrowly,never,new,nodding,occasionally,often,onto,ovoid,pair,pedicel,petiole,pitted,platform,pointed,primary,pubescent,purple,quadrate,reddish,reniform,ripe,scar,seed,shiny,shrub,simple,sinus,slightly,small,spaced,sparsely,spreading,square,stellate,stem,stigma,style,surface,tall,terminal,testal,thin,time,tinged,tip,tree,trichome,tube,tuft,turbinate,uniseriate,unit,vein,wall,way,weight,white,wing,winged,woody,x,yellowish,Â¾	.5,1-1.5,1.5-3.5,2-2.5,2.5-3,20-40,4.5-5.5,5-merou,adaxial,adaxially,ag,alyx,archin,ark,articulated,basall,berry,connivent,decurrent,denser,eaf,eed,entire,erect,exserted,fleshy,ilament,inserted,insertion,lengthening,loosely,lower,m.,membranous,nflorescence,older,orolla,pale,papillat,papillo,peduncle,per,perfect,pericarp,plurifoliat,point,pore,poricidal,portion,revolute,ruit,shin,short,sleeve,slender,slit,sometimes,strongly,tem,thi,twinin,ud,upper,vary,yellow,ympodial	appearance,arching,bark,basally,bud,color,count,habitat,length,major,mentioned,minor,null,ovary,papillate,papillose,plurifoliate,position,shape,size,structure,sympodial,texture,twining,width,young
19	wfo-0001025845	success	180	135	102	78	33	0.567	0.3-0.5,0.4-1.5,0.5-11,0.5-2.5,1,1-2,1-4.5,1.5-13,1.5-2,1.5-7,2-15,2-5-lobed,3,3-4,4-5,4-6,abaxially,acuminate,adaxial,adaxially,along,anther,apex,base,branch,brown,calyx,cm,compressed,corolla,cuneate,dark,decurrent,deltate,diameter,distally,eglandular,ellipsoidal,especially,extra-axillary,filament,flattened,flower,fork,free,fruit,glabrous,green,greenish,herb,lateral,laterally,leaf,light,lobe,located,longitudinal,major,margin,membranaceous,minutely,mm,narrowly,obtuse,often,orange,ovoid,pedicel,peduncle,perfect,petiole,pinnately,puberulent,pubescent,purple,rachi,rugose-verrucate,sagittate,sand-punctate,shorter,shrub,side,simple,sparsely,stigma,stripe,strongly,style,subcordate,tapered,tip,triangular,truncate,tube,unbranched,unit,unlobed,vein,veiny,white,x,yellow	.5,1-1.8,1.5,1.5-2.5,2,2-3,2.5-4,3-13,3-6,3-foliat,5-6,6-6.5,6-9,7-10,abundantly,acute,aggregate,apart,apiculate,around,articulated,ascending,axe,ba,blade,cell,channe,chartaceous,connivent,cylindrical,diamete,directed,distall,divided,eaf,eed,elliptic,entire,glabrou,inserted,lobed,long,lower,mesocarp,midrib,near,nearly,nflorescence,obovate,orolla,ovate,part,patch,pore,radiu,rarely,rotate-stellate,rounded,ruit,sinus,small,spaced,stone,tal,tamen,tem,terminal,thecae,thick,tightly,time,tomento,truncat,vary,wide,yellowish,ympodial,youn	+,3-foliate,anthesi,appearance,bark,bud,channel,color,count,fruiting,growth,habitat,inflorescence,length,mentioned,minor,new,ovary,position,scar,seed,shape,size,stem,structure,surface,sympodial,tall,texture,tomentose,width,wing,young
20	wfo-0001025850	success	197	141	116	81	25	0.589	-5,-7,.5,0.5,0.5-,0.5-1,0.6-1,1,1-1.5,1-3,1.5,1.5-5,2-12,2-6.5,3-4,30,4-5,5-7,6-7,acute,along,anther,anthesi,apex,base,berry,branched,broadly,brown,calyx,capitate,cell,cm,corolla,cyathiform,deflexed,deltate,densely,denser,diameter,divaricate,drying,ellipsoid,elliptic,elongate,filament,flattened,flower,free,fruiting,glabrous,glandular,globose,green,growth,inflorescence,irregularly,lamina,later,lateral,lax,lobe,lobed,many,margin,minute,minutely,mm,narrowly,nearly,new,often,openly,orange,outline,pair,papillate-puberulent,pedicel,petiole,pinnatifid,pitted,plurifoliate,primary,pubescent,reddish,reniform,rhomboid,ripe,rounded,scar,scattered,shallowly,shrub,simple,sinuate,spaced,spreading,stem,stigma,style,surface,terminal,testal,time,tip,trichome,truncate,tube,uniseriate,unit,vein,vine,white,woody,x,young	.8,0.5-3,1-celled,15-20,2,5-merou,abaxial,ag,alyx,apar,apparently,ark,articulated,axi,basal,connivent,cupped,deciduous,divided,eaf,eed,em,entire,erect,exserted,extending,fleshy,geminat,glabrou,gland,half,halfway,ilament,leaving,lengthening,less,long,loosely,lower,membranous,midrib,nflorescence,nodding,node,occasionally,older,orolla,pale,papillo,peduncle,peg,per,perfect,planar,pore,poricidal,portion,puberulen,ruit,shiny,sinus,sleeve,slender,slightly,slit,small,sometimes,soon,splitting,spreadin,stellate,strongly,surfac,tan,thin,tiny,twinin,ud,vary,yellow,ympodial	apart,appearance,bark,bud,color,count,fruit,geminate,habitat,leaf,length,major,minor,null,ovary,position,puberulent,seed,shape,size,structure,sympodial,texture,width,wing
21	wfo-0001025872	success	160	154	137	23	17	0.856	.1,.5,0.25-0.5,0.5,0.5-1,0.6-1,1-1.3,1-1.5,1-2,1.2-1.5,1.2-1.6,1.7-3,10-25-flowered,2-2.5,2-5,2/3,3.5-4,4-4.5,4.5-13,6-10,6-8,acute,along,anther,anthesi,apart,apex,apically,auriculate,bark,base,becoming,beginning,beneath,berry,blade,branched,bright,broadly,brownish,calyx,capitate,cm,coriaceous,corolla,crinkled,crowded,cup-shaped,dark,decurrent,deeply,deflexed,dense,densely,dia,dry,elliptic,exserted,filament,flattened,flattened-reniform,flower,free,fruiting,glabrous,globose,green,greenish-tan,incrassate,irregularly,junction,later,lateral,leaf,live,lobe,lobed,long,main,margin,material,midrib,minutely,mm,narrowly,occasionally,often,older,onto,opposite,ovary,pair,paler,papillae,papillose,pedicel,petiole,pitted,planar,plant,pore,poricidal,prominent,pubescent,red-papillose,rounded,rounded-triangular,scar,several,shaped,shrub,simple,somewhat,soon,spaced,specimen,stem,stigma,style,surface,tall,tear-drop,terminal,thickened,time,tip,trichome,tube,uniseriate,unit,vein,visible,way,white,woody,x,young	1,ba,eaf,edicel,eed,fleshy,glandular-resinous,grayish-brow,inflorescenc,lon,lower,nflorescence,papillo,plurifoliat,portion,revolute,ruit,straight,tapering,thick,tub,ud,ympodial	bud,color,count,diameter,fruit,grayish-brown,habitat,inflorescence,length,major,plurifoliate,position,shape,size,structure,sympodial,texture
22	wfo-0001025893	success	157	151	127	30	24	0.809	.25,.4,.5,0.5-1.5,0.8-1,1-1.5,1-2.5,1-4,1.5-1.7,1.5-2,11-20,2-2.5,3-5,5-6,6-10,along,anther,anthesi,apex,attenuate,bank,bark,base,bearing,beginning,beneath,berry,bi-lobed,blade,branched,broadly,calyx,capitate,closely,cm,corolla,cup-shaped,decurrent,deflexed,deltoid,densely,dia,difoliate,dry,ellipsoid,elliptic,erect,even,faintly,filament,flower,free,fruit,fruiting,geminate,glabrate,glabrous,globose,golden-puberulent,gravelly,green,greyish,growing,impressed,internodal,lateral,leaf,lobe,lobed,long,long-acuminate,longitudinally,main,many,margin,minutely,mm,narrowly,nearly,obovate,occasionally,older,opposite,ovary,overlapping,ovoid-reniform,pair,papillose,pedicel,petiole,pitted,planar,pore,poricidal,red-papillose,reflexed,river,rocky,sandy,scar,shaped,shrub,slender,slightly,sometimes,spaced,specimen,stem,stigma,stream,style,surface,tall,tapering,tear-drop,time,tip,tube,unit,usually,vein,white,winged,woody,x,yellowish,young	1-1.2,2-3,accrescent,barely,brownish-green,eaf,early,eed,exserted,inflorescenc,lon,lower,material,middle,nflorescence,pale,papillo,plurifoliat,portion,puberulent,ruit,straight,striat,thickened,trichome,ud,unicellular,visible,widest,ympodial	appearance,bud,color,count,diameter,growth,habitat,inflorescence,length,major,minor,new,null,plurifoliate,position,seed,shape,size,striate,structure,sympodial,texture,width,wing
23	wfo-0001025896	success	146	130	94	52	36	0.644	-3,-30,.5-2.5,0.5,0.5-2,1-1.5,1-3,1-8,2-14,2.5-14,4,4-12,4-23,4-5,5-15,5-7,6-10,6-13,7-,abaxial,abaxially,acuminate,adaxially,also,angled,apex,base,blade,brownish,calyx,chartaceous,cm,connivent,constricted,cuneate,cylindrical,deltate,densely,diameter,eglandular,elliptic-ovate,especially,flower,forked,fruit,glabrous,gland,globose,hair,inflated,like,lobe,long,margin,membranaceous,mm,moderately,near,nearly,obtuse,often,orange,ovate,pale,pedicel,petiole,puberulent,pubescent,purple,red,ripe,rugose,short-stalked,shrub,simple,smooth,sparsely,stalked,stem,stigma,style,subcordate,surface,time,tip,triangular-ovate,triangular-subulate,tube,unbranched,unit,vein,white,wide,x	1-25,1-6.5,1.5-2,1.5-9,10-15,10-25,2-2.5,2.5-5,4-6,7743,absen,acosta,acute,adaxiall,aggregate,apart,articulated,axe,ba,branched,cell,dendritically,directed,distall,eaf,eed,entire,greenish,lower,many-foliat,nflorescence,nther,occasionally,orolla,peduncle,perfect,pore,present,pubescen,rachi,radiu,rotate-stellate,ruit,solÃ­,spaced,stone,tal,tem,truncat,vary,yellow,ympodial	anther,anthesi,appearance,bark,bud,color,corolla,count,filament,free,fruiting,growth,habitat,inflorescence,lateral,leaf,length,major,many-foliate,mentioned,minor,new,ovary,position,scar,seed,shape,size,structure,sympodial,tall,texture,truncate,width,wing,young
24	wfo-0001025902	success	211	158	131	80	27	0.621	.2,/2,0.1-0.5,0.5-2,1-1.5,1.2-1.5,1.5-3,11-15,1983,2-6,2.5-4,3-10,4,4-13,4-5,4-6,8-15,8-9,abaxially,accompanied,acute,adaxially,aid,along,always,anther,anthesi,apex,attenuate,bark,base,becoming,berry,black,branched,broadly,cabrera,calyx,clavate,cm,completely,conical,corolla,deltate,densely,diameter,dull,either,ellipsoid,entire,fide,filament,flattened-reniform,flower,free,fruiting,glabrous,globose,green,growth,inflorescence,lanceolate,lateral,leaf,leaf-opposed,length,less,linear,lobe,lobed,low,margin,markedly,mature,minute,minutely,mm,new,occasionally,often,one,ovary,pair,pale,papillose,pedicel,petiole,pitted,plurifoliate,prominent,pubescent,ridged,rounded,scar,scattered,scrambling,semi-circular,shallow,simple,sometimes,soon,spaced,stem,stigma,strongly,style,surface,tangled,tapering,terminal,time,tip,trichome,tube,twining,ultimate,uniseriate,unit,usually,vegetation,vein,vine,violet,water,way,whitish,widely,wing,woody,x,yellowish	.5,0.5-2.5,1-1.2,1.5,1.5-2,1/3,40,5-6,5-merou,8-10,>,absent,ag,alyx,apar,ark,articulated,axi,beginning,berr,branch,branching,c.,cell,chartaceous,circular,climbin,connivent,deciduou,eaf,eed,except,exfoliatin,exserted,fleshy,geminat,ilament,leaving,lengthening,long,loosely,lower,midvei,nflorescence,obscured,older,orolla,papillat,peduncle,peg,pendant,per,perfect,pericarp,planar,pore,poricidal,portion,primary,revolute,rotate-stellate,ruit,semi-aquati,sleeve,slender,slit,small,somewhat,sparsely,spreading,tem,testal,thin,ud,vary,weak,weight,yellow,ympodial,Â½	apart,appearance,bud,climbing,color,count,deciduous,description,exfoliating,fruit,geminate,habitat,major,mentioned,midvein,minor,papillate,position,seed,semi-aquatic,shape,size,structure,sympodial,texture,width,young
25	wfo-0001025906	success	188	144	110	78	34	0.585	0-14,0.1-2,0.20-0.60,1-2,1-3,16-51,2-4.4,2-6,3-10,4-12,4-5,5.2-9,8-16,8.5-12.5,abaxially,acumen,acute,adaxially,anther,apex,axillary,base,berry,blue,brownish,bud,cell,clavate,cm,condition,connivent,coriaceous,corolla,covering,cuneate,dark,decurrent,delimited,diameter,distal,dorsally,drying,edge,filament,flat,flower,folded,forked,fresh,fruit,generally,glabrous,globose,green,greenish,hair,half,herb,lanceolate,lateral,leaf,light,lilac,linear,lobe,long,make,mm,mucilaginous,obtuse,odd-pinnate,ovoid,pedicel,petiole,plant,plurifoliate,pubescent,purple,rachi,ripe,seed,sessile,shiny,short,size,slightly,sparsely,stigma,stripe,style,sub-glabrous,subglabrous,subtending,tall,terminal,testal,thick,tip,tri-,tube,unit,unwinged,usually,wall,well,wet,white,whitish,width,x	0.15-0.6,0.2-0.6,1-6,1.1-2,1.6-12.4,1.8-4.8,2.6-5.2,3-5,4-10,4-7,5-6,5-7,5-merou,adaxiall,ag,alyx,apart,apparently,articulated,axe,blade,capitat,decreasing,decurrency,digestion,diminishing,eaf,eed,enzyme,erec,exceeding,falcate,first,geminat,glabrou,green-white,hair-like,hal,high,homostylous,honeycomb-shaped,interjected,leaflet,lengthening,living,lower,next,nflorescence,orolla,pair,peduncle,pentagonal,perfect,pore,poricidal,removed,rotate,ruit,second,seudostipule,slit,smaller,spaced,specimen,stamen,straight,subequal,subglabrou,tamen,tem,third,throughout,toward,typically,vary,wood,yellow,ympodial	'hair-like,anthesi,appearance,bark,calyx,capitate,color,count,erect,free,fruiting,geminate,growth,habitat,inflorescence,length,major,margin,mentioned,minor,new,ovary,position,scar,shape,stem,structure,surface,sympodial,texture,vein,wing,woody,young
26	wfo-0001025907	success	148	148	120	28	28	0.811	.05,.5,.5-1,0-60,0.8-1.8,1,1-1.2,1-2.3,1-3,1-5,1.5-2,1.5-2.2,10-15,12-45,2,2-3.5,3-,3-4,3/2,4-5,5-15,acuminate,acute,along,anther,anthesi,anticlinal,apex,attenuate,axillary,base,bearing,berry,brown,c,calyx,cell,cm,conical,conspicuously,deciduous,densely,diameter,elliptic,epidermal,filament,flattened,flower,free,fruit,fruiting,glabrous,globose,green,greenish,growth,highly,included,iquito,irregular,isolated,lamina,lobe,lobed,long,margin,minutely,mm,near,nearly,new,obovate,open,ovary,ovoid-reniform,pair,papillose,pedicel,petiole,plant,population,poricidal,portion,primary,projection,pubescent,raised,red-papillate,reflexed,remaining,round,rugose,scar,scattered,seed,shrub,simple,single-stemmed,sinuous,size,slender,soon,sparsely,stigma,style,surface,thickening,time,tip,trichome,truncate,tube,uniseriate,unit,variable,vein,white,white-lenticellate,without,x	-4,0,2-8,2/3,absent,anthesis5-7,appearing,axil,beak,breaking,clavat,eaf,edicel,eed,erec,lon,lower,nflorescence,occasionally,papillate,per,ruit,tal,tem,tub,ud,unifoliat,ympodial	5-7,appearance,bark,bud,clavate,color,corolla,count,erect,habitat,inflorescence,lateral,leaf,length,major,minor,null,position,shape,stem,structure,sympodial,tall,texture,unifoliate,width,wing,young
27	wfo-0001026203	success	197	155	122	75	33	0.619	0-39,0.06-0.86,0.3-11,0.3-6,0.4-3,0.5-2.3,0.7-2.6,1-2,1-9,2-10,2-4.9,2-43,2-5,2.2-13.3,3-10,3.2-22,3.2-23,7-47,abaxially,acumen,acuminate,acute,adaxially,along,anther,apex,arranged,asymmetric,attenuate,axillary,base,basiscopic,bead,berry,blue,bud,cell,clavate,cm,connivent,corolla,covering,dark,decurrent,deep,diameter,distal,erect,filament,flower,forked,fruit,generally,glabrescent,glabrous,globose,green,green-white,hair,hair-like,half,herb,lanceolate,lateral,leaf,light,like,lilac,linear,lobe,long,make,medium,mm,moniliform,mucilaginous,multiple,necklace,odd-pinnate,orbicular,ovate,ovoid,pedicel,pentagonal,petiole,plant,plurifoliate,rachi,ripe,rotate,rounded,seed,sessile,short,side,size,slightly,sometimes,stigma,stolon,stripe,style,subtending,tall,terminal,testal,thick,throughout,tip,tissue,tri-,tube,tuber,typically,unit,unwinged,usually,wall,wet,white,wide,x	0-7,0.38-11.3,0.5-3.2,1-13,1-4,1-5,1.1-7.9,1.2-5.5,2-8.5,3-11,3-5,5-merou,ag,alyx,apart,apparently,articulated,axe,blade,brownish,capitat,condition,coriaceous,decreasing,digestion,dorsally,drying,eaf,edge,eed,elliptic,enzyme,exceeding,flat,folded,fresh,geminat,glabrescen,glabrou,greenish,hal,high,homostylous,honeycomb-shaped,interjected,leaflet,lengthening,living,lower,middle,nflorescence,orolla,pair,peduncle,perfect,pore,poricidal,removed,rosett,ruit,seudostipule,slit,spaced,specimen,stamen,straight,subequal,subglabrous,tamen,tem,toward,vary,whitish,yellow,ympodial	anthesi,appearance,bark,calyx,capitate,color,count,free,fruiting,geminate,growth,habitat,inflorescence,length,major,margin,minor,new,null,ovary,position,rosette,scar,shape,stem,structure,surface,sympodial,texture,vein,width,wing,young
28	wfo-0001026208	success	214	172	146	68	26	0.682	-5,.5,/3,0,0-20,0.1,0.1-0.2,0.1-0.25,0.1-0.3,0.5-0.8,0.5-1.2,0.6-0.8,0.8-1.3,0.8-1.5,1-2,1-5,1.5,1.5-2.5,1.8-2.3,1.8-2.5,1/4-1/6,11-25,2,2-3,2.5-6,3-5,3-6,3.5-5,4-9,5-,5-17,5-22,6-8,abaxial,abaxially,acuminate,acute,anther,apex,apically,apparently,bark,base,becoming,berry,blade,branched,bright,calyx,cm,connivent,cuneate,dark,deltate,densely,diameter,difoliate,dull,elliptic,elongated,erect,evenly,filament,flattened-reniform,flower,free,fruit,fruiting,geminate,glabrescent,glabrous,gray-greenish,green,lateral,leaf,length,lobe,lobed,long,longer,lower,margin,maturity,mauve,midpoint,mm,moderately,older,orange,orange-brown,ovate,pale,pedicel,pendulous,per,petiole,poricidal,porrect,prickle,prickly,ray,recurved,red,rounded,scar,sessile,shorter,shrub,side,slender,sometimes,somewhat,sparsely,spherical,spreading,stalk,stalked,stellate,stellate-pubescent,stem,stout,straight,style,subentire,surface,tapering,terete,terminal,tertiary,time,tip,toward,trichome,tube,unarmed,unit,variously,vein,venation,visible,way,white,wide,woody,yellow,young	-1/2,-10,-3,0-4,0-5,0-8,0.6-0.9,0.7-2,1-4,1/3,1/4-1/3,2-20,2-4,2.5-5,3-30,3/,4-7,5,5-merous,6-22,acut,adaxial,alyx,apar,apart,articulated,broad-deltate,brown,chartaceous,conical,curved,discolorous,distance,drying,eaf,eed,elongating,equal,extending,flattened,geminat,green-brown,infructescence,mature,membranous,midvein,nflorescence,one,open,orolla,oung,pair,peduncle,perfec,pericarp,portion,primary,pubescent,red-brow,ruit,smooth,spaced,straw-yellow,tamen,unarme,usually,vary,ympodial	3/4,anthesi,appearance,bud,color,corolla,count,growth,habitat,inflorescence,major,mentioned,minor,new,ovary,position,red-brown,seed,shape,size,stigma,structure,sympodial,texture,width,wing
29	wfo-0001026215	success	150	146	118	32	28	0.787	-3,.5,0,0.05,0.5-1,1,1-3,1.5,1.5-2,1.5-2.2,13-35,15-2,18-20,2-3,2-3.5,2-4,3/4,4-15,4-5,7-8,abaxially,abruptly,absent,acuminate,anther,anthesi,anticlinal,apex,axillary,base,beak,berry,broadly,calyx,cell,clavate,cm,conical,conspicuously,continually,corolla,deltate,densely,diameter,elliptic,enlarged,epidermal,erect,filament,flattened-round,flower,free,fruit,fruiting,glabrous,globose,green,herb,highly,internode,irregular,length,less,lobe,lobed,long,markedly,minutely,mm,narrowing,nearly,nodding,occasionally,often,onto,ovary,ovoid-reniform,pair,papillate,pedicel,petiole,poricidal,portion,primary,projection,purple,raised,red-papillose,reflexed,rounded,rugose,scar,seed,shrub,simple,single-stemmed,sinuous,small,stem,stigma,strongly,style,surface,thickening,time,tip,tube,unit,usually,vein,way,white,white-lenticellate,wide,wing,winged,without,x	.05,2,along,ape,axil,bifi,brown,completely,eaf,edicel,eed,entire,exserted,greenish,horizontal,kink,lower,marked,nflorescence,noddin,papillae,papillat,per,ruit,shortsympodial,ste,tal,tem,tub,ud,unifoliat,white-pubescent	appearance,bark,bifid,bud,color,count,description,growth,habitat,inflorescence,lateral,leaf,major,margin,mentioned,minor,new,position,shape,short,size,structure,sympodial,tall,texture,unifoliate,width,young
30	wfo-0001026229	success	299	263	228	71	35	0.763	0.35,0.3â0.9,0.3â1.2,0.4,0.8â1.2,0.8â2,0.9â4.3,1,1.2â4.8,1.3â1.7,1.4,1.7â11.8,1.8,1.8â5.5,1.9â2.5,1/3,13,1â2,1â4,2,2â3,2â3-celled,2â4-celled,3,3â4,3â5,4.5â6.5,4â6,5,5â9,6â15,6â8,8.6â12,8â10,abaxial,abaxially,accrescent,acuminate,acute,adaxially,almost,also,always,anther,anthesi,apex,associated,asymmetric,attenuate-caudate,barely,base,beneath,berry,black,blade,branch,branching,broadly,broken,brown,calyx,camptodromous,capitate,celled,central,changing,clavate,cm,commonly,completely,concentrated,connivent,cordate,corolla,covered,creating,cuneate,cyme,dark,deltoid,densely,developed,diameter,differing,diÂ­,dried,drying,eglandular,ellipsoidal,elliptic,elongated,even,few-rayed,flattened,flower,found,free,frequently,fruit,fully,geminate,glabrescent,glabrous,gland,glandular,globose,green,growth,hair,head,hirsute,hispid,hyaline,immature,impressed,included,inflorescence,insertion,internodal,involute,irregular,lamina,lanceolate,larger,lateral,leaf,less,lobe,lobed,long,long-stalked,longer,mainly,margin,material,mature,midvein,mixed,mm,moderately,much,multangulate,multangulate-stellate,multiseriate,narrow-ovate,narrowly,near,nearly,new,oblong,often,old,one,open,orientation,other,ovate,ovate-elliptic,pair,paired,pale,papillose,pedicel,petiole,pit,plurifoliate,point,poorly,porrect-stellate,primary,pubescent,purple,rachi,raised,rarely,ray,remnant,reniform,rounded,secondary,sessile,shiny,short-,short-stalked,shorter,shrub,simple,size,slightly,small,smaller,solitary,sometimes,somewhat,sparsely,spread,spreading,stalk,stellate,stem,stigma,strongly,style,subopposite,subsessile,supported,surface,terminal,tree,trichome,trifoliate,tube,tuft,type,unbranched,unit,upper,usually,vein,venation,vestiture,visible,white,whitish-green,wide,yellow,yellowish-white,Â¾	0.1â1.47,0.2â0.8,0.9,1-celled,1.3â1.5,1.7â2.3,1â1.4,2.3â3.4,2.8â4,35,5-merou,6â7,9â31,adaxial,adaxiall,ag,alyx,ark,articulated,axe,ba,commentary,cylindrical,develope,directed,discolorous,eaf,eed,entire,faces,fresh,glandular-capitate,golden,ilament,introrsely,like,longitudinal,lower,maturit,membranaceous,midpoint,midri,minute,nflorescence,older,opening,orolla,oung,peduncle,pedunculate,per,perfect,pink,pore,poricidal,portion,purplish,ra,revolute,ruit,see,shin,slit,spreadin,surfac,three,ud,unequal,vary,weakly,ympodial	--,1.3,1.5,2.8,4,4.5,6,6.5,7,appearance,bark,bud,color,count,filament,fruiting,habitat,length,major,maturity,midrib,minor,null,ovary,position,scar,seed,shape,structure,sympodial,texture,tip,width,wing,young
31	wfo-0001026230	success	144	136	114	30	22	0.792	.25,.5,.8,0.3-1.5,0.5-3,0.9-2,1-1.4,1-1.5,1-4,1.8-2.3,1.9-4.1,12.6-20.8,2-4,2-5,3-4,4.6-9.3,5-10,5-20-flowered,acuminate,acute,anther,anthesi,apart,apex,apiculate,area,back,bark,base,beneath,berry,broadly,bud,calyx,clavate,cm,cordate,corolla,deltoid,dia,difoliate,elliptic,erect,evenly,filament,free,fruit,fruiting,geminate,glabrous,globose,green,grey,large,lateral,leaf,lobe,lobed,long,long-acuminate,long-triangular,main,major,margin,minor,minutely,mm,nearly,older,opposite,orbicular,ovary,ovoid,pair,papillose,pedicel,petiole,pore,poricidal,portion,raised,reflexed,rounded,rusty-papillose,scar,shaped,shrub,simple,sinus,slender,slightly,small,spaced,stem,stigma,straight,strongly,style,surface,tall,tapering,tear-drop,thickened,tip,tree,tube,unit,unknown,vein,white,winged,woody,x,young	0.75-1,1.1-1.8,anisomorphic,anisophyllou,appears,beginning,clu,completely,coroll,deflexed,distal,eaf,edicel,eed,enclosing,except,immature,inflorescenc,lon,lower,middle,nflorescence,obtuse,pointed,ruit,ud,umbonate,white-lenticellat,widest,ympodial	anisophyllous,appearance,club,color,count,diameter,flower,growth,habitat,inflorescence,length,new,position,seed,shape,size,structure,sympodial,texture,white-lenticellate,width,wing
32	wfo-0001026233	success	165	149	113	52	36	0.685	-1,-1.9,-3.8,-5.5,-8.1,.25,0.7-,0.7-0.8,0.8-1.3,0.8-1.55,0.8-4,1,1-,1.1,1.5,2,2-,2.1,2.3-7,2.4-3.5,2.6,3.2-3.7,3.2-4.7,3.5-4.5,4-,5-6.2,6,abundant,acute,annual,anther,antrorse,apex,base,bearing,berry,broadly,calyx,campanulate,capitate,cm,coat,conspicuous,cuneate-attenuate,densely,diameter,ellipsoidal,elliptic,entire,evident,few-,filament,fruiting,glabrous,globose,herb,herbaceous,interlobular,investing,larger,leaf,less,lilac,lobe,lobed,long,longitudinally,margin,membrane,minutely,mm,moderately,narrowly,non-glandular,obtuse,outer,ovate,pale,papery-scarious,partially,petiole,protuberance,pubescent,reticulate,ridged,rounded,scarcely,seed,serrate,shorter,simple,slender,slightly,small,smaller,sparsely,stigma,style,subglobose,surface,tip,trans-ovoidal,trichome,tube,tuberculate,unequal,unifoliate,uniseriate,unit,wider,winged,x,yellow	-50,.75,0.3,0.5,1.2-2.7,1/2,2/3,5-30,accrescent,ag,annular,articulated,ascending,basal,curved,cylindrical,difoliat,dimorphic,eaf,eed,embryo,hair,hig,lamina,longitudinal,lower,multicellular,near,occasionally,opening,orolla,other,ovule,pinnatipartite,pinnatisect,pore,poricidal,portion,present,pubescen,ree,ruit,seede,slit,striate,strongly,styl,tem,vary,venatio,verrucose,ympodial	anthesi,appearance,bark,bud,color,corolla,count,difoliate,flower,free,fruit,growth,habitat,inflorescence,lateral,length,major,minor,new,null,ovary,pedicel,position,scar,seeded,shape,size,stem,structure,sympodial,texture,vein,venation,width,wing,young
33	wfo-0001026241	success	220	188	163	57	25	0.741	.3,.5,0.1â0.15,0.3â,0.3â0.4,0.3â1,0.5,0.5â0.7,0.5â0.8,0.5â1,1-,1-celled,1.2â1.5,1.5â1.7,1.5â2.5,1.5â3.5,1/3â1/2,109,1â,1â1.1,1â1.4,1â1.5,1â2,2-flowered,2â3,3,3-,30â50,4-,4.5â5,5,5-celled,6,abaxially,adaxially,anther,anthesi,apex,appearing,appears,basal,base,basiscopically,beak,berry,black,branching,brittle,broader,brown,calyx,campanulate,capitate,cell,center,cm,conical,cordate,corolla,covered,cup,curving,darker,decurrent,deltate,densely,denser,depressed-globose,dia,difoliate,dry,drying,dwarf,eglandular,elliptic,erect,et,extended,filament,flower,free,fruit,fruiting,galiano,geminate,gland,glandular,glandular-pubescent,globose,herb,inflorescence,internodal,larger,lateral,leaf,leaflet,like,lobe,lobed,long,main,margin,midvein,mixture,mm,much,near,oblique,one,open,orangish,outline,ovary,ovate,ovoid,papillate,pedicel,perennial,petiole,pinnatifid,pitted,prolonged,pubescent,pulp,rachi,remain,reniform,robust,seed,shallowly,shiny,simple,sinuate,slightly,small,smaller,sometimes,somewhat,spatulate,stem,stigma,style,subshrub,surface,taproot,ternate,thickened,tip,triangular,trichome,truncate,tube,tuberculate,uniseriate,unit,usually,vein,way,white,wide,wing,woody,x	.2,0.2â,0.3â0.6,0.7â1.1,1.2â2,1.9â2.1,10-20,2.5â3,2â2.1,3â3.1,5-merous,always,apical,articulated,attenuate,ba,connecting,curved,deflexe,dehiscing,discrete,eaf,enclosed,entire,equal,erose,foliat,foliose,glabrous,intially,irregularly,lon,longitudinal,nflorescence,onto,papillat,peduncle,per,perfect,pericarp,pore,portion,pubescen,ruit,slit,stamen,stellate,stout,strongly,succulent,sulcate,terminal,testa,thick,tissue,ud,ympodial	2,appearance,bark,bud,color,count,deflexed,diameter,foliate,growth,habitat,length,major,mentioned,minor,new,position,scar,shape,size,structure,sympodial,texture,width,young
34	wfo-0001026242	success	210	158	132	78	26	0.629	-0.9,/4,0.05-0.2,0.1,0.35-,0.4-0.5,0.4-0.55,0.5,0.5-0.7,0.5-1,0.7-1.3,1-1.5,1-2.5,1.2-2,1.5-3,1.5-4,1/2,10-,10-20,2-5,3-6.5,30-80,4-10,4.5-5.5,5-,5-7,6.5-8,7-17,8-20,abaxially,acute,almost,ame,anther,apart,apex,apparently,bark,base,branched,bright,c.,calyx,cm,concolorous,connivent,cuneate,curved,deltate,densely,diameter,difoliate,drying,dull,elliptic,erect,evenly,filament,filiform,flattened,flattened-reniform,flower,free,fruit,fruiting,glabrescent,glabrous,glandular,green,hair,lateral,leaf,length,lobe,lobed,long,margin,maturity,midpoint,minute,mm,moderately,multangulate,narrow-deltate,occasionally,orange-brown,pair,pale,pale-brown,pedicel,petiole,porrect,prickle,prickly,ray,red,red-brown,reflexed,scar,sessile,shorter,shrub,simple,sometimes,spaced,sparsely,spherical,spreading,stalk,stalked,stellate,stellate-pubescent,stem,straight,style,surface,tapering,terete,tip,trichome,tube,unit,upper,variously,vein,way,weakly,white,wide,woody,yellow,young	-1.5,-2,-5,-6,0,0-2,0.3-0.5,0.4-2,0.55-0.9,0.7,1-3,1/5-1/3,1/6-1/4,2-2.5,2.5-2.8,2.5-4.5,4-13,4-5-merous,5-18,abaxial,acut,alyx,apar,apically,articulated,berry,blade,broad-deltate,distance,eaf,eed,elongating,equal,extending,eye,geminat,glabrou,green-gra,infructescence,irregularly,largely,longer,lower,mature,membranous,midvein,naked,nflorescence,obtuse,older,one,open,orolla,oung,peduncle,per,perfec,pericarp,poricidal,portion,prickl,primary,recurved,rounded,ruit,shorte,side,smooth,subentire,tamen,tertiary,time,unarme,unarmed,vary,venation,visible,ympodial	anthesi,appearance,bud,color,corolla,count,geminate,green-gray,growth,habitat,inflorescence,major,minor,new,null,ovary,position,seed,shape,size,stigma,structure,sympodial,texture,width,wing
35	wfo-0001026259	success	233	155	124	109	31	0.532	0.1â0.2,0.3â1.2,0.4â0.6,0.7â0.9,0404,1-celled,1.0â1.2,1.2â8.4,1.4â4.0,1.5â2.0,1â3-celled,2-ridged,2/3,2â17,6,7â10,?,abaxially,acuminate,acute,adaxially,affected,anther,anthesi,apex,appressed,base,berry,broadly,brown,calyx,cell,central,cm,coloured,concave-reniform,conical-ellipsoid,corolla,decurrent,deltate,diameter,difoliate,ellipsoid,end,especially,et,filament,flower,free,fruit,fruiting,glabrous,globose,green,green-orange,halfway,inflorescence,internodal,knapp,lateral,leaf,length,less,like,lilac,lobe,lobed,long,margin,minutely,mm,much,narrower,near,nearly,node,often,once-branched,one,outline,ovary,ovate-lanceolate,pair,papillate,pathogen,pedicel,pentagonal,petiole,primary,pubescent,purple,purple-black,purple-coloured,rarely,reduced,ripe,rounded,scar,shorter,simple,slightly,sparsely,star,stem,stigma,style,surface,testal,tip,toward,translucent,trichome,tube,turning,uniseriate,unit,vein,white,wide,winged,woody,yellow,yellow-green,young	.1,.7,.8,0.2â0.4,0.5,0.5â0.6,0â2,1,1.0â3.3,1.5,11â22,12â24,1m,1â2,1â2-celled,2â3-celled,3.0â3.4,35â45,4â5,5-merous,5â14,5â7-celled,8â11,abaxial,adaxial,age,apar,arising,becoming,beyond,branch,branched,branching,close,cone,congested,cream-coloured,cylindrical,dehiscing,densely,drop,eaf,eed,elongating,entire,exerted,fleshy,geminat,gradually,growt,herb,hilum,individual,larger,leave,lengthening,live,lon,longer,lower,lowermost,membranous,narrowly,nflorescence,occasionally,pale,peduncle,per,perfect,pericarp,plant,pore,poricidal,portion,positioned,rachi,recurving,reflexed,relatively,remaining,ruit,shiny,short,shrub,similar,slit,smooth,sometimes,somewhat,spaced,splitting,spreading,stellate,stone,stout,straight,strongly,sub-laterally,tall,tapering,tem,thick,tightly,tinged,together,two,ud,ympodial,â15	-15,1-3-celled,11-22,12-24,2-3-celled,4-5,5-14,5-7-celled,appearance,bark,bud,color,count,description,explicitly,geminate,growth,habitat,major,mentioned,minor,new,position,seed,shape,size,structure,sympodial,texture,width,wing
36	wfo-0001026267	success	162	154	132	30	22	0.815	.25,.5,0.5-1,0.6-1.7,0.7-1.1,1-1.2,1-1.5,1-2.6,1-4,1.5-2,1.5-2.3,2.5-3,3-15,3-6.1,3.2-8.6,4-8,5-7,8-10,8.5-15,acuminate,acute,anther,anthesi,apex,attenuate,axil,bark,base,beginning,beneath,berry,blackish,body,bright,broadly,calyx,closely,cm,corolla,crateriform,cuneate,decurrent,deflexed,depressed,dia,difoliate,distinct,drying,except,filament,flattened-reniform,free,fruiting,glabrous,globose,green,greenish-white,hard,incrassate,larger,lateral,lavender,leaf,lobe,lobed,long,main,major,margin,maturity,middle,minor,minutely,mm,narrowly,nearly,occasionally,often,opposite,ovary,ovate,overlapping,pair,pale,papillose,pedicel,petiole,pitted,pitting,pore,poricidal,quickly,raised,reflexed,remaining,ripening,rough,scar,scattered,shaped,shrub,simple,size,slightly,small,softening,spaced,stem,stigma,style,surface,tall,tan,tear-drop,tinge,tip,tree,triangular,trichome,tube,tuft,uniseriate,unit,vein,white,widest,wing,winged,woody,x,yellow-green,young	0.1-1,20-30-flowered,ba,densely,differing,distally,eaf,edicel,eed,exerted,geminat,greyish-green,inflorescenc,lon,longinflorescence,lower,older,one,papillo,portion,pubescent,ruit,scarious,slender,soon,sparsely,straight,tapering,ud,ympodial	20-30,appearance,bud,color,count,diameter,flower,fruit,geminate,growth,habitat,inflorescence,length,mentioned,new,position,seed,shape,structure,sympodial,texture,width
37	wfo-0001026279	success	248	170	147	101	23	0.593	-4,-5.9,/14-1/8,0.2-0.4,0.8-2.3,1-3.5,1.1-1.9,1.5-3,1.7-2.3,1.9-3,1/2,14-27,2.5-3.2,2.6-4.8,2/3,3-4,3.4-5.2,3.5-7.8,3.8-5.1,4-7.5,5-200,5-8,8-11,9-22,abaxially,acuminate,acute,adaxially,anther,anthesi,apex,appearing,appressed,attenuate,axillary,base,black,blade,blunt-tipped,branch,branched,brown,bud,calyx,capitate,chartaceous,cm,corolla,cuneate,dark,deltoid,dendritic-echinoid,dense,diameter,drying,due,echinoid,elliptic,elongated,few-rayed,filament,flower,free,fruit,fruiting,glabrescent,globose,granular,grayish,grayish-green,green,hair,immature,lanceolate,lateral,lavender,leaf,length,lilac,lobe,lobed,long,long-stalked,many,margin,mature,midrib,minute,mixed,mm,multangulate,multangulate-pubescent,narrowly,oblong,obovate,occasionally,orbicular,ovate-lanceolate,overlapping,pale,pedicel,petiole,plant,plurifoliate,porrect-stellate,present,pseudo-terminal,pubescence,reticulate-punctate,rounded,scabridulous,scabrous,semi-ovate,sessile,short,short-,short-decurrent,short-stalked,side,simple,slowly,spaced,stellate,stem,stigma,style,subcampanulate,suborbicular,sulcate,surface,thickened,time,tip,tomentose-pubescent,tube,unit,unwinged,usually,vein,way,white,whitish,wide,x,yellow,yellowish,young	-11.4,-2.9,-34.3,0.25-0.4,0.9-1,0.9-1.8,1-1.4,1-10,1.1-1.6,1.5-1.8,1.9-3.2,11.5-19.7,2.4-3.2,3.1-3.6,3.1-4.2,8,8.5-10.5,accrescent,adaxiall,ag,apart,apparently,ark,around,articulated,axe,ba,berry,closely,completely,conical,covering,cylindrical,dendritic-echinoi,directed,distally,eaf,earl,echinoi,edge,eed,entire,enveloping,equal,evident,exerted,expanded,farinose,fleshy,glabrescen,glabrous,half,inserted,lengthening,longer,longitudinal,longitudinall,lower,m.,main,multiseriate,nflorescence,occasional,often,older,open,orolla,partly,peduncle,perfect,pore,poricidal,prominent,rachi,ruit,scattered,secondary,shrub,slightly,slit,somewhat,splitting,stalk,stamen,subcoriaceous,subsessile,suture,tall,tamen,tertiary,thin,thin-stalked,tomentose,tree,ud,unarme,unarmed,upper,vary,yellowish-tan,ympodial	appearance,bark,color,count,growth,habitat,inflorescence,longitudinally,major,mentioned,minor,new,ovary,position,scar,seed,shape,size,structure,sympodial,texture,width,wing
38	wfo-0001026299	success	239	210	186	53	24	0.778	--,-0.8,-1,-10,-3.5,.5,0-8,0.1-0.2,0.1-0.4,0.1-0.5,0.2-0.25,0.25-0.5,0.5,0.5-0.6,0.5-0.7,0.5-2.5,0.8-1,0.9-1,1,1-1.4,1-celled,1.1-1.7,1.2-1.6,1.5-,1.5-2.3,1.8-2,2-4,2-6,2-foliate,2-locular,2.2-3.2,2.5-7,25,3-,3.5-10,5,5-15,5-20,6-20,7-12,abaxially,absent,abundant,acroscopically,acute,adaxially,almost,along,angled,anther,anthesi,apex,appearance,axi,basal,base,basiscopically,bract,bracteate,broadly,brown,calyx,capitate,cell,change,chota,cm,conical,corolla,could,crenate-serrate,dark,decurrent,densely,diameter,ebracteate,eglandular,elliptic,entire,erect,filament,flower,fruit,fruiting,give,glabrous,glandular,globose,green,hair-like,half,head,herb,imparipinnate,inflorescence,interjected,intermixed,internode,interrupted,investing,irregularly,jequetepeque,lacking,lanceolate,larger,lateral,leaf,leaflet,like,lobe,lobed,long,longer,loosely,margin,maturity,minute,minutely,mixture,mm,multicellular,narrowly,nearly,node,oblique,obovate,occasionally,often,outgrowth,ovary,pair,pale,patent,pedicel,peduncle,perennial,petiole,population,present,prostrate,pubescence,pubescent,purple,rachi,reflexed,regularly,rest,scattered,secondary,sessile,short,silky,simple,size,sparse,sparsely,spreading,stem,stigma,stout,straight,stripe,style,surface,tall,tertiary,testa,thick,tip,toward,trichome,truncate,tube,unicellular,uniseriate,unit,valley,variously,vein,velvety,wall,white,wide,winged,woody,yellow	-2.5,-5,0.1-0.25,0.15-0.2,0.2-1,0.3-0.4,0.4-0.5,0.4-2,0.5-1,0.6-2,0.7-3.5,0.8-0.9,1.2-5,2.5,apical,appendage,approximately,articulated,beneath,berr,column,crenat,developed,diamete,distal,eaf,edicel,eed,exserted,gree,hal,less,lon,long-acuminate,lower,maraÃ±Ã³n,middle,nflorescence,pentagonal,petiolule,primary,pseudostipule,ruit,scarcely,staminal,sterile,tem,terminal,ud,usually,way,weak-walled,ympodial	bark,berry,bud,color,count,description,free,growth,habitat,length,major,mentioned,minor,new,position,scar,seed,shape,structure,sympodial,texture,width,wing,young
39	wfo-0001026305	success	135	136	109	26	27	0.807	.25,/4,0.2-1,0.25-0.5,0.5-2,0.6-1,0.7-1,1-1.5,1.3-1.5,2-2.5,2-6-flowered,2.5-3,3-8.5,4-4.5,5-7,6-9,7-16,7-9,abaxial,acute,anther,anthesi,apex,apical,area,attenuate,bark,base,beige-tan,calyx,closely,cm,congested,conical,corolla,dark,deflexed,deltate,dendritic,densely,difoliate,drying,elliptic,filament,free,fruiting,glabrate,glabrous,globose,green,greenish-white,interlocking,knob-like,lamina,lateral,leaf,leaf-opposed,lobe,lobed,long,main,margin,middle,minute,minutely,mm,occasionally,older,ovary,ovoid-reniform,pair,pale,papillose,pedicel,petiole,pitted,planar,pore,poricidal,projection,pubescent,rounded,scar,shaped,shining,shrub,simple,slender,spaced,sparsely,stem,stigma,style,surface,tall,tan,tear-drop,tip,trichome,tube,unifoliate,unit,vein,visible,way,widest,woody,x,young	abaxially,adaxially,along,ba,berry,dia,eaf,edicel,eed,exserted,geminat,like,lon,lower,midrib,nflorescence,overlappin,portion,reddish-brow,ruit,scattered,strongly,styl,tub,ud,ympodial	appearance,bud,color,count,diameter,flower,fruit,geminate,growth,habitat,inflorescence,length,major,minor,new,null,overlapping,position,reddish-brown,seed,shape,size,structure,sympodial,texture,width,wing
40	wfo-0001026307	success	193	156	133	60	23	0.689	.0â1.2,.5,.5â4.0,0.2â0.5,0.2â1.5,0.5â5.0,0.6,0.8â2,0.8â5,1.0â1.2,1.0â1.5,1.0â2.0,2.0â3.5,2.6â13,2/3,3.5â7.0,3â8,3â8-celled,4â5.7,5â7,8â12,9,abaxially,acute,acute-acuminate,adaxially,angled,anther,anthesi,apex,appressed,base,berry,black,broadly,calyx,cell,central,clavate,cm,corolla,cuneate,cylindrical,decurrent,densely,diameter,difoliate,ellipsoid,end,eye,filament,flattened-reniform,flower,free,fruit,fruiting,glabrous,glandular,globose,green,growth,herb,hilum,internodal,lateral,length,like,lobe,lobed,long,lower,margin,minutely,mm,narrower,narrowing,new,one,outline,ovary,ovate,pair,paler,pedicel,pentagonal,per,petiole,positioned,pubescent,purple,purple-yellow,recurved,reflexed,restricted,ripe,scar,shallow,shape,shrub,simple,slightly,sparsely,spreading,ste,stem,stigma,stone,strongly,style,sub-laterally,surface,testal,three,tinged,tip,toward,translucent,triangular,trichome,tube,turning,two,unequal,uniseriate,unit,upper,vein,vigorous,weak-stemmed,white,wide,yellow,yellow-green	.3,.6,.8,0.4,0.5â0.6,0.5â0.7,0.8â0.9,1.0â2.4,1.0â2.5,1â3-celled,1â6-celled,2.0,2.0â3.0,3.0â4.0,35â45,5-merous,abaxial,adaxial,age,apar,articulated,becoming,beyond,cone,eaf,eed,entire,exerted,facing,geminat,gradually,later,lengthening,longer,membranous,middle,nflorescence,papillat,peduncle,perfect,pore,poricidal,portion,primary,reflexe,ruit,shallowly,shorter,side,slit,spaced,stellate,straight,tal,tem,ud,undulate,unevenly,variable,ympodial	appearance,bark,bud,color,count,geminate,habitat,inflorescence,leaf,major,mentioned,minor,papillate,position,seed,size,structure,sympodial,tall,texture,width,wing,young
41	wfo-0001026317	success	169	154	127	42	27	0.751	.5,0.25-1,0.3-1.2,0.5-0.6,0.5-0.8,0.5-1,0.6-,0.7-0.9,0.8-1,1-1.2,1-1.5,1-5.7,10-12,2-,2-2.5,2.5-10,3,3-foliate,3.5-15,4-5,50-200,6x,?,abaxially,absent,acuminate,acute,adaxially,anther,anthesi,apart,apex,approximately,attenuate,bark,base,berry,branched,bright,brown,calyx,capitate,clonal,closely,cm,conical,corolla,correlated,dark,deltate,dendritic,densely,diameter,distally,elliptic,entire,erect,essentially,exerted,extremely,filament,flattened,flower,found,free,fruiting,glabrous,globose,growth,inflorescence,internodal,lamina,like,lobe,longer,many,margin,maturity,minutely,mm,narrowly,new,occasionally,orange,ovary,packed,pair,papillate,pedicel,petiole,pitted,planar,plane,plant,population,pubescence,pubescent,rachi,red,reflexed,reniform,scar,shiny,shrub,simple,slightly,sparsely,stem,stigma,style,surface,swollen,terminal,time,tip,toward,triangular,trichome,tube,uniseriate,unit,variable,vein,white,woody,x,yellowish	/4,0.5,2-4,3-3.5,6-8,age,apically,dense,drying,eaf,eed,em,erec,geminat,halfwa,lengthening,less,lobed,lower,nflorescence,nodding,often,pale,papillat,peduncle,per,perfect,pericarp,pore,poricidal,portion,primary,pubescen,pulp,ruit,slit,sticky,straight,thin,ud,way,ympodial	2,appearance,bud,cell,color,count,fruit,geminate,habitat,halfway,lateral,leaf,length,major,minor,null,position,seed,shape,size,stone,structure,sympodial,texture,width,wing,young
42	wfo-0001026335	success	157	133	99	58	34	0.631	.5,.5-3.5,0.25-0.5,0.5-1,0.6-1,1-1.5,1-2,1-3,1.5-2,1.5-4,10-20,10-30,2,2-3,2-4,2-7.5,3-18,3-5,5-,5-15,5-7,abaxially,accrescent,acuminate,adaxially,anther,apex,base,blade,branched,calyx,chartaceous,cm,covering,cuneate,deltate,dense,densely,diameter,elliptic,elliptic-ovate,especially,filament,flattened,flower,forked,fruit,fruiting,geminate,glabrescent,glabrous,globose,green,hair,lanceolate,leaf,leaf-opposed,like,lobe,long,many-foliate,margin,mm,moderately,multangulate,oblong,pedicel,petiole,probably,pubescence,pubescent,reticulate,ripe,rounded,scattered,sessile,shrub,simple,slightly,stellate,stellate-pubescent,stem,stigma,style,subtending,surface,time,tip,toward,tube,unit,unripe,usually,vein,white,whitish,wide,x,yellowish	0.1-0.3,0.8-1.3,1,1-4,4-5,7-8,acute,adaxiall,ag,apart,apparently,articulated,axe,ba,capitat,connivent,curved,cylindrical,directed,distally,eaf,eed,entire,equal,erect,frui,glandula,glandular,held,large,longitudinal,lower,midpoint,much,nflorescence,often,opening,orolla,paired,peduncle,perfect,pore,rachi,ray,ruit,slit,smaller,sometimes,spaced,ste,straight,tal,tamen,tem,uprigh,vary,yellow,ympodial	1.5,anthesi,appearance,bark,bud,capitate,cell,color,corolla,count,free,growth,habitat,inflorescence,lateral,length,major,mentioned,minor,new,ovary,position,scar,seed,shape,size,stone,structure,sympodial,tall,texture,width,wing,young
43	wfo-0001026343	success	221	169	139	82	30	0.629	-15,-3.5,-4,-7,.5,/2,0.05-0.2,0.05-0.5,0.1-0.2,0.15,0.2,0.3,0.45-1,0.5-1.5,0.8-1.5,1.3-1.7,1.5-2,1.5-2.5,1.8-2.2,1/3,10-30,2-3,2-3.2,2-4,2-8,2.5-8,3-4,3.5-4.5,5-10,7-12,7-14,7-8,7-9,abaxial,abaxially,acute,adaxial,anther,apart,apex,apically,apparently,bark,base,blade,branched,broadly,calyx,cm,connivent,cream,cuneate,curved,dark,deltate,densely,diameter,dull,elliptic,erect,faint,filament,flattened,flattened-reniform,flower,free,fruit,fruiting,glabrescent,green,lateral,leaf,length,lobe,lobed,long,long-styled,longer,lower,margin,marking,mature,maturity,mauve,midpoint,mm,moderately,multangulate,narrow-deltate,orange,orange-brown,ovate,pale,pedicel,pendulous,petiole,poricidal,porrect,prickle,prickly,purple,ray,reddish,reduced,reflexed,rounded,scar,sessile,shrub,small,spaced,sparsely,spherical,spreading,stalk,stalked,stellate,stellate-pubescent,stem,style,surface,tapering,terete,tertiary,time,tip,tree,trichome,tube,unit,upper,variously,vein,venation,visible,wide,woody,yellow,young	-1,-1.5,/5,0,0-10,0-2,0-4,0-40,0-5,0.2-0.3,0.2-0.7,0.5,1-2,1-3,1-4,1.8-3,1/,1/4-2/3,1/5,2-5,2-6,2.2-3.2,3-5,5-merous,5.5-9,6-9,acuminat,alyx,andromonoecious,apar,articulated,berry,brow,chartaceous,concolorous,distal,distance,drying,eed,elongating,equal,extending,glabrous,green-brown,hermaphrodite,heterostylous,infructescence,less,lobing,lon,lowermost,midvein,nflorescence,obtuse,older,one,open,orolla,oung,pair,peduncle,per,pericarp,plant,plurifoliat,portion,prickl,primary,ruit,secondary,short-styled,side,smooth,sometimes,staminat,stout,tamen,unarmed,vary,way,weakly,ympodial	.2-3.2,acuminate,anthesi,appearance,brown,bud,cell,color,corolla,count,growth,habitat,inflorescence,major,mentioned,minor,new,ovary,plurifoliate,position,seed,shape,size,stigma,stone,structure,sympodial,texture,width,wing
44	wfo-0001026352	success	209	174	148	61	26	0.708	.3,.5,0.5,0.5-0.8,0.5-1,0.5-1.5,0.6-,0.7-2,0.9-1,1-,1-1.5,1-10,1-2-celled,1.2-1.7,1.5,1.5-2,1.5-4.6,12-60,2,2-3-celled,3-15,3.5-9,5-6,6-7,7-9,<,?,abaxially,acuminate,acute,almost,angle,anther,anthesi,antrorsely,apart,apex,appearance,arising,articulation,bark,basal,base,bending,berry,blue,branch,branching,broadly,brown,calyx,capitate-truncate,cell,cm,conical,cordate,corolla,curved,deciduous,deltate,densely,denser,diameter,ellipsoid,evenly,expanded,filament,flower,free,fruiting,giving,glabrous,globose,green,greenish,growth,herbarium,immature,impressed,inflorescence,irregularly,lamina,largest,leafy,length,like,lobe,lobed,long,many,margin,mature,minutely,mm,narrowly,nearly,new,older,outline,ovate,pair,pale,papillate,pedicel,petiole,pink,point,portion,primary,principal,pubescent,rachi,reflexed,right,scar,seen,shallowly,shoot,short,simple,spaced,specimen,spreading,stellate,stem,stigma,straw-colored,style,surface,terminal,third,time,tip,trichome,truncate,tube,tuberculate,uniseriate,unit,vein,vine,violet,weak,white,wide,widest,woody,yellowish	0.5-3,10+,4-4.5,5-merou,adaxiall,ag,alyx,apparently,articulated,axi,chartaceous,discolorous,eaf,eed,entire,eventually,exserted,few-celled,flattened,half,heigh,ilament,inflorescenc,junction,large,leave,leaving,lengthening,lower,membranous,near,nflorescence,orolla,papillo,peduncle,peg,per,perfect,pericarp,plurifoliat,pore,poricidal,reniform,rest,revolute,ruit,shiny,sleeve,slit,small,sparser,spreadin,strongly,tem,thin,tub,ud,unspecified,upper,vary,ympodial	adaxially,bud,color,count,fruit,habitat,lateral,leaf,major,mentioned,minor,null,ovary,papillose,plurifoliate,position,seed,shape,size,stone,structure,sympodial,texture,width,wing,young
45	wfo-0001026352	success	214	182	156	58	26	0.729	.3,.5,0.5,0.5-0.8,0.5-1,0.5-1.5,0.6-,0.7-2,0.9-1,1-,1-1.5,1-10,1-2-celled,1.2-1.7,1.5,1.5-2,1.5-4.6,12-60,2,2-3-celled,3-15,3.5-9,4-4.5,5-6,6-7,7-9,<,?,abaxially,acuminate,acute,adaxially,almost,angle,anther,anthesi,antrorsely,apart,apex,appearance,arising,articulation,basal,base,bending,berry,blue,branch,branching,broadly,brown,calyx,capitate-truncate,cell,cm,conical,connivent,cordate,corolla,curved,deciduous,deltate,densely,denser,diameter,ellipsoid,evenly,expanded,filament,flattened-reniform,flower,free,fruiting,giving,glabrous,globose,green,greenish,growth,herbarium,immature,impressed,inflorescence,irregularly,lamina,largest,leaf,leafy,length,like,lobe,lobed,long,many,margin,mature,minutely,mm,narrowly,nearly,new,older,outline,ovate,pair,pale,papillate,pedicel,petiole,pink,plurifoliate,point,primary,principal,pubescent,rachi,reflexed,rest,right,scar,seen,shallowly,shiny,shoot,short,simple,spaced,sparser,specimen,spreading,stem,stigma,straw-colored,style,surface,terminal,third,time,tip,trichome,truncate,tube,tuberculate,twining,uniseriate,unit,unspecified,vein,vine,violet,weak,white,widest,woody,x,yellowish	0.5-3,10+,5-merou,ag,alyx,apparently,ark,articulated,axi,chartaceous,discolorous,eaf,eed,entire,eventually,exserted,few-celled,form,geminat,half,heigh,ilament,inflorescenc,junction,large,leaving,lengthening,lower,membranous,near,nflorescence,orolla,papillo,peduncle,peg,per,perfect,pericarp,pore,poricidal,portion,revolute,ruit,sleeve,slit,small,speciman,spreadin,stellate,strongly,tem,thin,tub,ud,upper,vary,yellow,ympodial	bark,bud,color,count,fruit,geminate,habitat,height,lateral,major,mentioned,minor,null,ovary,papillose,position,seed,shape,size,stone,structure,sympodial,texture,width,wing,young
46	wfo-0001026379	success	219	219	192	27	27	0.877	-4.5,0.2-0.38,0.2-0.4,0.7-1,0.7-2.5,0.8-1.2,0.9-1.2,1-1.7,1-10,1-2,1-3.7,1.3-2.1,1.5-2.3,1.7-4.9,1.8-2.6,1.8-3.2,1.8-5,1.9-3.4,1/2,2-2.8,2-7,2.4-5.1,2.6-3.7,2.9-4,2/3,3-11,3/4,4-5,4.1-7,5.3-10.2,50-450,6-10.6,8-13,8-15,8-29,8.3-10,9-14,abaxially,accrescent,acute,adaxially,along,anther,anthesi,apart,apex,around,articulated,attenuate,axillary,bark,basal,base,berry,blade,blunt-tipped,branch,branched,brown,calyx,chartaceous,closely,cm,completely,conical,corolla,covering,cylindrical,dark,dendritic-echinoid,densely,diameter,directed,distal,distally,dried,echinoid,echinoid-pubescent,edge,ellipsoid,entire,enveloping,evident,farinose,few-rayed,filament,finely,fleshy,flower,free,fruit,fruiting,globose,granular,gray-brown,grayish,growth,hair,included,lacking,large,lateral,leaf,length,lengthening,line,lobe,lobed,long,long-attenuate,main,many,margin,mature,midrib,minute,minutely,mm,mostly,multangulate,multangulate-pubescent,nearly,oblong,obovate,obtuse,often,older,ovate,ovate-lanceolate,pale,partly,pedicel,peduncle,persistently,petiole,pitted,plant,plurifoliate,pore,poricidal,porrect-stellate,present,rachi,recent,reniform,rich,scabrous,scattered,semi-ovate,sessile,short-stalked,shrub,side,simple,size,slit,small,sometimes,somewhat,spaced,sparse,stellate,stellate-,stellate-pubescent,stellate-tomentose,stelliform,stem,stigma,style,suture,terete,testa,time,tip,tomentose-pubescent,translucent,tree,tube,uneven,unit,upper,usually,vein,velutinous-pubescent,vestigial,violet,way,whitish,whitish-brown,x,yellow,young	13,adaxiall,ag,apparently,ba,capitat,eaf,echinoi,eed,glabrous,hig,inserted,lower,m.,multangulat,nflorescence,orolla,perfect,pubescen,rather,ruit,runk,tamen,thin,ud,vary,ympodial	age,appearance,bud,capitate,cell,color,count,habitat,high,inflorescence,major,minor,new,null,ovary,position,pubescent,scar,seed,shape,stone,structure,surface,sympodial,texture,width,wing
47	wfo-0001026400	success	187	138	104	83	34	0.556	0.2-0.8,0.5-1,0.5-1.2,1-2,12-27,13-30,2-6,2-8,3.4-4.8,30-55,6-13,6-15,8-12,9-13,abaxially,acuminate,acute,adaxially,anther,apex,asymmetric,attenuate,axillary,base,basiscopic,berry,blue,bud,cell,clavate,cm,connivent,corolla,covering,dark,deep,diameter,distal,filament,finely,flower,forked,fruit,generally,glabrescent,glabrous,globose,green,green-white,hair,hair-like,half,herb,lanceolate,lateral,leaf,light,lilac,linear,lobe,make,mm,moderately,mucilaginous,odd-pinnate,ovoid,pedicel,petiole,petiolulate,plant,plurifoliate,puberulent,pubescent,purple,ripe,rounded,seed,sessile,short,side,simple,size,stigma,stripe,style,subtending,tall,terminal,testal,thick,throughout,tip,tissue,tri-,tube,typically,unit,unwinged,usually,wall,wet,white,whitish,x	0.4-1,0.7-1.1,1-10,1.3-2.6,1.7-2.2,10-18,10-28,2.4-5.9,3-6,3.5-5.9,4-7,5-7,5-merou,6.5-20,acumen,adaxiall,ag,alyx,apart,apparently,articulated,axe,blade,brownish,capitat,condition,coriaceous,decreasing,decurrent,digestion,dorsally,drying,eaf,edge,eed,elliptic,enzyme,erec,exceeding,flat,folded,fresh,geminat,glabrou,gree,greenish,hal,high,homostylous,honeycomb-shaped,interjected,leaflet,lengthening,living,long,lower,nflorescence,orbicular,orolla,ovate,pair,peduncle,pentagonal,perfect,pore,poricidal,removed,ruit,semi-stellate,seudostipule,slightly,slit,spaced,specimen,stamen,straight,subequal,tamen,tem,toward,vary,yellow,ympodial	anthesi,appearance,bark,calyx,capitate,color,count,erect,free,fruiting,geminate,growth,habitat,inflorescence,length,major,margin,mentioned,minor,new,ovary,position,scar,shape,stem,stone,structure,surface,sympodial,texture,vein,width,wing,young
48	wfo-0001026406	success	219	138	110	109	28	0.502	.5,0.4-0.9,1-2,1.3-1.5,1.8-2.4,1/4,1/4-1/2,1/4-1/3,12-19,2-3,2-6,2.5-8,20-60,3-10.5,5-6,5-8,6-12,6-15,7-10,9-15,abaxially,acute,anther,apex,apically,apparently,bark,base,branched,broad-deltate,calyx,cm,connivent,cordate,cream,dark,deltate,densely,diameter,dirty-whitish,elongating,erect,filament,flattened-reniform,flower,foliaceous,free,fruit,fruiting,fully,green,herb,lateral,leaf,length,lobe,lobed,long,long-styled,margin,marking,mature,maturity,mauve,midvein,mm,oblong,obtuse,opening,orange-brown,ovate,pair,pale,pedicel,petiole,poricidal,porrect,prickle,prickly,purple,red-brown,reflexed,scar,short-styled,shrub,sparsely,spherical,spreading,stalked,stellate,stellate-pubescent,stem,style,surface,tapering,terete,terminal,tip,trichome,tube,unit,upper,vein,velvety,way,white,wide,woody,yellow,young	-1,.2,0,0-3,0-30,0-5,0.3,0.3-0.5,0.3-0.7,0.4-0.8,0.5,0.5-1.5,0.5-2.5,0.8,00-200,1,1.5-2,1.5-5,1/,1/3,10-30,2-2.7,2.9-3.2,3-4,3.2-3.8,30-60,5,5-25,5-50,5-7,5-merous,6.5-7,7-8,7-9,abaxial,adaxial,adaxially,alyx,ame,andromonoecious,apar,apart,articulated,berry,blade,c.,chartaceous,conical,curved,discolorous,distal,distance,drying,eaf,eed,elongated,equal,extending,flattened,gently,glabrous,hermaphrodite,heterostylous,infructescence,least,lon,longer,lower,lowermost,midpoint,moderately,nflorescence,older,one,open,orolla,oung,peduncle,pendent,pendulous,per,pericarp,plant,plurifoliat,portion,prickl,primary,ray,rounded,ruit,sessile,side,smooth,sometimes,spaced,stalk,staminat,stout,straight,tamen,tertiary,time,variously,vary,venation,visible,weakly,yellow-brow,ympodial	anthesi,appearance,bud,cell,color,corolla,count,growth,habitat,inflorescence,major,mentioned,minor,new,ovary,plurifoliate,position,seed,shape,size,stigma,stone,structure,sympodial,texture,width,wing,yellow-brown
49	wfo-0001026407	success	221	169	143	78	26	0.647	+,-11,-6,.5,/3,0.5,0.5-0.6,0.5-2,0.9-3,1,1-1.2,1-10,1.5-1.7,1.5-2,1.5-7,2-2.5,20-40,3.5,5,5-10,7-10,7-8,abaxially,acute,adaxially,anther,anthesi,apart,apex,area,around,basal,base,becoming,beneath,berry,black,branch,branched,broadly,brown,brownish,calyx,capitate,cell,cm,congested,conical,corolla,deep,deltate,dendritic,densely,denser,diameter,ellipsoid,elliptic,erect,evenly,filament,flattened-reniform,flower,free,fruiting,glabrous,globose,golden,golden-pubescent,growth,inflorescence,internodal,interpetalar,irregularly,lamina,lateral,lax,leafy,like,lobe,lobed,long,many,margin,minutely,mixture,mm,narrowly,near,new,oblique,obscured,occasionally,often,older,open,outline,pair,pale,paler,papillate,pedicel,pentagonal,persistent,petiole,pitted,planar,plurifoliate,pubescence,pubescent,purple,purplish,reddish,ripe,scar,shiny,shrub,simple,sinus,spaced,sparsely,spreading,stellate,stem,stiff,stigma,style,surface,terminal,testal,time,tip,trichome,truncate,tube,undulate,unit,vein,vine,violet,way,woody,x,yellow	0.5-1,1.2-1.5,1.3,2.5-3,20-30,3.5-5.5,4-5,5-7,5-merou,ag,aid,along,always,alyx,appearing,ark,articulated,axi,berr,blunt,chartaceous,clear,climbin,connivent,dense,discolorous,eaf,eed,entire,exserted,fleshy,geminat,glabrescen,glabrou,ilament,leaving,lengthening,loosely,lower,markedly,membranous,midvein,nflorescence,numerous,orolla,papillat,pedice,peduncle,peg,per,perfect,pericarp,pore,poricidal,portion,primary,pubescenc,revolute,ruit,short,sleeve,slightly,slit,small,sparser,stout,strongly,tangled,tem,thin,transition,twining,ud,upper,usually,vary,weak,ympodial	appearance,bark,bud,color,count,fruit,geminate,glabrescent,habitat,leaf,length,major,minor,null,ovary,position,seed,shape,size,stone,structure,sympodial,texture,width,wing,young
50	wfo-0001026424	success	138	145	105	33	40	0.761	-25,-3.5,-4,0.75-1.5,1-,1-1.5,1-10,1-2,1.5-2,10,10-15,12-60,15,15-30,2,3-4,637/1,8-,acuman,acuminate,acute,age,angular,anthesi,apex,aspect,axil,base,becoming,blunt,bluntly,blush-violet,broad,broadly,calyx,campanulate,cell,clonal,close,cm,conspicuous,corolla,cuneate,cyme,downard,ellipsoid,elliptic,erect,exceeding,except,facetted,facing,floral,flower,fork,general,glabrous,glandular,growing,hair,interacuminal,lasting,lavender,leaf,line,lobe,lobed,long,minute,mm,oblique,obovate,often,part,pedicel,petiole,pinnatisect,point,rachi,raised,rarely,rh,rotate-stellate,rounded,scorpioid,several,shallowly,shrub,simple,slightly,soft-wooded,stem,stone,straggly,tip,tissue,toward,triangular,unit,unwinged,violet,woody,x,year,young	1,3-11,acumen,ba,common,cut,dia,distinct,eaf,exerted,forked,gree,lacking,lanceolate,lanceolate-elliptic,larger,lon,lower,midvein,nflorescence,pedicellate,peduncle,plurifoliat,second,short,sinus,soon,time,tub,ud,usually,within,ympodial	anther,appearance,bark,bud,color,count,diameter,filament,free,fruit,fruiting,green,growth,habitat,inflorescence,lateral,length,major,margin,mentioned,minor,new,null,ovary,plurifoliate,position,scar,seed,shape,size,stigma,structure,style,surface,sympodial,texture,tube,vein,width,wing
51	wfo-0001026440	success	181	153	123	58	30	0.68	0-15,1-5,1.1-1.4,1.1-1.5,1.5-2.1,1.8-4.5,1.9-3.7,1/2,14-30,3-5,3-7,3.9-6.5,3/4,4-12,5-7,7-14,accrescent,acute,adaxially,along,always,anther,anthesi,apex,axillary,bark,basal,base,berry,blunt-tipped,bract-like,branch,branched,broadly,brown,calyx,chartaceous,cm,conical,corolla,dendritic-echinoid,developed,diameter,dichotomy,distal,echinoid,elliptic,entire,filament,first,fleshy,flower,free,fruiting,globose,granular,green,greenish-yellow,hair,high,leaf,length,lobe,long,long-attenuate,many,margin,minutely,mm,multangulate,multangulate-pubescent,nearly,oblong,obovate,obovoid-oblong,obtuse,often,openly,ovate,pair,pale,pedicel,persistently,petiole,pitted,plurifoliate,porrect-stellate,rather,reniform,ripe,scabrous,semi-ovate,sessile,short-acuminate,short-stalked,shrub,simple,size,small,sometimes,somewhat,sparse,stellate,stellate-pubescent,stem,stigma,style,terete,thin,time,tip,tomentose,tomentose-pubescent,tree,truncate,tube,turning,uneven,unit,white,x,yellow,young	1.3-1.7,1/2-2/3,2-2.8,2-4,2.9-4.4,3-8,9,abaxially,adaxiall,ag,apparently,appressed,articulated,ba,blade,branche,capitat,closely,dense,directed,distally,eaf,echinoi,eed,included,inserted,large,lengthening,lobed,lower,m.,minute,mostly,multangulat,nflorescence,obscure,older,orolla,peduncle,perfect,pore,poricidal,pubescen,ruit,runk,slit,spaced,suture,tamen,testa,thick,tomentum,translucent,ud,usually,vary,way,ympodial	appearance,bud,capitate,cell,color,count,description,fruit,growth,habitat,inflorescence,lateral,major,mentioned,minor,new,ovary,position,pubescent,scar,seed,shape,stone,structure,surface,sympodial,texture,vein,width,wing
52	wfo-0001026441	success	197	147	116	81	31	0.589	0-2,0.3-0.7,0.5-1.5,0.8,1-2,10,10-14,15-20,2-2.5,2-5.5,2-8,4-8,4-8.5,5-10.5,6-15,7-20,7-8,9-14,abaxially,acuminate,adaxially,anther,apex,attenuate,axillary,base,berry,blade,bud,cell,chartaceous,ciliate,cm,conical,connivent,corolla,covering,diameter,distal,eaf,end,especially,filament,flower,forked,fruit,generally,glabrous,green,green-white,hair,hair-like,half,herb,interjected,lanceolate,lateral,leaf,leaflet,light,like,lobe,long,make,margin,minutely,mm,mottled,mucilaginous,narrow,odd-pinnate,one,orbicular,ovate,ovoid,pale,pedicel,petiole,petiolule,placed,plant,plurifoliate,puberulent,pubescent,purple,ripe,seed,semierect,size,slightly,sparsely,stem,stigma,stolo,straight,style,subsessile,subtending,symmetrical,tall,terminal,testal,thick,throughout,tip,tri-,tube,tuber,typically,unit,usually,violet,wall,wet,wing,x	.5,0.4-3,1-1.5,1-10,1.5-2,1.5-2.5,3-5,4-6,4.5-6.5,5,5-merou,absent,acumen,ag,alyx,apart,apparently,articulated,axe,brownish,capitat,condition,decreasing,digestion,dorsally,drying,edge,eed,elliptic-lanceolate,enzyme,equal,erec,exceeding,flat,folded,fourt,fresh,geminat,glabrou,gradually,greenish,homostylous,honeycomb-shaped,internal,larger,lengthening,living,lower,middle,minute,nflorescence,obtuse,orolla,pair,peduncle,perfect,pore,poricidal,removed,rotate,rounded,ruit,secondary,seudostipule,short,slit,spaced,specimen,stamen,star,ste,subequal,tamen,tem,toward,vary,white,whitish,wide,yellow,ympodial	anthesi,appearance,bark,calyx,capitate,color,count,erect,free,fruiting,geminate,growth,habitat,inflorescence,length,major,mentioned,minor,new,ovary,position,scar,shape,stone,structure,surface,sympodial,texture,vein,width,young
53	wfo-0001026460	success	131	122	100	31	22	0.763	.1,.5,0.5-1.5,1-1.5,1.5-2,1/2,10-15,13.5-21,2-2.5,5,513,6-7,6-9,7-9,8-10,abaxially,acute-acuminate,anther,anthesi,apex,base,becoming,berry,branched,calyx,capitate,closely,cm,completely,conical,corolla,deflexed,deltate,dia,distal,do,drying,elliptic,fide,filament,filiform,floccose,flower,free,fruiting,glabrous,globose,green,inflorescence,internodal,leaf,less,lobe,long,major,membraneous,middle,minutely,mm,often,older,opposite,ovary,ovoid-reniform,pair,pale,papillose,pedicel,pitted,pore,poricidal,puberulent,reddish,santo,scar,shaped,shrub,simple,somewhat,soon,spaced,stem,stigma,style,subshrub,surface,tall,tear-drop,tiny,tip,trichome,tube,unit,vein,white,widest,woody,x,yellow,young	2.5-3,4.5-5,acut,adaxially,axi,brown,dark,eaf,edicel,eed,erect,frui,greenish,inflorescenc,like,lobed,long-exserted,lower,nearly,nflorescence,papillo,portion,reddish-brow,reflexed,ruit,slightly,tapering,tub,ud,unifoliat,ympodial	acute,bud,color,count,diameter,fruit,habitat,lateral,length,margin,null,petiole,position,reddish-brown,seed,shape,size,structure,sympodial,texture,unifoliate,width
54	wfo-0001026489	success	153	140	114	39	26	0.745	.3,0.05-0.1,0.25-0.5,0.5-1,0.5-2,0.6-1.4,0.8-1.2,0.8-1.3,0.8-3.7,1-1.5,1.3-3,1.5-5,2-3,2-5,2-8-flowered,2.5-13,2.5-4,2/3,5-6,8-13,acute,along,anther,anthesi,apex,appearing,area,axil,bark,base,beneath,branched,broadly,calyx,closely,cm,corolla,cup-shaped,deflexed,deltoid,densely,dia,difoliate,dry,elliptic,filament,flattened,flattened-reniform,fleshy,free,fruiting,glabrous,globose,green,later,lateral,leaf,lobe,lobed,long,main,major,margin,middle,minor,minutely,mm,occasionally,often,older,opposite,ovary,pair,papillose,parallel,pedicel,perpendicular,petiole,pitted,planar,poricidal,prominent,pubescent,red-papillose,scar,shiny,shrub,simple,size,slender,somewhat,spaced,specimen,stem,stigma,strongly,style,surface,tall,tapering,tip,trichome,tube,uniseriate,unit,vein,way,white,whitish,widened,widest,woody,x,young	0.5,0.5-0.75,2-4,ba,berry,brown,dark,differing,eaf,edicel,eed,erect,exserted,extending,geminat,gra,incrassate,lamina,lon,lower,nflorescence,one,overlappin,paler,papillo,pore,portion,rhachi,ruit,shaped,soon,straight,tear-drop,terminal,thickened,tub,ud,usually,ympodial	appearance,bud,cell,color,count,diameter,flower,fruit,geminate,gray,growth,habitat,inflorescence,length,new,null,overlapping,position,seed,shape,stone,structure,sympodial,texture,width,wing
55	wfo-0001026490	success	272	183	143	129	40	0.526	.5,0.1â2.5,0.2â1.5,0.3â3.5,0.5â8,0.8â12,1.5,1.5â3.5,1.9,1â3,2,3,3â5-pinnate,4.6,6,7,7-pinnate,=,[,],abaxially,accrescent,acuminate,acute,adaxially,along,anther,anthesi,apex,around,axillary,base,becoming,blade,branched,broadly,calyx,ciliate,climbing,cm,commonly,connivent,corolla,covered,crisped,darker,densely,diameter,eglandular,ellipsoidal,elliptic,extra-axillary,filament,flattened,flower,free,fruit,fruiting,fused,glabrous,green,ground,immature,incurved,inflorescence,lacking,lateral,leaf,length,lenticular,lobe,long,main,margin,mature,mean,mean=,midvein,mm,moderately,mottled,multicellular,nearly,node,oblique,oblong,obtuse,obtusely,orange,ovate,ovate-lanceolate,pedicel,petiole,plurifoliate,pointed,pubescence,pubescent,punctate,rooting,rounded,sand,seed,shape,shoot,short,shorter,simple,size,slender,slightly,smooth,sometimes,somewhat,sparsely,spur,stem,stigma,striping,style,surface,tawny,teardrop-shaped,terminal,tip,toward,trailing,transparent,trichome,truncate,tube,unbranched,unit,vegetation,vine,violet,white,wide,wing,woody,yellow,Â½,Ã,â4.5	0.1â0.2,0.2â1,0.4â0.8,0.5â1,0.5â1.5,0.5â3.5,0.7â3,0.8â1.5,1.2â8,1.5â2,1.5â5,1.8â2.2,10â20,1â1.2,1â15,1â2.5,1â8,2.5â3.5,2â2.5,2â4,2â6,2â8,3â4.2,3â4.5,3â5,3â8,4â4.5,4â5,5-merous,5â7,7â15,absent,ag,alyx,apart,apical,apicall,apparently,articulated,axe,ba,bract,bracteate,brown,capitat,cauline,chartaceous,completely,contiguously,cordate,cylindrical,decreasing,directed,distal,distally,eaf,eed,entire,equal,exceeding,expanded,flat,geminat,interjected,irregularly,large,latrorse-introrse,leaflet,light,lobed,longitudinal,lower,lowermost,lunate,markedly,match,medium,middle,minute,near,nflorescence,obliqu,obliquely,oblon,occasionally,one,opening,orolla,pair,papillose,part,peduncle,pentagonal,per,perfec,perfect,petiolule,pore,present,pseudostipule,pubescen,pur,rachi,radial,reflexed,reniform,resulting,revolute,ruit,seudostipule,similar,slit,smaller,spaced,stamen,striation,strongly,tamen,tem,thickened,trichomessympodial,typically,undulate,vary,yellowish-tan,youn,â4,â8,â9.5	--,0.1,0.2,0.5,0.8,1,10,15,2.5,20,3.5,4,4.5,5,8,apically,appearance,bark,bud,capitate,cell,color,count,geminate,growth,habitat,major,mentioned,minor,new,ovary,position,scar,stone,structure,sympodial,texture,vein,width,young
56	wfo-0001026491	success	165	164	125	40	39	0.758	.5,1,1-2,1.5-2,1.5-2.5,1.5-3.5,1.7,10-50,1977,2-3,2-4,2-celled,3,3-pinnate,5-6,5-8,6-8,7-8,abaxially,acuminate,acute,adaxially,anderson,anther,apex,appressed,articulated,averaging,axe,base,bayonet,bent,berry,blade,branched,broadly,cellular-papillose,cellular-pilose,central,cm,connivent,crinkly,cuneate,deep,deltoid,densely,diameter,directed,elliptic-lanceolate,filament,flower,glistening,globose,green,growing,hair,highly,inflorescence,lanceolate,lateral,leaf,leaflet,less,light,lobe,long,margin,mean,middle,minutely,mm,near,oblong-elliptic,obtuse,often,ovate,ovate-elliptic,ovoid,pale,pedicel,peduncle,perfect,petiole,pilose,plurifoliate,pore,poricidal,porrect-incurved,pubescent,purple,rarely,rotate-pentagonal,rotate-substellate,rounded,row,scandent,sharp,shortly,shrub,simple,slender,small,spotted,stigma,straight,strigose,strong,strongly,subacute,suborbicular-ovate,surface,tawny,terminal,tightly,tip,tube,uniseriate,unit,upright,usually,ventral,white,whitish,x,yellow	2.5-3.5,5-merou,abaxiall,absent,alyx,apparently,ba,bract,branching,capitat,conspicuously,deciduous,distall,eaf,eed,entire,equal,first,geminat,greatly,homostylous,interjected,lower,lunulat,nflorescence,orolla,point,present,rachi,readily,reduced,ruit,seudostipule,similar,strigo,tal,tamen,tem,tyle,ympodial	anthesi,appearance,bark,bud,calyx,capitate,cell,color,corolla,count,distally,free,fruit,fruiting,geminate,growth,habitat,length,major,minor,new,null,ovary,position,scar,seed,shape,size,stem,stone,structure,style,sympodial,tall,texture,vein,width,wing,young
57	wfo-0001026501	success	195	151	122	73	29	0.626	-1.7,-3,.1,.5,.6,.7,/3,0,0.1,0.27-0.7,0.5-0.9,0.6-1,0.6-1.1,0.6-2,0.9-2.2,1,1-2,1-2.5,1/2-2/3,1/4,1/6-1/2,2.5-4,3-4,3-5,4-5,4-7,7-9,?,abaxially,acute,anther,apart,apex,apically,bark,base,blade,branched,brown,calyx,cm,color,cuneate,deltate,densely,diameter,dull,elliptic,elongating,entire,eye,filament,flattened-reniform,flower,free,fruit,fruiting,glabrous,gray,green,known,leaf,length,lobe,lobed,long,longer,margin,mature,mauve,midpoint,mm,moderately,naked,one,open,orange-brown,orbicular,ovate,pair,pale,pedicel,petiole,porrect,prickle,prickly,ray,reddish,rounded,scandent,scar,shoot,short,shorter,shrub,simple,spaced,sparsely,spherical,spreading,stalk,stalked,stellate,stellate-pubescent,stem,style,surface,tapering,terete,terminal,time,tip,trichome,tube,unit,upper,vein,visible,way,white,wide,yellow	.35,0-1,0-2,0.05-0.3,0.2-1.8,0.5,0.5-0.6,0.5-1,1.8-2.2,2-10,2.8-3,3-9,3.5-4,5-merous,6-9,acicular,almost,alyx,apar,apparently,articulated,becoming,berry,borne,brown-green,chartaceous,concolorous,curved,discolorous,drying,eaf,eed,elongated,equal,erect,filiform,filiform-acuminat,flattened,glabrou,infructescence,light,lower,nflorescence,often,older,orolla,oung,peduncle,pendulous,per,perfec,pericarp,plurifoliat,poricidal,portion,prickl,primary,ruit,sessile,slender,small,smooth,sometimes,somewhat,straight,subsessile,tamen,unarme,unarmed,variously,vary,yellow-green,ympodial	anthesi,appearance,bud,cell,corolla,count,filiform-acuminate,growth,habitat,inflorescence,lateral,major,mentioned,minor,new,ovary,plurifoliate,position,seed,shape,size,stigma,stone,structure,sympodial,texture,width,wing,young
58	wfo-0001026513	success	138	146	118	20	28	0.855	.1,.25,.3,.75,/3,0.8-2,1-1.5,1-3,2-2.2,2-5,3-5,3-6-flowered,4-5,6-8,7-9,8-16,acute,anther,anthesi,apex,apiculate,area,bark,base,berry,broadly,calyx,closely,cm,completely,corolla,darkish,decurrent,deflexed,delicate,deltoid,dia,differentiated,dry,elliptic,erect,exserted,filament,flower,free,fruit,fruiting,glabrous,globose,green,hirsute,known,lanceolate,lateral,leaf,less,live,lobe,lobed,long,long-styled,longer,mature,middle,minute,minutely,mm,much,obscure,older,opposite,ovary,pair,pale,papillose,pedicel,petiole,plant,pore,poricidal,prominent,raised,reflexed,rest,scar,shaped,shiny,short-styled,shrub,simple,slender,small,somewhat,soon,spaced,specimen,stem,stigma,style,surface,tall,tear-drop,tip,treelet,trichome,tube,undersurface,uniseriate,unit,vein,venation,way,white,wide,widest,woody,x,young	ba,caly,eaf,edicel,eed,except,gre,immature,leave,lower,main,nflorescence,overlappin,portion,ruit,straight,styl,ud,unifoliat,ympodial	appearance,bud,cell,color,count,diameter,grey,growth,habitat,inflorescence,length,major,margin,minor,new,null,overlapping,position,seed,shape,size,stone,structure,sympodial,texture,unifoliate,width,wing
59	wfo-0001026529	success	219	170	139	80	31	0.635	0-25,0.3-1,0.5-4.5,1,1-2,1-3,1-4.5,1.1-2.5,10-28,11-14,12-22,120-210,2-7.5,20-60,4-8,5-15,50-70,6-20,600-950,abaxially,acumen,acuminate,adaxially,along,anther,apex,attenuate,axillary,base,berry,blade,blue,broadly,bud,cell,chartaceous,ciliate,clavate,cm,connivent,cordate,corolla,covering,creamy,dark,deep,densely,diameter,distal,dot,especially,faintly,filament,flower,forked,fruit,generally,glabrous,gland,glandular,globose,greatly,green,green-white,hair,hair-like,half,head,herb,lanceolate,lateral,length,light,like,lilac,lobe,long,longer,make,margin,medium,membranous,midrib,minutely,mm,moderately,mucilaginous,narrowly,non-glandular,oblique,odd-pinnate,often,orbicular,ovate,ovoid,pedicel,petiole,petiolulate,plant,plurifoliate,puberulent,pubescent,pure,rarely,ripe,rounded,scattered,seed,sessile,shape,short,size,slightly,stem,stigma,style,subtending,tall,terminal,testal,tetralobulate,thick,throughout,tip,tri-,trichome,tube,typically,unit,unwinged,usually,varying,wall,wet,white,wide,wing,x,yellowish	1-10,1.5-2.5,1.5-4,10,2,2-5,3-12,3-5,3-6,3-9.5,5-17,5-9,5-merou,?,acute,ag,alyx,apart,apparently,articulated,axe,brownish,capitat,condition,digestion,dorsally,drying,eaf,edge,eed,elliptic,enzyme,erec,exceeding,except,flat,folded,fresh,geminat,glabrou,gree,greenish,hal,homostylous,honeycomb-shaped,interjected,leaflet,lengthening,living,lower,lunate,nflorescence,orolla,pair,peduncle,pentagonal,perfect,petiolule,pore,poricidal,proximal,reduced,removed,ruit,seudostipule,slit,spaced,specimen,stamen,ste,straight,subequal,subsessile,substellate,tamen,tem,vary,whitish,yellow,ympodial	anthesi,appearance,bark,calyx,capitate,color,count,erect,free,fruiting,geminate,growth,habitat,inflorescence,leaf,major,mentioned,minor,new,ovary,position,scar,stone,structure,surface,sympodial,texture,vein,width,young,Âµm
60	wfo-0001026534	success	150	121	83	67	38	0.553	-1.5,0.5-1,1-2,1.5-6,10-20,10-50,2-2.5,2-3,2.5-15,2.5-4,3-,3-25,5-6,6-35,7-12,7-40,abaxially,acuminate,acute,adaxially,apex,auriculate,basal,base,blade,branched,calyx,cell,cm,connivent,cordate,darker,deltate,densely,diameter,eglandular,ellipsoidal,flattened,fleshy,flower,fruit,glabrous,glandular,hair,lanceolate,lobe,long,longitudinal,margin,mm,moderately,narrowly,obtuse,often,orange,ovate,ovoid,pedicel,petiole,pinkish,puberulent,pubescent,purple,red,simple,sparsely,stigma,stone,stripe,style,subcoriaceous,time,tip,triangular,truncate,tube,unbranched,unit,vein,white,wide,x,yellow	1-2.5,1-3,1.5-9,10-15,15-50,2-7,2-8,3-10,3-4,3-5,3.5-4,4-10,4-foliat,4.5-5,absent,aggregate,apart,ape,apiculate,articulated,axe,beyond,bright,chartaceous,connective,cylindrical,directed,distally,eaf,eed,entire,equal,exserted,leaving,lemon-yello,lon,lower,m.,nflorescence,nther,orolla,pale,pedicellar,peduncle,perfect,pore,presen,puberulen,rachi,radiu,remnant,ruit,shorter,slightly,small,spaced,stamen,stellate,tal,tem,thecae,tomento,tree,truncat,ud,vary,ympodial	4-foliate,anther,anthesi,appearance,bark,bud,color,corolla,count,filament,free,fruiting,growth,habitat,inflorescence,lateral,leaf,length,major,mentioned,minor,new,ovary,position,present,scar,seed,shape,size,stem,structure,surface,sympodial,texture,tomentose,width,wing,young
61	wfo-0001026535	success	248	213	185	63	28	0.746	.1,.2,.4,.5,.8,0.15,0.2,0.2-0.3,0.5-1,0.7-1.5,1,1-2,1-3,1-5,1.2-2,1.3,1.5-2,1.5-3,1/2-2/3,2-3,2-5,3,3-4.5,3.5-4,4-15,5-7,5Â°,7-8,accrescent,acute,age,almost,alternate,anther,anthesi,apex,apically,area,around,bark,base,becoming,berry,black,brachyblast,branched,branching,broadly,brown,calyx,chartaceous,clavate,clearly,cm,concolorous,condensed,conical,corolla,cuneate,cup,cupular,curved,dark,deeply,delineated,deltoid,dendritic,dendritic-pubescent,dense,developed,developing,diameter,discolorous,divided,dorsal,drying,elliptic,elongated,equal,evenly,except,filament,flexuous,flower,forming,free,fruit,fruiting,glabrous,green-brown,increasing,inside,known,leaf,length,lengthening,liana,like,linear,lobe,lobed,long,loop,loose,margin,marginal,membranous,midvein,minute,minutely,mm,mostly,much,number,oblong,obovate,obscure,orange-brown,outside,ovate,ovoid,pair,partly,pedicel,pendulous,pericarp,petiole,pointed,pore,poricidal,prominent,pubescent,rachi,rarely,ray,ridged,rounded,scar,secondary,short,shrub,side,simple,sinus,slender,slightly,smaller,smooth,spaced,sparsely,spreading,stem,stigma,stump,style,surface,tearing,terete,terminal,thin,tip,tissue,toward,translucent,trichome,truncate,tube,tufted,unarmed,uneven,unevenly,unit,unlignified,vein,violet,visible,weakly,white,wide,widely,wider,x,yellowish,young,youngest	0-0.5,0.1-0.2,0.2-1.5,1/3,2.5,3-5,5-10,abaxial,abaxially,absent,adaxially,along,alyx,apar,apparently,articulated,branch,clustered,delineate,detaching,dilated,distributed,domatia,dry,eaf,eed,ellipsoi,entire,eye,fertilisation,fine,flat,frui,leave,lon,lower,m.,main,naked,network,nflorescence,nther,older,orolla,papillo,peduncle,perfec,plant,plurifoliat,portion,primary,protruding,raised,reaching,ruit,see,soon,tertiary,two,ud,vary,venation,ympodial	apart,appearance,bud,cell,color,count,ellipsoid,growth,habitat,inflorescence,lateral,major,minor,new,null,ovary,papillose,plurifoliate,position,seed,shape,size,stone,structure,sympodial,texture,width,wing
62	wfo-0001026604	success	192	167	144	48	23	0.75	.4,.75,0.1,0.4-0.6,0.8-0.9,0.8-1,1.1-1.3,10-30,2-2.3,2-2.5,2.3-3.5,3-5,3.5-4,4.5-7,5,5-7,50-100,<,?,absent,acuminate,along,anther,anthesi,apart,apex,appearing,articulation,atop,bark,basal,base,berry,branching,brown,c.,calyx,capitate,cell,clearly,cm,comical,conical,cordate,corolla,cucullate,cupped,dark,deflexed,densely,diameter,differentiated,drying,due,ellipsoid,elongate,expanding,exserted,filament,flattened,flexuous,flower,free,fruit,fruiting,glabrous,globose,growth,inflated,later,leaf-opposed,liana,lobe,lobed,margin,mere,midrib,minute,minutely,mm,narrowly,new,oblique,older,outline,ovary,ovate,overall,ovoid,pair,papillose,part,particularly,pedicel,peg,petiole,pitted,planar,point,portion,primary,pubescent,purple,receptacle-like,red,reddish,reniform,rim,ripe,scar,series,shape,shrub,simple,sinuate,slightly,somewhat,spaced,stellate,stem,stigma,stout,strongly,structure,style,surface,terminal,testal,time,tip,trichome,truncate,tube,undulation,uniseriate,unit,upper,vein,vining,violet,way,widely,woody,x	.5,0,1-1.2,1.2-1.7,1.5-2,1.5-9,3-3.5,4-4.5,age,aid,always,articulated,brow,climbing,distal,distinct,eaf,eed,entire,leaving,lengthening,lower,nflorescence,nodding,occasionally,pale,papillo,peduncle,per,perfect,pericarp,plurifoliat,poin,pore,poricidal,quarter,ruit,shiny,slender,slit,support,swolle,thin,tub,twisting,ud,ympodial,Â½	appearance,bud,color,count,habitat,inflorescence,lateral,leaf,length,major,mentioned,minor,plurifoliate,position,seed,size,stone,swollen,sympodial,texture,width,wing,young
63	wfo-0001026607	success	204	161	129	75	32	0.632	0.1-0.3,0.3-1.8,0.8-3.4,0.8-5,1-2,1-3.8,1-5,1-8,1.5-4,10-30,2-10,2-2.5,2.4-5.8,2.5-3.8,3-8,5.8-19.8,6-10,abaxially,acumen,acute,adaxially,along,anther,apex,attenuate,axillary,base,basiscopic,berry,brownish,bud,cell,chartaceous,ciliate,clavate,cm,coarse,condition,connivent,corolla,covering,decurrent,deep,diameter,distal,dot,drying,especially,filament,finely,flower,forked,forming,fresh,fruit,generally,glabrous,globose,green,green-white,greenish,hair,hair-like,half,herb,interjected,lanceolate,lateral,leaf,leaflet,like,lobe,long,make,margin,medium,membranous,midrib,minutely,mm,moderately,mucilaginous,obtuse,odd-pinnate,often,orbicular,ovate,ovoid,pedicel,peduncle,petiole,petiolulate,plant,plurifoliate,puberulent,pubescent,rachi,ripe,rosette,rounded,scattered,seed,sessile,short,side,simple,size,stem,stigma,style,subtending,tall,terminal,testal,thick,throughout,tip,tri-,tube,typically,unit,unwinged,usually,violet,wall,wet,white,whitish,x	0-3,0-4,0.5-5.8,0.8-4.5,1-10,2-3,2.7-19,4-10,4-6,5,5-merou,absent,ag,alyx,apart,apparently,articulated,axe,blade,capitat,clearly,decreasing,digestion,dorsally,eaf,edge,eed,elliptic,enzyme,exceeding,flat,folded,geminat,glabrou,greatly,gree,hal,high,homostylous,honeycomb,larger,lengthening,living,lower,marked,minute,much,nflorescence,orolla,pair,pentagonal,perfect,pore,poricidal,present,rarely,removed,ruit,semierec,seudostipule,shaped,slit,sometimes,spaced,specimen,stamen,ste,straight,tamen,tem,toward,vary,without,yellow,ympodial	anthesi,appearance,bark,calyx,capitate,color,count,free,fruiting,geminate,growth,habitat,inflorescence,length,major,mentioned,minor,new,ovary,position,scar,semierect,shape,stone,structure,surface,sympodial,texture,vein,width,wing,young
64	wfo-0001026613	success	159	126	92	67	34	0.579	0.6,1-2,1.5-4,11-19.5,2-7.5,2.3-8,2.5-2.8,3-10,4-5,5-7,6-12,8-18,8.5-10,8.5-9,9.5-13.5,abaxially,absent,acuminate,adaxially,along,anther,apex,attenuate,axillary,base,berry,bud,chartaceous,ciliate,cm,conical,cordate,corolla,densely,diameter,distal,especially,filament,flower,forked,fruit,generally,glabrous,green,hair,half,herb,immature,lanceolate,lateral,leaf,leaflet,like,lobe,long,m-1.2,margin,mature,membranous,midrib,minutely,mm,mottled,odd-pinnate,ovate,pedicel,petiole,petiolule,plant,plurifoliate,puberulent,pubescent,purple,secondary,semierect,size,sparsely,stem,stigma,style,subtending,symmetrical,tall,terminal,tip,tri-,tube,unit,unknown,unwinged,usually,x	0.5-1,1-10,3-5,4.5-8.5,5,5-6,5-merou,5.5-7,6-8,6.2-9.5,acumen,ag,alyx,apart,apparently,articulated,axe,blade,borne,capitat,connivent,decreasing,dorsally,eaf,edge,eed,end,erec,flat,folded,geminat,greatly,hal,homostylous,interjected,larger,lengthening,lower,middle,minute,nflorescence,orolla,pair,peduncle,perfect,pore,poricidal,proximal,pubescen,rotate-pentagonal,ruit,seudostipule,singly,slit,spaced,ste,stolo,subequal,tamen,tem,toward,tuber,typically,unknow,vary,yellow,ympodial	anthesi,appearance,bark,calyx,capitate,cell,color,count,erect,free,fruiting,geminate,growth,habitat,inflorescence,length,major,mentioned,minor,new,ovary,position,scar,seed,shape,stone,structure,surface,sympodial,texture,vein,width,wing,young
65	wfo-0001026614	success	200	151	104	96	47	0.52	0.4-0.7,0.5,1-,1.3-1.8,3-foliate,5,5.3-8.2,6.4-8.4,7.2-9.8,abaxially,acuminate,acute,adaxially,anther,apex,base,berry,black,blunt-tipped,brown,calyx,chartaceous,cm,concentrated,cylindrical,dark,densely,diameter,dried,especially,evenly,extra-axillary,filament,flattened-reniform,fleshy,flower,foveolate,fruit,fruiting,geminate,glabrescent,glabrous,gland-tipped,globose,golden,hair,interpetalar,lanceolate-attenuate,lateral,leaf,less,linear,lobe,long,margin,midvein,minute,minutely,mm,mottled,nearly,oblique,obtuse,often,orange,orange-red,ovate,ovate-lanceolate,ovoid,pair,pedicel,petiole,pubescence,pubescent,ripe,scattered,sessile,side,simple,slightly,sometimes,somewhat,soon,sparsely,stellae,stellate,stellate-pubescent,stem,stigma,style,surface,tapering,time,tissue,tube,usually,vein,weakly,white,wide,x,yellow,yellowish,young	.8,0.2,0.2â0.3,0.5â2,1.5â2,11-15,15â30,1â2,1â3,1â5,2.2,2.2-5.5,2.5,2.5â3,20â25,2â4,2â4-branched,2â6.5,3.2-5.2,3â10,4-7,4.5â11,4.5â5.5,5-merou,50,6â8,8â10,9â16,>,absent,across,adaxiall,alyx,apart,apparently,armed,articulated,axe,ba,blade,broad-based,campanulate,capitat,clavate,closely,commonly,denser,developed,directed,distally,eaf,eed,entire,erect,expanded,globo,homostylous,internode,irregularly,lobed,lon,lower,midpoint,nflorescence,orolla,peduncle,per,perfect,pore,prickle,rachi,rarely,ray,reflexed,repand,rotate-pentagonal,rounded,ruit,shallowly,shin,shrub,similar,smaller,spaced,spreading,tall,tamen,tem,tissu,ud,unarme,unarmed,vary,well,ympodia,â5	0.2-0.3,1-2,1-3,1.5-2,15-30,2-4,2-4-branched,2-6.5,2.5-3,3-10,4.5-11,4.5-5.5,8-10,9-16,anthesi,appearance,bark,bud,capitate,cell,color,corolla,count,description,free,growth,habitat,inflorescence,length,major,mentioned,minor,new,ovary,position,scar,seed,shape,size,stone,structure,sympodial,texture,tip,unit,width,wing
66	wfo-0001026642	success	193	166	112	81	54	0.58	.05,.8,0.1,0.2,0.25,0.4,0.4â2.2,0.5,0.5â,0.6,1.0,1.0â2.0,1.2â6.2,1.6â8.0,50â100,6,abaxial,abaxially,acute,adaxially,along,annual,anther,anthesi,apex,appressed,axillary,base,bipinnate,black,blade,blue,borne,branched,calyx,cell,chartaceous,circular,clavate,cm,decumbent,densely,denser,diameter,either,elliptic,erect,filament,flattened,fleshy,flower,fruit,glabrous,gland,glandular,globose,green-purple,hair,herb,indumentum,lavender,leaf,length,lilac,lobe,long,mm,moderately,multicellular,narrow,number,oblong,obtuse,often,ovate,pale,pedicel,perennial,petiole,pinnate,pitted,present,probably,pubescent,rounded,sessile,shallowly,shoot,side,simple,sometimes,sparsely,stigma,stone,style,subglabrous,surface,time,tip,tube,unicellular,unifoliate,uniseriate,unit,usually,vein,violet,wide,wing,woody,x,â4.5	.1,0.1â0.3,0.5â0.7,0.5â1.7,0.5â2.0,0.5â3.5,0.6â1.0,0.75â1.0,0.75â2.0,0.7â1.6,0.8â1.2,1.2â1.7,1.2â2.0,1.2â3.5,1.9â3.0,12â30,1â10,1â3,2.0â4.0,2.5â3.5,2.5â4.0,2.8â3.0,3.0â5.1,3â5,4.0â6.0,4â7,5,5.0â7.0,<,adaxiall,ag,apart,articulated,axe,ba,brown,connivent,cylindrical,dark,decreasing,divided,eaf,eed,equal,geminat,glabrescen,half,lon,longitudinal,lower,m.,nflorescence,occasionally,opening,orolla,pair,peduncle,pentagonal,perfect,pinnae,pore,poricidal,primary,rapidly,ruit,secondary,slit,spaced,straight,tal,tamen,tem,vary,white,yellow,ympodial,â1.2,â11.0,â2.0,â6,â7	--,0.3,0.7,0.75,1,1.2,1.6,1.9,11.0,12,2.0,2.5,2.8,3,3.0,3.5,30,4.0,5.0,5.1,7.0,appearance,bark,bud,color,corolla,count,description,free,fruiting,geminate,glabrescent,growth,habitat,inflorescence,lateral,major,margin,mentioned,minor,new,ovary,position,scar,seed,shape,size,stem,structure,sympodial,tall,texture,width,young
67	wfo-0001026651	success	222	184	159	63	25	0.716	-celled,0.2â1.3,0.35â2.6,0.9â3,1,1.8,1â2,2.2â10,2.8,2â11.5,2â13,2â3,2â8,3,3-plurifoliate,3â7,4,4â6,6â10,6â14,abaxially,absent,accrescent,acuminate,acute,adaxially,anisophyllous,anther,antrorse,apex,appressed,asymmetric,attenuate,base,beneath,berry,branch,broadly,brochidodromous,brown,brownish-green,calyx,capitate,cell,circular,cm,cyme,dark,decumbent,decurrent,densely,diameter,differing,drying,dull,elliptic,erect,exfoliating,eye,filament,flattened,flexuous,flower,fruit,geminate,glabrescent,glabrous,glandular,globose,green,hair,head,herb,highly,hilum,hollow,impressed,lanceolate,lateral,leaf,length,less,light,like,lobe,long,major,margin,markedly,matte,membranaceous,midrib,minor,mm,moderate,moderately,mostly,much-branched,multicellular,naked,narrowly-elliptic,new,normally,oblong-ellipsoid,obtuse,older,one,onto,ovate-deltate,ovate-lanceolate,ovate-reniform,pedicel,pedunculate,petiole,plant,prominent,pubescence,pubescent,region,ripe,rounded,secondary,seed,shape,shiny,shrub,similar,simple,single-celled,size,slightly,small,smaller,sometimes,stalk,stellate,stem,stigma,style,sub-opposite,surface,tall,terminal,translucent,trichome,turning,unbranched,undulate,uniseriate,unit,upper,usually,vein,venation,visible,white,woody,young,Ã	2â3.3,2â4,2â4.5,3â5,4â7.8,5-merou,8,adaxiall,along,alyx,antror,antrorsely,apar,arcuate,ark,articulated,axi,beyond,capitat,chartaceous,ciliate,connivent,cordate,cylindrical,directed,discolorous,eaf,eed,emarginate,entire,equal,exserted,frui,geniculate,glabrou,growt,introrsely,longitudinal,lower,lying,nflorescence,opening,orolla,parallel,peduncle,per,perfect,pore,poricidal,reduce,revolute,ruit,slit,spaced,stamen,straight,subapical,tamen,tem,vary,wide,yellow,ympodial	anthesi,appearance,bark,bud,color,corolla,count,free,fruiting,growth,habitat,inflorescence,mentioned,ovary,position,reduced,scar,stone,structure,sympodial,texture,tip,tube,width,wing
68	wfo-0001026656	success	211	173	139	72	34	0.659	0.3-3,1,1-2,1-3.8,1-4,1.5-7,2-6,2.5-17,20-60,4-13,5,5-18,5.5-27,9-11,abaxially,absent,acumen,acuminate,acute,adaxially,along,anther,apex,attenuate,base,bearing,blue,borne,broadly,brownish,bud,capitate,cell,chartaceous,ciliate,cm,condition,connate,connivent,corolla,covering,cuneate,dark,decurrent,densely,diameter,digestion,distal,dot,drying,elliptic,enzyme,especially,filament,flower,forked,fresh,fruit,generally,glabrous,glaucous,globose,green,green-white,greenish,greenish-yellow,hair,hair-like,half,herb,honeycomb-shaped,lanceolate,lateral,leaflet,lengthening,light,lobe,long,make,margin,membranous,midvein,minutely,mm,moderately,mucilaginous,narrowly,non-glandular,oblique,odd-pinnate,often,ovate,ovoid,pedicel,pentagonal,petiole,plant,plurifoliate,pore,poricidal,puberulent,pubescent,purple,rachi,removed,rotate-pentagonal,scattered,seed,short,slit,sometimes,star,stem,stigma,style,subglabrous,subtending,symmetrical,tall,terminal,tertiary,testal,thick,throughout,tinged,tip,tri-,truncate,tube,unit,unwinged,violet,wall,wet,white,whitish,wide,wing,yellow	0-4,0.3-4.2,0.4-6.5,0.7-10.5,0.9-13,1-1.8,1-10,1-5,1.1-8.1,10,2-8,4-10,4-8,5-35,5-merou,ag,alyx,apart,articulated,blade,clavat,curved,dorsally,eaf,edge,eed,end,erec,exceeding,flat,folded,geminat,greatly,homostylous,interjected,larger,like,living,lower,lunate,middl,mottled,nflorescence,occasionally,orolla,pair,peduncle,petiolulate,petiolule,pubescen,ranging,ruit,scale-like,seudostipule,singly,slightly,somewhat,spaced,specimen,stamen,ste,stolo,straight,subequal,tamen,tem,therefore,tuber,typically,vary,without,ympodial	age,anthesi,appearance,bark,calyx,clavate,color,count,erect,free,fruiting,geminate,growth,habitat,inflorescence,leaf,length,major,mentioned,minor,new,ovary,position,scar,shape,size,stone,structure,surface,sympodial,texture,vein,width,young
69	wfo-0001026663	success	251	232	206	45	26	0.821	-15,-2.9,-8,-9.7,.5-2.5,/25-1/15,/3,0-160,0.2-0.6,0.3-0.8,0.4-2.2,1,1-2.5,1-3.2,1-5,1.1,1.1-2.1,1.2-2,1.4-2.6,1.6-2.3,1.9-2.6,1/2,1/3,1/4-1/2,10-26,10.3-13.2,12-14,2-12,2.1-2.6,2.5-3.7,2.8-5.3,2/3,24-45,3-5,3.5-5,3.8-5.7,4.5-5.7,4.7-25.9,5-8,5.5-,5.5-8.8,7.5-9,8-17,abaxially,accrescent,acuminate,acute,adaxially,along,angled,anther,anthesi,apex,appressed,ascending,attenuate,axe,axillary,bark,base,becoming,berry,blade,blunt-tipped,branched,broadly,brown,bud,calyx,chartaceous,cm,completely,conical,corolla,covering,cylindrical,dark,densely,diameter,distributed,drying,echinoid,echinoid-pubescent,elongated,enveloping,especially,evident,exserted,filament,flared,fleshy,flower,free,fruit,fruiting,glabrescent,glabrous,globose,granular,granular-tomentose,green,greenish-brown,grooved,hair,immature,inserted,lanceolate,lateral,leaf,length,less,light,line,lined,lobe,lobed,long,long-stalked,longer,longitudinally,lower,main,many,margin,midrib,midvein,minute,mm,multangulate,multangulate-pubescent,nearly,obtuse,occasional,occuring,older,opening,openly,ovate,ovate-lanceolate,pale,pedicel,peduncle,persistent,petiole,plurifoliate,porrect-stellate,present,pseudo-terminal,pubescence,pubescent,rachi,ray,rich,ridged,robust,scabrous,sessile,short,short-stalked,shrub,side,simple,slightly,small,sometimes,soon,spaced,sparsely,stalk,stalked,stamen,stellate,stem,stigma,strongly,style,subcampanulate,subcoriaceous,subglabrous,subglobose,suture,tall,tangled,terete,thick,time,tip,tomentose,tomentose-pubescent,tomentum,touching,tree,tube,unarmed,unit,upper,usually,vein,violet,way,white,whitish,wide,x,yellow,young	0.9-1.5,1.4-3.1,2.9-5,31,adaxiall,ag,apart,apparently,around,articulated,branch,capitat,closely,constricted,directed,distally,eaf,echinoi,edge,eed,entire,farinose,glabrescen,lengthening,long-stalke,longitudinal,m.,matur,nflorescence,orolla,ovate-lanceolat,perfect,pore,poricidal,rather,ruit,runk,slit,somewhat,tamen,thin,ud,unarme,vary,ympodial	appearance,capitate,cell,color,count,growth,habitat,inflorescence,major,mature,minor,new,null,ovary,position,scar,seed,shape,size,stone,structure,surface,sympodial,texture,width,wing
70	wfo-0001026686	success	196	137	105	91	32	0.536	0.2-0.5,0.6-0.9,1,1-2,1.5-7,10-28,2-10,2-9,3-4,4-6,5-16.5,6.5-12.7,7-9,8-10,8-14,8-27,abaxially,acumen,acuminate,adaxially,along,anther,apex,axillary,base,berry,brownish,bud,cell,chartaceous,ciliate,cm,condition,conical,connivent,corolla,covering,densely,diameter,distal,drying,especially,filament,flower,forked,fresh,fruit,generally,glabrous,green,green-white,greenish,hair-like,half,herb,lanceolate,lateral,leaf,light,lobe,long,make,margin,midrib,minutely,mm,mottled,mucilaginous,odd-pinnate,ovoid,pedicel,petiole,petiolule,plant,plurifoliate,puberulent,pubescent,purple,purple-violet,ripe,seed,semierect,size,sparsely,stigma,straight,style,subsessile,subtending,symmetrical,tall,terminal,testal,thick,throughout,tip,tri-,tube,unit,usually,wall,wet,whitish,wing,x	.4,1-10,1-2.5,1.2-3.4,1.2-3.6,1.7-2.5,2.4-3.6,2.5-8,3-5,3.7-8,5,5-8,5-merou,absent,ag,alyx,apart,apparently,articulated,axe,blade,borne,capitat,decreasing,digestion,dorsally,eaf,edge,eed,elliptic-lanceolate,end,enzyme,equal,erec,exceeding,flat,folded,geminat,glabrou,gradually,hair,homostylous,honeycomb-shaped,interjected,larger,leaflet,lengthening,like,living,lower,middle,minute,nflorescence,obtuse,often,orbicular,orolla,ovate,pair,peduncle,perfect,pore,poricidal,pubescen,removed,rotate-stellate,round,ruit,secondary,seudostipule,singly,slightly,slit,spaced,specimen,stamen,star,ste,stolo,stripe,subequal,tamen,tem,toward,tuber,typically,vary,white,wide,yellow,ympodial	anthesi,appearance,bark,calyx,capitate,color,count,erect,free,fruiting,geminate,growth,habitat,inflorescence,length,major,mentioned,minor,new,ovary,position,scar,shape,stem,stone,structure,surface,sympodial,texture,vein,width,young
71	wfo-0001026696	success	139	139	99	40	40	0.712	0.3-4.5,0.8-7,0.9-7.2,1,1-1.3,1-4,1.3-2.1,1.5-3,2-17,2-3,3-17,3-3.5,3-6,3-8.5,5-35,9,abaxially,acumen,acute,adaxially,apex,apiculate,articulate,base,branched,calyx,cell,cm,connate,corolla,covering,cuneate,cyme,decurrent,densely,diameter,dichasial,dichasially,digestion,distal,dorsally,ebracteate,edge,emoval,enzyme,exceeding,filament,flat,flower,folded,forked,generally,globose,green,hair-like,half,herbaceous,honeycomb,lateral,light,lobe,long,make,margin,mm,monochasial,mucilaginous,oblong,obtuse,odd-pinnate,ovoid,pattern,pedicel,peduncle,perennial,petiole,plant,proximal,pubescent,reveal,rounded,seed,stamen,stellate,stigma,straight,style,testal,thick,throughout,tuber-bearing,typically,unit,wall,white-cream,wide,without,yellow,Â¼	3-6-foliat,4-16,apical,apically,broadly,dehiscent,eaf,eed,entire,globo,green-white,introrse,lanceolate,light-yello,linear,living,lon,lower,lunat,maturing,nflorescence,nther,often,orolla,ovate,perfect,plan,poricidally,ruit,seudostipule,short,simple,sinuate,slit,specimen,tal,tem,throughou,vary,ympodial	3-6-foliate,anther,anthesi,appearance,ba,bark,bud,color,count,free,fruit,fruiting,growth,habitat,inflorescence,leaf,length,light-yellow,major,minor,new,null,ovary,position,scar,shape,size,stem,stone,structure,surface,sympodial,tall,texture,tip,tube,vein,width,wing,young
72	wfo-0001026706	success	232	147	123	109	24	0.53	-3.1,-5.5,/14-1/6,0-240,0.2-0.3,0.8-1.2,0.9-2,1-2.2,1-5,1.1-4,1.5-3,1/2-2/3,10-15,14-32,2.2-3.3,2.3-3.8,2.7-4,2.9-6,4.2-12,4.5-5.5,5-6.5,5.3-6.4,6-10,7-16,abaxially,accrescent,acute,adaxially,anther,anthesi,apex,attenuate,axillary,bark,base,berry,blade,blunt-tipped,branch,branched,brown,bud,calyx,cm,completely,corolla,covering,cuneate,dendritic-multangulate,diameter,enveloping,filament,fleshy,flower,fourth,free,fruit,fruiting,glabrate,globose,grayish,green,hair,lacking,lanceolate,lateral,leaf,length,lobe,lobed,many,margin,midrib,mixed,mm,multangulate,oblong,obtuse,often,older,ovate,ovate-elliptic,ovate-lanceolate,pale,pedicel,petiole,plurifoliate,porrect-stellate,pseudo-terminal,pubescence,pubescent,reddish,reticulate-punctate,sessile,short-stalked,side,simple,softly,sparsely,splitting,stalked,stem,stigma,strongly,style,subcampanulate,suborbicular,sulcate,surface,time,tip,tomentose-pubescent,tube,unevenly,unit,upper,vein,velutinous,way,white,whitish,x,young	-4.4,-6.1,.5,0.2-0.5,0.6-2.2,0.8-1.5,0.8-2.8,0.9-1.9,12,2.5-3,2/3-3/4,3-4.6,3.1-3.8,3.6-5.7,4,6-8,6.1-,8-14,9.8-15.4,adaxiall,ag,apart,apparently,appearing,around,articulated,axe,ba,becoming,capitat,chartaceous,closely,coriaceous,crisped,cylindrical,dark,dendritic-echinoid,densely,directed,distally,eaf,edge,eed,entire,exserted,farinose,furfuraceou,glabrous,golden,herbarium,indument,inserted,lackin,lengthening,long,long-stalked,longitudinal,lower,m.,main,matted,minute,multangulat,nearly,nflorescence,obscured,occasionally,orolla,peduncle,perfect,persistent,pore,poricidal,rachi,rather,ruit,runk,semi-ovate,short-,shrub,slightly,slit,small,somewhat,soon,spaced,specimen,stamen,stellate,subconical,subglobose,suture,tall,tamen,thin-walled,tomentu,touching,translucent,transparent,tree,ud,unarme,unarmed,vary,wavy,wide,yellow,yellowish-tan,ympodial	appearance,capitate,cell,color,count,growth,habitat,inflorescence,major,mentioned,minor,new,ovary,position,scar,seed,shape,size,stone,structure,sympodial,texture,width,wing
73	wfo-0001026707	success	196	173	143	53	30	0.73	-3,.5,.8,/3,0,0.05,0.05-0.15,0.1-0.2,0.3-0.8,0.5-1,0.5-3,0.6-0.7,0.7-1.4,0.7-1.5,1-1.7,1-3,1.6-2,1/3,1/3-1/2,1/3-3/4,1/4-1/3,11-16,2-10,2.5-3,2.5-4,2.5-6,3-4.5,3-7,3-8,4,5-10,5-7,5-8,?,abaxially,acute,anther,apart,apex,apically,apparently,attenuate,bark,base,branched,broad-deltate,broadly,calyx,cm,color,connivent,curved,densely,diameter,elongating,erect,eye,filament,flattened-reniform,flower,foliaceous,free,fruit,fruiting,fused,gently,glabrescent,glabrous,gray,green,inflated,known,lateral,leaf,length,less,lobe,lobed,long,lower,margin,mature,mauve,midpoint,mm,moderately,naked,narrow-deltate,narrow-oblong,obtuse,older,one,open,pedicel,petiole,poricidal,porrect,porrect-lepidote,prickle,prickly,pubescent,ray,red-brown,reflexed,rounded,scar,sessile,shorter,shrub,slender,small,sometimes,spaced,sparsely,spherical,spreading,stalk,stalked,stellate,stellate-pubescent,stem,stout,straight,style,surface,tapering,terete,terminal,time,tip,tree,trichome,tube,unarmed,unit,upper,variously,venation,visible,way,white,wide,Â¼	-1/3,-5,0-20,0.6-0.8,0.7-1,1-5,1.5-1.8,1/8-1/4,2-2.3,2-6,3-4,5-25,5-merous,8-15,alyx,apar,articulated,berry,blade,branche,chartaceous,clustered,concolorous,cuspidat,decurrent,discolorous,drying,eaf,eed,entire,equal,glabrou,infructescence,juvenil,longer,nflorescence,orange-brown,orolla,oung,peduncle,per,perfec,pericarp,plurifoliat,portion,ruit,simple,smooth,tamen,vary,weakly,yellow-green,ympodial	anthesi,appearance,bud,cell,corolla,count,cuspidate,growth,habitat,inflorescence,juvenile,major,minor,new,null,ovary,plurifoliate,position,seed,shape,size,stigma,stone,structure,sympodial,texture,vein,width,wing,young
74	wfo-0001026711	success	210	169	141	69	28	0.671	-15,-5,.2,.5,.8,0.1,0.15,0.2-0.3,0.5-1.5,0.7-1.4,0.75-1,0.8,0.8-2.2,0.9-1.5,1-2,1-30,1.5-2.2,1.7-4,1/2-2/3,1/3,1/4-1/3,2-3.5,2-6,3-4.5,3-5,3-7,4-8,4.5-7,7-8,abaxially,acicular,acute,ame,anther,apart,apex,apically,apparently,bark,base,branched,c.,calyx,cell,cm,connivent,cuneate,curved,deltate,densely,diameter,difoliate,elliptic,elongating,erect,evenly,filament,flattened-reniform,flower,free,fruit,fruiting,glabrous,green,lateral,leaf,length,less,lobe,lobed,long,lower,margin,mature,maturity,mauve,midpoint,mm,moderately,narrow-deltate,obtuse,occasionally,older,one,open,orange,outline,pair,pale,pedicel,perpendicular,petiole,pit,poricidal,porrect,prickle,prickly,purple,raised,ray,red,reduced,reflexed,rounded,scar,sessile,shorter,shrub,slender,small,smooth,sometimes,somewhat,spaced,spherical,spreading,stalk,stalked,stellate,stellate-pubescent,stem,straight,style,surface,tapering,terete,terminal,time,tip,trichome,tube,unarmed,unit,upper,variously,vein,way,wide,woody,yellow,young	-2,-6,-7,0,0-0.2,0-25,0-4,0-6,0.3-1,0.7-,0.7-0.9,0.9-1.1,1-,1.5-,1/,1/4,2-2.2,2-2.5,2-4,2.1-2.5,3-4,3.5-5.2,5-merous,acuminat,alyx,apar,articulated,berry,blade,brow,concolorous,discolorous,distance,drying,dull,eaf,eed,equal,extending,faint,geminat,infructescence,longer,midvein,nflorescence,orange-brown,orolla,oung,peduncle,pendulous,per,perfec,pericarp,portion,prickl,primary,ruit,shallowly,side,tamen,tertiary,thick-chartaceous,uniform,vary,venation,visible,weakly,yellow-green,ympodial	acuminate,anthesi,appearance,brown,bud,color,corolla,count,geminate,growth,habitat,inflorescence,major,minor,new,null,ovary,position,seed,shape,size,stigma,stone,structure,sympodial,texture,width,wing
75	wfo-0001026717	success	207	162	130	77	32	0.628	0.3-0.6,0.3-5,0.6-1.5,0.8,1-2,1-3,13-28,14-22,15-34,2.5-4.5,2.5-5.5,3-4,4-6,4-8,5-11,5-13.5,7-11,abaxially,acumen,acuminate,adaxially,along,anther,apex,attenuate,axillary,base,berry,blade,borne,brownish,bud,cell,chartaceous,ciliate,cm,condition,conical,corolla,covering,dark,darker,decurrent,diameter,distal,drying,eaf,end,especially,filament,flower,forked,fresh,fruit,generally,glabrous,green,green-white,greenish,hair,hair-like,half,herb,lanceolate,lateral,leaf,light,like,lobe,long,make,margin,medium,membranous,middle,midrib,minutely,mm,mottled,mucilaginous,narrow,odd-pinnate,often,orbicular,ovate,ovoid,pedicel,pentagonal,petiole,petiolule,plant,plurifoliate,puberulent,pubescent,purple,ripe,rotate,seed,semierect,sessile,singly,size,sparsely,stigma,stolo,straight,stripe,style,subglabrous,subsessile,subtending,symmetrical,tall,terminal,testal,thick,throughout,tip,tri-,tube,tuber,typically,unit,usually,violet,wall,wet,whitish,wing,x	0.3-2.5,1-10,1-2.5,1.3-2.5,1.4-2.2,1.8-3,2.2-5,3-5,3-6,3.3-11,4-9,5,5-6,5-merou,5.3-9,ag,alyx,apart,apparently,articulated,axe,capitat,connivent,decreasing,digestion,dorsally,edge,eed,elliptic,enzyme,equal,erec,exceeding,flat,folded,geminat,glabrou,gradually,homostylous,honeycomb-shaped,interjected,larger,leaflet,lengthening,living,lower,minute,nflorescence,obtuse,one-quarte,orolla,pair,peduncle,perfect,pore,poricidal,present,pubescen,removed,round,ruit,secondary,seudostipule,slightly,slit,spaced,specimen,stamen,ste,subequal,tamen,tem,toward,vary,wide,yellow,ympodial	anthesi,appearance,bark,calyx,capitate,color,count,erect,free,fruiting,geminate,growth,habitat,inflorescence,length,major,minor,new,null,ovary,position,scar,shape,stem,stone,structure,surface,sympodial,texture,vein,width,young
76	wfo-0001026725	success	166	157	131	35	26	0.789	.3,.5,/4,0.2,0.7-1.2,1-1.2,1-4.5,1-5,1.2-1.7,1.5,1.5-2,1.6-2,1/2,2.2-4,3.5-4,3.6-7.7,5-20-flowered,5-5.5,5-6,8-18.6,8-9,acute,anther,anthesi,apart,apex,attenuate,axil,bark,base,becoming,beneath,broadly,brownish-papillose,calyx,capitate,character,cm,corolla,cup-shaped,dark,deflexed,dia,difoliate,drying,ellipsoid,elliptic,evenly,extremely,filament,flattened-reniform,free,fruit,fruiting,geographically,glabrous,globose,green,greenish-white,interpetalar,large,lateral,leaf,less,lobe,lobed,long,main,major,margin,minor,minutely,mm,occasionally,older,onto,open,opposite,ovary,ovate,ovoid,pair,paler,papillose,pedicel,petiole,pitted,planar,pore,poricidal,prominent,pubescent,reflexed,rounded,scar,scarious,shaped,short,shrub,simple,sinus,size,slender,slightly,spaced,split,stem,stigma,stretching,style,subshrub,surface,tall,tapering,tear-drop,tip,triangular,trichome,tube,tuft,uniseriate,unit,upper,varying,vein,way,white,winged,woody,x,young	1-1.5,2,accrescent,berry,black,bluish,crackin,differing,dry,eaf,edicel,eed,geminat,glandular-papillose,incrassate,inflorescenc,lon,lower,margine,material,middle,nflorescence,often,one,pale,papillo,portion,proximal,reddish-brown,ruit,straight,tan,ud,widest,ympodial	acrescent,appearance,bud,cell,color,count,cracking,diameter,flower,geminate,growth,habitat,inflorescence,length,margined,mentioned,new,position,seed,shape,stone,structure,sympodial,texture,width,wing
77	wfo-0001026733	success	188	180	140	48	40	0.745	-1,-13,-14,-4,-8,.5-3,0.3-0.5,0.3-2,0.5,0.5-1,1-2,1-3,1-7,1.5-14,1.5-2,1.5-2.5,10-20,15-,2-2.5,2-3,2-4,2.5-7.5,20-50,25-40,3-15,3-3.5,3-7,4,4-23,4-5,4.5-5,5-8,7-10,abaxially,acuminate,acute,acute-acuminate,adaxially,aggregate,apex,basal,base,beyond,calyx,cell,chartaceous,cm,color,connivent,cordate,curled,cylindrical,deltate,dense,densely,dia,diameter,directed,distally,eglandular-pilose,eglandular-pubescent,eglandular-villous,ellipsoidal,elliptic-ovate,equal,especially,exceeding,exserted,flattened,flower,forked,fruit,fusiform,glabrate,glabrous,gland-tipped,glandular-,glandular-puberulent,glandular-tomentose,green,greyish,hair,hirsute,immature,lanceolate,linear-triangular,lobe,long,longitudinal,margin,membranaceous,midrib,mm,moderately,narrowly,oblique,ovate,ovoid,pedicel,petiole,pilose,pore,present,pubescent,pubescent-pilose,ripe,round,shining,shorter,slightly,small,smooth,sometimes,sparsely,stamen,stigma,stone,stripe,style,submarginally,swelling,thecae,time,toward,tree,triangular,truncate,tube,unbranched,unit,unknown,usually,vein,villous,white,white-puberulent,wide,x,yellow,yellowish	-11,-15,-2,-7,0.5-2,0.5-4,1,1-1.5,2-6,3-4-foliat,8-12,apart,ape,articulated,axe,blade,capitat,ciliat,connective,eaf,eed,entire,glandula,leaving,lon,lower,near,nflorescence,nther,orolla,ovum,pedicellar,peduncle,perfect,pubescent-pilo,rachi,radiu,remnant,ruit,simple,spaced,stellate,tal,tem,ud,unknow,vary,ympodial	3-4-foliate,anther,anthesi,appearance,bark,bud,capitate,ciliate,corolla,count,filament,free,fruiting,growth,habitat,inflorescence,lateral,leaf,length,major,minor,new,null,oval,ovary,position,scar,seed,shape,size,stem,structure,surface,sympodial,tall,texture,tip,width,wing,young
78	wfo-0001026734	success	266	229	201	65	28	0.756	0.3,0.5,0.6,0.7â1,0.8â1,1,1.6â2.5,1.8â2.2,1.8â3,1/4,1â1.2,1â3,2.2â7,2.3â5,2.5â3,2â3,3,3.2â3.8,3â4,3â4-celled,3â8,4â6,4â7,5â9,8,abaxial,abaxially,accrescent,acuminate,acute,adaxial,adaxially,anther,anthesi,apex,apical,ark,associated,asymmetric,barely,base,becoming,beneat,berry,blade,branch,branched,bright,broadly,brown,calyx,capitate,celled,central,clavate,cm,commonly,congested,connivent,corolla,covered,covering,cuneate,cylindrical,cyme,dark,dense,densely,denser,diameter,differing,directed,downward,dried,drying,due,eglandular,elliptic,erect,fewer,flat,flattened,flower,foliate,forked,found,free,fruit,geminate,glabrescen,glabrescent,glabrous,glandular,globose,gray,green,growth,hair,held,immature,initially,internodal,introrsely,irregular,lamina,lanceolate,lateral,leaf,length,less,lobe,long,long-attenuate,longer,longitudinal,lying,margin,material,mature,maturity,midpoint,minute,mm,moderately,mostly,much,narrow,near,new,normally,oblong,obovate,obtuse,often,old,older,one,one-celled,opening,other,ovary,ovate,pair,paired,pale,papillose,pedicel,petiole,pit,pointing,pore,poricidal,porrect-stellate,pubescence,pubescent,purple,rarely,ray,reaching,reniform,rounded,scandent,sessile,shape,shiny,short-stalked,shorter,shrub,simple,size,slightly,slit,smaller,sometimes,sparse,sparsely,spread,spreading,stellate,stem,stigma,style,subopposite,subsessile,surface,terminal,trichome,tube,unbranched,unequal,uniseriate,unit,upward,vein,vestiture,visible,white,whole,wide,yellow,yellowish	0.1,0.2,0.7â0.9,1.6â2,2â2.4,4â8,4â9,5-merou,absent,adaxiall,ag,also,always,alyx,apice,archin,articulated,axi,beneath,caly,camptodromous,chartaceous,closely,discolorous,distally,eaf,eed,emergent,entire,f.,frequently,ilament,j,large,lobed,lower,maturit,membranaceous,midri,multiseriate,nflorescence,observed,orolla,oung,peduncle,perfect,plane,porrect,portion,purplish,rachi,raised,rayed,ruit,secondary,spaced,stalk,still,surfac,tuft,ud,vary,venation,ympodial,Â¾	age,appearance,arching,bark,bud,cell,color,count,filament,fruiting,habitat,inflorescence,larger,major,midrib,minor,null,position,scar,seed,stone,structure,sympodial,texture,tip,width,wing,young
79	wfo-0001026740	success	171	153	117	54	36	0.684	-2,0-10,0.5-1,1-10,1-2,1-3,1-4,1-5,10-20,10-30,2-3,2-4,2.5-27,2.5-3,3-15,3.5-40,5-40,5-8,6-10,abaxially,absent,acuminate,acute,acute-acuminate,adaxially,also,apart,apex,apiculate,articulated,basal,base,blade,branched,calyx,cell,ciliate,cm,connivent,cordate,corky,curled,darker,deltate,densely,diameter,eglandular,ellipsoidal,elliptic,especially,flattened,flower,fruit,glabrate,glabrous,glandular-puberulent,greenish,hair,immature,lanceolate,lobe,long,margin,mature,mm,moderately,narrowly,near,nearly,oblong,obtuse,often,ovate,ovoid,pedicel,pedicellar,petiole,pilose,present,puberulent,pubescent,purple,rarely,remnant,reticulate,scar,sessile,simple,small,sometimes,spaced,sparsely,stellate,stigma,stone,stripe,style,subcoriaceous,time,tomentose,toward,tree,triangular,truncate,tube,unbranched,unit,unlobed,vein,villous,white-puberulent,whitish,wide,woody,x,yellow,young	-17,1-12,2.5-4.5,2.5-6,20-50,3-3.5,3-5,3-foliat,4-5,4.5-10,8-19,absen,aggregate,ape,axe,beyond,browni,connective,cylindrical,directed,distally,eaf,eed,entire,equal,exceeding,exserted,fleshy,leaving,lon,lower,nflorescence,nther,orange,orolla,peduncle,perfect,pilo,pore,rachi,radiu,ruit,shorter,slightly,stamen,swelling,tal,tems,thecae,truncat,ud,vary,violet,ympodial	3-foliate,anther,anthesi,appearance,bark,bud,color,corolla,count,filament,free,fruiting,growth,habitat,inflorescence,lateral,leaf,length,major,mentioned,minor,new,ovary,position,seed,shape,size,stem,structure,surface,sympodial,tall,texture,tip,width,wing
80	wfo-0001026752	success	169	154	113	56	41	0.669	-25,-3,-4,-50,0-,1,1-1.5,1-12,1-2,1-3,1-5,1.5-2,1.5-2.5,10-20,15-35,2,2-2.5,2-4,2.5-20,2.5-5,3,3-18,3-5,4-45,4-5,7-15,abaxially,abruptly,acute,adaxially,aggregate,also,apex,apiculate,basal,base,beyond,black,blade,branched,calyx,cell,cm,connivent,cordate,coriaceous,cuneate,cylindrical,darker,deltate,densely,diameter,dilated,distally,ellipsoidal,elliptic-oblong,elliptic-ovate,exserted,finely,flattened,fleshy,flower,forked,fruit,glabrous,globose,green,greenish-brown,hair,immature,lanceolate,lobe,long,margin,mm,moderately,narrowly,obtuse,ovoid,papillose,pedicel,petiole,pilose,possibly,presence,pubescent,pubescent-pilose,purplish,rarely,ripe,short-acuminate,simple,slightly,small,stamen,stigma,stone,stripe,style,time,tree,triangular,truncate,tube,unbranched,unit,vein,violet,white,whitish,wide,x,yellow	1-6,1.5-12,2-3,20-30,3-4,3-foliat,3.5-4,8-16,absent,apart,ape,articulated,axe,campanulate,capitat,chartaceous,connective,directed,eaf,eed,entire,equal,exceeding,laterally,leaving,less,lon,lower,near,nearly,nflorescence,nther,orolla,pedicellar,peduncle,perfect,pilo,pore,present,rachi,radiu,rather,remnant,ruit,somewhat,spaced,stellate,tal,tem,thecae,tomento,ud,unknow,vary,yello,ympodial	3-foliate,anther,anthesi,appearance,bark,bud,capitate,color,corolla,count,filament,free,fruiting,growth,habitat,inflorescence,lateral,leaf,length,major,mentioned,minor,new,ovary,position,scar,seed,shape,size,stem,structure,surface,sympodial,tall,texture,tip,tomentose,unknown,width,wing,young
81	wfo-0001026754	success	176	161	130	46	31	0.739	-6+,0.5,0.5-1,0.9-1.1,1,1-,1.5-3,1/2,10,2,2-2.5,2-3,2-4,2.5-3.5,2/3,3-4-celled,30+,4-5,5-lobed,5.5-9,7-9,9,9-11,abaxially,acute,adaxially,along,anther,anthesi,apex,apparently,asymmetric,axi,base,berry,branched,broadly,cabrera,calyx,clavate,cm,complete,conical,connivent,corolla,deeply,dendritic,densely,diameter,distal,divided,ellipsoid,elliptic,especially,extending,fide,filament,flower,free,glabrous,globose,growth,half,inflorescence,irregularly,lamina,later,lateral,leaf,lengthening,like,lobe,lobed,long,loosely,lower,many,margin,mature,midvein,minute,minutely,mixture,mm,mostly,narrowly,new,oblique,outline,pair,pedicel,petiole,pinnate,planar,pore,poricidal,pubescent,scandent,scar,seen,simple,slit,sometimes,spaced,sparsely,splitting,stellate-rotate,stem,stigma,style,surface,terminal,time,tip,transparent,trichome,truncate,tube,twining,uniseriate,unit,upper,vein,vine,way,white,woody,x,yellow,yellowish	.5,198.,5,5-merou,ag,alyx,apar,ark,articulated,basal,brow,cucullat,denser,eaf,ed,entire,exerted,halfway,ilament,leaving,membranous,nflorescence,older,orolla,papillo,peduncle,peg,perfect,plurifoliat,portion,primary,puberulent,ruit,sleeve,slender,small,spreading,tangled,tem,tub,twinin,ud,vary,weak,within,ympodial	1983,age,apart,bark,brown,bud,cell,color,count,cucullate,fruit,fruiting,habitat,length,major,minor,null,ovary,papillose,plurifoliate,position,seed,shape,size,stone,structure,sympodial,texture,width,wing,young
82	wfo-0001026756	success	147	146	118	29	28	0.803	.25,.5,0-7-1.2,0.25-0.5,0.5-1,0.5-3,1-1.5,1-2,1.5-1.7,1.5-10,1.5-2,1.5-3,1.8-3,3-4,3.5-8.5,5-10,5-10-flowered,6-10,6-16,abaxial,acute,along,anther,anthesi,apex,apiculate,attenuate,bark,base,berry,bilobed,broadly,brown,calyx,closely,cm,conical,corolla,dark,deltate,dendritic,densely,denser,dia,difoliate,distal,elliptic,erect,filament,fleshy,free,fruiting,glabrescent,glabrous,globose,green,hard,lamina,lateral,lax,leaf,like,lobe,lobed,long,main,major,middle,minor,minutely,mm,nearly,occasionally,older,opposite,ovary,ovate,ovoid-reniform,pair,pale,pedicel,pericarp,petiole,pinkish-white,pitted,planar,pore,poricidal,pubescent,rest,scar,shape,shaped,shrub,simple,soon,spaced,sparsely,stem,stigma,style,surface,tall,tear-drop,thick,tip,tree,trichome,tube,unifoliate,uniseriate,unit,vein,white,wide,widest,woody,young	5-5.5,abaxially,adaxially,ba,corresponding,deflexed,differing,eaf,edicel,eed,exserted,geminat,grayish-brow,inflorescenc,irregular,lower,nflorescence,overlappin,papillo,perhaps,portion,present,pubescence,ruit,somewhat,strongly,tub,ud,ympodial	appearance,bud,cell,color,count,diameter,flower,fruit,geminate,grayish-brown,growth,habitat,inflorescence,length,margin,mentioned,new,overlapping,papillose,position,seed,size,stone,structure,sympodial,texture,width,wing
83	wfo-0001026777	success	168	142	119	49	23	0.708	.5,0.25-0.5,0.5-1,0.5-1.5,0.5-5,0.9-3,1-1.3,1-1.5,1-10,1-4,1.2-1.8,1.5-3,1.5-5,2-4.5,2-5,3-3.5,4-8,5-14,5-7,acuminate,acute,anther,anthesi,apart,apex,apiculate,axil,base,beneath,blue,brown,calyx,campanulate,capitate,cell,cm,corolla,cup,decurrent,dense,difoliate,elliptic,fide,filament,filiform,flattened,flattened-reniform,free,fruiting,glabrate,glabrous,globose,green,growth,irregularly,lateral,leaf,lobe,long,main,major,margin,matted,minor,minutely,mm,narrowly,new,occasionally,often,onto,opposite,outline,ovary,pair,papillose,pedicel,petiole,pitted,planar,pore,poricidal,prominent,pubescent,quadrate-deltoid,quite,russet,scar,seed,shaped,shiny,shrub,sinuate,size,slightly,somewhat,spaced,sparsely,stem,stigma,style,surface,tall,tear-drop,testa,tip,trichome,tube,tuft,uniseriate,unit,vein,vellozo,wall,white,woody,x,yellowish,young	.25,/3,1-2,2-4,5-50-flowered,ba,beginning,berry,body,branching,deflexed,dia,differing,distal,eaf,edicel,eed,end,exserted,flexuous,geminat,greyi,hyaline,incrassate,inflorescenc,like,lobed,lon,lower,middle,near,nearly,nflorescence,older,one,overtopping,papillo,portion,rest,ruit,smooth,soon,straight,tapering,thread-like,ud,way,widest,ympodial	5-50,appearance,bark,bud,color,count,diameter,flower,fruit,geminate,greyish,habitat,inflorescence,length,mentioned,position,shape,stone,structure,sympodial,texture,width,wing
84	wfo-0001026819	success	218	161	127	91	34	0.583	0.5-1.5,1-2,1-2.3,2-5,2.5-5,3-120,3-18,3-20,3-35,3-38,4,4-10,5-30,6-11,abaxially,acumen,acuminate,acute,adaxially,along,anther,apex,ascending,attenuate,base,blue,borne,brownish,bud,capitate,cell,chartaceous,ciliate,cm,condition,connate,connivent,corolla,covering,cuneate,dark,densely,diameter,distal,dot,drying,especially,filament,flower,forked,fresh,fruit,generally,glabrous,glaucous,globose,green,green-white,greenish,greenish-yellow,hair,half,herb,lanceolate,lateral,light,like,lobe,long,make,margin,membranous,midvein,minutely,mm,moderately,mottled,mucilaginous,non-glandular,oblique,odd-pinnate,often,ovoid,pedicel,pentagonal,petiole,plant,plurifoliate,puberulent,pubescent,purple,rachi,rotate-pentagonal,scattered,seed,short,slightly,sometimes,star,stem,stigma,stripe,style,subglabrous,subrosette,subtending,symmetrical,tall,terminal,testal,thick,throughout,tinged,tip,tri-,truncate,tube,unit,unwinged,violet,wall,wet,white,whitish,wide,wing,yellow	0-27,0.3-4.7,1-10,1-5,1.2-36,1.5-10,1.5-12,1.5-3.0,1.5-3.3,1.5-3.5,1.6-3.5,10,10-26,2-6,4-7,5-merou,7,absent,ag,alyx,apart,articulated,bearing,blade,broadly,clavat,curved,decurrent,digestion,dorsally,eaf,edge,eed,elliptic,end,enzyme,erec,exceeding,flat,folded,geminat,glabrou,greatly,hair-like,homostylous,honeycomb-shaped,interjected,larger,leaflet,lengthening,living,lower,lunate,middle,narrowly,nflorescence,orolla,ovate,pair,pedice,peduncle,petiolule,pore,poricidal,ranging,removed,ruit,scale-like,seudostipule,singly,slit,somewhat,spaced,specimen,stamen,ste,stolo,straight,subequal,suborbicular,tamen,tem,tertiary,therefore,tuber,typically,usually,vary,within,without,ympodial	'hair-like,anthesi,appearance,bark,calyx,clavate,color,count,erect,free,fruiting,geminate,growth,habitat,inflorescence,leaf,length,major,mentioned,minor,new,ovary,position,scar,shape,size,stone,structure,surface,sympodial,texture,vein,width,young
85	wfo-0001026821	success	204	143	104	100	39	0.51	.2,/3,0-20,0.2-1.5,0.5-1.2,0.5-3.5,0.7-1.8,1-1.5,1-5,1.5-2.5,17,2-celled,3-18,3-branched,3-celled,4-4.5,5-12,5-20,5-34,acuminate,angular,anther,apex,apical,apically,appressed,basal,base,bayonet,broadly,brown,cell,chartaceous,cm,cordate,dark,deltate,diameter,due,ellipsoidal,filament,flattened,flower,forked,fruit,gglobose,glabrous,gland-tipped,green,hair,herb,incurved,lanceolate,lateral,leaf-opposed,length,light,lobe,long-attenuate,margin,mature,mean,membranous,mm,moderately,much,narrowly,oblique,oblong,obtuse,occasional,occasionally,odd-pinnate,one-celled,pale,pedicel,petiole,pilose,plurifoliate,puberulent,pubescent,rarely,remnant,rounded,scandent,slender,small,smaller,somewhat,sparsely,stigma,stripe,style,subglabrous,surface,thickening,tri-,tube,unbranched,unit,wall,white,winged,x	0.3-1.2,0.3-2.5,0.4-1.5,0.8-1,1-2,1-20,1-3,1.2-1.5,10-15,1977,2-15,2-3.5,2-6,2.5-18,3-11,3-6,3-7,5-10,5-merou,abaxially,acut,adaxial,adaxially,ag,alyx,anderson,apart,apiculate,articulated,auriculate,axe,ba,berry,blade,bract,ciliat,cuneate,directed,distal,distally,eaf,eed,elliptic,equal,especially,exceeding,frequent,fused,geminat,glabrou,greatly,homostylous,interjected,interstaminal,large,leaflet,long,longitudinal,lower,lowermost,many,membrane,minute,minutely,nflorescence,obliquely,opening,orolla,pair,paired,peduncle,per,perfect,petiolule,pore,present,pseudostipular,pubescen,rachi,reduced,reniform,ruit,seudostipule,short,slightly,slit,spaced,stamen,stellate,substellate,subtended,tamen,tem,terminal,time,truncat,vary,wide,yellow,ympodial	anthesi,appearance,bark,bud,calyx,ciliate,color,corolla,count,free,fruiting,geminate,growth,habitat,inflorescence,leaf,major,mentioned,minor,new,ovary,position,scar,seed,shape,size,stem,stone,structure,sympodial,texture,tip,truncate,vein,width,wing,young,â,â
86	wfo-0001026827	success	143	137	111	32	26	0.776	0.4-0.6,0.5-2,0.6-1,1-,1-1.1,1-1.5,1-2,1-2.1,1.3-1.6,1.5-2,2-2.2,2-2.5,2-4,3-9,5-6,7-9,abaxially,acute,age,and/or,anther,anthesi,apart,apex,appearing,arachnoid,attenuate,bark,base,branched,broadly,calyx,clavate,cm,conical,corolla,deltate,dendritic,dense,densely,diameter,distally,drying,ellipsoid,erect,especially,exerted,filament,flower,free,glabrescent,glabrous,growth,inflorescence,internodal,irregularly,known,lamina,lanceolate,leaf,lengthening,less,like,lobe,margin,minutely,mm,narrowly,near,new,oblanceolate,ovary,pair,paler,papillate,pedicel,petiole,planar,plane,pore,poricidal,primary,pubescent,rachi,reddish,scar,shrub,simple,sinus,slender,slit,small,soon,sparsely,stem,stigma,strongly,style,surface,terminal,third,tip,trichome,tube,uniseriate,unit,upper,vein,white,widest,x	.5,/3,0.2-0.5,?,adaxiall,branch,crowded,deciduou,dry,eaf,fleshy,know,lobed,lower,nflorescence,nodding,ot,papillat,peduncle,perfect,plurifoliat,portion,revolute,stout,straight,surfac,thick,thickened,tub,ud,way,ympodial	adaxially,appearance,bud,cell,color,count,deciduous,fruit,fruiting,habitat,lateral,length,major,minor,plurifoliate,position,seed,shape,size,stone,structure,sympodial,texture,width,wing,young
87	wfo-0001026830	success	198	172	139	59	33	0.702	0-10,0.3-1.3,0.5-1.0,1-2,1.5-4,10-57,2.5-4.4,2.5-5,4-14.5,4.4-14.5,4.5-17.5,5-11,6-13,7-18,abaxially,acumen,acuminate,acute,adaxially,along,anther,apex,apparently,arranged,asymmetric,attenuate,axillary,base,basiscopic,bead,berry,blade,brown,brownish,bud,cell,ciliate,clavate,cm,condition,connivent,coriaceous,corolla,covering,deep,diameter,distal,dorsally,drying,eaf,edge,filament,finely,flat,flower,folded,forked,fresh,fruit,geminat,generally,glabrescent,glabrous,globose,green,green-white,greenish,hair,hair-like,half,herb,interjected,lanceolate,lateral,leaf,leaflet,light,like,linear,lobe,long,make,margin,medium,mm,moderately,moniliform,mucilaginous,multiple,necklace,odd-pinnate,orbicular,ovate,ovoid,pedicel,perfect,petiole,petiolulate,plant,plurifoliate,puberulent,pubescent,purple,ripe,rounded,seed,sessile,short,side,simple,size,stigma,stolon,stripe,style,subglabrous,subtending,tall,terminal,testal,thick,throughout,tip,tissue,tri-,tube,tuber,typically,unit,unwinged,usually,wall,wet,white,whitish,x,yellow,yellowish,ympodial	0.4-1,0.5-1.2,0.9-1.9,1-10,1-11,1.1-2.7,1.4-4,2-4,2-6,2.7-8,3.5-8.5,4-10,4-7,5-merou,adaxiall,ag,alyx,apart,articulated,axe,capitat,decreasing,digestion,eed,elliptic,enzyme,erec,exceeding,glabrou,hal,high,homostylous,honeycomb,lengthening,living,lower,nflorescence,orolla,pair,peduncle,pentagonal,pore,poricidal,removed,rotate,ruit,seudostipule,shaped,slit,spaced,specimen,stamen,straight,subequal,subglabrou,tamen,tem,toward,vary	anthesi,appearance,bark,calyx,capitate,color,count,erect,free,fruiting,geminate,growth,habitat,inflorescence,length,major,mentioned,minor,new,ovary,position,scar,shape,stem,stone,structure,surface,sympodial,texture,vein,width,wing,young
88	wfo-0001026831	success	207	124	96	111	28	0.464	-6.5,-9,/4,0.2-1,0.3-0.65,0.5-1.2,0.6-2,0.7-1.1,0.7-2,1-2,1-2.2,1-2.5,1-4,1.2-2,1.5-2.5,1/3,2-4,3-5,abaxially,acute,anther,apex,apparently,attenuate,bark,base,branched,bright,calyx,cell,cm,connivent,deltate,densely,diameter,difoliate,elliptic,elongating,filament,flattened-reniform,flower,free,fruit,fruiting,fully,glabrescent,glabrous,herbaceous,lateral,leaf,length,lobe,long,margin,mature,maturity,mauve,mm,moderately,narrow-cuneate,one,open,opening,orange,outline,ovate,pair,pale,pedicel,petiole,prickly,raised,rounded,scar,shiny,smooth,sparsely,spherical,spreading,stellate,stellate-pubescent,stem,style,surface,tapering,terete,time,tip,tube,unit,upper,vein,white,white-gray,wide,young	-0.25,-5,.5,0-10,0-20,0-3,0-6,0.1,0.1-0.2,0.1-0.25,0.15-0.25,0.2-0.4,0.3-0.6,0.6,0.65-1,1-10,1-3,1-6,1/3-1/,1/3-2/3,1/5-1/4,2-2.5,2-3,2.3-2.9,2.5-4.5,3-6,3.5-10,5-merous,7-10,7-8,alyx,apar,apart,apically,articulated,berry,blade,broad-deltate,brow,caudat,chartaceous,concolorous,cream,curved,dark,distance,drying,dull,eaf,eed,equal,erect,extending,eye,geminat,gray-brown,green,infructescence,less,lobed,longer,lower,marking,membranous,midpoint,midvein,multangulate,naked,nflorescence,oblong,occasionally,older,orange-brown,orolla,oung,peduncle,pendulous,per,perfec,pericarp,poricidal,porrect,portion,prickl,prickle,primary,ray,red-brown,reduced,ruit,scandent,sessile,shorter,shrub,side,slender,sometimes,spaced,stalk,subsessile,tamen,tertiary,trichome,usually,vary,venation,visible,way,yellow,yellow-green,ympodial	0.5,anthesi,appearance,brown,bud,color,corolla,count,geminate,growth,habitat,inflorescence,major,mentioned,minor,new,ovary,position,seed,shape,size,stigma,stone,structure,sympodial,texture,width,wing
89	wfo-0001026841	success	139	134	106	33	28	0.763	.5,/4,0.25-0.3,0.25-0.5,0.5-1,0.5-2,0.75-1,0.8-1,0.8-3,1.5,1.5-2,2-2.5,3-6.5,3.5-5,4-8,5-8-flowered,6-8,7-9,9.2-18,acute,along,anther,anthesi,apart,apex,arch,axi,bark,base,beneath,bi-lobed,broadly,calyx,clavate,cm,conical,corolla,curly-tipped,decurrent,deltoid,ellipsoid,elliptic,exsertion,filament,free,fruiting,glabrate,glabrous,globose,green,hyaline,immature,inflorescence,joined,known,later,lateral,leaf,like,lobe,long,main,margin,middle,minutely,mm,older,opposite,ovary,pair,papillose,pedicel,petiole,poricidal,prominent,pubescent,raised,reddish,reflexed,rest,scar,series,shining,shrub,simple,slightly,spaced,sparsely,stem,stigma,style,tall,tip,trichome,tube,unevenly,uniseriate,unit,vein,way,white,widest,winged,woody,x,young	.25,0.05,0.5-0.75,0.6-1,ba,berry,coroll,deflexed,dia,eaf,edicel,eed,filiform,greyish-gree,lobed,lon,lower,nflorescence,paler,papillo,pore,portion,ruit,shaped,slender,straight,tapering,tear-drop,terminal,thickened,ud,unifoliat,ympodial	appearance,bud,cell,color,count,diameter,flower,fruit,greyish-green,growth,habitat,length,major,mentioned,minor,new,position,seed,shape,size,stone,structure,surface,sympodial,texture,unifoliate,width,wing
90	wfo-0001026849	success	180	153	124	56	29	0.689	-50,0-10,0.5-1,1,1-1.5,1-2,1-6,11,2,2-3,30-,38/2,40,5,5-10,637/2,7-8,acute,adherent,adult,anther,apex,appearing,aspect,aster,axil,base,calyx,capitate,cell,cm,conical,conspicuous,corolla,cut,cyme,deflexed,developed,discoidal,distinctly,ellipsoid,emarginate,entire,erect,exceeding,except,expanded,facetted,filament,floral,flower,flowered,fork,free,fruiting,general,glabrous,glandular,globose,globular,green,growth,hair,half,inflorescence,interacuminal,large,lavender,leaf,less,linear-lanceolate,lobe,long-cuneate,margin,maturity,mid-vein,minute,minutely,mm,oblong,oblong-lanceolate,often,ovary,pedicel,peduncle,petal,petiole,preparation,rarely,relatively,reproducing,reticulate,rh,rhachi,rotate,rounded,sea,seed,shallow,short-lived,shrub,simple,sinus,slightly,soft-wooded,somewhat,stem,stigma,stone,stout,style,surface,thus,tip,tissue,tube,unarmed,unit,vegetatively,violet,way,well,x,young	1.5-2.5,1.75-2,100-130,80-,amongst,australian,berry,brown,colour,composed,curved,dia,distinct,eed,enlarge,exerted,filled,flesh,granule,greater,gree,grey-brown,leave,lengthening,little,lon,long,loosely,lower,mature,native,nflorescence,occasionally,pal,pale,pedicellate,plurifoliat,pore,poricidal,pruinose,purple,ruit,ruiting,shed,slende,slit,solanum,solitary,sometimes,soon,stony,tub,ud,undulate,uvenile,ympodial	anthesi,appearance,bark,bud,color,count,diameter,enlarged,fruit,habitat,juvenile,lateral,length,major,minor,new,null,plurifoliate,position,scar,shape,size,slender,structure,sympodial,texture,vein,width,wing
91	wfo-0001026858	success	153	145	104	49	41	0.68	-30,0.5,0.8,1-4,1.3-1.5,1.5-4,2-2.5,2-3,2-4,2.5-3,3-,3-4,3-6-foliat,4-24,4.5-10.5,5-15,6-10,6-18,6-7,abaxially,acumen,acute,adaxially,apex,base,branched,calyx,cell,cm,connate,cordate,corolla,covering,cuneate,cyme,diameter,dichasial,dichasially,digestion,distal,dorsally,eaf,ebracteate,edge,enzyme,exceeding,filament,flat,flower,folded,forked,generally,glabrescent,glabrous,globose,green,hair-like,half,herbaceous,honeycomb,lateral,leaf,light,lobe,long,make,minute,mm,monochasial,mucilaginous,mucronate,oblique,oblong,obtuse,odd-pinnate,ovoid,pattern,pedicel,perennial,petiole,plan,plant,reveal,rounded,seed,seudostipule,shiny,size,slightly,stamen,stellate,stigma,straight,style,testal,thick,throughout,triangular,tuber-bearing,typically,unit,wall,wide,without	-4,0-.,0.8-1,1-,1-10,1-11.5,1-5,abruptly,apical,apically,articulate,dehiscent,diminishing,eed,emoval,globo,green-white,interjected,introrse,leaflet,living,lon,lower,lunat,maturing,nflorescence,nther,often,orolla,ovate,ovate-lanceolate,pair,peduncle,perfect,poricidally,proximal,ruit,short,slit,specimen,tal,tem,throughou,toward,vary,white-crea,yellow,ympodial,Â¼	3-6-foliate,anther,anthesi,appearance,bark,bud,color,count,free,fruit,fruiting,growth,habitat,inflorescence,length,lunate,major,margin,minor,new,null,ovary,position,removal,scar,shape,stem,stone,structure,surface,sympodial,tall,texture,tip,tube,vein,wet,white-cream,width,wing,young
92	wfo-0001026895	success	166	154	128	38	26	0.771	0-0.5,0.5-1,0.5-1.2,0.5-1.5,0.5-2,0.8-1,1-1.5,1-5,1.4-2.1,1.5-2,2-2.3,2.5-3.2,3-12,4.5-5,5-6,5-8-flowered,abaxial,acute,along,anther,anthesi,apex,apical,apically,attenuate,bark,base,borne,broad,broadly,brown,calyx,campanulate,capitate,closely,cm,conical,corolla,dark,deltoid,dendritic,denser,dia,differing,difoliate,drying,ellipsoid,elliptic,elongate,filament,flattened,free,fruiting,glabrate,glabrous,globose,green,incrassate,internodal,lamina,lateral,leaf,lobe,long,main,major,margin,middle,minor,minute,minutely,mm,mustard,narrowly,obovate,often,older,ovary,pair,pale,pedicel,petiole,pitted,pointed,pore,poricidal,present,projection,pubescent,reddish,reniform,scar,scattered,shape,shaped,shoot,short,shrub,shrublet,side,simple,size,small,soon,spaced,sparsely,stem,stigma,style,surface,swollen,tall,tan,tear-drop,thin,tip,trichome,tube,uniseriate,unit,usually,vein,white,widest,woody,x,yellow,young	.5,2-2.5,2-3,2/3,adaxial,appearing,ba,berry,contracted,deflexed,eaf,edicel,eed,erect,filiform,geminat,hard,like,lobed,lon,long-exserted,lower,nflorescence,overlappin,papillo,pericarp,portion,reddish-brow,ruit,somewhat,swollen-based,toothed,tub,tuft,type,ud,way,ympodial	appearance,bud,cell,color,count,diameter,flower,fruit,geminate,growth,habitat,inflorescence,length,mentioned,new,overlapping,papillose,position,reddish-brown,seed,stone,structure,sympodial,texture,width,wing
93	wfo-0001026905	success	204	178	151	53	27	0.74	-10,-2,.2,.5,0,0-20,0.1,0.15,0.2-0.3,0.2-0.5,0.3-0.4,0.4-0.9,0.4-1,0.5-0.7,0.5-1.5,0.6-0.7,0.7-1.4,0.9-1.3,1,1-2,1-2.5,1-20,1-3.7,1-4,1-6,1/2-3/4,1/3,1/5-1/3,2-3,3-5,3-8,6-8,7-8,abaxially,acute,ame,anther,apart,apex,apically,apparently,attenuate,bark,base,blade,branched,c.,calyx,cell,cm,connivent,cream,curved,dark,deltate,densely,diameter,difoliate,dull,elongating,erect,eye,filament,flattened-reniform,flower,free,fruit,fruiting,green,inflorescence,lateral,leaf,length,lobe,lobed,long,longer,lower,margin,marking,mature,maturity,mauve,midpoint,mm,moderately,naked,oblong,older,one,open,orange,orange-brown,outline,ovate,pale,pedicel,petiole,pit,porrect,prickle,prickly,raised,ray,red,reduced,rounded,scar,sessile,shorter,shrub,slender,small,smooth,sometimes,somewhat,spaced,sparsely,spherical,spreading,stalk,stalked,stellate,stellate-pubescent,stem,straight,style,subentire,surface,tapering,terete,tertiary,time,tip,trichome,tube,unarmed,unit,upper,usually,variously,vein,venation,visible,way,weakly,white,wide,woody,yellow,young	-1.5,-2/3,-3,-4,0-2,0-25,0.4,0.75-1.1,1.9-2.5,1/4,2.5-2.9,2.5-3.5,2/3-3/,5-6,5-merous,acuminat,alyx,apar,articulated,berry,brow,chartaceous,discolorous,distance,drying,eaf,eed,equal,extending,geminat,glabrous,gray-green,infructescence,midvein,orolla,oung,pair,peduncle,pendulous,per,perfec,pericarp,poricidal,portion,prickl,primary,ruit,shallowly,side,tamen,vary,yellow-green,ympodial	acuminate,anthesi,appearance,brown,bud,color,corolla,count,geminate,growth,habitat,major,mentioned,minor,new,ovary,position,seed,shape,size,stigma,stone,structure,sympodial,texture,width,wing
94	wfo-0001026923	success	177	149	116	61	33	0.655	-5,.1-0.3,.5,0.25-0.5,0.5,0.5-1,0.6-0.8,1,1-1.5,1-3,1-4,1-7,1.5-2,10,2-3,2-6,20-50,3-5,4-18,4-5-,5-10,5-15,5-9,abaxially,absent,acuminate,acute,adaxially,anther,apex,base,black,blade,branched,calyx,chartaceous,cm,covering,cuneate,deltate,densely,denser,diameter,eglandular,elliptic,elliptic-ovate,filament,flattened,flower,forked,fruit,fruiting,geminate,glabrescent,glabrous,glandular,globose,green,hair,intermediate,lanceolate,lateral,leaf,leaf-opposed,like,lobe,long,many-foliate,margin,midpoint,midvein,mm,moderately,multangulate,nearly,oblong,pedicel,peltate,petiole,possibly,pubescence,pubescent,purple,ray,red,relatively,ripening,rounded,rugulose,scale,sessile,short,shrub,simple,small,sometimes,sparsely,stellate,stem,stigma,strongly,style,subtending,surface,time,tip,tree,trichome,tube,unit,usually,white,whitish,wide,x,yellowish	0-5,0.8-1,1.5-4,2,2-2.5,3-4,5-6,accrescent,adaxiall,ag,apart,apparently,articulated,axe,ba,brown,capitat,center,connivent,curved,cylindrical,directed,distally,eaf,eed,entire,equal,erect,frui,fused,gland-tippe,held,large,light,longitudinal,lower,much,nflorescence,opening,orange,orolla,paired,peduncle,perfect,pore,rachi,ruit,slightly,slit,smaller,somewhat,spaced,ste,straight,tal,tamen,tem,uprigh,vary,yellow,ympodial	anthesi,appearance,bark,bud,capitate,cell,color,corolla,count,free,growth,habitat,inflorescence,length,major,mentioned,minor,new,ovary,position,scar,seed,shape,size,stone,structure,sympodial,tall,texture,vein,width,wing,young
95	wfo-0001026925	success	215	176	147	68	29	0.684	.5,/6,0,0-20,0.1-0.2,0.1-0.3,0.2,0.7-1.8,0.9-1.8,1-1.3,1-1.4,1-25,1-3.5,1-4,1.5-2.5,1.5-4.5,1.8-2.5,1/3,1/3-1/2,2-5,2.4-3,2.5-6,3-20,3-7,4-10,4-14,4-7,5-8,5.5-10,6-10,6-17,6-8,7-12,abaxially,acute,ame,anther,apart,apex,apically,apparently,attenuate,bark,base,blade,branched,broad-deltate,c.,calyx,cm,connivent,cream,curved,dark,deltate,diameter,elliptic,elongating,erect,filament,flattened,flattened-reniform,flower,free,fruit,fruiting,gently,glabrescent,glabrous,green,green-brown,hair,lateral,leaf,length,lobe,lobed,long,long-styled,longer,margin,marking,mature,maturity,mauve,midpoint,minute,mm,moderately,narrow-deltate,older,one,open,orange-brown,ovate,pale,pedicel,petiole,poricidal,porrect,prickle,prickly,rarely,ray,reduced,reflexed,rounded,scar,sessile,short-styled,shrub,simple,sometimes,spaced,sparsely,spherical,spreading,stalk,stalked,stellate,stellate-pubescent,stem,stout,straight,style,surface,tapering,terete,terminal,tertiary,time,tip,translucent,trichome,tube,unit,upper,vein,venation,visible,way,white,wide,woody,yellow,yellow-orange,young	-2,0-10,0-5,0-7,0.1,0.5-1.5,0.5-4,00-200,1-3,1.5-2,1.8-2,1/4-2/3,1/6-1/3,2-4,2.4-2.6,2/,4-5,5-6,5-merous,acuminat,alyx,andromonoecious,apar,articulated,berry,brow,chartaceous,concolorous,distal,distance,drying,eaf,eed,equal,extending,hermaphrodite,heterostylous,infructescence,lobing,lower,lowermost,membranous,midvein,nflorescence,oblong,orolla,oung,pair,peduncle,pendent,pendulous,per,pericarp,plant,plurifoliat,portion,prickl,primary,red-brown,ruit,secondary,side,smooth,staminat,tamen,unarmed,vary,ympodial	acuminate,anthesi,appearance,brown,bud,cell,color,corolla,count,growth,habitat,inflorescence,major,minor,new,null,ovary,plurifoliate,position,seed,shape,size,stigma,stone,structure,sympodial,texture,width,wing
96	wfo-0001026946	success	205	184	151	54	33	0.737	0-20,0-5,0.5-2,0.9-3.5,0.9-4.3,1,1-2,1-4,1.6-3.7,10-39,12-23,2,2-15,2.5-10.5,2.7-9,3.5-10,4-7,4.1-9.4,6-24,8-15,8-25,abaxially,acuminate,acute,adaxially,along,anther,apex,apparently,attenuate,axe,axillary,base,berry,blade,borne,broadly,brownish,bud,cell,chartaceous,ciliate,clavate,cm,condition,corolla,covering,creamy,densely,diameter,digestion,distal,dot,drying,eaf,elliptic,end,enzyme,especially,except,filament,flower,forked,fresh,fruit,generally,glabrous,globose,greatly,green,green-white,greenish,hair,hair-like,half,herb,honeycomb-shaped,interjected,lanceolate,lateral,leaflet,like,lobe,long,make,margin,membranous,midrib,minutely,mm,mottled,mucilaginous,narrowly,oblique,odd-pinnate,often,orbicular,ovate,ovoid,pair,pedicel,perfect,petiole,petiolulate,petiolule,plant,plurifoliate,proximal,puberulent,pubescent,pure,purple,reduced,removed,ripe,rounded,scattered,seed,sessile,short,short-pubescent,singly,size,slightly,stem,stigma,stolo,streak,style,subequal,subtending,tall,terminal,testal,thick,throughout,tip,tri-,truncate,tube,tuber,typically,unit,unwinged,wall,wet,white,whitish,wing,x,yellow-white	1-10,1.5-2,2-5,3-20,3-5,3-6,5-7,5-merou,acumen,ag,alyx,apart,articulation,capitat,connivent,deeply,dorsally,edge,eed,erec,exceeding,extremely,flat,folded,geminat,glabrou,homostylous,lengthening,living,lower,nflorescence,orolla,peduncle,pentagonal,pore,poricidal,pubescen,ruit,seudostipule,slit,spaced,specimen,stamen,ste,stellate,straight,tamen,tem,thir,usually,variable,vary,yellow,ympodial	0-2,anthesi,appearance,bark,calyx,capitate,color,count,erect,free,fruiting,geminate,growth,habitat,inflorescence,leaf,length,major,mentioned,minor,new,ovary,position,scar,shape,stone,structure,surface,sympodial,texture,vein,width,young
97	wfo-0001026962	success	205	170	146	59	24	0.712	.05,.5,0,0.3-0.7,0.5,0.8-1,1,1-1.2,1-1.5,1-2,1-3,1-4.5,1-6,1.5-17,1.5-2,1.5-3,1.5-5,10-20,15-22,2-5,2-6,2/3-3/4,3-6,6-7,9-12,9-17,abaxially,abruptly,acute,adaxially,anther,anthesi,apex,apparently,appearing,bark,base,becoming,beneath,blade,brittle,broadly,bud,calyx,cell,chartaceous,cm,composed,connivent,constricted,corolla,deltate,densely,denser,diameter,differing,difoliate,dimorphic,elongate,evenly,except,exerted,filament,flattened-reniform,flower,free,fruit,fruiting,glabrate,glabrous,globose,green,inflorescence,internodal,later,lateral,leaf,like,lobe,lobed,long,main,major,margin,minor,minutely,mm,obconic,oblong,obovoid,occasionally,older,one,opposite,outline,ovate-lanceolate,pair,pale,papillose,pedicel,peduncle,perfect,petiole,pitted,prominent,pubescent,purplish,rachi,raised,reflexed,remaining,rest,rounded,rounder,sagittate,shrub,simple,size,slightly,small,sometimes,somewhat,soon,stem,stigma,style,surface,tinged,tip,tree,triangular,trichome,trunk,tube,unarmed,unbranched,unifoliate,uniseriate,unit,vein,way,white,x,yellow,yellowish,young	0.5-0.8,0.5-1,0.5-1.5,10-12,2-2.5,3-3.5,4-5,abrupt,accrescent,ag,alyx,arising,articulated,axe,basebud,capitat,closely,cucullat,cylindrical,darker,deflexed,dry,eaf,eed,elliptic,entire,geminat,glabrou,ilament,incrassate,longitudinal,material,narrowly,nflorescence,often,opening,orolla,oung,overlapping,packed,paten,pendent,pore,portion,pubescen,ruit,shaped,slender,slit,stellate,straight,tal,tapering,tear-drop,tooth,vary,whit,woody,ympodial	appearance,capitate,color,count,cucullate,geminate,growth,habitat,length,new,null,ovary,patent,position,scar,seed,shape,stone,structure,sympodial,tall,texture,width,wing
98	wfo-0001026964	success	128	126	95	33	31	0.742	.2,.5,0,0.5-1,1-1.2,1-2.5,10,10-30,2-2.5,2-4,3-5,3.5-7,7-8,?,acuminate,acute,along,anther,anthesi,apex,attenuate,axillary,base,beak,bearing,berry,calyx,cm,conical,conspicuously,corolla,diameter,distinct,elliptic,filament,filiform,fleshy,flower,free,fruiting,glabrous,globose,green,greenish,herb,lateral,leaflet,lenticellate,lightly,line,lobe,lobed,long,margin,minutely,mm,nearly,obovate,one,open,ovary,pair,papillate,pedicel,petiole,pinnate,poricidal,primary,pubescent,purple,reflexed,rugose,scar,shape,side,simple,size,slender,small,smooth,somewhat,sparsely,stigma,style,surface,time,tip,trichome,tube,uniseriate,unit,vein,winged,x,yellow	0.5,4.5-8.5,basal,capitat,differentiated,eaf,edicel,equal,erec,exserted,glabrou,horizontal,immature,known,long-attenuate,lower,nflorescence,noddin,often,onto,ot,petiolule,portion,purpli,rachi,ruit,tal,tem,terminal,tub,ud,unifoliat,ympodial	appearance,bark,bud,capitate,cell,color,count,erect,fruit,growth,habitat,inflorescence,leaf,length,major,mentioned,minor,new,position,purplish,seed,stem,stone,structure,sympodial,tall,texture,unifoliate,width,wing,young
99	wfo-0001026981	success	252	163	134	118	29	0.532	-0.4,-0.8,-2.5,-35,-8,.2,.2-0.2,0-5,0.05-0.1,0.25-0.4,0.3-0.5,0.3.6,0.45-1.3,0.5-0.3,0.5-30,0.6-2,0.9-1.5,1-2,1.5-8.5,1.8-2.8,11,2-3-branched,3-foliate,3.5-14,4,4-celled,6-10,7.5,abaxially,abundant,academy,acute,adaxially,adpressed,along,anther,anthesi,apex,appearance,appressed,asymmetric,base,bay,beak,becoming,calyx,capitate,cell,cm,cone,conical,cordate,corolla,dark,deltate,densely,diameter,erect,filament,flower,fruit,fruiting,giving,glabrescent,glandular,globose,green,hair-like,head,herb,imparipinnate,initially,interrupted,later,lateral,leaf,lime,linear,lobe,long,margin,maturity,minutely,mixed,mm,much,multicellular,narrowly,obovate,orange,outgrowth,ovary,pedicel,perennial,petiole,procumbent,pronounced,pubescent,robust,rounded,shaggy,shaped,short,silky,simple,slender,smaller,sometimes,sparsely,sparser,stem,stigma,style,surface,tangled,testa,tightly,transparent,trichome,tube,uni-,uniseriate,unit,upto,variously,velvety,villous,viny,wall,wide,winged,yellow,â,â	-14,-2,-4,0.1-0.2,0.1-0.3,0.15-0.2,0.2,0.2-0.4,0.2-2,0.4-0.5,0.4-0.7,0.4-2,0.5,0.6-1.4,0.7-0.8,0.8-1.2,0.8-6,0.9-1.4,1,1-2-cellular,1-3,1-3-celled,1-3.3,1-4,1.5-2.0,1.5-5,1/3,196.,2-3,2-locular,4-8,<,absen,absent,accrescent,amongst,angled,apical,appendage,articulated,articulation,axi,basiscopically,bract,bracteole-like,brown,citrus-like,coastal,column,composed,d,distal,eaf,ebracteate,edicel,eed,entire,exserted,gree,half,halfway,included,interjected,internode,irregularly,jointles,larger,leaflet,less,like,lobed,lon,lower,mainly,nflorescence,occasionally,orbicular,ovate,pair,pale,patent,peduncle,pentagonal,per,petiolule,plant,population,present,primary,proximal,pseudostipule,pubescence,rachi,reflexed,rick,ruit,scen,secondary,see,sessile,several,shorter,specimen,spreadin,staminal,sterile,straight,strong,tem,terminal,tertiary,thick,tub,type,unicellular,usually,without,ympodial	acrescent,bark,bud,color,count,free,growth,habitat,inflorescence,length,major,mentioned,minor,new,position,scar,seed,shape,size,spreading,stone,structure,sympodial,texture,tip,vein,width,wing,young
100	wfo-0001026992	success	243	183	158	85	25	0.65	-2.5,/7,0.2-0.5,0.8-3.4,00-170,1-4,1.2-1.4,1.2-1.7,1.3-2.6,1.3-4.3,1.4-1.6,1.4-1.9,1.7-1.9,1.7-2.4,1.7-4.3,10-12,12-33,2-10,2-5.6,2.3-3.3,2.6-4.6,2.8-4.6,3-4,4-8,5-15,6-10,8-14,abaxially,abruptly,acuminate,acute,adaxially,angled,anther,anthesi,apex,appressed,approximately,attenuate,axillary,bark,base,berry,blade,blunt-tipped,branched,broadly,brown,calyx,chartaceous,cm,corolla,crown,deltoid,diameter,echinoid,elliptic,equal,filament,flat-topped,fleshy,flower,forming,free,fruit,fruiting,geminate,glabrous,globose,granular-tomentose,greenish,grooved,hair,high,immature,lacking,lance-ovate,lanceolate,lateral,leaf,length,lobe,long,long-stalked,longitudinally,many,margin,mature,maturity,midrib,mm,moderately,multangulate,nearly,oblong,obtuse,often,orange-tan,ovate,ovate-lanceolate,overlapping,pedicel,petiole,plant,plurifoliate,porrect-stellate,pubescent,rare,reniform,reticulate-punctate,ripe,scabridulous-,semi-ovate,sessile,short,short-,short-stalked,shorter,shrub,side,simple,size,small,sometimes,spaced,sparingly,spreading,stalked,stamen,stellate,stem,stigma,stout-stalked,style,subcampanulate,subglobose,surface,terete,terminal,time,tip,tomentose,tree,tube,unarmed,unequal,unit,usually,vein,velutinous,violet,white,whitish,wide,x,yellow,yellowish,young	0.25-0.45,0.5-1.2,0.6-1.5,1.5-3.4,1/2,2.8-4.7,3.3-5.5,3.3-5.6,5-merou,5.3-12.1,8,8-11,abaxial,accrescent,adaxiall,ag,along,alyx,apart,apparently,around,articulated,axe,ba,branch,capitat,completely,coriaceous,covering,cylindrical,dark,densely,directed,distally,drying,eaf,echinoi,edge,eed,entire,enveloping,evident,exserted,farinose,glabrescen,homostylous,inserted,lengthening,less,line,lobed,longitudinal,lower,m.,main,minute,mostly,nflorescence,occasional,occasionally,older,orolla,peduncle,perfect,pore,poricidal,pubescence,rachi,rather,ruit,runk,slit,somewhat,split,suture,tamen,tan,thin-textured,ud,unarme,vary,way,weakly,ympodial,Â½	appearance,bud,capitate,cell,color,count,glabrescent,growth,habitat,inflorescence,major,minor,new,null,ovary,position,scar,seed,shape,stone,structure,sympodial,texture,width,wing
101	wfo-0001026994	success	266	181	158	108	23	0.594	-0.7,-10,-20,-30,-foliate,.2,0.05-0.1,0.1-0.2,0.15-0.2,0.25,0.4-0.5,0.5,0.5-0.6,0.5-2,1-1.4,1-1.5,1-1.6,1-2,1.2-1.6,1.4-2.1,12-,2,2-,2-2.6,2.5-6.5,20-50,3,3-branched,4,4-celled,5,5-,6-20,7-13,8,abaxially,abundant,acuminate,acute,additional,adpressed,amongst,anther,anthesi,apex,apically,appearance,articulation,base,basiscopically,beneath,bent,berry,bifurcate,bifurcation,branched,bright,broader,broadly,calyx,capitate,cell,celled,cm,conical,corolla,darker,decurrent,densely,diameter,eglandular,fewer,filament,flower,fruit,fruiting,giving,glabrous,glandular,globose,grayish,green,greenish,habitat,hair-like,head,imparipinnate,inflorescence,internode,interrupted,investing,lamina,lanceolate,lateral,leaf,less,like,lobe,locule,long,loosely,margin,medial,midvein,minutely,mm,much,narrowing,narrowly,oblique,obovate,occasionally,outgrowth,ovary,paler,papillate,pedicel,petiole,puberulent,pubescent,purple,rachi,rarely,reflexed,regularly,ripe,rocky,shaggy,short,silky,simple,sinus,size,slightly,sometimes,sparsely,spreading,stem,stigma,straight,stripe,style,surface,testa,tip,trichome,tube,unicellular,uniseriate,unit,usually,velvety,wall,white,wide,winged,yellow,young	.5,0.05-0.2,0.1,0.1-0.3,0.2-0.4,0.2-0.5,0.3-0.4,0.4-1.2,0.5-0.7,0.5-0.8,0.5-0.9,0.5-1.2,0.5-1.3,0.7-2.5,0.9-1.2,0.9-1.3,1,1-1.2,1.2-3.5,10-20,2-4,2-5-locular,2.2-3.2,4-15,5-7,8-12,absent,acroscopically,along,also,andscattered,apical,appendage,articulate,basal,basally,becoming,bract,bracteate,brown,column,crenat,crenate,crowded,dark,decreasing,decumbent,deeply,developed,distal,eaf,ebracteate,edicel,eed,elliptic,erect,especially,essentially,exserted,gree,hal,half,halfway,herb,interjected,irregularly,large,larger,largest,leaflet,leave,lobed,lon,lower,markedly,moderately,narrower,nearly,nflorescence,node,often,pair,peduncle,perennial,petiolule,present,primary,pseudostipule,robust,rotate-stellate,secondary,sessile,set,specimen,spreadin,staminal,sterile,tall,tem,terminal,tertiary,thick,toward,ud,weak-walled,well,woody,ympodial	bark,bud,color,count,free,growth,length,major,mentioned,minor,new,position,scar,scattered,seed,shape,stone,structure,sympodial,texture,vein,width,wing
102	wfo-0001026996	success	188	144	109	79	35	0.58	0-6,0.6-1,0.9-2.7,1-2,1-3,1.3-7.7,1.8-4.4,14-33,15-28,2-3,3-10,3.8-14.1,4-8,4.5-10.5,8.7-18.6,abaxially,acumen,acuminate,acute,adaxially,along,anther,apex,arranged,attenuate,axillary,base,bead,berry,blade,blue,bud,cell,clavate,cm,connivent,coriaceous,corolla,covering,dark,deep,diameter,distal,eaf,filament,flower,forked,fruit,geminat,generally,glabrou,glabrous,globose,green,green-white,half,herb,interjected,lanceolate,lateral,leaf,leaflet,like,lilac,lobe,make,medium,mm,moniliform,mottled,mucilaginous,multiple,necklace,odd-pinnate,orbicular,ovate,ovoid,pedicel,petiole,plant,plurifoliate,purple,ripe,rounded,seed,sessile,size,stigma,stolon,stripe,style,subtending,tall,terminal,testal,thick,throughout,tip,tri-,tube,tuber,typically,unit,unwinged,usually,wall,wet,white,x	1-4,1-5,1.2-1.8,3-5,3-7,3.3-6,4-4.4,5-8,5-merou,6-8,6.9-10.9,abaxiall,ag,alyx,apart,apparently,articulated,asymmetric,axe,basiscopic,brownish,capitat,condition,considerably,decreasing,digestion,dorsally,drying,edge,eed,elliptic,enzyme,erec,exceeding,flat,folded,fresh,greenish,hair-like,homostylous,honeycomb-shaped,larger,lengthening,linear,living,long,lower,middl,nflorescence,orolla,pair,peduncle,pentagonal,perfect,petiolulate,pore,poricidal,removed,rotate,ruit,seudostipule,side,slightly,slit,sometimes,spaced,specimen,stamen,straight,subglabrou,symmetric,tamen,tem,tissue,toward,vary,whitish,yellow,ympodial	'hair-like,anthesi,appearance,bark,calyx,capitate,color,count,erect,free,fruiting,geminate,growth,habitat,inflorescence,length,major,margin,mentioned,minor,new,ovary,position,scar,shape,stem,stone,structure,surface,sympodial,texture,vein,width,wing,young
103	wfo-0001027010	success	198	181	148	50	33	0.747	0-2,0-2.5,0-3,0.4-5.1,0.5-1.5,1-2,1-4,1-7,1.2-1.7,1.2-1.9,1.4-6.9,10-60,14-46,2-9.4,2.1-15.3,2.1-4.3,3-10,3-6,3-8,3.5-13.6,4-12,4.4-29,4.9-31,5-14,abaxially,acumen,acuminate,acute,adaxially,along,anther,apex,apparently,arranged,asymmetric,attenuate,axe,axillary,base,basiscopic,bead,blade,brownish,bud,cell,clavate,cm,coloration,condition,connivent,coriaceous,corolla,covering,decreasing,deep,diameter,distal,dorsally,drying,eaf,edge,elliptic,filament,flat,flower,folded,forked,fresh,fruit,generally,glabrescent,glabrous,green,green-white,greenish,hair,hair-like,half,herb,interjected,lanceolate,larger,lateral,leaf,leaflet,light,like,lobe,long,make,mm,moniliform,mucilaginous,multiple,narrow,necklace,occasionally,odd-pinnate,orbicular,ovate,ovoid,pair,pedicel,perfect,petiole,petiolulate,plant,plurifoliate,purple,ripe,rounded,scabrous,seed,sessile,short,side,size,slightly,sometimes,spot,stigma,stolon,stripe,style,subequal,subtending,tall,terminal,testal,thick,throughout,tip,tissue,toward,tri-,tube,tuber,typically,unit,usually,wall,wet,white,whitish,wide,wing,winged,x	1-10,2-6,2.2-12.9,3-5,4-8,5-13,5-merou,adaxiall,ag,alyx,apart,articulated,capitat,digestion,eed,enzyme,erec,exceeding,geminat,glabrescen,glabrou,hal,high,homostylous,honeycomb-shaped,lengthening,living,lower,nflorescence,orolla,peduncle,pentagonal,pore,poricidal,present,removed,rotate,ruit,scabrou,seudostipule,slit,spaced,specimen,stamen,straight,tamen,tem,vary,yellow,ympodial	anthesi,appearance,bark,calyx,capitate,color,count,erect,free,fruiting,geminate,growth,habitat,inflorescence,length,major,margin,mentioned,minor,new,ovary,position,scar,shape,stem,stone,structure,surface,sympodial,texture,vein,width,young
104	wfo-0001027019	success	142	149	122	20	27	0.859	.5,/4,0-0.5,0.5-1,1-1.5,1-2,1.5-2,1.5-3,1/2,10,10-40-flowered,12-30,2-3,2-5,2-8,4-5,4-8.5,7-14,abaxial,abruptly,acute,adaxially,along,anther,anthesi,apex,apparent,attenuate,bark,base,branched,bright,calyx,capitate,cm,constriction,corolla,cyathiform,deflexed,deltoid,densely,dia,difoliate,distal,ellipsoid,erect,even,exserted,filament,flattened,fleshy,free,fruiting,glabrate,glabrous,globose,golden,green,inflorescence,largely,later,leaf,like,live,lobe,lobed,long,major,midrib,minor,minutely,mm,narrowed,obovate,older,onto,opposite,ovary,overlapping,ovoid-reniform,pale,papillose,pedicel,petiole,pitted,planar,plant,pore,poricidal,pubescent,scar,shaped,shrub,small,somewhat,spaced,sparsely,stem,stigma,straight,strongly,style,surface,tall,tan,tapering,tear-drop,third,tip,tree,trichome,tube,unit,waxy,way,white,widest,wing,winged,woody,x,young	abaxially,ba,berry,eaf,edicel,eed,elliptic,geminat,inflorescenc,lon,lower,nflorescence,papillo,portion,reddish-brow,rest,ruit,tub,ud,ympodial	appearance,bud,cell,color,count,diameter,flower,fruit,geminate,growth,habitat,lateral,length,margin,mentioned,new,position,reddish-brown,seed,shape,size,stone,structure,sympodial,texture,vein,width
105	wfo-0001027030	success	234	189	164	70	25	0.701	-15,.2,.5,0.05-0.1,0.15-0.2,0.2,0.2-0.3,0.3-,0.3-0.5,0.4-0.5,0.4-1.5,0.5-,0.5-0.7,0.5-0.8,0.6-0.7,0.7-1,0.8-0.9,0.8-1,1,1-1.3,1-3,1-3.4,1.6-2,2-,2-6,2-7,2-foliate,2-locular,3-4-celled,3-8,3-9,4-celled,5-12,8-celled,abaxial,abundant,acute,adaxially,adpressed,angled,anther,anthesi,apex,apical,appearance,appendage,articulation,axi,basal,base,basiscopically,beneath,berry,bract,branched,bright,brown,calyx,capitate,cell,cm,conical,corolla,dark,darker,decurrent,densely,denser,diameter,due,eglandular,evenly,exserted,filament,flower,fruit,fruiting,giving,gland,glandular,globose,grayish,green,hair-like,halfway,herb,imparipinnate,inflorescence,internode,interrupted,interspersed,investing,lamina,lanceolate,larger,lateral,leaflet,less,like,lobe,long,longer,loosely,margin,minutely,mm,multicellular,narrowly,node,oblique,obovate,occasionally,often,outgrowth,ovary,pale,paler,papillate,pedicel,perennial,petiole,pubescence,pubescent,reflexed,robust,silky,similar,simple,size,slightly,small,soft,sometimes,somewhat,sparsely,spread,spreading,stem,sterile,stigma,straight,stripe,style,surface,tall,terminal,testa,tiny,trailing,trichome,truncate,tube,unicellular,uniseriate,unit,vein,velvety,wall,white,wide,winged,woody,yellow,young	-11,0-4,0.1-0.7,0.1-0.9,0.2-1,0.3-0.7,0.4-0.8,0.5,0.5-1,0.6-0.8,0.6-1.8,0.9-1.1,1-,1-1.2,1.2-1.6,1.5-,2-3,2-4,2-4.8,2.2-3.2,abaxially,absent,acuminate,articulated,beyond,column,crenat,crenate,crenation,deeper,deeply,diamete,distal,eaf,edicel,eed,elliptic,entire,extremely,gree,growt,hal,half,interjected,irregularly,lon,lower,near,nflorescence,pair,peduncle,petiolule,present,primary,pseudostipule,rotate-stellate,ruit,secondary,sessile,slender,smaller,spreadin,staminal,tem,tertiary,thick,ud,usually,weak,ympodial	bark,bud,color,count,description,free,growth,habitat,leaf,length,major,mentioned,minor,new,position,scar,seed,shape,stone,structure,sympodial,texture,tip,width,wing
106	wfo-0001027035	success	199	162	129	70	33	0.648	0-36,0.1-0.9,0.3-2.3,0.5-3.4,0.5-5,0.5-7,0.8-4.2,1-2,1-3,1.5-5.9,1.7-8,1.8-5.2,10-80,2-38,2.8-10.3,3-10,3-5,4-18,4-18.5,4.9-23.5,abaxially,acumen,acuminate,acute,adaxially,anther,apart,apex,apparently,articulated,asymmetric,attenuate,axillary,base,basiscopic,blade,blue,bud,cell,clavate,cm,coloration,completely,connivent,corolla,covering,deep,diameter,distal,dorsally,edge,elliptic,filament,flat,flower,folded,forked,fruit,generally,glabrescent,glabrous,globose,green,green-white,hair,hair-like,half,herb,high,interjected,lanceolate,lateral,leaf,leaflet,light,lilac,lobe,long,make,medium,mm,moniliform,mucilaginous,odd-pinnate,orbicular,ovate,ovoid,pedicel,pentagonal,perfect,petiole,petiolulate,plant,plurifoliate,purple,ripe,rotate,rounded,seed,sessile,shape,short,side,size,sometimes,spaced,stigma,stripe,style,subtending,tall,terminal,testal,thick,throughout,tip,tissue,tri-,tube,tuber,typically,unit,unwinged,usually,variable,wall,wet,white,x	0-7,0.4-12.8,0.8-3,0.9-3.1,1-3.4,1-8,2-7,5-merou,adaxiall,ag,along,alyx,arranged,axe,bead,brownish,capitat,condition,decreasing,digestion,drying,eaf,eed,enzyme,erec,exceeding,fresh,geminat,glabrescen,glabrou,greenish,hal,homostylous,honeycomb,larger,lengthening,like,living,lower,multiple,necklace,nflorescence,orolla,pair,peduncle,pore,poricidal,present,removed,ruit,second,seudostipule,shaped,slightly,slit,smaller,specimen,stamen,stolon,straight,subequal,subglabrous,tamen,tem,toward,vary,whitish,wide,yellow,ympodial	anthesi,appearance,bark,calyx,capitate,color,count,erect,free,fruiting,geminate,growth,habitat,inflorescence,length,major,margin,mentioned,minor,new,ovary,position,scar,stem,stone,structure,surface,sympodial,texture,vein,width,wing,young
107	wfo-0001027050	success	244	196	167	77	29	0.684	-12,-9,.2,.5,/3,0-0.2,0-3,0.1-0.3,0.1-3,0.2-0.5,0.2-1,0.9-2.1,1,1-2,1.5-6,10-13.5,12-15,15-50+,2-3,2-4,2-5,2-8,2.5-3,3-5,4-20,4-8,5,5-10,5-6,5-7,5-9,6-8,8-26,abaxially,absent,abundant,acuminate,acute,adult,anther,apex,bark,base,branch,branched,broad,broad-based,broadly,brown,calyx,capitate,closely,cm,conical,connivent,cordate,cuneate,curved,densely,diameter,difoliate,drying,eglandular,elliptic,erect,ferruginous,filament,flattened,flattened-reniform,flower,free,fruit,fruiting,glabrous,glandular-puberulent,green,growth,hair,half,inflorescence,interpetalar,lanceolate,lateral,leaf,leaf-opposed,length,less,like,lobe,lobed,long,long-styled,margin,mature,midpoint,midvein,minute,minutely,mm,moderately,multiseriate,narrowly,oblique,obtuse,often,older,ovate,ovate-lanceolate,pale,pedicel,petiole,porrect,present,prickle,pricklier,prickly,pubescent,ray,rest,ripe,rounded,scar,scattered,sessile,several,short-stalked,shorter,shrub,slightly,small,somewhat,spaced,sparsely,spherical,stalk,stalked,stellate,stellate-pubescent,stem,stigma,straight,style,surface,tall,terete,time,tip,tissue,touching,tree,triangular,trichome,truncate,tube,unarmed,unbranched,unit,usually,way,white,whitish,wide,woody,yellow,yellowish-green,young,younger	0.3-1.5,0.5-3,0.8,1-1.5,1.5-2,2-2.5,5-merous,50,7-30+,abaxial,absen,adaxial,adaxiall,alyx,andromonoeciou,apar,arme,articulated,axe,basal,berry,blade,brow,chartaceous,coarsely,deeply,directed,distal,distall,distally,eaf,eed,entire,equal,erec,except,geminat,heterostylous,infructescence,inside,juicy,juvenile,larger,least,longer,lower,markedly,mid-way,midrib,moist,mucilaginous,near,nflorescence,numerous,occasionally,orolla,oung,papillat,peduncle,per,pericarp,plant,pore,poricidal,portion,ruit,secondary,shallowly,shiny,short-styled,side,tamen,thicker,toothed,vary,weakly,ympodial	adaxially,anthesi,apart,appearance,armed,bud,cell,color,corolla,count,geminate,habitat,major,minor,new,null,ovary,papillate,position,seed,shape,size,stone,structure,sympodial,texture,vein,width,wing
108	wfo-0001027050	success	234	194	161	73	33	0.688	.2,0-0.2,0-0.5,0-1,0-3,0.1-3,0.2-0.6,0.2-1,0.3-0.6,0.4-1,0.5-0.8,0.5-1,1-1.5,1-2,1-5,1.5-6,10-13.5,11-21,14-20,15-50+,2-10,2-3,2-3-locular,2-4,2-5,2-8,2-foliate,2.5-3,3-5,4-40,4-8,5-6,5-7,5-9,6-8,7-30+,8-40+,abaxially,absent,abundant,across,acuminate,acute,adaxially,adult,anther,apart,apex,armed,base,branched,broad-based,broadly,brown,calyx,chartaceous,cm,connivent,cordate,cross-section,cuneate,curved,densely,diameter,distributed,drying,eglandular,elliptic,erect,exocarp,extra-axillary,ferruginous,filament,flattened,flower,forked,fruit,fruiting,glabrous,glandular-puberulent,globose,green,growth,hair,half,held,inflorescence,interpetalar,juicy,lanceolate,lateral,leaf,leaf-opposed,length,less,like,lobe,long,margin,mature,mesocarp,midpoint,midvein,minutely,mm,moderately,moist,mucilaginous,multiseriate,narrowly,oblique,obtuse,often,ovate,ovate-lanceolate,pedicel,per,petiole,pitted,placenta,porrect,present,prickle,ray,rounded,scattered,sessile,shorter,shrub,small,somewhat,spaced,sparsely,stalk,stalked,stellae,stellate,stellate-pubescent,stem,stigma,straight,style,surface,thick,throughout,tip,tissue,tree,triangular,truncate,tube,unarmed,unbranched,unit,upright,usually,white,whitish,x,yellowish-green,younger	0.5-3,0.8,1.5-2,10-30,12-15,16-40,2-2.5,2-6,23-40+,3-15,4-19,5,5-10,5-merous,8-26,absen,accrescent,adaxiall,andromonoecious,anvil-shape,articulated,axe,ba,blade,branche,capitat,coarsely,contiguous,cylindrical,deeply,directed,distall,distally,eaf,eed,entire,except,functional,geminat,juvenile,lobed,longer,lower,markedly,minute,nearly,nflorescence,orolla,pair,pale,peduncle,pinnatifid,plant,pore,rachi,ruit,shallowly,side,simple,slightly,tal,tamen,tem,thicker,time,toothed,unarme,upper,vary,weakly,wide,yellow,ympodial	anthesi,anvil-shaped,appearance,bark,branch,bud,capitate,cell,color,corolla,count,free,geminate,habitat,major,minor,new,null,ovary,position,scar,seed,shape,size,stone,structure,sympodial,tall,texture,vein,width,wing,young
109	wfo-0001027091	success	142	165	120	22	45	0.845	.3,0.7,0.8,1-1.6,1.1-1.6,1.8-2.6,1/2-2/3,2.3-2.9,2.5-3.5,3-8,3-9,4-10,5-11,6-10,9-13,accrescent,across,acute-tipped,along,annual,anther,anthesi,arcuate,armed,base,beneath,berry,blade,blue,branched,bristly,broadly,brown,calyx,campanulate,capitate-glandular,cauline,cm,dark,deltoid,densely,developing,dia,difoliate,divided,dm,dry,enveloped,extended,few-rayed,fully,glabrous,gland,glandular,green,hair,herb,high,internodal,invested,lenticular,linear-lanceolate,lobe,long,longer,low,main,maturity,mm,mostly,narrowly,near,obtuse,occasionally,oriented,ovate,pedicel,petiole,pinnatifid,pinnatisect,prickly,radially,reticulately,ridge,rounded,scattered,sessile,short,short-stipitate,simple,sometimes,somewhat,sparsely,spherical,splitting,spreadingly,stellae,stellate-pentagonal,stem,strait,suffused,surface,tapering,taprooted,terete,terminally,tightly,tube,twice,undulate,uniseriate,unit,usually,variously,vein,vestiture,violet,wholly,wrinkled,younger	30-60,6-10-flowere,8.5-11.5,alyx,eaf,eed,geminat,lon,nflorescence,orolla,per,ruit,slende,ste,tamen,tigma,tub,tyle,unexpande,vary,yello,ympodial	6-10-flowered,apex,appearance,bark,bud,cell,color,corolla,count,diameter,filament,flower,free,fruit,fruiting,geminate,growth,habitat,inflorescence,lateral,leaf,length,major,margin,minor,new,null,ovary,position,scar,seed,shape,size,stigma,stone,structure,style,sympodial,texture,tip,unexpanded,width,wing,yellow,young
110	wfo-0001027102	success	167	131	105	62	26	0.629	.5,.5-6,0.5,0.5-1,0.5-2,0.5-3,1-1.5,1-2,1-3,1-6,1.5-2,10-20,15-35,2-2.5,3-12,3-4,3-5,4-5,5-12,abaxially,absent,accrescent,acuman,acuminate,acute,adaxial,adaxially,almost,anther,apex,appearance,base,blade,broad,broadly,calyx,cell,chartaceous,cm,corky,cuneate,deltate,densely,diameter,differing,difoliate,dimorphic,elliptic,filament,flattened,flower,forked,free,fruit,fruiting,giving,glabrous,globose,hair,lanceolate,leaf,leaf-opposed,lobe,long,long-tapered,major,margin,minor,mm,moderately,multiseriate,narrowly,oblong,one,orange,ovate,pedicel,perfect,petiole,pubescent,rarely,ripe,roughened,simple,size,small,somewhat,sparsely,stem,stigma,stone,style,surface,time,tip,tomentose,triangular,truncate,tube,unbranched,unit,white,wide,x,young	0.2-2,1-2.5,1-4,15,2-3,3,4-7,<,absen,adaxiall,ag,aggregate,alyx,apart,articulated,axe,ba,channe,ciliate,congested,connivent,curved,cylindrical,directed,distally,eaf,eed,entire,few-,geminat,ilament,longitudinal,m.,nflorescence,obtuse,often,opening,orolla,peduncle,per,pore,portion,rachi,rugulose,ruit,short,shrub,slender,slit,spaced,stellate,straight,subcoriaceous,tal,tem,truncat,unarme,usually,vary,yellow,yellow-brown,ympodial	anthesi,bark,bud,channel,color,corolla,count,geminate,growth,habitat,inflorescence,lateral,length,mentioned,new,ovary,position,scar,seed,shape,structure,sympodial,texture,vein,width,wing
111	wfo-0001027104	success	141	134	93	48	41	0.66	0.5-0.8,1-1.5,1-3,1-4,1.2-6,1.5-2.3,1.5-4.2,10-15,2-3,2-6,2.2-5,3-5.5,4-15,6-7.5,abaxially,acumen,acuminate,acute,adaxially,apex,articulate,attenuate,base,branched,calyx,cell,cm,condition,connate,cordate,corolla,covering,cyme,diameter,dichasial,dichasially,distal,dorsally,ebracteate,edge,epiphytic-like,exceeding,filament,finely,flat,flower,folded,forked,generally,globose,green,growing,hair-like,half,lateral,lobe,long,make,mm,monochasial,mos,mucilaginous,mucronate,ovate,ovoid,pedicel,peduncle,petiole,plant,proximal,pubescent,rarely,seed,stamen,stellate,stigma,straight,style,terrestrial,testal,thick,throughout,tone,truncate,typically,unit,wall,white,wide,without,yellow,yellow-green,Â¼	0.15-0.35,3-6-foliat,5-15,apical,apically,dehiscent,digestion,eaf,eed,emoval,enzyme,epiphyti,globo,green-white,herbaceous,honeycomb,introrse,linear,living,lon,lower,maturing,narrowly,nflorescence,nther,odd-pinnate,often,orolla,ovat,pattern,perennial,perfect,plan,poricidally,reveal,ruit,seudostipule,short,simple,slit,specimen,tall,tem,throughou,tuber-bearing,vary,viole,ympodial	3-6-foliate,anther,anthesi,appearance,bark,bud,color,count,epiphytic,free,fruit,fruiting,growth,habitat,inflorescence,leaf,length,major,margin,mentioned,minor,new,ovary,position,scar,shape,size,stem,stone,structure,surface,sympodial,texture,tip,tube,vein,violet,wet,width,wing,young
112	wfo-0001027114	success	154	125	101	53	24	0.656	-17,-2,-30,.5,0.5-1,1-1.1,1-1.5,1-2,1.5-1.7,1.5-2,13-21,2-3,20-40,3-4,3-7,6-8,6-9,7-10,7-9,abaxial,acute,anther,anthesi,apex,appearing,bark,base,branched,bushy,calyx,capitate,cm,conical,corolla,deltate,dendritic,densely,difoliate,drying,due,elliptic,filament,flattened-reniform,free,fruiting,geminate,glabrous,globose,green,inflorescence,lamina,lateral,leaf,lobe,long,major,many,margin,minor,minute,minutely,mm,occasionally,opposite,ovary,pair,pedicel,petiole,pitted,planar,plurifoliate,pubescent,rapid,reddish,scar,scattered,shoot-terminal,shrub,simple,size,soft,spaced,stem,stigma,style,surface,tall,thickened,time,tip,trichome,tube,unevenly,uniseriate,unit,vein,white,wide,woody,yellowish,young	1-1.2,1/2,2-2.5,5,abaxially,adaxially,along,alternating,apar,axillary,ba,berry,closely,commonly,dark,dia,differing,eaf,edicel,eed,erect,exserted,flowered,glabrou,growt,halfway,inflorescenc,investing,like,lobed,lon,lower,main,nflorescence,older,opening,papillo,pore,poricidal,portion,projection,reddish-brown,rest,ruit,several,shoot,slit,tapering,triangular,tub,ud,way,ympodial	apart,appearance,bud,cell,color,count,diameter,flower,fruit,growth,habitat,length,mentioned,new,papillose,position,seed,shape,stone,structure,sympodial,texture,width,wing
113	wfo-0001027117	success	235	146	118	117	28	0.502	-12,-2.8,.5,0.1-0.7,0.5,0.5-1.5,0.6-0.9,0.7-1.5,0.8-,1-2,1-6,1.5-,1.5-2.3,1.5-6.5,1.8-2.5,1/3,10-20,2-3,2-6,2-8,25-100,3-10,3-15,4-6.5,4-7,4-8,5-14,abaxially,acicular,acute,anther,apart,apex,apparently,attenuate,bark,base,beyond,branched,calyx,cell,cm,cordate,dark,deltate,densely,diameter,elongating,erect,evenly,extending,fifth,filament,fine,flattened-reniform,flower,four,free,fruit,fruiting,glabrescent,glabrous,green,herb,lateral,leaf,length,less,lobe,long,lower,margin,mature,maturity,mauve,mm,moderately,narrow-deltate,narrow-elliptic,narrow-lanceolate,oblong,outline,ovate,pair,pale,pedicel,perpendicular,petiole,pit,prickle,prickly,raised,red-brown,rounded,scar,small,smooth,sometimes,spaced,sparsely,spherical,stellate,stellate-pubescent,stem,straight,style,surface,tapering,tip,trichome,tube,unit,upper,vein,wide,woody,yellow,young	-1.5,-11,-3/4,/3,0-10,0-15,0-20,0-25,0-40,0-5,0.1,0.1-,0.15-0.25,0.15-0.35,0.2,0.2-0.45,0.7-0.9,0.7-1.3,1-4,1.2,1.7-2.5,1/,1/4,1/8-1/2,2.3-2.8,3-6,4.5-6.5,4.5-8,5-11,5-merous,6-10,6-9,7-,8,accrescent,almost,alyx,ame,apar,apically,articulated,berry,black,blade,brittle,brown,c.,chartaceous,concolorous,connivent,curved,discolorous,distance,drying,eaf,eed,enclosing,gently,gra,herbarium,infructescence,irregularly,lobed,lon,long-acuminat,longer,membranous,midpoint,midvein,nflorescence,obovate,older,one,open,orolla,oung,peduncle,pendulous,per,perfec,pericarp,plurifoliat,poricidal,porrect,portion,prickl,primary,ray,reduced,reflexed,ruit,sessile,shallowly,shiny,shorter,side,specimen,spreading,stalk,stalked,staman,tamen,tearing,terete,tertiary,time,tissue,translucent,unequal,variously,vary,venation,visible,way,weakly,yellow-green,ympodial	anthesi,appearance,bud,color,corolla,count,gray,growth,habitat,height,inflorescence,major,minor,new,null,ovary,plurifoliate,position,seed,shape,size,stigma,stone,structure,sympodial,texture,width,wing
114	wfo-0001027123	success	181	170	142	39	28	0.785	-10,-20,.3,.5,0.5,0.5-0.8,0.7-3.5,0.8-1.3,0.9-1.3,1,1-1.2,1-1.5,1.5-2,2-2.2,2-2.5,2-2.6,2-3,2-lobed,2.5-10.4,2.5-4,2.5-6,3-15,3-4,4-5,4-6,5-10,5-6,abaxial,acute,adaxial,anther,anthesi,apex,appearing,attenuate,axi,bark,base,branched,bright,broadly,brown,calyx,cell,clavate,cm,commonly,conical,constricted,coriaceous,corolla,cup-shaped,dark,deltate,dendritic,densely,denser,diameter,drying,edge,elliptic,enlarged,erect,exerted,filament,flattened,flower,free,fruiting,glabrous,glandular,globose,green,inflorescence,lax,leaf,less,like,lobe,lobed,long,loose,loosely,margin,mauve-purple,midvein,minute,minutely,mm,narrowly,outline,ovary,pair,papillae,papillate,pedicel,perhaps,petal,petiole,pitted,plurifoliate,primary,prominent,pubescent,reddish,reniform,revolute,scar,scatted,scattered,shining,shiny,simple,sinuate,sometimes,soon,sparsely,stellate,stem,stigma,strongly,style,subshrub,surface,terminal,testal,thick,time,tip,trailing,trichome,tube,unit,usually,vein,violet,warty,way,white,x,young,Â¾	0.3-1.6cm,2-5.5,adaxially,along,axe,campanulate,completely,darker,eaf,eed,fide,inserted,lamina,lewi,lon,lower,monopodia,nflorescence,nodding,older,peduncle,perfect,planar,portion,shin,shinin,short,sleeve,slightly,spaced,stoutish,straight,tub,turned,ud,upper,widely,wood,ympodial	0.3-1.6,appearance,bud,color,count,fruit,growth,habitat,height,lateral,length,major,mentioned,minor,monopodial,new,position,prickle,seed,shape,size,stone,structure,sympodial,texture,width,wing,woody
115	wfo-0001027146	success	213	162	129	84	33	0.606	0.3-2.2,0.8,1-2,1-9.5,13-36,2-13,2-4.2,3.5-22,4-11,4-38,4-8,6,6-10,6-17.5,6.5-52,abaxially,acuminate,adaxially,along,anther,apex,arranged,asymmetrical,attenuate,axillary,base,basiscopic,bead,berry,blade,bud,cell,chartaceous,ciliate,clavate,cm,coarsely,commonly,conical,connivent,corolla,covering,dark,darker,deep,diameter,distal,eaf,especially,filament,finely,flower,forked,fruit,generally,glabrous,green,green-white,hair,hair-like,half,herb,lanceolate,lateral,leaf,like,lobe,long,make,margin,medium,membranous,midrib,minutely,mm,moniliform,mottled,mucilaginous,multiple,necklace,odd-pinnate,ovoid,pedicel,petiole,petiolule,plant,plurifoliate,puberulent,pubescent,purple,ray,ripe,seed,semierect,side,simple,size,sometimes,stem,stigma,stolon,style,subglabrous,subsessile,subtending,symmetrical,tall,terminal,testal,thick,throughout,tinged,tip,tissue,tri-,tube,tuber,typically,unit,unwinged,usually,violet,wall,wet,white,whitish,wide,wing,x	0-11,0.5-3.2,0.6-3.3,0.7-2.4,0.8-3.1,0.8-5.8,1-10,1-2.5,1.9-10,10,2-12.2,2-5,3.3-6.1,4-12.5,5-merou,acumen,ag,alyx,apart,apparently,articulated,axe,brownish,capitat,condition,decreasing,digestion,dorsally,drying,edge,eed,elliptic,enzyme,erec,exceeding,flat,folded,fourt,fourth,fresh,geminat,glabrou,gradually,greenish,homostylous,honeycomb-shaped,interjected,leaflet,lengthening,living,lower,minute,nflorescence,orbicular,orolla,ovate,pair,peduncle,pentagonal,perfect,pore,poricidal,proximal,rarely,removed,rotate,ruit,secondary,sessile,seudostipule,slit,spaced,specimen,stamen,ste,straight,subequal,subglabrou,tamen,tem,toward,vary,yellow,ympodial	anthesi,appearance,bark,calyx,capitate,color,count,erect,free,fruiting,geminate,growth,habitat,height,inflorescence,length,major,mentioned,minor,new,ovary,position,prickle,scar,shape,stone,structure,surface,sympodial,texture,vein,width,young
116	wfo-0001027157	success	207	175	140	67	35	0.676	0.15-0.3,0.7-2,0.9-2.8,1,1-2,1-3,1-3.8,1-6,10-30,2,2-15,2-3,2.5-3,3-12,3.3-7.8,6.5-14.5,9-12,abaxially,absent,acumen,acuminate,acute,adaxially,along,among,anther,apex,articulated,attenuate,axillary,base,berry,blade,bud,cell,chartaceous,ciliate,clavate,cm,conical,connivent,cordate,corolla,covering,decurrent,deeply,densely,diameter,distal,dorsally,eaf,edge,end,especially,filament,flat,flower,folded,forked,fruit,generally,glabrous,grassland,green,green-white,hair,half,herb,interjected,lanceolate,lateral,leaf,leaflet,like,lobe,long,low-growing,make,margin,membranous,midrib,minutely,mm,mucilaginous,oblique,obtuse,odd-pinnate,one,orbicular,ovate,ovoid,pedicel,petiole,petiolulate,petiolule,placed,plant,plurifoliate,puberulent,pubescent,rarely,ripe,rounded,seed,semi-rosette,sessile,shady,short,situation,size,slightly,sometimes,stellate,stem,stigma,stolo,style,subsessile,subtending,sunny,tall,terminal,testal,thick,throughout,tinged,tip,tri-,tube,tuber,typically,unit,unwinged,usually,violet,wall,wet,white,woodland,x	0-3,1-10,1.5-6.5,2-2.5,2-5,2.3-4,3-7,3.8-8.3,4-5,5-merou,ag,alyx,apart,apparently,axe,broadly,brownish,capitat,condition,cuneate,decreasing,digestion,drying,eed,elliptic,enzyme,erec,exceeding,fresh,geminat,glabrou,greatly,greenish,hair-like,homostylous,honeycomb-shaped,lengthening,living,lower,markedly,middl,narrowly,nflorescence,orolla,pair,peduncle,perfect,pore,poricidal,removed,ruit,seudostipule,slit,spaced,specimen,stamen,ste,straight,tamen,tem,toward,unequal,vary,whitish,wide,yellow,ympodial	'hair-like,anthesi,appearance,bark,calyx,capitate,color,count,erect,free,fruiting,geminate,growth,habitat,height,inflorescence,length,major,mentioned,minor,new,ovary,position,prickle,scar,shape,stone,structure,surface,sympodial,texture,vein,width,wing,young
117	wfo-0001027184	success	219	188	152	67	36	0.694	.3,.5,.8,0.2-0.4,0.4-2,0.4â0.9,0.8,0.8â1.6,1.5,1.5-5,1.8â3.5,19,1â2,2,2â4-celled,3-4-,3-foliolate,3â,3â4-celled,4,4â12,5-7,7,abaxially,absent,accrescent,acute,adaxially,adventitious,along,anther,apart,apex,appressed,articulated,axi,axillary,basal,base,blade,blue,borne,bract-like,branch,brown,calyx,cell,chartaceous,cluster,cm,connivent,covered,densely,diameter,elliptic,entire,epidermal,especially,extension,fasciculate,filament,flattened,flower,free,fruit,fruiting,generally,glabrescent,glabrous,globose,grading,hair,hairlike,herbaceous,imparipinnate,lanceolate,largest,lateral,leaf,leaflet,leafy,least,light,like,lobe,long,margin,meter,midrib,minutely,mm,mostly,much,narrowly,node,oblong,obtuse,older,orange,ovate,pedicel,petiole,pilose,plurifoliate,prominent,prominently,puberulent,pubescent,raised,rarely,red,reticulate,ripe,root,scarcely,secondary,several,shape,shoot,short,simple,size,small,soft-woody,somewhat,spaced,sparsely,stellate,stem,stigma,style,sulcate,surface,tertiary,tightly,tip,tree,truncate,trunk,tube,unbranched,unequal,unit,vein,vine,visible,wall,weak,white,x,young,â9	.7,0-,0-0.2,0.5-2,0â3,1-2,13â18,1â2.5,1â4,2.8â4.1,3.5â8,5,9,adaxiall,ag,always,alyx,axe,ba,broad,broadly,clavat,cordat,cylindrical,directed,eaf,eed,fleshy,foliaceous,geminat,glabrou,half,ilament,introrsely,larger,less,longitudinal,lower,m.,membranous,nearly,nflorescence,often,opening,opposite,orolla,ower,peduncle,per,petiolule,pore,portion,pseudostipule,rachi,revolute,ruit,slightly,slit,straight,subopposite,terminal,unarme,uniform,usually,vary,yellow,ympodial	--,0,1-2.5,1-4,13-18,3,anthesi,appearance,bark,bud,clavate,color,corolla,count,geminate,growth,habitat,height,inflorescence,length,major,minor,new,null,ovary,position,prickle,scar,seed,stone,structure,sympodial,texture,unarmed,width,wing
118	wfo-0001027186	success	168	152	125	43	27	0.744	-6,.4,.5,0.5-1,1-1.5,1-2.5,1.4-1.6,1.5,1.5-2,1.5-2.5,1.6-5,15,2-lobed,2.5-3,3-4,3.5-4,30-40,4-15,4-9,5-10,6-7,9-10,?,acute,anther,anthesi,apart,apex,attenuate,axil,bark,base,berry,branched,broadly,brown,calyx,clavate,cm,conical,corolla,dark,dbh,deltate,dendritic,densely,diameter,ellipsoid,elliptic,enlarging,entire,exerted,filament,flower,free,fruit,fruiting,glabrescent,glabrous,globose,golden,green,growth,immature,irregularly,keeled,lamina,less,lobe,lobed,loose,margin,maturity,midrib,minutely,mm,narrowly,new,ovary,ovoid,pair,pale,pedicel,pendent,petiole,pitted,planar,plane,pointed,poridical,primary,pubescent,rachi,reddish,reniform,scar,seed,shiny,simple,slightly,small,soon,spaced,sparsely,spreading,stem,stigma,strongly,style,surface,terminal,time,tip,tree,treelet,trichome,tube,uniseriate,unit,variably,vein,way,white,x,yellow	2-6,abaxial,abaxially,adaxially,age,always,apparently,branch,deflexed,denditic,denser,dry,eaf,filiform,incrassat,lengthening,like,longer,lower,m.,much,nflorescence,occasionally,papillat,papillate,peduncle,perfect,pericarp,plurifoliat,pore,portion,pubescen,rough,ruit,scattered,short,slit,stalk,straight,tub,ud,woody,ympodial	appearance,bud,cell,color,count,habitat,height,incrassate,inflorescence,lateral,leaf,length,major,minor,null,plurifoliate,position,prickle,shape,size,stone,structure,sympodial,texture,width,wing,young
119	wfo-0001027198	success	191	190	163	28	27	0.853	.4,.5,0.05-1.0,0.5-0.75,0.5-1,0.7-1,0.8-1,1-1.5,1-10,1-5,1.5-10,1.5-2,10-11,11-20,2-5.5,3/4,4-9,5-120-flowered,5-6,7.5-9,abruptly,acuminate,acute,always,anther,anthesi,apart,apex,attenuate,axil,base,beginning,beneath,berry,broadening,bushy,calyx,channeled,clavate,closely,cm,complex,corky,corolla,corresponding,cyathiform,decurrent,deltoid,dendritic,densely,dia,difoliate,elliptic,entire,erect,evenly,exserted,extremely,eye,female,filament,flower,found,free,fruiting,furcate,glabrate,glabrous,globose,golden,green,impressed,inflorescence,invisible,large,lateral,leaf,lobe,lobed,long,main,major,male,many,margin,medium,middle,minor,minute,minutely,mm,naked,nearly,obovate,often,older,opposite,ovary,overlapping,ovoid,ovoid-reniform,pale,paler,papillose,pedicel,petiole,pitted,planar,plant,pore,poricidal,puberulent,pubescence,pubescent,rather,reflexed,rest,rounded,scar,set,shaped,shining,short,shrub,simple,size,slender,slightly,small,soon,spaced,speciman,specimen,stem,stigma,straight,style,styled,surface,tall,tannish-yellow,tear-drop,testae,thin,time,tip,tree,trichome,tube,two,type,undersurface,uniseriate,unit,usually,vein,way,white,widest,woody,x,yellowish,young	ba,caly,constriction,differing,dry,eaf,edge,edicel,eed,geminat,inflorescenc,like,live,lon,lower,meet,nflorescence,papillo,pendan,portion,reddi,ruit,sessile,strong,thickened,top,ud,ympodial	appearance,bark,bud,cell,color,count,diameter,fruit,geminate,growth,habitat,height,length,new,null,pendant,position,prickle,reddish,seed,shape,stone,structure,sympodial,texture,width,wing
120	wfo-0001027200	success	139	129	104	35	25	0.748	0.05-0.25,0.25-0.5,0.5-0.75,0.5-1,0.6-1,0.7-2.5,1-1.4,1-1.5,1.5-5,1.6-6,2-3,3.5-6,6-8,8-15,9-11,acute,anther,anthesi,apex,bark,base,beneath,branch,broadly,calyx,capitate,cm,conical,converging,corolla,decurrent,deeply,deflexed,deltoid,densely,dia,differing,elliptic,except,filament,free,fruiting,glabrous,globose,golden,green,grey-brown,impressed,inflorescence,lateral,leaf,lightly,lobe,long,main,major,margin,minor,minute,minutely,mm,near,non-reproductive,onto,ovary,ovoid-reniform,papillose,pedicel,petiole,pitted,planar,pore,poricidal,prominent,puberulent,reflexed,shaped,shrub,size,slightly,small,sparsely,stem,stigma,style,surface,tall,tear-drop,tip,tree,trichome,tube,unicellular,unifoliate,uniseriate,unit,vein,white,widened,winged,woody,x,yellowish,young	1.2-1.5,1.5-2,2.5-3,3-3.5,across,aspec,ba,berry,branche,brown,dark,eaf,eed,flattened,geminate,giving,horizontally,like,lobed,lon,lower,middle,nearly,node,occasionally,older,papillo,portion,rest,ruit,sparse,spreading,straight,widest,ympodial	appearance,bud,cell,color,count,diameter,flower,fruit,growth,habitat,height,length,new,position,prickle,scar,seed,shape,specified,stone,structure,sympodial,texture,width,wing
121	wfo-0001027213	success	231	167	138	93	29	0.597	-230,/10,0.2-0.4,1-2,1-5,1.2-2.5,1.7-3.6,1.7-3.9,1.8-2.8,1.8-3.2,1/2-2/3,10-24,2-5,2.4-4.7,2.5-5.1,3.5-5,3.5-8,4-9.5,5-7.5,5.7-6.2,8-24,9-13,abaxially,accrescent,acuminate,acute,adaxially,along,anther,anthesi,apex,attenuate,axillary,base,blade,blunt-tipped,branch,branched,broadly,brown,calyx,cell,cm,completely,corolla,covering,cuneate,dark,decurrent,deltoid,diameter,elliptic,entire,enveloping,eventually,filament,flower,free,fruit,fruiting,glabrescent,glabrous,globose,granular,grayish-brown,green,hair,immature,lanceolate,lateral,leaf,length,lobe,lobed,long-,long-stalked,many,margin,midrib,mixed,mm,mostly,multangulate,nearly,oblanceolate,obovate,obtuse,often,orbicular,ovate,ovate-lanceolate,pale,partly,pedicel,petiole,plurifoliate,porrect-stellate,pseudo-terminal,pubescence,pubescent,rather,reniform,reticulate-punctate,scabrous,sessile,short,short-,short-attenuate,short-stalked,side,simple,stem,stigma,style,subcampanulate,surface,terete,thick-stalked,thin-stalked,time,tip,tomentose,tomentose-pubescent,tube,unarmed,unit,unwinged,vein,violet,way,white,whitish,whitish-green,x,yellow-green,yellow-tan,yellowish,young	-19,-3.3,-4.5,0-160,0-2.5,0.2-0.5,0.7-2.3,0.8-1.8,1.1-1.7,1.2-1.6,1.2-1.7,1.3-2.2,12.3-16.3,2.9-3.8,2.9-4.8,2/3,4.2-5.9,5-8,5-merou,8.2-10.5,ag,alyx,apart,apparently,ark,around,articulated,axe,ba,basal,capitat,conical,cylindrical,directed,distally,drying,eaf,early,edge,eed,epidermal,exserted,farinose,few-rayed,glabrescen,group,high,homostylous,inserted,lackin,lengthening,long,longitudinal,lower,m.,main,moderately,multangulat,nflorescence,obscured,older,orolla,peduncle,perfect,pore,poricidal,porrect-stellat,prominent,rachi,relatively,ruit,shrub,slit,sometimes,somewhat,spaced,sparsely,stamen,stellate,suture,tamen,thick,ti,tomentu,touching,tree,ud,unarme,vary,vestigial-rayed,wide,yellow,ympodial	90-160,appearance,bark,bud,capitate,color,count,growth,habitat,height,inflorescence,lacking,major,mentioned,minor,new,ovary,position,prickle,scar,seed,shape,size,stone,structure,sympodial,texture,width,wing
122	wfo-0001027214	success	181	162	134	47	28	0.74	-20,-38,-9,.25,.5,0,0.25,0.3-1.5,0.5-0.8,0.5-1,0.7-2.5,0.8-1,1-1.5,1-2.8,1.5,10-,10-13,12-17,15-25,2,2-9,3-,3-6,4-5,5-6,6-,6-12,abaxially,absent,adaxially,along,anther,anthesi,anticlinal,apex,apical,base,broadly,calyx,cell,climbing,cm,composed,conical,conspicuously,corolla,deltate,densely,diameter,drying,elliptic,epidermal,erect,extending,filament,finely,flattened-round,flower,free,fruit,fruiting,glabrous,globose,green,greenish,height,herb,horizontal,inflorescence,irregular,lamina,lateral,leaflet,length,less,like,lobe,lobed,long,long-acuminate,long-conical,margin,midrib,minutely,mm,nearly,nodding,oblique,obovate,occasionally,once-branched,open,ovary,pair,papillate,pedicel,per,petiole,pinnate,pointed,poricidal,projection,pubescent,rachi,reflexed,rest,rugose,rugosity,scar,scattered,scrambling,seed,sharply,simple,sinuous,somewhat,stigma,style,surface,thickening,time,tip,triangular,trichome,truncate,tube,uniseriate,unit,vein,white,white-lenticellate,whitish,without,x	..,0-16,0.3-1.7,0.7-2,1.2-3,1.5-1.8,1.5-6,7-12,8-9,acuminate,acute,basal,berry,capitat,decurrent,dr.,eaf,edicel,eed,exserted,groove,grown,inflorescenc,lanceolate,lon,lower,markedly,narrowly,nflorescence,noddin,often,onto,opposite,paired,papilla,perfectly,petiolule,portion,ruit,smaller,tem,terminal,tub,ud,unevenly,unifoliat,ympodial	appearance,bark,bud,capitate,color,count,dry,growth,habitat,leaf,major,minor,new,null,papillae,position,prickle,shape,size,stem,stone,structure,sympodial,texture,unifoliate,width,wing,young
123	wfo-0001027219	success	143	134	103	40	31	0.72	.5,0.4-0.6,0.5,0.5-0.8,1,1-15,1-2,1-3,1.5-2,1.5-2.5,2,2-3,2-4,3-6,6-8,7-8,absent,acuminate,acute,anther,anthesi,apex,axillary,bark,base,berry,bright,broadly,brown,calyx,capitate,closely,cm,conical,corolla,cup-shaped,deltate,densely,diameter,edge,elliptic,erect,filament,flower,free,fruiting,glabrescent,glabrous,globose,green,greyish,growth,hard,leaf-opposed,less,lobe,long-conical,long-styled,margin,maturity,minutely,mm,new,ovary,pair,pale,papillose-pubescent,pedicel,pendent,petiole,planar,pore,poricidal,primary,pubescent,purple,scar,shoot,short,short-styled,shrub,simple,somewhat,soon,spaced,stem,stigma,stout,style,surface,terminal,thickened,tip,trichome,tube,uniseriate,unit,vein,violet,weight,white,woody,x	/4,0.3,2-2.5,2-3.5,3-5,age,berr,c.,completely,drying,eaf,eed,entire,exerte,exfoliatin,glabrou,heterostylous,known,lengthening,lobed,lower,nflorescence,overlappin,papillo,peduncle,pericarp,plurifoliat,pointed,portion,ruit,sharply,slightly,slit,sometimes,tuft,ud,way,yellowish,ympodial,â1/3	appearance,bud,cell,color,count,exfoliating,fruit,habitat,height,inflorescence,lateral,leaf,length,major,mentioned,minor,overlapping,papillose,plurifoliate,position,prickle,seed,shape,size,stone,structure,sympodial,texture,width,wing,young
124	wfo-0001027223	success	189	134	98	91	36	0.519	0.19-0.75,0.3-1.2,1-2,1.8-3.5,16-41,3-10,3-11,3-5.2,3.5-4,5-21,5.9-12.2,9-15,9-22,9-35,abaxially,acuminate,adaxially,anther,apex,asymmetric,attenuate,axillary,base,basiscopic,berry,bud,cell,clavate,cm,conical,connivent,corolla,covering,deep,densely,diameter,distal,dot,filament,flower,forked,fruit,generally,glabrous,green,green-white,hair,half,herb,hyaline,lanceolate,lateral,leaf,light,lobe,long,make,mm,mucilaginous,odd-pinnate,orbicular,ovate,ovoid,pedicel,petiole,petiolulate,plant,plurifoliate,pubescent,purple,ripe,rounded,seed,sessile,short,shortly,side,size,sometimes,stigma,stripe,style,subtending,terminal,testal,thick,throughout,tip,tissue,tri-,tube,unit,unwinged,usually,wall,wet,white,x	.5,1-3,1.3-2,1.5-3.5,2-4,2-7,3-5,3.5-6,3.5-7,3.7-9.3,4-6,5-10,5-8,5-merou,acumen,adaxiall,ag,alyx,apart,apparently,articulated,axe,blade,brownish,capitat,condition,decreasing,digestion,dorsally,drying,eaf,edge,eed,elliptic,end,enzyme,erec,exceeding,flat,folded,fresh,geminat,glabrou,greenish,hair-like,hal,homostylous,honeycomb-shaped,interjected,larger,leaflet,lengthening,like,living,lower,middle,nflorescence,one,orolla,pair,peduncle,pentagonal,perfect,placed,pore,poricidal,present,removed,rotate,ruit,seudostipule,slightly,slit,spaced,specimen,stamen,ste,stolo,straight,subequal,tall,tamen,tem,toward,tuber,typically,vary,whitish,wide,yellow,ympodial	'hair-like,anthesi,appearance,bark,calyx,capitate,color,count,free,fruiting,geminate,growth,habitat,height,inflorescence,length,major,margin,mentioned,minor,new,ovary,position,prickle,scar,shape,stem,stone,structure,surface,sympodial,texture,vein,width,wing,young
125	wfo-0001027237	success	122	128	94	28	34	0.77	.5,0.5-1,1-1.2,1.5-2,1.5-2.5,2-3,3-3.5,3-4,30-100-flowered,6-11,6-8,8,anther,anthesi,apart,apiculate,appearing,bark,base,berry,black,branched,broadly,brown,calyx,clavate,cm,corolla,cucullate,cup-shaped,dark,deltoid,difoliate,drying,ellipsoid,erect,exsertion,filament,flattened,free,fruiting,geminate,glabrous,globose,green,greenish-white,inflorescence,internodal,later,leaf,lobe,many,margin,minutely,mm,occasionally,older,ovary,paler,papillose,part,pedicel,pitted,pore,poricidal,regularly,reniform,scar,shaped,shining,shrub,slender,small,spaced,stem,stigma,style,surface,tall,tear-drop,terminal,time,tip,tree,tube,unit,upper,usually,white,widely,woody,x,x.,young	/4,5,apiculae,ba,blac,branc,completely,deflexed,dia,edicel,eed,greyi,lobed,long,lower,nflorescence,papillate,papillo,plurifoliat,portion,reflexed,regulary,ruit,straight,tapering,ud,way,ympodial	apex,appearance,branch,bud,cell,color,count,diameter,flower,fruit,greyish,growth,habitat,height,lateral,length,major,mentioned,minor,new,petiole,plurifoliate,position,prickle,seed,shape,size,stone,structure,sympodial,texture,vein,width,wing
126	wfo-0001027238	success	204	166	133	71	33	0.652	-25,-5,.3,.5,0-1,0-1.5,0.3-0.5,0.3-0.8,0.3-1,0.3-5,0.5-1,0.5-16,0.5-2,1-1.5,1-2,1.5-3,1.5-4,1.5-7,10,2-3,2-4,3-4,3-5,3-6,4-,4-10,4-16,5-7,6-15,6-8,abaxially,acuminate,acute,adaxially,anther,apex,base,berry,blade,branch,brown,calyx,chartaceous,cm,connivent,cuneate,cylindrical,dark,densely,diameter,differentiated,discolorous,elliptic,elliptic-ovate,entire,equal,extra-axillary,filament,flattened,fleshy,flower,free,fruit,fruiting,geminate,glabrous,gland,gland-tipped,green,greenish,hair,homostylous,leaf,light,lighter,like,lobe,long,major,margin,membranaceous,midpoint,minor,minutely,mixed,mm,multangulate,nearly,new,oblique,oblong,often,outline,pedicel,petiole,pitted,plurifoliate,porrect-stellate,pubescent,ray,reniform,rounded,scandent,sessile,short-stalked,shrub,side,simple,small,sometimes,somewhat,sparse,sparsely,sprawling,stellate-pubescent,stem,stigma,straight,strongly,style,surface,time,tip,tree,tube,unbranched,unit,vein,whitish,wide,x,yellow,yellowish	0-0.7,15-30,4-5,4-8,5-15,5-merou,accrescent,adaxiall,ag,alyx,apparently,articulated,axe,ba,black,capitat,contiguous,covering,deltate,directed,distally,eaf,eed,foliaceous,fork,frui,glabrescent,globose,growt,interpetalar,introrsely,juic,large,lavender,longitudinal,lower,narrowly,near,nflorescence,obtuse,one,opening,orolla,paired,pale,part,peduncle,perfect,pericarp,pore,purple,rachi,ripe,ruit,shiny,similar,slit,ste,stellate,subtending,tamen,tem,tissue,toward,triangular,unarme,unequal,vary,white,without,ympodial	5-merous,anthesi,appearance,bark,bud,capitate,cell,color,corolla,count,growth,habitat,height,inflorescence,lateral,length,null,ovary,position,prickle,scar,seed,shape,size,stamen,stone,structure,sympodial,texture,unarmed,width,wing,young
127	wfo-0001027244	success	294	188	163	131	25	0.554	-1.2,-12,-2,-3.2,0.02-,0.04-,0.05,0.07-0.15,0.1-0.3,0.15-0.2,0.2,0.2-1,0.3-0.6,0.3-0.8,0.5,0.6-0.9,0.6-09,0.7-1.5,0.9-1.3,0.9-1.7,1,1.1-1.3,1.5-2.1,1.5-2.4,1.5-6.5,2-,2-9,2-foliate,2-locular,2.1-8,3.5-13,4-12,5-,7-12,8-16,abaxially,abundant,acuminate,acute,adaxially,adpressed,along,also,angled,anther,anthesi,apex,appearance,articulation,axi,base,berry,bifurcate,bracteate,branched,broadly,cage,calyx,capitate,cell,cm,conical,cordate,corolla,curved,dark,decumbent,decurrent,deltate,densely,diameter,erect,filament,flower,flushed,fruit,fruiting,giving,glabrous,glandular,globose,green,greenish,hair-like,herb,imparipinnate,inflorescence,internode,interrupted,investing,irregularly,lamina,lanceolate,larger,lateral,leaflet,length,like,lobe,long,longer,margin,midvein,minute,mixture,mm,narrowly,oblique,obovate,occasionally,often,onto,outgrowth,ovary,papillate-pubescent,patent,pedicel,perennial,petiole,pubescent,purple,rachi,reflexed,ripe,shaggy,silky,simple,size,slender,sometimes,somewhat,sparsely,spreading,stem,stigma,stout,straight,stripe,strongly,style,surface,tall,testa,tip,toward,trichome,truncate,tube,two,undulate,uniseriate,unit,upper,usually,vein,velvety,vivid,wall,white,wide,winged,woody,yellow	.5,0-,0.05-1,0.1-,0.1-0.5,0.1-0.6,0.2-,0.25-0.4,0.3,0.3-0.4,0.3-0.5,0.4-,0.4-0.6,0.4-1,0.45-0.6,0.5-0.8,0.5-1,0.7-1,0.7-2,0.7-3,0.8-1.2,1-2-celled,1-2.5,1-3.5,1-celled,1.2-1.6,1.5-2,1.7-3.0,1/2,2-4,2-4-celled,3-5,3/4,4-celled,5-10,5-9-celled,8-celled,absent,abundance,acroscopically,alfway,always,amongst,apical,apparently,appendage,arequipa,around,articulated,articulatio,basal,berr,bract,brown,c.,column,common,crenate,deciduous,deeper,dense,density,dentate,developed,diamete,distal,eaf,edicel,eed,eglandular,either,elliptic,elliptical,exserted,extremely,forming,general,glabrescent,gland,gree,half,halfway,head,hyaline,interjected,largest,leave,lobed,lobing,lon,lower,middle,mixed,multicellular,near,node,orbicular,pair,peduncle,petiolule,population,present,primary,pseudostipule,rest,rotate-stellate,rounded,ruit,scattered,secondary,sessile,short,shorter,sinus,small,sparse,sparser,staminal,sterile,tem,terminal,tertiary,thick,tiny,tipped,ud,unicellular,united,variable,variety,ympodial	bark,bud,color,count,free,growth,habitat,height,leaf,major,mentioned,minor,new,position,prickle,scar,seed,shape,stone,structure,sympodial,texture,width,wing,young
128	wfo-0001027248	success	158	152	127	31	25	0.804	.5,0.5-1,0.5-2.5,0.7-1.2,1-1.5,1-2,1-3,1-5,2-2.5,2-4.5,3-4,3-7,3-7-flowered,4-8,6-13,6.5-8,7-9,abaxial,abaxially,acute,adaxially,along,anther,anthesi,apex,appearing,arachnoid,arachnoid-pubescent,area,bark,base,beige,beneath,berry,broadened,broadly,brownish,calyx,cm,conical,corolla,deltate,densely,denser,dia,differing,difoliate,dirty,ellipsoid,elliptic,erect,felty,filament,fleshy,free,fruit,fruiting,geminate,glabrescent,glabrous,globose,grayish-green,green,impressed,lamina,later,lateral,leaf,lightly,lobe,lobed,long,main,major,margin,merely,minor,minutely,mm,nearly,node,occasionally,older,opposite,ovary,ovoid-reniform,pair,pale,papillose,patch,pedicel,petiole,pitted,planar,present,pubescence,pubescent,scar,scattered,shoot,shrub,simple,size,small,somewhat,soon,sparsely,specimen,stem,stigma,style,surface,tall,thick,tip,top,tree,trichome,tube,unifoliate,unit,vein,white,wide,winged,woody,young	0,3.5-4,5-5.5,ape,arachnoid-pubescen,brown,brownish-gra,closely,dark,deflexed,eaf,edicel,eed,exserted,lower,nflorescence,overlappin,papillo,per,pore,poricidal,portion,ruit,shaped,spaced,strongly,tear-drop,tub,ud,wid,ympodial	appearance,brownish-gray,bud,cell,color,count,diameter,flower,growth,habitat,height,inflorescence,length,mentioned,new,position,prickle,seed,shape,stone,structure,sympodial,texture,width,wing
129	wfo-0001027258	success	178	174	148	30	26	0.831	.25,.5,/4,0.25-0.5,0.5-1,0.6-2,0.9-1.3,1-1.5,1-2.3,1-4,1.2-2,1.5-1.6,2-2.5,2.5-8,3-4,3-6,3.5-4,4-5,4.5-5,5-10-flowered,6-8,7-13,7-9,abaxially,abruptly,acuminate,acute,adaxially,age,along,anther,anthesi,apex,apical,apiculae,attenuate,axil,bark,base,beneath,berry,broadly,calyx,capitate,cm,corolla,darker,decurrent,deflexed,deltate,densely,dia,difoliate,drying,ellipsoid,elliptic,entire,evenly,extending,filament,flattened-reniform,free,fruit,fruiting,glabrous,globose,green,greenish-yellow,incrassate,internodal,lamina,large,lateral,leaf,length,lengthening,lenticel,lobe,lobed,long,main,major,margin,middle,minor,minute,minutely,mm,occasionally,often,older,onto,opposite,ovary,ovate,pair,pale,papillose,pedicel,petiole,pitted,planar,pore,poricidal,portion,projection,prominent,pubescent,red-papillose,reddish,scar,scattered,shrub,simple,size,slender,slightly,slit,small,spaced,sparsely,stem,stigma,straight,strongly,style,surface,swollen,tall,tip,treelet,trichome,tube,tuft,uniseriate,unit,urceolate,vein,way,white,widening,widest,winged,woody,x,yellowish,yellowish-tan,young	apar,ba,crystal,dense,deposit,differing,dissecting,eaf,edicel,eed,enlarge,exserted,fide,fragrant,geminat,glabrou,lower,microscope,nee,nflorescence,papillo,ruit,sand,speck,sweetly,tiny,tub,ud,visible,ympodial	apart,appearance,bud,cell,color,count,diameter,enlarged,flower,geminate,growth,habitat,height,inflorescence,minutedeltate,new,position,prickle,seed,shape,stone,structure,sympodial,texture,width,wing
130	wfo-0001027260	success	176	167	123	53	44	0.699	-2,-60,-7,0.25-1,0.5-1,0.5-3,0.5-6.5,0.75-1,0.8-2,1-,1-3,1-4,1-6,1-7,10-25,15-30,2-,2-10,2-18,2-2.5,2.5-14,2.5-3.5,3-,3-4.5,3-6,3.5-25,4-25,4-32,4-6,5-,5-40,6-20,abaxially,absent,acuminate,acute,acute-,adaxially,age,aggregate,also,apex,basal,base,berry,blade,branched,cell,chartaceous,clavate,cm,connivent,cordate,darker,densely,diameter,distally,eglandular,ellipsoidal,elliptic,elliptic-ovate,equal,exceeding,fading,flattened,flower,fruit,glabrate,glabrous,globose,greenish,hair,lanceolate,lavender,lobe,long,longitudinal,margin,membranaceous,mm,moderately,narrowly,nearly,obtuse,often,ovate,pedicel,petiole,pilose,pink,puberulent,puberulent-pubescent,pubescent,pubescent-pilose,purple,shorter,shrub,simple,slightly,small,sparsely,stigma,stone,stripe,strongly,style,subcoriaceous,tapered,thecae,time,tree,triangular,truncate,tube,unbranched,unit,vein,white,wide,x,yellow,yellow-green,yellowish	-17,1-2,1.5-13,1.5-2,3-10,3-11,4-5-foliat,4.5-14,5-25,5-merous,alyx,apart,ape,articulated,axe,beyond,connective,cylindrical,diamete,directed,eaf,eed,entire,exserted,leaving,lon,lower,nflorescence,nther,orolla,pedicellar,peduncle,perfec,perfect,pilo,pore,presen,puberulent-pubescen,rachi,radiu,remnant,ruit,spaced,stamen,stellate,tal,tem,tomento,ud,usually,vary,yellow-orang,ympodial	4-5-foliate,anther,anthesi,appearance,bark,bud,calyx,color,corolla,count,filament,free,fruiting,growth,habitat,height,inflorescence,lateral,leaf,length,major,mentioned,minor,new,ovary,position,present,prickle,scar,seed,shape,size,stem,structure,surface,sympodial,tall,texture,tip,tomentose,width,wing,yellow-orange,young
131	wfo-0001027265	success	159	139	99	60	40	0.623	-2.5,.2,.3,.5,0.2-0.4,0.5-1,1-1.3,1-2.5,1.2-1.3,1.5-2.5,1.5â4,2,2-,2-3,2-4,20-30,3-,30â50,4.5â8,4â7-branched,abaxially,accrescent,acute,adaxially,anther,apex,apparently,base,berry,blade,calyx,chartaceous,ciliate,cm,covering,diameter,erect,extra-axillary,filament,flattened-reniform,flower,foliate,fruit,fruiting,glabrous,globose,granule,hair,herb,larger,leaf-opposed,lobe,long,long-attenuate,low,lower,margin,minutely,mm,near,nearly,node,oblong,orange,ovate-lanceolate,paired,pedicel,petiole,pitted,present,prominent,puberulent,pubescent,purple,red,ripe,rooting,scarcely,sclerotic,seed,simple,sometimes,sparsely,stigma,style,surface,tall,time,tip,triangular,tube,unit,usually,weak,white,white-puberulent,wide,winged,x	0.1â2,0.5,0.5â0.6,1-3,1.2-2,1.2â1.4,1.5â1.8,1.5â2,2/3,2â2.5,2â3,3-lobed,4-5,4â6,5-merou,58409,adaxiall,alyx,apart,articulated,axe,ba,broad,capitat,connivent,croat,cylindrical,dehiscent,eaf,eed,entire,frui,geminat,hermaphroditic,juic,light,lon,longitudinall,mesocarp,nflorescence,numerous,obtuse,orolla,partially,peduncle,pore,rachi,rarely,recurved,rotate-stellate,ruit,slightly,somewhat,spaced,subcoriaceous,tamen,tem,vary,yellow,ympodial	0.5-0.6,2-2.5,anthesi,appearance,bark,bud,capitate,cell,color,corolla,count,description,free,geminate,growth,habitat,height,inflorescence,lateral,leaf,length,major,mentioned,minor,new,ovary,position,prickle,scar,shape,size,stem,stone,structure,sympodial,texture,vein,width,wing,young
132	wfo-0001027265	success	156	129	90	66	39	0.577	-2.5,.2,.3,.5,0.2-0.4,0.5-1,1-1.3,1.5-2.5,1.5â2,1.5â4,2,2-,2-3,2-4,20-30,3-,30â50,4.5â8,4â7-branched,abaxially,accrescent,acute,adaxially,anther,apex,base,blade,calyx,chartaceous,ciliate,cm,covering,diameter,erect,extra-axillary,filament,flattened-reniform,flower,foliate,fruit,fruiting,glabrous,globose,granule,hair,herb,larger,leaf-opposed,lobe,long,long-attenuate,low,margin,minutely,mm,near,nearly,oblong,orange,ovate-lanceolate,paired,pedicel,petiole,pitted,prominent,puberulent,pubescent,purple,red,ripe,scarcely,sclerotic,seed,simple,sometimes,sparsely,stigma,style,surface,time,tip,triangular,tube,unit,weak,white,white-puberulent,wide,winged,x	0.1â2,0.5,0.5â0.6,1-2.5,1-3,1.2-1.3,1.2-2,1.2â1.4,1.5â1.8,2/3,2â2.5,2â3,3-lobed,4-5,4â6,5-merou,58409,adaxiall,alyx,apart,apparently,articulated,axe,ba,broad,capitat,connivent,croat,cylindrical,dehiscent,eaf,eed,entire,frui,geminat,hermaphroditic,juic,light,lon,longitudinall,lower,mesocarp,nflorescence,node,numerous,obtuse,orolla,partially,peduncle,pore,rachi,rarely,recurved,rooting,rotate-stellate,ruit,slightly,somewhat,spaced,subcoriaceous,tall,tamen,tem,vary,yellow,ympodial	0.5-0.6,2-2.5,anthesi,appearance,bark,bud,capitate,cell,color,corolla,count,free,geminate,growth,habitat,height,inflorescence,lateral,leaf,length,major,minor,new,ovary,position,prickle,provided,scar,shape,size,stem,stone,structure,sympodial,texture,vein,width,wing,young
133	wfo-0001027284	success	172	160	111	61	49	0.645	.3,0.2â,1.5â8,1â1.5,1â2,3.5â14,4,5â7,abaxially,accrescent,acuminate,acute,adaxially,anther,anthesi,apex,axillary,base,blade,branch,branched,brownish,calyx,climbing,cm,conspicuous,cordate,deltoid,densely,diameter,elliptic,extra-axillary,filament,fine,flattened,flattened-reniform,fleshy,flower,fruit,fruiting,glabrous,globose,gradually,green,herbaceous,inflorescence,leafy,lobe,long,margin,maturity,midvein,minutely,mm,nearly,oblique,orangish,ovate,ovoid,pair,pale,pedicel,petiole,pinnate,planar,plurifoliate,pointed,prominent,pubescence,pubescent,rarely,reduced,reticulate-rugulose,rounded,sand-punctate,scandent,scar,secondary,shortly,shrub,simple,size,slightly,sometimes,somewhat,soon,sparsely,spreading,stellate,stem-terminal,stigma,style,surface,tan,thickly,time,tip,toward,tree,truncate,tube,unbranched,understory,unit,vein,vine,weakly,white,wide,woody,x	0.1â0.5,0.1â2,0.7â0.9,0.7â1,1.2â1.5,1.5â2,1.5â2.5,1.5â5.5,1.8â2,1â3,2.5â3,2.5â3.5,2â16,2â2.2,3â4,4â12,4â6,5-merous,5â8,9â18,alyx,axe,berry,c.,capitat,ciliat,contiguousl,cylindrical,deflected,distally,eaf,eed,enlarged,entire,glabrescen,glabrou,immature,lower,m.,near,nflorescence,nternode,one,orolla,peduncle,pendulou,perfec,pink,rachi,ruit,sand-punctat,seen,side,spaced,tamen,tem,thickened,unifoliat,vary,venation,ympodial	1-1.5,1-3,1.2-1.5,1.5-2,1.5-2.5,2-16,2.5-3,3-4,4-12,4-6,5-8,9-18,appearance,bark,bud,capitate,cell,ciliate,color,corolla,count,description,free,glabrescent,growth,habitat,height,lateral,leaf,length,major,mentioned,minor,new,ovary,pendulous,position,prickle,seed,shape,stem,stone,structure,sympodial,texture,unifoliate,width,wing,young
134	wfo-0001027302	success	188	164	136	52	28	0.723	0.4-5,0.5,0.5-1,0.6-1,1,1-1.3,1-1.5,1-2,1-3,1.2-1.6,1.2-2.5,1.5-2,10,10-20,2,2-3,2-6,2.2,2.7-7.5,3.5-5,3/4,6-12,7,7/8,abaxially,acuminate,acute,adaxially,age,along,anther,anthesi,apex,appearing,bark,base,becoming,berry,branching,bright,brownish-yellow,calyx,capitate,clavate,cm,conical,cordate,corolla,cultivation,deltoid,dendritic,densely,denser,diameter,elliptic,especially,filament,fine,flat-topped,flattened,flower,free,fruiting,glabrous,globose,growth,later,lateral,lax,leaf,length,lenticular,less,lobe,lobed,long,long-triangular,main,margin,minutely,mm,monochasial,narrowly,occasionally,older,otherwise,ovary,ovate,overtopping,pair,pale,per,petiole,pitted,planar,plant,plurifoliate,pore,poridical,puberulent,pubescent,pyramidal,red,reflexed,scar,scattered,scrambling,secondary,shoot,shrub,simple,slit-like,small,somewhat,stem,stigma,style,surface,tall,terminal,tiny,tip,tree,trichome,truncate,tube,unit,usually,vein,violet,way,wide,winged,woody,x,young	.5,0.8-1,5-7,abaxial,adaxial,apical,ba,basal,blade,broader,crispate,decurrent,deflexed,dichasia,discussion,eaf,edicel,eed,entire,ew,exserted,growing,inserted,juvenile,larger,like,lon,lower,m.,nflorescence,nodding,papillo,pedicle,pericarp,portion,prominent,reddish-brown,ruit,see,shade,shin,sleeve,sparsely,stamen,strongly,tapering,thin,time,tub,ud,undulate,ympodial	appearance,bud,cell,color,count,dichasial,fruit,habitat,height,inflorescence,major,minor,new,null,papillose,pedicel,position,prickle,seed,shape,shiny,size,stone,structure,sympodial,texture,width,wing
135	wfo-0001027310	success	215	177	147	68	30	0.684	-2.2,-20,/3,0-20,0.05,0.05-0.15,0.1-0.2,0.15-0.3,0.6-1,0.7-2,1-1.2,1-1.7,1-6,1.5-2.2,1.5-5,1/10-1/6,1/3-1/2,11-16,2-3.1,2-4,2/3,22-30,3-15,4-10,4-9,4.5-5.5,4.5-7,5-10,5-20,5-7,7-10,9-13,abaxially,acute,anther,apart,apex,apically,apparently,bark,base,branched,branching,broadly,calyx,cm,connivent,cuneate,curved,dark,deltate,densely,diameter,erect,evenly,filament,flattened,flattened-reniform,flower,foliaceous,free,fruit,fruiting,fused,gently,glabrescent,glabrous,glaucous,gray,green,green-brown,hair,inflated,lanceolate,lateral,leaf,length,less,lobe,lobed,long,long-styled,lower,margin,maturity,mauve,midpoint,minutely,mm,moderately,older,pair,pale,pedicel,petiole,pitted,poricidal,porrect,porrect-lepidote,prickle,prickly,primary,pubescent,purple,ray,red,reflexed,rounded,scar,secondary,sessile,shallowly,shorter,shrub,simple,sometimes,spaced,sparse,sparsely,spherical,spreading,stalk,stalked,stellate,stellate-pubescent,stem,stout,straight,style,surface,tapering,terete,terminal,tip,toward,tree,trichome,truncate,tube,unarmed,unit,vein,way,wide,woody,yellow,young	.8,0,0-5,0.1,0.9-0.17,1.1-1.5,1/3-3/4,2-10,2-5,2.2-2.5,2.8-3,20-60,5-merous,6-8,8-10,abaxial,acut,adaxial,alyx,andromonoecious,apar,articulated,berry,blade,chartaceous,discolorous,distal,drying,eaf,eed,elongating,entire,equal,faint,glabrou,hermaphrodite,heterostylous,infructescence,longer,lowermost,mature,nflorescence,one,open,orange-brown,orolla,oung,peduncle,pendulous,per,pericarp,plant,plurifoliat,portion,reddi,ruit,short-styled,smooth,staminat,strongly,tamen,tertiary,time,unarme,vary,venation,visible,ympodial	0.9-1.7,anthesi,appearance,bud,cell,color,corolla,count,growth,habitat,height,inflorescence,major,minor,new,null,ovary,plurifoliate,position,reddish,seed,shape,size,stigma,stone,structure,sympodial,texture,width,wing
136	wfo-0001027317	success	144	148	120	24	28	0.833	.25,.5,0.1-0.2,0.3-1,0.4-1.5,0.5-1,0.5-3,0.8-3.5,1,1-1.5,1-2,1-5,1.4-1.6,1.5-2,2-3-flowered,2-9,3-3.5,4.5-5,7-9,?,abaxial,acuminate,acute,adaxially,along,anther,anthesi,apex,apical,apically,arch,bark,base,beneath,berry,bilobed,broadly,calyx,closely,cm,conical,corolla,cucullate,deltoid,densely,dia,difoliate,drying,ellipsoid,elliptic,elongated,erect,expanded,filament,free,fruit,fruiting,glabrous,globose,golden,green,joined,known,lateral,leaf,like,lobe,lobed,long,main,major,margin,mature,minor,minute,minutely,mm,nearly,offset,older,opposite,ovary,pair,pale,papillose,pedicel,petiole,pointed,pore,poricidal,projection,prominent,pubescent,reflexed,rest,scar,series,shaped,shrub,simple,size,slightly,spaced,sparsely,stem,stigma,strongly,style,surface,tall,tear-drop,tip,trichome,tube,uniseriate,vein,white,woody,x,young	ba,deciduous,deflexed,differing,eaf,edicel,eed,filiform,geminat,greyish-whit,immature,inflorescenc,lon,long-exserted,lower,nflorescence,overlappin,papillo,portion,ruit,soon,tub,ud,ympodia	appearance,bud,cell,color,count,diameter,flower,geminate,greyish-white,growth,habitat,height,inflorescence,length,mentioned,new,overlapping,position,prickle,seed,shape,stone,structure,sympodial,texture,unit,width,wing
137	wfo-0001027323	success	175	141	116	59	25	0.663	/3,0.5-1,1-1.5,1-2,1.2-1.5,10-15,14-21,2-3,2-6,2.5-3,20-45,3-5,5-20-flowered,5-7,6-11,7-9,acute,adaxial,along,anther,anthesi,apex,area,arising,asymmetric,attenuate,bark,base,berry,broadened,bud,calyx,campanulate,closed,cm,corolla,decurrent,densely,dia,difoliate,elliptic,elongate,entire,filament,fleshy,flopping,flower,free,fruit,fruiting,furcate,glabrate,glabrous,globose,grey,held,higher,hood,immature,lateral,leaf,live,lobe,lobed,long,long-triangular-deltoid,major,margin,matte,minor,minutely,mm,occasionally,one,onto,opposite,ovary,ovoid,ovoid-reniform,pair,papillose,partially,pedicel,petiole,pinkish-grey,pitted,plant,prominent,red-papillose,reddish-grey,rest,ridge,scar,secondary,size,slightly,small,stem,stigma,style,surface,tall,tan,thickened,tip,treelet,tube,two,unit,vein,way,white,winged,woody,x,young	.75,apparent,appearing,ba,character,closely,cork,deflexed,differing,dried,dry,eaf,edicel,eed,erect,erose,exserted,five-pointed,geminat,growing,hooded,interpetalar,like,lon,lower,main,mature,measured,middle,nflorescence,older,overlapping,papillae,papillo,persistent,planar,pore,poricidal,portion,proximal,rather,ruit,seen,shaped,sinus,smoot,soon,spaced,specimen,straight,tear-drop,thin,tiny,trunk,ud,upper,visible,widest,ympodial	appearance,cell,color,corky,count,diameter,geminate,growth,habitat,height,inflorescence,length,mentioned,new,position,prickle,seed,shape,smooth,stone,structure,sympodial,texture,width,wing
138	wfo-0001027340	success	189	144	111	78	33	0.587	0.5-0.9,1-2,10-16,16-22,2-4,3.5-5,3.5-9,4-6,4-7.5,5-11,7-18,8-14,8-9.5,abaxially,abruptly,acumen,acuminate,adaxially,along,anther,apex,apparently,axillary,base,berry,bud,cell,chartaceous,ciliate,cm,connivent,cordate,corolla,covering,dark,developing,diameter,distal,elliptic,especially,filament,flower,forked,fruit,generally,glabrous,globose,green,green-white,hair,hair-like,half,herb,lanceolate,lateral,like,lilac-purple,lobe,long,make,margin,membranous,midrib,minutely,mm,mucilaginous,narrow,narrowed,odd-pinnate,ovate,ovoid,pedicel,perfect,petiole,petiolulate,plant,plurifoliate,pointed,puberulent,pubescent,purple,ripe,rounded,seed,semi-rosette,sessile,short,shortly,size,sparsely,splotched,stem,stigma,style,subtending,terminal,testal,thick,throughout,tinged,tip,tri-,truncate,tube,unit,usually,wall,wet,wing,x,young	1-10,1-3,1.5-2.7,2-3,2-3.5,2.5-4.5,2.7-4.5,3-4,5-6,5-merou,6-8.5,7-8,absent,ag,alyx,apart,articulated,articulation,auriculate,axe,blade,brownish,capitat,condition,decreasing,digestion,distinct,dorsally,drying,eaf,edge,eed,enzyme,exceeding,flat,folded,fresh,geminat,glabrou,greenish,hal,high,homostylous,honeycomb-shaped,indistinct,interjected,leaflet,lengthening,living,lower,minute,nflorescence,orolla,pair,papillose,peduncle,pore,poricidal,purpl,removed,rotate,ruit,semi-erec,seudostipule,slightly,slit,spaced,specimen,stamen,ste,straight,tall,tamen,tem,vary,whitish,yellow,ympodial	anthesi,appearance,bark,calyx,capitate,color,count,free,fruiting,geminate,growth,habitat,height,inflorescence,leaf,length,major,mentioned,minor,new,ovary,position,prickle,scar,semi-erect,shape,stone,structure,surface,sympodial,texture,vein,width
139	wfo-0001027354	success	166	136	110	56	26	0.663	0.5-2,0.7-1.3,1-1.5,1-7,1.5-1.8,1.5-2,1.7-5,10-20,3.4-4,4-10,5-7,6.5-13,8-12,abaxially,absent,acute,adaxial,age,along,anther,anthesi,apex,appearing,bark,base,becoming,bi-lobed,branch,branching,calyx,cm,conical,corolla,covered,dark,deltoid,dendritic,densely,denser,diameter,drying,elliptic,filament,flattened,flower,fork,free,fruit,fruiting,glabrate,glabrous,globose,golden,growth,later,lateral,leaf,length,lenticular,like,lobe,long,loosely,minutely,mm,monochasial,mostly,narrowly,occasionally,ovary,pair,pedicel,petiole,pitted,planar,plurifoliate,pore,poricidal,pubescent,purplish-black,pyramidal,reddish-brown,scar,secondary,shrub,simple,slit-like,small,sparsely,stem,stigma,style,surface,tall,terminal,tiny,tip,tree,tree-like,trichome,tube,unit,vein,violet,white,wide,winged,woody,x,young	.5,0,0.5,1,1-1.2,10,2.5-3.5,3-4,3/4,abaxial,apical,ba,basal,belo,berry,blade,dichasia,eaf,edicel,eed,entire,erect,ew,exserted,inserted,less,lobed,loose,lower,m.,near,nflorescence,nodding,older,papillo,per,pericarp,portion,pubescen,raised,ruit,side,sleeve,slightly,somewhat,stamen,strongly,tapering,thecalyx,thin,time,tub,type,ud,way,ympodial	appearance,bud,cell,color,count,dichasial,habitat,height,inflorescence,major,margin,minor,new,null,papillose,position,prickle,seed,shape,size,stone,structure,sympodial,texture,width,wing
140	wfo-0001027359	success	224	163	135	89	28	0.603	-2,-4,-9,.1,.2,.5,/4,0-2,0-3,0-5,0.1,0.1-0.2,0.3-1.2,0.5-2,1-1.2,1-2,1.2-1.5,1.2-2,1.5-2.5,2-3,2-4,2.5-3.5,2.5-5.5,3-10,4-5,5-,6-8,7-8,abaxially,acute,anther,apex,apparently,bark,base,berry,branched,bright,calyx,cell,cm,cream,cuneate,curved,dark,deltate,densely,diameter,difoliate,dull,elongate,erect,filament,flattened-reniform,flower,free,fruit,fruiting,glabrescent,glabrous,gray,green,herbaceous,lateral,leaf,length,lobe,long,margin,marking,mature,maturity,midpoint,minutely,mm,moderately,narrow-deltate,narrow-ovate,obtuse,occasional,often,orange-brown,outline,ovate,ovoid,pair,pale,pedicel,petiole,pit,poricidal,porrect,prickle,prickly,purple,raised,ray,red,reflexed,reticulate,scandent,scar,sessile,shorter,shrub,slender,small,smooth,sometimes,sparsely,spherical,spreading,stalk,stalked,stellate,stellate-pubescent,stem,stump,style,surface,tapering,terete,terminal,tip,trichome,tube,unarmed,unit,variously,vein,white,wide,woody,yellow,young	-0.25,-20,-3,-7,/3,0,0-9,0.1-1.5,0.3-0.5,0.5,0.5-1,0.6-0.8,0.6-1,1-3,1-4,1-5,1.5-2,1.8-3.2,1/5-1/4,2-10,4-,5-6.5,5-merous,acut,alyx,apar,apart,apically,articulated,ba,blade,brow,chartaceous,concolorous,coroll,distinctive,drying,eaf,eed,elongating,entire,equal,eye,filiform,flattened,geminat,infructescence,less,like,lobed,longer,lower,membranous,naked,near,nflorescence,older,one,open,orolla,oung,peduncle,per,perfec,pericarp,portion,primary,rachi,rarely,ruit,shallowly,simple,slightly,spaced,tamen,tertiary,time,tinge,ud,unarme,undulate,usually,vary,venation,visible,way,weakly,yellow-brown,ympodial	anthesi,appearance,brown,bud,color,corolla,count,geminate,growth,habitat,height,inflorescence,major,minor,new,null,ovary,position,seed,shape,size,stigma,stone,structure,sympodial,texture,width,wing
141	wfo-0001027366	success	136	128	97	39	31	0.713	/4,0.25-0.5,0.5-1,0.7-1,1-1.5,1-2,1-3,11-21,2-2.5,3-10-flowered,3-9,4-5,5-7,6-19,acute,anther,anthesi,apex,bark,base,bright,broadly,brown,calyx,capitate,closely,cm,conical,conspicuously,corolla,dark,deltate,drying,elliptic,filament,free,fruiting,glabrous,globose,golden,green,greenish-white,internodal,lamina,lateral,leaf,less,lobe,lobed,long,long-triangular,main,margin,minutely,mm,older,opposite,orbicular,ovary,ovoid,ovoid-reniform,packed,pair,pale,papillose,parallel,pedicel,petiole,pitted,planar,pointed,pore,poridical,rounded,scar,secondary,shaped,shining,shrub,simple,sometimes,somewhat,stem,stigma,style,surface,tall,tear-drop,tip,tube,unit,vein,venation,way,wide,woody,young	.5,/2,1.5-2,4-4.5,603,abaxially,adaxially,ape,axe,ba,berry,deflexed,dia,eaf,edicel,eed,erect,et,except,exserted,fide,lon,lower,middle,nflorescence,overlappin,papillo,portion,ramo,reddish,ruit,straight,trichome,tub,ud,unifoliat,widest,yellowish-gre,ympodial	appearance,bud,cell,color,count,diameter,flower,fruit,growth,habitat,height,inflorescence,length,major,mentioned,minor,new,overlapping,position,prickle,seed,shape,size,stone,structure,sympodial,texture,unifoliate,width,wing,yellowish-grey
142	wfo-0001027368	success	145	141	98	47	43	0.676	-10,-2,-20,-5,.5,0.3-2.5,0.5-3.5,0.5-5,0.8-2,1-2,1-6,1.5-2,1.5-2.5,2-3,2-4,3-12.5,4-6,5-10,5-15,5-6,abaxially,abruptly,acuminate,acute,adaxially,apex,base,blade,branched,calyx,cell,chartaceous,cm,color,cuneate,darker,decurrent,deltate,dendritically,densely,denser,diameter,distally,ellipsiodal,elliptic,elliptic-ovate,except,forked,glabrous,globose,hair,lanceolate,lenticular,lighter,lobe,long,long-stalked,margin,midvein,mm,moderately,narrowed,narrowly,nearly,oblong,occasionally,often,otherwise,ovoid-fusiform,pedicel,petiole,puberulent,pubescent,purple,ray,shrub,simple,small,sparsely,star,stigma,stone,style,subhastate,terminal,three,time,tip,triangular,truncate,tube,unbranched,unit,unknown,vein,white,wide,x	-15,1-15-flower,2,2-2.5,2-9,3,4-many-foliat,8-13,absen,adaxiall,aggregate,also,apart,articulated,axe,ba,connivent,contiguous,cylindrical,directed,eaf,eed,entire,gland,lower,nflorescence,nther,obtuse,orolla,peduncle,pore,pubescen,rachi,radiu,ruit,sometimes,spaced,stalked,stellate,subcapitat,subcoriaceous,tal,tem,usually,vary,yellow,ympodial	1-15,4-many-foliate,absent,anther,anthesi,appearance,bark,bud,corolla,count,filament,flower,free,fruit,fruiting,growth,habitat,height,inflorescence,lateral,leaf,length,major,mentioned,minor,new,ovary,position,prickle,scar,seed,shape,size,stem,structure,subcapitate,surface,sympodial,tall,texture,width,wing,young
143	wfo-0001027369	success	191	157	127	64	30	0.665	-1,-10,-11,-2,.1,.5,/4,0,0-6,0.05-0.15,0.1,0.1-0.2,0.2-0.5,0.25-0.4,0.3-1.5,0.5,0.5-0.8,0.5-1.5,0.6-0.8,1-,1-2,1-2.5,1-3,1.2-2.5,1.2-3,1.5-2,2-3,2-4,2-5,3-4,4-8,7-15,abaxially,almost,ame,anther,apart,apex,apparently,bark,base,blade,branched,c.,calyx,cm,color,concolorous,cordate,deltate,densely,diameter,difoliate,drying,elongating,equal,filament,flower,free,fruit,fruiting,glabrous,glaucous,green,hair,herbaceous,known,lanceolate,lateral,leaf,length,less,lobe,long,margin,mature,mauve,membranous,midpoint,mm,moderately,multangulate,older,one,open,orbicular,pale,pedicel,perpendicular,petiole,poricidal,porrect,prickle,prickly,ray,reflexed,reniform,rounded,scandent,scar,sessile,shrub,simple,slightly,spaced,sparsely,spherical,spreading,stalk,stalked,stellate,stellate-pubescent,stem,straight,style,surface,tapering,terete,terminal,time,tip,trichome,tube,unit,visible,wide,yellow	.4,.7,0-1,0-15,0-3,0-5,0.1-0.3,1-4,1/3,3,3-10,4-5,5,5-merous,acut,alyx,apar,apically,articulated,berry,broad-deltate,curved,distance,eaf,eed,erect,extending,eye,filiform,geminat,glabrou,gra,infructescence,know,lobed,lon,lower,midvein,naked,narrowly,nflorescence,orolla,oung,peduncle,pendulous,per,perfec,pericarp,portion,prickl,ruit,side,slender,smooth,strongly,tamen,unarmed,unequal,vary,venation,way,wider,winged,ympodial	anthesi,appearance,bud,cell,corolla,count,geminate,gray,growth,habitat,height,inflorescence,major,mentioned,minor,new,ovary,position,seed,shape,size,stigma,stone,structure,sympodial,texture,vein,width,wing,young
144	wfo-0001027378	success	149	112	64	85	48	0.43	.2,0.5â1,1.5â8,2â11,3â5,abaxially,acuminate,adaxially,anther,apex,base,blue,broadly,calyx,ciliate,cm,color,cordate,deeply,deltoid,diameter,extra-axillary,filament,flattened,flower,fruit,fruiting,glabrous,hair,herbaceous,lanceolate,leaf,light,lobe,long,margin,markedly,membranous,mm,ovate,ovoid,pedicel,petiole,pubescent,rounded,sand-punctate,scattered,short,slender,slightly,sparsely,stem,stigma,style,terrestrial,tip,trichome,tube,unbranched,unit,unknown,vein,white,x	0.7â1,0.8â2.5,1.2â1.5,1.2â1.8,1.5â1.8,15â35,1â1.5,1â3,2.3â5,2.5â7,2â2.2,2â2.5,3â4.5,3â6,4â6,4â9,5-8,5-merous,5â10,5â13,5â7,6â10,6â7,acute,adaxial,alyx,apar,apicall,axe,berry,blade,c.,capitat,chartaceous,clavate,climbin,cylindrical,densely,eaf,eed,fleshy,glabrou,hair-tipped,half,like,lon,longer,lower,m.,minutely,moderately,narrowly,nflorescence,nternode,obscure,often,orolla,palmate,papillose,peduncle,pentagonal,perfec,plurifoliat,pointed,primary,rachi,revolute,rotate-stellate,ruit,sand-punctat,side,simple,small,somewhat,spaced,tamen,tem,tooth,unknow,vary,venation,vine,wide,widely,ympodial	0.7-1,1-1.5,1-3,1.2-1.5,1.5-1.8,15-35,3-6,4-6,4-9,5-13,6-7,anthesi,apically,appearance,bark,bud,capitate,cell,climbing,corolla,count,free,growth,habitat,height,inflorescence,lateral,length,major,minor,new,null,ovary,plurifoliate,position,prickle,scar,seed,shape,size,stone,structure,surface,sympodial,texture,width,wing,young
145	wfo-0001027378	success	141	128	90	51	38	0.638	.2,0.7-1,1-1.5,1-3,1.2-1.5,1.5-1.8,1.5-8,15-35,2-11,2-4,2.3-5,3-5,3-6,4-6,4-9,5-13,6-7,abaxially,acuminate,acute,adaxially,anther,apex,apparently,basally,base,blade,blue,broadly,calyx,chartaceous,ciliate,climbing,cm,connivent,cordate,deeply,deltoid,densely,diameter,extra-axillary,filament,fleshy,flower,fruit,fruiting,glabrous,hair,herb,lanceolate,leaf,light,lobe,long,longer,margin,mm,moderately,multicellular,narrowly,node,oblong,ovate,pedicel,petiole,plurifoliate,pubescent,rooting,rounded,scattered,short,simple,slender,slightly,somewhat,sparsely,stigma,style,terrestrial,tip,trailing,tube,unbranched,unit,unknown,vein,weakly,white,wide,x	0.8-2.5,2-2.2,2.5-7,3-4.5,5-8,5-merou,6-10,ag,alyx,apart,apicall,articulated,axe,ba,capitat,clavate,cylindrical,directed,distally,eaf,eed,equal,geminat,hair-tipped,large,longitudinal,lower,minutely,nflorescence,obscure,often,opening,orolla,peduncle,perfect,pore,pubescen,rachi,revolute,rotate-pentagonal,slit,small,spaced,tamen,tem,tooth,unknow,vary,widely,yellow,ympodial	anthesi,apically,appearance,bark,bud,capitate,cell,color,corolla,count,free,geminate,growth,habitat,height,inflorescence,lateral,length,major,minor,new,null,ovary,position,prickle,scar,seed,shape,size,stem,stone,structure,surface,sympodial,texture,width,wing,young
146	wfo-0001027384	success	155	160	133	22	27	0.858	.25,.5,/3,0.4-1.1,0.5-1,0.9-1,1-1.3,1-1.5,1-3,1-4,1.5-2,2.5-6.5,3-3.5,3-4,3/4,4-7,5-15-flowered,5-5.5,7-14,7.5-8,acute,anther,anthesi,apart,apex,bark,base,beginning,beneath,berry,breaking,broadly,brown,bud,calyx,capitate,clavate,closely,cm,corolla,cuneate,deep,dia,difoliate,distal,drying,ellipsoid,equal,erect,filament,flattened-reniform,free,fruiting,geminate,glabrous,globose,green,herbarium,incrassate,later,lateral,leaf,lobe,lobed,long,long-exserted,margin,member,middle,minutely,mm,mustard,narrowly,obovate,occasionally,older,opposite,ovary,overlapping,pair,pale,paler,papillose,pedicel,peeling,petiole,pitted,planar,pore,poricidal,prominent,pseudo-terminal,rarely,reddish-purple,rounded,scar,section,shaped,shining,shrub,simple,small,spaced,specimen,stem,stigma,style,subcoriaceous-fleshy,sulcate,surface,tall,tear-drop,thick,tip,transverse,tree,triangular,trichome,tube,tuft,uniseriate,unit,vein,way,white,widely,widest,without,woody,x,yellow,yellowish,young	.75,abov,anothe,ba,eaf,edicel,eed,hard,inflorescenc,lower,main,nflorescence,papillo,portion,ruit,siz,slender,straight,tapering,tub,ud,ympodial	appearance,cell,color,count,diameter,flower,fruit,growth,habitat,height,inflorescence,length,major,mentioned,minor,new,position,prickle,seed,shape,size,stone,structure,sympodial,texture,width,wing
147	wfo-0001027389	success	154	147	118	36	29	0.766	.1,.5,0.25-0.3,0.25-0.5,0.5-1.5,0.6-1,1,1-1.5,1-2,1.8-1.9,11-14,3-3.5,3-4.5,4-5-flowered,5-7,7-8,acuminate,acute,along,anther,anthesi,apart,apex,bark,base,beneath,berry,broadening,broadly,bud,calyx,cm,conical,corolla,decurrent,deflexed,deltoid,dia,ellipsoid,elliptic,erect,evenly,exserted,filament,foetid,foliage,free,fruiting,glabrous,globose,green,hispidulous,inflorescence,lateral,leaf,like,lobe,lobed,long,main,making,margin,minutely,mm,nearly,occasionally,often,older,one,opposite,ovary,ovate,ovoid-reniform,pair,papillose,pedicel,petiole,pitted,pore,poricidal,prominent,prominently,puberulent,raised,reddish-golden,reflexed,rest,scar,shaped,shrub,side,simple,slight,slightly,soon,spaced,sparsely,stem,stigma,style,surface,tall,tear-drop,thread-like,tip,top,trichome,truncate,tube,uniseriate,unit,vein,white,winged,woody,x,yellowish,young	.25,0.5-0.75,2-2.5,ba,brown,dark,dry,eaf,edicel,eed,except,expanded,filiform,geminate,lon,lower,material,middle,nflorescence,node,non-reproductive,obovoi,paler,papillo,portion,proximal,raise,ruit,shin,slender,straight,tapering,ud,unifoliat,widest,ympodial	appearance,cell,color,count,diameter,flower,fruit,growth,habitat,height,length,major,mentioned,minor,new,obovoid,position,prickle,seed,shape,shiny,size,stone,structure,sympodial,texture,unifoliate,width,wing
148	wfo-0001027395	success	153	152	126	27	26	0.824	.25,.5,0.25-0.5,0.6-1.1,1-1.5,1-2,1-5,1.1-1.5,1.5-1.9,1.5-2.5,1.6-2.9,10-20-flowered,11-15,12.5-17.3,2-3,2.2-7,3.5-4,4-6,5-6.5,8,acute,anther,anthesi,apex,apically,apiculate,attenuate,bark,base,becoming,beginning,beneath,berry,black,calyx,capitate,closely,cm,conical,constricted,corolla,cucullate,decurrent,deflexed,deltoid,densely,depressed,dia,difoliate,drying,enlarging,exfoliating,filament,fleshy,free,fruit,fruiting,glabrous,globose,green,immature,known,large,lateral,leaf,lobe,lobed,long,main,major,margin,midrib,minor,minutely,mm,narrowly,nearly,obovate,occasionally,older,once-furcate,opposite,ovary,overlapping,ovoid,pair,papillose,pedicel,petiole,piece,planar,pointed,pore,poricidal,primary,pubescent,restricted,robust,rusty-papillate,scar,secondary,shaped,shiny,shrub,simple,size,small,somewhat,spaced,stem,stigma,style,tall,tear-drop,thick,tip,transverse,trichome,tube,uniseriate,unit,vein,white,woody,x,young	0.75-1,caly,differing,eaf,edicel,eed,erect,exserted,geminat,imperceptibly,inflorescenc,lon,lower,nflorescence,papillo,partially,portion,raised,ruit,shining,straight,tapering,thickened,ud,within,without,ympodial	appearance,bud,cell,color,count,diameter,flower,geminate,growth,habitat,height,inflorescence,length,mentioned,new,position,prickle,seed,shape,stone,structure,surface,sympodial,texture,width,wing
149	wfo-0001027396	success	244	204	174	70	30	0.713	-5,/3,0-4,0.1-0.5,0.1-1,0.4-0.7,0.5-1,0.5-1.5,0.5-2,0.5-2.5,0.7-2.5,0.8,0.8-1.3,1,1-4,1.2-2,1.5-3,1.5-3.5,1.8-3,1/3,1/4-1/3,1/6,10-15,10-25,10-30,10-35,12-25,15-40,2-3,2-7,20-100,3.5-6,4,4-6,4-7,5-10,5-20,5-50,5-8,6-20,7-10,7-15,8-20,abaxially,acute,almost,ame,anther,apart,apex,apically,apparently,attenuate,bark,base,berry,black,blade,broad,broad-deltate,brown,bulbous,c.,calyx,cm,connivent,cream,cuneate,curved,dark,deltate,densely,diameter,difoliate,elliptic,elongate,elongating,erect,filament,flattened,flattened-reniform,flower,free,fruit,fruiting,fully,glabrescent,glabrous,glandular,green,hair,herb,lateral,leaf,length,less,lignified,lobe,lobed,long,long-styled,longer,margin,marking,mature,maturity,mauve,midpoint,mm,moderately,obtuse,often,one,open,opening,orange,pair,pale,pedicel,pendulous,per,perpendicular,petiole,poricidal,porrect,prickle,prickly,primary,pubescent,purple,ray,reflexed,rotate,scar,sessile,short-styled,shrub,simple,sometimes,somewhat,spaced,sparsely,spherical,spreading,stalk,stalked,stellate-pubescent,stem,stout,straight,style,surface,tapering,tearing,terete,tertiary,time,tip,trichome,tube,unbranched,unit,upper,variously,vein,venation,visible,way,white,wide,woody,yellow,yellowish,young	-2,-6,0-100,0-3,0-30,0-5,1/2-2/3,2-3.5,2.5-4,2.8-4.5,3-,3-9,4-5,5-30,5-merous,5.5-7.5,6.5-7.5,abaxial,adaxial,alyx,andromonoecious,apar,articulated,ba,chartaceous,concolorous,decurrent,discolorous,distal,distance,drying,eaf,eed,equal,extending,extensive,fewer,geminat,gray-brow,hermaphrodite,heterostylous,infructescence,lobing,lon,long-acuminat,lower,lowermost,midvein,near,nflorescence,older,orolla,oung,peduncle,pericarp,plant,portion,prickl,red-brown,ruit,secondary,side,smooth,staminat,tamen,unarmed,usually,vary,yellow-green,ympodial	anthesi,appearance,bud,cell,color,corolla,count,geminate,gray-brown,growth,habitat,height,inflorescence,long-acuminate,major,minor,new,null,ovary,position,seed,shape,size,stigma,stone,structure,sympodial,texture,width,wing
150	wfo-0001027449	success	160	142	116	44	26	0.725	.4,.75,/3,0.5-1,0.8-1.5,0.9-1.1,1.2-1.5,1.4-1.5,1.5-2.5,2-3,2-4,3-3.5,3-7,4-6,5-6,8-15,acuminate,acute,anther,anthesi,apex,area,around,axil,bark,base,becoming,beginning,beneath,bud,calyx,closely,cm,corolla,cup,densely,difoliate,ellipsoid,elliptic,extreme,filament,forming,free,fruit,fruiting,glabrate,glabrous,globose,green,inflorescence,later,lateral,leaf,like,lobe,lobed,long,long-acuminate,long-triangular,main,major,minor,minutely,mm,narrowly,obconic,oblique,often,opposite,orangish,ovary,overlapping,ovoid-reniform,packed,pair,pale,papillose,pedicel,persistent,petiole,pitted,pointed,pore,poricidal,prominent,pubescent,raised,red-papillose,reflexed,rest,scar,shaped,shrub,simple,size,small,sparsely,stem,stigma,style,surface,tall,tear-drop,tip,tree,trichome,tube,tuft,uniseriate,unit,vein,way,white,woody,x,young	.5,0.5-1.5,10-15-flowered,3,appearing,arising,berry,brown,dark,deciduous,deflexed,dense,density,dia,differing,dry,eaf,edicel,eed,erect,exserted,frui,geminat,inflorescenc,lamina,lon,lower,material,nflorescence,older,one,portion,reddish-brow,ruit,slender,soon,sparse,straight,styl,tapering,trunk,ud,varying,ympodial	10-15,appearance,cell,color,count,diameter,flower,geminate,growth,habitat,height,length,margin,mentioned,new,position,prickle,reddish-brown,seed,shape,stone,structure,sympodial,texture,width,wing
151	wfo-0001027452	success	152	156	117	35	39	0.77	.5,0.5-1,0.5-1.5,0.5-2,0.5-2.5,1,1-2,1-3,1-4.5,1-5,1.5,1.5-3,10-20,2-6,2-foliate,3-6,3-9,4,4-6,5-12,abaxially,absent,abundant,acute,adaxially,anther,apex,axe,base,berry,beyond,branched,brown,calyx,cell,celled,center,chartaceous,cm,connected,cordate,decurrent,densely,denser,diameter,dm,drying,elliptic,elliptic-ovoid,equal,exserted,filament,flower,fruit,glabrous,globose,hair,herb,immature,interpetalar,large,linear-lanceolate,lobe,long,margin,maturing,membranaceous,mm,moderately,nearly,new,notched,oblong,obtuse,often,one-,outer,parallel,pedicel,peduncle,perpendicular,petiole,placenta,pubescent,rachi,raised,ridge,rounded,running,seed,semitransparent,short,significantly,single,slightly,smaller,smoother,sometimes,sparsely,stamen,stigma,straight,style,swollen,tissue,triangular,tube,two-celled,unbranched,unit,usually,vein,wall,white,woody,x,yellow	2-4,5-20,adaxiall,along,blade,ciliate,dehiscing,eaf,eed,emarginat,entire,explosively,flat,frui,geminat,growt,held,lower,lying,maturit,mesocarp,nfloresence,orolla,per,pressure,pubescen,rotate,ruit,tal,tamen,tem,vary,watery,wid,ympodial	anthesi,appearance,bark,bud,color,corolla,count,emarginate,free,fruiting,geminate,growth,habitat,height,inflorescence,lateral,leaf,length,major,minor,null,ovary,position,prickle,scar,shape,size,stem,stone,structure,surface,sympodial,tall,texture,tip,wide,width,wing,young
152	wfo-0001027471	success	165	160	137	28	23	0.83	.5,0.2-0.4,0.2-0.5,0.4-1,0.5,0.5-0.6,0.5-0.7,0.5-1.5,0.7-0.9,0.9-1,1-1.2,1-1.5,1-1.6,1.4-3,1.5-2,2-2.5,2-3,2-lobed,3-7,4-5,6-7,abaxially,acute,adaxially,age,along,anther,anthesi,apex,appressed,ascending,bark,base,berry,bifid,branched,calyx,closely,cm,conical,corolla,deltate,dendritic,densely,diameter,difoliate,distant,drying,elliptic,entire,erect,especially,filament,flattened,flower,free,fruiting,furcate-dendritic,geminate,glabrous,globose,growth,herb,inflorescence,internodal,lamina,leaf,leaf-opposed,lengthening,less,like,lobe,long-triangular,major,margin,maturity,midvein,minor,minutely,mixture,mm,new,node,occasionally,open-conical,orbicular,ovary,ovate,overlapping,pair,pale,pedicel,petal,petiole,pitted,planar,plane,pore,poridical,primary,pubescent,rachi,red-orange,reflexed,reniform,scar,scattered,shape,shrub,similar,simple,size,slender,slightly,slit,small,somewhat,spaced,sparsely,stem,stigma,style,subshrub,surface,tan,thickened,tip,trichome,tube,uniseriate,unit,usually,vein,white,woody,x,yellowish	/4,0.1-0.2,3-4,brittle,c.,desnsely,differing,eaf,eed,erec,included,lobed,lower,nflorescence,nodding,papillat,peduncle,perfect,pericarp,portion,pubscent,ruit,straight,thin,trifoliat,ud,way,ympodial	appearance,bud,cell,color,count,fruit,habitat,height,lateral,length,null,papillate,position,prickle,seed,stone,structure,sympodial,texture,trifoliate,width,wing,young
153	wfo-0001027473	success	138	128	99	39	29	0.717	.25,0.25-0.5,0.5-1,0.8-1,1-1.5,1-2,1.3-2,1.8-2,4.5-13,5,6-9,8.5-37,?,abaxially,acute,along,anther,anthesi,apex,bark,base,calyx,clavate,cm,conical,corolla,decurrent,deep,dendritic,densely,denser,di-,differing,drying,erect,filament,flattened-reniform,free,fruiting,glabrous,globose,green,incrassate,later,lateral,leaf,lobe,long,long-triangular,main,major,margin,middle,minor,minute,minutely,mm,near,obovate,occasionally,older,ovary,pair,pale,pedicel,petiole,pitted,planar,pointed,poricidal,pubescent,pubesent,rootstock,sessile,shape,shrub,somewhat,sparsely,stem,stigma,style,subshrub,surface,tall,thick,tip,trichome,trifoliate,tube,unit,usually,vein,white,wide,widest,wing,woody,yellowish,young	/2,1.5-2,1/3,2-2.5,2.5-3,3.5-5,absen,adaxially,ape,apparently,berry,brown,deccurent,deflexed,dia,eaf,eed,empty,geminat,giving,less,like,lobed,lower,overall,papillo,pore,portion,ruit,rusty,sac,shaped,sterile,strongly,tear-drop,way,winged,yellowish-brow,ympodial	absent,appearance,bud,cell,color,count,diameter,flower,fruit,geminate,growth,habitat,height,inflorescence,length,mentioned,new,papillose,position,prickle,scar,seed,size,stone,structure,sympodial,texture,width,yellowish-brown
154	wfo-0001027483	success	164	148	107	57	41	0.652	0.2-1.9,0.6,1,1-2,1-2.5,1-4,1.2-2.5,1.5-10,1.5-2.6,1.5-3,2,2-3,2-4,2-4.5,3-15,3-6,3.5-20,4.5-8,5-10,5-6,abaxially,acumen,acute,adaxially,apex,articulate,basal,base,branched,calyx,cell,cm,coarsely,connate,corolla,covering,cuneate,cyme,diameter,dichasial,dichasially,distal,dorsally,dot,ebracteate,edge,filament,finely,flat,flower,folded,forked,generally,globose,green,hair-like,half,herbaceous,interpetiolar,lateral,leaf,leaflet,light,lighter,lobe,long,make,medium,minute,mm,monochasial,mucilaginous,obtuse,odd-pinnate,ovoid,pedicel,peduncle,perennial,petiole,plant,proximal,pubescent,purple,ray,rosette,rotate,rounded,seed,size,smooth,sometimes,stigma,style,tall,testal,thick,tuber-bearing,uniform,unit,varying,violet,violet-purple,wall,white,wide,yellow,Â¼	0-1.,1-5,3-6-foliat,apical,apically,decurrent,dehiscent,digestion,diminishing,eaf,eed,elliptical,emoval,enzyme,erec,exceeding,globo,gradually,green-white,honeycomb,interjected,introrse,living,lon,lower,lunat,maturing,nflorescence,nther,often,orolla,ovate,pair,pattern,perfect,petiolule,plan,poricidally,rachi,reveal,ruit,sessile,seudostipule,short,slit,specimen,stamen,straight,subsessile,tem,terminal,throughout,tissu,toward,typically,vary,ympodial	3-6-foliate,anther,anthesi,appearance,bark,bud,color,count,erect,free,fruit,fruiting,growth,habitat,height,inflorescence,length,major,margin,minor,new,null,ovary,position,prickle,scar,shape,stem,stone,structure,surface,sympodial,texture,tip,tissue,tube,vein,wet,width,wing,young
155	wfo-0001027506	success	215	195	168	47	27	0.781	-0.35,-1,-20,-3,-7,-7.5,.2,.5,/2,/6,0,0-10,0.1-,0.1-0.3,0.2,0.2-0.3,0.25,0.5-1.5,0.5-6,0.7-1.3,1-2,1-3,1-4,1.2-1.5,1.5-2.2,1.8,1/3,1/6-1/4,10-40,2-3.2,2.2-3.5,2.5-5,2.5-8,3-10,3-5,3-6,3.5-5,5-10,5-7,6-13,6.5-10,7-8,7-9,8-10,9-13,abaxially,acuminate,acute,ame,anther,apart,apex,apically,apparently,bark,base,becoming,berry,blade,branched,brown,c.,calyx,cell,cm,connivent,cordate,cream,cuneate,curved,dark,densely,diameter,dry,erect,filament,fine,flattened,flattened-reniform,flower,free,fruit,fruiting,glabrescent,glabrous,green,hard,lateral,leaf,length,lobe,lobed,long,long-styled,longer,lower,margin,marking,mature,maturity,mauve,midpoint,mm,moderately,multangulate,narrow-deltate,older,one,open,orange,orange-brown,outline,ovate,pair,pale,pedicel,pendulous,pericarp,petiole,pit,poricidal,porrect,prickle,prickly,primary,purple,raised,ray,reddish,reduced,reflexed,scar,sessile,shrub,simple,small,smooth,sometimes,spaced,spherical,spreading,stalk,stalked,stellate,stellate-pubescent,stem,stout,style,surface,tapering,terete,terminal,time,tip,tree,trichome,truncate,tube,twice,unit,upper,variously,vein,way,wide,woody,yellow,young	0-2,0-6,0-60,0.8-1.5,5-merous,acuminat,alyx,andromonoecious,apar,articulated,brow,chartaceous,concolorous,distal,drying,eaf,eed,elongating,entire,equal,hermaphrodite,heterostylous,infructescence,lengt,lowermost,nflorescence,occasionally,orolla,oung,peduncle,per,plant,plurifoliat,portion,prickl,ruit,short-styled,staminat,subentire,tamen,tertiary,unarmed,vary,venation,visible,yellow-green,ympodial	anthesi,appearance,bud,color,corolla,count,growth,habitat,height,inflorescence,major,mentioned,minor,new,ovary,plurifoliate,position,seed,shape,size,stigma,stone,structure,sympodial,texture,width,wing
156	wfo-0001027548	success	216	168	136	80	32	0.63	-11.5,.3,0.5,0.5-2,1,1-1.5,1-10,1-2.5,1-3.5,1.2,1.5,1.5-2,1.5-2.5,10-50,3-7,4-6,4-8,6-9,7-10,8-9,acuminate,acute,almost,along,also,anther,anthesi,apart,apex,articulation,attenuate,base,beneath,bent,berry,black,branch,branched,brown,c.,calyx,capitate,cell,cm,conical,corolla,deltate,dendritic,densely,diameter,ellipsoid,elliptic,elongate,extending,filament,flattened-reniform,flower,free,fruiting,glabrous,glandular,globose,green,growth,immature,inflorescence,irregularly,lamina,leaf,like,lilac,lobe,lobed,long,loose,loosely,many,margin,minute,minutely,mixed,mm,narrowly,new,occasionally,older,pair,pale,papillae,papillate,pedicel,petiole,pitted,planar,plurifoliate,point,primary,pubescent,rachi,rectangular,reddish,ripe,scar,scattered,simple,size,slender,small,sometimes,somewhat,spaced,sparse,sparsely,spreading,stem,stigma,style,surface,terminal,testal,thickened,time,tinged,tip,transparent,trichome,tube,uniseriate,unit,usually,vein,vine,way,white,woody,x	0.2,0.3-1.2,10-12,4.5,5-merou,abaxiall,adaxially,ag,although,alyx,apical,apparently,appearing,area,ark,articulated,axi,basal,branching,bu,connivent,dark,darker,deflexe,denser,depressed-elliptic,drying,dull,eaf,early,eed,em,entire,exserted,flexuous,geminat,glabrescen,half,herbarium,ilament,leaving,lengthening,less,lon,long-styled,lower,matte,membranous,near,nflorescence,orolla,outline,papillo,peduncle,per,perfect,pericarp,pore,poricidal,portion,prominent,puberulent,revolute,ruit,slit,specimen,stellate,strongly,swollen,tapering,thin,tiny,twinin,type,ud,upper,vary,warty,yellow,ympodial	8,abaxially,appearance,bark,bud,color,count,deflexed,description,fruit,geminate,glabrescent,habitat,height,lateral,length,major,mentioned,minor,ovary,papillose,position,prickle,seed,shape,stone,structure,sympodial,texture,width,wing,young
157	wfo-0001027581	success	200	163	125	75	38	0.625	0.3,0.3â1,0.5â1,0.5â1.5,1,1.5â3,10,100+,12â30,15â20,1â3-rayed,4.5â16,4â8,8â10,9â11,>,abaxial,abaxially,acute,adaxial,anther,anthesi,apex,axe,base,beneath,berry,branched,branching,broadly,brown,bulbous,c.,calyx,clavate,closely,cm,corolla,cup-shaped,dark,deltate,densely,diameter,drying,echinoid,ellipsoidal,elliptic,evenly,filament,flattened-reniform,flower,free,fruiting,glabrescent,glabrous,globose,gradually,green,greyish,growth,inflorescence,leaf,length,less,like,lobe,lobed,long,many,margin,minutely,mixed,mm,moderately,multangulate,multiseriate,narrowing,near,new,older,pair,pedicel,petiole,pitted,plurifoliate,porrect-stellate,primary,pubescent,purple,ray,reddish,reflexed,rhachi,ripe,scar,sessile,short-stalked,shrub,simple,size,small,spaced,spreading,stalk,stellate,stem,stigma,style,surface,tall,terminal,time,tip,tree,trichome,tube,undersurface,unit,vein,visible,way,weak,wide,woody,yellowish	0.2â0.3,1.2â1.5,1.3â1.5,1.5,1.5â2,10â16,12,1â1.5,2.5â3,200,3.5â4.5,3â3.5,5-merou,6â7,7â10,7â9,8,9â9.5,ag,along,alyx,apar,ark,articulated,brow,clearly,connivent,dichasia,discolorous,distally,eaf,eed,entire,erec,exserted,golden,ilament,lamina,largest,lengthening,longest,loosely,lower,midvei,minute,nflorescence,nodding,orolla,papillo,part,peduncle,per,perfect,pericarp,plane,pore,poricidal,portion,ruit,scarcely,shiny,slit,smaller,sparsely,stout,tem,thin,ud,unevenly,upper,vary,varying,whit,yellow,ympodial	1.2-1.5,1.3-1.5,2.5-3,3-3.5,3.5-4.5,6-7,7-9,9-9.5,apart,appearance,bark,bud,cell,color,count,dichasial,erect,fruit,habitat,height,lateral,major,mentioned,midvein,minor,ovary,position,prickle,seed,shape,stone,structure,sympodial,texture,white,width,wing,young
158	wfo-0001027584	success	144	155	123	21	32	0.854	-16,-2,..,.5,0.5-1,0.5-1.5,0.9-1,0.9-2.5,1-1.2,1.2-1.4,1.5-2,1.5-8,1.6-1.9,10-15,100,11.5-45,2,2-10,2.5-3,3,3-.,4-6,4-7,4.5-20,7-10,8-9,abruptly,absent,acuminate,anther,anthesi,apex,apical,attenuate,bark,base,becoming,branch,branched,brittle,broadly,calyx,cell,cm,conical,corolla,cucullate,darker,deltate,densely,diameter,dry,ellipsoid,elliptic,filament,flattened,flower,four,fruit,fruiting,glabrous,green,herb,lobe,lobed,long,margin,markedly,minutely,mm,narrowly,nearly,open,outer,outline,ovary,ovate,pair,pale,papillate,pedicel,peduncle,per,pericarp,petiole,planar,pointed,primary,reddish,regularly,reniform,scar,scattered,shrub,single,single-stemmed,sinuate,small,smooth,sparsely,stem,stigma,striate,stripe,style,suffruticose,surface,tan,testal,thin,time,tip,triangular,trichome,tube,tuft,uniseriate,unit,vein,wall,white,without,x	beginning,beneath,brow,c.,capitat,deflexe,eaf,edicel,eed,erec,irregular,lamina,lower,nflorescence,plurifoliat,present,ruit,sparse,thickening,ud,ympdoial	appearance,brown,bud,capitate,color,count,deflexed,free,growth,habitat,height,inflorescence,lateral,leaf,length,major,minor,new,null,plurifoliate,position,prickle,seed,shape,size,stone,structure,sympodial,texture,width,wing,young
159	wfo-0001027600	success	185	164	126	59	38	0.681	-3,0.5-1,0.5-1.5,1,1-14,1-2,1-4,1.5-2,1.5-2.5,10-,10-20,15-25,2-18,2-3,2-3.5,2-4,2-4.5,2.5-21,2.5-6,3-15,3-5-lobed,4-6,5-13,abaxially,abruptly,absent,acuminate,acute,adaxial,adaxially,adpressed,aggregate,along,apex,apical,apiculate,basal,base,beyond,calyx,cell,cm,collection,concave,cordate,coriaceous,cream,cuneate,deltate,densely,diameter,dilated,distally,ellipsoidal,especially,exceeding,except,exserted,fading,flattened,flower,forked,fruit,glabrescent,glabrous,gland,greenish-white,leaf,leaving,lobe,long,main,margin,mature,midrib,minutely,mm,moderately,narrowed,obconical,oblong,obtuse,occasionally,older,orange,ovoid,pedicel,pedicellar,perfect,petiole,pilose,pinnately,puberulence,puberulent,pubescent,purple,rarely,remnant,rounded,simple,slightly,small,sparsely,stamen,stigma,stone,strongly,style,surface,time,tip,tree,triangular,truncate,tube,two,unbranched,unit,unlobed,vein,wide,x,yellow,yellow-green,yellowish,young	-10,1-5,1/2-3/4,2-11,2-5,2-6,20-30,3-5,3-6,4-foliat,8-17,absen,apart,ape,articulated,axe,blade,brow,campanulate,channe,connective,directed,divided,eaf,eed,elliptic,entire,fleshy,glandular-puberulent,laterally,lobed,lon,lower,nflorescence,nther,orolla,ovate,papillose,peduncle,pilo,pore,puberulen,purplish,rachi,radiu,ruit,shorter,sinus,somewhat,spaced,subcoriaceous,tal,tem,thecae,tomento,ud,vary,white,ympodial	4-foliate,anther,anthesi,appearance,bark,brown,bud,channel,color,corolla,count,filament,free,fruiting,growth,habitat,height,inflorescence,lateral,length,major,minor,new,null,ovary,position,scar,seed,shape,size,stem,structure,sympodial,tall,texture,tomentose,width,wing
160	wfo-0001027607	success	167	176	145	22	31	0.868	.1,.25,.5,0.25-0.5,0.5,0.5-1,0.8-1,1,1-4,1.2-1.5,1.5-3,2-2.5,2-3,2-4,2.5-3,3-3.5,3/4,4-10-flowered,5-10,5-7,8-9,acuminate,acute,age,anther,anthesi,apex,arching,area,aspect,bark,basal,base,becoming,berry,branch,brown,calyx,cm,corky,corolla,curling,dark,decurrent,deflexed,deltoid,densely,dia,dry,ellipsoid,elliptic,elongate,erect,evenly,except,f,filament,filiform,flattened,free,fruiting,geminate,gently,giving,glabrate,glabrous,globose,golden,green,lamina,lateral,leaf,less,lobe,lobed,long,lower,main,material,middle,midrib,minutely,mm,narrowly,non-reproductive,obovoid,occasionally,older,opposite,ovary,ovoid-reniform,pagoda-like,pair,papillose,pedicel,petiole,pitted,plant,pore,poricidal,present,prominent,pubescent,raised,rarely,reddish-brown,reflexed,scar,shaped,short,shrub,simple,slender,slight,slightly,small,spaced,stem,stigma,strongly,style,surface,tall,tan,tapering,tear-drop,tip,treelet,trichome,tube,unifoliate,uniseriate,unit,vein,way,white,widened,widening,widest,winged,woody,x,yellowish,young,zig-zag	apar,ba,branche,eaf,edicel,eed,exserted,lenticellat,like,lon,m.,minute,narrow,nflorescence,portion,ruit,soon,straight,styl,tub,ud,ympodial	apart,appearance,bud,cell,color,count,diameter,flower,fruit,growth,habitat,height,inflorescence,length,lenticellate,major,margin,minor,new,null,position,prickle,seed,shape,size,stone,structure,sympodial,texture,width,wing
161	wfo-0001027618	success	202	143	106	96	37	0.525	-10,-pubescent,1-,1-3,1-5,1-9,1.4-4,15-35,2-11,2-11.5,2-27,2-5,2-8.5,2.5-6,3-30,3-7,3.5-6,4,4-8,5-30,5-7.5,6-40,8-35,abaxially,acute,adaxially,aggregate,also,apex,base,branched,bud,campanulate,capitate,cell,chartaceous,cm,compound,cordate,cuneate,darker,deltate,densely,diameter,ellipsoidal,elliptic-ovate,fleshy,flower,fruit,fusiform,glabrous,globose,greenish,lateral,leaf,length,lobe,long,longitudinal,margin,mesocarp,minutely,mm,moderately,oblong,obtuse,often,orange,papillose,pedicel,per,petiole,pilose,pinnately,puberulent,puberulent-pubescent,pubescent,pubescent-pilose,purple,reticulate,ripe,shrub,simple,small,sometimes,somewhat,sparsely,stigma,stone,stripe,style,sympodial,tomentose,tree,triangular,truncate,tube,unbranched,unit,urceolate,white,wide,width,without,x,yellow	0-10,0.5,0.5-1,0.5-6,1,1-1.5,1-13,1-14,1-23,1.5-13,1.5-3,1.5-7,1.5-8.5,11-16,11-22,11-pinnate,12-27,15-30,2-12,2-9,3-18,3-5,3-7-pinnate,5-18,5-20,5-merous,5.5-12,6-25,7-25,8-16,acuminat,acut,alyx,apart,ape,articulated,ascending,axe,basal,beyond,blade,connective,cylindrical,dia,diamete,dilated,directed,distally,eaf,eed,elliptic,entire,exceeding,exserted,laterally,leaflet,leaving,less,lon,lower,membranaceous,near,nflorescence,nther,obovate,obtu,orolla,ovate,pedicellar,peduncle,perfec,perfect,petiolule,pilo,pore,presen,puberulent-pilo,rachi,radiu,ranch,ratio,remnant,rown,ruit,runk,shallowly,shorter,slightly,spaced,spreading,stamen,tal,terminal,thecae,uni,vary	acuminate,anther,anthesi,appearance,bark,branch,calyx,color,corolla,count,filament,free,fruiting,growth,habitat,height,inflorescence,major,mentioned,minor,new,ovary,position,prickle,scar,seed,shape,size,stem,structure,surface,tall,texture,tip,vein,wing,young
162	wfo-0001027622	success	203	161	126	77	35	0.621	.5,0-14,0.3-10,1,1-2,1.5-3.5,1.5-4.2,12-23,2-6,2.5-3.5,3-16,3-4,3-4.5,4-9.5,6-17,8-16,8-20,abaxially,acuminate,acute,adaxially,along,anther,apex,axillary,base,blade,blue,blue-purple,borne,bud,cell,chartaceous,ciliate,clavate,cm,corolla,covering,diameter,different,distal,end,erect,especially,filament,flower,forked,fruit,generally,glabrescent,glabrous,globose,greatly,green,green-white,hair,hair-like,half,herb,lanceolate,lateral,leaflet,light,like,lobe,long,make,margin,membranous,middle,midrib,minutely,mm,mottled,mucilaginous,oblique,odd-pinnate,ovate-lanceolate,ovoid,pale,pedicel,pentagonal,petal,petiole,petiolule,plant,plurifoliate,population,puberulent,pubescent,purple,rounded,seed,shortly,singly,size,slightly,star,stellate,stem,stigma,striped,style,subglabrous,subtending,tall,terminal,testal,thick,throughout,tip,tri-,truncate,tube,tuber,typically,unit,unwinged,usually,varying,wall,wet,wide,wing,x,yellow	0-16,1-10,1.6-4.5,1/,2-25,2-3,3.5-11,4-5,5-11,5-merou,6-7,acumen,ag,alyx,apart,apparently,articulated,axe,berry,broadly,brownish,capitat,condition,connivent,decumben,digestion,dorsally,drying,eaf,edge,eed,elliptic,elliptical,enzyme,exceeding,except,flat,folded,fresh,geminat,glabrou,greenish,homostylous,honeycomb-shaped,interjected,lengthening,living,lower,narrowly,nflorescence,often,orolla,ovate,pair,peduncle,perfect,pore,poricidal,proximal,reduced,removed,ruit,seudostipule,slit,sometimes,spaced,specimen,stamen,ste,stolo,straight,subequal,tamen,tem,vary,whitish,ympodial	anthesi,appearance,bark,calyx,capitate,color,count,decumbent,free,fruiting,geminate,growth,habitat,height,inflorescence,leaf,length,major,mentioned,minor,new,ovary,position,prickle,scar,shape,stolon,stone,structure,surface,sympodial,texture,vein,width,young
163	wfo-0001027624	success	189	148	109	80	39	0.577	0-3,0.1-0.9,0.3-1,0.5-1.5,1-2,1-3,2-20,2.4-4.8,3-10,3-11,3-4,4-15.2,6-18.5,9-41,abaxially,acumen,acuminate,acute,adaxially,along,anther,apex,arranged,axillary,base,bead,berry,blade,bud,cell,clavate,cm,connivent,corolla,covering,cuneate,decurrent,deep,densely,diameter,distal,eaf,entirely,erect,filament,flower,forked,fruit,glabrous,globose,green,green-white,hair,half,herb,lanceolate,lateral,leaf,light,like,lobe,long,make,mm,moniliform,mottled,mucilaginous,multiple,necklace,odd-pinnate,onto,ovate,ovoid,pedicel,pentagonal,petiole,plant,plurifoliate,pubescent,purple,rachi,rotate,seed,short,size,slightly,sometimes,stigma,stolon,style,subtending,tall,terminal,testal,thick,throughout,tip,tri-,tube,tuber,typically,unit,unwinged,usually,wall,wet,white,widely,x	0-7,0.4-3,0.8-5.6,1-5,1.1-8.4,1.2-2.6,1.3-2.9,1.5-6.6,2-5,2-7,2.9-12,3-5,4-7,4-8,5-9,5-merou,acuman,ag,alyx,apart,apparently,articulated,axe,brownish,capitat,condition,considerably,decreasing,decumben,digestion,dorsally,drying,edge,eed,elliptic,enzyme,exceeding,flat,folded,fresh,geminat,glabrou,greenish,hair-like,homostylous,honeycomb-shaped,interjected,larger,leaflet,leave,lengthening,living,lower,middl,nflorescence,orbicular,orolla,pair,peduncle,perfect,pore,poricidal,present,removed,ruit,sessile,seudostipule,slit,spaced,specimen,stamen,straight,tamen,tem,toward,vary,whitish,wide,yellow,ympodial	'hair-like,0-5.6,anthesi,appearance,bark,calyx,capitate,color,count,decumbent,description,free,fruiting,geminate,growth,habitat,height,inflorescence,length,major,margin,mentioned,minor,new,ovary,position,prickle,scar,shape,stem,stone,structure,surface,sympodial,texture,vein,width,wing,young
164	wfo-0001027626	success	152	147	100	52	47	0.658	.3,0.1â0.2,0.2â0.6,0.5-1,1.3â4.5,2â3,3â4,4.4â11,8,abaxially,acuminate,acute,adaxially,along,anther,apex,arrangement,base,berry,blade,broadly,calyx,center,clavate,climbing,cm,color,cordate,diameter,distant,distichous,distinct,elliptical,extra-axillary,filament,flower,frequently,fruit,fruiting,glabrous,greenish-white,immature,lamina,lanceolate,leaf-opposed,liana,line,lobe,long,margin,maturity,membranous,midvein,minutely,mm,moderately,nearly,oblique,ovate,pair,pedicel,petal,petiole,pinnate,pointed,possibly,pubescent,reflexed,rounded,sand-punctate,scandent,scar,secondary,seen,shortly,shrub,side,simple,slender,somewhat,sparsely,spindle-shaped,stigma,style,terminal,time,tip,trichome,truncate,tube,two,unbranched,unit,unknown,vein,venation,white,wide,wiry-woody,x	.5,0.5â1,0.7â1,0.7â2.8,1,1.5â2,1.5â8,13â14,14â116,2â49,2â5,3â4.5,3â5,3â55,4â6,5-merous,5â6,9â18,accrescen,alyx,apar,axe,c.,capitat,chartaceous,ciliat,coriaceous,densely,eaf,eed,entire,fleshy,glabrou,lower,m.,mor,nflorescence,nternode,orolla,peduncle,perfec,plurifoliat,rachi,ruit,sand-punctat,spaced,ste,stellate,tamen,tem,vary,ympodial	0.7-1,13-14,14-116,2-3,3-4,3-5,3-55,4-6,5-6,9-18,anthesi,appearance,bark,bud,capitate,cell,ciliate,corolla,count,free,growth,habitat,height,inflorescence,lateral,leaf,length,major,mentioned,minor,new,ovary,plurifoliate,position,prickle,seed,shape,size,stem,stone,structure,surface,sympodial,texture,width,wing,young
165	wfo-0001027630	success	149	139	109	40	30	0.732	.1,.2,0.05-0.1,0.5-1,0.5-1.2,0.5-2,1-5,1.4-1.7,1.5-2,2-3,4-6,5.5-11.2,6-10,8-9,acute,also,anther,anthesi,apart,apex,arising,bark,base,beginning,berry,blunt,broadly,calyx,climbing,cm,corolla,de,decurrent,deltoid,distinguishable,except,extreme,filament,free,fruit,fruiting,glabrate,glabrous,globose,golden,green,hirsute,indistinct,internodal,irregularly,knob-like,known,lanceolate,lateral,leaf,linear,lobe,long,long-acuminate,main,margin,middle,midrib,minutely,mm,novo,occasionally,older,opposite,ovary,pair,paler,papillose,partially,pedicel,petiole,prominent,proximal,puberulent,pubescent,raised,reflexed,rest,rounded,scar,shrub,simple,spaced,sparsely,stem,stigma,strongly,style,swollen,terminal,thickened,tip,trichome,tube,uniseriate,unit,vein,white,widest,wing,winged,x,yellowish,young	.5,1-1.5,2-6-flowered,3/4,branchlet,ciliate,deflexed,densely,dia,eaf,edicel,eed,elongat,erose,globo,immature,inflorescenc,lobed,lon,lower,near,nflorescence,pore,poricidal,portion,ruit,seen,shaped,slender,straight,tall,tapering,tear-drop,ti,ud,ultimate,unifoliat,way,wide,ympodial	2-6,appearance,bud,cell,color,count,diameter,elongate,flower,growth,habitat,height,inflorescence,length,major,mentioned,minor,new,position,prickle,seed,shape,size,stone,structure,surface,sympodial,texture,unifoliate,width
166	wfo-0001027661	success	222	190	162	60	28	0.73	+,-10,0.5,0.5-2,1-,1-1.5,1-5,1.2-6,1.3,1.5,1.5-2,2.5-3,2.5-7,30,4-15,4-8-celled,4.5-6,40,5-9,6-12,6-8,6-9,8-10,<,>,abaxially,acuminate,acute,along,anther,anthesi,apart,apex,axi,base,berry,branch,branched,bright,broadly,calyx,capitate,cell,cm,column,conical,connivent,cordate,corolla,creeping,dendritic,densely,denser,density,diameter,ellipsoid,elliptic,even,extremely,filament,flattened,flower,free,fruiting,fused,glabrous,globose,green,grey,ground,growth,herbaceous,irregularly,lamina,lateral,leaf,leaf-opposed,like,lobe,long,many,margin,markedly,minute,minutely,mixture,mm,moderately,new,occasionally,often,older,open,outline,ovate,pair,pale,papillate,pedicel,pentagonal,per,petiole,pinnatifid,pitted,poricidal,portion,primary,pubescence,pubescent,purple,rarely,red,reflexed,reniform,ripe,scar,shape,shiny,short,simple,single,size,spaced,sparsely,spot,spreading,stem,stigma,strongly,style,surface,tan,tangled,terminal,ternately,testa,tightly,time,tip,trailing,triangular,trichome,truncate,tube,turbinate,two,type,underground,unieriate,uniseriate,unit,upper,usually,variable,vein,vine,violet,white,wide,woody,yellow,yellowish	0.5-,0.6-1.1,0.6-1.5,1-7,2,5-merou,adaxiall,ag,alyx,ark,articulate,basal,commonly,deeply,eaf,eed,entire,gre,hue,ilament,leaving,lengthening,lobed,long-exserted,lower,membraneous,narrowing,near,nflorescence,orolla,papillat,papillo,peduncle,peg,perfect,pericarp,plurifoliat,pointed,pore,prominent,pubescen,purplish,rachi,ruit,sinus,sleeve,slender,slit,small,spreadin,stellate,swollen,tem,thin,ud,vary,way,ympodial,zig-za,Â¾	adaxially,appearance,bark,bud,color,count,fruit,habitat,height,inflorescence,length,major,minor,null,ovary,papillose,plurifoliate,position,prickle,seed,stone,structure,sympodial,texture,width,wing,young,zig-zag
167	wfo-0001027714	success	251	208	181	70	27	0.721	+,.5,/3,0,0.5,0.6-0.7,0.9-1.5,1,1-,1-1.5,1-1.6,1.5-2,1.5-2.5,1.5-3,14-16,2-,2-2.5,2-8,2.5-,2.5-4,4-10,4-5,5,5-6,6-7,7-20,80,<,abaxially,acuminate,acute,adaxial,adaxially,aid,almost,along,angle,anther,anthesi,apex,appearance,around,basal,base,berry,branched,bright,brown,calyx,capitate,cell,channelled,cm,confined,conical,connected,cordate,corky,corolla,creating,cucullate,cupped,deep,dendritic,densely,denser,diameter,ellipsoid,elliptic,elongate,especially,fide,filament,flattened,flower,free,fruit,fruiting,furcate,giving,glabrate,glabrous,globose,groove,growth,hairy,hanging,immature,individual,inflated,inflorescence,juicy,lamina,large,lateral,leaf,like,lobe,lobed,long,longer,many,margin,marginal,mature,mere,minute,minutely,mm,nee,new,obovate,occasionally,often,older,otherwise,outline,ovary,pair,papillate,pedicel,per,petal,petiole,pinnatifid,pitted,primary,prominent,pubescence,pubescent,purple,reaching,rectangular,red,reniform,rim,ripe,scar,seed,shiny,similar,simple,slightly,small,somewhat,sparsely,spreading,stem,stigma,style,surface,tangled,terminal,testa,testal,third,time,tip,tooth,trichome,truncate,tube,twining,uniformly,uniseriate,unit,upper,usually,vein,vine,violet,wall,way,weak,weight,widest,wing,woody,x,yellowish,younger	0.4,0.5-0.7,1-2,1.5-5,2373.,3-3.5,4.5-5,5-10,5-merou,abaxial,age,alyx,apar,apice,ark,articulated,axi,canop,climbin,connivent,deflexed,drying,eaf,eed,enlarged,entire,exserted,fleshy,glabrou,ilament,irregularly,leaving,lengthening,lon,loosely,lower,mpodial,nflorescence,nodding,orolla,pale,papillo,peduncle,peg,perfect,pericarp,petiolule,plat,plurifoliat,pore,poricidal,portion,reddish,ruit,showy,sleeve,slender,slit,spaced,stellate-rotate,strongly,tem,thecae,thick,thickened,thin,tiny,ud,visible,yellow	23735,bark,bud,canopy,climbing,color,count,description,habitat,height,length,major,mentioned,minor,papillose,plate,plurifoliate,position,prickle,shape,size,stone,structure,sympodial,texture,width,young
168	wfo-0001027720	success	184	180	143	41	37	0.777	%,0,0-15,0.15-0.25,0.25-0.35,0.3-5,0.4-0.8,0.5-0.8,0.5-1,0.6-1.2,0.8-1,1-1.5,1-2,1-3.5,1-locular,1.5-2,13-23,13-35,15-25,2-3,2-4,2-branched,2-foliate,2.8-3.1,23-35,3-13,4-5.5,4-7,4.3-15,4.3-7.5,6,7-10,7-8,7-9,8-16,9-15,abaxially,absent,acute,adaxially,adult,anther,apex,axe,base,berry,blade,brown,calyx,chartaceous,cm,confined,connivent,cuneate,deltate,densely,diameter,directed,distally,eglandular,elliptic,erect,extra-axillary,filament,finger,flattened,flower,fruit,fruiting,glabrous,gland-tipped,globose,green,hair,half,incomplete,inflorescence,juicy,juvenile,lamina,lanceolate,lateral,leaf,length,less,lilac,lobe,long,loosely,margin,mature,mesocarp,midpoint,midrib,minute,mm,narrowly,notched,oblique,ovate,pale,part,pedicel,peduncle,per,perennial,perfect,petiole,pore,porrect,present,prickle,pubescent,rachi,ray,red,rhizomatous,septum,sessile,short,shrub,simple,slightly,sparsely,stellae,stellate,stellate-pubescent,stigma,straight,style,subreniform,surface,time,triangular,tube,unarmed,unit,upper,white,wide,without,x,yellow	.25-0.3,0.4-0.7,2-7,4-,5-merous,8-11,absen,adaxiall,alyx,apparently,articulated,ba,capitat,cylindrical,distall,eaf,eed,entire,geminat,hig,homostylous,intepetalar,lower,markedly,mid-point,nflorescence,orolla,perfec,ruit,scarce,succulen,tamen,tem,thick,thicker,tissue,toward,unarme,vary,yellowi,ympodial	anthesi,appearance,bark,bud,capitate,cell,color,corolla,count,free,geminate,growth,habitat,height,high,major,minor,new,null,ovary,position,scar,seed,shape,size,stem,stone,structure,succulent,sympodial,texture,tip,vein,width,wing,yellowish,young
169	wfo-0001027720	success	272	207	155	117	52	0.57	.2,.3,0,0.9,1.5â9.0,1/2,1/3,12â16,19.7â30.0,2.0,2.5,2â3,3.2,3.6,6â8,8.0,9.5â16.0,abaxially,acuminate,acute,adaxially,aequilateral,anther,anthesi,apex,apical,apiculate,apparently,appearing,attachment,attenuate,base,becoming,berry,bilobed,broad,broad-based,bud,calyx,cancellate,capitate,channel,cm,concave,conical,connivent,corolla,cream,deciduous,densely,dentate,developed,diameter,difoliate,dry,either,elliptic,especially,extra-axillary,fertile,filament,flattened-irregular,flattened-orbicular,flattened-reniform,flower,free,fruit,glabrous,glandular,globose,growth,hair,internode,interpetalar,juvenile,large,lateral,lavender,leaf,lobe,long,major,margin,mature,midrib,midvein,minor,minute,mm,moderately,narrowly,nearly,notched,oblique,oblong,orange,ovate,part,pedicel,petiole,point,poorly,pore,porrect,portion,potentially,prickle,proximal,pubescent,ray,red,reflexed,scattered,sessile,short,shrub,side,sinus,slightly,small,soon,sparsely,splitting,stellae,stellate,stellate-pubescent,stem,stigma,straight,style,subacute,surface,tip,tissue,toward,tree,triangular,truncate,tube,twice-branched,unarmed,upper,vein,violet,way,white,wide,yellow,yellow-ferruginous,yellow-tan,young,youngest,Â±equal,Ã,â4	.0,.04,.5,.9,0.1â0.6,0.2â0.4,0.3â0.4,0.7â0.9,0.7â1.1,0.7â1.2,0.8â1.3,0.8â1.9,0.8â2.0,1.4â1.9,1.5â1.7,1.5â2.0,1.5â2.5,1.5â3.3,1.7â1.8,1.7â2.0,1.7â2.5,1.8â2.0,1.9â2.2,1/3â1/2,10.0,10.8â18.2,13.0,2.5â2.8,2.5â2.9,3.7â5.7,3.9,4.0â12.6,4.0â18.0,4â5-merou,5.1â18.6,6.5â9.5,8.0â11.9,8.2â10.5,8.5â9.4,adnate,alyx,armed,articulated,axe,ba,blade,branch,brochidodromous,channeled,colore,congested,crisped,curved,dehiscence,distally,dorsally,eaf,eed,emerging,endocarp,entire,erect,exocarp,filiform,geminat,glossy,gradually,heavily,homostylous,hooked,inclined,increasing,intersepalar,juic,lamina,least,like,line,lon,longer,lower,m.,midpoint,nflorescence,occasionally,often,orolla,peduncle,per,perforate,porrect-stellate,presumably,raised,rigid,rip,row,ruit,shorter,simple,spread,stamen,stellate-pubescen,subcoriaceous,suture,tall,tamen,tem,thin,time,translucent,two,ud,vary,wavy,weakly,yellow-ferruginou,ympodia	--,0.7,0.8,1.3,1.4,1.5,1.7,1.8,1.9,10.8,11.9,18.0,18.2,2.2,2.8,2.9,3.3,3.7,4.0,5.7,6.5,8.5,9.4,9.5,appearance,bark,cell,color,colored,count,fruiting,geminate,habitat,height,inflorescence,length,new,null,ovary,position,ripe,scar,seed,shape,size,stone,structure,sympodial,texture,unit,width,wing
170	wfo-0001027757	success	186	140	86	100	54	0.462	0.2,0.3â2.0,0.5,0.6,1.2â4.0,2,2.5,60â100,abaxially,accrescent,acute,adaxially,along,anther,anthesi,apex,axillary,base,blue,borne,branching,brown,calyx,cell,clavate,cm,colour,decurrent,deeply,diameter,elliptic,equal,erect,filament,flattened,flower,fruit,glabrous,globose,hair,lanceolate,leaf,leafy,lilac,lobe,long,margin,mm,moderately,multicellular,narrowly,oblong,obtuse,often,opposed,ovate,pale,pedicel,perennial,petiole,pitted,plurifoliate,pubescent,shoot,shrub,simple,sparsely,stigma,stone,style,surface,tip,toward,tube,unbranched,unicellular,uniseriate,unit,unknown,violet,white,woody,x,â19,â2.7,â5.5	0.2â0.3,0.6â1.0,0.7,0â1.4,1.0â1.1,1.0â2.5,1.5â1.6,1.5â2.5,1.6â2.4,1.9â2.7,12,1â1.5,1â11,1â2,1â3,2.5â4,2.5â5.5,2.5â7,2â,2â10,3â12,3â5,4â9,5,5â,6â9,7â8,8â16,absen,adaxiall,ag,apart,apical,arising,articulated,axe,ba,basal,blade,campanulate,chartaceous,concave,connivent,convex,cylindrical,dark,densely,directed,distally,eaf,eed,entire,erose,fleshy,geminat,glabrescen,glabrou,irregularly,lobed,lon,longitudinal,lower,m.,nflorescence,occasionally,opening,orolla,pair,peduncle,perfect,pore,poricidal,primary,probably,regularly,rootstock,rotate,ruit,secondary,serrate,side,slit,smaller,sometimes,spaced,straight,tall,tamen,tem,thic,thickened,time,vary,wide,yellow,ympodial,â3.2,â4.0,â6,â9	--,0,0.3,1,1.0,1.4,1.5,1.6,10,11,16,2.4,3,3.2,4,7,8,9,absent,appearance,bark,bud,color,corolla,count,free,fruiting,geminate,glabrescent,growth,habitat,height,inflorescence,lateral,length,major,mentioned,minor,new,ovary,position,prickle,scar,seed,shape,size,stem,structure,sympodial,texture,vein,width,wing,young
171	wfo-0001027765	success	167	153	113	54	40	0.677	-30,-44,0.8,1,1-10,1-11.5,1-2,1-4,1-5,10-13,2-2.5,2-3,2-4,2.5-4.2,20-30,3-,3-20,5,5-15,5-6,5-8,7-20,abaxial,abaxially,acumen,acuminate,acute,apex,apiculate,articulate,base,branched,calyx,cell,cm,connate,cordate,corolla,covering,cuneate,cyme,diameter,dichasial,dichasially,distal,dorsally,ebracteate,edge,elliptic,filament,flat,flower,folded,forked,generally,glandular,globose,green,hair,hair-like,half,herbaceous,lateral,leaf,leaflet,light,lobe,long,make,mm,monochasial,mucilaginous,oblique,obtuse,odd-pinnate,ovate,ovate-lanceolate,ovoid,pedicel,peduncle,perennial,petiolate,petiole,petiolule,pilose,plant,proximal,rounded,seed,sessile,side,simple,size,slightly,stellate,stigma,style,testal,thick,throughout,tip,tone,truncate,tuber-bearing,typically,unit,violet,wall,white,wide,without,yellow,Â¼	-4,0-.,1-,1.5-6,2.5-4,3-12,3-6-foliat,abruptly,apical,apically,dehiscent,digestion,diminishing,eaf,eed,elliptic-lanceolate,emoval,enzyme,exceeding,globo,green-white,honeycomb,interjected,introrse,living,lon,lower,lunat,maturing,nflorescence,nther,often,orolla,ovate-elliptic,pair,pattern,perfect,plan,poricidally,reveal,ruit,seudostipule,short,slit,specimen,stamen,straight,tal,tem,terminal,throughou,toward,vary,ympodial	3-6-foliate,anther,anthesi,appearance,bark,bud,color,count,free,fruit,fruiting,growth,habitat,height,inflorescence,length,lunate,major,margin,minor,new,null,ovary,position,prickle,pseudostipule,scar,shape,stem,stone,structure,surface,sympodial,texture,tube,vein,wet,width,wing,young
172	wfo-0001027807	success	116	120	84	32	36	0.724	.5,0.1-1,0.2-0.9,0.9-2.5,1-1.5,15-30,2-5,2-6,3.5-9,acuminate,acute,almost,apex,attenuate,bark,base,berry,brittle,brown,bud,closely,cm,decurrent,diameter,difoliate,elliptic,flattened,flower,fruiting,glabrous,globose,gray,green,growth,internodal,known,lanceolate,leaf,leaf-opposed,margin,maturity,minutely,mm,narrowly,new,occasionally,older,overlapping,pair,pale,paler,papillae,papillate,parallel,pedicel,petiole,pitted,plane,rachi,reddish,reniform,reproductive,scar,seemingly,shoot,shrub,simple,slender,slightly,small,spaced,sparsely,stem,surface,thickened,tree,unifoliate,unit,usually,vein,white,winged,x,young	0-0.2,0.2-0.3,0.3-0.4,0.9-1,abaxially,adaxially,barely,deflexe,deflexed,dry,drying,eaf,eed,ellipti,geminat,grayish,know,material,midrib,nflorescence,ot,peduncle,primary,prominent,reddi,revolute,ruit,somewhat,ud,visible,yellowish,ympodial	anther,anthesi,appearance,calyx,cell,color,corolla,count,filament,free,fruit,geminate,habitat,height,inflorescence,lateral,length,lobe,major,minor,ovary,position,prickle,seed,shape,size,stigma,stone,structure,style,sympodial,texture,tip,tube,width,wing
173	wfo-0001027816	success	187	185	154	33	31	0.824	.5,0.2,0.5-1,0.5-2,0.6-0.8,0.7-1,1,1-1.5,1-3,1-4,1.2-2,1.5-2,1.8-6,12-14,2-2.5,2-4,2/3,3-3.5,3.5-4,4-5,5-30,6-9,<,acuminate,acute,almost,along,anther,anthesi,apex,attenuate,base,becoming,berry,bluish,branched,brown,calyx,capitate,cell,cm,confined,conical,connivent,corolla,cupped,dark,dense,densely,diameter,drying,ellipsoid,entire,erect,exserted,filament,flattened,fleshy,flower,free,fruiting,glabrous,gland-tipped,glandular,globose,growth,half,inflorescence,irregularly,lanceolate,lateral,leaf,lengthening,less,like,linear,lobe,lobed,loosely,lower,margin,markedly,minute,minutely,mm,new,nodding,occasionally,often,older,orange,pair,patent,pedicel,peduncle,per,perhaps,pericarp,petiole,pitted,plant,pore,poricidal,portion,primary,pubescent,purple,rectangular,red,reddish,reniform,ripe,rounded,scar,several,shiny,shrub,simple,slightly,slit,small,sometimes,spaced,sparse,sparsely,spreading,square,stellate,stem,stigma,style,surface,terminal,testal,thin,time,tip,triangular,trichome,tube,ultimate,uniformly,uniseriate,unit,upper,usually,variable,vein,viscous,way,woody,x,yellowish,Â½	..,0.5,1-1,5-merou,ag,alyx,apar,ark,articulated,axi,eaf,eed,em,filiform,ilament,leaving,m.,nflorescence,orolla,papillo,peg,perfect,plurifoliat,prominen,pubescen,ruit,sleeve,somewhat,spreadin,twinin,ud,vary,ympodial	age,apart,appearance,bark,bud,color,count,fruit,habitat,height,length,major,minor,null,ovary,papillose,plurifoliate,position,prickle,prominent,seed,shape,size,stone,structure,sympodial,texture,twining,width,wing,young
174	wfo-0001027819	success	199	141	104	95	37	0.523	-100,1-2,1-5,10-20,10-50,12-21,15-22,2-15,2-3,20-35,20-40,22-35,3-5,4,4-15,4-25,4-5,5-6,8-10,9-12,abaxially,acute,adaxially,aggregate,apex,apical,base,branched,cell,ciliate,cm,color,concave,cordate,cuneate,densely,denser,diameter,eglandular,ellipsoidal,especially,except,fading,finely,fleshy,flower,forked,fruit,glabrous,globose,green,hair,leaf,length,lobe,lobed,long,main,margin,mesocarp,mm,moderately,narrowly,oblong,obtuse,occasionally,pedicel,per,petiole,pilose,probably,protuberance,puberulence,puberulent,purple,rarely,ripe,rugose,simple,sometimes,sparsely,stellate,stigma,stone,style,subcoriaceous,sympodial,triangular,truncate,tube,two,umbrella-shaped,unbranched,unit,unknown,unlobed,usually,vein,whitish,wide,width,x,yellow,young	0.5-1,1,1-,1.5-2,16-25,2,2-,20-25,25-35,3-40,3-5-lobed,4-10,5,5-merous,also,alyx,apart,ape,apiculat,articulated,axe,ba,basal,beyond,blade,connective,cylindrical,deeply,dia,diamete,dilated,directed,distally,divided,eaf,eed,eglandular-pilose,elliptic,elliptic-ovate,entire,equal,exceeding,exserted,halfway,leaving,lon,lower,midrib,narrow,near,nflorescence,nther,oblique,obtu,often,orolla,ovate,pedicellar,peduncle,perfec,perfect,pinnately,pore,present,prominent,puberulen,purplish,rachi,radiu,ranch,ratio,remnant,rounded,rown,ruit,runk,shallowly,short-acuminat,shorter,sinus,slightly,small,spaced,stamen,strongly,swelling,tal,thecae,toward,tree,ud,uni,vary,villous,without	anther,anthesi,apiculate,appearance,bark,bud,calyx,corolla,count,crown,filament,free,fruiting,growth,habitat,height,inflorescence,lateral,major,mentioned,minor,new,ovary,position,prickle,scar,seed,shape,short-acuminate,size,stem,structure,surface,texture,tip,trunk,wing
175	wfo-0001027834	success	236	183	153	83	30	0.648	-6.1,.5-3,0-110,0.2-0.3,0.2-0.6,0.4-1.1,0.9-1.8,1-1.9,1-10,1.1-1.8,1.6-2.7,10-25,2-3.8,2-8,2.2-4.3,2.4-6.2,2.7-7.3,2.9-4.2,3-15,3-4.3,4-5.2,5-20,9-13,abaxially,absent,accrescent,acuminate,acute,adaxially,angled,anther,anthesi,apex,apical,attenuate,axillary,bark,base,becoming,berry,blunt-tipped,branch,branched,brown,bud,calyx,closely,cm,completely,concentrated,corolla,covering,crown,deltoid,dendritic-echinoid,densely,diameter,echinoid,ellipsoid,enveloping,filament,finely,flat-topped,fleshy,flower,forming,fruit,fruiting,glabrescent,globose,granular-tomentose,gray,grooved,hair,high,leaf,lenticular,less,lobe,long,long-stalked,longitudinally,many,margin,mm,mostly,multangulate,near,obovate,obtuse,older,orbicular,ovate,ovate-elliptic,ovate-lanceolate,pair,pedicel,petiole,plurifoliate,porrect-stellate,primary,pseudo-terminal,pubescence,pubescent,rarely,ray,reticulate-punctate,ripe,rounded,scabridulous,scar,semi-ovate,sessile,short,short-stalked,shrub,simple,small,soft,somewhat,spaced,spreading,stalked,stellate,stem,stigma,style,subcampanulate,surface,though,time,tip,tomentose,toward,tree,trichome,tube,turbinoid,unit,usually,vein,velutinous-tomentose,villous,white,whitish,whitish-tomentose,wide,x,yellow,yellowish,yellowish-tan,yellowish-tomentose,young	0.2-0.4,0.5-2,1-1.6,1-2.5,1.1-1.6,1.4-2,1.8-4.9,1/2,2.3-3.4,25,4-6,4.8-6.9,5-merous,5.1-8,6.9-18.1,9-11.9,abaxial,adaxial,ag,alyx,apar,around,articulated,ba,blade,branching,capitat,connivent,coriaceous,cylindrical,dendritic-echinoi,dichasia,directed,discolorous,distally,drying,eaf,echinoi,edge,eed,enclosing,entire,equal,erec,exserted,farinose,glabrous,included,inserted,lengthening,light,lobed,longitudinal,lower,multangulat,nflorescence,numerous,obscured,orolla,peduncle,perfec,persistent,pore,poricidal,rachi,ruit,runk,semi-spherical,slit,sometimes,sparsely,stamen,stellate-pubescent,subcoriaceous,suture,tamen,tomentu,tomentum,ud,unarme,vary,way,ympodial	apart,appearance,capitate,cell,color,count,free,growth,habitat,height,inflorescence,lateral,length,major,mentioned,minor,new,ovary,position,prickle,seed,shape,size,stone,structure,sympodial,texture,unarmed,width,wing
176	wfo-0001027843	success	154	139	114	40	25	0.74	.5,0.5-0.75,0.5-1,0.8-3.5,1-1.3,1-1.5,1.2-1.5,1.2-2.5,2-2.5,2-4,3-15-flowered,3-6,5-6,6-13,6-9,acute,along,anther,anthesi,apart,apex,apiculate,bark,base,beneath,berry,broadly,calyx,clavate,cm,conical,corolla,curly,deflexed,deltoid,densely,dia,difoliate,ellipsoid,exsertion,filament,flower,free,fruiting,glabrate,glabrous,globose,green,hairy,impressed,irregularly,lamina,later,lateral,leaf,lobe,lobed,long,long-acuminate,main,major,margin,minor,minutely,mm,nearly,occasionally,older,opposite,ovary,ovate,pair,papillose,pedicel,petiole,pleated,pore,poricidal,prominent,pubescent,reflexed,rounded,scar,shape,shaped,shrub,simple,sinus,size,slender,slightly,spaced,sparsely,stem,stiff,stigma,strongly,style,surface,tall,tapering,tear-drop,tip,tipped,trichome,tube,uniseriate,unit,vein,white,winged,woody,x,young	.75,/3,1-1.2,ba,bearing,becoming,beginning,coroll,denser,differing,distally,eaf,edicel,eed,erose,geminat,known,larger,like,lon,lower,middle,near,nflorescence,one,orbicular,papillo,portion,proximal,reddish-gre,ruit,somewhat,sparser,straight,time,two,ud,way,widest,ympodial	appearance,bud,cell,color,count,diameter,fruit,geminate,growth,habitat,height,inflorescence,length,mentioned,new,position,prickle,reddish-grey,seed,stone,structure,sympodial,texture,width,wing
177	wfo-0001027847	success	219	191	164	55	27	0.749	-0.8,-2,-2.5,-3,-4,-5,-6,.35,.7,/3,0,0-2,0.1-0.4,0.15-0.2,0.2,0.4-1,0.5,0.8,0.8-1.2,1,1-2,1-2.5,1.5-2,1.5-2.5,1.5-5,1/2,1/4,2-2.8,2-4,2-5,2.5-3.5,3-15,3-5,3.5-6,5-6,6-11,6-8,7-10,abaxially,acute,almost,ame,anther,apart,apex,apically,apparently,bark,base,berry,blade,branched,c.,calyx,cm,connivent,cordate,curved,deltate,densely,diameter,dimorphic,dull,edge,elliptic,elongating,erect,evenly,filament,filiform,finely,flattened,flattened-reniform,flower,free,fruit,fruiting,geminate,glabrescent,glabrous,gray,green,increasing,lateral,leaf,length,lobe,lobed,long,longer,lower,margin,mature,maturity,mauve,middle,midpoint,minor,mm,moderately,narrow-deltate,older,one,open,orange,orange-brown,ovate,pair,pedicel,pendulous,perpendicular,petiole,pit,pitted,poricidal,porrect,prickle,prickly,purple,ray,red,red-brown,retrorse,rounded,scandent,scar,seed,sessile,shrub,simple,size,slender,smooth,sometimes,spaced,sparsely,spherical,spreading,stalk,stalked,stellate,stellate-pubescent,stem,straight,style,surface,tapering,terete,terminal,time,tip,toward,trichome,tube,unit,upper,usually,variously,vein,way,white,wide,yellow,young	/2,0-7,0.5-1,0.8-0.9,1.9-2.3,1/6-1/3,2-3,2.2-3,2/,3-6,4-5-merous,5-25,5.5-8,alyx,apar,articulated,broadly,brow,chartaceous,discolorous,distance,drying,eaf,eed,equal,extending,faint,filiform-acuminat,infructescence,lon,midvein,nflorescence,orbicular,orolla,oung,peduncle,per,perfec,pericarp,plurifoliat,portion,prickl,primary,reddish,ruit,side,strongly,tamen,tertiary,unarmed,vary,venation,visible,weakly,ympodial	anthesi,appearance,brown,bud,cell,color,corolla,count,filiform-acuminate,growth,habitat,height,inflorescence,major,new,null,ovary,plurifoliate,position,shape,stigma,stone,structure,sympodial,texture,width,wing
178	wfo-0001027872	success	190	166	123	67	43	0.647	0.5,1,1-1.2,1-4,1-8,10,12-35,15,2,2-3,2.2-3.5,2.8,35,4-6,5-8,6-20,8-11,abaxially,acuminate,acute,adaxially,angular,apex,apiculate,articulate,b,basal,base,becoming,branched,calyx,caudate,cell,celled,cm,commonly,cordate,covering,cuneate,cyme,decreasing,deep,densely,diameter,dichasial,dichasially,distal,ebracteate,erect,externally,filament,flower,forked,four-celled,generally,glabrescent,gland,glandular,glandular-pubescent,globose,gray-green,green,green-white,half,herbaceous,homogeneously,lanceolate,lateral,leaflet,light,lobe,long,longer,make,middle,mm,moderately,monochasial,mottled,mucilaginous,obliquely,oblong,odd-pinnate,ovoid,pair,pedicel,perennial,petiolate,petiolulate,petiolule,plant,puberulent,pubescent,purple,rarely,reduced,rhizomatous,rounded,seed,shape,short,single,size,slightly,sometimes,somewhat,stigma,style,subequal,terete,testal,thick,tinged,tip,trailing,type,typically,uniformly,unit,usually,wall,wide,yellowish-green	1.0-1.3,1.5-4,20,3-6-foliat,5-10,5-7,5-lobed,acumen,apical,apically,ba,ca,clasping,connate,dehiscent,digestion,eaf,eed,elliptic,emoval,enzyme,exceeding,globo,hair-like,honeycomb,interjected,introrse,living,lon,lower,maturing,narrowly,nearly,nflorescence,nther,often,orolla,ovate,pattern,peduncle,pentagonal,perfect,poricidally,purpl,reveal,rhizome,rotate,rotate-,ruit,semi-lunate,sessile,seudostipule,slit,specimen,stamen,ste,straight,symmetrically,tem,terminal,unbranched,vary,viole,wid,wider,yellow,ympodial	'hair-like,1-2,3-6-foliate,anther,anthesi,appearance,bark,bud,color,corolla,count,free,fruit,fruiting,growth,habitat,height,inflorescence,leaf,length,major,margin,mentioned,minor,new,ovary,petiole,position,prickle,scar,stem,stone,structure,surface,sympodial,texture,tube,vein,violet,wet,width,wing,young
179	wfo-0001027880	success	185	176	137	48	39	0.741	-3,.25,0.3-3,0.5-1.5,0.5-5,0.6-1,0.6-1.5,0.8-1.5,1-14,1-15,1-2,1-2.5,1-3,1.5-2,10-15,2-3,2-80,3-4,4-10,4-6,5-11,5-8,8,abaxially,acuminate,acute,adaxially,along,anther,apart,apex,apiculate,articulated,base,blade,calyx,cell,chartaceous,clavate,cm,conical,connivent,contiguously,cordate,coriaceous,cylindrical,deltate,dense,densely,diameter,discolorous,epiphytic,extra-axillary,filament,flattened,flower,fruit,fruiting,glabrous,globose,green,greenish,growing,hair,inflorescence,leaf,leaf-opposed,lobe,long,longer,lower,margin,midvein,minutely,mm,multicellular,nearly,node,oblique,oblong,oblong-ovate,occasionally,often,ovate,ovoid,pair,pale,papillose,pedicel,peduncle,petiole,pink,plurifoliate,pubescent,purple,rachi,red-brown,reddish,ripe,rooting,rounded,rugulose,scar,secondary,shrub,simple,size,slender,slightly,sometimes,somewhat,spaced,sparsely,stellate,stigma,stone,style,surface,tan,time,tip,trailing,tree,truncate,trunk,tube,typically,unbranched,uniseriate,unit,usually,vein,vine,white,wide,x,yellow	-3.5,1.5-3,2/,5-merou,absen,accrescen,ag,aggregate,alyx,apparently,axe,ba,branch,branching,ciliat,curled,diminishing,directed,distally,distichous,distinct,distinctly,eaf,eed,entire,equal,geminat,increasing,internode,line,longitudinal,nflorescence,opening,orolla,perfect,point,pore,pubescen,revolute,ruit,slit,ste,tamen,tem,thickened,undulate,vary,ympodial	2/3,absent,accrescent,anthesi,appearance,assumed,bark,bud,ciliate,color,corolla,count,explicitly,free,geminate,growth,habitat,height,lateral,length,major,mentioned,minor,new,null,ovary,part,position,prickle,seed,shape,stem,structure,sympodial,texture,variable,width,wing,young
180	wfo-0001027880	success	170	168	109	61	59	0.641	.25,0.2-0.5,0.5,2-80,2/3,8,abaxially,absent,acuminate,acute,adaxially,along,anther,apex,apiculate,base,blade,bluish-purple,calyx,clavate,climbing,cm,contiguously,cordate,curled,cylindrical,deltate,dense,densely,diameter,discolored,extra-axillary,filament,flattened,flower,fruit,fruiting,glabrous,globose,green,greenish,hair,lanceolate,leaf,leaf-opposed,lobe,long,longer,lower,margin,membranous,midvein,minutely,mm,mottled,nearly,oblique,oblong-ovate,occasionally,often,ovate,ovoid,pair,pale,papillose,pedicel,petiole,pink,pinnate,pubescent,red,reddish,reddish-brown,rounded,rugulose,sand-punctate,scar,secondary,shrubby,simple,slender,slightly,sometimes,somewhat,spaced,sparsely,stellate,stigma,style,surface,tan,time,tip,tree,trichome,truncate,trunk,tube,typically,unbranched,uniseriate,unit,vein,vine,white,wide,woody,x,â3.5	0.3â3,0.5â1.5,0.5â5,0.6â1,0.6â1.5,0.8â1.5,1.5â2,1.5â3,10â15,1â14,1â15,1â2,1â2.5,1â3,2â3,3â4,4â10,4â6,5-merous,5â11,5â8,accrescen,alyx,apar,arrangement,axe,berry,c.,capitat,chartaceous,ciliat,conical,coriaceous,distichous,distinct,distinctly,eaf,eed,entire,line,m.,nflorescence,nternode,orolla,peduncle,perfec,plurifoliat,rachi,revolute,rip,ruit,sand-punctat,ste,tamen,tem,thickened,undulate,vary,vegetatio,venation,ympodial	0.3-3,0.5-1.5,0.5-5,0.6-1,0.6-1.5,0.8-1.5,1-15,1-2,1-2.5,1-3,1.5-2,10-15,2-3,3-4,4-10,4-6,5-11,5-8,accrescent,anthesi,apart,appearance,bark,bud,capitate,cell,ciliate,color,corolla,count,free,growth,habitat,height,inflorescence,internode,lateral,length,major,minor,new,null,ovary,plurifoliate,position,prickle,ripe,seed,shape,size,stem,stone,structure,sympodial,texture,vegetation,width,wing,young
181	wfo-0001027881	success	215	212	161	54	51	0.749	-3,.3â0.5,1-celled,1â2-celled,1â3,1â3-celled,1â4,20â40,8,abaxially,absent,abundant,acuminate,acute,adaxiall,adaxially,almost,anther,apex,articulated,asymmetric,attenuate,axe,ba,barely,base,berry,blackish,blade,bulge,calyx,camptodromous,case,central,chartaceous,cm,commonly,connected,connivent,contiguous,cordate,cordiform,decurrent,densely,denser,diameter,difoliate,directed,dorsally,drying,eaf,eglandular,emarginate,emerging,equal,erect,exceeding,exclusively,extra-axillary,eye,few-,fewer,filament,flattened,flower,forming,frequent,fruit,geminate,giving,glabrous,glandular,globose,greenish,groove,hair,half,herb,hollow,immature,impression,interpetalar,introrsely,larger,lateral,leaf,less,light-brown,like,lobe,long,longer,longitudinal,mainly,many-branched,margin,maturity,membranaceous,mixed,mm,moderately,multicelled,multicellular,naked,netlike,one,opening,ovate-elliptic,pair,parallel,part,pedicel,peduncle,petiole,placenta,pore,primary,projection,prominent,pubescence,pubescent,rachi,raised,reniform,rotate,secondary,seed,sessile,short,side,similar,simple,size,slightly,slit,small,smaller,solitary,sometimes,sparsely,stalk,stem,stigma,style,subapically,subopposite,surface,tissue,translucent,triangular,tube,unbranched,unit,vein,venation,visible,white,winged,woody,yellow,Ã	0.5â2.2,0.8â1.5,1.3â2,1.8â2.9,10â25,1â2,1â2.5,1â2.6,2.5â3.6,2â4,2â6,2â7,4â6,4â9.5,5,5-merous,6â10,7â14,7â9,accrescent,alyx,appressed,capitat,ciliate,closely,curved,cylindrical,dehiscing,ed,entire,explosively,held,lower,maturit,mesocarp,much,near,nflorescence,normally,orolla,other,per,perfec,pressure,ruit,staman,stamen,tal,tamen,tem,two,vary,watery,ympodial	--,0.5,1,10,14,2,2-celled,2.2,2.5,2.6,3,4,6,7,9,anthesi,appearance,bark,bud,capitate,cell,color,corolla,count,description,free,fruiting,growth,habitat,height,inflorescence,length,lob,major,mentioned,minor,new,ovary,position,prickle,scar,shape,stone,structure,sympodial,tall,texture,tip,width,wing,young
182	wfo-0001027882	success	184	186	157	27	29	0.853	.25,0.1,0.5-1,1,1-1.5,1-5,1.5-,1.5-2,1.5-2.2,1.5-6,1.6-2.2,10-25,10-40,2-3,2-6,2-lobed,2.1-2.6,2.5-3,3-4,3.2-6,3.5-4,3.5-5,4-5,6-9,7-,9-13,abaxially,absent,acuminate,adaxially,age,along,anther,anthesi,apart,apex,apparently,appearing,attenuate,axil,bark,base,berry,branch,branched,branching,broadly,brown,c.,calyx,clavate,cm,completely,conical,corolla,cucullate,dark,deltate,dense,densely,diameter,difoliate,dry,drying,elliptic,erect,exerted,filament,flattened,flower,fork,free,fruiting,fusiform,glabrous,globose,green,growth,hairy,hollow,hooked,inflorescence,irregularly,junction,lamina,leaf-opposed,lengthening,less,lobe,lobed,margin,markedly,maturity,midrib,minutely,mm,new,occasionally,ovary,ovoid,pair,pale,papillate,paulo,pedicel,peduncle,petiole,pitted,planar,plane,pointed,population,pore,poricidal,primary,rachi,rarely,reddish,reniform,scar,shattering,shiny,shrub,simple,slit,small,sometimes,spaced,sparse,sparsely,specimen,stem,stigma,stout,strongly,structurally,style,surface,swollen,sÃ£o,thickened,time,tip,tree,trichome,tube,tuft,uniseriate,unit,usually,vein,way,white,woody,x,yellow,yellowish	.5,06a,caly,eaf,eed,entire,et,fide,geminat,glabrou,kallunki,lower,nflorescence,nodding,papillat,penden,perfect,portion,pulp,red-papillat,ruit,slender,sticky,straight,sweet-scented,ud,ympodial	bud,cell,color,count,fruit,geminate,habitat,height,lateral,leaf,length,major,minor,null,pendent,position,present,prickle,red-papillate,seed,shape,size,stone,structure,sympodial,texture,width,wing,young
183	wfo-0001027889	success	151	126	88	63	38	0.583	-2.5,-pubescent,0.5-1,0.5-11,1,1-10,1.5,1.5-2,10-30,2-20,2-3,3-4,3-9,5-10,abaxially,acuminate,acute,acute-acuminate,adaxially,apex,basal,base,beyond,blade,calyx,cell,chartaceous,cm,color,connivent,darker,deltate,densely,diameter,eglandular-puberulent,eglandular-pubescent,elliptic,exserted,finely,flower,fruit,glabrous,glandular-,green,greenish,immature,length,light,lobe,longitudinal,margin,mm,moderately,ovate,ovoid,pedicel,petiole,present,probably,puberulent,puberulent-pubescent,ripe,shrub,simple,small,somewhat,sparsely,stamen,stellate,stigma,stone,stripe,style,subcordate,subcoriaceous,tip,tomentose,tree,triangular,truncate,tube,unbranched,unit,unknown,violet,white,x,yellowish	.5,.5-2,0,0.7-2,1-3,1-3.5,10-12,10-20,3-8,4-foliat,aggregate,apart,ape,apiculate,articulated,axe,capitat,connective,cylindrical,dilated,directed,distally,eaf,eed,entire,equal,exceeding,extending,introrse,laterally,leaving,lon,long,lower,narrow,nflorescence,nther,oblong,orolla,pedicellar,peduncle,perfect,pore,presen,puberulen,puberulent-pubescen,rachi,radiu,remnant,ruit,slightly,spaced,swelling,tal,tem,thecae,time,tomento,ud,vary,wide,yello,ympodial	4-foliate,anther,anthesi,bark,bud,capitate,corolla,count,filament,free,fruiting,habitat,height,inflorescence,lateral,leaf,major,mentioned,minor,oid,ovary,position,prickle,primary,scar,seed,shape,size,stem,structure,surface,sympodial,tall,texture,vein,width,wing,young
184	wfo-0001027901	success	156	150	124	32	26	0.795	.25,.5,0.3-1.2,0.5-1,0.8-2,0.9-2.3,1-2,1-2.5,1.5-1.8,1.8-4.5,2.5-3,3-5,4-5,4.7-12,6-7,?,abaxial,abaxially,acuminate,acute,anther,anthesi,apex,area,attenuate,bark,base,beneath,berry,broadened,brown,calyx,closely,cm,conical,corolla,curled,dark,deflexed,densely,dia,difoliate,direction,drying,ellipsoid,elliptic,exserted,filament,free,fruiting,glabrous,globose,green,immature,inflorescence,keeled,later,lateral,leaf,like,lobe,lobed,long,main,major,middle,midrib,minor,minutely,mm,nearly,opposite,orbicular,oriented,ovary,ovoid-reniform,pair,papillose,pedicel,petiole,pitted,planar,pore,poricidal,prominently,pubescent,reddish,reflexed,rest,ripe,rounded,scar,shape,shaped,shiny,shrub,simple,single,size,spaced,sparsely,stem,stigma,strongly,style,surface,swollen,tall,tear-drop,tip,translucent,triangular,trichome,tube,uniseriate,unit,usually,vein,white,widest,woody,x,yellow,young	0.8-1,1-1.5,4-10-flowered,adaxially,ba,bright,brow,differing,dry,eaf,edicel,eed,firm,fleshy,fresh,geminat,imbedded,lon,lower,material,matrix,nflorescence,older,overlappin,papillo,portion,ruit,slender,straight,tub,ud,ympodial	.8-1,4-10,bud,cell,color,count,diameter,flower,fruit,geminate,habitat,height,length,margin,null,overlapping,position,prickle,primary,seed,stone,structure,sympodial,texture,width,wing
185	wfo-0001027902	success	128	122	83	45	39	0.648	0.5-1,1-2,10-20,2,2-15,2-3,20-50,3-5,4-25,4-5,5-20,6-37,7-9,abaxially,acuminate,acute,adaxially,angled,apex,axe,base,blade,branched,calyx,cell,chartaceous,cm,color,connivent,cordate,cylindrical,deeply,densely,diameter,distally,eglandular,flower,forked,fruit,glabrous,glandular,globose,hair,inflated,like,lobe,long,margin,mm,moderately,narrowly,nearly,obtuse,ovate,pedicel,petiole,puberulent,pubescent,purple,reticulate,ripe,shrub,simple,small,sparsely,stellate,stigma,stone,style,subcoriaceous,time,tip,tree,triangular,truncate,tube,unbranched,unit,unknown,usually,whitish,wide,x	-2.5,1-1.5,1-6,1.5-3,10-15,15-30,2-12,2-8,2-9,3-4,3-foliat,8-13,absen,adaxiall,aggregate,apart,articulated,directed,distall,eaf,eed,entire,leaving,lon,lower,nflorescence,nther,orolla,pedicellar,peduncle,pore,pubescen,purplish,rachi,radiu,remnant,ruit,spaced,ste,tal,tem,truncat,vary,yellow,ympodial	2-2.5,3-foliate,absent,anther,anthesi,bark,bud,corolla,count,filament,free,fruiting,habitat,height,inflorescence,lateral,leaf,length,major,mentioned,minor,ovary,position,prickle,primary,scar,seed,shape,size,stem,structure,surface,sympodial,tall,texture,vein,width,wing,young
186	wfo-0001027929	success	193	134	97	96	37	0.503	0.2-0.9,1,1-10,1-4,10,2,2-3,2.0-3.0,20,3.5-5,35,4-30,5-6,6-15,acumen,acuminate,acute,along,angular,apex,apiculate,base,beyond,branched,calyx,caudate,cell,center,cm,color,connate,cordate,corolla,covering,cuneate,cyme,darker-violet-blue,deep,diameter,dichasial,dichasially,distal,ebracteate,except,filament,flower,forked,generally,glabrous,globose,green,hair,half,herbaceous,lanceolate,lateral,light,lobe,long,make,mm,monochasial,mucilaginous,obliquely,oblong,occasional,odd-pinnate,ovoid,pedicel,perennial,plant,puberulent,purple,rhizomatous,rounded,seed,shape,size,sometimes,star,stigma,style,terete,testal,thick,tinged,tip,typically,unit,usually,vein,violet,violet-blue,wall,white,wide,without	1-8,1.0-1.3,1.5-4,15,3-6-foliat,4-5,4-6,5-10,5-lobed,abaxially,adaxially,apical,apically,articulate,ba,basal,becoming,cente,clasping,coat,dark,decreasing,dehiscent,digestion,eaf,eed,elliptic,embryo,emoval,enzyme,erect,exceeding,formed,globo,green-white,hair-like,honeycomb,included,interjected,introrse,leaflet,living,lon,lower,maturing,middle,mostly,narrowly,nearly,nflorescence,nther,often,orolla,ovate,pair,pattern,peduncle,pentagonal,perfect,petiolate,petiolulate,petiolule,poricidally,purpl,radiating,rarely,reduced,reveal,rhizome,rotate,rotate-,ruit,semi-lunate,sessile,seudostipule,short,slightly,slit,somewhat,specimen,spot,stamen,ste,straight,subequal,symmetrically,tem,terminal,trailing,unbranched,vary,visible,wid,wider,yellow,ympodial	'hair-like,3-6-foliate,anther,anthesi,bark,bud,count,explicitly,free,fruit,fruiting,habitat,height,inflorescence,leaf,length,major,margin,mentioned,minor,ovary,petiole,position,prickle,primary,scar,stem,stone,structure,surface,sympodial,texture,tube,wet,width,wing,young
187	wfo-0001027948	success	186	173	140	46	33	0.753	-16,-6,.5,0-,0.5-0.7,0.5-2,0.8-,1-2,1.2-2.2,1.3-1.8,1.5-4.5,1.6,1/10,10-14,14,2-,2.2-,2.5-,3-8.2,3.2-5.2,3.5,5,5-,6-celled,7-15,7.5-10,abaxially,abundant,acuminate,adaxially,aggregate,anther,antrorse,apex,articulate,attenuate,basal,base,berry,calyx,cell,cm,connectival,corolla,diameter,difoliate,dorsally,edentate,ellipsoidal,elliptical,erect,filament,finely,flexuous,free,fruiting,generally,glabrous,glandular,globose,herb,hollow,inconspicuous,inserted,lamina,leaf,length,light,lobe,long,long-stalked,longer,longitudinal,longitudinally,lower,many-,margin,midvein,mm,narrow,narrowly,near,non-glandular,occasionally,opening,ovate,ovoid,papillate,patent,pericarp,petiole,pore,poricidal,prolongation,pubescence,pubescent,purple,reduced,ridged,scarce,scarcely,secondary,seed,seeded,seen,separated,short-stalked,shorter,simple,slightly,slit,small,solitary,spur-like,stem,stigma,stone,straight,striate,style,sub-opposite,sub-shrub,thecae,thickened,time,tip,triangular,trichome,tube,twice,unequal,unit,vein,ventrifixed,verrucate,violet,viscid-pubescent,x,Â¼,Â½	-15,0.4,0.6,1-1.2,13,3.7-4,7,8-celled,accrescen,ag,ape,ature,bicellular,branch,c.,campanulate,crushed,cuticle,dark,delicate,diamete,directed,eaf,fragrance,head,herbaceous,hig,ill-smelling,odorles,orolla,pair,portion,ree,ruit,saddle-shape,serrulate,single-celled,sinus,smooth,stalk,striat,tem,tooth,upward,vary,ympodial	accrescent,age,anthesi,bark,bud,color,count,flower,fruit,habitat,height,inflorescence,lateral,major,mentioned,minor,null,ovary,pedicel,position,prickle,primary,saddle-shaped,scar,shape,size,structure,surface,sympodial,texture,width,wing,young
188	wfo-0001027961	success	177	150	119	58	31	0.672	.5,0.25,0.25-0.5,0.5-1,1-1.5,1-3,1-4,1-5,1-9,10-50,2-2.5,2.3-2.5,2.5-9,3-3.5,5-8,6-9,7-9,8-10,<,?,abaxially,acute,adaxially,always,anther,anthesi,apex,asymmetric,axil,base,berry,branched,broadly,c.,calyx,clavate,cm,conical,connivent,cordate,corolla,curling,deltate,densely,diameter,distributed,ellipsoid,elliptic,entire,fading,filament,flower,free,fruiting,fusiform,glabrous,globose,green,immature,inflorescence,irregularly,lamina,lateral,lobe,long,loosely,many,margin,mature,maturity,midrib,minute,minutely,mm,obovate,observed,occasionally,often,older,pair,pedicel,petiole,pinnatifid,plurifoliate,present,primary,probably,pubescent,purple,reddish,scar,shiny,simple,slightly,spaced,sparsely,stem,stigma,style,surface,terminal,time,tip,triangular,trichome,truncate,tube,tuft,twining,uniseriate,unit,vein,vine,violet,way,white,white-pubescent,woody,x	0.9-1,1,4.5-5,5-merou,adaxiall,age,alyx,apar,ark,articulated,brow,clear,eaf,early,eed,equalling,exserted,geminat,growth,ilament,lengthening,lobed,lon,lower,membranous,new,nflorescence,one,orolla,other,papillo,peduncle,pendan,perfect,pericarp,pinched,planar,pore,poricidal,portion,pubescen,rotate-stellate,ruit,sleeve,slender,slit,small,spreading,tem,thin,transition,twinin,ud,unequal,upper,vary,yellow,ympodial	apart,bark,brown,bud,cell,color,count,fruit,geminate,habitat,height,leaf,length,major,mentioned,minor,ovary,papillose,pendant,position,prickle,seed,shape,size,stone,structure,sympodial,texture,width,wing,young
189	wfo-0001027966	success	207	139	107	100	32	0.517	0.8,0.8-2.5,1-2,1-4.2,1.5-5.2,10-30,2.2-2.9,2.5-10.5,3-5,3-7,40-80,5-10,5-6,5-9.5,5.5-14,6-11,abaxially,acuminate,adaxially,anther,apex,attenuate,axillary,base,berry,blue-violet,brownish,bud,cell,ciliate,cm,condition,conical,corolla,covering,densely,diameter,distal,drying,elliptic,especially,filament,flower,forked,fresh,fruit,generally,glabrous,green,greenish,hair,half,herb,lanceolate,lateral,leaf,leaflet,less,light,like,lobe,long,make,margin,mm,mottled,mucilaginous,narrow,odd-pinnate,ovate,ovoid,pale,pedicel,petiole,plant,plurifoliate,pubescent,purple,ray,ripe,seed,sessile,shorter,size,slightly,sparsely,stem,stigma,straight,subsessile,subtending,terminal,testal,thick,tip,tri-,tube,unit,usually,violet,wall,wet,white,whitish,wide,wing,x	0.4-0.5,0.7-3,1-1.8,1-10,1-3,1-5,1.2-4.5,1.3-2.2,1.5-3,10,2.8-9,3-4,4,5-merou,absent,acumen,ag,along,alyx,apart,apparently,arranged,articulated,asymmetrical,axe,basiscopic,bead,blade,capitat,chartaceous,commonly,connivent,decreasing,digestion,dorsally,eaf,edge,eed,enzyme,erec,exceeding,flat,folded,geminat,glabrou,gradually,green-white,hair-like,homostylous,honeycomb-shaped,interjected,larger,lengthening,living,lower,medium,membranous,middle,minute,moniliform,multiple,necklace,nflorescence,orbicular,orolla,pair,peduncle,pentagonal,perfect,petiolule,pore,poricidal,proximal,rarely,removed,rotate,ruit,secondary,semierect,seudostipule,side,slit,somewhat,spaced,specimen,stamen,ste,stolon,subequal,symmetrical,tall,tamen,tem,throughout,tissue,tuber,tyle,typically,yellow,ympodial	'hair-like,anthesi,bark,calyx,capitate,color,count,free,fruiting,geminate,habitat,height,inflorescence,length,major,mentioned,minor,ovary,position,prickle,primary,scar,shape,stone,structure,style,surface,sympodial,texture,vein,width,young
190	wfo-0001028014	success	222	196	170	52	26	0.766	-0.5,-1,-1/2,-2.5,-3,-4,-5,-6,.5,/5,0,0.1-0.2,0.15,0.15-0.3,0.2,0.2-0.4,0.2-1,0.2-1.6,0.25,0.3-0.4,0.5,0.5-1,0.5-1.5,0.5-2,0.5-3,0.7-1,0.7-1.6,0.9-1.2,1-,1-10,1-2,1-3,1-4,1.3-2.4,1.5,1.5-2,1/4,1/4-2/3,2-20,2-3,2-4.5,2-6.5,3-10,4-10,6-10,6-11,abaxially,ame,anther,apart,apex,apically,apparently,around,bark,base,blade,branched,brown,brown-green,c.,calyx,cell,chartaceous,cm,concolorous,connivent,cordate,curved,deltate,densely,diameter,difoliate,discolorous,drying,edge,elongating,erect,filament,flattened,flattened-reniform,flower,free,fruit,fruiting,glabrescent,glabrous,gland,globular,gray,gray-green,herbaceous,lateral,leaf,length,lobe,lobed,long,longer,lower,margin,mature,maturity,mauve,membranous,midpoint,mm,moderately,obtuse,occasionally,one,open,orange,outer,outline,ovate,pair,pale,pedicel,petiole,pit,poricidal,porrect,prickle,prickly,primary,purple,raised,ray,red,reduced,reflexed,rough,rounded,scandent,scar,seed,sessile,shiny,shorter,shrub,simple,slender,sometimes,spaced,spherical,spreading,stalk,stalked,stellate,stellate-pubescent,stem,straight,strongly,style,surface,tapering,terete,terminal,time,tip,trichome,tube,unit,vein,visibly,way,wide,yellow,yellow-green	-10,-15,0.6-0.9,1.8-3,2,2.5-4,4.5-7,5-merous,acuminat,almost,alyx,apar,articulated,berry,black,broad-deltate,decurrent,distance,eaf,eed,equal,extending,eye,geminat,glabrou,infructescence,lon,midvein,naked,nflorescence,older,orange-gra,orolla,oung,peduncle,pendulous,per,perfec,pericarp,portion,prickl,ruit,side,smooth,tamen,tertiary,vary,venation,visible,weakly,winged,ympodial	acuminate,anthesi,bud,color,corolla,count,geminate,habitat,height,inflorescence,major,minor,null,orange-gray,ovary,position,shape,size,stigma,stone,structure,sympodial,texture,width,wing,young
191	wfo-0001028017	success	158	146	106	52	40	0.671	-2.5,0.3-1,1-2,1.5-2,10-22,13-40,15-35,15-50-flower,2,2-3,2-4,2.5-5,3,3-12,3-14,3-4,5-7,5-9,6-7,6-8,9-11,abaxially,absent,acuminate,acute,adaxially,apex,apiculate,basal,base,beyond,blade,brown,calyx,cell,chartaceous,clavate,cm,connivent,cuneate,densely,diameter,eglandular,eglandular-puberulent,eglandular-pubescent,ellipsoidal,elliptic,exserted,flattened,fleshy,flower,forked,fruit,fusiform,glabrous,glandular,glandular-,glandular-puberulent,green,greenish,hair,immature,lanceolate,lobe,long,margin,mm,moderately,narrowly,oblique,obtuse,ovate,ovoid,pedicel,perfect,petiole,pointed,pubescent,purplish,rarely,ripe,short-acuminate,simple,small,sometimes,sparsely,stamen,stigma,stone,style,subcoriaceous,time,tip,tomentose,tree,triangular,truncate,tube,unbranched,unit,vein,white,wide,without,x,yellow	1,1-10,1-3,3-foliat,40-50,5,absen,aggregate,apart,ape,articulated,axe,ciliat,connective,cream,cylindrical,directed,distally,eaf,eed,entire,exceeding,introrse,leaving,lon,lower,near,nflorescence,nther,orolla,pedicellar,peduncle,pore,puberulen,purple,rachi,radiu,remnant,ruit,shorter,slightly,spaced,stellate,stellate-campanulate,tal,tan,tem,thecae,truncat,ud,vary,ympodial	15-50,3-foliate,anther,anthesi,bark,bud,ciliate,color,corolla,count,filament,free,fruiting,habitat,height,inflorescence,lateral,leaf,length,major,mentioned,minor,ovary,position,prickle,primary,puberulent,scar,seed,shape,size,stem,structure,surface,sympodial,tall,texture,width,wing,young
192	wfo-0001028033	success	157	145	113	44	32	0.72	.6,1.4â1.8,1.5,1â4,1â5,2â3,2â4,2âfoliate,3,3â11,3â4,4â12,4â5,50,5â7,6â12,abaxially,acuminate,acute,adaxially,along,anther,anthesi,apex,ark,ascending,attenuate,base,becoming,blade,branch,brochidodromous,brown,calyx,cell,chartaceous,cm,connivent,cyme,darker,decurrent,densely,denser,diameter,discolorous,drying,elliptic,eye,few-branched,filament,flower,fruit,glabrescent,glabrous,greenish,growth,herb,high,hispid-pubescent,lateral,length,light,like,linear-lanceolate,lobe,long,mainly,margin,membranaceous,midrib,mm,naked,new,oblong,older,onto,order,ovate-lanceolate,pedicel,petiole,prominent,pubescence,pubescent,rhizomatous,secondary,sessile,shin,shiny,shorter,shrub,simple,slightly,solitary,sparsely,spreading,stem,stigma,style,surface,trichome,tube,unbranched,uniseriate,unit,unknown,upright,vein,venation,visible,white,wide,woody,Ã	3â5,5-merou,adaxiall,alyx,capitat,ciliate,contiguou,cordate,cylindrical,deeply,directed,eaf,eed,emarginate,entire,equal,florescence,geminat,green,introrsely,know,known,lobed,longitudinal,lower,nearly,opening,orolla,perfect,pore,poricidal,prostrat,recurved,ruit,slit,stellate,straight,strongly,subapical,tamen,tem,vary,yellow,ympodial	bark,bud,capitate,color,corolla,count,free,fruiting,geminate,habitat,height,inflorescence,leaf,major,minor,ovary,position,prickle,primary,prostrate,scar,seed,shape,size,stone,structure,sympodial,texture,tip,width,wing,young
193	wfo-0001028067	success	139	121	85	54	36	0.612	0.5-1,0.5-1.5,0.5-2,1,1-2,1-3,1-7,1.5-2.5,2-2.5,2-3,3-17,3-4,3-5,5-7,6-12,6-18,7-11-compound,7-20,7-9,8-13,abaxially,acuminate,acute,adaxially,apex,axe,base,calyx,cell,chartaceous,cm,color,connivent,cuneate,cylindrical,dark,diameter,elliptic-fusiform,flattened,flower,fruit,glabrous,hair,lateral,leaf,leaving,lobe,long,margin,mm,moderately,narrowly,nearly,often,pedicel,pedicellar,per,petiole,pink,pinnately,puberulent,purple,rarely,remnant,ripe,several,shrub,simple,sparsely,stigma,stone,strongly,style,tip,tomentulose,triangular,triangular-deltate,truncate,tube,unbranched,unequal,unit,usually,x,yellow	-30,1-10,1-11,10-25,2,2.5-3,3-7,4-foliat,adaxiall,aggregate,along,apart,articulated,basiscopically,blade,compound,decurrent,directed,distall,eaf,eed,elliptic-ovate,entire,especially,glabrou,leaflet,lon,lower,midrib,nflorescence,nther,obtuse,orolla,peduncle,pore,puberulen,rachi,radiu,ruit,slightly,smal,spaced,stellate,subcoriaceous,tal,tem,time,truncat,unknown,upper,vary,wide,ympodial,zigzag	4-foliate,anther,anthesi,bark,bud,corolla,count,filament,free,fruiting,habitat,height,inflorescence,length,major,minor,ovary,position,prickle,primary,scar,seed,shape,size,small,stem,structure,surface,sympodial,tall,texture,unspecified,vein,width,wing,young
194	wfo-0001028069	success	253	228	199	54	29	0.787	-0.4,-30,-6,.1,.1-0.2,.2,.5,0.05-0.1,0.1-0.15,0.1-0.2,0.1-0.3,0.1-0.5,0.2-0.5,0.3,0.3-0.4,0.3-0.6,0.3-0.7,0.3-1,0.4,0.4-0.8,0.5-0.7,0.5-1.8,0.5-2,0.6-1.1,0.6-4,0.7-1,0.7-1.3,0.7-1.5,1-2-celled,1-2.7,1-3.5,1.4,1.5-3.5,1.6-3.2,10,10-12,10-30,12,2-17,2-3-branched,2-4,3,3-,3-foliate,5-22,5-25,6-,accrescent,acute,adpressed,along,alternate,always,among,anther,anthesi,apex,apical,appearance,appendage,appressed,articulated,axi,basal,base,basioscopically,becoming,berry,bract,bracteole-like,bright,calyx,cell,citru,cm,composed,conical,cordate,corolla,cuneate,curving,decurrent,deep,deeply,dense,densely,diameter,ebracteate,erect,exserted,filament,flower,forming,fruit,fruiting,giving,gland,gland-tipped,glandular,glandular-villous,globose,green,hair-like,half,halfway,herb,imparipinnate,initially,interjected,internode,interrupted,later,lateral,leaf,leaflet,length,lime,linear,lobe,lobed,long,longer,longest,margin,maturity,midvein,minute,minutely,mm,multicellular,narrowly,oblique,obovate,occasionally,often,one,orange,outgrowth,ovary,ovate,pair,pale,pedicel,peduncle,per,perennial,petiole,petiolule,plant,population,present,primary,procumbent,pseudostipule,pubescence,pubescent,quaternary,reflexed,robust,rounded,scent,secondary,sessile,several,shaggy,short,shorter,silky,simple,single-celled,size,slender,smaller,stem,sterile,stigma,straight,strong,style,subopposite,surface,tangled,tertiary,testa,tightly,toward,transparent,trichome,tube,unicellular,uniseriate,unit,usually,varying,viny,wall,wide,winged,yellow	0.1-0.6,0.2-0.3,0.3-0.45,0.4-0.5,0.4-1,0.5,0.8-1.2,1-4.5,1.5-2.0,2-7,2-locular,4-celled,<,abaxially,absen,abundant,adjacent,ba,bilaterally,brown,column,cone-shaped,due,eaf,edicel,eed,eglandular,fusion,glabrescent,gland-tippe,gree,head,included,larger,less,like,lon,lower,middl,nflorescence,patent,pentagonal,rarely,ruit,scarcely,somewhat,staminal,symmetric,tem,terminal,thick,ud,weak,ympodial	absent,axillary,bark,bud,cauliflorous,color,count,free,habitat,height,inflorescence,major,middle,minor,null,position,prickle,scar,seed,shape,stone,structure,sympodial,texture,tip,vein,width,wing,young
195	wfo-0001028075	success	196	134	102	94	32	0.52	1-2,1.5-2.5,1.5-7,10-35,2-4.5,2-6,3-11,3-23.5,4-7,5-12,5-17,7-30,8-12,abaxially,acuminate,acute,adaxially,along,anther,apex,axillary,base,berry,broadly,bud,cell,ciliate,cm,corolla,covering,dark,diameter,distal,distinctively,dorsally,dot,especially,filament,flat,flower,folded,forked,fruit,generally,glabrescent,glabrous,globose,green,green-white,half,herb,lanceolate,lateral,leaf,light,ligulate,lobe,make,margin,midrib,minutely,mm,mucilaginous,narrow,oblique,obtuse,odd-pinnate,often,ovoid,pale,pedicel,pentagonal,petiole,plant,plurifoliate,puberulent,reflexed,rotate,rounded,scattered,seed,size,sometimes,star,stigma,style,subcordate,subtending,terminal,testal,thick,throughout,tip,tri-,tube,unit,usually,wall,wet,white,wing,x	.5,1-10,1-2.7,1-3,1.6-2.7,2-3,2.5-10,4-12,5-14,5-7,5-8,5-9,5-merou,7-13,absent,acuman,acumen,ag,alyx,apart,apparently,articulated,axe,blade,borne,brownish,capitat,chartaceous,condition,connivent,cuneate,decreasing,differentiated,digestion,distally,drying,eaf,edge,eed,elliptic-lanceolate,end,enzyme,erec,exceeding,fresh,geminat,glabrescen,greenish,hair-like,homostylous,honeycomb-shaped,interjected,larger,leaflet,lengthening,living,long,lower,membranous,middl,much,nflorescence,orolla,ovate,ovate-elliptic,pair,peduncle,perfect,petiolule,pore,poricidal,purple,removed,ruit,seudostipule,singly,slightly,slit,spaced,specimen,stamen,stolo,straight,tall,tamen,tem,toward,tuber,typically,vary,whitish,wide,yellow,ympodial	'hair-like,anthesi,bark,calyx,capitate,color,count,free,fruiting,geminate,habitat,height,inflorescence,length,major,mentioned,minor,ovary,position,prickle,primary,scar,shape,stem,stone,structure,surface,sympodial,texture,vein,width,young
196	wfo-0001028076	success	195	138	107	88	31	0.549	.5,0.4-0.5,0.5,1-2,1-3,1.2-2.2,110,12-22,13-14,2-12,2-3,2.2-2.6,2.5-4,2.6-3.8,5-20,5-6.5,7-8,?,abaxially,acumen,acuminate,adaxially,anther,apex,attenuate,axillary,base,berry,bud,cell,chartaceous,ciliate,cm,conical,connivent,corolla,covering,densely,diameter,distal,dorsally,edge,especially,filament,flat,flower,folded,forked,fruit,generally,glabrous,green,hair,half,herb,lanceolate,lateral,leaf,leaflet,less,light,like,lobe,long,make,margin,membranous,mm,mucilaginous,odd-pinnate,ovoid,pedicel,petiole,plant,plurifoliate,pubescent,purple,rarely,ray,ripe,seed,sessile,size,slightly,stem,stigma,straight,style,subsessile,subtending,symmetrical,tall,terminal,testal,thick,tip,tri-,tube,unit,unwinged,usually,wall,wet,white,wide,wing,x	1-1.3,1-10,1.8-2.2,2-5.4,2.2-3.7,2.5-3,4-5,4.5-7,5,5-6,5-merou,absent,ag,alyx,apart,apparently,articulated,axe,blade,borne,brownish,capitat,condition,decreasing,digestion,drying,eaf,eed,elliptic,end,enzyme,erec,exceeding,fresh,geminat,glabrou,gradually,green-white,greenish,hair-like,homostylous,honeycomb-shaped,interjected,larger,lengthening,living,lower,medium,minute,nflorescence,obtuse,orolla,ovate,pair,peduncle,pentagonal,perfect,petiolule,pore,poricidal,proximal,pubescen,removed,rotate,round,ruit,secondary,semierect,seudostipule,singly,slit,spaced,specimen,stamen,ste,stolo,subequal,tamen,tem,thir,throughout,toward,tuber,typically,vary,whitish,yellow,ympodial	'hair-like,anthesi,bark,calyx,capitate,color,count,free,fruiting,geminate,habitat,height,inflorescence,length,major,mentioned,minor,ovary,position,prickle,primary,scar,shape,stone,structure,surface,sympodial,texture,vein,width,young
197	wfo-0001028105	success	150	137	110	40	27	0.733	.1,.4,.5,0.3-1.5,0.5-1,0.5-2,0.6-1,1-1.2,1-1.5,1-2.5,1.5-1.8,1.5-2,1.5-4.5,2-2.2,2-5,3-5-celled,3-6,6-7,9.5-15,abaxially,acuminate,acute,anther,anthesi,apex,apical,attenuate,axil,bark,base,bilobed,calyx,clavate,cm,conical,corolla,deflexed,dense,difoliate,distinct,drying,ellipsoid,elliptic,evenly,filament,filiform,flattened-reniform,free,fruiting,glabrous,glandular,globose,green,incrassate,lamina,lateral,leaf,lobe,long,main,major,margin,minor,minutely,mm,occasionally,opposite,ovary,pair,pale,papillose,pedicel,petiole,pitted,planar,pore,poricidal,projection,pubescent,quadrate,reflexed,scar,scattered,shaped,shrub,simple,size,slightly,small,spaced,spreading,stem,stigma,style,surface,tall,tear-drop,tip,tree,trichome,tube,tuft,uniseriate,unit,vein,white,woody,x,yellowish,young	0.5,1.5,2,3.5-4,5-7-flowered,adaxially,apar,axi,ba,berry,dark,dia,differing,eaf,edicel,eed,erect,exserted,geminat,greenish-yello,like,lobed,lon,lower,middle,nearly,nflorescence,older,olive-green,papillo,portion,reddish-brown,ruit,sparsely,straight,strongly,tub,ud,widest,ympodial	5-7,apart,bud,cell,color,count,diameter,flower,fruit,geminate,greenish-yellow,habitat,height,inflorescence,length,mentioned,position,prickle,primary,seed,shape,stone,structure,sympodial,texture,width,wing
198	wfo-0001028109	success	205	196	171	34	25	0.834	-20,-4,-7,.5,/3,0.05-0.15,0.05-0.2,0.1,0.1-0.2,0.3,0.4-0.8,0.4-1.5,0.45-0.65,0.5-1.2,0.5-2.5,0.7,0.8-1.5,0.8-1.6,1.5-10,1.5-2.5,1.5-5.5,1/8-1/4,10-25,10-30,12-40,2-15,2-4,2.3-2.9,2.5-3,2.5-5,2/3-3/4,3-,3-7,3.5-6,3/4,30-150,4-13,5-13,5-30,8-12,8-15,8-25,abaxial,abaxially,acuminate,acute,adaxial,almost,ame,anther,apart,apex,apically,apparently,bark,base,berry,blade,branching,bright,c.,calyx,cm,connivent,cuneate,curved,deltate,densely,diameter,dimorphic,dull,elliptic,elongating,equal,erect,evenly,filament,flattened-reniform,flower,free,fruit,fruiting,fully,geminate,gently,glabrescent,glabrous,gray-green,green,green-brown,lateral,leaf,length,light,lobe,lobed,long,long-styled,longer,lower,margin,mature,maturity,mauve,midpoint,minor,mm,moderately,multangulate,obtuse,occasionally,one,open,opening,orange-brown,pair,pedicel,per,perpendicular,petiole,poricidal,porrect,portion,prickle,prickly,primary,ray,red,red-brown,reflexed,scar,secondary,sessile,shrub,simple,slender,small,sometimes,spaced,spherical,spreading,stalk,stalked,stellate,stellate-pubescent,stem,straight,style,surface,tapering,terete,terminal,tertiary,time,tip,tree,trichome,tube,unarmed,unit,usually,vein,venation,visible,way,weakly,white,wide,woody,yellow,young	0.6-0.8,15-100,20-60,4-5-merous,acut,alyx,apar,articulated,brow,chartaceous,discolorous,drying,eaf,eed,entire,glabrou,infructescence,nflorescence,older,orolla,oung,peduncle,perfec,pericarp,plurifoliat,prickl,recurved,ruit,smooth,strongly,tamen,unarme,vary,ympodial	anthesi,brown,bud,cell,color,corolla,count,habitat,height,inflorescence,major,null,ovary,plurifoliate,position,seed,shape,size,stigma,stone,structure,sympodial,texture,width,wing
199	wfo-0001028115	success	165	148	110	55	38	0.667	-1.1,-5.2,.6,0.42,0.7-0.8,0.8-,1-2.4,1-3,1.1-1.8,1.4-1.7,1.7-2.2,1.8-3.5,12-13.5,2-,2-3.2,2.5-,3-4.5,3-6.5,4.7-,5-15,5-8.5,6-10,7-7.5,9-17,abaxially,abundant,accrescent,acute,adaxially,amply,annular,anther,antrorse,apex,attenuate,base,berry,blade,blue,calyx,campanulate,capitate,cm,coat,diameter,ellipsoidal,elliptical,embryo,especially,evident,exceeding,filament,fruiting,glabrescent,glabrous,glandular,globose,growing,herb,herbaceous,inflated,length,light,linear,lobe,long,longitudinally,margin,mm,moderately,much,multi-seeded,narrowly,nerve,non-glandular,one,ovate,pale,papery-scarious,petiole,prostrate,pubescent,reticulate,ridged,scarce,seed,simple,slender,small,stem,stigma,strongly,style,tip,trans-ovoidal,triangular,trichome,tube,tuberculate,unifoliate,uniseriate,unit,venation,violet,wide,wider,width,winged,x,yellow	-2.5,.2,0.2-0.3,0.5,0.6-0.7,1.3-1.8,3-5,acuminat,ag,alternate,articulate,basal,connectival,curved,difoliat,dorsal,eaf,eed,entire,half,hig,longer,longitudinal,lower,mixed,near,oblong,opening,opposite,orolla,pair,papillo,pinnatifid,pinnatipartite,pinnatisect,pore,poricidal,portion,prolongation,rarely,ree,ruit,segment,similar,slightly,slit,smooth,sometimes,styl,subsessil,tem,time,unequal,vary,ympodial	acuminate,anthesi,bark,bud,cell,color,corolla,count,difoliate,flower,free,fruit,habitat,height,inflorescence,lateral,leaf,major,minor,null,ovary,papillose,pedicel,position,prickle,primary,scar,shape,size,stone,structure,subsessile,surface,sympodial,texture,vein,wing,young
200	wfo-0001028131	success	208	175	149	59	26	0.716	.1,.5,/5,0-30,0.1-0.3,0.2-1.5,0.3-0.7,0.4-0.8,0.5-1.1,0.7-1.1,0.8-1,0.8-1.1,1-10,1-3,1-4,1-5,1.5-3,1.5-5,1.8-2,1.8-2.2,1/4-2/3,1/5,2-2.8,2-4,2-5,2-6.5,3-6,5-6.5,6-7,7-8,abaxially,absent,anther,apart,apex,apically,apparently,attenuate,bark,base,berry,branched,calyx,cell,cm,connivent,cream,curved,dark,deltate,densely,diameter,difoliate,dull,epidermi,erect,filament,filiform,flattened,flattened-reniform,flower,free,fruit,fruiting,glabrescent,glabrous,green,herb,lanceolate,lateral,leaf,length,like,lobe,lobed,long,longer,margin,marking,mature,maturity,mauve,mm,moderately,narrow-obovate,narrow-ovate,oblong,obtuse,often,older,one,open,orange,orange-brown,outline,pair,pale,pale-brown,pedicel,pendulous,per,petiole,pit,poricidal,porrect,prickle,prickly,primary,purple,raised,ray,red,reduced,reflexed,rounded,scar,sessile,shiny,simple,small,smooth,spaced,sparsely,spherical,spreading,stellate,stellate-pubescent,stem,straight,strongly,style,sunk,surface,tapering,terete,time,tip,trichome,tube,unarmed,unit,upper,vein,visible,way,wide,woody,yellow,young	-1.2,0-0.6,0-2,0-3,0-4,0.05-0.2,0.1-0.15,2/3,4-6,5-8,5-merous,abaxial,acuminat,adaxial,alyx,apar,articulated,blade,broad-deltate,chartaceous,concolorous,distance,drying,eaf,eed,elongating,equal,extending,eye,geminat,gland,infructescence,lengt,lower,membranous,midpoint,midvein,naked,nflorescence,orolla,oung,pale-gra,peduncle,perfec,pericarp,portion,prickl,ruit,sessil,shorter,side,sometimes,tamen,tertiary,unarme,vary,venation,yellow-green,ympodial	acuminate,anthesi,bud,color,corolla,count,geminate,habitat,height,inflorescence,major,minor,null,ovary,pale-gray,position,seed,shape,size,stigma,stone,structure,sympodial,texture,width,wing
201	wfo-0001028148	success	157	144	119	38	25	0.758	-6,.5-4,0.25-0.5,0.5-1.5,0.6-3.5,0.75-2,1-15,1-3.5,1.5,1.5-2.5,10-30,12-15,15,2,2-3,2-7,2.5-4,20-50,3.5-4,3.5-9,4.5-10,5,5-20,5-7,5-8,6-18,abaxially,acute,adaxially,aggregate,angled,apart,apex,apiculate,articulated,axe,base,blade,blue-black,branched,calyx,cell,central,chartaceous,cm,connivent,cylindrical,dark,deltate,densely,diameter,directed,elliptic,except,flower,fresh,fruit,glabrous,glaucous,globose,hair,highly,less,lobe,long,margin,material,mature,minute,mm,moderately,narrowly,obtuse,often,orange,ovate,pedicel,peduncle,perfect,petiole,pink,plicate,pore,puberulence,puberulent-pubescent,purple,rachi,radiu,rarely,rhizomatous,ridge,ripe,rotate-stellate,scalloped,shrub,simple,slender,smooth,sometimes,spaced,sparse,star,stigma,stone,style,surface,time,treelet,tube,unbranched,unit,usually,violet,white,whitish,wide,x,yellow,young	4-10,5-10,absen,ba,broadly,decurrent,distal,distall,eaf,eed,entire,especially,fleshy,light-colored,lower,many-foliat,margi,midrib,nflorescence,nther,orolla,part,plicae,puberulent,ruit,slightly,smoot,succulent,tal,tapered,tem,thickened,tip,triangular,truncat,vary,winge,ympodial	absent,anther,bud,color,corolla,distally,habitat,height,inflorescence,leaf,length,many-foliate,ovary,position,primary,scar,seed,shape,stem,structure,sympodial,tall,texture,truncate,vein
202	wfo-0001028161	success	124	132	98	26	34	0.79	.5,0.1-0.25,0.25-0.5,0.7-1.7,1-1.5,1-2,1-2.3,1.5-4.5,1/3,2-5-flowered,2-9,3-7,4-5,6-9,7.5-12,9-11,abaxially,acuminate,acute,adaxially,along,anthesi,apex,arising,attenuate,bark,base,branch,branched,brown,calyx,cell,closely,cm,corolla,deflexed,dendritic,densely,denser,dia,difoliate,distal,elliptic,exserted,fruiting,globose,green,incrassate,lanceolate,later,lateral,leaf,like,long,main,major,margin,middle,minor,minutely,mm,narrowly,obovoid,older,opposite,outline,ovoid-reniform,pair,pale,pedicel,petiole,pitted,pubescent,reddish-brown,rest,rounded,scar,shape,shrub,simple,sinuate,size,somewhat,spaced,sparsely,stem,strongly,surface,tall,tan,tapering,thin,trichome,unit,vein,widest,x,young	1-1.3,2.5-3,3-4,ba,berry,congested,consisting,differing,eaf,edicel,eed,geminat,glabrescen,inflorescenc,lon,nflorescence,often,orbicular,overlappin,probably,pubescence,ruit,short,tub,ud,ympodial	2-5,anther,bud,color,count,diameter,filament,flower,free,fruit,geminate,glabrescent,habitat,height,inflorescence,length,lobe,ovary,overlapping,position,prickle,primary,seed,specified,stigma,stone,structure,style,sympodial,texture,tip,tube,width,wing
203	wfo-0001028164	success	197	166	137	60	29	0.695	-1,-6,/4,0.05-1.5,0.1,0.4-0.8,0.5-0.8,0.5-1,0.8-1.5,0.9-1.6,1,1-1.5,1-4.5,1.8-2.5,1/3,1/6-1/4,12-20,2-2.5,2.5-4.5,3-7,6-8,8-15,8-17,abaxial,abaxially,acuminate,acute,almost,ame,anther,apex,apparently,attenuate,bark,base,blade,branched,bright,c.,calyx,cm,connivent,curved,deltate,densely,diameter,difoliate,dull,elliptic,elongating,erect,evenly,eye,filament,filiform,flattened-reniform,flower,free,fruit,fruiting,glabrescent,glandular,gray,green,hair,lateral,leaf,length,less,lobe,long,longer,margin,mature,maturity,mauve,midpoint,midvein,minute,mm,moderately,multangulate,naked,narrow-deltate,obtuse,often,older,one,open,orange-brown,pair,pale,pedicel,petiole,porrect,primary,ray,red,scar,sessile,shorter,shrub,side,simple,sometimes,spaced,sparsely,spherical,spreading,stalk,stalked,stellate,stellate-pubescent,stem,straight,style,surface,tapering,terete,terminal,tertiary,time,tip,trichome,tube,unarmed,unit,upper,variously,vein,venation,visible,white,wide,woody,yellow,young	-14,-8,0-20,0.05-0.2,0.3-0.8,0.7-1.1,1.5-2.5,2.5-4,2.8-4,3-17,3.6-4.8,4-13,4-5-merous,4-7,4-8,alyx,apar,apically,articulated,berry,concolorous,dark,drying,eaf,eed,entire,equal,geminat,glabrescen,glabrou,glabrous,infructescence,lobed,long-acuminat,lower,membranous,nflorescence,orolla,oung,peduncle,per,perfec,pericarp,poricidal,portion,recurved,red-brown,reflexe,ruit,shallowly,shorte,smooth,tamen,unarme,undulate,vary,way,yellow-gra,yellow-green,ympodial	anthesi,apart,bud,cell,color,corolla,count,geminate,habitat,height,inflorescence,major,minor,null,ovary,position,prickle,reflexed,seed,shape,size,stigma,stone,structure,sympodial,texture,width,wing,yellow-gray
204	wfo-0001028180	success	147	144	119	28	25	0.81	.05,.5,/2,0.7-1,1-1.5,1-1.8,1-3,1.5-5,15-28,2-2.2,2-3,2.5-3,20-30-flowered,3-10,3-4,4.5-5,5-6,5-8,7,8-10,abaxially,acute,along,anther,anthesi,apex,attenuate,bark,base,beginning,calyx,capitate,closely,cm,conical,corolla,cucullate,darker,deflexed,deltate,densely,difoliate,distinctly,drying,elliptic,elongate,erect,falcate,filament,fleshy,four-angled,free,fruiting,glabrous,globose,golden,green,irregularly,larger,lateral,leaf,lobe,lobed,long,main,major,margin,midrib,minor,minutely,mm,nearly,obscure,older,onto,opposite,ovary,ovoid-reniform,pair,pale,papillose,pedicel,petiole,pinkish-white,pitted,planar,pore,poricidal,puberulent,pubescent,scar,shaped,shiny,simple,size,small,somewhat,spaced,sparsely,stem,stigma,style,surface,tan,tear-drop,tip,tree,trichome,tube,uniseriate,unit,vein,way,white,winged,woody,x,yellow-gray,young	1-1.2,adaxially,ba,berry,c.,dark,dia,differing,eaf,eed,geminat,glabrat,gold,know,leathery,lon,lower,nflorescence,overlappin,portion,ruit,straight,styl,tall,thick,ud,underside,ympodial	20-30,bud,cell,color,count,diameter,flower,fruit,geminate,glabrate,habitat,height,inflorescence,known,length,overlapping,position,prickle,primary,seed,shape,stone,structure,sympodial,texture
205	wfo-0001028182	success	150	129	102	48	27	0.68	0.1-0.2,0.5-0.6,0.5-1,0.8-1,0.9-1,1-1.5,2-2.5,2-6.5,3-5,4-6,5-15-flowered,6-9,anther,anthesi,apex,bark,base,branch,brown,calyx,capitate,ciliate,cm,conical,cordate,corolla,deflexed,deltoid,dia,dry,ellipsoid,except,extreme,filament,filiform,flower,free,glabrous,globose,hemiepiphyte,inflorescence,internodal,keeled,known,later,lateral,lax,leaf,like,lobe,lobed,long,long-acuminate,main,margin,midrib,minutely,mm,narrowly,nearly,obovoid,older,opposite,ovary,ovate,pair,papillose,pedicel,petiole,planar,pore,poricidal,prominent,pubescent,purplish,reflexed,rounded,scar,shaped,shiny,shrub,simple,slightly,somewhat,sparsely,specimen,spindly,stem,stigma,style,surface,tear-drop,tip,trichome,truncate,tube,uniseriate,unit,vein,white,x,young	.5,0-90,0.5,2,3,5-ribbed,along,apart,apiculae,apiculate,arching,axi,bending,beneath,black,blade,densely,eaf,edicel,eed,evenly,gre,know,less,lower,material,minute,nflorescence,papillo,portion,present,proximal,rib,ruit,sca,slender,spaced,sparser,still,strongly,tapering,third,time,ud,unifoliat,widest,ympodial,zig-zag	bud,cell,color,count,diameter,fruit,fruiting,grey,habitat,height,length,major,mentioned,minor,position,prickle,primary,seed,shape,size,stone,structure,sympodial,texture,unifoliate,width,wing
206	wfo-0001028183	success	237	224	188	49	36	0.793	-10,.5-3,0.1,0.1-0.2,0.1-0.4,0.1-0.9,0.2-0.3,0.2-0.4,0.5,0.5-2.5,0.6,0.7-1.2,0.7-2,1.1-1.8,1.4-2.8,1.5-3.4,1.6-2.3,1.9-3.7,1/3-1/2,10-15,11-30,2-4.2,2-5,2.2-5.7,2.5-4.1,2.6-4.4,3.2-,3.5-6.6,4.5-9,4.6-6.4,5-8,5-8.5,50-400,7.5-23,8-9.1,9-13,abaxial,abaxially,accrescent,acute,adaxially,ag,along,anther,anthesi,apex,around,attenuate,axi,axillary,bark,base,berry,blade,blunt-tipped,branch,branched,brown,bud,calyx,capitate,cell,central,chartaceous,cm,corolla,cuneate,dark,deltoid,dendritic-multangulate,diameter,directed,distally,distantly,drying,dull,edge,elongated,epidermal,except,exserted,farinose,few-rayed,filament,flower,free,fruit,fruiting,glabrescen,glabrescent,glabrous,globose,granular-punctate,group,hair,half,high,lackin,lanceolate,lateral,leaf,lengthening,lobe,lobed,lon,long,long-decurrent,longitudinal,m.,main,many,margin,midrib,mm,multangulate,narrowly,nearly,oblong,older,ovate-lanceolate,overlapping,pedicel,petiole,plurifoliate,pore,poricidal,porrect-stellat,porrect-stellate,present,prominent,pseudoterminal,pubescence,pubescent,purple,rarely,relatively,scabrous,sessile,short-,shrub,side,simple,slit,small,somewhat,soon,spaced,sparingly,sparse,spherical,stalk,stellate,stem,stigma,stipitate-glandular,stout,streak,strongly,style,sub-lenticular,subcampanulate,surface,terete,thick,thin,thin-textured,time,tip,tomentose,touching,translucent,tree,tube,unarme,unit,upper,usually,vein,violet,way,white,whitish,wide,x,yellow,yellowish,yellowish-tomentose,young	-5.3,0.2-0.5,0.8-1.4,0.8-3.1,1.2-1.4,1.3-1.4,1.3-1.7,1.7-2.7,2.8-4.2,5.2-6.2,6.6-20,alyx,apart,apparently,articulated,closely,cylindrical,eaf,earl,eed,elliptic,entire,especially,evident,inserted,lower,nflorescence,obovoid,open,orangish-tan,orolla,peduncle,perfec,rachi,reportedly,reticulate-punctate,ripe,ruit,runk,short,splitting,stage,stamen,suture,tamen,tan,ud,vary,ympodial	abaxiall,adaxiall,color,count,description,ellipti,glabrou,globo,habitat,height,inflorescence,length,major,mentioned,minor,obovoi,orangish-ta,ovary,position,prickle,primary,reticulate-punctat,rip,scabrou,scar,seed,shape,size,stone,structure,sympodial,ta,texture,trunk,width,wing
207	wfo-0001028227	success	236	203	176	60	27	0.746	-2/3,-6.2,.5-4,0-250,0.1,0.2-0.3,0.2-0.5,0.3,0.4,0.5,0.8,0.8-1.4,0.9,1-1.7,1-2.5,1-4.2,1.2-2,1.3-4,1.4,1.4-2.6,1.5-2.3,1.7-2.8,1.9-4.2,1.9-5.8,1/2,10-24,11-15,2-12,2-3.8,2.5-7.8,2.6-5.9,2.9-4.7,3.7-6.3,4-13,4.8-7.6,5-7.5,6-16,8.5-22,abaxial,abaxially,acuminate,acute,adaxially,age,along,anther,anthesi,apex,appressed,around,attenuate,axillary,bark,base,berry,blade,blunt-tipped,branched,brown,brownish,bud,c.,calyx,cm,corolla,cuneate,dark,decurrent,deltoid,dendritic-echinoid,diameter,directed,distally,drying,echinoid,edge,elliptic,elongate,farinose,filament,fleshy,flower,free,fruit,fruiting,glabrescent,glabrous,globose,granular-tomentose,gray,grayish,green,hair,lacking,lanceolate,lateral,leaf,lengthening,less,lobe,lobed,long,longitudinal,main,many,margin,midrib,midvein,mm,mostly,multangulate,oblong,oblong-lanceolate,obscured,obtuse,occasionally,older,orangish-tan,orbicular,ovate-lanceolate,overlapping,pale,pedicel,petiole,plurifoliate,pore,poricidal,porrect-stellate,present,pseudoterminal,pubescence,purple,quarter,reticulate-punctate,ripe,rounded,scabridulous,sessile,shrub,side,simple,slightly,slit,somewhat,stalk,stem,stigma,stout,style,subcampanulate,sublenticular,subspherical,sulcate,surface,suture,thick,thin,time,tip,tomentose,touching,tree,tube,unit,upper,usually,vein,velutinous,violet,way,well,wide,x,yellow,yellowish,young	0.2,0.2-0.4,0.7-2.1,0.9-1.2,0.9-1.4,1,1.1-3.1,1.9,1/2-3/4,10,3-4.9,3.7-7,6.7-15,8.1-18,accrescent,ag,alyx,apart,apparently,articulated,becoming,blunt-tippe,branch,closely,cylindrical,eaf,early,echinoi,eed,ength,entire,exserted,high,inserted,lon,lower,m.,nflorescence,often,orolla,ovate-orbicula,peduncle,perfec,prominent,pubescent,rachi,relatively,ruit,runk,spaced,sparsely,stamen,stellate,tamen,thicker,tomentu,ud,unarme,vary,ympodial	cell,color,count,habitat,height,inflorescence,length,major,mentioned,minor,ovary,ovate-orbicular,position,prickle,primary,scar,seed,shape,size,stone,structure,sympodial,texture,tomentum,unarmed,width,wing
208	wfo-0001028228	success	143	142	117	26	25	0.818	.5,0.1-1.7,1-1.5,1.1-1.2,1.1-2.5,1.2-1.8,1.5-2,1.8-3.4,10-30-flowered,2,2-5,2-8,2.1-4.2,2.8-6.5,3/4,6-7,6-8,7.5-12.5,abruptly,acute,age,anther,anthesi,apex,area,bark,base,becoming,beginning,beneath,berry,brown,calyx,campanulate,closely,cm,coriaceous,corolla,dark,deflexed,deltoid,dia,difoliate,dry,elliptic,erect,exserted,filament,free,fruiting,glabrous,globose,green,greenish-yellow,impressed,lateral,leaf,lobe,lobed,long,main,major,margin,material,minor,minute,minutely,mm,narrowing,obovate,occasionally,older,opposite,ovary,overlapping,ovoid,ovoid-reniform,pair,pale,papillose,pedicel,petiole,planar,portion,prominent,reticulate,rounded,scar,shining,shrub,simple,slender,slightly,small,spaced,stem,stigma,straight,style,surface,tall,tapering,terminal,thick-margined,thickened,tip,tree,tube,unit,usually,vein,way,weight,white,woody,x,young	0.75,ba,caly,clavate,distal,eaf,edicel,eed,fragrant,geminat,inflorescenc,lon,lower,middle,nflorescence,pore,poricidal,ruit,shaped,shinin,styl,sweetly,tear-drop,ud,widest,ympodial	bud,cell,color,count,diameter,flower,fruit,geminate,habitat,height,inflorescence,length,null,position,prickle,primary,seed,shape,size,stone,structure,sympodial,texture,width,wing
209	wfo-0001028263	success	156	147	107	49	40	0.686	0.25,1-2,1-3,1-4,11-13,11-23,14-44,2,2-3,2-4,2.6,3,4,5-7,6,8-14,9,abaxially,acumen,acuminate,acute,adaxially,apex,apical,apically,atenuate,base,branched,broadly,calyx,cell,cm,conical,connate,cordate,corolla,covering,cuneate,cyme,darker,deep,dehiscent,diameter,dichasial,dichasially,distal,dorsally,ebracteate,edge,elliptical,exceeding,filament,flat,flower,folded,forked,green,green-white,half,herbaceous,interjected,introrse,lateral,leaf,leaflet,light,lobe,long,make,maturing,medium,mm,monochasial,mucilaginous,oblique,odd-pinnate,often,ovate,ovoid,pedicel,perennial,petiole,plant,poricidally,puberulent,pubescent,rotate,seed,sessile,short,size,slit,stamen,stigma,straight,strigose,style,testal,thick,throughout,tuber-bearing,typically,unit,violet,wall,wide,yellow	3-6-foliat,3.4,3.5-4.2,4-5,5-7.5,6-8,8-1.,abaxiall,articulate,digestion,diminishing,eaf,eed,emoval,enzyme,equal,first,generally,globo,gradually,hair-like,honeycomb,living,lon,lower,lunat,nflorescence,nther,orolla,pair,pattern,peduncle,perfect,plan,proximal,reveal,ruit,seudostipule,specimen,tal,tem,terminal,throughou,toward,truncate,two,vary,ympodial,Â¼	'hair-like,3-6-foliate,anther,anthesi,bark,bud,color,count,free,fruit,fruiting,globose,habitat,height,inflorescence,length,major,margin,mentioned,minor,ovary,position,prickle,primary,scar,shape,stem,stone,structure,surface,sympodial,tall,texture,tip,tube,vein,wet,width,wing,young
210	wfo-0001028280	success	87	103	65	22	38	0.747	.5,1-2,1.5-2.7,2-2.5,2-3,6-9,7-8,acuminate,almost,anthesi,apex,arching,attenuate,axil,bark,base,branch,closely,cm,completely,dark,decurrent,elliptic,flattened,fruiting,glabrous,globose,green,immature,known,lanceolate,lateral,leaf,main,margin,mm,narrowly,new,older,onto,opposite,pair,papillae,pedicel,pendant,petiole,present,rounded,scar,shrub,simple,small,somewhat,spaced,stem,surface,tall,tip,ultimate,unit,vein,winged,woody,x,young	0.7-1,1-2-flowered,ape,berry,brow,ciliate,dia,eaf,eed,know,lon,long,lower,middle,minutely,nflorescence,ruit,sessil,ud,unifoliat,widest,ympodial	anther,brown,bud,calyx,cell,color,corolla,count,diameter,filament,flower,free,fruit,habitat,height,inflorescence,length,lobe,major,minor,ovary,position,prickle,primary,seed,sessile,shape,size,stigma,stone,structure,style,sympodial,texture,tube,unifoliate,width,wing
211	wfo-0001028281	success	267	122	109	158	13	0.408	+,-1,-45,-5,0.1-0.15,0.15-0.2,0.2-0.5,0.3-1,0.5-1,0.7-,0.7-1.2,0.75-1,0.8-1,1-1.5,1.1-1.4,1.1-2.4,1.7-2.5,10-30,2-13,2-4,2-locular,2.5-,20-30,3-foliate,6,6-15,abaxial,abaxially,adaxial,anther,articulation,basiscopically,calyx,capitate,cell,cm,column,conical,corolla,dark,decurrent,deep,densely,diameter,distal,dry,eglandular,elongate,elongate-triangular,filament,flower,free,fruit,fruiting,glandular,globose,golden,green,hair-like,half,imparipinnate,inflorescence,internode,interrupted,large,lateral,leaf,lobe,long,margin,material,midvein,mm,narrowly,obovate,once-branched,outgrowth,ovary,pale,paler,pedicel,peduncle,petiole,petiolule,portion,primary,pubescent,rachi,shrub,small,sparsely,sprawling,staminal,stem,stigma,stripe,style,surface,testa,tip,trichome,tube,uniseriate,unit,vein,vine,wall,wide,yellow	-0.9,-10,-20,-3,-36,-7,-8,.2,.4,.5,0.05-0.4,0.2-0.3,0.2-0.7,0.3-0.5,0.5-,0.5-0.6,0.5-0.7,0.5-1.1,0.5-1.2,0.7-2.5,1,1-,1-3,1-5,1.0-1.6,1.2-1.5,1.2-1.6,1.4-4,1.5-2,1.5-6,10-18,2-4-celled,2-6.5,2.1-3.0,3-16,3-5,3-8.5,5-8-celled,7-30,absent,acuminate,acute,almost,alternate,anthesi,apex,apical,appearance,appendage,appressed,arising,autogamous,axi,base,bent,berr,blade,bract,bracteate,branching,broadly,brown,composed,covering,darker,decreasing,developed,doubly,eaf,edicel,eed,either,elliptic,enclosing,entire,exerted,exserted,extended,form,fragile,generally,giving,glabrous,gland,gree,hal,halfway,head,included,interjected,largest,leaflet,less,like,lon,longest,lower,medial,minute,mixture,multi-celled,multi-cellular,multicellular,nflorescence,node,oblique,occasionally,opposite,orbicular,other,ovate,pair,patent,point,population,present,primarily,probably,proximal,pseudostipule,regularly,rest,rotate,ruit,secondary,serrat,serrate,sessile,set,shorter,silky,size,smaller,smooth,sometimes,sparser,sterile,stiff,straight,strongly,subopposite,tem,terminal,tertiary,thick,thin,three,toward,transparent,type,ud,unicellular,usually,weak,weak-walled,well,winged,ympodial	bud,color,habitat,height,length,position,scar,seed,shape,structure,sympodial,texture,young
212	wfo-0001028317	success	204	163	136	68	27	0.667	-1.5,-5,/5,0.1-0.3,0.3-1,0.5-3.5,0.6-1.2,0.6-1.5,0.8-1.1,0.8-2.5,1-1.3,1-3,1-4,1.1-1.9,1.4-2,1.8-2.5,1/3-1/4,1/4-2/3,1/5,2-4,2-4.5,2.5-6.5,3-10,3-4,3-5,4-6,5-8,6-10,abaxially,acute,almost,anther,apart,apex,apically,apparently,bark,base,berry,blade,branched,bright,brown,calyx,chartaceous,cm,concolorous,cream,cuneate,curved,dark,deltate,densely,diameter,difoliate,drying,dull,elongating,erect,filament,filiform,flattened-reniform,flower,free,fruit,fruiting,glabrous,gray,green,herb,herbaceous,lanceolate,lateral,leaf,length,lobe,lobed,long,longer,lower,margin,marking,mature,maturity,mauve,mm,moderately,oblong,obtuse,one,open,orange-brown,ovate,pair,pale,pedicel,petiole,poricidal,prickle,prickly,primary,purple,red,reflexed,scandent,scar,shrub,simple,sometimes,spaced,sparsely,spherical,spreading,stellate,stellate-pubescent,stem,straight,style,surface,tapering,terete,terminal,time,tip,toward,truncate,tube,unit,upper,vein,way,white,wide,yellow,yellow-green,young	0,0-1,0-5,0.1,0.1-0.25,0.1-0.4,0.3-0.4,0.6-0.8,1/,2-2.8,2.8-3.3,2/3,4-5-merous,4-8,absent,acuminat,alyx,apar,articulated,broad-deltate,brow,distance,eaf,eed,equal,extending,eye,geminat,hair,infructescence,midpoint,midvein,minute,naked,nflorescence,older,orolla,oung,peduncle,pendulous,per,perfec,pericarp,porrect,portion,prickl,ray,reduced,rounded,ruit,sessile,shorter,side,smooth,stalk,stalked,subsessile,tamen,tertiary,translucent,trichome,unarme,unarmed,variously,vary,venation,visible,ympodial	1/2,acuminate,anthesi,bud,cell,color,corolla,count,geminate,habitat,height,inflorescence,major,minor,null,ovary,position,seed,shape,size,stigma,stone,structure,sympodial,texture,width,wing
213	wfo-0001028323	success	164	164	136	28	28	0.829	-2,0.2-0.5,0.2-1,0.4-1.3,0.5,0.5-1,0.8,0.9-1.2,1,1-1.2,1-1.5,1-2,1.1-4.5,1.5,1.5-2.5,2-3,2-9,3,3-5,3-6,3.5-4,5-6,7.5-9,abaxially,absent,along,anther,anthesi,apart,apex,appressed,articulated,bark,base,berry,blue-green,brown,c.,calyx,cell,cm,conical,corolla,cup-shaped,dark,deltate,dendritic,densely,diameter,drying,ellipsoid,elliptic,erect,fading,filament,flower,free,fruiting,glabrescent,glabrous,globose,grey,growth,included,inflorescence,internodal,lanceolate,leaf-opposed,lengthening,less,like,lobe,lobed,longer,main,margin,maturity,minute,minutely,mm,new,occasionally,ovary,ovate,ovoid,pair,pale,papillose,pedicel,peduncle,peg,petiole,pitted,planar,pore,poricidal,primary,proceed,pubescent,reddish,remaining,scar,scattered,shiny,shoot,short,shrub,simple,sinus,small,sometimes,somewhat,soon,sparely,sparsely,splitting,stem,stigma,straight,style,surface,tearing,testal,tip,trichome,tube,tuft,uniseriate,unit,vein,violet,wall,way,white,woody,x	0.6-1,abscissio,acute,apparently,attenuate,ba,capiatate,coriaceous,eaf,eed,entire,fleshy,glabrescen,lower,nflorescence,papillat,perfect,pericarp,plurifoliat,portion,revolute,rounded,ruit,soft,thick,thin,ud,ympodial	abscission,bud,capitatate,color,count,fruit,habitat,height,lateral,leaf,length,major,minor,null,papillate,plurifoliate,position,prickle,seed,shape,size,stone,structure,sympodial,texture,width,wing,young
214	wfo-0001028329	success	215	192	164	51	28	0.763	.75-2,.75-5.75,/10-3/10,0-100,0.2-0.3,0.8-1.1,0.8-1.4,0.9-1.3,1-6,1.1-2.5,1.3-1.8,1.3-2,1.5-2.3,1.5-2.75,1.5-3.5,1.5-8,10-34,2-4,2.2-3.9,2.6-5,2.75-4.5,3-14,3-8,3.75-7,3/4,4-15,5-10,6-8,6-9,7-19,abaxially,acuminate,acute,adaxially,anther,anthesi,apex,articulated,asperous,axillary,bark,base,becoming,berry,blade,blunt-tipped,branched,brown,bud,calyx,chartaceous,cm,conical,continued,corolla,cylindrical,deltoid,dendritic-echinoid,diameter,dichotomously,distantly,distinct,due,echinoid,filament,finely,fleshy,flower,free,fruit,glabrous,granular,granular-tomentose,gray,green,growth,hair,high,honeycombed,lateral,leaf,length,lobe,lobed,long,long-attenuate,main,margin,midvein,minutely,mm,moderately,mostly,multangulate,obelliptic,oblong,obovate,obtuse,occasional,older,orbicular,ovate,ovate-elliptic,pale,pedicel,peduncle,petiole,plurifoliate,porrect-stellate,present,pseudo-terminal,pubescent,rachi,rather,receptacle,reniform,reticulate-punctate,ripe,sessile,several,short-,short-stalked,shrub,side,simple,slightly,small,sometimes,spaced,sparse,sparsely,stalked,stellate,stelliform,stem,stigma,style,subglobose,suborbicular,swollen,testa,thick,thickened,time,tomentose,touching,toward,tree,tube,turning,unarmed,unit,usually,vein,velutinous,vestigial,way,white,whitish,wide,x,yellow,yellowish,young	.5-3,1.0-1.4,12,2-3,4-5,6-11,absen,ag,angled,apart,apical-lateral,apparently,axe,ba,branch,closely,dehiscing,dendritic-echinoi,eaf,eed,entire,glabrescen,grooved,inserted,introrse,large,lengthening,longitudinally,lower,multangulat,nflorescence,obscured,orolla,perfect,pore,relatively,ruit,runk,sessil,slit,stellat,stellate-pubescent,stellate-rotate,subcapitat,suture,tamen,thin,tomentu,unarme,vary,ympodial	absent,cell,color,count,fruiting,habitat,height,inflorescence,major,mentioned,minor,ovary,position,prickle,primary,scar,seed,shape,size,stone,structure,subcapitate,surface,sympodial,texture,tip,width,wing
215	wfo-0001028337	success	195	167	143	52	24	0.733	-2,-2.5,-4,.5,.8,/3,0.1-0.3,0.3-0.5,0.4-0.7,0.4-0.8,0.7-0.9,0.7-1,1-1.8,1-2,1-3,1.5-3,1.5-4,1.8-2,1/2,1/8-1/4,15-50,2-2.2,2-4,3-4,4-5,5-6,5-8,6-7,8-10,8-14,abaxial,abaxially,adaxial,anther,apart,apex,apically,apparently,bark,base,berry,blade,branched,calyx,cm,color,conical,connivent,cuneate,curved,dark,deltate,densely,diameter,elongating,erect,evenly,eye,filament,flattened-reniform,flower,free,fruit,fruiting,gently,glabrescent,glabrous,glaucous,gray,gray-brown,green,green-brown,hair,inflorescence,juvenile,known,lateral,leaf,length,lobe,lobed,long,long-styled,longer,margin,marking,mature,mauve,minutely,mm,moderately,naked,narrow-oblong,one,open,orange-brown,pale,pedicel,petiole,pitted,poricidal,porrect,porrect-lepidote,prickle,prickly,primary,ray,reddish,reflexed,rounded,scar,sessile,shallowly,shrub,simple,slender,smooth,spaced,sparse,spherical,stellate,stellate-pubescent,stem,stout,straight,style,surface,tapering,terete,terminal,time,tip,toward,trichome,tube,unarmed,unit,vein,visible,way,white,wide,young	-6,0,0.05-0.15,0.05-1,1,1/3-2/3,1/4-1/3,11-16,5-25,5-merous,acut,alyx,apar,ape,articulated,chartaceous,discolorous,drying,eaf,eed,entire,equal,fused,glabrou,infructescence,juvenil,lower,midpoint,nflorescence,occasionally,older,orolla,oung,peduncle,per,perfect,pericarp,plurifoliat,portion,ruit,shoot,short,short-styled,shorter,small,staminate,strongly,tamen,unarme,usually,vary,ympodial	acute,anthesi,bud,cell,corolla,count,habitat,height,major,minor,null,ovary,plurifoliate,position,seed,shape,size,stigma,stone,structure,sympodial,texture,width,wing
216	wfo-0001028339	success	195	172	148	47	24	0.759	.5,0.05-0.1,0.8-1.2,1-1.5,1-2,1-5,1.1-1.4,1.2-1.5,1.5-2,1.7-3.2,10-30-flowered,10.2-18.5,2.5-5,3.4-5.5,3.5-4,5-7,5.8-7.9,7-11,8-10,8182,acuminate,acute,anther,anthesi,apex,appearance,appearing,appressed,attenuate,bark,base,becoming,beneath,berry,blue,broadly,brown,bud,calyx,capitate,carinate,closely,cm,connate,corolla,covered,crystalline,cuneate,cup-shaped,dark,decurrent,densely,difoliate,dried,dry,enclosed,epidermi,erect,evenly,exserted,filament,flattened,floccose,flower,free,fruiting,glabrate,glabrous,globose,grainy,greyish-brown,growth,irregular,large-celled,later,lateral,leaf,like,little,lobe,lobed,long,long-triangular,main,major,margin,minor,minutely,mm,mustard,nearly,oblique,opposite,ovary,ovate,ovoid,ovoid-reniform,papillate,papillose,pedicel,petiole,pitted,planar,pore,poricidal,pulp,red-brown,reflexed,scar,schwarz,shaped,shining,shrub,simple,size,slightly,small,somewhat,spaced,sparsely,specimen,stem,stigma,strong,strongly,style,surface,tall,tear-drop,texture,tightly,tip,tree,trichome,tube,uniseriate,unit,urceolate,vein,white,white-speckled,wide,winged,woody,x,yellow,yellowish,young	1-1.2,1.5,43191,5-angled,across,almost,carpel,deflexed,dia,differing,distinctly,eaf,edicel,eed,fide,filiform,first,frui,geminat,leave,lon,lower,middle,nee,nflorescence,obscure,occasionally,older,one,overlappin,papery,portion,proximal,ruit,secondary,septum,slender,speckled,straight,tapering,tub,ud,venation,white-lenticellat,white-papillo,widest,ympodial	10-30,cell,color,count,diameter,fruit,geminate,habitat,height,inflorescence,length,overlapping,position,prickle,primary,seed,shape,specified,stone,structure,sympodial,white-lenticellate,width,wing
217	wfo-0001028351	success	175	148	106	69	42	0.606	.2,.8,0,0.2,0.5,0â,1.0â,1.0â1.6,1.0â2.5,1.5â4.0,1.6â,10,2,2.0â5.0,2â4,40,5.0,abaxially,absent,acute,adaxially,along,annual,anther,anthesi,apex,base,becoming,blade,blue,branching,brown,calyx,capitate,cell,clavate,cm,colour,connivent,densely,diameter,erect,filament,flattened,fleshy,flower,fruit,glabrous,glandular,globose,green,hair,herb,lanceolate,leaf,like,lobe,long,margin,midvein,mm,moderately,multicellular,narrowly,number,oblong,occasionally,opposed,ovate,pale,pedicel,perennial,perfect,petiole,pitted,plurifoliate,present,probably,pubescent,shallowly,shiny,simple,slender,smaller,stem,stigma,stone,style,surface,time,truncate,tube,unbranched,unicellular,uniseriate,unit,unknown,velutinous,white,wide,wing,winged,woody,x,young,â3.0	.8â1.0,0.1,0.6,1.0â2.0,1.4â1.5,2.0â2.5,2.1â3.5,2/3,2â2.5,3,3.4â5.0,3â4,4,5,5.0â5.5,5.5â10.5,5â7,6.5â8.5,6â12,8â15,adaxiall,ag,apart,apical,articulated,axe,ba,basal,chartaceous,convex,cylindrical,directed,distally,eaf,eed,equal,geminat,indumentum,lamin,lobed,lon,longitudinal,lower,m.,nfloresence,obtuse,opening,orolla,pair,peduncle,pentagonal,pore,regularly,ruit,serrate,shaped,side,slit,spaced,sparsely,straight,tal,tamen,tardily,teardrop,tem,vary,ympodial,â	.8-1.0,1.4-1.5,2-2.5,2-4,2.0-2.5,2.1-3.5,3.4-5.0,5.5-10.5,6.5-8.5,8-15,bark,bud,color,corolla,count,free,fruiting,geminate,habitat,height,inflorescence,lamina,lateral,length,major,mentioned,minor,ovary,position,prickle,primary,scar,seed,shape,size,structure,sympodial,tall,texture,tip,vein,width
218	wfo-0001028353	success	177	141	125	52	16	0.706	0.2-0.4,0.5,0.5-,1,1-2,1-4,1.5-2,1.5-5,2,2-3,2-4,3,3-5,4-7,6-8,7,8-10,abaxially,accrescent,acute,along,anther,anthesi,apart,apex,area,base,beneath,berry,bright,calyx,capitate,cell,centre,cm,conical,corolla,cup-shaped,dark,deep,deeply,densely,diameter,difoliate,dry,drying,ellipsoid,elliptic,emarginated,exerted,filament,fleshy,flower,free,fruiting,glabrous,globose,green,greenish,growing,herb,heteromorphic,hollow,honey-comb,inserted,internodal,leaf,less,like,lobe,long,margin,material,midrib,minute,minutely,mm,nodding,often,open,outline,ovary,ovoid,pair,pale,papery,papillate,papillose,pedicel,petiole,pitted,plump,primary,principal,pubescent,purple,reddish,rhomboid,ripe,scar,scattered,sessile,shallow,short,simple,sleeve,slightly,sparsely,stem,stigma,straight,strongly,style,surface,testal,tip,trichome,tube,uniseriate,unit,vein,wall,wrinkled,x,yellow	.5,/3,0.9-1.2,1.4-2,age,becoming,bluntly,campanulate,ciliate,clasping,coarsely,cordate,curved,decreasing,decumben,distally,eaf,edicel,eed,erect,fracturing,frui,geminat,gree,horn,horned,lengthening,lon,lower,m.,nflorescence,peduncle,pericarp,plant,point,pore,poricidal,portion,ruit,sessil,size,slender,slit,somewhat,tan,thin,toothed,toward,truncate,ud,way,ympodial	bud,color,fruit,geminate,habitat,height,inflorescence,length,mentioned,position,seed,shape,structure,sympodial,texture,young
219	wfo-0001028390	success	147	148	106	41	42	0.721	.5-3.3,0,0.5,0.5-1.5,1,1-2.5,1-3,1.5-2,1.5-3.5,1.5-5.5,10-15,2,3-4,4-11,4-5,5-7,7-8,abaxially,acute,adaxially,angled,apex,apiculate,axe,base,blade,branched,calyx,cell,chartaceous,cm,connivent,cuneate,curled,cylindrical,deltate,dendritically,dendritically-branched,dense,densely,diameter,divided,eglandular,elliptic,felty-pubescent,flower,forked,glabrous,gland,globose,hair,lanceolate,leaving,less,like,lobe,long,margin,midvein,mixed,mm,moderately,mostly,narrowly,obtuse,occasionally,often,orange,ovate,pedicel,peg,perfect,petiole,pseudohair,puberulent,pubescent,rarely,ripe,scar,short,shrub,simple,slightly,small,sparsely,stalked,stigma,stone,style,subclavate,subcordate,time,tip,triangular,truncate,tube,unbranched,unequally,unit,usually,violet,white,white-pubescent,wide,x,yellow	-10,0.5-1,0.5-2.5,1-5,2.5,3-5,6-many-foliat,7,9,absen,adaxiall,aggregate,apart,articulated,directed,distall,eaf,eed,entire,lon,lower,near,nflorescence,nther,orolla,peduncle,pore,presen,pubescen,rachi,radiu,ruit,spaced,ste,stellate,subcapitat,subcoriaceous,tal,tem,vary,ympodial	6-many-foliate,absent,anther,anthesi,bark,bud,color,corolla,count,explicitly,filament,free,fruit,fruiting,habitat,height,inflorescence,lateral,leaf,length,major,mentioned,minor,ovary,position,present,prickle,primary,seed,shape,size,stem,structure,subcapitate,surface,sympodial,tall,texture,vein,width,wing,young
220	wfo-0001028405	success	149	141	101	48	40	0.678	0.4-0.5,1-4,1.5-6.5,10-11,2,2-2.5,2-3,2-4,3-20,3-4,4-11.5,4-6,6-7,7-14.5,abaxially,acumen,acute,adaxially,apex,apical,apically,apiculate,articulate,base,branched,calyx,cell,cm,conical,connate,corolla,covering,cyme,decurrent,dehiscent,diameter,dichasial,dichasially,distal,dorsally,ebracteate,edge,elliptic,elliptic-lanceolate,exceeding,filament,flat,flower,folded,forked,generally,green,hair-like,half,herbaceous,introrse,lanceolate,lateral,leaf,lobe,long,make,maturing,mm,monochasial,mucilaginous,oblique,oblong,odd-pinnate,often,ovate-elliptic,ovoid,pedicel,perennial,petiole,plant,poricidally,proximal,puberulent,rachi,seed,short,short-petiolate,size,slit,stamen,stellate,stigma,style,subsessile,testal,thick,throughout,tuber-bearing,typically,unit,wall,wide,without,yellow,Â¼	0.5-3,1-9,1.3-8,3-6-foliat,3.5-10,3.5-6.5,8-15,9-15,absen,attenuate,digestion,diminishing,eaf,eed,emoval,enzyme,globo,gradually,green-white,honeycomb,interjected,leaflet,living,lon,lower,lunat,nflorescence,nther,orolla,pair,pattern,peduncle,perfect,plan,reveal,ruit,seudostipule,short-acuminate,specimen,straight,tal,tem,terminal,throughou,toward,vary,whit,ympodial	3-6-foliate,anther,anthesi,bark,bud,color,count,free,fruit,fruiting,globose,habitat,height,inflorescence,length,major,margin,mentioned,minor,ovary,position,prickle,primary,scar,shape,stem,stone,structure,surface,sympodial,tall,texture,tip,tube,vein,wet,white,width,wing,young
221	wfo-0001028429	success	162	141	101	61	40	0.623	0.2-0.4,0.8-1.2,1-4,1.5-3,1.5-4,10-11,10-27,10.5-21,2-3,2.5-12,2.5-7.5,2.7-3.6,3-6,5-12,6-18,6-28,7-7,abaxially,acumen,acuminate,acute,adaxially,apex,articulate,base,branched,broadly,calyx,cell,cm,connate,cordate,corolla,covering,cuneate,cyme,darker,diameter,dichasial,dichasially,distal,dorsally,ebracteate,elliptical,especially,filament,flat,flower,folded,forked,generally,glabrescent,glabrous,globose,green,green-white,greenish,hair,half,herbaceous,lateral,leaf,light,lobe,long,long-attenuate,make,medium,mm,monochasial,mucilaginous,narrowly,odd-pinnate,ovate,ovoid,pedicel,peduncle,perennial,petiole,plant,proximal,scattered,seed,size,slightly,spot,stigma,style,testal,thick,throughout,tuber-bearing,typically,unit,vein,violet,wall,white,wide,yellow,Â¼	0.9-2.3,1-2.5,2-1.,2-4,2-8,2.5-4,3-6-foliat,4-14,abaxiall,apical,apically,dehiscent,digestion,diminishing,eaf,edge,eed,emoval,enzyme,exceeding,globo,gradually,hair-like,honeycomb,interjected,introrse,leaflet,living,lon,lower,lunat,maturing,nflorescence,nther,oblique,obovate,often,orolla,pair,pattern,pentagonal,perfect,petiolule,plan,poricidally,reveal,rotate,ruit,seudostipule,short,slit,specimen,stamen,straight,tal,tem,terminal,throughou,toward,vary,ympodial	'hair-like,2-19,3-6-foliate,anther,anthesi,bark,bud,color,count,explicitly,free,fruit,fruiting,habitat,height,inflorescence,length,major,margin,mentioned,minor,ovary,position,prickle,primary,scar,shape,stem,stone,structure,surface,sympodial,tall,texture,tip,tube,wet,width,wing,young
222	wfo-0001028436	success	150	152	117	33	35	0.78	.5,0.2-0.4,0.5,0.5-1,0.8-1.5,1-2,1-3,1.5,1.5-2,1.5-2.5,10-20,1st,2-3,2-4,2.5-3,2nd,4,5-10,5-12,5-15,5-8,8-12,abaxially,absent,abundant,acute,adaxially,anther,apex,apically,appearance,appearing,axe,base,berry,beyond,brown,calyx,cell,center,cm,connected,decurrent,deflated,dehiscent,diameter,difficult,dm,dried,due,edge,elliptic,explosively,exserted,filament,fine,flower,fruit,fruiting,geniculate,glabrous,globose,hair,interpetalar,leaf,like,linear,linear-lancolate,lobe,margin,membranaceous,mm,moderately,nearly,notch,oblong,often,older,parallel,pedicel,peduncle,per,petiole,placenta,pointing,presence,pubescent,rachi,radiating,raised,ridge,rotate,running,shallow,small,sparsely,stamen,stem,stigma,structure,style,surface,swollen,taproot,tear,thick,tissue,triangular,tube,two-celled,unbranched,unifoliate,unit,white,woody,wrinkled,x	1-2-celled,7,adaxiall,along,blade,chartaceous,ciliate,cordat,eaf,eed,entire,evaluat,flat,frui,glabrescen,lengt,long,lower,lying,much-branched,nflorescence,orolla,oung,pubescen,reaching,rhizomatous,ruit,shrub,tal,tamen,vary,wid,ympodial	anthesi,bark,bud,color,cordate,corolla,count,evaluate,free,glabrescent,habitat,height,inflorescence,lateral,length,major,mentioned,minor,ovary,position,prickle,primary,scar,seed,shape,size,stone,sympodial,texture,tip,vein,wide,width,wing,young
223	wfo-0001028465	exception_thrown	159	0	0	159	0	0.0		0.75,1-2,1-4,1.2-2,1.5-2.9,10,10-24,11-23,2,2-3,2-4,2-6,2-9.3,2.4-2.8,2.5-4,3-4,3-5,3-6-foliat,3-8,3.8-7,4-1.,4-8,4.5-5.5,5-7,7-15,8-10,9-19,abaxially,acumen,acuminate,acute,adaxially,apex,apical,apically,articulate,attenuate,base,branched,broadly,calyx,cell,cm,connate,corolla,covering,cuneate,cyme,decurrent,dehiscent,diameter,dichasial,dichasially,digestion,diminishing,distal,dorsally,eaf,ebracteate,edge,eed,elliptical,emoval,enzyme,equal,exceeding,filament,first,flat,flower,folded,forked,generally,globo,globose,gradually,green,green-white,hair-like,half,herbaceous,honeycomb,interjected,interpetalar,introrse,lateral,leaf,leaflet,living,lobe,lon,long,lower,lunat,make,maturing,medium,mm,monochasial,mucilaginous,nflorescence,nther,oblique,odd-pinnate,often,orolla,ovoid,pair,pattern,pedicel,peduncle,perennial,perfect,petiole,petiolule,plan,plant,poricidally,proximal,puberulent,pubescent,purple,rachi,rarely,reveal,rotate,ruit,seed,sessile,seudostipule,short,size,slit,specimen,spot,stamen,stigma,straight,strigose,style,tal,tem,terminal,testal,thick,throughout,tissu,toward,tuber-bearing,two,typically,unit,vary,wall,white,wide,yellow,ympodial,Â¼	
224	wfo-0001028468	success	255	210	179	76	31	0.702	-10,-3,-4,-5.5,-7,.1-0.2,.1-0.3,.1-0.4,.2-0.4,.3,.3-0.4,.5-1.5,.5-1.6,/10-1/5,0.05,0.1,0.2-0.3,0.4-1,0.4-4,0.7-2.5,0.8-3.5,1.2-1.5,1.3-2,1.5-2.2,1.5-3.1,1.6,1/3-1/2,1/5-1/2,16,2,2-9,2.5-4,20,3-4,4-6,5-21,5-9,6-9,abaxially,accrescent,acuminate,acute,adaxially,along,anther,apex,appressed,armed,articulated,attenuate,base,becoming,blade,blue,broad-based,brown,bud,calyx,campanulate,clavate,cm,commonly,compressed,corolla,dark,decreasing,densely,density,diameter,distal,distally,distantly,dry,ellipsoid,equal,extra-axillary,filament,flattened,flower,foveate,fruit,fruiting,glabrescent,gradually,gray,green,greenish,hair,half,increasing,interpetalar,lateral,laterally,length,light,lobe,lobed,long,longer,main,margin,midpoint,midvein,mixed,mm,moderately,mostly,multangulate,narrowly,oblique,oblong-lanceolate,orange,ovate,overlapping,ovoid,pale,pedicel,per,petiole,porrect-stellate,prickle,pubescence,purple,ray,recurved,reduced,relatively,reticulate,rhombic,sessile,short,short-,short-stalked,shrub,side,similar,slightly,somewhat,spaced,sparsely,specimen,stalk,stellate-pubescent,stelliform,stem,stigma,straight,style,subacuminate,subcapitate,subchartaceous,subcuneate,subelliptic,subglobose,sublenticular,subreniform,subsessile,subshrub,surface,terete,testa,thick-stalked,thicknes,time,tissue,touching,toward,tube,unarmed,unbranched,unifoliate,unit,usually,vein,way,wide,x,yellowish,young	-1.3,.2,.5,.6-1,/4-1/3,0.2-0.6,0.2-1.5,0.5-2,0.5-3,0.5-3.3,0.5-3.5,0.5-8,0.6-1.2,0.6-2,1,2.2-3,2.8-4.1,2/3-3/4,4-9,6-10,apart,ark,axe,berry,beyond,broadly,bu,c.,cauline,central,chartaceous,compresse,connivent,d.,directed,eaf,eed,exserted,geminat,glabrous,inserted,introrsel,lamin,lower,m.,minutely,multangulat,nflorescence,oblong-conical,obtuse,occasionally,older,orangish,orolla,pair,papillo,peduncle,perfect,pore,proximal,pubescent,rachi,rotate-stellate,ruit,shallowly,similarly,simple,stamen,tal,tamen,thick,triangular,upper,vary,yellow,ympodial	anthesi,bark,cell,color,count,dm,free,geminate,habitat,height,inflorescence,lamina,leaf,major,mentioned,minor,ovary,position,primary,scar,seed,shape,size,stone,structure,sympodial,tall,texture,tip,width,wing
225	wfo-0001028470	success	185	143	111	74	32	0.6	0.25-0.75,1-2,1-3,1.6-3.2,11.8-21,12-44,2-7,2-8,2.1-3.9,3-10,3.5-16,3.5-7,5.5-11.6,6-33,abaxially,acumen,acute,adaxially,anther,apex,apparently,asymmetric,attenuate,axillary,base,basiscopic,berry,brownish,bud,cell,clavate,cm,condition,corolla,covering,dark,deep,diameter,distal,dorsally,dot,drying,edge,elliptic,filament,flat,flower,folded,forked,fresh,fruit,generally,glabrescent,glabrous,green,greenish,hair,hair-like,half,herb,lanceolate,lateral,leaf,leaflet,light,lobe,long,make,medium,mm,mottled,mucilaginous,odd-pinnate,ovate,ovoid,pedicel,perfect,petiole,petiolulate,plant,plurifoliate,pubescent,purple,ripe,rounded,seed,short,side,size,sometimes,stigma,style,subtending,tall,terminal,testal,thick,tip,tissue,tri-,tube,typically,unit,unwinged,usually,wall,wet,white,whitish,wing,x	0-18,0.9-2.2,0.9-2.3,1-12.3,1.5-2.8,2-10,2-5,3-5,3.2-5.5,4-6,4-7,5-merou,adaxiall,ag,alyx,apart,articulated,axe,blade,capitat,chartaceous,connivent,decreasing,digestion,eaf,eed,end,enzyme,erec,exceeding,geminat,glabrou,green-white,hal,high,homostylous,honeycomb-shaped,interjected,lengthening,living,lower,nflorescence,one,orbicular,orolla,pair,peduncle,pentagonal,placed,pore,poricidal,removed,ruit,scarce,sessile,seudostipule,slit,spaced,specimen,stamen,stolo,straight,subequal,subglabrou,substellate,tamen,tem,throughout,toward,tuber,vary,wide,yellow,ympodial	anthesi,bark,calyx,capitate,color,count,free,fruiting,geminate,habitat,height,inflorescence,length,major,margin,mentioned,minor,ovary,position,prickle,primary,scar,shape,stem,stone,structure,surface,sympodial,texture,vein,width,young
226	wfo-0001028476	success	246	160	135	111	25	0.549	-16,-6,-8,.05-0.1,0.15-0.2,0.2-0.5,0.25-0.5,0.3-0.7,0.4-0.6,0.5,0.8-1.2,1,1-1.5,1-2,1-2-celled,1-4,1-6,1-celled,1.1-1.6,1.8-2.5,12-30,2-foliate,3-foliate,3.5-13,4-celled,6-,7-10,8-30,abaxially,abundant,acuminate,acute,along,anther,anthesi,apex,appearance,axi,base,basiscopically,bifurcate,branched,bright,calyx,capitate,cell,cm,conical,corolla,curved,dark,diameter,elongate,especially,filament,flower,fortaleza,fruit,fruiting,give,glandular,globose,green,hair-like,head,herb,imparipinnate,incurved,inflorescence,interrupted,lanceolate,lateral,leaf,less,like,lobe,long,margin,maturity,minute,minutely,mixed,mm,narrowly,oblique,obovate,outgrowth,ovary,pedicel,perennial,petiole,population,primary,puberulent,pubescence,pubescent,purple,rarely,reflexed,regularly,rest,rounded,rÃ­o,scattered,short,silky,simple,slightly,sparsely,sprawling,stem,stiff,stigma,straight,stripe,style,surface,tall,testa,tip,toward,trichome,truncate,tube,unicellular,uniformly,uniseriate,unit,usually,vein,wall,white,wide,woody,yellow	-1,-20,.5,0-,0-0.5,0.1-0.15,0.1-0.4,0.15-0.4,0.2-0.3,0.2-0.6,0.25-0.4,0.3-0.4,0.3-0.5,0.3-1.2,0.4-0.5,0.4-1.5,0.5-0.6,0.5-1.7,0.7-2.5,0.8-1.6,1-1.2,1-1.4,1.1-1.5,1.2-2.5,2,2-6,2-locular,2.4-3,3-12,3-7,5-15,absent,acroscopically,age,almost,also,alternate,ape,apical,appendage,articulated,basal,becoming,bifurcation,bract,bracteate,brown,column,decurrent,deeply,diamete,distal,eaf,ebracteate,edicel,eed,elliptic,entire,exserted,first,glabrescent,gradually,gree,hal,half,hyaline,interjected,internode,irregularly,largest,leaflet,lobed,lon,lower,main,midvein,nflorescence,node,numerous,occasionally,often,pair,pale,peduncle,petiolule,present,prominent,pseudostipule,rachi,recurve,ruit,secondary,sessile,set,sinus,smaller,spreading,staminal,stellate,sterile,subopposite,tem,terminal,tertiary,thick,ud,unpaired,weak-walled,wid,winged,ympodial	bark,bud,color,count,explicitly,free,habitat,height,length,major,mentioned,minor,position,prickle,scar,seed,shape,size,stone,structure,sympodial,texture,width,wing,young
227	wfo-0001028481	success	194	168	139	55	29	0.716	.1,.5,0.1-0.2,0.5-1,0.6-1,0Â°,1-2,1-4,1.5,1.5-2,1.8-2.5,2-3,2.5-3,3,3-4,3-4.5,3-6,5.5-7.5,acuminate,acute,age,almost,anther,anthesi,apex,apically,attenuate,bark,base,branch,branched,brown,canaliculate,chartaceous,clavate,clearly,cm,colour,conical,corolla,cuneate,cupular,deeply,delineated,deltoid,dendritic,dendritic-pubescent,density,diameter,different,discolorous,divided,drying,elliptic,equal,evenly,except,extent,eye,faint,filament,flaking,flexuous,flower,free,glabrous,green,increasing,known,lamina,leaf,length,lengthening,less,liana,like,linear,lobe,long,long-acuminate,longitudinally,main,margin,midvein,mm,mostly,naked,narrowly,oblique,oblong,often,orange-brown,ovate,pair,pedicel,petiole,pore,poricidal,portion,primary,pubescent,ray,reddish,ribbed,ridged,scar,shortly,shrub,side,simple,sinus,size,slender,smoothly,sparsely,spreading,stem,stigma,style,surface,tearing,terminal,thickly,tip,toward,trichome,tube,unarmed,uneven,unit,unknown,vein,venation,visible,white,wide,x,yellowish,young	.3,0-2,0.15,1-1.4,1-3,1/2-2/3,3-3.5,8,abaxially,absent,adaxially,along,alyx,apar,apparently,articulated,close,dilated,distributed,domatia,dorsifixed,dry,eaf,eed,ellipsoi,entire,erect,extending,flat,know,lobed,lon,longer,lower,m.,nflorescence,nther,occasional,orolla,peduncle,perfec,plurifoliat,protruding,rachi,raised,ruit,see,small,smoot,stump,tertiary,together,ud,vary,ympodial	bud,calyx,cell,color,count,description,ellipsoid,fruit,fruiting,habitat,height,inflorescence,lateral,major,mentioned,minor,ovary,plurifoliate,position,prickle,seed,shape,smooth,stone,structure,sympodial,texture,width,wing
228	wfo-0001028482	success	224	200	175	49	25	0.781	.1,.5,/3,0.2,0.5-1,0.7-1.1,00,1-1.5,1-11,1-2,1-4,1.1-5,1.5-3,10,2-3,2-celled,3-12,3-4,4-5,5-25,6-50,7-14,abaxially,acuminate,acute,adaxially,age,alternate,angled,anther,anthesi,apex,apiculae,ascending,asymmetric,bark,base,becoming,berry,bilobed,branched,bright,broadly,brownish,bud,calyx,campanulate,capitate,channeled,chartaceous,closely,cm,corky,corolla,corrugated,creamy,cucullate,cymose,deciduous,deflexed,deltate,densely,diameter,diffusely,difoliate,distally,distinct,dry,drying,eaf,ellipsoid,elliptic,emarginate,enlarged,exfoliating,expanding,filament,flattened-reniform,fleshy,flower,free,fresh,fruit,fruiting,glabrous,glandular,globose,golden,green,growth,hard,impressed,incrassate,individual,internodal,investing,keeled,leaf-opposed,lengthening,less,lobe,lobed,long,margin,materia,material,maturity,midrib,minute,minutely,mm,new,obovate,olive,ovary,pair,pale,pedicel,petiole,pitted,pore,poricidal,primary,pubescent,reddish,row,scandent,scar,shaped,shiny,short,simple,size,slightly,slit,small,sometimes,somewhat,soon,spaced,stem,stigma,style,subcoriaceous,subglobose,subpyramidal,surface,tan,tear-drop,tightly,tiny,tip,transparent,transversely,tree,trichome,truncate,tube,tuberculate,tuft,twice,two,unifoliate,uniseriate,unit,vegetative,vein,way,white,woody,x,yellow,yellowish,young,Âµm	0,0.5,0.5-5,1.2-1.6,1.5-2,basal,berr,bifid,bifurcate,brochiodromous,circinate,constriction,coriaceous,curved,discolorous,eed,embryo,entire,exerted,geminat,glabrou,grayish,halfway,heterostylous,irregular,lower,markedly,midvein,nflorescence,nodding,occasionally,overlappin,papillat,peduncle,pentamerous,per,pericarp,petal,portion,revolute,ruit,sparsely,stout,straight,tub,ud,usually,venation,ympodial	cell,color,count,geminate,habitat,height,inflorescence,lateral,leaf,length,major,minor,null,overlapping,papillate,position,prickle,seed,shape,stone,structure,sympodial,texture,width,wing
229	wfo-0001028487	success	195	167	135	60	32	0.692	0-9,0.3-0.7,0.4-1.5,0.9-3,1-2,1-3,1-3.2,1.7-7,10-41,15-28,2-4,2-4.8,2-6,2.5-3.5,3-10,3-19,3.4-7.8,4-7,4.6-13.6,7.8-16.4,abaxially,acumen,acuminate,acute,adaxially,along,anther,apex,arranged,asymmetric,attenuate,axillary,base,basiscopic,bead,berry,blade,brownish,bud,cell,central,clavate,cm,condition,connivent,coriaceous,corolla,covering,dark,deep,diameter,distal,dorsally,drying,eaf,edge,elliptic,filament,flat,flower,folded,forked,fresh,fruit,generally,glabrescent,glabrous,green,green-white,greenish,hair,hair-like,half,herb,lanceolate,lateral,leaf,leaflet,light,like,lobe,long,make,medium,mm,moniliform,mucilaginous,multiple,narrow,necklace,odd-pinnate,orbicular,ovate,ovoid,pedicel,petiole,petiolulate,plant,plurifoliate,purple,ripe,rounded,scabrous,scarce,seed,sessile,short,side,size,sometimes,star,stigma,stolon,style,subtending,tall,terminal,testal,thick,throughout,tip,tissue,tri-,tube,tuber,typically,unit,unwinged,usually,wall,wet,white,whitish,wing,x	1.1-1.5,1.4-1.7,10-4.3,3-4,3-5,5-6,5-merou,adaxiall,ag,alyx,apart,apparently,articulated,axe,capitat,considerably,decreasing,digestion,eed,enzyme,erec,exceeding,geminat,glabrou,hal,high,homostylous,honeycomb-shaped,interjected,lengthening,living,lower,nflorescence,orolla,pair,peduncle,pentagonal,perfect,pore,poricidal,removed,ruit,second,seudostipule,slit,smaller,spaced,specimen,stamen,straight,subequal,subglabrou,substellate,tamen,tem,toward,vary,wide,yellow,ympodial	anthesi,bark,calyx,capitate,color,count,free,fruiting,geminate,habitat,height,inflorescence,length,major,margin,mentioned,minor,ovary,position,prickle,primary,scar,shape,stem,stone,structure,surface,sympodial,texture,vein,width,young
230	wfo-0001028489	success	224	202	178	46	24	0.795	-0.6,-2.5,-4,-5,-6,/4,0-10,0-20,0-50,0.1,0.1-0.6,0.2,0.2-0.4,0.2-0.5,0.2-0.6,0.2-0.7,0.3-0.5,0.3-0.7,0.3-1,0.3-1.2,0.4-0.8,0.5-0.8,0.5-1,0.5-1.1,0.5-1.5,0.6-1.2,0.7-3,1-3,1-4,1-6,1-7,1.5-3,1.5-4,1.8-4,1.8-5.5,1/3,1/3-1/2,2-4,2-6,3-7,3.5-6,4-10,4-13,4-8,5-8,7.5,abaxially,acicular,acute,anther,apart,apex,apically,apparently,bark,base,beyond,blade,branched,calyx,cell,chartaceous,cm,concolorous,connivent,cordate,cream,cuneate,curved,dark,deltate,densely,diameter,difoliate,drying,dull,eaf,elliptic,elongating,erect,filament,flattened-reniform,flower,free,fruit,fruiting,geminat,glabrous,gray,green,hair,herbaceous,lateral,leaf,length,less,lobe,long,longer,margin,marking,mature,maturity,mauve,membranous,midpoint,minute,mm,moderately,occasionally,often,older,one,open,orange,orange-brown,orange-green,outline,ovate,pair,pale,pedicel,pendulous,perpendicular,petiole,poricidal,porrect,prickle,prickly,primary,protruding,purple,raised,ray,red-brown,rounded,scar,sessile,shiny,shrub,simple,slender,smooth,sometimes,spaced,sparsely,spherical,spreading,stalk,stellate,stellate-pubescent,stem,straight,style,subsessile,surface,tapering,terete,time,tip,trichome,truncate,tube,unarmed,unit,upper,vein,way,weakly,white,white-gra,wide,woody,yellow,yellow-green,yellow-orange,ympodial,young	-10,0-15,0-3,0.2-,1.8-2.2,1/4-1/2,2-3,2.1-3,5-25,5-merous,alyx,apar,articulated,ba,berry,broad-deltate,caudat,distance,eed,equal,extending,eye,infructescence,lobed,lon,lower,midvein,naked,nflorescence,obtuse,orolla,oung,peduncle,per,perfec,pericarp,portion,ruit,side,tamen,tertiary,toward,unarme,vary,venation,visible	anthesi,bud,caudate,color,corolla,count,habitat,height,inflorescence,major,minor,null,ovary,position,seed,shape,size,stigma,stone,structure,texture,white-gray,width,wing
231	wfo-0001028492	success	130	112	70	60	42	0.538	0.5-1,1-2.5,1.5-3,1.5-6,2-2.5,2-3,2-5,2.5-9,3,6-11,abaxially,acute,adaxially,angled,apex,axi,base,blade,calyx,cell,chartaceous,ciliolate,cm,color,colored,containing,crystal,dark,deltate,diameter,elliptic-ovate,except,forked,fruit,glabrous,globose,hair,herb,leaving,lobe,margin,mm,narrowly,pedicel,petiole,pubescent,punctate,purple,rarely,reticulate,ripe,rounded,scar,shrub,simple,sparse,stigma,stone,style,subcordate,tip,triangular,triangular-ovate,tube,unbranched,unit,white,white-punctate,whitish,x	-5-foliat,0.2-2,1-4,1-5,1.5-2.5,1.75-3.5,15-20,2-4,3-6,4,5-15,5-25-flower,5-8,6-12,8-15,absen,aggregate,apart,apiculate,articulated,axe,connivent,cylindrical,directed,distall,eaf,eed,entire,glabrou,irregularly,long,lower,nflorescence,nther,obtuse,orolla,peduncle,pore,rachi,radiu,ruit,san,sand-punctate,somewhat,spaced,splitting,stellate,subcoriaceous,succulent,tal,tem,time,truncat,unevenly,unknown,vary,veiny,wide,x1-3,ympodial	-5-foliate,1-3,5-25,absent,anther,anthesi,bark,bud,corolla,count,filament,flower,free,fruiting,habitat,height,inflorescence,lateral,leaf,length,major,mentioned,minor,ovary,position,prickle,primary,sand,seed,shape,size,stem,structure,surface,sympodial,tall,texture,truncate,vein,width,wing,young
232	wfo-0001028501	success	195	134	100	95	34	0.513	0-3.2,0-4,0.3-0.7,1-2,1-8,2-4,2.8-18,2.8-4.9,3-10,3-7,3.1-12,6.6-21.1,8-10,8-34,abaxially,acumen,acuminate,acute,adaxially,anther,apex,axillary,base,brownish,bud,cell,clavate,cm,condition,coriaceous,corolla,covering,dark,decurrent,diameter,drying,filament,flower,forked,fresh,fruit,generally,glabrescent,glabrous,green,greenish,hair,herb,lanceolate,lateral,leaf,light,linear,lobe,make,medium,mm,mottled,mucilaginous,narrowly,odd-pinnate,onto,orbicular,ovate,ovoid,pedicel,petiole,plant,plurifoliate,purple,pyriform,rachi,ripe,scarce,seed,sessile,short,simple,size,sometimes,spot,stigma,style,subtending,tall,terminal,testal,thick,tip,tri-,tube,unit,unwinged,usually,wall,wet,white,whitish,wing,x	0-3,0.3-3.3,0.6-5.8,0.8-1.6,0.8-1.7,1,1-3,1.8-10.7,13-41,2-5,3-5,3.1-10.4,4-8,4.8-18,5-merou,adaxiall,ag,along,alyx,apart,apparently,arranged,articulated,attenuate,axe,bead,berry,blade,broadly,capitat,connivent,considerably,decreasing,digestion,distal,dorsally,eaf,edge,eed,elliptic,enzyme,erec,exceeding,flat,folded,geminat,glabrou,green-white,hair-like,hal,half,high,homostylous,honeycomb-shaped,interjected,larger,leaflet,lengthening,like,living,long,lower,moniliform,multiple,narrow,necklace,nflorescence,orolla,pair,peduncle,perfect,pore,poricidal,present,removed,rotate,ruit,seudostipule,slit,spaced,specimen,stamen,stolon,straight,subglabrou,tamen,tem,throughout,toward,tuber,typically,vary,wide,yellow,ympodial	'hair-like,0-3.3,anthesi,bark,calyx,capitate,color,count,free,fruiting,geminate,habitat,height,inflorescence,length,major,margin,mentioned,minor,ovary,position,prickle,primary,scar,shape,stem,stone,structure,surface,sympodial,texture,vein,width,young
233	wfo-0001028502	success	158	136	110	48	26	0.696	.5,/2,0.5-1,1-2,1.5-2,1.5-2.5,1.5-3,1.5-6,1.6-2.4,2-4,2-5,2-7,2-8,3.5-15,5-15,6-8,abaxial,acute,adaxially,anther,anthesi,apex,bark,base,beige,body,branched,brown,calyx,campanulate,christmas-tree-like,clavate,cm,congested,constricted,corolla,dark,deltate,dendritic,densely,dia,elliptic,erect,fawn,filament,flat,flattened-reniform,fleshy,flower,free,fruiting,glabrous,globose,impressed,incrassate,inflorescence,later,lateral,leaf,light,like,lobe,lobed,long,main,margin,middle,minutely,mm,obovate,older,ovary,pair,papillose,pedicel,petiole,pitted,planar,prominent,pubescent,rest,scar,seed,shining,shrub,small,spaced,stem,stigma,structure,style,surface,tall,terminal,thick,time,tip,tree,tree-like,trichome,tube,unevenly,vein,warty,way,white,wide,widest,woody,young	2-2.5,3.5-4,5-6,?,abaxially,age,along,apar,ba,blade,branch,cazalet,closely,cone,denser,eaf,edicel,eed,exserted,fide,glabrat,heteromorphic,included,inflorescenc,lengthening,lon,long-styled,lower,matted,narrower,nflorescence,often,packed,papillo,plurifoliat,pore,poricidal,portion,reddish-brown,ruit,scattered,short-styled,slit,tub,ud,unclear,within,ympodia	apart,bud,cell,color,count,diameter,fruit,glabrate,habitat,height,length,major,mentioned,minor,plurifoliate,position,prickle,primary,shape,size,stone,sympodial,texture,unit,width,wing
234	wfo-0001028505	success	168	143	121	47	22	0.72	.01,.3,.5,/3,0.25-0.5,0.8-1.5,1,1-3,1.2-2.5,10-14-flowered,10-15,2.5-4.5,3-5,3.5-5,7-8,acuminate,acute,anther,anthesi,apex,barely,bark,basal,base,body,broadly,bud,calyx,cm,conical,corolla,darker,deciduous,decurrent,deflexed,delicate,deltoid,dia,differentiated,difoliate,dry,drying,elliptic,erect,expanded,exsertion,f,filament,free,fruiting,gently,glabrous,globose,greatly,green,grey,incrassate,lateral,leaf,lobe,lobed,long,main,major,margin,minor,minutely,mm,narrowly,obovoid,older,opposite,ovary,ovate,ovoid-reniform,pair,pale,papillose,pedicel,petiole,pitted,pore,poricidal,prominent,pubescent,purple,rounded,scar,seed,shape,shaped,short,shrub,simple,size,slightly,somewhat,soon,specimen,stem,stigma,style,surface,tall,tapering,tear-drop,tip,trichome,truncate,tube,unicellular,uniseriate,unit,usually,vein,way,white,woody,x,yellowish,young	.1,0.8-1,1/3,2,aspect,ba,beneath,berry,black,blade,branch,bright,characteristic,differing,distance,distinct,dried,eaf,edicel,eed,exserted,flattened,geminat,live,lon,lower,m.,materia,material,member,minute,nflorescence,obvious,overlapping,plant,portion,proximal,reflexed,ruit,straight,strongly,tan,touching,ud,whit,widest,ympodial	.8-1,cell,color,count,diameter,flower,fruit,geminate,habitat,height,inflorescence,length,position,prickle,primary,specified,stone,structure,sympodial,texture,width,wing
235	wfo-0001028524	success	236	218	190	46	28	0.805	-2.7,-3,/10-3/10,0-150,0.3,0.6-1.4,1-5,1.1-1.2,1.5-1.6,1.5-3,1.8-2.5,1/3-2/3,10-20,11,2-3.8,2-6,2.5-3.4,2.5-3.8,3-10,3-15,3.3-4,4-6,4-8,6-9,7-10,7-11,8-13,abaxially,accrescent,acuminate,acute,adaxially,along,anther,anthesi,apex,apical-lateral,ascending,axe,axillary,bark,base,becoming,berry,blade,blunt-tipped,branched,brown,bud,calyx,chartaceous,cm,conical,continued,corolla,cream,dark,dehiscing,deltoid,densely,diameter,distal,dm,due,echinoid,elliptic,exserted,extend,ferrugineous,few-,few-rayed,filament,first,fleshy,flower,free,fruit,fruiting,glabrescent,glabrous,granular-tomentose,gray,green,greenish,growth,hair,half,high,honeycombed,indument,interpetalar,introrse,lacking,lanceolate,large,later,lateral,leaf,length,lobe,lobed,long,longitudinal,main,many-rayed,margin,matted,midvein,mixed,mm,multangulate,nearly,oblong,obscured,obtuse,often,orbicular,ovate,ovate-lanceolate,overlapping,pale,partly,pedicel,persistent,petiole,plurifoliate,pore,porrect-stellate,present,probably,prominent,pseudo-terminal,pubescent,rather,ray,relatively,reniform,reticulate-punctate,ripe,rounded,scabridulous,sessile,short,short-stalked,side,simple,slightly,slit,small,somewhat,sparingly,sparsely,stalked,stamen,stellate,stelliform,stem,stigma,stout-stalked,style,subcoriaceous,subglobose,suborbicular,sulcate,suture,terete,testa,thick-stalked,thin,thin-stalked,time,tissue,tomentose,touching,translucent,tree,tube,unarmed,unit,usually,vein,velutinous,warty,way,wide,x,yellow,yellowish,yellowish-green,young	.5-1,0.3-0.8,0.5-3.5,1.2-1.3,2.5-4,2.8-3.5,3-4.3,3.4-3.6,4.3-6,6-7,9-14,ag,apart,apparently,articulated,ba,branch,capitat,closely,eaf,echinoi,eed,entire,glabrescen,inserted,lanceolat,late,lower,m.,midvei,nflorescence,older,orolla,peduncle,perfect,rachi,ruit,runk,spaced,strongly,tamen,thick,tomentu,unarme,vary,ympodial	age,capitate,cell,color,count,habitat,height,inflorescence,major,minor,null,ovary,position,prickle,primary,scar,seed,shape,size,stone,structure,surface,sympodial,texture,tip,tomentum,width,wing
236	wfo-0001028525	success	257	231	207	50	24	0.805	.25,.4,0.2-0.3,0.2-0.6,0.5,0.5-1.5,0.5-2.5,0Â°,1-1.5,1-2,1-2.5,1-4,1.1-1.7,1.2-1.6,1.5,1.5-3,10,10-13,1mm,2,2-2.5,2-3,2.5-5,3,3-7,4,4-15,4-5,4-7,6,7,7-13,7.5,accrescent,acuminate,acute,age,almost,along,alternate,anther,anthesi,apart,apex,apically,around,articulated,attenuate,bark,base,becoming,berry,black,branch,branched,branching,broadly,brown,calyx,capitate,centre,chartaceous,clavate,clearly,cm,conical,cordate,corolla,cup,dark,deeply,delineated,deltoid,dendritic,dendritic-pubescent,densely,density,developed,developing,diameter,dilated,discolorous,divided,dorsal,drying,elongated,entire,equal,eye,fewer,filament,fine,flattened,flexible,flexuous,flower,form,forming,free,frequently,fruit,fruiting,glabrescent,glabrous,green-brown,grey,increasing,inside,lateral,leaf,lengthening,less,liana,light,like,linear,lobe,lobed,long,longer,longitudinally,loop,loose,lumpy,margin,mature,mauve,membranous,midvein,minute,mm,much,multicellular-dendritic,naked,narrowly,obconical,oblong,obscuring,often,one,orange-brown,outside,ovate,ovoid,pair,partly,pedicel,peduncle,pendulous,petiole,pore,poricidal,primary,puberulous,pubescent,pyriform,rachi,ray,red-brown,ridged,rounded,scar,scattered,sessile,shrub,side,sinus,size,slender,slightly,small,smaller,smooth,sometimes,sparsely,spheroidal,spreading,stem,stigma,stripe,structure,stump,style,surface,tangling,tearing,terete,terminal,tertiary,tip,toward,trichome,truncate,tube,unarmed,uneven,unit,vein,venation,visible,weakly,white,whitish,wide,wider,x,young	1/3-3/4,3-5,alyx,apar,apice,apparently,axil,brachyblast,clum,clustered,curved,detaching,domatia-like,dorsifixed,eaf,eed,ellipsoi,erect,fertilisation,flat,formed,frui,known,lamina,laterally,leave,lower,m.,main,nflorescence,nther,orolla,overlapping,perfec,pericarp,plurifoliat,portion,prominent,protruding,ruit,simple,smoot,somewhat,soon,thick,thin,ud,vary,well-developed,ympodial	bud,cell,clump,color,count,ellipsoid,habitat,height,inflorescence,length,major,minor,ovary,plurifoliate,position,prickle,seed,shape,specified,stone,sympodial,texture,width,wing
237	wfo-0001028528	success	155	146	116	39	30	0.748	.5,0.9-1.2,1-2,1.5,1.8-2,2-3,2-4,2.5-3,3.5-6,3/4,4-5,4-6,6-10,6-7,8-9,acuminate,acute,adaxially,age,along,anther,anthesi,apex,attenuate,bark,base,becoming,bi-lobed,blackish,branch,branching,calyx,cm,conical,coriaceous,corolla,decurrent,dendritic,densely,denser,diameter,elliptic,erect,except,exserted,filament,flattened,flower,fork,free,fruiting,glabrous,glandular,globose,growth,impressed,later,leaf,lobe,lobed,long,margin,midvein,minute,minutely,mm,mucronate,narrowly,obovate,occasionally,older,outline,ovary,pair,pedicel,petal,petiole,pitted,planar,plurifoliate,pore,poricidal,pubescent,pyramidal,reddish-brown,revolute,round,scar,secondary,shiny,short,shrub,slit-like,sparsely,stem,stigma,strongly,style,surface,tall,terminal,time,tip,triangular,trichome,tube,unit,vein,violet,way,white,wide,winged,woody,x,young	1.1-1.2,3.5-4,?,abaxial,absent,adaxial,apical,ba,basal,berry,dichasia,eaf,edicel,eed,ew,glabrat,immature,inserted,leave,like,lower,m.,nflorescence,nodding,papillo,per,pericarp,portion,prominent,ruit,sleeve,somewhat,stamen,ste,tapering,thin,tub,ud,ympodial	abaxially,bud,cell,color,count,dichasial,fruit,glabrate,habitat,height,inflorescence,lateral,length,major,mentioned,minor,new,papillose,position,prickle,primary,seed,shape,size,stone,structure,sympodial,texture,width,wing
238	wfo-0001028529	success	164	155	129	35	26	0.787	.2,0.1,0.5,0.5-2,0.8-1.3,0.8-3,0.8-3.2,1,1-1.2,1-1.5,2.5-3,2/3,3-40-flowered,3-5,5-6,6-9,7-8,8-14,across,acuminate,acute,age,anther,anthesi,apart,apex,apiculate,attenuate,bark,base,becoming,berry,bluish,brown,bud,calyx,capitate,cast,cm,corolla,course,dark,decurrent,deltoid,dia,erect,evenly,exfoliating,exserted,filament,flower,free,fruiting,furcate,glabrous,globose,green,growing,hyaline,internodal,lanceolate,lateral,leaf,less,lobe,lobed,long,main,major,metallic,minor,minute,minutely,mm,narrowly,nearly,oblanceolate,occasionally,older,opposite,ovary,ovoid-reniform,pair,paler,papillae,papillose,pedicel,petiole,pitted,planar,pore,poricidal,present,prominent,reflexed,river,scar,scattered,shape,shaped,short,shrub,simple,size,slender,slightly,small,smooth,somewhat,soon,spaced,stem,stigma,style,subshrub,surface,tall,tapering,tear-drop,tip,tube,vein,way,white,winged,woody,x,yellowish,young	1.5,beginning,beneath,close,cork,deflexe,distal,eaf,edicel,eed,ellipsoi,elliptic,heterostylous,hrub,immature,indistinct,inflorescenc,lenticellat,linear,lon,lower,middle,much,nflorescence,one,papillo,portion,range,ruit,species,straight,ud,umbonate,variable,widest	cell,color,corky,count,deflexed,diameter,ellipsoid,fruit,habitat,height,inflorescence,length,lenticellate,margin,mentioned,position,prickle,primary,seed,stone,structure,sympodial,texture,unit,width,wing
239	wfo-0001028532	success	186	127	93	93	34	0.5	0-19,0.2-1,1-1.7,1-2,1-3,1-5,15-36,2-3,2-8,2.2-4.2,3-10,3-7,5.5-15,6.5-9.2,7.5-15.2,abaxially,acumen,acuminate,acute,adaxially,anther,apex,attenuate,base,brownish,bud,cell,clavate,cm,condition,corolla,covering,dark,deep,diameter,distal,drying,filament,flower,forked,fresh,fruit,generally,glabrous,globose,green,greenish,half,herb,lanceolate,lateral,leaf,linear,lobe,long,make,medium,mm,mucilaginous,odd-pinnate,ovate,ovoid,pedicel,pentagonal,petiole,petiolulate,plant,plurifoliate,purple,ripe,rotate,rounded,seed,size,sometimes,spot,stigma,style,tall,terminal,testal,thick,tip,tri-,tube,unit,unwinged,usually,wall,wet,white,whitish,x	1-1.6,1.3-8.7,1.4-1.6,17-42,2-6,3-5,3.3-4.4,3.9-5,4-7,5-9,5-merou,abaxiall,ag,along,alyx,apart,apparently,arranged,articulated,asymmetric,axe,axillary,basiscopic,bead,berry,blade,capitat,chartaceous,connivent,decreasing,digestion,dorsally,eaf,edge,eed,enzyme,erec,exceeding,flat,folded,geminat,glabrou,green-white,hair-like,homostylous,honeycomb-shaped,interjected,larger,leaflet,lengthening,like,living,lower,middl,moniliform,mottled,multiple,necklace,nflorescence,orbicular,orolla,ovate-lanceolate,pair,peduncle,perfect,pore,poricidal,removed,ruit,second,sessile,seudostipule,side,slightly,slit,spaced,specimen,stamen,stolon,straight,subequal,subtending,symmetric,tamen,tem,throughout,tissue,toward,tuber,typically,vary,yellow,ympodial	'hair-like,anthesi,bark,calyx,capitate,color,count,free,fruiting,geminate,habitat,height,inflorescence,length,major,margin,mentioned,minor,ovary,position,prickle,primary,scar,shape,stem,stone,structure,surface,sympodial,texture,vein,width,wing,young
240	wfo-0001028547	success	224	198	176	48	22	0.786	-1/2,-13,-3,-6,.2,.5,.7,.8,/2,0,0-1,0-10,0-15,0-2,0-30,0-5,0.05-0.15,0.1-0.2,0.15,0.2-0.35,0.3-0.4,0.5-,0.7-1,0.8-1,1-2,1-2.5,1-4,1-5,1.5-2.5,1.7-2,1/3,1/5-1/4,10-12,2-1.5,2-2.5,2-4,2-6,3.5-4.5,4-5,4-6,6-8,7-10,7-9,abaxial,abaxially,absent,acute,adaxial,anther,apart,apex,apically,apparently,appearing,bark,base,berry,blade,branched,branching,bright,bulbous,calyx,cell,chartaceous,cm,conical,connivent,cuneate,curved,deltate,densely,diameter,discolorous,distance,drying,eaf,elongate,elongating,entire,extending,faint,filament,flattened,flattened-reniform,flower,free,fruit,fruiting,gently,glabrescent,glabrous,gray-brow,inflorescence,lateral,leaf,length,lobe,lobed,long,long-acuminate,long-styled,longer,margin,mature,maturity,mauve,midpoint,midvein,mm,moderately,narrow-deltate,oblong,often,older,one,open,orange,ovate,pair,pedicel,peduncle,pendulous,petiole,plurifoliat,poricidal,porrect,prickle,prickly,primary,purple,ray,red,reddish,reflexed,rounded,scandent,scar,sessile,shallowly,shrub,side,simple,slender,sometimes,somewhat,spaced,spherical,spreading,stalk,stalked,stellate-pubescent,stem,straight,style,subsessile,surface,tapering,terete,terminal,tertiary,time,tip,trichome,truncate,tube,unit,vein,venation,villous,wide,woody,yellow-green,yellow-orange,ympodial,young	/5,1.2-1.4,2.5-2.8,2.8-3.2,3-5,5-merous,alyx,apar,ape,articulated,cream,dark,dull,eed,equal,erect,glabrou,green,infructescence,lon,lower,marking,nflorescence,occasionally,orange-brown,orolla,oung,outline,pale,per,perfect,pericarp,pit,portion,prickl,raised,ruit,short-styled,small,smooth,staminate,stellate,tamen,thin-acuminat,usually,vary,way,yellow	anthesi,color,corolla,count,gray-brown,habitat,height,major,minor,null,ovary,position,seed,shape,size,stigma,stone,structure,texture,thin-acuminate,width,wing
241	wfo-0001028587	success	178	160	137	41	23	0.77	.4,.5,0.3,0.3-1,0.5,0.5-1,0.7-1.2,0.8-1.6,0.8-1.8,0.8-2.9,1-1.3,1-1.5,1-2,1-4,1.3-5.1,1/4,2-5,2.1-6.9,2.5,3-8,6-8,6.5-17.7,8-10,8-10-flowered,abruptly,accrescent,acuminate,acute,anther,anthesi,apex,bark,base,becoming,berry,brown,ca,calyx,closely,cm,coat,corolla,cracking,cup,densely,dia,difoliate,distal,ellipsoid,erect,filament,flower,forming,free,fruit,fruiting,geminate,glabrous,globose,green,greenish-white,impressed,lamina,lateral,layer,leaf,length,like,lobe,lobed,long,long-styled,main,major,minor,minute,minutely,mm,narrowing,nearly,obovate,obovoid,often,older,open,opposite,outer,ovary,ovate,ovoid-reniform,pair,paler,papillose,pedicel,peeling,persistent,petiole,pitted,puberulent,pubescent,pubesent,reflexed,scar,scattered,seed,short,shrub,simple,slender,spaced,sparsely,stem,stiff,stigma,straw-colored,style,subumbellate,surface,tall,terminal,thickened,thin,tip,triangular,trichome,tube,umbonate,unicellular,uniseriate,unit,usually,vein,white,wide,woody,x,young	.75,0,across,baseflower,chartaceou,deflexed,degree,different,drying,eaf,edicel,eed,geminat,keeled,lon,lower,middle,midrib,nflorescence,obe,occasionally,overlappin,papillo,per,pore,poricidal,portion,pubescence,ruit,slightly,slit-like,straight,transversel,two,type,ud,upon,upper,variable,widest,ympodial	bud,cell,chartaceous,color,count,diameter,habitat,height,inflorescence,margin,obtuse,overlapping,position,prickle,primary,shape,size,specified,stone,structure,sympodial,texture,transversely
242	wfo-0001028594	success	142	133	106	36	27	0.746	.5,0.3-1.0,0.8-1.8,1-1.2,1-1.5,1-2,1.5-9,12,12-14,2,3-4,3-6,3-9,5-6,6-20,6-7,abaxially,acuminate,acute,adaxially,along,anther,anthesi,apex,axillary,base,bearing,becoming,black,calyx,cell,climbing,cm,conical,corolla,densely,denser,diameter,drying,ellipsoid,elliptic,epidermal,especially,filament,flattened-reniform,flower,free,fruit,fruiting,glabrous,globose,green,hair-like,herb,immature,inflorescence,lax,leaf,length,lobe,long,margin,maturity,minute,minutely,mm,obtuse,open,orange-brown,ovary,ovate,pair,papillate,pedicel,petiole,planar,primary,projection,pubescent,purple,quit,rectangular,reddish,reflexed,regular,rounded,scar,scattered,simple,slightly,soft,somewhat,sparsely,spreading,stigma,style,surface,time,tip,trichome,tube,uniseriate,unit,vein,violet,x	0-100,1-1.3,1-3,axil,berry,bottle-shaped,capitat,eaf,edicel,eed,exserted,floo,forest,glabrat,inflorescenc,like,lon,lower,nflorescence,noddin,often,pendent,per,portion,rest,ruit,side,smooth,strait,strongly,tem,trailing,tub,ud,unifoliat,ympodial	bark,bud,capitate,color,count,glabrate,habitat,height,lateral,major,minor,nodding,null,position,prickle,seed,shape,size,stem,stone,structure,sympodial,texture,unifoliate,width,wing,young
243	wfo-0001028660	success	204	169	136	68	33	0.667	0.2-1.1,0.3-1.1,0.5-2.8,0.7-4.2,1-2,1.5-2.8,1.5-4,1.5-7.6,2-5,2-6,2-9,20,3-30,3-7,3-9,3.8-13,6,7-10,abaxially,absent,acute,adaxially,along,anther,apex,apparently,attenuate,axillary,base,blade,blue,broadly,bud,cell,chartaceous,ciliate,clavate,cm,condition,connivent,corolla,covering,decumbent,decurrent,densely,diameter,distal,dot,elliptic,entirely,especially,except,filament,flower,forked,fruit,generally,glabrous,globose,greatly,green,green-white,hair,hair-like,half,herb,interjected,lanceolate,lateral,leaflet,less,like,linear,lobe,long,make,margin,membranous,midrib,minutely,mm,mucilaginous,narrowly,oblique,obtuse,odd-pinnate,often,orbicular,ovate,ovoid,pair,pedicel,perfect,petiole,petiolulate,plant,plurifoliate,proximal,puberulent,pubescent,purple,rarely,reduced,ripe,scabrous,scattered,seed,sessile,short,size,sparsely,specimen,stem,stigma,style,subequal,subtending,sunny,tall,terminal,testal,thick,throughout,tinged,tip,tri-,tube,typically,unit,unwinged,usually,wall,wet,white,whitish,x	0-5,0.1-0.3,0.5-5.5,0.8-1,0.9-2.5,1-10,2-11,3-5,4-6,5-8,5-merou,acumen,ag,alyx,apart,articulated,axe,berry,borne,brownish,capitat,digestion,dorsally,drying,eaf,edge,eed,end,enzyme,erec,exceeding,flat,folded,fresh,geminat,glabrou,greenish,homostylous,honeycomb-shaped,lengthening,living,lower,middl,nflorescence,orolla,peduncle,pentagonal,petiolule,pore,poricidal,removed,rotate,ruit,seudostipule,singly,slit,spaced,stamen,ste,stolo,straight,substellate,tamen,tem,tuber,vary,yellow,ympodial	anthesi,bark,calyx,capitate,color,count,erect,free,fruiting,geminate,habitat,height,inflorescence,leaf,length,major,mentioned,minor,ovary,position,prickle,primary,scar,shape,stone,structure,surface,sympodial,texture,vein,width,wing,young
244	wfo-0001028667	success	129	120	84	45	36	0.651	-2.6,0.4-0.7,1-1.5,1-2-1.5,1-4.5,1-6,1.3-2,3-11,5,5-20,8-10,acute,anthesi,apex,appearing,axillary,base,branch,branched,calyx,cell,climbing,clustered,cm,completely,conical,corolla,creamy,deciduous,diameter,dry,ellipsoid,elliptic,exfoliating,flattened,flower,fruiting,glabrous,growth,inflorescence,irregularly,leaf,like,lobe,long,margin,midrib,minutely,mm,narrowly,new,occasionally,older,other,outer,pedicel,petiole,pitted,primary,reniform,scar,shiny,shoot,short,simple,slightly,soon,spaced,stem,surface,terminal,tip,triangular,tube,twice,twining,unit,vein,vine,visible,white,woody,wrinkling,x	.5,0.7-4,3,5-merou,aid,alyx,apar,ark,around,articulated,berry,climbin,coriaceous,curling,discolorous,eaf,eed,entire,exfoliatin,exserted,fide,fragrant,lower,mentz,nflorescence,orolla,pale,papilla,papillat,peduncle,pendan,per,perfect,plurifoliat,revolute,sleeve,slender,small,straw-colored,strongly,support,tem,ud,yellow,ympodial	4.5,anther,apart,bark,bud,color,count,filament,free,fruit,habitat,height,lateral,length,major,mentioned,minor,ovary,papillae,papillate,pendant,plurifoliate,position,prickle,seed,shape,size,stigma,stone,structure,style,sympodial,texture,width,wing,young
245	wfo-0001028688	success	137	144	114	23	30	0.832	.5,0.4-1,0.5,0.5-0.75,0.5-1,0.5-1.5,0.9-1,1-1.5,1-1.8,1-3,1-5,1.1-1.2,1.4-2.8,2-3,2.2-4.8,5-11,5-6,acuminate,acute,along,anther,anthesi,apex,area,bark,base,beneath,bi-cellular,branch,calyx,cm,corolla,curl-tipped,deciduous,decreasing,deflexed,deltoid,densest,dia,difoliate,elliptic,filament,free,furcate,glabrous,globose,golden,interpetalar,irregularly,known,lanceolate,leaf,like,lobe,lobed,long,major,markedly,membraneous,middle,minor,minutely,mm,near,nearly,occasionally,often,older,opposite,ovary,overtopping,paler,papillose,pedicel,petiole,pilose,planar,pore,poricidal,proximal,pubescent,reddish-brown,scar,shaped,shiny,shoot,shrub,sinus,size,slender,slightly,spaced,sparsely,stem,stigma,style,tall,tapering,tear-drop,terminal,thickened,thin,tip,trichome,tube,uniseriate,unit,usually,vein,white,wide,widest,x,young	across,apar,clavate,densely,differing,eaf,edicel,eed,exfoliatin,exserted,geminat,know,lon,lower,nflorescence,portion,ruit,soon,straight,styl,tub,ud,ympodial	apart,bud,cell,color,count,diameter,exfoliating,flower,fruit,fruiting,geminate,habitat,height,inflorescence,lateral,length,margin,mentioned,position,prickle,primary,seed,shape,stone,structure,surface,sympodial,texture,width,wing
246	wfo-0001028698	success	166	149	110	56	39	0.663	0.3-0.75,1-2,1-4,1-9.8,1.9-4,13-25,2-10,2-3,3-17,3-5,3.5,5-6,5-8,6-27,8-10,9-35,abaxially,acumen,acuminate,acute,adaxially,apex,apical,apically,articulate,base,branched,calyx,cell,cm,conical,connate,corolla,covering,cyme,dark,darker,dehiscent,diameter,dichasial,dichasially,distal,dorsally,dot,ebracteate,edge,ellipsoid,exceeding,filament,flat,flower,folded,forked,generally,green,hair-like,half,herbaceous,introrse,lateral,leaf,light,lobe,long,long-attenuate,make,maturing,medium,minute,mm,monochasial,mucilaginous,oblique,odd-pinnate,often,ovoid,pedicel,peduncle,pentagonal,perennial,petiole,plant,poricidally,proximal,puberulent,pubescent,raised,rotate,seed,short,size,slit,smooth,stamen,stigma,straight,strigose,style,testal,thick,tuber-bearing,typically,unit,usually,violet,wall,white,wide,yellow,Â¼	0-1.,1.8-5,2-4,3-6-foliat,4-14,5-15,6,6-13,abaxiall,broadly,commonly,cuneate,decurrent,digestion,diminishing,eaf,eed,elliptical,emoval,enzyme,equal,first,globo,gradually,green-white,honeycomb,interjected,leaflet,living,lon,lower,lunat,nflorescence,nther,orolla,ovate,pair,pattern,perfect,petiolule,plan,rachi,rarely,reveal,ruit,sessile,seudostipule,specimen,tal,tem,terminal,throughout,toward,two,vary,ympodial	3-6-foliate,anther,anthesi,bark,bud,color,count,free,fruit,fruiting,globose,habitat,height,inflorescence,length,major,margin,mentioned,minor,ovary,position,prickle,primary,scar,shape,stem,stone,structure,surface,sympodial,tall,texture,tip,tube,vein,wet,width,wing,young
247	wfo-0001028716	success	145	132	105	40	27	0.724	.2,.5,0.5,0.6-1.9,0.75,1-2,1.9-5.5,10-40-flowered,11-16.4,2-4,2.2-7.9,2.5-8,3.6-8.8,7-8,8-9,9-10,acuminate,anther,anthesi,apex,asymmetric,bark,base,branched,brown,calyx,cm,corolla,cuneate,dark,decurrent,dia,difoliate,ellipsoid,elliptic,except,fifth,filament,filiform,free,fruit,geminate,glabrous,glandular,hirsute,intermediate,known,lateral,leaf,lengthening,less,like,lobe,lobed,long,main,major,markedly,minor,minutely,mm,much,nearly,node,opposite,orbicular,ovary,ovate,pair,papillose,pedicel,petiole,pore,poricidal,prominent,puberulent,pubescent,raised,remaining,rounded,scar,shape,shaped,shrub,simple,size,slightly,sparsely,stem,strongly,style,tall,tear-drop,tip,triangular,trichome,truncate,tube,two,uniseriate,unit,vein,white,x,young	5-6,across,anisophyllou,apart,appearing,ba,becoming,beginning,beneath,bi-cellular,deflexed,differing,eaf,edicel,eed,evenly,fertilization,inflorescenc,know,lenticellat,lon,long-triangular,lower,middle,nflorescence,often,older,one,pointed,portion,proximal,reflexed,ruit,spaced,stigm,straight,ud,widening,widest,ympodial	10-40,anisophyllous,bud,cell,color,count,diameter,flower,fruiting,habitat,height,inflorescence,length,lenticellate,margin,position,prickle,primary,seed,stigma,stone,structure,surface,sympodial,texture,width,wing
248	wfo-0001028723	success	211	186	156	55	30	0.739	.5,0-0.5,0.2,0.8-1,0.8-2,0Â°,1,1-1.8,1-2.2,1-2.5,10-15,10-16,2-2.5,2-2.7,2-4,2.5,4,4-5,5,5-6,5-7,abaxial,abaxially,acute,adaxially,almost,anther,anthesi,apar,apex,apically,articulated,bark,base,becoming,brachyblast,branch,branched,branching,broadly,brown,calyx,capitate,clustered,cm,common,concolorous,corolla,dark,decurrent,deltoid,dendritic,densely,density,developed,diameter,dilated,domatia,drying,elliptic,entire,except,ey,faint,filament,fine,flat,flexuous,flower,formed,free,frequent,glabrous,gradual,green,increasing,inner,junction,leaf,length,less,liana,like,lobe,long,long-attenuate,longitudinally,main,margin,membranous,middle,midvein,minutely,mm,mostly,multiply,naked,narrowly,obconical,oblong,obovate,obtuse,occasional,orange-brown,outer,ovate,overlapping,pair,pedicel,peduncle,petiole,poorly,primary,prominent,pubescent,rachi,raised,ray,regular,ridged,scar,short,shrub,side,simple,slender,small,sparsely,spreading,stem,stigma,stump,style,surface,surrounding,terminal,tertiary,tip,toward,transition,trichome,tube,tuft,unarmed,uneven,unevenly,unit,vein,venation,visible,white,widely,wrinkled,x,young,youngest	-1.5,.3,1-1.5,1/3-1/2,1/5-1/3,3-4,3.5-4,age,alternate,alyx,another,apice,apparently,clearly,conical,curved,delineated,divided,dorsifixed,eaf,eed,ellipsoi,equal,know,known,lengthening,lobed,lower,m.,much,nflorescence,nther,one,orolla,pale,papillo,perfec,plurifoliat,pore,poricidal,portion,protruding,region,ruit,separated,sinus,smaller,smooth,tearing,tissu,ud,vary,wide,yellow,ympodial	apart,bud,cell,color,count,ellipsoid,fruit,fruiting,habitat,height,inflorescence,lateral,major,mentioned,minor,ovary,papillose,plurifoliate,position,prickle,seed,shape,size,stone,structure,sympodial,texture,tissue,width,wing
249	wfo-0001028736	success	180	166	134	46	32	0.744	0.2-0.4,0.5-1.5,0.5-1mm,0.5-2,1,1-2,1-3,1.5,1.5-3,10-15,2-4,2-5,3-5,3-6,3-8,3.5-5,4-12,4-6,4-9,5-10,5-15,6-13x3-8,6-8,abaxially,absent,accrescent,acute,adaxially,anther,apex,apparently,armed,attenuate,base,berry,blade,brown,calyx,cm,connivent,created,cylindrical,dark,decurrent,densely,diameter,difoliate,discolorous,either,extra-axillary,filament,filiform,flattened,flower,fruit,fruiting,geminate,glabrous,glandular,globose,green,hair,immature,leaf,length,light,like,lobe,lobed,long,major,many,mature,midpoint,midvein,mm,moderately,mottled,multicellular,multiseriate,narrowly,nearly,netlike,obtuse,occasionally,onto,orange,pair,pedicel,per,perfect,petiole,pit,porrect-stellate,prickle,pubescent,purple,rachi,raised,ray,recurved,red,reniform,rhombic,ridge,roselike,shrub,side,simple,slightly,small,sparsely,stalk,stellate,stem,stigma,style,surface,tapering,thin-skinned,triangular,tube,unarmed,unbranched,unicellular,uniseriate,unit,unlobed,vein,white,wide,x,yellow,yellow-white	0.5,0.5-1,1-1.5,1/6,2-7,40-70,5-merou,adaxiall,alyx,apar,apical,axe,beyond,chartaceous,contiguous,cordate,cut,directed,eaf,eed,exserted,frui,glabrou,gree,introsel,less,lower,m.,midrib,nflorescence,occasional,orolla,peduncle,pore,ruit,scanden,sinus,spaced,stamen,ste,tamen,tem,unequa,vary,way,ympodial	anthesi,bark,bud,cell,color,corolla,count,free,habitat,height,inflorescence,lateral,margin,minor,null,ovary,position,primary,scandent,scar,seed,shape,size,stone,structure,sympodial,texture,tip,unequal,width,wing,young
250	wfo-0001028737	success	151	146	107	44	39	0.709	0.2-0.5,0.7-2,1,1-2.5,1-4,1.5-3.5,12-14,16-30,2-3,2-5,2.8-3.5,3-5,4-10,4-9,5-6,6,7-15,abaxially,acumen,acuminate,acute,adaxially,apex,apical,apically,apiculate,articulate,attenuate,base,branched,calyx,caudate,cell,cm,connate,corolla,covering,cyme,decurrent,dehiscent,diameter,dichasial,dichasially,distal,dorsally,ebracteate,edge,elliptic-lanceolate,exceeding,filament,flat,flower,folded,forked,generally,glabrescent,glandular,globose,green,hair-like,half,herbaceous,introrse,lanceolate,lateral,leaf,lobe,long,make,maturing,mm,monochasial,mucilaginous,oblique,oblong,odd-pinnate,often,ovoid,pedicel,perennial,petiole,plant,poricidally,proximal,rachi,seed,sessile,short,size,slit,stamen,stellate,stigma,straight,strongly,style,testal,thick,throughout,tuber-bearing,typically,unit,wall,wide,without,yellow,Â¼	1-6,10,3-4,3-6-foliat,4-6.5,absen,digestion,diminishing,eaf,eed,emoval,enzyme,globo,gradually,green-white,honeycomb,interjected,larger,leaflet,living,lon,lower,nflorescence,nther,orolla,pair,pattern,peduncle,perfect,pinnatifi,plan,reveal,ruit,second,seudostipule,specimen,tal,tem,terminal,throughou,toward,vary,whit,ympodial	3-6-foliate,anther,anthesi,bark,bud,color,count,free,fruit,fruiting,habitat,height,inflorescence,length,major,margin,mentioned,minor,ovary,position,prickle,primary,scar,shape,stem,stone,structure,surface,sympodial,tall,texture,tip,tube,vein,wet,white,width,wing,young
251	wfo-0001028777	success	205	148	121	84	27	0.59	-10,-2.5,-3,-4,.5,.8,0.4-0.8,0.5-1.3,0.7-1.2,0.7-1.3,0.8-1,0.8-2.2,1,1-2,1-2.5,1-3,1.5,1.5-3,1.5-4,1.8-2.5,1/4,1/4-1/2,2-,2.5-3,3,3.5-5,7-11,abaxially,anther,apex,attenuate,bark,base,blade,branched,calyx,cm,connivent,deltate,diameter,elongating,erect,faint,filament,flattened-reniform,flower,free,fruit,fruiting,glabrescent,glabrous,inflorescence,leaf,length,less,lobe,long,long-styled,longer,margin,mature,maturity,mauve,minute,mm,moderately,narrow-deltate,obovate,one,open,orange,orange-brown,ovate,pair,pedicel,petiole,primary,recurved,red-brown,reflexed,retuse,rounded,scar,shoot,short,shrub,simple,small,smooth,sometimes,somewhat,spaced,sparsely,spherical,stellate,stellate-pubescent,stem,strongly,style,surface,tapering,terete,terminal,tertiary,time,tip,tree,trichome,truncate,tube,unarmed,unit,vein,venation,visible,white,whole,wide,wider,woody,young	-12,.9,0-2,0-30,0.1-0.2,0.1-0.3,0.2,0.6-1,2.5,2.5-5,3/4-4/5,4-5-merous,4.5-8,6-10,8,8-15,acuminat,acute,alyx,ame,apar,ape,apically,articulated,berry,briefly,c.,chartaceous,concolorous,curved,dark,deciduou,discolorous,drying,eaf,eed,entire,equal,glabrescen,green,green-brown,infructescence,lengt,lobed,lower,marking,midpoint,multangulate,nflorescence,occasionally,older,orolla,oung,pale,peduncle,per,perfect,pericarp,plurifoliat,poricidal,porrect,portion,present,ray,reflexe,ruit,sessile,short-styled,shorte,shorter,soon,spreading,stalk,stalked,staminate,stout,tamen,unarme,usually,variously,vary,way,yellow-green,ympodial	anthesi,apart,bud,cell,color,corolla,count,habitat,height,lateral,major,minor,null,ovary,plurifoliate,position,prickle,seed,shape,size,stigma,stone,structure,sympodial,texture,width,wing
252	wfo-0001028791	success	257	219	203	54	16	0.79	+,.5,0.05-0.2,0.2-0.3,0.25-0.3,0.3-0.4,0.3-0.5,0.3-0.6,0.4-0.5,0.4-0.6,0.4-0.65,0.45-0.55,0.5,0.6-0.8,0.6-0.9,0.7-1.5,0.8-1,0.8-1.3,1-1.5,1-2,1-2-celled,1-3,1-3-celled,1-celled,1.5-2,1.7-2.1,1.8-3.3,10,100,2-3,2-3.5,2-7,2-7-celled,2-locular,2.8-3.0,20-to,3-,4-15,4-5+,4-celled,5-,5-15,5-22,5-plurifoliate,50-80,8-10-celled,9-30,9-35,abaxially,absent,abundant,acuminate,adaxially,addition,along,anther,anthesi,apex,apical,appearance,appendage,articulated,articulation,basal,base,beneath,border,branched,breaking,brown,bullate,calyx,capitate,cell,clambering,cm,column,conical,corolla,dark,darker,deciduous,deltate,densely,densest,developed,diameter,dichotomously,ebracteate,eglandular,elliptic,elongating,enlarged,entire,exserted,filament,flower,free,fruit,fruiting,give,glabrescent,glabrous,glandular,globose,green,grow,growing,hair-like,half,halfway,head,imparipinnate,internode,interrupted,lamina,large,lateral,leaf,leaving,less,liana,like,lobe,long,many,middle,midvein,minutely,mixture,mm,much,multicellular,near,obovate,occasionally,often,outgrowth,ovary,pale,paler,papillate,pedicel,peduncle,petiole,plant,poorly,primary,protuberance,pseudostipule,pubescence,pubescent,rachi,reflexed,rough,round,sandpapery,scandent,seed,short,shorter,silky,simple,slightly,small,sometimes,sparse,sparsely,spreading,stamen,staminal,stellate,stem,sterile,stiff,stigma,straight,style,surface,testa,thick,thickened,time,tip,touch,transparent,trichome,tube,unicellular,uniseriate,unit,upper,usually,vegetation,vein,vine,wall,white,wide,winged,woody,yellow,â1-2-celled	-0.6,-1.5,-9,0-6,0.05,0.2-0.4,0.2-0.8,0.3-0.8,0.4-1.1,1.5-,1.6-4.5,2.5-4.5,3-4,4-11.5,5-10,absen,acute,ag,basiscopically,berr,broadly,colo.,consistently,eaf,edicel,eed,even,extended,gree,interjected,leaflet,lon,lower,margin,nflorescence,oblique,pair,per,petiolule,present,rest,ruit,secondary,sessile,single,smaller,somewhat,tal,tem,terminal,tertiary,truncate,ud,ympodial	age,berry,bud,color,habitat,height,inflorescence,length,position,scar,shape,structure,sympodial,tall,texture,young
253	wfo-0001028798	success	214	176	148	66	28	0.692	.5-5,0-1,0-60,0.2-0.4,0.9-1.2,1.5-1.8,1/2-2/3,1/20,10,15-19,2-3,2-3.75,2-6,2-7,2.4-4.4,2.5-3.5,2.6-4,3-4,3-5,3.8-4.2,4-5.4,5-8,6-10,6-8,7-8,8-18,abaxially,accrescent,acuminate,acute,adaxially,anther,anthesi,apex,attenuate,axillary,base,becoming,berry,blade,blunt-tipped,boat-shaped,branched,bud,calyx,chartaceous,cm,continued,corolla,curved,decurrent,densely,diameter,distal,dm,downward,due,echinoid,entire,filament,fleshy,flower,free,fruit,fruiting,granular,granular-tomentose,green,greenish,growth,hair,lacking,lanceolate,large,lateral,leaf,length,less,lined,lobe,lobed,long,main,many,margin,midvein,minutely,mixed,mm,multangulate,nearly,oblanceolate,oblong,obovate,obtuse,orbicular,ovate-lanceolate,overlapping,pale,pedicel,peduncle,persistent,persistently,petiole,plurifoliate,porrect-stellate,present,probably,prominent,pseudo-terminal,pubescent,rachi,rather,ray,ripe,rough,rough-granular,semi-ovate,sessile,short,short-stalked,side,simple,slightly,somewhat,sparingly,stalked,stem,stigma,style,subcampanulate,subcoriaceous,subglobose,sulcate,time,tip,tomentose,toward,tube,unarmed,unit,vein,velutinous,way,wide,x,yellow,yellowish	0.5-2,1-3,1-4.5,1-6,1.1-2,2/3,3.3-5.6,5.25-7.5,8.5-13,ag,apart,apical-lateral,apparently,articulated,axe,ba,branch,capitat,conical,cylindrical,dehiscing,eaf,echinoi,eed,exserted,extend,glabrous,hal,high,included,inserted,introrse,irregularly,longitudinal,lower,m.,multangulat,nflorescence,oblanceolat,obscured,often,orolla,oung,perfect,pore,quite,rotate-stellate,ruit,shrub,slit,small,spaced,splitting,stamen,stellate-pubescent,strongly,suture,tamen,thick,tomentu,tomentum,translucent,unarme,unknow,vary,ympodial	bark,capitate,cell,color,count,habitat,half,height,inflorescence,major,mentioned,minor,ovary,position,prickle,primary,scar,seed,shape,size,stone,structure,surface,sympodial,texture,width,wing,young
254	wfo-0001028815	success	196	144	111	85	33	0.566	0.4-0.8,1-2,10-15,14-28,2-4,2-9,22-35,3-4,4-10,5-6,6-10,6-8,abaxially,acumen,acute,adaxially,along,anther,apex,axillary,base,berry,broadly,bud,cell,chartaceous,ciliate,cm,connivent,corolla,covering,cuneate,dark,developing,diameter,distal,elliptic,elliptic-lanceolate,especially,filament,flower,forked,fruit,generally,glabrous,globose,green,green-white,hair,half,herb,lanceolate,lateral,like,lilac-purple,lobe,long,make,margin,medium,membranous,midrib,minutely,mm,mucilaginous,narrowly,obtuse,odd-pinnate,ovate,ovoid,pedicel,petiole,plant,plurifoliate,pointed,puberulent,pubescent,purple,red-purple,ripe,rotate,rounded,rugose,seed,semi-rosette,size,sparsely,splotched,stem,stigma,style,subtending,tall,terminal,terminated,testal,thick,throughout,tinged,tip,tri-,triangular-lanceolate,tube,unit,unwinged,usually,wall,wet,winged,x,young	0.5-1,1-10,1-3.5,1-4,1-5,2-4.5,2.5-6.5,3-5,3-7,5-7,5-merou,7-16,ag,alyx,apart,apparently,articulated,articulation,auriculate,axe,basiscopic,blade,brownish,capitat,condition,decreasing,decurrent,digestion,distinct,dorsally,drying,eaf,edge,eed,enzyme,exceeding,flat,folded,fresh,geminat,glabrou,greenish,hair-like,hal,high,homostylous,honeycomb-shaped,indistinct,interjected,leaflet,lengthening,living,lower,nflorescence,onto,orolla,pair,papillose,peduncle,perfect,petiolulate,pore,poricidal,purpl,rachi,removed,ruit,semi-erec,sessile,seudostipule,short,side,slightly,slit,spaced,specimen,stamen,ste,straight,tamen,tem,vary,whitish,yellow,ympodial	'hair-like,anthesi,bark,calyx,capitate,color,count,free,fruiting,geminate,habitat,height,inflorescence,leaf,length,major,mentioned,minor,ovary,position,prickle,primary,scar,semi-erect,shape,stone,structure,surface,sympodial,texture,vein,width,wing
255	wfo-0001028876	success	127	122	91	36	31	0.717	.5,/4,0.4-1,0.5-2,1-2,1.5-2,1.5-3,2-2.3,3-5,3-8,4-8,5-6,acute,adaxially,along,anther,anthesi,apex,attenuate,bark,base,branched,brown,calyx,capitate,closely,cm,conical,corolla,dark,dendritic,densely,difoliate,ellipsoid,elliptic,filament,flower,free,glabrous,internodal,known,lateral,leaf,like,lobe,lobed,long,long-triangular,main,middle,midrib,minutely,mm,occasionally,opposite,ovary,pair,papillae,papillose,pedicel,petiole,planar,pubescent,rounded,sagittate,scar,shining,shrub,simple,small,spaced,sparsely,speciman,stem,stigma,style,subshrub,surface,tall,tip,trichome,tube,type,uniseriate,unit,vein,way,white,widest,x,young	4-5,abaxial,abaxially,dia,drying,eaf,edicel,eed,geminat,glabrat,golden,hroughout,included,inflorescenc,know,lamina,leave,lower,nflorescence,nodding,older,overlappin,papillo,pore,poricidal,portion,reddish,rest,ruti,shaped,slender,straight,tear-drop,tub,ud,ympodial	0.5,bud,cell,color,count,diameter,fruit,fruiting,geminate,glabrate,habitat,height,inflorescence,length,major,margin,minor,overlapping,position,prickle,primary,provided,seed,shape,size,stone,structure,sympodial,texture,width,wing
256	wfo-0001028883	success	207	201	159	48	42	0.768	0.5â2,0.6,1,1.5â7,1â2,1â6,2,2â3,2â5,3â5,4,5,50,6,6â10,6â12,abaxially,absent,accrescent,acuminate,acute,adaxially,almost,along,anther,antrorse,apex,arched,articulated,ascending,attenuate,axi,base,becoming,berry,blade,branch,brochidodromous,calyx,capitate,cell,cm,common,completely,concolorous,connivent,curved,cyme,dark,decurrent,deltate,densely,diameter,differing,drying,dull,elliptic,erect,exfoliating,eye,filament,flattened,flower,fruit,geminate,glabrescent,glabrous,glandular,globose,green,greenish,growth,head,herb,hilum,hollow,impressed,lateral,leaf,length,less,light,like,lobe,long,margin,membranaceous,midrib,minor,mm,moderately,multicellular,naked,narrowly,new,normally,notably,oblong,obtuse,often,onto,ovate-lanceolate,pedicel,peduncle,per,petiole,plurifoliate,present,primarily,prominent,pubescence,pubescent,rachi,rarely,region,reniform,ripe,rounded,secondary,seed,sessile,shiny,shrub,similar,simple,single,single-celled,size,slightly,small,sometimes,spaced,sparse,sparsely,spreading,stalk,stellate,stem,stigma,style,subopposite,subsessile,surface,swollen,tall,trichome,unbranched,undulate,uniseriate,unit,vein,venation,visible,white,whitish,wide,woody,yellow,Ã	0.3â0.6,0.4â1.2,4â6,5-merou,adaxiall,alyx,antrorsely,apar,ark,brow,capitat,chartaceous,ciliate,circular,coriaceous,cylindrical,directed,eaf,eed,elliptic-ovate,emarginate,entire,equal,frui,geniculat,glabrou,introrsely,longitudinal,lower,lying,nflorescence,older,opening,orolla,parallel,pendan,perfect,pore,poricidal,ruit,shap,slit,straight,subapical,tamen,tem,vary,ympodial	--,0.3,0.4,0.5,1.2,1.5,10,12,3,7,anthesi,apart,bark,brown,bud,color,corolla,count,free,fruiting,geniculate,habitat,height,inflorescence,major,null,ovary,pendant,position,prickle,primary,scar,shape,stone,structure,sympodial,texture,tip,tube,width,wing,young
257	wfo-0001028885	success	214	179	152	62	27	0.71	-1,.5,0.3-0.5,0.5-1,0.5-5,0.7-2,1-1.5,1-2,1-3,1.5-1.7,10-20,2,2-,2-2.5,2.3-2.5,2.5-3.5,2/3,3-5,3.5-4.5,3.5-8.5,4-5,7-8,7-9,9-11,9-12,abaxial,acute,adaxial,adaxially,along,anther,anthesi,apart,apex,apiculate,apparently,attenuate,base,berry,black,branched,broadly,brown,calyx,capitate,cell,cm,collapsing,connivent,corolla,cup-shaped,dark,decurrent,deltate,densely,diameter,distal,dried,ellipsoid,elliptic,filament,fleshy,flower,free,fruiting,furcate,glabrescent,glabrous,glandular,globose,golden,gradually,groove,height,inflorescence,irregularly,known,lamina,lanceolate,lateral,leaf,lengthening,less,like,live,lobe,lobed,long,loosely,lower,margin,material,midvein,minute,minutely,mm,mostly,multicellular,narrowing,narrowly,nodding,occasionally,pair,part,pedicel,petiole,pigmentation,plant,pore,poricidal,portion,primary,pubescent,purple,recorded,reddish,retaining,rhachi,ripe,scandent,scar,scattered,shiny,shrub,simple,slightly,slit,smaller,spaced,sparsely,spreading,stellate,stem,stigma,style,surface,terminal,time,tip,trichome,tube,uniseriate,unit,usually,vein,vine,way,weak,wide,winged,woody,Â¾	1-1.2,1.5-3.5,5-merou,?,ag,alyx,archin,ark,articulated,basal,blackish,branch,dark-pigmented,dendriti,drying,eaf,eed,entire,erect,exserted,extending,glabrou,groupe,growth,ilament,immature,inserted,leaving,new,nflorescence,noddin,often,older,orolla,papillo,peduncle,peg,perfect,pericarp,plurifoliat,quarter,revolute,ruit,shin,short,sleeve,slender,small,sometimes,spheroidal,strongly,tangled,tem,thin,third,twinin,ud,upper,vary,wall,weak-walled,ympodial	age,bark,bud,color,count,fruit,grouped,habitat,length,major,mentioned,minor,ovary,papillose,plurifoliate,position,prickle,seed,shape,size,stone,structure,sympodial,texture,width,wing,young
258	wfo-0001028888	success	207	155	123	84	32	0.594	0-3.5,0-5,0.15-0.5,1,1-2,12.5-25,2-6,2.5-3.3,3-4,4-25,5-10,8-11,8-13.5,abaxially,acuminate,acute,adaxially,along,anther,apex,apiculate,articulated,axillary,base,berry,blade,broadly,bud,cell,center,central,chartaceous,ciliate,clavate,cm,connivent,corolla,covered,covering,diameter,distal,dorsally,dot,elliptic,especially,filament,flat,flower,folded,forked,fruit,generally,glabrous,glaucous,globose,green,green-white,hair,half,herb,lanceolate,lateral,less,like,lobe,low,make,margin,membranous,middle,midrib,minutely,mm,mottled,mucilaginous,oblique,odd-pinnate,often,orbicular,ovate,ovoid,pedicel,petiole,plant,plurifoliate,proximal,puberulent,pubescent,purple,ripe,rounded,scattered,seed,short,size,slightly,sometimes,sparsely,stem,stigma,streak,style,subglabrous,subtending,tall,terminal,testal,thick,throughout,tip,tri-,tube,typically,unit,unwinged,usually,violet,wall,wet,white,whitish,wing,x	0-7,1-1.5,1-10,1-3,1.5-4,10-25,2-5,2.3-5,2.3-7,3-5,3.6-12.5,3.8-8.3,4-7,5-7,5-merou,6-11,acumen,ag,alyx,apart,apparently,axe,brownish,capitat,condition,cuneate,digestion,drying,eaf,edge,eed,end,enzyme,erec,exceeding,except,fresh,geminat,glabrou,greatly,greenish,hair-like,hal,homostylous,honeycomb-shaped,interjected,leaflet,lengthening,living,long,lower,nflorescence,one,orolla,pair,peduncle,pentagonal,perfect,petiolulate,petiolule,placed,pore,poricidal,reduced,removed,ruit,sessile,seudostipule,slit,spaced,specimen,stamen,ste,stolo,straight,subequal,substellate,tamen,tem,truncate,tuber,vary,yellow,ympodial	'hair-like,anthesi,bark,calyx,capitate,color,count,free,fruiting,geminate,habitat,height,inflorescence,leaf,length,major,minor,null,ovary,position,prickle,primary,scar,shape,stone,structure,surface,sympodial,texture,vein,width,young
259	wfo-0001028920	success	152	147	123	29	24	0.809	.5,0.2-1,0.5-1,0.8-1.1,1-1.2,1-1.5,1-2.4,1-3,1.5-2,2-7,3-3.5,3-4,5-9,6-15,6-6.5,abaxially,acuminate,acute,adaxially,anther,anthesi,apex,arachnoid,arachnoid-pubescent,area,attenuate,axil,bark,base,broadly,brownish,calyx,closely,cm,congested,conical,corolla,cucullate,decurrent,deflexed,deltate,dendritic,dense,densely,difoliate,ellipsoid,elliptic,erect,felty,filament,flower,free,fruiting,glabrate,glabrous,globose,green,later,lateral,leaf,lightly,lobe,lobed,long,long-styled,main,major,middle,minor,minutely,mm,nearly,obovate,obovoid,occasionally,older,opposite,ovary,ovoid-reniform,pair,papillose,pedicel,petiole,pitted,planar,pore,poricidal,pubescence,pubescent,scar,shape,shaped,short-styled,shrub,simple,size,small,soon,spaced,sparsely,stem,stigma,strongly,style,surface,tall,tapering,tear-drop,tip,tree,trichome,tube,tuft,unifoliate,uniseriate,unit,vein,white,widest,winged,woody,x,young	.25,2-2.5,3-15-flowered,ba,berry,brown,dark,dia,differing,eaf,edicel,eed,exserted,fleshy,geminat,gray-brow,lon,lower,nflorescence,overlappin,portion,present,ruit,somewhat,styl,thick,tub,ud,ympodial	3-15,bud,cell,color,count,diameter,fruit,geminate,gray-brown,habitat,height,inflorescence,length,margin,mentioned,overlapping,position,prickle,primary,seed,stone,structure,sympodial,texture
260	wfo-0001028929	success	210	200	177	33	23	0.843	-2,.5,.7,.9,/5,0,0-1,0-10,0-20,0-3,0.1,0.15-0.3,0.2-0.3,0.2-0.4,0.2-0.8,0.3-0.6,0.4-0.8,0.5-1.5,0.5-2,0.7-1,0.7-2,0.8-1,1-3,1.5-2.4,2-3,2-4,2-6,2-9,2.5-4,2/3-3/4,3-20,4-6,5-6,5-7.5,5-merous,6-8,7-9,8-10,abaxial,abaxially,acicular,acute,adaxial,alyx,anther,apar,apart,ape,apex,apically,apparently,articulated,bark,base,berry,blade,branched,calyx,cell,chartaceous,cm,concolorous,connivent,cuneate,curved,densely,diameter,difoliate,discolorous,drying,dull,eaf,elliptic,elongating,erect,filament,flattened-reniform,flower,foliaceous,free,fruit,fruiting,geminat,gently,glabrescent,glabrous,gra,hair,inflorescence,lateral,leaf,length,lobe,lobed,long,long-styled,longer,lower,margin,mature,maturity,midpoint,minute,minutely,mm,narrow-deltate,narrow-ovate,oblong,obovate,obtuse,occasionally,older,one,open,orange-brown,outline,pair,pale,patch,pedicel,peduncle,pendulous,perfect,perpendicular,petiole,pit,poricidal,porrect,prickle,prickly,primary,raised,ray,red,red-brown,red-green,reticulate,scar,sessile,short-styled,shrub,simple,slender,small,smooth,sometimes,spaced,spherical,spreading,stalk,stalked,staminate,stellate,stellate-pubescent,stem,straight,style,subsessile,surface,tapering,terete,time,tip,trichome,tube,unarmed,unit,usually,variously,vein,way,white,wide,woody,yellow,yellow-green,ympodial	-2/3,1,1-1.1,1/2,1/4-1/3,2.2-2.3,2.7-3,3-4,5-25,distance,eed,equal,extending,glabrou,infructescence,lon,midvein,nflorescence,obtu,orolla,oung,per,pericarp,portion,prickl,rounded,ruit,side,tamen,tertiary,vary,venation,visible	anthesi,bud,color,corolla,count,gray,habitat,height,major,minor,null,ovary,position,seed,shape,size,stigma,stone,structure,texture,width,wing,young
261	wfo-0001028963	success	197	178	150	47	28	0.761	.5,/2,0-0.4,0.1,0.1-0.2,0.1-0.25,0.15-0.3,0.3-0.6,0.3-0.7,0.3-1,0.3-1.5,0.45-0.6,0.6-1,0.8-1.8,0.9-1.5,1-4,1/4-1/3,1/5,1/6,2-3,2-4,2-9,3-4.5,4-10,4-8,6-10,7-8,abaxially,acute,anther,apex,apically,apparently,attenuate,bark,base,becoming,berry,blade,bright,broad-deltate,brown,calyx,cell,chartaceous,cm,concolorous,connivent,curved,deltate,densely,diameter,difoliate,discolorous,drying,dull,elongating,erect,evenly,filament,flattened-reniform,flower,free,fruiting,glabrescent,gray-green,green,herb,herbaceous,inflorescence,lanceolate,lateral,leaf,length,less,light,lobe,lobed,long,long-styled,longer,margin,mature,maturity,mauve,midpoint,mm,moderately,narrow-cuneate,narrow-elliptic,narrowly,obtuse,older,one,open,orange,outline,pair,pale,pedicel,pendulous,petiole,pit,poricidal,porrect,primary,purple,raised,ray,red,scar,sessile,shorter,shrub,simple,slender,slightly,small,smooth,spaced,spherical,spreading,stalk,stalked,stellate,stellate-pubescent,stem,straight,style,subsessile,surface,tapering,terete,terminal,time,tip,trichome,tube,unarmed,unbranched,unit,upper,variously,vein,way,wide,winged,woody,yellow-orange,young	0-2,0.6-0.9,1.5-2,1/,2-2.3,2-5,2.4-2.8,3.5-4.2,5-25,5-merous,alyx,apar,ape,articulated,cuspidat,eaf,eed,entire,equal,eye,frui,geminat,glabrous,gra,infructescence,lower,naked,nflorescence,occasionally,orolla,oung,peduncle,per,perfect,pericarp,portion,ruit,short-styled,staminate,tamen,tertiary,unarme,usually,vary,venation,visible,ympodial	anthesi,apart,bud,color,corolla,count,cuspidate,fruit,geminate,gray,habitat,height,major,minor,null,ovary,position,prickle,seed,shape,size,stigma,stone,structure,sympodial,texture,width,wing
262	wfo-0001028971	success	225	217	182	43	35	0.809	-0.8,-1.4,.1-0.2,0.1-0.4,0.1-0.5,0.2-0.5,0.25-0.6,0.4-0.9,0.4-1.5,0.8-2.5,1-2,1-5,1.5-2.2,1.5-4,1.75-2.5,1/5-1/2,10-15,15-30,2-5,2-foliate,2.2-3.5,2.5-3.5,2.5-4.5,2.5-5,20-35,3-14,3-5,3-6,4-5,4-9,5-10,5-15,5-8,6-16,6-8.5,6-9,abaxially,acute,adaxially,also,anther,apex,appearance,appearing,articulated,ascending,attenuate,base,bearing,becoming,blade,branched,broad-based,broadly,calyx,campanulate,cauline,close,cm,compressed,connivent,cylindrical,delicate,deltoid,densely,diameter,directed,distal,eaf,elongate,elongate-deltoid,erect,essentially,extra-axillary,farinaceous,felty,felty-pubescent,female-sterile,filament,flower,form,fruit,glabrous,globose,grading,hair,inflorescence,inserted,invested,lanceolate,largest,later,lateral,laterally,leaf,least,length,lenticular,lignescent,like,linear-lanceolate,lobe,lon,long,longer,longest,major,manifestly,margin,midpoint,minute,minutely,mixture,mm,much,multiseriate,numerous,obtuse,occasionally,often,one,orange,other,outline,ovate,ovate-apiculate,ovate-lanceolate,pair,pedicel,per,perennial,persistent,petiole,pitted,pore,prickle,pubescent,ray,reduced,reniform-ovate,ripe,scattered,sericeous,sessile,short,short-stalked,shorter,side,simple,smaller,sometimes,spaced,sparse,spreading-hirsute,spreadingly,stalk,stellae,stellate,stellate-pubescent,stem,stigma,stipitate,style,surface,tan,thin-textured,time,trichome,truncate,tube,unbranched,underdeveloped,unit,usually,variable,variously,vein,well-developed,white,wide,x,yellow	0.25-1.25,0.3-0.6,05-2.5,7-16,acute-,adaxiall,along,apart,armed,axe,ba,capitat,coarsely,dentate,distall,eed,entire,frequently,geminat,growt,interlobal,lower,maturit,midrib,narrowly,nflorescence,orolla,peduncle,prickly,principal,rachi,round-tipped,ruit,similar,sinus,ste,tal,tamen,tem,termination,tooth-like,vary,ympodial	0.5-2.5,anthesi,bark,bud,capitate,cell,color,corolla,count,distally,free,fruiting,geminate,growth,habitat,height,maturity,minor,null,ovary,position,primary,scar,seed,shape,size,stone,structure,sympodial,tall,texture,tip,width,wing,young
263	wfo-0001028975	success	163	155	129	34	26	0.791	.2,.5,0.1-1,0.5-1,1,1-3,1-5,1.2-1.5,1.5-1.8,1.5-2,2.2-6,3-3.5,3-6.5,5.5-10,6-6.5,7.5-15,8-9,?,acuminate,acute,along,anther,anthesi,apart,apex,appearing,area,bark,base,beneath,broad,brown,calyx,closely,cm,conically,corky,corolla,cup-shaped,dark,decurrent,deflexed,densely,denser,difoliate,elliptic,epidermi,erect,exserted,extension,filament,free,fruit,fruiting,glabrous,globose,golden,green,immature,large-celled,late,lateral,leaf,length,lobe,lobed,long,main,major,margin,member,mere,middle,minor,minutely,mm,narrowly,nearly,obscured,older,once-furcate,opposite,ovary,ovoid-reniform,pair,pedicel,petiole,pitted,pore,poricidal,prominent,pubescent,raised,reflexed,rib,scar,shaped,shiny,short,shrub,simple,size,slightly,small,somewhat,spaced,sparsely,stem,stigma,style,surface,tall,tear-drop,tip,tree,triangular,trichome,tube,uniseriate,unit,upper,varying,vein,white,wide,widest,woody,x,young	3-10-flowered,5-ribbed,berry,conical,dia,differing,eaf,edicel,eed,entire,equal,geminat,hyaline,like,lon,lower,mainly,nflorescence,occasionally,one,papillo,portion,pubescenc,reddi,remaining,ruit,sinus,slender,straight,strongly,tapering,tub,ud,ympodial	3-10,bud,cell,color,count,diameter,flower,geminate,habitat,height,inflorescence,mentioned,papillose,position,prickle,primary,pubescence,reddish,seed,shape,stone,structure,sympodial,texture,width,wing
264	wfo-0001028980	success	168	146	122	46	24	0.726	.1,.5,0.5-1.5,1.2-1.8,1.2-3,1.5-1.8,1.5-2,1.5-6,2.5-5,20-25-flowered,3-4,3/4,4-5,5-6,5-8,6,6-8,7-12,acuminate,acute,anther,anthesi,apex,bark,base,beneath,black,broadly,calyx,capitate,clearly,cm,coarsely,conical,corky,corolla,cucullate,deltoid,densely,dia,differentiated,difoliate,drying,elliptic,expanded,filament,flattened-reniform,fleshy,free,fruiting,furcate,glabrate,glabrous,glandular,globose,green,impressed,incrassate,lateral,leaf,lobe,lobed,long,main,major,margin,minor,minutely,mm,occasionally,older,opposite,ovary,ovate,ovoid,pair,paler,papillose,pedicel,petiole,pit,pitted,pore,poricidal,prominent,pubescent,reddish,reflexed,scar,seed,shaped,sharply,shining,shrub,simple,size,slightly,small,soon,speciman,stem,stigma,strongly,style,surface,tall,tear-drop,thick,tip,tree,trichome,tube,type,uniseriate,unit,usually,vein,way,white,woody,x,young	.75,/3,1-1.2,2.5,along,apart,axil,basal,beginning,berry,deflexed,differing,dry,eaf,edicel,eed,exserted,extending,f,frui,geminat,inflorescenc,lamina,lenticellat,like,lon,lower,m.,material,member,middle,nflorescence,one,pale,peduncle,planar,portion,ruit,scarious,sparsely,tapering,ti,ud,widest,yellowish,ympodial	bud,cell,color,count,diameter,flower,fruit,geminate,habitat,height,inflorescence,length,lenticellate,mentioned,position,prickle,primary,shape,stone,structure,sympodial,texture,width,wing
265	wfo-0001028984	success	180	149	111	69	38	0.617	-2,-2.5,-3,-6,-65,-9,0.5-,1,1-2,1-2.5,1-9,1.2-4,1.5,15-35,2,2-,2-16,2-2.5,2-3,3-28,3-6,4-30,4-6,4-7,5,5-10,abaxially,acuminate,acute,adaxially,adpressed,age,aggregate,almost,also,apex,apical,basal,base,blade,broadly,calyx,cell,chartaceous,cm,color,concave,cordate,densely,diameter,eglandular,ellipsoid-fusiform,especially,fleshy,flower,forked,fruit,glabrous,gland,glandular-puberulent,globose,greenish,hair,lanceolate,lobe,long,margin,minutely,mm,moderately,obtuse,often,ovate,ovoid,pale,papillose,pedicel,petiole,pilose,possibly,presence,puberulent,puberulent-pubescent,pubescent-pilose,purple,rarely,ripe,shrub,simple,small,sparsely,stigma,stone,style,time,tip,tomentose,toward,tree,triangular,truncate,tube,turning,two,unbranched,unit,unknown,violet,wide,x,yellow	-14,1-,1-1.7,1-6,10-20,12-20,2-4,20-40,3-10,3-26,4-5,4-6.3,4-foliat,7-14,8-15,abruptly,absen,apart,ape,articulated,axe,broad,campanulate,connective,dilated,directed,distally,eaf,eed,entire,equalling,exceeding,laterally,leaving,lon,longer,lower,narrowed,near,nflorescence,nther,obconical,orolla,pedicellar,peduncle,perfect,pilo,pore,present,pubescent-pilo,rachi,radiu,remnant,ruit,shorter,slightly,spaced,stamen,strongly,subcoriaceous,swelling,tal,tem,thecae,tomento,ud,unknow,vary,ympodial	4-foliate,absent,anther,anthesi,bark,bud,corolla,count,filament,free,fruiting,habitat,height,inflorescence,lateral,leaf,length,major,mentioned,minor,ovary,position,prickle,primary,scar,seed,shape,size,stem,structure,surface,sympodial,tall,texture,vein,width,wing,young
266	wfo-0001028997	success	136	132	102	34	30	0.75	.5,0.5-0.7,0.5-1,0.5-1.5,0.8-1.1,1-1.2,1-1.5,2-2.5,2-3.5,20-50-flowered,3-4,4-10,4-angled,5-6,6-10,6-7,abaxially,acute,anther,anthesi,apex,appearing,area,attenuate,bark,base,branched,broadened,calyx,cm,conical,corolla,cucullate,difoliate,dry,drying,elliptic,elliptic-obovate,erect,filament,filiform,flattened-reniform,free,fruiting,glabrous,globose,golden,green,height,incrassate,later,lateral,leaf,lobe,lobed,main,many,margin,matte,merely,minutely,mm,mustard,nearly,older,opposite,ovary,pair,pale,papillose,pedicel,petiole,pitted,pore,poricidal,quadrate,scar,shaped,shiny,shrub,spaced,specimen,stem,stigma,style,surface,tan,tear-drop,terminal,thickened,time,tip,trifoliate,tube,unevenly,unknown,vein,white,woody,x,yellow,young	3.3.5,4-4.5,adaxially,apar,ba,berry,coriaceous,deflexed,dia,eaf,edicel,eed,exserted,fragrant,geminat,glabrou,greenish-brow,lon,long,lower,middle,nflorescence,partially,pericarp,portion,revolute,ruit,strongly,styl,thick,tub,ud,widest,ympodia	20-50,apart,bud,cell,color,count,diameter,flower,fruit,geminate,greenish-brown,habitat,inflorescence,length,major,minor,null,position,prickle,primary,seed,shape,size,stone,structure,sympodial,texture,unit,width,wing
267	wfo-0001029003	success	207	174	143	64	31	0.691	0-6,0.3-0.5,0.4-3,0.5,1,1-2,1-3,1-5,1.2-2.5,1.5-2.3,11-32,12.2-30,13-36,2-6,2.5-10,2.5-7.5,3,3-20,3.5-7.5,4-8,5-10.5,7-15.5,7-9,abaxially,absent,acumen,acuminate,adaxially,anther,apex,attenuate,axillary,base,berry,blade,blue-violet,bud,cell,chartaceous,ciliate,cm,conical,connivent,corolla,covering,diameter,digestion,distal,dorsally,eaf,edge,elliptic,elongated,end,enzyme,especially,filament,flat,flower,folded,forked,fruit,generally,glabrous,green,green-white,hair,hair-like,half,herb,highly,honeycomb-shaped,interjected,lanceolate,lateral,leaf,leaflet,light,like,lobe,long,make,margin,medium,membranous,mm,mottled,mucilaginous,obtuse,odd-pinnate,one,orbicular,ovate,ovoid,pale,pedicel,petiole,petiolule,pigmentation,placed,plant,plurifoliate,prostrate,pubescent,purple,ray,removed,ripe,rounded,secondary,seed,sessile,size,sometimes,sparsely,stem,stigma,stolo,straight,style,subcapitate,subglabrous,subtending,symmetrical,tall,terminal,testal,thick,throughout,tip,tri-,tube,tuber,typically,unit,usually,violet,wall,wet,white,wide,wing,x	1-10,1-2.5,1.2-1.9,3-5,5,5-12.5,5-merou,9-14,ag,alyx,apart,apparently,articulated,axe,brownish,capitat,condition,decreasing,drying,eed,equal,erec,exceeding,fourth,fresh,geminat,glabrou,gradually,greenish,hal,homostylous,larger,lengthening,living,lower,middle,minute,nflorescence,orolla,pair,peduncle,pentagonal,perfect,pore,poricidal,proximal,rarely,rotate,ruit,seudostipule,slightly,slit,spaced,specimen,stamen,ste,subequal,tamen,tem,toward,vary,whitish,yellow,ympodial	anthesi,bark,calyx,capitate,color,count,erect,free,fruiting,geminate,habitat,height,inflorescence,length,major,mentioned,minor,ovary,position,prickle,primary,scar,shape,stone,structure,surface,sympodial,texture,vein,width,young
268	wfo-0001029006	success	217	175	156	61	19	0.719	-+,.5,0.2,0.4-2.5,0.5,0.5-2,0.5-4,1,1-1.5,1-4,1-5,1.2-1.5,1.8-2.2,10,10-20,2-3,2-6,2.5,3.5-4,4-6,5,5-6,50,7-8,7-9,<,>,abaxially,adaxial,age,along,anther,anthesi,area,axil,basal,base,berry,beyond,bilobed,black,blackish,branched,broadest,c.,calyx,cell,cm,conical,connivent,corolla,deeply,deltate,dense,diameter,drying,ellipsoid,elliptic,elongate,exserted,extending,filament,flattened,flower,free,fruiting,glabrous,globose,groove,inflated,inflorescence,intramarginal,irregular,irregularly,keeled,lamina,later,lateral,lengthening,lobe,lobed,long,loosely,many,margin,markedly,midrib,minute,minutely,mm,narrowly,obvious,occasionally,often,pair,pale,papillate,part,pedicel,peduncle,pentagonal,per,pericarp,petiole,pinnatifid,pitted,planar,pore,poricidal,primary,puberulent,pubescent,purple,reniform,ripe,rotate-stellate,sagittate,scar,shiny,simple,slit,sometimes,somewhat,spaced,sparsely,spreading,stem,stigma,strong,strongly,style,surface,tan,terminal,testal,thin,time,tiny,tip,trichome,tube,tuft,twining,uniseriate,unit,usually,variously,vein,vine,violet,way,white,within,woody,x,young	1/3,5-merou,acuminate,acute,adaxiall,ag,alyx,apar,apex,ark,articulated,asymmetrical,axi,bright,chartaceous,clavat,depending,eaf,eed,entire,filiform,green,growing,growth,ilament,leaving,lower,membranous,nearly,new,nflorescence,nodding,oblique,older,one,orolla,peg,pendan,perfect,plurifoliat,portion,puberulen,purplish,reaching,reddish,ruit,size,sleeve,small,smaller,sunligh,tem,truncate,twinin,ud,upper,variable,vary,widest,ympodial,zig-zag	adaxially,apart,bud,clavate,color,fruit,habitat,height,leaf,length,ovary,pendant,plurifoliate,position,seed,shape,structure,sympodial,texture
269	wfo-0001029031	success	213	163	134	79	29	0.629	-12.3,-3.6,-8,.5-1.2,0.1-0.5,0.5-1.5,0.6-1.2,0.7-1.1,1-1.5,1-2,1-2.5,1-2.6,1-3,1-5,1.5-2.8,1.8-2.7,1.8-4,2-10.7,2-3,2-3.3,2-5,2.5-5.5,2.5-5.6,20-150,3-10,4-5-,5-17,6-12,6-21,abaxially,acuminate,acute,adaxially,angle,anther,apex,articulated,base,becoming,berry,black,blade,bluish,branched,calyx,capitate,chartaceous,cm,corolla,covering,cuneate,deltate,densely,diameter,elliptic,elliptic-ovate,erect,filament,flattened,fleshy,flower,forked,fruit,fruiting,geminate,glabrescent,glabrous,globose,green,hair,held,impressed,lanceolate,lateral,leaf,leaf-opposed,length,like,lobe,long,major,many-foliate,margin,mm,oblong,obtuse,occasionally,outline,pedicel,peltate,peltate-stellate,petiole,porrect-stellate,possibly,prominent,pseudoterminal,pubescent,rarely,reniform,ripening,rounded,rugulose,sessile,short-stalked,shrub,side,silvery,simple,small,sparsely,stellate,stellate-pubescent,stem,stigma,strongly,style,suborbicular,subtending,surface,tall,time,tip,tree,trichome,tube,unbranched,unit,usually,vein,white,whitish,wide,x,yellowish	-11.4,.1-0.3,0-5,0.5,0.5-4,1-9.4,1.3-3.3,1.5-3.5,1/3,10,13.5,4-7.5,absent,accrescent,adaxiall,ag,apart,apexacute,apparently,around,axe,ba,bilobe,brown,center,connivent,curved,cylindrical,denser,directed,distally,eaf,edge,eed,eglandula,eglandular,entire,equal,farinose,frui,fused,immature,inserted,large,least,light,longitudinal,lower,midpoint,midvein,nearly,nflorescence,opening,orange,orolla,paired,peduncle,perfect,pore,pubescen,pubescence,rachi,ray,ruit,short,slightly,slit,smaller,sometimes,somewhat,spaced,ste,straight,tamen,tem,unarme,vary,yellow,ympodial	anthesi,bark,bilobed,bud,cell,color,count,free,habitat,height,inflorescence,minor,null,ovary,position,prickle,primary,scar,seed,shape,size,stone,structure,sympodial,texture,unarmed,width,wing,young
270	wfo-0001029048	success	162	171	144	18	27	0.889	.01,.2,.5,/3,0.5,0.5-1,0.5-1.7,1,1-2,1-8,1.5-2,11,14,2,25,26,3-4,3-7,3.5-4,4-6,5-8,8-10,9-15,acuminate,angle,another,anther,anthesi,apex,arching,attenuate,basal,base,bearing,becoming,beneath,berry,bicellular,branch,bright,broadly,calyx,cm,conical,corolla,decurrent,dia,elliptic,elongated,except,expanded,f,filament,filiform,flower,free,fruiting,geminate,glabrate,glabrous,globose,golden,greatly,green,greenish-white,greenish-yellow,hanging,hispidulous,incrassate,lateral,leaf,less,live,lobe,lobed,long,main,margin,matte,middle,midrib,minute,minutely,mm,node,non-reproductive,obovoid,obtuse,one,opposite,ovary,ovoid-reniform,pair,pale,papillose,parallel,pedicel,petiole,pitted,planar,pore,poricidal,puberulent,reflexed,right,ripe,rounded,scar,shaped,sharply,shrub,slender,slightly,small-capitate,somewhat,spaced,specimen,stem,stigma,straight,style,surface,tall,tan,tapering,tear-drop,thread-like,time,tip,translucent,trichome,tube,unevenly,uni-,unifoliate,unit,vein,way,widely,widest,winged,x,young,zig-zag	0.8-1,apar,apparent,blade,eaf,edicel,eed,greenish-yello,like,lower,much,nflorescence,older,papillo,portion,ruit,ud,ympodial	apart,bark,bud,cell,color,count,diameter,fruit,habitat,height,inflorescence,length,major,mentioned,minor,position,prickle,primary,seed,shape,size,stone,structure,sympodial,texture,width,wing
271	wfo-0001029055	success	169	156	116	53	40	0.686	0.4-1.5,1-2.6,1-4,1-5,1.7-2.2,1.8-3.5,14-50,2-3,2.5-8,3,4-6,4-7,5-24,5.5-9,6-14,8-9,9-22,abaxially,acumen,acuminate,acute,adaxially,apex,apical,apically,base,branched,calyx,cell,cm,connate,cordate,corolla,covered,covering,cuneate,cyme,dark,decurrent,dehiscent,densely,diameter,dichasial,dichasially,distal,dorsally,ebracteate,edge,elliptical,filament,flat,flower,folded,forked,generally,gland,green,hair,hair-like,half,herbaceous,introrse,lateral,leaf,lobe,long,long-attenuate,longitudional,make,maturing,mm,monochasial,mucilaginous,near,oblique,odd-pinnate,often,outline,ovate,ovoid,pedicel,peduncle,pentagonal,perennial,petiole,pilose,plant,poricidally,pubescent,purple,rarely,rotate,seed,sessile,short,short-petiolate,short-stalked,size,slit,sometimes,spreading,stigma,stripe,style,testal,thick,time,triangular,tuber-bearing,type,typically,unit,wall,wide,widest,yellow	1.6-3.5,2-1.,2-4,2.2-3,3-10,3-6,3-6-foliat,4-10,articulate,attenuate,digestion,diminishing,eaf,eed,elliptcal,emoval,enzyme,exceeding,first,globo,green-white,honeycomb,interjected,leaflet,living,lon,longer,lower,lunat,nflorescence,nther,orolla,pair,pattern,perfect,plan,proximal,reveal,ruit,second,seudostipule,specimen,stamen,straight,tal,tem,terminal,throughout,toward,vary,whit,ympodial,Â¼	3-6-foliate,anther,anthesi,bark,bud,color,count,free,fruit,fruiting,globose,habitat,height,inflorescence,length,major,margin,mentioned,minor,ovary,position,prickle,primary,scar,shape,stem,stone,structure,surface,sympodial,tall,texture,tip,tube,vein,wet,white,width,wing,young
272	wfo-0001029059	success	199	173	148	51	25	0.744	.5,0.1-1,0.2,0.2-0.5,0.5,0.5-1,1-1.5,1-3,1-4,1-6,1.2-3,1.3-1.7,1.5-2,1.5-2.8,10-19,2.5,3-3.5,3-6.5,3.5-6,3.5-8,4-10.5,5-15-flowered,6-10,7-9,acute,along,anther,anthesi,apex,apiculae,apiculate,arising,bark,base,beneath,berry,bud,calyx,clavate,closely,cm,cordate,corolla,covered,cuneate,deep,deflexed,deltoid,densely,dia,differing,difoliate,dirty,ellipsoid,elliptic,extremely,filament,flattened-reniform,foetid,free,fruiting,geminate,glabrate,glabrous,globose,hispidulous,impressed,inflorescence,lateral,leaf,lobe,lobed,long,main,major,margin,member,middle,minor,minute,minutely,mm,narrowly,nearly,oblique,occasionally,often,older,one,opposite,orange,orangish-yellow,orbiculate,ovary,pair,pale,papillose,partially,pedicel,petiole,pitted,planar,pointed,prominent,pubescence,pubescent,purplish,rest,ripe,rounded,scar,shallowly,shape,shrub,simple,size,slender,small,somewhat,spaced,stem,stigma,style,surface,tall,tapering,tinge,tip,tree,triangular,trichome,tube,underside,unicellular,uniseriate,unit,usually,variable,vein,waxy,white,widest,woody,x,yellowish,yellowish-green,yellowish-tan,young	0.1-0.5,1-1.2,5,anisophyllou,apar,ape,bout,branched,coiba,connivent,de,dense,eaf,edicel,eed,expanded,exserted,extending,greatly,incrassate,interpetalar,isla,lamina,lon,longest,lower,membranous,nflorescence,paler,panama,papillo,population,pore,poricidal,portion,reddish-gre,ruit,shaped,sinus,soon,sparse,specimen,straight,tear-drop,terminal,thickened,ti,tightly,ud,wide,ympodial	absent,anisophyllous,apart,cell,color,count,diameter,flower,fruit,habitat,height,length,persistent,position,present,prickle,primary,reddish-grey,seed,stone,structure,sympodial,texture,width,wing
273	wfo-0001029072	success	235	199	171	64	28	0.728	-15,-2.5,.5,/6,0,0-2,0-20,0-4,0-8,0.1-0.4,0.2-0.3,0.2-0.4,0.3,0.4-0.9,0.5-2,0.7,0.8,0.8-1.5,1-1.2,1-1.5,1-25,1-3,1.5-2.6,1.5-3.2,1/3,1/4-1/2,1/4-1/3,12-19,2-10,2-5,2-7,2-8,2.5-3.5,20-50,3-10,3-20,3-5,3-50,3-8,3.5-6,4-10,4.5-9,5-10,5-50,5-7,5-9,7-10,7-15,8-20,8-27,abaxially,acute,ame,angled,anther,apart,apex,apically,apparently,articulated,bark,base,blade,branched,bright,broad-deltate,c.,calyx,cm,conical,connivent,cordate,cream,cuneate,curved,dark,deltate,densely,diameter,dirty,dull,elongated,elongating,erect,filament,flattened,flattened-reniform,flower,free,fruit,fruiting,gently,green,green-brown,herb,lateral,leaf,least,length,lobe,lobed,long,long-styled,longitudinal,lower,margin,marking,mature,maturity,mauve,midpoint,mm,moderately,multangulate,narrow-deltate,one,open,orange-brown,ovate,pair,pale,pedicel,peduncle,pendent,petiole,poricidal,porrect,prickle,prickly,primary,raised,ray,reflexed,ridge,rounded,scar,sessile,short-styled,shrub,sometimes,spaced,sparsely,spherical,spreading,stalk,stalked,stellate,stellate-pubescent,stem,stout,straight,style,surface,tapering,terminal,time,tip,trichome,tube,unarmed,unit,upper,variously,vein,way,white,whitish,wide,woody,yellow,young	-1/2,0.5-3,00-200,1,1.5-2.5,2.2-2.5,2.2-3.2,2.5-3.8,2.5-4.5,3/,4-,4.2-6.5,5-merous,abaxial,adaxial,adaxially,alyx,andromonoecious,apar,berry,broadly,chartaceous,clearly,discolorous,distal,distance,drying,eaf,eed,equal,extending,glabrous,gra,hermaphrodite,heterostylous,infructescence,longer,lowermost,midvein,nflorescence,obtu,older,orolla,oung,pendulous,per,pericarp,plant,plurifoliat,portion,prickl,ruit,side,simple,smooth,staminat,strongly,tamen,tertiary,vary,venation,visible,weakly,ympodial	3/4,anthesi,bud,cell,color,corolla,count,gray,habitat,height,inflorescence,major,minor,null,obtuse,ovary,plurifoliate,position,seed,shape,size,stigma,stone,structure,sympodial,texture,width,wing
274	wfo-0001029073	success	211	188	163	48	25	0.773	.5,.7,0.5,0.6-0.7,0.6-2,1-1.2,1-1.5,1-2.5,1-3,1.1-1.5,1.2-1.6,10-15,10-16,2,2-3,2-4,2/3,3.5-9,4-5,4-6,5-6,6-9,7-10,8-14,abaxially,acuminate,acute,adaxially,along,another,anther,anthesi,apart,apex,armed,articulated,away,awn-like,bark,basal,base,berry,broad-based,calyx,cell,cm,conical,corolla,curved,dark,darker,dense,densely,diameter,difoliate,dimorphic,drying,elliptic,enlarged,equal,except,filament,flattened,flower,four,free,fruiting,glabrous,globose,golden,hooked,inflorescence,internodal,interpetalar,lamina,lanceolate,leaf,length,like,linear,lobe,lobed,long,long-styled,lower,margin,maturity,midpoint,midvein,minutely,mm,multangulate,narrowly,nodding,oblique,occasionally,one,opposite,orange,pair,pale,papillose,pedicel,petiole,planar,plurifoliate,poricidal,porrect,prickle,primary,pubescent,purple,ray,rectangular,reniform,reticulate,scar,sessile,short,short-stalked,shorter,shrub,simple,sinuate,slightly,sometimes,somewhat,spaced,sparsely,splitting,stellate,stem,stigma,straight,strongly,style,styled,surface,tapering,testal,three,tip,tissue,triangular,trichome,truncate,tube,two,unequal,unequally,unit,upper,upward,vein,visible,wall,way,whitish,wide,woody,x,yellow,Â½	0.3-1,0.5-1,1.5-2,5-8,5-merous,ba,beneath,brown,chartaceous,cream,discolorous,eaf,eed,entire,erect,exserted,frui,geminat,gre,growth,lengthening,mixture,new,nflorescence,older,paler,peduncle,per,perfect,pericarp,pore,portion,prickly,pubescence,ruit,shallowly,shiny,slit,tan,thin,ti,ud,unarmed,underside,unisexual,yellowish,ympodial,zygomorphic	.5-2,bud,color,count,fruit,geminate,grey,habitat,height,lateral,major,minor,null,ovary,position,seed,shape,size,stone,structure,sympodial,texture,width,wing,young
275	wfo-0001029074	success	174	173	144	30	29	0.828	.1,.5,0.2-1,0.3-0.4,0.5-1,0.5-1.2,0.7-0.8,0.7-0.95,1,1-,1-1.2,1-1.5,1-2,1.4-1.8,1.5-2,1.5-4,11,2-2.3,2-4,2-5,2-7,3-,3-6,3.5-5,5-6,5-7,abaxially,absent,acute,adaxially,age,almost,along,anther,anthesi,apart,apex,appearing,articulation,bark,base,berry,black,broadly,calyx,capitate,cm,conical,corolla,cuneate,deflexed,densely,denser,diameter,ellipsoid,exerted,expanding,filament,flattened,flower,free,fruiting,glabrous,globose,green,grey,herb,immature,internodal,lacking,leaf,lengthening,less,lignescent,like,lobe,lobed,longest,margin,markedly,midpoint,midvein,minutely,mixture,mm,obscuring,often,opposite,ovary,ovate,pair,pale,pedicel,petal,petiole,pitted,planar,pore,poricidal,primary,pubescent,purplish,ray,reflexed,reniform,ripening,rounded,sagittate,scar,scattered,sessile,simple,slit,small,somewhat,sparsely,stalk,stalked,stellate,stellate-pubescent,stem,stigma,strongly,style,subshrub,surface,swollen,tip,triangular,trichome,truncate,tube,underside,uniformly,uniseriate,unit,usually,vein,way,white,woody,x,yellowish,Â¾	0,0.3-0.8,apparently,basa,eaf,eed,entire,frui,glabrescen,growth,lower,new,nflorescence,older,papillat,peduncle,per,perfect,pericarp,plurifoliat,portion,prominent,pulp,ruit,thin,tub,ud,watery,yellow,ympodial	basal,bud,cell,color,count,fruit,glabrescent,habitat,height,inflorescence,lateral,length,major,minor,null,papillate,plurifoliate,position,prickle,seed,shape,size,stone,structure,sympodial,texture,width,wing,young
276	wfo-0001029075	success	217	139	107	110	32	0.493	0.8-1.5,1-2,2.5-3,30-60,4-10,4-14,4-7,5-10,5-8,7-17,8-9,abaxially,abruptly,adaxially,along,anther,apex,attenuate-acuminate,atypically,axillary,base,berry,broadly,brown,bud,cell,ciliate,cm,corolla,covering,cuneate,dark,densely,diameter,distal,dot,especially,etota,filament,flecked,flower,forked,fruit,generally,glabrous,glandular-pilose,glandular-puberulent,gray-green,green,green-white,hair,half,herb,lanceolate,lateral,leaf,like,lobe,long-spatulate,make,margin,midrib,minutely,mm,mucilaginous,narrowed,odd-pinnate,ovoid,pedicel,pentagonal,petiole,plant,plurifoliate,pointed,puberulent,pubescent,rounded,sec,seed,size,small,stem,stigma,style,subobtuse,subquadrate,substellate,subtending,terminal,testal,thick,throughout,tip,tri-,tube,unit,unwinged,usually,wall,wet,white,whitish-gray,woody,x,yellow,yellow-green,yellowish-white	.3,.5,0-3,0-8,0.5-0.8,0.8-1.2,1-10,1-2.5,1-3,10-20,2-4,2-5,2.7-4.2,4-5,4.5-6.5,5-8.5,5-merou,6-12,7-9,acumen,ag,alyx,apart,apparently,articulated,axe,blade,brownish,canescent,clavifor,condition,connivent,decreasing,decurrent,digestion,dorsally,drying,eaf,edge,eed,elliptic-lanceolate,end,enzyme,erect,erect-ascendin,exceeding,flat,folded,fresh,geminat,glabrescent,glabrou,gradually,greatly,greenish,hair-like,homostylous,honeycomb-shaped,interjected,larger,leaflet,lengthening,light,living,long,lower,middl,narrowly,nflorescence,orbicular,orne,orolla,ovate,pair,peduncle,perfect,petal,petiolulate,petiolule,pore,poricidal,purple,rachi,removed,ruit,sessile,seudostipule,short,singly,slightly,slit,sometimes,spaced,specimen,stamen,ste,stolo,straight,subequal,tall,tamen,tem,toward,tuber,typically,upper,vary,whitish,wide,ympodial	'hair-like,anthesi,bark,calyx,claviform,color,count,free,fruiting,geminate,habitat,height,inflorescence,length,major,mentioned,minor,ovary,position,prickle,primary,scar,shape,stone,structure,surface,sympodial,texture,vein,width,wing,young
277	wfo-0001029084	success	192	131	99	93	32	0.516	.5,0.8-2,1-2,10-50,2-3.5,2-5,3-6,3.5-8,4-17,4.5-10,4.5-6.5,6-13,7-9,abaxially,acuminate,adaxially,along,anther,apex,axillary,base,berry,brownish,bud,cell,chartaceous,ciliate,cm,condition,conical,corolla,covering,diameter,distal,drying,especially,filament,flower,forked,fresh,fruit,generally,glabrous,green,green-white,greenish,half,herb,lanceolate,lateral,leaf,leaflet,light,lilac,lobe,make,margin,midrib,minutely,mm,mottled,mucilaginous,narrow,obtuse,odd-pinnate,ovoid,pedicel,petiole,petiolule,pilose,plant,plurifoliate,puberulent,pubescent,purple,ripe,seed,size,sparsely,stigma,style,subglabrous,subsessile,subtending,terminal,testal,thick,throughout,tip,tri-,tube,unit,unwinged,usually,wall,wet,whitish,wing,x	0.8-2.1,1-10,1-3,1-4,1.1-2.2,1.5-2.5,2-4,3.5-7.5,4-7,5,5-7,5-merou,8-23,absent,acumen,ag,alyx,apart,apparently,arranged,articulated,axe,bead,blade,capitat,connivent,darker,decreasing,digestion,dorsally,eaf,edge,eed,enzyme,exceeding,flat,folded,geminat,glabrou,gradually,hair-like,homostylous,honeycomb-shaped,interjected,interpetalar,larger,lengthening,like,living,lon,long,lower,middle,minute,moniliform,multiple,necklace,nflorescence,orolla,ovate-lanceolate,pair,peduncle,perfect,pore,poricidal,proximal,ray,removed,rotate,ruit,secondary,semierec,seudostipule,slit,spaced,specimen,stamen,stolon,subequal,subglabrou,symmetrical,tall,tamen,tem,thir,tissue,toward,tuber,typically,vary,wide,yellow,ympodial	'hair-like,anthesi,bark,calyx,capitate,color,count,free,fruiting,geminate,habitat,height,inflorescence,length,major,mentioned,minor,ovary,position,prickle,primary,scar,shape,stem,stone,structure,surface,sympodial,texture,vein,width,young
278	wfo-0001029088	success	149	141	91	58	50	0.611	.2,.3,0.1,3.5â7,3.5â8,5,<,abaxially,acuminate,acute,adaxially,anther,apex,base,berry,blade,bronze-brown,calyx,capitate,ciliate,climbing,cm,cordate,densely,diameter,eaf,emarginate,extra-axillary,filament,flattened,fleshy,flower,fruit,fruiting,glabrou,glabrous,greenish-brown,hair,herbaceous,immature,lanceolate,leaf,lenticular,light,lobe,long,margin,mature,membranous,minutely,mm,moderately,narrowly,near,obtuse,ovoid-rhomboid,palmate,papillose,pedicel,petiole,plurifoliat,primary,pubescent,purplish,reddish-brown,rounded,rugose,sand-punctate,shortly,simple,slender,slightly,somewhat,sparsely,stigma,style,surface,terrestrial,tip,truncate,tube,unbranched,unit,vein,venation,vine,white,wider,x,ympodial,â7	0.6â3.2,0.9â1.5,1.3â4.5,1.5â2,1.5â3,15â25,1â1.2,1â1.5,1â1.6,1â3,2-lobe,2.5â20,2.5â4.2,25â30,2â2.5,2â3,3â16,4â8,5-merous,5â8,6-10,accrescent,alyx,apar,apicall,axe,c.,cylindrical,eed,entire,flavor,fragrant,groun,half,heavy,juicy,lower,m.,nflorescence,nternode,orolla,peduncle,perfec,rachi,revolute,ruit,scent,spaced,stellate,stout,straight,strongly,swee,sweet,tamen,tem,truncate-acuminat,vary	0.6-3.2,1-1.2,1-1.5,1-1.6,1-3,1.5-2,15-25,2-2.5,2-3,2-lobed,25-30,3-16,3.5-7,3.5-8,4-8,anthesi,apically,bark,bud,cell,color,corolla,count,free,ground,habitat,height,inflorescence,lateral,length,major,minor,null,ovary,plurifoliate,position,prickle,scar,seed,shape,size,stem,stone,structure,sympodial,texture,truncate-acuminate,width,wing,young
279	wfo-0001029089	success	177	156	139	38	17	0.785	.5,/4,0.1-0.25,0.5-0.6,0.5-1,0.8-1.2,1,1-1.5,1.5-2,1.5-6,1/2,10-25,4.5-5,5-10,5-9,6-7,8-9,along,anther,anthesi,apart,apiculate,axil,bark,base,beginning,berry,bilobed,branched,bud,calyx,campanulate,caniculate,closely,cm,completely,corolla,covered,covering,cracking,deflexed,densely,dia,difoliate,either,elliptic,enclosed,entire,erect,expand,exserted,filament,flattened-reniform,free,fruiting,furcate,glabrous,globose,golden,green,impressed,incrassate,lamina,later,lateral,leaf,lobe,lobed,long,main,major,margin,material,member,middle,minor,minutely,mm,obovoid,occasionally,older,opposite,otherwise,ovary,overlapping,pair,papillose,part,pedicel,peeling,persistent,petiole,pinkish,pitted,planar,pore,poricidal,primary,prominent,pubescent,purplish,reddish-grey,resinous,rounded-deltoid,scar,secretion,shaped,shiny,shrub,simple,slightly,small,smooth,somewhat,spaced,stem,stigma,still,style,surface,tall,tear-drop,tip,tree,trichome,tube,underside,uniseriate,unit,usually,varnish,varnished,vein,way,white,widest,woody,x,young	.75,0.8-1,2.5-3.5,5-20-flowered,5-6,abrupt,acute,apex,ba,beneath,dark,decurrent,differing,drying,eaf,edicel,eed,geminat,glabrou,inflorescenc,like,lon,lower,nflorescence,one,papillo,portion,resinou,rounded,ruit,size,straight,tan,tapering,tub,ud,widening,ympodial	cell,color,diameter,fruit,geminate,habitat,height,inflorescence,length,position,prickle,seed,shape,stone,structure,sympodial,texture
280	wfo-0001029091	success	212	173	140	72	33	0.66	-1,-4,-4.5,0.3-,0.5-0.8,1,1-10,1-2,10,10-20,10-toothed,15-40,2-3,2.5-,20-30,3,3-11-lobed,4,5,7-8,acuminate,acute,anther,apex,appearing,articulated,articulation,axil,base,bluntly,broadly,brownish,buff,calyx,campanulate,capitate,cell,cm,common,corolla,cuneate,cyme,developed,dia,discoidal,downward,effect,ellipsoid,elliptic,emarginated,erect,exceeding,filament,flattened,floral,flower,flushed,fork,forked,fresh,fruiting,giving,glandular,globose,globular,grey,hair,half,intense,interacuminal,irregular,irregularly,lacking,larger,lateral,leaf,light,line,linear,lobe,long,may,mid-vein,minutely,mm,narrowly,oblong,obovate,obscure,occasionally,ochre-yellow,ovate,overlain,ovoid,pale,pattern,pedicel,pedicellate,peduncle,pentagonal,petiolate,petiole,poricidal,pubescent,rachi,raised,reddish-purple,reticulate-concentric,ridge,ridged,shallowly,shortly,shrub,sigmoid,simple,slender,slightly,soft-wooded,sparsely,speckled,stellate-rotate,stem,stigma,stone,style,subulate,surface,swollen,tall,tip,tissue,toward,transverse,triangular,unit,upper,usually,violet-purple,well,x	-15,0.5-1,1.5-,1.5-2,170-210,2-12,2-2.5,3-,3-4,46/1,5-7,635/1,age,aromatic,aspect,ba,becoming,berry,blunt,clonal,close,colour,conspicuous,cut,dark,deeply,develop,eed,exerted,general,gree,growing,juvenile,lasting,later,lavende,lavender,lengthening,linear-lanceolate,long-triangular,lower,mineral,nflorescence,ower,petiol,plurifoliat,point,pore,readily,relatively,rh,ripe,rounded,ruit,scarcely,separate,several,shed,sinus,slit,soft,soon,straggly,succulent,tub,ud,violet,winged,without,woody,year,ympodial	anthesi,bark,bud,color,count,diameter,free,fruit,habitat,height,inflorescence,length,major,margin,minor,ovary,plurifoliate,position,prickle,primary,scar,seed,shape,size,specified,structure,sympodial,texture,tube,vein,width,wing,young
281	wfo-0001029101	success	233	190	164	69	26	0.704	-15,.5,/3,/4,0-100,0-2,0-5,0-8,0.1,0.1-0.4,0.1-0.5,0.1-0.7,0.1-1,0.2,0.4-1.5,0.5-1,0.7-,1,1-3,1-4,1-8,1.3-2,1.3-2.6,1.4-2.2,1.5-2,1.5-2.5,1.7,1.8-3,1/5-1/4,10-14,10-20,2-20,2.5-6,3-,3-10,3-4,3-7,4-12,4-7,5-,5-20,5-6,5-7,5-8,5-9,5.5-8,6-8,7-13,8-15,abaxially,anther,apart,apex,apparently,articulated,bark,base,berry,blade,branched,broad-deltate,calyx,cell,cm,connivent,cream,cuneate,dark,darker,deltate,diameter,dull,elliptic,elongating,erect,filament,flattened,flattened-reniform,flower,free,fruit,fruiting,glabrescent,glabrous,green,lateral,leaf,length,like,lobe,lobed,long,long-styled,longer,margin,marking,mature,maturity,mauve,midpoint,mm,moderately,multangulate,narrow-deltate,obovate,obtuse,older,one,open,orange-brown,outline,ovate,pair,pale,pedicel,peduncle,pendulous,petiole,pit,poricidal,porrect,prickle,prickly,primary,raised,rarely,ray,reduced,reflexed,rounded,scar,sessile,short-styled,shrub,small,smooth,sometimes,spaced,sparsely,spherical,spreading,stalk,stalked,stellate,stellate-pubescent,stem,straight,style,surface,tapering,terete,time,tip,trichome,tube,unit,variously,vein,way,wide,woody,yellow,yellow-orange,young	-3,0-20,0.8-3.5,00-200,1-1.5,2-,2-6,2.5-3.5,2.8-3.3,2/3-3/4,30-100,5-merous,abaxial,acute,adaxial,almost,always,alyx,andromonoecious,apar,apically,brown-green,chartaceous,concolorous,discolorous,distal,distance,drying,eaf,eed,equal,extending,green-brow,hermaphrodite,heterostylous,infructescence,lengt,lon,lower,lowermost,midvein,nflorescence,oblong,often,orolla,oung,per,pericarp,plant,plurifoliat,portion,present,prickl,rounde,ruit,secondary,side,simple,staminat,suborbicular,tamen,tertiary,thick,vary,venation,visible,well-developed,yellow-green,ympodial	.5-3.5,anthesi,bud,color,corolla,count,green-brown,habitat,height,inflorescence,major,minor,null,ovary,plurifoliate,position,seed,shape,size,stigma,stone,structure,sympodial,texture,width,wing
282	wfo-0001029106	success	200	158	132	68	26	0.66	-6,.5,/3,0,0.2-0.4,0.2-1,0.25-0.7,0.5,0.5-0.8,0.5-0.9,0.5-1,1-1.6,1.5-1.8,1.5-2,1.5-3.5,1/5-1/4,2-3.5,2-4,2-5.5,2-6,2-8,3-4,4-6,5-14,5-8,abaxially,anther,apart,apex,apparently,bark,base,berry,blade,branched,calyx,cell,cm,concolorous,cuneate,curved,deltate,densely,diameter,discolorous,drying,elliptic,elongating,eye,filament,flattened-reniform,flower,free,fruit,fruiting,glabrescent,glabrous,lateral,leaf,length,light,lobe,lobed,long,longer,lower,margin,mature,maturity,mauve,membranous,midpoint,mm,naked,obtuse,older,one,open,orange,orange-brown,orbicular,outline,ovate,pair,pedicel,pendulous,petiole,pit,poricidal,porrect,prickle,prickly,primary,raised,ray,red,rounded,scandent,scar,sessile,shiny,shrub,simple,size,slender,small,smooth,sometimes,spaced,sparsely,spherical,spreading,stellate,stellate-pubescent,stem,style,surface,tapering,terete,time,tip,trichome,tube,unit,vein,visible,way,weakly,white,wide,woody,yellowish-green	.1,0-0.3,0-10,0-2,0-20,0-5,0-6,0.1,0.5-2.5,0.9-1.2,1-2,1-5,1/4,2.2-3,2/,3-25,3-3.5,4-8,5-merous,6-8,acuminat,acute,alyx,ame,apar,apically,appearing,articulated,c.,distance,eaf,eed,equal,erect,extending,flattened,gently,infructescence,lon,midvein,nflorescence,orange-brow,orolla,oung,pale,peduncle,per,perfec,pericarp,plurifoliat,portion,prickl,reflexed,shallow,shorter,side,stalk,stalked,straight,subentire,tamen,tertiary,uit,variously,vary,venation,yellow-orange,ympodial	2/3,anthesi,bud,color,corolla,count,habitat,height,inflorescence,major,minor,null,ovary,plurifoliate,position,seed,shape,similar,stigma,stone,structure,sympodial,texture,width,wing,young
283	wfo-0001029112	success	190	133	101	89	32	0.532	0.5,1-2,1-3,1-4,10-17,10-21,2-3.5,2.5-4.5,2.6-3,20,3-7,3.5-4.5,3.5-7,5-8,6.5-5.5,9.5-13,abaxially,acumen,acuminate,adaxially,anther,apex,axillary,base,berry,brownish,bud,cell,chartaceous,ciliate,cm,condition,conical,connivent,corolla,covering,densely,diameter,distal,drying,especially,filament,flower,forked,fresh,fruit,generally,glabrous,green,green-white,greenish,hair-like,half,herb,lanceolate,lateral,leaf,light,lobe,long,make,margin,mm,mottled,mucilaginous,narrow,odd-pinnate,ovoid,pale,pedicel,petiole,petiolule,plant,plurifoliate,pubescent,purple,ray,ripe,seed,size,stigma,style,subtending,symmetrical,tall,terminal,testal,thick,throughout,tip,tri-,tube,unit,usually,violet,wall,wet,whitish,wide,wing,x	0-2,0.9-1.7,1-10,1.4-2.5,1.5-1.8,1.5-2,2.7-3.5,2.7-4.2,2.7-5.7,3-4,3-5,3-6,5,5-merou,ag,along,alyx,apart,apparently,arranged,articulated,axe,bead,blade,capitat,decreasing,digestion,dorsally,eaf,edge,eed,elliptic-lanceolate,enzyme,equal,exceeding,flat,folded,geminat,glabrou,gradually,hair,homostylous,honeycomb-shaped,interjected,larger,leaflet,lengthening,like,living,lower,middle,minute,moniliform,multiple,necklace,nflorescence,obtuse,orolla,ovate,pair,peduncle,perfect,pore,poricidal,present,pubescen,removed,rotate,ruit,secondary,semierec,seudostipule,slightly,slit,spaced,specimen,stamen,ste,stolon,subequal,tamen,tem,thir,toward,tuber,typically,vary,yellow,ympodial	anthesi,bark,calyx,capitate,color,count,free,fruiting,geminate,habitat,height,inflorescence,length,major,mentioned,minor,ovary,position,prickle,primary,scar,semierect,shape,stem,stone,structure,surface,sympodial,texture,vein,width,young
284	wfo-0001029120	success	168	156	131	37	25	0.78	.5,.75,/2,0.1-0.5,0.5-1.5,0.7-1,1-1.5,1.1-1.5,1.1-2,2.5-3.5,2.6-7,3-3.5,5-10-flowered,5-8,6-8,6.5-16.5,abrupt,acuminate,acute,anther,anthesi,apart,apex,bark,basal,base,beginning,beneath,black,bud,calyx,cell,cm,corolla,dark,decurrent,deflexed,dia,difoliate,drying,evenly,f,filament,fleshy,free,glabrous,globose,golden,greenish-brown,hirsute,internodal,lanceolate,large,lateral,leaf,like,lobe,long,long-triangular,main,margin,midrib,minor,minutely,mm,narrow,narrower,narrowly,occasionally,often,older,opposite,outer,ovary,ovate,pair,pale,paler,papillose,pedicel,peduncle,petiole,point,pore,poricidal,portion,present,prominently,pubescent,raised,reproductive,rest,scar,scattered,shaped,shrub,simple,slender,slightly,spaced,sparsely,speckle,stem,stigma,style,surface,sympodial,tall,tapering,tear-drop,terminal,thickened,tip,trichome,tube,unbranched,unifoliate,uniseriate,unit,urceolate,vein,venation,way,white,wide,widening,widest,x,yellow,yellow-green,young	.05,8511,bullate,densely,dry,eaf,edicel,eed,epidermi,erose,especially,fide,geminat,inflorescenc,infloresence,know,known,larger,later,lehmann,lobed,lon,lower,middle,nearly,nflorescence,peduncl,petaloid,proximal,ruit,specimen,straight,tub,ud,upper,white-papillo,ympodial	color,count,diameter,flower,fruit,fruiting,geminate,habitat,height,inflorescence,length,major,mentioned,position,prickle,primary,seed,shape,size,stone,structure,texture,white-papillose,width,wing
285	wfo-0001029121	success	161	113	88	73	25	0.547	0-2,0.2-2,1-4,1-5,1.1-3.9,15-30,2-10,2-13,2-3,2-3-celled,4-10,4-5.5,5-20,5-8,8-16,9-33,acumen,acute,articulate,base,blue,branched,calyx,cell,cm,conical,connate,corolla,covering,cyme,deep,diameter,dichasial,dichasially,distal,dorsally,ebracteate,edge,exceeding,filament,flat,flower,folded,forked,generally,glabrous,green,hair,half,herbaceous,lateral,leaf,lobe,long,make,medium,mm,monochasial,mucilaginous,obtuse,odd-pinnate,ovoid,pedicel,perennial,petiole,plant,proximal,purple,scattered,seed,short,short-attenuate,size,stamen,stigma,straight,style,testal,thick,throughout,tip,tuber-bearing,typically,unit,wall,wide,yellow,Â¼	-6,0,1.2-2.5,1.2-3.3,10,2-,3-5,3-6-foliat,3.6-9,3.8-11,4.5-10.0,abaxiall,abaxially,acuminate,adaxially,apex,apical,apically,attenuate,commonly,cuneate,dehiscent,digestion,diminishing,eaf,eed,elliptical,emoval,enzyme,globo,gradually,green-white,hair-like,honeycomb,interjected,introrse,leaflet,living,lon,lower,lunat,maturing,narrowly,nflorescence,nther,oblique,often,orolla,ovate,pair,pattern,peduncle,perfect,petiolule,plan,poricidally,rarely,reveal,rotate,rounded,ruit,sessile,seudostipule,slit,specimen,subequal,tal,tem,terminal,throughou,toward,vary,ympodial	'hair-like,3-6-foliate,anther,color,count,free,fruit,globose,habitat,height,inflorescence,length,lunate,ovary,position,pseudostipule,shape,stem,structure,surface,sympodial,tall,texture,tube,wet
286	wfo-0001029125	success	197	160	146	51	14	0.741	.0â3.5,.1â1.4,.2,.5â2.0,.6,0.5â1.0,0.9,1,1.0â1.2,1.0â1.5,1.0â4.0,1.5â2.0,1.5â3.0,1.8â3.5,1â2-celled,2.5â12.0,2/3,20â100,3.5â4,3â5,3â5-celled,4â8,5â6,6,abaxial,abaxially,acute,adaxial,adaxially,along,anther,anthesi,apex,apparently,appressed,arising,base,berry,black,branching,brownish,calyx,cell,central,closely,cm,concave-reniform,conical,corolla,delicate,deltate,densely,diameter,difoliate,ellipsoid,end,especially,exerted,filament,flower,free,fruit,fruiting,glabrous,globose,green,herb,hilum,internodal,later,lateral,leaf,like,live,lobe,lobed,long,margin,maturity,maximum,minutely,mm,narrower,nearly,occasionally,often,one,orange,outline,ovary,ovate-lanceolate,pair,pale,papillate,pedicel,pentagonal,per,petiole,place,plant,positioned,primary,pubescent,purple,purple-tinged,purplish,reflexed,ripe,scar,scattered,seed,shorter,simple,single,slightly,small,spaced,sparsely,spreading,star,stem,stemmed,stigma,stone,strongly,style,sub-lateral,subshrub,surface,tall,testal,tip,toward,traingular,trichome,tube,turning,uniseriate,unit,usually,vein,white,wide,woody,yellow,young	.1,.4,0.5,0.5â0.6,0.8â0.9,1.7-,2â3-celled,2â4,3.0â3.4,35â45,5-merous,6â7,acuminate,age,apar,articulated,attenuate,ba,beyond,cone,cuneate,eaf,eed,entire,geminat,growt,lengthening,lon,lower,nflorescence,oblique,peduncle,perfect,pore,poricidal,portion,reflexe,ridged,ruit,shiny,slit,stellate,straight,tem,terete,tinged,ud,unequal,whitewith,ympodial,Â¼	apart,bud,color,geminate,growth,habitat,height,inflorescence,length,position,shape,structure,sympodial,texture
287	wfo-0001029150	success	177	167	134	43	33	0.757	.5,0.3,0.3-0.5,0.5â1.1,0.8-1,0.8â1,0.8â1.5,0.8â3.5,1.2â1.5,1.5,1.5â2,15,1â1.5,1â11,1â2,1â5,1â6,2.5â3,2.5â8,2â2.5,2â3,3-5,3â10,3â4,3â50,6,7â8,8-shaped,9â12,abaxially,accrescent,across,acute,adaxially,anther,apex,apically,apiculate,attenuate,base,berry,blade,branched,calyx,canopy,ciliate,climbing,cm,color,conical,cros,cylindrical,diameter,distant,ellipsoidal,elliptical,entire,except,extra-axillary,filament,flattened,flower,fruit,fruiting,glabrous,lamina,lanceolate,larger,leaf,light,lobe,long,margin,membranaceous,midvein,minutely,mm,moderately,nearly,oblique,older,opposed,ovate,pair,pale,pedicel,petiole,pinkish-white,pinnate,pointed,pubescent,rarely,reaching,rounded,rounded-deltoid,rugose,sand-punctate,scar,secondary,section,shortly,side,simple,slender,slightly,small,somewhat,sparsely,stem,stigma,strong,style,surface,tan,teardrop-shaped,thick,thickened,time,tip,tree,trichome,truncate,tube,understory,unit,vegetation,vein,venation,vine,white,wide,wiry,woody,x	0.3â0.5,1.5â2.2,2.5â5,2â10,5-merous,adaxiall,alyx,apar,apicall,axe,c.,capitat,delicate,dried,eaf,eed,enlarged,fleshy,flush,glabrou,inconspicuous,living,lon,lower,m.,material,mor,nflorescence,nternode,orolla,peduncle,perfec,plurifoliat,rachi,ruit,spaced,specimen,stellate,tamen,tem,translucent,vary,ympodial	anthesi,apart,bark,bud,capitate,cell,corolla,count,free,habitat,height,inflorescence,lateral,length,major,minor,null,ovary,plurifoliate,position,prickle,primary,seed,shape,size,stamen,stone,structure,sympodial,texture,width,wing,young
288	wfo-0001029152	success	197	156	136	61	20	0.69	.1,.5,0.5-1,0.9-1.3,1,1-1.5,1-2,1-4,1.1-1.3,1.5-1.7,2-3,2-4,2-5,2.5-3,3-5,4-6,6-8,8.5-16,acuminate,acute,anther,anthesi,apex,appressed,area,attenuate,bark,base,beneath,blade,broadened,broadly,bud,calyx,cm,conical,corky,corolla,cuneate,deciduous,decurrent,deep,deltoid,densely,difoliate,distal,dry,elliptic,erect,filament,floccose,flower,free,fruit,fruiting,glabrous,globose,green,greyish-red,hyaline,inflorescence,keeled,large-lenticellate,lateral,leaf,lightly,live,lobe,lobed,long,long-styled,main,major,margin,material,middle,midrib,minor,minutely,mm,nearly,obovate,often,older,opposite,ovary,ovoid-reniform,pair,pale,papillose,pedicel,petiole,pitted,planar,plant,pore,poricidal,prominent,prominently,red,red-floccose,reddish,reddish-floccose,reflexed,scar,shape,shaped,shiny,short-styled,shrub,simple,size,slightly,small,somewhat,soon,stem,stigma,style,surface,tall,tear-drop,third,tip,tree,trichome,tube,unit,vein,weak,white,widest,winged,woody,x,young	0.25-0.5,0.75-1,0.8-1,1-3,1.5-2,2-2.5,3-8-flowered,61-25,appearanc,appearing,ba,beginning,berry,branch,brown,citronella,closely,completely,dark,deflexed,dia,differing,eaf,edicel,eed,ellipsoi,enclosing,et,exsertion,fide,flattened,fragrance,geminat,giving,held,inflorescenc,late,lon,longer,lower,nflorescence,one,overlapping,per,plane,portion,quite,reminiscent,rounded,ruit,single,slender,spaced,straight,styl,tapering,terminal,tillett,ud,usually,ympodial	3-8,cell,color,count,diameter,geminate,habitat,height,length,position,prickle,primary,seed,specified,stone,structure,sympodial,texture,width,wing
289	wfo-0001029156	success	65	67	58	7	9	0.892	-3,0.5,1,1.5-2,10-12,2,4-6,6,6-8,<,almost,apex,apparently,bark,berry,cell,center,cm,completely,deeply,diameter,epiphytic,exfoliating,flattened,fruiting,glabrous,golden,lateral,liana,long,margin,markedly,minute,minutely,mm,multiseriate,occasionally,pale,pedicel,per,pitted,rectangular,reniform,rib-like,seed,shiny,shreddy,sinuate,stem,surface,tan,testal,thickening,trichome,vine,wall,wide,woody	eed,fide,growth,nee,new,noddin,older	habitat,height,leaf,length,nodding,texture,young,â,â
290	wfo-0001029156	success	65	61	52	13	9	0.8	-3,0.5,1,1.5-2,2,<,almost,apparently,cell,center,cm,completely,deeply,diameter,epiphytic,exfoliating,fide,flattened,fruiting,glabrous,golden,growth,lateral,liana,margin,markedly,minute,minutely,mm,multiseriate,nee,new,occasionally,pale,pedicel,pitted,rectangular,reniform,rib-like,seed,shiny,shreddy,sinuate,stem,surface,tan,testal,thickening,trichome,vine,wall,woody	10-12,4-6,6-8,apex,ark,berry,eed,em,lon,noddin,older,per,x	6,bark,habitat,length,long,nodding,position,shape,texture
291	wfo-0001029163	success	149	135	99	50	36	0.664	-25,-4,-9,0.3-2.5,0.5-1,1-2,1.5-2,1.5-2.5,1.5-3,2,2-3,2-7,2.5-3,3-4,3-5,4-20,4.5-23,5-12,5-8,7-9,9-15,abaxially,acuminate,acute,adaxially,apex,base,blade,calyx,cell,chartaceous,cm,color,connivent,cuneate,cylindrical,decurrent,deltate,densely,denser,diameter,distally,eglandular,elliptic,elliptic-ovate,flower,free,fruit,glabrous,glandular,globose,hair,herb,lanceolate,lenticular,lobe,long,margin,mm,moderately,narrowed,narrowly,nearly,obtuse,pedicel,perennial,petiole,projection,pseudohair,puberulent,puberulent-pubescent,purple,ripe,shrub,simple,small,sometimes,sparsely,stalked,stem,stigma,stone,style,subapical,subcoriaceous,surface,time,tip,triangular,tube,unbranched,unit,unknown,vein,white,whitish,wide,x,yellow	1,10-,13-18,2-18,2-6,20-30,3-14,4-5-foliat,4-6,abaxial,absen,adaxiall,aggregate,apart,articulated,axe,band,directed,distall,eaf,eed,entire,leaving,like,lon,lower,nflorescence,nther,orolla,papillose,pedicellar,peduncle,pore,puberulent-pubescen,pubescence,rachi,radiu,remnant,roughened,ruit,scale-like,slightly,spaced,stellate,tal,tem,thickened,truncat,vary,ympodial	4-5-foliate,absent,anther,anthesi,bark,bud,corolla,count,explicitly,filament,fruiting,habitat,height,inflorescence,lateral,leaf,length,major,mentioned,minor,ovary,position,prickle,primary,scar,seed,shape,size,structure,sympodial,tall,texture,truncate,width,wing,young
292	wfo-0001029171	success	137	135	95	42	40	0.693	-,-15,0.5,1-3,1-4.5,1.5-2,1.5-7.5,10-25,2-3,3-4,3.5-18,4-10,4-5,5-6,5-8,6-,7-9,abaxially,abruptly,acuminate,acute,adaxially,also,and/or,angled,apex,base,blade,branched,calyx,cell,chartaceous,cm,cuneate,decurrent,deltate,dendritically,densely,diameter,eglandular,elliptic,except,flower,forked,fruit,glabrous,gland,glandular,globose,hair,lanceolate,like,lobe,long,margin,midrib,mm,moderately,narrowed,narrowly,near,nearly,obtuse,often,orange,ovate-elliptic,pedicel,petiole,puberulent,pubescent,purple,rarely,red,ripe,rugose,shoot,short-stalked,shrub,simple,slightly,smooth,sometimes,sparsely,stigma,stone,style,time,tip,triangular,tube,unbranched,unit,white,wide,x	-10,1-5,10-35,11-20,3.5-6.5,8-17,absen,aggregate,apart,articulated,axe,ba,connivent,cylindrical,dense,directed,distall,eaf,eed,entire,glandula,lower,many-foliat,nflorescence,nther,orolla,peduncle,perfect,pore,rachi,radiu,ruit,spaced,ste,stellate,tal,tem,truncat,usually,vary,yellow,ympodial	absent,anther,anthesi,bark,bud,color,corolla,count,filament,free,fruiting,habitat,height,inflorescence,lateral,leaf,length,major,many-foliate,mentioned,minor,ovary,position,prickle,primary,scar,seed,shape,size,stem,structure,surface,sympodial,tall,texture,truncate,vein,width,wing,young
293	wfo-0001029215	success	49	88	41	8	47	0.837	.2,0.3-0.5,0.5-2.5,appearance,border,brown,calyx,cell,cm,coarse,diameter,elongating,entire,fide,fruit,give,hair-like,herb,lateral,lobe,long,markedly,narrowly,obovate,outgrowth,pubescent,round,shrub,silky,small,smelling,strong,surface,tall,testa,wall,weigend,wide,winged,woody,xyledecor	-1.8-2.3,0.5-0.7,1,2.3-2.9,eed,mm,spreadin,thick	anther,anthesi,apex,bark,base,bud,color,corolla,count,filament,flower,free,fruiting,habitat,height,inflorescence,leaf,length,major,margin,mentioned,minor,ovary,pedicel,petiole,position,prickle,primary,scar,seed,shape,size,spreading,stem,stigma,stone,structure,style,sympodial,texture,tip,tube,unit,vein,width,wing,young
294	wfo-0001029216	success	243	190	160	83	30	0.658	+,-10,.5,.8-1,0.1-0.5,0.2-0.25,0.2-0.4,0.2-0.8,0.3-0.4,0.5,0.6-1,1-1.2,1-2,1-3,1-6,1.2-6,1.5-2.5,10,10-,10-14,2,2-locular,20-35,3,3-,3-foliate,4,5,5-15-flower,7-10,acute,adpressed,and/or,angeld,annual,anther,anthesi,apex,appearance,articulation,attenuate,axi,base,basiscopically,becoming,biennial,branch,bright,calyx,capitate,cell,cm,composed,cone,conical,cordate,corolla,cultivar,decurrent,deep,diameter,erect,exserted,extending,fasciated,filament,fruit,fruited,fruiting,giving,glabrescent,gland-tipped,glandular,globose,green,hair-like,halfway,herb,imparipinnate,inflorescence,initially,internode,interrupted,lanceolate,large,later,lateral,length,less,like,linear,lobe,long,longer,margin,maturity,minute,minutely,mixture,mm,multicellular,multilocular,narrowly,numerous,oblique,obovate,often,one,orange,outgrowth,ovary,particularly,pedicel,peduncle,perennial,petiole,plant,primary,procumbent,pubescent,rarely,red,shaggy,shape,shaped,short,silky,simple,sometimes,somewhat,sparse,sparsely,spreading,stem,stigma,straight,strong,strongly,style,surface,tangled,testa,thickening,tip,toward,trichome,truncate,tube,unicellular,uniseriate,unit,usually,variety,varying,villous,viny,wall,wide,winged,yellow	-0.5,-5,0.1-0.3,0.1-0.6,0.1-0.8,0.2-0.3,0.3-0.5,0.3-2,0.4,0.4-0.5,0.5-0.8,0.5-1.5,0.5-2,0.6-0.8,0.8-2.5,1-4,1.5-2.3,1.5-3,1/,2-4.5,2.5-3.3,3-4,3-5,3-7,6-10,<,absen,absent,accrescent,acroscopically,allogamous,always,apical,appendage,articulated,basal,brown,cente,column,crenate,deeply,dentate,distal,eaf,edicel,eed,elliptic,entire,facultatively,gree,half,included,interjected,larger,leaflet,lobulate,lon,lower,mainly,near,nflorescence,ovate,pair,pale,pentagonal,petiolule,population,present,pseudostipule,reflexe,ruit,scen,secondary,sessile,staminal,sterile,tem,terminal,tertiary,thick,total,ud,ympodial	0.1-0.4,5-15,bark,bud,center,color,count,flower,free,habitat,height,leaf,major,mentioned,minor,position,prickle,reflexed,scar,scent,seed,size,stone,structure,sympodial,texture,vein,width,wing,young
295	wfo-0001029226	success	206	172	143	63	29	0.694	-7,-9,.5,.75,0-1,0.5,0.5-5,1-1.5,1-3,1-celled,10-40+,2,2-3,2-6,2-9,2.5-10,3-3.5,3-6,4,4-6,5-7,7-11,8-13,anther,anthesi,apart,apex,apparently,base,berry,branched,breaking,bright,calyx,capitate,cell,cm,congested,conical,connivent,cordate,corolla,deltate,densely,diameter,dry,ellipsoid,elongate,enation,filament,flattened,flexuous,flower,free,fruiting,glabrescent,glabrous,gland,glandular,globose,green,hairy,herbaceous,irregularly,lateral,lavender,leaf,like,lobe,lobed,long,longer,loosely,lyrate,many,margin,material,mature,mere,minute,minutely,mm,occasionally,one,open,overtopping,pair,pale,papillate,pedicel,petiole,pinnatifid,pitted,primary,pubescent,red,reflexed,reniform,rim,ripe,scar,seed,shiny,short-glandular,shorter,shrub,simple,spaced,sparsely,spot,sprawling,spreading,stellate,stem,stigma,strongly,style,surface,tan,tangled,terminal,testal,time,tip,translucent,trichome,truncate,tube,uniformly,uniseriate,unit,usually,vein,vine,wall,way,weak,white,wide,winged,woody,yellowish,Â¾	1-2,30,5-merou,>,acuminate,acute,ag,alyx,ark,articulated,ba,basal,black,blue,completely,dark,decurrent,distall,divided,eaf,eed,entire,exserted,growth,ilament,juice,lengthening,lower,membranous,new,nflorescence,often,older,orolla,papillat,papillo,peduncle,per,perfect,pinnate,plurifoliat,pore,poricidal,portion,remainin,ruit,sagittate,scarlet,sleeve,slender,slit,small,sometimes,spreadin,staining,tem,thin,third,twinin,ud,vary,widest,ympodial	bark,bud,color,count,distally,fruit,habitat,height,inflorescence,length,major,minor,ovary,papillose,plurifoliate,position,prickle,remaining,shape,size,specified,stone,structure,sympodial,texture,twining,width,wing,young
296	wfo-0001029236	success	159	135	114	45	21	0.717	.5,0.2-1,0.5-1.5,1-1.5,1-2,1.4-1.7,1/2,2-4,2-5,abaxially,absent,adaxial,age,anther,anthesi,apex,apically,appearing,bark,base,becoming,branch,branching,broadly,calyx,cm,compact,conical,coriaceous,corolla,cupulate,decurrent,deflexed,deltate,dendritic,densely,diameter,elliptic,erect,except,filament,flattened,fleshy,flower,free,fruit,fruiting,glabrous,globose,grey-brown,growth,later,lateral,leaf,lenticular,less,lobe,lobed,long,many,margin,midvein,minutely,mm,narrowly,near,obscure,obscurely,occasionally,older,ovary,overtopping,pale,pedicel,persistent,petiole,pitted,pointed,pore,poricidal,prominent,pubescent,purplish,purplish-black,reddish-brown,revolute,scar,scattered,shiny,shoot,short,shrub,simple,slightly,slit-like,sparsely,stem,stigma,strongly,style,surface,tall,terminal,time,tip,trichome,tube,usually,violet,way,wide,winged,woody,young	0.2-0.7,0.45-0.5,0.5,0.9-2.3,3,6-9,apical,apparently,axi,ba,basal,berry,bi-lobe,branchlet,completely,dichasial,eaf,edicel,eed,ew,exserted,inserted,lower,m.,middle,nflorescence,nodding,packe,per,pericarp,plurifoliate,portion,ruit,secondary,sleeve,stamen,tapering,thin,trongly,tub,ud,unit,venation,x,ympodial	bi-lobed,bud,cell,color,habitat,height,inflorescence,length,mentioned,new,position,prickle,primary,seed,shape,stone,structure,texture,vein,width,wing
297	wfo-0001029246	success	209	189	161	48	28	0.77	-1,-1.5,-4,/5,0,0.1-0.3,0.1-0.4,0.15-0.3,0.2-1.5,0.3-0.5,0.3-0.8,0.5-1.5,0.7-1.3,0.7-1.5,0.7-2,0.8-1.1,0.8-3,0.9-1.3,1-1.5,1-1.8,1-10,1-3,1-4,1-5,1-8,1.2-2,1.5-2.3,1.5-2.5,1.5-6,1.7-6,1.8-3,1/10-1/5,1/3,2-3,2-3.5,2-5,2.5-3.2,2.8-4,3-20,3-5,3.5-5,4-6,5-,5-20,5-merous,6-10,6-8,7-12,8-16,abaxially,acuminate,acute,almost,anther,apart,apex,apically,apparently,bark,base,berry,blade,c.,calyx,cm,connivent,cuneate,curved,deltate,densely,diameter,dull,elliptic,elongating,equal,erect,filament,flattened,flattened-reniform,flower,free,fruit,fruiting,glabrescent,glabrous,infructescence,lateral,leaf,length,lobe,lobed,long,longer,lower,margin,mature,maturity,mauve,midpoint,midvein,mm,moderately,narrow-deltate,narrow-ovate,obtuse,older,one,open,orange-brown,orange-red,pair,pale,pedicel,pendulous,per,petiole,poricidal,porrect,portion,prickle,prickly,primary,procumbent,pubescent,purple,ray,recurved,scar,sessile,shrub,simple,sometimes,spaced,sparsely,spherical,spreading,stellate,stellate-pubescent,stem,stout,straight,strongly,style,surface,tapering,terete,time,tip,trichome,tube,unbranched,unit,upper,vein,way,white,wide,woody,yellow,yellow-orange,Â¼	0-15,0-5,0.5,2,2/3,2/3-3/,abaxial,acuminat,adaxial,alyx,apar,articulated,broad-deltate,chartaceous,concolorous,discolorous,distance,drying,eaf,eed,entire,extending,eye,less,lon,naked,nflorescence,oblong,orange-brow,orolla,oung,peduncle,perfec,pericarp,plurifoliat,prickl,rounded,ruit,side,smooth,tamen,tertiary,unarmed,usually,vary,venation,visible,ympodial	2/3-3/4,anthesi,bud,cell,color,corolla,count,habitat,height,inflorescence,major,minor,null,ovary,perfect,plurifoliate,position,seed,shape,size,stigma,stone,structure,sympodial,texture,width,wing,young
298	wfo-0001029286	success	224	190	160	64	30	0.714	.5,0-0.5,0.1,0.8,0Â°,1-1.5,1-2,1.5-2,1.5-4,1.5-8,1/8,15-50,2-3,3-4,4-5,4-6,4.5,4.5-7,5,5-6,6-8,6-9,7-10,abaxial,abscising,acute,along,altered,anther,anthesi,apart,apex,apically,apiculate,arising,around,articulated,articulation,attenuate,axil,bark,base,becoming,branch,branched,branching,broadly,brown,canaliculate,capitate,chartaceous,closer,cm,concave,concolorous,conical,corolla,curved,cuspidate,deltoid,dendritic,density,diameter,dilated,distributed,drying,equal,except,extending,fertilization,filament,flexuous,flower,forming,free,fresh,glabrescent,glabrous,green,grey,hair,increasing,inside,isolated,known,lamina,leaf,length,liana,light,lilac,lobe,long,main,margin,mas,mauve,meeting,membranous,middle,midvein,minutely,mm,multicellular,narrowly,obconical,oblong,obovate,occasional,often,outside,ovate,pair,pedicel,peduncle,petiole,poricidal,primary,prominent,protruding,rachi,rounded,scar,side,simple,slender,smooth,sometimes,somewhat,soon,sparsely,specimen,spreading,stem,stigma,stump,style,surface,tangled,terete,terminal,thick,thickened,time,tip,together,toward,translucent,translucent-violet,trichome,tube,tuft,unarmed,unit,vein,wide,widely,x,yellowish,young	.4,0.15-0.4,0.4-1.2,0.6-1.2,2.5-3,abaxially,adaxially,age,almost,alyx,another,apar,apice,apparently,clearly,clustered,crenulate,delineated,domatia,eaf,eed,entire,faint,flat,formed,globo,inflorescenc,junction,know,lengthening,less,lobed,lower,m.,margi,much,nflorescence,nther,one,orolla,papillo,perfec,plurifoliat,pore,portion,raised,rarely,regular,ruit,separated,shallowly,smaller,stretchy,tearing,tertiary,textur,thinner,tissue,ud,uneven,vary,venation,visible,ympodial	<,bud,calyx,cell,color,count,fruit,fruiting,globose,habitat,height,inflorescence,lateral,major,minor,ovary,papillose,plurifoliate,position,prickle,seed,shape,size,specified,stone,structure,sympodial,texture,width,wing
299	wfo-0001029310	success	216	189	160	56	29	0.741	-16,-25,.1,.5,.6,/4,/6,0-5,0.1-0.2,0.2-0.3,0.2-0.8,0.5,0.5-3,0.6-1.1,1-1.5,1-4,1.2-1.5,1.8-3,10,10-13,10-15,10-20,15-20,2-3.5,2-4,20-60,200-500,3-4,3.5,4-10,4-8,45-60,5,5-10,5-20,5-30,5-6,5-7,5-8,6-8,7-12,7-13,8,abaxially,acute,ame,anther,apart,apex,apically,apparently,bark,base,beyond,blade,branched,brown,c.,calyx,cm,concolorous,conical,connivent,cordate,dark,deltate,diameter,difoliate,drying,dull,elliptic,elongating,erect,extending,filament,flattened-reniform,flower,free,fruit,fruiting,gently,glabrescent,glabrous,gray,hair,herb,inflated,lateral,leaf,length,lobe,lobed,long,long-styled,longer,lower,margin,mature,maturity,mauve,membranous,midpoint,minute,mm,moderately,narrow-deltate,older,one,open,orange-green,pair,pedicel,peduncle,perpendicular,petiole,pinnatifid,poricidal,porrect,prickle,prickly,primary,ray,recurved,retrorse,scar,sessile,short-styled,shorter,shrub,simple,sometimes,spaced,sparsely,spherical,spreading,stalk,stalked,stellate,stellate-pubescent,stem,stout,straight,style,surface,tapering,terete,time,tip,tissue,toward,trichome,truncate,tube,unit,variously,vein,way,wide,woody,yellow	0-20,00,1,1-2,1/,2.5-6,2/3-3/4,20-40,3-5,5-12,5-merous,accrescent,alyx,andromonoecious,apar,articulated,berry,distal,distance,eaf,eed,enclosing,equal,filifor,geminat,hermaphrodite,heterostylous,infructescence,lobing,lon,lowermost,midvein,nflorescence,ornately,orolla,oung,pendent,pendulous,per,pericarp,plant,portion,prickl,red-brow,ruit,secondary,side,smooth,staminat,strongly,tamen,tertiary,vary,venation,visible,ympodial	1/3,anthesi,bud,cell,color,corolla,count,filiform,geminate,habitat,height,inflorescence,major,minor,null,ovary,position,red-brown,seed,shape,size,stigma,stone,structure,sympodial,texture,width,wing,young
300	wfo-0001029317	success	151	141	115	36	26	0.762	.5,0.25,0.5,0.5-0.75,0.5-1,0.8-1,1,1-1.5,1.5-3.5,10-16,10-30-flowered,11-14,2-3,2.5-5,6-8,6.5-11,7-8,8-9,acuminate,anther,anthesi,apex,area,attenuate,base,beneath,broadly,bud,ca,calyx,channeled,closely,cm,corolla,cup-like,deltoid,densely,denser,dia,difoliate,erect,extreme,filament,free,fruiting,geminate,glabrate,glabrous,globose,grayish,immature,inflorescence,lateral,leaf,like,lobe,lobed,long,main,major,margin,middle,minor,minutely,mm,narrowly,nearly,often,opposite,ovary,ovate,overlapping,pair,paler,papillose,pedicel,petiole,pore,poricidal,probably,prominent,proximal,pubescent,raised,reflexed,remaining,rest,rounded,scar,shaped,shrub,simple,size,slightly,soft,spaced,sparsely,stem,stigma,style,tall,tear-drop,thickened,tip,trichome,tube,tuft,uniseriate,unit,vein,white,widest,x,yellowish,young	along,apar,barely,brow,deciduou,deflexed,differing,dry,eaf,edicel,eed,ellipsoi,epidermi,exserted,frui,known,lon,lower,nflorescence,occasionally,older,one,otherwise,ovoid,portion,rachi,ruit,slender,soon,specimen,straight,styl,tapering,ud,visible,ympodial	10-30,bark,brown,cell,color,count,deciduous,diameter,flower,fruit,habitat,height,length,mentioned,position,prickle,primary,seed,shape,stone,structure,surface,sympodial,texture,width,wing
301	wfo-0001029332	success	197	167	138	59	29	0.701	-5,.5,/3,0,0-20,0-4,0-5,0.1,0.1-0.2,0.15-0.2,0.15-0.25,0.5-1,0.8-1,1-1.5,1-2,1-3,1.3-1.5,1.5-2,1/2,1/3,1/4-1/3,10-30,2,2-2.5,2-4,2.8-3.7,2/3-3/4,3-4,3-6,3.5-5,4-10,4-15,5-6,6-8,8.5-9.5,abaxial,abaxially,anther,apart,apex,apically,apparently,bark,base,becoming,blade,calyx,cm,conical,connivent,cordate,curved,densely,diameter,difoliate,elongating,erect,filament,flattened,flattened-reniform,flower,free,fruit,fruiting,glabrescent,gland,globular,herbaceous,lateral,leaf,length,less,lobe,lobed,long,long-styled,lower,margin,mature,maturity,mauve,midpoint,mm,moderately,narrow-deltate,often,older,one,open,orange-brown,ovate,pair,pale,pedicel,pendulous,petiole,poricidal,porrect,prickle,prickly,primary,pubescent,ray,reduced,rounded,scandent,scar,sessile,shorter,shrub,slender,spaced,spherical,spreading,stalk,stalked,stellate,stellate-pubescent,stem,style,subsessile,surface,tapering,terete,terminal,time,tip,trichome,tube,unbranched,unit,upper,variously,vein,way,wide,woody,yellow	0-0.5,0-100,0-2,1-4,1/4,2.5-3.5,2/,5-8,5-merous,adaxial,alyx,andromonoecious,apar,articulated,berry,broad-deltate,chartaceous,concolorous,distal,distance,drying,eaf,eed,equal,extending,geminat,glabrous,grayi,hermaphrodite,heterostylous,infructescence,long-acuminat,longer,lowermost,midvein,nflorescence,orolla,oung,peduncle,per,pericarp,plant,portion,prickl,ruit,short-styled,side,simple,smooth,staminat,tamen,tertiary,vary,venation,visible,weakly,yellow-green,yellow-orange,ympodial	2/3,anthesi,bud,cell,color,corolla,count,geminate,grayish,habitat,height,inflorescence,long-acuminate,major,minor,null,ovary,position,seed,shape,size,stigma,stone,structure,sympodial,texture,width,wing,young
302	wfo-0001029333	success	155	146	122	33	24	0.787	.25,.5,/4,0.5-1,0.7-1,1-1.2,1-1.5,1-15,1-2,1-7,1.5-2,1.5-3,10-15-flowered,100,17-26,2-2.5,3-7,3-7.5,5-6,8-15,9-13,abaxial,acuminate,acute,along,anther,anthesi,apex,auriculate,bark,base,beige,broadly,calyx,clavate,cm,conical,corolla,deflexed,dendritic,dendritic-pubescent,densely,denser,difoliate,dry,elliptic-obovate,erect,filament,flattened-reniform,flower,free,fresh,fruiting,geminate,glabrous,globose,golden,green,incrassate,lateral,leaf,like,lobe,lobed,long,long-styled,main,major,margin,minor,minutely,mm,obovate,occasionally,older,opposite,orbicular,ovary,pair,pale,paler,pedicel,petiole,pitted,planar,present,pubescence,pubescent,reddish-brown,rest,rounded,scar,sessile,shape,shining,short-styled,shrub,simple,size,slender,small,somewhat,spaced,sparsely,stem,stigma,style,surface,tall,time,tip,tree,triangular,trichome,truncate,tube,unit,vein,way,wide,woody,young	0.5,1-3,1.5-2.5,abaxially,adaxially,anisophyllou,ba,beneath,berry,contracted,dia,differing,eaf,edicel,eed,exserted,heteromorphic,inflorescenc,lon,lower,nflorescence,overlappin,papillo,pore,poricidal,portion,ruit,shaped,strongly,tear-drop,type,ud,ympodial	anisophyllous,bud,cell,color,count,diameter,fruit,habitat,height,inflorescence,length,overlapping,papillose,position,prickle,primary,provided,seed,stone,structure,sympodial,texture,width,wing
303	wfo-0001029334	success	211	163	129	82	34	0.611	0.15-0.3,1,1-2,1-3,1-6,1.3-4.5,1.8-2.9,2,2-8,4-8.5,5-10,7.5-15.5,8-30,9-12,abaxially,absent,acumen,acute,adaxially,almost,along,among,anther,apex,apparently,attenuate,axe,axillary,base,berry,blade,broadly,bud,cell,chartaceous,ciliate,clavate,cm,connivent,cordate,corolla,covering,cuneate,decurrent,densely,diameter,distal,elliptic,especially,filament,flower,forked,fruit,generally,glabrous,globose,grassland,green,green-white,hair,half,herb,interjected,lanceolate,lateral,leaflet,like,lobe,long,make,margin,membranous,midrib,minutely,mm,mucilaginous,narrowly,oblique,obtuse,odd-pinnate,orbicular,ovate,ovoid,pedicel,perfect,petiole,petiolulate,petiolule,plant,plurifoliate,puberulent,pubescent,pure,rarely,ripe,rounded,seed,sessile,shady,short,situation,size,slightly,stellate,stem,stigma,style,subsessile,subtending,sunny,tall,terminal,testal,thick,throughout,tinged,tip,tri-,tube,typically,unit,unwinged,usually,violet,wall,wet,white,woodland,x	.2,0-4,1-10,1.5-3.9,1.5-6,2-2.5,2-4,2-5,2.5-3,3-5,3-7,3.2-5.8,3.3-6.5,4-5.5,5-merou,ag,alyx,apart,articulated,borne,brownish,capitat,condition,decreasing,digestion,dorsally,drying,eaf,edge,eed,end,enzyme,erect,exceeding,except,flat,folded,fresh,geminat,glabrou,gradually,greatly,greenish,hair-like,homostylous,honeycomb-shaped,lengthening,living,low-growin,lower,middl,nflorescence,often,orolla,pair,peduncle,pore,poricidal,proximal,reduced,removed,ruit,semi-rosette,seudostipule,singly,slit,spaced,specimen,stamen,ste,stolo,straight,subequal,tamen,tem,toward,tuber,vary,whitish,wide,yellow,ympodial	'hair-like,anthesi,bark,calyx,capitate,color,count,free,fruiting,geminate,habitat,height,inflorescence,leaf,length,major,mentioned,minor,ovary,position,prickle,primary,pseudostipule,scar,shape,stone,structure,surface,sympodial,texture,vein,width,wing,young
304	wfo-0001029344	success	147	147	108	39	39	0.735	.5,0.4-1,0.5-1,0.5-1.5,0.5-3,1,1-2,1-3,1-5,1-6,1.5,1.5-4,10-20,2-3,2-3-celled,2-7,3-10,4-6,5-12,5-15,abaxially,absent,abundant,acute,adaxially,along,anther,apex,base,berry,beyond,brown,calyx,center,chartaceous,cm,connected,cordate,decurrent,densely,diameter,difoliate,dm,drying,edge,elliptic,elliptic-ovoid,equal,exserted,filament,fine,flower,fruit,glabrous,globose,hair,herb,immature,interpetalar,lacking,linear-lanceolate,lobe,long,margin,maturing,membranaceous,mm,moderately,nearly,notch,oblong,obtuse,obvious,often,one-,parallel,pedicel,peduncle,petiole,placenta,pubescent,rachi,radiating,raised,rhizomatous,ridge,rounded,running,semitransparent,shallow,short,sparsely,stamen,stigma,straight,style,surface,swollen,tissue,triangular,tube,two-celled,unbranched,unit,vein,white,x,yellow	1.5-3,10-35,2-4,adaxiall,axe,blade,ciliate,dehiscing,denser,eaf,eed,emarginat,entire,explosively,flat,frui,geminat,held,lower,lying,maturit,mesocarp,nflorescence,orolla,per,pressure,pubescen,rotate,ruit,slightly,sometimes,tal,tamen,tem,vary,watery,wid,woody,ympodial	anthesi,bark,bud,cell,color,corolla,count,dense,emarginate,free,fruiting,geminate,habitat,height,inflorescence,lateral,leaf,length,major,minor,null,ovary,position,prickle,primary,scar,seed,shape,size,stem,stone,structure,sympodial,texture,tip,wide,width,wing,young
305	wfo-0001029363	success	152	143	118	34	25	0.776	.25,/4,0-0.1,0.1-0.5,0.2-1.1,0.5-1,1,1-1.2,1.5-1.7,1.5-3.5,2-6,3-7,4-11,5-7-flowered,6-7,7-10,acuminate,acute,anther,anthesi,apex,axil,bark,base,becoming,beginning,beneath,berry,bi-lobed,bud,calyx,capitate,closely,cm,corolla,cup-shaped,deep,deflexed,deltoid,densely,dia,edge,elliptic,erect,filament,free,fruit,fruiting,glabrous,globose,green,greyish,immature,internodal,known,larger,lateral,leaf,lobe,lobed,long,main,margin,maroon,mature,meeting,middle,minutely,mm,much,narrowly,near,obtuse,occasionally,often,opposite,ovary,overlapping,pair,papillose,pedicel,petiole,poricidal,prominent,pubescent,reflexed,scar,shiny,shrub,simple,slender,small,somewhat,spaced,sparsely,stem,stigma,style,surface,tall,tapering,tip,tree,trichome,tube,tuft,uniseriate,unit,usually,vein,way,white,white-papillose,wide,widest,woody,yellowish,young	.75,0.5,6-8,ba,coroll,drying,eaf,edicel,eed,except,exsertion,inflorescenc,lamina,later,lon,lower,minute,nflorescence,older,pale,paler,papillo,pore,portion,ruit,slit-like,sparse,straight,terminal,thickened,ud,unifoliat,upon,ympodial	cell,color,count,diameter,flower,habitat,height,inflorescence,length,major,minor,position,prickle,primary,seed,shape,size,specified,stone,structure,sympodial,texture,unifoliate,width,wing
306	wfo-0001029364	success	153	148	113	40	35	0.739	-2,-6,.5,0.2-0.5,1-,1-3,1-4,1-5,1.5-2,10-27,2,2-,2-6,3-4,4-12,5-,5-11,5-9,6-8,8-15,abaxially,according,acuminate,acute,adaxially,aggregate,anther,apart,apex,around,articulated,base,bitter,blade,blue,calyx,cell,center,cm,color,connivent,corolla,cream,cuneate,curled,cylindrical,darker,deep,diameter,distally,elliptic,entire,extra-axillary,fide,filament,finger,flower,free,fruit,glabrous,gland-tipped,globose,green,greenish,hair,herb,lobe,major,margin,membranaceous,mesocarp,minutely,mm,moderately,narrowly,nearly,obtuse,ovate,pedicel,perfect,petiole,presence,present,puberulent,pubescent,ripe,rusby,sagittate,shallow,short-tomentose,shrub,side,simple,spaced,sparsely,spot,stellate,stigma,stone,strongly,style,tapered,tightly,triangular,tube,unbranched,unit,unknown,vein,white,wide,x,yellow	-3,1,191.,2-foliat,4-9,7-9,8-10,?,axe,ba,chartaceous,directed,distall,eaf,ed,glandular-puberulen,immature,inserted,long,lower,nflorescence,orolla,part,peduncle,pore,puberulen,rachi,radiu,ruit,shorter,small,tal,tamen,tem,thecae,time,tomento,truncat,vary,ympodial	1912,2-foliate,anthesi,bark,bud,count,fruiting,glandular-puberulent,habitat,height,inflorescence,lateral,leaf,length,minor,ovary,position,prickle,primary,scar,seed,shape,size,stem,structure,surface,sympodial,tall,texture,tip,tomentose,truncate,width,wing,young
307	wfo-0001029368	success	139	132	106	33	26	0.763	.5,0,0.5-2,0.9-1,1.5-1.6,1.5-2,1.5-3,1.5-4,11-13,16-25,2-5,2.5-4,5-6,?,abaxially,acuminate,acute,adaxially,along,anther,anthesi,apex,apparently,bark,base,bitter,breaking,broadly,calyx,capitate,closely,cm,coarse,conical,corolla,crumpled,cup,densely,dia,elliptic,erect,exserted,few-branched,fide,filament,flattened,flower,free,fruit,fruiting,glabrous,globose,golden,green,herb,indistinct,inflorescence,internodal,known,lanceolate,lateral,leaf,leaving,like,lobe,main,margin,midrib,minute,minutely,mm,obtuse,opposite,ovary,pair,papillose,parallel,pedicel,petiole,pore,poricidal,puberulent,reflexed,rest,scar,shaped,shrub,simple,somewhat,stem,stigma,strongly,style,tall,tear-drop,tip,trichome,tube,uniseriate,unit,vein,white,winged,woody,x,young	.2,.25,bearing,berry,borne,brow,deflexed,distal,eaf,edicel,eed,half,inflorescenc,lamina,long,lower,margi,middle,nflorescence,non-flower,older,one,overlappin,papillo,portion,ruit,spaced,straight,ud,unifoliat,upper,widest,ympodial	brown,bud,cell,color,count,diameter,habitat,height,length,major,minor,position,prickle,primary,provided,seed,shape,size,stone,structure,surface,sympodial,texture,unifoliate,width,wing
308	wfo-0001029370	success	224	190	162	62	28	0.723	-20,-32,.1,.3,.5,/4,0-3,0.1,0.1-0.15,0.2,0.3,0.5-1,0.5-2.2,1-2,1-3,1-4,1.5-6,1.8-2.5,1/3-1/2,10-17,10-40,12-17,15-30,2-10,2-20,2-3,2-6,3-4,3.5-8,4-7,4-9,5-10,5-12,5.5-7,6-15,7-11,7-13,8-14,8-20,8-23,abaxial,abaxially,adaxial,ame,anther,apart,apex,apically,apparently,bark,basal,base,berry,blade,branched,broad-deltate,c.,calyx,cm,conical,connivent,cordate,cream,curved,dark,densely,diameter,elongate,erect,filament,fine,flattened,flattened-reniform,flower,free,fruit,fruiting,fully,gently,glabrescent,green,greenish,herb,lateral,leaf,length,lobe,long,long-styled,longer,lower,margin,marking,mature,maturity,mauve,midpoint,mixture,mm,moderately,multangulate,obtuse,often,older,one,open,opening,orange,orange-brown,ornate,ovate,overlapping,pair,pale,pattern,pedicel,perpendicular,petiole,poricidal,porrect,prickle,prickly,primary,ray,red-brown,reticulate,rounded,scar,sessile,shiny,short-styled,shrub,simple,slightly,smooth,sometimes,spaced,spherical,spreading,stalk,stalked,stellate-pubescent,stem,stout,straight,style,surface,tapering,terete,time,tip,trichome,tube,unit,variously,vein,venation,white,whitish,wide,yellow,young	0-10,0-100,0-35,1,1.8-2.8,1/4-1/3,10-50,2.5-3.5,3.5-4,3/,4-6,5-merous,acut,almost,alyx,andromonoecious,apar,articulated,chartaceous,clearly,discolorous,distal,distance,drying,eaf,eed,elongating,equal,extending,fewer,glabrous,hermaphrodite,heterostylous,infructescence,lobed,lowermost,midvein,nflorescence,orolla,oung,peduncle,pendulous,per,pericarp,plant,plurifoliat,portion,prickl,rotate,ruit,side,staminat,strongly,tamen,tertiary,unarmed,vary,visible,way,white-gra,woody,ympodial	3/4,acute,anthesi,bud,cell,color,corolla,count,habitat,height,inflorescence,major,minor,null,ovary,plurifoliate,position,seed,shape,size,stigma,stone,structure,sympodial,texture,white-gray,width,wing
309	wfo-0001029373	success	199	152	114	85	38	0.573	.0â1.2,.3,.5,.5â2.0,0.5â1.2,1.0â1.6,1.2â1.5,1.4â3.5,1.5â2.7,1.8â2.0,180Â°,2-celled,2.0â2.5,20â30,2â4-celled,3â5,4â6,abaxially,acuminate,acute,adaxially,anther,anthesi,apex,appressed,bark,basal,base,bayonet,berry,beyond,broadly,bud,calyx,capped,cell,clavate,cm,cone,conical,corolla,deltate,densely,diameter,distal,ellipsoid,elongate,enclosing,entire,exerted,filament,finger,flattened-reniform,flower,free,fruit,fruiting,glabrous,glandular-tipped,globose,green,grey-brown,hair,half,herb,internodal,lateral,leaf,like,lobe,long,margin,minute,minutely,mm,moderately,mouth,obtuse,ovary,ovate-lanceolate,pair,papillate,pedicel,petiole,pitted,plurifoliate,portion,primary,pubescent,reflexed,rounded,scar,shape,short,simple,spaced,spreading,stem,stigma,style,surface,tall,terete,thicker-walled,tip,trailing,trichome,tube,uniseriate,unit,upper,vein,white,wide	.2,0.3â0.5,0.4â1.6,0.5â1.8,0.6â0.7,1.0â1.2,1.3â2.2,1.5â2.0,1.5â2.5,1.8â2.3,2.7â3.0,3,3.5â4.0,30â40,4â5,5,5-merous,5â6,6.8,8â9,abaxial,accrescent,adaxial,age,apar,appearanc,arising,articulated,curved,developing,eaf,eed,enclosed,fully,geminat,growth,halfway,hilum,immature,individual,laterally,lengthening,less,live,lobed,lon,lower,mature,mesocarp,middle,new,nflorescence,node,older,outline,peduncle,pentagonal,per,perfect,plant,pore,poricidal,positioned,resembling,root,ruit,seen,seudostipule,shallowly,slightly,slit,smoot,stellate,still,straight,tem,testal,tub,ud,woody,yellow,yellow-green,yellowish,ympodial,â5	-5,.0-1.2,.5-2.0,0.3-1.8,1.0-1.6,1.2-1.5,1.3-2.2,1.4-3.5,1.5-2.0,1.5-2.5,1.8-2.0,2.0-2.5,3-5,4-5,5-6,apart,color,count,geminate,habitat,height,inflorescence,length,major,mentioned,minor,position,prickle,seed,size,smooth,stone,structure,sympodial,texture,width,wing,young
310	wfo-0001029402	success	113	112	74	39	38	0.655	0.5-1,0.5-2,1-2.5,15-30,2,2-10,2-3,3-4,3-6,4-8,5-25,6-16,7-11,7-8,7-9,8-15,abaxially,acuminate,acute,adaxially,apart,apex,articulated,base,blade,branched,calyx,chartaceous,cm,color,connivent,cylindrical,deltate,denser,diameter,elliptic,fleshy,flower,forked,free,glabrate,glabrous,hair,lanceolate,leaving,lobe,long,margin,mm,moderately,narrowed,narrowly,pedicel,petiole,pubescent,rachi,scar,shrub,simple,somewhat,spaced,sparsely,stigma,style,surface,tapered,time,tip,triangular,tube,unit,violet,wide,x	11-17,3-5,4-6,4-7,abaxial,axe,band,ciliolate,directed,distall,eaf,eed,glabrou,inrolled,lower,many-foliat,nearly,nflorescence,nther,often,orolla,papillose,peduncle,pore,pubescence,rachise,radiu,roughened,ruit,scale-like,stellate,tal,tem,thickened,truncat,unknow,unknown,vary,ympodial	anther,anthesi,bark,bud,cell,corolla,count,filament,fruit,fruiting,habitat,height,inflorescence,lateral,leaf,length,major,many-foliate,minor,null,ovary,position,prickle,primary,seed,shape,size,stem,stone,structure,sympodial,tall,texture,truncate,vein,width,wing,young
311	wfo-0001029404	success	154	125	83	71	42	0.539	-3,0.5-1,1,1-4,2-3,2-4,2.5-22,2.5-3,5-10,5-24,6-8,6.5-34,abaxially,acuminate,acute,adaxially,anther,apex,apiculate,auriculate,basal,base,branched,calyx,cell,center,cm,connivent,cordate,dark,darker,deltate,densely,diameter,eglandular,ellipsoidal,flattened,fleshy,flower,fruit,glabrous,glandular,green,hair,lanceolate,less,lobe,long,longitudinal,margin,mm,moderately,mottling,obtuse,orange,ovate,ovoid,pedicel,petiole,pink,puberulent,pubescent,purple,ripe,shrub,small,somewhat,sparsely,star,stigma,stone,style,subcoriaceous,toward,tree,triangular,tube,unbranched,unit,vein,white,x,yellow	-1.5,-10,-5,0-60-flower,1.5-2,15-25,2,2-5,2-8,20-35,3-4,3-5,3-8.5,4-foliat,5-20,5-6,6-9,8-12,absent,aggregate,apart,ape,articulated,axe,beyond,blade,chartaceous,connective,cream,cylindrical,directed,distally,eaf,eed,entire,exserted,glandular-puberulen,leaving,lemon,light,lon,lower,narrowly,nflorescence,nther,orang,orolla,pedicellar,peduncle,perfect,pore,presen,rachi,radiu,remnant,ruit,shorter,simple,slightly,spaced,stellate,tal,tem,thecae,time,tomento,truncat,ud,vary,wide,ympodial	0-60,4-foliate,anthesi,bark,bud,color,corolla,count,filament,free,fruiting,glandular-puberulent,habitat,height,inflorescence,lateral,leaf,length,major,mentioned,minor,ovary,position,present,prickle,primary,scar,seed,shape,size,stem,structure,surface,sympodial,tall,texture,tip,tomentose,truncate,width,wing,young
312	wfo-0001029406	success	136	147	121	15	26	0.89	.5,0.3-1,0.5-1,0.6-1,1-1.5,1-10,1-2,1.5-2.2,1.5-2.5,1.5-5,2,2-11,2-3,2.5-3.5,28,3-9,30,4-18,4-6,7-12,abaxially,acute,adaxially,along,anther,anthesi,apex,arachnoid,arachnoid-pubescent,bark,base,berry,broadly,brown,brownish,calyx,clavate,cm,conical,corolla,dark,deciduous,deflexed,deltate,densely,dia,difoliate,dry,elliptic,felt-like,filament,free,fruiting,glabrous,globose,grayish-brown,grayish-green,green,greenish-white,impressed,large,lateral,leaf,lenticel,lilac,lobe,lobed,long,main,major,margin,matted,maturity,middle,minor,minutely,mm,nearly,occasionally,often,ovary,ovoid,ovoid-reniform,pair,pale,papillose,pedicel,petiole,pitted,planar,pointed,population,pore,poricidal,pubescent,shaped,shiny,shrub,size,slightly,small,soon,stem,stigma,style,surface,tall,tear-drop,tinge,tip,tree,trichome,tube,unit,vein,waxy,white,wide,widest,woody,young	0.7-1.5,ba,bullate,conspicuously,differing,eaf,eed,geminat,lon,lower,older,papillo,portion,ruit,ympodial	0.3-1.5,bud,cell,color,count,diameter,flower,fruit,geminate,habitat,height,inflorescence,length,null,position,prickle,primary,scar,seed,shape,stone,structure,sympodial,texture,width,wing
313	wfo-0001029407	success	208	186	161	47	25	0.774	-10,-2,-25,-4,-6,-7,.5,/3,0,0-2,0-4,0-5,0.1-0.2,0.1-0.25,0.15-0.4,0.2-0.3,0.4-0.7,0.4-1,0.5-0.7,0.5-1.5,0.5-2,0.6,0.7-1.2,1,1-1.4,1-2,1-3,1-4.5,1.5,1/3,1/3-1/2,1/5,1/8-1/5,2-3,2-4,2-5,2.5-3,3-4,3.5-4.5,4-15,4-9,4.5-6,5-7,6-20,7-8,abaxially,acute,almost,anther,apart,apex,apically,apparently,bark,base,blade,bright-red,calyx,cm,connivent,cuneate,curved,dark,deltate,densely,diameter,difoliate,dull,elliptic,elongating,erect,evenly,filament,flattened,flattened-reniform,flower,free,fruit,fruiting,geminate,glabrescent,glabrous,gray-greenish,green,lateral,leaf,length,lobe,lobed,long,longer,lower,margin,mature,maturity,mauve,midpoint,mm,moderately,obtuse,occasionally,older,one,open,orange,orange-brown,ovate,pair,pale,pedicel,pendulous,petiole,poricidal,porrect,prickle,prickly,primary,pubescent,ray,recurved,reflexed,rounded,scar,sessile,shorter,shrub,simple,slender,sometimes,spaced,sparsely,spherical,spreading,stalk,stalked,stellate,stellate-pubescent,stem,stout,straight,straw-yellow,style,surface,tapering,terete,thick,time,tip,trichome,tube,unbranched,unit,upper,vein,way,weakly,white,wide,woody,yellow,young	0-15,0.6-0.9,1-4,1.8-2.5,3-6,5-merous,6-13,abaxial,acut,adaxial,alyx,apar,articulated,berry,brow,chartaceous,discolorous,drying,eaf,eed,entire,equal,geminat,green-brown,infructescence,lengt,nflorescence,orolla,oung,peduncle,per,perfec,pericarp,portion,prickl,rarely,ruit,side,smooth,strongly,tamen,tertiary,vary,venation,visible,yellow-green,ympodial	anthesi,brown,bud,cell,color,corolla,count,habitat,height,inflorescence,major,minor,null,ovary,position,seed,shape,size,stigma,stone,structure,sympodial,texture,width,wing
314	wfo-0001029408	success	244	225	195	49	30	0.799	-1.5,-10.5,-4.5,.2-3.5,/10,0-100,0.2-0.3,0.9-1.3,0.9-1.6,1-8,1.1-1.5,1.4-1.9,1.6-2.8,1.7-2.4,1.8-3.5,1/2,1/2-3/4,1/4,11-31,2-12,2-3.5,2-4,2-5,2/3,3-5,3.5-5,4-14,5-24,5-6,5-6.5,5-8,7-12,abaxially,accrescent,acuminate,acute,adaxially,anther,anthesi,apex,apical-lateral,axe,axillary,bark,base,becoming,berry,blade,blunt-tipped,branched,broadly,brown,bud,calyx,clavate,cm,conical,continued,corolla,cuneate,dehiscing,deltoid,dendritic-multangulate,densely,diameter,directed,distal,due,echinoid,elliptic,exserted,extend,faintly,few-rayed,filament,fleshy,flower,free,fruit,fruiting,glabrous,globose,gray,growth,hair,high,honeycombed,indument,inserted,interpetalar,introrse,lacking,lanate,lanceolate,large,lateral,leaf,length,lilac,lobe,lobed,long,long-,long-attenuate,long-stalked,longitudinal,main,many,margin,midvein,mixed,mm,moderately,mostly,multangulate,near,nearly,oblong,obscured,obtuse,often,older,orbicular,ovate,ovate-lanceolate,overlapping,pale,part,partly,pedicel,perfect,persistent,petiole,plurifoliate,pore,porrect-stellate,present,pseudo-terminal,pubescent,purplish,rarely,ray,relatively,reniform,reticulate-punctate,ribbed,ripe,sessile,short-,short-attenuate,short-stalked,shrub,side,simple,slightly,slit,small,sometimes,stamen,stelliform,stem,stigma,style,subcampanulate,suborbicular,subovate,suture,terete,testa,thick,thick-stalked,thin-stalked,time,tissue,tomentose,tomentum,touching,toward,tree,tube,turbinate,unarmed,unit,usually,vein,velutinous,way,well,white,whitish,wide,x,yellow,yellowish,young	0,0.3-5,0.5-2.5,0.7-1.2,1.5-3,2.2-3.7,2.5-7,4-20,4-7.5,5-merou,adaxiall,ag,alyx,apart,articulated,ba,barely,branch,capitat,chartaceous,dark,decurrent,dendritic-echinoi,develope,distall,eaf,echinoi,eed,entire,green,homostylous,lower,m.,nflorescence,orolla,peduncle,rachi,rather,rotate-stellate,ruit,runk,spaced,tamen,thick-textured,tomentu,top,unarme,vary,ympodial	age,capitate,cell,color,count,dendritic-echinoid,developed,distally,habitat,height,inflorescence,major,minor,ovary,position,prickle,primary,scar,seed,shape,size,specified,stone,structure,surface,sympodial,texture,tip,width,wing
315	wfo-0001029417	success	213	169	137	76	32	0.643	0-7,0.2-0.6,0.4-8,0.7-3,1,1-2,1-8,1.5-1.8,1.5-10,1.5-8,12,2.5-10,2.8-3.5,3-14,3-5,5-15,8-15,8-9,abaxially,acuminate,acute,adaxially,along,anther,apex,apiculate,attenuate,axillary,base,berry,blue,broadly,brownish,bud,cell,ciliate,clavate,cm,coarsely,condition,corolla,covering,dark,deep,diameter,distal,dorsally,dot,drying,edge,erect,especially,filament,flat,flower,folded,forked,fresh,fruit,glabrous,globose,green,green-white,greenish,hair,hair-like,herb,interjected,lanceolate,lateral,leaflet,like,linear,lobe,long,lunate,make,margin,medium,midrib,minute,minutely,mm,moderately,mucilaginous,narrowly,non-glandular,odd-pinnate,often,orbicular,ovate,ovoid,pedicel,petiole,petiolulate,pilose,plant,plurifoliate,puberulent,pubescent,purple,rarely,ripe,rounded,scattered,seed,sessile,short,size,slightly,sometimes,stem,stigma,style,subtending,tall,terminal,testal,thick,throughout,tinged,tip,tri-,trichome,tube,typically,unit,unwinged,usually,violet,wall,wet,white,whitish,wide,wing,x	.5,1-1.5,1-10,1-4,1.3-8,2-4,4-7,5-merou,6-11,acumen,ag,alyx,apart,apparently,articulated,axe,basiscopic,blade,borne,capitat,central,chartaceous,connivent,decreasing,decurrent,digestion,eaf,eed,end,enzyme,erec,exceeding,geminat,generally,glabrou,greatly,hal,half,homostylous,honeycomb-shaped,lengthening,living,lower,membranous,nflorescence,orolla,pair,peduncle,pentagonal,perfect,pore,poricidal,rapidly,removed,rotate,ruit,seudostipule,short-petiolulate,side,singly,slit,spaced,specimen,stamen,star,ste,stolo,straight,subequal,tamen,tem,tuber,vary,widely,yellow,ympodial	anthesi,bark,calyx,capitate,color,count,free,fruiting,geminate,habitat,height,inflorescence,leaf,length,major,minor,null,ovary,position,prickle,primary,pseudostipule,scar,shape,stone,structure,surface,sympodial,texture,vein,width,young
316	wfo-0001029461	success	217	181	153	64	28	0.705	-1.5,-2,-3,-3.2,-4.5,-5,.5,0,0.1,0.1-0.25,0.15-0.25,0.6-1,0.7-1,1-,1-1.6,1-6,1.2-1.7,1.3-2.2,1.5-,1.5-2,1/3,1/3-2/3,1/4-1/2,2-2.8,2-3,2-4,3-20,3-6,4-6.5,4-7,4.7-7.2,5-10,7-10,7-12,8-9,abaxially,almost,ame,anther,apart,apex,apically,attenuate,bark,base,becoming,berry,black,breaking,brittle,broad-deltate,brown,c.,calyx,cell,cm,cuneate,curved,dark,densely,diameter,elliptic,elongating,erect,evenly,fifth,filament,fine,flattened,flattened-reniform,flower,four,free,fruit,fruiting,glabrescent,glabrous,green,leaf,length,lobe,lobed,long,long-styled,longer,margin,mature,maturity,mauve,midpoint,mm,moderately,oblong,obtuse,older,orange,outline,ovate,pair,pedicel,petiole,pit,poricidal,porrect,portion,prickle,prickly,primary,raised,ray,reddish,reduced,reflexed,rounded,sessile,shiny,shrub,side,slender,slightly,small,smooth,sometimes,spaced,sparsely,spherical,spreading,stalk,stalked,staman,stellate,stellate-pubescent,stem,straight,strongly,style,surface,terete,time,tip,trichome,tube,unarmed,unequal,unit,upper,variously,vein,way,wide,woody,yellow,young	-14,-3/4,-4,0.8,0.8-1.5,1-2,1-3,1-4,1.2-1.8,1/4,2-2.4,2.5-3,4-10,4.5-7,5-25,5-merous,acuminat,alyx,andromonoecious,blade,chartaceous,concolorous,discolorous,distal,distance,drying,dull,eaf,eed,extending,faint,gra,hermaphrodite,heterostylous,infructescence,lengt,lower,lowermost,midvein,obovate,orolla,oung,pendulous,per,pericarp,plant,plurifoliat,prickl,ruit,shallow,short-styled,shorter,simple,staminat,subentire,tamen,tertiary,unarme,vary,venation,visible,weakly,ympodial,zygomorphic	acuminate,anthesi,bud,color,corolla,count,gray,habitat,height,inflorescence,lateral,major,mentioned,minor,ovary,plurifoliate,position,scar,seed,shape,size,stigma,stone,structure,sympodial,texture,width,wing
317	wfo-0001029462	success	166	151	113	53	38	0.681	-2,-30,-4,-5,0.5-1,0.5-2,1,1-2,1-3,1-6,1.5,1.5-2,1.5-3,1.5-7,2-3,2.5-3.5,2.5-5.5,3,3-18,3-4,3-5,3-6,4-20,5-30,6-9,7-19,7-8,8-9,abaxially,abruptly,acuminate,acute,adaxially,aggregate,apex,basal,base,beyond,blade,broad,calyx,cell,chartaceous,ciliate,cm,connivent,constricted,cuneate,curled,dark,densely,dentate,diameter,eglandular,ellipsoidal,elliptic,equal,exserted,flattened,flower,fruit,glabrous,green,hair,lanceolate,laterally,leaving,light,lobe,long,longitudinal,margin,membranaceous,mm,moderately,narrowly,obtuse,often,oval,ovate,ovoid,pedicel,pedicellar,perfect,petiole,pubescent,pubescent-pilose,purplish,remnant,reticulate,rounded,simple,smooth,somewhat,sparsely,stamen,stigma,stone,stripe,style,time,tip,tomentose,triangular,truncate,tube,unbranched,unit,white,wide,without,x,yellow	1-,10-,10-22,15-25,2-6.5,20-35,3-27,3-7,4-15,4-foliat,absent,apart,ape,articulated,axe,campanulate,connective,cylindrical,directed,eaf,eed,entire,exceeding,lon,lower,m.,minutely,near,nflorescence,nther,occasionally,orolla,peduncle,pore,puberulent,pubescent-pilo,purpl,rachi,radiu,ruit,shorter,slightly,small,spaced,stellate-,tal,tem,thecae,tree,truncat,ud,vary,ympodial	4-foliate,anther,anthesi,bark,bud,color,corolla,count,filament,free,fruiting,habitat,height,inflorescence,lateral,leaf,length,major,mentioned,minor,ovary,position,prickle,primary,scar,seed,shape,size,stem,structure,surface,sympodial,tall,texture,vein,width,wing,young
318	wfo-0001029464	success	235	173	147	88	26	0.626	-2/3,-30,.9,0,0.2,0.2-0.5,0.2-0.7,0.5,0.8-2,1-10,1-3,1-8,1.2-3,1/4,1/4-1/3,10-23,10-40,10-50,12-50,2-3,2-3.5,2.4-4,2.5-5,2.5-8,3-5,3.5-5,4-7,4-8,5-17,6-15,7-10,9-15,abaxially,acicular,acute,ame,annual,anther,apart,apex,apically,apparently,around,bark,base,blade,branched,broad,broad-deltate,brown,c.,calyx,cm,connivent,cordate,cultivar,cup-shaped,curved,dark,deltate,diameter,difoliate,ellipsoid,elongating,erect,filament,flattened-reniform,flower,free,fruit,fruiting,fully,glabrescent,glabrous,glaucous,globular,green-brown,herb,lateral,leaf,length,less,lobe,long,long-styled,margin,maroon,mature,maturity,mauve,midpoint,mm,moderately,narrow-deltate,oblong,obtuse,often,one,open,opening,orange-brown,ovate,ovoid,pair,pedicel,pendulous,petiole,poricidal,porrect,prickle,primary,purple,ray,red-brown,scar,sessile,short-styled,spaced,sparsely,spreading,stalk,stalked,stellate,stellate-pubescent,stem,straight,style,surface,tapering,terete,terminal,tertiary,time,tip,tube,unit,upper,variously,vein,venation,visible,white,wide,woody,yellow-green,yellow-orange,young	-3,-5,0-2,0-80,0.3-0.7,0.3-1,0.5-2,00-200,1,1.5-2,1/,1/4-1/2,10-15,2,2-4,2.2-2.5,2.9-3.2,3-20,3-7,4-8-merous,5-8,5.5-6,5.5-7.5,8-13,8-15,abaxial,adaxial,alyx,andromonoecious,apar,articulated,berry,black,brow,chartaceous,discolorous,distal,distance,drying,eaf,eed,elongated,equal,extending,geminat,green,hair,hermaphrodite,heterostylous,infructescence,lobed,long-acuminat,longer,lower,lowermost,midvein,minute,mottled,nflorescence,occasionally,older,orolla,oung,peduncle,pendent,per,pericarp,pink,plant,portion,prickl,prickly,rounded,ruit,side,simple,smooth,sometimes,staminat,striped,tamen,translucent,trichome,unarmed,usually,vary,way,ympodial	anthesi,bud,cell,color,corolla,count,geminate,habitat,height,inflorescence,long-acuminate,major,minor,null,ovary,position,seed,shape,size,stigma,stone,structure,sympodial,texture,width,wing
319	wfo-0001029546	success	203	151	118	85	33	0.581	0.3-1,1-2,1-3.2,1-4.5,1.6-6.5,2.2-2.8,3.5-5,4-10,4.5-12.5,5,5-18,5-8,7-10,8,8-19.5,abaxially,acuminate,acute,adaxially,anther,apex,apiculate,attenuate,axillary,base,blue,brownish,bud,cell,clavate,cm,condition,connivent,cordate,corolla,covered,covering,curved,densely,diameter,distal,dot,drying,elliptical,erect,filament,flower,forked,frequently,fresh,fruit,generally,glabrous,glandular,globose,green,green-white,greenish,hair,hair-like,half,herb,lanceolate,lateral,leaf,like,lobe,long,longer,make,minutely,mm,mucilaginous,non-glandular,oblique,odd-pinnate,often,ovoid,pedicel,petiole,plant,plurifoliate,pubescent,purple,rarely,regular,ripe,seed,short,simple,size,slightly,soft,stem,stigma,straight,style,subtending,tall,terminal,testal,thick,throughout,tinged,tip,tri-,trichome,tube,unit,unwinged,usually,wall,wet,white,whitish,wide,wing,x	0-2,1-10,1-5,1.5-2,1.5-6.2,2-4,2-9,3-8,4.5-7,5-10,5-merou,6.3-19.5,8-17,absent,acumen,adaxiall,ag,alyx,apart,apparently,articulated,axe,berry,blade,broadly,capitat,chartaceous,decreasing,decumben,decurrent,digestion,dorsally,eaf,edge,eed,elliptic,enzyme,exceeding,flat,folded,geminat,glabrou,greatly,homostylous,honeycomb-shaped,interjected,leaflet,lengthening,living,lower,lunate,membranous,middl,mottle,nearly,nflorescence,orbicular,ovate,pair,peduncle,pentagonal,perfect,petiolule,pore,poricidal,rachi,removed,rotate-pentagonal,ruit,sessile,seudostipule,slit,sometimes,spaced,specimen,stamen,ste,subequal,tamen,tem,truncate,typically,vary,yellow,ympodial	anthesi,bark,calyx,capitate,color,count,decumbent,free,fruiting,geminate,habitat,height,inflorescence,length,major,margin,mentioned,minor,mottled,ovary,position,prickle,primary,scar,shape,stone,structure,surface,sympodial,texture,vein,width,young
320	wfo-0001029552	success	161	164	140	21	24	0.87	.5,0.1-0.5,0.5,0.6-1,1-1.3,1-1.5,1-2,1-3,1-5,1.5-2,1.5-6.5,10-20,12,2-2.5,2-9,2.5-3,5-10-flowered,5.5-8,6-9,abaxially,abruptly,acuminate,acute,along,anther,anthesi,apex,area,bark,base,berry,branched,broadened,broadly,calyx,clavate,closely,cm,conical,contracted,corolla,decurrent,deflexed,deltate,dendritic,densely,denser,dia,differing,difoliate,drying,elliptic,erect,exserted,filament,flattened-reniform,flower,free,fruiting,glabrous,globose,green,greyish-brow,heteromorphic,incrassate,inflorescence,lamina,later,lateral,leaf,like,lobe,long,long-styled,main,major,margin,middle,minor,minute,minutely,mm,occasionally,older,onto,opposite,orbicular,ovary,pair,pale,paler,pedicel,persistent,petiole,pitted,planar,pore,poricidal,present,pubescent,reflexed,rest,rounded,scar,shape,shaped,shining,short-styled,shrub,simple,size,slender,slightly,small,somewhat,spaced,sparsely,stem,stigma,strongly,style,surface,swollen,tall,tan,tear-drop,tip,tree,tree-like,trichome,tube,unit,vein,white,wide,widest,woody,x,yellowish,young	.25,abaxial,adaxially,eaf,edicel,eed,geminat,inflorescenc,lobed,lon,lower,nearly,nflorescence,overlappin,papillo,portion,ruit,scattered,tub,ud,ympodial	5-10,bud,cell,color,count,diameter,fruit,geminate,habitat,height,length,null,overlapping,papillose,position,prickle,primary,seed,stone,structure,sympodial,texture,width,wing
321	wfo-0001029584	success	180	140	104	76	36	0.578	0-30,1,1-2,1-6,16.2-33,2-3,2-4,3-10,3-7,4-15,4-5,4.5-11.5,9.7-23.4,abaxially,acumen,acuminate,acute,adaxially,anther,apex,asymmetric,axillary,base,basiscopic,blade,brownish,bud,cell,clavate,cm,condition,connivent,coriaceous,corolla,covering,dark,dense,densely,diameter,distal,drying,filament,finer,flower,forked,fresh,fruit,generally,glabrescent,glabrous,green,greenish,hair,half,herb,lateral,leaf,light,linear,lobe,long,make,margin,mm,mucilaginous,oblong-lanceolate,odd-pinnate,orbicular,ovate,ovoid,pedicel,pentagonal,petiole,petiolulate,plant,plurifoliate,pubescent,purple,seed,sessile,short,side,simple,size,stigma,style,substellate,subtending,tall,terminal,testal,thick,tip,tissue,tri-,tube,unit,unwinged,usually,wall,wet,white,whitish,x	1-3,1.5-6.5,2.4-6.3,3-5,4-14,5-merou,5.3-13.3,6-7,6.1-9.4,7-14,8-15,9.8-17,ag,alyx,apart,apparently,articulated,attenuate,axe,borne,capitat,considerably,decreasing,digestion,dorsally,eaf,edge,eed,elliptic,end,enzyme,erry,flat,folded,geminat,green-white,hair-like,hal,homostylous,honeycomb-shaped,interjected,larger,leaflet,lengthening,living,lower,middle,nflorescence,orolla,pair,peduncle,perfect,pore,poricidal,present,proximal,removed,second,semi-erec,seudostipule,singly,slit,spaced,specimen,stolo,straight,tamen,tem,throughout,toward,tuber,typically,unknow,vary,yellow,ympodial	'hair-like,anthesi,bark,berry,calyx,capitate,color,count,free,fruiting,geminate,habitat,height,inflorescence,length,major,mentioned,minor,ovary,position,prickle,primary,scar,semi-erect,shape,stem,stone,structure,surface,sympodial,texture,unknown,vein,width,wing,young
322	wfo-0001029593	success	181	156	128	53	28	0.707	0.05,0.5-1,0.5-5,0.8-1,0.8-1.2,1,1-1.2,1-1.5,1-2,1-8,1.6-2.3,10-50,100,2,2-14,2-5,2.3-3.0,3-4,4-6,5-10,5-15,7-25,abaxially,abruptly,acuminate,acute,adaxially,age,always,anther,anthesi,anticlinal,apex,apically,arising,attenuate,axil,axillary,base,basiscopically,bearing,broadly,brown,calyx,capitate,cell,cm,conical,deltate,densely,diameter,dry,drying,enlarged,epidermal,extremely,filament,filiform,flower,free,fruit,fruiting,glabrescent,glabrous,globose,green,half,hollow,irregular,lamina,lateral,leaf,leaflet,lobe,long,lower,markedly,minutely,mm,narrowing,oblique,occasionally,once-branched,open,opposite,ovary,ovoid-reniform,pair,papillose,pedicel,perfectly,petiole,pinnate,place,plant,pointed,poricidal,primary,projection,pubescence,pubescent,rest,scar,seed,shape,simple,sinuous,slightly,somewhat,sparsely,stigma,style,surface,tall,thickening,tip,trichome,tube,uniseriate,unit,usually,variable,vein,white,white-lenticellate,without,woody,x	-10,2-3,2.3,3.5-8,35-60,7.5-15,9-15,basal,berry,cateniform,clavat,colony,cone,decurrent,eaf,edicel,eed,elliptic,entire,exserted,growing,included,large,much,nflorescence,noddin,obovate,often,onto,per,petiolule,portion,pubescen,purple,rachi,rarely,reflecting,ruit,short-styled,shrub,similar,single-stemmed,small,smaller,smooth,tem,terminal,tub,ud,unifoliat,wider,winged,ympodial	bark,bud,cateniforme,clavate,color,corolla,count,habitat,height,inflorescence,length,major,margin,mentioned,minor,nodding,position,prickle,size,stem,stone,structure,sympodial,texture,unifoliate,width,wing,young
323	wfo-0001029601	success	187	156	123	64	33	0.658	0-37,0.2-0.8,1-2,1-3,1-4,1-53,1.2-2.3,1.7-6.5,2,2-9,2.2-4.5,2.3-5.9,2.8-10.5,3-10,3-7,4-13.5,5-41,6.6-22,6.8-14.5,abaxially,acumen,acuminate,acute,adaxially,anther,apex,asymmetric,attenuate,axillary,base,basiscopic,berry,blade,borne,bud,cell,clavate,cm,connivent,coriaceous,corolla,covering,dark,diameter,distal,dorsally,dot,eaf,edge,elliptic,end,filament,flat,flower,folded,forked,fruit,generally,glabrescent,glabrous,globose,green,green-white,hair,hair-like,half,herb,lanceolate,lateral,leaf,leaflet,light,linear,lobe,long,make,mm,mucilaginous,narrow,odd-pinnate,orbicular,ovate,ovoid,pedicel,pentagonal,petiole,petiolulate,plant,plurifoliate,puberulent,ripe,rotate,rounded,seed,sessile,short,side,singly,size,small,stigma,stolo,style,subtending,tall,terminal,testal,thick,throughout,tip,tissue,tri-,tube,tuber,typically,unit,unwinged,usually,wall,wet,white,wing,x	0.5-5.8,0.5-8,1.1-2.7,2-12,2-3,2-7,3-5,5-merou,6-10,abaxiall,ag,alyx,apart,apparently,articulated,axe,brownish,capitat,condition,decreasing,digestion,drying,eed,enzyme,erec,exceeding,fresh,geminat,glabrou,greenish,homostylous,honeycomb-shaped,interjected,larger,lengthening,living,lower,middl,middle,nflorescence,orolla,pair,peduncle,perfect,pore,poricidal,removed,ruit,seudostipule,slightly,slit,spaced,specimen,stamen,straight,subequal,subglabrou,tamen,tem,toward,vary,whitish,yellow,ympodial	anthesi,bark,calyx,capitate,color,count,erect,free,fruiting,geminate,habitat,height,inflorescence,length,major,margin,mentioned,minor,ovary,position,prickle,primary,scar,shape,stem,stone,structure,surface,sympodial,texture,vein,width,young
324	wfo-0001029621	success	165	169	138	27	31	0.836	.1,0.5-0.75,0.5-1.2,0.5-1.5,0.7-1.1,0.8-4.5,1-1.5,1.5-2,1.5-2.5,1.5-5,2.5-3,2/3,3-3.5,3.5-4.5,5-20-flowered,6-20,6-8,7-9,acute,along,anther,anthesi,apex,appearing,appressed,area,attenuate,bark,base,becoming,beneath,berry,borne,branched,calyx,caudate,cluster,cm,completely,constricted,corolla,course,cup-shaped,decurrent,deltoid,densely,dia,distal,dry,ellipsoid,elongate,enclosed,erect,filament,fleshy,free,fruit,fruiting,geminate,glabrate,glabrous,globose,green,irregularly,lanceolate,late,later,lateral,leaf,like,live,lobe,lobed,long,main,many,margin,material,merely,middle,minutely,mm,oblanceolate,occasionally,often,older,onto,ovary,ovoid-reniform,pair,papillate,papillose,pedicel,pitted,planar,plant,pore,poricidal,prominent,puberulent,quite,rarely,reddish,ripe,river,scar,sessile,shaped,shiny,shrub,small,somewhat,spaced,stem,stigma,style,surface,tall,tear-drop,terminal,thick,time,tip,trichome,tube,uniseriate,unit,vein,way,white,whorl-like,widened,widest,woody,x,yellow,yellowish,young	0.5-1,0.8-1,1-2,1/3,accrescent,apar,brown,dark,eaf,edicel,eed,exsertio,lon,lower,nflorescence,pale,papillo,plurifoliat,portion,reddish-gre,ruit,ste,straight,tan,tapering,ud,ympodial	acrescent,apart,bud,cell,color,count,diameter,exsertion,flower,habitat,height,inflorescence,length,major,minor,null,petiole,plurifoliate,position,prickle,primary,reddish-grey,seed,shape,size,stone,structure,sympodial,texture,width,wing
325	wfo-0001029622	success	182	147	123	59	24	0.676	.1,.5,0.3,0.5,0.5-0.7,0.5-1,0.8-1,1-1.2,1-1.5,1-2.7,1.5,2-4,2-5,3-4,3-5,30-35,40,45-50,5-6,7-11,abaxially,accrescent,acute,adaxially,anther,anthesi,apex,apparently,appearing,attenuate,axil,bark,base,brown,bud,calyx,chartaceous,cm,connivent,consisting,corolla,deciduous,diameter,difoliate,elliptic,elongate,except,filament,flower,free,fruit,fruiting,geminate,glabrous,globose,green,included,inflorescence,internodal,known,lateral,leaf,less,lobe,long,long-acuminate,long-triangular,main,major,margin,mature,measured,midrib,minor,minute,minutely,mm,narrowly,obconic,oblong,occasionally,often,onto,opposite,ovate,ovate-lanceolate,pair,papillose,pedicel,pendent,petiole,present,probably,raised,reddish,reflexed,rounded,sagittate,scar,second,shiny,shrub,simple,single,size,slender,slightly,somewhat,stem,stigma,style,thus,tip,trichome,tube,tuft,uniseriate,unit,vein,white,within,x,young	.2,/3,0.6-0.9,1-4,2-11,2.5-3,4-6.5,absent,ag,alyx,arising,axe,beneath,blade,capitat,cylindrical,deflexed,differing,dimorphic,eaf,eed,entire,glabrou,ilament,immature,interlaced,jointed,lamina,lobed,longitudinal,m.,nflorescence,older,one,opening,orolla,oung,peduncle,pore,portion,rachi,remaining,ruit,shaped,slende,slit,stellate,straight,tal,tapering,tear-drop,thin,ud,unarme,unifoliat,vary,way,yellow,ympodial	capitate,cell,color,count,habitat,height,length,mentioned,ovary,position,prickle,primary,seed,shape,stone,structure,surface,sympodial,tall,texture,unarmed,unifoliate,width,wing
326	wfo-0001029625	success	168	155	129	39	26	0.768	..,.1-0.2,.5,0.5-1,0.5-1.3,0.5-2,0.8-1.8,1-1.5,1-2,1-3,1.2-1.6,100,2,2.5-.,3,3-,3-3,4-10,4-4,4-5-celled,4-7-celled,4-9,5,5-6,5-8,8-13,9-25,abaxial,along,anther,anthesi,apical,bark,base,beneath,branch,branched,calyx,cell,cm,conical,corolla,cucullate,darker,deflexed,deltate,densely,denser,diameter,distinct,elliptic,erect,filament,flattened,flower,four,fruit,fruiting,glabrescent,glabrous,gland,glandular,globose,green,greenish,growth,herb,inflorescence,lamina,later,like,lobe,long,margin,markedly,middle,midline,minute,mixed,mm,narrowly,new,occasionally,outer,outline,ovary,ovate-reniform,pair,papillate,pedicel,peduncle,point,pointed,primary,pubescent,purplish,regularly,scar,scattered,shrub,single,sinuate,slightly,small,sparsely,stem,stigma,striate,stripe,strongly,style,surface,testa,time,tinged,tip,triangular,trichome,tube,tuft,uniseriate,unit,vein,wall,weight,white,without,x,young	-15,0.5-2mm,0.8-1.4,3-3.5,5-10,6-9,branc,brittle,brow,capitat,cel,deflexe,dry,eaf,edicel,eed,frui,gland-tipped,hyaline,lighter,lobed,lower,nearly,nflorescence,open,pale,per,pericarp,planar,plurifoliat,rarely,reddish,ruit,single-stemmed,smooth,tan,thin,ud,ympodial	apex,brown,bud,capitate,color,count,free,habitat,height,lateral,leaf,length,major,minor,null,petiole,plurifoliate,position,prickle,seed,shape,size,stone,structure,sympodial,texture
327	wfo-0001029645	success	160	155	120	40	35	0.75	-1,.5-1,0.2-0.5,0.3-0.5,0.5-2.5,0.5-7,1,1-1.5,1-2,1.3-7,1.5,1.5-2,2-4,2.5-17,2.5-4,3-7,337,4-8,5,6-12,7-12,750,?,abaxially,abundantly,acuminate,acute,adaxially,aggregate,along,anther,apex,around,base,blade,blue,brown,calyx,cell,chartaceous,cm,connivent,corolla,cuneate,cylindrical,decurrent,deltate,diameter,distally,entire,et,except,extra-axillary,fide,filament,finger,flattened,flower,free,fruit,glabrous,gland-tipped,globose,green,greenish,hair,herb,immature,kayap,line,lobe,long,major,margin,membranaceous,mesocarp,minutely,mm,moderately,nearly,obtuse,ovate,ovate-elliptic,pedicel,perfect,petiole,puberulent,purple,rarely,red,rotate-stellate,rugose-verrucate,sagittate,sand-punctate,short,short-tomentose,side,simple,small,smith,sparsely,stigma,stone,strongly,style,subcordate,tapered,tightly,time,triangular,truncate,tube,unbranched,unit,vein,veiny,white,wide,x,Â±	1-4,2-3-foliat,3-10,3-15,3.5-4,4-5,5-8,apart,articulated,axe,ba,directed,distall,eaf,eed,glabrou,inserted,knapp,lower,nflorescence,orolla,part,peduncle,pore,puberulen,rachi,radiu,ruit,shorter,shru,spaced,tal,tamen,tem,thecae,tomento,truncat,vary,yellow,ympodial	2-3-foliate,anthesi,bark,bud,color,count,fruiting,habitat,height,inflorescence,lateral,leaf,length,minor,null,ovary,position,prickle,primary,scar,seed,shape,shrub,size,stem,structure,surface,sympodial,tall,texture,tip,tomentose,width,wing,young
328	wfo-0001029646	success	141	155	117	24	38	0.83	0.1-0.6,0.5,0.5-0.8,0.7-2.2,1-4,1.5-2,1.5-4.9,10-15,2-3,3-14,4-5.5,6-8,7-15,abaxially,acumen,acuminate,acute,adaxially,apex,apical,apically,articulate,attenuate,base,branched,calyx,cell,cm,commonly,corolla,covering,cyme,dehiscent,diameter,dichasial,dichasially,digestion,distal,dorsally,ebracteate,edge,elliptic,emoval,enzyme,epiphytic,equaling,filament,finely,flat,flower,folded,forked,free,generally,globose,green,ground,growing,hair-like,half,herbaceous,honeycomb,introrse,lateral,leaf,lobe,long,make,maturing,mm,monochasial,mos,mould,mucilaginous,mucronate,narrowly,oak,often,ovate,ovoid,pattern,pedicel,perennial,perfect,petiole,pine,plant,poricidally,proximal,pubescent,rarely,reveal,seed,short,simple,slit,stamen,stellate,stigma,straight,style,tall,testal,thick,throughout,tone,tree,tuber-bearing,typically,unit,wall,white,wide,without,yellow,yellow-green,Â¼	3-6-foliat,5-15,eaf,eed,globo,green-white,linear,living,lon,lower,nflorescence,nther,orolla,ovat,peduncle,plan,ruit,seudostipule,specimen,tem,throughou,vary,viole,ympodial	3-6-foliate,anther,anthesi,ba,bark,bud,color,count,fruit,fruiting,habitat,height,inflorescence,length,major,margin,mentioned,minor,ovary,position,prickle,primary,scar,shape,size,stem,stone,structure,surface,sympodial,texture,tip,tube,vein,violet,width,wing,young
329	wfo-0001029652	success	160	162	139	21	23	0.869	.3,.5,0.5-1,0.5-4,0.75-1,0.8-1,1,1-2,1-3,1.5-2,2,2-2.5,2-4,2.5-3,25,3.5-4,3/4,4-4.5,6-15,7-9,abaxially,adaxially,along,anther,anthesi,apex,apical,arch,attenuate,bark,base,bearing,berry,broadly,calyx,cm,cone,conical,corolla,curling,deciduous,deflexed,deltate,denser,dia,differing,difoliate,drying,elliptic-ovate,evenly,exserted,filament,flower,free,fruiting,glabrous,globose,golden,golden-red,green,greenish-white,hard,heteromorphic,hispid,included,joining,lamina,lateral,leaf,like,lobe,lobed,long,long-acuminate,long-styled,main,major,margin,maturity,middle,midrib,minor,minute,minutely,mm,narrowly,near,occasionally,opposite,ovary,ovoid-reniform,pair,pale,papillose,pedicel,pericarp,petiole,pitted,pore,poricidal,portion,projection,pubescent,reddish-brown,reflexed,scar,series,shaped,short-styled,shrub,simple,size,slender,slightly,soon,spaced,sparsely,stem,stigma,style,surface,swollen,tall,tan,tear-drop,thickened,time,tip,trichome,tube,uniseriate,unit,vein,way,white,widest,within,x,young	.25,apar,ape,arching,ba,eaf,edicel,eed,filiform,geminat,lon,lower,nflorescence,older,papillo,ruit,slende,tub,ud,undulate,ympodial	apart,bud,cell,color,count,diameter,fruit,geminate,habitat,inflorescence,length,null,position,prickle,primary,seed,shape,stone,structure,sympodial,texture,width,wing
330	wfo-0001029673	success	159	142	117	42	25	0.736	.5,0.5-1,0.7-1.1,1-10,1-2,1-5,1.2-3.5,1.5-1.8,1.5-2,10-20,2-2.5,2-4,2.5,3-5,4-6,5-25,5.5-15,abaxially,accrescent,acuminate,acute,adaxially,age,along,anther,anthesi,apex,appearing,bark,base,becoming,black,branch,branching,broadly,calyx,clavate,cm,conical,corolla,deep,deflexed,deltoid,dendritic,densely,denser,diameter,elliptic,filament,flower,fork,free,fruit,fruiting,glabrous,globose,greyish-yellow,individual,lamina,later,lateral,leaf,length,lenticular,like,lobe,long,longer,minutely,mm,monochasial,narrowly,occasionally,ovary,overtopping,pair,pedicel,petal,petiole,pitted,planar,plurifoliate,pore,poricidal,pubescent,purple,pyramidal,reflexed,scar,secondary,shoot,shrub,slightly,slit-like,small,somewhat,sparsely,stem,stigma,style,surface,tall,terminal,time,tip,tree,triangular,trichome,tube,unit,vein,violet,wide,winged,woody,x,young	0.75-1,0.8-1,2-3,3/4,abaxial,absent,adaxial,apical,basal,berry,blade,decurrent,dichasia,eaf,edicel,eed,ew,exserted,greyish,greyish-yello,growth,inserted,lon,lower,m.,nflorescence,nodding,older,papillo,pericarp,portion,prominent,reddish-brown,ruit,sleeve,stamen,strongly,tapering,thin,tub,ud,ympodial	bud,cell,color,count,dichasial,habitat,height,inflorescence,major,margin,minor,papillose,position,prickle,primary,provided,seed,shape,size,stone,structure,sympodial,texture,width,wing
331	wfo-0001029680	success	212	152	104	108	48	0.491	.0,0.1,0.4,0.6,1,1.0,10,12,50,abaxially,adaxially,annual,anther,anthesi,apex,arequipa,axillary,base,becoming,beyond,bipinnate,blue,borne,branched,calyx,cell,clavate,cm,decurrent,densely,diameter,difoliate,erect,extending,filament,flange,flattened,fleshy,flower,forming,fruit,glabrous,globose,green,hair,herb,leaf,length,light,lobe,long,margin,mm,moderately,multicellular,node,oblong,obovate,ovate,parallel,pedicel,perfect,petiole,pinnate,pitted,plurifoliate,primary,prostrate,pubescent,purple,rarely,red,ripe,running,shallowly,shoot,simple,size,sometimes,sparsely,specimen,stem,stigma,stone,style,subglabrous,surface,tacna,terminal,time,tip,tripinnate,tube,turning,unicellular,uniseriate,unit,violet,white,wide,wing,winged,woody,x	0.5â1.5,0.6â1.2,0.6â2.0,0.9â1.0,1.0â1.1,1.0â1.5,1.0â1.8,1.1â1.2,1.4â2.5,1.4â7.5,1.5,1.6â2.7,1.7â7,1.8â3.8,11â16,11â25,1â2,1â3,1â6,1â8,2.2â4.2,2â20,3.0â4.2,3.3â5.5,3â22,3â6,4.0â16,4.0â6.5,4.5â20,4.5â7.0,4â10,4â30,5,5.5â8.5,5â11,7â10,8â32,absen,acute,adaxiall,ag,along,apart,appressed,arranged,articulated,asymmetrically,axe,ba,blade,brown,connivent,cylindrical,decreasing,divided,eaf,eed,entire,equal,geminat,indistinct,irregularly,lon,longitudinal,lower,m.,midrib,narrow,nflorescence,obtuse,occasionally,often,opening,orolla,pair,pale,peduncle,pendant,pentagonal,pinnae,pore,poricidal,rapidly,rotate,ruit,secondary,shaped,side,spaced,split,straight,tal,tamen,tear-drop,tem,tertiary,usually,vary,winge,yellow,ympodial,â10,â12.5,â19,â3,â3.2,â46,â48	--,0.5-1.5,0.6-2.0,1-2,1.0-1.5,1.0-1.8,1.4-7.5,1.8-3.8,11-16,19,2.2-4.2,3,4.0-16,4.5-20,4.5-7.0,5-11,5.5-8.5,7-10,8-32,absent,bark,bud,color,corolla,count,free,fruiting,geminate,habitat,height,inflorescence,lateral,major,mentioned,minor,ovary,position,prickle,scar,seed,shape,structure,sympodial,tall,texture,vein,width,young
332	wfo-0001029704	success	146	143	111	35	32	0.76	-17,-3,.5,0.5,1-4,1.5,1.5-2.5,1.5-3,10-14,140-185,15-25,2-3,2-5,3-4-celled,3-5,4,5,7-,7-10,9-20,acuman,acuminate,acute,along,anther,anthesi,apex,apparently,aspect,base,berry,blue,branch,broadly,calyx,cell,cm,composed,conical,corolla,cuneate,dark,deeply,deflexed,dia,diam,ellipsoid,enlarged,erect,extra-axillary,few-flowered,filament,flower,fork,fruiting,glabrous,globose,gradually,green,halfway,leaf,less,lobe,lobed,long,minute,minutely,mm,moderately,mottled,obovate,obovoid,occasionally,one,ovary,pedicel,petiole,pinnatisect,poricidal,pubescent,purple,record,reticulate,rounded,shoot,short,shrub,simple,single,sombre,sprawling,stellate,stigma,stone,stout,striped,style,subdiscoidal,surface,swollen,tip,trichome,tube,twig,unit,variable,variously,vein,white,x,young	0-1.5,1,1-2,1000-1200,2-2.5,4-7,also,axi,brown,c.,cunate,cut,eaf,eed,especially,exerted,flowering,lanceolate,lengthening,lower,midrib,nflorescence,peduncle,plurifoliat,pore,reddish,ruit,sinus,slit,straight,subglobo,tub,ud,within,ympodial	bark,bud,color,count,diameter,explicitly,free,fruit,habitat,height,inflorescence,lateral,length,major,margin,mentioned,minor,plurifoliate,position,prickle,primary,scar,seed,shape,size,stem,structure,subglobose,sympodial,texture,width,wing
333	wfo-0001029727	success	260	164	142	118	22	0.546	-1/3,-10,-3,0.15-0.2,0.2-2.5,0.3,0.4-1,0.5,0.7-0.9,1-,1-1.2,1-2,1-4,1.5-2.3,1.5-5.5,1.6-3,1/4,1/8-1/5,2-5,2.5-5.5,3-11,3-6,3-7,4.5-,5-12,5.5-7,6-11,7-10,abaxially,acuminate,acute,almost,along,ame,anther,anthesi,apex,apically,apparently,bark,base,blade,branched,c.,calyx,clavate,climber,cm,colourles,connivent,cordate,corolla,deltate,deltoid,densely,diameter,drying,edge,elongating,equal,erect,except,filament,filiform,finely,flattened-reniform,flower,free,glabrous,increasing,inside,lateral,leaf,length,like,lobe,long,lower,margin,mauve,middle,midpoint,midvein,minor,mm,moderately,narrow-deltate,one,open,outside,ovate,pair,papillose,pedicel,petiole,pit,pitted,poricidal,porrect,portion,prickle,prickly,primary,pubescent,ray,red-brown,reduced,regular,rounded,scandent,scar,seed,sessile,shape,shrub,size,smooth,spreading,stellate,stellate-pubescent,stem,stigma,strongly,style,surface,tapering,terete,terminal,time,tip,toward,translucent,trichome,tube,uneven,unit,upper,vein,violet,wide,yellowish,young	.5,/3,0-15,0-2,0-20,0-30,0-4,0-40,0-5,0-8,0.1-5,0.15-0.3,0.2,0.2-0.5,0.4,0.5-1.2,0.5-3,0.7-1,1,1.2-2,1.5-2.5,1.5-3,1/2-2/3,1/3-1/2,2.5,2.5-3.2,2.8-4,3/,4-7,4-merou,4-merous,4.5,5-8,5-9,abaxial,acicular,adaxial,age,alternate,alyx,apar,apart,articulated,berry,bristle,brown,chartaceous,covered,cupular,curved,darker,developing,different,dimorphic,discolorous,divided,eaf,eed,extending,ferrugineous,filiform-acuminat,fissure,geminate,lengthening,less,lobed,lon,longer,m.,mature,minutely,mixture,nflorescence,nther,obconical,oblong,occasional,older,orange-brown,orolla,oung,papillo,peduncle,per,perfec,perfect,plurifoliat,pore,prickl,protruding,raised,rarely,red-brow,reddish,series,shallowly,short,simple,sinus,sometimes,spaced,stalk,stalked,straight,subentire,tamen,tearing,tertiary,transverse,unarmed,variable,variously,vary,venation,visible,way,x,ympodial	3/4,bud,cell,color,count,filiform-acuminate,fruit,fruiting,habitat,height,inflorescence,major,null,ovary,plurifoliate,position,stone,structure,sympodial,texture,width,wing
334	wfo-0001029731	success	246	206	181	65	25	0.736	.5,.6,0.25-0.3,1,1-1.5,1-2,1-2.5,1.5,1.5-2.5,10-20,1994,2,2-3,2-6,2.5,2.5-4.5,3-10,3-4,31,4,4-5,6,6-7,7-11,8-9,abaxially,accrescent,acquiring,acuminate,acute,adaxially,age,almost,along,anther,anthesi,apex,apically,arcy,bark,basally,base,beak,becoming,berry,black,branch,branched,branching,broadly,brown,calyx,clavate,clearly,cm,concolorous,connate,coriaceous,corolla,crinkled,cuneate,darker,delineated,deltoid,dense,diameter,dorsal,dorsifixed,dry,drying,elliptic,enlarge,epiphyte,equal,erect,faint,filament,fine,finely,flaring,flattened,fleshy,flower,free,fruit,fruiting,glabrous,ground,hair,lamina,large,lateral,leaf,lengthening,less,liana,like,linear,lobe,lobed,long,long-ellipsoid,longitudinal,longitudinally,main,margin,mature,maturity,mauve,midvein,mm,narrowly,obconical,oblong,obovate,obtuse,often,orange-brown,pair,papillae,papillose,pedicel,pendulous,pericarp,petiole,pore,poricidal,primary,prominent,pyriform,raised,rakotozafy,rarely,reflexed,reported,ribbed,ridge,ridged,rounded,scar,several,simple,slender,slightly,smaller,sometimes,sparsely,stem,stigma,stretched,stump,style,succulent,sunk,surface,terminal,thick,thickened,tip,toward,trichome,tube,tuft,unit,usually,vein,venation,ventral,visible,well-developed,white,wide,widely,wing,winged,woody,wrinkling,x,yellow-green,young,â	0.05,0.1-0.8,1.5-3,1/3,3,4-9,alyx,apar,apparently,articulated,basal,boundary,bumpy,conical,delimited,development,different,dilated,distributed,domatia,dull,eaf,early,elongating,entire,even,evenly,exserted,filiform,iscoid,later,lon,lower,much,nflorescence,nther,occasionally,orolla,part,peduncle,perfec,persisting,plurifoliat,portion,protruding,rachi,revolute,ruit,see,shallowly,shorter,sinus,small,smoot,straight,tearing,thinner,though,time,tub,ud,vary,visibl,yellow,ympodial	apart,bud,cell,color,count,habitat,height,inflorescence,length,major,minor,null,ovary,plurifoliate,position,prickle,seed,shape,size,smooth,stone,structure,sympodial,texture,width
335	wfo-0001029741	success	137	137	110	27	27	0.803	.4,.5,0.5-1.5,0.8-3.5,1-1.5,1-3.5,1.1-1.3,1.5,1.5-4,1.5-6,2-2.5,2.2-9,2.5-7.8,3,9.5-22.5,?,accrescent,acute,age,anther,anthesi,apex,attenuate,base,becoming,berry,branched,ca,calyx,capitate,closely,cm,corolla,dark,deflexed,deltoid,dia,difoliate,dry,elliptic,erect,filament,flower,free,fruit,fruiting,furcate,glabrous,globose,green,growth,inflorescence,known,lateral,leaf,lenticellate,lighter,lobe,lobed,long,main,major,middle,minor,minutely,mm,nearly,new,opposite,ovary,ovate,overlapping,pair,papillose,pedicel,petiole,planar,pore,poricidal,produced,prominent,proximal,quite,raised,reddish-brown,scar,shaped,shrub,size,slender,slightly,spaced,stem,stigma,style,tall,tapering,tear-drop,tip,tree,tube,unit,usually,variable,vein,weak,white,widest,woody,x	0.9-1.2,10-50-flowered,apiculate,black,caly,completely,differing,divisio,drying,eaf,early,edicel,eed,exserted,geminat,glabrou,immature,lon,lower,nflorescence,papillo,portion,ruit,straight,ud,wood,ympodial	10-50,bark,bud,cell,color,count,diameter,division,geminate,habitat,height,length,margin,position,prickle,primary,seed,shape,specified,stone,structure,surface,sympodial,texture,width,wing,young
336	wfo-0001029744	success	113	107	79	34	28	0.699	0.3-0.6,0.5-1,1.5,1.5-3.2,2,2-4,5-8,50,7-15,8-11,abaxially,adaxially,along,apart,bark,base,beginning,branch,calyx,cm,deltate,dendritic,densely,denser,difoliate,elliptic,fide,flattened,flexuous,fruit,geminate,glabrescent,glabrous,golden,incrassate,lamina,lanceolate,leaf,lobe,margin,minutely,mm,narrowly,node,non-reproductive,oblanceolate,occasionally,opposite,ovoid-reniform,pair,pale,pedicel,petiole,pitted,primary,pubescence,pubescent,scar,shape,shrub,simple,single-celled,slightly,small,smith,spaced,stem,surface,thin,tip,trichome,unicellular,unifoliate,uniseriate,unit,vein,white,x,young	1,8-10-flowered,acute,apex,blunt,brow,distinct,eaf,eed,entire,examined,extreme,form,inflorescenc,leave,long-acuminate,looping,lower,major,marginal,mature,minor,nflorescence,oblique,older,revolute,see,similar,smaller,sometimes,somewhat,thee,ud,ympodial	3,anther,brown,bud,cell,color,corolla,diameter,filament,free,fruiting,habitat,height,inflorescence,length,mentioned,ovary,position,prickle,seed,seen,stigma,stone,structure,style,sympodial,texture,tube
337	wfo-0001029746	success	179	173	152	27	21	0.849	.5,0.5-1,0.7-1,1,1-1.3,1-1.5,1.2-1.5,1.5,2,2-2.5,2-4,2-7,2-8,3,3-4,3-4-pluri-foliate,3-6,4-9,6,8-10,abaxially,acute,adaxially,age,anther,anthesi,apart,apex,base,bearing,becoming,berry,blackish,broadly,brown,calyx,capitate,cell,centre,cm,color,conical,corolla,crenate,crowded,cup-shaped,curved,dark,darker,densely,diameter,ellipsoid,elliptic,enlarged,erect,filament,flattened,fleshy,flower,flush,free,fruit,fruiting,glabrous,gland-tipped,glandular,globose,greenish,growing,herb,heteromorphic,hollow,horn,inflorescence,internodal,irregularly,lamina,leaf,lengthening,less,lobe,lon,long,longer,lower,margin,markedly,mature,minutely,mixed,mm,narrowly,near,nodding,orange,ovary,ovate,ovoid,pair,pale,papillose,pedicel,petiole,pitted,plan,pore,poricidal,primary,principal,pubescent,purple,rachi,red,reddish,reflexed,scar,shallowly,shortest,simple,slender,slightly,slit,somewhat,spaced,sparse,sparsely,spreading,stem,stigma,straight,strongly,style,subshrub,surface,testal,third,tip,triangular,trichome,tube,uniseriate,unit,upper,upward,vein,wall,widely,widest,woody,x,ympodial,â3	0.3-2,3-4.5,6-7,8-11,acuminate,c.,ciliate,cordate,eaf,edicel,eed,entire,exerted,longest,maturit,mid-length,nflorescence,occasionally,papillo,peduncle,pericarp,portion,pubescen,ruit,single,thin,ud	bark,bud,count,growth,habitat,height,length,maturity,mentioned,new,position,prickle,seed,shape,stone,structure,sympodial,texture,width,wing,young
338	wfo-0001029769	success	142	138	110	32	28	0.775	.25,.5,0.5-1.5,1-1.2,1-3,1.5-2,1.5-2.5,2.5-8,30-60-flowered,5-8,6-17,7-8,8-9,8.5-17,abaxially,acuminate,acute,adaxially,along,anther,anthesi,apex,bark,base,bearing,berry,brochidodromu,brown,calyx,capitate,cm,conical,corolla,curl-tipped,cyathiform,dark,deltoid,densely,dia,elliptic,filament,filiform,flower,free,fresh,fruiting,glabrous,globose,golden,green,hen,internodal,lateral,leaf,less,like,lobe,lobed,long,main,margin,midrib,minutely,mm,nearly,older,onto,opposite,ovary,ovoid-reniform,pair,papillose,pedicel,petiole,pitted,pore,poricidal,pubescent,reflexed,ried,scar,scattered,shaped,shrub,simple,smooth,somewhat,sparsely,stem,stigma,style,surface,swollen,tall,tear-drop,three,time,tip,trichome,tube,two,uniseriate,unit,vein,white,wide,winged,woody,x,young	2.5-3,3.5-4,4,4-5,apar,ape,archin,ba,branch,cerro,deflexed,eaf,edicel,eed,exserted,horizontally,inglÃ©,lon,lower,nflorescence,papillo,portion,puberulent,ruit,spaced,straight,tub,ud,unevenly,unifoliat,widely,ympodial	bud,cell,color,count,diameter,fruit,growth,habitat,height,inflorescence,length,major,mentioned,minor,new,position,prickle,primary,seed,shape,size,stone,structure,sympodial,texture,unifoliate,width,wing
339	wfo-0001029780	success	204	153	118	86	35	0.578	1-2,1.4-1.9,11-24,120-210,15-22,15-45,2-12,2-2.8,2-5.5,2.4-4.2,20-60,3.5-7.3,5-7,5.5-13,50-70,600-950,8-12,abaxially,acute,adaxially,along,anther,apex,apparently,attenuate,axillary,base,berry,bud,cell,ciliate,cm,connivent,cordate,corolla,covering,cuneate,dark,decumbent,densely,diameter,distal,dorsally,edge,especially,filament,flat,flower,folded,forked,fruit,generally,glabrous,gland,glandular,globose,green,green-white,hair,hair-like,half,head,herb,invested,lanceolate,lateral,length,like,lobe,long,longer,make,margin,midrib,minutely,mm,mucilaginous,non-glandular,obtuse,odd-pinnate,ovoid,pale,pedicel,perfect,petiole,pinkish,plant,plurifoliate,puberulent,pubescent,ripe,seed,short,size,stem,stigma,streak,stripe,style,subtending,tall,terminal,testal,tetralobulate,thick,throughout,tip,tri-,trichome,truncate,tube,unit,unwinged,wall,wet,white,x,yellow	1-1.2,1-10,1.5-2,2-2.5,2-3.5,3,3-6,4-6,4.5-6,5-merou,5.5,?,absent,acumen,ag,alyx,apart,articulated,axe,blade,borne,brownish,capitat,chartaceous,condition,digestion,drying,eaf,eed,end,enzyme,erec,exceeding,except,fresh,geminat,glabrou,greatly,greenish,hal,high,homostylous,honeycomb-shaped,interjected,leaflet,lengthening,living,lower,membranous,minute,nflorescence,often,orbicular,orolla,ovate,pair,peduncle,petiolulate,petiolule,pore,poricidal,proximal,rarely,reduced,removed,rotate,ruit,sessile,seudostipule,singly,slit,spaced,specimen,stamen,ste,stolo,straight,subequal,tamen,tem,tuber,typically,usually,vary,whitish,ympodial	anthesi,bark,calyx,capitate,color,count,erect,free,fruiting,geminate,growth,habitat,height,inflorescence,leaf,major,mentioned,minor,new,ovary,position,prickle,primary,scar,shape,stone,structure,surface,sympodial,texture,vein,width,wing,young,Âµm
340	wfo-0001029784	success	237	156	130	107	26	0.549	-12,.1,.2,.5,0.1-,0.1-0.15,0.2-0.3,0.25-0.3,0.3-0.35,0.4-0.45,0.4-0.5,0.4-0.6,0.5-1.5,0.6-1,0.9-1.2,1-1.1,1-1.2,1-1.5,2,2-,2-foliate,5-10,5-14,abaxially,acute,adaxially,adpressed,angled,anther,anthesi,apex,apical,appearance,appendage,articulated,articulation,axi,base,berry,broadly,calyx,capitate,cell,cm,column,conical,corolla,dark,densely,diameter,distal,distributed,eglandular,enclosing,evenly,filament,flower,fruit,fruiting,giving,glabrous,glandular,globose,golden,green,hair-like,half,head,herb,imparipinnate,inflorescence,interrupted,interspersed,irregularly,lamina,lanceolate,lateral,like,live,lobe,long,loosely,margin,mm,mostly,multicellular,narrowly,obovate,occasionally,often,outgrowth,ovary,pedicel,pentagonal,perennial,petiole,plant,primary,pubescent,reflexed,silky,simple,soft,somewhat,sparse,sparsely,staminal,stem,sterile,stigma,straight,stripe,strongly,style,surface,testa,trailing,trichome,tube,undulate,unicellular,unit,unseriate,vein,velvety,wall,wide,winged,woody,yellow	-5,0-4,0.1-0.5,0.2,0.2-,0.2-0.5,0.3-0.4,0.3-0.5,0.3-1,0.4-,0.5,0.5-,0.7-1.2,1,1-,1-2,1-2-celled,1-4,1.0-1.3,1.2-2.5,1.5-,1.7-2.6,1/3,2-2.5,2-3-celled,2-4,2-4.5,2-locular,2.5-3.5,2/3,3-,3-5,5-8,abaxial,absent,abundant,acuminate,along,arising,basal,basicopically,beneath,bract,brown,crenate-serrate,crenation,decurrent,deeper,developed,due,eaf,edicel,eed,elliptic,entire,exserted,glabrescent,gree,hal,halfway,included,interjected,internode,larger,leaflet,lon,long-acuminate,lower,markedly,maturing,nflorescence,node,northern,orbicular,pair,pale,paler,patent,peduncle,petiolule,population,present,proximal,pseudostipule,pubescence,rarely,ripe,robust,ruit,scattered,secondary,sessile,smaller,sometimes,spreadin,stout,tem,terminal,tertiary,thick,truncate,ud,uniseriate,usually,white,x,ympodial	bark,bud,color,count,free,growth,habitat,height,leaf,length,mentioned,new,position,prickle,scar,seed,shape,spreading,stone,structure,sympodial,texture,tip,width,wing,young
341	wfo-0001029785	success	223	122	91	132	31	0.408	0.1-0.5,1-2,1-5,1.2-3.2,1.8-3.5,10-26,3-6,3-8,5-9,8-11,abaxially,acute,adaxially,along,anther,attenuate,axillary,bud,cell,clavate,cm,commonly,corolla,covering,dark,darker,denser,diameter,especially,filament,flower,forked,fruit,glabrous,globose,green,hair,herb,invested,lanceolate,lateral,leaf,like,lobe,make,margin,midrib,minutely,mm,mucilaginous,multiple-celled,non-glandular,odd-pinnate,outer,ovoid,pale,pedicel,pentagonal,petiole,plurifoliate,puberulent,pubescent,purple,rarely,ripe,rotate,seed,short,slightly,sparsely,stem,stigma,stripe,style,subglabrous,subtending,tall,terminal,testal,thick,tip,tri-,tube,unbranched,unit,unwinged,vein,violet,wall,wet,white	0-2,0-3,0.3-2.2,0.4-4.9,0.8-1,1-1.2,1-10,1.5-3.6,1.8-7,2-4,3-4,3.5-5,3.8-7.2,4-10.5,5-16,5-merou,6,absent,acumen,ag,alyx,apart,apex,apparently,articulation,axe,base,berry,blade,borne,broadly,brownish,capitat,chartaceous,condition,connivent,cordate,cuneate,decreasing,decumbent,digestion,distal,dorsally,drying,eaf,edge,eed,elliptic,end,enzyme,erec,exceeding,flat,folded,fresh,geminat,generally,glabrou,greatly,green-white,greenish,hair-like,half,homostylous,honeycomb-shaped,interjected,larger,leaflet,lengthening,living,long,lower,markedly,medium,membranous,middle,minute,mottled,much,nflorescence,oblique,obovate,obtuse,one-quarte,orbicular,orolla,ovate,pair,peduncle,perfect,petiolulate,petiolule,plant,point,pore,poricidal,present,purple-tinged,quite,removed,rounded,ruit,scale-like,sessile,seudostipule,shallowly,singly,size,slit,sometimes,spaced,specimen,stamen,ste,stolo,straight,tamen,tem,throughout,toward,truncate,tuber,typically,unequal,usually,variable,vary,whitish,wide,x,yellow,ympodial	'hair-like,anthesi,bark,calyx,capitate,color,count,free,fruiting,geminate,growth,habitat,height,inflorescence,length,mentioned,new,ovary,position,prickle,primary,scar,shape,stone,structure,surface,sympodial,texture,width,wing,young
342	wfo-0001029789	success	167	120	83	84	37	0.497	0.2-0.5,1-2,1-3,2-25,2-6,2.7-4.7,4-10,6,7-16.6,7-21,8-9,abaxially,acuminate,acute,adaxially,anther,apex,axillary,base,basiscopic,blue,bud,chartaceous,clavate,cm,corolla,dark,decurrent,diameter,filament,flower,forked,fruit,glabrous,green,hair,herb,lanceolate,lateral,leaf,light,like,lilac,linear,lobe,long,long-attenuate,membranous,minutely,mm,mottled,odd-pinnate,ovary,pedicel,pentagonal,petiole,petiolulate,plant,plurifoliate,pubescent,rarely,rotate,sessile,short,side,simple,size,sparsely,star,stigma,style,subglabrous,subtending,tall,terminal,tinged,tip,tri-,tube,unit,usually,white,x	0-2,0.5-2.8,0.8-3.5,1-10,1.5-2,1.7-8.5,1.8-6.5,12,2-3,2-6.5,3-5,3-8.5,4-13,5-7,5-merou,6-7,acumen,adaxiall,ag,alyx,apart,apparently,articulated,attenuate,axe,blade,broadly,capitat,connivent,decreasing,distal,dorsally,eaf,edge,eed,erec,exceeding,flat,folded,formed,geminat,generally,greatly,hal,half,homostylous,interjected,lant,leaflet,lengthening,lower,lunate,maturing,minute,narrowly,never,nflorescence,orbicular,orolla,ovate,pair,peduncle,perfect,pore,poricidal,pubescen,purpl,rachi,seudostipule,slightly,slit,spaced,stamen,ste,sterile,straight,subequal,tamen,tem,toward,typically,vary,yellow,ympodial	anthesi,bark,calyx,capitate,cell,color,count,free,fruiting,geminate,growth,habitat,height,inflorescence,length,major,margin,mentioned,minor,new,position,prickle,primary,purple,scar,seed,shape,stem,stone,structure,surface,sympodial,texture,vein,width,wing,young
343	wfo-0001029810	success	149	148	124	25	24	0.832	.25,.5,0.5-1,0.5-3,1-1.3,1-1.5,1-10,1-2,1-3,1.1-2.3,1.5-3,2-3,2-5,3-3.5,3-6,4-10,5-15-flowered,5-16,5-6,8-12,abaxially,acuminate,acute,along,anther,anthesi,apex,apically,arachnoid,attenuate,bark,base,berry,brown,calyx,capitate,closely,cm,compact,compressed,congested,conical,corolla,dark,deflexed,deltate,dendritic,densely,dia,difoliate,drying,ellipsoid,elliptic,exserted,filament,fleshy,free,fruiting,glabrous,globose,green,inflorescence,internodal,large,later,lateral,leaf,lenticel,less,like,lobe,lobed,long,main,major,margin,middle,minor,minutely,mm,narrowly,nearly,occasionally,older,opposite,ovary,papillose,pedicel,petiole,planar,pointed,pore,poricidal,pubescent,rest,scar,shaped,shining,shrub,simple,size,slender,small,spaced,sparsely,stem,stigma,style,surface,tall,tapering,tear-drop,tip,tree,trichome,tube,unit,vein,white,wide,widest,woody,yellowish,young	2.5-3,3-4,adaxially,ape,differing,eaf,edicel,eed,geminat,glabrou,lon,lower,nflorescence,overlappin,ovoid-reniform,pale,papillo,pitted,portion,reddish-brown,ruit,tan,tub,ud,ympodial	5-15,bud,cell,color,count,diameter,flower,fruit,geminate,habitat,height,length,overlapping,position,prickle,primary,provided,shape,stone,structure,sympodial,texture,width,wing
344	wfo-0001029811	success	225	174	148	77	26	0.658	-3,/3,0-30,0.1-0.3,0.1-0.4,0.2,0.2-0.6,0.3-1,0.3-1.5,0.5-2,0.8-1.5,1,1-2.5,1-3,1.3-1.7,1.5-2.5,1.5-6,1/2-2/3,1/3,10-22,13-20,15-23,2-5,2-5.5,20-100,3-5,3-5.5,3-7,3.5-4.5,4-8,4.5-5,5-17,5-40,5-9,7-18,8-12,8-18,abaxially,acicular,anther,apart,apically,apparently,bark,base,berry,blade,broad-deltate,brown,calyx,cell,cm,connivent,cream,dark,densely,diameter,elongate,elongating,filament,flattened,flattened-reniform,flower,free,fruit,fruiting,glabrous,glandular,green,hair,herb,inflated,lateral,leaf,length,less,lobe,lobed,long,long-styled,margin,marking,mature,maturity,mauve,midpoint,mm,moderately,multangulate,narrow-deltate,often,one,open,orange-brown,outline,ovate,pair,pale,pedicel,perpendicular,petiole,pit,poricidal,porrect,prickle,prickly,primary,raised,ray,scandent,scar,sessile,short,short-styled,shorter,shrub,simple,small,smooth,sometimes,spaced,sparsely,spherical,spreading,stalk,stalked,stellate,stellate-pubescent,stem,straight,style,surface,tapering,terete,time,tip,trichome,tube,unbranched,unit,upper,usually,vein,way,wide,woody,yellow,young	-6,-merous,.5,0,0-35,1-1.5,1/,1/3-2/3,15-50,2-2.5,2.5-3,2.8-3.2,5,5-11,6-12,7-9,abaxial,adaxial,alyx,andromonoecious,apar,apex,articulated,chartaceous,cordate,cuneate,discolorous,distal,distance,drying,eaf,eed,equal,erect,extending,eye,faint,fewer,green-brow,hermaphrodite,heterostylous,infructescence,lobing,long-acuminat,longer,lower,lowermost,midvein,minute,naked,nflorescence,obtuse,older,orolla,oung,peduncle,pendulous,per,pericarp,plant,plurifoliat,portion,prickl,ruit,secondary,side,slightly,staminat,stout,tamen,tertiary,unarmed,vary,venation,visible,yellow-green,ympodial	anthesi,bud,color,corolla,count,elongated,green-brown,growth,habitat,height,inflorescence,long-acuminate,new,null,ovary,plurifoliate,position,seed,shape,stigma,stone,structure,sympodial,texture,width,wing
345	wfo-0001029978	success	208	125	93	115	32	0.447	0.5-0.6,0.8,1-2,1.5-3.1,11-19,15-27,3-7,3.2-2.5,4-7,8-10,abaxially,adaxially,along,anther,attenuate,axillary,berry,bud,cell,chartaceous,ciliate,clavate,cm,coarsely,conical,corolla,covering,dark,darker,diameter,especially,filament,finely,flower,forked,fruit,glabrous,green,green-white,hair,herb,lanceolate,lateral,leaf,less,light,like,lobe,long,make,margin,medium,membranous,midrib,minutely,mm,mucilaginous,narrow,odd-pinnate,ovoid,pedicel,pentagonal,petiole,plurifoliate,puberulent,pubescent,purple,ray,ripe,rotate,seed,semierect,simple,sparsely,stem,stigma,style,subtending,tall,terminal,testal,thick,throughout,tip,tri-,tube,unit,usually,wall,wet,whitish,wide,wing	0.3-0.4,0.3-0.7,0.7-1.9,0.9-2.3,1-10,1.3-1.5,1.4-1.5,1.8-5,2-4,3-5,3.1-6.3,3.5-9.5,3.7-8.1,4-11,4.2-5.2,5,5-16.5,5-merou,acumen,acuminate,ag,alyx,apart,apex,apparently,arranged,articulated,asymmetrical,axe,base,basiscopic,bead,blade,brownish,capitat,commonly,condition,connivent,decreasing,digestion,distal,dorsally,drying,eaf,edge,eed,elliptic,enzyme,erec,exceeding,flat,folded,fourt,fresh,geminat,generally,glabrou,gradually,greenish,hair-like,half,homostylous,honeycomb-shaped,interjected,larger,leaflet,lengthening,living,lower,middle,minute,moniliform,mottled,multiple,necklace,nflorescence,orbicular,orolla,ovate,pair,peduncle,perfect,petiolule,plant,pore,poricidal,pubescen,removed,ruit,secondary,sessile,seudostipule,side,size,slightly,slit,spaced,specimen,stamen,ste,stolon,straight,subequal,subsessile,symmetrical,tamen,tem,tissue,toward,tuber,typically,vary,x,yellow,ympodial	'hair-like,anthesi,bark,calyx,capitate,color,count,erect,free,fruiting,geminate,growth,habitat,height,inflorescence,length,mentioned,new,ovary,position,prickle,primary,scar,shape,stone,structure,surface,sympodial,texture,vein,width,young
346	wfo-0001029980	success	173	164	140	33	24	0.809	.1,.5,0.1-0.25,0.25-0.5,0.25-1,0.5-1,0.5-1.2,0.5-2.5,0.5-5,0.7-1.3,0.9-4.5,1-1.5,1-1.7,1.5-6,2-5,2-6,2/3,3-9,5-10,5-50-flowered,6.4-17,abaxially,acute,adaxially,anther,anthesi,apex,appressed,axil,bark,base,berry,black,bright,brown,bud,calyx,closely,cm,conical,corolla,curved,dark,decurrent,deflexed,deltoid,density,difoliate,dried,drying,elevation,elliptic,especially,filament,flattened-reniform,free,fruiting,glabrous,globose,gray,greatly,green,greenish-white,high,impressed,lateral,leaf,live,lobe,lobed,long,main,major,margin,material,middle,minor,minutely,mm,near,node,often,one,onto,opposite,ovary,ovate,overlapping,pair,papillose,pedicel,petiole,pitted,plant,pore,poricidal,prominent,proximal,puberulent,race,reflexed,rounded,scar,shape,shaped,shiny,shrub,side,simple,size,slightly,small-capitate,somewhat,spaced,specimen,stem,stigma,straight,style,surface,tall,tear-drop,tip,trichome,tube,tuft,unicellular,uniseriate,unit,varying,vein,venezuelan,way,white,widest,winged,woody,x,yellowish,young	0.8-1.2,1.2-2.5,1.5-2,3-4,apar,appearing,ba,dia,differing,eaf,edicel,eed,exserted,five,geminat,incrassate,knob,lon,lower,nflorescence,older,orbicular,pale,paler,portion,ruit,slender,soon,tan,tapering,ud,whit,ympodial	apart,cell,color,count,diameter,flower,fruit,geminate,habitat,height,inflorescence,length,null,position,present,prickle,primary,seed,stone,structure,sympodial,texture,width,wing
347	wfo-0001029989	success	161	165	135	26	30	0.839	.2,.5,0.25-0.5,0.5-1,0.5-1.5,1-1.5,1-2,1-2.5,1-4,1.3-2.3,1.5-2.5,10-14,2.5-3,3-5,3-8,3.5-8,4-4.5,5-10-flowered,5-6,7-20,abaxial,abaxially,acute,adaxially,anther,anthesi,apex,bark,base,berry,branch,broadly,calyx,capitate,central,closely,cm,collection,congested,conical,corolla,deflexed,deltoid,dendritic,densely,described,dia,difoliate,dimaeter,drying,elliptic,erect,filament,flattened,fleshy,free,fruiting,glabrous,globose,golden,gray,green,greenish-black,heteromorphic,incrassate,inflorescence,internodal,lamina,lateral,leaf,lenticular,like,lobe,lobed,long,main,margin,middle,minutely,mm,nearly,northern,occasionally,older,opposite,ovary,pair,pedicel,peru,peruvian,perÃº,petal,petaloid,petiole,pitted,planar,population,pore,poricidal,pubescent,reddish,reddish-brown,rest,scar,scattered,shaped,shining,short-style,shrub,simple,small,somewhat,spaced,sparsely,stem,stigma,style,surface,tall,tear-drop,tip,tree,tree-like,trichome,tube,unifoliate,unit,vein,white,wide,widest,woody,x,yellow,young	/2,branched,brownish-re,dense,discussion,due,eaf,edicel,eed,exserted,geminat,inflorescenc,lon,lower,nflorescence,nodding,overlappin,papillo,portion,probably,pubescence,ruit,see,ud,way,ympodial	brownish-red,bud,cell,color,count,diameter,flower,fruit,geminate,habitat,height,length,major,minor,null,overlapping,papillose,position,present,prickle,primary,seed,shape,size,stone,structure,sympodial,texture,width,wing
348	wfo-0001030000	success	155	132	99	56	33	0.639	-7,0.5-,0.5-1,1,1-,1-10,1-2,1.5-,10-,2-2.5,2-3,2-4,2.5-,2.5-3,2.5-3.5,3-,3-16,3-4,3.5-5,30-50,4-4.5,4-5,7-15,abaxially,acute,adaxially,aggregate,also,apex,apiculate,base,calyx,cell,chartaceous,cm,connivent,conspicuous,coriaceous,cucullate,deltate,densely,dia,diameter,eglandular,ellipsoidal,flattened,flower,fruit,glabrous,globose,green,hair,immature,leaving,lobe,long,margin,mature,mm,moderately,narrowly,oblong,obtuse,occasionally,orange,ovoid,pedicel,pedicellar,perfect,pilose,puberulent,pubescent,purplish,rachi,rarely,remnant,scar,shrub,slightly,small,sparsely,spotted,stigma,stone,style,subcoriaceous,tinge,tip,tomentose,tree,triangular,truncate,tube,unbranched,unit,white,x,yellow,yellow-brown	-4,-5,-50,-pilose,0.5-14,0.5-3,1.5-2,10-20,15-25,2-5,25-30,4,4-foliat,absent,apart,ape,articulated,axe,biglandula,ciliat,connective,creamy-whit,dilated,directed,distally,eed,equal,exceeding,laterally,lon,lower,nflorescence,nther,orolla,peduncle,pore,produced,pubescen,radiu,ruit,shorter,smal,spaced,stamen,stellate,strongly,swelling,tal,tem,thecae,ud,umbrella-shaped,vary,wide,yellowish,ympodial	4-foliate,anther,anthesi,bark,biglandular,bud,ciliate,color,corolla,count,filament,free,fruiting,habitat,height,inflorescence,leaf,length,null,ovary,position,prickle,seed,shape,stem,structure,surface,sympodial,tall,texture,width,wing,young
349	wfo-0001030000	success	178	182	141	37	41	0.792	-4,-5,-50,-7,-pilose,0.5-,0.5-1,0.5-13,1,1-,1-10,1-2,1.5-,1.5-2,10-,10-20,15-25,2-,2-2.5,2-3,2-4,2-5,2.5-,2.5-3,2.5-3.5,25-30,3-,3-16,3-4,3.5-5,30-50,4,4-25,4-4.5,4-5,5-25,7-15,abaxially,absent,acute,adaxially,aggregate,also,apart,apex,apiculate,articulated,base,blade,calyx,cell,chartaceous,cm,connective,connivent,conspicuous,coriaceous,cucullate,deltate,densely,dia,diameter,dilated,directed,distally,eglandular,ellipsoidal,elliptic,equal,exceeding,flattened,flower,fruit,glabrescent,glabrous,globose,green,hair,immature,laterally,leaving,lobe,long,margin,mature,mm,moderately,narrowly,oblong,obtuse,occasionally,orange,ovate,ovoid,pedicel,pedicellar,petiole,pilose,pore,produced,puberulent,pubescent,purplish,rachi,radiu,rarely,remnant,scar,shorter,shrub,simple,slightly,small,spaced,sparsely,spotted,stellate,stigma,stone,strongly,style,subcoriaceous,swelling,thecae,tinge,tip,tomentose,tree,triangular,truncate,tube,umbrella-shaped,unbranched,unit,vein,white,wide,x,yellow,yellow-brown,yellowish	-2,0.5-14,0.5-3,1-1.5,1-5,4-foliat,acuminate,ape,axe,basal,biglandula,ciliat,cordate,creamy-whit,eaf,eed,entire,lon,lower,nflorescence,nther,oblique,often,orolla,peduncle,perfect,pilo,pubescen,ruit,smal,stamen,tal,tem,time,ud,vary,ympodial	0.5-16,4-foliate,anther,anthesi,bark,biglandular,bud,ciliate,color,corolla,count,creamy-white,filament,free,fruiting,growth,habitat,height,inflorescence,lateral,leaf,length,major,minor,new,ovary,position,prickle,primary,seed,shape,size,stem,structure,surface,sympodial,tall,texture,width,wing,young
350	wfo-0001030004	success	177	160	138	39	22	0.78	.3,0-0.5,0-1.5,0.3-1,0.8-1.1,1-2,1.2-2,1.5-2.5,15,15-20,2-20,20-200-flowered,3-3.5,3-4,3.5-5,5-25,abaxially,across,adaxially,along,always,anther,anthesi,apex,axillary,bark,base,berry,body,branched,branching,broadly,bushy,calyx,capitate,cm,collection,conical,corolla,decurrent,deltate,dendritic,densely,denser,dia,distal,drying,elliptic,erect,exserted,filament,flat,flattened-reniform,fleshy,free,fruiting,giving,glabrous,globose,green,hard,incrassate,inflorescence,knob,large,later,lateral,leaf,like,lobe,lobed,long,loose,main,many,margin,minutely,mm,much,nearly,obovate,obovoid,occasionally,often,onto,ovary,pair,pale,papillate,pedicel,petiole,pitted,planar,plurifoliate,pore,poricidal,possessing,prominent,pubescence,pubescent,rest,scar,seed,sessile,shaped,shrub,simple,small,spaced,sparsely,stem,stigma,strongly,style,surface,tall,tan,tear-drop,terminal,thick,thin,time,tip,translucent,tree,trichome,tube,tuft,unevenly,variously,vein,white,wide,winged,woody,yellowish,yellowish-green,young	0.2-1,1-1.5,4-15,9-30,abaxial,acuminate,acute,apar,appearanc,barely,basal,blade,cone,crotaloid,dense,diamete,eaf,edicel,eed,especially,greenish-yello,juvenile,lamina,lower,middle,nflorescence,older,papillo,pericarp,plant,portion,ruit,stout,surpassing,tub,ud,widest,x,ympodia	apart,appearance,bud,cell,color,diameter,fruit,greenish-yellow,habitat,height,length,null,papillose,position,prickle,primary,shape,stone,structure,sympodial,texture,unit
351	wfo-0001030007	success	168	174	148	20	26	0.881	.05,.4,.5,0.1-0.5,0.2-1,0.5-1,0.8-1,1-1.5,1-15,1-2,1.5-5,1.6-2.2,15-20,2-4,2-7,3-5,3/4,4.5-5,6-10-flowered,7-10,7-9,acuminate,acute,along,anther,anthesi,apart,apex,bark,base,becoming,beneath,berry,branched,broadly,brown,bud,calyx,campanulate,clavate,closely,cm,corolla,dark,decurrent,deltoid,densely,dia,difoliate,dry,elliptic,erect,exserted,filament,flattened,fleshy,free,fruiting,glabrate,glabrous,globose,golden,golden-pubescent,green,hooded,impressed,incrassate,lateral,leaf,like,live,lobe,lobed,long,longer,main,major,margin,material,middle,midrib,minor,minutely,mm,oblique,obovoid,occasionally,older,one,onto,opposite,outline,ovary,pair,pale,papillose,pedicel,petiole,pitted,planar,plant,pore,poricidal,portion,prominent,pubescent,raised,reniform,rounded,scar,shaped,short,shorter,shrub,simple,slightly,small,soft,soon,spaced,sparsely,specimen,stem,stigma,straight,style,surface,tall,tear-drop,thick,thickened,tip,tree,trichome,trunk,tube,two,type,uniseriate,unit,vein,way,white,widest,winged,woody,x,young	abrupt,ba,cork,edicel,eed,geminateleaf,gre,inflorescenc,lon,lower,nflorescence,papillo,rest,ruit,slender,tapering,tub,ud,widening,ympodial	cell,color,corky,count,diameter,flower,fruit,geminate,grey,habitat,height,inflorescence,length,null,position,prickle,primary,seed,shape,size,stone,structure,sympodial,texture,width,wing
352	wfo-0001030010	success	156	153	126	30	27	0.808	.5,/4,0.5-5,0.7-1,0.9-1.1,1-1.5,1-2,1.2-1.5,1.5-2,10-15,11-12,2-2.2,2-7,20-40,3-5,4-4.5,5-7,7-10,acuminate,acute,anther,anthesi,apex,appearing,area,attenuate,bark,base,beneath,berry,brown,bud,calyx,closely,cm,corolla,cyathiform,dark,deciduous,decurrent,deflexed,deltate,difoliate,dry,ellipsoid,exserted,filament,fleshy,free,fruit,fruiting,furcate,glabrate,glabrous,globose,green,grey,hooded,lateral,leaf,lobe,lobed,long,main,major,margin,material,midrib,minor,minute,minutely,mm,near,nearly,obovate,occasionally,often,older,opposite,orange,ovary,ovoid-reniform,pair,papillose,pedicel,persistent,petiole,pitted,planar,pore,poricidal,prominent,puberulent,rather,reddish,scar,shaped,shrub,simple,size,slightly,small,smooth,soon,spaced,stem,stigma,style,surface,tall,tear-drop,tiny,tip,tree,trichome,trunk,tube,uniseriate,unit,vein,way,white,winged,woody,x,young	.75,1-1.3,10-50-flowered,2.5,basal,dia,differing,distal,eaf,edicel,eed,f,geminat,lon,lower,m.,materia,middle,nflorescence,one,overlappin,portion,ruit,shin,straight,styl,tapering,ud,widest,ympodial	10-50,cell,color,count,diameter,flower,geminate,growth,habitat,height,inflorescence,length,new,null,overlapping,position,prickle,primary,seed,shape,shiny,stone,structure,sympodial,texture,width,wing
353	wfo-0001030023	success	171	180	140	31	40	0.819	-,0-100+,0.5-1,1,1-2,1-8,1.5-2,1.5-7,10-,10-25,11-40+,12-18,2,2-3,2.5-3.5,3-4.5,3-5,30-50+,4,4-12,5,5-,5-16,5-6,6-26,6-7,7-9,abaxially,acute,adaxially,aggregate,apex,apiculate,articulated,axe,basal,base,beyond,blade,branched,calyx,cell,ciliate,cm,color,connivent,cordate,cuneate,cylindrical,deeply,densely,denser,diameter,dilated,directed,distally,ellipsoidal,elliptic,especially,exceeding,except,exserted,finely,flattened,fleshy,flower,forked,fruit,glabrous,glandular-puberulent,globose,greenish-white,hair,highly,lanceolate,leaving,lobe,long,loosely,main,margin,membranaceous,mm,moderately,narrow,narrowly,near,oblique,oblong,obtuse,occasionally,often,ovate,pedicel,pedicellar,peduncle,peltiform,perfect,petiole,pore,present,probably,prominent,puberulent,pubescence,pubescent,purplish-,rachi,remnant,ripe,short-acuminate,shorter,simple,slightly,small,somewhat,sparsely,stamen,stigma,stone,style,subcoriaceous,swelling,thecae,time,tip,tree,triangular,truncate,tube,unbranched,unit,unknown,usually,vein,villous,wide,x,yellowish,young	1-,13-20,20-30,4-10,4-foliat,apart,ape,capitat,connective,eaf,eed,entire,glandular-puberulen,lon,lower,nflorescence,nther,orolla,presen,pubescen,pubescent-pilo,radiu,ruit,spaced,stellate,tal,tem,ud,unknow,vary,ympodial	4-foliate,anther,anthesi,bark,bud,capitate,corolla,count,explicitly,filament,free,fruiting,growth,habitat,height,inflorescence,lateral,leaf,length,major,mentioned,minor,new,ovary,position,prickle,primary,pubescent-pilose,scar,seed,shape,size,stem,structure,surface,sympodial,tall,texture,width,wing
354	wfo-0001030032	success	250	195	168	82	27	0.672	+,0.1-0.4,0.1-0.5,0.2-0.3,0.2-0.5,0.25-0.4,0.5,0.5-0.6,0.5-1,0.5-2,0.6-1.1,0.7-0.8,0.8-1.1,1-1.3,1-1.5,1-2-celled,1.5-2,1.5-2.5,11-20,13-35,2-10,2-3-locular,2-3.5,2-4,2-5,2-60,2-lobed,2.4-3.5,3.5-12,30,4-5,4-6-celled,5-plurifoliate,60-80,7.5-10,8-10,8-10-celled,8-20,abaxially,absent,abundant,acuminate,acute,along,anther,anthesi,apex,appearance,articulated,articulation,base,bent,border,branched,breaking,bright,calyx,capitate,cell,clambering,cm,completely,conical,corolla,dark,decurrent,deltate,densely,diameter,dry,ebracteate,elliptic,entire,filament,flower,free,fruit,fruiting,give,glabrous,golden,green,greenish-brown,hair-like,imparipinnate,interjected,internode,interrupted,irregularly,large,lateral,leaf,leaflet,length,like,lobe,long,longest,many,margin,middle,midvein,mm,moderately,obovate,occasionally,often,onto,opposite,orbicular,outgrowth,ovary,pale,patent,pedicel,peduncle,petiole,pithy,present,primary,pubescence,pubescent,rachi,reflexed,round,seed,silky,simple,slightly,soft,somewhat,sparsely,specimen,splitting,spreading,stem,stigma,straight,style,subopposite,surface,swollen,tall,tangled,terminal,testa,thickened,time,tip,transparent,trichome,truncate,tube,unicellular,uniseriate,unit,vein,venation,vine,wall,weaker-walled,white,wide,winged,woody,yellow,younger,Â½-3/4	.05,.5,0.2,0.4-1.5,0.5-0.7,0.5-1.5,0.8-1.0,1-3,1-celled,2,3,3-5,3.0-3.5,4-celled,4.3-5.0,6-11,7-16,adaxial,adaxially,also,apical,appendage,basal,basally,basiscopically,branche,brown,column,conspicuou,densest,desne,eaf,edicel,eed,exserted,glandular,gree,halfway,hea,head,herbarium,lamina,larger,leave,lower,markedly,mixed,much,multicellular,nflorescence,node,oblanceolate,oblique,older,pair,paler,petiolule,pseudostipule,rest,rotate,rotate-stellate,rough,ruit,secondary,set,shorter,smaller,sometimes,sparser,stamen,staminal,sterile,tem,tertiary,thick,tiny,touch,ud,usually,vegetatio,well-developed,ympodial	0.1-0.2,bark,bud,color,conspicuous,count,dense,growth,habitat,height,inflorescence,major,minor,new,position,prickle,scar,shape,size,stone,structure,sympodial,texture,vegetation,width,wing,young
355	wfo-0001030048	success	156	156	124	32	32	0.795	.5,0.5-1.5,1-2,1.2-2,1.3-1.6,1.5-3.5,1.5-7,10-16,2-3,2-5,3-5,4-15,5-10-flowered,5-8,5973,abaxial,abaxially,acute,adaxially,anther,anthesi,apex,apically,apparently,arachnoid,bark,base,becoming,bi-lobed,blue,broadly,brown,calyx,clavate,closely,cm,completely,conical,corolla,covered,decurrent,deflexed,deltate,densely,dia,difoliate,drying,ellipsoid,elliptic,felt-like,fide,filament,fleshy,free,fruiting,glabrate,glabrous,globose,golden,green,greyish,impressed,internodal,lateral,leaf,lightly,lobe,lobed,long,main,margin,matted,middle,minutely,mm,nearly,onto,opposite,ovary,ovoid-reniform,pair,pale,papillose,pedicel,petiole,pitted,planar,pointed,pore,poricidal,prominent,pubescent,rather,scar,shaped,shiny,shrub,simple,small,solomon,somewhat,spaced,sparsely,stem,stigma,style,surface,tall,tear-drop,thick,thickened,tip,tree,trichome,trifoliate,tube,unit,vein,white,wide,widest,woody,yellowish,young	1-1.5,3-3.5,4-4.5,along,ape,berry,bi-colored,eaf,edicel,eed,exserted,four-angle,geminat,inflorescenc,lamina,like,lon,lower,nflorescence,occasionally,older,overlappin,papillo,portion,reddish-brown,rest,ruit,strongly,tan,tub,ud,ympodial	5-10,bud,cell,color,count,diameter,flower,four-angled,fruit,geminate,growth,habitat,height,inflorescence,length,major,mentioned,minor,new,overlapping,position,prickle,primary,seed,shape,size,stone,structure,sympodial,texture,width,wing
356	wfo-0001030053	success	141	138	108	33	30	0.766	0.5,1-1.3,1-13,1.3-3.5,1.5-5.5,1.8-2,100,2-2.5,4-,5,7-11,7-9,<,abruptly,acuminate,acute,aiding,anthesi,apart,apex,apical,apiculae,ark,around,base,branch,branched,brown,calyx,cell,climbin,cm,completely,coriaceous,corolla,cyathiform,decurrent,diameter,eaf,elliptic,entire,filiform,fine,flattened,flower,fruiting,glabrous,greenish,growth,hyaline,inflorescence,irregularly,lobe,lobed,long,many,margin,minutely,mm,near,new,nipple,older,pair,pale,papillo,parallel,pedicel,pendant,petiole,pitted,plurifoliat,primary,reniform,revolute,rim,scar,secondary,shallowly,shin,shining,shiny,simple,slightly,spaced,spreading,stem,strongly,support,surface,terminal,time,tiny,tip,truncate,tube,turbinate,twining,unit,usually,vein,venation,vine,white,woody,x,yellowish,ympodial	0.5-1,10-20,2.5-3,3.5-4,5-merou,abscission,alyx,articulated,berry,bfeore,eed,exserted,far,fide,fragrant,frui,leaving,lower,mentz,nflorescence,orolla,papilla,peduncle,peg,per,perfect,rectangular,sleeve,small,spreadin,tem,testal,ud	anther,bark,bud,color,count,filament,free,fruit,habitat,height,leaf,length,mentioned,ovary,papillae,papillose,plurifoliate,position,prickle,seed,shape,stigma,stone,structure,style,sympodial,texture,width,wing,young
357	wfo-0001030057	success	141	117	76	65	41	0.539	2-3-celled,2-4,2-6,2.1-4.1,20-80,3-5,4-10,4.3-8.2,7-14,8-19,abaxially,acuminate,acute,adaxially,apex,axillary,base,berry,bud,cell,chartaceous,cm,cordate,covering,cuneate,diameter,distal,flower,forked,fruit,generally,globose,green,green-white,hair,half,herb,lateral,leaf,like,make,membranous,mm,mottled,mucilaginous,narrow,odd-pinnate,ovoid,pedicel,petiole,plant,plurifoliate,pubescent,purple,seed,short,size,sometimes,stem,subglabrous,subtending,tall,terminal,testal,thick,throughout,tri-,truncate,unit,unwinged,usually,wall,wet,whitish,wing,x	-2,1-10,1-2,2-4.5,20-30,3.5-8,5.5-12,8,absent,apart,apparently,articulated,axe,blade,borne,broadly,brownish,condition,decreasing,digestion,drying,eaf,eed,elliptic,end,enzyme,erec,extremely,fresh,geminat,glabrou,greatly,greenish,hair-like,high,honeycomb-shaped,interjected,larger,leaflet,living,long,lunate,nflorescence,ovate,pair,peduncle,perfect,petiolule,removed,ruit,scale-like,seudostipule,singly,small,spaced,specimen,ste,stolo,suborbicular,tem,thir,toward,tuber,typically,ympodial	'hair-like,anther,anthesi,bark,calyx,color,corolla,count,filament,free,fruiting,geminate,growth,habitat,height,inflorescence,length,lobe,major,margin,mentioned,minor,new,ovary,position,prickle,primary,scar,shape,stigma,stone,structure,style,surface,sympodial,texture,tip,tube,vein,width,young
358	wfo-0001030057	success	197	146	114	83	32	0.579	-10,.5-3.5,1-2,2-3-celled,2-4,2-6,2.1-4.1,20-30,20-80,3-5,4-10,4.3-8.2,5-10,5-6,7-14,8-19,abaxially,acuminate,acute,adaxially,along,anther,apex,apparently,axillary,base,berry,bud,cell,chartaceous,ciliate,cm,connivent,cordate,corolla,covering,cuneate,diameter,distal,dorsally,especially,filament,flat,flower,folded,forked,fruit,generally,glabrous,globose,green,green-white,greenish-yellow,hair,hair-like,half,herb,lanceolate,lateral,leaf,like,linear,lobe,make,margin,membranous,middle,midrib,minutely,mm,mottled,mucilaginous,narrow,odd-pinnate,ovate-lanceolate,ovoid,pedicel,perfect,petal,petiole,plant,plurifoliate,puberulent,pubescent,purple,seed,short,size,sometimes,star,stem,stigma,striped,style,subglabrous,subtending,tall,terminal,testal,thick,throughout,tip,tri-,truncate,tube,unit,unwinged,usually,wall,wet,white,whitish,wing,x	-2,1-10,2-3,2-4.5,2-5,3.5-8,5-merou,5.5-12,8,absent,acumen,ag,alyx,apart,articulated,axe,blade,borne,broadly,brownish,condition,decreasing,digestion,drying,eaf,edge,eed,elliptic,end,enzyme,erec,exceeding,extremely,fresh,geminat,glabrou,globo,greatly,greenish,high,homostylous,honeycomb-shaped,interjected,larger,leaflet,lengthening,living,long,lower,lunate,nflorescence,orolla,ovate,pair,peduncle,pentagonal,petiolule,pore,poricidal,removed,rotate,ruit,scale-like,seudostipule,singly,slit,small,spaced,specimen,stamen,ste,stolo,straight,suborbicular,tamen,tem,thir,toward,tuber,typically,vary,yellow,ympodial	anthesi,bark,calyx,color,count,erect,free,fruiting,geminate,growth,habitat,height,inflorescence,length,major,mentioned,minor,new,ovary,position,prickle,primary,scar,shape,stone,structure,surface,sympodial,texture,vein,width,young
359	wfo-0001030080	success	186	109	76	110	33	0.409	0.4-1.5,0.5-4,1-2,1.5-2.5,2-3,2-4,3-10,4-7,5-13.5,8-16,abaxially,adaxially,anther,axillary,berry,bud,cell,clavate,cm,corolla,covering,dark,diameter,distal,dot,filament,flower,forked,fruit,generally,glabrescent,glabrous,green,hair,half,herb,lanceolate,lateral,leaf,light,lobe,make,medium,mm,mucilaginous,odd-pinnate,ovate,ovoid,pedicel,petiole,plant,plurifoliate,purple,pyriform,seed,sometimes,stellate,stigma,style,subtending,tall,terminal,testal,thick,throughout,tiny,tip,tri-,tube,unit,usually,wall,wet,white,width,winged	0.3-7,1-3,1.5-2,1.8-4.5,1999,2.1-7.1,3-5,3.3-7.7,4-12,5-7,5-merou,5.5-9.9,6.5-18.6,8-23,9.9-33,abaxiall,absent,acumen,acuminate,ag,along,alyx,apart,apex,apparently,arranged,articulated,axe,base,bead,blade,brownish,capitat,ccording,condition,connivent,coriaceous,cuneate,decreasing,decurrent,digestion,dorsally,drying,eaf,edge,eed,elliptic,enzyme,erec,exceeding,flat,folded,fresh,geminat,glabrou,green-white,greenish,hair-like,hal,high,homostylous,honeycomb-shaped,inconspicuous,interjected,larger,leaflet,lengthening,like,linear,living,long,lower,moniliform,mottled,multiple,necklace,nflorescence,ochoa,onto,orolla,pair,peduncle,perfect,pore,poricidal,rachi,removed,second,seudostipule,size,slightly,slit,spaced,specimen,stamen,stolon,straight,strongly,subequal,tamen,tem,toward,tuber,typically,unknown,vary,whitish,x,yellow,ympodial	'hair-like,anthesi,bark,calyx,capitate,color,count,free,fruiting,geminate,growth,habitat,height,inflorescence,length,margin,mentioned,new,ovary,position,prickle,primary,scar,shape,stem,stone,structure,surface,sympodial,texture,vein,wing,young
360	wfo-0001030081	success	157	144	113	44	31	0.72	.5,0.5-1,0.5-1.5,0.5-2.5,1,1-2,1-2-celled,1-3,1-4,1-5,1.5,10-20,1st,2-7,2-foliate,2nd,3-6,4-6,abaxially,absent,abundant,acute,adaxially,along,anther,apex,apically,axe,base,berry,beyond,blade,brown,calyx,cell,center,chartaceous,cm,connected,cordate,densely,denser,diameter,dm,drying,edge,elliptic,elliptic-ovoid,equal,exserted,few-branched,filament,fine,flat,flower,fruit,geniculate,glabrous,globose,hair,herb,immature,interpetalar,linear-lanceolate,lobe,lying,margin,maturing,membranaceous,mm,moderately,nearly,notch,oblong,parallel,pedicel,peduncle,petiole,placenta,pointing,pubescent,rachi,radiating,raised,rarely,ridge,running,semitransparent,shallow,short,single-,slightly,small,sometimes,sparsely,stamen,stigma,straight,style,surface,swollen,tissue,triangular,tube,two-celled,unbranched,unit,usually,vein,white,woody,x,yellow	0.25-0.5,1.5-3,1.5-7,10-35,2-4,3-10,5-12,5-15,adaxiall,ciliate,decurrent,dehiscing,eaf,eed,emarginat,entire,explosively,frui,geminat,held,long,longer,lower,maturit,mesocarp,nfloresence,obtuse,often,one,orolla,other,per,pressure,pubescen,rotate,rounded,ruit,tal,tamen,tem,vary,watery,wid,ympodial	bud,color,corolla,emarginate,free,fruiting,geminate,growth,habitat,height,inflorescence,leaf,length,new,ovary,position,prickle,primary,scar,seed,shape,specified,stem,stone,structure,sympodial,tall,texture,tip,wide,young
361	wfo-0001030083	success	146	121	98	48	23	0.671	0.25-0.5,0.5-1,0.5-2,0.8-1,0.8-3,1-1.5,1-2,1.5-3,2,2-3,3/4,4-6,9-11,accrescent,anther,anthesi,bark,base,beginning,broadly,calyx,closely,cm,corolla,cup-shaped,decurrent,deeply,deltoid,dry,elliptic,elongate,fleshy,flower,fruit,fruiting,glabrous,globose,green,greenish-white,hyaline,internodal,lateral,leaf,lobe,lobed,long,long-styled,main,minutely,mm,narrowly,near,opposite,ovary,ovate,overlapping,ovoid-reniform,pair,pale,papillose,pedicel,petiole,pitted,poricidal,prominent,raised,red-papillose,reddish-gold,reflexed,scar,shallowly,short-styled,shrub,simple,single-stemmed,slender,slightly,small-capitate,somewhat,spaced,specimen,stem,stigma,style,surface,tall,tan,tip,translucent,tube,unit,vein,way,white,winged,woody,x,young	.5,.75,0.1,10-30,2-5-flowered,3-4,4-15,acute,apex,berry,dar,deciduous,deflexed,dia,drying,eaf,edicel,eed,exserted,greyish-re,inflorescenc,lon,long-acuminate,lower,membranous,middle,nflorescence,older,onto,paler,papillae,pore,proximal,ruit,shaped,soon,straight,strongly,tapering,tear-drop,terminal,thickened,thin,tub,ud,unifoliat,widest,ympodial	bud,cell,color,diameter,filament,free,greyish-red,habitat,height,inflorescence,length,margin,mentioned,position,prickle,primary,seed,shape,stone,structure,sympodial,texture,unifoliate
362	wfo-0001030093	success	181	176	150	31	26	0.829	.2,.5,0,0.1-0.3,0.2,0.2-0.5,0.2-1,0.5-1.1,0.6-1.5,0.75-1,1-1.5,1-12,1-5,1.3-4.5,2-2.5,2.5-11,3-4,3.5-12,4-6,5-50-flowered,5-8,7-30,8-9,anther,anthesi,apex,bark,base,becoming,beneath,berry,branched,brownish-tan,calyx,campanulate,case,clavate,closely,cm,continues,corolla,deflexed,deltoid,densely,dia,difoliate,ellipsoid,elliptic,erect,especially,evenly,except,expanded,exserted,filament,flower,forest,free,fruiting,furcate,glabrous,globose,golden,green,greenish-white,growth,hirsutulous,impressed,inundated,lateral,leaf,lobe,lobed,long,long-styled,major,many,margin,member,middle,minor,minutely,mm,narrowly,nearly,new,obovate,occasionally,often,older,onto,opposite,ovary,ovoid-reniform,pair,pale,paler,pedicel,persisting,petiole,pitted,plant,population,pore,poricidal,portion,present,puberulent,pubescent,quite,reflexed,remaining,scar,shaped,shiny,shoot,short-styled,shrub,simple,slender,slightly,small,soon,southern,spaced,stem,stigma,style,surface,tall,tapering,tear-drop,terminal,thickened,time,tiny,tip,tree,trichome,tube,underside,uniseriate,unit,vein,white,widest,woody,x,yellowish,young	7-9,acuminate,acute,apar,attenuate,collection,commonly,cuneate,differing,eaf,edicel,eed,geminat,greyish-brow,guyanese,hyaline,like,lon,lower,main,nflorescence,one,open,orbicular,papillo,ruit,size,straight,tub,ud,ympodial	apart,bud,cell,color,count,diameter,fruit,geminate,greyish-brown,habitat,height,inflorescence,length,papillose,position,prickle,primary,seed,shape,specified,stone,structure,sympodial,texture,width,wing
363	wfo-0001030145	success	153	119	80	73	39	0.523	-3,0.2-2,0.5,0.5-1,0.5-4,1-1.5,1-2,1-3,1.5-2,1.5-7,2-3,2-4,2.5-6.5,3-5,6-40,abaxially,acute,adaxially,adpressed,also,apex,basal,base,calyx,cell,chartaceous,cm,color,compound,cuneate,deltate,densely,diameter,ellipsoidal,elliptic-ovate,fleshy,flower,forked,fruit,glabrous,glandular,globose,hair,herb,lateral,leaf,less,lobe,long,margin,mm,moderately,narrowly,obtuse,pedicel,petiole,pilose,puberulent,ripe,shrub,simple,slender,slightly,somewhat,sparsely,stigma,stone,style,subcordate,subcoriaceous,ternately,toward,triangular,truncate,tube,unbranched,unit,unknown,violet,x	-2,0.3-,1,1-2.5,1-5,1.5,1.5-4.5,10-12,3,3-10,3-4,4-5,4-8,4-foliat,8-11,absent,aggregate,apart,ape,articulated,axe,beyond,blade,campanulate,connective,cylindrical,directed,distally,dunal,eaf,eed,elliptic,entire,exceeding,exserted,fide,lanceolate,larger,leaflet,leaving,lon,lower,near,nflorescence,nther,orolla,ovate-elliptic,pedicellar,peduncle,pore,presen,puberulen,rachi,radiu,reddish,remnant,ruit,shorter,sinuate,spaced,stamen,tal,tem,terminal,thecae,time,tomento,truncat,ud,vary,wide,yellow,ympodial	4-foliate,anther,anthesi,bark,bud,corolla,count,filament,free,fruiting,growth,habitat,height,inflorescence,length,major,mentioned,minor,new,ovary,position,present,prickle,primary,scar,seed,shape,size,stem,structure,surface,sympodial,texture,tip,tomentose,vein,width,wing,young
364	wfo-0001030146	success	210	141	119	91	22	0.567	.1,0.5,0.5â1,0.6â2,1.2â1.5,1.5â2,16â20,1â1.1,1â1.5,2.5â9,20,4â4.5,5â8,60+,6â7,8â15,9â9.5,>,abaxial,abaxially,adaxial,anther,anthesi,axe,base,beneath,berry,branched,branching,brownish,c.,calyx,capitate,cell,closely,cm,corolla,covered,cup-shaped,dark,deeply,deltate,dense,densely,diameter,drying,echinoid,ellipsoidal,elliptic,filament,flower,free,fresh,fruiting,glabrous,globose,gradually,green,growth,impressed,inflorescence,layer,leaf,length,less,like,lobe,lobed,long,many,margin,minutely,mm,multangulate,narrowing,narrowly,new,olive,pair,pale,papillose,pedicel,peltate,persistent,petiole,plurifoliate,primary,pubescence,pubescent,ray,reflexed,regularly,ripe,scar,sessile,shiny,short-stalked,spaced,stellate,stem,stigma,style,subtended,surface,tan,tangled,terminal,time,tip,trichome,tube,undersurface,unit,vein,way,white,wide,woody,â18	.2,.5,0.2â0.4,0.6â0.7,0.9â1,20â30,2â5,3â4,3â6,40â50,4â30,5-merou,6.5â16,absent,acuminate,acute,ag,almost,along,alyx,apar,apex,appearing,ark,articulated,beig,bright,brown,center,connivent,coriaceous,dichasia,discolorous,eaf,edge,eed,elongate,entire,erec,exserted,flattened-reniform,fused,golden,halfway,ilament,lamina,lengthening,loosely,lower,midpoint,nflorescence,nodding,older,orolla,part,peduncle,per,perfect,pericarp,pitted,plant,pore,poricidal,portion,projection,reddish,revolute,rhachi,ruit,scurfy,simple,slit,small,sparsely,stout,strongly,tall,tem,testal,thin,tiny,tree,treelet,ud,unevenly,upper,vary,varying,visible,yellow,ympodial	apart,bark,beige,bud,color,count,dichasial,fruit,habitat,height,mentioned,ovary,position,prickle,shape,stone,structure,sympodial,texture,width,wing,young
365	wfo-0001030147	success	158	137	97	61	40	0.614	0-5,0.5-2,1-4,1-5,1.0-2.0,10-19,14-35,15-30,2,2-10,2-10.5,2-13,2-3,2-5,2.5-7.5,4-5.5,4.5-10,5-8,8-38,abaxially,acumen,acuminate,acute,adaxially,apex,attenuate,base,blue,branched,calyx,cell,cm,conical,connate,corolla,covering,cuneate,cyme,deep,diameter,dichasial,dichasially,distal,dorsally,ebracteate,edge,filament,finely,flat,flower,folded,forked,generally,green,hair-like,half,herbaceous,lateral,leaf,living,lobe,long,long-attenuate,make,medium,mm,monochasial,mucilaginous,oblique,obtuse,odd-pinnate,ovoid,pedicel,peduncle,perennial,petiole,petiolule,plant,pubescent,purple,rotate,rounded,seed,size,specimen,stigma,style,testal,thick,throughout,tip,tuber-bearing,typically,unit,wall,wide,yellow	-8,1.0-2.2,3-,3-6-foliat,4-3.,4.2-7.5,5-7,abaxiall,apical,apically,articulate,dehiscent,digestion,diminishing,eaf,eed,elliptical,emoval,enzyme,exceeding,globo,gradually,green-white,honeycomb,interjected,introrse,leaflet,lon,lower,lunat,maturing,narrowly,nflorescence,nther,often,orolla,ovate,pair,pattern,perfect,plan,poricidally,proximal,reveal,ruit,sessile,seudostipule,short,slit,stamen,straight,subequal,subsessile,tal,tem,terminal,throughou,toward,vary,ympodial,Â¼	3-6-foliate,anther,anthesi,bark,bud,color,count,free,fruit,fruiting,globose,habitat,height,inflorescence,length,lunate,major,margin,mentioned,minor,ovary,position,prickle,primary,pseudostipule,scar,shape,stem,stone,structure,surface,sympodial,tall,texture,tube,vein,wet,width,wing,young
366	wfo-0001030151	success	175	149	110	65	39	0.629	-50,0.2-0.5,0.5,1-1.5,1-17,1-2,1-3,1.5-2.5,15-35,2-25,2-6,2-7-compound,3-14,3-5,3.5-32,5-6,6-9,abaxially,abundantly,acuminate,acute,adaxial,adaxially,aggregate,apex,apiculate,around,basal,base,beyond,blade,blotch,calyx,cell,cm,connate,cordate,cuneate,decurrent,deltate,diameter,eglandular,except,exserted,flower,fruit,glabrate,glabrous,glandular,glandular-puberulent,globose,hair,lanceolate,leaf,less,lilac-tinged,line,lobe,long,longitudinal,margin,membranaceous,mm,narrowly,oblique,oblong,obovate,often,pedicel,petiole,pinnately,presence,probably,puberulent,pyriform,ring,ripe,sand-punctat,sand-punctate,scattered,shallowly,short,simple,slightly,small,sometimes,sparsely,stamen,stigma,stone,stripe,style,surface,tal,tem,tip,toward,tree,triangular,truncate,tube,unbranched,unit,vein,veiny,white,white-puberulent,x,yellow,yellow-green	-3,0.3-0.5,0.5-1,1,1-5,1.5-2,10-20,10-25,2-11,2-3,20-30,4-5,4-foliat,?,absent,apart,ape,articulated,axe,channe,chartaceous,ciliat,compound,connective,cylindrical,directed,distally,eaf,eed,elliptic,entire,exceeding,leaflet,leaving,lon,lower,near,nflorescence,nther,obtuse,orolla,pedicellar,peduncle,perfect,pore,purplish,rachi,radiu,remnant,ruit,shorter,slender,somewhat,spaced,stalked,stellate,thecae,time,truncat,ud,unknow,vary,whitish,wide,ympodial	4-foliate,anther,anthesi,bark,bud,channel,ciliate,color,corolla,count,filament,free,fruiting,growth,habitat,height,inflorescence,lateral,length,major,mentioned,minor,new,ovary,position,prickle,primary,scar,seed,shape,size,stem,structure,sympodial,texture,unknown,width,wing,young
367	wfo-0001030153	success	147	154	128	19	26	0.871	.1,.2,/3,0.2-1,0.8-0.9,0.8-1.3,1-1.2,1-1.5,1-10,1-2,1-2.5,1.3-1.5,1.3-1.9,1.5-2,2-8,2-lobed,2.5-4,3-4,3-5,3-50,3.5-10.5,5-6,6-8,abaxially,acute,adaxially,age,anther,anthesi,apart,apex,apiculate,apparently,attenuate,axil,bark,base,berry,branched,brittle,broadly,calyx,campanulate,clavate,cm,conical,corolla,dark,deltate,densely,diameter,distinct,domatia,dot,dry,ellipsoid,elliptic,enlarged,erect,exerted,filament,flower,free,fruiting,glabrous,globose,green,growth,impressed,internodal,irregularly,lanceolate,lengthening,less,lobe,lobed,margin,markedly,membranous,minutely,mm,narrowly,new,nodding,occasionally,older,ovary,pair,paler,papillate,pedicel,peduncle,petiole,pit-like,plane,pore,poricidal,primary,rachi,resinous,ripe,scar,simple,slightly,slit,small,spaced,specimen,stem,stigma,straight,strongly,style,surface,terminal,thin,time,tip,tree,treelet,tube,unit,vein,way,white,x,yellowish,young	absent,acuminate,ape,caly,eaf,entire,glabrou,known,lower,nflorescence,ot,papillat,perfect,plurifoliat,portion,revolute,ruit,ud,ympodial	bud,cell,color,count,fruit,habitat,height,inflorescence,lateral,leaf,length,major,minor,n/a,plurifoliate,position,prickle,seed,shape,size,stone,structure,sympodial,texture,width,wing
368	wfo-0001030167	success	141	118	68	73	50	0.482	.8,14â19,4.5â8,abaxially,accrescent,acuminate,adaxially,along,anther,apex,base,blade,calyx,ciliate,climbing,cm,densely,diameter,extra-axillary,filament,flattened,flower,fruit,fruiting,gap,glabrous,green,herbaceous,lanceolate,less,lobe,margin,maturity,membranous,minutely,mm,near,obtuse,ovate,ovoid,pair,pedicel,petal,petiole,pinnate,reflexed,rounded,sand-punctate,scar,secondary,simple,slender,somewhat,sparsely,stigma,style,symmetrical,tip,tube,unbranched,unit,unknown,vegetation,vein,vine,weakly,white,x	.9,0.1â0.2,0.5â0.6,0.5â0.7,0.6,0.6â0.8,0.7â1.2,0.8â1,1.2â2.5,1.5â2,1.5â7,12,15â20,17â58,1â1.2,1â1.5,2â3,2â4.5,4â10,4â4.5,4â5,4â7,5-merous,8â10,acute,alyx,apar,apically,axe,berry,branch,c.,chartaceous,ciliat,clavate,contiguously,eaf,eed,enlarged,entire,fertile,glabrou,immature,long,lower,m.,membranaceous,moderately,nearly,nflorescence,nternode,orolla,peduncle,penden,perfec,plurifoliat,pointed,rachi,ruit,seen,slightly,spaced,stellate,subequal,tamen,tem,thinly,time,truncat,vary,venation,wide,ympodial	0.1-0.2,0.5-0.6,0.5-0.7,0.6-0.8,0.8-1,1-1.5,14-19,17-58,4-10,4-4.5,4-7,4.5-8,anthesi,bark,bud,cell,color,corolla,count,description,free,growth,habitat,height,inflorescence,lateral,leaf,length,major,mentioned,minor,new,ovary,plurifoliate,position,prickle,primary,seed,shape,size,stem,stone,structure,surface,sympodial,texture,truncate,width,wing,young
369	wfo-0001030176	success	171	176	139	32	37	0.813	-1.4,-4.25,.2,.7,.75-1.5,0.4-1.5,0.5,0.5-2,0.6-0.9,0.7-1.4,1,1-5,1.2-2.5,1.5-2,1/3,1/6,2-3,2-foliate,2.25-3.25,2.5,2.5â7.5,2.5â9,3-5,3-lobed,4-9,6-8,abaxially,accrescent,acute,adaxially,angulate,anther,apart,apex,apparently,articulated,asymmetrically,attenuate,axe,ba,basal,base,berry,bi-lobed,bilobed,blade,branch,broadly,calyx,chartaceous,ciliate,cm,connivent,contact,covering,decumbent,depressed-globose,diameter,downward,eaf,especially,extra-axillary,few-branched,filament,flattened-reniform,flower,forming,fruit,fruiting,geminat,glabrous,hair,herb,hold,interlobal,lance-ovate,lanceolate-oblong,lateral,light,line,lobe,lon,long,lower,major,margin,midrib,minutely,mm,near,nearly,nflorescence,node,oblong,often,ovate,pale,patch,pedicel,peduncle,perfect,petiole,plant,prostrate,pubescent,rachi,rarely,recurved,ripe,rooting,round,simple,sinus,slightly,soil,sometimes,somewhat,spaced,sparsely,stigma,style,terminal,time,tip,triangular,tube,unbranched,unit,vein,violet,white,white-puberulent,wide,winged,x,yellow,yellow-orange,ympodial,young	-6.25,0.7â0.8,1-2,1.2,1.5-2.5,1.6,2â3,3.75-5,5-merou,6â8,adaxiall,alyx,broad,capitat,cylindrical,dehiscent,eed,erec,hermaphroditic,juic,longitudinall,mesocarp,numerous,orolla,partially,pore,recurve,rotate-stellate,ruit,tamen,tem,vary	anthesi,bark,bud,capitate,cell,color,corolla,count,description,erect,free,geminate,growth,habitat,height,inflorescence,leaf,length,mentioned,minor,new,ovary,position,prickle,primary,scar,seed,shape,size,stem,stone,structure,surface,sympodial,texture,width,wing
370	wfo-0001030180	success	135	137	109	26	28	0.807	.1,.5,0.5-1,0.8-2,0.9-1.8,1-1.5,1.1-1.2,10-30-flowered,3-4,3-8,4.5-5,6,8-10,8.5-23,?,abruptly,accrescent,anther,anthesi,apex,appearing,attenuate,bark,base,becoming,calyx,clavate,cm,corolla,dark,decurrent,deltoid,dia,ellipsoid,filament,free,fruit,fruiting,furcate,glabrate,glabrous,globose,green,height,immature,interpetalar,known,lateral,leaf,linear,lobe,lobed,long,long-acuminate,main,middle,minute,minutely,mm,narrowing,nearly,occasionally,older,opposite,ovary,overlapping,pair,papillate,papillose,pedicel,petiole,planar,pore,poricidal,prominent,proximal,puberulent,raised,rounded,scar,shaped,shrub,sinus,slightly,soon,spaced,sparsely,stem,stigma,style,surface,tear-drop,terminal,thin,tip,trichome,tube,unevenly,uniseriate,unknown,vein,white,widely,widest,winged,woody,x,yellowish,young	.75,0.05-1,apart,apiculate,berry,clu,deflexe,eaf,edicel,eed,erect,exserted,inflorescenc,lenticellat,lon,lower,nflorescence,peduncl,plurifoliat,portion,ruit,slender,straight,ud,unit,ympodial	bud,cell,club,color,count,diameter,flower,growth,habitat,inflorescence,length,lenticellate,major,margin,minor,new,peduncle,plurifoliate,position,prickle,primary,shape,size,stone,structure,texture,width,wing
371	wfo-0001030189	success	188	181	152	36	29	0.809	-1/2,-4,.2,/3,0-15,0-30,0.1,0.1-0.2,0.2-0.3,0.2-0.5,0.5-1.6,0.9-1.1,1,1-1.5,1-2,1-3-cellular,1-4-cellular,1.1-2.7,1.3-4.2,1.5-2,1.5-4.5,1.5-5,1/3,1/6-1/3,2,2-3,2-5.5,2.5-4,3-4,3.2-4.5,4-13,4-5.5,5-,5-10,5-6,6-10,6-12,8,8-10,8-18,abaxially,anther,apically,apparently,appressed,bark,base,berry,blade,branched,calyx,chartaceous,cm,concolorous,connivent,curved,deltate,densely,diameter,drying,dull,elliptic,erect,evenly,filament,flattened-reniform,flower,foliaceous,free,fruit,fruiting,glabrescent,glabrous,gland-tipped,gray,green,lateral,leaf,length,lobe,lobed,long,longer,lower,margin,mature,maturity,mauve,midpoint,mm,moderately,oblong,obtuse,often,older,one,open,orange,ovate,pair,pedicel,per,pericarp,petiole,poricidal,porrect,primary,purple,ray,recurved,red,reflexed,scandent,scar,sessile,shorter,shrub,simple,slender,smooth,sometimes,somewhat,spaced,sparsely,spherical,spreading,stalk,stalked,stellate,stellate-pubescent,stem,strongly,style,surface,tapering,terete,terminal,time,tip,trichome,tube,unarmed,unit,upper,variously,vein,way,wide,woody,yellow,yellow-green,young	0-1,1-4-cellula,1/,5-merous,acut,alyx,apar,apex,articulated,cordate,eaf,eed,elongating,entire,equal,faint,frui,glabrescen,infructescence,nflorescence,orolla,oung,peduncle,perfec,plurifoliat,portion,red-brow,rounded,ruit,tamen,tertiary,unarme,vary,venation,visible,ympodial	1/4,acute,anthesi,apart,bud,cell,color,corolla,count,growth,habitat,height,inflorescence,new,null,ovary,plurifoliate,position,prickle,red-brown,seed,shape,stigma,stone,structure,sympodial,texture,width,wing
372	wfo-0001030219	success	191	184	144	47	40	0.754	0.1â0.3,0.5,0.8â3.0,0â,1.0â1.5,1.0â2.0,1.3â2.9,1.4â2.8,1.6â,10,15,2.0â2.5,2.0â3.2,2.0â5.5,2.4â6.0,2â,2â2.5,2â3,2â4.5,3,4.8â11.5,4â5,4â7,5â,5â8,60,6â,6â8,7â11,8â18,9â10,9â12,abaxially,acute,adaxially,adnate,along,anisophyllous,anther,anthesi,apex,apical,apparently,appearing,arising,arranged,basal,base,black,blade,blue,bractâlike,branched,brown,calyx,cell,chartaceous,cm,concave,connivent,convex,decreasing,decurrent,deeply,densely,diameter,difoliate,elliptic,equal,erect,filament,flattened,flower,fruit,glabrescent,glabrous,globose,green,hair,incised,indistinct,internode,lanceolate,leaf,lilac,lobe,long,margin,marking,mm,moderately,multicellular,number,oblong,olive,opposed,oppositely,ovate,pair,pale,paler,pedicel,peduncle,perennial,perfect,petiole,pitted,present,procumbent,pubescent,purple,redâpurple,regularly,rounded,serrate,sessile,shallowly,shrub,side,simple,size,smaller,spaced,sparsely,stigma,stone,stripe,strongly,style,surface,time,tube,two,unicellular,uniseriate,unit,velutinous,wide,wing,winged,woody,x,â3.0,â7.0	0.2â2.3,0.4â1.0,0.5â,0.7â1.1,1.0â1.2,1.0â2.2,1.5,1â2.5,4.5â5.5,5,6â10,abaxiall,acut,adaxiall,ag,apart,articulated,axe,ba,clavat,cylindrical,diamete,directed,distally,eaf,eed,geminat,longitudinal,lower,nflorescence,opening,orolla,pentagonal,pore,rapidly,ruit,sid,split,straight,tal,tamen,tem,vary,white,yellow,ympodial,â9.5	--,0.2,2.3,6,8,bark,bud,clavate,color,corolla,count,free,fruiting,geminate,growth,habitat,height,inflorescence,lateral,length,major,minor,new,null,ovary,position,prickle,primary,scar,seed,shape,stem,structure,sympodial,tall,texture,tip,vein,width,young
373	wfo-0001030225	success	155	130	91	64	39	0.587	-1.5,-11,-4,-7,.5-2.5,1,1-6,1.5,1.5-2.5,10-30,2,2-18,2-2.5,2-3,2-6,3-11-compound,3-20,3-4,3-5,4-5,8-15,abaxially,acuminate,acute,adaxially,apex,apical,basal,base,bilobed,calyx,cm,color,conivent,cordate,coriaceous,cuneate,deltate,densely,diameter,expanded,fleshy,flower,forked,fruit,glabrate,glabrous,gland,globose,leaf,less,lobe,long,margin,minutely,mm,moderately,narrowly,oblong,obtuse,papillose,pedicel,perfect,petiole,pinnately,possibly,prominent,puberulent,purple,rachi,scar,shallowly,shrub,simple,small,sparsely,stigma,style,succulent,time,tip,tree,triangular,truncate,tube,two,unbranched,unit,unknown,wide,x	-30,-45,.5,0,0-20,0-5,1-4,10-15,3-foliat,absent,apart,ape,apically,articulated,ature,axe,beyond,blade,campanulate,compound,connective,cylindrical,dilated,directed,distally,eaf,eed,elliptic-ovate,entire,equal,especially,exceeding,exserted,immature,laterally,leaflet,leaving,lower,nflorescence,nther,one,orolla,peduncle,pore,puberulen,radiu,see,seen,slightly,somewhat,spaced,stalked,stamen,stellate,strongly,tal,tem,thecae,tomento,toward,ud,unknow,vary,ympodial	3-foliate,anther,anthesi,bark,bud,cell,corolla,count,filament,free,fruiting,growth,habitat,height,inflorescence,lateral,length,major,minor,new,ovary,position,prickle,primary,seed,shape,size,stem,stone,structure,surface,sympodial,tall,texture,tomentose,vein,width,wing,young
374	wfo-0001030250	success	169	151	124	45	27	0.734	.5,/4,0.5-1,1-3,1.1-1.2,1.1-3.5,1.25-1.5,1.4-1.5,1.7-7,1.9-2.6,11.2-22,11.3,2.1-6,2.5-3.25,25,3-5,3.4-6.6,4-7,5-6,6-8,anther,anthesi,apart,apex,arching,attenuate,bark,base,beginning,beneath,berry,broadly,bullate,calyx,capitate,carinate-hooded,cm,conical,corolla,cuneate,cup-shaped,dark,decurrent,deflexed,dia,difoliate,dry,elliptic-ovate,filament,free,fresh,fruiting,glabrous,globose,green,greenish-white,greenish-yellow,horizontally,inflorescence,irregularly,lateral,leaf,lobe,lobed,long,long-acuminate,main,major,maturity,middle,minor,minutely,mm,n,node,older,opposite,orbiculate,ovary,pair,pale,paler,papillose,pedicel,petiole,pore,poricidal,projection,prominent,proximal,raised,reflexed,rim,scar,sea-green,shape,shaped,shrub,simple,size,slender,slightly,spaced,specimen,spreading,stem,stigma,style,surface,tall,tapering,tear-drop,tip,translucent,translucent-green,tube,unit,vein,way,white-lenticellate,widest,winged,woody,x	0-seeded,1-1.5,2-2.5,3.5-4,5-50-flowered,across,appearing,brown,consisting,curved,differing,eaf,edicel,eed,elliptic,exerted,five,geminat,glabrou,inflorescenc,lon,lower,nflorescence,occasionally,one,orbicular,ovoid-reniform,papillo,pendulous,pit,pitted,portion,ruit,seed,shallow,smooth,soon,straight,tan,two,ud,usually,white-lenticellat,wide,ympodial	5-50,bud,cell,color,count,diameter,flower,fruit,geminate,growth,habitat,height,length,margin,new,null,persistent,position,prickle,primary,stone,structure,sympodial,texture,width,wing,young
375	wfo-0001030271	success	195	133	98	97	35	0.503	0.15-0.75,0.5-1.2,0.9-3.6,1-2,1-3,1-4,1.4-2.1,1.9-6.6,2-3,2-4,2.4-5.6,3-10,4-22,5.6-12.3,6-15,abaxially,acumen,acute,adaxially,anther,apex,asymmetric,attenuate,axillary,base,basiscopic,berry,blue,bud,cell,clavate,cm,coloration,completely,connivent,corolla,dark,deep,diameter,distal,dorsally,edge,erect,filament,flat,flower,folded,forked,fruit,generally,glabrous,green,half,herb,lanceolate,lateral,leaf,light,lilac,linear,lobe,long,medium,mm,odd-pinnate,ovate,ovoid,pedicel,pentagonal,petiole,petiolulate,plant,plurifoliate,purple,ripe,rosette,rotate,rounded,side,size,sometimes,spot,stigma,style,subtending,symmetric,tall,terminal,tip,tissue,tri-,tube,unit,unwinged,usually,vein,white,x	0-2,0.7-9.5,0.9-2.5,1-2.5,1-6,1-7,15-61,2-2.7,2-6,3-5,3.4-7.5,4-7,5-8,5-merou,adaxiall,ag,along,alyx,apart,apparently,arranged,articulated,axe,bead,blade,brownish,capitat,condition,considerably,coriaceous,covering,decreasing,digestion,drying,eaf,eed,elliptic,enzyme,exceeding,fresh,geminat,glabrou,green-white,greenish,habi,hair-like,homostylous,honeycomb-shaped,interjected,larger,leaflet,lengthening,like,living,lower,make,middl,moniliform,mottled,mucilaginous,multiple,necklace,nflorescence,orbicular,orolla,pair,peduncle,perfect,pore,poricidal,removed,ruit,seed,sessile,seudostipule,slightly,slit,spaced,specimen,stamen,stolon,straight,tamen,tem,testal,thick,throughout,toward,tuber,typically,vary,wall,wet,whitish,wide,yellow,ympodial	anthesi,bark,calyx,capitate,color,count,free,fruiting,geminate,growth,habit,habitat,height,inflorescence,length,major,margin,mentioned,minor,new,ovary,position,prickle,primary,scar,shape,stem,stone,structure,surface,sympodial,texture,width,wing,young
376	wfo-0001030272	success	179	157	128	51	29	0.715	-6,.3,.5,/4,0.05-0.1,0.05-1.5,0.5-1,0.5-1.5,0.5-2,0.65-1,0.7-2.5,0.8-1.5,1,1-1.5,1-2.8,1.2-1.8,1.5-2.5,1.5-3,1/3,1/3-2/3,10-20,2-2.5,2-6.5,2.5-3,3.5-5,4-10,4-15,4-6,4-8,5-7,abaxially,acute,almost,ame,anther,apically,apparently,bark,base,berry,blade,bright,c.,calyx,cm,connivent,deltate,densely,diameter,difoliate,elliptic,elongating,erect,evenly,filament,flattened-reniform,flower,free,fruit,fruiting,glabrescent,glabrous,gland,glandular,green,hair,lateral,leaf,length,less,lobe,lobed,long,longer,margin,mature,maturity,mauve,midpoint,minute,mm,multangulate,narrow-deltate,near,older,one,open,orange-brown,pair,pedicel,petiole,poricidal,porrect,primary,ray,red,reduced,scar,sessile,shrub,simple,slender,spaced,sparsely,spherical,spreading,stellate,stellate-pubescent,stem,straight,style,surface,tapering,terete,terminal,time,tip,trichome,tube,unarmed,unbranched,unit,upper,vein,way,wide,woody,young	0-20,0.6-0.9,2.5-3.5,2.8-3.5,3-8,5-merous,acut,alyx,apar,apex,articulated,ba,concolorous,drying,eaf,eed,entire,equal,geminat,glabrescen,gra,infructescence,long-attenuate,lower,membranous,moderately,nflorescence,obtuse,orolla,oung,peduncle,per,perfec,pericarp,portion,red-brown,reflexe,rounded,ruit,shallowly,shorte,smooth,sometimes,tamen,tertiary,unarme,undulate,vary,venation,visible,ympodial	anthesi,apart,bud,cell,color,corolla,count,geminate,gray,growth,habitat,height,inflorescence,new,null,ovary,position,prickle,reflexed,seed,shape,shorter,stigma,stone,structure,sympodial,texture,width,wing
377	wfo-0001030287	success	150	136	96	54	40	0.64	-11,-40,-many,0.5-1,1,1-2,1-2.5,1-3,1-4,1.5-10,1.5-2.5,2,2-,2-10,2-12,2.5-4,3,3-9,4-5,4-6,4.5-6,5-10,?,abaxially,acute,adaxially,aggregate,apex,base,bluish,branched,calyx,cell,chartaceous,cm,color,compound,connivent,cylindrical,deltate,dendritic,dendritically,densely,diameter,eglandular,ellipsoidal,flattened,flower,forked,glabrous,gland,glandular,hair,herb,lanceolate,lateral,leaf,lilac,lobe,long,long-stalked,margin,membranaceous,mm,moderately,narrowly,oblong,obtuse,often,ovoid,pedicel,petiole,pinnately,puberulent,pubescent,purple,rugulose,scar,scattered,shrub,simple,sparsely,stalked,stigma,stone,strongly,style,subcordate,tip,triangular,truncate,tube,unbranched,unit,unknown,x	-foliat,.5-2.5,0-15,1-10,1-15,1-5.5,1966,2-5,8-13,adaxiall,apart,articulated,axe,basiscopically,blade,decurrent,dendritic-pubescen,directed,distall,down,eaf,eed,elliptic-ovate,entire,fide,leaflet,leaving,lon,lower,nflorescence,nther,orolla,pedicellar,peduncle,pore,presen,rachi,radiu,ruit,slightly,smith,spaced,sparser,stellate,subcapitat,subcoriaceous,tal,tem,time,upper,vary,wide,yellow,ympodial	-foliate,anther,anthesi,bark,bud,corolla,count,dendritic-pubescent,filament,free,fruit,fruiting,growth,habitat,height,inflorescence,length,major,mentioned,minor,new,ovary,position,present,prickle,primary,seed,shape,size,stem,structure,subcapitate,surface,sympodial,tall,texture,vein,width,wing,young
378	wfo-0001030300	success	235	187	158	77	29	0.672	-0.9,-1,.5,0.1-0.15,0.15-1,0.2,0.2-0.5,0.4-0.5,0.4-4.5,0.5,0.5-0.6,0.5-4,0.6-0.7,0.6-0.8,0.7-0.8,0.7-1.2,0.8-1,0.9-1,1,1-1.3,1-2,1-6,1-celled,1.2-,1.4-2.4,1.5-,1.5-2.5,2-2.1,2-2.5,2-foliate,2.2-7.5,3.5-13,4-11,4-celled,6-15,6-8-celled,abaxially,absent,abundant,acute,adaxial,adaxially,almost,always,anther,anthesi,apex,apical,appearance,appendage,articulation,base,bent,bifid,bracteate,brittle,calyx,capitate,cell,cm,cordate,corolla,curved,deltate,densely,diameter,distal,eglandular,ellipsoidal,elongate,face,filament,flower,fruit,fruiting,give,glabrous,glandular,globose,glutinous-viscose,golden,green,hair-like,head,herb,imparipinnate,inflorescence,internode,interrupted,introrse,large,larger,lateral,less,like,lobe,long,margin,markedly,midvein,minute,mm,moderately,narrowly,node,oblique,obovate,once-branched,outgrowth,ovary,pedicel,perennial,petiole,plant,population,pore,present,primary,pubescence,pubescent,reflexed,rest,rounded,silky,simple,slightly,sparsely,spathulate,spreading,stem,sterile,stigma,straight,strongly,style,surface,tall,testa,thick,tip,triangular,trichome,tube,two,unicellular,uniseriate,unit,upper,usually,vein,wall,weak,wide,winged,woody,yellow,yellowish,yellowish-green	-7,0.1,0.2-1.5,0.4-1.5,0.5-1,0.5-5,0.7-1.5,0.8-3,0.8-4,1-2-celled,1-4,2-3,2-4,2-locular,3/4,9-12,although,articulated,ba,basal,beyond,bract,broadly,brown,coherent,column,crenat,crenate,developed,diamete,eaf,edicel,eed,elliptical,entire,even,exserted,finely,frequently,gree,halfway,interjected,irregularly,lamina,leaflet,leave,lon,longer,multicellular,nflorescence,occasionally,orbicular,pair,pale,papillae,partially,peduncle,pentagonal,petal,petiolule,pith,pseudostipule,ruit,secondary,spreadin,staminal,tem,terminal,tertiary,ud,underlying,united,velvety,well,wider,ympodial,zygomorphic	0.4-5,bark,bud,color,count,explicitly,free,growth,habitat,height,leaf,length,major,mentioned,minor,new,position,prickle,scar,seed,shape,size,stone,structure,sympodial,texture,width,wing,young
379	wfo-0001030311	success	182	131	76	106	55	0.418	.2,.5,5-pinnate,abaxially,accrescent,acuminate,acute,adaxial,adaxially,anther,brown,calyx,ciliate,clavate,cm,color,deltoid,densely,diameter,especially,extra-axillary,fallen,filament,flattened,flower,fruit,fruiting,glabrous,granular,green,groove,ground,half,herbaceous,lanceolate,lenticular,lobe,log,long,lower,margin,membranous,mm,orangish,ovoid-rhomboid,papillose,pedicel,petiole,pubescent,purplish,sand-punctate,scattered,short,slender,slightly,sparsely,stellate,stem,stigma,style,surface,tan,terrestrial,thick,thickened,tip,trailing,trichome,tube,unbranched,unit,vein,white,wide-diameter,widely,x	.5â1.8,0.1,0.1â0.2,0.3â1.5,0.4â2,0.5â0.8,0.5â1,0.5â2,0.5â2.5,0.6â1,0.6â2.4,0.8â1.2,0.8â4,0.8â4.5,1.2â7,1.5â2,1.5â3,1.5â5.5,1.5â6,1.5â8,1.8â2,15â22,1â1.2,1â1.5,1â2,1â2.5,1â3,2.2â2.5,2.2â3,2.5â9,2â10,2â2.5,2â6,3â5,3â7,5â10,<,along,alyx,apar,apex,apical,appearance,axe,basal,base,berry,blade,c.,capitat,chartaceous,ciliat,cordate,cuneate,dense,distal,eaf,eed,elliptical,entire,falcate,giving,glabrou,groov,hair,lateral,leaflet,like,lon,m.,membranaceous,midvein,minutely,nflorescence,nternode,oblique,obovate,obtuse,occasionally,orolla,pair,peduncle,petiolulate,petiolule,plurifoliat,present,proximal,pubescence,rachi,rhomboid,rounded,ruit,sessile,shortly,side,smaller,spaced,strongly,tamen,tem,thinner,upper,vary,vine,wide,ympodial	.5-1.8,0.5-0.8,0.5-1,0.6-1,0.8-1.2,1-1.2,1-1.5,1-2,1-2.5,1-3,1.5-2,1.5-3,1.5-5.5,1.8-2,15-22,2-2.5,2.2-2.5,2.2-3,2.5-9,3-5,3-7,5-10,anthesi,bark,bud,capitate,cell,corolla,count,free,growth,habitat,height,inflorescence,internode,leaf,length,new,null,ovary,plurifoliate,position,prickle,primary,scar,seed,shape,similar,stone,structure,sympodial,texture,width,wing,young
380	wfo-0001030311	success	203	161	129	74	32	0.635	.2,.5,.5-1.8,0.1,0.5-0.8,0.5-1,0.6-1,1-1.2,1-1.5,1-2.5,1-3,1.2-7,1.5-2,1.5-3,1.5-5.5,1.5-8,15-22,2-10,2-6,2.2-3,3-5,3-7,5-10,5-pinnate,<,abaxially,absent,accrescent,acuminate,acute,adaxial,adaxially,anther,apart,articulated,axe,basally,base,blade,brown,cell,chartaceous,ciliate,clavate,cm,color,connivent,cordate,deltoid,dense,densely,diameter,directed,distally,entire,especially,fallen,filament,flattened,flower,fruit,glabrous,green,groove,ground,hair,half,herb,interjected,large,leaflet,like,lobe,log,long,longitudinal,lower,m.,margin,membranaceous,midvein,minutely,mm,node,oblong,occasionally,opening,orolla,ovoid-rhomboid,papillose,pedicel,peduncle,petiole,plurifoliate,pore,present,pubescent,purplish,rachi,rooting,scattered,short,simple,slender,slightly,slit,spaced,sparsely,stellate,stem,stigma,stone,style,surface,thick,thickened,thinner,tip,trailing,tube,unbranched,uniseriate,unit,vein,white,wide,widely,x,yellow	0-2.5,0.4-2,0.5-2,0.6-2.4,0.8-1.2,0.8-4,0.8-4.5,1.5-6,1.8-2,2-2.5,2.2-2.5,2224,5-merou,8031,[,],absen,ag,aggregate,along,alyx,apex,apical,apparently,appearance,ba,basal,capitat,ciliat,cuneate,dig,distal,eaf,eed,elliptical,equal,falcate,formation,g,geminat,gh,giving,granular,groov,lateral,lenticular,lon,nflorescence,oblique,obovate,obtuse,orangish,pair,perfect,petiolulate,petiolule,pittier,proximal,rhomboid,rounded,ruit,sessile,shortly,side,sinple,smaller,strongly,tamayo,tamen,tan,tem,upper,vary,ympodial	age,anthesi,bark,bud,calyx,capitate,corolla,count,free,fruiting,geminate,growth,habitat,height,inflorescence,leaf,length,mentioned,new,ovary,position,prickle,primary,scar,seed,shape,structure,sympodial,texture,width,wing,young
381	wfo-0001030335	success	153	148	119	34	29	0.778	.1,.25,.5,0-5,0.05-0.2,0.1-0.5,0.25-0.5,0.5-1,0.7-1,1-2,1-3-flowered,1.1-1.4,2-2.2,2-2.5,2-4.5,2-5,3/4,5-6,5-7,7-13,acuminate,acute,along,anther,anthesi,apex,bark,base,beneath,berry,bi-lobed,branch,bud,calyx,cm,conical,corolla,deciduous,decurrent,deltoid,densely,dia,elliptic,expanded,exserted,filament,filiform,flattened,free,fruiting,gently,giving,glabrous,globose,green,greyish-red,horizontally,lateral,leaf,lenticellate,lightly,lobe,lobed,long,main,minute,minutely,mm,narrowly,obovoid,often,older,onto,opposite,ovary,ovoid-reniform,pair,papillose,pedicel,petiole,pitted,pore,poricidal,prominent,puberulent,pubescent,raised,reflexed,ripe,shaped,shrub,simple,slightly,soon,sparsely,spreading,stem,stigma,strongly,style,surface,tall,tapering,tear-drop,tip,trichome,tube,underside,uniseriate,unit,vein,way,white,winged,woody,x,yellow,yellowish-green,young	.75,1-1.5,1.1.5,2.5-3,aspec,ba,dark,deflexed,dry,eaf,edicel,eed,erect,except,geminate,lamina,like,lon,lower,material,middle,nflorescence,occasionally,pale,papillo,portion,puberulen,ruit,straight,tan,ud,unifoliat,widest,ympodial	aspect,cell,color,count,diameter,flower,fruit,habitat,height,inflorescence,length,major,margin,mentioned,minor,position,prickle,primary,scar,seed,shape,size,stone,structure,sympodial,texture,unifoliate,width,wing
382	wfo-0001030336	success	266	212	183	83	29	0.688	-1.5,-10,-19,-2,.5,0.1-0.3,0.1-1,0.15-0.2,0.2,0.2-0.25,0.2-1.5,0.3-0.4,0.5,0.5-0.7,0.6-0.8,0.8-0.9,0.8-1.2,1,1-1.4,1-1.5,1-3,1-celled,1.0-1.4,1.5-,1.5-2,1.5-5,1.6-7,1.7-2.3,1.8-3.0,10,2-foliate,3-5,4-,4-10,4-celled,8-16,8-20,8-celled,acute,adpressed,amongst,anther,anthesi,apex,apical,appearance,appendage,base,basiscopically,bent,berry,bifurcate,bluntly,bract,bracteate,branch,bright,brown,calyx,capitate,cell,cm,coat,conical,cordate,corolla,curved,dark,darker,decurrent,densely,diameter,distal,eglandular,elongate,entire,erect,exserted,filament,first,flower,flushed,fruit,fruiting,giving,glandular,globose,grayish,green,greenish,hair-like,halfway,head,herb,imparipinnate,inflorescence,internode,interrupted,investing,lanceolate,largest,lateral,leaf,less,like,lobe,long,longer,loosely,margin,markedly,maturity,midvein,minute,minutely,mixed,mm,narrowing,narrowly,node,oblique,obovate,occasionally,often,once-branched,outgrowth,ovary,pale,pedicel,peduncle,perennial,petiole,present,primary,puberulent,pubescent,purple,reflexed,rest,rounded,scattered,shaggy,shorter,shrub,silky,simple,sinus,slightly,small,sometimes,sparse,spreading,stem,sterile,stigma,stripe,strongly,style,surface,surrounding,tall,ten,testa,thick,tip,trichome,truncate,tube,two,unicellular,uniformly,uniseriate,unit,upper,usually,velvety,wall,white,wide,winged,woody,yellow,young	0-,0.1-0.5,0.1-0.7,0.15-0.9,0.2-0.8,0.2-1,0.3-1.1,0.5-1,0.5-1.5,0.6-1.5,0.8-1.3,0.8-3,1.5-3.5,1/4-1/3,2-4,2-9,2-locular,2/3,4,6,absent,almost,appearing,articulated,articulation,basal,clavat,column,completely,crenate,deeply,developed,diamete,divided,eaf,edicel,eed,elliptic,entir,essentially,extremely,glandula,half,interjected,large,larger,leaflet,leave,lobed,lon,lower,mere,middl,mostly,nflorescence,orbicular,pair,papillate,part,petiolule,population,proximal,pseudostipule,rachi,range,rotate,ruit,secondary,sessile,soft,southern,spreadin,staminal,stellate,straight,tem,terminal,tertiary,ud,united,way,weak-walled,ympodial	4-16,bark,bud,clavate,color,count,description,free,growth,habitat,height,length,major,mentioned,minor,new,position,prickle,scar,seed,shape,size,stone,structure,sympodial,texture,vein,width,wing
383	wfo-0001030342	success	155	103	54	101	49	0.348	.2,3-pinnate,abaxially,accrescent,acuminate,acute,adaxially,anther,calyx,cm,deltoid,dense,diameter,extra-axillary,filament,flattened,flower,fruit,fruiting,glabrous,greenish,lanceolate,leaf,lenticular,lobe,margin,mm,mottled,often,ovoid-rhomboid,pedicel,petiole,pubescent,rarely,scattered,slender,slightly,smooth,stem,stigma,style,surface,tip,trichome,truncate,tube,unbranched,unit,vein,white,wide-diameter,widely,x,yellowish	.5,0.1â0.2,0.3â1.2,0.5â1,0.5â3,0.5â5,0.8â1.5,0.8â4,1-5,1-6.5,1.2â3,1.5,1.5â13,1.5â2,1.5â5,1.5â7.5,10â25,1â1.2,1â1.5,1â2.5,1â3,1â5.5,1â6,1â7,2â,2â2.5,2â4,3,3â12,4â5,4â8,5-merous,6â7,abundant,along,alyx,apar,apex,apical,apiculate,axe,base,berry,blade,broadly,brown,c.,capitat,chartaceous,ciliat,cordate,cuneate,cylindrical,eaf,eed,elliptical,entire,glabrou,herbaceous,lateral,leaflet,light,like,lon,long,lower,m.,membranous,minutely,nflorescence,nternode,oblique,obtuse,orolla,peduncle,perfec,petiolule,plurifoliat,pointed,proximal,pubescen,rachi,revolute,rhomboid,rounded,ruit,sand-punctate,side,spaced,sparsely,stellate,tamen,tem,terrestria,truncate-acuminat,undulate,vary,vine,wide,ympodial,â7	-7,0.5-1,0.8-1.5,1-1.2,1-1.5,1-2.5,1-3,1.5-13,1.5-2,10-25,2-2.5,2-3,2-4,3-12,4-5,anthesi,bark,bud,capitate,cell,ciliate,color,corolla,count,free,growth,habitat,height,inflorescence,length,mentioned,new,ovary,plurifoliate,position,prickle,primary,scar,seed,shape,stone,structure,sympodial,terrestrial,texture,truncate-acuminate,width,wing,young
384	wfo-0001030342	success	153	154	148	5	6	0.967	-7,.2,.5,0.5-1,0.5-3,0.5-5,0.8-4,1-1.2,1-1.5,1-3,1-5,1-5.5,1-6,1-6.5,1-7,1.2-3,1.5-13,1.5-2,1.5-5,1.5-7.5,10-25,2-,2-2.5,2-3,3,3-12,3-pinnate,4-5,4-8,5-merou,6-7,abaxially,absent,abundant,accrescent,acuminate,acute,adaxially,ag,along,alyx,anther,apart,apex,apical,apiculate,apparently,articulated,axe,ba,basally,base,blade,broadly,brown,calyx,capitat,chartaceous,ciliat,cm,connivent,cordate,cuneate,cylindrical,deltoid,diameter,directed,distally,eed,elliptical,entire,equal,extra-axillary,filament,flower,fruit,fruiting,glabrous,hair,herb,interjected,lanceolate,lateral,leaf,leaflet,lenticular,light,lobe,long,longitudinal,lower,margin,minutely,mm,nflorescence,node,oblique,oblong,obtuse,opening,orolla,pedicel,peduncle,perfect,petiole,petiolule,plurifoliate,pore,proximal,pubescen,pubescent,rachi,rarely,revolute,rhomboid,rooting,rounded,sagittate,scattered,side,simple,slender,slightly,slit,smooth,spaced,stellate,stigma,style,surface,tamen,terrestrial,tip,trailing,truncate,truncate-acuminat,tube,unbranched,undulate,uniseriate,unit,vary,vein,white,wide,widely,x,yellow	eaf,geminat,membraceous,tem,ympodial	geminate,habitat,height,membranaceous,stem,sympodial
385	wfo-0001030353	success	227	171	144	83	27	0.634	-1/2,-5,.2,.5,.7,0.1-0.3,0.5-0.9,0.8-1.2,1,1-2,1-6,1-7,1.2-1.8,1.8-3,1/2-2/3,1/5,1/6,1/6-1/4,10-15,2-10,2.5-4,3-4,3-5.5,3.5-4,4-,4-5,5,5-6,6,6-8,7-10,8-15,abaxially,acute,almost,anther,apart,apex,apically,apparently,bark,base,berry,blade,c.,calyx,cm,connivent,cuneate,deltate,densely,development,diameter,ellipsoid,elliptic,elongating,erect,evenly,filament,flower,free,fruit,fruiting,glabrescent,glabrous,green,lateral,leaf,length,less,lobe,lobed,long,long-styled,longer,margin,mature,maturity,mauve,mm,moderately,multangulate,narrow-deltate,one,open,pair,patch,pedicel,pendulous,petiole,pointed,poricidal,porrect,prickle,prickly,primary,ray,red-brown,reddish-green,reflexed,retaining,rounded,scar,sessile,shape,short-styled,shrub,simple,small,somewhat,spaced,spreading,stalked,stellate,stellate-pubescent,stem,stout,straight,style,surface,tapering,terete,terminal,tertiary,throughout,time,tip,tree,trichome,tube,unarmed,unbranched,unit,upper,vein,venation,visible,way,white-gray,wide,wo,woody,yellow,young	-0.2,-1.5,-2,-3,-6,-merous,.1,0,0-15,0-2,0-6,0.1-0.2,0.15-0.3,0.5,0.8,1-3,1.8-2.2,1/,1/3,11-16,2-7,2.8-3.7,20-200,4-4.5,6-15,abaxial,adaxial,alyx,andromonoecious,apar,apiculat,articulated,broad-deltate,brown,chartaceous,conical,curved,discolorous,distal,distance,drying,eaf,eed,equal,extending,flattened,flattened-reniform,half,hermaphrodite,heterostylous,infructescence,lower,lowermost,midpoint,midvein,nflorescence,older,orange-brown,orolla,oung,peduncle,per,pericarp,plant,plurifoliat,portion,ruit,shorter,side,smooth,sometimes,sparsely,stalk,staminat,strongly,subentire,tamen,unarme,vary,warty,weakly,whit,ympodial	anthesi,apiculate,bud,cell,color,corolla,count,growth,habitat,height,inflorescence,major,minor,new,null,ovary,plurifoliate,position,size,stigma,stone,structure,sympodial,texture,white,width,wing
386	wfo-0001030407	success	182	116	83	99	33	0.456	.5,1-2,1-3,12-14,12-15,2-5,2-7,3-9,3.5-9.5,30-60,6-7,7-8,abaxially,acumen,acuminate,adaxially,anther,axillary,base,berry,bud,cell,chartaceous,ciliate,cm,conical,connivent,corolla,covering,densely,diameter,distal,especially,filament,flower,forked,fruit,generally,glabrous,green,green-white,half,herb,lanceolate,lateral,leaf,light,lobe,long,make,margin,mm,mottled,mucilaginous,odd-pinnate,ovoid,pedicel,pentagonal,petiole,plant,plurifoliate,pubescent,purple,ray,ripe,seed,stigma,style,subtending,terminal,testal,thick,throughout,tip,tri-,tube,unit,unwinged,usually,wall,wet,white,x	.2,0.7-3.2,1-10,1-4,1.5-5,2-2.5,2-6.7,3-10.5,3-4,3-6.5,4-5,5,5-merou,6.5-18.5,absent,ag,alyx,apart,apex,apparently,articulated,axe,blade,brownish,capitat,condition,decreasing,digestion,dorsally,drying,eaf,edge,eed,elliptic-lanceolate,end,enzyme,exceeding,flat,folded,fresh,geminat,glabrou,gradually,greenish,hair,hair-like,homostylous,honeycomb-shaped,interjected,larger,leaflet,lengthening,like,living,lower,middle,minute,nflorescence,obtuse,one,orolla,ovate,pair,peduncle,perfect,petiolule,placed,pore,poricidal,proximal,pubescen,removed,round,ruit,secondary,semierec,seudostipule,size,slit,spaced,specimen,stamen,ste,stolo,subequal,subsessile,symmetrical,tall,tamen,tem,thir,toward,tuber,typically,vary,whitish,wide,yellow,ympodial	'hair-like,anthesi,bark,calyx,capitate,color,count,free,fruiting,geminate,growth,habitat,height,inflorescence,length,mentioned,new,ovary,position,prickle,primary,scar,shape,stem,stone,structure,surface,sympodial,texture,vein,width,wing,young
387	wfo-0001030420	success	170	134	94	76	40	0.553	-2,-20,-pubescent,0.5-,0.5-1,0.5-4,0.5-8,1,1-1.5,1-2,1-3,1-4,1-7.5,1.5-5,2-,2-14.5,2-3,2-9,3-7,3-lobed,4-7,5-,5-15,7-19,abaxially,acuminate,acute,adaxially,aggregate,also,apex,basal,base,calyx,cell,chartaceous,cm,color,connivent,cordate,deltate,densely,diameter,eglandular,ellipsoidal,elongated,flower,forked,fruit,glabrate,glabrous,glandular-,glandular-puberulent,hair,lanceolate,leaf,lobe,long,margin,mm,moderately,narrowly,obtuse,often,pedicel,petiole,pilose,pinnately,puberulent,puberulent-pubescent,pubescent,pubescent-pilose,purple,rarely,ripe,shrub,simple,small,sparsely,stigma,stone,style,subcoriaceous,tip,tree,triangular,truncate,tube,unbranched,unit,unknown,unlobed,vein,x	-30,-35,-4,-9,1-,1-6,1.5-3,1/2,10-,10-25,15-25,2-5,2-6,4-foliat,5-6,6-7,7-22,7/8,absent,apart,ape,articulated,axe,beyond,blade,connective,cylindrical,dark,directed,distally,divided,eaf,eed,eglandular-pilo,eglandular-puberulent,elliptic-ovate,entire,equal,exserted,leaving,lobed,lon,lower,midrib,nearly,nflorescence,nther,orolla,ovate,pedicellar,peduncle,perfect,pore,presen,pubescent-pilo,rachi,radiu,remnant,ruit,shorter,sinus,spaced,stamen,stellate,tal,tem,thecae,time,tomento,truncat,ud,vary,wide,yello,yellow,ympodial	4-foliate,anther,anthesi,bark,bud,corolla,count,eglandular-pilose,filament,free,fruiting,growth,habitat,height,inflorescence,lateral,length,major,mentioned,minor,new,ovary,position,present,prickle,primary,scar,seed,shape,size,stem,structure,surface,sympodial,tall,texture,tomentose,width,wing,young
388	wfo-0001030426	success	158	141	98	60	43	0.62	-30,0.4-0.7,1-4,1-4.2,1.5-6.5,15-25,2,2-3,2.5-4,2.5-6,3-12,3-4,3-6,4-10,4-6.5,6-11.5,6-8,9,acumen,acute,apex,apiculate,base,branched,calyx,caudate,cell,cm,connate,corolla,covering,cyme,decurrent,diameter,dichasial,dichasially,digestion,distal,dorsally,ebracteate,edge,elliptic-lanceolate,enzyme,exceeding,filament,flat,flower,folded,forked,glandular,globose,green,green-white,hair-like,half,heart-shaped,herbaceous,honeycomb,lanceolate,lateral,leaf,linear,lobe,long,mm,monochasial,mucilaginous,oblique,oblong,odd-pinnate,ovoid,pattern,pedicel,perennial,petiole,pilose,plant,rachi,rounded,seed,sessile,size,spot,stamen,stellate,stigma,stripe,style,testal,thick,throughout,tuber-bearing,unit,wall,white,wide,without,yellow	0.3-7,0.3-8,1.5-3,1.7-3.2,10,3-6-foliat,abaxially,absen,adaxially,apical,apically,articulate,dehiscent,diminishing,eaf,eed,emoval,generally,globo,gradually,interjected,introrse,larger,leaflet,linear-lanceolate,linear-oblong,living,lon,lower,make,maturing,nflorescence,nther,obtuse,often,orolla,pair,peduncle,perfect,pinnatifi,plan,poricidally,proximal,reveal,ruit,second,seudostipule,short,slit,specimen,straight,tal,tem,terminal,toward,typically,vary,whit,ympodial,Â¼	'hair-like,3-6-foliate,anther,anthesi,bark,bud,color,count,free,fruit,fruiting,growth,habitat,height,inflorescence,length,major,margin,mentioned,minor,new,ovary,position,prickle,primary,removal,revealing,scar,shape,stem,stone,structure,surface,sympodial,tall,texture,tip,tube,vein,wet,width,wing,young
389	wfo-0001030430	success	171	151	88	83	63	0.515	.2,.5,0.25,0.3,0.5,0.6,0.8â5.6,1.2â2.0,1.3â8.0,30â200,5,abaxially,abundant,acute,adaxially,anther,anthesi,apex,axillary,base,blade,blue,borne,branched,brittle,brown,bud,calyx,capitate,cell,clavate,cm,decurrent,densely,diameter,elliptic,erect,especially,filament,flattened,fleshy,flower,fruit,glabrous,globose,green,hair,leaf,lobe,long,margin,mm,moderately,multicellular,oblong,occasionally,ovate,pale,pedicel,perennial,petiole,pitted,pubescent,purple,rounded,shallowly,shoot,shrub,simple,stigma,stone,style,subglabrous,surface,terminal,time,tip,toward,tube,unifoliate,uniseriate,unit,violet,white,wide,woody,x,â2.7	0.4,0.5â12,0.6â0.8,0.6â1.0,0.8â3.0,0.9â1.0,0â20,1.0â1.2,1.0â1.5,1.0â2.0,1.4â1.5,1.5â1.7,1.6â1.8,1.8â5.0,12â20,12â30,1â3,1â9,2.0â3.0,2.0â4.2,2â3,3.0â4.5,3â17,3â24,3â4,3â5,3â8,5.5â12,5â10,5â6,6â10,adaxiall,ag,apart,apical,appressed,articulated,axe,ba,basal,chartaceous,connivent,convex,cylindrical,dentate,diamete,eaf,eed,equal,few-seeded,geminat,indumentum,lobed,lon,longitudinal,lower,m.,nflorescence,opening,orolla,pair,peduncle,pentagonal,perfect,pore,poricidal,present,regularly,ruit,serrate,shaped,side,slit,spaced,straight,tal,tamen,tear-drop,tem,vary,yellow,ympodial,â40	--,0,0.8,1,1.0,1.2,1.3,1.4,1.5,1.6,1.7,1.8,10,12,17,2,2.0,20,3,3.0,30,4,4.2,40,5.5,5.6,6,8,8.0,bark,color,corolla,count,free,fruiting,geminate,growth,habitat,height,inflorescence,lateral,length,major,mentioned,minor,new,ovary,position,prickle,primary,scar,seed,shape,size,stem,structure,sympodial,tall,texture,vein,width,wing,young
390	wfo-0001030441	success	178	185	153	25	32	0.86	+,.5,0.5,0.5-0.75,0.5-1,0.5-3,1,1-1.4,1-1.5,1-2-celled,1.2-1.4,1.5-2,10-40,2,2-10,2-3,2-5.5,2.5,3-4,30,4-5,5-14,5-6,5-7,5-7.5,6-11,<,>,acuminate,acute,anther,anthesi,apart,apex,articulated,attenuate,base,berry,branched,bright,c.,calyx,capitate,cell,closely,cm,corolla,decurrent,deltate,diameter,ellipsoid,elliptic,entire,exerted,eye,filament,flattened,flexuous,flower,free,fruiting,glabrous,glandular,globose,green,growth,hair,impressed,irregularly,juicy,lateral,leaving,lengthening,lobe,lobed,long,making,many,margin,markedly,membranous,minutely,mm,narrowly,new,occasionally,older,onto,open,otherwise,pair,pale,papillose,pedicel,peduncle,peg,per,perfect,pericarp,petiole,plant,pore,poricidal,portion,primary,pubescent,red,reflexed,reniform,ridged,ripe,scandent,scar,shiny,short,shrub,shrubby,simple,slightly,slit,small,somewhat,spaced,spot,spreading,stellate,stem,stigma,strongly,style,surface,terminal,thin,time,tip,trailing,triangular,trichome,tube,undulate,uniseriate,unit,upper,usually,vein,vine,violet,wall,way,white,wide,woody,yellow	5-merou,ag,along,alyx,ark,brow,distall,eaf,eed,glabrou,glandula,ilament,lon,lower,midvein,nflorescence,orolla,papillat,plurifoliat,ruit,spreadin,tem,ud,vary,ympodial	5-merous,age,bark,brown,bud,color,count,distally,fruit,habitat,height,inflorescence,leaf,length,major,minor,null,ovary,papillate,plurifoliate,position,prickle,seed,shape,size,stone,structure,sympodial,texture,width,wing,young
391	wfo-0001030444	success	196	135	101	95	34	0.515	0-24,0.15-0.8,0.8-2,1,1-2,1-4,1.2-1.8,2-8,2.4-3.8,3-10,4-39,6.1-12.8,7.1-17.5,9.4-20.1,acumen,acuminate,acute,anther,apex,attenuate,axillary,base,berry,blue,bud,cell,clavate,cm,connivent,corolla,covering,dark,deep,diameter,distal,dorsally,dot,edge,filament,flat,flower,folded,forked,fruit,generally,glabrous,green,half,herb,lanceolate,lateral,leaf,light,lilac,linear,lobe,long,make,margin,medium,mm,mucilaginous,narrow,odd-pinnate,orbicular,ovate,ovoid,pedicel,pentagonal,petiole,petiolulate,plant,plurifoliate,purple,ripe,rotate,rounded,seed,sessile,shortly,size,sometimes,stigma,style,subtending,tall,terminal,testal,thick,tip,tri-,tube,unit,unwinged,usually,wall,wet,white,wide,wing,x	1-10,1-5,1.1-2.7,11-45,2-3,2-6,2.3-3.6,3-5,3.7-6.8,4-17,4-7,5-merou,5.3-9,abaxiall,abaxially,adaxially,ag,along,alyx,apart,apparently,arranged,articulated,asymmetric,axe,basiscopic,bead,blade,brownish,capitat,ciliate,condition,coriaceous,decreasing,digestion,drying,eaf,eed,elliptic,enzyme,erec,exceeding,fresh,geminat,general,glabrou,green-white,greenish,hair-like,hal,high,homostylous,honeycomb-shaped,interjected,larger,leaflet,lengthening,like,living,lower,moniliform,multiple,necklace,nflorescence,orolla,pair,peduncle,perfect,pore,poricidal,removed,rough,ruit,seudostipule,side,slit,spaced,specimen,stamen,stolon,straight,subequal,symmetric,tamen,tem,throughout,tissue,touch,toward,tuber,typically,vary,whitish,yellow,ympodial	'hair-like,anthesi,bark,calyx,capitate,color,count,free,fruiting,geminate,growth,habitat,height,inflorescence,length,major,mentioned,minor,new,ovary,position,prickle,primary,scar,shape,stem,stone,structure,surface,sympodial,texture,vein,width,young
392	wfo-0001030445	success	226	219	187	39	32	0.827	.1,.5,/5-2/3,0.1-0.7,0.2,0.2-0.5,0.2-0.7,0.3,0.4,0.5,0.6-2.2,0.7,0.8,1-1.3,1-7,1.1-4.3,1.3,1.3-1.8,1.3-2,1.5-2.1,1.6-2,1.7-2.4,1.8-3.5,10-14,15-35,2.1-5.2,2.2-2.9,2.2-3.5,2.4-4.7,3-5.4,3.1-5,3.4-5.6,3.5-4.2,4.1-8.7,4.2-10,5-125,5.2-7.1,5.9-15,5.9-8.3,6.1-9.1,8.1-10,8.2-18,abaxial,abaxially,accrescent,acuminate,adaxially,along,anther,apart,apex,appressed,around,articulated,axillary,bark,base,berry,black,blade,blunt-tipped,branch,branched,brown,brownish-yellow,bud,bulbous-based,calyx,capitate,cm,concentrated,corolla,cylindrical,decurrent,deltoid-reniform,diameter,directed,distally,drying,eaf,edge,elliptic,elliptical,elongated,erect,exserted,ferruginous,ferruginous-granular,ferruginous-tomentose,filament,flower,free,fruit,fruiting,geminate,glabrate,glabrous,globose,green,greyish-tan,hair,high,inserted,lackin,lateral,leaf,lengthening,lobe,lobed,long,longitudinal,main,many,margin,midrib,midvein,mm,mostly,multangulate,oblong,oblong-lanceolate,obovate,obscured,obtuse,older,open,orange,orangish-tan,orbicular,ovate,ovate-lanceolate,pedicel,petiole,plurifoliate,pore,poricidal,porrect-stellate,pseudoterminal,pubescence,pubescent,ray,relatively,reniform,resorption,reticulate-punctate,rounded,semi-spherical,sessile,shrub,side,simple,slightly,slit,small,somewhat,spaced,sparse,splitting,stalk,stamen,stem,stigma,stout,style,subcampanulate,sulcate,surface,suture,thick,thin,time,tip,tissue,tomentose,tomentum,tree,tube,unit,vein,vestigial-rayed,way,wide,x,yellow,yellowish,yellowish-tan,young	0.2-0.4,0.6-3.5,1,10-16,14,5-merou,7.5-16,acute,ag,alyx,blunt-tippe,earl,eed,entire,glabrescen,homostylous,intermediate,lon,lower,m.,multangulat,nflorescence,orolla,peduncle,porrect-stellat,rachi,ruit,runk,soon,sparsely,stellate,tamen,thick-textured,thicknes,thin-,unarme,vary,white,ympodial	age,anthesi,cell,color,count,early,glabrescent,growth,habitat,height,inflorescence,lacking,length,major,mentioned,minor,new,ovary,position,prickle,primary,scar,seed,shape,size,stone,structure,sympodial,texture,unarmed,width,wing
393	wfo-0001030447	success	276	217	198	78	19	0.717	.2,.3,.5,/5,0,0.1,0.1-0.3,0.15-0.3,0.2,0.2-0.4,0.4-0.9,0.7-1,0.8-1.7,0.8-3.5,1-1.5,1-2,1-2.5,1-3,1-6,1.5-2.5,1.5-7,1.8-2.5,1/3,1/3-2/3,1/4-1/3,2-4,2.2-2.8,2.5-10,2.5-6.5,3,3-4.5,3-5,30-45Â°,5,5-15,6,6-10,6-16,6-7,6-8,6-9,7-8,abaxially,accrescent,acute,adaxially,age,always,anther,apart,apex,apically,apparently,bark,base,berry,beyond,blade,c.,calyx,cell,clavate,cm,corolla,covering,cupular,curved,dark,deltate,densely,diameter,difoliate,drying,elongating,equal,erect,exserted,filament,filiform,finely,finger-hair,flat,flattened,flattened-reniform,flower,free,fruit,fruiting,gently,glabrescent,glabrous,globose,herbaceous,irregular,lateral,leaf,length,lengthening,lobe,lobed,long,long-styled,longer,longitudinal,lower,margin,mature,maturity,midpoint,midvein,minute,mm,moderately,mostly,narrow-deltate,obconical,oblong,often,older,one,open,orange,orange-brown,orange-red,orange-translucent,outline,ovate,pair,pale,pedicel,pendulous,per,petiole,pit,point,pore,poricidal,porrect,prickle,primary,pronounced,prostrate,pubescent,purple,raised,ray,red-brown,reduced,ridged,scar,sessile,short-styled,shorter,shortly,shrub,side,simple,slit,small,smooth,sometimes,somewhat,spaced,sparsely,spreading,stalk,stalked,stellate-pubescent,stem,stigma,straight,straw-yellow,stump,style,subsessile,surface,tapering,thick,time,tip,toward,translucent,trichome,tube,unarmed,unbranched,unit,variously,vein,venation,visible,white,wide,widest,woody,x,yellow,Ã	0.4-0.7,0.5,0.5-0.65,0.5-10,0.5-3,1,1-10,1-5,1.5,1/3-1/2,4-8,5-merou,6.5-9,8,alyx,apar,apical,armed,articulated,axe,branche,broad-deltate,characteristically,chartaceous,cuneate,development,discolorous,distance,divided,eaf,eed,extending,fine,geminat,infructescence,irregula,less,long-ovoi,nflorescence,oblique,obtuse,opening,orolla,oung,papillo,peduncle,perfect,pericarp,persisting,portion,rachi,rest,ri,ridge,rounded,ruit,shallow,shallowly,shiny,sinus,slender,sparse,spherical,stellate,stout,tamen,terete,terminal,tertiary,thin,throughout,ud,unequal,usually,vary,weakly,yellow-orange,ympodial	bud,color,geminate,growth,habitat,height,inflorescence,long-ovoid,new,ovary,papillose,position,rim,seed,shape,structure,sympodial,texture,young
394	wfo-0001030453	success	127	131	100	27	31	0.787	.25,/4,0.25-0.5,0.8-1.5,1-1.3,1-1.5,1.5-1.6,1.5-2.5,3-3.5,4-5,9-12,9-14,abaxially,acuminate,acute,along,anther,anthesi,apex,arachnoid,arachnoid-pubescent,attenuate,bark,base,broadly,calyx,clavate,closely,cm,corolla,cup-shaped,dark,deflexed,delicate,deltate,dendritic,densely,divided,ellipsoid,elliptic,especially,filament,fine,flat,free,glabrate,glabrous,known,later,lateral,leaf,less,lobe,long,main,margin,middle,midrib,minute,minutely,mm,narrowly,nearly,opposite,ovary,pair,papillose,pedicel,petiole,planar,pore,poricidal,pubescent,reddish,rounded,scar,shaped,shiny,shrub,simple,slender,soon,spaced,sparsely,stem,stigma,style,surface,tall,tear-drop,tip,trichome,tube,unit,vein,way,white,wide,widest,young	.5,adaxially,axi,dia,eaf,edicel,eed,exserted,floccose,know,lon,lower,near,nflorescence,occasionally,older,overlappin,papillat,portion,reddish-brow,ruit,straight,strongly,tub,ud,unifoliat,ympodial	2,bud,cell,color,count,diameter,flower,fruit,fruiting,habitat,height,inflorescence,length,major,minor,overlapping,papillate,position,prickle,primary,reddish-brown,seed,shape,size,stone,structure,sympodial,texture,unifoliate,width,wing
395	wfo-0001030486	success	141	142	114	27	28	0.809	.5,0.8-2.2,1-1.5,1-5,1.1-1.4,1.5-2,1.7-2,1/2,1/4,10-12,10-14.5,2-3,2-5.5,3-5,3/4,4-6.5,4.5-5,5-8-flowered,6-7,abaxially,acute,adaxially,anther,anthesi,apex,bark,basal,base,beneath,calyx,clavate,closely,clustered,cm,completely,conical,corolla,deflexed,deltate,dia,difoliate,distal,drying,ellipsoid,elliptic,erect,exserted,f,filament,fleshy,free,fruiting,glabrous,globose,green,internodal,later,lateral,leaf,lobe,lobed,long,main,major,margin,middle,minor,minutely,mm,older,opposite,ovary,overlapping,ovoid-reniform,pair,pale,papillose,pedicel,petiole,pitted,planar,pore,poricidal,reddish,scar,shaped,shrub,simple,size,slightly,small,spaced,stem,stigma,stout,style,surface,tall,tapering,tear-drop,thickened,tip,treelet,tube,unit,usually,vein,way,white,widest,woody,x,yellow-green,young	3-3.5,4-4.5,ba,berry,brown,dark,differing,dry,eaf,edicel,eed,fresh,geminat,inflorescenc,lon,lower,m.,material,nflorescence,papillo,portion,ruit,shin,tan,tub,ud,ympodial	5-8,bud,cell,color,count,diameter,flower,fruit,geminate,growth,habitat,height,inflorescence,length,new,position,prickle,primary,seed,shape,shiny,specified,stone,structure,sympodial,texture,width,wing
396	wfo-0001030489	success	196	180	154	42	26	0.786	-6.5,.5-2.8,.5-3,.75-5.25,0.25-0.4,0.5-3,0.6-0.9,0.9-1.1,1-3,1-3.75,1.1-1.3,1.2-1.5,1.2-1.6,1.6-2.1,1.75-2,1/3-1/2,1/5-1/2,100,12-24,3-6,3-8,4-8,4.5-9,5,5-6,6-8,7-15,abaxially,acuminate,acute,adaxially,anther,anthesi,apart,apex,appressed,appressed-pubescent,articulated,axe,axillary,bark,base,becoming,berry,blade,blunt-tipped,branch,branched,broadly,brown,bud,calyx,chartaceous,cinereous,closely,cm,conical,continued,corolla,cylindrical,deltoid,densely,diameter,dichotomously,due,echinoid,elliptic,elongate,filament,fleshy,flower,free,fruit,glabrate,globose,greenish,growth,hair,high,honeycombed,lateral,leaf,length,lobe,lobed,long,main,margin,midvein,minute,minutely,mm,mostly,multangulate,oblong,obtuse,older,ovate,ovate-lanceolate,pale,pedicel,peduncle,petiole,plurifoliate,porrect-stellate,probably,pseudo-terminal,puberulent,pubescent,pulverulent,rachi,reniform,reticulate-punctate,ripe,sessile,several,short-stalked,shrub,side,simple,slender,small,smooth,somewhat,spaced,sparingly,sparse,stellate-pubescent,stellate-rotate,stem,stigma,style,subcampanulate,subglobose,suborbicular,terete,testa,thick,time,tomentose,toward,tree,tube,unarmed,unit,usually,vein,way,white,wide,x,yellow,yellowish,young	0.75-0.9,1-1.3,1.7-2,1.9-2.6,2.1-2.9,abruptly,absen,adaxiall,ag,apical-lateral,apparently,attenuate,ba,dehiscing,eaf,echinoi,eed,entire,glabrous,inserted,introrse,large,long-acuminate,long-exserted,longitudinal,lower,narrowly,nflorescence,orolla,perfect,pore,pulverulen,ruit,runk,short,slit,subcapitat,tamen,turn,unarme,vary,ympodial	absent,cell,color,count,fruiting,habitat,height,inflorescence,mentioned,new,ovary,position,prickle,primary,scar,seed,shape,stone,structure,subcapitate,surface,sympodial,texture,tip,width,wing
397	wfo-0001030509	success	220	172	146	74	26	0.664	-10,-2,-6,/3,0,0-15,0.1-0.2,0.1-0.3,0.2,0.3-2.5,0.5-1.5,0.6-1,0.8-1.2,0.8-4,1-2,1-3,1/3-2/3,1/4,2-2.5,2-3,2-4.2,2-4.5,2-6,2/3-3/4,3-10,3-4,4.5-10,4.5-12,4.5-8,5-10,7-15,7-9,8-16,abaxially,anther,apart,apical,apically,apparently,bark,base,becoming,blade,calyx,cm,connivent,cream,curved,dark,densely,diameter,difoliate,discolorous,drying,entire,erect,filament,flattened-reniform,flower,free,fruit,fruiting,glabrescent,glabrous,gland,globular,gray,green,herb,herbaceous,inflated,lateral,leaf,length,lobe,lobed,long,long-styled,lower,margin,marking,mature,maturity,mauve,midpoint,mm,moderately,narrow-deltate,narrow-oblong,occasional,occasionally,often,older,one,open,orange,orange-brown,ovate,pair,pale,pedicel,pendulous,perpendicular,petiole,poricidal,porrect,prickle,prickly,primary,purple,ray,reduced,scar,shorter,shrub,slender,spaced,sparsely,spherical,spreading,stalk,stalked,stellate,stellate-pubescent,stem,straight,style,surface,tapering,terete,terminal,time,tip,trichome,tube,unarmed,unbranched,unit,variously,vein,way,wide,woody,yellow,yellow-green,young	0-0.3,0-100,0-3,0-5,0.1,0.1-0.25,1,1-1.5,1-4,1-6,1.3-2,1.5-2,1.7-2,1/,2.8-3,5-merous,alyx,andromonoecious,apar,apex,articulated,berry,broad-deltate,brow,chartaceous,cordate,cuneate,distal,distance,eaf,eed,elongating,equal,extending,eye,geminat,half,hermaphrodite,heterostylous,infructescence,long-acuminat,longer,lowermost,midvein,naked,nflorescence,obtuse,orolla,oung,peduncle,per,pericarp,plant,portion,rounded,ruit,short-styled,shorte,side,simple,smooth,sometimes,staminat,subsessile,tamen,tertiary,unarme,upper,usually,vary,venation,visible,weakly,ympodial	anthesi,brown,bud,cell,color,corolla,count,geminate,growth,habitat,height,inflorescence,long-acuminate,mentioned,new,ovary,position,seed,shape,stigma,stone,structure,sympodial,texture,width,wing
398	wfo-0001030516	success	172	132	91	81	41	0.529	0.4-1.5,1-2.5,1-4,1-7,1.1-3.5,1.5-2,1.8-2.4,2-3,3-9.8,4-7,6-15,8-9,9-22,9-32,abaxially,acumen,acuminate,acute,adaxially,apex,articulate,base,branched,calyx,cell,cm,connate,cordate,corolla,covered,cuneate,cyme,darker,densely,diameter,dichasial,dichasially,distal,dorsally,ebracteate,edge,filament,flat,flower,folded,forked,generally,gland,globose,green,hair,half,herbaceous,lateral,leaf,light,lobe,long,long-attenuate,mm,monochasial,oblique,odd-pinnate,outline,pedicel,pentagonal,perennial,petiole,pilose,plant,proximal,puberulent,pubescent,rotate,sessile,short-stalked,size,slightly,sometimes,spreading,stigma,stripe,style,triangular,tuber-bearing,typically,unit,wide,yellow,Â¼,â	1.1-4.1,1.7,2-12,2-2.,2-4,3-6,3-6-foliat,3-8,4-22,4-4,4-6,4.2-10.7,apical,apically,covering,decurrent,dehiscent,digestion,diminished,eaf,eed,elliptical,emoval,enzyme,exceeding,first,globo,gradually,green-white,hair-like,honeycomb,interjected,introrse,leaflet,less,living,lon,longer,lower,lunat,make,maturing,mucilaginous,nflorescence,nther,often,orolla,ovate,ovoid,pair,pattern,peduncle,perfect,plan,poricidally,rarely,reveal,ruit,second,seed,seudostipule,short,short-petiolate,slit,specimen,stamen,straight,tal,tem,terminal,testal,thick,throughout,time,toward,triangulat,type,vary,wall,whit,ympodial	'type,3-6-foliate,anther,anthesi,bark,bud,color,count,free,fruit,fruiting,growth,habitat,height,inflorescence,length,major,margin,mentioned,minor,new,ovary,position,prickle,primary,scar,shape,stem,stone,structure,surface,sympodial,tall,texture,tip,tube,vein,white,width,wing,young
399	wfo-0001030551	success	167	147	106	61	41	0.635	-12,0-2,0.5-1,0.6-1.5,1-,1-2,1-2.5,1-4,1-5,1.5-,1.5-2.5,10-40,2,2-3,2-6,2.5-5,3-12,3-5,3-8,4-,4-5,5-6,abaxially,acuminate,acute,adaxially,adpressed,aggregate,also,apart,apex,articulated,basal,base,blade,blue,calyx,cell,chartaceous,cm,color,concave,cordate,densely,dia,diameter,distally,ellipsoidal,et,fading,fleshy,flower,fruit,glabrous,glandular-puberulent,globose,hair,lanceolate,leaving,lobe,long,margin,martinelli,mm,moderately,narrowly,oblong-fusiform,obtuse,often,ovate,ovate-elliptic,ovoid,papillose,pedicel,pedicellar,perfect,petiole,pilose,puberulent,puberulent-pubescent,pubescent-pilose,remnant,ripe,round,seen,simple,small,spaced,sparsely,stigma,stone,style,time,tip,triangular,triangular-elliptic,truncate,tube,unbranched,unit,unknown,violet,wide,widening,x,yellowish	-30,-5,1,1-10,1-3.5,10-20,13.,2.5-4,20-25,3-,4-7,4-foliat,5-17,9-20,abruptly,absent,ape,axe,beyond,bilobe,broad,campanulate,clavate,connective,dilated,directed,eaf,ed,entire,equal,exceeding,exserted,laterally,lon,lower,narrow,narrowed,nflorescence,nther,orolla,peduncle,pore,puberulen,pubescent-pilo,rachi,radiu,ruit,shorter,shrub,slightly,stamen,stellate,subcoriaceous,tal,tem,thecae,tomento,ud,unknow,vary,ympodial	138,4-foliate,anther,anthesi,bark,bilobed,bud,corolla,count,filament,free,fruiting,growth,habitat,height,inflorescence,lateral,leaf,length,major,mentioned,minor,new,ovary,position,prickle,primary,scar,seed,shape,size,stem,structure,surface,sympodial,texture,tomentose,vein,width,wing,young
400	wfo-0001030570	success	173	140	100	73	40	0.578	-1,.3-0.5,0.3-0.5,0.5-,1,1-,1-1.5,1-3,1-8,1.5,10-17,15-35,2-2.5,2-3,2-4,2-5,2-7-lobed,2-8,2.5-22,3-10,3-5,3-6,3.5-5,4-25,4-5,4-7,5-,abaxially,acuminate,acute,adaxially,aggregate,apex,apiculate,basal,base,calyx,cell,cm,color,connivent,cordate,diameter,eglandular,ellipsoidal,flattened,fleshy,flower,forked,fruit,glabrous,glandular-puberulent,globose,green,hair,lanceolate,leaf,lobe,long,margin,mm,narrowly,occasionally,often,ovoid,pedicel,petiole,pilose,pinnately,pubescent,punctate,purplish,rarely,ripe,rounded,rugose,simple,small,sometimes,somewhat,sparsely,stigma,stone,style,subcoriaceous,submarginally,tip,tree,triangular,truncate,tube,unbranched,unequal,unit,unknown,unlobed,vein,white,x,yellow	0-,0.5-1,1-2,1-4,1-5,1.5-2.5,1/2,10-25,15-20,2-7,20-30,4-foliat,4/5,8-,absent,apart,ape,articulated,axe,beyond,blade,campanulate,connective,cylindrical,dilated,directed,distally,divided,eaf,eed,elliptic-oblong,entire,exceeding,exserted,glabrat,leaving,lobed,lon,lower,midrib,near,nflorescence,nther,obtuse,orolla,ovate,pedicellar,peduncle,perfect,pilo,pore,presen,purpl,rachi,radiu,remnant,ruit,shorter,sinus,slightly,spaced,stamen,stellate,tal,tem,thecae,time,tomento,truncat,ud,vary,wide,ympodial	4-foliate,anther,anthesi,bark,bud,corolla,count,filament,free,fruiting,glabrate,growth,habitat,height,inflorescence,lateral,length,major,mentioned,minor,new,ovary,position,present,prickle,primary,scar,seed,shape,size,stem,structure,surface,sympodial,tall,texture,tomentose,width,wing,young
401	wfo-0001030581	success	187	168	134	53	34	0.717	.3,.5,0.2â0.8,0.4â0.6,0.4â1.6,0.5,0.5â0.7,0.5â2.5,1-4-celled,1.8â8,1â2-celled,1â2.5,1â4-celled,2,20â50,3â5,4.5â12,5â8,9,abaxially,acute,adaxially,aggregate,along,angle,angled,anther,anthesi,apex,appressed,base,becoming,berry,beyond,black,branched,bright,calyx,capitate,cell,central,clustered,cm,cone,conical,corolla,decurrent,densely,denser,diameter,difoliate,drop,ellipsoid,elliptic,exserted,filament,flower,free,fruit,fruiting,glabrous,globose,green,growth,herb,inflorescence,intermodal,lacking,later,lateral,leaf,less,like,live,lobe,long,margin,maturity,minute,minutely,mm,near,new,often,once-branched,ovary,ovate,pair,papillate,pedicel,peduncle,petiole,plant,portion,primary,pubescent,purplish,rachi,reflexed,remaining,ridge,ripe,rounded,scar,shorter,simple,somewhat,spaced,sparsely,spreading,stem,stigma,stone,straight,strongly,style,surface,tangled,terete,translucent,trichome,tube,turning,uniseriate,unit,upper,usually,vein,white,wide,woody,yellow,â15,â5	0.6â0.7,0.7â0.8,0.9â1,1,1.2â1.5,1â2,2â3-celled,35â45,3â4,4â7,4â9,5-merous,5â6,abaxial,adaxial,apar,articulated,basal,eaf,eed,entire,flattened-reniform,florescence,geminat,halfway,individual,leave,lobed,lon,lower,markedly,narrowly,occasionally,outline,pentagonal,per,perfect,pitted,reflexe,ruit,shallow,shiny,slightly,sprawlin,stellate,tall,tem,testal,third,ud,winged,yellowish,ympodial	0.6-0.7,0.7-0.8,1-2,1.8-8,3-4,3-5,4-7,4-9,4.5-12,5-6,5-8,apart,bark,bud,color,count,geminate,habitat,height,length,major,minor,null,position,prickle,shape,size,structure,sympodial,texture,tip,width,wing,young
402	wfo-0001030583	success	166	143	124	42	19	0.747	.2,0.1-0.5,0.2-1,0.5-1,0.8-1,1,1-1.5,1-2,1.5-4,1/2,2.5,2.5-3,3-4,3/4,4-6,5-6,5-7,6-7,abaxial,adaxially,along,anther,anthesi,apex,bark,base,berry,calyx,cell,closely,cm,conical,corky,corolla,cultivar,cultivated,deep,dendritic,densely,difoliate,dry,ellipsoid,elliptic,enlarged,erect,filament,flattened-reniform,free,fruit,fruiting,glabrous,globose,golden,green,immature,incrassate,lateral,leaf,like,lobe,lobed,long,long-rectangular,long-triangular,main,major,margin,midvein,minor,minutely,mm,narrowly,occasionally,older,opposite,orange-red,outline,ovary,overlapping,pair,pale,papillose,pedicel,petiole,pitted,planar,plant,pore,poricidal,prostrate,pubescent,rest,ripe,rounded,scar,shaped,shrub,simple,small,small-capitate,soon,spaced,spathulate,specimen,stem,stigma,style,surface,tall,tan,tear-drop,testal,tip,trichome,tube,uniseriate,unit,vein,way,white,woody,x,yellow,young	.5,0.3-1,0.4-2.7,0.7-4.5,0.9-3.5,1-8,2.5-9,abaxially,acute,ba,brow,crisped,dark,deflexed,dia,differing,eaf,edicel,eed,especially,flower,form,frui,geminat,included,irregular,leave,live,lon,lower,nflorescence,often,papery,papillo,pericarp,portion,ruit,size,stout,thin,ud,ympodial	brown,bud,color,diameter,geminate,habitat,height,inflorescence,length,position,prickle,primary,seed,shape,specified,stone,structure,sympodial,texture
403	wfo-0001030605	success	144	150	119	25	31	0.826	.4,.5,0.1,0.3-0.5,1,1-4,1.5-2,1.5-5.5,1.7,1/3-1/2,12-19-flowered,2,2-3,2.5,5-12.5,7,abaxially,acute,adaxially,almost,along,anther,anthesi,apart,apex,area,attenuate,base,beginning,beneath,berry,branch,branched,brown,calyx,cinereous,cm,commonly,conical,coriaceous,corolla,covered,cylindrical,dark,deflexed,dendritic-echinoid,densely,dia,difoliate,drying,ellipsoid,filament,free,fruiting,glabrate,glabrous,globose,green,growth,inflorescence,internodal,leaf,less,lobe,lobed,long,margin,midrib,minutely,mm,nearly,new,obovate,obtuse,occasionally,olive,opposite,otherwise,ovary,ovate,overlapping,ovoid-reniform,papillate,pedicel,petiole,pitted,pore,poricidal,pubescent,rarely,reflexed,rounded,scar,scattered,shaped,shiny,shrub,simple,slender,slightly,smooth,somewhat,sparsely,stigma,style,surface,tear-drop,thickened,tip,trichome,tube,unifoliate,unit,vein,way,white,woody,x,yellow	ape,apical,dry,eaf,edicel,eed,entire,exerted,geminat,gold,inflorescenc,light,lower,material,nflorescence,papillosefruit,peduncle,portion,revolute,soon,sparesly,tinged,tub,ud,ympodial	bark,bud,cell,color,count,diameter,flower,fruit,geminate,habitat,height,lateral,length,major,mentioned,minor,papillose,position,prickle,primary,seed,shape,size,stem,stone,structure,sympodial,texture,width,wing,young
404	wfo-0001030624	success	170	159	131	39	28	0.771	.25,.5,0.5,0.5-1,0.5-1.5,0.9-1,1-3,1.2-1.8,1.5-2,2-10,2-3,2.5-5.5,25-40-flowered,4.5-8,6-13,7-9,acute,anther,anthesi,apart,apex,apiculate,attenuate,axil,bark,base,beginning,branch,calyx,cell,clavate,cm,corolla,decurrent,deflexed,dia,difoliate,dimorphic,distal,ellipsoid,elliptic,end,erect,except,expanded,exserted,extreme,falcate,filament,flattened-reniform,free,fruiting,furcate,glabrate,glabrous,glandular,globose,green,hyaline,large,later,lateral,leaf,like,lobe,lobed,long,longitudinally,main,major,margin,middle,midrib,minor,minutely,mm,narrowly,near,nearly,occasionally,older,opposite,ovary,pair,pale,papillose,pedicel,petiole,pitted,planar,poricidal,prominent,puberulent,raised,scar,shining,short,shrub,simple,size,slender,slightly,small,somewhat,soon,spaced,square,stem,stigma,style,surface,tall,tapering,tip,tree,trichome,trunk,tube,tuft,unevenly,uniseriate,unit,vein,white,widest,woody,x,yellow,yellowish-green,yellowish-grey,young	1.2-2,2,3,3-3.5,3.5-4,appearing,ba,berry,caly,differing,dry,eaf,edicel,eed,geminat,greyish,incrassate,inflorescenc,lon,lower,material,nflorescence,one,outer,pore,portion,remaining,round,rugo,ruit,straight,thickened,three,ti,two,ud,wall,yellowish,ympodial	25-40,bud,color,count,diameter,flower,fruit,geminate,growth,habitat,height,inflorescence,length,new,position,prickle,primary,rugose,seed,shape,stone,structure,sympodial,texture,unspecified,width,wing,younger
405	wfo-0001030638	success	177	168	147	30	21	0.831	0.1,0.5,0.5-0.7,0.5-1,0.5-1.5,0.5-2,0.7-1.5,1-1.2,1-1.5,1-2,1.5-2,1.6-2.2,2-3,2-5,2-7-flowered,2.5-4,3-10,3-13,4-6,8,8-11,8-9,acute,along,anther,anthesi,apex,apically,appear,appearing,bark,base,beginning,beneath,berry,branched,broadly,bud,calyx,cm,conspicuously,corky,corolla,cucullate,cup-shaped,deltoid,densely,dia,difoliate,dry,elliptic,entire,erect,exfoliating,filament,flattened,fleshy,free,fruit,fruiting,geminate,glabrate,glabrous,glandular,globose,green,impressed,inflorescence,known,large,later,lateral,leaf,less,like,lobe,lobed,long,major,margin,material,middle,minor,minutely,mm,near,nearly,obovate,occasionally,older,one,opposite,ovary,overlapping,pair,pale,paler,papillae,papillose,pedicel,persistent,petiole,planar,pore,poricidal,prominent,rather,red,red-glandular,reddish,rest,roundish,rugose,scar,seed,shape,shaped,shrub,simple,size,soon,speciman,stem,stigma,style,surface,tall,tear-drop,terminal,thick,thickened,thickening,tip,transversely,tree,trichome,tube,uniseriate,unit,usually,vein,wall,white,widest,woody,x,young	1.4-1.7,axi,axil,ba,blade,closely,deflexed,differing,eaf,eed,extending,geminat,gre,irregular,lamina,lon,lower,main,nflorescence,often,open,ovoi,papillo,portion,present,ruit,spaced,straight,tapering,ympodial	2-7,cell,color,count,diameter,flower,grey,habitat,height,length,mentioned,ovoid,position,prickle,primary,stone,structure,sympodial,texture,width,wing
406	wfo-0001030661	success	183	163	136	47	27	0.743	-24,.2,.5,0.5-0.6,0.5-2,1-,1-1.2,1-1.3,1-1.4,1-1.5,1.2-7,1.5-7,12-16,2-,3-20,3-4,4-15,4-6,5-10,5-5.5,50-100+,along,anther,anthesi,attenuate,base,berry,branch,branched,brown,calyx,capitate,cell,clustered,cm,conical,connivent,corolla,deltate,densely,denser,diameter,drying,ellipsoid,elliptic,erect,exserted,extending,filament,flattened,flower,free,fruiting,glabrescent,glabrous,globose,group,growth,inflorescence,insertion,lamina,lateral,leaf,lengthening,lobe,lobed,long,loosely,many,margin,mature,midrib,minute,minutely,mm,narrowly,near,never,new,occasionally,older,otherwise,pair,pale,pedicel,peduncle,petiole,pitted,planar,platform,point,pore,poricidal,primary,pubescent,rectangular,red,reniform,scar,scattered,shrub,simple,slightly,slit,small,sparsely,spreading,stellate,stem,stigma,strongly,style,surface,tangled,terminal,testal,time,tinged,tip,tree,trichome,tube,uniseriate,unit,upper,usually,vein,violet,way,white,woody,x,yellow,yellowish,Â½,Â¾	0,0.5-0.75,0.7-0.8,1-.,1.5-2,2-2.5,3-3.5,5-merou,acute,ag,alyx,apex,ark,articulated,brow,dar,eaf,eed,em,entire,erec,glabrou,ilament,lon,lower,membranous,nflorescence,nodding,onto,orolla,papillo,per,perfect,pericarp,plurifoliat,portion,reddish,ruit,shiny,sleeve,slender,thin,twinin,ud,vary,winged,ympodial	1-5,age,bark,bud,color,count,dark,fruit,habitat,height,length,mentioned,ovary,papillose,plurifoliate,position,prickle,seed,shape,stone,structure,sympodial,texture,twining,width,wing,young
407	wfo-0001030676	success	220	195	169	51	26	0.768	-1.6,-2.5,-8.5,/10-1/5,0-100,0.4,0.6-1.2,1-1.2,1.1-1.4,1.1-1.9,1.2-1.3,1/4,14-17,19-35,2.1-2.3,2.2-5.7,2.4-3.1,2.5-5.5,2.75-3.25,3-3.5,3-5,3-6,4-6,4-6.5,7-10,7-8,7-9,8-10,8-12,abaxially,acute,adaxially,along,angled,anther,anthesi,apex,appearing,appressed-tomentose,axillary,bark,base,becoming,berry,blade,blunt-tipped,branch,branched,brown,bud,calyx,chartaceous,cm,conical,continued,corolla,crown,deltoid,densely,diameter,dichotomously,due,echinoid,elongate,except,filament,finely,flat-topped,fleshy,flower,forming,free,fruit,glabrescent,glabrous,globose,granular-tomentose,green,greenish,grooved,growth,hair,high,honeycombed,horizontal,initially,lamina,lateral,leaf,length,lined,lobe,lobed,long,longitudinally,main,margin,midvein,minute,minutely,mm,moderately,mostly,multangulate,nearly,oblong,oblong-elliptic,obtuse,occasional,older,opening,openly,ovate,ovate-lanceolate,parallel,pedicel,peduncle,petiole,plurifoliate,probably,pseudo-terminal,pubescent,pulverulent,rachi,ray,reniform,reticulate-punctate,ridged,ripe,scabrous,scattered,sessile,short-stalked,shrub,side,simple,small,somewhat,sparsely,spreading,stellate,stellate-pubescent,stem,stigma,style,subcampanulate,subglobose,suborbicular,tending,terete,thick,time,tip,tomentose,tree,tube,tuft,unit,usually,vein,velutinous,way,white,whitish,wide,x,yellow,yellowish,young	-3.9,1,1-3,1.3-1.5,1.7-2,11-14,16,2.1-2.6,abruptly,apart,apical-lateral,apparently,articulated,ba,closely,cylindrical,dehiscing,eaf,echinoi,eed,entire,exserted,glabrescen,inserted,introrse,lackin,large,lengthen,longitudinal,lower,midvei,nflorescence,oblique,often,orolla,perfect,pore,rather,ruit,runk,short-attenuate,slit,spaced,strongly,subcapitat,tamen,testa,thin,unarme,vary,ympodial	cell,color,count,fruiting,habitat,height,inflorescence,lacking,mentioned,new,ovary,position,prickle,primary,scar,seed,shape,stone,structure,subcapitate,surface,sympodial,texture,unarmed,width,wing
408	wfo-0001030686	success	182	182	155	27	27	0.852	.2,.5,.5-1,0.5-1,1-1.1,1-1.2,1-1.5,1-2,1.2-1.5,1.6-3,15,2-2.5,2-3,2-6.5,2.5-4,2.5-8,3-3.5,5-12,5-25,5-30,5-6,8-9,?,abaxially,aborted,abruptly,acuminate,acute,adaxially,age,anther,anthesi,apart,apex,bark,basal,base,beneath,berry,bifid,black,branched,breast,brown,c.,calyx,centre,closely,cm,conical,corolla,cup-shaped,dark,darker,deeply,densely,denser,diameter,different,difoliate,discolorous,drying,elliptic,empty,entire,erect,exerted,filament,flattened,flower,form,free,fruit,fruiting,globose,golden,half,height,heteromorphic,internodal,lamina,leaf,leaf-opposed,lengthening,lepidote,less,lilac,lobe,lobed,long,many,margin,maturity,midrib,midvein,minutely,mm,oblique,older,orange,ovary,overlapping,pair,pale,paler,papillae,papillose,pedicel,petiole,pitted,planar,plant,pore,poricidal,primary,pubescent,purple,rachi,scar,scarious,seed,shallow,shallowly,shiny,short,simple,slightly,slit,somewhat,space,spaced,sparsely,spreading,stellate,stem,stigma,strongly,style,surface,time,tip,tissue,tree,trichome,tube,uniformly,unit,usually,vein,visible,way,woody,x,yellow,â	1.5-2,1.5-4.5,1972,adam,brittle,bu,dry,eaf,edicel,eed,fide,fragrant,geminat,glabrescen,glabrous,lower,nflorescence,noddin,peduncle,pericarp,portion,pubescen,ruit,styl,thin,ud,ympodial	bud,cell,color,count,geminate,glabrescent,growth,habitat,inflorescence,lateral,length,major,minor,new,nodding,null,position,prickle,shape,size,stone,structure,sympodial,texture,width,wing,young
409	wfo-0001030709	success	217	194	167	50	27	0.77	-5,-9,0,0-,0-20,0.1-0.2,0.15-0.5,0.2-0.5,0.3-1.5,0.4,0.7-1,0.9-1.5,1-1.6,1-4.5,1-6,1.3-1.4,1.4-2,1/2-2/3,1/3-1/2,1/4,1/4-1/3,10-14,10-50,2-4,2-6,2-8,2.3-3,5-10,5-6,5-7,6-10,6-21,6-7,6-8,7-8,7-9,8-11,8-15,abaxially,acute,adaxially,almost,ame,anther,apart,apex,apically,apparently,bark,base,berry,blade,branched,bright,broad-deltate,c.,calyx,chartaceous,cm,conical,connivent,cordate,cuspidate,diameter,discolorous,drying,dull,edge,elliptic,elongating,equal,erect,filament,finely,flattened-reniform,flower,free,fruit,fruiting,glabrescent,glabrous,increasing,inflorescence,lateral,leaf,length,lobe,lobed,long,longer,margin,mature,maturity,mauve,middle,midpoint,mm,moderately,narrow-deltate,older,one,open,orange-brown,pair,pedicel,pendulous,perpendicular,petiole,pit,pitted,poricidal,porrect,portion,prickle,prickly,primary,purple,ray,red-green,red-orange,reflexed,retrorse,rounded,scar,seed,shorter,shrub,simple,size,slender,smooth,sometimes,spaced,sparsely,spherical,spreading,stalk,stalked,stellate,stellate-pubescent,stem,straight,style,surface,tapering,terete,terminal,tertiary,time,tip,toward,trichome,truncate,tube,unit,upper,usually,variously,vein,venation,visible,way,weakly,wide,woody,yellow,yellow-green	-2,0-30,0.8-4,1-1.2,1.6-2.1,1.9-2.8,2-5,2/3-3/4,3-,4-5-merous,5-20,5-9,acuminate,alyx,apar,ape,articulated,brow,deltate,distance,eaf,eed,extending,infructescence,lanceolate,lengt,lobing,lon,long-acuminat,lower,midvein,nflorescence,occasionally,often,orolla,oung,peduncle,per,perfect,pericarp,plurifoliat,prickl,ruit,secondary,short-styled,side,tamen,unarmed,vary,ympodial	anthesi,brown,bud,cell,color,corolla,count,growth,habitat,height,long-acuminate,major,minor,new,null,ovary,plurifoliate,position,shape,stigma,stone,structure,sympodial,texture,width,wing,young
410	wfo-0001030714	success	178	162	137	41	25	0.77	.2,.5,/3,0.1-0.3,0.3-0.4,0.5,0.7-0.8,0.8-1,1-1.2,1-1.3,1-1.5,1-2.5,1.2-1.5,1.2-4,1.4-3.5,1.5-2,2-2.5,2-2.6,3-3.5,3-7,5-100,5-6,7-17,abaxial,abaxially,adaxially,age,aid,along,anther,anthesi,apex,bark,base,becoming,beneath,berry,blue,blue-black,branching,calyx,campanulate,clavate,cm,conical,corolla,cup,dark,densely,denser,diameter,ellipsoid,elliptic,especially,except,fide,filament,flattened,flower,free,fruit,glabrous,globose,grading,greyish,growth,herbaceous,howard,joined,leaf-opposed,lengthening,liana,lobe,lobed,many,margin,midrib,minute,minutely,mm,narrow,narrowly,new,node,ob-ellipsoid,ob-elliptic,occasionally,older,ovary,overall,pair,pale,paler,papillate,pedicel,petiole,pitted,planar,pore,poricidal,portion,primary,prominent,pubescent,quadrate,reniform,ripe,scar,shape,simple,slightly,slit,spaced,sparsely,stellate,stem,stigma,style,submarginal,surface,terminal,thickened,time,tip,trichome,tube,twining,uniseriate,unit,vein,vine,violet,way,widely,woody,x,yellow	-3,0.5-0.8,0.5-1.9,1/3,20,>,acuminate,acute,apar,articulating,basal,climbin,cordate,eaf,eed,entire,exserted,gradually,gree,leaving,like,long,lower,membranous,nflorescence,nodding,oblique,papillat,pedice,peduncle,peg,per,perfect,plurifoliat,ruit,strongly,tapering,truncate,tub,ud,ympodial	apart,bud,cell,climbing,color,count,fruiting,green,habitat,height,inflorescence,leaf,length,plurifoliate,position,prickle,seed,specified,stone,structure,sympodial,texture,width,wing,young
411	wfo-0001030733	success	130	130	97	33	33	0.746	.5,/4,0.5-1,1-1.2,1-1.5,1-2,1.5-5,1.7-2.7,3-5,4-15,4.5-5,6-7,6-9,?,abaxially,acuminate,acute,adaxially,along,anther,anthesi,apex,bark,base,bi-lobed,broadly,calyx,capitate,closely,cm,conical,corolla,decurrent,deltate,densely,denser,ellipsoid,elliptic,erect,filament,free,fruiting,glabrous,globose,green,later,lateral,leaf,lobe,lobed,long,main,margin,middle,minutely,mm,moderately,narrowly,onto,opposite,ovary,ovoid-reniform,pair,pedicel,petiole,planar,pore,poricidal,pubescent,rounded,scar,shaped,shrub,simple,smooth,somewhat,spaced,sparsely,stem,stigma,style,surface,tall,tear-drop,tip,treelet,trichome,tube,uniseriate,unit,vein,way,white,widest,woody,x,young	2-2.5,3-4,5-8-flowered,ape,berry,brown,clearly,coriaceous,dark,dia,eaf,eed,elongate,embryo,exserted,grayish-brow,lamina,like,lon,lower,nflorescence,older,overlappin,papillo,portion,ruit,strongly,testa,thick,ud,unifoliat,visible,ympodial	5-8,bud,cell,color,count,diameter,flower,fruit,grayish-brown,growth,habitat,height,inflorescence,length,major,mentioned,minor,new,overlapping,papillose,position,prickle,primary,seed,shape,size,stone,structure,sympodial,texture,unifoliate,width,wing
412	wfo-0001030772	success	155	131	108	47	23	0.697	-2,.2,.25,.5,0.2-0.8,0.25-0.5,0.5-1,0.75-1,0.9-1,1-2,1.4-1.6,1.5-2,2-7,3-3.5,3-5,5-10-flowered,5-6,8-10,anther,anthesi,bark,base,becoming,berry,bud,calyx,capitate,closely,cm,corolla,dark,deflexed,dia,difoliate,ellipsoid,elliptic,erect,filament,free,fruit,fruiting,glabrous,globose,green,grey,impressed,later,lateral,leaf,lenticellate,lobe,lobed,long,long-triangular,main,major,margin,methyl,minor,minutely,mm,nearly,occasionally,older,opposite,ovary,overlapping,ovoid-reniform,pair,pale,paler,papillose,pedicel,petiole,pitted,pore,poricidal,prominent,reflexed,ripe,salicylate,scar,shape,shaped,shining,shrub,simple,slender,smelling,soon,spaced,stem,stigma,strongly,style,surface,tall,tapering,tear-drop,tip,tube,unit,vein,white,wintergreen,woody,x,young	.05,0.9-3.1,1-2.5,1.2-5,4.2-6.5,9-15,acuminate,acute,apex,archin,attenuate,ba,beginning,beneath,branch,differing,eaf,edicel,eed,extreme,geminat,gently,inflorescenc,large,lon,long-acuminate,lower,middle,nflorescence,node,one,papillo,per,portion,rounded,ruit,size,slightly,straight,swollen,tan,trichome,ud,uniseriate,usually,widest,ympodial	cell,color,count,diameter,flower,geminate,growth,habitat,height,inflorescence,length,mentioned,new,position,prickle,primary,seed,stone,structure,sympodial,texture,width,wing
413	wfo-0001030781	success	213	163	128	85	35	0.601	0-5,0.2-4,0.5-6,1-12,1-2,1-4,1.5-9,10-40,15-35,2-20,2.5-3.5,3-4,3-6,4-15,5-6,7.5-9,abaxially,acumen,adaxially,along,anther,apex,apiculate,axillary,base,brown,brownish,bud,cell,ciliate,cm,condition,connivent,corolla,covering,dark,decurrent,deep,diameter,distal,dorsally,dot,drying,edge,erect,especially,filament,flat,flower,folded,forked,fresh,fruit,generally,glabrous,glandular,globose,gray-green,green,green-white,greenish,hair,half,herb,lanceolate,lateral,leaf,light,like,lobe,long,make,margin,midrib,minutely,mm,mucilaginous,odd-pinnate,ovate,ovate-lanceolate,ovoid,pedicel,pentagonal,petiole,pilose,plant,plurifoliate,pointed,puberulent,pubescent,purple,rachi,rarely,rotate-pentagonal,rounded,scattered,seed,simple,size,slightly,small,sometimes,somewhat,sparsely,stem,stigma,style,subovoid,subtending,tall,terminal,testal,thick,throughout,tip,tri-,tube,typically,unit,unwinged,usually,violet,wall,wet,white,whitish,x,yellow	0.5-8,1-1.5,1-10,1-8,1.5-12,1.5-2,1.6-2.2,2-3,2.5-14,5-7,5-8,5-merou,6-7,abruptly,ag,alyx,apart,apparently,articulated,axe,berry,blade,borne,broadly,caly,capitat,chartaceous,cuneate,decreasing,densely,digestion,eaf,eed,elliptic,end,enzyme,exceeding,finely,geminat,glabrou,gradually,hair-like,high,homostylous,honeycomb-shaped,interjected,larger,leaflet,lengthening,living,low-growin,lower,membranous,narrowed,nflorescence,obovate,orbicular,orolla,pair,papillose,peduncle,perfect,petiolulate,pore,poricidal,removed,ruit,sessile,seudostipule,short,singly,slit,spaced,specimen,stamen,ste,stolo,straight,tamen,tem,toward,tuber,vary,wide,ympodial	'hair-like,anthesi,bark,calyx,capitate,color,count,free,fruiting,geminate,growth,habitat,height,inflorescence,length,low-growing,major,mentioned,minor,new,ovary,position,prickle,primary,scar,shape,stone,structure,surface,sympodial,texture,vein,width,wing,young
414	wfo-0001030782	success	198	132	97	101	35	0.49	0-1,0.4-1.5,1-2,1-3,1.5-7.5,12-30,15,2,2.2-4,3-10,7-15.6,abaxially,acumen,adaxially,anther,axillary,base,berry,broadly,brownish,bud,cell,clavate,cm,condition,connivent,coriaceous,corolla,covering,dark,deep,diameter,distal,dorsally,drying,edge,filament,flat,flower,folded,forked,fresh,fruit,generally,glabrescent,glabrous,globose,green,green-white,greenish,hair,half,herb,lanceolate,lateral,leaf,light,lilac,lobe,long,make,medium,mm,mottled,mucilaginous,odd-pinnate,ovate,ovoid,pedicel,pentagonal,petiole,plant,plurifoliate,purple,ripe,rotate,scarce,seed,short,stigma,style,subtending,terminal,testal,thick,throughout,tip,tri-,tube,unit,usually,wall,wet,white,whitish,winged,x	0-7,1-5,1-6,1.2-3.9,1.3-1.6,1.5-2,1.6-4.6,11-47,13-22,2-3,2.4-11.5,3-5,4-11.6,4-6,4.6-26,5-20,5-merou,6-8,abaxiall,acuminate,acute,ag,along,alyx,apart,apex,apparently,arranged,articulated,asymmetric,attenuate,axe,basiscopic,bead,blade,capitat,cuneate,decreasing,digestion,eaf,eed,elliptic,enzyme,exceeding,geminat,glabrou,hair-like,hal,high,homostylous,honeycomb-shaped,inconspicuous,interjected,leaflet,lengthening,like,living,lower,moniliform,multiple,necklace,nflorescence,orbicular,orolla,pair,peduncle,perfect,petiolulate,pore,poricidal,prominently,rachi,removed,rounded,ruit,second,sessile,seudostipule,side,size,slit,smaller,sometimes,spaced,specimen,stamen,stolon,straight,subequal,tal,tamen,tem,tissue,totally,toward,tuber,typically,vary,wide,yellow,ympodial	'hair-like,anthesi,bark,calyx,capitate,color,count,free,fruiting,geminate,growth,habitat,height,inflorescence,length,margin,mentioned,new,ovary,position,prickle,primary,scar,shape,stem,stone,structure,surface,sympodial,tall,texture,vein,width,wing,young
415	wfo-0001030802	success	171	165	139	32	26	0.813	.3,.5,0.25-0.4,0.5-1,0.7-1cm,0.75-1,0.9-1,1,1-1.1,1-1.5,2-2.5,2-3,2-5,3-3.5x,3-6,4-5mm,4-6,5-10-flowered,abaxially,acuminate,acute,adaxially,along,anther,anthesi,apex,appearing,bark,basal,base,becoming,beginning,beneath,brown,bud,calyx,campanulate,cm,cordate,corolla,cucullate,deeply,deflexed,densely,denser,difoliate,dry,ellipsoid,evenly,except,exerted,exudate,filament,filiform,flattened-reniform,free,fruit,fruiting,glabrous,gland,glandular,globose,halfway,hanging,heart-shaped,incrassate,internodal,invest,irregularly,lamina,later,lateral,leaf,length,line,live,lobe,lobed,long,long-triangular,main,margin,markedly,midvein,minutely,mm,near,obconic,older,ovary,ovoid,pair,pale,palmate,papillate,papillose,pedicel,persistently,petiole,pitted,plant,pore,poricidal,prominent,pubescent,raised,red,reddish,scar,shaped,shrub,simple,single-celled,somewhat,soon,spaced,specimen,stem,stigma,strongly,style,subshrub,surface,tear-drop,tip,tipped,trichome,tube,unifoliate,uniseriate,unit,variable,vein,white,widely,woody,x,yellowish,young	.5mm,0,0.5-0.75,0.5-1.5,1-1.2,2.5-3,3-4,abrupt,berry,dia,eaf,edicel,eed,geminat,glandurla,inflorescenc,lower,m.,material,nflorescence,per,portion,pubescen,ruit,slender,stigm,straight,tapering,trichoem,ud,yellow,ympodial	cell,color,count,diameter,flower,geminate,growth,habitat,height,inflorescence,major,mentioned,minor,new,position,prickle,primary,seed,shape,size,stone,structure,sympodial,texture,width,wing
416	wfo-0001030809	success	154	137	109	45	28	0.708	.5,0.2,0.5-1,1-1.5,1.2-1.4,1.4-1.5,1.5-2.4,1.5-3.5,2-2.5,2.3-5.5,20-60-flowered,4.5-5,5-8,6-8,8,9.9-12,across,acute,anther,anthesi,apex,appearing,bark,base,beneath,berry,branched,broadly,calyx,campanulate,clavate,cm,corolla,curl-tipped,deflexed,deltoid,densely,difoliate,ellipsoid,elliptic,evenly,falcate,filament,free,fruit,fruiting,glabrous,globose,golden,green,hidden,large,lateral,leaf,like,lobe,lobed,long,long-papillose,main,major,middle,midrib,minor,mm,nearly,older,opposite,ovary,ovate,overtopping,pedicel,petiole,planar,pubescent,scar,scattered,several,shining,shoot,simple,size,slightly,small,spaced,stem,stigma,style,tall,terminal,three,time,tip,tomentose,tree,triangular,trichome,tube,two,underside,unequal,uniseriate,unit,vein,white,widest,x,yellow-brown,young	1-1.25,along,also,apar,caly,curved,dark-papillo,deciduous,dense,dia,distally,eaf,edicel,eed,erect,especially,exserted,geminat,hair,interpetalar,known,leave,lon,lower,markedly,mature,membranous,minutely,nflorescence,one,pore,poricidal,portion,present,round,ruit,shinin,sinus,slender,soon,straight,tapering,ud,wide,ympodial	apart,bud,cell,color,count,dark-papillose,diameter,flower,geminate,growth,habitat,height,inflorescence,length,margin,mentioned,new,position,prickle,primary,shape,stone,structure,surface,sympodial,texture,width,wing
417	wfo-0001030810	success	191	144	83	108	61	0.435	20â100,abaxially,accrescent,adaxially,anther,anthesi,apart,apex,articulated,axillary,base,bipinnate,blue,borne,branched,brown,calyx,cell,clavate,cm,colour,dark,densely,diameter,elliptic,elliptical,filament,flattened,fleshy,flower,fruit,glabrous,globose,green,greyish,hair,indumentum,leaf,leafy,lobe,long,margin,mm,moderately,multicellular,oblong,pale,pedicel,petiole,pinnate,pitted,plurifoliate,primary,pubescent,reflexed,shallowly,shiny,shoot,shrub,simple,size,sometimes,spaced,sparsely,stem,stigma,stone,style,subglabrous,surface,time,tip,tomentose,tube,unicellular,uniseriate,unit,unknown,violet,white,wing,woody,x	0.2,0.2â0.3,0.3,0.4,0.5â,0.5â0.8,0.6â1.0,0.7â1.4,0.8â5.5,0.95â2.0,0â,1,1.0â1.5,1.0â2.0,1.0â3.0,1.1â2.0,1.1â2.2,1.2â1.5,1.5â1.9,1â2,1â3,1â5,2.9â4.5,2â3,2â4,3.0â5.0,3.3â5.5,3.3â8.5,3.5â4.6,3â19,4â14,4â5,4â7,5,5â15,5â30,5â32,6â10,6â22,7â10,7â11,8â10,absen,acute,adaxiall,ag,along,axe,ba,blade,chartaceous,connivent,cylindrical,decreasing,denser,divided,eaf,eed,equal,erect,especially,geminat,half,hig,irregular,lon,longitudinal,lower,m.,midrib,midvein,narrow,nflorescence,obtu,occasionally,older,opening,opposed,orolla,oung,pair,peduncle,pentagonal,perfect,pinnae,pore,poricidal,rarely,rounded,ruit,secondary,shaped,side,slit,straight,tamen,tardily,tear-drop,vary,wide,yellow,ympodial,â2.5,â3,â3.4,â4.5,â5.0,â8	-,--,0.2-0.3,0.5-1,0.6-1.0,0.7-1.4,0.8-5.5,1-2,1-3,1.0-1.5,1.0-2.0,1.0-3.0,1.1-2.0,1.1-2.2,2.5,2.9-4.5,3,3.0-5.0,3.3-8.5,3.4,4-14,4.5,5-15,5-32,5.0,6-10,6-22,7-10,7-11,8-10,absent,bark,bud,color,corolla,count,free,fruiting,geminate,growth,habitat,height,inflorescence,lateral,length,major,minor,new,null,ovary,position,prickle,scar,seed,shape,structure,sympodial,texture,vein,width,young
418	wfo-0001030822	success	146	145	120	26	25	0.822	.2,0-0.5,0.1-0.2,0.4,0.4-1,0.5-1.5,0.9-1,1-1.2,1-1.5,1.5-2,11-15.5,2-2.5,2-3.8,2-5,3-3.5,3-5,3.5-7,5-6,5-7,8-9,acute,anther,anthesi,apex,attenuate,base,beneath,broadly,calyx,clavate,closely,clustered,cm,completely,corolla,cucullate,cup,decurrent,deflexed,deltate,dia,difoliate,elliptic-obovate,filament,filiform,flattened-reniform,fleshy,flower,free,fruiting,glabrous,globose,green,incrassate,inflorescence,internodal,later,lateral,leaf,lobe,lobed,long,long-ellipsoid,main,major,margin,middle,minor,minutely,mm,near,nearly,occasionally,onto,open,opposite,ovary,pair,pale,papillose,pedicel,perhaps,petiole,pitted,planar,pore,poricidal,present,red-papillose,scar,shaped,shiny,shrub,simple,size,somewhat,spaced,sparsely,stem,stigma,strongly,style,surface,tall,tan,tapering,tear-drop,tip,tube,unit,usually,vein,white,widest,winged,woody,x,yellowish,yellowish-brown,young	0.8-1,abaxially,adaxially,ba,berry,cucullat,differing,eaf,edicel,eed,erect,exserted,geminat,inflorescenc,lon,lower,minute,nflorescence,older,papillo,portion,revolute,ruit,slightly,ud,ympodial	bark,bud,cell,color,count,diameter,fruit,geminate,growth,habitat,height,length,mentioned,new,position,prickle,primary,seed,shape,stone,structure,sympodial,texture,width,wing
419	wfo-0001030871	success	248	221	194	54	27	0.782	.2-3,.8-3.5,.9-1.2,/30-1/5,0-120,0.2-0.4,0.3-4,0.6-1.5,0.7-1.3,0.7-2.5,1-18,1.3-2,1.3-3,1.4-2.7,1.5-3,1.8-2.6,1.8-3.5,1/2,1/2-3/4,1/4,1/4-1/3,11,2-3,2-8,2.8-4.5,3-5,3-6,3.5-14,4.5-6.5,4.8-9.5,5-33,5-7,6-40,7-12,9-13,abaxially,abruptly,acuminate,acute,adaxial,adaxially,along,anther,anthesi,apart,apex,appressed,articulated,attenuate,axe,axillary,bark,base,becoming,berry,blade,blunt-tipped,branch,branched,brown,bud,calyx,campanulate,chartaceous,closely,cm,conical,continued,corolla,dark,decurrent,deltoid,dendritic-echinoid,dendritic-multangulate,densely,diameter,directed,distal,due,echinoid,elliptic,elongate,entire,equal,erect,filament,fleshy,flower,free,fruit,fruiting,glabrescent,glabrous,granular-tomentose,grayish,green,greenish,growth,hair,held,high,honeycombed,lateral,leaf,length,lobe,lobed,long,long-,long-stalked,longer,main,margin,midvein,minute,mixed,mm,mostly,multangulate,narrowly,nearly,nodding,oblong,obtuse,occasionally,often,orbicular,ovate,ovate-lanceolate,overlapping,pale,partly,pedicel,petiole,plurifoliate,porrect-stellate,present,probably,prominent,pubescent,purple,rather,ray,reflexed,relatively,reniform,reticulate-punctate,ripe,scabridulous,sessile,short,short-,short-stalked,shrub,side,simple,small,sometimes,soon,spaced,sparingly,sparsely,stamen,stellate-tomentose,stem,stigma,style,subglobose,suborbicular,sulcate,terete,terminal,testa,thick,thick-stalked,thin-stalked,time,tomentose,toward,tree,tube,unarmed,unit,usually,vein,velutinous,violet,way,white,wide,x,yellow,yellowish,young	0.4-1.8,1-1.3,1.5-6,3-32,3-4.4,30,accrescent,ag,apical-lateral,apparently,appressed-tomentose,ba,capitat,dehiscing,dendritic-echinoi,eaf,earl,early,echinoi,eed,evident,exserted,extend,glabrescen,inserted,introrse,large,longitudinal,lower,m.,multangulat,nflorescence,older,open,orbicula,orolla,peduncle,perfect,plait,pore,rachi,rotate-stellate,ruit,runk,slit,somewhat,splitting,striate,strongly,suture,tamen,unarme,vary,ympodial	capitate,cell,color,count,habitat,height,inflorescence,major,minor,new,null,ovary,position,prickle,primary,scar,seed,shape,size,stone,structure,surface,sympodial,texture,tip,width,wing
420	wfo-0001030872	success	166	148	122	44	26	0.735	.5,0.5,0.8-1,1-1.5,1-2,1.2-1.5,1.5-2,1.5-5,2-5,3-7,4-6,4-6-flowered,5-6,5.5-7,adaxial,along,anther,anthesi,appearing,area,bark,base,black,broadly,brown,calyx,center,closed,closely,cm,completely,consisting,corky,corolla,crateriform,cucullate,dark,darker,deltoid,densely,difoliate,dry,ellipsoid-ovoid,elliptic,filament,fleshy,free,fruiting,full,glabrate,glabrous,globose,green,hooded,incurved,known,large,leaf,lenticel,lenticellate,less,like,lobe,lobed,long,major,margin,middle,minor,minutely,mm,nearly,nerve,older,one,opposite,ovary,ovate,pair,paler,papillose,pedicel,petal,petiole,planar,pore,poricidal,primary,prominent,proximal,raised,rather,red-glandular-puberulent,reddish-glandular-puberulent,rest,ridge,scar,shaped,shining,side,simple,slightly,small,soon,spaced,specimen,stem,stigma,style,tall,tear-drop,thickened,tip,tree,treelet,tube,unit,white,widest,woody,x,young	0.5-1,0.8-2,1-1.2,1.2-3,12-18,6-12.5,acuminate,acute,age,apex,beginning,berry,caly,deflexed,dia,eaf,edicel,eed,erect,exserted,geminat,inflorescenc,live,lon,lower,material,nflorescence,oblique,overlapping,pale,portion,puberulent,reddish-glandular,relative,rounded,ruit,shorter,size,straight,strongly,styl,tapering,ud,ympodial	bud,cell,color,count,diam,diameter,flower,fruit,geminate,habitat,height,inflorescence,length,mentioned,position,prickle,seed,shape,stone,structure,surface,sympodial,texture,vein,width,wing
421	wfo-0001030882	success	144	130	106	38	24	0.736	.1,.5,0.5-0.75,0.5-1,0.5-1.1,0.8-2.4,0.9-1.1,1-1.3,1-1.5,1-4,1.6-2,2-5.4,2-6,2.2-4.6,3-3.5,3/4,6.5-15.6,8-12,accrescent,acuminate,anther,anthesi,apex,attenuate,bark,base,beginning,beneath,calyx,capitate,closely,cm,conical,corolla,crenulate,deltoid,difoliate,elliptic,filament,free,fruit,fruiting,glabrous,globose,green,lateral,leaf,lightly,lobe,lobed,long,main,major,margin,middle,minor,minutely,mm,narrowly,occasionally,older,opposite,ovary,overlapping,ovoid,ovoid-reniform,pair,pale,paler,papillose,pedicel,petiole,pitted,planar,prominent,raised,ruguse,scar,short,shrub,simple,size,slightly,small,spaced,stem,stigma,style,surface,tall,terminal,thick,thickened,tip,transversely,tree,tube,unit,vein,way,white,widest,woody,x,yellowish,young	0.75-1,0.8-1.1,2,?,berry,deflexed,dia,differing,eaf,edicel,eed,erect,exserted,extreme,geminat,inflorescenc,lon,lower,nearly,nflorescence,one,papillo,peelin,pore,poricidal,portion,ruit,shaped,slender,soon,straight,tan,tapering,tear-drop,truncate,tub,ud,ympodial	bud,cell,color,count,diameter,flower,geminate,habitat,height,inflorescence,length,mentioned,peeling,position,prickle,primary,seed,shape,stone,structure,sympodial,texture,width,wing
422	wfo-0001030883	success	179	162	136	43	26	0.76	.05,.1,.5,0.5-3,0.5-5,1-1.2,1-1.3,1-1.5,1-4,1.5-3.5,10-18,2-5,20-50-flowered,3-3.5,3-4,3/4,5-6,accrescent,across,acute,anther,anthesi,apart,appearing,arching,bark,base,becoming,berry,branched,calyx,cell,clavate,cm,collapsed,collection,corolla,dark,dia,difoliate,dry,elliptic,epidermal,erect,evenly,filament,finely,fleshy,free,fruit,fruiting,furcate,geminate,glabrous,glandular,globose,green,hard,hollow,inflorescence,large,later,lateral,leaf,less,like,little,living,lobe,lobed,long,long-acuminate,main,malodorous,massive,material,midrib,minute,minutely,mm,narrowly,occasionally,older,opposite,ovary,ovate,ovoid-reniform,pair,papillate,papillose,pedicel,perpendicular,petaloid,petiole,pitted,pore,poricidal,present,puberulent,pulp,quite,rather,reflexed,reticulate,scar,seed,shaped,shrub,slightly,sometimes,soon,spaced,stem,stigma,stout,strongly,style,surface,tall,tear-drop,thick,time,tip,triangular,trichome,tube,uniseriate,unit,upper,vein,wall,way,white,woody,x,young	-3,1-1.1,1.5-2,18-44.5,9.5-27.5,acuminate,apex,approximatately,brown,bu,deflexed,differing,eaf,edicel,eed,geminat,imbedded,laminar,lenticellat,live,lon,lower,markedly,middle,nflorescence,oblique,pale,papillo,placenta,plant,portion,proximal,ruit,russet,size,slender,straight,tan,tapering,two,ud,widest,ympodial	approximately,bud,color,count,description,diameter,flower,fork,growth,habitat,height,length,lenticellate,margin,mentioned,new,position,prickle,primary,shape,stone,structure,sympodial,texture,width,wing
423	wfo-0001030884	success	218	190	165	53	25	0.757	.2,0.3-0.5,0.4-3,0.5,0.8-1,0.9-5,1,1-1.2,1-1.5,1.5-2.5,10,2,2-5,4-13,4-5,5,5-30,5-6,5.5-7,6-25,6-8,7-8,9-11,abaxial,abaxially,abruptly,acute,adaxial,along,also,anther,anthesi,apex,bark,base,blade,broad-based,brown,c.,calyx,capitate,cm,conical,curved,dark,decurrent,densely,di-,diameter,differing,directed,elliptic,extend,filament,flower,flowering,free,fruiting,geminate,glabrous,glandular,gray-tinged,green,greenish,growth,half,herbaceous,inflorescence,lateral,leaf,leafy,length,like,lobe,lobed,long,long-styled,long-triangular,magnification,margin,mature,midpoint,minute,minutely,mixture,mm,moderately,new,node,occasionally,older,one,onto,open,ovary,ovoid-reniform,pair,pale,pedicel,petiole,pore,poricidal,porrect,present,prickle,prickly,primary,pubescent,ray,red,reddish,reflexed,regularly,rest,sagittate,scar,scattered,sessile,short-stalked,short-styled,shrub,similar,simple,size,spaced,sparsely,spherical,spreading,stellate,stellate-pubescent,stem,stiff,stigma,still,strongly,style,surface,tall,tannish,tapering,time,tip,treelet,trichome,trifoliate,tube,unarmed,unicellular,uniformly,uniseriate,unit,upward,usually,varying,vein,visible,way,white,wide,wing,winged,without,woody,yellow,young	.5,.7,0.3,0.5-1.2,1-3,1.5,1.5-2,100,4.5-5,5-merous,6-10,>,adaxiall,alyx,andromonoeciou,apar,arme,articulated,basal,berry,connivent,discolorous,distal,eaf,eed,equal,extending,gree,heterostylous,infructescence,long-stalked,lower,midrib,nflorescence,orolla,oung,outlin,papillat,peduncle,per,plant,portion,principal,reflexe,ruit,shallowly,shap,short,slender,tamen,vary,weakly,ympodial	adaxially,apart,armed,bud,cell,color,corolla,count,description,fruit,habitat,height,major,mentioned,minor,outline,papillate,position,seed,shape,stone,structure,sympodial,texture,width
424	wfo-0001030899	success	146	98	61	85	37	0.418	.5-2,0.3-0.5,1-2,1.5-2,2,2-3.5,2.5-3.5,3-12,3-4,3-foliate,4-5,5-10,?,abaxially,acute,adaxially,apex,base,bronze,calyx,cell,cm,coriaceous,densely,diameter,ellipsoidal,end,flattened,flower,fruit,glabrous,glandular-puberulent,globose,green,inside,lobe,margin,mm,mucronate,narrowly,oblong,outside,ovate,ovoid,pedicel,petiole,puberulent,pubescent,purple,splotch,stigma,stone,stripe,style,triangular,tube,unbranched,unit,vein,x,yellow	-45,0.5,0.5-1,1,1-1.5,1-3,1-6,10-13,10-20,2-3,20-25,3-5,3.5-4,5-6.5,6.5-31,7-27,8-11,absent,acuminate,aggregate,apart,ape,articulated,axe,basal,beyond,blade,chartaceous,connective,connivent,cordate,deeply,desc,dilated,directed,distally,eaf,eed,entire,ex,exceeding,exserted,extrorse,leaving,less,light,lon,long,lower,nflorescence,nther,obconical,obtuse,orang,orolla,pedicellar,peduncle,peltifor,perfect,pore,presen,puberulen,rachi,radiu,remnant,ruit,shorter,shrub,simple,slightly,spaced,stamen,stellate,strongly,tal,tem,thecae,time,tomento,ud,upward,vary,white,wide,ympodial	anther,anthesi,bark,bud,color,corolla,count,filament,free,fruiting,growth,habitat,height,inflorescence,leaf,length,mentioned,new,ovary,peltiform,position,present,prickle,primary,scar,seed,shape,stem,structure,surface,sympodial,texture,tip,tomentose,width,wing,young
425	wfo-0001030902	success	159	135	93	66	42	0.585	-2,0.6-1.5,1-2,1.5-13,1.5-2.5,15-50,2,2-3,2-5,2.5,2.5-4,3-13,3-4,3.5-4,4-22,4-7,5-7,5-9,6-24,8-14,abaxially,acuminate,acute,adaxially,aggregate,along,angled,apex,apiculate,basal,base,blade,branched,brown-pilose,calyx,cell,cm,connivent,cordate,dark,deltate,densely,diameter,eglandular,ellipsoidal,except,flattened,fleshy,flower,forked,fruit,glabrescent,glabrous,glandular,globose,hair,leaving,lobe,long,margin,mature,mm,narrowly,oblong,obtuse,occasionally,orange,ovate,pedicel,pedicellar,petiole,present,puberulence,purple,rarely,reddish,remnant,simple,sparse,sparsely,stigma,stone,style,subcoriaceous,tip,triangular,truncate,tube,unbranched,unit,vein,x,yellow	-20,-5,0-15,1-6,1.5-,1.5-2,10-15,3-20,30-50,4,4-6,4-foliat,absent,apart,ape,apically,articulated,axe,beyond,brow,connective,cylindrical,dilated,directed,distally,eaf,eed,entire,equalling,exceeding,exserted,glabrat,glandular-puberulen,laterally,lon,lower,nflorescence,nther,orolla,peduncle,perfect,pinkish,pore,presen,purplish,rachi,radiu,ruit,shorter,slightly,small,somewhat,spaced,stamen,stellate,subcapitat,tal,tem,thecae,time,tomento,tree,ud,vary,wide,ympodial	4-foliate,anther,anthesi,bark,bud,color,corolla,count,filament,free,fruiting,glabrate,glandular-puberulent,growth,habitat,height,inflorescence,lateral,leaf,length,major,mentioned,minor,new,ovary,position,prickle,primary,scar,seed,shape,size,stem,structure,subcapitate,surface,sympodial,texture,tomentose,width,wing,young
426	wfo-0001030914	success	186	160	137	49	23	0.737	.1,/4,0-0.25,0.5-1,0.7-1,0.8-1,0.8-1.3,1-1.5,1-2,1.2-1.5,1.5-3,1.5-8,2-10,2.5-11,3-4,3.5-17,5-17,7-10,7-8,9-35,acute,along,anther,anthesi,apex,attenuate,bark,base,beneath,berry,bud,calyx,campanulate,capitate,closely,cm,corolla,dark,decurrent,deltoid,densely,difoliate,dry,ellipsoid,elliptic,erect,evenly,filament,flower,free,fruiting,furcate,glabrate,glabrous,globose,golden,green,inflorescence,later,lateral,leaf,lemon-yellow,length,live,lobe,lobed,long,long-styled,major,many,margin,minor,minutely,mm,obovate,occasionally,often,older,onto,opposite,otherwise,ovary,ovoid-reniform,pair,pale,papillose,pedicel,petiole,pitted,planar,plant,pore,poricidal,prominent,puberulent,pubescent,raised,reddish-brown,rest,ripe,scar,shape,shaped,short-styled,shrub,simple,size,slightly,small,spaced,sparsely,specimen,stem,stigma,style,surface,tall,tan,tear-drop,thick,time,tip,tree,trichome,trunk,tube,uniseriate,unit,usually,vein,way,white,winged,woody,x,yellow,young	.5,0.1-0.5,1.5-2,2-2.5,2.5-3,5-25-flowered,blade,constriction,deflexed,dia,differing,distal,eaf,edicel,eed,equal,even,exserted,geminat,greyish-brow,individual,like,lon,lower,main,middle,narowly,nflorescence,one,overlappin,papillo,portion,quite,rounded,ruit,slender,sometimes,soon,straight,tapering,third,ti,tub,ud,variable,weight,widest,within,ympodial	5-25,cell,color,count,diameter,fruit,geminate,greyish-brown,habitat,height,narrowly,overlapping,position,prickle,primary,seed,specified,stone,structure,sympodial,texture,width,wing
427	wfo-0001030918	success	230	145	117	113	28	0.509	-2.3,-3.2,-5,-6,-9,.5,0.1-0.25,0.3-1.5,0.6-2.5,0.7-1.7,1,1-1.5,1-1.8,1.5-2,1.5-2.5,1.5-5.5,1/2-2/3,1/3,1/3-1/2,1/4-1/3,2-4,2-8,3-4,3-6.5,3-7,3.5-6,5-7,5-8,acute,anther,apex,apically,apparently,bark,base,blade,branched,calyx,cell,cm,connivent,cuneate,curved,deltate,densely,diameter,difoliate,elliptic,elongating,erect,evenly,faint,filament,flower,free,fruit,fruiting,glabrescent,green,lateral,leaf,length,lobe,lobed,long,longer,margin,mature,maturity,mauve,mm,moderately,narrow-deltate,obtuse,one,open,orange,pair,pedicel,pendulous,petiole,prickle,prickly,primary,pubescent,purple,ray,red,red-brown,scandent,scar,shrub,simple,slender,sometimes,sparsely,spherical,spreading,stellate,stellate-pubescent,stem,style,surface,tapering,terete,terminal,time,tip,tube,unit,upper,vein,visible,way,wide,woody,young	-12,-4,-4.5,-40,.7,0-10,0-20,0-25,0-4,0-6,0.1,0.2-0.4,0.25-0.45,0.5-0.7,0.5-2,0.5-2.5,0.6,0.7-1.2,1-2,1-4,1/2-3/4,1/3-,2-10,2-2.5,2-25,2-3,2-7,2.8-3,2/,3-15,4-7,5-merous,5.5-7,6-8,7-10,abaxial,abaxially,acicular,adaxial,alyx,ame,apar,apart,articulated,berry,brow,c.,caudat,chartaceous,dark,discolorous,distance,drying,dull,eaf,elongated,equal,extending,flattened,flattened-reniform,geminat,glabrous,green-brown,infructescence,lobing,lower,midpoint,midvein,mixture,nflorescence,oblong,occasionally,older,orange-brown,orolla,oung,outline,pale,peduncle,per,perfec,pericarp,perpendicular,pit,poricidal,porrect,portion,prickl,raised,reduced,reflexed,ruit,secondary,seed,sessile,side,small,smooth,somewhat,spaced,stalk,stalked,straight,strongly,tamen,tertiary,trichome,usually,vary,venation,weakly,yellow,ympodial	anthesi,brown,bud,caudate,color,corolla,count,geminate,growth,habitat,height,inflorescence,major,minor,new,null,ovary,position,present,shape,size,stigma,stone,structure,sympodial,texture,width,wing
428	wfo-0001030943	success	167	147	118	49	29	0.707	0.5-3,1-1.2,1-1.5,1.5-2,1.8-2.2,1/2,10-25,12-15,2-6,3-4,3/4,4-4.5,4-5,4-6,7-13.5,7-8,8-10,abaxially,absent,acuminate,acute,adaxially,age,along,anther,anthesi,apex,bark,base,becoming,bi-lobed,black,branch,branching,calyx,cm,conical,corolla,cupulate,dark,decurrent,dendritic,densely,denser,diameter,drying,echinoid,elliptic,filament,flattened,flower,free,fruiting,glabrous,globose,golden,golden-yellow,growth,lateral,leaf,lenticular,lobe,lobed,long,main,minute,minutely,mm,narrowly,older,outline,ovary,overtopping,pair,pale,pedicel,petiole,pitted,planar,plurifoliate,pore,poricidal,pubescent,purplish-black,scar,scattered,secondary,shoot,shrub,slightly,slit-like,small,somewhat,sparsely,stem,stigma,style,surface,tall,terminal,time,tip,tree,tree-like,triangular,trichome,tube,unit,upper,vein,violet,way,wide,woody,x,yellow,yellowish-white,young	.5,0,0.5-1,1.1,3,abaxial,adaxial,apical,basal,belo,berry,deflexed,eaf,edicel,eed,elongate,erect,ew,exserted,fide,glabrat,horizontal,im,inserted,large,lon,lower,m.,monochasia,nflorescence,nodding,often,papillo,pearce,per,pericarp,portion,raised,reddish-brown,ruit,showy,sleeve,stamen,strongly,tapering,thin,tub,ud,ympodial	bud,cell,color,count,fruit,glabrate,habitat,height,inflorescence,length,major,margin,mentioned,minor,monochasial,new,papillose,position,prickle,primary,seed,shape,size,stone,structure,sympodial,texture,width,wing
429	wfo-0001030959	success	164	136	108	56	28	0.659	.05,.8,/5,0.5-1.5,0.7-1.2,1-10,1-2,1.2-1.8,1.5-2,1.5-3.5,1/5-1/10,10-15,2-4,2.5-4,2.5-4.5,2.5-5,5-9,6-8,9-12,abaxially,almost,ame,anther,apart,apex,apically,apparently,articulated,bark,base,blade,branched,c.,cm,color,connivent,curved,deltate,diameter,difoliate,elliptic,erect,filament,flower,free,fresh,gently,glabrescent,glabrous,glandular,hair,inflorescence,known,lateral,leaf,length,lobe,lobed,long,long-acuminate,longer,margin,midpoint,minute,mm,narrow-deltate,numerous,older,one,open,pair,part,pedicel,petiole,poricidal,porrect,present,prickle,prickly,primary,ray,scar,sessile,several,shrub,simple,slender,spaced,sparsely,spreading,stellate,stellate-pubescent,stem,style,surface,tapering,terete,time,tip,toward,trichome,tube,unit,usually,vein,way,wide,youngest	.2,0.5,1-7,4-6,4-8,5-6,5-merous,alyx,apar,armed,brown,brown-green,concolorous,cuneate,densely,distributed,drying,eaf,eed,equal,evenly,geminat,glabrou,green-brow,know,less,like,long-acuminat,lower,membranous,nflorescence,orolla,oung,peduncle,perfec,perpendicular,portion,prickl,prominent,ruit,scrambling,secondary,short,side,straight,straw,subentire,tamen,tertiary,unarmed,vary,venation,visible,whole,yellow,ympodial	anthesi,bud,calyx,cell,corolla,count,fruit,fruiting,geminate,green-brown,growth,habitat,height,new,null,ovary,position,scrambled,seed,shape,stigma,stone,structure,sympodial,texture,width,wing,young
430	wfo-0001030982	success	215	169	148	67	21	0.688	.1,.2,0.05,0.1,0.1-0.15,0.2-3,0.3-2,0.5,0.5-0.9,0.5-1,0.5-3,1,1-1.5,1-8,1.5,1.5-2,1.5-3,3-21,3-8,4-12,4-5,6-8,abaxially,acuminate,acute,adaxially,angular,anisophyllous,anther,anthesi,apex,appressed,base,beneath,berry,broadly,brownish,bud,caducous,calyx,capitate,ciliate,closely,cm,conic,conical,corolla,cream,cucullate,cuneate,dark,deflexed,deltate,diameter,difoliate,distally,dry,drying,ellipsoid,elliptic,enlarged,extension,filament,fleshy,flower,foliage,free,fresh,fruit,fruiting,geminate,glabrescent,glabrous,glandular,globose,golden-green,green,greenish,growth,impressed,inconspicuously,later,leaf,less,like,lobe,long,major,margin,material,maturity,midvein,minor,minutely,mm,mostly,new,oblique,obovate,occasionally,often,olive,one,opposite,ovary,ovate,packed,pair,papillae,papillate,papillose,pedicel,petiole,planar,primary,projection,prominent,puberulent,pubescent,reflexed,rhizomatous,sagittate,scar,separated,simple,size,slightly,somewhat,sparsely,stem,stigma,strongly,style,subshrub,surface,tightly,time,tip,trichome,tube,uniseriate,unit,vein,weakly,white,x,yellowish,young	-2-2.5,.5,0.05-0.5,2/3,age,ape,ba,brown,central,channelled,chartaceous,curved,differing,distall,distichou,eaf,edicel,eed,entire,exerted,external,flattened-reniform,form,glandular-papillose,hilum,internal,isostylous,larger,lengthening,live,lobed,lower,materia,near,nflorescence,overlappin,pale,papillat,peduncle,pitted,plant,pore,poricidal,portion,prominently,reddish,rest,revolute,ruit,seed,shoot,sigmoidally,sinuate,situated,slit,stamen,straight,stripe,testa,tetramerous,transverse,tub,ud,vegetative,veined,way,ympodial	bark,cell,color,count,distichous,habitat,height,inflorescence,lateral,length,null,overlapping,position,prickle,shape,stone,structure,sympodial,texture,width,wing
431	wfo-0001030989	success	177	109	77	100	32	0.435	0.5-1,1-1.5,1-2,12-15,3-20,3-4,3-7.5,4-5,9-10,abaxially,adaxially,anther,axillary,base,berry,bud,cell,ciliate,cm,conical,connivent,corolla,covering,densely,diameter,distal,especially,filament,flower,forked,fruit,generally,glabrous,green,half,herb,lanceolate,lateral,leaf,light,lobe,long,make,margin,mm,mucilaginous,odd-pinnate,ovoid,pale,pedicel,petiole,plant,plurifoliate,pubescent,ray,ripe,seed,sparsely,stem,stigma,style,subtending,tall,terminal,testal,thick,tip,tri-,triangular,tube,unit,unwinged,violet,wall,wet,x,yellow	.5,1-10,15-27.5,2-3.5,3-5.5,4-7,4-8,5,5-merou,5.5-7.9,6-13,6-6.5,acuminate,ag,alyx,apart,apex,apparently,articulated,axe,blade,brownish,capitat,chartaceous,condition,decreasing,digestion,dorsally,drying,eaf,edge,eed,end,enzyme,erec,flat,folded,fresh,geminat,glabrou,gradually,green-white,greenish,hair,hair-like,homostylous,honeycomb-shaped,interjected,larger,leaflet,lengthening,like,living,lower,minute,nflorescence,obtuse,occurring,orbicular,orolla,ovate,ovate-lanceolate,pair,peduncle,perfect,petiolule,pore,poricidal,present,proximal,pubescen,removed,rotate,ruit,secondary,semierect,seudostipule,singly,size,slit,spaced,specimen,ste,stolo,subequal,subsessile,symmetrical,tamen,tem,thir,throughout,toward,tuber,typically,usually,vary,whitish,wide,wider,ympodial	'hair-like,anthesi,bark,calyx,capitate,color,count,free,fruiting,geminate,growth,habitat,height,inflorescence,length,mentioned,new,ovary,position,prickle,primary,scar,shape,stone,structure,surface,sympodial,texture,vein,width,wing,young
432	wfo-0001030991	success	204	167	149	55	18	0.73	.5,0,0.1,0.2,0.3-0.4,0.5,0.5-0.7,0.5-1,0.5-1.5,0.6-0.8,1-1.5,1-1.6,1-2.5,1.5,10-20,2.5-3,2/3,3-,4-10,5-5.5,9-11,<,abaxially,absent,adaxially,along,anther,anthesi,apparently,appressed,arising,ascending,basal,base,berry,brown,calyx,capitate,cell,cm,color,conical,connivent,corolla,densely,diameter,different,distally,drying,ellipsoid,ellipsoidal,elliptic,elongate,eye,filament,flattened,flower,free,fruiting,furcate,fusiform,glabrous,globose,grey,growth,herb,inflorescence,lanceolate,lateral,leaf,leaf-opposed,lengthening,less,like,lobe,lobed,long-triangular,loosely,margin,minute,minutely,mm,narrowly,nearly,new,occasionally,often,outline,packed,pair,particularly,pedicel,pendant,per,pericarp,petiole,pinnatifid,pitted,pointing,pore,poricidal,portion,primary,pseudoumbel,pubescent,rectangular,red,reflexed,reniform,ripe,scar,scattered,shiny,short,shrub,simple,slit,small,somewhat,sparsely,spreading,stellate,stem,stigma,strongly,style,suffrutescent,surface,tangled,terminal,testal,thin,tightly,tip,trichome,tube,uniformly,uniseriate,unit,variably,vein,violet,weak,weight,white,woody,x,yellowish,young	0.2-0.7,0.5-3.5,0.7-1.2,1-2.2,1-7,2-plurifoliat,2.5-10,3-5-lobed,5-merou,acuminate,acute,adaxiall,ag,alyx,angled,apex,ark,articulated,attenuate,bulbous,eaf,eed,enlarged,entire,exerted,filiform,frui,glabrescen,ilament,incised,leave,lower,midrib,nflorescence,nodding,older,orolla,papillo,part,peduncle,perfect,platfor,rest,rootstoc,ruit,shallowly,sleeve,slightly,tem,twinin,ud,upper,vary,winged,ympodial	2-plurifoliate,age,bud,fruit,glabrescent,habitat,height,length,ovary,papillose,platform,position,rootstock,shape,structure,sympodial,texture,twining
433	wfo-0001031005	success	231	204	177	54	27	0.766	.4,.5,0-0.5,0.1,0.3-0.5,0.8,0.9,1,1-1.5,1-2,1-2.5,1-3,1.5-2.5,1.5-4,10,2-3.2,2.3-3,2.5,2.5-4,3-10,3-4,3-6.5,4-6,5,5-7,5-8,5Â°,6-12,abaxial,accrescent,acuminate,acute,age,almost,along,anther,anthesi,apex,apically,apparently,articulated,attenuate,bark,base,berry,black,blue,branch,branched,branching,brown,calyx,capitate,clearly,cm,common,conical,corolla,dark,delineated,deltoid,dendritic,dendritic-pubescent,denser,density,developing,diameter,dilated,domatia,drying,elliptic,elongated,entire,equal,evenly,extending,eye,filament,flattened,flexuous,flower,form,forming,free,fruit,fruiting,glabrous,immature,increasing,inside,junction,known,lateral,leaf,length,lengthening,liana,like,linear,lobe,long,longitudinally,loop,main,margin,midvein,minute,mm,much,naked,oblong,obovate,obscure,occasional,often,orange-brown,outside,ovate,ovoid,pair,pedicel,peduncle,pendulous,pericarp,petiole,pointed,pore,poricidal,primary,prominent,pubescent,purple,rachi,ray,region,rest,ridged,scar,secondary,seed,short,side,simple,slender,smaller,smooth,sometimes,sparsely,spread,spreading,standing,stem,stigma,strongly,stump,style,surface,surrounding,tangling,terete,terminal,thin,tip,trichome,tube,unarmed,uneven,unit,usually,vein,venation,visible,well-developed,white,wide,x,young	/3-1/2,0.5-1.5,abaxially,adaxially,alyx,apar,brachyblast,chartaceous,clum,clustered,concolorous,cupular,curved,datum,deeply,detaching,discolorous,divided,eaf,ellipsoi,fertilisation,fine,flat,greenish,leave,lobed,lower,m.,membranous,network,nflorescence,nther,occasionally,older,onl,orolla,ou,perfec,plurifoliat,portion,protruding,raised,ruit,smoot,somewhat,soon,tearing,tertiary,thick-chartaceous,toward,ud,vary,weakly,ympodial	apart,bud,cell,clump,color,count,ellipsoid,growth,habitat,height,inflorescence,major,mentioned,minor,new,ovary,plurifoliate,position,prickle,shape,size,stone,structure,sympodial,texture,width,wing
434	wfo-0001031007	success	207	189	157	50	32	0.758	0.2,0.5,0.5-10,0.75-1.5,1,1-1.5,1-3.5,1.2-1.5,1.3-,1.5-2,1.6-2,1.9-3,1/3,11-14,15,2.5-,2.5-5,4-7,4.5-5,5,5-12,50-100,6,7-10,8-10,<,abruptly,acute,alfway,almost,along,anther,anthesi,apex,apparently,base,becoming,beginning,berry,bifid,black,branched,broad,broadly,brown,c.,calyx,campanulate,capitate,cell,clustered,cm,completely,connivent,corolla,cuneate,cup-shaped,dark,deltate,dendritic,densely,diameter,dilated,drying,dull,ellipsoid,elliptic,exserted,extending,filament,flattened-reniform,flower,free,fruit,fruiting,glabrous,globose,growth,herbarium,impressed,inflorescence,intramarginal,irregularly,lamina,lax,lengthening,lilac,lobe,long,looping,loose,loosely,many,margin,markedly,matte,midvein,minutely,mm,narrowing,narrowly,near,new,nodding,occasionally,often,older,outline,papillate,pedicel,petiole,pitted,planar,plurifoliate,pore,poricidal,portion,primary,prominent,pubescent,rat,reddish,round-rectangular,sagittate,scar,shiny,shrub,simple,slightly,slit,spaced,sparsely,specimen,splitting,stem,stigma,stout,strongly,style,surface,tangled,terminal,testal,time,tiny,tip,trichome,tube,twining,unit,upper,vein,vine,way,woody,x,yellow	.5,0.5-1,1-1.2,3-4,4-6,5-merou,5.5-6,abaxiall,ag,alyx,apar,ark,articulated,branching,chartaceous,eaf,eed,entire,fleshy,geminat,glabrescen,glabrou,ilament,junction,leaving,lobed,lower,m.,multi-celled,nflorescence,orolla,pale,papillat,peduncle,peg,per,perfect,pericarp,revolute,ruit,sleeve,slender,spreading,stellate,stellate-pentagonal,thin,ud,usually,vary,ympodial	?,abaxially,age,apart,bark,bud,color,count,geminate,glabrescent,habitat,height,lateral,leaf,length,major,minor,null,ovary,paler,position,prickle,seed,shape,size,stone,structure,sympodial,texture,width,wing,young
435	wfo-0001031007	success	206	167	143	63	24	0.694	0.2,0.5,0.5-1,0.75-1.5,1,1-1.2,1-1.5,1-3.5,1.2-1.5,1.3-,1.5-2,1.6-2,1.9-3,1/3,11-14,15,2.5-,2.5-5,4-7,5,5-12,50-100,6,7-10,8-10,<,abaxially,abruptly,adaxial,alfway,almost,along,anther,anthesi,apex,apparently,bark,base,becoming,beginning,berry,bifid,black,branched,broad,broadly,brown,c.,calyx,campanulate,capitate,cell,cm,completely,corolla,cup-shaped,dark,deltate,dendritic,densely,diameter,dilated,drying,ellipsoid,elliptic,extending,filament,flattened,flower,free,fruit,fruiting,glabrous,globose,growth,herbarium,impressed,inflorescence,intramarginal,irregularly,lamina,lax,lilac,lobe,lobed,long,looping,loose,many,margin,markedly,midvein,minutely,mm,narrowing,narrowly,near,new,nodding,occasionally,often,outline,papillate,pedicel,petiole,pitted,planar,primary,prominent,pubescent,rat,reddish,reniform,round-rectangular,sagittate,shrub,simple,slender,slightly,sparsely,specimen,splitting,spreading,stem,stigma,stout,style,surface,tall,tangled,terminal,testal,time,tiny,tip,trichome,tube,unit,vein,vine,way,wide,woody	.5,0.5-10,3-4,4-6,4.5-5,5-merou,5.5-6,acute,ag,alyx,apar,articulated,branching,chartaceous,clustered,cuneate,dull,eaf,eed,entire,exserted,fleshy,glabrescen,glabrou,ilament,junction,leaving,lengthening,lower,m.,matte,multi-celled,nflorescence,older,orolla,pale,papillat,peduncle,peg,per,perfect,pericarp,plurifoliat,pore,poricidal,portion,revolute,ruit,scar,shiny,sleeve,slit,spaced,stellate,stellate-rotate,strongly,thin,twinin,ud,upper,usually,vary,ympodial	bud,color,count,glabrescent,habitat,height,leaf,length,null,ovary,paler,plurifoliate,position,prickle,seed,shape,stone,structure,sympodial,texture,twining,width,wing,young
436	wfo-0001031036	success	150	141	112	38	29	0.747	.2,.25,.5,0.5-1,0.8-1,0.8-1.2,1-2.5,1.2-1.5,1.5-3,12-15,2-2.5,2.2-3.7,3-5,3.5-5.5,4.5-6.5,5-6,7-8,acuminate,acute,along,angle,anther,anthesi,apex,axil,base,becoming,bi-lobed,broadly,calyx,closely,cm,conical,corolla,decurrent,deflexed,dia,difoliate,drying,ellipsoid,elliptic,enlarged,filament,filiform,flattened-reniform,fleshy,free,fresh,fruiting,glabrous,globose,green,greenish-white,knob-like,lateral,leaf,lobe,lobed,main,major,margin,middle,minor,minutely,mm,nearly,oblique,older,onto,opposite,ovary,pair,papillose,pedicel,perhaps,petiole,pitted,planar,pointed,rounded,sagittate,scar,shiny,short,shrub,simple,sinus,size,slightly,soon,spaced,spathulate,stem,stigma,style,surface,tapering,thickened,tip,trichome,tube,uniseriate,unit,usually,vein,white,widest,winged,woody,x,yellowish,young	1-1.3,10-20-flowered,3-4,abaxially,adaxially,arising,ba,berry,brown,crisped,dark,differing,dry,eaf,edicel,eed,erect,exserted,geminat,lamina,lon,long,lower,material,nflorescence,overlappin,papillo,pore,poricidal,portion,ruit,shaped,strongly,tall,tear-drop,tub,ud,ympodial	10-20,bark,bud,cell,color,count,diameter,flower,fruit,geminate,growth,habitat,height,inflorescence,length,mentioned,new,overlapping,position,prickle,primary,seed,shape,stone,structure,sympodial,texture,width,wing
437	wfo-0001031064	success	179	147	126	53	21	0.704	.0-2.5,.5,.5-1,0,0-15,0.5,1,1-1.2,1-2,1-3,1.2,1.5-2,10-12,2,2.5-3,3,3.5-4,4-5-celled,5-6,8-10-celled,abaxially,adaxially,along,anther,anthesi,anticlinal,arising,axil,base,bearing,berry,bright,calyx,cell,cm,completely,conical,corolla,deltate,densely,denser,diameter,distal,elongate,epidermal,exserted,filament,fleshy,flower,free,fruit,fruiting,glabrous,globose,green,half,highly,inflorescence,irregular,irregularly,leaf,leaflet,lightly,like,lobe,lobed,long,margin,minute,minutely,mm,near,nearly,node,occasionally,open,ovary,ovate,ovoid-reniform,pair,papillate,pedicel,per,petiole,pinnate,planar,poricidal,portion,projection,prominent,pubescent,purple,rachi,rugose,scar,scattered,shrub,simple,single,sinuous,sinus,slender,somewhat,sparsely,splitting,stem,stigma,strongly,style,surface,swollen,terminal,thickening,time,tip,translucent,trichome,tube,uniseriate,unit,vein,wand-like,white,winged,without,x	.05,0.5-0.7,0.5-0.8,1.7-4.2,10-12.5,10-17,3-5.5,3-7,5-10.5,6-16,7-16,acroscopic,acuminate,apex,attenuate,basal,blade,broader,clavat,commentary,conspicuous,dark,dr.,eaf,edicel,eed,erec,lamina,lateral,leave,lenticel,lon,lost,lower,narrower,nflorescence,nodding,obovate,often,petiolule,pubescen,ruit,see,short-pubescent,side,smaller,tal,tem,tub,ud,unifoliat,usually,ympodial	bud,clavate,color,erect,growth,habitat,height,length,new,position,prickle,primary,seed,shape,stone,structure,sympodial,tall,texture,unifoliate,young
438	wfo-0001031071	success	186	123	89	97	34	0.478	0-10,0.2-0.8,1-1.5,1-2,1-3,2-8,2.1-3,2.4-3.4,3-10,3-6,4-25,5-9.4,7-16.5,abaxially,acute,adaxially,anther,apex,asymmetric,axillary,base,basiscopic,berry,blue,bud,cell,clavate,cm,color,connivent,corolla,dark,deep,diameter,distal,filament,flower,forked,fruit,generally,glabrous,globose,green,half,herb,lanceolate,lateral,leaf,lilac,lobe,long,medium,mm,mottled,narrowly,odd-pinnate,orbicular,ovate,pedicel,peduncle,pentagonal,petiole,petiolulate,plant,plurifoliate,purple,ripe,rotate,round,sessile,short,side,size,spot,star,stigma,style,subtending,tall,terminal,tip,tissue,tri-,tube,unit,usually,white,winged,x	0.4-2,1-7,1.5-2.2,2-3,2-5,3-5,3.8-5.4,4-6,5-merou,5.7-8.8,6-8,7-8,8-28,abaxiall,acumen,ag,along,alyx,apart,apparently,arranged,articulated,attenuate,axe,bead,blade,brownish,capitat,condition,coriaceous,covering,decreasing,digestion,dorsally,drying,eaf,edge,eed,elliptic,enzyme,erec,exceeding,flat,folded,fresh,geminat,glabrou,green-white,greenish,hair-like,homostylous,honeycomb-shaped,interjected,leaflet,lengthening,like,living,lower,make,middl,moniliform,mucilaginous,multiple,necklace,nflorescence,orolla,ovoid,pair,perfect,pore,poricidal,removed,ruit,seed,seudostipule,slightly,slit,spaced,specimen,stamen,stolon,straight,subequal,tamen,tem,testal,thick,throughout,toward,tuber,typically,vary,wall,wet,whitish,yellow,ympodial	anthesi,bark,calyx,capitate,count,free,fruiting,geminate,growth,habitat,height,inflorescence,length,major,margin,mentioned,minor,new,ovary,position,prickle,primary,scar,shape,stem,stone,structure,surface,sympodial,texture,vein,width,wing,young
439	wfo-0001031097	success	174	144	105	69	39	0.603	0.45,0.5,1-3,1-4,1.8-2.5,13-30,2-3,2-3.3,3-5,4-6,4-7,5-11,5-12,8-11,abaxial,abaxially,acumen,adaxially,along,apical,apically,articulate,base,branched,calyx,cell,cm,connate,corolla,covering,cyme,darker,deep,dehiscent,diameter,dichasial,dichasially,distal,dorsally,dotted,ebracteate,edge,filament,flat,flower,folded,forked,generally,green,hair-like,half,herbaceous,interpetalar,introrse,lateral,leaf,light,lighter,lobe,long,make,margin,maturing,medium,mm,monochasial,mottled,mucilaginous,narrow,noticeably,odd-pinnate,often,ovoid,pattern,pedicel,pentagonal,perennial,petal,petiole,plant,poricidally,proximal,puberulent,pubescent,purple,rotate,seed,short,side,slit,sometimes,stigma,strigose,style,testal,thick,tuber-bearing,typically,unit,violet,violet-blue,wall,wide,yellow,Â¼	1,1-4.5,1.5,1.6-5.5,1.8-2.6,2-4,3-6-foliat,3.5-6,3.7-8.4,5-9,9-21,acuminate,acute,apex,cuneate,decurrent,digestion,diminishing,eaf,eed,elliptical,emoval,enzyme,exceeding,frequently,globo,gree,green-white,highly,honeycomb,interjected,leaflet,living,lon,lower,lunat,nflorescence,nther,oblique,obovate,orolla,ovate,pair,peduncle,perfect,petiolulate,petiolule,plan,rachi,rapidly,rarely,reveal,ruit,sessile,seudostipule,size,specimen,stamen,straight,tal,tem,terminal,throughout,tissu,toward,vary,vbase,without,ympodial	3-6-foliate,anther,anthesi,bark,bud,color,count,free,fruit,fruiting,globose,habitat,height,inflorescence,length,lunate,mentioned,ovary,position,prickle,primary,pseudostipule,scar,shape,stem,stone,structure,surface,sympodial,tall,texture,tip,tissue,tube,vein,wet,width,wing,young
440	wfo-0001031101	success	197	181	149	48	32	0.756	-16,-20,-30,-5,-8,/2,/2-equal,0.05-0.2,0.1-0.2,0.1-0.3,0.5-0.8,0.5-3,0.7-0.8,1-,1-2,1-3,1.3-2,1.3-2.5,1.4-1.7,1.5-3,1/3-1/2,1/4-1/2,10-30,2-4,2-5,2-6,2.5-,2.5-3.5,3-10,3-15,3-8,3.5-4.5,4-10,4-7,4.5-9,5-6,6-10,8-15,abaxially,acuminate,adaxial,almost,ame,anther,apex,apical,apically,apparently,bark,base,berry,blade,branched,bright,c.,calyx,cm,connivent,deltate,diameter,difoliate,dull,elongating,erect,evenly,filament,filiform,flattened-reniform,flower,free,fruiting,glabrescent,glabrous,glandular,green,hair,herbaceous,lateral,leaf,length,lobe,lobed,long,long-acute,longer,margin,mature,maturity,mauve,midpoint,minute,mm,moderately,multangulate,narrow-deltate,near,obtuse,often,older,one,open,orange-brown,orange-red,ovate,pair,pale,pedicel,petiole,poricidal,porrect,primary,ray,red,resembling,rounded,scandent,scar,sessile,shrub,simple,spaced,sparsely,spherical,spreading,stalk,stalked,stellate,stellate-pubescent,stem,straight,style,surface,tapering,terete,terminal,time,tip,trichome,tube,umbel,unarmed,unit,variously,vein,way,white,wide,yellow,young	-1,0.3-0.5,0.6-0.8,0.8-,1-2.3,2-2.8,2.5-3.8,4-5-merous,5-20,abaxial,alyx,apar,articulated,ba,concolorous,drying,eaf,eed,entire,equal,frui,geminat,green-brown,infructescence,long-acuminat,lower,membranous,nflorescence,orolla,oung,peduncle,pendulous,per,perfec,pericarp,portion,red-brow,ruit,smooth,stellate-pubescen,tamen,tertiary,unarme,vary,venation,visible,yellow-green,ympodial	anthesi,apart,bud,cell,color,corolla,count,fruit,geminate,growth,habitat,height,inflorescence,long-acuminate,major,minor,new,null,ovary,position,prickle,red-brown,seed,shape,size,stigma,stone,structure,sympodial,texture,width,wing
441	wfo-0001031114	success	208	154	122	86	32	0.587	.2,0.5,0.5-1,0.7-1.5,0.8-1.2,1-10,1-2,1-4.5,1-8,10-15,2-17,2-7,2.5-3,25-50,3-10,3-4,3-7,4-10,4.5-6,6-7,7-15,abaxially,accrescent,acuminate,acute,adaxially,anther,apart,apex,apparently,articulated,base,becoming,berry,blade,branched,calyx,cm,connivent,covering,deltate,densely,diameter,differentiated,dried,echinoid,elliptic-ovate,erect,filament,first,fleshy,flower,free,fruit,fruiting,geminate,glabrous,globose,green,hair,impressed,lacking,leaf,leaf-opposed,like,lobe,long,long-stalked,major,margin,membanaceous,minor,mm,nearly,nodding,oblong,obtuse,often,ovate,pedicel,perfect,petiole,plurifoliate,porrect,prominent,pubescent,purple,ripe,rounded,sessile,short-,short-stalked,shrub,side,simple,slightly,small,spaced,sparsely,stellate,stellate-pubescent,stem,stigma,style,subcucullate,subcuneate,subtending,surface,tall,tip,tree,triangular,truncate,tube,unit,vein,white,white-pubescent,white-stellate,whitish,x,yellowish	.1,.5,0-0.3,0.3-0.5,1-1.5,1-7,1.5-2.5,1.5-4,2-3,2-4,2/3,3-5,4-5,4-8,5-10,5-8,5-merou,absen,adaxiall,ag,alyx,axe,ba,brown,capitat,chartaceous,cylindrical,dark,directed,discolorous,distal,distally,eaf,eed,entire,equal,especially,flattened,frui,highly,homostylous,interpetalar,introrsely,juic,large,light,longitudinal,lower,midpoint,multangulate,nflorescence,one,opening,orolla,outline,paired,part,peduncle,pericarp,pore,rachi,ray,reniform,rugulose,ruit,short,slit,somewhat,stalk,ste,straight,strongly,subcoriaceous,tamen,tem,thickened,thin,time,tissue,toward,unarme,vary,wide,without,yellow,ympodial	anthesi,bark,bud,capitate,cell,color,corolla,count,growth,habitat,height,inflorescence,lateral,length,mentioned,new,ovary,position,prickle,primary,scar,shape,size,stellate-multangulate,stone,structure,sympodial,texture,unarmed,width,wing,young
442	wfo-0001031116	success	191	166	139	52	27	0.728	-10,.2,.5,.8,/4,0,0.05-0.15,0.1,0.3-0.5,0.4-0.7,0.7-0.9,1,1-5,1/2,1/6-1/4,10-14,15-25,30-100,4-10,4-7,5-15,8-11,9-13,abaxially,almost,ame,anther,apart,apex,apparently,arachnoid,bark,base,blade,branching,bristle,broad-deltate,c.,calyx,clearly,cm,collapsed,connivent,densely,diameter,dirty-white,dull,elliptic,elongated,epidermi,erect,evenly,filament,flat,flattened-reniform,flexuous,flower,fragile,free,fruit,fruiting,glabrescent,glabrous,green,hair,lateral,leaf,length,less,lobe,lobed,long,longer,lower,margin,mature,maturity,mauve,midpoint,minute,mm,moderately,multangulate,narrow-deltate,obovate,often,older,one,open,orange-brown,orange-red,pair,pedicel,perpendicular,petiole,poricidal,primary,ray,reflexed,scar,secondary,sessile,shrub,simple,single,slender,small,soft,spaced,sparsely,spherical,stalk,stalked,stellate,stellate-pubescent,stem,straight,style,surface,tapering,terete,tertiary,time,tip,tree,trichome,tube,unarmed,unit,upper,vein,venation,visible,way,weakly,wide,woody,yellow,young	0.7-1,1/3-2/,2-5,2.7-3.2,3.5-4,30-50,5,5-merous,abaxial,acuminate,adaxial,alyx,apar,apically,articulated,attenuate,berry,brow,caudate,discolorous,drying,eaf,eed,elongating,equal,glaucous-green,infructescence,membranous,nflorescence,obtu,obtuse,orolla,oung,peduncle,per,perfec,pericarp,plurifoliat,portion,recurved,red-brown,rounded,ruit,sharply,shortly,smooth,sometimes,subentire,tamen,unarme,vary,ympodial	1/3-2/3,anthesi,brown,bud,cell,color,corolla,count,growth,habitat,height,inflorescence,new,null,ovary,plurifoliate,position,prickle,seed,shape,stigma,stone,structure,sympodial,texture,width,wing
443	wfo-0001031128	success	213	179	151	62	28	0.709	-10,-6.5,/4,0,0.05-0.2,0.05-0.25,0.2,0.2-0.4,0.3-0.8,0.5-0.7,0.5-0.8,0.5-1.5,0.5-5,0.6-1,0.8-1.7,1,1-,1-1.6,1.2-2,1.5-3,1.5-3.5,10-20,2-5,2-9.5,2.5-10,2.5-3.5,20-50,4-7,5-,5-15,5-19,5-30,8-12,8-23,abaxially,acute,almost,anther,apart,apex,apically,apparently,bark,base,blade,branched,branching,bristle,brown,calyx,cm,connivent,cuneate,deltate,densely,diameter,drying,dull,elliptic,elongated,erect,evenly,filament,filiform,flattened-reniform,flexuous,flower,free,fruit,fruiting,glabrescent,glabrous,gland,glandular,green,hair,inflorescence,lateral,leaf,length,less,lobe,lobed,long,long-acuminate,longer,margin,mature,maturity,mauve,midpoint,minute,mm,moderately,multangulate,narrow-deltate,near,often,one,open,orange-brown,pair,pale,pedicel,perpendicular,petiole,poricidal,primary,purple-black,ray,red,reduced,reflexed,scar,secondary,sessile,short-attenuate,shrub,simple,single,soft,spaced,spherical,spreading,stalk,stalked,stellate,stellate-pubescent,stem,straight,style,surface,tapering,terete,terminal,time,tip,trichome,tube,unit,usually,variously,vein,way,white,whitish,wide,woody,yellow,yellow-brown,young	-100,-4.5,0-30,1/,1/6-1/3,10-35,2.3-,20-60,3-4,3.5-4.5,4-5-merous,abaxial,alyx,apar,ape,articulated,berry,concolorous,eaf,eed,elongating,entire,equal,eye,gra,infructescence,lon,long-acuminat,lower,membranous,multangualte,naked,nflorescence,occasionally,older,orolla,oung,peduncle,per,perfect,pericarp,plurifoliat,portion,recurved,red-brown,ruit,shallowly,short-styled,side,smooth,staminate,tamen,tertiary,unarme,unarmed,undulate,vary,venation,visible,weakly,yellow-green,ympodial	anthesi,bud,cell,color,corolla,count,gray,growth,habitat,height,major,minor,new,null,ovary,plurifoliate,position,prickle,seed,shape,size,stigma,stone,structure,sympodial,texture,width,wing
444	wfo-0001031135	success	189	167	128	61	39	0.677	-7,0-2,0.7-2,1-,1-1.5,1-10,1-2.5,1-3,1-4,1.5-2,10-20,2,2-,2-2.5,2-23,2-3,2-3.5,2-4,2-5,2.5-28,3-10,3-4,3.5-12,4-5,5-11,5-30,5-9-pinnate,abaxially,acuminate,acute,adaxially,adpressed,along,also,apart,apex,articulated,basal,base,beyond,calyx,cell,chartaceous,cm,color,compound,cordate,coriaceous,cuneate,darker,deflexed,deltate,densely,diameter,ellipsoidal,especially,exserted,fading,flattened,flower,frequently,fruit,fusiform,glabrous,green,hair,interstitial,irregularly,lateral,leaf,leaflet,leaving,light,lobe,lobed,long,longitudinal,margin,midrib,mm,moderately,oblong,obtuse,occasionally,often,ovoid,papillose,pedicel,pedicellar,peltiform,perfect,petiole,pilose,pink,pinnatifid,puberulent,pubescent,purple,remnant,ripe,shrub,simple,small,smaller,spaced,sparsely,stamen,stigma,stone,stripe,style,time,tip,toward,tree,triangular,truncate,tube,unbranched,unit,unlobed,violet,white,whitish,wide,x,yellow-green,yellowish	0.5-2,1.5-3,1.5-9,3-5,4-foliat,7-15,absent,aggregate,ape,axe,basiscopically,biglandula,blade,broad,campanulate,connective,cylindrical,decurrent,dilated,directed,distally,eaf,eed,eglandular-pubescent,ellipsoida,elliptic,entire,equal,exceeding,glandular-,laterally,lon,lower,narrowed,nflorescence,nther,obconical,oblique,orolla,ovate,peduncle,pilo,pinnately,pore,present,rachi,radiu,ruit,shorter,slightly,strongly,subcoriaceous,tal,tem,thecae,tomento,ud,unknow,upper,vary,ympodial	4-foliate,anther,anthesi,bark,biglandular,bud,corolla,count,filament,free,fruiting,growth,habitat,height,inflorescence,length,major,minor,new,ovary,position,prickle,primary,scar,seed,shape,size,stem,structure,surface,sympodial,tall,texture,tomentose,unspecified,vein,width,wing,young
445	wfo-0001031144	success	231	199	172	59	27	0.745	-11,-13,.2,.5,0.2,0.5,0.8-1.4,1-,1-1.5,1-4,1.1-2.5,100,2-,2-3,2-6,2-9,2/3,25,3-4.5,3.5-10,4,4-6,5-9,6,7-10,<,acuminate,acute,adaxially,anther,anthesi,apart,apex,apiculae,appearing,ark,around,articulated,asymmetric,axi,basal,base,berry,blac,branch,bright,broadly,brow,brown,calyx,capitate,cell,closer,cm,cordate,corolla,corresponding,cupped,densely,diameter,divaricate,drying,ellipsoid,elliptic,elongate,entire,extending,filament,flattened,flattened-reniform,flower,free,fruiting,geminat,glabrous,globose,groove,growth,inflated,inflorescence,irregularly,lamina,larger,later,lateral,leaf,leaflet,leaving,like,lobe,lobed,long,many,margin,markedly,mere,minute,minutely,mm,near,new,number,oblique,occasionally,often,older,one,open,outline,pair,pale,pedicel,peduncle,peg,pendant,pentagonal,petiole,pinnately,pinnatifid,pitted,plurifoliate,primary,pubescent,red,reddish,rim,ripe,scar,seed,shiny,simple,sleeve,slightly,small,sometimes,spaced,sparsely,spreading,stem,stigma,style,surface,terete,terminal,testal,third,tiny,tip,together,triangular,trichome,truncate,tube,tuft,twining,uniseriate,unit,upper,vein,vine,violet,wall,way,weight,white,widest,wing,woody,x,yellowish,ympodial,Â½	2,2.5-3,3-7,4-20,4-4.5,5,5-merou,ag,alyx,apicula,away,basiscopically,branche,commonly,connivent,curved,eaf,eed,elongating,exserted,form,four,ilament,lengthening,less,longer,longest,loosely,lower,membranous,nflorescence,orolla,papillo,per,perfect,pericarp,pore,poricidal,portion,progress,quite,ruit,slit,smaller,stellate-rotate,strongly,tan,tangle,tem,thin,twinin,two,ud,unequal,usually,variable,vary,wood,yellow	bark,black,bud,color,count,fruit,geminate,habitat,height,length,major,mentioned,minor,minutephysophyllous,ovary,papillose,position,prickle,shape,size,stone,structure,sympodial,tangled,texture,width,young
446	wfo-0001031152	success	232	218	187	45	31	0.806	-10,-5.5,.4,/100-1/16,0-100,0.2-0.3,0.2-1.5,1-3,1-6,1.1-3,1.3-4,1.5-3,1.5-3.5,1/2-2/3,1/2-3/4,13-27,2.5-7.5,2.7-3.7,2.7-4.5,2.7-6,2.8-4,3.7-7,4-6,4-7,4-8,5-6,6.5-10,8-20,9-13,abaxially,accrescent,acuminate,acute,adaxially,along,anther,anthesi,apex,apical-lateral,attenuate,axillary,basal,base,becoming,berry,blade,blister,blunt-tipped,branch,branched,brown,bud,bullate,calyx,chartaceous,cm,conical,continued,corolla,decurrent,dehiscing,deltoid,densely,diameter,directed,due,evident,exserted,extend,few-rayed,filament,fleshy,flower,free,fruit,fruiting,glabrous,globose,granular-tomentose,green,greenish,growth,hair,honeycombed,introrse,lanceolate,large,lateral,lavender,leaf,length,less,lilac,lobe,lobed,long,long-,longer,longitudinal,main,margin,midvein,mixed,mm,moderately,mostly,multangulate,narrowly,nearly,oblanceolate,oblong,obtuse,occasionally,one,open,openly,orbicular,ovate,pale,partly,pedicel,persistently,petiole,pitted,plurifoliate,pore,porrect-stellate,probably,pubescent,rather,ray,reddish,relatively,reniform,reticulate-punctate,ripe,rotate-stellate,scabrous,sessile,short-,short-stalked,side,simple,slightly,slit,somewhat,soon,spaced,sparingly,sparsely,splitting,stamen,stellate-pubescent,stelliform,stem,stigma,stipitate-glandular,stout-stalked,strongly,style,suborbicular,surface,suture,swelling,terete,terminal,testa,thick,thick-stalked,thin-stalked,time,tomentose,touching,toward,tube,unarmed,unit,usually,variously,vein,violet,way,wide,x,yellow,yellowish,young	-1.5,0.3-1.3,0.3-3,1-1.5,1.1-2.2,1.2-1.8,1.4-2.6,11,2-5,4-19,ag,apart,apparently,articulated,axe,ba,capitat,closely,eaf,earl,eed,entire,glabrescen,high,inserted,lackin,lower,m.,multangulat,nflorescence,orolla,peduncle,perfect,rachi,reddish-brown,ruit,runk,shrub,tamen,thin,thin-,tree,unarme,vary,ympodial	age,bark,capitate,cell,color,count,early,glabrescent,habitat,height,inflorescence,lacking,major,mentioned,minor,new,ovary,position,prickle,primary,scar,seed,shape,size,stone,structure,sympodial,texture,tip,width,wing
447	wfo-0001031202	success	198	167	152	46	15	0.768	.1,0-0.5,0-1,0.5,0.5-1,0.8-1,1-1.5,1-1.7,1-5,1.5-2.5,2-3,2-8,2.5-3.5,2.5-4,2/3,3.5-4,6-25,9-11,accrescent,along,anther,anthesi,apart,apiculate,axi,bark,base,beneath,berry,broadly,bud,calyx,capitate,cm,completely,complex,condition,corky,corolla,cup-shaped,decurrent,deltoid,densely,dia,difoliate,distal,dry,enclosed,erect,exserted,extremely,filament,fleshy,flower,free,fruit,fruiting,furcate,glabrate,glabrous,globose,golden,green,greenish-white,hard,inflorescence,irregularly,large,later,lateral,leaf,live,lobe,lobed,long,long-ellipsoid,long-styled,longer,main,many,margin,material,middle,minute,minutely,mm,obovate,occasional,occasionally,often,older,opposite,ovary,overtopping,ovoid-reniform,pair,pale,paler,papillose,pedicel,petiole,pitted,planar,plant,pore,poricidal,prominent,puberulent,pubescent,quite,raised,reddish-brown,scar,scattered,shape,shaped,shoot,short-styled,shrub,slightly,small,spaced,specimen,stem,stigma,style,surface,tall,tan,tear-drop,terminal,thick,thickened,third,time,tip,tree,trichome,tube,uniseriate,unit,usually,variable,vein,way,white,whitish,widest,winged,woody,x,young	.5,0.1-0.3,0.6-1.1,1.5-2,1.5-9,15-40,2.5-13,20-100-flowered,9-20,abrupt,acute,apex,cordate,deflexed,differing,due,eaf,edicel,eed,frui,geminat,greyi,like,lon,lower,major,minor,narrowing,nflorescence,one,orbicular,papillo,portion,rounded,ruit,sessile,size,slender,sparsely,straight,tapering,thicker,tub,ud,weight,ympodial	cell,color,diameter,geminate,greyish,habitat,height,length,position,primary,seed,stone,structure,sympodial,texture
448	wfo-0001031207	success	219	196	167	52	29	0.763	-0.4,-1/2,-11,-4,-5,-7,.1,/5,0,0-10,0.1-0.2,0.1-0.3,0.1-0.5,0.2,0.2-0.3,0.25-0.5,0.3-0.5,0.5-1,0.6-1.2,0.7-2,0.8,0.85-1.4,0.9-1.6,1,1-4,1-5,1.4-2,1.5-5,1/3-equal,1/4-1/3,2-3,2-4,2.5-,3-5,5-8,6-8,6.5-8,9,abaxially,acute,ame,anther,apart,apex,apically,apparently,bark,base,berry,blade,branched,bristle,bristly,c.,calyx,cell,cm,cordate,curved,dark,densely,diameter,difoliate,dull,elongated,evenly,filament,filiform,flattened-reniform,flower,free,fruit,fruiting,gently,glabrescent,glabrous,gray,green,herb,herbaceous,lanceolate,lateral,leaf,length,less,like,lobe,lobed,long,longer,lower,margin,mature,maturity,mauve,midpoint,mm,moderately,multangulate,narrow-deltate,oblong,obtuse,occasionally,older,one,open,orange-brown,outline,ovate,pair,pale,pedicel,pendulous,perpendicular,persistent,petiole,pit,poricidal,porrect,prickle,prickly,primary,raised,ray,red,reflexed,rounded,scandent,scar,sessile,shorter,shrub,simple,small,smooth,sometimes,spaced,spherical,spreading,stalk,stalked,stellate,stellate-pubescent,stem,straight,style,surface,tapering,terete,terminal,time,tip,toward,trichome,tube,unarmed,unit,upper,usually,variously,vein,visible,way,white,wide,yellow,young	-8,0-0.5,0-20,0.6-0.9,1-3,1/,1/3,2.1-2.3,2.8-3,3.5-7,5-merous,acuminat,alyx,apar,articulated,broad-deltate,brow,chartaceous,concolorous,discolorous,distance,drying,eaf,eed,elongating,equal,erect,extending,eye,geminat,infructescence,midvein,naked,nflorescence,orolla,oung,peduncle,per,perfec,pericarp,portion,prickl,ruit,side,subentire,tamen,tertiary,vary,venation,weakly,yellow-green,ympodial	1/4,acuminate,anthesi,brown,bud,color,corolla,count,geminate,growth,habitat,height,inflorescence,major,minor,new,null,ovary,position,seed,shape,size,stigma,stone,structure,sympodial,texture,width,wing
449	wfo-0001031218	success	154	137	94	60	43	0.61	0.5,0.5-1,1-2,1-3,1-4,2-22,2-3,3,4-28,4-8,40-100+,5-37,6-7,8-20,abaxially,acuminate,acute,adaxially,aggregate,apex,apiculate,basal,base,beyond,blade,branched,calyx,cell,cm,connivent,cordate,coriaceous,dark,densely,diameter,eglandular,eglandular-pilose,ellipsoidal,especially,exserted,flattened,flower,fruit,glabrous,glandular,glandular-puberulent,globose,greenish-purple,hair,lanceolate,lavender,less,lobe,long,margin,minutely,mm,moderately,mottled,narrowly,oblique,obtuse,orange,ovate,ovate-elliptic,ovoid,pedicel,petiole,present,puberulent,pubescent,purple,ripe,shorter,simple,slightly,small,sometimes,sparsely,stamen,stellate,stigma,stone,style,succulent,tip,toward,tree,triangular,tube,unit,violet,x,yellow	-5,10-19,15-25,2-2.5,2.5-3,3-14,3-5,4-5,4-7,4-foliat,40,5-7,5.5-7,6-10,6-9,8-17,apart,ape,articulated,axe,connective,cylindrical,directed,distally,eaf,eed,entire,equal,exceeding,glabrou,introrse,leaving,lon,lower,nflorescence,nther,orolla,papillo,pedicellar,peduncle,perfect,pore,presen,purpl,rachi,radiu,remnant,ruit,spaced,subcoriaceous,tal,tem,thecae,time,tomento,truncat,ud,vary,wide,ympodial	4-foliate,anther,anthesi,bark,bud,color,corolla,count,filament,free,fruiting,growth,habitat,height,inflorescence,lateral,leaf,length,major,mentioned,minor,new,ovary,papillose,position,prickle,primary,scar,seed,shape,size,stem,structure,surface,sympodial,tall,texture,tomentose,truncate,vein,width,wing,young
450	wfo-0001031225	success	163	169	147	16	22	0.902	.25,.5,/3,0.1-0.75,0.2,0.2-0.75,0.5,0.5-1,0.7-6,0.75-1,0.8-1,1-1.5,1-1.7,1-3,1-5,1.5-5,2,2.5-3,3-9,3/4,5-50-flowered,5-6,6-8,7-9,9-16,acute,along,anther,anthesi,apart,apex,bark,base,beginning,berry,broadly,bud,calyx,characteristic,closely,cm,conspicuous,corolla,cup-shaped,decurrent,deltoid,dia,differentiated,differing,difoliate,dry,ellipsoid,elliptic,erect,exserted,filament,fragrant,free,fruiting,furcate,glabrate,glabrous,globose,green,growth,inflorescence,lateral,leaf,less,like,live,lobe,lobed,long,main,major,margin,middle,minor,minute,minutely,mm,much,narrowly,often,older,one,opposite,outline,ovary,ovate,ovoid-reniform,pair,pale,papillose,pedicel,petiole,pitted,plant,pore,poricidal,portion,proximal,pubescent,raised,red-papillose,reflexed,rest,rhomboidal,rounded,scar,shape,shaped,shrub,size,slender,slightly,small,soon,spaced,specimen,stem,stigma,straight,strongly,style,surface,sweetly,swelling,tall,tan,tapering,tear-drop,tip,tree,trichome,tube,unevenly,uniseriate,unit,vein,way,white,widest,woody,x,young	darker,eaf,edicel,eed,flattene,geminat,greyish-brow,inflorescenc,lon,lower,nflorescence,papillo,prominent,ruit,ud,ympodial	cell,color,count,diameter,flattened,flower,fruit,geminate,greyish-brown,habitat,length,null,position,prickle,primary,seed,stone,structure,sympodial,texture,width,wing
451	wfo-0001031231	success	175	161	125	50	36	0.714	-2,.5,0.5-1.5,1-2,1-3,1.5-2,13,2-3,37/2,37/3,4-8,5-7,8-10,80-110,acumen,acuminate,acute,adherent,along,anther,anthesi,apex,aromatic,axi,axillary,base,becoming,berry,beyond,blunt,branch,branched,brown,calyx,campanula,campanulate,cell,cluster,cm,corolla,dark,declinate,developed,dia,discoidal,ellipsoid,erect,exceeding,except,expanded,facetted,filament,fleshy,flower,flowering,folded,fork,glabrous,glandular,globose,green,greyish,hair,herbarium,interacuminal,juvenile,lasting,leaf,len,less,lobe,long,loosely,marbled,margin,mauve,midrib,minute,mm,oblong,occasionally,often,ovary,pedicel,pedicellate,petal,pinnatisect,plant,projecting,purple,rh,ripe,ripening,rounded,rugose-ruminate,seed,sessile,several,shrub,simple,slightly,small,soft,sometimes,specimen,stigma,stone,stout,style,succulent,surface,tinged,tip,tissue,toward,translucent,unit,usually,variable,vigorous,violet,well,wooded,x,year	1-1.5,1-4,2-4,2.5-3,25-35,3-4,absent,almost,aspect,basal,bluntly,clonal,colour,eaf,eed,elliptic,entire,equal,exerted,general,gree,habit,lanceolate,lengthening,lon,lower,mature,nflorescence,pedice,peduncle,pentagonal,plurifoliat,pore,poricidal,rarely,readily,recurve,rotate,ruit,shallow,shed,short,sinus,slit,stonrgly,triangular,tub,ud,without,ympodial	bark,bud,color,count,diameter,free,fruit,fruiting,growth,habitat,height,inflorescence,lateral,length,major,mentioned,minor,new,petiole,plurifoliate,position,prickle,primary,recurved,scar,shape,size,stem,structure,sympodial,texture,tube,vein,width,wing,young
452	wfo-0001031252	success	170	139	102	68	37	0.6	0.2-1.5,0.3-1.1,1-2,1-3,1.3-1.9,12-20,2-3,2.5-7,2.8-3.6,3-10,5-17,5-8,5-9,abaxially,acumen,acute,adaxially,anther,apex,attenuate,axillary,base,berry,blade,brownish,bud,cell,clavate,cm,condition,connivent,coriaceous,corolla,covering,cuneate,dark,deep,diameter,distal,dorsally,drying,edge,elliptic,filament,flat,flower,folded,forked,fresh,fruit,generally,glabrous,globose,green,green-white,greenish,half,herb,lanceolate,lateral,light,linear,lobe,long,make,margin,medium,mm,mottled,mucilaginous,ovate,ovoid,pedicel,petiole,plant,plurifoliate,purple,ripe,rounded,seed,simple,sometimes,stigma,stripe,style,subtending,tall,terminal,testal,thick,throughout,tip,tri-,tube,unit,unwinged,usually,wall,wet,white,whitish,x	0.4-3,1.75-5.2,16-33,3-5,3-6,5-merou,5.5-6.5,7-18,absent,adaxiall,ag,along,alyx,apart,apparently,arranged,articulated,axe,bead,capitat,ciliate,digestion,eaf,eed,entire,enzyme,erec,exceeding,geminat,glabrou,hair-like,hal,high,homostylous,honeycomb-shaped,interjected,leaflet,lengthening,like,living,lower,moniliform,multiple,necklace,nflorescence,orolla,peduncle,perfect,pore,poricidal,removed,rotate,ruit,serrate,seudostipule,slit,spaced,specimen,stamen,stolon,straight,tamen,tem,tuber,typically,vary,yellow,ympodial	'hair-like,anthesi,bark,calyx,capitate,color,count,free,fruiting,geminate,growth,habitat,height,inflorescence,leaf,length,major,mentioned,minor,new,ovary,position,prickle,primary,scar,shape,size,stem,stone,structure,surface,sympodial,texture,vein,width,wing,young
453	wfo-0001031257	success	206	176	144	62	32	0.699	-12,-22.5,-5,-6,0,0.5-0.8,0.7-1,0.75-2.5,1-1.2,1-1.3,1.1-1.2,1.5-1.7,1.5-2,10-16,11.5-15,2-,2-4.5,3.5-,3.5-5.7,4-4.5,4.5-,5,5-8.5,6-12,6-celled,7-,7.5-9,8,abaxially,abundant,acuminate,adaxially,aggregate,anther,anthesi,antrorse,apex,attenuate,basal,base,berry,blue-violet,bud,calyx,cell,cm,connectival,corolla,cotyledon,cuneate,curved,dark,densely,diameter,difoliate,dorsally,edentate,ellipsoidal,embryo,endosperm,epidermal,erect,filament,finely,flexuous,foliage,free,fruiting,glabrous,glandular,globose,hair-like,herb,hollow,honey-combed,inconspicuous,inserted,lamina,lateral,leaf,length,light,like,little,lobe,long,long-stalked,longer,longitudinally,many-seeded,margin,midvein,mm,narrowly,non-glandular,odorles,ovate,papillate,patent,petiole,prolongation,pubescent,purple,rarely,reduced,rest,ridged,ring,robust,scarce,secondary,short-stalked,shorter,shrub,simple,slightly,small,solitary,somewhat,spur-like,stem,stigma,stone,strand,striate,style,subglobose,thickened,thickening,tip,trans-ovoidal,triangular,trichome,tube,unit,vein,ventrifixed,verrucate,viscid,wall,white,within,x,yellow	0.4,0.5,1.5,1/10,3,4-10,5-,8-celled,accrescen,ag,ascending,bicellular,branch,broad,campanulate,coarsely,coat,cuticle,deep,dentate,diamete,directed,eaf,eed,elliptical,geminat,half,head,herbaceous,high,lon,longitudinal,lower,opening,orolla,outward,pair,pericarp,pore,poricidal,portion,ree,ruit,saddle-shape,scarcely,seed,separated,serrate,single-celled,sinus,slit,smooth,stalk,tem,thecae,time,tooth,unequal,upward,vary,viscid-pubescen,ympodial	accrescent,bark,color,count,flower,fruit,geminate,growth,habitat,height,inflorescence,major,minor,new,null,ovary,pedicel,position,prickle,primary,saddle-shaped,scar,shape,size,structure,surface,sympodial,texture,viscid-pubescent,width,wing,young
454	wfo-0001031270	success	234	185	160	74	25	0.684	+,0.4-1.5,0.5-1,1,1-1.2,1-4,1.5,1.5-2,10,10-12,2-3,2-7,3-10,3-20,3-5,4-5,5,5-10,5-15,5-6,6-17,6-50,7-12,9-10,abaxially,acute,anther,anthesi,apex,associated,bark,base,berry,bipinnatifid,blade,bright,brown,c.,calyx,capitate,cell,celled,clavate,cm,colored,conical,curved,densely,depressed-spherical,diameter,differentiated,difoliate,directed,elliptic,erect,few-rayed,filament,flower,free,fruiting,glabrous,gland,glandular,glandular-pubescent,green,growth,heavily,herb,inflorescence,later,lateral,leaf,leaf-opposed,leafy,length,like,live,lobe,long,long-styled,margin,midpoint,minute,minutely,mixture,mm,multangulate,multiseriate,narrowly,new,obovate,often,older,outline,ovoid,pair,pedicel,petiole,pinnatifid,pitted,plant,pore,poricidal,prickle,prickly,primary,pubescent,ray,red,reddish,reflexed,reniform,rest,ripe,rounded,scar,scattered,sessile,shallowly,short-stalked,short-styled,shrub,simple,single,sinuate,size,slightly,small,sparsely,spherical,spreading,stalk,stellate,stem,stigma,straight,straw-colored,style,surface,tall,tapering,terete,testal,tip,trichome,truncate,tube,uniseriate,unit,upward,usually,varying,vein,well,white,wice,wide,wing,woody,yellow	.5,1-3,1.2-1.6,1/3,100,2-2.5,2-20,2-4,2.5-3,5-merous,8,>,abaxial,accrescent,adaxial,adaxiall,along,alyx,apart,arme,articulated,basal,beginning,brow,connivent,consistently,deeply,distal,eed,ellipti,entire,equal,frui,geminat,heterostylous,infructescence,investing,lobed,lon,longer,loosely,lower,membranous,midvein,nflorescence,occasionally,orolla,oung,pale,papillo,peduncle,per,pericarp,portion,rachi,ruit,secondary,shallow,shining,slender,staminat,strongly,tamen,tan,thin,thus,tightly,tissue,vary,way,wid,yellowish,ympodial,Â½	adaxially,armed,bud,color,corolla,count,description,fruit,geminate,habitat,height,major,mentioned,minor,ovary,papillose,position,seed,shape,stone,structure,sympodial,texture,width,young
455	wfo-0001031283	success	52	92	48	4	44	0.923	-0.25,.7-2.3,0.1-0.15,0.4-0.5,0.5-0.7,0.7,2.2-2.8,30-40,acute,apex,appearance,base,brown,calyx,cell,cm,diameter,eed,elongating,erect,fruit,give,hair-like,lateral,lo,lobe,long,markedly,mm,narrowly,obovate,outgrowth,pale,pubescent,shrub,silky,small,somewhat,sprawling,spreadin,surface,tall,testa,thick,wall,wide,winged,woody	fide,moore,pleasant,smelling	anther,anthesi,ba,bark,bud,color,corolla,count,filament,flower,free,fruiting,growth,habitat,height,inflorescence,leaf,length,margin,mentioned,new,ovary,pedicel,petiole,position,prickle,primary,scar,shape,spreading,stem,stigma,stone,structure,style,sympodial,texture,tip,tube,unit,vein,width,wing,young
456	wfo-0001031287	success	147	158	130	17	28	0.884	.5,0.5-1.5,0.9-1,1,1-1.2,1-1.3,1-1.5,1-5,1.5-2,1.5-5.5,2-2.5,3-4,3-5,4-5,4-6,4.5-5,5-14,6-10-flowered,6-7,acute,adaxially,anther,anthesi,apex,attenuate,axil,bark,base,bearing,berry,bi-lobed,branch,calyx,cm,conical,connective,coriaceous,corolla,dark,deflexed,deltate,dendritic,densely,dia,difoliate,divergently,ellipsoid,elliptic,elongate,enlarged,erect,exserted,filament,fleshy,free,fruiting,geminate,glabrous,globose,green,greenish-white,internodal,knob,later,lateral,leaf,lobe,lobed,long,main,many,margin,membranous,middle,minutely,mm,nearly,occasionally,older,onto,ovary,ovoid-reniform,pair,pale,papillose,pedicel,petiole,pitted,planar,plurifoliate,pointed,pore,poricidal,portion,pubescent,red-papillose,reflexed,rounded,scar,shaped,shoot,short,shrub,simple,sinus,small,somewhat,spaced,stem,stigma,strongly,style,surface,tan,tear-drop,thick,thin,tip,trichome,tube,tuft,unevenly,unit,vein,white,widest,winged,woody,x,young	abaxially,apar,ape,eaf,edicel,eed,frui,lamina,lon,lower,nflorescence,papillo,reddish-brow,ruit,tub,ud,ympodial	apart,bud,cell,color,count,diameter,flower,fruit,habitat,height,inflorescence,length,major,minor,null,position,prickle,primary,reddish-brown,seed,shape,size,stone,structure,sympodial,texture,width,wing
457	wfo-0001031300	success	219	140	115	104	25	0.525	-4,-5,-6,.5,/4,0.2-0.4,0.2-0.5,0.3,0.5-0.9,0.5-2,0.7-0.9,0.8-1.5,1-2,1-4,1.2-1.7,1.5-3.5,1/3-1/2,1/6-1/4,10-30,2-3,2-4,2-6,3-4,5-15,6-8,abaxially,anther,apart,apex,apparently,bark,base,blade,branched,calyx,cell,cm,connivent,creeping,curved,deltate,densely,diameter,difoliate,dull,elongating,filament,filiform,flattened,flattened-reniform,flower,free,fruit,fruiting,glabrescent,glabrous,herbaceous,lateral,leaf,length,lobe,lobed,long,margin,mature,maturity,mm,moderately,near,oblanceolate,one,open,orange,orange-green,outline,pair,pale,pedicel,petiole,pit,poricidal,porrect,prickle,prickly,primary,pubescent,raised,red,scar,shrub,small,spaced,sparsely,spherical,spreading,stellate,stellate-pubescent,stem,style,surface,tapering,terete,time,tip,trichome,tube,uniradiate,unit,vein,way,weakly,white,wide,winged,yellow-orange	-2.2,0-15,0-20,0-3,0-8,0.1,0.1-0.5,0.1-0.6,0.15-0.7,0.2-0.7,0.2-1,0.3-0.6,0.3-1.3,0.5-1.5,0.5-18,0.6-0.8,0.6-1,0.6-1.2,0.7-1.2,1-5,1.3-2,1/2-3/4,2-,2-5.5,2.2-2.3,2.2-2.7,2.5-3.2,3-,4,4.5-6,5-merous,absent,acute,also,alyx,apar,apically,articulated,attenuate,ba,berry,brow,brown-green,bulbous,caudat,chartaceous,concolorous,distance,drying,eaf,eed,equal,erect,extending,eye,geminat,geniculate,gray-green,hair,highly,infructescence,lon,longer,lower,membranous,midpoint,midvein,minute,naked,nflorescence,oblong,obtuse,older,orange-brown,orolla,oung,peduncle,pendulous,per,perfec,pericarp,portion,prickl,rarely,ray,reduced,rounded,ruit,sessile,side,simple,smooth,stalk,stalked,tamen,tertiary,thin,vary,venation,visible,wider,yellow,yellow-green,ympodial	anthesi,brown,bud,color,corolla,count,geminate,growth,habitat,height,inflorescence,new,null,ovary,position,seed,shape,stigma,stone,structure,sympodial,texture,width,wing,young
458	wfo-0001031310	success	203	128	95	108	33	0.468	1-2,1-3,1.5-4,15-40,3-10,4-10,5-6,abaxially,acuminate,adaxially,along,anther,axillary,berry,blue,blue-purple,brown,bud,cell,ciliate,cm,connivent,conspicuously,corolla,covering,decurrent,diameter,distal,especially,filament,flower,forked,fruit,generally,glabrous,globose,green,green-white,hair,half,herb,lanceolate,lateral,leaf,less,light,like,lobe,make,margin,midrib,minutely,mm,mucilaginous,multicellular,odd-pinnate,ovate-lanceolate,ovoid,pale,pedicel,petiole,pilose,plant,plurifoliate,puberulent,pubescent,rachi,rosette-forming,rotate,seed,shortly,simple,sometimes,somewhat,sparsely,stem,stigma,streak,style,subrosette-forming,subtending,tall,terminal,testal,thick,throughout,tip,tri-,tube,unit,usually,wall,wet,white,x	.5,0-3,0-4,0.5-3,1-10,1-5.5,1-6,2-3,2.5-5.5,2.5-8.5,4-12,4.5-4.8,5-7,5-merou,5.5-21,6-7,absent,acumen,ag,alyx,apart,apex,apparently,articulated,attenuate,axe,base,blade,borne,broadly,brownish,caly,chartaceous,condition,cuneate,decreasing,digestion,dorsally,drying,eaf,edge,eed,elliptic,end,enzyme,erect-decumben,exceeding,extremely,flat,folded,fresh,geminat,glabrou,gradually,greenish,hair-like,high,homostylous,honeycomb-shaped,interjected,larger,leaflet,lengthening,living,long,lower,membranous,mottled,narrowly,nflorescence,obtuse,orolla,ovate,ovate-elliptic,pair,peduncle,perfect,petiolule,pointed,pore,poricidal,purple,removed,ruit,seudostipule,singly,size,slightly,slit,small,spaced,specimen,stamen,ste,stolo,straight,subellipsoi,tamen,tem,tissue,toward,tuber,typically,unwinged,vary,whitish,yellow,ympodial	'hair-like,anthesi,bark,calyx,color,count,erect-decumbent,free,fruiting,geminate,growth,habitat,height,inflorescence,length,new,null,ovary,position,prickle,primary,scar,shape,stone,structure,subellipsoid,surface,sympodial,texture,vein,width,wing,young
459	wfo-0001031316	success	207	175	147	60	28	0.71	-2,.1,/3,0.05-0.1,0.05-0.15,0.1-0.2,0.3-1,0.4-0.6,0.4-0.8,0.5-2,0.6-1,0.8-1.8,0.9-1.3,1-5,1.2-2.1,1.5-2,1.5-3.5,1.5-5,1/3-1/2,1/3-2/3,2-3,3-10,3-8,4,4-9,5-15,5-6,5-8,6-20,8-11,8-12,8-25,abaxially,almost,ame,anther,apically,apparently,bark,base,becoming,berry,blade,blue-mauve,branched,bright,broad,c.,calyx,cm,connivent,cream,curved,dark,densely,diameter,difoliate,dull,elongating,erect,fifth,filament,flattened-reniform,flower,four,free,fruit,fruiting,glabrescent,glabrous,gray,green,hair,held,herbaceous,inward,lateral,leaf,length,lobe,lobed,long,lowermost,margin,marking,mature,maturity,midpoint,minute,mm,moderately,multangulate,narrow-deltate,older,one,open,orange,orange-brown,ovate,pair,pale,pedicel,pendulous,petiole,poricidal,porrect,portion,primary,purple,ray,red-brown,reflexed,scar,sessile,shrub,simple,slender,sometimes,spaced,sparsely,spherical,spreading,stalk,stalked,stellate,stellate-pubescent,stem,strongly,style,surface,tapering,terete,terminal,time,tip,trichome,tube,unarmed,unequal,unit,variously,vein,way,white,wide,yellow,young	0.8-1.2,1.3-3.5,1.5-,2-20,2-4,2.5-8,3.5-3.8,3.8-5,4-7,5-10,5-merous,abaxial,acuminate,acute,adaxial,alyx,apar,apex,articulated,colored,concolorous,contrast,discolorous,drying,eaf,eed,entire,eye,foliaceou,geminat,glabrou,infructescence,long-acuminat,longer,lower,membranous,naked,nflorescence,obtuse,orolla,oung,peduncle,per,perfec,pericarp,red-brow,ruit,smooth,stellate-pubescen,tamen,tertiary,unarme,usually,vary,venation,visible,white-green,whitish,yellow-green,ympodial	anthesi,apart,bud,cell,color,corolla,count,foliaceous,geminate,growth,habitat,height,inflorescence,long-acuminate,new,null,ovary,position,prickle,seed,shape,stigma,stone,structure,sympodial,texture,width,wing
460	wfo-0001031333	success	194	172	143	51	29	0.737	+,.5,0.1-0.5,0.5,1-1.5,1-4,1-5,1.2-2,1.5,1.5-1.7,1.5-2,1/2,2,2-3,2.5-3,2.7-7,3/4,30-40,5-7,5-8,50,7-10,7-9,<,>,?,abaxially,adaxially,adjacent,almost,anther,anthesi,apart,appearing,base,berry,bilobed,branched,broadly,brown,calyx,capitate,cell,clustered,cm,collection,composed,conical,cupped,densely,denser,diameter,ellipsoidal,elliptic,exserted,filament,flattened,flower,free,fruting,glabrescent,glabrous,globose,golden,green,greenish,growth,half,immature,inflorescence,lamina,less,like,lobe,lobed,long,lower,many,margin,mere,minute,minutely,mm,narrowly,near,new,occasionally,outline,ovate,pair,pale,pedicel,per,petiole,pitted,planar,poricidal,primary,pubescent,pubescent-papillate,quadrate,reniform,rest,scar,simple,sinus,slightly,somewhat,soon,sparsely,splitting,stem,stigma,striped,strongly,style,surface,tangled,terminal,testal,thickened,time,tip,trailing,triangular,trichome,tube,twining,undulation,unequal,unevenly,uniseriate,unit,vein,venation,vine,way,white,whitish,woody,x,yellow,yellowish	3-4,5-merou,acuminate,acute,adaxiall,ag,alyx,apex,ark,articulated,branche,crea,eaf,eed,entire,glabrescen,high,ilament,leaving,lengthening,m.,matte,membranous,nflorescence,nodding,older,orolla,papillat,peduncle,peg,penden,pentagonal,perfect,pericarp,plurifoliat,pore,portion,rhachi,ruit,slit,small,ste,stellate,tem,thin,truncate,ud,undersurface,upper,vary,ympodial	bark,branch,bud,color,corolla,count,cream,fruit,fruiting,habitat,height,leaf,length,null,ovary,papillate,pendent,plurifoliate,position,prickle,seed,shape,stone,structure,sympodial,texture,width,wing,young
461	wfo-0001031333	success	194	141	116	78	25	0.598	0.5,1-1.5,1-4,1-5-2,1.5-1.7,1.5-2,2,2-3,2.5-3,30-40,5-7,5-8,7-10,7-9,<,?,abaxially,adaxially,adjacent,almost,anther,anthesi,bark,berry,bilobed,branched,broadly,brown,calyx,capitate,cell,cm,composed,conical,corolla,cream,cupped,densely,denser,diameter,ellipsoid,elliptic,filament,flattened,flower,free,fruiting,glabrescent,glabrous,globose,golden,green,greenish,growth,half,immature,inflorescence,lamina,less,like,lobe,long,lower,many,margin,mere,minute,minutely,mm,narrowly,new,occasionally,outline,ovate,pair,pale,pedicel,petiole,pitted,planar,primary,pubescent,pubescent-papillate,quadrate,reniform,rest,scar,simple,sinus,slightly,somewhat,soon,sparsely,splitting,stem,stigma,style,surface,terminal,time,tip,trailing,triangular,trichome,tube,undulation,unevenly,uniseriate,unit,vein,vine,white,whitish,wide,woody,yellowish	+,.5,0.1-0.5,1-5,1.5,1/2,2.7-7,3,3-4,3/4,5-merou,50,>,acuminate,acute,adaxiall,ag,alyx,apart,apex,appearing,articulated,base,branche,clustered,eaf,eed,entire,exserted,glabrescen,high,ilament,leaving,lengthening,lobed,m.,matte,membranous,near,nflorescence,nodding,older,orolla,papillat,peduncle,peg,penden,per,perfect,pericarp,plurifoliat,pore,poricidal,portion,rhachi,rotate-stellate,ruit,slit,small,spaced,stellate,striped,strongly,tangled,testal,thickened,thin,truncate,tub,twinin,ud,undersurface,unequal,upper,vary,venation,way,ympodial	bud,color,count,fruit,habitat,height,leaf,length,mentioned,ovary,papillate,pendent,plurifoliate,position,prickle,seed,shape,stone,structure,sympodial,texture,twining,width,wing,young
462	wfo-0001031359	success	166	153	127	39	26	0.765	.25,.5,/4,0.5-1,0.5-6,0.75-1,1-4,1.2-1.6,1.2-2.5,1.3-1.6,1.5-2,1.6-2.8,1.9-2.3,12-21,3-3.5,3.6-8.8,5-30-flowered,5-7,5-angled,5.3-7.5,6-7,acuminate,anther,anthesi,apart,apex,apiculate,attenuate,axil,bark,base,beginning,beneath,berry,bi-lobed,broadly,brown,calyx,cm,corolla,curled,dark,deflexed,difoliate,distal,dull,elliptic,evenly,filament,free,fruiting,glabrous,globose,green,internodal,interpetalar,lamina,lateral,leaf,live,lobe,lobed,long,main,major,margin,membraneous,middle,minor,minutely,mm,narrowly,near,obovoid,occasionally,often,older,opposite,originating,ovary,pair,papillae,papillose,pedicel,petiole,pitted,planar,plant,pore,poricidal,portion,reflexed,ripe,rusty,scar,shaped,shiny,shrub,simple,sinus,size,slightly,somewhat,spaced,stem,stigma,straight,style,surface,tall,tear-drop,tip,triangular,trichome,tube,tuft,undulate,uniseriate,unit,vein,way,white,widest,woody,x,yellow-orange,young	.02,1.1-1.6,2.5-3,angle,appearing,ba,dia,differing,dried,eaf,edicel,eed,extending,flattened-reniform,geminat,incrassate,inflorescenc,lon,lower,nearly,nflorescence,one,outline,paler,papillo,pit,ridged,round,ruit,slender,specimen,strongly,tan,tapering,tub,ud,white-lenticellat,yellow,ympodial	bud,cell,color,count,diameter,flower,fruit,geminate,habitat,height,inflorescence,length,null,persistent,position,prickle,primary,seed,shape,stone,structure,sympodial,texture,white-lenticellate,width,wing
463	wfo-0001031362	success	138	123	93	45	30	0.674	.2,.5,0.4-0.5,0.5-1,1-1.1,1-1.5,1-3,2-2.5,3-4,3-6,?,acute,anther,anthesi,apex,attenuate,bark,base,brown,calyx,cell,closely,cm,conical,corolla,dendritic,densely,ellipsoid,filament,flattened,flattened-reniform,free,fruiting,glabrous,globose,golden,incrassate,internodal,lanceolate,lateral,leaf,lobe,lobed,long,long-triangular,main,margin,minutely,mm,nearly,nodding,older,opposite,orange-red,outline,ovary,pair,papillose,pedicel,petiole,pitted,planar,pore,poricidal,pubescent,pubesent,rectangular,red,rounded,scar,shaped,shrub,simple,slender,small-capitate,somewhat,spaced,sparsely,stem,stigma,style,subshrub,surface,tear-drop,tip,trichome,tube,unit,vein,white,woody,x,young	.3,0.7-1,1-3-flowered,1-4,1.5-2,abaxially,adaxially,along,appearance,berry,branch,bushy,denser,dia,eaf,edicel,eed,erect,exceeding,exserted,giving,golden-brow,inflorescenc,lamina,like,lon,lower,middle,nflorescence,overlappin,packed,pale,papillo,pericarp,plurifoliat,portion,rest,ruit,shiny,straight,tan,thin,ud,widest,ympodial	bud,color,count,diameter,flower,fruit,golden-brown,growth,habitat,height,inflorescence,length,major,mentioned,minor,new,overlapping,plurifoliate,position,prickle,primary,seed,shape,size,stone,structure,sympodial,texture,width,wing
464	wfo-0001031400	success	161	156	119	42	37	0.739	0.25-0.8,0.4-1.7,0.7-6,0.8-1.1,1,1-4,1.2-2,1.5-5,10-11,2,2-3,2-5,2-9,4-,4-17,4-6.5,4-7,5-12.5,7-25,abaxial,abaxially,acumen,acute,adaxially,apex,apical,apically,apiculate,articulate,base,branched,calyx,cell,cm,connate,corolla,covering,cuneate,cyme,dark,decurrent,deeply,dehiscent,diameter,dichasial,dichasially,distal,dorsally,ebracteate,edge,exceeding,filament,flat,flower,folded,forked,forming,generally,globose,green,half,herbaceous,introrse,lateral,leaf,leaflet,linear,linear-lanceolate,lobe,long,make,maturing,mm,monochasial,mucilaginous,oblique,oblong,occasionally,odd-pinnate,often,ovoid,pedicel,peduncle,perennial,petiole,plant,poricidally,proximal,puberulent,rachi,seed,sessile,short,side,size,slit,stamen,stellate,stigma,straight,stripe,structure,style,subglabrous,testal,thick,tip,tone,trilobe,tuber-bearing,typically,unit,violet,wall,white,wide,without,yellow,Â¼	-3,0.6-1.8,1-,3-6-foliat,4-13,6-23,7-28,abruptly,absen,digestion,diminishing,eaf,eed,emoval,enzyme,globo,green-white,hair-like,honeycomb,interjected,living,lon,lower,lunat,nflorescence,nther,orolla,pair,pattern,perfect,plan,reveal,ruit,seudostipule,specimen,tal,tem,terminal,throughout,toward,vary,ympodial	'hair-like,3-6-foliate,anther,anthesi,bark,bud,color,count,free,fruit,fruiting,habitat,height,inflorescence,length,major,margin,mentioned,minor,ovary,position,prickle,primary,scar,shape,stem,stone,surface,sympodial,tall,texture,tube,vein,wet,width,wing,young
465	wfo-0001031401	success	182	167	144	38	23	0.791	0.5,0.6-1.2,0.8-1.2,1,1-1.4,1-1.5,1-6,1.5-2,1/2,2-2.4,2-5,2.5-4,3,3.5-4,3/4,5,5-7,7-9,8-10,abaxially,adaxially,age,along,anther,anthesi,appearing,bark,base,becoming,berry,bi-lobed,black,branch,branching,brown,calyx,clearly,cm,conical,corolla,dark,deciduous,deflexed,deltoid,dendritic,densely,denser,diameter,dichasial,differentiated,drying,ecuador,elliptic,filament,flattened,flower,fork,free,fruit,fruiting,glabrous,globose,golden,golden-yellow,growth,impressed,lateral,leaf,lenticular,less,lobe,lobed,long,long-triangular,matted,mesophyll,minutely,mm,narrowly,new,nodding,node,occasionally,often,older,outline,ovary,overtopping,pair,pedicel,per,pericarp,petiole,pitted,planar,plurifoliate,pore,poricidal,prominently,puberulent,pubescent,purplish-black,pyramidal,raised,reddish-brown,roundish,scar,secondary,shiny,shoot,short,shrub,slit-like,small,sometimes,somewhat,sparsely,stem,stigma,strongly,style,surface,tall,terminal,thin,time,tip,tree,tree-like,trichome,tube,unit,usually,vein,violet,visible,way,white,wide,winged,woody,x,yellow,young	1.1-3,5-9,abaxial,acute,adaxial,apex,apical,attenuate,axi,basal,blade,eaf,ecuadorian,edicel,eed,ew,exserted,finely,inserted,lower,m.,monochasia,near,nflorescence,noddin,papillo,portion,pubescen,rounded,ruit,sleev,specimen,stamen,ste,tapering,tub,ud,ympodial	bud,cell,color,count,habitat,height,inflorescence,length,margin,monochasial,null,papillose,position,prickle,primary,seed,shape,stone,structure,sympodial,texture,width,wing
466	wfo-0001031480	success	237	218	190	47	28	0.802	-0.25,-2,/3,0,0-1,0-2,0-5,0.1,0.1-0.3,0.1-0.4,0.15-0.3,0.4,0.4-0.8,0.5-,0.5-2,0.6-0.8,0.7,0.8,0.8-1,1-1.3,1-1.5,1-2,1-3,1-4,1.5-2.2,1.8-3,1/2,1/3,1/6-1/5,2-3,2-5,2-6,3-10,3-6,3-7,3.5-7,4-5,4-6,5-8,6-13,7-8,8-12,abaxial,abaxially,acute,adaxial,anther,apart,apex,apically,apparently,bark,base,berry,blade,branched,branching,bright,broad-deltate,calyx,cell,cm,cream,cuneate,curved,dark,deltate,densely,diameter,difoliate,discolorous,drying,dull,ellipsoid,elongate,elongating,eye,faint,filament,flattened,flattened-reniform,flower,free,fruit,fruiting,glabrescent,glabrous,glandular,green,hair,inconspicuous,infructescence,lateral,leaf,length,lobe,lobed,long,long-styled,longer,lower,margin,marking,mature,maturity,mauve,midpoint,minutely,mm,moderately,naked,near,obtuse,often,older,one,open,orange-brown,outline,ovate,pair,pale,pedicel,pendulous,per,pericarp,persistent,petiole,pit,poricidal,porrect,prickle,prickly,primary,pubescent,purple,raised,ray,red,red-brown,red-green,red-yellow-green,reduced,reticulate,rounded,scandent,scar,sessile,shorter,shrub,simple,slender,slightly,small,smooth,somewhat,spaced,sparsely,spherical,spreading,stalk,stalked,stellate,stellate-pubescent,stem,straight,style,surface,tapering,terete,terminal,tertiary,thick-chartaceous,time,tip,trichome,truncate,tube,unarmed,unit,upper,variously,vein,venation,visible,way,wide,woody,yellow,young	0-0.5,0-30,0.2-0.35,1.7-2.2,1/4,2-,2-2.7,3,5-merous,6-30,6-8,acuminat,alyx,andromonoecious,apar,articulated,ba,distal,distance,eaf,eed,entire,equal,erect,extending,geminat,hermaphrodite,heterostylous,lowermost,midvein,nflorescence,orolla,oung,peduncle,plant,portion,red-brow,ruit,shallowly,short-styled,side,staminat,tamen,unarme,vary,weakly,ympodial	0.2-0.3,acuminate,anthesi,bud,color,corolla,count,geminate,growth,habitat,height,inflorescence,major,minor,new,null,ovary,position,seed,shape,size,stigma,stone,structure,sympodial,texture,width,wing
467	wfo-0001031483	success	154	145	116	38	29	0.753	.5,/2,0.5,0.5-2,1-2,1.1-2.5,1.2-1.4,1.7-5.5,11-20.5,2-2.5,2.5-3.2,3-8-flowered,6-10,7-10,acuminate,acute,almost,anew,anther,anthesi,apex,attenuate,base,beginning,beneath,berry,ca,calyx,clavate,cm,continuous,corky,corolla,decurrent,deflexed,deltoid,dia,difoliate,distal,dry,end,filament,filiform,flower,free,fresh,fruiting,fusiform,glabrous,green,indistinct,larger,lateral,leaf,lenticellate,linear,lobe,lobed,long,main,major,markedly,minor,minutely,mm,oblanceolate,obovate,obovoid,often,opposite,ovary,ovoid-reniform,pair,pale,paler,papillose,pedicel,petiole,planar,pointed,pore,poricidal,prominent,quite,raised,rounded,scar,shape,shaped,short-triangular,shrub,simple,slender,slightly,somewhat,stem,stigma,strongly,style,subshrub,tall,tan,tapering,tear-drop,tip,tube,turbinate,unit,variable,vein,way,white,wing,winged,woody,x	0,1,1/3,2-3,3-4,across,apart,ba,bearing,blade,caly,cork,eaf,edicel,eed,evenly,exserted,geminat,indistinc,internode,lea,less,lower,nflorescence,oblong,orbiculate,papillo,per,portion,ruit,short,soon,spaced,straight,third,ud,widest,ympodial	-4,bark,bud,cell,color,count,diameter,fruit,geminate,growth,habitat,height,inflorescence,length,margin,mentioned,new,position,prickle,primary,seed,size,stone,structure,surface,sympodial,texture,width,young
468	wfo-0001031492	success	175	157	131	44	26	0.749	.5,/4,0.5,0.7-1.3,0.9-1.1,08,1-1.5,1.3-2,1.5-1.8,10-15,2-10,2-3,2-5,20,3-5,4-10,6-8,8-11,abaxially,acuminate,acute,adaxially,age,anther,anthesi,apex,apical,appearing,attenuate,bark,basal,base,becoming,beneath,bi-lobed,branching,calyx,cm,conical,corolla,dark,dbh,decurrent,deltoid,dendritic,densely,denser,diameter,distinguishable,drying,dull,echinoid,elliptic,filament,flattened,flower,free,fruit,fruiting,glabrous,globose,golden,grey,growth,lamina,lateral,leaf,lenticular,lightly,lobe,lobed,long,medium,minutely,mm,narrowly,nodding,occasionally,older,ovary,overtopping,pair,pedicel,petiole,pitted,planar,plurifoliate,pore,poricidal,predominantly,pubescent,purplish-black,pyramidal,remaining,scar,scarcely,scattered,secondary,shiny,shoot,short,shrub,size,slightly,slit-like,sometimes,sparsely,stem,stigma,style,sunken,surface,tall,tapering,terminal,time,tip,tree,tree-like,trichome,tube,unit,upturned,vein,violet,way,winged,woody,x,young,younger	1-1.3,1.5-2.5,3-4,4-4.5,8-9,absent,axe,ba,berry,bitter,deciduous,eaf,edicel,eed,erect,ew,exserted,inserted,juice,lower,m.,monochasia,nflorescence,papillo,per,pericarp,portion,prominent,rather,reddish-brown,ruit,sleeve,somewhat,stamen,ste,sticky,strongly,thin,tub,ud,undersurface,upper,wide,ympodial	.9-1.1,bud,cell,color,count,habitat,height,inflorescence,length,major,margin,mentioned,minor,monochasial,new,position,prickle,primary,seed,shape,stone,structure,sympodial,texture,width,wing
469	wfo-0001031503	success	142	123	86	56	37	0.606	-10,-25,-30,-6,-7,0.3-3,0.5-1,0.5-4,1-,1.5-2,1.5-3,1.5-7,1.7-3.5,2-3,2.5-10,3-15,3-6,5613,7-10,abaxially,acute,adaxially,angled,apex,blade,branched,calyx,cell,chartaceous,cm,connivent,curled,deltate,densely,diameter,eglandular,elliptic,except,fide,flower,forked,glabrous,globose,hair,lanceolate,lobe,long,margin,mm,moderately,mostly,narrowly,obtuse,often,orange,ovate,pedicel,petiole,present,puberulent,pubescent,rarely,reddish,ripe,rugose-pubescent,simple,sparsely,stigma,stone,style,time,tip,toward,triangular,truncate,tube,unbranched,unequal,uniseriate,unit,usually,vein,venturi,white,wide,x	-15,1-2.5,1-3,1-5,1-7,1.5-8,10-19,3-4,3-5,6-7,6-many-foliat,7-15,abruptly,absen,acuminate,aggregate,apart,articulated,axe,ba,base,cuneate,cylindrical,decurrent,directed,distall,distally,eaf,eed,entire,gland,lower,narrowed,nflorescence,nther,occasionally,orolla,peduncle,perfect,pore,rachi,radiu,rounded,ruit,shrub,slightly,spaced,stalked,stellate,subcapitat,subclavate,tal,tem,vary,yellow,ympodial	6-many-foliate,absent,anther,anthesi,bark,bud,color,corolla,count,filament,free,fruit,fruiting,growth,habitat,height,inflorescence,leaf,length,mentioned,new,ovary,position,prickle,primary,scar,seed,shape,stem,structure,subcapitate,surface,sympodial,texture,width,wing,young
470	wfo-0001031586	success	167	140	117	50	23	0.701	-2,.25,0.1-1,0.5-1,1-1.2,1-1.5,1-2,1.3-5,1.4-2.5,1.5-2,2,2-2.5,3-11,5-6,absent,acute,anther,anthesi,apex,apparently,attenuate,bark,base,becoming,borne,branch,bright,broadly,bud,calyx,campanulate,capitate,cm,completely,conical,corolla,cream-colored,cucullate,deltate,differing,difoliate,drying,ellipsoid,elliptic,filament,fleshy,flower,free,geminate,glabrous,globose,green,greenish,inflorescence,known,later,lateral,leaf,lobe,lobed,long,major,margin,minor,minutely,mm,mucro,nearly,olive,one,onto,open,opposite,ovary,overtopping,pale,paler,papillate,papillose,pedicel,petiole,planar,pore,poricidal,raised,ridged,rounded,scar,shaped,shiny,shrub,simple,size,small,somewhat,soon,spaced,sparsely,stem,stigma,style,surface,tall,tear-drop,thick,thickened,tip,truncate,tube,unit,vein,white,widely,x,yellow,yellowish,young	0.5-0.8,1,5-10,7-10-flowered,abrupt,apart,appearing,beneath,closer,deflexed,dia,distance,eaf,edicel,eed,exerted,exfoliatin,fresh,gree,inflorescenc,know,leave,lower,main,material,may,near,new,nflorescence,notched,occasionally,older,pair,portion,present,prominent,remaining,ruit,shap,shin,slender,sometimes,straight,swollen,tapering,trichome,trunk,ud,uniseriate,ympodial	7-10,cell,color,count,diameter,exfoliating,fruit,fruiting,habitat,height,length,mentioned,position,prickle,primary,seed,shape,stone,structure,sympodial,texture,width,wing
471	wfo-0001031587	success	142	139	111	31	28	0.782	.5,0.8-1,1-1.5,1.5-2,1.7-2,2-2.5,2-9-celled,2/3,3-4,5,6-7,7-9,abaxially,adaxially,along,anther,anthesi,apart,axi,bark,base,bi-lobed,broadly,calyx,closely,cm,cone,conical,corolla,decurrent,deflexed,deltate,dendritic,densely,denser,drying,elliptic,elliptic-ovoid,erect,evenly,exserted,filament,fleshy,free,furcate,glabrous,globose,golden-red,included,inflorescence,irregular,known,lamina,later,lateral,leaf,like,lobe,lobed,long,loose,main,major,middle,minor,minutely,mm,mostly,occasional,older,ovary,pair,pale,papillate,parallel,pedicel,perpendicular,petiole,pore,poricidal,pubescent,rarely,reddish-grey,rest,scar,shape,shaped,simple,soft,somewhat,spaced,stem,stigma,style,surface,tear-drop,thick,thickened,tip,tree,trichome,tube,uniseriate,vein,verrucose,way,white,widest,winged,x,young	10-15,12-16,17-30,2,6-8,acute,apex,attenuate,clavate,dia,differing,eaf,edicel,eed,fide,know,lower,lowered,oblique,ocasionally,overlappin,papillo,persisten,portion,rect,ruit,size,steinbach,tall,tub,ud	bud,cell,color,count,diameter,flower,flowered,fruit,fruiting,growth,habitat,height,length,margin,new,overlapping,papillose,persistent,position,prickle,primary,provided,seed,stone,structure,texture,width,wing
472	wfo-0001031589	success	222	158	129	93	29	0.581	-6.5,.5,/6,0-3,0.2-0.5,0.4,0.5-1,0.55-0.7,0.8-2.3,0.9-1.3,0.9-1.6,1,1-1.8,1/3,1/3-1/2,1/3-1/4,2-3.5,2.5-4.5,2.5-6,2.8-4,3-4,3-5,8-14,8-30,abaxially,acute,anther,apex,apparently,attenuate,bark,base,berry,blade,bright,broadly,brown-green,calyx,cell,chartaceous,cm,concolorous,connivent,cream,dark,deltate,densely,density,diameter,difoliate,discolorous,drying,dull,elliptic,elongating,eye,filament,flower,free,fruit,fruiting,glabrescent,glabrous,gray-green,green,higher,infructescence,lateral,leaf,length,lobe,lobed,long,long-obovate,longer,margin,marking,mature,maturity,mauve,membranous,mm,moderately,naked,narrow-cuneate,orange-green,pair,pale,part,pedicel,per,petiole,plant,poricidal,prickle,prickly,primary,rounded,scandent,shrub,simple,solitary,sparsely,spherical,stellate,stellate-pubescent,stem,stout,straight,style,surface,tapering,terete,time,tip,trichome,tube,unit,upper,vein,visible,way,weakly,white,wide,woody,yellow,yellow-green,young	-0.5,-15,-6,0,0-1,0-10,0-30,0.1,0.1-0.5,0.15-0.3,0.2-0.4,0.2-3,0.6-1.2,0.7,1-5,1.2-1.5,1.5-5,1.7-2.5,1.8-2.9,10-30,2-,2-10,3/4,4-6.5,4/5,5-8,5-merous,6-8,alyx,ame,apart,apically,articulated,brow,c.,caudat,distance,eed,equal,erect,extending,flattened-reniform,geminat,lengt,lon,lower,midpoint,midvein,multangulate,narrow,nflorescence,oblong,obovate,occasionally,often,older,orange-brown,orolla,oung,outline,pendulous,perfec,pericarp,pit,porrect,portion,prickl,raised,ray,reflexed,ruit,sessile,shiny,shorter,side,small,smooth,sometimes,somewhat,spaced,spreading,stalk,stalked,subentire,subsessile,tamen,tertiary,vary,venation,whole,winged,yellow-orange,ympodial	anthesi,brown,bud,color,corolla,count,geminate,growth,habitat,height,inflorescence,major,minor,new,null,ovary,position,present,scar,shape,similar,size,stigma,stone,structure,sympodial,texture,width,wing
473	wfo-0001031609	success	154	109	72	82	37	0.468	0-30,1-10,1-6,1.5-3,2-,2-3,2.5-4,3-24,3-5,3-9-lobed,4-6,4.5-60,absent,acute,adaxially,apex,around,base,brownish,calyx,cell,cm,connivent,cuneate,deltate,dia,diameter,ellipsoidal,elliptic,flattened,fleshy,flower,forked,fruit,glabrous,globose,green,inflorescence,leaf,lobe,margin,minutely,mm,obovate,obtuse,orange,papillose,pedicel,petiole,pinnately,puberulent,reticulate,ripe,scar,shallowly,shrub,simple,small,stigma,stone,style,succulent,tip,tree,triangular,truncate,tube,unbranched,unit,unlobed,x,yellow	.5,/4,0.4-3,0.5-1,0.5-3,1.3-3,1.5-2,10-25,2,20-25,3-foliat,4,4-5,5-25,5/6,8-20,abaxially,absen,aggregate,ape,apiculate,articulated,axe,barely,beyond,bilobe,blade,branch,brow,campanulate,connective,conspicuous,contiguous,dark,dilated,directed,distally,divided,eaf,eed,elliptic-ovate,emerging,entire,equal,exceeding,exserted,glabrou,laterally,leaving,lobed,long,lower,midrib,nearly,nflorescence,nther,obconical,occasionally,orolla,pedicellar,peduncle,point,pore,rachi,radiu,rounded,ruit,sinus,stamen,stellate,strongly,succulen,tal,tem,thecae,time,tomento,two,ud,vary,wide,ympodial	3-foliate,anther,anthesi,bark,bilobed,bud,color,corolla,count,filament,free,fruiting,habitat,height,lateral,length,major,mentioned,minor,ovary,position,prickle,primary,seed,shape,size,stem,structure,surface,sympodial,tall,texture,tomentose,vein,width,wing,young
474	wfo-0001031615	success	154	145	119	35	26	0.773	.5,0.5,0.5-1,0.8-1,0.9-1.1,1-1.6,1.3-1.8,1.5-5,11-15.5,2-3,2-4.2,3.8-6.1,4-6.5,5-6,6-8,acuminate,acute,anther,anthesi,apex,arising,attenuate,axil,bark,base,bilobed,calyx,capitate,closely,cm,corolla,dark,decurrent,deep,deflexed,deltoid,dia,difoliate,distal,elliptic,expanded,filament,flattened-reniform,free,fruit,fruiting,furcate,glabrous,glandular,globose,green,impressed,inflorescence,interpetalar,lamina,lateral,leaf,less,lobe,lobed,long,main,major,margin,minor,minute,minutely,mm,nearly,occasionally,opposite,ovary,packed,paler,papillae,papillose,pedicel,petiole,pitted,pore,poricidal,prominent,reflexed,scar,shaped,shiny,shrub,simple,sinus,size,slender,slightly,small,stem,stigma,style,subumbellate,surface,tall,tapering,tear-drop,terminal,thickened,thin,tip,tree,trichome,tube,tuft,unicellular,uniseriate,unit,urceolate,vein,white,winged,woody,x,young	0,1.5,5-20-flowered,8-10,ba,becoming,berry,brown,caly,dark-papillo,differing,eaf,edicel,eed,exserted,geminat,incrassate,lon,lower,maroo,middle,nflorescence,older,one,overlappin,pair,per,portion,ruit,scarcely,somewhat,straight,ud,widest,ympodial	5-20,bud,cell,color,count,dark-papillose,diameter,flower,geminate,habitat,height,length,maroon,overlapping,position,prickle,primary,provided,seed,shape,stone,structure,sympodial,texture,width,wing
475	wfo-0001031618	success	184	187	152	32	35	0.826	-2,0-3,0.5-1.5,1-1.5,1-7,1.5-2,1.5-3.5,10-18,10-lobed,13,2-3,3,3-4,3-8,4-5,40-60,5,5-12,acuman,acute,almost,also,anther,anthesi,apex,appearance,appearing,aspect,axil,base,becoming,berry,beyond,blunt,bluntly,branch,broadly,calyx,capitate,cell,cluster,cm,conical,corolla,covering,cuneate,cut,cyme,darker,developed,discoidal,ellipsoid,elliptic,emarginate,enlarged,equal,erect,except,extending,facetted,filament,finely,fleshy,floral,flower,forked,general,giving,glabrous,glandular,greatly,green,greyish,growing,hair,half,interacuminal,lanceolate,lasting,lavender-purple,leaf,less,lobe,lobed,long,loosely,lower,marbled,maturity,mid-vein,midrib,minute,mm,narrowly,oblong,obovoid,occasional,occur,often,ovary,ovate-lanceolate,ovoid,pale,pedicel,peduncle,petal,petiole,pinatisect,point,purple,rarely,reddish-brown,reticulate,rhachi,ripe,rotate,rounded,rugose,scorpioid,sessile,several,shallowly,shrub,simple,sinus,soft-wooded,sometimes,somewhat,specimen,stem,stigma,stone,stout,stripe,succulent,surface,tapering,terete,tinged,tip,tissue,triangular,unequal,unit,variable,vigorous,way,well,x,year,young,younger	2-2.5,90-110,c.,clonal,column,dia,eaf,eed,exerted,fork,frui,gree,habit,lengthening,lon,mauve,may,nflorescence,pal,pedicellate,plurifoliat,pore,poricidal,ruit,side,single,slit,strongly,styl,tub,ud,ympodial	bark,bud,color,count,diameter,free,fruit,fruiting,growth,habitat,height,inflorescence,lateral,length,major,margin,mentioned,minor,new,plurifoliate,position,prickle,primary,scar,seed,shape,size,structure,style,sympodial,texture,tube,vein,width,wing
476	wfo-0001031646	success	171	132	99	72	33	0.579	-7,-pinnate,.2,.5,1-6,1.2-2.5,1.5-3.5,1.5-4,15-25,18-38,2-2.5,2-3,20,3.5-4,4-18,4-20,4-5,4-foliate,5,5-7,5-7.5,7-8,8-15,abaxially,absent,acuminate,acute,adaxially,anther,apex,base,berry,blue,branched,brown,calyx,cell,climbing,cm,covered,cuneate,densely,diameter,ellipsoidal,filament,flattened,flower,fruit,fruiting,glabrous,glandular,globose,green,hair,high,highly,hyaline,immature,lateral,leaf,light,lobe,long,margin,mature,mm,multicellular,oblique,oblong,obtuse,ovate-lanceolate,pedicel,petiole,pubescence,pubescent,red,rounded,rugulose,scandent,shortly,shrub,simple,size,smooth,spreading,stem,stigma,stone,style,surface,tawny,tip,tree,tube,uniseriate,unit,vine,violet,x	0.2-0.8,0.5-2,0.8-1.5,1-1.8,1-10,1962,2-10,2.5-10,4-8,5-6,5-merou,absen,accrescent,acut,aggregate,alyx,apart,apical,apparently,articulated,axe,ba,basally,blade,chartaceous,ciliat,connivent,correll,cylindrical,darker,decreasing,directed,distall,eaf,eed,elliptic,elliptic-lanceolate,entire,equal,fide,geminat,homostylous,interjected,leaflet,lower,maroon,nflorescence,obliquely,orolla,ovate-lanceolat,part,peduncle,perfect,petiolule,pore,present,pubescen,rachi,rotate-pentagonal,ruit,seudostipule,slightly,small,spaced,stout,tamen,tem,toward,truncat,vary,yellow,ympodial	anthesi,bark,bud,ciliate,color,corolla,count,free,geminate,growth,habitat,height,inflorescence,length,major,minor,new,ovary,position,prickle,primary,scar,seed,shape,specified,structure,sympodial,texture,truncate,vein,width,wing,young
477	wfo-0001031651	success	201	175	150	51	25	0.746	-2,-3,-3.5,.1,.7,/3,/5,0.1,0.1-0.15,0.1-0.2,0.1-0.25,0.15-0.2,0.2-0.5,0.3-0.5,0.3-0.8,0.3-1.5,0.6-1,0.6-1.3,0.7-1,1,1-1.7,1-2,1-4,1.2-2,1.2-3,1.3-1.6,1.5-2,1/5,1/6-1/4,2-10,2-3,2-3.5,3-5,4-5,4-6,4.5-7,abaxially,ame,anther,apart,apparently,bark,base,berry,blade,branched,brown,c.,calyx,cell,cm,curved,dark,deltate,densely,diameter,difoliate,dull,elliptic,erect,faint,filament,filiform,flattened-reniform,flower,free,fruit,fruiting,glabrescent,glabrous,gray,herb,herbaceous,lanceolate,lateral,leaf,length,lobe,lobed,long,longer,lower,margin,mature,maturity,midpoint,mm,oblong,older,one,open,orange-brown,outline,ovate,pair,pedicel,pendulous,persistent,petiole,pit,poricidal,porrect,prickle,prickly,primary,purple,raised,ray,red,reflexed,scandent,scar,shorter,shrub,simple,small,smooth,spaced,spherical,spreading,stalk,stalked,stellate,stellate-pubescent,stem,straight,style,subsessile,surface,tapering,terete,terminal,thick,thick-stalked,time,tip,toward,trichome,tube,unarmed,unit,upper,variously,vein,visible,way,weakly,white,wide,yellow	.6,0-20,2/3-3/,5-merous,abaxial,absent,acuminat,acute,adaxial,alyx,apar,apex,apically,articulated,chartaceous,concolorous,cordate,discolorous,drying,eaf,eed,elongating,entire,equal,eye,geminat,gra,infructescence,naked,nflorescence,obtuse,orolla,oung,peduncle,per,perfec,pericarp,portion,prickl,red-green,rounded,ruit,sometimes,subentire,tamen,tertiary,unarme,vary,venation,yellow-green,ympodial	2/3-3/4,anthesi,bud,color,corolla,count,geminate,growth,habitat,height,inflorescence,new,null,ovary,position,seed,shape,stigma,stone,structure,sympodial,texture,width,wing,young
478	wfo-0001031656	success	154	144	119	35	25	0.773	.5,/4,0.5,0.5-1,1-1.5,1-2,1-2.5,1.2-1.5,1.5-2,1.5-5,2.5-3.5,3-3.5,3-5,5-ribbed,6-8,also,anther,anthesi,arising,bark,base,berry,bright,calyx,capitate,closely,cm,corolla,densely,dia,difoliate,directly,drying,ellipsoid,elliptic,erect,filament,fleshy,flower,free,fruit,fruiting,glabrous,globose,green,greyish,hooded,known,leaf,live,lobe,lobed,long,long-acuminate,major,margin,matte,mature,middle,minor,minute,minutely,mm,node,often,older,opposite,ovary,ovate,pale,paler,papillose,pedicel,persistent,petiole,planar,plant,pore,poricidal,prominent,proximal,rather,red-papillose,reddish,reflexed,rib,ridged,scar,sessile,shaped,shiny,shrub,slightly,somewhat,spaced,specimen,stem,stigma,strongly,style,surface,swollen,tall,tear-drop,terminal,thick,thickened,tip,transversely,tube,unit,vein,visible,way,white,wide,widest,woody,young	10-20,4-9,5-7,acuminate,acute,apex,ba,cork,differing,eaf,edicel,eed,enclosing,extremely,geminat,lateral,lon,lower,main,nflorescence,oblique,one,pair,papillo,peelin,portion,rounded,ruit,size,straight,top,ud,upper,x,ympodial	-,bud,cell,color,corky,count,diameter,geminate,habitat,height,inflorescence,length,peeling,position,prickle,primary,provided,seed,shape,stone,structure,sympodial,texture,width,wing
479	wfo-0001031667	success	153	139	98	55	41	0.641	0.6-1,0.6-1.5,1-1.5,1-4,1.4-3,1.5-2,10-13,12-35,2-3,2-5,2-6,2.5-5,3-13,3-5,3-8,5-15,5-9,6-10,8-13,8-15,abaxially,acumen,acute,adaxially,apex,apiculate,base,branched,calyx,caudate,cell,cm,connate,cordate,corolla,covering,cuneate,cyme,dark,diameter,dichasial,dichasially,distal,dorsally,ebracteate,edge,elliptic-lanceolate,exceeding,filament,flat,flower,folded,forked,generally,globose,green,half,herbaceous,irregularly,lanceolate,lateral,leaf,leaflet,lobe,lobed,long,make,mm,monochasial,mucilaginous,oblique,oblong,odd-pinnate,ovoid,pedicel,perennial,petiole,pilose,plant,rounded,seed,size,spot,stamen,stellate,stigma,stripe,style,testal,thick,tuber-bearing,typically,unit,wall,white,wide,without,yellow	3-6-foliat,4-1.,abruptly,acuminate,apical,apically,articulate,dehiscent,digestion,diminishing,eaf,eed,emoval,enzyme,globo,green-white,hair-like,honeycomb,interjected,introrse,living,lon,lower,lunat,maturing,nflorescence,nther,often,orolla,pair,pattern,peduncle,perfect,petiolate,petiolule,plan,poricidally,proximal,reveal,ruit,sessile,seudostipule,short,slit,specimen,straight,tal,tem,terminal,throughout,toward,vary,whit,ympodial,Â¼	'hair-like,3-6-foliate,anther,anthesi,bark,bud,color,count,free,fruit,fruiting,habitat,height,inflorescence,length,lunate,major,margin,mentioned,minor,ovary,position,prickle,primary,pseudostipule,scar,shape,stem,stone,structure,surface,sympodial,tall,texture,tip,tube,vein,wet,width,wing,young
480	wfo-0001031672	exception_thrown	157	0	0	157	0	0.0		0,0-2,0.3-0.5,0.5,0.5-1,0.5-1.5,1,1-,1-1.5,1-10,1-2,1-5,1.5-2,1.5-2.5,1.5-3.5,1.5-5,10-20,15-20,15-50,2-12,2-28,3-4-foliat,3/4,4,4-34,4.5-5,4/5,5-6,6,9-lobed,abaxially,absent,acuminate,acute,adaxially,aggregate,apart,ape,apex,apiculate,articulated,aublet,axe,basal,base,beyond,blade,calyx,cell,chartaceous,ciliat,cm,connective,cordate,cylindrical,densely,diameter,directed,distally,divided,eaf,eed,entire,exceeding,exserted,fide,flattened,fleshy,flower,fruit,glabrous,glandular-puberulent,globose,green,greenish-brown,hair,lanceolate,leaf,leaving,lobe,lobed,lon,long,lower,margin,mature,membranaceous,midrib,mm,moderately,narrowly,near,nflorescence,nther,obtuse,occasionally,often,one,orolla,ovate,ovoid,pedicel,pedicellar,peduncle,perfect,petiole,pilo,pilose,pinnately,pore,presen,present,puberulent,pubescent,purple,rachi,radiu,remant,represented,rounded,ruit,shorter,simple,sinus,slightly,small,spaced,sparsely,stamen,stellate,stigma,stone,style,subcoriaceous,tal,tem,thecae,time,tip,toward,tree,triangular,truncat,truncate,tube,ud,unbranched,unit,unlobed,vary,white,whitish,wide,x,yello,yellow,ympodial	
481	wfo-0001031684	success	161	150	127	34	23	0.789	.5,/4,0.1,0.4-1.5,0.5-0.7,0.5-0.8,0.5-1,0.7-1,0.75-1,1-1.2,1-5,10-100,2,2-9,3-3.5,3-30,4-17,5-7,acuminate,acute,along,anther,anthesi,apex,bark,base,bearing,beneath,borne,branched,calyx,causing,clavate,cm,corolla,curly,decurrent,deflexed,densely,difoliate,elliptic,elongated,filament,flower,free,fruiting,geminate,glabrous,globose,greatly,green,inflorescence,internodal,irregularly,lateral,leaf,less,like,lobe,lobed,long,long-triangular,lower,main,major,middle,midrib,minor,minutely,mm,obconic,occasionally,opposite,ovary,ovoid-reniform,pair,pale,papillose,pedicel,persistently,petiole,pitted,planar,pore,poricidal,previously,pubescent,pulled,raised,reflexed,rest,scar,shaped,short,shrub,size,slender,slightly,small,spaced,sparsely,stem,stigma,straight,style,surface,tall,tan,tear-drop,time,tip,tipped,tree,trichome,tube,unevenly,unifoliate,uniseriate,unit,vein,way,white,widely,widest,winged,x,young	.25,.75,apar,berry,black,denser,dia,differing,drying,eaf,edicel,eed,except,expanded,exserted,extremely,filiform,gre,lon,nflorescence,older,one,papillo,portion,present,reflexe,ruit,single,siz,soon,tapering,ud,varying,ympodial	bud,cell,color,count,diameter,fruit,grey,habitat,height,length,margin,mentioned,position,prickle,primary,seed,shape,stone,structure,sympodial,texture,width,wing
482	wfo-0001031695	success	185	155	116	69	39	0.627	0.5-1,0.5-2,1-2,1-3,1-9,1.5-8,1/2,1/3,10-35,2-3,2-4,2-5,3-19,4-5,5,5-20,6-10,6-20,abaxially,abruptly,acuminate,acute,adaxially,also,apex,apiculate,basal,base,beyond,blade,branched,broadened,calyx,cell,chartaceous,cm,color,connivent,cordate,dark,deep,densely,diameter,divided,eglandular,ellipsoidal,exserted,flattened,fleshy,flower,fruit,glabrate,glabrescent,glabrous,glandular-puberulent,green,greenish,hair,hard,immature,lateral,lavender,leaf,lobe,lobed,long,margin,midrib,mm,moderately,mottled,narrowly,oblique,oblong,obtuse,occasionally,often,ovate,ovoid,pedicel,perfect,petiole,pilose,pilose-hirsute,present,puberulent,puberulent-pubescent,pubescent,purple,ripe,rounded,shrub,simple,sinus,small,sometimes,somewhat,sparsely,stamen,stigma,stone,stripe,style,subcoriaceous,time,tip,tree,triangular,tube,unbranched,unequal,unit,unknown,unlobed,wide,x	1,1.5-2,10-,10-15,15-20,2.5-5,20-30,3-,3-10,3-17,3-7,30-40,4-10,4-6,4-foliat,5-7,6-8,7-,?,aggregate,apart,ape,apically,articulated,axe,campanulate,capitat,connective,cylindrical,d,dilated,directed,eaf,eed,eglandular-pilose,entire,exceeding,lanceolate,laterally,leaving,lilac,lon,lower,nflorescence,nther,orolla,pedicellar,peduncle,pilo,pilose-hirsut,pore,presen,purplish,rachi,radiu,remnant,ruit,shorter,slight,slightly,spaced,swelling,tal,tem,thecae,tomento,vary,yellow,ympodial	4-foliate,anther,anthesi,bark,bud,capitate,corolla,count,filament,free,fruiting,growth,habitat,height,inflorescence,length,major,mentioned,minor,new,ovary,position,prickle,primary,scar,seed,shape,size,stem,structure,surface,sympodial,tall,texture,tomentose,vein,width,wing,young
483	wfo-0001031698	success	58	79	34	24	45	0.586	2.5,bark,base,branch,decurrent,difoliate,dull,elliptic,flattened,fruiting,glabrous,green,leaf,margin,minutely,otherwise,pale,papillae,pedicel,pitted,reniform,repandly,rugose,shrub,stem,stout,strongly,surface,tall,unit,wing,winged,yellowish,young	'',2-2.5,2.5-3,4-4.5,``,ape,cm,deflexed,dia,eaf,eed,fide,geminat,incrassate,long,maguire,mm,older,paler,persistin,reddish-brown,woody,x,ympodial	anther,anthesi,apex,bud,calyx,cell,color,corolla,count,diameter,filament,flower,free,fruit,geminate,growth,habitat,height,inflorescence,lateral,length,lobe,major,minor,new,null,ovary,petiole,position,prickle,primary,scar,seed,shape,size,stigma,stone,structure,style,sympodial,texture,tip,tube,vein,width
484	wfo-0001031707	success	178	172	141	37	31	0.792	-3,.5,/4,0.5-1,1-1.2,1-1.3,1-1.5,1-3,1.2-1.8,1.2-2,1.5-1.7,1.5-2,1.5-6,16-20,2,2-3,2-4,2-6,3,4-5,4-6,5-10-celled,6-7,8-12,80-140,9-15,abaxially,absent,acuminate,acute,adaxially,almost,along,anther,anthesi,apex,apical,apically,attenuate,axil,axillary,base,basiscopically,berry,brown,calyx,capitate,cell,climbing,cm,conical,conspicuously,corolla,cucullate,dense,densely,diameter,distinct,elliptic,enlarged,epidermal,filament,flap-like,flat,flattened,fleshy,flower,four-lobed,free,fruiting,glabrous,globose,green,greenish,high,lanceolate,lateral,leaf,leaflet,less,like,lobe,lobed,long,margin,minutely,mm,narrowly,oblique,obovate,occasionally,open,ovary,pair,papillate,pedicel,per,petiole,pink,pinnate,planar,plant,pointed,primary,pubescent,quadrate,quite,raised,reddish,regular,rest,round,sagittate,scar,scattered,simple,slightly,smooth,somewhat,spaced,sparsely,stigma,stout,style,surface,ternate,thickening,time,tip,trichome,tube,uniseriate,unit,vein,vine,way,white,white-lenticellate,widely,woody,x	1/3,2-10,24,basal,bearing,c.,cateniform,clavat,distal,drying,eaf,edicel,eed,endrophilum,erect,exserted,horizonta,inflorescenc,lon,lower,narrower,nflorescence,penden,petiolule,poricidal,portion,ruit,smaller,strongly,tem,terminal,tub,type,ud,unifoliat,usually,ympodial	bark,bud,clavate,color,count,fruit,growth,habitat,height,inflorescence,length,major,mentioned,minor,new,pendent,position,present,prickle,seed,shape,size,stem,stone,structure,sympodial,texture,unifoliate,width,wing,young
485	wfo-0001031723	success	228	192	168	60	24	0.737	-1.5,-16,-2,-5,-6.5,-8,0,0.05-0.2,0.1-0.2,0.1-0.3,0.1-0.5,0.15,0.2-1,0.4,0.4-,0.4-0.9,0.4-1,0.6-1,0.7-1,0.8-1.5,1-,1-2,1-2.5,1-3,1-5,1.2-2,1.5-,1.5-10,1.5-2.5,1/3-1/2,10-30,2-,2-3.5,2-5.5,2-7,2.5-5,2/3,2/3-3/4,3-15,4-,4-10,4-11,4-20,4-6,5-9,8-20,abaxially,acute,ame,anther,apart,apex,apically,apparently,bark,base,blade,branched,branching,brown,c.,calyx,cm,conical,connivent,curved,dark,deltate,densely,diameter,dull,elongated,elongating,erect,evenly,filament,filiform,flattened-reniform,flower,free,fruit,fruiting,gently,glabrescent,glabrous,gland,gland-tipped,glandular,gray,green,hair,herbaceous,inflated,lateral,leaf,length,lobe,lobed,long,longer,lower,margin,marking,mature,maturity,mauve,midpoint,minute,mm,moderately,multangulate,narrow-deltate,obtuse,older,orange,orange-brown,ovate,pair,pale,pedicel,perpendicular,petiole,poricidal,porrect,prickle,prickly,primary,ray,red,reflexed,scar,secondary,sessile,shrub,simple,sometimes,spaced,sparsely,spherical,spreading,stalk,stalked,stellate,stellate-pubescent,stem,straight,style,surface,tapering,terete,terminal,time,tip,trichome,tube,unarmed,unit,variously,vein,way,weakly,white,whitish,wide,woody,yellow,yellow-green,young	-1/2,-15,-6,-merous,0.55-0.9,1/4-1/3,1/6-,15-45,2.5-4.5,3-10,4-5,5-40,abaxial,acuminate,acut,adaxial,alyx,apar,articulated,ba,berry,brow,chartaceous,cuneate,discolorous,drying,eaf,eed,entire,equal,eye,finely,infructescence,naked,near,nflorescence,one,open,orolla,oung,peduncle,per,perfec,pericarp,plurifoliat,portion,recurved,rounded,ruit,smooth,strongly,subentire,tamen,tertiary,unarme,usually,vary,venation,visible,ympodial	anthesi,bud,cell,color,corolla,count,growth,habitat,height,inflorescence,new,null,ovary,plurifoliate,position,seed,shape,stigma,stone,structure,sympodial,texture,width,wing
486	wfo-0001031729	success	161	159	124	37	35	0.77	-0.5,-2,-45,..,0.5,0.5-1,0.6-,1-1.5,1-2,1-2.5,1.0-1.3,1.5,1.5-2,11-30,12-13,2-2.5,2-3,2.5-,2.5-5,3-4,3.5-4,4.1-16,5-6,5-7,50,8-9,abruptly,acuminate,along,anther,anthesi,apex,apiculate-deltate,attenuate,base,beneath,branch,branched,calyx,cell,cm,conical,corolla,cucullate,dark,darker,deltate,diameter,drying,elliptic,elongate,filament,flattened,flower,fruit,fruiting,glabrous,globose,gradually,green,greenish,later,less,lobe,lobed,long,markedly,middle,minute,minutely,mm,mottling,narrowly,nearly,obovate,occasionally,open,outer,outline,ovary,ovate-reniform,pair,papillae,papillate,papillose,pedicel,petiole,pink,planar,point,pointed,primary,purplish,quadrate,regularly,scar,scattered,short,shrub,single,sinuate,small,somewhat,stem,stigma,striate,stripe,surface,testa,time,tip,toward,triangular,trichome,tube,tuft,unit,vein,wall,wand-like,white,widening,x,young	0.5-4,10-20,3-celled,5-,apicula,branc,brittle,brow,c.,curve,dry,eaf,edicel,eed,erec,flattened-capitat,glandular,lower,membranous,never,nflorescence,noddin,pale,peduncle,per,pericarp,plurifoliat,reddish,ruit,single-stemmed,smooth,tan,thin,thing,ud,usually,ympodial	bark,brown,bud,color,count,curved,erect,flattened-capitate,free,growth,habitat,height,inflorescence,lateral,leaf,length,major,margin,minor,new,nodding,null,plurifoliate,position,prickle,seed,shape,size,stone,structure,style,sympodial,texture,width,wing
487	wfo-0001031738	success	231	146	121	110	25	0.524	-15,-5,0,0.7-1,0.7-1.1,0.9-2.1,1-1.5,1-4,1.5-4,1/3,10-15,2.3-3,20-200,3-4,3-7,4-8,5-8,6-15,abaxially,almost,anther,apart,apparently,bark,base,branched,calyx,cell,cm,connivent,curved,dark,deltate,densely,diameter,distal,dull,elongating,erect,evenly,filament,flattened,flattened-reniform,flower,free,frequently,fruit,fruiting,glabrescent,glabrous,gray,green,held,hermaphrodite,inside,lateral,leaf,length,lobe,long,long-styled,lower,margin,maturity,mm,narrow-deltate,orange,orange-brown,outline,ovate,pair,pale,pedicel,petiole,pit,prickle,prickly,primary,prominent,pubescent,raised,reflexed,resin,scar,short-styled,shrub,small,smooth,spaced,sparsely,spherical,stellate,stellate-pubescent,stem,sticky,stout,straight,strongly,style,surface,tapering,terete,terminal,tip,tree,trichome,tube,unarmed,unit,upper,usually,vein,weakly,white,wide,woody,yellow,yellow-green,yellow-orange,yellowish,young	-6,-merous,.5,0-2,0-3,0.1-0.25,0.2-0.3,0.25-0.8,0.3-1,1-1.8,1-3,1.4-1.7,1.5-,1/,1/2-2/3,1/3-2/3,1/4-1/3,1/6-1/4,15-40,2-,2-4,3-6,3.5-3.8,3.5-4.5,4,4-10,4-5,4-6,5,7-12,7-12.5,8-10,8-18,abaxial,acuminat,acute,adaxial,adaxially,always,alyx,andromonoecious,apar,apex,apically,articulated,auriculate,berry,blade,chartaceous,cordate,discolorous,distance,drying,eaf,eed,equal,extending,heterostylous,infructescence,lobed,lobing,longer,lowermost,mature,midpoint,midvein,multangulate,nflorescence,oblong,obovate,often,older,one,open,orolla,oung,peduncle,per,pericarp,plant,plurifoliat,poorly,poricidal,porrect,portion,prickl,ray,rounded,ruit,secondary,sessile,shorter,side,simple,sometimes,spreading,stalk,stalked,staminat,tamen,tertiary,time,truncate,variously,vary,venation,visible,way,white-brow,ympodial	anthesi,bud,color,corolla,count,growth,habitat,height,inflorescence,new,null,ovary,plurifoliate,position,seed,shape,staminate,stigma,stone,structure,sympodial,texture,white-brown,width,wing
488	wfo-0001031752	success	172	139	106	66	33	0.616	-10,-100,-3,-47,0.5-1,0.5-1.5,1-,1-1.5,1-2,1-4,1.5-2.5,1.5-3,15-40,2-2.5,2-5,3-11.5,3-4,3-7,3.5-15,3.5-5,5-23,5-6,5-8,8-15,abaxially,acute,adaxially,aggregate,apex,apiculate,blade,calyx,cell,chartaceous,ciliate,cm,connivent,darker,deltate,densely,diameter,directed,distally,ellipsoidal,elliptic,flattened,fleshy,flower,fruit,fusiform,glabrate,glabrescent,glabrous,gland,glandular-puberulent,green,immature,lanceolate,light,lobe,long,margin,membranaceous,mm,moderately,narrowly,oblong,obtuse,often,older,ovate,ovoid,pedicel,petiole,pink,pore,present,puberulent,pubescent,purplish,ripe,rugose,shrub,simple,small,sparsely,stalked,stigma,stone,stripe,style,subcoriaceous,time,tip,tomentose,tree,triangular,truncate,tube,unbranched,unit,white,wide,x,yellow,young	-44,-6,-pubescent,1,1-3,1.5-10.5,1.5-2,1.5-3.5,15-25,2-3,20-35,3-4-foliat,9-16,acuminate,apart,ape,articulated,axe,basal,base,beyond,ciliat,connective,cuneate,cylindrical,eaf,eed,entire,equal,exceeding,exserted,glandular-puberulen,leaving,less,linear,lon,lower,near,nearly,nflorescence,nther,olde,orolla,pedicellar,peduncle,perfect,presen,purpl,rachi,radiu,remnant,rounded,ruit,slightly,spaced,stamen,stellate,subcordate,swelling,tal,tem,thecae,truncat,ud,vary,ympodial	3-4-foliate,anther,anthesi,bark,bud,color,corolla,count,filament,free,fruiting,habitat,height,inflorescence,leaf,length,mentioned,ovary,position,prickle,primary,scar,seed,shape,stem,structure,surface,sympodial,tall,texture,vein,width,wing
489	wfo-0001031756	success	186	171	146	40	25	0.785	-5,.1,.5,.8,/2,0-5,0.02-0.2,0.1,0.15-0.25,0.2,0.4-1.6,0.5-1,0.5-1.3,0.6-1.6,0.7-1.7,0.8-1,00,1-1.8,1-2,1-3,1-4,1.5-2,1.5-3.5,1/2,1/3,10,2-6,3-15,3-5,3-7,4-5,4.5,6-9,7-10,9-14,abaxially,anther,apart,apex,apically,bark,base,berry,blade,branched,broad-deltate,calyx,cm,color,concolorous,conical,connivent,curved,deltate,densely,diameter,drying,elongating,erect,evenly,eye,filament,finely,flattened-reniform,flower,free,fruit,fruiting,glabrescent,glabrous,gray,green,herbaceous,inflated,invested,known,leaf,lobe,lobed,long,longer,lower,margin,mature,mauve,midpoint,mm,moderately,naked,older,one,open,orange-brown,ovate,pair,pale,pedicel,pendulous,perpendicular,petiole,pitted,poricidal,porrect,prickle,prickly,primary,ray,red-brown,scandent,scar,sessile,shoot,short,shorter,shrub,simple,slender,small,spaced,sparsely,spherical,spreading,stalk,stalked,stellate,stellate-pubescent,stem,straight,style,surface,tapering,terete,terminal,time,tip,trichome,tube,unit,variously,vein,visible,way,white,wide,yellow-green,young	-1,0,0-2,0.6-1.2,1.8-2.5,5-merous,accrescent,acut,alyx,apar,apparently,articulated,chartaceous,cordate,eaf,eed,enclosing,entire,equal,fully,glabrou,infructescence,nflorescence,orolla,oung,peduncle,per,perfec,pericarp,plurifoliat,portion,prickl,rounded,ruit,smooth,tamen,truncate,unarmed,vary,ympodial	acute,anthesi,bud,cell,corolla,count,growth,habitat,height,inflorescence,length,new,null,ovary,plurifoliate,position,seed,shape,stigma,stone,structure,sympodial,texture,width,wing
490	wfo-0001031786	success	209	178	154	55	24	0.737	-5,.5,/3,0,0-5,0.1,0.1-0.4,0.2-0.3,0.2-2.5,0.5-1.5,0.7-1,0.7-1.6,0.7-4,0.8,1,1-2,1-3,1-4,1-6,1.2-1.6,1.5-1.9,1.5-2.5,1/3-1/2,2-13,2-3,2-7,2-8,3-4,3-5.5,4-5,5-7,6-8,8-12,abaxially,acute,almost,ame,anther,apart,apically,apparently,bark,base,becoming,blade,branched,c.,calyx,cell,chartaceous,cm,concolorous,connivent,curved,dark,deep,deltate,densely,diameter,drying,elliptic,elongating,erect,evenly,filament,flattened,flattened-reniform,flower,free,fruit,fruiting,glabrescent,glabrous,gray,green,herb,herbaceous,inconspicuous,lateral,leaf,length,lobe,lobed,long,longer,margin,mature,maturity,mauve,membranous,midpoint,minute,mm,older,one,open,orange,orange-brown,outline,ovate,pair,pedicel,petiole,pit,poricidal,porrect,prickle,prickly,primary,raised,ray,red,red-brown,reflexed,scandent,scar,sessile,shiny,shrub,simple,slightly,small,smooth,sometimes,spaced,sparsely,spherical,spreading,stalk,stalked,stellate,stellate-pubescent,stem,stigma,straight,style,surface,tapering,terete,thick,time,tip,trichome,tube,unit,variously,vein,way,weakly,white,wide,woody,yellow-orange,young	.4,/2,0-2,0-20,0-3,0.25-0.5,0.8-1.2,2.5-3.5,5-merous,acut,alyx,apar,apex,articulated,berry,clavat,cuneate,distance,eaf,eed,equal,extending,eye,filiform,gray-brow,infructescence,lon,lower,midvein,naked,nflorescence,obtuse,orolla,oung,pale,peduncle,pendulous,per,perfec,pericarp,plurifoliat,portion,prickl,rounded,ruit,shorter,side,tamen,tertiary,truncate,unarmed,vary,venation,visible,ympodial	anthesi,bud,clavate,color,corolla,count,gray-brown,growth,habitat,height,inflorescence,new,null,ovary,plurifoliate,position,seed,shape,stone,structure,sympodial,texture,width,wing
491	wfo-0001031793	success	188	140	108	80	32	0.574	-4,.5,0,1-1.5,1-2,1-8,1.5-2,1.5-4,10-15,15-20,2-3,2-5,3-8,40,absent,abundant,acumen,aging,almost,anther,apex,armed,aspect,berry,black,branched,broadly,brown,brownish,calyx,capitate,central,cm,densely,diameter,difoliate,distal,elliptic,erect,evident,extra-axillary,ferrugineous,filament,flattened,flower,forked,fruit,fruiting,general,glandular,globose,hair,inflorescence,interpetalar,leaf,linear,lobe,long,margin,midpoint,minutely,mm,mostly,oblong-lanceolate,orange-yellow,orbicular-ovate,pedicel,peduncle,petiole,porocidal,porrect,prickle,pubescent,rachi,reddish,reticulation,rusty,scarcely,scattered,sessile,shrub,similar,small,stellate,stellate-pubescent,stem,stigma,stipitate,stout,style,surface,tall,testa,thickened,tip,tissue,tree,triangular,trichome,tube,unbranched,unit,upward,usually,white,woody,yellow,yellow-brown	1,1-3,1/3,1/4,1/5,13-20,20,26,3-4,3/4,4,5-merous,7,8-11,accrescent,acuminate,acute,adult,alyx,apparently,articulated,axe,ba,base,bilobe,blade,branche,broad,chartaceous,cuneate,cut,eaf,eed,elongatin,erec,extreme,geminat,homostylou,larger,lobing,lon,lower,main,many,maturing,midrib,mucilaginous,nflorescence,oblique,obtuse,often,older,orolla,ovate,per,perfect,pore,principal,reduced,rounded,ruit,shallow,side,simple,single,sinus,size,smaller,sparsely,stellate-pubescen,tamen,tem,triangular-acuminat,unarmed,uvenile,vary,way,well-developed,x,ympodial	anthesi,bark,bilobed,branch,bud,cell,color,corolla,count,free,geminate,growth,habitat,height,length,mentioned,new,ovary,position,primary,scar,seed,shape,stone,structure,sympodial,texture,triangular-acuminate,vein,width,wing,young
492	wfo-0001031829	success	138	127	101	37	26	0.732	.25,.5,0.7-1,1-2,1.3-1.5,1.5-2,1.5-2.5,2-4,3-5-flowered,3/4,4-4.5,7-10,absent,adaxial,adaxially,along,anther,anthesi,apiculae,bark,base,berry,branched,broadly,calyx,capitate,cm,conical,corolla,crystalline,densely,denser,difoliate,drying,elliptic,epidermi,erect,exserted,filament,free,fruiting,globose,green,greenish-brown,growth,immature,inflorescence,known,large-celled,lateral,leaf,like,lobe,lobed,long,main,margin,minute,minutely,mm,occasionally,often,older,opposite,ovary,packed,pair,papillose,pedicel,petiole,planar,pore,poricidal,pubescent,quadrate,scar,shaped,shrub,simple,soft,sparsely,stem,stigma,style,surface,tall,tear-drop,tip,trichome,tube,tuft,uniseriate,unit,vein,waxy,way,white,woody,x,yellowish,young	0.5-2.1,1,1.5-3.5,1.5-4.5,4-8.5,abaxially,acute,ape,apex,bae,deflexed,dia,differing,eaf,edicel,eed,geminat,glabrat,glabrous,leathery,lon,lower,major,minor,nflorescence,overlappin,papillo,portion,revolute,ruit,size,somewhat,tapering,thick,tub,ud,ympodial	3-5,bud,cell,color,count,diameter,flower,fruit,geminate,glabrate,habitat,height,length,new,overlapping,position,prickle,primary,seed,shape,stone,structure,sympodial,texture,width,wing
493	wfo-0001031832	success	232	181	154	78	27	0.664	/50-1/10,0-150,0.1-0.3,0.2-0.6,0.2-1.5,0.7-1.6,0.7-2,0.8-1.2,1-12,1.1-2.4,1.2-1.6,1.2-2,1.2-2.5,1.3-4.2,1.5-4,1.7-4,1.8-4,1/2-3/4,2-6,2.8-4.8,3-6.5,3-7,3.5-7,5-21,7-10,8-25,abaxially,accrescent,acuminate,acute,adaxially,anther,anthesi,apex,attenuate,axillary,bark,base,becoming,berry,blade,blister,blunt-tipped,branch,branched,brown,brownish,bud,bullate,calyx,chartaceous,cm,connate,continued,corolla,dark,decurrent,deltoid,diameter,due,entire,ferrugineous,few-rayed,filament,fleshy,flower,forming,free,fruit,fruiting,glabrescent,globose,granular-tomentose,green,greenish,growth,hair,high,honeycombed,lanceolate,lateral,leaf,length,lobe,lobed,long,main,margin,midvein,mixed,mm,mostly,multangulate,nearly,oblanceolate,oblong,obovoid,obtuse,occasionally,older,orbicular,ovate,pale,pedicel,petiole,pitted,plurifoliate,porrect-stellate,probably,pubescence,pubescent,reniform,reticulate-punctate,ripe,rough,scabrous,sessile,short-,short-stalked,shrub,side,simple,smooth,somewhat,soon,sparingly,sparse,stellate-pubescent,stem,stigma,stipitate-glandular,style,suborbicular,surface,swelling,terete,terminal,testa,thick-stalked,time,translucent,tree,tube,unarmed,unit,usually,vein,violet,way,white,x,yellow,yellowish,young	-8,.5-1,0.3-0.8,0.3-3,0.7-1.5,14,2-3.6,2-4,2.5-6.5,4-20,4-7,5.5-10,9,ag,apart,apical-lateral,apice,apparently,articulated,axe,ba,basal,capitat,closely,conical,dehiscing,directed,eaf,eed,evident,exserted,extend,glabrescen,glabrous,half,indument,inserted,introrse,lackin,large,line,long-,longer,longitudinal,lower,m.,minute,nflorescence,orolla,partly,peduncle,perfect,persistent,pore,porrect-stellat,rachi,rather,ray,relatively,rotate-stellate,ruit,runk,slit,sometimes,spaced,splitting,stamen,subcampanulate,suture,tamen,thick,toward,unarme,vary,weakly,whitish,wide,ympodial	capitate,cell,color,count,habitat,height,inflorescence,lacking,major,mentioned,minor,new,ovary,position,prickle,primary,scar,seed,shape,size,stone,structure,sympodial,texture,tip,width,wing
494	wfo-0001031834	success	150	163	132	18	31	0.88	.5,0.5,0.5-1,0.5-3,0.5-3.5,0.6-1.4,0.8-1,0.9-1.4,1,1.5,1.5-4,1.6-2,1.9-6.5,2.9-7,2/3,6-7,6.5-14,accrescent,across,acuminate,acute,anther,anthesi,apex,apically,apiculate,appear,attenuate,base,berry,bi-cellular,borne,calyx,campanulate,cm,corolla,covered,deciduous,decurrent,deflexed,deltoid,depression,difoliate,expanded,eye,few-flowered,filament,flattened-reniform,free,fruit,fruiting,glabrous,globose,green,greenish-yellow,hook,hooked,incrassate,lamina,larger,leaf,leaving,less,lobe,lobed,long,major,margin,markedly,middle,minor,minute,minutely,mm,mound-like,multicellular,naked,often,opposite,ovary,ovate,pale,papillose,pedicel,persistent,petiole,pitted,planar,pore,poricidal,portion,proximal,pubescent,scabrous,scar,shaped,short,shrub,simple,slender,slightly,small,soon,spaced,sparsely,speck,stem,stigma,style,surface,tall,tan,tapering,tear-drop,tip,trichome,tube,tufted,unevenly,uni-,uniseriate,unit,upper,usually,vein,way,white,widest,woody,x,yellow,young	0.8-1.3,apar,deciduou,dia,eaf,edicel,eed,geminat,glabrou,like,lon,lower,nflorescence,papillo,ruit,straight,ud,ympodial	apart,bark,bud,cell,color,count,diam,diameter,flower,geminate,growth,habitat,height,inflorescence,lateral,length,mentioned,new,position,prickle,primary,seed,shape,size,specified,stone,structure,sympodial,texture,width,wing
495	wfo-0001031842	success	161	161	134	27	27	0.832	.1,.4,.5,0.1-0.5,0.5-1,0.5-2,0.6-1,0.7-1,1-1.5,1-1.8,1-3.5,1.5-2,10-12,10-20,10-30-flowered,2-10,2-3,2.5-6,3-8,3/4,4.5-6,9-15,acute,anther,anthesi,apart,apex,attenuate,axil,bark,base,bearing,beneath,bi-lobed,brown,calyx,capitate,cm,corolla,cup-shaped,cusp,dark,decurrent,deeply,deflexed,densely,dia,difoliate,dry,ellipsoid,elliptic,exsertion,filament,flattened-reniform,free,fruiting,glabrous,globose,green,incrassate,irregularly,later,lateral,leaf,leaf-opposed,lobe,lobed,long,main,major,margin,middle,minor,minutely,mm,near,new,often,onto,opposite,ovary,overtopping,pair,pale,paler,papillose,pedicel,petiole,pitted,pore,poricidal,prominent,pubescent,quadrate,reddish,reddish-resinous,reflexed,scar,shaped,shiny,shoot,shrub,simple,size,slender,somewhat,spaced,sparsely,specimen,stem,stigma,strongly,style,surface,tall,tapering,tear-drop,terminal,time,tip,tree,trichome,tube,tuft,uniseriate,unit,vein,way,white,widest,woody,x,yellowish,young	.75,1,2.5-3,7-9,ba,beginning,berry,differing,eaf,edicel,eed,exserte,geminat,inflorescenc,lon,lower,nflorescence,older,one,papillo,portion,ruit,soon,straight,ud,yellowish-whit,ympodial	bud,cell,color,count,diameter,flower,fresh,fruit,geminate,growth,habitat,height,inflorescence,length,mentioned,position,prickle,primary,seed,shape,stone,structure,sympodial,texture,width,wing,yellowish-white
496	wfo-0001031843	success	245	192	164	81	28	0.669	.2,.6,0.2-2,0.5-1,0.5-1.5,0.6-1.2,0.7-2,1-2,1-7,1.2-2.2,1.5-2,1.8-2.5,1mm,2-3,3-7,4-12,45-60Â°,5-10,5-12,6-9,accrescent,along,always,anther,anthesi,apex,apically,appressed,around,bark,basal,base,becoming,berry,black,branch,branched,branching,broadly,brown,calyx,canaliculate,capitate,cm,completely,corolla,cupular,curved,cuspidate,dark,deeply,deltoid,dendritic,density,diameter,discoid,discolorous,drying,dull,entire,erect,eye,filament,finely,flexuous,flower,forming,free,fruiting,glabrous,green,hand,honeycomb,inner,largely,leaf,len,length,liana,lignified,like,lobe,long,longitudinally,loop,looping,lower,main,margin,midvein,mm,multiseriate,naked,network,never,oblong,obovate,older,opening,orange,orange-brown,orange-yellow,ovate,pair,part,partly,pattern,pedicel,peduncle,pendulous,petiole,pit,pitted,present,primary,pronounced,pubescent,rachi,rarely,red,reddish,ribbed,ridged,rounded,scar,seed,shiny,shrub,side,simple,slender,slightly,small,sometimes,sparsely,spheroidal,spreading,stem,stigma,straight,strongly,stump,style,surface,terminal,tertiary,thick-chartaceous,thickened,tip,trichome,tube,tuft,twice,unarmed,unit,variable,vein,venation,violet,visible,weakly,wider,x,young	.3,.5,0-4,0.4-0.5,0.7-1.2,0.8-2,1.2-2,1.5,1/6-1/4,2-4,2.5,3-4,abaxially,acuminate,adaxially,age,almost,alyx,apar,apice,apparently,articulated,attenuate,caudate,clearly,collapsing,conical,delineated,detaching,dilated,distributed,domatia,eaf,eed,ellipsoi,equal,even,evenly,fertilisation,fine,flat,leave,lengthening,lobed,m.,much,nflorescence,nther,oblique,obscure,orolla,outline,papillo,perfec,pericarp,plurifoliat,pore,poricidal,portion,prominent,protruding,raised,recurve,reveal,ruit,see,shallowly,shortly,sinus,smaller,smooth,soon,surfac,tearing,thin,ud,vary,white,wide,without,ympodial	apart,bud,cell,color,count,ellipsoid,fruit,growth,habitat,height,inflorescence,mentioned,new,ovary,papillose,plurifoliate,position,prickle,provided,recurved,shape,slerandulate,stone,structure,sympodial,texture,width,wing
497	wfo-0001031852	success	155	130	89	66	41	0.574	-8,0.1-1,0.5-1.3,1-4,1-4.2,1-9,1.4-3,1.5-3,2-3,2-5.5,2.6-9.5,3-9,4-,4-5,4-6,5-15,9-11,abaxially,acumen,acuminate,acute,adaxially,apex,apiculate,articulate,base,branched,calyx,cell,cm,conical,connate,corolla,cyme,decurrent,diameter,dichasial,dichasially,distal,dorsally,ebracteate,edge,elliptic,elliptic-lanceolate,filament,flat,flower,folded,forked,generally,green,half,herbaceous,lanceolate,lateral,leaf,leaflet,light,lobe,long,mm,monochasial,oblique,oblong,odd-pinnate,ovate-elliptic,pedicel,peduncle,perennial,petiole,plant,proximal,pubescent,rachi,sessile,shortly,size,stellate,stigma,style,throughout,tuber-bearing,typically,unit,white,wide,without,yellow,Â¼	0.5-3,1-,1.3-2.5,12-35,3-4,3-6-foliat,3.5-10,4-10,7-,abruptly,absen,apical,apically,attenuate,covering,dehiscent,digestion,diminishing,eaf,eed,emoval,enzyme,exceeding,globo,green-white,hair-like,honeycomb,interjected,introrse,living,lon,lower,lunat,make,maturing,mucilaginous,nflorescence,nther,often,orolla,ovoid,pair,pattern,perfect,plan,poricidally,reveal,ruit,seed,seudostipule,short,slit,specimen,stamen,straight,tal,tem,terminal,testal,thick,throughou,toward,vary,wall,white-crea,ympodial	3-6-foliate,anther,anthesi,bark,bud,color,count,free,fruit,fruiting,globose,growth,habitat,height,inflorescence,length,major,margin,mentioned,minor,new,ovary,position,prickle,primary,scar,shape,stem,stone,structure,surface,sympodial,tall,texture,tip,tube,vein,white-cream,width,wing,young
498	wfo-0001031864	success	140	125	90	50	35	0.643	.2,.25,.5,0.2-0.5,0.4-3,0.5-13.5,0.7-0.8,0.8-1,1-1.2,1-1.8,1-5,1-6.5,1.2-1.5,1.5,1.5-2.5,15-60,2,2-3,2.5-6,3-3.5,3-pinnate,5-9,abaxially,acuminate,acute,adaxially,anther,apex,apiculate,base,berry,calyx,chartaceous,ciliate,cm,color,cuneate,deltoid,dense,densely,diameter,extra-axillary,filament,flattened,fleshy,flower,fruit,fruiting,glabrous,hair,herbaceous,lateral,lenticular,like,lobe,long,margin,minutely,mm,near,oblique,ovoid-deltoid,pedicel,petiole,pointed,pubescence,pubescent,rounded,scattered,short,slender,slightly,sparsely,stem,stigma,style,surface,tip,trichome,truncate,tube,unbranched,unit,unknown,vein,vine,violet,wide-diameter,widely,x	0.5-4,0.6-3.5,0.6-4,1-2,1-3,1.5-10,5-15,5-merous,7.5-8,accrescent,alyx,apar,apical,axe,blade,c.,capitat,clavate,eaf,eed,emarginate,entire,fine,glabrou,leaflet,lon,lower,m.,middle,moderately,nflorescence,nternode,orolla,papillose,peduncle,perfec,petiolule,plurifoliat,pubescenc,rachi,rotate,ruit,sand-punctate,spaced,tamen,tem,terrestria,typical,vary,ympodial	anthesi,bark,bud,capitate,cell,corolla,count,free,growth,habitat,height,inflorescence,leaf,length,major,minor,new,null,ovary,plurifoliate,position,prickle,primary,scar,seed,shape,size,stone,structure,sympodial,terrestrial,texture,width,wing,young
499	wfo-0001031864	success	148	126	89	59	37	0.601	.25,.5,0.4-3,0.5-13.5,1-1.2,1-3,1-5,1-6.5,1.2-1.5,1.5,15-60,2,2-3,2.5-6,3-3.5,3-5-celled,3-pinnate,5-9,abaxially,acuminate,acute,adaxially,anther,apex,apiculate,apparently,basally,base,blade,blue-purple,calyx,ciliate,cm,color,connivent,cordate,cuneate,deltoid,dense,densely,diameter,extra-axillary,filament,flower,fruit,fruiting,glabrous,hair,herb,lateral,lenticular,lobe,long,margin,minutely,mm,near,node,oblique,oblong,pedicel,plurifoliate,pubescence,pubescent,rooting,rounded,scattered,short,simple,slender,sparsely,stigma,style,surface,terrestrial,thick,tip,trailing,truncate,tube,unbranched,uniseriate,unit,unknown,weakly,widely,wiry,woody,x	.2,0.5-4,0.6-3.5,0.6-4,1-1.8,1-2,1.5-2.5,5-15,5-merou,7.5-8,absent,accrescent,ag,alyx,apart,apical,articulated,axe,ba,capitat,center,clavate,directed,distally,eaf,eed,emarginate,entire,equal,etiole,fine,fleshy,geminat,interjected,large,leaflet,longitudinal,lower,m.,nflorescence,opening,orolla,papillose,peduncle,perfect,petiolule,pore,pubescenc,rachi,rotate,slightly,slit,somewhat,spaced,tamen,tem,vary,yellow,ympodial	anthesi,bark,bud,capitate,cell,corolla,count,free,geminate,growth,habitat,height,inflorescence,leaf,length,major,mentioned,minor,new,ovary,petiole,position,prickle,primary,scar,seed,shape,size,stem,stone,structure,sympodial,texture,vein,width,wing,young
500	wfo-0001031871	success	185	134	98	87	36	0.53	0.4-2,0.6-1.2,1-2,14-22,2-4,3-10,3.5-4,33-40,5.4-12.3,6-12,6.5-20.5,7.5-23,abaxially,acumen,adaxially,anther,axillary,base,blade,brownish,bud,cell,chartaceous,clavate,cm,condition,connivent,corolla,covering,dark,deep,diameter,distal,dot,drying,eaf,end,filament,flower,forked,fresh,fruit,generally,glabrous,globose,green,green-white,greenish,hair,half,herb,lanceolate,lateral,linear,lobe,make,medium,mm,mottled,mucilaginous,narrowly,odd-pinnate,one,ovoid,pedicel,petiole,placed,plant,plurifoliate,pubescent,purple,ripe,seed,short,stigma,stolo,style,subglabrous,subtending,tall,terminal,testal,thick,throughout,tiny,tip,tri-,tube,tuber,typically,unit,usually,wall,wet,white,whitish,winged,x	1.4-2.1,1.5-11,1.5-2,1.5-2.1,1.6-2.7,2-3,2.9-6,3-4,3-5,36-44,4-6,4-7,5-merou,6-7,7-9,acute,adaxiall,ag,alyx,apart,apex,apparently,articulated,asymmetric,attenuate,axe,basiscopic,berry,capitat,digestion,dorsally,edge,eed,elliptic,enzyme,erec,exceeding,flat,folded,geminat,glabrou,hair-like,hal,high,homostylous,honeycomb-shaped,interjected,leaflet,lengthening,living,long,lower,nflorescence,orbicular,orolla,ovate,pair,peduncle,perfect,petiolulate,pore,poricidal,removed,rotate,round,rounded,ruit,sessile,seudostipule,side,size,slit,sometimes,spaced,specimen,stamen,straight,subequal,subglabrou,symmetric,tamen,tem,tissue,vary,wide,yellow,ympodial	'hair-like,anthesi,bark,calyx,capitate,color,count,erect,free,fruiting,geminate,growth,habitat,height,inflorescence,leaf,length,margin,mentioned,new,ovary,position,prickle,primary,scar,shape,stem,stone,structure,surface,sympodial,texture,vein,width,wing,young
501	wfo-0001031876	success	140	113	85	55	28	0.607	.1,.5,0-flowered,0.5,1,1-1.5,1-1.6,1-4,1.5-2.2,3,5,anther,anthesi,arising,bark,base,bearing,berry,bright,calyx,closely,cm,corolla,cup-like,decurrent,dia,elliptic,erect,filament,flower,free,fruiting,glabrous,globose,granular,green,irregularity,known,lateral,leaf,less,lightly,lobe,lobed,long,main,margin,minute,minutely,mm,nearly,oblanceolate,often,opposite,ovary,pair,papillose,pedicel,petiole,present,primary,prominent,raised,reflexed,scar,shrub,simple,slender,spaced,stem,stigma,style,tall,tapering,time,tip,tube,unit,vein,white,wide,winged,woody,yellow,young	0.8-1,27-35,9-15,?,across,acute,apex,apiculate,arc,ba,beneath,convergence,corky,differing,eaf,edicel,eed,family,glabrou,greenish-yellow,immature,lenticellat,long-acuminate,lower,major,melastomataceae,member,middle,nflorescence,oblique,otherwise,overlappin,parallel,perpendicular,persistent,point,pore,poricidal,portion,recurved,resemble,ruit,running,secondary,shaped,slightly,straight,styl,tear-drop,ud,unifoliat,venation,widest,x,ympodial	2,bud,cell,color,count,diameter,fruit,growth,habitat,height,inflorescence,length,lenticellate,mentioned,new,overlapping,position,prickle,seed,shape,stone,structure,surface,sympodial,texture,unifoliate,width,wing
502	wfo-0001031877	success	216	179	149	67	30	0.69	+,.3,0.2,0.3-,0.3-1.2,0.5,0.8-0.9,1,1-1.5,1-3,1-3.5,1-4,1.1-,1.5-1.9,1.5-2,1.8-5,2,3-5,3-6,3.5-4,6-8,abaxially,abruptly,acuminate,acute,adaxially,along,anther,anthesi,apex,ascending,basal,basally,base,berry,bright,calyx,capitate,cell,clavate,cm,conical,connivent,corolla,deflexed,densely,diameter,distal,dried,ellipsoid,ellipsoidal,enlarged,erect,especially,exposed,eye,filament,flattened,flower,free,fruit,fruiting,furcate,glabrous,globose,green,greenish,growth,hastate,impressed,internal,irregularly,lamina,later,lateral,line,lobe,lobed,long,long-acuminate,loosely,margin,material,mature,midvein,minute,minutely,mm,new,occasionally,often,pair,pale,papillate,part,pedicel,petiole,pitted,plump,pointing,primary,prominently,pubescent,purple,purplish,rectangular,red,reflexed,reniform,ripe,rounded,scar,scrambler,seed,semi-woody,shiny,silky,simple,sinuate,slightly,sometimes,somewhat,spaced,sparsely,stem,stigma,style,surface,terminal,testal,tinged,tip,triangular,trichome,truncate,tube,uniformly,uniseriate,unit,usually,vein,vine,visible,wall,weak,white,woody,x,young	.5,0.3-1,0.5-1,0.6-1.2,1.5,2-,2.5,5-merou,6-10,adaxiall,ag,alyx,angled,apar,apparently,ark,articulated,brown,deep,deltate,eaf,eed,entire,exserted,fleshy,ilament,lengthening,like,linear,lower,nearly,nflorescence,older,orolla,outline,papillo,parallel,peduncle,per,perfect,pericarp,plant,plurifoliat,pore,poricidal,portion,pubescence,reddish,rest,ruit,short,shorte,sleeve,slender,slit,spreadin,stellate,strongly,subshru,tem,thin,twinin,ud,upper,vary,yello,ympodial	apart,bark,bud,color,count,habitat,height,inflorescence,leaf,length,major,mentioned,minor,ovary,papillose,plurifoliate,position,prickle,shape,shorter,size,spreading,stone,structure,subshrub,sympodial,texture,width,wing,yellow
503	wfo-0001031880	success	180	173	150	30	23	0.833	.5,0.5-1,0.7-0.8,1,1-1.3,1-1.5,1-2,1.5,2,2-3,2-4,2-9,2.5-8,3-3.5,3-4-pluri-foliate,3-foliate,3-lobed,4,4-8,5,5-6,6-9,abaxially,acute,adaxially,age,anther,anthesi,apart,apex,basal,base,bearing,becoming,berry,broadly,brown,calyx,capitate,cell,cm,color,conical,corolla,crenate,crowded,cup-shaped,curved,dark,densely,diameter,ellipsoid,elliptic,enlarged,erect,filament,flattened,fleshy,flower,flush,free,fruit,fruiting,glabrous,gland,glandular,globose,green,growing,herb,heteromorphic,hollow,horn,inflorescence,internodal,irregularly,lamina,leaf,lengthening,less,lobe,long,lower,margin,markedly,mature,middle,minutely,mm,narrowly,near,nodding,orange,ovary,ovate,ovoid,pair,pale,papillose,pedicel,petiole,pitted,pore,poricidal,primary,pubescent,purple,rachi,red,reddish,reflexed,scar,shallowly,shortest,simple,single,slender,slightly,slit,sometimes,spaced,sparse,sparsely,spreading,stem,stigma,straight,strongly,style,subshrub,surface,terminal,testal,tip,triangular,trichome,tube,uniseriate,unit,unlobed,upper,upward,vein,wall,widely,widest,woody,x,yellow,â5	0.5-2,7-9,acuminate,c.,ciliate,cordate,eaf,edicel,eed,entire,exerted,gland-tipped,lon,longest,maturit,mid-length,nflorescence,papillo,peduncle,pericarp,plan,portion,pubescen,ruit,thin,toothed,truncate,ud,unicellula,ympodial	bark,bud,count,growth,habitat,height,length,maturity,new,null,plant,position,prickle,seed,shape,stone,structure,sympodial,texture,unicellular,width,wing,young
504	wfo-0001031881	success	168	167	142	26	25	0.845	.5,0.1-0.5,0.2,0.2-0.6,0.4-1,0.5-0.7,0.5-1,1-1.3,1-1.5,1-7,1.2-6,1.5-2.5,1/3,10-12,10-30,2-9,3-19,3.5-4,3/4,5-6,7-14,absent,acute,along,anther,anthesi,apex,apparent,attenuate,axil,bark,base,beneath,branch,branched,broadly,brown,bud,calyx,campanulate,capitate,cm,constriction,corolla,decurrent,deflexed,deltoid,densely,dia,difoliate,distal,dry,drying,either,ellipsoid,elliptic,erect,evenly,exserted,filament,fleshy,free,fruit,fruiting,glabrous,globose,golden,golden-puberulent,golden-pubescent,green,inflorescence,junction,lateral,leaf,lightly,like,lobe,lobed,long,main,major,margin,material,maturity,middle,midrib,minor,minutely,mm,obovate,older,opposite,ovary,ovoid-reniform,pair,papillose,pedicel,petiole,pitted,planar,pore,poricidal,puberulent,pubescent,rest,rounded,scar,shape,shaped,shrub,simple,size,slender,slightly,small,soon,spaced,sparsely,stem,stigma,straight,strong,style,surface,tall,tapering,tear-drop,tip,tree,trichome,tube,uniseriate,unit,usually,vein,way,white,widest,winged,woody,x,young	2,apar,ba,dark,differing,eaf,edicel,eed,geminat,greyish-brow,incrassate,inflorescenc,lon,lower,minute,nflorescence,occasionally,one,orbicular,papillo,portion,puberulen,ruit,somewhat,ud,ympodial	apart,cell,color,count,diameter,flower,geminate,greyish-brown,growth,habitat,height,length,mentioned,new,position,present,prickle,primary,seed,stone,structure,sympodial,texture,width,wing
505	wfo-0001031886	success	169	151	123	46	28	0.728	-1.2,-4,-9,0.1,0.5-1,1-1.5,1-4,1.2-2.5,1.5-2,2-2.5,2-3,2-5,20-30,3-6,4,5-6,5-ridged,6-8,9-10,abaxially,abruptly,absent,adaxially,along,anther,anthesi,apex,arising,axil,axillary,base,beak,bearing,berry,bright,broadly,bud,calyx,capitate,cell,cm,commonly,completely,conical,corolla,deltate,diameter,distinctly,dry,earl,elliptic,filament,fleshy,flower,free,fruit,fruiting,glabrous,green,greenish,half,lateral,leaflet,lobe,lobed,long,lower,margin,minutely,mm,narrowed,near,nearly,node,occasionally,open-conical,ovary,pair,papillae,papillate,papillose,pedicel,petiole,petiolule,pinnate,poricidal,portion,primary,purple,rachi,raised,reddish,reflexed,ripe,rugose,scar,scattered,seed,shape,shrub,simple,single,smelling,somewhat,sparse,specimen,stigma,strongly,style,surface,time,tip,triangular,trichome,tube,uniseriate,unit,usually,vein,white,wintergreen,woody,x	-25,.5,0,10-40,2,2-4,2.0-2.5,3.0,4-15,5-10,6-20,acuminate,anticlinal,attenuate,basal,brown,clavat,eaf,edicel,eed,either,em,epidermal,equal,erec,exserted,irregular,lanceolate,le,nflorescence,noddin,oblique,ovoid-reniform,per,projection,ruit,similar,sinuous,smaller,terminal,thickening,tub,ud,unifoliat,without,ympodial	-1.5,1,bark,clavate,color,count,erect,growth,habitat,height,inflorescence,leaf,length,major,minor,new,position,prickle,size,stem,stone,structure,sympodial,texture,unifoliate,width,wing,young
506	wfo-0001031895	success	160	140	117	43	23	0.731	-1.5,0.5,0.5-2,1-1.5,1.5-2,1.5-6,2-2.5,2.5-3,3-10,3-4,3-8,3.5-6,4,4-5,4.5-16.5,5,5-6,5-8,6-7,6-9,age,anther,anthesi,bark,base,beneath,berry,bluish,broadly,calyx,campanulate,capitate,cell,cm,completely,conical,corolla,cup-shaped,dark,deltate,densely,diameter,drying,ellipsoid,elliptic,emarginated,enlarging,erect,exfoliating,expand,filament,fleshy,flower,free,fruiting,glabrous,globose,green,growth,immature,irregular,leaf-opposed,leafy,less,lobe,margin,matte,minutely,mm,new,occasionally,older,once-branched,ovary,overlapping,ovoid,pair,pale,papillate,part,patch,pedicel,peeling,petiole,pitted,planar,poricidal,primary,reddish,reniform,scar,shiny,shoot,short,shrub,simple,sinuate,slender,small,somewhat,stem,stigma,stout,style,surface,tan,terminal,testal,tip,tree,tube,unit,vein,violet,white,woody,x	0.5-1,1.5-3,acute,apex,apparently,articulating,attenuate,blac,eaf,eed,entire,erec,exerted,fragrant,glabrou,inflorescenc,intensely,leaving,lengthening,lobed,lower,nflorescence,papillat,peduncle,peg,perfect,pericarp,plurifoliat,pore,portion,revolute,ruit,slightly,slit,straight,strongly,thick,thin,tub,ud,way,ympodial,Â¼-1/2	black,bud,color,count,fruit,habitat,height,inflorescence,leaf,length,null,plurifoliate,position,prickle,seed,shape,stone,structure,sympodial,texture,width,wing,young
507	wfo-0001031897	success	264	214	191	73	23	0.723	.1,.5,.8,0-1,0.1-0.5,0.15,0.4-1.1,0.5-1,0.5-3,0.6,0Â°,1-1.5,1-2,1-2.5,1.1,1.3-2,1.5-8,1.7-3,13,2-4,4-5,6-9,8,abaxial,abaxially,absent,acute,adaxial,adaxially,along,anther,anthesi,apex,apically,appearing,appendage,arising,aristate,articulated,axillary,bark,base,bendy,berry,black,boiteau,brachyblast,branch,branched,brown,calyx,cell,clavate,cm,condensed,conical,connate,corolla,covering,curved,dark,datum,dendritic,dense,densely,developed,developing,diameter,dilated,dorsifixed,dry,drying,elliptic,enlarged,epiphyte,erect,even,except,eye,faint,filament,filiform,fine,flower,foliaceous,free,fruit,fruiting,glabrous,green,grey,hair,immature,inner,inside,known,lanceolate,larger,lateral,leaf,least,light,like,linear,lobe,long,longitudinal,longitudinally,main,margin,mauve,membranous,midvein,mm,multicellular,multiseriate,naked,never,obconical,oblong,obtuse,occasional,occasionally,one,orange,orange-brown,outside,ovate,ovoid,pair,papillose,partly,pedicel,peduncle,pendulous,pericarp,petiole,plant,pointed,primary,pronounced,protruding,pubescent,raised,rarely,ribbed,ridge,ridged,scar,secondary,seen,shoot,short,shrub,side,simple,slender,slightly,smooth,sometimes,sparse,sparsely,stem,stigma,style,subulate,sunk,surface,terete,terminal,thick,thin,tip,toward,trichome,tube,unarmed,unbranched,unicellular,unit,usually,vein,venation,visible,weakly,white,wide,winged,wrinkle,x,young	0.2-0.4,0.8-1.5,1,1.5,2/3,462.,5-6,accrescent,age,almost,alyx,apar,apparently,attenuate,chartaceous,clearly,clustered,concolorous,coriaceous,cuneate,dehiscing,delineated,development,distributed,divided,domatia,dorsal,dull,eaf,earliest,ed,entire,equal,evenly,extending,indistinc,lamina,lengthening,lobed,looped,lower,m.,margi,minute,minutely,nflorescence,nther,oblon,orolla,overlapping,part,perfec,persisting,plurifoliat,pore,poricidal,portion,prominent,reach,reddish,revolute,ruit,see,sinus,smaller,smoot,stump,tearing,tertiary,ud,vary,well-developed,ympodial	4628,bud,color,count,growth,habitat,height,indistinct,inflorescence,length,new,ovary,plurifoliate,position,prickle,seed,shape,stone,structure,sympodial,texture,width,wing
508	wfo-0001032157	success	136	137	113	23	24	0.831	.5,.75,0.25,0.5-1,0.6-1,0.75-1,1-3,1.9-2.2,2-3,2-5,2.2,3-6,5-15-flowered,5-8,5-9,7-9,9-17,acute,anther,anthesi,apart,apex,bark,base,becoming,beginning,berry,bi-lobed,calyx,cm,completely,corolla,crystalline,decurrent,deflexed,deltoid,dia,difoliate,dry,elliptic,evenly,exserted,filament,free,fruiting,glabrous,globose,golden,green,incrassate,lateral,leaf,less,live,living,lobe,lobed,long,longitudinal,main,major,margin,middle,minor,minutely,mm,nearly,obscure,older,opposite,ovary,ovoid-reniform,pair,paler,papillose,pedicel,peeling,persistent,petiole,pitted,plant,pore,poricidal,raised,reddish,reflexed,rounded,scar,shaped,shiny,shrub,simple,size,slightly,soon,spaced,stem,stigma,strip,style,surface,tall,tear-drop,tip,tube,unit,vein,white,widest,woody,x,yellowish,young	beneath,caly,differing,eaf,edicel,eed,frui,geminat,glabrou,inflorescenc,lon,lower,nflorescence,one,papillo,portion,ruit,slender,straight,tapering,translucen,ud,ympodial	bud,cell,color,count,diameter,flower,fruit,geminate,habitat,inflorescence,length,null,position,prickle,primary,seed,shape,stone,structure,sympodial,texture,translucent,width,wing
509	wfo-0001032161	success	146	138	110	36	28	0.753	.5,0.4-1.2,0.5-1,0.7-4,0.75-1,0.8-1,1-11,1-3,1.2-1.3,1.4-2,2-7,2.5-3,?,acute,adaxially,anther,anthesi,apex,area,bark,base,beneath,calyx,closely,cm,color,conical,corolla,dark,deflexed,delicate,deltate,dendritic,densely,difoliate,drying,ellipsoid,elliptic,exserted,filament,filiform,free,fruiting,giving,glabrous,globose,golden,green,inflorescence,internodal,later,leaf,like,lobe,lobed,long,many,margin,merely,middle,minutely,mm,mustard,nearly,obovate,opposite,ovary,ovoid-reniform,papillose,pedicel,persistent,petiole,pitted,plant,plurifoliate,pore,poricidal,pubescent,quadrate,reflexed,rest,scar,shaped,shiny,shoot,short,shrub,simple,spaced,sparsely,stem,stigma,strongly,style,sulcate,surface,tall,tear-drop,thin,tip,trichome,tube,unit,vein,white,widest,x,yellow,yellowish,young	1-1.5,2-8-flowered,3.5-4,abaxially,adaxiall,apical,ba,berry,branched,brownish-blac,coriaceous,dia,eaf,edicel,eed,hanging,lamina,lower,minute,nflorescence,occasionally,older,overlappin,pale,pericarp,portion,projection,revolute,ruit,styl,tan,tub,ud,uniseriate,usually,ympodial	2-8,brownish-black,bud,cell,count,diameter,flower,fruit,habitat,height,lateral,length,major,mentioned,minor,overlapping,position,prickle,primary,seed,shape,size,stone,structure,sympodial,texture,width,wing
510	wfo-0001032165	success	197	177	152	45	25	0.772	.25,0.1,0.1-0.3,0.25-0.5,0.3-1,1-1.2,1-1.5,1-2,1.5-4,10-25,3-4,3-6,3.5-8.5,4-6,5-15,5-30-flowered,5-6,5-7,5-9.5,8-9,acute,along,anther,anthesi,apex,appearing,bark,base,beginning,beneath,berry,broadly,bud,calyx,capitate,center,closely,cm,corolla,cucullate,cup-shaped,decurrent,deltoid,densely,difoliate,distal,dry,due,edged,ellipsoid,elliptic,erect,expansion,exserted,exsertion,filament,free,fruiting,glabrous,globose,golden,golden-puberulent,golden-pubescent,green,greyish-brown,inflorescence,later,lateral,leaf,less,like,live,lobe,lobed,long,main,major,margin,markedly,middle,midrib,minor,minute,minutely,mm,near,nearly,node,obovate,occasionally,older,once-furcate,onto,opposite,ovary,overlapping,ovoid-reniform,pair,pale,paler,papillose,pedicel,petiole,pitted,planar,plant,pore,poricidal,portion,prominent,puberulent,purplish,rather,rest,ripe,rounded,scar,shape,simple,size,slightly,slow,small,spaced,specimen,stem,stigma,stout,strongly,style,surface,swollen,tall,tear-drop,terminal,thickened,time,tinged,tip,tree,trichome,tube,uniseriate,unit,vein,white,widest,winged,woody,x,yellowish,young	.5,0.75-1,2-2.5,2.5-3.5,abaxial,adaxial,apparent,ba,brown,continued,dark,deciduous,denser,dia,differing,dull,eaf,edicel,eed,end,entire,even,geminat,immature,inflorescenc,lon,lower,medial,nflorescence,one,orbicular,papillo,presence,ridge,ruit,shaepd,single,slender,smoot,straight,stripe,tapering,tub,ud,ympodial	cell,color,count,diameter,flower,fruit,geminate,growth,habitat,height,length,mentioned,new,position,prickle,primary,seed,shaped,smooth,stone,structure,sympodial,texture,width,wing
511	wfo-0001032167	success	163	146	109	54	37	0.669	0.5-1,0.5-1.5,0.5-2.5,0.75-3,1,1-2,1-2-celled,1-2.5,1-3,1-5,1-7,12-20,2-4,2-7,2-foliate,3-7,4-10,5-15,7-10,abaxially,absent,acute,adaxially,anther,apex,axe,base,berry,brown,calyx,cell,chartaceous,cm,connected,cordate,decurrent,densely,diameter,dm,drying,elliptic,elliptic-ovoid,entire,few-,filament,flattened,flower,forming,fruit,geniculate,glabrous,globose,growth,hair,herb,immature,linear-lanceolate,lobe,longer,lowermost,many-branched,margin,maturing,membranaceous,mm,moderately,nearly,netlike,new,notch,oblong,obtuse,often,one-celled,pedicel,peduncle,petiole,placenta,projection,pubescent,purple,rachi,raised,rounded,seed,semitransparent,shorter,slightly,small,sometimes,sparsely,stigma,straight,style,surface,triangular,tube,twisted,two-celled,unbranched,unit,upper,usually,vein,wall,white,woody,x,yellow	.5,1.5,10-20,10-35,3-6,4-6,abundant,adaxiall,along,appressed,blade,ciliate,closely,common,curved,dehiscing,dense,denser,eaf,eed,emarginat,explosively,flat,frui,geminat,growt,held,interpetalar,larger,long,lower,lying,maturit,mesocarp,near,nfloresence,older,orolla,per,pressure,pubescen,rotate,ruit,smaller,staman,stamen,tal,tamen,tem,tissue,vary,watery,wid,ympodial	anthesi,bark,bud,color,corolla,count,emarginate,free,fruiting,geminate,habitat,height,inflorescence,lateral,leaf,length,major,mentioned,minor,ovary,position,prickle,primary,scar,shape,size,stem,stone,structure,sympodial,tall,texture,tip,wide,width,wing,young
512	wfo-0001032176	success	177	149	120	57	29	0.678	.5,0.5,0.5-0.7,0.5-0.75,0.5-1,0.8-1,0.8-6,1-10,100,3-4,3-7,5-6-celled,6,6-10,7,adaxially,adhering,along,anther,anthesi,apart,apical,axillary,base,beak,becoming,berry,branched,calyx,cell,cm,conical,containing,corolla,creeping,cucullate,densely,denser,diameter,drying,ellipsoid,elliptic,epidermal,especially,fallen,filament,filiform,flower,free,fruiting,glabrous,globose,green,greenish,herb,leaf,leaflet,lengthening,like,lobe,lobed,log,long,margin,minute,minutely,mm,nearly,nodding,occasionally,often,open,ovary,ovoid-reniform,pair,pale,papillose,pedicel,petiole,pinnate,pore,poricidal,projection,pubescent,quadrate,reflexed,rest,scar,seed,simple,sinuous,slightly,slit,somewhat,soon,spaced,sparsely,stem,stigma,style,terminal,thickening,tightly,time,tip,tree,trichome,truncate,trunk,tube,ultimate,unevenly,uniseriate,unit,vein,wall,white,winged,without,x	0,0.42,1-1.2,1.5-1.6,1.5-2.5,1.5-6,1/2,2-3,2.5-10,3-15,3-3.5,apex,arising,attaining,attenuate,axil,basal,capitat,cateniform,copiously,eaf,edicel,eed,equal,exserted,grey-brown,greyish,hangin,inflorescenc,lateral,lengt,long-papillose,lower,nflorescence,node,obovate,obtuse,onto,per,petiolule,portion,rachi,rooting,rounded,ruit,separate,single,size,smaller,strait,strongly,tem,tub,ud,unifoliat,whit,ympodial	bark,bud,capitate,cateniforme,color,count,explicitly,fruit,growth,habitat,hanging,height,inflorescence,length,mentioned,new,position,prickle,primary,shape,stone,structure,surface,sympodial,texture,unifoliate,width,wing,young
513	wfo-0001032187	success	139	145	97	42	48	0.698	-2.1,-4,-4.2,-9,0.1â1.4,0.5,0.5-,0.5â1,0.6â1.3,1.1â3.2,1.8â2,1.8â2.8,100,1â1.7,3.1â3.5,3â3.2,5â7,7â11,acuminate,acute,adherent,angular,anther,apex,appressed,base,berry,broadly,brown,brownish,changing,cm,consisting,corolla,cyme,dark,di-foliate,dull,eaf,eglandular,elliptic,entire,equal,erect,filament,forked,geminat,glabrescent,globose,green,hair,herb,leaf,light,lobe,long,margin,marked,mature,mm,obovate,occasionally,ovate,pedicel,pentagonal,per,petiolate,petiole,plant,purple,rarely,ridge,running,short,simple,small,sparse,stage,stellate,stem,style,sub-glabrous,texture,tinged,tooth,triangular,truncate,unit,well,widest,wing,yellow,yellowish,ympodial,Â±,Â±1,Ã	-11,-5,1.3â1.8,1.6â2.1,22,24.6â26.3,2â9,3â4,5-merous,9,alyx,ape,aromatic,blade,branch,dia,eed,flowered,fully,granule,hite,hooked,hydrated,lower,many,nflorescence,numerous,peduncle,penden,perfec,persistent,pollen,predominantly,presen,protruding,ruit,sclerotic,soft,sometimes,spreading,straight,Âµm	0.5-1,1.8-2,2-5,3-3.2,3.1-3.5,7-11,anthesi,bark,bud,calyx,cell,color,count,diameter,flower,free,fruit,fruiting,growth,habitat,height,inflorescence,lateral,length,major,mentioned,minor,new,ovary,pendent,position,present,prickle,primary,scar,seed,shape,size,stigma,stone,structure,surface,tip,tube,vein,white,width,young
514	wfo-0001032206	success	216	218	160	56	58	0.741	-0.8,-20,-5,.2,.5,0,0.2,0.2â0.5,1,1.5â2,1/3,1/6,1â2,1â3,3â4,4â6,5-merous,5â15,5â20,6â8,8â20,abaxially,accrescent,acute,adaxially,andromonoecious,anther,apart,apex,apically,apparently,approximately,armed,articulated,bark,base,berry,blade,bluntly,branched,broad-deltate,calyx,chartaceous,clearly,cm,concolorous,connivent,covering,cream,cuneate,curved,dark,deltate,diameter,discolorous,distal,distance,drying,elliptic,erect,extending,filament,flattened,flower,foliaceous,free,fruit,fruiting,functionally,gently,glabrescent,glabrous,green,green-brown,hermaphroditic,heterostylous,lateral,leaf,length,lobe,lobed,lobing,long,long-styled,longer,lowermost,margin,marking,mature,maturity,mauve,midpoint,midvein,mm,moderately,obtuse,often,older,one,open,ovate,pair,pale,pedicel,peduncle,pendent,pendulous,petiole,plant,poricidal,porrect,prickle,primary,purple,rarely,ray,reflexed,scar,secondary,sessile,short-styled,shrub,side,slender,sometimes,spaced,sparsely,spherical,spreading,stalk,stalked,stellate,stellate-pubescent,stem,stout,straight,style,surface,tapering,tertiary,time,tip,toward,trichome,truncate,tube,unarmed,unit,usually,variously,vein,venation,visible,weakly,white,wide,woody,yellow,yellow-orange,young	-2,..,0.2â0.4,0.5â1,0.8â1.2,00â200,0â20,0â30,0â5,1.1â1.2,1.2â2.2,1.5â2.5,1/4â1/2,1/4â1/3,10â80,11â22,1â2.3,1â4,2.5â3.3,2.7â3.5,2â2.5,2â3,2â8,3.5â9,30â80,4.5â5.8,5â6,5â8,5â9,6â10,6â15,7â10,alyx,apar,brow,eaf,eed,equal,flattened-reniform,infructescence,lengt,mal,nflorescence,orange-brown,orolla,ower,per,pericarp,plurifoliat,portion,smooth,tamen,uit,ung,vary,ympodial	--,0.4,0.5â1.5,0.8,1.1,1.2,1.5,1/2,1/4,10,11,15,2,2.2,2.3,2.5,20,22,3,3.3,3.5,30,4,5,6,7,8,80,9,anthesi,brown,bud,cell,color,corolla,count,description,growth,habitat,height,inflorescence,major,male,mentioned,minor,new,ovary,plurifoliate,position,shape,size,stigma,stone,structure,sympodial,texture,width,wing
515	wfo-0001032209	success	257	188	163	94	25	0.634	-30+,.5,0.3,0.5-1,1,1-1.5,1-2,1-2-celled,1-6,1.5,1.5-2.5,10-13,100,12-16,2-3,2-3-lobed,2-5,4-20,6-8,absent,adaxial,along,anther,anthesi,apiculae,apparently,appearing,arching,base,berry,bilobed,blue,branch,branched,broadly,brown,calyx,canopy,capitate,cell,climbing,cm,colour,conical,connivent,conspicuously,corolla,dark,deeply,deltate,dendritic,densely,denser,diameter,distally,ecuador,ellipsoid,elliptic,enlarged,equal,especially,evenly,filament,finely,flattened-reniform,fleshy,flower,free,fruiting,glabrous,globose,groove,growth,hairy,hastate,inflorescence,lamina,large,lateral,leaf,length,lengthening,like,lobe,lobed,long,longest,margin,markedly,mean,mere,metallic,minute,minutely,mixture,mm,narrowly,nearly,new,nipple,occasionally,often,ovate,pair,papillae,papillate,pedicel,pentagonal,petiole,pinnately,planar,plurifoliate,pointed,pore,poricidal,primary,puberulent,pubescence,pubescent,purple,red,reddish,rest,rim,ripe,sagittate,several,shiny,simple,slit,sometimes,somewhat,sparser,stellate,stem,stigma,style,surface,tapering,terminal,testa,testal,tightly,time,tiny,tip,trichome,tube,twining,uniseriate,unit,upper,usually,variable,vein,vine,violet,w,wall,white,woody,x,yellow	-11,-20,0.5,1.5-,1.5-2,1.5-6,2,2.5-,2/3,20-30,3-7,3-9,4,5-8,5-merou,6-15,acute,ag,alyx,apart,apex,ark,articulated,axi,basal,berr,bu,cast,chartaceous,cordate,coriaceous,cucullat,distinct,dried,eaf,early,eed,entire,erect,exerted,flowering,geminat,giving,glabrescen,hanging,held,hollow,ilament,keeled,leathery,leaving,less,longer,lower,material,middle,midrib,midvein,near,nflorescence,older,one,orolla,papillat,part,particularly,peduncle,peg,per,perfect,pericarp,pinnatifid,portion,probably,rhachi,ruit,scar,sleeve,small,spaced,spreading,stout,tem,thin,third,truncate,twinin,ud,unequal,vary,weight,widest,within,ympodial	0.5-1-mm,age,bark,bud,color,count,cucullate,fruit,geminate,glabrescent,habitat,height,ovary,position,prickle,seed,shape,specified,stone,structure,sympodial,texture,width,wing,young
516	wfo-0001032232	success	137	118	92	45	26	0.672	.5,0.1,0.5,0.6-3,1-3,1.8-2,2-2.6,3/4,age,anther,anthesi,bark,base,becoming,berry,calyx,clavate,closely,cm,corolla,cup-shaped,dark-papillose,decurrent,deflexed,elliptic,erect,evenly,filament,flower,free,fruiting,glabrous,globose,green,greenish-brown,immature,irregular,leaf,lenticellate,less,light,lightly,lobe,lobed,long,margin,midrib,minutely,mm,narrowly,node,opposite,ovary,ovoid-reniform,packed,pale,paler,papillose,pedicel,petiole,pitted,pore,poricidal,prominent,raised,reflexed,rounded,scar,shaped,short-styled,shrub,simple,slightly,somewhat,sparsely,stem,stigma,style,subshrub,surface,tall,tear-drop,tip,translucent,tube,umbonate,unit,vein,way,wide,winged,woody	0.25,0.5-1,0.8-1,18.8-27.5,2,20-100-flowered,4.8-7.3,5-6,?,abruptly,apex,attenuate,ba,dia,distally,eaf,edicel,eed,erose,exfoliatin,filiform,lateral,long-acuminate,lower,main,middle,minute,nflorescence,occasionally,onto,overlappin,pair,papillo,portion,revolute,ruit,straight,ti,tub,ud,undulate,unifoliat,widening,widest,ympodial	bud,cell,color,diameter,exfoliating,fruit,habitat,height,inflorescence,length,mentioned,overlapping,position,present,prickle,primary,seed,shape,stone,structure,sympodial,texture,unifoliate,width,wing,young
517	wfo-0001032233	success	160	123	82	78	41	0.512	0.3-2,1-1.5,1-2,1.5-2.5,2-15,2-3,2-4,2-6,2.5-4,20-100+,3-4.5,4-18,5-16,5-6,6-25,abaxially,absent,acuminate,acute,adaxially,almost,apex,basal,base,branched,calyx,cell,cm,connivent,convex,cordate,coriaceous,dark,densely,diameter,ellipsoidal,especially,flattened,fleshy,flower,fruit,glabrate,glabrescent,glabrous,globose,green,lobe,longitudinal,margin,mm,moderately,narrowly,oblong,orange,ovate,ovoid,pedicel,petiole,present,puberulent,pubescent,purple,shallowly,small,sparsely,stigma,stone,stripe,style,subpeltiform,tip,toward,tree,triangular,truncate,tube,unbranched,unit,vein,x,yellow,yellow-green	0-2,1-3,10-15,157,2-5.5,25-40,3-15,3-4,3-5,3.5-4,4-5,4-7,4-foliat,8-12,absen,adaxial,aggregate,apart,ape,articulated,axe,bent,beyond,biglandula,blade,brow,chartaceous,connective,cylindrical,dilated,directed,distally,eaf,eed,entire,equal,exceeding,exserted,fleischmann,glandular-puberulent,laterally,leaving,lon,long,lower,nflorescence,nther,obtuse,orolla,pedicellar,peduncle,perfect,pore,projection,puberulen,rachise,radiu,remnant,ruit,shorter,simple,slightly,somewhat,spaced,stamen,stellate,subcoriaceous,tal,tem,thecae,time,tomento,ud,vary,white,wide,yellow-orange,ympodial	4-foliate,anther,anthesi,bark,biglandular,bud,color,corolla,count,filament,free,fruiting,growth,habitat,height,inflorescence,lateral,leaf,length,major,mentioned,minor,new,ovary,position,prickle,primary,scar,seed,shape,size,stem,structure,surface,sympodial,tall,texture,tomentose,width,wing,young
518	wfo-0001032259	success	202	178	153	49	25	0.757	-4,.5,/3,/4,0,0-10,0-2,0-20,0-4,0-5,0.1-0.2,0.1-0.3,0.15-0.3,0.45-0.6,0.5-0.8,0.5-1.5,0.7-1.1,0.8-1.3,0.9-1.2,1-1.8,1-2,1-2.5,1.5-4.5,1/3,1/6-1/5,2-2.5,2-4,2.2-3,20-60,3-4,4,4-5,4-6,4-9,5,5-30,5.5-8,7-16,7-8,9-22,abaxially,acute,anther,apart,apex,apically,apparently,bark,base,berry,blade,branched,brown,calyx,cm,conical,connivent,dark,deltate,densely,diameter,difoliate,dull,elongating,equal,erect,evenly,filament,flattened,flattened-reniform,flower,free,fruit,fruiting,fully,geminate,glabrescent,glabrous,gland,green,hair,lateral,leaf,length,lobe,lobed,long,longer,lower,margin,mature,maturity,mauve,midpoint,minute,mm,moderately,older,one,open,opening,orange,orange-brown,ovate,pair,pedicel,pendulous,per,petiole,poricidal,porrect,portion,prickle,prickly,primary,pubescent,ray,red,reduced,scar,sessile,shorter,shrub,side,simple,slender,sometimes,spaced,sparsely,spherical,spreading,stellate,stellate-pubescent,stem,straight,style,surface,tapering,terete,terminal,time,tip,toward,trichome,tube,unit,vein,way,white,wide,woody,yellow,young	1/2,1/4-1/3,10-30,15-40,2-5,3/,5-merous,abaxial,acut,adaxial,almost,alyx,apar,articulated,becoming,broad-deltate,brownish,chartaceous,cordate,cuneate,discolorous,distance,drying,eaf,eed,extending,green-brow,infructescence,midvein,nflorescence,orolla,oung,peduncle,perfec,pericarp,prickl,recurved,rounded,ruit,smooth,strongly,tamen,tertiary,unarmed,vary,venation,visible,yellow-green,ympodial	3/4,anthesi,bud,cell,color,corolla,count,green-brown,growth,habitat,height,inflorescence,new,null,ovary,position,seed,shape,stigma,stone,structure,sympodial,texture,width,wing
519	wfo-0001032260	success	216	156	131	85	25	0.606	-1.5,-8,.1,/5,0-,0-10,0-8,0.15-0.3,0.5-0.8,0.5-2,0.6-0.8,0.7,0.7-1.5,1-1.7,1-5,1-6,1.2-1.7,1/3-1/2,1/3-1/5,10-30,2,2-4,2-5,2.5,2.5-3,3-10,3-5,5-20,6-10,7-15,abaxially,acuminate,acute,anther,apart,apex,apically,apparently,bark,base,berry,blade,branched,calyx,cell,cm,connivent,curved,deltate,densely,diameter,difoliate,dull,elliptic,elongating,filament,flattened-reniform,flower,free,fruit,fruiting,glabrescent,glabrous,glaucous,green-brown,lateral,leaf,length,lobe,lobed,long,long-styled,margin,mature,maturity,mauve,midpoint,mm,moderately,narrow-ovate,one,open,orange-brown,outline,ovate,pair,pedicel,pendulous,petiole,pit,poricidal,porrect,prickle,prickly,primary,purple,raised,ray,red,reflexed,scandent,scar,sessile,shorter,shrub,slender,small,spaced,spherical,spreading,stalk,stalked,stellate,stellate-pubescent,stem,style,surface,tapering,terete,terminal,time,tip,trichome,tube,unit,vein,way,wide,woody,yellow,yellow-green	-0.5,-10,-3,0-0.5,0-20,0-5,0.1,0.1-0.3,0.1-0.4,0.2,0.2-0.5,0.4,0.5-5,0.8-1.1,1-3,1.5-4,1/2,1/3,2-20,2.5-3.5,3-8,3-9,4-,5-,5-merous,6-8,abaxial,acuminat,adaxial,alyx,apar,articulated,broad-deltate,chartaceous,cuneate,discolorous,distance,drying,eaf,eed,equal,erect,extending,eye,flattened,geminat,glabrou,gland,globular,gray-brow,infructescence,lon,longer,lower,midvein,naked,nflorescence,older,orolla,oung,pale,peduncle,per,perfec,pericarp,portion,prickl,pubescent,reduced,rounded,ruit,shallowly,side,simple,smooth,sparsely,strongly,subentire,tamen,tertiary,variously,vary,venation,visible,ympodial	anthesi,bud,color,corolla,count,geminate,gray-brown,growth,habitat,height,inflorescence,new,null,ovary,position,seed,shape,stigma,stone,structure,sympodial,texture,width,wing,young
520	wfo-0001032264	success	183	174	152	31	22	0.831	.2,.5,0.25-0.5,0.25-0.75,0.5-1,0.6-2.2,0.8-10,0.8-4,1-1.5,1.2-2,1.5-1.8,1.8-3,10-22,2-50-flowered,2-6,3-15,3-9,4.5-5,5-9,6-17,acuminate,acute,along,anther,anthesi,apex,apiculate,appearing,bark,base,branched,broadly,bud,bullate,calyx,cell,cell-layer,cm,corolla,cup-like,curling,deciduous,deflexed,densely,dia,difoliate,dry,elliptic,epidermal,exserted,filament,flattened-reniform,fleshy,flower,free,fruiting,glabrous,globose,gnarled,green,habitat,hair,inflorescence,lamina,larger,lateral,layer,leaf,like,live,lobe,lobed,long,main,major,margin,material,middle,minor,minutely,mm,multiseriate,narrowly,nearly,occasionally,often,older,one,opposite,ovary,ovoid,pair,pale,papillose,parallel,pedicel,peeling,petiole,pitted,planar,plant,pointed,pore,poricidal,primarily,prominent,pubescent,quite,raised,red-papillose,reddish,reddish-tan,rounded-deltoid,scar,scattered,several,shaped,sheet,sheltered,short,simple,size,small-capitate,small-celled,somewhat,soon,sparsely,stem,stigma,style,surface,tall,tear-drop,thick,time,tip,transversely,trichome,trunk,tube,uniseriate,unit,vein,weak,white,whitish,wide,widest,woody,x,yellowish-brown,young	3,apar,ba,berry,closely,differing,eaf,edicel,eed,geminat,greyi,incrassate,large,lon,lower,minute,nflorescence,overlapping,papillo,portion,revolute,ruit,shrub,slender,spaced,straight,tapering,tree,ud,upper,ympodial	color,count,diameter,fruit,geminate,greyish,growth,height,length,mentioned,new,position,prickle,primary,seed,shape,stone,structure,sympodial,texture,width,wing
521	wfo-0001032274	success	192	181	152	40	29	0.792	.5,0.15-0.2,0.5,0.5-0.7,0.5-1,0.5-1.5,0.7-1.8,0.9-1,1-1.2,1-1.5,1-3,1.5-2,2-3.5,2-7,3-10,3-4,3-5,3-6,3/4,5-7,<,acuminate,acute,anther,anthesi,apex,apiculate,apparently,appearance,arching,articulated,axillary,base,berry,borne,branch,calyx,capitate,cell,clustered,cm,conical,connivent,corolla,deltate,dendritic,densely,diameter,distal,ellipsoid,elliptic,filament,filiform,flattened-reniform,flower,free,fruiting,glabrous,globose,green,grey,group,growth,highly,inflorescence,irregular,lanceolate,lax,leaf,lengthening,less,like,lobe,lobed,long,loosely,margin,markedly,minute,minutely,mm,new,nodding,non-reproductive,obtusely,occasionally,often,older,once-branched,pair,pale,pedicel,peduncle,peg,petiole,pitted,platform,plurifoliate,pore,poricidal,primary,pubescent,purple,quadrate,red,reflexed,reproductive,ridge,ridged,ripe,rounded,scar,shape,shiny,shoot,short,shrub,simple,size,sleeve,slit,small,sometimes,sparsely,square,stellate,stem,stigma,strongly,style,suckering,surface,terminal,testal,tinged,tip,trichome,truncate,tube,uniseriate,unit,upper,usually,variable,vein,violet,visible,way,white,woody,x,yellow	0,2,5-merou,ag,alyx,ark,ba,basal,brown,eaf,eed,entire,exserted,fleshy,geminat,glabrou,ilament,lower,membranous,nflorescence,one,orolla,papillo,pendan,per,perfect,pericarp,platfor,portion,puberulent,reddish,ruit,somewhat,tem,thin,twinin,two,ud,vary,ympodial	age,bark,bud,color,count,fruit,geminate,habitat,height,lateral,length,major,minor,null,ovary,paler,papillose,pendant,position,prickle,seed,stone,structure,sympodial,texture,twining,width,wing,young
522	wfo-0001032276	success	152	164	132	20	32	0.868	-,.25,.5,0.25-1.5,0.3-1,0.5-0.75,0.5-1,0.8-1,1,1-1.5,1-2,1.8-2,2-2.5,2.5-4,3-3.5,3-6-flowered,5-7,7-8,9-18,acute,along,anther,anthesi,apart,apex,attenuate,bark,base,beneath,broadly,calyx,cm,converging,corolla,cup-shaped,curly-tipped,decurrent,deflexed,deltoid,densely,dia,ellipsoid,elliptic,evenly,except,exserted,filament,filiform,free,fruiting,geminate,glabrous,globose,green,lamina,later,lateral,leaf,like,lobe,lobed,long,long-pubescent,main,margin,middle,minute,minutely,mm,narrowly,nearly,node,non-reproductive,obovoid,occasionally,older,onto,opposite,ovary,ovoid-reniform,pair,pale,papillose,pedicel,perhaps,petiole,pitted,plant,pore,poricidal,prominent,pubescent,raised,reflexed,remaining,rest,scar,shaped,short,shrub,simple,slender,slightly,somewhat,soon,spaced,sparsely,stem,stigma,straw-colored,strongly,style,surface,tall,tapering,tear-drop,tip,triangular,trichome,tube,unifoliate,uniseriate,unit,vein,white,widely,widest,winged,woody,x,yellow,young	ba,blade,brown,capitat,dark,dry,eaf,edicel,eed,greyish-gree,lower,material,nflorescence,portion,raise,ruit,straight,tub,ud,ympodial	0.5,3-6,bud,capitate,cell,color,count,diameter,flower,fruit,greyish-green,growth,habitat,height,inflorescence,length,major,mentioned,minor,new,position,prickle,primary,seed,shape,size,stone,structure,sympodial,texture,width,wing
523	wfo-0001032277	success	163	147	120	43	27	0.736	.5,0.2-0.6,0.8-3,1-1.1,1-1.2,1-1.5,1-2,1-5,1.5-1.8,1/2,10-14,2-4,2-6-flowered,3-3.5,3-9,5-6,acute,along,anther,anthesi,apex,appear,area,auriculate,bark,base,beneath,berry,blunt,branched,bright,calyx,closely,cm,corolla,cup-shaped,deltoid,densely,dia,drooping,ellipsoid,elliptic,erect,filament,flattened-reniform,free,fruit,fruiting,glabrous,globose,green,immature,impressed,indentation,inflorescence,internodal,lateral,lax,leaf,lobe,lobed,long,main,margin,mature,middle,minutely,mm,number,obscured,opposite,ovary,overlapping,pair,papillae,papillose,partially,pedicel,petiole,pitted,pore,poricidal,prominent,puberulent,pubescent,raised,remaining,ripe,round,rounded,scar,shrub,simple,slender,small,spaced,sparsely,stem,stigma,strict,style,surface,tall,tapering,tip,translucent,trichome,tube,two,uniseriate,unit,varying,vein,virgately,way,white,widest,x,yellow,young	0.1-0.5,0.75-1,2-2.5,8-9,apiculate,appearing,ba,blade,coriaceous,dry,eaf,edicel,eed,exserted,geminat,gre,incrassate,like,lower,nflorescence,occasionally,older,pale,paler,portion,pubescenc,reddish,rest,revolute,ruit,slende,specimen,spicy-fragrant,straight,strongly,styl,truncate,trunk,tub,ud,woody,yellowish-tan,ympodial	bud,cell,color,count,diameter,flower,geminate,grey,habitat,height,length,major,minor,null,position,prickle,primary,pubescence,seed,shape,size,stone,structure,sympodial,texture,width,wing
524	wfo-0001032304	success	249	192	167	82	25	0.671	-3,.6-1.2,.9-1.4,/20,0-120,0.2-0.3,0.3-1.5,0.5-4.5,1.1-2,1.2-3,1.5-3.2,1.6-1.9,1.8-4,1/2,1/5,1/8,2-4,2-5,2.5-19.5,21,3-10,3-15,3-20,3-4.5,4-7.5,44,5-6,5.5-9,7-27,7.5-12,9-13,abaxially,acute,adaxially,along,anther,anthesi,apex,articulated,ascending,axe,axillary,bark,base,becoming,berry,blackish,blade,blunt-tipped,branched,broadly,brownish,bud,calyx,campanulate,chartaceous,cm,continued,corolla,dark,dendritic,dendritic-echinoid,diameter,directed,distal,due,echinoid,elliptic,especially,few-,few-rayed,filament,fleshy,flower,free,fruit,fruiting,glabrescent,granular-tomentose,green,greenish,growth,hair,juvenile,lateral,leaf,length,lobe,long,long-,long-stalked,main,many,many-rayed,margin,midvein,mixed,mm,mostly,multangulate,oblong,obtuse,occasionally,older,orbicular,ovate,ovate-lanceolate,overlapping,pale,partly,pedicel,peduncle,petiole,plant,plurifoliate,porrect-stellate,present,probably,pseudo-terminal,pubescent,rachi,rarely,ray,relatively,ripe,scabridulous,seed,sessile,short,short-,short-stalked,shrub,side,simple,small,spreading,stellate-tomentose,stem,stigma,style,subglobose,terete,thick,thick-stalked,thin,thin-,thin-stalked,time,tomentose,touching,toward,tree,triangular-ovate,tube,unarmed,unit,usually,vein,velutinous,violet,white,whitish,wide,x,yellow,yellowish,young	0.5-3,0.9-1.3,1,1-3.5,1.2-2.3,1.3-2.1,1/3-1/2,10,18,2-4.2,2/3-3/4,3-6,3.2-3.8,3.2-5.5,accrescent,acuminate,ag,apart,apical-lateral,apparently,appressed-tomentose,ba,branch,brown,capitat,closely,conical,decurrent,dehiscing,deltoid,dendritic-echinoi,densely,eaf,echinoi,entire,exserted,extend,glabrescen,glabrous,high,honeycombed,inserted,introrse,large,least,lobed,long-attenuate,longitudinal,lower,m.,multangulat,nflorescence,obscured,often,opaque,orolla,ovat,perfect,pore,rather,reniform,reticulate-punctate,rotate-stellate,ruit,runk,slit,somewhat,spaced,sparingly,stamen,strongly,suborbicular,sulcate,suture,tamen,testa,tomentu,unarme,vary,way,within,ympodial	capitate,cell,color,count,habitat,height,inflorescence,major,minor,new,ovary,position,prickle,primary,scar,shape,size,stone,structure,surface,sympodial,texture,tip,width,wing
525	wfo-0001032307	success	153	157	126	27	31	0.824	.5,/3,0.2-0.5,0.4-1.3,1-1.5,1-2,1.5-2,1.5-5,10-20,2-5,2.5-12,2.5-3.5,30,4-8,5-12,5-25-flowered,7-18,?,abaxial,acute,along,anther,anthesi,apex,bark,base,branched,calyx,campanulate,capitate,christmas-tree-like,cm,congested,corolla,dark,deltate,dendritic,densely,dia,ellipsoid,elliptic,elongate,erect,exserted,filament,flattened-reniform,fleshy,free,fruiting,glabrate,glabrous,globose,green,growth,immature,incrassate,inflorescence,later,lateral,leaf,like,lobe,lobed,long,loose,main,many,margin,middle,minute,minutely,mm,new,ovary,pair,pale,papillae,pedicel,petal,petiole,pitted,planar,plant,pore,poricidal,prominent,pubescent,reddish,reddish-brown,rest,scar,shaped,shrub,small,spaced,sparsely,stem,stigma,stout,strongly,style,surface,tall,tan,tear-drop,terminal,thick,thickened,time,tip,tree,tree-like,trichome,truncate,tube,unevenly,upper,variable,vein,way,white,wide,widest,within,woody,young	2.5-3,3.5-4,adaxial,apar,berry,blade,body,branch,brow,eaf,edicel,eed,either,flat,inflorescenc,lon,lower,nflorescence,older,papillo,plurifoliat,portion,ruit,tub,type,ud,ympodia	5-25,apart,brown,bud,cell,color,count,diameter,flower,fruit,habitat,height,length,major,minor,papillose,plurifoliate,position,prickle,primary,seed,shape,size,specified,stone,structure,sympodial,texture,unit,width,wing
526	wfo-0001032308	exception_thrown	190	0	0	190	0	0.0		0-3,0.2-2.1,0.3-5,0.7-1,0.7-1.2,1-10,1-2,1.5-2.5,1.8-2.5,1.9-3,12-16,2,2-3,2-4,2-6,3-10,3-6,3.8-5,4-7,4-8,4.8-7.7,5-7,5-merou,6,6-11,8-9,abaxially,absent,acumen,acute,adaxially,ag,along,alyx,anther,apart,apex,apparently,articulated,axe,axillary,base,berry,blade,broadly,brownish,bud,capitat,cell,chartaceous,ciliate,clavate,cm,condition,connivent,cordate,corolla,covering,cuneate,deep,diameter,digestion,distal,dorsally,dot,drying,eaf,edge,eed,elliptic,enzyme,especially,exceeding,filament,flat,flower,folded,forked,fresh,fruit,geminat,generally,glabrou,glabrous,globose,greatly,green,green-white,greenish,hair,hair-like,hal,half,homostylous,honeycomb-shaped,interjected,invested,irregular,lanceolate,larger,lateral,leaflet,leave,lengthening,like,living,lobe,lobed,long,lower,make,margin,medium,membranous,midrib,minute,minutely,mm,much,mucilaginous,narrowly,nflorescence,non-glandular,obtuse,odd-pinnate,often,orbicular,orolla,ovate,ovoid,pair,pedicel,peduncle,pentagonal,perfect,petiole,petiolulate,petiolule,plant,plurifoliate,pore,poricidal,puberulent,pubescent,pure,removed,ripe,rounded,ruit,scattered,seed,sessile,seudostipule,shape,short,slightly,slit,spaced,specimen,stamen,ste,stem,stigma,straight,style,substellate,subtending,sympodial,tamen,terminal,testal,thick,throughout,tip,tri-,trichome,truncate,tube,typically,unit,usually,vary,varying,wall,wet,white,whitish,wide,x,yellow	
527	wfo-0001032335	success	215	172	129	86	43	0.6	0,0.05,0.2,0.4,0.5,100+,15,16,abaxial,abaxially,adaxial,anther,anthesi,base,beneath,berry,branched,branching,bright,c.,calyx,capitate,cell,center,closely,cm,connivent,corolla,covered,cup-shaped,deltate,densely,diameter,drying,ellipsoidal,elliptic,evenly,filament,flower,free,fruiting,fused,glabrous,globose,gold,gradually,growth,half,impressed,inflorescence,lamina,length,lengthening,less,like,lobe,lobed,long,loosely,lower,many,margin,markedly,midpoint,minute,minutely,mm,moderately,multangulate,narrowing,narrowly,near,new,orange,pair,pale,part,pedicel,peltate,persistent,petiole,plurifoliate,pore,poricidal,porrect,porrect-stellate,primary,pubescence,pubescent,ray,reddish,reflexed,regularly,ripe,scar,sessile,short,short-stalked,shrub,simple,slightly,slit,small,sometimes,somewhat,spaced,sparsely,stellate,stem,stigma,stub,style,surface,terminal,time,tip,tree,trichome,tube,unit,vein,visible,way,white,wide,woody,yellow,â4,âstellate	'',.2,.5,0.2â0.3,0.5â1,0.9â1,1.5â2,100,10â12,12â15,1â1.2,1â1.5,1â3,2.5â3,2â10,2â2.5,2â5,3361,4â14,4â5,4â6-rayed,5-merou,5â6,6â19,6â6.5,7â10,>,acuminate,acute,ag,along,alyx,apar,apex,appearing,ark,articulated,attenuate,axe,boh,chartaceous,dichasia,discolorous,eaf,eed,elongate,entire,equal,erec,exserted,fide,flattened-reniform,golden-brow,golden-yellow,ilament,membranous,nflorescence,nodding,older,onto,orolla,papillo,peduncle,per,perfect,pericarp,pitted,plane,portion,ruit,scurfy,shiny,silvery,square,stout,strongly,tal,tem,testal,thin,ud,unevenly,upper,vary,varying,ympodial	0.2-0.3,0.9-1,1-1.2,1-1.5,1-3,1.5-2,10-12,12-15,2-10,2-2.5,2.5-3,4-14,4-5,6-19,6-6.5,7-10,age,apart,bark,bud,color,count,dichasial,erect,fruit,golden-brown,habitat,height,leaf,mentioned,ovary,papillose,position,prickle,shape,stone,structure,sympodial,tall,texture,width,wing,young
528	wfo-0001032337	success	225	156	124	101	32	0.551	0.4-1.5,0.5-3.5,1-2,1.5,1.6-4,2-14,2-3.5,4-9,8-10,8-17,9-21,9-29,abaxially,acuminate,acute,adaxially,along,anther,apex,apiculate,apparently,attenuate,axillary,base,basiscopic,berry,bud,canescent,cell,chartaceous,ciliate,clavate,cm,connivent,corolla,covering,cuneate,darker,decurrent,densely,diameter,distal,dot,especially,filament,flower,forked,fruit,generally,glabrous,globose,green,hair,hair-like,half,herb,lanceolate,lateral,leaf,light,like,lobe,long,make,margin,membranous,midrib,minutely,mm,mucilaginous,oblique,obtuse,odd-pinnate,often,orbicular,ovate,ovoid,pedicel,pentagonal,perfect,petiole,petiolulate,plant,plurifoliate,puberulent,pubescent,rarely,ray,ripe,rotate,rounded,scattered,seed,sessile,short,side,size,sometimes,sparsely,stem,stigma,style,subglabrous,subtending,tall,terminal,testal,thick,tip,tissue,tri-,tube,typically,unit,unwinged,usually,violet,violet-purple,wall,wet,white,wide,wing,x	0,1,1-10,1-4,1.2-2.8,1.4-2,10,2,2-4,2-4.5,2-7,2.3-11.5,2.3-4.8,3-4,3-8,3.6-5,4-17,4-6,4.5-14.5,5-11,5-merou,acumen,ag,alyx,apart,articulated,axe,blade,borne,broadly,brownish,capitat,condition,cordate,deep,digestion,dorsally,drying,eaf,edge,eed,elliptic,end,enzyme,erec,exceeding,except,flat,folded,frequently,fresh,geminat,glabrou,greatly,green-white,greenish,homostylous,honeycomb-shaped,interjected,leaflet,lengthening,living,lower,middl,mottled,nflorescence,orolla,pair,paired,peduncle,petiolule,pore,poricidal,proximal,purple,reduced,removed,ruit,seudostipule,singly,slightly,slit,small,spaced,specimen,stamen,ste,stolo,straight,subequal,subsessile,tamen,tem,tertiary,throughout,tuber,unpaired,vary,whitish,yellow,ympodial	anthesi,bark,calyx,capitate,color,count,free,fruiting,geminate,growth,habitat,height,inflorescence,length,major,minor,new,null,ovary,position,prickle,primary,scar,shape,stone,structure,surface,sympodial,texture,vein,width,young
529	wfo-0001032344	success	157	140	99	58	41	0.631	0.2-0.5,1-1.3,1-3,1-4,1.5-6,1.6-2.4,10-29,2-2.8,2-3,2.2-4,2.8,3-5,3-9,4-11,4-8,5-10,6-15,9.5-21,abaxially,acumen,acuminate,acute,adaxially,apex,apical,apically,base,bluish,branched,calyx,cell,cm,connate,corolla,covering,cuneate,cyme,dark,dehiscent,diameter,dichasial,dichasially,distal,dorsally,dot,ebracteate,exceeding,filament,flower,forked,generally,globose,green,half,herbaceous,inrolled,introrse,lateral,leaf,lobe,long,long-attenuate,make,maturing,medium,mm,monochasial,mucilaginous,oblique,odd-pinnate,often,ovoid,pedicel,peduncle,perennial,petiole,plant,poricidally,puberulent,pubescent,purple,seed,short,size,slit,smooth,stamen,stigma,style,testal,thick,tuber-bearing,typically,unit,violet,wall,white,wide,yellow	1.5-4.5,3-6-foliat,3-7,3-8.5,3.5-6.5,abruptly,absent,articulate,belo,broadly,decurrent,digestion,diminishing,eaf,edge,eed,elliptical,emoval,enzyme,globo,green-white,hair-like,honeycomb,interjected,layeral,leaflet,living,lon,lower,lunat,nflorescence,nther,orolla,ovate,pair,pattern,perfect,petiolule,plan,proximal,reveal,rotate,rotate-pentagonal,ruit,scarce,sessile,seudostipule,sometimes,specimen,straight,tal,tem,terminal,throughout,toward,vary,ympodial,Â¼	'hair-like,3-6-foliate,anther,anthesi,bark,bud,color,count,free,fruit,fruiting,growth,habitat,height,inflorescence,length,major,margin,mentioned,minor,new,ovary,position,prickle,primary,scar,shape,stem,stone,structure,surface,sympodial,tall,texture,tip,tube,vein,wet,width,wing,young
530	wfo-0001032354	success	171	144	115	56	29	0.673	0,1-10,1-2,1-3,10-lobed,2-2.5,38/2,40-75,acuminate,angular,anther,anthesi,apex,aspect,aster,axillary,base,becoming,berry,bilobed,branch,branched,broadly,brown,calyx,campanulate,capitate,cell,cm,coarsely,corolla,creating,deep,dia,discoidal,effect,ellipsoid,except,facetted,filament,fleshy,flower,fork,general,glabrous,glandular,globose,gree,green,greenish-ivory,greyish,hair,halfway,lasting,leaf,lengthening,lobe,lobed,maturity,minute,minutely,mm,obovate,obovoid,occasionally,oval,ovary,ovoid,pale,pebble-shaped,pedicel,pedicellate,pinnatisect,pore,poricidal,pubescent,rh,rotate,rugose-reticulate,secondary,seedling,several,shape,shoot,shrub,simple,single,sinus,size,slightly,slit,small,soft,somewhat,sparse,spreading,stellate,stem,stigma,stone,style,surface,tall,tip,trichome,unit,variable,vein,violet,wide,wing,wooded,woody,year,young	0-5,0.3,0.5-1,0.8-1,0.8-1.2,1-5,2,2.5-3,25,250-400,29,3-4,4-6,5-10,5-15,acute,almost,axi,c.,colour,cuneate,cut,decurrent,deeply,distal,eaf,eed,exerted,gre,lanceolat,large,linear,lower,midrib,narrow,nflorescence,ovate,pair,peduncle,plurifoliat,puberulent,rather,rounded,ruit,smaller,smel,straight,strongly,tub,ud,uniseriate,unpleasant,usually,within,x,ympodial	bark,bud,color,count,diameter,free,fruit,fruiting,grey,growth,habitat,height,inflorescence,length,margin,mentioned,new,petiole,plurifoliate,position,prickle,primary,scar,seed,structure,sympodial,texture,tube,width
531	wfo-0001032358	success	216	187	163	53	24	0.755	.1,.2,.3,.4,.5,/2,0.5-3,0.7-1,1-2,1.3-1.7,1.5-2,1/4-1/2,13-20,15-40,2-10,2-3,2-4,2-5,2.2-7.5,3-10,3-4,3.5-13,4-4.5,4-7,abaxially,acute,adaxially,along,anther,anthesi,apart,apex,appearing,armed,bark,basal,base,based,berry,branched,broad,brown,bulbous,calyx,capitate,cell,center,cm,cordate,corolla,cupuliform,curved,densely,diameter,difoliate,drying,equal,erect,expanding,exserted,filament,flattened,flower,free,fruit,fruiting,furcate,geminate,glabrescent,glabrous,globose,green,growth,heteromorphic,inflorescence,internodal,interpetalar,irregular,irregularly,lamina,leaf,left,lengthening,like,linear,lobe,lobed,long,longer,margin,margined,markedly,membranous,midpoint,midrib,midvein,minutely,mm,new,often,orangish,ovate,ovoid,pair,pale,paler,papillate,pedicel,peg,persistent,petiole,pitted,planar,pore,poricidal,porrect,present,prickle,prickly,primary,pubescent,purple,ray,red,reniform,ripening,ruffly,scar,sessile,short,short-stalked,shrub,simple,sinus,slightly,slit,small,sometimes,somewhat,spaced,sparsely,spreading,staman,stellate,stem,stigma,strongly,style,surface,thick,time,tip,trichome,tube,tuberculate,unevenly,unit,vein,way,whitish,widely,x,yellowish	0,0.2-4,0.6-0.8,0.6-1,1-1.6,1.5-2.5,12-20,2,4-8,4-merous,4.5-5,abscissio,another,away,dorsal,eaf,eed,entire,frui,glabrescen,lower,lowermost,maturity,nflorescence,nodding,occasionally,older,one,papillat,part,peduncle,per,perfect,pericarp,portion,rhachi,rotate-stellate,ruit,shiny,sinuate,space,tan,thin,three,tub,two,type,ud,unisexual,upper,usually,ympodial,zygomorphic	.5-5,abscission,bud,color,count,habitat,height,lateral,length,major,minor,null,ovary,position,seed,shape,size,stone,structure,sympodial,texture,width,wing,young
532	wfo-0001032367	success	231	244	211	20	33	0.913	-3,.2,.4,0-0.3,0.2â0.35,0.4-0.5,0.4â0.5,0.4â0.6,0.4â1,0.5â0.8,0.5â2,0.6,0.6â0.8,0.7-1.1,0.8,0.8â2,1-2,1-2.1,1.2,100-300,1â1.5,1â1.8,2,2-3-celled,2-4,2.2â2.5,2.2â2.8,2.5â3,3-5,3-celled,3.2â4,3â10,3â5,3â6,4,4â6.5,5-merous,5.5â6.9,5â18,6-8,6.8â8.2,7â10,8,abaxial,abaxially,accrescent,acicular,acute,adaxial,adaxially,also,alyx,anther,anthesi,apex,around,axi,base,berry,blade,branch,broad-based,calyx,capitate,cm,conical,connivent,copious,cordate,cream,curved,dark,deciduous,densely,diameter,difoliate,directed,distall,enlarged,entire,equal,erect,expand,fertile,filament,flattened-reniform,flower,free,fruiting,geminate,glabrous,gland-tipped,glandular-puberulent,globose,grading,green,greenish,hair,herbarium,heterostylous,hyaline,immature,inflorescence,infructescence,lanceolate,largest,lateral,layer,leaf,least,length,light,lobe,lobed,long,long-styled,longer,lowermost,major,many,margin,maturity,membranous,mesocarp,midpoint,minute,minutely,mixed,mixture,mm,moderately,mottled,narrowly,nearly,obtuse,often,one,ovary,ovate,pair,pale,pedicel,peduncle,per,petiole,pore,poricidal,portion,prickle,prickly,puberulent,pubescence,pubescent,rarely,ray,recurved,red-brown,rest,scarcely,scattered,secondary,sessile,shallow,short-styled,shorter,shrub,similar,simple,size,small,smaller,somewhat,sparsely,specimen,spongy,spreading,staminat,stellate,stem,stigma,straight,style,suborbicular,surface,tall,tapering,terete,thick,time,tip,tooth,triangular,trichome,truncate,tube,twice,unarmed,unbranched,uniformly,uniseriate,unit,usually,variable,vary,vein,white,whitish,wide,yellow,â15,â5	2â2.5,adaxiall,arme,ba,congested,eaf,eed,geminat,lower,nflorescence,orolla,oung,papillat,ruit,slender,spreadin,ste,tamen,tightly,ympodial	1-1.8,2-2.5,3-6,3.2-4,4-6.5,armed,bark,bud,cell,color,corolla,count,distally,fruit,growth,habitat,height,new,null,papillate,position,primary,scar,seed,shape,stamen,stone,structure,sympodial,texture,width,wing,young
533	wfo-0001032407	success	216	160	127	89	33	0.588	0.3-0.6,0.5-3,0.8,0.8-0.3,1-2,1.4-2.7,1.5-2.2,10-19.5,10-27,2-10.5,30,38,4-11,4-48,5-23,5-30,6,8-10,abaxially,acumen,acuminate,adaxially,anther,apex,apparently,asymmetrical,attenuate,axillary,base,basiscopic,berry,brownish,bud,cell,chartaceous,ciliate,clavate,cm,coarsely,commonly,condition,conical,connivent,corolla,covering,dark,densely,diameter,distal,drying,especially,filament,finely,flower,forked,fresh,fruit,generally,glabrous,green,green-white,greenish,hair,hair-like,half,herb,lanceolate,lateral,leaf,less,light,like,lobe,long,make,margin,medium,membranous,minutely,mm,mottled,mucilaginous,narrow,odd-pinnate,ovoid,pedicel,pentagonal,perfect,petiole,petiolule,plant,plurifoliate,puberulent,pubescent,purple,rarely,ripe,rotate,seed,semierect,side,simple,size,sparsely,stem,stigma,style,subtending,symmetrical,tall,terminal,testal,thick,throughout,tip,tissue,tri-,tube,unit,unwinged,wall,wet,white,whitish,wide,wing,x	0-4,0.3-8,0.4-4,1-10,1-2.4,1-5,1.2-7,12,2-4,2.5-10.5,2.5-9,3-15,3.1-13.5,4-7,5,5-merou,7-9,absent,ag,along,alyx,apart,arranged,articulated,axe,bead,blade,capitat,decreasing,digestion,eaf,edge,eed,elliptic,elongated,enzyme,erec,exceeding,folded,geminat,glabrou,gradually,homostylous,honeycomb-shaped,interjected,larger,leaflet,lengthening,living,lower,middle,minute,moniliform,multiple,necklace,nflorescence,obtuse,orbicular,orolla,ovate,pair,peduncle,pore,poricidal,proximal,pubescen,ray,removed,round,ruit,secondary,sessile,seudostipule,slit,spaced,specimen,stamen,ste,stolon,straight,subequal,tamen,tem,tuber,typically,usually,vary,yellow,ympodial	anthesi,bark,calyx,capitate,color,count,erect,free,fruiting,geminate,growth,habitat,height,inflorescence,length,major,mentioned,minor,new,ovary,position,prickle,primary,scar,shape,stone,structure,surface,sympodial,texture,vein,width,young
534	wfo-0001032465	success	233	173	146	87	27	0.627	+,-10,-14,-9,0.2,0.5-,0.5-2,1-,1-1.5,1-1.7,1.2-1.5,1.5,1.5-1.8,1.5-2,1/3,2,2.5-5.5,25,3-4,3-5,3-8,4,5,5-7,5-8,9,abaxial,acuminate,acute,angled,anther,anthesi,apex,base,berry,black,branched,brown,calyx,capitate,cell,clasping,cm,conical,connivent,cordate,corolla,de,deeply,deltate,densely,diameter,distal,drying,ellipsoid,erect,filament,flattened,flower,free,fruiting,glabrous,glandular,glandular-tipped,globose,green,greenish,growing,growth,inflorescence,janeiro,larger,later,lateral,leaf,length,like,lobe,lobed,long,loosely,margin,minute,minutely,mm,narrowly,new,nodding,occasionally,often,pair,paired,papillate,pedicel,petiole,pinnate,pinnatifid,planar,primary,pubescent,purplish,reniform,reticulate,rio,ripe,scattered,seed,shape,similar,simple,size,somewhat,sparsely,stem,stigma,strongly,style,subshrub,surface,terminal,thicker,time,tip,toward,transparent,trichome,truncate,tube,tuft,twining,uniseriate,unit,upper,usually,variously,varying,vein,vine,violet,way,white,woody,x,yellowish,young,Â½	-11,.2,.5,0,1-celled,1.5-5,2-2.5,3-3.5,3-9,5-merou,ag,alyx,apar,apically,appearing,ark,articulated,axi,basal,ciliate,commonly,coriaceous,decreasing,deep,deeper,eaf,edge,eed,elliptic,elongate,entire,exserte,filiform,fringe,glabrescen,gland,half,ilament,included,irregular,irregularly,leaving,lengthening,lower,mature,membranous,nflorescence,older,orolla,outline,ovate,papillo,peduncle,peg,pendan,pentagonal,per,perfect,pericarp,plurifoliat,pore,poricidal,portion,puberulent,reddish,revolute,ruit,scar,shallow,shiny,sinus,sleeve,slit,spaced,splitting,stellate-rotate,tem,testal,thin,tiny,twinin,ud,unicellular,vary,wall,widest,ympodial	1.5-,14,bark,color,count,fruit,glabrescent,habitat,height,herb,major,minor,null,ovary,papillose,pendant,plurifoliate,position,present,prickle,stone,structure,sympodial,texture,width,wing,woodines
535	wfo-0001032494	success	163	166	139	24	27	0.853	.1,.4,.5,0.6-1,0.75-1,0.8-1,0.9-1.2,1-1.5,1.1-1.2,1.45-1.5,1.5,1.5-8,1.8-4.5,16.5-20.5,2.3-2.5,2.5,2.5-8,3-4,3.4-14.5,3/4,4-8,5-40,5-6.4,8-11,acuminate,anther,anthesi,apart,apex,appearing,attenuate,axil,bark,base,beginning,beneath,berry,brown,bullate,calyx,clavate,cm,corolla,decurrent,deflexed,dia,difoliate,dry,equal,evenly,expanded,filament,flattened-reniform,flowered,free,fruit,fruiting,furcate,geminate,glabrous,globose,greenish-yellow,lateral,leaf,light,lobe,lobed,long,lower,main,major,margin,material,middle,minor,minutely,mm,narrowly,nearly,node,occasionally,opposite,orange,ovary,ovate,ovoid,pair,pale,papillae,papillose,pedicel,petiole,pitted,planar,pore,poricidal,prominent,proximal,pubescent,raised,revolute,ridge,scar,shaped,shrub,simple,size,slender,slightly,small,somewhat,spaced,stem,stigma,style,surface,tall,tapering,tear-drop,tip,tree,triangular,trichome,tube,two-winged,uniseriate,unit,upper,vein,venation,way,white,whitish-green,widest,winged,woody,x,yellow,zig-zag	1.6-2,accrescent,ba,differing,eaf,edicel,eed,except,exserted,geminat,incrassate,inflorescenc,lax,lenticellat,lon,nflorescence,papillo,portion,quite,ruit,straight,tan,ud,ympodial	acrescent,bud,cell,color,count,diameter,flower,growth,habitat,height,inflorescence,length,lenticellate,mentioned,new,position,prickle,primary,seed,shape,stone,structure,sympodial,texture,width,wing,young
536	wfo-0001032507	success	206	147	110	96	37	0.534	/4,0.25,0.3,0.5,0.7-1.2,0.8,1,1.2-1.7,1.3,2,6,abaxial,abaxially,absent,acuminate,adaxially,anther,anthesi,apiculate,base,becoming,berry,blue,branched,broadly,brown,bud,calyx,campanulate,cell,cm,collection,compound,corolla,deltate,diameter,distinct,ellipsoid,elongating,fertile,filament,flattened-reniform,flower,flowering,four,fruiting,glabrous,globose,green,hair,herbaceous,herbarium,highly,lateral,light,lobe,lobed,long,major,margin,material,minutely,mm,narrowly,oblong,occasionally,often,one,pedicel,pentagonal,perennial,petiole,pinnately,pitted,plant,present,prickle,puberulent,pulp,purple,quadrate,ranging,rarely,reddish,rounded,shape,side,simple,slender,spreading,stem,stigma,stout,strongly,style,surface,terminal,testal,tip,tube,unbranched,unit,variable,vein,vine,way,white,wide,woody,Ã	.2,.5,1.5â2,1.5â7,10â20,15â20,1â1.5,1â10,2.5â4,2.5â6,20â30,2â9,3â5,3â7,4â10,5â10,5â20,5â8,8â15,abundant,acute,adaxiall,adjacent,ag,alyx,apex,armed,articulated,blade,chartaceous,confluent,connivent,cream,curved,deep,distally,dr.,eaf,eed,either,elliptic,entire,equal,exserted,fifth,individual,internode,interpetalar,larger,leaflet,lengthening,longer,lower,midrib,nearly,nflorescence,observe,orolla,ovate,pale,papery,peduncle,pericarp,pinnate,pinnatifid,pistillate,plurifoliat,pore,poricidal,purplish,rachi,recurve,regularly,rotate-pentagonal,rugose,ruit,single,sinus,slightly,slit,sometimes,staminate,straight,tamen,tear,time,tissue,unequal,unlobed,usually,variously,vary,widest,wood,yellowish,ympodial	1-1.5,1.5-7,10-20,15-20,2-9,2.5-4,2.5-6,20-30,3-5,5-8,bark,color,count,free,fruit,growth,habitat,height,inflorescence,leaf,length,new,observed,ovary,plurifoliate,position,primary,recurved,scar,seed,stone,structure,sympodial,texture,width,wing,young
537	wfo-0001032523	success	200	182	154	46	28	0.77	-2,-5,.2,.5,/4,0-0.15,0-10,0-12,0-15,0-3,0.1-0.2,0.2,0.2-0.4,0.3-0.5,0.4-1,0.4-1.5,0.5-1,0.6-0.7,0.6-0.8,1-1.5,1-2,1-3,1-8,1.3-1.6,1.5-3,1/3-1/2,15-30,2,2-2.5,2-4,2-5.5,2.5-6,3-15,3-4,3.5-4,4-7,5-12,5-20,6-10,6-8,abaxially,acuminate,acute,ame,anther,apart,apex,apically,apparently,bark,base,berry,blade,branching,c.,calyx,cm,conical,connivent,cuneate,curved,deltate,diameter,dull,elliptic,elongating,erect,evenly,filament,filiform,flattened-reniform,flower,free,fruit,fruiting,gently,glabrescent,glabrous,green,hair,herbaceous,inflated,lateral,leaf,length,lobe,lobed,long,longer,margin,mature,maturity,mauve,midpoint,minute,mm,moderately,multangulate,narrow-deltate,older,one,open,orange,orange-brown,ovate,pair,pale,pedicel,perpendicular,petiole,poricidal,porrect,prickle,primary,ray,red,red-brown,reflexed,scandent,scar,secondary,sessile,shrub,simple,sometimes,spaced,sparsely,spherical,spreading,stalk,stalked,stellate,stellate-pubescent,stem,straight,style,surface,tapering,terete,terminal,time,tip,trichome,tube,unarmed,unit,variously,vein,way,weakly,wide,woody,yellow,young	1/4-1/3,10-50,2-2.4,2.7-3,4-5-merous,6-20,abaxial,acuminat,adaxial,alyx,apar,articulated,brow,discolorous,drying,eaf,eed,entire,equal,glabrou,infructescence,lon,lower,membranous,nflorescence,orolla,oung,peduncle,per,perfec,pericarp,plurifoliat,portion,prickly,recurved,ruit,smooth,strongly,subentire,tamen,tertiary,unarme,vary,venation,visible,ympodial	anthesi,brown,bud,cell,color,corolla,count,growth,habitat,height,inflorescence,major,minor,new,null,ovary,plurifoliate,position,seed,shape,size,stigma,stone,structure,sympodial,texture,width,wing
538	wfo-0001032524	success	205	151	116	89	35	0.566	1-2,1-2.5,10-35,12-13,120-210,2-3,2-5,25-90,3-4,3-5,3-8.5,3.5-4.5,4,4-5,50-70,6-13,6-16.5,7-35,abaxially,acumen,acute,adaxially,along,anther,apex,attenuate,axillary,base,bud,cell,chartaceous,ciliate,clavate,cm,connivent,corolla,covering,cuneate,densely,diameter,different,distal,especially,filament,flower,forked,fruit,generally,glabrous,globose,grayish-green,green,green-white,hair,half,head,herb,interjected,lanceolate,lateral,leaflet,length,light,like,lilac,lobe,long,make,margin,membranous,midrib,minutely,mm,mucilaginous,multicellular,non-glandular,obtuse,odd-pinnate,often,ovoid,pedicel,pentagonal,petiole,plant,plurifoliate,puberulent,pubescent,purple,ripe,rotate,rounded,seed,sessile,short,silky,silvery-white,size,stem,stigma,style,subtending,terminal,testal,tetralobulate,thick,throughout,tip,tri-,trichome,tube,unit,unwinged,violet,wall,wet,x	1-10,1.5-2,1.5-4,14-50,2.5-8,4.5-5,4.5-8,5-6,5-9,5-merou,7-8,?,ag,alyx,apart,apparently,arranged,articulated,ascending,axe,bead,berry,blade,brownish,capitat,condition,digestion,dorsally,drying,eaf,edge,eed,elliptic,enzyme,erec,exceeding,except,flat,folded,fresh,geminat,glabrou,greatly,greenish,hair-like,hal,homostylous,honeycomb-shaped,lengthening,living,lower,middle,moniliform,multiple,narrowly,necklace,nflorescence,orolla,ovate,pair,peduncle,perfect,petiolulate,petiolule,pore,poricidal,proximal,reduced,removed,ruit,seudostipule,slit,spaced,specimen,stamen,ste,stolon,straight,subequal,tall,tamen,tem,tuber,typically,usually,vary,whitish,yellow,ympodial	'hair-like,anthesi,bark,calyx,capitate,color,count,free,fruiting,geminate,growth,habitat,height,inflorescence,leaf,major,mentioned,minor,new,ovary,position,prickle,primary,scar,shape,stone,structure,surface,sympodial,texture,vein,width,wing,young,Âµm
539	wfo-0001032532	success	161	131	87	74	44	0.54	0.3-2.5,1-1.5,1-4,1.5-2.6,13-52,15-30,2,2-13,2-3,2.8-3.6,2.8-9.5,3-10,4.5,6,6-22,8-38,abaxially,acuminate,acute,adaxially,apex,attenuate,base,branched,calyx,cell,cm,conical,connate,corolla,covering,cuneate,cyme,deep,diameter,dichasial,dichasially,distal,dorsally,ebracteate,edge,filament,finely,flat,flower,folded,forked,generally,green,half,herbaceous,lateral,leaf,light,lobe,long,long-attenuate,make,medium,mm,monochasial,mucilaginous,oblique,obtuse,odd-pinnate,ovoid,pedicel,perennial,petiole,plant,pubescent,purple,rounded,seed,size,stigma,style,testal,thick,throughout,tip,tuber-bearing,typically,unit,wall,wide,yellow	0-.,1.5-3.2,1.5-4.3,2-,2-10,3-5,3-6-foliat,3.4-12.2,3.7-10,4-5.5,abaxiall,absent,acumen,apical,apically,articulate,coarsel,dehiscent,digestion,diminishing,eaf,eed,elliptical,emoval,enzyme,exceeding,globo,gradually,green-white,hair-like,honeycomb,interjected,introrse,leaflet,living,lon,lower,lunat,maturing,minute,narrowly,nflorescence,nther,often,orolla,ovate,pair,pattern,peduncle,perfect,petiolule,plan,poricidally,proximal,reveal,rotate,ruit,sessile,seudostipule,short,slit,specimen,stamen,straight,subequal,subsessile,tal,tem,terminal,throughou,toward,vary,ympodial,Â¼	'hair-like,0-1.1,0-2.2,3-6-foliate,anther,anthesi,bark,bud,coarsely,color,count,free,fruit,fruiting,globose,growth,habitat,height,inflorescence,length,major,margin,mentioned,minor,new,ovary,position,prickle,primary,scar,shape,stem,stone,structure,surface,sympodial,tall,texture,tube,vein,wet,width,wing,young
540	wfo-0001032536	success	254	209	190	64	19	0.748	/3,0.5,1,1-2.5,1.3-2.2,1.5,10,10-20,10-30,10-50,14-16,2-3,2.5-3,20-22,20-25,20-50,3,3-6,4-6,4-8,4-9,5,5-6,5.5-8,7-10,<,abaxially,abruptly,acute,adaxially,age,angle,anther,anthesi,appressed,around,articulated,axi,bark,base,berry,blade,bright,bristle,bristly,broad-based,broadly,brown,calyx,capitate,caudate,cell,clavate,clearly,cm,conical,curved,dark,deltate,densely,depressed,diameter,difoliate,directed,diverging,elliptic,enlarged,equal,evenly,fading,filament,flattened,flower,free,fruit,fruiting,geminate,glabrescent,glabrous,glandular,glandular-puberulent,globose,grayish,growth,hanging,inflorescence,interpetalar,irregularly,juvenile,lamina,lateral,leaf,leaf-opposed,leaving,length,like,lobe,lobed,long,long-stalked,long-styled,margin,mature,maturity,midpoint,midvein,minute,minutely,mixed,mixture,mm,multangulate,multiseriate,narrowing,narrowly,new,number,occasionally,odor,older,once-branched,open,ovary,papillae,papillate,pedicel,peduncle,pentagonal,petiole,plant,pore,poricidal,porrect,potato,prickle,prickly,primary,protuberance,pubescent,purple,rarely,ray,reddish,reniform,reproductive,rough,scar,scattered,shallowly,short-,simple,slender,slightly,small,smooth,soft,spaced,sparsely,spreading,stalk,stellate,stellate-pubescent,stem,stigma,style,surface,tall,tapering,terete,terminal,time,tip,tissue,tree,triangular,trichome,tube,unit,upward,urceolate,usually,vein,visible,way,white,wide,wood,woody,yellow-green,yellowish	-3,1-2,100,13-24,3-3.5,5-8,5-merous,>,abaxial,adaxial,adaxiall,almost,along,alyx,apar,apex,armed,basal-most,berr,caudat,chartaceous,coriaceous,cu,dbh,deeply,denser,eaf,eed,entire,halfway,heterostylous,inflorescenc,infructesecnce,lower,membranous,midrib,near,nflorescence,oblique,occurring,olive-green,orolla,oung,papillat,part,per,pericarp,portion,prickl,prominent,ruit,short-styled,somewhat,staminate,strongly,tamen,thick,truncate,trunk,unarmed,unequal,vary,ympodial,younger	apart,bud,color,corolla,count,cut,habitat,height,mentioned,position,seed,shape,stone,structure,sympodial,texture,width,wing,young
541	wfo-0001032542	success	161	155	130	31	25	0.807	.25,.25-0.5,.5-1,/4,0.5-1,0.7-1,1-1.5,1-2,1-5,1.5-3.5,10-15-flowered,10-28,2-3,2-3.5,2.5-5,3-5,4-7,4-9.5,4.5-5,5-8,abaxial,abaxially,acuminate,acute,anther,anthesi,apex,apical,attenuate,axi,bark,basal,base,beginning,bluish-green,bright,brown,calyx,capitate,closely,cm,conical,corolla,dark,deflexed,deltate,dendritic,densely,di,difoliate,distal,dry,elliptic,elliptic-obovate,erect,filament,flattened-reniform,free,fruiting,glabrous,globose,golden,green,growth,incrassate,inflorescence,lamina,later,lateral,leaf,less,like,lobe,lobed,long,main,major,margin,minor,minute,minutely,mm,narrowly,near,new,older,opposite,ovary,overlapping,pair,pedicel,petiole,pitted,planar,pore,poricidal,portion,pubescent,rounded,scar,shape,shaped,shining,shrub,simple,size,slender,small,somewhat,spaced,sparsely,stem,stigma,style,surface,tear-drop,tip,treelet,triangular,trichome,tube,unit,vein,way,wide,woody,x,yellow-green,yellowish,young	.5,1-1.3,3-4,adaxially,along,ba,berry,compact,dia,differing,eaf,edicel,eed,either,exserted,geminat,inflorescenc,lon,loose,lower,nflorescence,papillo,persisten,reddish-brown,ruit,slightly,strongly,swollen,tub,ud,ympodial	10-15,bud,cell,color,count,diameter,flower,fruit,geminate,habitat,height,length,papillose,persistent,position,prickle,primary,seed,specified,stone,structure,sympodial,texture,width,wing
542	wfo-0001032564	success	160	154	127	33	27	0.794	.05-0.1,.1,.5,0.3-1,0.75-1,1-1.2,1-1.5,1-2,1.3-2.5,2-2.5,4-5,4-6-flowered,5.5-9,6-7,8-9,along,anther,anthesi,apart,apex,bark,base,becoming,beneath,berry,broadly,bud,calyx,clavate,cm,conical,converging,corolla,deflexed,deltoid,densely,dia,elliptic,except,exserted,extreme,filiform,flower,fruiting,geminate,glabrate,glabrous,globose,green,greenish-white,greyish-red,halfway,lamina,later,lateral,leaf,like,lobe,lobed,long,long-acuminate,main,margin,middle,minute,minutely,mm,narrowly,nearly,node,non-reproductive,often,one,open,opposite,ovary,ovate,ovoid-reniform,pair,papillose,pedicel,petiole,pitted,point,pore,poricidal,projection,prominent,proximal,puberulent,raised,reflexed,ripe,rounded,scar,shaped,shiny,shrub,simple,slightly,small,soon,stem,stigma,strongly,style,surface,tall,tapering,tear-drop,thread-like,time,tiny,tip,trichome,truncate,tube,unifoliate,uniseriate,unit,vein,widest,winged,woody,x,yellowish-green,young	.05,0.25-0.5,1-1.3,1.5,apar,arched,aspec,ba,branch,brown,dark,dry,eaf,edicel,eed,expanded,flattened,fresh,giving,golden,lower,material,member,nflorescence,obovoi,older,papillo,planar,ruit,straight,tan,ud,ympodial	cell,color,count,diameter,filament,free,fruit,habitat,height,inflorescence,length,major,mentioned,minor,obovoid,position,prickle,primary,seed,shape,size,stone,structure,sympodial,texture,width,wing
543	wfo-0001032569	success	164	166	143	21	23	0.872	.5,/3,0.5-10,0.8-1,1-1.2,1-1.5,1-2,1-4,1.2-5,1.5,1.5-2,1.7-2,2-3,2-4,4-18,4-8,5-6,5-60-flowered,7-27,7-9,acute,along,anther,anthesi,apex,apparently,appearing,axi,bark,base,bearing,berry,bilobed,branched,broadly,brown,calyx,cell,closely,cm,conical,corolla,dark,decurrent,deflexed,dendritic,dense,densely,denser,dia,difoliate,drying,ellipsoid,elliptic,erect,exserted,filament,flattened,fleshy,free,fruiting,geminate,glabrous,globose,golden,green,incrassate,inflorescence,irregularly,later,lateral,leaf,like,lobe,lobed,long,los,main,major,margin,matted,mature,middle,minor,minutely,mm,moderately,obscured,occasionally,onto,open,opposite,ovary,ovate,pair,paler,papillose,pedicel,petiole,pitted,planar,pore,poricidal,portion,present,pubecsence,pubescent,reniform,rich,scar,shaped,shrub,simple,size,somewhat,spaced,sparsely,splitting,stem,stigma,stone,strongly,style,surface,tall,tear-drop,thick,time,tip,triangular,trichome,tube,tuft,unifoliate,unit,vein,waxy,way,white,widest,woody,x,young	abaxially,adaxially,bullate,corrugated,differing,dry,eaf,edicel,eed,gra,lea,lon,lower,nflorescence,otherwise,papillo,pericar,ruit,tub,ud,ympodial	5-60,bud,color,count,diameter,flower,fruit,gray,habitat,height,length,null,pericarp,position,prickle,primary,seed,shape,structure,sympodial,texture,width,wing
544	wfo-0001032576	success	229	191	164	65	27	0.716	-12,-2,/4,/5,0,0-3,0-30,0.1,0.1-0.15,0.1-0.2,0.1-0.25,0.3-0.5,0.3-0.7,0.5-1,0.5-1.5,0.5-2,0.5-4,0.8-1.2,0.8-2,1-3,1.2-1.8,1.5-2,1.5-7.5,1/3,1/3-1/6,2-10,2-4,2-5,2.5-3,2.5-4,3-14,4,4-,4-6,6-8,7-8,abaxially,acute,anther,apart,apex,apically,apparently,ascendant,bark,base,berry,blade,branched,bright,brown,brown-green,calyx,cell,chartaceous,cm,concolorous,conical,cuneate,curved,deltate,densely,diameter,difoliate,drying,ellipsoid,elongating,erect,evenly,filament,flattened,flower,free,fruit,fruiting,glabrescent,glabrous,gland,glandular,globular,gray,green,hair,herb,herbaceous,lanceolate,lateral,leaf,length,lobe,lobed,long,longer,margin,mature,maturity,membranous,midpoint,mm,moderately,narrow-deltate,narrow-ovate,obtuse,often,one,open,ovate,pair,pale,pedicel,petiole,poricidal,porrect,prickle,prickly,primary,purple,ray,red,red-green,reduced,reflexed,rounded,scandent,scar,sessile,short,shorter,shrub,simple,slender,slightly,sometimes,spaced,sparsely,spherical,spreading,stalk,stalked,stellate,stellate-pubescent,stem,straight,style,surface,tapering,terminal,time,tip,trichome,tube,unit,upper,usually,variously,vein,way,white,wide,woody,yellow,yellow-green,yellow-orange,young	-10,-2/3,0-1.5,0-5,0.8-1.4,1-4,1.5-2.3,1.8-2.5,1/2,2-3,4-5-merous,4-6.5,5-30,acuminat,alyx,apar,articulated,ba,branching,brow,distance,dull,eaf,eed,entire,equal,extending,eye,faint,flattened-reniform,geminat,infructescence,lower,midvein,minutely,naked,near,nflorescence,obovate,older,orange-brown,orolla,oung,outline,peduncle,per,perfec,pericarp,pit,portion,prickl,raised,reticulate,ruit,shiny,side,small,smooth,tamen,tertiary,unarmed,vary,venation,visible,ympodial	acuminate,anthesi,bud,color,corolla,count,geminate,growth,habitat,height,inflorescence,major,minor,new,null,ovary,position,present,shape,size,stigma,stone,structure,sympodial,texture,width,wing
545	wfo-0001032595	success	200	169	137	63	32	0.685	-20,-25,0.5-1,1-2,1-2.5,1-3,1-6.5,1.5-2,1.5-2.5,1.5-4.5,1.5-5,12-16,15-40,2-3,2-4,2.3-24,3-10,3-12,3-4,3-4-foliate,4-25,4-7,5-6,6-7,9-14,abaxially,acute,adaxially,aggregate,along,also,anther,apex,apical,apiculate,base,blade,branch,branched,brownish-purple,calyx,cell,cm,connivent,coriaceous,cream,cucullate,deltate,dense,densely,denser,diameter,dull,eglandular,ellipsoidal,equal,filament,finely,flattened,flower,fork,forked,free,fruit,fruiting,fusiform,geminate,glabrous,gland,glandular,greenish,hair,lanceolate,leaf-opposed,lobe,long,loosely,major,margin,mature,midrib,mm,moderately,narrowly,often,ovate,ovoid,pale,pedicel,peduncle,per,petiole,pilose,prominent,pseudohair,puberulent,pubescent,purplish,rachi,rarely,reniform,rugulose,shallow,shorter,shrub,side,simple,single,slightly,small,sparsely,spreading,stamen,stellate,stigma,stone,style,subcoriaceous,tall,time,tip,tomentose,toward,tree,triangular,truncate,trunk,tube,two,unbranched,unit,vein,violet,white,wide,x,yellow	-pilose,0-,0.5-3.5,1,1-6,15-25,25-40,3-5,4-5,5-merou,accrescen,acuminate,alyx,apart,ape,articulated,axe,basal,brownish,ciliat,connective,cordate,crow,deeply,dilated,directed,distally,eaf,eed,entire,exceeding,homostylous,larg,leaving,lon,longitudinal,lower,m.,near,nflorescence,oblique,opening,orolla,part,pedicellar,perfect,pilo,pore,produced,purple,remnant,ruit,slit,spaced,strongly,swelling,tamen,tem,thecae,ud,umbrella-shaped,vary,ympodial	+,accrescent,anthesi,bark,bud,ciliate,color,corolla,count,crown,habitat,height,inflorescence,large,leaf,length,null,ovary,position,prickle,primary,scar,seed,shape,stem,structure,surface,sympodial,texture,width,wing,young
