	coreid	status	nwords_original	nwords_result	nwords_recovered	nwords_omitted	nwords_created	prop_recovered	common_words	original_only	result_only
0	wfo-0001025636	success	208	83	64	144	19	0.308	0.1-0.3,1,1-10,1-5.5,10-45,2,2-4,6.5-10,abaxially,absent,adaxially,anther,apart,blue,broadly,brownish,cell,chartaceous,clavate,cm,condition,corolla,diameter,drying,elliptic,fresh,fruit,glabrous,globose,green,greenish,herb,honeycomb-shaped,lanceolate,long,membranous,minute,mm,mottled,mucilaginous,odd-pinnate,ovate,ovoid,pedicel,peduncle,petiole,petiolule,plant,purple,ripe,rosette-forming,rotate,rotate-pentagonal,scale-like,seed,slightly,stem,stigma,style,testal,unforked,wet,whitish,yellow	0-2,0-5,0.1,0.6-2.8,1-2,1-2.2,1-3,1-3.5,1-4,1-5,1.1-6.1,1.4-3.5,1.7-5.2,1.7-9.2,1.8,2.5-6,2.6-8.3,3-5,3-6,5-merou,9.5-29.5,acumen,acuminate,acute,ag,along,alyx,apex,apparently,articulated,axe,base,berry,blade,capitat,ciliate,clearly,connivent,contracted,covering,cuneate,decurrent,digestion,distal,dorsally,eaf,edge,eed,end,enzyme,especially,exceeding,except,filament,flat,flower,folded,geminat,generally,glabrou,greatly,green-white,hair,hair-like,hal,half,high,highly,homostylous,interjected,larger,lateral,leaflet,lengthening,like,living,lobe,longer,lower,make,margin,midrib,minutely,moderately,multicellular,near,nflorescence,oblique,obovate,obtuse,often,orbicular,orne,orolla,pair,perfect,petiolulate,plurifoliate,pore,poricidal,proximal,puberulent,pubescent,reduced,removed,rounded,ruit,semierec,sessile,seudostipule,short,singly,size,slit,sometimes,spaced,specimen,stamen,ste,stolo,straight,subequal,subglabrous,tall,tamen,tem,terminal,thick,throughout,tip,tri-,truncate,tube,tuber,typically,unequal,unit,unwinged,uppermost,vary,wall,wide,x,ympodial	0.1-1.8,arrangement,capitate,color,form,growth,height,history,inflorescence,leaf,length,life,ovary,pseudostipule,semierect,shape,spacing,surface,texture
1	wfo-0001025637	success	193	75	58	135	17	0.301	0-0.3,0.2-0.9,1-12,14-38,2-7,3-10,3-4,3-5,anther,blue,brownish,cell,clavate,cm,coriaceous,corolla,dark,deep,diameter,dot,drying,elliptic,forked,fruit,glabrescent,glabrous,globose,green,green-white,greenish,herb,honeycomb-shaped,lanceolate,leaf,lilac,medium,mm,mucilaginous,odd-pinnate,ovoid,pedicel,peduncle,pentagonal,petiole,petiolule,plant,rotate,seed,stigma,stripe,style,testal,throughout,tiny,wet,white,whitish,yellow	0-27,0.2-0.5,0.3-0.5,0.8-2.6,1-2,1-2.5,1-5,1.2-3.5,1.5-5,1.6-2.5,2-20,2-3,2.5-8,2.8-4.2,3-9,4-6,5-7,5-merou,abaxially,acumen,acuminate,acute,adaxiall,adaxially,ag,along,alyx,apart,apex,apparently,arranged,articulated,attenuate,axe,axillary,base,bead,berry,blade,bud,capitat,condition,connivent,covering,cuneate,decreasing,decurrent,digestion,distal,dorsally,eaf,edge,eed,enzyme,erec,exceeding,filament,flat,flower,folded,fresh,geminat,generally,glabrou,hair,hair-like,hal,half,high,homostylous,interjected,lateral,leaflet,lengthening,light,like,linear,living,lobe,long,lower,make,moniliform,mottled,multiple,necklace,nflorescence,onto,orolla,ovate,pair,perfect,petiolulate,plurifoliate,pore,poricidal,purple,rachi,removed,ripe,rounded,ruit,secondary,seudostipule,short,size,slit,sometimes,spaced,specimen,stamen,stolon,straight,subequal,subtending,symmetric,tall,tamen,tem,terminal,thick,tip,toward,tri-,tube,tuber,typically,unit,unwinged,usually,vary,wall,wide,x,ympodial	arrangement,capitate,color,form,growth,height,history,inflorescence,length,life,ovary,pseudostipule,shape,spacing,stem,surface,texture
2	wfo-0001025639	success	154	82	62	92	20	0.403	1-2,1-3,20-35,3-6,4-10,5-10,8-9,apical,apically,articulate,broadly,cell,cm,corolla,covering,dark,dehiscent,diameter,distal,elliptic,globose,green,green-white,hair-like,herbaceous,introrse,lateral,leaf,make,maturing,medium,mm,mucilaginous,obovate,odd-pinnate,often,ovate,ovoid,pedicel,peduncle,perennial,petiole,petiolule,plant,poricidally,proximal,puberulent,pubescent,rotate,seed,short,slit,stigma,style,testal,thick,throughout,violet,wall,white,yellow,¼	1-4,10-21,2-3,2-3.5,2.8-3.2,3-4,3-5,3-6-foliat,3.5-7,4.5-8.5,5-1.,5-8,6-12,6-8,8-12,abaxially,acumen,acuminate,acute,adaxially,apex,base,belo,branched,calyx,connate,cuneate,cyme,dichasial,dichasially,digestion,diminishing,dorsally,eaf,ebracteate,edge,eed,elliptical,emoval,enzyme,exceeding,filament,flat,flower,folded,forked,frequently,generally,globo,gradually,half,honeycomb,interjected,leaflet,lobe,lon,long,long-attenuate,lower,lunat,monochasial,nflorescence,nther,oblique,orolla,pair,pattern,perfect,plan,present,produced,rare,reveal,ruit,seudostipule,size,sometimes,stamen,straight,tal,tem,terminal,throughou,top,toward,truncate,tuber-bearing,typically,unit,vary,wide,ympodial	anther,arrangement,color,form,fruit,growth,height,history,length,life,lunate,na,ovary,pseudostipule,shape,spacing,stem,surface,texture,wet
3	wfo-0001025642	success	149	97	74	75	23	0.497	0.3-0.4,1-2,1-2.7,1-3.2,10-20,2-3,3-5,4-7.5,5.5-7,8-13,9-12,absent,apical,apically,articulate,branched,calyx,cell,cm,connate,corolla,cyme,dehiscent,diameter,dichasial,dichasially,diminishing,distal,ebracteate,elliptic,elliptic-lanceolate,forked,globose,gradually,green,green-white,hair-like,herbaceous,interjected,introrse,lanceolate,lateral,leaf,leaflet,long,lunate,maturing,mm,monochasial,mucilaginous,odd-pinnate,often,ovoid,pedicel,peduncle,perennial,petiole,plant,poricidally,proximal,puberulent,seed,short,size,slit,stellate,stigma,style,terminal,testal,throughout,wide,yellow,¼	1,1-2.5,1-3,1-4,1.5-2.5,2-10,3,3-6-foliat,3.5-6,4.5-8,5-6,7-11.5,abaxially,absen,acumen,acuminate,acute,adaxially,apex,apiculate,attenuate,base,covering,digestion,dorsally,eaf,edge,eed,emoval,enzyme,exceeding,filament,flat,flower,folded,generally,globo,half,honeycomb,lanceolat,living,lobe,lon,lower,make,nflorescence,nther,oblique,obtuse,orolla,pair,pattern,perfect,plan,present,reveal,ruit,sessile,seudostipule,specimen,stamen,straight,tal,tem,thick,throughou,toward,tuber-bearing,typically,unit,vary,wall,whit,without,ympodial	anther,arrangement,color,dehiscence,form,fruit,growth,height,history,inflorescence,length,life,na,ovary,petiolule,pseudostipule,shape,spacing,stem,surface,texture,wet,white
4	wfo-0001025644	success	204	96	77	127	19	0.377	0-5,1-10,1.3-2.1,10,10-11,2.4-4,2.5-6,25-50,3-10,3-5,3.3-8.2,4-19,4.5-9.5,6-7,6.5-13,abaxially,adaxially,almost,anther,blue,broadly,brownish,cell,chartaceous,clavate,cm,condition,corolla,covering,diameter,drying,elliptic,forked,fresh,fruit,glabrous,globose,green,greenish,hair,hair-like,herb,honeycomb-shaped,interjected,lanceolate,lateral,leaflet,like,membranous,mm,odd-pinnate,ovate,ovoid,pedicel,peduncle,pentagonal,petiole,petiolule,plant,poricidal,pubescent,rounded,seed,size,stem,stigma,style,terminal,testal,thick,tinged,tip,wall,white,whitish,x,yellow	.3,0.8-1.5,1-2,12-28,13-21,2,2-3,2-4,2.5-11,3-4,4-6,5-merou,absent,acumen,acuminate,acute,ag,along,always,alyx,apart,apex,apparently,articulated,attenuate,axe,axillary,base,berry,blade,bud,c.,capitat,ciliate,connivent,cordate,cuneate,denticulate,digestion,distal,dorsally,eaf,edge,eed,end,enzyme,erec,especially,exceeding,except,filament,finely,flat,flower,folded,geminat,generally,glabrou,greatly,green-white,half,homostylous,invested,lengthening,living,lobe,long,lower,make,margin,middl,midrib,minutely,mottled,mucilaginous,multicellular,nflorescence,non-glandular,oblique,often,one,orbicular,orolla,pair,perfect,placed,plurifoliate,pore,proximal,puberulent,purple,rarely,reduced,removed,ruit,sessile,seudostipule,shallowly,short,slit,spaced,specimen,stamen,ste,stolo,straight,subequal,subtending,tall,tamen,tem,throughout,tri-,trichome,truncate,tube,tuber,typically,uniseriate,unit,usually,vary,well-developed,wet,wing,winged,ympodial	arrangement,calyx,capitate,color,dehiscence,form,growth,height,history,inflorescence,leaf,length,life,ovary,pseudostipule,shape,spacing,surface,texture
5	wfo-0001025645	success	150	101	76	74	25	0.507	0.3-0.8,1-2,1-3.5,10-11,15-25,2-3,2-4.5,3-5.5,4-6,4-7,5,8-10,apical,apically,articulate,branched,calyx,cell,cm,connate,corolla,covering,cyme,dehiscent,diameter,dichasial,dichasially,distal,ebracteate,elliptic-lanceolate,forked,glabrous,globose,green,green-white,hair-like,herbaceous,interjected,introrse,lanceolate,lateral,leaf,leaflet,long,make,maturing,mm,monochasial,mucilaginous,odd-pinnate,often,ovoid,pedicel,peduncle,perennial,petiole,plant,poricidally,proximal,puberulent,seed,short,size,slit,stellate,stigma,style,terminal,testal,thick,throughout,tuber-bearing,wall,wide,yellow,¼	0.5-1,0.8,1-4,10-16,12-17,2.5,3-6-foliat,4-12,4-5,5-5.5,abaxially,absen,acumen,acuminate,acute,adaxially,apex,base,cuneate,decurrent,digestion,diminishing,dorsally,eaf,edge,eed,elliptic,emoval,enzyme,exceeding,filament,flat,flower,folded,generally,globo,gradually,half,honeycomb,larger,living,lobe,lon,lower,lunat,mucronate,nflorescence,nther,oblique,oblong,orolla,pair,pattern,perfect,plan,rachi,reveal,ruit,second,sessile,seudostipule,specimen,stamen,straight,tal,tem,throughou,toward,typically,unit,vary,whit,without,ympodial	absent,anther,arrangement,color,dehiscence,form,fruit,growth,height,history,inflorescence,length,life,lunate,na,ovary,petiolule,pseudostipule,shape,spacing,stem,surface,texture,wet,white
6	wfo-0001025646	success	136	106	83	53	23	0.61	0.25-0.4,0.5-2.1,0.6-2.3,0.6-3,0.7-3.5,1-7,1.1-4.5,1.2-7.0,2-3,2-4,3,3.2-6,3.5-7,7-8,abruptly,acuminate,acute,apex,apical,apically,articulate,base,branched,calyx,cm,connate,corolla,cuneate,cyme,decurrent,dehiscent,diameter,dichasial,dichasially,diminishing,distal,ebracteate,elliptic,forked,fruit,generally,globose,gradually,half,herbaceous,interjected,introrse,lateral,leaf,leaflet,like,long,maturing,mm,monochasial,oblique,obovate,odd-pinnate,often,ovary,pedicel,peduncle,pentagonal,perennial,petiole,petiolule,plant,poricidally,proximal,puberulent,short,size,slightly,slit,stigma,strigose,style,terminal,toward,tuber-bearing,wide,yellow,¼	0-.,1-4,1.1-1.4,1.2,1.5-3,2.3-9.0,2.5-3,3-6-foliat,4-10,4-15.5,4-5,abaxially,acumen,adaxially,apiculate,attenuate,ature,caudate,dorsally,eaf,edge,eed,exceeding,filament,flat,flower,folded,globo,lobe,lon,lower,lunat,nflorescence,nther,orolla,ovate,pair,perfect,plan,probably,seen,sessile,seudostipule,sometimes,stamen,straight,tal,tem,typically,unit,vary,whit,ympodial	0-4,anther,arrangement,color,dehiscence,form,growth,height,history,inflorescence,length,life,lunate,na,pseudostipule,seed,shape,spacing,stem,surface,texture,white,ye
7	wfo-0001025647	success	194	103	79	115	24	0.407	0-4,0.06-0.24,0.4-1.5,0.6-3,0.8-3,1-10,1.3-2.9,1.4-5,1.5-5.5,2,2-3,2-4,3-6,4-10,5-6,acute,anther,apex,attenuate,base,blue,broadly,brownish,cell,chartaceous,clavate,cm,condition,corolla,covering,decurrent,diameter,distal,drying,elliptic,forming,fresh,fruit,globose,green,greenish,hair-like,herb,interjected,lanceolate,lateral,leaflet,light,linear,membranous,mm,narrowly,oblique,obtuse,odd-pinnate,ovoid,pedicel,peduncle,petiole,plant,poricidal,ripe,rosette,rotate,scale-like,seed,size,stem,stigma,style,terminal,testal,thick,tip,unbranched,wall,whitish,x,yellow	1,1-2,1-3,1-5,1.2-3,1.5-5,2-5,2.5-3,4-6,5-merou,6.2-11,abaxially,absent,acumen,adaxially,ag,along,alyx,apart,apparently,articulated,axe,axillary,berry,blade,borne,bud,capitat,ciliate,connivent,densely,digestion,dorsally,eaf,edge,eed,end,enzyme,erec,especially,exceeding,except,filament,flat,flower,folded,frequently,geminat,glabrou,glabrous,greatly,green-white,hair,hal,half,high,homostylous,honeycomb-shaped,lengthening,like,living,lobe,long,lower,make,margin,midrib,minutely,moderately,mucilaginous,multicellular,near,nflorescence,often,orbicular,orolla,ovate,pair,perfect,petiolulate,plurifoliate,pore,proximal,puberulent,pubescent,reduced,removed,ruit,sessile,seudostipule,short,singly,slit,sometimes,spaced,specimen,stamen,ste,stolo,straight,subequal,subtending,tall,tamen,tem,throughout,tri-,tube,tuber,typically,unit,unwinged,vary,wet,ympodial	arrangement,calyx,capitate,color,dehiscence,diminishing,erect,form,growth,height,history,inflorescence,leaf,length,life,na,petiolule,pseudostipule,shape,spacing,surface,texture,tuber-bearing,ye
8	wfo-0001025652	success	156	100	72	84	28	0.462	0.5-1,1,1.5-2,10-20,15-17,2-5,2-6,20-50,3-3.5,4-7,acuminate,acute,anther,anthesi,apex,bark,base,bilobed,calyx,campanulate,closely,cm,connate,corolla,elliptic,fruit,furcate,glabrate,glabrous,greyish,growth,lateral,leaf,lobed,minutely,mm,nearly,occasionally,ovary,ovoid-reniform,pale,papillae,papillose,pedicel,petiole,pinkish-grey,pitted,planar,plant,poricidal,red-papillose,shape,shaped,shiny,shrub,simple,size,small,spaced,stem,stigma,straight,style,surface,tan,tear-drop,tightly,tip,tree,tube,white,x	.3,.5,1-1.5,15-19,2-3,3-5,3-5-flowered,4,4-6,9-11,abruptly,appearing,blade,broad,closed,completely,decurrent,densely,dia,differing,difoliate,dry,eaf,edicel,eed,emerge,envelope,filament,fleshy,flower,free,geminat,green,greyi,growing,irregular,like,live,lobe,lon,long,lower,main,major,margin,matte,middle,minor,minute,narrowing,new,nflorescence,older,one,onto,opposite,overlappin,ovoid,pair,paler,papillo,parallel,pore,portion,rather,ry,scar,soon,specimen,strongly,tall,tapering,tear,thick,thicker,ud,unit,vein,wider,widest,wing,winged,ympodial,young	1.3,alternate,arrangement,color,connation,dehiscence,diameter,diminishing,distal,form,height,history,inflorescence,interjected,leaflet,length,life,na,overlapping,peduncle,petiolule,pseudostipule,seed,spacing,straightnes,terminal,texture,tuber-bearing
9	wfo-0001025653	success	218	86	51	167	35	0.234	.0,.3,.5,.7,.9,1.3,20,acuminate,anther,apart,apex,attenuate,bark,base,broad,brown,calyx,chartaceous,cm,corolla,diameter,flower,fruit,globolunate,lateral,leaf,least,long,mm,obtuse,ovate,pedicel,peduncle,persistent,petiole,reddish,rounded,scarcely,short,shrub,simple,stellate,stem,stigma,straight,style,subcordate,surface,truncate,tube,unbranched	.1,.2,.6,.8,0.1,0.13,0.15,0.2–0.4,0.3–0.5,0.3–0.8,0.6–1.6,0.7–1.1,0.8,1.0–1.6,1.1–1.3,1.3–1.8,1.6,1.9–3.3,1–1.5,2.3–3.2,2.5–4.0,2.6,4–6,5-merou,6–8,6–9,7–12,8–11,90°,abaxially,absent,adaxiall,adaxially,adnate,aequilateral,ag,alyx,among,anthesi,apical,apparently,appearing,around,articulate,axe,ba,blade,bud,channeled,clinate,congested,craspedodromous,cylindrical,deltoid,densely,developed,directed,distinct,dry,eaf,edge,eed,either,emerging,entire,erect,extending,extra-axillary,ferruginous,fertile,filament,filiform,free,glabrous,glandular,globose,hair,heterostylous,increasing,intact,internode,interpetalar,intersepalar,know,known,lanceolate,layer,less,lobe,lobed,lon,longer,low,lower,margin,mature,midpoint,midrib,midvein,minute,much,nflorescence,noticeably,oblique,occasionally,opaque,opposed,orolla,plurifoliat,pore,porrect,porrect-stellate,portion,potentially,prickl,prickle,primary,pubescent,raised,ray,reduced,remaining,restricted,rhizomatous,rigid,row,ruit,secondary,see,seen,sessile,short-stipitate,shorter,shot-stipitate,side,sinuate,sloughing,sparsely,splitting,spread,stamen,stellae,stellate-pubescent,stipe,stipitate,suture,tamen,tem,time,tip,tissue,transparent,truncat,two,ud,unarme,unarmed,vary,vein,well,wide,yellow-ferruginous,ympodia,young,±equal,±erect,×	0.2-0.4,0.6-1.6,1.3-1.8,2.3-3.2,2.5-4.0,arrangement,color,connation,dehiscence,diminishing,distal,form,growth,height,history,inflorescence,interjected,leaflet,length,life,na,ovary,papillae,perennial,petiolule,plant,pseudostipule,seed,shape,size,spacing,straightnes,terminal,texture,tuber-bearing
10	wfo-0001025654	success	140	99	63	77	36	0.45	1,1-2,15-22,2,2-2.5,25-30,5,abaxial,absent,abundant,acuminate,adaxial,anther,apex,articulated,base,broadly,calyx,chartaceous,cm,cuneate,diameter,dull,elliptic,flattened,flower,fruit,fruiting,globose,hooked,inflorescence,lanceolate,leaf,long,mainly,midvein,mm,oblique,pale,pedicel,pedicellate,peduncle,petiole,position,prickle,purple,retrorse,scarcely,scattered,shortly,shrub,simple,size,slightly,stellate,stem,stigma,straw-coloured,style,sub-axillary,surface,unknown,yellow	0,2-foliate,3/4,4,4-5,5-6,5-merous,6,7-8,?,abaxially,abortive,accrescen,acumen,alyx,ape,apica,apparently,armed,axe,ba,blade,branched,eaf,eed,erect,filament,frequently,geminat,glabrous,glandular,hair,homostylou,juvenile,larger,later,less,lobe,lower,margin,mature,minute,minutely,mostly,narrowed,nflorescence,often,older,orolla,phase,pore,pubescent,rachi,repand,ruit,sessile,several,shallowly,single,slender,smaller,solitary,sparsely,sub-acuminate,tal,tamen,tem,tip,toward,triangular,unarme,unit,unknow,vary,x,ympodial,young	accrescent,apical,arrangement,articulation,bark,color,connation,corolla,dehiscence,diminishing,distal,form,growth,height,history,interjected,lateral,leaflet,length,life,na,ovary,papillae,perennial,petiolule,plant,pseudostipule,red,seed,shape,spacing,straightnes,terminal,texture,tube,tuber-bearing
11	wfo-0001025655	success	226	111	78	148	33	0.345	0.3-0.4,1-1.5,1.3-1.5,1.5-2,3-5,3-7,4-6,6-7,6-8,accrescent,acuminate,anther,apex,articulate,asymmetric,attenuate,bark,base,beige,brown,calyx,clavate,cm,compressed,cordate,cordate-lanceolate,curved,cyme,dark,deeply,diameter,distal,dry,ferruginous,ferruginous-pubescent,flower,fruit,fruiting,glabrescent,globose,helicoid,leaf,length,lilac,linear-lanceolate,long,minutely,mm,monoclinous,parted,pedicel,peduncle,persistent,petiole,plant,prickle,recurved,rounded,rugose,shrub,slightly,small,solitary,somewhat,splitting,staminate,stellate,stem,stigma,straight,style,sub-capitate,subreniform,subsagittate,surface,tube,violet,viscid-velutinous	-3-5-lobed,-8-17,0.6-0.8,1-1.2,1-2,1-3,1.4-2,11,2,2-2.5,2-3,2-3.5,2-5-celled,2.5-3,2.5-5-,3-,3-8-flowered,4,4-5,5-6-merous,5-7,8-10,abaxial,along,alyx,anthesi,armed,ba,basal,blade,branch,branched,brow,canaliculate,central,cinereous,densely,di-,discolorous,eaf,eed,elongate,enlarged,entire,epicarp,equal,erect,exceeding,ferruginous-tomentose,filament,free,functional,fused,geminat,glabrous,gland,glandular,glandular-stellate,glandular-tipped,gynoeci,held,hirsute-glandular,indument,lanate,leathery,lobe,long-exserted,long-stalked,longer,lower,many-celled,maturit,midrib,mix,mucilaginous,multiangulate,multiangulate-stellate,multiseriate,nflorescence,numerous,oblong-urceolate,older,one,orolla,papillo,part,peduncl,perennia,persistently,petiol,porrect-stellate,primary,prolonged,prominent,rachi,ranch,ray,reddish,reduced,reflexed,ruit,secondary,sepal,sessile,short,similar,slender,sparsely,stalk,stalked,stamen,stellae,stellate-glandular,strongly,sub-globose,sub-quadrangular,sub-sessile,subcoriaceous,subterete,surrounded,tall,tamen,terete,time,tomentose,tomentose-velutinous,triangular-lanceolate,trichome,trifoliate,unarmed,unbranched,uniseriate,unit,upright,vary,vein,velutinous,villous,weakly,wide,within,without,woolly,yellowish,ympodial,young,¼,½	arrangement,articulation,color,connation,corolla,dehiscence,diminishing,form,growth,height,history,inflorescence,interjected,lateral,leaflet,life,maturity,na,ovary,papillae,papillose,perennial,petiolule,position,pseudostipule,seed,shape,size,spacing,straightnes,terminal,texture,tuber-bearing
12	wfo-0001025656	success	209	116	86	123	30	0.411	0.2-,0.2-0.3,0.2-0.4,0.8-1,1-2,1-4,12-15,2.5-5,3,3-12,4-5,acuminate,acute,almost,anther,apart,apex,bark,base,berry,blue,branched,brown,calyx,chartaceous,clavate-truncate,cm,corolla,corymbose,cuneate,curved,cyme,diameter,distal,elliptic,elliptic-ovate,flattened,flower,fruiting,globose,green,grey,growth,inflorescence,internodal,lanate,lobed,long-styled,mature,minutely,mm,ochraceous,ovary,ovate,pedicel,peduncle,petiole,plant,poricidal,prickle,purple,reniform,reticulate,rounded,rugose,rusty,short-styled,shrub,simple,slightly,stellate,stem,stigma,straight,style,subcoriaceous,subreniform,subtuncate,surface,tapering,tip,tomentose,tube,whitish,x,yellow	-10,-14,0.5-0.6,1-1.5,1.5-2,1.8-2,1/3,10-,10-15,2-2.5,3-3.5,3-7,30-40,4-4.5,4-6,5-,6,6-11,8-10,8-9,abaxially,adaxially,adult,along,anthesi,apical,apically,armed,basal,cell,channelled,congested,coriaceous,densely,denser,discolorous,eaf,eed,elongate,entire,erect,evenly,exserted,filament,flexuous,foliaceous,free,glabrous,gland,glandular,gre,heterostylous,hirsute,inflorescenc,juvenile,lengthening,like,linear-lanceolate,lobe,lobed-angulate,long,long-stalked,longer,loosely,looser,lower,margin,midpoint,midrib,minute,mixed,multangulate,multicellular,near,new,nflorescence,older,papillat,partially,perfect,pericarp,plurifoliat,pore,porrect,portion,prickly,pubescence,pubescent,raised,reflexed,relatively,ruit,scandent,scar,sessile,several,short-stalked,single,spaced,sparse,sparsely,stalk,staminate,subglobose,subscandent,tall,testa,time,tomentose-lanate,tomentose-velutinous,trichome,turbinate,ud,unit,upper,vein,venation,viscid,white,without,wood,ympodial,young	arrangement,articulation,color,connation,dehiscence,diminishing,form,fruit,height,history,interjected,lateral,leaf,leaflet,length,life,na,papillae,papillate,petiolule,position,pseudostipule,seed,shape,size,spacing,straightnes,terminal,texture,tuber-bearing
13	wfo-0001025657	success	239	108	75	164	33	0.314	0.1-0.4,0.2-0.4,1-3,2-10,2-3.5,3-6,4-4.4,4-4.5,5-14,5-16,7-9.5,8.3-12,abaxially,accrescent,acute,adaxially,also,anther,apart,apex,articulated,base,bluish,blunt-tipped,branched,brown,calyx,cm,conical,cordate,corolla,dark,deltoid,diameter,dried,flower,fruit,fruiting,lateral,leaf,length,light,long,mm,narrowly,oblong,orbicular,ovate,pedicel,peduncle,petiole,plurifoliate,poricidal,reportedly,reticulate-punctate,ripe,shrub,somewhat,stellate,stem,stigma,style,suborbicular,surface,tan,tip,tomentose-pubescent,tree,tube,unarmed,velutinous-pubescent,white,x,yellow,yellowish	-2,/3,0.5-2.5,1-1.1,1-1.3,1-1.6,1.2-1.5,1.3-2,1.5-1.8,1.7-1.9,12x,2.2-5.5,2.5-9.3,2.7-4.3,2/3,25-60,3-4,3-4.8,3.2-6,4-7,6-12,6-8,6.5-10,7-27,7-9,8-10.5,ag,anthesi,apparently,appearing,ark,around,ascending,axe,axillary,ba,berry,blade,branch,broadly,bud,capitat,central,chartaceous,closely,cylindrical,dendritic-multangulat,dendritic-multangulate,dense,densely,directed,distally,due,eaf,earl,edge,eed,elliptic,entire,especially,evident,exerted,expanded,exserted,farinose,few-rayed,filament,fleshy,free,glabrous,glandula,glandular,granular,green,hair,half,inserted,lanate-pubescent,lanceolate,lengthening,lobe,lobed,long-stalked,longitudinal,lower,m.,magnification,main,margin,midrib,minutely,mixed,multangulate,nearly,nflorescence,obtuse,occasional,often,older,open,orolla,ovat,ovate-lanceolate,overlapping,pale,part,parted,partly,perfect,persistent,persistently,pore,porrect-stellate,present,pseudo-terminal,pubescence,pubescent,rachi,ray,ruit,scented,semi-ovate,sessile,short,short-,short-stalked,side,simple,slightly,slit,soft,spaced,splitting,stamen,stellate-pubescent,stipitate-glandular,stipitate-multangulate,strongly,subcampanulate,subcoriaceous,suture,tall,tamen,terete,thick-stalked,thickened,thin-stalked,time,tomentose,tomentum,transparent,two-third,ud,unarme,unit,upper,usually,vary,vein,way,weakly,wide,ympodial,young	arrangement,articulation,bark,capitate,color,connation,dehiscence,diminishing,distal,form,growth,height,history,inflorescence,interjected,leaflet,life,na,ovary,papillae,petiolule,plant,position,prickle,pseudostipule,seed,shape,size,spacing,straightnes,terminal,texture,tuber-bearing
14	wfo-0001025666	success	217	111	80	137	31	0.369	0-0.7,0.3,0.5-1,1,1-1.7,1-2,2-8,21-30,3-5,5-6,6-20,6-7.5,acute,adaxially,anther,apart,apex,articulated,base,calyx,chartaceous,cm,connivent,cuneate,diameter,distal,elliptical,extra-axillary,finely,flattened,flower,fruit,fruiting,glabrous,globose,green,half,inflorescence,lateral,leaf,length,less,lobe,lobed,long,loosely,mature,midvein,mm,narrowly,obtuse,ovate,pale,pedicel,peduncle,perennial,petiole,pinkish,plant,present,prickle,pseudo-racemose,pseudo-umbellate,purple,reticulate,shallowly,shrub,simple,sparsely,stellate-pubescent,stigma,style,surface,triangular,tube,vein,whitish,x,yellow,yellowish-green	%,.8,0-5,0.05-0.25,0.2-0.3,0.2-0.35,0.2-0.8,0.25-0.35,0.25-0.4,0.5-1.5,0.5-2,1-1.4,1-1.5,1-locular,1.5-1.8,1.5-2.5,1.5-3.5,1.6-2.3,10-30,14-29,2-3,2-4,2.8-4.5,20-60,25-65,3-3.5,3-7,3.5-4,4-5,4-6,5-merou,5.5-9.5,7-8,8-12,9-10,9-20,abaxially,absen,absent,acicular,across,alyx,andromonoecious,armed,attenuate,axe,ba,blade,brown,capitat,center,confined,cross-section,cylindrical,d.,densely,difoliate,directed,distall,eaf,eed,eglandular,elliptica,entire,exocarp,filament,finger,functional,geminate,gland-tipped,hair,heterostylous,incomplete,index,interpetalar,juicy,lamina,lobing,longer,lower,margin,mesocarp,midpoint,midrib,minute,moderately,moist,nflorescence,oblique,orolla,part,per,placenta,pore,porrect,presen,probably,prostrate,rachi,ray,ridged,ruit,septum,sessile,short,side,slightly,spaced,sparse,stage,stellae,stellate,stoloniferous,straight,strongly,tal,tamen,tapered,tem,terete,thick,throughout,time,tissu,tissue,transparent,unarme,unarmed,unbranched,unit,uvenile,vary,weakly,white,wide,yellowish,ympodial	arrangement,articulation,bark,capitate,color,connation,corolla,dehiscence,diminishing,form,growth,height,history,interjected,leaflet,life,na,ovary,papillae,petiolule,position,pseudostipule,seed,shape,size,spacing,stem,straightnes,terminal,texture,tuber-bearing
15	wfo-0001025669	invalid_json_followup	216	152	112	104	40	0.519	'',.5,0-7,0.1-0.3,0.8-2.4,1,1-10,1-2,1-4,1.3-4.2,1.6-4.4,13-35,2,2-4,2.2-6.5,2.4-7,3-5,3-7,``,absent,anther,apex,articulation,base,blue,broadly,brownish,cell,chartaceous,clavate,clearly,cm,condition,connivent,corolla,covering,cuneate,diameter,distal,drying,end,forming,fresh,fruit,globose,green,greenish,hair,herb,interjected,lanceolate,larger,lateral,leaflet,lengthening,like,long,membranous,minute,mm,moderately,mottled,oblique,obovate,obtuse,odd-pinnate,one,orbicular,ovoid,pedicel,peduncle,petiole,petiolulate,petiolule,placed,plant,pore,poricidal,pubescent,purple,rarely,ripe,rosette,rotate,scale-like,seed,sessile,short,size,slightly,slit,sometimes,stem,stigma,straight,streaked,style,subglabrous,terminal,testal,thick,tinged,tip,tube,typically,unbranched,unwinged,wall,white,whitish,x,yellow	0-1,0-5,1-2.2,1-3,1.4-2.5,2-3,2.2-6,4-6,5-merou,9-24.5,abaxially,absen,acumen,acuminate,acute,adaxially,ag,along,alyx,apart,apparently,axe,berry,blade,capitat,ciliate,contracted,decurrent,digestion,discussion,distinct,dorsally,eaf,edge,eed,elliptic,enzyme,erec,especially,exceeding,except,extra,filament,flat,flower,flowered,folded,geminat,glabrou,glabrous,greatly,green-white,hair-like,half,highly,homostylous,honeycomb-shaped,living,lobe,lower,make,margin,midrib,minutely,monochasium,mucilaginous,multicellular,near,nflorescence,often,orolla,ovate,pair,perfect,plurifoliate,proximal,puberulent,reduced,removed,rounded,ruit,see,seudostipule,single,spaced,species,specimen,stamen,ste,stolo,subequal,tall,tamen,tem,throughout,tri-,truncate,tuber,unequal,unit,vary,wet,wide,ympodial	'hair-like,[,],age,arrangement,bark,calyx,capitate,characteristic,color,connation,dehiscence,diminishing,erect,form,fruiting,growth,height,history,inflorescence,leaf,length,life,na,ovary,papillae,position,present,prickle,pseudostipule,shape,spacing,stolon,straightnes,surface,texture,tuber-bearing,value,{,}
16	wfo-0001025685	success	222	138	106	116	32	0.477	-15,-22,-30,/3,0.2-0.3,0.3-1,0.4-6,1-4,1.5-2,10-15,12-13,2-4,2-5,2-6,2-7,3-4,3.5-10,4-5,7-18,7-8,abaxially,acuminate,acute,adaxially,anther,apart,apex,articulated,bark,basally,base,berry,branched,brown,calyx,chartaceous,clavate,cm,cordate,cordiforme,corolla,cuneate,curved,dark,deciduous,diameter,discolorous,distal,finely,flattened,flower,flowering,fruiting,globose,green,growth,internodal,lanceolate,lobed,long,long-styled,minutely,mm,oblique,orangish,ornamented,ovary,ovate-cordiforme,ovate-elliptic,pedicel,peduncle,persistent,petiole,plant,poricidal,prickle,quadrate,recurved,red,reniform,reticulate,ripe,short-styled,shrub,simple,size,small,stem,stigma,straight,style,subcompressed,subtruncate,tapering,time,tip,tomentose-scabrous,tomentose-velutinous,tree,truncate,tube,velutinous-floccose,way,white,x,yellowish	/4,0.3-0.5,0.45-0.9,0.5-1,1-1.5,1-multicellular,1.4,1.5-2.5,1.8-2.5,2,2-2.2,2-3,3,3-10,3-3.5,4-4.5,50,6.5-9,8-10,<,adult,angulate,anthesi,apiculate,armed,ascendin,basal,caly,channelled,concav,coriaceous,deltate,dense,eaf,eed,elongating,entire,erect,exserted,filament,foliaceous,free,glabrescen,glabrous,glandular,glandular-viscid,heavily,heterostylous,impressed,juvenile,larger,like,lobe,lower,margin,midpoint,minute,mixed,multangulate,multicellular,new,nflorescence,oblong-lanceolate,obverse,older,ovate,papillo,partially,per,perfect,pericarp,plurifoliat,pore,porrect,portion,prickly,puberulent,pubescence,pubescent,raised,ray,reduced,reflexed,rest,ruit,scabrous,scandent,scar,sessile,shallowly,slightly,slit,spaced,sparse,sparsely,stalked,staminate,stellate,subcordate,subglobose,subscabrous,testa,thick,tomentose-ferruginous,tomentose-floccose,triangular-lanceolate,trichome,turbinate,ud,uneven,unit,vein,venation,without,woody,ympodial	arrangement,articulation,color,connation,dehiscence,diminishing,form,fruit,glabrescent,height,history,inflorescence,interjected,lateral,leaf,leaflet,length,life,na,papillae,papillose,petiolule,position,pseudostipule,seed,shape,spacing,straightnes,surface,terminal,texture,tuber-bearing
17	wfo-0001025688	success	218	88	44	174	44	0.202	accrescent,acute,anther,apex,base,brown,calyx,cm,cylindrical,dense,diameter,extra-axillary,free,fruit,fruiting,globose,glutinous,leaf,minute,mm,narrowed,nearly,ovate,pedicel,peduncle,petiole,prickle,shrub,simple,size,stellate,stem,stigma,style,suborbicular,surface,thin-textured,truncate,tube,unbranched,white,yellow,yellow-green,yellowish-green	0.1,0.1–2,0.2,0.5,0.5–2,0.5–3,0.5–3.5,0.6–0.8,0.6–2,0.6–2.4,0.6–4,0.8,0–10,1,1-celled,1.3–1.7,1.5–2,1.5–3,1.5–4,1/2,14155,15–25,1–1.5,1–1.6,1–1.8,1–2,1–3-celled,1–6-celled,1–8,2-foliate,25,2–3,2–3.5,2–4-celled,2–4–celled,3.2–3.6,3–10,3–4,4,4-lobed,40–75,4–15,4–5-rayed,4–6,4–9,5,59,5°,5–18,6–7,6–8,8–10,8–15,=,abaxially,abruptly,acicular,adaxiall,adaxially,also,angle,anthesi,armed,ascending,average,axe,blade,branch,coiling,conpsicuously,constricted,contiguou,curved,darker,deeply,densely,developing,directed,distall,distally,eaf,eed,enlarged,entire,erect,except,fewer,filament,flattened,flower,flowering,fresh,geminate,glabrous,gland,gland-tipped,grading,green,hair,hyaline,lacking,lanceolate,larger,less,lobe,lobed,lon,long,lower,major,many,margin,minor,mottling,n,narrowly,nee,nflorescence,none,often,one,orolla,otherwise,per,pericarp,pilose,pore,puberulent,pubescence,rachi,rarely,rather,recurved,ripe,ruit,scarious,scattered,sessile,short,similar,single,slightly,small,sometimes,somewhat,sparsely,spreading,stellae,stipitate,straight,sulcate,tal,tamen,tapering,tem,thic,thick,thickene,thickened,tip,triangular,truncat,twice,unit,upper,usually,vary,vein,way,wide,wing,x,ympodial,±	0.1-2,0.5-3,0.5-3.5,0.6-4,1-2,3-4,4-9,6-7,8-15,arrangement,articulation,bark,color,connation,contiguous,corolla,dehiscence,diminishing,distal,form,growth,height,history,inflorescence,interjected,lateral,leaflet,length,life,na,ovary,papillae,perennial,petiolule,plant,position,pseudostipule,seed,shape,spacing,straightnes,terminal,texture,tuber-bearing
18	wfo-0001025694	success	199	104	55	144	49	0.276	20,accrescent,acute,anther,apart,apex,apical,articulated,attenuate,base,brown,calyx,chartaceous,cm,completely,connivent,covering,diameter,drying,elliptic,flower,fruit,fruiting,globose,green,inflorescence,length,long,mm,mottled,obtuse,often,opening,ovate,pedicel,peduncle,petiole,plant,prickle,reniform,rugose,shrub,simple,slit,stellate,stem,stigma,still,style,surface,tube,turning,white,yellow,×	0.2,0.2–0.3,0.3–0.6,0.5–1,0.5–1.5,0.5–3,1,1.5–2,1.5–3.5,10–15,10–25,1991,1–2,1–2.5,1–3,2.5,2.5–11,25–50,2–15,2–3,2–3.5,2–4,2–5-branched,3–5,3–6,4–12,4–15,4–5,5-merous,5–10,6–10,6–20,8–12,abaxial,abaxially,absen,absent,adaxial,adaxiall,adaxially,alyx,androgynoecious,andromonoecious,armed,asymmetrical,axe,ba,becoming,berry,beyond,blade,capitat,center,cordate,cylindrical,dark,densely,discolorous,eaf,eed,entire,erect,exerted,exserted,filament,flattened,frui,functionally,fused,glabrous,gland-tipped,glandular,hair,hermaphroditic,heterostylou,interpetalar,like,little,lobe,lower,male,margin,matur,membranaceous,midpoint,midrib,midvein,mixed,moderately,multicellular,multiseriate,narrowly,nearly,nflorescence,occasionally,orange,orolla,per,pinnate,plurifoliat,pore,porrect-stellate,pubescent,rachi,ray,recurved,reflexed,roselike,ruit,rusty,scandent,secondary,short,side,spaced,sparse,sparsely,specifically,spine,stalk,stamen,staminate,stellate-pubescent,swollen,tal,tamen,tan,tem,tip,tissue,triangular,triangular-ovate,unicellular,uniseriate,unit,vary,vein,venation,walker,whelan,whitish,wide,ympodial,young	0.5-1,0.5-1.5,0.5-3,1-3,10-25,2-15,2-3,2-4,2-5-branched,2.5-11,3-5,3-6,4-15,6-20,arrangement,articulation,bark,capitate,color,connation,corolla,dehiscence,diminishing,distal,form,growth,height,history,interjected,lateral,leaf,leaflet,life,na,ovary,papillae,perennial,petiolule,position,present,pseudostipule,seed,shape,size,spacing,straightnes,terminal,texture,tuber-bearing
19	wfo-0001025697	success	181	118	86	95	32	0.475	0-14,0.15-0.75,0.6-3.5,1-1.7,1-2,1.7-8.6,2-10.5,2-2.6,2-6,25-35,3-10,3-5,3-6,4-7.5,5.5-11.5,acuminate,acute,anther,apex,articulated,attenuate,axillary,base,blue,brownish,bud,clavate,cm,condition,connivent,coriaceous,corolla,decreasing,deep,diameter,distal,drying,elliptic,forked,fresh,fruit,glabrescent,glabrous,globose,green,greenish,half,herb,high,interjected,lanceolate,lateral,leaf,leaflet,lilac,medium,mm,mucilaginous,odd-pinnate,ovate,ovoid,pedicel,peduncle,pentagonal,petiole,plant,poricidal,purple,rotate,rounded,seed,sessile,size,stigma,straight,stripe,style,subtending,terminal,tip,toward,tube,wet,whitish,x,yellow	-9,0.8-2,1-3,1.5-1.8,10-26,2-4,3-4,3.3-11,5-merou,6.5-13.5,abaxially,acumen,adaxiall,adaxially,ag,alyx,apart,apparently,asymmetric,axe,basiscopic,berry,blade,capitat,cell,covering,dark,decurrent,digestion,dorsally,eaf,edge,eed,enzyme,erec,exceeding,filament,flat,flower,folded,geminat,generally,glabrou,green-white,hair,hair-like,hal,homostylous,honeycomb-shaped,lengthening,light,linear,living,lobe,long,lower,make,nflorescence,orbicular,orolla,pair,perfect,petiolulate,plurifoliate,pore,rachi,removed,ripe,ruit,seudostipule,short,side,slightly,slit,spaced,specimen,stamen,subequal,subglabrou,tall,tamen,tem,testal,thick,throughout,tissue,tri-,typically,unit,unwinged,usually,vary,wall,wood,ympodial	arrangement,articulation,bark,calyx,capitate,color,connation,dehiscence,diminishing,form,fruiting,growth,height,history,inflorescence,length,life,na,ovary,papillae,petiolule,position,prickle,pseudostipule,shape,spacing,stem,straightnes,subglabrous,surface,texture,tuber-bearing
20	wfo-0001025699	success	181	109	77	104	32	0.425	1-2,1-2.5,1-3,1/3,10,15-20,2-6,2cm,3-3.5,8-9,absent,acute,almost,anther,apart,apex,bark,base,berry,branching,brown,calyx,capitate,cm,corolla,dark,darker,diameter,dry,elliptic,fruiting,glabrous,globose,green,grey-brown,growth,immature,inflorescence,leaf,leaf-opposed,leafy,leaving,lobed,minutely,mm,older,ovary,pale,pedicel,peduncle,peg,petiole,poricidal,red,reniform,reticulate-pitted,rounded,rounded-sagittate,shoot,short,simple,slightly,small,stem,stigma,straight,style,surface,time,tip,tree,tube,way,white,woody,young,½	.2,.5,0.5,1,1-1.5,1.5,1.5-2,2,2-2.5,3-15,3-5.5,3-8,4-5,499,5-8,5-winged,5.5-14,abaxially,adaxially,age,anthesi,apparently,appearing,articulating,attenuate,becoming,c.,campanulate,completely,conical,conspicuously,continuing,corrugate,crystal,cup-shaped,deltate,densely,difoliate,dorsal,drying,eaf,eed,ellipsoid,entire,erect,exerted,face,fide,filament,flower,free,glabrou,included,inclusion,inflorescenc,irregularly,lanceolate,lengthening,less,lobe,lower,margin,markedly,midrib,narrowly,new,nflorescence,nodding,one,onto,oxalate,pair,papillat,papillose,penden,per,perfect,plurifoliate,pore,portion,primary,reddish,ruit,sand,scar,slit,somewhat,spaced,stearn,strongly,tangled,thickened,triangular,trichome,ud,unit,vein,white-spotted,wide,wing,winged,x,yellow,ympodial	arrangement,articulation,color,connation,dehiscence,diminishing,distal,form,fruit,height,history,interjected,lateral,leaflet,length,life,na,papillae,pendent,petiolule,plant,position,prickle,pseudostipule,seed,shape,size,spacing,straightnes,terminal,texture,tuber-bearing
21	wfo-0001025700	success	189	113	80	109	33	0.423	0-16,0.30-2.0,0.7-2.7,0.8-2.6,1-2,1.1-2.3,10.5-12,15-40,2-12,3-8,3.5-10.5,3.7-8.6,5-15,5-20,5.3-17.5,acuminate,acute,anther,apex,articulated,attenuate,base,brownish,chartaceous,clavate,cm,condition,connivent,corolla,diameter,distal,dot,drying,elliptic,forked,fresh,fruit,glabrescent,glabrous,globose,green,greenish,half,herb,high,honeycomb-shaped,interjected,lanceolate,lateral,leaf,leaflet,lilac,mm,odd-pinnate,ovate,ovoid,pedicel,peduncle,pentagonal,petiole,petiolulate,plant,poricidal,purple,ripe,rotate-pentagonal,rounded,seed,size,sometimes,stigma,straight,style,terminal,tip,tube,white,whitish,x,yellow	0.5-2,0.8-4,1-3,1.5-2,10-40,2-7,2.5-4,3-4,4-5,5-merou,5.5-18,5.5-8,9-31,abaxially,acuman,acumen,adaxially,ag,alyx,apiculate,apparently,asymmetric,axe,axillary,basal,basiscopic,berry,blade,bud,capitat,cell,considerably,covering,decrease,decreasing,digestion,dorsally,eaf,edge,eed,enzyme,erec,exceeding,except,filament,flat,flower,folded,geminat,generally,glabrou,green-white,hair,hair-like,hal,homostylous,larger,lengthening,light,linear,living,lobe,long,lower,make,medium,mucilaginous,narrowly,nflorescence,orbicular,orolla,pair,par,perfect,plurifoliate,pore,proximal,removed,ruit,sessile,seudostipule,short,side,slightly,slit,specimen,stamen,subequal,subglabrou,subtending,tall,tamen,tem,testal,thick,throughout,tissue,toward,tri-,typically,unit,unwinged,usually,vary,wall,wet,whose,winged,ympodial	arrangement,articulation,bark,calyx,capitate,color,connation,dehiscence,diminishing,erect,form,fruiting,growth,height,history,inflorescence,length,life,na,ovary,papillae,petiolule,position,prickle,pseudostipule,shape,spacing,stem,straightnes,surface,texture,tuber-bearing,ye
22	wfo-0001025702	success	279	122	87	192	35	0.312	.0,0.3–0.4,0.3–2.2,0.4–2.3,0.5–0.6,1.3–2.8,1.4–2.8,1.6–2.3,1.7–9.2,2,2.0–3.2,2.3,2.3–7.8,3.2,acuminate,acute,adjacent,aequilateral,anther,apex,apical,articulate,attachment,attenuate,bark,base,brown,calyx,capitate,chartaceous,cm,completely,corolla,cuneate,deflexed,diameter,distal,dry,elliptic,emerging,extra-axillary,flattened-orbicular,flower,fruit,globose,incurved,lanceolate,lateral,long,mature,minute,mm,notched,oblique,oblong,obtuse,pedicel,petiole,point,pore,porrect,prickle,red,reddish,rounded,scandent,shrub,side,simple,smooth,somewhat,stamen,stellae,stellate,stem,stigma,style,sub-coriaceous,surface,tube,two,white,yellow,yellow-tan,±connivent,×,–6	.1,.3,.5,.7,/2,0.04,0.5–0.8,0.5–1.3,0.6–0.9,0.6–1.0,0.7–1.4,1.2–1.6,1.3–1.8,1.4–1.6,1.4–2.2,1.6–1.7,1.6–1.8,1.6–2.0,1.6–2.1,1.7,1.7–2.3,1.9,1/3,1/4–1/3,2.2,2.2–2.9,2.3–6.6,2.5,2.6–7,2–14,3.6–3.9,4,4.3,4.5–5.2,4–16,5-merou,5.2–7.5,5.4,6.6,6.9–10.3,6–10,6–8,abaxially,adaxially,adnate,ag,alyx,anthesi,apart,apiculate,apparently,appearing,appresse,around,axe,ba,based,becoming,berry,blade,branch,broad,broad-based,broadly,brochidodromous,bud,channeled,congested,cream,curved,deciduous,deltate,deltoid,densely,dentate,developed,difoliate,directed,distally,distinct,eaf,edge,eed,either,endocarp,entire,exocarp,extending,ferruginous,fertile,filament,filiform,flexed,forked,free,geminat,glabrous,glandular,glossy,gradually,gree,hair,homostylous,hooked,hort,increasing,indistinct,intact,internode,interpetalar,intersepalar,joining,juic,laterally,lax,layer,limp,lobe,lon,longer,lower,m.,margin,midpoint,midrib,midvein,moderately,nearly,nflorescence,occasionally,opaque,orolla,ovate,per,perforated,poorly,portion,potentially,presen,primary,pseudo-intermarginal,pseudo-peduncle,pubescent,raised,ray,reflexed,remaining,retrorse,row,ruit,scattered,secondary,seen,sessile,shoot,sinus,sloughing,smoot,sometimes,soon,sparsely,splitting,spread,stellate-pubescent,straight,strongly,suture,tamen,tem,thin,time,tip,tissue,toward,transparent,triangular,truncate,ud,unarmed,unbranched,upper,vary,vein,wide,yellow-ferruginou,yellow-ferruginous,ympodia,young,±90,±90°,±equal,±glabrous	arrangement,articulation,color,connation,dehiscence,diminishing,form,fruiting,green,growth,height,history,inflorescence,interjected,leaf,leaflet,length,life,na,ovary,papillae,peduncle,petiolule,plant,position,present,pseudostipule,seed,shape,size,spacing,straightnes,terminal,texture,tuber-bearing
23	wfo-0001025704	success	248	120	89	159	31	0.359	/6,0-2,0-3.5,0-5,0.7-1,1-3.5,1-4,1-6,1.2-3,3-15,3-6,6-12,8-15,acute,almost,anther,apart,apex,articulated,auriculate,bark,base,branched,calyx,cell,cm,connivent,cordate,covering,diameter,distal,ellipsoid,elongating,evenly,flattened-reniform,fruit,fruiting,glabrescent,gray,green,green-yellow,lateral,leaf,length,less,lobed,long,mature,maturity,mauve,mm,orange-brown,outline,ovate,pale,pedicel,peduncle,petiole,pit,plant,poricidal,prickle,raised,rarely,recurved,red-brown,round,shape,shrub,small,smooth,sometimes,spherical,stellate-pubescent,stem,straight,style,surface,tapering,terminal,tip,truncate,tube,unbranched,white,wide,yellow,yellowish,young	-10,-2,-3,-5,0,0-100,0.1,0.1-0.3,0.1-0.5,0.15-0.8,0.3-0.8,0.5-1.5,1,1.5-2,1.5-3.2,1.5-4.5,1.8-3.5,1/2-4/5,1/4-3/4,1/5,2,2-10,2-3,2-4.5,2-5,2-7,2.5-4.5,2.7-4,3-10,3-5,4-12,4-5,4.5-6.5,5-20,5-merous,6-15,8-12,8-17,abaxial,abaxially,adaxial,age,alyx,andromonoecious,apar,apically,apiculate,apparently,axe,ba,berry,blade,broad-deltate,brow,chartaceous,curved,deltate,densely,development,discolorous,distance,drying,eaf,eed,elliptic,end,equal,erect,extending,filament,flattened,flower,free,glabrous,half,hermaphrodite,heterostylous,infructescence,irregular,lobe,lobing,long-styled,longer,lower,lowermost,margin,midpoint,midvein,moderately,multangulate,near,nflorescence,obtuse,occasionally,often,older,one,open,orange,orolla,oung,pair,pendulous,per,pericarp,plurifoliat,porrect,portion,prickl,prickly,primary,prominent,ray,red-green,reflexed,retaining,rounded,ruit,scar,secondary,sessile,short-styled,shorter,side,slender,somewhat,spaced,sparsely,spreading,stalk,stalked,staminat,stellate,stellate-pubescen,stout,strongly,tamen,terete,tertiary,throughout,time,tree,trichome,unarmed,unit,upper,variously,vary,vein,venation,visible,warty,way,white-gray,widening,woody,yellow-green,ympodial,×	arrangement,articulation,brown,color,connation,corolla,dehiscence,diminishing,form,growth,height,history,inflorescence,interjected,leaflet,life,na,ovary,papillae,perennial,petiolule,plurifoliate,position,pseudostipule,seed,size,spacing,stigma,straightnes,texture,tuber-bearing
24	wfo-0001025714	success	249	90	45	204	45	0.181	accrescent,acute,anther,apex,articulated,attenuate,base,broadly,calyx,cm,diameter,extra-axillary,flattened,free,fruit,fruiting,glabrous,glandular-pubescent,globose,light,mm,numerous,orbicular,ovary,ovate,pedicel,peduncle,petiole,prickle,rounded,shrub,simple,size,stellate,stem,stigma,straight,style,subreniform,tan,tube,unbranched,white,yellow,yellowish	%,-5,-rayed,.2,0.1–0.8,0.2–0.8,0.5,0.5–0.6,0.5–1.3,0.5–2,0.8,0–0.4,1,1.2–2.4,1.3–3,1.5–2,1.5–2.5,1.5–3.5,1.6–2.3,1.8–,1/3,100,10–11,13,15,15–25,1–2,1–4,2,2-foliate,2.2–3,2.5,2.5–3.8,2.8,2–3,2–4-celled,2–7,2–8,3.7–5,3–16,3–9,4–18,4–6,5,5.9–7.5,50,5–25,5–6.5,6.2–6.8,6–16,7–18,7–8.5,8–13,9.2–10,9–22,>,abaxially,absent,acicular,adaxiall,adaxially,additional,always,anthesi,apart,appearing,armed,around,ascending,asia,axe,ba,berry,blade,branch,capitat,caudate-tipped,completely,concealing,covering,curved,cylindrical,decidedly,differing,dilated,dimorphic,directed,distall,eaf,eed,enlarged,entire-margined,erect,fertile,few-branched,few-rayed,filament,flower,forward,frui,geminat,glabrou,gland,gland-tipped,gland–tipped,hair,half,halfway,herbarium,horizontally,hyaline,immediately,increasingly,lacking,larger,latter,less,lobe,lobed,lobing,long,longer,longest,lower,lowermost,mainly,major,male,many-rayed,margin,maturity,midrib,minor,minute,minutely,mixed,multangulate,narrowly,nearly,nflorescence,obtuse,often,one,orolla,pair,per,perhaps,pilose,plane,pointing,pore,predominating,pubescence,pubescent,rachi,rare,rarely,recurved,reflexed,ruit,scarcely,scattered,sessile,short,shorter,similar,single,slender,slightly,small,smaller,sometimes,spaced,sparse,specimen,spine,spreading,stellae,stipitate,stipitate-glandular,stouter,subcordate,subglabrous,tal,tamen,tem,terete,thin-textured,time,toward,triangular,truncate,unequal,unit,upper,usually,various,vary,way,wide,x,ympodial,–1.25,–7–9	0-0.8,0.1-0.8,0.5-2,1.5-2.5,1.5-3.5,3-9,6.2-6.8,7-8.5,9-22,arrangement,articulation,bark,capitate,color,connation,corolla,dehiscence,diminishing,distal,form,growth,height,history,inflorescence,interjected,lateral,leaf,leaflet,length,life,na,papillae,perennial,petiolule,plant,position,pseudostipule,seed,shape,spacing,straightnes,surface,terminal,texture,tuber-bearing
25	wfo-0001025726	success	158	101	68	90	33	0.43	-10,-5,0-1,0.2-0.3,0.5,0.5-1.5,1-2.5,1-3,10-15,2-,3-5,4-10,acuminate,acute,anther,apex,articulated,base,branched,brown,calyx,chartaceous,cm,connivent,diameter,elliptic,flattened,foveolate,fruit,fruiting,glabrous,globose,green,internode,lateral,leaflet,light,mm,narrowly,oblong,ovate,pedicel,peduncle,perennial,petiole,plurifoliate,poricidal,present,prickle,purple,rarely,recurved,rounded,shape,size,stellate,stigma,straight,strongly,style,subwoody,surface,terminal,tip,tube,white,x,yellow	-16,0.2,1,1-1.5,2-3,2.5,20-40,3-10,3-4,4,5,6-12,6-8,7-9,abaxially,accrescen,adaxiall,adaxially,adjacent,ag,alyx,anthesi,armed,axe,ba,becoming,blade,broadly,campanulate,clustered,compound,confluent,dr.,eaf,eed,elongating,entire,equal,fertile,filament,flower,geminat,hair,imparipinnately,lengthening,lobe,lobed,long,major,margin,midrib,nflorescence,oblon,occasionally,often,orolla,pinnate,pinnatifid,pore,puberulent,rachi,ranging,recurve,rugose,ruit,scandent,side,simple,slender,slit,spreading,stout,swollen,tamen,tem,terminally,time,truncat,ud,unbranched,unit,usually,variable,variously,vary,vein,vin,wide,woody,ympodial	accrescent,arrangement,articulation,bark,color,connation,corolla,dehiscence,diminishing,distal,form,growth,height,history,inflorescence,interjected,leaf,length,life,na,ovary,papillae,plant,position,pseudostipule,seed,spacing,stem,straightnes,texture,truncate,tuber-bearing,vine
26	wfo-0001025729	success	177	101	67	110	34	0.379	.5,0.7-1.2,1-5,1.1-1.5,20,4-5,abaxially,acute,adaxially,anther,apex,apical,bark,basal,base,bristly,calyx,cm,corolla,densely,dirty,elliptic,expanded,flattened-reniform,fruiting,furcate,glabrous,globose,greenish-yellow,greyish-brown,lateral,leaf,lobed,minutely,mm,opposite,ovary,pale,papillose,pedicel,petiole,pitted,plant,poricidal,portion,shiny,short,simple,size,sparsely,stem,stigma,stout,straight,style,surface,tapering,terminal,tip,tree,treelet,trichome,tube,uniseriate,white,woody,yellow	-20,/4,0.25-0.5,1-1.5,1.2-1.8,1.5-2,1.75,2,2-3.5,3-6,4-8,5-50-flowered,6-8,7-8,9-17,abaxial,abrupt,along,anthesi,apar,apiculate,appearing,axil,berry,black,blackish,branched,bright,bud,covered,covering,cyathiform,dark,deflexed,deltoid,denser,dia,diam,differing,difoliate,drying,eaf,edicel,eed,enclosed,f,filament,fleshy,free,geminat,gently,glabrou,green,growing,incrassate,lamina,lat,like,live,lobe,lon,long,lower,m.,main,mainly,major,margin,member,middle,minor,minute,nflorescence,oblique,occasionally,often,older,one,overlapping,overtopping,pair,papillo,partially,pit,pore,prominent,pubescent,quite,raised,reflexed,ripening,rounded,ruit,scar,shaped,tall,tear-drop,touching,tub,tuft,ud,unit,usually,vein,way,widening,widest,x,ympodial,young	4-20,apart,arrangement,articulation,color,connation,dehiscence,diameter,diminishing,distal,form,fruit,geminate,growth,height,history,inflorescence,interjected,leaflet,length,life,na,papillae,peduncle,petiolule,position,prickle,pseudostipule,seed,shape,spacing,straightnes,texture,tuber-bearing
27	wfo-0001025737	success	220	137	80	140	57	0.364	-branched,10,2,3,5,abaxially,absent,adaxially,angularly-cordate,anther,apart,apex,apical,articulated,attenuate,base,bright,broad-based,cm,densely,diameter,directed,extra-axillary,flattened-reniform,flower,fruit,glabrous,gland-tipped,globose,greenish,growth,hair,interpetalar,lateral,light,lighter-colored,linear-attenuate,long,loosely,margin,minute,minutely,mm,narrow,near,obtuse,orange,ovate,ovate-lanceolate,pale,pedicel,peduncle,petiole,pitted,pore,prickle,rarely,reflexed,rounded,scarcely,seed,short-stipitate,shrub,simple,stellate,stellate-tomentose,stem,stigma,straight,style,surface,tinge,tissue,tomentose,triangular-attenuate,tube,violet,white,wide,yellow	0.2–0.3,0.3–0.7,0.3–2,0.6,0.6–0.9,0.7–1.3,0.8–1.1,0.9–1.1,1.4–1.8,1.5,1.5-2,1.5–2,1.5–3,1.5–5,1.5–6.5,1.7–2.2,10–12,1–,1–1.2,1–1.5,2.5–3,2.5–4.5,25–50,2–3,3.5–5,3.5–8,3–10,44599,47092,4–11,4–6,5-merous,51,5–6,7–8,8–10,8–16,9-10,95,accrescen,acute,adaxiall,age,alyx,apparently,appressed-tomentose,armed,axe,ba,becoming,blade,branch,capitat,deeply,difoliate,distall,eaf,eed,entire,except,fertile,filament,filiform,finely,free,geminat,glabrou,green,high,homostylous,immature,internode,juicy,juvenile,lance-ovoid,like,linear-lanceolate,lobe,lobed,lon,long-stipitate,lower,major,midpoint,midvein,midzone,mixed,nee,nflorescence,northern,numerous,oblong,odorle,orolla,part,per,perfect,persistently,porrect,principal,range,ray,ruit,sessile,shallowly,shiny,short-,shorter,side,sinus,slender,southern,spaced,sparsely,splitting,ste,stellae,stellate-pubescent,stipe,straigh,tamen,tem,thick-chartaceous,time,tomento,turning,ud,unarmed,usually,vary,vein,vigorous,whitish,x,ympodia,×,–14,–20,–3,–4	-3,0.3-0.7,0.3-2,0.8-1.1,1-,1-1.5,1.5-3,1.5-5,10-12,14,2.5-3,2.5-4.5,20,3.5-5,3.5-8,4,4-11,5-6,8-16,accrescent,arrangement,articulation,bark,calyx,capitate,color,connation,corolla,dehiscence,diminishing,distal,distally,form,fruiting,height,history,inflorescence,leaf,leaflet,length,life,na,ovary,papillae,plant,position,presence,present,pseudostipule,shape,size,spacing,straightnes,terminal,texture,tuber-bearing,ye
28	wfo-0001025741	success	231	116	70	161	46	0.303	abaxial,adaxial,anther,apart,apex,articulated,bark,base,broad-based,brown,calyx,chartaceous,cm,connivent,curved,dark,densely,diameter,extraaxillary,fading,flattened,fruit,fruiting,glabrous,globose,golden-tan,green,inflated,inflorescence,juicy,knobby,lanceolate,leaf,length,light,lighter,lustrous,maturity,mm,moderately,once-branched,orange,outline,ovate,pedicel,peduncle,petiole,plant,prickle,pubescent,reniform,rotate-stellate,rugose,sharp,short-cylindrical,simple,stem,stigma,stout,strongly,style,surface,tan,tapered,tree,tube,unbranched,violet,white,yellow	.2,.5,0-0.1,0.5–0.8,0.5–3,0–0.1,1.1–2,1.2–1.5,1.7–2,1.8–2.1,10–35,11–14,12–15,15–45,1–2,1–2.5,1–4,2.5–3,2.5–3.5,2.5–8,20–23,29–36,2–3,2–3.2,2–4,2–7.5,30–120,3–10,3–6,4–5,4–6,4–7,5-merous,5–17,5–6,6.5–9,6–7,8–15+,8–18,abaxially,abundant,abundantly,acuminate,acute,adaxially,along,alyx,andromonoeciou,andromonoecious,anthesi,armed,axe,ba,becoming,berry,blade,capitat,column,congested,covered,cuneate,cylindrical,db,deltate,deltoid,difoliate,directed,distall,dry,eaf,eed,eglandular,either,emergent,entire,equal,filament,flower,flowering,free,fresh,frui,functionally,geminat,glandular,hair,half,hermaphroditic,heterstylous,included,interpetalar,like,lobe,lobed,lon,long,long-stalked,lower,major,margin,membranaceous,midpoint,midvein,multangulate,multiseriate,nearly,nflorescence,oblique,one,orange-tan,orolla,part,pericarp,pore,porrect-stellate,present,rachi,ray,remaining,ruit,runk,sessile,shallowly,shiny,short,short-stalked,side,small,somewhat,spaced,sparse,sparsely,stalk,stalked,staminate,stellate,stellate-pubescent,straight,subtending,tamen,thi,thin,time,tissue,tuft,unarmed,unit,vary,vein,wide,within,ympodial,young,×,–12,–20,–28,–30,–39,–6,–8	-12,0.5-0.8,0.5-3,1-4,1.2-1.5,12-15,2.5-8,20,20-23,28,3-10,30,5-17,6.5-9,arrangement,articulation,capitate,color,connation,corolla,dbh,dehiscence,diminishing,distal,form,growth,height,history,lateral,leaflet,life,na,ovary,papillae,petiolule,position,pseudostipule,seed,shape,size,spacing,straightnes,terminal,texture,tuber-bearing,x
29	wfo-0001025743	success	157	111	87	70	24	0.554	%,.5,0-15,0.15-0.3,0.3-0.6,0.4-0.5,0.4-0.8,0.9-1.2,0.9-2.6,1.2-4,11-25,12-17,2-3,2-4,2-4.5,2.3-5,2.8-3.5,3.5-5.5,30-80,4.5-5.5,5-10,6-10,6-7,8-10,9-18,abaxially,absent,adaxially,apex,articulated,base,broadly,brown,calyx,chartaceous,cm,cordate,cuneate,cylindrical,decimetre,deeply,dense,diameter,extra-axillary,finger,flower,fruit,functional,glabrous,gland-tipped,globose,green,grey,hair,herbaceous,index,inflorescence,lamina,length,lobe,lobed,lobing,longer,margin,mm,obtuse,ovate,pale,pedicel,peduncle,per,petiole,plant,prickle,resprouter,short,stellate,straight,style,throughout,time,tube,unbranched,white,wide,x,yellow	0-6,0.1-0.3,0.3-0.5,0.5-0.9,1,1-6,1.3-1.8,3-13,3-4,3-6,4-8,5-20,5-merou,6-20,absen,acicular,adaxiall,adult,alyx,andromonoecious,apart,armed,axe,ba,blade,branche,deltate,directed,distall,eaf,eed,fruiting,half,heterostylous,lateral,less,lon,long,lower,mature,mid-point,midvein,minute,nflorescence,nther,oblique,onl,orolla,part,pore,presen,present,prostrate,ruit,side,simple,spaced,sprawling,stage,strongly,tal,tem,thick,unit,unknow,uvenile,vary,vein,yellowish-gree,ympodial	5-merous,anther,articulation,color,corolla,count,density,form,growth,height,history,leaf,life,ovary,position,proportion,seed,shape,size,stem,texture,thicknes,width,yellowish-green
30	wfo-0001025749	success	217	94	61	156	33	0.281	0-8,0.2-1.5,0.3-1.5,0.5-0.9,0.8-0.9,1-10,1-8.5,1-9,2-10,3-5,anther,apex,apparently,articulated,bark,base,berry,calyx,chartaceous,cm,diameter,dull,elongating,flattened-reniform,fruit,fruiting,glabrescent,glabrous,gray,lateral,leaf,length,light,lobed,markedly,maturity,mauve,mm,orange-brown,orange-red,orbicular,ovate,pedicel,peduncle,petiole,poricidal,prickle,recurved,shrub,spherical,spreading,stem,straight,style,surface,tapering,tip,tube,white,yellow,yellowish	-1,-12,.5,/5,0-10,0-3,0-5,0-6,0.1,0.1-0.2,0.1-0.3,0.1-0.4,0.2,0.4-0.7,0.5,0.5-0.8,0.5-1.3,0.5-3,0.6-4.5,1,1-13,1-2,1-3,1-6,1.5,1.5-2,1.5-2.5,1/4-1/3,1/5-1/2,2-2.5,2.5-6,2/3,3-20,4-8,5-,5-10,5-20,5-merous,6-8,abaxial,abaxially,acuminat,acute,adaxial,adaxially,adnate,almost,alyx,apar,apart,apically,blade,branched,broad-deltate,concolorous,cuneate,curved,dark,densely,difoliate,discolorous,distance,drying,eaf,eed,equal,erect,extending,filament,filiform,flattened,flower,free,geminat,gently,green-brown,herbaceous,indistinct,infructescence,lobe,lon,long,long-ovate,longer,lower,magnification,margin,mature,midpoint,midvein,moderately,narrow-deltate,narrow-ovate,nflorescence,oblong,obtuse,occasionally,older,one,open,orange-brow,orolla,oung,pair,pale,pendulous,per,perfec,pericarp,porrect,portion,prickl,prickly,primary,procumbent,purple,rarely,ray,red-brown,reduced,rounded,ruit,scar,sessile,shorter,side,smooth,sometimes,spaced,sparsely,stalk,stalked,stellate,stellate-pubescent,straw-yellow,strongly,tamen,terete,tertiary,time,toward,trichome,unit,usually,variously,vary,vein,venation,visible,way,wide,without,yellow-green,yellow-orange,ympodial,½-2/	arrangement,articulation,color,connation,corolla,dehiscence,diminishing,distal,form,growth,height,history,inflorescence,interjected,leaflet,life,na,ovary,papillae,perennial,petiolule,plant,position,pseudostipule,seed,shape,size,spacing,stigma,straightnes,terminal,texture,tuber-bearing
31	wfo-0001025754	success	164	102	65	99	37	0.396	0.5-1,0.5-1.5,1-3,10-20,3-10,4-6,5-15,absent,acuminate,acute,anther,apex,asymmetrical,base,brown,calyx,center,cm,cordate,cordiform,decurrent,diameter,dm,drying,edge,fine,flower,fruit,glabrous,globose,herb,immature,leaf,margin,maturing,mm,nearly,oblong,often,parallel,pedicel,peduncle,petiole,pubescent,radiating,raised,ridge,rotate,running,semitransparent,shallow,slightly,solitary,sometimes,sparsely,stem,stigma,style,surface,truncate,tube,white,woody,x,yellow	-celled,.5,0.1-0.2,1,1-2,1-3.5,1.5,1.5-3,1.5-4,10-35,2-4,2-5-celled,2-7,2-foliate,3-5,3-6,4,5-12,abaxially,abundant,adaxiall,adaxially,along,axe,barely,berry,beyond,blade,branch,chartaceous,ciliate,connected,decumbent,dehiscing,densely,denser,dried,eaf,eed,eglandular,emarginat,entire,equal,erect,explosively,exserted,filament,flat,geminat,glandular,hair,held,interpetalar,leaving,like,linear-lanceolate,lobe,long,lower,lying,main,material,maturit,membranaceous,mesocarp,mixed,moderately,much-branched,nfloresence,notch,orolla,palmately,penden,per,placenta,pressure,probably,pubescen,rachi,ruit,short,small,stamen,straight,swollen,tal,tamen,tem,tissue,triangular,unbranched,unit,upright,vary,vein,visible,watery,wid,ympodial	arrangement,articulation,bark,color,connation,corolla,dehiscence,diminishing,distal,form,fruiting,geminate,growth,height,history,inflorescence,interjected,lateral,leaflet,length,life,na,ovary,papillae,petiolule,plant,position,prickle,pseudostipule,seed,shape,size,spacing,straightnes,terminal,texture,tuber-bearing
32	wfo-0001025760	success	210	110	75	135	35	0.357	/3,0-0.5,0.15-0.3,0.3-1,0.45-0.9,0.5-2,1-1.8,1-4,1/4,3.5-9,annual,anther,apex,articulated,bark,base,calyx,cm,connivent,cream,cultivar,dark,diameter,distance,dull,elliptic,flattened-reniform,fruit,fruiting,glabrous,green,herb,lateral,leaf,length,lobed,margin,marking,maturity,midpoint,midvein,mm,moderately,orange,orange-brown,ovate,pale,pedicel,peduncle,perennial,petiole,poricidal,ray,recurved,shape,shrub,sometimes,spherical,spreading,stellate-pubescent,stem,straight,style,subentire,surface,tapering,tip,tube,unbranched,various,way,weakly,white,yellow,young	-10,-12,-3,-5,-6,.5,0-100,0.1,0.1-0.2,0.2-0.35,0.4-0.8,0.5-1.5,0.7-2.5,0.8-1.8,1,1-,1-2,1.5,1.5-2.5,1.5-4.5,1.5-5,1/4-1/2,1/4-1/3,1/5,2-2.5,2-3,2.1-3.5,2.3-4,2.5-10,2.5-8,2/3,3,3-6,3.5-17,5-10-merous,5-18,8-10,abaxial,abaxially,acut,acute,adaxial,almost,alyx,apar,apically,apparently,berry,black,blade,broad-deltate,brow,chartaceous,concolorous,cuneate,curved,deltate,difoliate,discolorous,drying,eaf,eed,elongating,equal,erect,extending,filament,flower,free,geminat,geminate,gently,glabrescent,hair,infructescence,lengt,lobe,long,longer,lower,mature,membranous,minute,nflorescence,often,older,one,open,orolla,oung,pair,pendulous,per,perfec,pericarp,porrect,portion,primary,red-brown,reflexe,rounded,ruit,scar,sessile,shorter,side,simple,slender,smooth,spaced,stalk,stalked,stellate,stellate-pubescen,stout,tamen,terete,tertiary,thick-stalked,time,trichome,unarme,unarmed,unit,upper,usually,variously,vary,vein,venation,visible,wide,woody,yellow-green,ympodial	apart,arrangement,articulation,brown,color,connation,corolla,dehiscence,diminishing,distal,form,growth,height,history,inflorescence,interjected,leaflet,life,na,ovary,papillae,petiolule,plant,position,prickle,pseudostipule,reflexed,seed,size,spacing,stigma,straightnes,terminal,texture,tuber-bearing
33	wfo-0001025782	success	200	92	62	138	30	0.31	0-5,0.55-0.75,0.9-1.3,1-2.5,1.2-6,1.5-3,2-3,2-5,2-7,3-4,4,anther,apex,bark,base,brown,calyx,chartaceous,climbing,cm,conical,connivent,cuneate,curved,diameter,distal,dull,elliptic,evenly,flattened,flattened-reniform,fruit,glabrescent,glabrous,green,lateral,leaf,length,lobed,maturity,membranous,mm,orange-brown,pedicel,peduncle,petiole,plant,poricidal,prickle,shrub,spherical,stem,straight,style,surface,tapering,tip,tube,unbranched,white,yellow,young	-2,.5,0-10,0.1-0.15,0.1-0.2,0.1-0.25,0.3-1,0.4-0.6,0.5-1,1,1-1.7,1-2,1-4,1.3-1.6,1/4-1/2,1/4-1/3,1/6,10-13,2-10,2-2.5,2.5-3.5,2/3-3/4,20,3-5,4-4.5,4.5-9,5-20,5-6.5,5-8,5-merous,5.5-6,6-14,6-8,abaxial,abaxially,acuminat,acuminate,adaxial,also,alyx,andromonoecious,apar,apart,apically,apparently,articulated,berry,blade,concolorous,deltate,densely,difoliate,discolorous,distance,drying,eaf,eed,elongated,elongating,equal,extending,filament,flower,free,fruiting,geminat,geminate,gently,green-brown,hair,hermaphrodite,heterostylous,infructescence,lengt,less,lobe,long,long-styled,longer,lower,lowermost,margin,mature,midpoint,midvein,minute,moderately,nflorescence,occasionally,older,one,open,orolla,oung,pair,pendulous,per,pericarp,porrect,portion,prickl,prickly,primary,ray,red-brow,reduced,ruit,scar,sessile,short-styled,shorter,side,simple,smooth,spaced,sparsely,spreading,staminat,stellate,stellate-pubescent,stout,tamen,terete,tertiary,time,toward,trichome,unit,vary,vein,venation,visible,way,weakly,wide,woody,yellow-green,ympodial	apiculate,arrangement,color,connation,corolla,dehiscence,diminishing,form,growth,height,history,inflorescence,interjected,leaflet,life,na,ovary,papillae,pseudostipule,red-brown,seed,shape,size,spacing,stigma,straightnes,terminal,texture,tuber-bearing,width
34	wfo-0001025783	success	179	107	74	105	33	0.413	0.5-1,0.5-1.5,1-1.2,1-1.5,1-3,2,2-3+,2-5,2-6.5,acute,anther,apart,apex,articulated,base,berry,branched,brown,c.,calyx,cluster,cm,conical,coriaceous,corolla,diameter,ellipsoid,elliptic,flattened,fleshy,fruiting,glabrous,globose,greyish,growth,inserted,lateral,lax,less,lobed,minutely,mm,narrowly,obtuse,pale,pedicel,peduncle,petiole,pitted,purple,reniform,ripe,sagittate,shoot,short,shrub,simple,sleeve,somewhat,sparse,stellate,stem,stigma,style,surface,terminal,thin,time,truncate,tube,vine,violet,way,woody	.5,0.5,0.8-3.5,1.8-2,3-4,5,5-merou,7-10,<,abaxiall,abaxially,adaxiall,adaxially,along,alyx,anthesi,ape,ark,axil,branching,bud,cell,completely,confined,dendritic,densely,eaf,eed,entire,erect,expanded,exposed,exserted,filiform,flexuous,flower,free,glabrou,green,groove,hromosome,ilament,keeled,known,lobe,long,long/tall,lower,margin,mature,midrib,midvein,minute,mmm,near,new,nflorescence,nodding,number,obscured,occasionally,older,orolla,outlin,pair,penden,pentagonal,perfect,pericarp,plurifoliat,point,portion,possibly,primary,pubescent,revolute,ruit,scar,scarious,see,shiny,slightly,sometimes,spaced,sparsely,strongly,suture,testal,transparent,triangular,trichome,tuft,twinin,type,ud,uniseriate,unit,upper,vary,vein,weak,wide,within,yellowish,ympodial	3,arrangement,articulation,bark,color,connation,dehiscence,diminishing,distal,form,fruit,height,history,inflorescence,interjected,leaf,leaflet,length,life,na,ovary,papillae,petiolule,plant,position,prickle,seed,shape,size,spacing,straightnes,texture,tuber-bearing
35	wfo-0001025784	success	241	108	67	174	41	0.278	-3,.5,0.2-0.3,0.5,1-5,6,abaxially,accrescent,acicular,adaxially,anther,apart,apex,articulated,base,black,calyx,cm,cylindrical,diameter,extra-axillary,free,fruit,fruiting,gland,globose,green,greenish,lanceolate,leaf,long,major,midrib,minute,mm,nearly,numerous,ovate,pedicel,peduncle,petiole,prickle,purple,sharp,short,shrub,simple,smooth,somewhat,spiny,stellate,stem,stigma,stipitate,style,subreniform,surface,thin-textured,truncate,tube,unbranched,vein,white,x,yellow,yellow-brown,yellow-green	.2–0.4,0.2,0.2–1.1,0.3–0.5,0.4–2.5,0.5–1.8,0.5–2,0.5–3,0.6–0.8,0.7,0.8–1.1,0.8–1.2,0.9–1.2,0.9–1.4,1,1.2,1.2–2.5,1.3–1.8,1.6–2.2,1/3,10,10–15,15075,1709,1–,1–3,1–5,2,2-foliate,2.5–3.3,2/3,2–2.5,2–3,2–4,2–5-celled,2–7,3.5,3–4,3–4-rayed,4.5–5.5,5,5–6,6.5–8,6.5–8.5,=,acute,adaxiall,also,always,anthesi,asplund,ba,becoming,blade,branched,brazil,cell,ciliate,completely,conical,curved,directed,distall,drying,eaf,eed,enclosing,enlarged,especially,et,exceeding,fertile,fide,filament,flattened,flower,frui,geminat,glabrescent,glabrou,glabrous,gland-tipped,glandular-pubescent,greenish-yellow,hair,hyaline,insolated,irregularly,irwin,lobe,lobed,longitudinal,lower,lowest,male,many,margin,midpoint,minutely,moderately,mostly,mottled,much,n,narrowly,nflorescence,obtuse,offset,one,orolla,pair,per,pilose,pore,pubescence,pubescent,rachi,raised,rarely,ray,recurved,reflexed,reported,ripe,rounded,rudimentary,ruit,second,sessile,shallowly,side,similar,slightly,small,sometimes,spaced,sparsely,sprawling,spreading-pilose,stamen,ste,stellae,stout,straight,subcapitat,subcordate,tal,tamen,tem,thick,thicker,time,tip,toward,triangular,unarmed,unequal,unit,upper,usually,variously,vary,way,wid,wide,widest,without,ympodial,young,–2,–4,–5.5,–8,–9	-8,0.2-0.4,0.5-3,10-15,2-4,2-7,arrangement,articulation,bark,color,connation,corolla,dehiscence,diminishing,distal,form,growth,height,history,inflorescence,interjected,lateral,leaflet,length,life,na,ovary,papillae,petiolule,plant,position,pseudostipule,seed,shape,size,spacing,straightnes,subcapitate,terminal,texture,tuber-bearing
36	wfo-0001025788	success	158	131	97	61	34	0.614	0.5-2,1-5,1.8-2.7,1.8-3.9,15-30,2-10,2-13,2-3,2.8-9.5,4.5-10.1,4.5-12.5,5-8,6.2-12.5,acuminate,acute,apex,apical,apically,articulate,base,blue,branched,calyx,cell,cm,conical,connate,corolla,covering,cuneate,cyme,deep,dehiscent,diameter,dichasial,dichasially,diminishing,distal,ebracteate,elliptical,finely,forked,generally,gradually,green,green-white,hair-like,half,herbaceous,interjected,introrse,lateral,leaf,leaflet,long,make,maturing,medium,mm,monochasial,mucilaginous,narrowly,oblique,obtuse,odd-pinnate,often,ovate,ovoid,pedicel,peduncle,perennial,petiole,plant,poricidally,proximal,pubescent,purple,rotate,rounded,seed,short,size,slit,stigma,straight,style,terminal,testal,thick,throughout,tip,toward,tuber-bearing,wall,wide,yellow,¼	-8,0-6,1-4,10-24,14-48,2-5,2m,3-,3-6-foliat,4-3.,4-5.5,6-7,8-38,abaxiall,abaxially,acumen,adaxially,attenuate,digestion,dorsally,eaf,edge,eed,emoval,enzyme,exceeding,filament,flat,flower,folded,globo,honeycomb,living,lobe,lon,long-attenuate,lower,lunat,nflorescence,nther,orolla,pair,pattern,perfect,petiolule,plan,reveal,ruit,sessile,seudostipule,specimen,stamen,subequal,subsessile,tal,tem,throughou,typically,unit,vary,ympodial	4-31,anther,arrangement,articulation,bark,color,connation,dehiscence,form,fruit,fruiting,globose,growth,height,history,inflorescence,length,life,lunate,na,ovary,papillae,position,prickle,pseudostipule,shape,spacing,stem,straightnes,surface,texture,tube,wet,ye
37	wfo-0001025792	success	203	116	86	117	30	0.424	0.4-0.7,1-10,1-2,1-3,10-15,2-3.5,2.5-4,21-28,3-5,4-12,4.5-7,5,5-10,5-9,7.5-8,8-10,acute,anther,apex,articulation,auriculate,axillary,base,blue-mauve,blue-purple,brownish,bud,cm,condition,connivent,corolla,densely,diameter,distal,distinct,distinctly,drying,elliptic,forked,fresh,fruit,glabrous,globose,green,greenish,herb,indistinct,interjected,lanceolate,lateral,leaflet,mauve,minute,mm,mucilaginous,oblique,odd-pinnate,ovoid,papillose,pedicel,peduncle,petiole,plant,poricidal,pubescent,purple,rotate-pentagonal,rounded,seed,size,slightly,stem,stigma,straight,streak,style,subtending,terminal,tinged,tip,tube,wet,white,whitish,x,yellow	1-4,2-11,2-3,2.5-3.5,3-4,3.5-6,4-6,5-6,5-merou,7-10,9-12,abaxially,acumen,acuminate,adaxially,ag,along,alyx,apart,apparently,articulated,axe,basiscopic,berry,blade,broadly,capitat,cell,chartaceous,ciliate,covering,dark,decurrent,developing,digestion,dorsally,eaf,edge,eed,enzyme,especially,exceeding,except,filament,flat,flower,folded,geminat,generally,glabrou,greatly,green-white,hair,hair-like,hal,half,high,homostylous,honeycomb-shaped,lengthening,like,living,lobe,long,lower,make,margin,membranous,midrib,minutely,mottle,narrow,narrowly,nflorescence,often,onto,orolla,pair,perfect,petiolulate,plurifoliate,pore,proximal,puberulent,rachi,reduced,removed,ripe,ruit,semi-erec,semi-rosette,sessile,seudostipule,short,shortly,side,slit,spaced,specimen,stamen,ste,sub-rosette,subequal,tall,tamen,tem,testal,thick,throughout,tri-,unit,usually,vary,wall,wing,ympodial,young	arrangement,bark,calyx,capitate,color,connation,dehiscence,diminishing,form,fruiting,growth,height,history,inflorescence,leaf,length,life,na,ovary,papillae,position,prickle,pseudostipule,shape,spacing,straightnes,surface,texture,tuber-bearing,ye
38	wfo-0001025804	success	155	91	60	95	31	0.387	1-1.5,1-3,1.4-1.7,3.5-12,6-8,abaxially,adaxially,age,anther,bark,base,bilobed,calyx,cm,conical,corolla,cream,dark,difoliate,elliptic,flattened,fruiting,glabrous,glandular,globose,green,internodal,lateral,leaf,lengthening,light,lobed,minute,minutely,mm,nearly,obovate,occasionally,opposite,ovary,papillae,pedicel,pitted,plurifoliate,poricidal,red,reddish-brown,reniform,shrub,size,slit,somewhat,stem,stigma,style,surface,tip,tube,white,whitish-green	.25,.5,0.5-1,1.2-1.5,1.5-2,10-20,11-20,16-35,2-2.5,2.5-4,3-4.5,4-10,5,7-10,?,acute,anthesi,apar,ape,apex,apiculate,attenuate,ba,berry,branched,c.,clavate,covered,cucullate,decurrent,deflexed,densely,dia,differing,drying,eaf,edicel,eed,ellipsoid,erect,exserted,filament,fleshy,flower,free,geminat,incrassate,later,lobe,long,lower,main,major,many,margin,mere,middle,minor,near,nflorescence,often,older,onto,pair,paler,papillat,papillate,papillose,planar,pore,portion,projection,red-papillose,reddish-brow,regularly,rim,ruit,scar,sessile,spaced,strongly,tall,thick,time,tub,ud,unit,vein,widest,wing,winged,woody,x,ympodial,young	apart,arrangement,articulation,color,connation,dehiscence,diameter,form,fruit,geminate,growth,height,history,inflorescence,interjected,leaflet,length,life,na,peduncle,petiole,plant,position,prickle,pseudostipule,seed,shape,spacing,straightnes,terminal,texture
39	wfo-0001025813	success	197	115	82	115	33	0.416	0-2,0.7-1.7,1-10,1-2,1-4,1.2-4.5,1.3-7,15-30,2-3,3-4,3-5,3-7,5-6,6-7,anther,apex,articulated,base,berry,blue,broadly,brownish,cell,cm,condition,connivent,corolla,covering,cuneate,dark,decurrent,densely,diameter,distal,drying,elliptic,fresh,fruit,globose,green,greenish,hair,hair-like,herb,interjected,lanceolate,lateral,leaflet,light,mm,monochasium,obtuse,odd-pinnate,ovoid,pedicel,peduncle,petiole,pilose,plant,poricidal,pubescent,rarely,rotate,seed,size,stem,stigma,straight,style,suborbicular,terminal,testal,thick,tip,tube,typically,violet,wall,white,whitish,x,yellow	'',1-1.5,1.5-1.8,1.5-2,1.5-6.5,2-4,2-5,3-3.5,3-6,5-18.5,5-merou,``,abaxially,absent,acumen,acuminate,acute,adaxially,ag,along,alyx,apart,apparently,axe,blade,borne,chartaceous,ciliate,contracted,decreasing,digestion,discussion,distinct,dorsally,eaf,edge,eed,end,enzyme,especially,exceeding,extra,filament,flat,flower,folded,geminat,glabrou,glabrous,green-white,half,highly,homostylous,honeycomb-shaped,larger,lengthening,like,living,lobe,long,longer,lower,make,margin,membranous,midrib,minute,minutely,mucilaginous,near,nflorescence,often,orbicular,orolla,ovate,ovoi,pair,perfect,petiolulate,plurifoliate,pore,puberulent,rachi,removed,rosette-formin,ruit,see,sessile,seudostipule,short,single-flowered,singly,slit,sometimes,spaced,species,specimen,stamen,ste,stolo,strongly,tamen,tem,thir,throughout,toward,tri-,tuber,unforked,unit,unwinged,vary,vein,wet,ympodial	arrangement,articulation,bark,calyx,color,connation,dehiscence,diminishing,form,fruiting,growth,height,history,inflorescence,leaf,length,life,na,ovary,papillae,petiolule,position,prickle,pseudostipule,rosette-forming,shape,spacing,straightnes,surface,texture,third,tuber-bearing,ye
40	wfo-0001025817	success	238	114	68	170	46	0.286	10,acuminate,anther,apart,apex,articulated,asymmetric,asymmetrically,base,bifurcate,black,broadly,brown,calyx,chartaceous,cm,deeper,densely,diameter,directed,distally,dull,eventually,extra-axillary,flower,fruit,fruiting,globose,larger,lateral,leaf,lenticular,linear-lanceolate,minutely,mm,near,obtuse,occasionally,ovate,pale,pedicel,peduncle,petiole,pitted,present,prickle,pubescent,purple,ripe,rounded,shrub,simple,slender,stellate,stem,stigma,style,surface,tapering,tree,tube,turning,unequally,violet,weakly,white,yellow,×	0.5–0.7,0.6–0.8,0.8–1.5,0–1.6,1-1.6,1.5–2.5,1.7-2.1,1.8–2.3,1.8–3,10–16,10–35,12–16,1–3,1–5,2–2.9,2–3,2–5,2–6.5,2–8,3.2–8,3.5–6,3–,3–13,3–6,3–8,4–5.5,4–6,4–7,5-merou,5–20,5–6,6–13,7–9,8–14,8–21,abaxially,absent,accrescen,acute,adaxially,age,along,although,alyx,amount,apiculate,apparently,armed,axe,ba,berry,bicolorous,blade,branch,branched,broad-based,campanulate,capitat,central,compresse,conical,dark,deciduous,deltoid,dense,developing,difoliate,distall,eaf,eed,entire,exceeding,except,expanded,expansion,fertile,fewer,filament,filiform,flowering,forming,free,geminat,glabrate,glabrou,glabrous,green,high,impressed,interpetalar,juvenile,lacking,lanceolate,large,laterally,like,lobe,long,low,lower,major,margin,midpoint,midvein,minute,moderate,much,nerve,nflorescence,numerous,oblong,often,one,orolla,overlapping,pedunculate,persistent,persistently,pinnatifi,pore,portion,prickly,principal,pubescence,racemose,rachi,rarely,rayed,reaching,recognizable,row,ruit,sessile,short,single,sinuate–repand,sinus,sized,slightly,small,sometimes,soon,spaced,sparse,spreading,stalked,stellae,stout,strongly,tamen,time,tissue,tomentose,trunk,ultimate,unarmed,underside,unit,usually,variously,vary,vein,velvety,well,white-stellate,wide,without,woolly,ympodial,young	0-1.6,10-35,2-5,2-8,3-13,3-6,3-8,4-7,5-20,7-9,8-21,accrescent,arrangement,articulation,bark,capitate,color,connation,corolla,dehiscence,diminishing,distal,form,growth,height,history,inflorescence,interjected,leaflet,length,life,na,ovary,papillae,perennial,petiolule,plant,position,seed,shape,size,spacing,straightnes,terminal,texture,tuber-bearing
41	wfo-0001025825	success	187	110	78	109	32	0.417	0.4-1,0.5-10.4,0.7-2.2,0.9-2,1-2,1-5.5,10-24,14-85,3-10,3-5,3-8.5,3.7-6.5,4-9,5-10,6-10,acuminate,acute,anther,apex,articulated,axillary,base,berry,bud,clavate,cm,connivent,coriaceous,corolla,decurrent,diameter,distal,elliptic,forked,fruit,glabrous,green,greenish,half,herb,high,interjected,lanceolate,lateral,leaf,leaflet,lilac,medium,mm,mucilaginous,odd-pinnate,ovoid,pedicel,peduncle,pentagonal,petiole,petiolulate,plant,poricidal,rotate-pentagonal,seed,sessile,shiny,size,slightly,stigma,straight,streak,style,subtending,terminal,tip,tube,wet,white,whitish,x,yellow	0-0.21,0.4-3,0.5-0.8,0.9-4,1-3,1.1-1.4,10.5-26,2-3.7,2-5,22-86,4-8,5-7,5-merou,6.6-14,abaxially,acumen,adaxiall,adaxially,ag,alyx,apart,apparently,asymmetric,attenuate,axe,back,basiscopic,blade,brownish,capitat,cell,condition,covering,cuneate,dark,decreasing,digestion,dorsally,drying,eaf,edge,eed,enzyme,erec,exceeding,filament,flat,flower,folded,fresh,geminat,generally,glabrescent,glabrou,green-white,hair,hair-like,hal,homostylous,honeycomb-shaped,increasing,lengthening,light,living,lobe,long,lower,make,middle,nflorescence,orbicular,orolla,ovate,pair,perfect,plurifoliate,pore,rachi,removed,rounded,ruit,seudostipule,short,side,slit,smaller,spaced,specimen,stamen,subequal,subglabrou,tall,tamen,tem,testal,thick,throughout,tissue,toward,tri-,unit,unwinged,usually,vary,wall,wide,wing,winged,ympodial	arrangement,articulation,bark,calyx,capitate,color,connation,dehiscence,diminishing,form,fruiting,growth,height,history,inflorescence,length,life,na,ovary,papillae,position,prickle,pseudostipule,shape,spacing,stem,straightnes,subglabrous,surface,texture,tuber-bearing,ye
42	wfo-0001025835	success	297	140	109	188	31	0.367	0.5,0.5-2.8,0.6-1.3,0.65-0.8,0.7-3,1-2,1-2.5,1-4,1-8,1-9,1.5-3,1/4-1/3,2.5-3,20,3-6,4,4-5,6,accrescent,always,anther,apart,apex,apparently,articulated,bark,base,becoming,berry,bright,brown,calyx,cell,chartaceous,clavate,cm,corolla,covering,curved,diameter,drying,dull,elongating,evenly,finely,flattened,flattened-reniform,fruit,fruiting,glabrous,globose,green,green-brown,lamina,lateral,leaf,length,less,lobed,long,mature,maturity,mauve,mm,moderately,outline,ovate,pale,papillae,pedicel,peduncle,petiole,pit,point,poricidal,prickle,raised,rarely,red,reflexed,ridged,scar,shrub,side,significantly,simple,small,spaced,stellate,stem,stigma,straight,straw-yellow,stump,style,surface,tapering,terminal,tip,tube,unarmed,usually,vein,white,wide,widest,yellow,yellow-orange,young	.1,.3,/4,0.05-0.1,0.1,0.1-0.2,0.2-2,0.5-0.7,0.5-1,0.7-1.8,1,1-1.5,1-3,1-5,1-7,1.2-1.8,1.2-2,1.5-1.8,1.5-2,1.5-3.5,1/2,1/3,1/3-3/4,1/4-1/2,1/4-2/3,2-6,2.2-2.5,2.5-3.5,3-5,3-7,3.5-4,30-45°,4-8,5,5-20,5-merou,6-8,7-9.5,8,9-11,abaxially,acuminate,acute,adaxial,adaxially,ag,almost,alyx,apar,apically,apiculate,armed,axe,beyond,black,blade,branche,branched,broad-based,broad-deltate,concolorous,cupular,dark,deep,deltate,developed,development,difoliate,distance,divided,dorsal,eaf,eed,equal,erect,exserted,extending,faint,filament,finger-hair,flat,flower,foliaceous,free,geminat,gently,glabrescent,gre,greenish,infructescence,irregula,irregular,lengthening,lobe,lobing,long-deltate,longer,longitudinal,lower,margin,midpoint,midvein,minute,mostly,network,nflorescence,obconical,oblong,obtuse,occasional,often,older,one,open,opening,orange,orange-brown,orange-translucent,orolla,oung,ovoi,ovoid,pair,papillo,part,pendulous,per,perfect,pericarp,pore,porrect,portion,primary,pronounced,rachi,ray,reduced,regular,rest,ribbed,rounded,ruit,secondarily,secondary,sessile,shallow,shiny,short,shorter,shortly,sinus,slender,slightly,slit,smooth,sometimes,somewhat,sparsely,spherical,spreading,stalk,stalked,stellate-pubescent,tamen,terete,tertiary,thin,throughout,time,toward,translucent,trichome,trifoliate,ud,unequal,unit,upper,variously,vary,venation,visible,weakly,wing,woody,x,yellowish,ympodial,×	arrangement,articulation,color,connation,dehiscence,diminishing,distal,form,grey,growth,height,history,inflorescence,interjected,leaflet,life,na,ovary,papillose,perennial,petiolule,plant,position,pseudostipule,seed,shape,size,spacing,straightnes,texture,tuber-bearing
43	wfo-0001025838	success	217	109	79	138	30	0.364	0.7-2,1-1.2,1.5-2.5,1.5-3.5,1.5-5,2-5,4-15,6.5-7,acuminate,anther,apart,apex,articulated,attenuate,base,berry,black,brown,calyx,capitate,clavate,cm,connivent,corolla,dark,diameter,ellipsoidal,elliptic,flattened,fleshy,fruit,fruiting,globose,greenish,growth,inflorescence,inserted,lanceolate,lateral,leaf,lobed,loosely,membranous,minutely,mm,narrowly,often,onto,pale,pedicel,peduncle,petiole,pitted,poricidal,purple,reddish,reniform,ripe,seed,shiny,short,shrub,simple,sleeve,slightly,small,stellate,stem,stigma,style,surface,terminal,tinged,tip,tree,tube,white,winged,yellow	-20,.5,0.5,0.5-1,1-1.5,1.2-5,1.5-1.7,1.5-2,1.8-2,10-15,10-60,2-2.5,2.5-3,2/3,20-40,3.5-,4.5-5.5,5,5-merou,6-15,abruptly,adaxial,adaxially,ag,along,alyx,anthesi,apiculate,appearing,archin,ark,axil,basall,branch,branched,broad,cell,clustered,cucullate,cup-shaped,decurrent,dendritic,dense,densely,denser,disintegrating,drying,eaf,eed,entire,erect,exserted,extending,filament,flower,free,glabrescent,glabrous,hairy,ilament,insertion,irregularly,keeled,lamina,lengthening,less,like,lobe,long,lower,m.,many,margin,midrib,minute,mostly,narrowing,never,new,nflorescence,nodding,occasionally,older,orolla,ovoid,pair,papillat,papillo,per,perfect,pericarp,platform,plurifoliat,point,pointed,pore,portion,primary,pubescent,quadrate,revolute,ruit,scar,shin,sinus,slender,slit,sometimes,spaced,sparsely,spreading,square,strongly,tall,tem,testal,thi,thin,time,trichome,tuft,turbinate,twinin,ud,uniseriate,unit,upper,vary,vein,wall,way,weight,wing,woody,x,yellowish,ympodial,¾	arrangement,articulation,bark,color,connation,dehiscence,diminishing,distal,form,height,history,interjected,leaflet,length,life,na,ovary,papillae,papillose,petiolule,plant,position,prickle,pseudostipule,shape,size,spacing,straightnes,texture,tuber-bearing
44	wfo-0001025845	success	180	100	65	115	35	0.361	0.3-0.5,0.4-1.5,0.5-11,1-4.5,1.5-7,2-3,2-5-lobed,3-13,3-4,4-5,4-6,acuminate,anther,apex,articulated,base,branch,brown,calyx,chartaceous,cm,connivent,corolla,cuneate,diameter,ellipsoidal,elliptic,extra-axillary,flattened,fork,fruit,greenish,herb,lateral,leaf,light,located,membranaceous,mm,narrowly,obovate,orange,ovate,ovoid,pedicel,peduncle,petiole,pinnately,rotate-stellate,rugose-verrucate,shrub,simple,stigma,style,subcordate,terminal,tightly,triangular,truncate,tube,unbranched,white,x,yellow,yellowish	.5,0.5-2.5,1,1-1.8,1-2,1.5,1.5-13,1.5-2,1.5-2.5,2,2-15,2.5-4,3,3-6,3-foliat,5-6,6-6.5,6-9,7-10,abaxially,abundantly,acute,adaxial,adaxially,aggregate,along,apart,apiculate,around,ascending,axe,ba,blade,cell,channe,compressed,cylindrical,dark,decurrent,deltate,diamete,directed,distall,distally,divided,eaf,eed,eglandular,entire,especially,filament,flower,free,glabrou,glabrous,green,inserted,laterally,lobe,lobed,long,longitudinal,lower,major,margin,mesocarp,midrib,minutely,near,nearly,nflorescence,obtuse,often,orolla,part,patch,perfect,pore,puberulent,pubescent,purple,rachi,radiu,rarely,rounded,ruit,sagittate,sand-punctate,shorter,side,sinus,small,spaced,sparsely,stone,stripe,strongly,tal,tamen,tapered,tem,thecae,thick,time,tip,tomento,truncat,unit,unlobed,vary,vein,veiny,wide,ympodial,youn	arrangement,articulation,bark,color,connation,dehiscence,diminishing,distal,form,fruiting,growth,height,history,inflorescence,interjected,leaflet,length,life,na,ovary,papillae,petiolule,plant,position,prickle,pseudostipule,seed,shape,size,spacing,stem,straightnes,surface,texture,tuber-bearing
45	wfo-0001025850	success	197	118	83	114	35	0.421	.5,0.5-1,0.5-3,0.6-1,1,2-12,2-6.5,6-7,acute,anther,apex,articulated,base,berry,branched,brown,calyx,capitate,cm,connivent,corolla,cyathiform,diameter,divaricate,ellipsoid,elliptic,flattened,fruiting,glabrous,globose,green,growth,inflorescence,later,lateral,lax,lengthening,lobed,loosely,many,minutely,mm,narrowly,nearly,often,openly,orange,pale,pedicel,peduncle,petiole,pinnatifid,pitted,pore,poricidal,reddish,reniform,rhomboid,ripe,rounded,scattered,shrub,simple,sleeve,slit,small,stellate,stem,stigma,style,surface,tan,terminal,time,tip,trichome,truncate,tube,uniseriate,vine,white,woody,yellow	-5,-7,.8,0.5,0.5-,1-1.5,1-3,1-celled,1.5,1.5-5,15-20,2,3-4,30,4-5,5-7,5-merou,abaxial,ag,along,alyx,anthesi,apar,apparently,ark,axi,basal,broadly,cell,cupped,deciduous,deflexed,deltate,densely,denser,divided,drying,eaf,eed,elongate,em,entire,erect,exserted,extending,filament,fleshy,flower,free,geminat,glabrou,gland,glandular,half,halfway,ilament,irregularly,lamina,leaving,less,lobe,long,lower,margin,membranous,midrib,minute,new,nflorescence,nodding,node,occasionally,older,orolla,outline,pair,papillate-puberulent,papillo,peg,per,perfect,planar,plurifoliate,portion,primary,puberulen,pubescent,ruit,scar,shallowly,shiny,sinuate,sinus,slender,slightly,sometimes,soon,spaced,splitting,spreadin,spreading,strongly,surfac,testal,thin,tiny,twinin,ud,unit,vary,vein,x,ympodial,young	age,apart,arrangement,articulation,bark,color,connation,dehiscence,diminishing,distal,form,fruit,height,history,interjected,leaf,leaflet,length,life,na,ovary,papillae,papillose,petiolule,plant,position,prickle,pseudostipule,seed,shape,size,spacing,straightnes,texture,tuber-bearing
46	wfo-0001025856	success	185	110	69	116	41	0.373	.4,/4,0,0.3-1,0.5,1-3,3-10,abaxially,acuminate,adaxially,always,anther,apex,base,berry,branched,brown,calyx,chartaceous,cm,compound,connivent,corolla,cuneate,diameter,elliptic,flattened-reniform,flower,foveolate,glabrous,globose,green,lateral,leaflet,lengthening,light,lobed,long,long-styled,mm,oblique,oblong,orange,pedicel,peduncle,perennial,petiole,petiolule,pinnately,pore,poricidal,slit,stellate,stigma,straight,streak,strongly,style,surface,terminal,time,tip,tube,uniformly,way,white,wide,yellow,×	0.3–0.5,1.5–2,10–,10–15,15–20,1–,1–1.5,1–2,1–5,2,2.5–4,20,20–30,20–35,2–,2–4,3,3–4,3–5,4–,4–10,4–6,5–,5–10,5–15,5–7,6–12,acute,ag,alyx,anthesi,apiculate,armed,articulated,axe,becoming,blade,bud,c.,calcium,campanulate,commonly,corresponding,crystal,densely,difoliate,dr.,eaf,eed,ellipsoid,entire,equal,exserted,fifth,filament,four,fruiting,geminat,glabrescent,glabrou,herbaceous,internode,larger,lobe,longer,lower,major,margin,narrowly,nearly,nflorescence,often,one,opposite,orolla,outline,oxalate,pair,papillat,pericarp,petiolulate,plurifoliate,pointed,present,prickle,rachi,rarely,recurve,recurved,rounded,rugose,ruit,side,slender,slightly,somewhat,soon,spreading,stout,subopposite,subwood,subwoody,tamen,tem,throughout,triangular,truncat,tub,unequal,unit,usually,vary,vein,vin,widest,ympodial	1-,10-,10-15,2-,2-4,20-30,3-5,5-15,age,arrangement,bark,color,connation,dehiscence,diminishing,distal,form,fruit,growth,height,history,inflorescence,interjected,leaf,length,life,na,ovary,papillae,plant,pseudostipule,seed,shape,size,spacing,stem,straightnes,texture,truncate,tuber-bearing,vine
47	wfo-0001025872	success	160	81	50	110	31	0.312	.5,0.6-1,1-2,2-5,6-8,anther,apart,bark,branched,broadly,brownish,calyx,capitate,cm,corolla,crinkled,cup-shaped,dark,deeply,deflexed,elliptic,flattened-reniform,fruiting,glabrous,globose,green,lateral,leaf,lobed,long,mm,narrowly,ovary,papillae,pedicel,petiole,pitted,plant,poricidal,rounded,shrub,stem,stigma,straight,style,surface,terminal,tip,tube,white	.1,0.25-0.5,0.5,0.5-1,1,1-1.3,1-1.5,1.2-1.5,1.2-1.6,1.7-3,10-25-flowered,2-2.5,2/3,3.5-4,4-4.5,4.5-13,6-10,acute,along,anthesi,apex,apically,auriculate,ba,base,becoming,beginning,beneath,berry,blade,bright,coriaceous,crowded,decurrent,dense,densely,dia,dry,eaf,edicel,eed,exserted,filament,flattened,fleshy,flower,free,glandular-resinous,grayish-brow,greenish-tan,incrassate,inflorescenc,irregularly,junction,later,live,lobe,lon,lower,main,margin,material,midrib,minutely,nflorescence,occasionally,often,older,onto,opposite,pair,paler,papillo,papillose,planar,plurifoliat,pore,portion,prominent,pubescent,red-papillose,revolute,rounded-triangular,ruit,scar,several,shaped,simple,somewhat,soon,spaced,specimen,tall,tapering,tear-drop,thick,thickened,time,trichome,tub,ud,uniseriate,unit,vein,visible,way,woody,x,ympodial,young	0.1,arrangement,articulation,color,connation,dehiscence,diameter,form,fruit,grayish-brown,growth,height,history,inflorescence,interjected,leaflet,length,life,na,peduncle,perennial,plurifoliate,position,prickle,pseudostipule,seed,shape,size,spacing,straightnes,texture
48	wfo-0001025875	success	205	91	60	145	31	0.293	0.1-1.1,0.3-2,0.4-0.7,0.8-1.8,1.5-2.5,5-10,8-11,?,accrescent,acute,anther,apart,apex,articulated,base,calyx,chartaceous,cm,cuneate,dark,diameter,directed,distally,extra-axillary,fruit,fruiting,globose,green,hastate,inflorescence,lanceolate,lateral,leaf,length,lobed,minute,mm,oblate,obtuse,pale,pedicel,peduncle,perennial,petiole,plant,present,prickle,pseudo-racemose,purple,rotate,shrub,simple,stigma,streak,style,surface,truncate,tube,white,yellow	%,.05,0-0.1,0-0.5,0-1.5,0-5,0.1-0.2,0.2-0.45,0.25-0.4,0.3-0.4,0.4-0.5,0.5-1,0.5-1.3,0.5-6,0.7-0.8,0.8-0.9,0.9-1.4,1-10,1-2,1-3,1-7,1.1-1.6,1.2-1.8,1.5-6,15-25,2-locular,2.3-3,2.4-2.8,2.5-4.5,3-5,3-6,4-10,4.5-6.5,5-11,5-14,5-15,5-9,5-merou,6-13,7-10,7-14,7-8,8-14,9-13,abaxially,absen,absent,acicular,across,adaxiall,adaxially,adult,alyx,andromonoecious,anvil-shape,attenuate,axe,ba,basal,blade,branchlet,cross-section,cylindrical,decimetre,deeply,deltate,densely,dm,eaf,eed,eglandular,entire,erect,exocarp,filament,finger,flower,functional,geminat,glabrous,gland-tipped,grey,hair,half,heterostylous,juicy,juvenile,lamina,less,linear,lobe,long,longer,lower,margin,mature,mesocarp,mid-point,midpoint,midvein,moist,narrowly,nflorescence,oblique,orolla,pair,part,per,placenta,plurifoliate,pore,porrect,possibly,ray,rhizomatous,ruit,sessile,shallowly,short,spaced,sparsely,stalk,stalked,stellae,stellate,stellate-pubescent,straight,tal,tamen,tem,thick,throughout,time,transparent,unarme,unarmed,unbranched,unit,upper,vary,weakly,wide,x,yellowish,ympodial	arrangement,articulation,bark,color,connation,corolla,dehiscence,diminishing,distal,form,growth,height,history,interjected,leaflet,life,na,ovary,papillae,petiolule,position,pseudostipule,seed,shape,size,spacing,stem,straightnes,terminal,texture,tuber-bearing
49	wfo-0001025888	success	256	101	60	196	41	0.234	.5,1.5,2.1,2.6,3.2,3.8,acute,alveolate,anther,apart,apex,area,articulate,attachment,base,calyx,central,chartaceous,cm,corolla,deltoid,diameter,distal,dry,extra-axillary,flattened-orbicular,flower,fruit,globose,hooked,lateral,leaf,longitudinally,margin,mm,nearly,notched,oblong,orange-red,ovate,pedicel,peduncle,petiole,point,red,shrub,simple,small,stellate,stigma,style,surface,tree,tube,unarmed,white,yellow,yellow-tan,±smooth,±straight	.05,.3,.4,.6,0.04,0.1,0.2,0.3–0.5,0.4,0.4–0.6,0.4–0.7,0.5–0.7,0.6–1.2,0.7–0.8,0.7–1.5,0.8,0.8–1.0,0.9–1.1,0.9–1.2,0.9–1.3,1.0–1.8,1.2–2.3,1.4–1.8,1.5–1.9,1.5–2.0,1.5–2.1,1.5–4.0,1.7–2.1,1.8–2.3,1.8–3.5,1.9–2.2,1.9–3.4,1/2–2/3,1/3,2.2,2.5–2.6,2.7–3.0,3,3.0–11.1,3.1–4.2,3/4,4.2–5.5,4–8,4–9,5,5-merou,5.5–11.1,5–7,6–10,7.1–9.1,8.1–17.1,9.5,90°,abaxially,across,adaxially,adnate,along,alyx,anthesi,apiculate,apparently,appearing,appresse,arching,axe,ba,berry,blade,branch,branching,broad,brochidodromous,bud,capitat,channeled,clinate,congested,cuneate,dehiscen,densely,denser,dentate,development,difoliate,distinct,eaf,eed,either,emerging,endocarp,entire,exocarp,fertile,filament,filiform,flexed,free,geminat,glabrescent,glabrous,glandular,gradually,hair,homostylous,increasing,internode,interpetalar,intersepalar,juic,lamina,less,little,lobe,lon,long,longer,lower,major,many,mature,middle,midpoint,midrib,midvein,minor,minute,moderately,nflorescence,oblique,opaque,orolla,per,poorly-developed,porrect,portion,potentially,pubescen,pubescence,pubescent,raised,ray,reflexed,restricted,rigid,rounded,row,ruit,scattered,sessile,shinny,short-stipitate,shorter,side,sinuate,sinus,smoot,sometimes,spaced,sparsely,splitting,spread,spreading,stellae,stellate-pubescent,stipe,straight,swelling,tamen,tardily,tem,thin,though,time,tip,tissue,truncate,two,typically,ud,unbranched,vary,vein,weakly,well,wide,yellow-ferruginous,ympodia,young,±90°,±aequilateral,±equal,±erect,±glabrous,±overlapping,×	0.8-1.0,0.9-1.2,1.4-1.8,1.5-4.0,3.0-11.1,arrangement,articulation,bark,capitate,color,connation,dehiscence,dehiscent,diminishing,form,fruiting,growth,height,history,inflorescence,interjected,leaflet,length,life,na,ovary,papillae,petiolule,plant,position,prickle,pseudostipule,seed,shape,size,spacing,stem,straightnes,terminal,texture,tuber-bearing
50	wfo-0001025892	success	170	90	57	113	33	0.335	0.2-0.4,0.3-0.8,2.5-4,5-17,8-11.5,absent,anther,apex,articulated,base,calyx,chartaceous,cm,connivent,cuneate,curved,diameter,extra-axillary,fruit,fruiting,glandular,globose,half,herbaceous,inflorescence,lanceolate,lateral,leaf-opposed,length,less,linear,lobe,mature,mm,narrowly,oblate,obtuse,pale,papillae,pedicel,peduncle,petiole,prickle,pseudo-racemose,purple,resprouter,simple,solitary,stellate,stem,stigma,style,tube,unbranched,white,yellow,yellowish-green	%,.3,0-0.1,0-0.3,0-1,0-10,0.05-0.1,0.1-0.2,0.2-0.5,0.2-0.8,0.3-0.5,0.3-0.7,0.4-0.6,0.4-0.8,0.7-0.9,0.8-1.1,1-2,1.5-5,10-17,2-7,2-locular,2.5-6,2.8-3,4-merou,4.5-7.5,5-7,6-10,7-15,8-10,8-11,8-13,9-18,abaxially,absen,adaxiall,adaxially,alyx,apart,axe,ba,blade,broad-based,cross-section,cylindrical,d.,deltate,dense,densely,directed,distall,distributed,dult,eaf,eed,eglandular,entire,erect,exocarp,finger,flower,geminat,glabrous,gland-tipped,grey,grey-green,hair,juicy,lamina,long,longer,lower,margin,mesocarp,mid-point,midpoint,minute,moist,nflorescence,oblique,orolla,part,per,perfect,placenta,pore,porrect,present,ray,ruit,sessil,sessile,short,spaced,stage,stalk,stellae,stellate-pubescent,sticky-glandular,straight,tal,tamen,thick,throughout,time,triangular,truncat,unarmed,unit,uvenile,vary,wide,x,ympodial	arrangement,articulation,bark,color,connation,corolla,dehiscence,diminishing,distal,form,growth,height,history,interjected,leaf,leaflet,life,na,ovary,petiolule,plant,position,pseudostipule,seed,shape,size,spacing,straightnes,surface,terminal,texture,truncate,tuber-bearing
51	wfo-0001025893	success	157	92	63	94	29	0.401	0.5-1.5,0.8-1,1-1.5,1-4,1.5-2,5-6,accrescent,along,anther,bark,base,beneath,bi-lobed,broadly,brownish-green,calyx,capitate,cm,corolla,cup-shaped,ellipsoid,elliptic,even,faintly,fruit,fruiting,glabrous,globose,golden-puberulent,green,greyish,internodal,lateral,leaf,lobed,longitudinally,minutely,mm,narrowly,nearly,obovate,opposite,ovary,ovoid-reniform,pale,pedicel,petiole,pitted,poricidal,shrub,slightly,sometimes,stem,stigma,straight,style,surface,tip,tube,vein,white,woody,young	.25,.4,.5,1-1.2,1-2.5,1.5-1.7,11-20,2-2.5,2-3,3-5,6-10,anthesi,apex,attenuate,bank,barely,bearing,beginning,berry,blade,branched,closely,decurrent,deflexed,deltoid,densely,dia,difoliate,dry,eaf,early,eed,erect,exserted,filament,flower,free,geminate,glabrate,gravelly,growing,impressed,inflorescenc,lobe,lon,long,long-acuminate,lower,main,many,margin,material,middle,nflorescence,occasionally,older,overlapping,pair,papillo,papillose,planar,plurifoliat,pore,portion,puberulent,red-papillose,reflexed,river,rocky,ruit,sandy,scar,shaped,slender,spaced,specimen,stream,striat,tall,tapering,tear-drop,thickened,time,trichome,ud,unicellular,unit,usually,visible,widest,winged,x,yellowish,ympodial	alternate,arrangement,articulation,color,connation,diameter,diminishing,distal,form,growth,height,history,inflorescence,leaflet,length,life,na,papillae,perennial,plant,position,prickle,seed,shape,size,straightnes,striate,texture,tuber-bearing
52	wfo-0001025896	success	146	94	54	92	40	0.37	0.5-2,1-25,1-6.5,1-8,2.5-14,2.5-5,5-15,5-7,6-10,acuminate,angled,apart,apex,articulated,base,brownish,calyx,chartaceous,cm,connivent,cuneate,densely,diameter,elliptic-ovate,forked,fruit,glabrous,globose,greenish,mm,nearly,orange,ovate,pale,pedicel,peduncle,petiole,pubescent,purple,red,rotate-stellate,rugose,shrub,simple,smooth,stem,stigma,style,subcordate,surface,tube,unbranched,white,yellow	-3,-30,.5-2.5,0.5,1-1.5,1-3,1.5-2,1.5-9,10-15,10-25,2-14,2-2.5,4,4-12,4-23,4-5,4-6,6-13,7-,7743,abaxial,abaxially,absen,acosta,acute,adaxiall,adaxially,aggregate,also,axe,ba,blade,branched,cell,constricted,cylindrical,deltate,dendritically,directed,distall,eaf,eed,eglandular,entire,especially,flower,gland,hair,inflated,like,lobe,long,lower,many-foliat,margin,membranaceous,moderately,near,nflorescence,nther,obtuse,occasionally,often,orolla,perfect,pore,present,puberulent,pubescen,rachi,radiu,ripe,ruit,short-stalked,solí,spaced,sparsely,stalked,stone,tal,tem,time,tip,triangular-ovate,triangular-subulate,truncat,unit,vary,vein,wide,x,ympodial	anther,arrangement,articulation,bark,color,connation,corolla,dehiscence,diminishing,distal,distally,form,fruiting,growth,height,history,inflorescence,interjected,lateral,leaf,leaflet,length,life,na,ovary,papillae,petiolule,plant,position,prickle,pseudostipule,seed,shape,size,spacing,straightnes,terminal,texture,truncate,tuber-bearing
53	wfo-0001025902	success	211	104	75	136	29	0.355	0.1-0.5,0.5-2,0.5-2.5,1-1.5,1.5-3,11-15,1983,2-6,3-10,4-13,acute,anther,apex,articulated,attenuate,bark,base,becoming,black,cabrera,calyx,clavate,cm,connivent,corolla,diameter,dull,ellipsoid,fide,flattened-reniform,fruiting,glabrous,globose,green,growth,inflorescence,lanceolate,lateral,leaf,leaf-opposed,length,linear,loosely,mature,minutely,mm,ovary,pale,papillose,pedicel,peduncle,petiole,pitted,poricidal,rotate-stellate,rounded,scrambling,simple,sleeve,small,sometimes,stem,stigma,style,surface,tapering,terminal,tip,tube,vine,violet,woody,x,yellow,yellowish	.2,.5,/2,1-1.2,1.2-1.5,1.5,1.5-2,1/3,2.5-4,4,4-5,4-6,40,5-6,5-merou,8-10,8-15,8-9,>,abaxially,absent,accompanied,adaxially,ag,aid,along,always,alyx,anthesi,apar,ark,axi,beginning,berr,berry,branch,branched,branching,broadly,c.,cell,chartaceous,circular,climbin,completely,conical,deciduou,deltate,densely,eaf,eed,either,entire,except,exfoliatin,exserted,filament,fleshy,flower,free,geminat,ilament,leaving,lengthening,less,lobe,lobed,long,low,lower,margin,markedly,midvei,minute,new,nflorescence,obscured,occasionally,often,older,one,orolla,pair,papillat,peg,pendant,per,perfect,pericarp,planar,plurifoliate,pore,portion,primary,prominent,pubescent,revolute,ridged,ruit,scar,scattered,semi-aquati,semi-circular,shallow,slender,slit,somewhat,soon,spaced,sparsely,spreading,strongly,tangled,tem,testal,thin,time,trichome,twining,ud,ultimate,uniseriate,unit,usually,vary,vegetation,vein,water,way,weak,weight,whitish,widely,wing,ympodial,½	apart,arrangement,articulation,color,connation,dehiscence,diminishing,distal,form,fruit,height,history,interjected,leaflet,life,na,papillae,petiolule,plant,position,prickle,pseudostipule,seed,shape,size,spacing,straightnes,texture,tuber-bearing
54	wfo-0001025906	success	188	110	89	99	21	0.473	0-14,0.1-2,0.15-0.6,0.2-0.6,0.20-0.60,1.6-12.4,1.8-4.8,16-51,2-6,2.6-5.2,3-10,3-5,5-6,5-7,8.5-12.5,abaxially,adaxially,anther,articulated,blue,brownish,cell,clavate,cm,condition,coriaceous,corolla,covering,diameter,distal,drying,forked,fresh,fruit,glabrous,globose,green,green-white,greenish,hair,hair-like,half,herb,high,interjected,lanceolate,lateral,leaf,leaflet,lengthening,light,lilac,linear,make,mm,mucilaginous,odd-pinnate,ovoid,pedicel,peduncle,pentagonal,petiole,plant,pore,poricidal,pubescent,purple,ripe,rotate,seed,shiny,short,size,slit,stigma,stripe,style,subglabrous,terminal,testal,thick,throughout,tip,wall,wet,white,whitish,x,yellow	1-2,1-3,1-6,1.1-2,2-4.4,4-10,4-12,4-5,4-7,5-merou,5.2-9,8-16,acumen,acute,adaxiall,ag,alyx,apart,apex,apparently,axe,axillary,base,berry,blade,bud,capitat,connivent,cuneate,dark,decreasing,decurrency,decurrent,delimited,digestion,diminishing,dorsally,eaf,edge,eed,enzyme,erec,exceeding,falcate,filament,first,flat,flower,folded,geminat,generally,glabrou,hal,homostylous,honeycomb-shaped,living,lobe,long,lower,next,nflorescence,obtuse,orolla,pair,perfect,plurifoliate,rachi,removed,ruit,second,sessile,seudostipule,slightly,smaller,spaced,sparsely,specimen,stamen,straight,sub-glabrous,subequal,subglabrou,subtending,tall,tamen,tem,third,toward,tri-,tube,typically,unit,unwinged,usually,vary,well,width,wood,ympodial	age,arrangement,articulation,calyx,capitate,color,dehiscence,erect,form,growth,height,history,inflorescence,length,life,pseudostipule,shape,spacing,stem,surface,texture
55	wfo-0001025907	success	148	90	54	94	36	0.365	.05,1-3,1-5,12-45,2,3-,4-5,5-15,acuminate,acute,anther,apex,attenuate,axillary,base,brown,calyx,cm,conical,densely,diameter,elliptic,filament,flattened,free,fruit,fruiting,glabrous,green,greenish,growth,long,mm,obovate,ovary,ovoid-reniform,pedicel,petiole,plant,poricidal,portion,pubescent,round,rugose,seed,shrub,simple,size,stigma,style,surface,tip,tube,x	-4,.5,.5-1,0,0-60,0.8-1.8,1,1-1.2,1-2.3,1.5-2,1.5-2.2,10-15,2-3.5,2-8,2/3,3-4,3/2,absent,along,anthesi,anthesis5-7,anticlinal,appearing,axil,beak,bearing,berry,breaking,c,cell,clavat,conspicuously,deciduous,eaf,edicel,eed,epidermal,erec,flower,globose,highly,included,iquito,irregular,isolated,lamina,lobe,lobed,lon,lower,margin,minutely,near,nearly,new,nflorescence,occasionally,open,pair,papillate,papillose,per,population,primary,projection,raised,red-papillate,reflexed,remaining,ruit,scar,scattered,single-stemmed,sinuous,slender,soon,sparsely,tal,tem,thickening,time,trichome,truncate,tub,ud,unifoliat,uniseriate,unit,variable,vein,white,white-lenticellate,without,ympodial	5-7,arrangement,articulation,bark,clavate,color,connation,corolla,dehiscence,diminishing,distal,form,height,history,inflorescence,lateral,leaf,leaflet,length,life,na,papillae,peduncle,perennial,petiolule,position,prickle,shape,spacing,stem,straightnes,tall,terminal,texture,tuber-bearing,unifoliate
56	wfo-0001026203	success	197	119	89	108	30	0.452	0-39,0.06-0.86,0.38-11.3,0.4-3,0.5-3.2,1-13,1-2,1-9,1.1-7.9,1.2-5.5,2-10,2-8.5,3-10,3-5,3.2-23,7-47,anther,articulated,berry,blue,brownish,cell,clavate,cm,condition,connivent,coriaceous,corolla,covering,dark,deep,diameter,distal,drying,elliptic,forked,fresh,fruit,glabrescent,glabrous,globose,green,greenish,hair-like,half,herb,high,honeycomb-shaped,interjected,lanceolate,lateral,leaf,leaflet,lilac,linear,medium,middle,mm,moniliform,odd-pinnate,ovate,ovoid,pedicel,peduncle,pentagonal,petiole,plant,poricidal,ripe,rotate,seed,size,sometimes,stigma,straight,stripe,style,subglabrous,terminal,testal,thick,tip,tube,typically,wall,white,whitish,x,yellow	0-7,0.3-11,0.3-6,0.5-2.3,0.7-2.6,1-4,1-5,2-4.9,2-43,2-5,2.2-13.3,3-11,3.2-22,5-merou,abaxially,acumen,acuminate,acute,adaxially,ag,along,alyx,apart,apex,apparently,arranged,asymmetric,attenuate,axe,axillary,base,basiscopic,bead,blade,bud,capitat,decreasing,decurrent,digestion,dorsally,eaf,edge,eed,enzyme,erect,exceeding,filament,flat,flower,folded,geminat,generally,glabrescen,glabrou,green-white,hair,hal,homostylous,lengthening,light,like,living,lobe,long,lower,make,mucilaginous,multiple,necklace,nflorescence,orbicular,orolla,pair,perfect,plurifoliate,pore,rachi,removed,rosett,rounded,ruit,sessile,seudostipule,short,side,slightly,slit,spaced,specimen,stamen,stolon,subequal,subtending,tall,tamen,tem,throughout,tissue,toward,tri-,tuber,unit,unwinged,usually,vary,wet,wide,ympodial	absent,arrangement,articulation,bark,calyx,capitate,color,connation,dehiscence,form,fruiting,growth,height,history,inflorescence,length,life,ovary,papillae,position,present,prickle,pseudostipule,shape,spacing,stem,straightnes,surface,texture,tuber-bearing
57	wfo-0001026205	success	165	90	55	110	35	0.333	0.3-2,1,15-20,5.5-6,7-9,absent,acuminate,acute,anther,apex,apical,articulated,attenuate,base,calyx,cm,cream,cuneate,deeply,diameter,elliptic,extra-axillary,flattened,fruit,fruiting,globose,growth,lateral,leaf,mm,pedicel,peduncle,petiole,prickle,pubescent,purple,rare,seed,sessile,short,shortly,shrub,simple,size,sparsely,stellate,stem,stigma,strongly,style,surface,tube,violet,white,yellow	-14,-2.5,-6,.5,.5-2,0.5-,0.75-1,1-1.5,1-2,1-3,1-6,1.5,2-14,2-3,3,3/4,30-35,4,5-7.5,5-merous,8,abaxially,accrescen,adaxially,alyx,apparently,armed,around,axe,ba,blade,chartaceous,densely,difoliate,distinct,divided,eaf,eed,enlarged,entire,erect,exceeding,extror,filament,flower,four,geminat,glabrous,glandular,globo,hair,homostylous,including,linear-lanceolate,lobe,long,lower,major,margin,maturing,midpoint,minor,minute,minutely,new,nflorescence,node,oblique,often,orolla,perfec,pore,porrect,porrect-stellate,proximally,rachi,rarely,ray,ruit,scarcely,similar,slender,slightly,small,smaller,solitary,sparse,stellat,stellate-pubescen,stellate-pubescent,straight,summit,tall,tamen,tem,thickened,third,tip,toward,trichome,unarme,unarmed,unit,usually,vary,wide,wing,x,ympodial,zigza	0.5-2.5,accrescent,arrangement,articulation,bark,color,connation,corolla,dehiscence,diminishing,distal,extrorse,form,height,history,inflorescence,interjected,leaflet,length,life,na,ovary,papillae,perennial,petiolule,plant,position,pseudostipule,red,shape,spacing,straightnes,terminal,texture,tuber-bearing
58	wfo-0001026208	success	214	96	63	151	33	0.294	0-4,0-5,0.5-1.2,0.6-0.8,0.7-2,1-5,2-20,2-4,2.5-5,2.5-6,3-5,anther,apex,articulated,bark,base,bright,calyx,cm,connivent,densely,diameter,dull,elliptic,elongating,flattened-reniform,fruit,fruiting,glabrescent,gray-greenish,lateral,leaf,length,lobed,long,mauve,mm,moderately,orange,orange-brown,ovate,pale,pedicel,peduncle,petiole,poricidal,prickle,recurved,red,shrub,sparsely,spherical,stellate-pubescent,stem,straight,style,surface,tapering,terminal,tip,tube,white,yellow	-1/2,-10,-3,-5,.5,/3,0,0-20,0-8,0.1,0.1-0.2,0.1-0.25,0.1-0.3,0.5-0.8,0.6-0.9,0.8-1.3,0.8-1.5,1-2,1-4,1.5,1.5-2.5,1.8-2.3,1.8-2.5,1/3,1/4-1/3,1/4-1/6,11-25,2,2-3,3-30,3-6,3.5-5,3/,4-7,4-9,5,5-,5-17,5-22,5-merous,6-22,6-8,abaxial,abaxially,acuminate,acut,acute,adaxial,alyx,apar,apart,apically,apparently,becoming,berry,blade,branched,broad-deltate,brown,chartaceous,conical,cuneate,curved,dark,deltate,difoliate,discolorous,distance,drying,eaf,eed,elongated,equal,erect,evenly,extending,filament,flattened,flower,free,geminat,geminate,glabrous,green,green-brown,infructescence,lobe,longer,lower,margin,mature,maturity,membranous,midpoint,midvein,nflorescence,older,one,open,orolla,oung,pair,pendulous,per,perfec,pericarp,porrect,portion,prickly,primary,pubescent,ray,red-brow,rounded,ruit,scar,sessile,shorter,side,slender,smooth,sometimes,somewhat,spaced,spreading,stalk,stalked,stellate,stout,straw-yellow,subentire,tamen,terete,tertiary,time,toward,trichome,unarme,unarmed,unit,usually,variously,vary,vein,venation,visible,way,wide,woody,ympodial,young	arrangement,articulation,color,connation,corolla,dehiscence,diminishing,distal,form,growth,height,history,inflorescence,interjected,leaflet,life,na,ovary,papillae,perennial,petiolule,plant,position,pseudostipule,red-brown,seed,shape,size,spacing,stigma,straightnes,texture,tuber-bearing
59	wfo-0001026215	success	150	107	71	79	36	0.473	-3,0.5-1,1-3,1.5-2,2-3,3/4,7-8,abruptly,acuminate,anther,anticlinal,apex,axillary,base,broadly,brown,calyx,clavate,cm,completely,conical,conspicuously,corolla,densely,diameter,elliptic,flattened-round,fruit,fruiting,glabrous,green,greenish,herb,highly,horizontal,irregular,kink,length,lobed,marked,markedly,mm,narrowing,nearly,occasionally,often,ovary,ovoid-reniform,papillae,pedicel,petiole,poricidal,projection,purple,red-papillose,seed,shrub,simple,sinuous,stem,stigma,style,surface,thickening,tip,tube,way,white,white-lenticellate,winged,without	.05,.5,0,0.05,1,1.5,1.5-2.2,13-35,15-2,18-20,2,2-3.5,2-4,4-15,4-5,abaxially,absent,along,anthesi,ape,axil,beak,berry,bifi,cell,continually,deltate,eaf,edicel,eed,enlarged,entire,epidermal,erect,exserted,filament,flower,free,globose,internode,less,lobe,long,lower,minutely,nflorescence,noddin,nodding,onto,pair,papillat,papillate,per,portion,primary,raised,reflexed,rounded,rugose,ruit,scar,shortsympodial,single-stemmed,small,ste,strongly,tal,tem,time,tub,ud,unifoliat,unit,usually,vein,white-pubescent,wide,wing,x	arrangement,articulation,bark,bifid,color,connation,dehiscence,diminishing,distal,form,growth,height,history,inflorescence,interjected,lateral,leaf,leaflet,life,na,peduncle,perennial,petiolule,plant,position,prickle,pseudostipule,shape,size,spacing,straightnes,tall,terminal,texture,tuber-bearing,unifoliate
60	wfo-0001026220	success	158	86	41	117	45	0.259	/3,0.3-1.5,1.0-1.8,1.3-1.7,1.5-2.5,4-10,4-12,acute,annual,anther,base,blade,brown,calyx,campanulate,cm,dark,essentially,foveolate,herb,internodal,leaf,long,minutely,mm,obtuse,ovate,pentagonal,pentagonal-stellae,petiole,plant,prickle,reticulately,ridged,spherical,stellate-pubescent,stem,straight,surface,tube,yellow	.3-2.8,.5,0.2,1,10-20,2.5-3.5,5-10,50-90,6-10,7-11-flowere,8-12,accrescent,across,along,alyx,anthesi,ape,armed,back,band,bearded,becoming,berry,closely,coarsely,conspicuous,developing,dia,difoliate,divided,dry,dryin,eaf,eed,flattened-ovo,foliaceous,geminat,glabrous,glandular,glaucescent,hair,heteromorphic,interpetalar,invested,lacking,lanceolate,large,later,latter,lobe,lon,main,many,maturity,mostly,much,near,nearly,nflorescence,often,one,orolla,per,persistent,persisting,petal,pigment,pinnatifid,pinnatisect,plicate,portion,prickly,proximal,purple,ray,red,reddish,reduced,ruit,scattered,second,short,shorter,side,similar,simple,slende,somewhat,spaced,splitting,stellae,stellate,suffused,surrounding,tall,tamen,terminally,thrice,tightly,tigma,tissue,tub,twice,tyle,ultimate,unexpande,unit,upon,vary,vein,ventral,well-developed,widely,year,yello,ympodial,young	alternate,apex,arrangement,articulation,bark,color,connation,corolla,dehiscence,diameter,diminishing,distal,flattened-ovoid,form,fruit,fruiting,growth,height,history,inflorescence,interjected,lateral,leaflet,length,life,na,ovary,papillae,pedicel,peduncle,petiolule,position,pseudostipule,seed,shape,size,spacing,stigma,straightnes,style,terminal,texture,tuber-bearing,unexpanded,widesely
61	wfo-0001026227	success	150	88	52	98	36	0.347	.3,.8,0-1.5,0.3-2.2,2.5-3,absent,apex,articulated,base,calyx,chartaceous,cm,cuneate,densely,diameter,elliptical,flower,fruit,fruiting,globose,green,herbaceous,inflorescence,lateral,leaf-opposed,length,lobed,mm,moderately,obtuse,ovate,pale,pedicel,peduncle,petiole,present,prickle,pseudo-racemose,resprouter,shallowly,simple,solitary,sparsely,stellate,stellate-pubescent,stigma,style,thick,tube,unbranched,yellow,yellowish	%,0,0-0.1,0-1,0-3,0.1-0.7,0.25-0.4,0.3-0.4,0.3-0.5,0.3-0.6,0.3-0.9,0.4-1.4,0.5-1,0.9-1.2,1,1-1.3,1-4,1.5-4,1.6-2,10-15,15-20,17-55,2-10,2-2.5,2-3,3-6,3-7.5,5-30,5-merous,6-8,7-8,abaxially,absen,acicular,across,adaxially,apart,armed,axe,ba,blade,chartaceou,d.,deltate,distributed,eaf,eed,eglandular,entire,finger,gland-tipped,gree,grey,hair,half,index,lamina,lobe,lobing,lon,long,longer,lower,margin,mature,mid-point,midpoint,midvein,nflorescence,oblique,orolla,part,per,porrect,ray,ruit,sessile,short,side,spaced,sprawling,stage,stalk,stellae,straight,tal,tamen,tem,throughout,time,transparent,unit,unknow,uvenile,vary,wide,x,ympodial	abaxial,adaxial,anther,arrangement,articulation,bark,color,connation,corolla,dehiscence,diminishing,distal,form,growth,height,history,leaf,leaflet,life,na,ovary,papillae,petiolule,plant,position,pubescence,seed,shape,size,spacing,stem,straightnes,surface,terminal,texture,tuber-bearing
62	wfo-0001026229	success	299	113	82	217	31	0.274	0.1–1.47,0.35,0.3–1.2,0.9–4.3,1.8–5.5,1.9–2.5,1–2,5,6–7,accrescent,acute,anther,apex,articulated,attenuate-caudate,base,berry,black,brown,calyx,clavate,cm,connivent,corolla,cyme,densely,diameter,directed,elliptic,elongated,flattened,flower,fruit,globose,golden,green,growth,hirsute,immature,inflorescence,introrsely,irregular,lateral,leaf,lobed,long,longitudinal,mature,mm,moderately,narrowly,oblong,opening,ovate-elliptic,pale,papillose,pedicel,peduncle,petiole,pit,pore,poricidal,purple,reniform,shrub,simple,size,slit,small,stellate,stem,stigma,style,surface,terminal,tree,tube,unbranched,white,yellow,yellowish-white,¾	0.2–0.8,0.3–0.9,0.4,0.8–1.2,0.8–2,0.9,1,1-celled,1.2–4.8,1.3–1.5,1.3–1.7,1.4,1.7–11.8,1.7–2.3,1.8,1/3,13,1–1.4,1–4,2,2.3–3.4,2.8–4,2–3,2–3-celled,2–4-celled,3,35,3–4,3–5,4.5–6.5,4–6,5-merou,5–9,6–15,6–8,8.6–12,8–10,9–31,abaxial,abaxially,acuminate,adaxial,adaxiall,adaxially,ag,almost,also,always,alyx,anthesi,ark,associated,asymmetric,axe,ba,barely,beneath,blade,branch,branching,broadly,broken,camptodromous,capitate,celled,central,changing,commentary,commonly,completely,concentrated,cordate,covered,creating,cuneate,cylindrical,dark,deltoid,develope,developed,differing,discolorous,di­,dried,drying,eaf,eed,eglandular,ellipsoidal,entire,even,faces,few-rayed,found,free,frequently,fresh,fully,geminate,glabrescent,glabrous,gland,glandular,glandular-capitate,hair,head,hispid,hyaline,ilament,impressed,included,insertion,internodal,involute,lamina,lanceolate,larger,less,like,lobe,long-stalked,longer,lower,mainly,margin,material,maturit,membranaceous,midpoint,midri,midvein,minute,mixed,much,multangulate,multangulate-stellate,multiseriate,narrow-ovate,near,nearly,new,nflorescence,often,old,older,one,open,orientation,orolla,other,oung,ovate,pair,paired,pedunculate,per,perfect,pink,plurifoliate,point,poorly,porrect-stellate,portion,primary,pubescent,purplish,ra,rachi,raised,rarely,ray,remnant,revolute,rounded,ruit,secondary,see,sessile,shin,shiny,short-,short-stalked,shorter,slightly,smaller,solitary,sometimes,somewhat,sparsely,spread,spreadin,spreading,stalk,strongly,subopposite,subsessile,supported,surfac,three,trichome,trifoliate,tuft,type,ud,unequal,unit,upper,usually,vary,vein,venation,vestiture,visible,weakly,whitish-green,wide,ympodial	age,arrangement,articulation,bark,color,connation,dehiscence,diminishing,distal,form,fruiting,height,history,interjected,leaflet,length,life,na,ovary,papillae,petiolule,plant,position,prickle,pseudostipule,seed,shape,spacing,straightnes,texture,tuber-bearing
63	wfo-0001026230	success	144	92	59	85	33	0.41	.5,0.3-1.5,0.9-2,1-1.4,1-1.5,2-4,acuminate,acute,anisomorphic,anther,apart,apex,apiculate,area,bark,base,calyx,cm,corolla,deflexed,distal,elliptic,erect,fruit,fruiting,glabrous,globose,green,grey,large,lateral,leaf,lobed,minutely,mm,opposite,ovary,papillose,pedicel,petiole,poricidal,rounded,rusty-papillose,shaped,shrub,simple,small,stem,stigma,straight,strongly,style,surface,tear-drop,tip,tree,tube,white,woody	.25,.8,0.5-3,0.75-1,1-4,1.1-1.8,1.8-2.3,1.9-4.1,12.6-20.8,2-5,3-4,4.6-9.3,5-10,5-20-flowered,anisophyllou,anthesi,appears,back,beginning,beneath,berry,broadly,bud,clavate,clu,completely,cordate,coroll,deltoid,dia,difoliate,eaf,edicel,eed,enclosing,evenly,except,filament,free,geminate,immature,inflorescenc,lobe,lon,long,long-acuminate,long-triangular,lower,main,major,margin,middle,minor,nearly,nflorescence,obtuse,older,orbicular,ovoid,pair,pointed,pore,portion,raised,reflexed,ruit,scar,sinus,slender,slightly,spaced,tall,tapering,thickened,ud,umbonate,unit,unknown,vein,white-lenticellat,widest,winged,x,ympodial,young	arrangement,articulation,color,connation,dehiscence,diameter,diminishing,form,growth,height,history,inflorescence,interjected,leaflet,length,life,na,papillae,peduncle,petiolule,plant,position,prickle,pseudostipule,seed,shape,size,spacing,straightnes,terminal,texture,tuber-bearing,white-lenticellate
64	wfo-0001026233	success	165	84	45	120	39	0.273	-3.8,-5.5,-50,2.4-3.5,3.5-4.5,5-30,6,accrescent,acute,annual,anther,apex,base,calyx,campanulate,capitate,cm,cuneate-attenuate,densely,diameter,ellipsoidal,elliptic,fruiting,globose,herb,leaf,less,lilac,mm,ovate,pale,petiole,poricidal,pubescent,seed,sparsely,stigma,style,surface,tip,trans-ovoidal,tube,tuberculate,unifoliate,yellow	-1,-1.9,-8.1,.25,.75,0.3,0.5,0.7-,0.7-0.8,0.8-1.3,0.8-1.55,0.8-4,1,1-,1.1,1.2-2.7,1.5,1/2,2,2-,2.1,2.3-7,2.6,2/3,3.2-3.7,3.2-4.7,4-,5-6.2,abundant,ag,annular,antrorse,articulated,ascending,basal,bearing,berry,broadly,coat,conspicuous,curved,cylindrical,difoliat,dimorphic,eaf,eed,embryo,entire,evident,few-,filament,glabrous,hair,herbaceous,hig,interlobular,investing,lamina,larger,lobe,lobed,long,longitudinal,longitudinally,lower,margin,membrane,minutely,moderately,multicellular,narrowly,near,non-glandular,obtuse,occasionally,opening,orolla,other,outer,ovule,papery-scarious,partially,pinnatipartite,pinnatisect,pore,portion,present,protuberance,pubescen,ree,reticulate,ridged,rounded,ruit,scarcely,seede,serrate,shorter,simple,slender,slightly,slit,small,smaller,striate,strongly,styl,subglobose,tem,trichome,unequal,uniseriate,unit,vary,venatio,verrucose,wider,winged,x,ympodial	arrangement,articulation,bark,color,connation,corolla,dehiscence,difoliate,diminishing,distal,form,fruit,growth,height,history,inflorescence,interjected,lateral,leaflet,length,life,na,ovary,papillae,pedicel,peduncle,petiolule,plant,position,prickle,pseudostipule,shape,size,spacing,stem,straightnes,terminal,texture,tuber-bearing
65	wfo-0001026241	success	220	113	76	144	37	0.345	0.5,109,anther,apex,apical,appearing,appears,articulated,attenuate,base,basiscopically,berry,black,brown,calyx,capitate,cm,cordate,corolla,covered,cup,dry,dwarf,et,extended,fruit,fruiting,galiano,globose,herb,inflorescence,lateral,leaf,leaflet,lobed,longitudinal,mm,oblique,onto,open,orangish,outline,ovary,ovate,ovoid,pedicel,peduncle,perennial,petiole,pinnatifid,pitted,pore,pubescent,pulp,rachi,remain,reniform,seed,shallowly,slit,somewhat,stellate,stem,stigma,style,subshrub,surface,terminal,ternate,triangular,truncate,tube,tuberculate,usually,white,x	.2,.3,.5,0.1–0.15,0.2–,0.3–,0.3–0.4,0.3–0.6,0.3–1,0.5–0.7,0.5–0.8,0.5–1,0.7–1.1,1-,1-celled,1.2–1.5,1.2–2,1.5–1.7,1.5–2.5,1.5–3.5,1.9–2.1,1/3–1/2,10-20,1–,1–1.1,1–1.4,1–1.5,1–2,2-flowered,2.5–3,2–2.1,2–3,3,3-,30–50,3–3.1,4-,4.5–5,5,5-celled,5-merous,6,abaxially,adaxially,always,anthesi,ba,basal,beak,branching,brittle,broader,campanulate,cell,center,conical,connecting,curved,curving,darker,decurrent,deflexe,dehiscing,deltate,densely,denser,depressed-globose,dia,difoliate,discrete,drying,eaf,eglandular,elliptic,enclosed,entire,equal,erect,erose,filament,flower,foliat,foliose,free,geminate,glabrous,gland,glandular,glandular-pubescent,internodal,intially,irregularly,larger,like,lobe,lon,long,main,margin,midvein,mixture,much,near,nflorescence,one,papillat,papillate,per,perfect,pericarp,portion,prolonged,pubescen,robust,ruit,shiny,simple,sinuate,slightly,small,smaller,sometimes,spatulate,stamen,stout,strongly,succulent,sulcate,taproot,testa,thick,thickened,tip,tissue,trichome,ud,uniseriate,unit,vein,way,wide,wing,woody,ympodial	0.5-0.7,0.5-0.8,0.7-1.1,1-2,1.2-2,30-50,4.5-5,arrangement,articulation,bark,color,connation,decurent,dehiscence,diameter,diminishing,distal,form,growth,height,history,interjected,length,life,na,papillae,petiolule,plant,position,prickle,pseudostipule,shape,size,spacing,straightnes,texture,tuber-bearing
66	wfo-0001026242	success	210	100	65	145	35	0.31	0-2,0.4-0.5,0.4-2,0.5-1,1-2.5,1.5-3,1.5-4,acute,almost,anther,apart,apex,articulated,bark,base,branched,bright,calyx,cm,connivent,cuneate,curved,diameter,dull,elliptic,evenly,flattened-reniform,fruit,fruiting,glabrescent,glabrous,glandular,green,hair,lateral,leaf,length,lobed,maturity,membranous,minute,mm,orange-brown,pedicel,peduncle,petiole,poricidal,prickle,prickly,red,reflexed,shrub,spherical,spreading,stem,straight,style,surface,tapering,tip,tube,unarmed,white,yellow,young	-0.9,-1.5,-2,-5,-6,/4,0,0.05-0.2,0.1,0.3-0.5,0.35-,0.4-0.55,0.5,0.5-0.7,0.55-0.9,0.7,0.7-1.3,1-1.5,1-3,1.2-2,1/2,1/5-1/3,1/6-1/4,10-,10-20,2-2.5,2-5,2.5-2.8,2.5-4.5,3-6.5,30-80,4-10,4-13,4-5-merous,4.5-5.5,5-,5-18,5-7,6.5-8,7-17,8-20,abaxial,abaxially,acut,alyx,ame,apar,apically,apparently,berry,blade,broad-deltate,c.,concolorous,deltate,densely,difoliate,distance,drying,eaf,eed,elongating,equal,erect,extending,eye,filament,filiform,flattened,flower,free,geminat,glabrou,green-gra,infructescence,irregularly,largely,lobe,long,longer,lower,margin,mature,midpoint,midvein,moderately,multangulate,naked,narrow-deltate,nflorescence,obtuse,occasionally,older,one,open,orolla,oung,pair,pale,pale-brown,per,perfec,pericarp,porrect,portion,prickl,primary,ray,recurved,red-brown,rounded,ruit,scar,sessile,shorte,shorter,side,simple,smooth,sometimes,spaced,sparsely,stalk,stalked,stellate,stellate-pubescent,subentire,tamen,terete,tertiary,time,trichome,unarme,unit,upper,variously,vary,vein,venation,visible,way,weakly,wide,woody,ympodial	0.35-0.9,arrangement,articulation,color,connation,corolla,dehiscence,diminishing,distal,form,green-gray,growth,height,history,inflorescence,interjected,leaflet,life,na,ovary,papillae,perennial,petiolule,plant,position,pseudostipule,seed,shape,size,spacing,stigma,straightnes,terminal,texture,tuber-bearing
67	wfo-0001026259	success	233	96	57	176	39	0.245	1.5,6,acuminate,acute,anther,apex,appressed,base,berry,broadly,brown,calyx,cm,concave-reniform,corolla,diameter,ellipsoid,fruit,fruiting,globose,green,green-orange,herb,inflorescence,internodal,lateral,leaf,length,lilac,minutely,mm,once-branched,ovary,ovate-lanceolate,papillate,pedicel,peduncle,petiole,plant,poricidal,pubescent,rarely,ripe,simple,sparsely,stellate,stem,stigma,style,surface,tightly,tip,translucent,tube,turning,white,yellow	.1,.7,.8,0.1–0.2,0.2–0.4,0.3–1.2,0.4–0.6,0.5,0.5–0.6,0.7–0.9,0404,0–2,1,1-celled,1.0–1.2,1.0–3.3,1.2–8.4,1.4–4.0,1.5–2.0,11–22,12–24,1m,1–2,1–2-celled,1–3-celled,2-ridged,2/3,2–17,2–3-celled,3.0–3.4,35–45,4–5,5-merous,5–14,5–7-celled,7–10,8–11,?,abaxial,abaxially,adaxial,adaxially,affected,age,anthesi,apar,arising,becoming,beyond,branch,branched,branching,cell,central,close,coloured,cone,congested,conical-ellipsoid,cream-coloured,cylindrical,decurrent,dehiscing,deltate,densely,difoliate,drop,eaf,eed,elongating,end,entire,especially,et,exerted,filament,fleshy,flower,free,geminat,glabrous,gradually,growt,halfway,hilum,individual,knapp,larger,leave,lengthening,less,like,live,lobe,lobed,lon,long,longer,lower,lowermost,margin,membranous,much,narrower,narrowly,near,nearly,nflorescence,node,occasionally,often,one,outline,pair,pale,pathogen,pentagonal,per,perfect,pericarp,pore,portion,positioned,primary,purple,purple-black,purple-coloured,rachi,recurving,reduced,reflexed,relatively,remaining,rounded,ruit,scar,shiny,short,shorter,shrub,similar,slightly,slit,smooth,sometimes,somewhat,spaced,splitting,spreading,star,stone,stout,straight,strongly,sub-laterally,tall,tapering,tem,testal,thick,tinged,together,toward,trichome,two,ud,uniseriate,unit,vein,wide,winged,woody,yellow-green,ympodial,young,–15	0-2,0.3-1.2,0.4-0.6,1.0-1.2,1.0-3.3,1.2-8.4,1.4-4.0,1.5-2.0,2-17,apart,arrangement,articulation,bark,color,connation,dehiscence,diminishing,distal,form,growth,height,history,interjected,leaflet,life,na,papillae,petiolule,position,prickle,pseudostipule,seed,shape,size,spacing,straightnes,terminal,texture,tuber-bearing
68	wfo-0001026262	success	179	117	80	99	37	0.447	0.2-0.6,0.5-1,0.5-1.5,0.5-1mm,1-2,1-5,1.5,10-15,2-3,3,3-10,3-6,7-9,absent,accrescent,acute,anther,apex,apical,asymmetrical,attenuate,base,brown,calyx,chartaceous,cm,connivent,cylindrical,dark,diameter,directed,distal,extra-axillary,flower,fruit,fruiting,globose,green,immature,leaf,lobed,long,mature,mm,moderately,mottling,nearly,netlike,obtuse,occasionally,orange,ovate,pedicel,peduncle,petiole,pit,prickle,pubescent,raised,reniform,ridge,roselike,scandent,separated,shrub,simple,slightly,stem,stigma,style,surface,tan,tapering,tube,unbranched,unlobed,vine,white,x,yellow	0.25-0.5,0.5,0.75-1.5,0.8-1.4,1,1-.,1.5-2,2-2.5,2-5,30,4-10,4-15,4-6,4-7,4-8,5-8,5-merou,7-13,abaxial,abaxially,absen,adaxial,adaxiall,adaxially,alyx,apar,apparently,armed,axe,berry,beyond,blade,contiguous,cordate,densely,difoliate,discolorous,eaf,eed,either,em,end,expanded,exserted,filament,filiform,frui,geminate,glabrou,glabrous,gree,hair,interpetelar,intorsel,lacking,light,like,lobe,lower,major,midpoint,midrib,midvein,multicellular,multiseriate,narrowly,nflorescence,obscure,often,orolla,pair,per,perfect,pore,porrect-stellate,rachi,ray,recurved,ruit,rusty,secondary,side,spaced,sparsely,stalk,stamen,ste,stellate,tamen,tissue,triangular,unarmed,unequa,unicellular,unit,vary,vein,wide,ympodial	1-4,apart,arrangement,articulation,bark,color,connation,corolla,dehiscence,diminishing,form,growth,height,history,inflorescence,interjected,intorsely,lateral,leaflet,length,life,na,ovary,papillae,petiolule,plant,position,pseudostipule,recurred,seed,shape,size,spacing,straightnes,terminal,texture,tuber-bearing
69	wfo-0001026267	success	162	106	73	89	33	0.451	0.6-1.7,0.7-1.1,1-2.6,3-15,5-7,acuminate,acute,anther,apex,attenuate,axil,bark,base,beneath,bright,calyx,closely,cm,corolla,crateriform,cuneate,drying,except,flattened-reniform,fruiting,glabrous,globose,green,greenish-white,lateral,lavender,leaf,lobed,main,minutely,mm,narrowly,nearly,occasionally,often,opposite,ovary,ovate,overlapping,papillose,pedicel,petiole,pitted,poricidal,ripening,rough,shrub,simple,size,slightly,small,spaced,stem,stigma,straight,style,surface,tan,tinge,tip,tree,trichome,tube,tuft,uniseriate,vein,white,yellow-green	.25,.5,0.1-1,0.5-1,1-1.2,1-1.5,1-4,1.5-2,1.5-2.3,2.5-3,20-30-flowered,3-6.1,3.2-8.6,4-8,8-10,8.5-15,anthesi,ba,beginning,berry,blackish,body,broadly,decurrent,deflexed,densely,depressed,dia,differing,difoliate,distally,distinct,eaf,edicel,eed,exerted,filament,free,geminat,greyish-green,hard,incrassate,inflorescenc,larger,lobe,lon,long,longinflorescence,lower,major,margin,maturity,middle,minor,older,one,pair,pale,papillo,pitting,pore,portion,pubescent,quickly,raised,reflexed,remaining,ruit,scar,scarious,scattered,shaped,slender,softening,soon,sparsely,tall,tapering,tear-drop,triangular,ud,unit,widest,wing,winged,woody,x,ympodial,young	arrangement,articulation,color,connation,dehiscence,diameter,diminishing,distal,form,fruit,growth,height,history,inflorescence,interjected,leaflet,length,life,na,papillae,peduncle,petiolule,plant,position,prickle,pseudostipule,seed,shape,spacing,straightnes,terminal,texture,tuber-bearing
70	wfo-0001026272	success	182	105	75	107	30	0.412	1,1-1.5,1.5-2,12-15,2-3,2-7,4-5,5-8,age,anther,apex,apiculate,articulated,bark,base,berry,brown,calyx,clavate,cm,corolla,corymbose,cyme,diameter,distal,elliptic,flattened,form,fruiting,globose,green,growth,inflorescence,internodal,lanceolate,lengthening,lobed,mm,obelliptic,ovary,ovoid,pedicel,peduncle,petiole,pitted,poricidal,prickle,pubescent,recurved,reddish,reniform,reticulately,rugose,scabrous,scandent,shrub,simple,slit,somewhat,spaced,stellate,stem,stigma,style,subconical,surface,tapering,thick,tip,tube,unevenly,way,white,yellowish,¾	0.2-0.3,1-1/5,1-2,1-2-celled,1.2-1.5,1/3,2-2.5,20,20-30,3-4,3-5,3.5-4,6-8,7-10,7-8,abaxial,abaxially,adaxially,anthesi,armed,basal,beyond,branched,celled,coriaceous,cream-colored,densely,denser,discolorous,eaf,eed,epidermi,erect,exserted,filament,flower,free,fused,glabrous,glandular,heterostylous,like,lobe,long,long-styled,lower,many,midpoin,midpoint,minute,mixed,multangulate,multicellular,new,nflorescence,numerous,oblong,older,partially,pendant,per,perfect,pericarp,plurifoliat,pore,porrect,porrect-stellate,portion,prickly,pubescence,quarter,rachi,raise,reduced,ruit,rusty,scar,sessile,short-styled,slightly,sparse,sparsely,stalked,staminate,sub-sessile,subcoriaceous,subglobose,subtruncat,terete,testa,time,triangular-lanceolate,trichome,turbinate,ud,unarme,unarmed,unicellular,unit,upper,velutinous,venation,viscid-pubescent,visible,woody,x,ympodial	arrangement,articulation,color,connation,dehiscence,diminishing,fruit,height,history,interjected,lateral,leaf,leaflet,length,life,na,papillae,petiolule,plant,position,pseudostipule,seed,shape,size,spacing,straightnes,subtruncate,terminal,texture,tuber-bearing
71	wfo-0001026279	success	248	126	94	154	32	0.379	-34.3,-5.9,0.2-0.4,1-10,1-3.5,1.9-3,1.9-3.2,11.5-19.7,3-4,3.4-5.2,3.8-5.1,8,9-22,abaxially,accrescent,acuminate,adaxially,anther,apart,apex,articulated,attenuate,base,black,blunt-tipped,branched,brown,calyx,capitate,cm,completely,corolla,covering,cuneate,dark,deltoid,diameter,drying,elliptic,elongated,enveloping,flower,fruit,fruiting,glabrescent,globose,grayish,green,immature,lanceolate,lateral,lavender,leaf,length,lilac,long,many,mature,mm,narrowly,oblong,occasionally,pale,pedicel,peduncle,petiole,plant,poricidal,reticulate-punctate,rounded,scabridulous,scabrous,short,shrub,simple,slowly,somewhat,stellate,stem,stigma,style,suborbicular,surface,time,tip,tree,tube,unarmed,white,whitish,x,yellow,yellowish,yellowish-tan	-11.4,-2.9,-4,/14-1/8,0.25-0.4,0.8-2.3,0.9-1,0.9-1.8,1-1.4,1.1-1.6,1.1-1.9,1.5-1.8,1.5-3,1.7-2.3,1/2,14-27,2.4-3.2,2.5-3.2,2.6-4.8,2/3,3.1-3.6,3.1-4.2,3.5-7.8,4-7.5,5-200,5-8,8-11,8.5-10.5,acute,adaxiall,ag,anthesi,apparently,appearing,appressed,ark,around,axe,axillary,ba,berry,blade,branch,bud,chartaceous,closely,conical,cylindrical,dendritic-echinoi,dendritic-echinoid,dense,directed,distally,due,eaf,earl,echinoi,echinoid,edge,eed,entire,equal,evident,exerted,expanded,farinose,few-rayed,filament,fleshy,free,glabrescen,glabrous,granular,grayish-green,hair,half,inserted,lengthening,lobe,lobed,long-stalked,longer,longitudinal,longitudinall,lower,m.,main,margin,midrib,minute,mixed,multangulate,multangulate-pubescent,multiseriate,nflorescence,obovate,occasional,often,older,open,orbicular,orolla,ovate-lanceolate,overlapping,partly,perfect,plurifoliate,pore,porrect-stellate,present,prominent,pseudo-terminal,pubescence,rachi,ruit,scattered,secondary,semi-ovate,sessile,short-,short-decurrent,short-stalked,side,slightly,slit,spaced,splitting,stalk,stamen,subcampanulate,subcoriaceous,subsessile,sulcate,suture,tall,tamen,tertiary,thickened,thin,thin-stalked,tomentose,tomentose-pubescent,ud,unarme,unit,unwinged,upper,usually,vary,vein,way,wide,ympodial,young	arrangement,articulation,bark,color,connation,dehiscence,diminishing,distal,form,growth,height,history,inflorescence,interjected,leaflet,life,longitudinally,na,ovary,papillae,petiolule,position,prickle,pseudostipule,seed,shape,size,spacing,straightnes,terminal,texture,tuber-bearing
72	wfo-0001026292	success	190	123	89	101	34	0.468	0.5,0.5-1,0.5-1.5,0.5-2,1-3,1-5,1.5,10-15,2-4,2-6,20-25,3-5,3-9,4-8,5-10,absent,accrescent,acute,anther,apex,attenuate,base,brown,bud,calyx,chartaceous,cm,connivent,curved,diameter,distal,end,extra-axillary,flower,fruit,fruiting,glabrous,globose,green,hair,immature,leaf,lobe,lobed,long,many,mature,midpoint,mm,multicellular,multiseriate,nearly,netlike,often,orange-red,ovate,pedicel,peduncle,petiole,pit,porrect-stellate,prickle,pubescent,raised,ray,reflexed,reniform,ridge,separated,shrub,simple,small,sparsely,spreading,stalk,stem,stigma,style,surface,tan,tapering,tube,unbranched,unicellular,upward,white,wide,x,yellow	-13,0.25-0.5,0.75-1.25,1-1.5,1-2.5,1-8,1.5-2,1.5-2.5,1.5-8,1/3,12-16,13-17,2-3,2.5-3.5,3-15,3-8,30-40,5-merou,abaxially,absen,adaxial,adaxiall,adaxially,alyx,apar,apical,apparently,armed,asymmetrical,axe,berry,beyond,blade,cordate,cut,cylindrical,dark,densely,difoliate,directed,discolorous,distally,eaf,eed,either,expanded,exserted,filament,filiform,flattened,frui,geminate,glabrou,gree,introrsel,lanceolate,less,like,lon,lower,major,margin,midrib,midvein,moderately,nflorescence,obscure,obtuse,occasionally,orange,orolla,pair,per,perfect,pore,rachi,recurved,roselike,ruit,scandent,secondary,side,sinus,slightly,spaced,stamen,stellate,swollen,tamen,tem,thin-skinned,triangular,unarmed,unequa,unit,vary,vegetatio,vein,way,whitish,ympodial	apart,arrangement,articulation,bark,color,connation,corolla,dehiscence,diminishing,form,growth,height,history,inflorescence,interjected,lateral,leaflet,length,life,na,ovary,papillae,petiolule,plant,position,pseudostipule,seed,shape,size,spacing,straightnes,terminal,texture,tuber-bearing
73	wfo-0001026298	success	192	105	74	118	31	0.385	0.2-4,0.3-2,0.4-1,0.5-3,0.75-1,1-1.5,2850,3-6,3/4,acuminate,acute,anther,apex,area,bark,base,broadened,calyx,closely,cm,conical,corolla,difoliate,distal,elliptic,fide,fruiting,glabrous,globose,green,greyish,haught,inflorescence,lateral,leaf,length,lobed,long-styled,minutely,mm,obovate,opposite,ovary,overlapping,ovoid-reniform,pale,papillose,pedicel,petiole,pitted,plant,poricidal,red,rhizomatous,rounded,shape,short-styled,shrub,simple,size,sometimes,spaced,stem,stigma,straight,style,surface,tip,treelet,tube,unit,way,white,yellowish-tan	.5,0.1-0.3,0.25-0.5,0.5-2,0.6-1.5,0.8-2,1.4-6,1.5-2.5,1.5-4,1.5-9,2-3,3-4,4-13,5-30-flowered,7-12,8-28,along,american,anthesi,appearing,appressed,auriculate,ba,bearing,beginning,beneath,berry,blade,bu,caudate,central,corky,costa,deflexed,deltoid,densely,dia,differing,dry,eaf,edicel,eed,ellipsoid,erect,even,exsertion,filament,flower,free,geminat,glabrate,golden,impressed,inflorescenc,later,lobe,locality,lon,long,long-triangular,lower,main,major,margin,material,middle,midrib,minor,minute,nflorescence,oblique,occasionally,often,older,one,orbicular,pair,papillo,peelin,planar,pore,portion,prominent,puberulent,rarely,rather,reddish,reflexed,rest,rican,rough,ruit,scar,scattered,shaped,shorter,single,slender,somewhat,tall,tapering,tear-drop,thick,third,time,trichome,two,ud,unicellular,uniseriate,variable,varying,vein,widest,woody,x,ympodial,young	arrangement,articulation,color,connation,dehiscence,diameter,diminishing,form,fruit,geminate,growth,height,history,interjected,leaflet,life,na,papillae,peduncle,peeling,petiolule,position,prickle,pseudostipule,seed,spacing,straightnes,sympodial,terminal,texture,tuber-bearing
74	wfo-0001026299	success	239	117	89	150	28	0.372	-0.8,-2.5,-3.5,-5,0-8,0.1-0.4,0.1-0.5,0.4-2,0.5-0.6,0.5-0.7,0.5-1,0.5-2.5,0.6-2,0.7-3.5,0.8-1,1,1.1-1.7,1.2-5,2.5,6-20,7-12,acute,anther,apex,articulated,base,broadly,brown,calyx,capitate,cm,corolla,dark,densely,developed,diameter,distal,elliptic,fruit,fruiting,glabrous,globose,green,hair-like,half,herb,imparipinnate,inflorescence,interjected,interrupted,investing,lateral,leaf,leaflet,long,loosely,middle,mm,node,obovate,outgrowth,ovary,pale,pedicel,peduncle,pentagonal,perennial,petiole,petiolule,present,pseudostipule,pubescent,short,simple,size,sparsely,spreading,stem,stigma,straight,stripe,style,surface,tall,terminal,truncate,tube,wide,yellow	--,-1,-10,.5,0.1-0.2,0.1-0.25,0.15-0.2,0.2-0.25,0.2-1,0.25-0.5,0.3-0.4,0.4-0.5,0.5,0.8-0.9,0.9-1,1-1.4,1-celled,1.2-1.6,1.5-,1.5-2.3,1.8-2,2-4,2-6,2-foliate,2-locular,2.2-3.2,2.5-7,25,3-,3.5-10,5,5-15,5-20,abaxially,absent,abundant,acroscopically,adaxially,almost,along,angled,anthesi,apical,appearance,appendage,approximately,axi,basal,basiscopically,beneath,berr,bract,bracteate,cell,change,chota,column,conical,could,crenat,crenate-serrate,decurrent,diamete,eaf,ebracteate,edicel,eed,eglandular,entire,erect,exserted,filament,flower,give,glandular,gree,hal,head,intermixed,internode,irregularly,jequetepeque,lacking,lanceolate,larger,less,like,lobe,lobed,lon,long-acuminate,longer,lower,marañón,margin,maturity,minute,minutely,mixture,multicellular,narrowly,nearly,nflorescence,oblique,occasionally,often,pair,patent,population,primary,prostrate,pubescence,purple,rachi,reflexed,regularly,rest,ruit,scarcely,scattered,secondary,sessile,silky,sparse,staminal,sterile,stout,tem,tertiary,testa,thick,tip,toward,trichome,ud,unicellular,uniseriate,unit,usually,valley,variously,vein,velvety,wall,way,weak-walled,white,winged,woody,ympodial	1.5-10,arrangement,articulation,bark,berry,color,connation,dehiscence,diminishing,form,growth,height,history,length,life,mentioned,na,papillae,plant,position,prickle,seed,shape,spacing,straightnes,texture,tuber-bearing,ye
75	wfo-0001026305	success	135	93	60	75	33	0.444	/4,0.2-1,0.5-2,0.6-1,0.7-1,1-1.5,5-7,abaxially,acute,adaxially,anther,area,bark,base,calyx,closely,cm,conical,corolla,densely,difoliate,elliptic,fruiting,glabrous,globose,green,greenish-white,lateral,leaf,leaf-opposed,lobed,minute,minutely,mm,occasionally,ovary,ovoid-reniform,pale,papillose,pedicel,petiole,pitted,poricidal,pubescent,rounded,shaped,shining,shrub,simple,spaced,stem,stigma,style,surface,tan,tear-drop,tip,tube,unifoliate,way	.25,0.25-0.5,1.3-1.5,2-2.5,2-6-flowered,2.5-3,3-8.5,4-4.5,6-9,7-16,7-9,abaxial,along,anthesi,apex,apical,attenuate,ba,beige-tan,berry,congested,dark,deflexed,deltate,dendritic,dia,drying,eaf,edicel,eed,exserted,filament,free,geminat,glabrate,interlocking,knob-like,lamina,like,lobe,lon,long,lower,main,margin,middle,midrib,nflorescence,older,overlappin,pair,planar,pore,portion,projection,reddish-brow,ruit,scar,scattered,slender,sparsely,strongly,styl,tall,trichome,tub,ud,unit,vein,visible,widest,woody,x,ympodial,young	arrangement,articulation,color,connation,dehiscence,diameter,form,fruit,geminate,growth,height,history,inflorescence,interjected,leaflet,length,life,na,overlapping,papillae,peduncle,plant,position,prickle,pseudostipule,reddish-brown,seed,shape,size,spacing,straightnes,terminal,texture
76	wfo-0001026307	success	193	115	82	111	33	0.425	0.2–1.5,0.5–0.7,0.5–5.0,0.8–2,1.0–2.4,1.0–2.5,2.0–3.5,3–8-celled,4–5.7,5–7,acute-acuminate,anther,apex,appressed,articulated,base,berry,black,broadly,calyx,cell,central,clavate,cm,corolla,cylindrical,diameter,entire,eye,flattened-reniform,fruit,fruiting,glandular,globose,green,growth,herb,hilum,internodal,lateral,length,lobed,margin,membranous,minutely,mm,outline,ovary,ovate,pair,pedicel,peduncle,pentagonal,petiole,poricidal,positioned,purple-yellow,ripe,shallowly,shape,shrub,simple,stellate,stem,stigma,style,sub-laterally,surface,testal,tip,trichome,tube,turning,undulate,uniseriate,variable,vein,vigorous,weak-stemmed,white,yellow,yellow-green	.0–1.2,.3,.5,.5–4.0,.6,.8,0.2–0.5,0.4,0.5–0.6,0.6,0.8–0.9,0.8–5,1.0–1.2,1.0–1.5,1.0–2.0,1–3-celled,1–6-celled,2.0,2.0–3.0,2.6–13,2/3,3.0–4.0,3.5–7.0,35–45,3–8,5-merous,8–12,9,abaxial,abaxially,acute,adaxial,adaxially,age,angled,anthesi,apar,becoming,beyond,cone,cuneate,decurrent,densely,difoliate,eaf,eed,ellipsoid,end,exerted,facing,filament,flower,free,geminat,glabrous,gradually,later,lengthening,like,lobe,long,longer,lower,middle,narrower,narrowing,new,nflorescence,one,paler,papillat,per,perfect,pore,portion,primary,pubescent,purple,recurved,reflexe,reflexed,restricted,ruit,scar,shallow,shorter,side,slightly,slit,spaced,sparsely,spreading,ste,stone,straight,strongly,tal,tem,three,tinged,toward,translucent,triangular,two,ud,unequal,unevenly,unit,upper,wide,ympodial	apart,arrangement,articulation,bark,color,connation,dehiscence,diminishing,distal,form,height,history,inflorescence,interjected,leaf,leaflet,life,na,papillae,papillate,petiolule,plant,position,prickle,pseudostipule,seed,size,spacing,straightnes,terminal,texture,tuber-bearing,width
77	wfo-0001026317	success	169	115	90	79	25	0.533	/4,0.25-1,0.3-1.2,0.5,0.5-0.6,0.7-0.9,2-4,2.5-10,3,4-5,6x,acuminate,acute,age,anther,anthesi,apart,bark,base,branched,bright,brown,calyx,capitate,clonal,closely,cm,conical,corolla,correlated,dark,dendritic,densely,diameter,distally,elliptic,entire,extremely,flattened,fruiting,glabrous,globose,growth,inflorescence,lengthening,lobed,many,minutely,mm,narrowly,new,nodding,orange,ovary,packed,pale,papillate,pedicel,peduncle,petiole,pitted,plane,plant,poricidal,pubescence,pubescent,rachi,red,reniform,scar,shiny,shrub,simple,slit,sparsely,stem,stigma,straight,style,surface,terminal,time,tip,trichome,tube,uniseriate,variable,way,white,yellowish	.5,0.5-0.8,0.5-1,0.6-,0.8-1,1-1.2,1-1.5,1-5.7,10-12,2-,2-2.5,3-3.5,3-foliate,3.5-15,50-200,6-8,?,abaxially,absent,adaxially,apex,apically,approximately,attenuate,berry,deltate,dense,drying,eaf,eed,em,erec,erect,essentially,exerted,filament,flower,found,free,geminat,halfwa,internodal,lamina,less,like,lobe,longer,lower,margin,maturity,nflorescence,occasionally,often,pair,papillat,per,perfect,pericarp,planar,population,pore,portion,primary,pubescen,pulp,reflexed,ruit,slightly,sticky,swollen,thin,toward,triangular,ud,unit,vein,woody,x,ympodial	2,arrangement,color,connation,correlation,dehiscence,form,fruit,height,history,interjected,lateral,leaf,leaflet,length,life,na,papillae,pseudostipule,seed,shape,size,spacing,straightnes,texture
78	wfo-0001026321	success	213	114	85	128	29	0.399	.5,0-0.2,0.1-0.4,0.5-0.6,1-1.2,1.2-3.5,1.5-3,2-5,2-7,2.5-5.5,2.7-3.1,3-10,3.5-8.5,4-,4.5-6,7-9,8-20,abaxially,acicular,adaxially,anther,apex,articulated,base,broadly,brown,calyx,chartaceous,cm,cordate,densely,diameter,entire,extra-axillary,flower,fruit,glandular-puberulent,globose,green,herbaceous,inflorescence,lanceolate,lateral,leaf,leaf-opposed,length,lobe,lobed,long,margin,mid-point,mm,moderately,oblique,obtuse,orbicular,ovate,pale,pedicel,peduncle,petiole,plant,present,prickle,prostrate,pseudo-racemose,rachi,resprouter,rusty,shallowly,solitary,sprawling,stellate,stellate-pubescent,stigma,style,surface,thick,throughout,tube,unbranched,white,x,yellow,yellowish-green	%,0-0.1,0-0.25,0-0.3,0-2,0-3.5,0.1-0.2,0.1-0.3,0.3-0.6,0.4-0.6,0.4-0.7,0.6-0.9,1-1.5,1-2,1-3,1-4,1-5,1-locular,1.2-1.7,10-17,2-3,2-4,2-5.5,20-40,3-4,30-65,4.5,5-25,5-merou,50-100,6-10,6-11,7-10,8-11,absent,accrescent,across,adaxial,adaxiall,adult,also,alyx,andromonoecious,apart,armed,ascending,attenuate,axe,ba,bisexual,blade,branchlet,capitat,central,connivent,cross-section,cylindrical,decimetre,deltate,directed,distall,eaf,eed,eglandular,elliptica,exocarp,finger,frui,fruiting,functional,glabrous,gland-tipped,glandular,greenish-white,grey-green,hair,half,halfway,heterostylous,hig,incomplete,juicy,juvenile,less,longer,lower,mature,mesocarp,midpoint,midrib,midvein,minute,moist,nflorescence,orolla,pair,part,per,placenta,pore,porrect,ray,rostrate,ruit,septum,sessile,shallowly-lobed,short,side,simple,spaced,sparse,stalk,stellae,straight,tamen,tem,time,transparent,unarme,unarmed,unit,unknow,upper,vary,weakly,wide,ympodial	5-merous,articulation,bark,capitate,color,connation,corolla,form,growth,height,history,interjected,leaflet,life,na,ovary,papillae,position,pseudostipule,seed,shape,size,stem,straightnes,terminal,texture,thicknes,tuber-bearing,unknown
79	wfo-0001026325	success	216	121	89	127	32	0.412	0.5,0.5–1.5,0.5–5,10–12,1–2,1–2.5,2,2–4,2–6,3,3.3,3.5,5,7–10,abaxially,absent,accrescent,acute,adaxially,anther,apart,articulated,base,berry,blue-violet,calyx,cm,completely,connivent,covering,curved,darker,densely,diameter,directed,downward,ellipsoid,elliptic,extra-axillary,finely,flattened-reniform,flower,forked,foveolate,fruit,fruiting,green,herb,inflorescence,lanceolate,lateral,leaf,lenticular,less,light,long,maturity,mm,mottling,narrowly,oblong,obtuse,ovate-elliptic,ovoid,pale,pedicel,peduncle,perennial,petiole,prickle,rotate-stellate,simple,sometimes,somewhat,stellate,stellate-pentagonal,stellate-pubescent,stem,stigma,straight,style,surface,tube,unbranched,usually,white,yellow,yellow-orange,young	.2,0.15–0.4,0.3,0.6–1.8,1,1.1–2,1.2–1.8,1.2–2,1.2–2.2,1.2–2.5,1.3–2.5,1.5,1.5–2.3,1.7–3.5,1.8–2.5,10–20,12–16,1–1.5,1–5,1–6,2-,2.5–4,2–10,2–5,3-foliate,4,4–7,4–8,5-merous,5–9,6.5–15,7–8.5,acuminate,adaxiall,alyx,andromonoecious,apex,appearing,armed,axe,blade,bud,c.,capitat,caudate,central,chartaceous,cuneate,cylindrical,deltate,directly,discolorous,distal,distall,eaf,eed,emerging,exserted,few-branched,filament,formed,functionally,geminat,glabrous,hair,hermaphorditi,hermaphroditic,heteromorphic,like,linear,lobe,lobed,lon,long-stuled,lower,lowermost,major,malae,margin,moderately,nflorescence,node,often,one,orolla,outline,per,plurifoliate,pointed,pore,producing,proximal,pubescent,ray,rind,root,ruit,sessile,shallowly,shoot,short-styled,side,sinuate,spaced,sparsely,staminate,subentire,subglobose-ovoid,subtruncate,swelling,tall,tamen,tapered,tem,toug,triangular,tuber-like,unarmed,unequal,unit,upright,vary,vein,weakly,ympodial,×,–3	arrangement,articulation,bark,capitate,color,connation,corolla,dehiscence,distally,form,growth,height,history,interjected,leaflet,length,life,na,ovary,papillae,plant,position,pseudostipule,seed,shape,size,spacing,straightnes,terminal,texture,tuber-bearing,ye
80	wfo-0001026335	success	157	104	67	90	37	0.427	0.25-0.5,0.5-1,1-1.5,1-2,1-4,10-20,2-3,2-4,5-15,5-7,accrescent,acuminate,adaxially,anther,apart,apex,articulated,base,branched,calyx,chartaceous,cm,connivent,cuneate,curved,diameter,elliptic,elliptic-ovate,flattened,flower,forked,fruit,fruiting,glabrescent,globose,green,hair,leaf,leaf-opposed,longitudinal,mm,oblong,opening,pedicel,peduncle,petiole,probably,reticulate,ripe,rounded,scattered,shrub,simple,slightly,slit,stellate,stem,stigma,straight,style,surface,tube,unripe,white,x,yellow,yellowish	.5,.5-3.5,0.1-0.3,0.6-1,0.8-1.3,1,1-3,1.5-2,1.5-4,10-30,2,2-7.5,3-18,3-5,4-5,5-,7-8,abaxially,acute,adaxiall,ag,apparently,axe,ba,blade,capitat,covering,cylindrical,deltate,dense,densely,directed,distally,eaf,eed,entire,equal,erect,especially,filament,frui,geminate,glabrous,glandula,glandular,held,lanceolate,large,like,lobe,long,lower,many-foliate,margin,midpoint,moderately,much,multangulate,nflorescence,often,orolla,paired,perfect,pore,pubescence,pubescent,rachi,ray,ruit,sessile,smaller,sometimes,spaced,ste,stellate-pubescent,subtending,tal,tamen,tem,time,tip,toward,unit,uprigh,usually,vary,vein,whitish,wide,ympodial	age,arrangement,articulation,bark,capitate,color,connation,corolla,dehiscence,diminishing,distal,form,growth,height,history,inflorescence,interjected,lateral,leaflet,length,life,na,ovary,papillae,petiolule,plant,position,prickle,pseudostipule,seed,shape,size,spacing,straightnes,terminal,texture,tuber-bearing
81	wfo-0001026342	success	280	111	65	215	46	0.232	1/3,2.0,2.1,acuminate,acute,aequilateral,anther,apart,apex,articulate,attachment,bark,base,brown,calyx,cancellate,chartaceous,cm,connivent,corolla,diameter,distal,dry,emerging,entire,extra-axillary,flattened-orbicular,flattened-reniform,flower,fruit,globose,inflorescence,internode,lateral,leaf,length,long,mm,notched,oblique,occasionally,oval,ovate,pedicel,peduncle,petiole,point,red,reddish,rounded,shrub,simple,slightly,stellate,stem,stigma,straight,style,surface,tube,upper,white,yellow,yellow-tan,±evenly	.3,.4–3.0,.6,.9,0.06,0.07,0.08,0.3–0.5,0.3–0.6,0.3–0.9,0.4–0.6,0.6–1.3,0.6–2.8,0.7–1.4,0.7–1.6,0.7–1.8,0.8,0.8–1.1,0.8–1.2,0.8–1.5,0.9–1.3,1.1–1.5,1.1–3.7,1.2,1.3–1.8,1.5–2.1,1.5–2.3,1.7–2.6,1.8–2.2,1.9–2.9,1/2–2/3,2.0–7.6,2.1–3.3,2.1–3.7,2.5,2.5–3.8,2.8–4.9,2.9,3.1–13.7,3.2–3.7,3.6–4.6,4.7,4602,5-merou,5.1–6.6,5.2–7.7,5–8,6–12,7.7–11.2,7–8,8,8.5–9.5,8–13,9.5–14.2,90°,abaxially,absent,adaxial,adaxially,adnate,ag,along,alyx,anthesi,apical,apparently,appearing,arching,around,attenuate,axe,ba,becoming,bent,berry,blade,borne,branch,broad,brochidodromous,bud,capitat,caudate,channeled,climate,clinate,congested,deciduous,deltoid,densely,dentate,development,difoliate,directed,dorsally,edge,eed,either,endocarp,erect,exocarp,extending,fertile,filament,filiform,flexed,free,geminat,glabrous,glandular,glossy,gradually,hair,homostylous,immature,increasing,individually,intact,interpetalar,intersepalar,juic,laxly,layer,less,lobe,lon,longer,lower,many,margin,markedly,mature,mckee,midpoint,midrib,midvein,minute,moderate,moderately,nearly,nflorescence,oblong,observed,one,orolla,ove,per,perforated,pore,porrect,porrect-stellate,portion,potentially,pubescence,pubescent,raised,ray,reflexe,remaining,rigid,row,ruit,seen,sessile,short-stipitate,shorter,side,sinus,sloughing,smoot,soon,spaced,sparsely,speciman,splitting,spread,stamen,stellae,stellate-pubescent,stipe,suture,tamen,tardily,tem,thin,time,tip,tissue,toward,translucent,transparent,trifurcating,truncate,two,typically,ud,unarmed,unbranched,various,vary,vein,weakly,well-developed,wide,yellow-ferruginous,ympodia,young,±90°,±densely,±equal,±glabrous,×,–0.9,–19.0,–31.0	0.3-0.9,0.6-1.3,0.6-2.8,0.8-1.2,0.8-1.5,1.3-1.8,1.9-2.9,19.0,2.1-3.7,2.8-4.9,31.0,5.2-7.7,7.7-11.2,9.5-14.2,arrangement,articulation,capitate,color,connation,dehiscence,diminishing,form,fruiting,growth,height,history,interjected,leaflet,life,na,ovary,papillae,perennial,petiolule,plant,position,prickle,pseudostipule,seed,shape,size,spacing,straightnes,terminal,texture,tuber-bearing
82	wfo-0001026343	success	221	117	85	136	32	0.385	-3.5,-4,-7,0-4,0.05-0.5,0.45-1,1-4,1.3-1.7,1.5-2,1.5-2.5,2-3,2-4,2-5,2-6,2.5-8,5-10,5.5-9,7-12,acute,anther,apart,apex,apparently,articulated,bark,base,broadly,calyx,chartaceous,cm,connivent,cream,cuneate,curved,dark,diameter,distal,dull,elliptic,elongating,erect,flattened-reniform,fruit,fruiting,glabrescent,glabrous,green,lateral,leaf,length,lobed,long,longer,marking,maturity,mauve,mm,moderately,orange-brown,pale,pedicel,peduncle,petiole,plant,poricidal,prickle,purple,reddish,rounded,shrub,small,spherical,stellate-pubescent,stem,stout,style,surface,tapering,time,tip,tree,tube,wide,yellow,young	-1,-1.5,-15,.5,/2,/5,0,0-10,0-2,0-40,0-5,0.05-0.2,0.1-0.2,0.15,0.2,0.2-0.3,0.2-0.7,0.3,0.5,0.5-1.5,0.8-1.5,1-2,1-3,1.8-2.2,1.8-3,1/,1/3,1/4-2/3,1/5,10-30,2-3.2,2-8,2.2-3.2,3-4,3-5,3.5-4.5,5-merous,6-9,7-14,7-8,7-9,abaxial,abaxially,acuminat,adaxial,alyx,andromonoecious,apar,apically,berry,blade,branched,brow,concolorous,deltate,densely,distance,drying,eed,equal,extending,faint,filament,flattened,flower,free,green-brown,hermaphrodite,heterostylous,infructescence,less,lobe,lobing,lon,long-styled,lower,lowermost,margin,mature,midpoint,midvein,multangulate,narrow-deltate,nflorescence,obtuse,older,one,open,orange,orolla,oung,ovate,pair,pendulous,per,pericarp,plurifoliat,porrect,portion,prickl,prickly,primary,ray,reduced,reflexed,ruit,scar,secondary,sessile,short-styled,side,smooth,sometimes,spaced,sparsely,spreading,stalk,stalked,staminat,stellate,tamen,terete,tertiary,trichome,unarmed,unit,upper,variously,vary,vein,venation,visible,way,weakly,woody,ympodial	arrangement,articulation,brown,color,connation,corolla,dehiscence,diminishing,form,growth,height,history,inflorescence,interjected,leaflet,life,na,ovary,papillae,petiolule,plurifoliate,position,pseudostipule,seed,shape,size,spacing,stigma,straightnes,terminal,texture,tuber-bearing
83	wfo-0001026351	success	199	112	80	119	32	0.402	0.5-1.0,0.5-1mm,1-2.5,1-3,1-4,2-5,3-10,3-6,4-7,8-15,accrescent,acute,anther,apex,armed,attenuate,base,brown,bud,calyx,cm,connivent,coriaceous,corolla,diameter,extra-axillary,flattened,flower,fruit,fruiting,glabrous,globose,green,hair,immature,leaf,length,like,lobed,long,mature,mm,moderately,narrowly,nearly,obtuse,orange,orange-red,ovary,ovate,pale,pedicel,peduncle,petiole,plant,prickle,pubescent,purple,recurved,reniform,roselike,seed,simple,slightly,spreading,stellate,stem,stigma,style,subcoriaceous,surface,tan,tapering,triangular,tube,vine,white,wide,x,yellow	0.25-0.5,0.5,0.5-1,0.5-1.5,0.75-1.0,1-.,1-1.5,1-2,10-15,10-18,12-16,15-50,2-3.5,2-4,3-9,4-6,4-9,40-80,5-15,5-merou,6-10,6-8,abaxial,abaxially,absent,adaxial,adaxially,alyx,andromonoecious,apar,apical,apparently,asymmetrical,axe,berry,beyond,blade,branch,branched,chartaceous,commonly,cordate,cylindrical,dark,densely,difoliate,directed,discolorous,distally,distinct,eaf,eed,either,em,entire,exserted,exseted,filament,filiform,forming,frui,functionally,geminate,glabrou,gree,hermaphroditic,heteromorphic,introrsel,leathery,lobe,long-styled,lower,major,male,margin,midpoint,midrib,midvein,multicellular,multiseriate,nflorescence,occasional,occasionally,often,orane,orolla,outer,pair,per,pore,porrect-stellate,proximally,rachi,ray,red,revolute,ruit,scrambling,short-,side,siz,spaced,sparsely,stalk,stamen,ste,stellare,straight,surfac,swellin,tamen,unarmed,unbranched,unequal,unicellular,unit,vary,vein,ympodial	1-6,apart,arrangement,articulation,bark,color,connation,dehiscence,diminishing,distal,form,growth,height,history,inflorescence,interjected,lateral,leaflet,life,na,papillae,perennial,petiolule,position,pseudostipule,shape,size,spacing,straightnes,terminal,texture,tuber-bearing
84	wfo-0001026352	success	209	98	68	141	30	0.325	0.5-0.8,0.5-3,0.7-2,1-10,3-15,5-6,acuminate,acute,anther,apex,articulated,articulation,bark,base,berry,blue,brown,calyx,capitate-truncate,chartaceous,cm,cordate,corolla,diameter,ellipsoid,flattened,fruiting,globose,green,greenish,growth,inflorescence,leafy,length,membranous,minutely,mm,narrowly,near,ovate,pale,pedicel,peduncle,petiole,pink,poricidal,reniform,shallowly,shoot,short,simple,sleeve,small,stellate,stem,stigma,style,surface,terminal,tip,truncate,tube,tuberculate,unspecified,vine,white,woody,yellowish	.3,.5,0.5,0.5-1,0.5-1.5,0.6-,0.9-1,1-,1-1.5,1-2-celled,1.2-1.7,1.5,1.5-2,1.5-4.6,10+,12-60,2,2-3-celled,3.5-9,4-4.5,5-merou,6-7,7-9,<,?,abaxially,adaxiall,ag,almost,alyx,angle,anthesi,antrorsely,apart,apparently,appearance,arising,axi,basal,bending,branch,branching,broadly,cell,conical,curved,deciduous,deltate,densely,denser,discolorous,eaf,eed,entire,evenly,eventually,expanded,exserted,few-celled,filament,flower,free,giving,glabrous,half,heigh,herbarium,ilament,immature,impressed,inflorescenc,irregularly,junction,lamina,large,largest,leave,leaving,lengthening,like,lobe,lobed,long,lower,many,margin,mature,nearly,new,nflorescence,older,orolla,outline,pair,papillate,papillo,peg,per,perfect,pericarp,plurifoliat,point,pore,portion,primary,principal,pubescent,rachi,reflexed,rest,revolute,right,ruit,scar,seen,shiny,slit,spaced,sparser,specimen,spreadin,spreading,straw-colored,strongly,tem,thin,third,time,trichome,tub,ud,uniseriate,unit,upper,vary,vein,violet,weak,wide,widest,ympodial	arrangement,color,connation,dehiscence,diminishing,distal,form,fruit,height,history,interjected,lateral,leaf,leaflet,life,na,ovary,papillae,petiolule,plant,position,prickle,pseudostipule,seed,shape,size,spacing,straightnes,texture,tuber-bearing
85	wfo-0001026352	success	214	106	75	139	31	0.35	0.5-0.8,0.5-3,0.7-2,1-10,3-15,5-6,?,acuminate,acute,anther,apart,apex,articulated,articulation,base,berry,blue,brown,calyx,capitate-truncate,chartaceous,cm,connivent,corolla,diameter,ellipsoid,flattened-reniform,form,fruiting,globose,green,greenish,growth,inflorescence,leaf,leafy,length,lengthening,lobed,membranous,minutely,mm,narrowly,near,nearly,ovate,pale,pedicel,peduncle,petiole,pink,pore,poricidal,shiny,shoot,short,simple,sleeve,slit,small,stellate,stem,stigma,style,surface,terminal,tip,tube,tuberculate,unspecified,vine,white,woody,yellow,yellowish	.3,.5,0.5,0.5-1,0.5-1.5,0.6-,0.9-1,1-,1-1.5,1-2-celled,1.2-1.7,1.5,1.5-2,1.5-4.6,10+,12-60,2,2-3-celled,3.5-9,4-4.5,5-merou,6-7,7-9,<,abaxially,adaxially,ag,almost,alyx,angle,anthesi,antrorsely,apparently,appearance,arising,ark,axi,basal,bending,branch,branching,broadly,cell,conical,cordate,curved,deciduous,deltate,densely,denser,discolorous,eaf,eed,entire,evenly,eventually,expanded,exserted,few-celled,filament,flower,free,geminat,giving,glabrous,half,heigh,herbarium,ilament,immature,impressed,inflorescenc,irregularly,junction,lamina,large,largest,leaving,like,lobe,long,lower,many,margin,mature,new,nflorescence,older,orolla,outline,pair,papillate,papillo,peg,per,perfect,pericarp,plurifoliate,point,portion,primary,principal,pubescent,rachi,reflexed,rest,revolute,right,ruit,scar,seen,shallowly,spaced,sparser,speciman,specimen,spreadin,spreading,straw-colored,strongly,tem,thin,third,time,trichome,truncate,tub,twining,ud,uniseriate,unit,upper,vary,vein,violet,weak,widest,x,ympodial	age,arrangement,bark,color,connation,dehiscence,diminishing,distal,fruit,height,history,interjected,lateral,leaflet,life,na,ovary,papillae,papillose,petiolule,plant,position,prickle,pseudostipule,seed,shape,size,spacing,straightnes,texture,tuber-bearing
86	wfo-0001026357	success	206	109	76	130	33	0.369	0.2-0.7,1-6,1.5-2.5,2-6,3.9-6.2,4-6,4-7,5,5.8-13.6,7-15,abaxially,accrescent,adaxially,anther,apart,apex,articulated,asymmetrically,bark,base,blunt-tipped,branched,brown,calyx,chartaceous,cm,corolla,dark,diameter,elliptic,ferrugineous-pubescent,flower,foveolate,fruit,fruiting,globose,granular,green,immature,lanceolate,lateral,leaf,length,long-attenuate,many,mature,mm,narrowly,nearly,oblanceolate,oblong,ovate,pale,pedicel,peduncle,petiole,poricidal,rough,scabrous,several,shrub,simple,small,smooth,somewhat,stellate,stem,stigma,style,tan,time,tip,tree,tube,white,yellow	0.1-0.3,0.11-0.29,0.4-1.6,0.6-1.5,0.8-1,0.8-1.2,0.9-1.2,1-1.2,1.1-1.7,1.4-2,1.5-2.2,1.5-2.8,1.7-2.9,1/2,10-11,10-17,2-2.8,2-3,2-3.3,2.3-4.2,2.5-3.3,30-68,4-5,6-7.5,7-10,absen,acute,adaxiall,ag,along,anthesi,apparently,around,axillary,ba,berry,blade,branch,capitat,closely,completely,conical,conspicuous,coriaceous,covering,cylindrical,decurrent,densely,directed,distally,eaf,edge,eed,ellipsoid,entire,enveloping,exserted,farinose,filament,fleshy,free,glabrous,hair,half,hig,inserted,large,lengthening,line,lobe,lobed,long,lower,m.,main,margin,midrib,minute,mostly,multangulat,multangulate,multangulate-pubescent,nflorescence,obovoid,obtuse,older,orolla,ovate-lanceolate,perfect,persistently,plurifoliate,pore,porrect-stellat,porrect-stellate,pubescent,rachi,revolute,ruit,runk,semi-ovate,sessile,short-stalked,side,slightly,slit,spaced,sparse,sparsely,stellate-pubescen,stellate-pubescent,stellate-tomentose,stelliform,suture,tamen,terete,testa,thick-stalked,tomentose-pubescent,touching,ud,unit,vary,vein,way,weakly,whitish,within,x,ympodial,young	arrangement,articulation,capitate,color,connation,dehiscence,diminishing,distal,form,growth,height,history,inflorescence,interjected,leaflet,life,na,ovary,papillae,petiolule,plant,position,prickle,pseudostipule,seed,shape,size,spacing,straightnes,surface,terminal,texture,tuber-bearing
87	wfo-0001026367	success	216	119	81	135	38	0.375	abaxially,acuminate,adaxially,anther,apart,apex,articulated,asymmetric,attenuate,base,black-brown,blue,branch,broadly,cm,colored,cordate,deltoid,densely,diameter,directed,distally,dried,entire,erect,eventually,filiform,flower,fruit,globose,green,growth,internode,irregularly,lance,lateral,lavender,leaf,lenticular,lighter,lobe,lobed,longer,loosely,margin,midpoint,midvein,midzone,minutely,mm,narrowly,ovate,pedicel,peduncle,pentagonal,petiole,pitted,plump,pubescent,ray,rotate,rounded,shallowly,shrub,simple,sinuately,slightly,stellate,stem,stigma,style,surface,tan,terminal,tomentose,tube,turning,usually,weakly,yellow,×	.5,0.2–0.5,0.4–0.6,0.4–0.7,0.5–0.7,0.7–1.5,1.2-1.6,1.8–2.5,10,10–15,10–18,15-20,15–30,1–2,1–3,2.5–4,2–3,2–3.5,2–4,2–4.5,2–5-branched,3–4,3–6,3–7,5-merou,5–7.5,5–9,6–8,7-9.7,7–11,8–10,abaxial,acicular,acute,adaxial,adaxiall,age,along,alyx,apparently,armed,ascending,axe,ba,blade,branched,capitat,caudate,center,close,closely,deeply,dense,denser,eaf,eed,farinose,filament,finely,geminat,glabrate,glabrous,hair,high,homostylous,immature,initially,interpetalar,interwoven,larger,later,like,little,lon,long,looser,lower,maturit,midvei,mostly,much,near,nflorescence,oblong,often,orolla,overtopped,ovoid,perfect,plurifoliate,pore,porrect,prickle,principal,pubescence,ruit,sessile,short,shorter,side,similar,sinus,small,somewhat,some­what,soon,spaced,sparsely,splitting,spreadin,spreading,spreadingly,stalk,stalked,ste,stellae,stellate-pubescent,stellate-tomentose,tamen,tawny,tem,thick-chartaceous,time,tip,tissue,tomento,triangular,ud,unarmed,vary,vein,well-developed,wide,ympodia,–20	0.4-0.6,0.5-0.7,1-2,1-3,10-18,2-3,2-3.5,2-4,2-5-branched,2.5-4,3-7,5-9,8-10,arrangement,articulation,calyx,capitate,color,corolla,dehiscence,form,height,history,inflorescence,interjected,leaflet,length,life,na,ovary,plant,pseudostipule,seed,shape,size,spacing,texture,width
88	wfo-0001026377	success	155	109	76	79	33	0.49	0,12,16,2,2-3,3,30,5-6,5-7,5-merous,7,8-13,abaxially,abundant,abundantly,adaxially,along,anther,apex,articulated,base,bright,broadly,brownish,calyx,central,cm,densely,distinctly,flower,forked,hair,hermaphroditic,heterostylous,lateral,leaf,like,long,main,mainly,midpoint,mm,narrow,often,ovate,pale,pedicel,peduncle,petiole,plant,polished,pore,prickle,prickly,pubescent,purple,ray,reduced,retrorse,scattered,shrub,staminate,stellate,stellate-pubescent,stem,stigma,straight,style,surface,tapered,triangular,tube,unbranched,unequal,vein,x	-8,0.5,1,1/5-1/4,2.5,3-,3-5,4,7-7.5,abaxiall,acumen,acute,andromonoecious,apica,armed,axe,ba,belo,blade,branched,broad,cell,chartaceous,cut,distall,eaf,eed,ending,ermaphroditic,extra-axillary,filament,fresh,geminat,hermaphrodite,internode,linear,lobe,lon,lower,margin,midrib,minor,nflorescence,oblique,orolla,porrect,prickl,proximal,rachi,repand,rounded,ruit,seen,shallow,sharp,short,side,simple,single,sinus,smaller,sparsely,stipe,stou,straggly,structure,subcordate,subsagittate,tamen,taminate,tem,tipped,transition,unknow,unknown,vary,vestigia,way,ympodial	3-6,60-100,alternate,apical,arrangement,articulation,color,corolla,dioecious,form,fruit,glabrous,green,greyish,growth,height,herb,hirsute,history,inflorescence,length,life,na,ovary,perennial,reproduction,seed,shape,size,staman,texture,vestigial,white
89	wfo-0001026379	success	219	133	103	116	30	0.47	-4.5,0.2-0.38,0.2-0.4,1-1.7,1-10,1-2,1.5-2.3,1.9-3.4,13,2-2.8,2-7,2/3,4.1-7,5.3-10.2,8-13,8-15,8.3-10,accrescent,acute,along,anther,apart,apex,articulated,attenuate,bark,basal,base,blunt-tipped,branched,brown,calyx,cm,completely,conical,corolla,covering,cylindrical,dark,densely,diameter,distal,dried,echinoid-pubescent,ellipsoid,entire,enveloping,finely,flower,fruit,fruiting,globose,granular,gray-brown,growth,lateral,leaf,length,long,long-attenuate,many,margin,minutely,mm,multangulate,multangulate-pubescent,nearly,oblong,obovate,ovate,pale,pedicel,peduncle,persistently,petiole,pitted,plant,poricidal,porrect-stellate,reniform,rich,scabrous,shrub,simple,size,small,somewhat,stellate,stellate-,stellate-tomentose,stelliform,stem,stigma,style,time,tip,tomentose-pubescent,tree,tube,velutinous-pubescent,violet,x,yellow	0.7-1,0.7-2.5,0.8-1.2,0.9-1.2,1-3.7,1.3-2.1,1.7-4.9,1.8-2.6,1.8-3.2,1.8-5,1/2,2.4-5.1,2.6-3.7,2.9-4,3-11,3/4,4-5,50-450,6-10.6,8-29,9-14,abaxially,adaxiall,adaxially,ag,anthesi,apparently,around,axillary,ba,berry,blade,branch,capitat,chartaceous,closely,dendritic-echinoid,directed,distally,eaf,echinoi,echinoid,edge,eed,evident,farinose,few-rayed,filament,fleshy,free,glabrous,grayish,hair,hig,included,inserted,lacking,large,lengthening,line,lobe,lobed,lower,m.,main,mature,midrib,minute,mostly,multangulat,nflorescence,obtuse,often,older,orolla,ovate-lanceolate,partly,perfect,plurifoliate,pore,present,pubescen,rachi,rather,recent,ruit,runk,scattered,semi-ovate,sessile,short-stalked,side,slit,sometimes,spaced,sparse,stellate-pubescent,suture,tamen,terete,testa,thin,translucent,ud,uneven,unit,upper,usually,vary,vein,vestigial,way,whitish,whitish-brown,ympodial,young	arrangement,articulation,bud,capitate,color,connation,dehiscence,diminishing,form,height,history,inflorescence,leaflet,life,na,ovary,papillae,petiolule,position,prickle,pseudostipule,pubescent,seed,shape,spacing,straightnes,surface,terminal,texture,tuber-bearing
90	wfo-0001026388	success	264	92	60	204	32	0.227	.5,0.15,1.8,8.5,abundant,acicular,anther,apex,attenuate,bilobed,brown,calyx,cm,color,corolla,diameter,dilated,distinctly,extra-axillary,free,fruit,gland,globose,glutinous,green,lateral,leaf,length,less,life,minute,mm,ovate,pedicel,peduncle,petiole,plant,prickle,reflexed,shape,shrub,simple,size,somewhat,stellate,stem,stigma,stipitate,straight,style,suborbicular,surface,thin-textured,truncate,tube,unbranched,white,x,yellow-orange,yellowish	.2,.7,0.2-0.6,0.2–1,0.2–2,0.4–1,0.5–1.7,0.5–2,0.5–4,0.8–1.5,0.8–2.5,1-2,1.4,1.4–1.6,1.5-2,1.5–2.2,1.5–3.5,1.6,108,10–20,12,1–2,1–2.5,1–6,2-foliate,2.5–4,20–,25,2–4,2–4-celled,2–9,3,3.2–3.7,45,4–10,4–5-rayed,4–6-celled,5,5–12,5–20,6,65–145,6–11,6–7,8-13,=,?,abaxially,acuminate,acute,adaxiall,adaxially,always,angle,apar,apiculate,apparent,appearance,armed,ascending,base,becoming,blade,bleaching,branch,bright,ciliate,closely,conduplicate,confined,covering,cylindrical,deeply,dense,developing,directed,distall,divided,division,dried,eaf,eed,enlarged,entire,erect,especially,exceeding,except,exclusive,exserted,filament,first,flower,flowering,folded,forward,geminat,geminate,giving,glabrous,glistening,golden,grading,greenish,hair,halfway,hyaline,inserted,inside,lanceolate,larger,least,light,lighter,lobe,lobed,lon,long,lower,major,margin,midrib,minutely,moderately,mostly,much,n,nearly,nflorescence,oblique,often,one,orolla,otherwise,outside,ovate-apiculate,pair,papillat,par,per,pilose,plane,pointing,pore,pressing,probably,purple-colored,rachi,ranging,rarely,recurved,reported,rip,ripe,ruit,scarious,scattered,sessile,shallowly,sideway,similar,single,sinuate,sinus,slightly,small,smaller,sometimes,spaced,sparsely,spreading,stamen,stellae,straw,strongly,sunlight,tal,tamen,tem,thickened,tip,triangular,turning,twice,twisted,two,unarmed,unicellular,unit,upper,usually,various,variously,vary,vein,viewed,whole,wide,wing,yellow,yellow-green,ympodial,±,–8	0.4-1,0.5-2,0.5-4,0.8-2.5,1.5-2.2,2-9,5-12,arrangement,articulation,bark,connation,dehiscence,form,fruiting,growth,height,history,inflorescence,interjected,leaflet,na,ovary,papillae,perennial,position,pseudostipule,seed,spacing,straightnes,terminal,texture,tuber-bearing
91	wfo-0001026397	success	202	120	85	117	35	0.421	0.5-1,0.5-1.5,1-3,1-6,10-20,13-18,2-10,2-5,2.5,5-15,5-8,6-10,absent,accrescent,anther,apex,attenuate,base,brown,bud,calyx,chartaceous,cm,connivent,coriaceous,cylindrical,diameter,extra-axillary,flower,fruit,fruiting,functionally,globose,green,hair,hermaphroditic,immature,leaf,line,lobed,long,male,many,mature,mm,moderately,nearly,netlike,occasional,orange,ovate,pedicel,peduncle,petiole,pit,plant,prickle,pubescent,purple,raised,recurved,red,reniform,ridge,roselike,separated,simple,small,sparsely,spreading,stellate,stem,stigma,style,surface,tan,tapering,tube,unbranched,vine,weakly,white,woody,x,yellow	1,1-.,1-2,1-2.5,1-9,1.5,1.5-3,1.5-3.5,10-14,12-15,12-16,2-2.5,3-3.5,3-4,3-5,3-9,4-16,4-8,5,5-merou,50-100,8-20,abaxially,absen,acute,adaxial,adaxially,alyx,andromonoecious,anthesi,apar,apical,armed,asymmetrical,axe,berry,beyond,blade,cordate,dark,densely,difoliate,directed,discolorous,eaf,eed,either,em,entire,expanding,exserted,filament,filiform,flattened,frui,geminate,glabrou,glabrous,glandular,greatly,gree,greem,heteromorphic,introrsel,leathery,like,lobe,long-styled,lower,major,margin,midpoint,midrib,midvein,multicellular,multiseriate,narrowly,nflorescence,obscure,obtuse,often,older,orolla,pair,per,pore,porrect-stellate,present,rachi,ray,reflexed,ruit,rusty,secondary,short-and,side,siz,slightly,spaced,stalk,stamen,ste,straight,tamen,thick,triangular,unarmed,unequal,unicellular,unit,usually,vary,vein,whitish,wide,ympodial,young	1-4,apart,arrangement,articulation,bark,color,connation,corolla,dehiscence,diminishing,distal,form,growth,height,history,inflorescence,interjected,lateral,leaflet,length,life,na,ovary,papillae,petiolule,position,pseudostipule,seed,shape,size,spacing,straightnes,terminal,texture,tuber-bearing
92	wfo-0001026400	success	187	141	108	79	33	0.578	0.2-0.8,0.4-1,0.5-1,0.5-1.2,1-10,1-2,1.3-2.6,10-18,10-28,2-6,3.5-5.9,30-55,4-7,6-15,6.5-20,9-13,abaxially,acuminate,acute,adaxially,anther,apex,articulated,asymmetric,attenuate,axillary,base,basiscopic,blue,brownish,bud,cell,clavate,cm,condition,connivent,coriaceous,corolla,covering,deep,diameter,distal,drying,elliptic,forked,fresh,fruit,glabrescent,glabrous,globose,green,green-white,greenish,hair,hair-like,half,herb,high,interjected,lanceolate,lateral,leaf,leaflet,lengthening,light,lilac,make,mm,mucilaginous,odd-pinnate,ovate,ovoid,pedicel,peduncle,pentagonal,petiole,plant,pore,poricidal,purple,ripe,rounded,seed,semi-stellate,sessile,short,side,size,slit,stigma,straight,stripe,style,subtending,terminal,testal,thick,throughout,tip,tissue,tube,typically,wall,wet,white,whitish,x,yellow	0.7-1.1,1.7-2.2,12-27,13-30,2-8,2.4-5.9,3-6,3.4-4.8,5-7,5-merou,6-13,8-12,acumen,adaxiall,ag,alyx,apart,apparently,axe,berry,blade,capitat,dark,decreasing,decurrent,digestion,dorsally,eaf,edge,eed,enzyme,erec,exceeding,filament,finely,flat,flower,folded,geminat,generally,glabrou,gree,hal,homostylous,honeycomb-shaped,linear,living,lobe,long,lower,moderately,nflorescence,orbicular,orolla,pair,perfect,petiolulate,plurifoliate,puberulent,pubescent,removed,ruit,seudostipule,simple,slightly,spaced,specimen,stamen,subequal,tall,tamen,tem,toward,tri-,unit,unwinged,usually,vary,ympodial	age,arrangement,articulation,bark,calyx,capitate,color,connation,dehiscence,diminishing,form,fruiting,growth,height,history,inflorescence,length,life,na,ovary,papillae,petiolule,position,prickle,pseudostipule,shape,spacing,stem,straightnes,surface,texture,tuber-bearing,ye
93	wfo-0001026406	success	219	102	72	147	30	0.329	.5,0-5,0.5-1.5,1-2,12-19,2-6,2.5-8,20-60,3-10.5,5-25,acute,anther,apart,apex,articulated,bark,base,berry,calyx,cm,connivent,cordate,cream,curved,dark,diameter,distal,erect,flattened-reniform,fruit,fruiting,gently,glabrous,green,herb,lateral,leaf,length,lobed,long,marking,maturity,mauve,midvein,mm,obtuse,orange-brown,ovate,pale,pedicel,peduncle,petiole,plant,poricidal,prickle,purple,red-brown,reflexed,shrub,spherical,stem,straight,style,surface,tapering,terminal,tip,tube,velvety,white,yellow,young	-1,.2,0,0-3,0-30,0.3,0.3-0.5,0.3-0.7,0.4-0.8,0.4-0.9,0.5,0.5-2.5,0.8,00-200,1,1.3-1.5,1.5-2,1.5-5,1.8-2.4,1/,1/3,1/4,1/4-1/2,1/4-1/3,10-30,2-2.7,2-3,2.9-3.2,3-4,3.2-3.8,30-60,5,5-50,5-6,5-7,5-8,5-merous,6-12,6-15,6.5-7,7-10,7-8,7-9,9-15,abaxial,abaxially,adaxial,adaxially,alyx,ame,andromonoecious,apar,apically,apparently,blade,branched,broad-deltate,c.,chartaceous,conical,deltate,densely,dirty-whitish,discolorous,distance,drying,eaf,eed,elongated,elongating,equal,extending,filament,flattened,flower,foliaceous,free,fully,hermaphrodite,heterostylous,infructescence,least,lobe,lon,long-styled,longer,lower,lowermost,margin,mature,midpoint,moderately,nflorescence,oblong,older,one,open,opening,orolla,oung,pair,pendent,pendulous,per,pericarp,plurifoliat,porrect,portion,prickl,prickly,primary,ray,rounded,ruit,scar,sessile,short-styled,side,smooth,sometimes,spaced,sparsely,spreading,stalk,stalked,staminat,stellate,stellate-pubescent,stout,tamen,terete,tertiary,time,trichome,unit,upper,variously,vary,vein,venation,visible,way,weakly,wide,woody,yellow-brow,ympodial	arrangement,articulation,color,connation,corolla,dehiscence,diminishing,form,growth,height,history,inflorescence,interjected,leaflet,life,na,ovary,papillae,petiolule,position,pseudostipule,seed,shape,size,spacing,stigma,straightnes,texture,tuber-bearing,yellow-brown
94	wfo-0001026407	success	221	114	81	140	33	0.367	0.5-0.6,0.5-1,0.5-2,1-10,2-2.5,3.5,5,5-10,7-8,acute,anther,apart,apex,around,articulated,axi,base,becoming,berry,black,brown,brownish,calyx,capitate,chartaceous,cm,connivent,corolla,deep,diameter,ellipsoid,elliptic,flattened-reniform,fleshy,fruiting,globose,growth,inflorescence,internodal,lateral,lax,leaving,lobed,long,loosely,membranous,minutely,mm,narrowly,occasionally,pale,papillate,pedicel,peduncle,peg,persistent,petiole,pitted,poricidal,purple,purplish,reddish,shiny,short,shrub,simple,sleeve,slightly,small,stellate,stem,stigma,style,surface,terminal,tip,tube,vine,violet,woody,yellow	+,-11,-6,.5,/3,0.5,0.9-3,1,1-1.2,1.2-1.5,1.3,1.5-1.7,1.5-2,1.5-7,2.5-3,20-30,20-40,3.5-5.5,4-5,5-7,5-merou,7-10,abaxially,adaxially,ag,aid,along,always,alyx,anthesi,appearing,area,ark,basal,beneath,berr,blunt,branch,branched,broadly,cell,clear,climbin,congested,conical,deltate,dendritic,dense,densely,denser,discolorous,eaf,eed,entire,erect,evenly,exserted,filament,flower,free,geminat,glabrescen,glabrou,glabrous,golden,golden-pubescent,ilament,interpetalar,irregularly,lamina,leafy,lengthening,like,lobe,lower,many,margin,markedly,midvein,mixture,near,new,nflorescence,numerous,oblique,obscured,often,older,open,orolla,outline,pair,paler,papillat,pedice,pentagonal,per,perfect,pericarp,planar,plurifoliate,pore,portion,primary,pubescenc,pubescence,pubescent,revolute,ripe,ruit,scar,sinus,slit,spaced,sparsely,sparser,spreading,stiff,stout,strongly,tangled,tem,testal,thin,time,transition,trichome,truncate,twining,ud,undulate,unit,upper,usually,vary,vein,way,weak,x,ympodial	arrangement,articulation,bark,color,connation,dehiscence,diminishing,distal,form,fruit,glabrescent,height,history,interjected,leaf,leaflet,length,life,na,ovary,papillae,petiolule,plant,position,prickle,pseudostipule,seed,shape,size,spacing,straightnes,texture,tuber-bearing
95	wfo-0001026422	success	273	114	73	200	41	0.267	.0,3.5,6.8,8.4,acuminate,acute,alveolate,anther,apart,apex,apical,articulate,bark,base,calyx,capitate,chartaceous,cm,corolla,cream,darker,densely,diameter,distal,dry,elliptic,evenly,extra-axillary,flattened-irregular,flattened-reniform,flower,fruit,globose,gray-brown,green,immature,lanceolate,lateral,length,light,long,mature,minute,mm,moderately,observed,occasionally,pedicel,peduncle,petiole,pore,presumably,pubescent,red-brown,shrub,simple,sparsely,spreading,stellate,stem,stigma,straight,stripe,style,surface,tube,typically,unarmed,white,yellow,yellow-tan,yellowish-green,±congested	.04,.3,.6,.7,.9,/3,0.04,0.06,0.08,0.1–0.5,0.2,0.2–0.4,0.3–0.5,0.3–0.7,0.4–1.3,0.4–2.4,0.6–0.9,0.6–1.1,0.6–2.0,0.7–0.8,0.7–1.6,0.8,0.9–1.5,0.9–1.9,0.9–7.5,1.0,1.0–1.9,1.1–1.4,1.2–2.8,1.3–2.2,1.6–1.9,1.6–2.2,1.7–2.4,1.8–2.2,1.8–2.3,1/2–2/3,1/3,1/3–2/3,10,13.2–27.8,1–3,2.0–3.2,2.2–14.0,2.8–4.2,3.5–4.5,3.8–4.8,4.7,4–8,5-merou,5.0,5.8–7.4,5.8–8.3,56,5–7,6–8,7.6,7.7–9.2,7.8–26.9,abaxially,absent,adaxially,adnate,aequilateral,ag,alyx,anthesi,apiculate,apparently,appearing,appresse,around,attenuate,axe,ba,basal,becoming,bent,berry,blade,borne,branch,branching,broad,brochidodromous,bud,channeled,cuneate,deciduous,deltoid,dentate,development,difoliate,directed,distally,distinct,eaf,edge,eed,either,emerging,endocarp,entire,erect,especially,exocarp,extending,fertile,filament,filiform,free,geminat,glabrous,glandular,glossy,gradually,gree,hair,homostylous,increasing,individually,intact,internode,interpetalar,intersepalar,juic,layer,lobe,lon,longer,lower,many,many-flowered,margin,midpoint,midrib,midvein,much,nearly,nflorescence,oblique,oblong,orolla,ovate,ove,per,perforated,porrect,porrect-stellae,portion,potentially,pubescence,raised,ray,reflexed,remaining,rigid,rounded,row,ruit,scarcely,sessile,short-stipitate,side,sinuate,sinus,sloughing,smoot,soon,splitting,stamen,stellae,stellate-pubescent,stipe,suture,tamen,tardily,tem,thin,time,tip,tissue,translucent,transparent,truncate,two,ud,unbranched,upper,various,vary,vein,weakly,well-developed,wide,yellow-ferruginous,ympodia,young,±erect,×,–5	0.1-0.5,0.4-2.4,0.6-2.0,1.0-1.9,1.8-2.3,13.2-27.8,2.8-4.2,5.8-7.4,7.8-26.9,arrangement,articulation,color,connation,dehiscence,diminishing,form,fruiting,growth,height,history,inflorescence,interjected,leaf,leaflet,life,na,ovary,papillae,petiolule,plant,position,prickle,pseudostipule,seed,shape,size,spacing,straightnes,terminal,texture,tuber-bearing
96	wfo-0001026424	success	138	76	32	106	44	0.232	1-1.5,1.5-2,15,3-4,acuminate,acute,apex,base,bluntly,blush-violet,broadly,calyx,cm,corolla,cuneate,cyme,elliptic,glabrous,leaf,mm,oblique,obovate,pedicel,peduncle,petiole,pinnatisect,rotate-stellate,scorpioid,shrub,simple,stem,triangular	-25,-3.5,-4,0.75-1.5,1,1-,1-10,1-2,10,10-15,12-60,15-30,2,3-11,637/1,8-,acuman,acumen,age,angular,anthesi,aspect,axil,ba,becoming,blunt,broad,campanulate,cell,clonal,close,common,conspicuous,cut,dia,distinct,downard,eaf,ellipsoid,erect,exceeding,except,exerted,facetted,facing,floral,flower,fork,forked,general,glandular,gree,growing,hair,interacuminal,lacking,lanceolate,lanceolate-elliptic,larger,lasting,lavender,line,lobe,lobed,lon,long,lower,midvein,minute,nflorescence,often,part,pedicellate,plurifoliat,point,rachi,raised,rarely,rh,rounded,second,several,shallowly,short,sinus,slightly,soft-wooded,soon,stone,straggly,time,tip,tissue,toward,tub,ud,unit,unwinged,usually,violet,within,woody,x,year,ympodial,young	1-4,anther,arrangement,articulation,bark,color,connation,dehiscence,diameter,diminishing,distal,form,fruit,fruiting,growth,height,history,inflorescence,interjected,lateral,leaflet,length,life,na,ovary,papillae,perennial,petiolule,plant,position,prickle,pseudostipule,seed,shape,size,spacing,stigma,straightnes,style,surface,terminal,texture,tube,tuber-bearing
97	wfo-0001026440	success	181	119	85	96	34	0.47	1-5,1/2-2/3,14-30,3-7,3-8,4-12,7-14,9,abaxially,accrescent,acute,adaxially,along,anther,apex,articulated,bark,base,blunt-tipped,branched,broadly,brown,calyx,closely,cm,corolla,diameter,directed,distal,distally,elliptic,entire,flower,fruiting,globose,green,large,leaf,length,lengthening,long-attenuate,many,minutely,mm,multangulate-pubescent,nearly,oblong,obovate,obtuse,ovate,pale,pedicel,peduncle,petiole,pitted,plurifoliate,pore,poricidal,porrect-stellate,reniform,ripe,scabrous,short-acuminate,shrub,simple,size,slit,small,somewhat,spaced,sparse,stellate,stem,stigma,style,time,tip,tree,truncate,tube,turning,way,white,x,yellow	0-15,1.1-1.4,1.1-1.5,1.3-1.7,1.5-2.1,1.8-4.5,1.9-3.7,1/2,2-2.8,2-4,2.9-4.4,3-5,3.9-6.5,3/4,5-7,adaxiall,ag,always,anthesi,apparently,appressed,axillary,ba,basal,berry,blade,bract-like,branch,branche,capitat,chartaceous,conical,dendritic-echinoid,dense,developed,dichotomy,eaf,echinoi,echinoid,eed,filament,first,fleshy,free,granular,greenish-yellow,hair,high,included,inserted,lobe,lobed,long,lower,m.,margin,minute,mostly,multangulat,multangulate,nflorescence,obovoid-oblong,obscure,often,older,openly,orolla,pair,perfect,persistently,pubescen,rather,ruit,runk,semi-ovate,sessile,short-stalked,sometimes,stellate-pubescent,suture,tamen,terete,testa,thick,thin,tomentose,tomentose-pubescent,tomentum,translucent,ud,uneven,unit,usually,vary,ympodial,young	10-15,age,arrangement,articulation,capitate,color,connation,dehiscence,diminishing,form,fruit,growth,height,history,inflorescence,lateral,leaflet,life,na,ovary,papillae,petiolule,plant,position,prickle,seed,shape,spacing,specified,straightnes,surface,terminal,texture,tuber-bearing
98	wfo-0001026441	success	197	113	82	115	31	0.416	0-2,0.3-0.7,0.5-1.5,1-10,1-2,1.5-2.5,10,15-20,2-5.5,2-8,4-6,4.5-6.5,5,5-10.5,6-15,7-8,9-14,acuminate,anther,apex,articulated,base,berry,brownish,chartaceous,cm,condition,conical,connivent,corolla,diameter,distal,drying,elliptic-lanceolate,forked,fresh,fruit,glabrous,green,greenish,herb,interjected,lanceolate,lateral,leaf,leaflet,light,long,middle,minute,mm,mucilaginous,obtuse,odd-pinnate,ovoid,pale,pedicel,peduncle,petiole,petiolule,plant,poricidal,pubescent,ripe,rotate,rounded,seed,size,slightly,sparsely,stem,stigma,straight,style,terminal,tip,tube,violet,wet,whitish,x,yellow	.5,0.4-3,0.8,1-1.5,1.5-2,10-14,2-2.5,3-5,4-8,4-8.5,5-merou,7-20,abaxially,absent,acumen,adaxially,ag,alyx,apart,apparently,attenuate,axe,axillary,blade,bud,capitat,cell,ciliate,covering,decreasing,digestion,dorsally,eaf,edge,eed,end,enzyme,equal,erec,especially,exceeding,filament,flat,flower,folded,fourt,geminat,generally,glabrou,gradually,green-white,hair,hair-like,half,homostylous,honeycomb-shaped,internal,larger,lengthening,like,living,lobe,lower,make,margin,minutely,mottled,narrow,nflorescence,one,orbicular,orolla,ovate,pair,perfect,placed,plurifoliate,pore,puberulent,purple,removed,ruit,secondary,semierect,seudostipule,short,slit,spaced,specimen,stamen,star,ste,stolo,subequal,subsessile,subtending,symmetrical,tall,tamen,tem,testal,thick,throughout,toward,tri-,tuber,typically,unit,usually,vary,wall,white,wide,wing,ympodial	arrangement,articulation,bark,calyx,capitate,color,connation,dehiscence,diminishing,form,fourth,fruiting,growth,height,history,inflorescence,length,life,na,ovary,papillae,position,prickle,pseudostipule,shape,spacing,straightnes,surface,texture,true,tuber-bearing
99	wfo-0001026453	success	211	118	87	124	31	0.412	.5,0.1-2.7,0.45-5.5,0.5-1,0.8-1.1,1-2,1.9-21.3,15,4m,7-9,acuminate,acute,almost,anther,apart,apex,armed,articulated,attenuate,bark,base,berry,bright,brown,calyx,capitate,cm,corolla,diameter,distally,elliptic,flattened,fruiting,glabrescent,glabrous,globose,grayish,growth,inflorescence,lateral,leaf,length,linear,lobed,maturity,minutely,mm,narrowly,nearly,oblique,occasionally,opposite,pale,pedicel,peduncle,petiole,pitted,poricidal,porrect,prickle,red,reniform,rounded,scattered,sessile,shrub,simple,small,sometimes,stellate,stem,stigma,strongly,style,surface,tan,tapering,tip,tree,trichome,trunk,tube,unarmed,violet,white,x,yellowish	0.5,0.5-0.7,1,1-1.2,1-1.5,1.5-2,10-20,2,2-2.5,30,5-32,5.5-8,6-10,6-8,6376,<,abaxially,aberrant,absent,adaxial,adaxially,along,anthesi,axi,basal,based,beneath,bent,branched,broad,cell,conical,deflexed,deltate-triangular,dense,densely,denser,directed,distall,eaf,easily,eed,enlarged,enmeshing,entire,equal,evenly,exceeding,exserted,filament,filiform,flower,free,hanging,howard,internode,irregularly,lamina,lengthening,less,like,lobe,long,lower,margin,midpoint,midrib,midvein,new,nflorescence,often,older,one,open,orange,outline,pair,papillo,parallel,per,perfect,pericarp,plurifoliat,pore,portion,primary,pubescence,pubescent,ray,reddish,rest,ruit,scar,shallowly,shiny,shorter,side,sinuate,slightly,slit,smaller,somewhat,sorter,spaced,sparse,sparsely,sparser,spreading,straight,surfac,tangled,testal,thin,time,triangular,ud,unit,upper,usually,vein,visible,weak,within,ympodial	arrangement,articulation,color,connation,dehiscence,diminishing,distal,form,fruit,height,history,interjected,leaflet,life,na,ovary,papillae,papillose,petiolule,plant,position,present,pseudostipule,seed,shape,size,spacing,straightnes,terminal,texture,tuber-bearing
100	wfo-0001026460	success	131	88	50	81	38	0.382	0.5-1.5,1-1.5,5,6-7,acute-acuminate,anther,apex,base,brown,calyx,capitate,closely,cm,completely,conical,corolla,dark,deflexed,distal,elliptic,erect,fruiting,glabrous,globose,green,greenish,inflorescence,leaf,lobed,long,minutely,mm,opposite,ovary,ovoid-reniform,papillose,pedicel,pitted,poricidal,shrub,simple,spaced,stem,stigma,style,subshrub,surface,tube,white,yellow	.1,.5,1.5-2,1/2,10-15,13.5-21,2-2.5,2.5-3,4.5-5,513,6-9,7-9,8-10,abaxially,acut,adaxially,anthesi,axi,becoming,berry,branched,deltate,dia,do,drying,eaf,edicel,eed,fide,filament,filiform,floccose,flower,free,frui,inflorescenc,internodal,less,like,lobe,long-exserted,lower,major,membraneous,middle,nearly,nflorescence,often,older,pair,pale,papillo,pore,portion,puberulent,reddish,reddish-brow,reflexed,ruit,santo,scar,shaped,slightly,somewhat,soon,tall,tapering,tear-drop,tiny,tip,trichome,tub,ud,unifoliat,unit,vein,widest,woody,x,ympodial,young	acute,arrangement,articulation,bark,color,connation,dehiscence,diameter,diminishing,form,fruit,growth,height,history,interjected,lateral,leaflet,length,life,na,papillae,peduncle,petiole,petiolule,plant,position,prickle,pseudostipule,reddish-brown,seed,shape,size,spacing,straightnes,terminal,texture,tuber-bearing,unifoliate
101	wfo-0001026485	success	188	111	78	110	33	0.415	-35,.25,0.25-1,1-10,1-2,1-4,1.5-5,2-3,20-30,3-25,3-4,3-6,3.5-7,4-9,5-20,abaxially,acute,adaxially,anther,apart,apex,articulated,attenuate,base,bright,brown,calyx,cm,compound,connivent,diameter,elliptic,flattened,flower,forked,foveolate,fruit,fruiting,glabrous,globose,greenish-white,inflorescence,lateral,leaf,leaflet,light,long-attenuate,midvein,mm,oblique,obovoid,opposite,orange,ovate,pair,pedicel,peduncle,perennial,petiole,plant,prickle,puberulent,pyriform,rarely,recurved,simple,slightly,stellate,stigma,straight,strongly,style,surface,truncate,tube,unbranched,x,yellow	-1.5,-22,1-2.5,1.5,10-20,10-25,2,2-4,2-6,2.3-5,2.5-5,20-40,20-50,3-7,4.5-9,45,5-7,5-merou,6-10,6-9,7-15,abaxiall,absen,accrescen,aggregate,alyx,andromonoecious,appearing,armed,axe,blade,broadly,chartaceous,congested,cylindrical,developing,difoliate,directed,distall,dr.,eaf,eed,elongating,entire,even,fertile,filament,geminat,glabrou,heterostylous,hollow,imparipinnate,internode,lanceolate,leaving,like,lobe,long,lower,lowermost,major,margin,narrowly,nearly,nflorescence,occasionally,one,orolla,per,pore,pubescent,rachi,recurve,reflexed,ripe,robust,rugose,ruit,scandent,scar,side,small,sometimes,spaced,sparsely,speciman,spreading,subcoriaceous,subopposite,swollen,tamen,tapering,tem,thickened,time,tip,tissue,tone-cell,toward,triangular,trichome,truncat,unit,usually,vary,vein,vin,wide,winged,ympodial	accrescent,arrangement,articulation,bark,color,connation,corolla,dehiscence,diminishing,distal,form,growth,height,history,interjected,length,life,na,ovary,papillae,petiolule,position,pseudostipule,seed,shape,size,spacing,stem,straightnes,terminal,texture,tuber-bearing,vine
102	wfo-0001026489	success	153	94	59	94	35	0.386	0.5-2,0.8-1.3,1.5-5,2-5,2/3,5-6,acute,anther,apex,area,bark,base,beneath,broadly,brown,calyx,closely,cm,corolla,cup-shaped,dark,elliptic,flattened-reniform,fruiting,glabrous,globose,green,lateral,leaf,lobed,minutely,mm,opposite,ovary,paler,pedicel,petiole,pitted,poricidal,pubescent,shaped,shiny,shrub,simple,size,spaced,stem,stigma,straight,style,surface,tear-drop,terminal,tip,tube,way,white,whitish,widened	.3,0.05-0.1,0.25-0.5,0.5,0.5-0.75,0.5-1,0.6-1.4,0.8-1.2,0.8-3.7,1-1.5,1.3-3,2-3,2-4,2-8-flowered,2.5-13,2.5-4,8-13,along,anthesi,appearing,axil,ba,berry,branched,deflexed,deltoid,densely,dia,differing,difoliate,dry,eaf,edicel,eed,erect,exserted,extending,filament,flattened,fleshy,free,geminat,gra,incrassate,lamina,later,lobe,lon,long,lower,main,major,margin,middle,minor,nflorescence,occasionally,often,older,one,overlappin,pair,papillo,papillose,parallel,perpendicular,planar,pore,portion,prominent,red-papillose,rhachi,ruit,scar,slender,somewhat,soon,specimen,strongly,tall,tapering,thickened,trichome,tub,ud,uniseriate,unit,usually,vein,widest,woody,x,ympodial,young	alternate,arrangement,articulation,color,connation,dehiscence,diameter,diminishing,distal,form,fruit,gray,growth,height,history,inflorescence,interjected,leaflet,length,life,na,overlapping,papillae,peduncle,petiolule,plant,position,prickle,pseudostipule,seed,shape,spacing,straightnes,texture,tuber-bearing
103	wfo-0001026490	success	272	150	126	146	24	0.463	0.1–0.2,0.1–2.5,0.2–1.5,0.3–3.5,0.5–1,0.5–1.5,0.7–3,1.2–8,1.5–3.5,10–20,1–2.5,1–3,2,3,4–5,5–7,6,7-pinnate,7–15,absent,accrescent,acuminate,acute,anther,apart,apex,articulated,axillary,base,branched,brown,calyx,chartaceous,cm,connivent,contiguously,corolla,cylindrical,darker,densely,diameter,distal,ellipsoidal,elliptic,extra-axillary,flattened,flower,fruit,fruiting,glabrous,green,immature,incurved,inflorescence,interjected,lacking,lateral,latrorse-introrse,leaf,leaflet,length,lenticular,light,long,longitudinal,lower,main,mature,medium,middle,mm,moderately,mottled,nearly,oblique,obliquely,oblong,obtuse,obtusely,opening,orange,ovate,papillose,pedicel,peduncle,pentagonal,petiole,petiolule,pointed,present,pseudostipule,pubescent,rounded,seed,shape,shoot,short,simple,size,slender,slightly,slit,smooth,sometimes,sparsely,spur,stem,stigma,striping,style,surface,teardrop-shaped,terminal,trailing,trichome,truncate,tube,vine,violet,white,yellow,½,×,–4,–4.5,–9.5	.5,0.2–1,0.4–0.8,0.5–3.5,0.5–8,0.8–1.5,0.8–12,1.5,1.5–2,1.5–5,1.8–2.2,1.9,1–1.2,1–15,1–8,2.5–3.5,2–2.5,2–4,2–6,2–8,3–4.2,3–4.5,3–5,3–5-pinnate,3–8,4.6,4–4.5,5-merous,7,=,[,],abaxially,adaxially,ag,along,alyx,anthesi,apical,apicall,apparently,around,axe,ba,becoming,blade,bract,bracteate,broadly,capitat,cauline,ciliate,climbing,commonly,completely,cordate,covered,crisped,decreasing,directed,distally,eaf,eed,eglandular,entire,equal,exceeding,expanded,filament,flat,free,fused,geminat,ground,irregularly,large,lobe,lobed,lowermost,lunate,margin,markedly,match,mean,mean=,midvein,minute,multicellular,near,nflorescence,node,obliqu,oblon,occasionally,one,orolla,ovate-lanceolate,pair,part,per,perfec,perfect,plurifoliate,pore,pubescen,pubescence,punctate,pur,rachi,radial,reflexed,reniform,resulting,revolute,rooting,ruit,sand,seudostipule,shorter,similar,smaller,somewhat,spaced,stamen,striation,strongly,tamen,tawny,tem,thickened,tip,toward,transparent,trichomessympodial,typically,unbranched,undulate,unit,vary,vegetation,wide,wing,woody,yellowish-tan,youn,–8	age,arrangement,articulation,bark,capitate,color,connation,dehiscence,diminishing,form,growth,height,history,life,na,ovary,papillae,plant,position,prickle,spacing,straightnes,texture,tuber-bearing
104	wfo-0001026491	success	165	122	79	86	43	0.479	.5,1-2,1.5-3.5,1.7,2-4,3,3-pinnate,5-6,5-8,6-8,abaxially,absent,acuminate,acute,adaxially,anther,apex,articulated,base,bent,branched,broadly,cellular-papillose,cm,connivent,cuneate,deep,diameter,elliptic-lanceolate,flower,globose,greatly,green,highly,inflorescence,interjected,lanceolate,lateral,leaf,leaflet,light,middle,minutely,mm,near,oblong-elliptic,often,ovate-elliptic,ovoid,pale,pedicel,peduncle,petiole,poricidal,pubescent,purple,reduced,rotate-pentagonal,rotate-substellate,rounded,shortly,shrub,simple,slender,spotted,stigma,strigose,strong,strongly,suborbicular-ovate,surface,terminal,tightly,tip,tube,usually,white,x,yellow	1,1.5-2,1.5-2.5,10-50,1977,2-3,2-celled,2.5-3.5,5-merou,7-8,abaxiall,alyx,anderson,apparently,appressed,averaging,axe,ba,bayonet,berry,blade,bract,branching,capitat,cellular-pilose,central,conspicuously,crinkly,deciduous,deltoid,densely,directed,distall,eaf,eed,entire,equal,filament,first,geminat,glistening,growing,hair,homostylous,less,lobe,long,lower,lunulat,margin,mean,nflorescence,obtuse,orolla,ovate,perfect,pilose,plurifoliate,point,pore,porrect-incurved,present,rachi,rarely,readily,row,ruit,scandent,seudostipule,sharp,similar,small,straight,strigo,subacute,tal,tamen,tawny,tem,tyle,uniseriate,unit,upright,ventral,whitish,ympodial	23,arrangement,articulation,average,bark,calyx,capitate,color,connation,corolla,dehiscence,diminishing,distal,distally,form,fruit,fruiting,growth,height,history,length,life,lunulate,na,number,ovary,papillae,per,perennial,petiolule,plant,position,prickle,pseudostipule,seed,shape,size,spacing,stem,straightnes,style,texture,tuber-bearing
105	wfo-0001026501	success	195	108	77	118	31	0.395	.6,/3,0-1,0-2,0.2-1.8,0.27-0.7,0.5-0.9,0.5-1,1-2.5,2.5-4,3-9,4-5,?,acute,almost,anther,apart,apex,articulated,bark,base,berry,brown,calyx,cm,color,cuneate,curved,densely,diameter,dull,elliptic,elongating,filiform,flattened-reniform,fruit,fruiting,glabrous,gray,green,leaf,length,lobed,long,mauve,mm,orange-brown,orbicular,ovate,pale,pedicel,peduncle,petiole,poricidal,prickle,reddish,rounded,scandent,shoot,short,shrub,simple,spherical,spreading,stellate-pubescent,stem,straight,style,surface,tapering,terminal,tip,tube,way,white,wide,yellow	-1.7,-3,.1,.35,.5,.7,0,0.05-0.3,0.1,0.5,0.5-0.6,0.6-1,0.6-1.1,0.6-2,0.9-2.2,1,1-2,1.8-2.2,1/2-2/3,1/4,1/6-1/2,2-10,2.8-3,3-4,3-5,3.5-4,4-7,5-merous,6-9,7-9,abaxially,acicular,alyx,apar,apically,apparently,becoming,blade,borne,branched,brown-green,chartaceous,concolorous,deltate,discolorous,drying,eaf,eed,elongated,entire,equal,erect,eye,filament,filiform-acuminat,flattened,flower,free,glabrou,infructescence,known,light,lobe,longer,lower,margin,mature,midpoint,moderately,naked,nflorescence,often,older,one,open,orolla,oung,pair,pendulous,per,perfec,pericarp,plurifoliat,porrect,portion,prickl,prickly,primary,ray,ruit,scar,sessile,shorter,slender,small,smooth,sometimes,somewhat,spaced,sparsely,stalk,stalked,stellate,subsessile,tamen,terete,time,trichome,unarme,unarmed,unit,upper,variously,vary,vein,visible,yellow-green,ympodial	arrangement,articulation,connation,corolla,dehiscence,diminishing,distal,form,growth,height,history,inflorescence,interjected,lateral,leaflet,life,na,ovary,papillae,petiolule,plant,position,pseudostipule,seed,shape,size,spacing,stigma,straightnes,texture,tuber-bearing
106	wfo-0001026503	success	269	110	78	191	32	0.29	0.3–,0.7–3.7,0.8–1.1,0.8–3.5,1.0–3.5,1.1–1.4,1.4–1.7,1.5–2.0,2.2–6.3,3,3.0–4.5,5.0,8.2,acuminate,anther,apart,apex,articulate,attachment,bark,base,brown,calyx,capitate,central,chartaceous,cm,corolla,depression,diameter,distal,dry,extra-axillary,flattened-orbicular,flattened-reniform,flower,fruit,glabrous,globose,green,lanceolate,lateral,leaf,long,margin,mature,mm,notched,oblong,ovate,pale,pedicel,peduncle,petiole,point,portion,red,red-brown,reddish,rotate-stellate,shallow,shrub,simple,small,spreading,stem,stigma,style,surface,tree,tube,unarmed,white,yellow,yellow-tan,yellowish,±smooth,±straight	.3,.5,.6,.9,0.03,0.3–0.6,0.4–1.2,0.6–0.7,0.6–1.0,0.7,0.8–1.7,1.0–1.5,1.0–1.6,1.3,1.3–1.6,1.3–3.7,1.4–2.3,1.5–1.8,1.5–2.5,1.7,1.9–5.5,1/3,1/3–1/2,1/4–1/3,2.2–2.5,2.2–2.8,2.3–2.6,2.6–2.9,22,2–3,4.0–12.0,4.7,4.8,4.9–5.8,5,5-merou,6.0,6.9–10.3,7–10,9.0–1.0,90°,abaxially,acute,adaxially,adnate,aequilateral,ag,always,alyx,anthesi,apical,apiculate,apparently,appearing,arching,around,attenuate,axe,ba,becoming,bent,berry,blade,branch,branching,brochidodromous,bud,channeled,deltoid,dentate,developed,development,difoliate,directed,distally,eaf,edge,eed,eglandular,either,emerging,endocarp,entire,exocarp,extending,fertile,filament,filiform,flattened,flexed,free,geminat,glabrou,glandular,glossy,gradually,gree,hair,homostylous,increasing,intact,internode,interpetalar,intersepalar,irregularly,juic,lackin,lacking,layer,lobe,lon,lower,lying,major,many,midrib,midvein,minor,minute,moderate,moderately,near,nearly,nflorescence,oblique,obviously,ocasionally,occasionally,opaque,orolla,outline,oval,per,perforated,pore,potentially,present,pubescence,pubescent,raised,reflexe,remaining,rigid,rounded,row,ruit,scarcely,scattered,short,shortly,side,sinuate,sinus,slightly,sloughing,smoot,spaced,sparse,sparsely,splitting,spread,stamen,stellate,stipitate,straight,subacute,suture,tamen,tem,thin,though,time,tip,tissue,transparent,truncate,two,ud,upper,usually,vary,vein,weakly,well,wide,without,yellow-ferruginous,ympodia,young,±equal,×	arrangement,articulation,color,connation,dehiscence,diminishing,form,fruiting,growth,height,history,inflorescence,interjected,leaflet,length,life,na,ovary,papillae,petiolule,plant,position,prickle,pseudostipule,seed,shape,size,spacing,straightnes,terminal,texture,tuber-bearing
107	wfo-0001026513	success	138	91	55	83	36	0.399	.25,/3,0.8-2,1-3,3-5,6-8,acute,anther,apex,area,bark,base,calyx,closely,cm,corolla,deflexed,elliptic,fruit,fruiting,glabrous,globose,green,lanceolate,lateral,leaf,lobed,long-styled,minute,mm,opposite,ovary,papillose,pedicel,petiole,plant,poricidal,shaped,short-styled,shrub,simple,slender,small,spaced,stem,stigma,straight,style,surface,tear-drop,tip,treelet,tube,way,white	.1,.3,.75,1-1.5,2-2.2,2-5,3-6-flowered,4-5,7-9,8-16,anthesi,apiculate,ba,berry,broadly,caly,completely,darkish,decurrent,delicate,deltoid,dia,differentiated,dry,eaf,edicel,eed,erect,except,exserted,filament,flower,free,gre,hirsute,immature,known,leave,less,live,lobe,long,longer,lower,main,mature,middle,minutely,much,nflorescence,obscure,older,overlappin,pair,pale,pore,portion,prominent,raised,reflexed,rest,ruit,scar,shiny,somewhat,soon,specimen,styl,tall,trichome,ud,undersurface,unifoliat,uniseriate,unit,vein,venation,wide,widest,woody,x,ympodial,young	arrangement,articulation,color,connation,dehiscence,diameter,diminishing,distal,form,grey,growth,height,history,inflorescence,interjected,leaflet,length,life,na,overlapping,papillae,peduncle,perennial,petiolule,position,prickle,pseudostipule,seed,shape,size,spacing,straightnes,terminal,texture,tuber-bearing,unifoliate
108	wfo-0001026529	success	219	143	113	106	30	0.516	0-25,0.3-1,0.5-4.5,1-10,1-2,1-4.5,1.5-4,10,11-14,12-22,2-7.5,3-12,3-5,3-9.5,5-15,5-17,acuminate,anther,apex,articulated,axillary,base,blue,brownish,bud,cell,chartaceous,clavate,cm,condition,connivent,cordate,corolla,covering,creamy,dark,deep,diameter,distal,dot,drying,elliptic,faintly,forked,fresh,fruit,globose,greatly,green,green-white,greenish,hair-like,half,herb,interjected,lanceolate,lateral,leaflet,length,lengthening,lilac,long,lunate,make,medium,membranous,mm,mucilaginous,oblique,odd-pinnate,often,ovate,ovoid,pedicel,peduncle,pentagonal,petiole,petiolule,plant,pore,poricidal,pure,rarely,ripe,rounded,scattered,seed,shape,size,slightly,slit,stem,stigma,straight,style,subequal,substellate,subtending,terminal,testal,thick,throughout,tip,tube,typically,varying,wall,wet,white,whitish,x,yellow,yellowish	1,1-3,1.1-2.5,1.5-2.5,10-28,120-210,2,2-5,20-60,3-6,4-8,5-9,5-merou,50-70,6-20,600-950,?,abaxially,acumen,acute,adaxially,ag,along,alyx,apart,apparently,attenuate,axe,berry,blade,broadly,capitat,ciliate,densely,digestion,dorsally,eaf,edge,eed,enzyme,erec,especially,exceeding,except,filament,flat,flower,folded,geminat,generally,glabrou,glabrous,gland,glandular,gree,hair,hal,head,homostylous,honeycomb-shaped,light,like,living,lobe,longer,lower,margin,midrib,minutely,moderately,narrowly,nflorescence,non-glandular,orbicular,orolla,pair,perfect,petiolulate,plurifoliate,proximal,puberulent,pubescent,reduced,removed,ruit,sessile,seudostipule,short,spaced,specimen,stamen,ste,subsessile,tall,tamen,tem,tetralobulate,tri-,trichome,unit,unwinged,usually,vary,wide,wing,ympodial	age,arrangement,articulation,bark,calyx,capitate,color,connation,dehiscence,diminishing,form,fruiting,growth,height,history,inflorescence,leaf,life,na,ovary,papillae,position,prickle,pseudostipule,spacing,straightnes,surface,texture,tuber-bearing,ye
109	wfo-0001026534	success	150	87	46	104	41	0.307	1.5-9,10-20,2-3,2-7,2.5-15,3-10,3-25,3-5,5-6,acuminate,apex,articulated,auriculate,base,calyx,chartaceous,cm,connivent,cordate,densely,diameter,ellipsoidal,flattened,fruit,lanceolate,mm,orange,ovate,ovoid,pale,pedicel,peduncle,petiole,pinkish,pubescent,purple,red,simple,stellate,stigma,style,tree,truncate,tube,white,yellow	-1.5,0.5-1,1-2,1-2.5,1-3,1.5-6,10-15,10-50,15-50,2-2.5,2-8,2.5-4,3-,3-4,3.5-4,4-10,4-foliat,4.5-5,6-35,7-12,7-40,abaxially,absent,acute,adaxially,aggregate,apart,ape,apiculate,axe,basal,beyond,blade,branched,bright,cell,connective,cylindrical,darker,deltate,directed,distally,eaf,eed,eglandular,entire,equal,exserted,fleshy,flower,glabrous,glandular,hair,leaving,lemon-yello,lobe,lon,long,longitudinal,lower,m.,margin,moderately,narrowly,nflorescence,nther,obtuse,often,orolla,pedicellar,perfect,pore,presen,puberulen,puberulent,rachi,radiu,remnant,ruit,shorter,slightly,small,spaced,sparsely,stamen,stone,stripe,subcoriaceous,tal,tem,thecae,time,tip,tomento,triangular,truncat,ud,unbranched,unit,vary,vein,wide,x,ympodial	anther,arrangement,articulation,bark,color,connation,corolla,dehiscence,diminishing,distal,form,fruiting,growth,height,history,inflorescence,interjected,lateral,leaf,leaflet,length,life,na,ovary,papillae,perennial,petiolule,plant,position,prickle,pseudostipule,seed,shape,size,spacing,stem,straightnes,surface,terminal,texture,tuber-bearing
110	wfo-0001026535	success	248	110	78	170	32	0.315	0-0.5,0.7-1.5,1/2-2/3,2-3,2-5,3-5,7-8,accrescent,almost,along,anther,anthesi,apex,bark,base,berry,black,brachyblast,branch,branched,broadly,brown,calyx,chartaceous,clavate,clustered,cm,condensed,corolla,dark,developed,diameter,distributed,dorsal,drying,elliptic,elongated,evenly,fruit,fruiting,leaf,length,liana,lobed,membranous,mm,oblong,obovate,older,orange-brown,ovate,ovoid,partly,pedicel,peduncle,petiole,plant,poricidal,rarely,short,shrub,side,slightly,smooth,sparsely,stem,stigma,style,surface,terminal,tip,tube,unarmed,violet,white,widely,yellowish,young	.1,.2,.4,.5,.8,0.1-0.2,0.15,0.2,0.2-0.3,0.2-1.5,0.5-1,1,1-2,1-3,1-5,1.2-2,1.3,1.5-2,1.5-3,1/3,2.5,3,3-4.5,3.5-4,4-15,5-10,5-7,5°,abaxial,abaxially,absent,acute,adaxially,age,alternate,alyx,apar,apically,apparently,area,around,articulated,becoming,branching,clearly,concolorous,conical,cuneate,cup,cupular,curved,deeply,delineate,delineated,deltoid,dendritic,dendritic-pubescent,dense,detaching,developing,dilated,discolorous,divided,domatia,dry,eaf,eed,ellipsoi,entire,equal,except,eye,fertilisation,filament,fine,flat,flexuous,flower,forming,free,frui,glabrous,green-brown,increasing,inside,known,leave,lengthening,like,linear,lobe,lon,long,loop,loose,lower,m.,main,margin,marginal,midvein,minute,minutely,mostly,much,naked,network,nflorescence,nther,number,obscure,orolla,outside,pair,papillo,pendulous,perfec,pericarp,plurifoliat,pointed,pore,portion,primary,prominent,protruding,pubescent,rachi,raised,ray,reaching,ridged,rounded,ruit,scar,secondary,see,simple,sinus,slender,smaller,soon,spaced,spreading,stump,tearing,terete,tertiary,thin,tissue,toward,translucent,trichome,truncate,tufted,two,ud,uneven,unevenly,unit,unlignified,vary,vein,venation,visible,weakly,wide,wider,x,ympodial,youngest	0-2.5,1.5,arrangement,articulation,color,connation,dehiscence,diminishing,distal,form,growth,height,history,inflorescence,interjected,lateral,leaflet,life,na,ovary,papillae,petiolule,position,prickle,pseudostipule,seed,shape,size,spacing,straightnes,texture,tuber-bearing
111	wfo-0001026538	success	226	123	91	135	32	0.403	-5.8,0.1-0.3,0.8-2.2,1-3,1.2-2.6,1.4-2.6,2-5,3.2-4.8,3.5-4.6,3.5-5.8,5,6-13,6.7-,8.1-14.8,abaxially,accrescent,acuminate,acute,adaxially,along,anther,apart,apex,articulated,bark,base,black,branched,broadly,brown,brown-black,calyx,cm,constricted,corolla,decurrent,deltoid,diameter,drying,elliptic,entire,flower,fruit,fruiting,globose,gray,green,lanceolate,lateral,leaf,length,long-attenuate,many,mm,nearly,obovate,occasionally,ovate,ovate-lanceolate,pale,pedicel,peduncle,petiole,poricidal,porrect-stellate,pseudo-terminal,pubescent,reticulate-punctate,scabridulous,short,shrub,simple,slightly,small,sometimes,somewhat,stellate,stem,stigma,style,suborbicular,surface,time,tip,tree,tube,white,x,yellow,yellowish,yellowish-tan	-3.5,.5-3,/15-1/9,0-160,0.3-1.5,0.4-,0.6-0.8,0.8-1.2,0.8-1.5,0.9-1.2,1-1.9,1-2.5,1.2-1.4,1.2-1.5,1.3-2.8,1.4-3,1.5-2.5mm,1.7-2.5,1.8-4.6,1/2,12-21.5,2-3.5,2.1-3.2,2.1-3.4,3-4,3.7-5.8,4-8,6.3-8.9,8-10,[,],adaxiall,ag,anthesi,apparently,appearing,around,axe,axillary,ba,berry,blade,blunt-tipped,branch,bud,capitat,chartaceous,closely,completely,covering,cylindrical,dense,densely,directed,distally,due,eaf,edge,eed,enveloping,exserted,farinose,filament,fleshy,free,frui,glabrescen,glabrou,glabrous,hair,inserted,lackin,lengthening,lobe,lobed,long,long-stalked,longer,longitudinal,lower,main,margin,measured,midrib,mixed,mostly,multangulate,nflorescence,obscured,obtuse,older,orolla,overlapping,perfect,plurifoliate,pore,porrect-stellat,pubescence,rachi,rarely,rather,ruit,runk,semi-ovate,sessile,short-stalked,side,slit,soon,spaced,stamen,subcampanulate,subconical,suture,tall,tamen,terete,thick,thickened,thin-textured,tomentose-pubescent,tomentu,touching,ud,unarme,unarmed,unit,usually,vary,vein,way,weakly,wide,ympodial,young	arrangement,articulation,capitate,color,connation,dehiscence,diminishing,distal,form,growth,height,history,inflorescence,interjected,leaflet,life,na,ovary,papillae,petiolule,plant,position,prickle,pseudostipule,seed,shape,size,spacing,straightnes,terminal,texture,tuber-bearing
112	wfo-0001026539	success	194	94	58	136	36	0.299	0,abaxially,absent,acuminate,acute,adaxially,anther,apex,articulated,base,branched,brown,calyx,campanulate,clustered,cm,connivent,corolla,creamy,diameter,equal,flattened-reniform,fruit,globose,growth,height,lance-elliptic,lateral,leaf,long-attenuate,minutely,mm,nearly,oblanceolate,orange,pedicel,peduncle,perennial,petiole,pilosulose,pitted,poricidal,present,prickle,red,stellate,stem,stigma,straight,strongly,style,surface,terminal,tip,tube,vine,white,yellow	-6,.5,0.2,0.25,0.3-0.5,0.5,0.9,1,1-1.5,1-2-celled,1.5–2,10–15,10–28,15–20,1–2,2,2-4-celled,2.5,2.5–4,20,20–35,2–2.5,2–3,2–4,2–5,3,30,3–5,4–6,5,5.5,5–,5–10,6–15,ag,always,alyx,anthesi,apiculate,approximately,armed,axe,ba,basal,becoming,berry,blade,broadly,bud,capitat,cell,chartaceous,cucullate,deltate,densely,dr.,eaf,early,eed,ellipsoid,elongate,elongating,entire,exserted,filament,flower,four,glabrou,glabrous,hair,hooked,ine,interpetalar,larger,lengthening,lobe,lobed,long,long-styled,longer,lower,major,margin,midrib,narrowly,nflorescence,occasionally,often,one,orolla,pair,pericarp,pointed,pore,puberulent,pubescent,pustulate,rachi,recurve,recurved,robust,rounded,rugose,ruit,sessil,shallow,shoot,short,side,simple,sinuate,slender,slightly,slit,somewhat,spreading,staman,stout,subwoody,tamen,tapering,terminally,time,tissue,triangular,trichome,tub,unequal,usually,vary,vein,wide,winged,woody,young,×	0.25-0.9,10-15,2-4,30-20,6-15,arrangement,articulation,bark,capitate,color,connation,dehiscence,diminishing,distal,form,fruiting,history,inflorescence,interjected,leaflet,length,life,na,ovary,papillae,petiolule,plant,position,pseudostipule,seed,shape,size,spacing,straightnes,texture,tuber-bearing
113	wfo-0001026604	success	192	114	86	106	28	0.448	0.8-0.9,1.2-1.7,1.5-9,10-30,2-2.5,2.3-3.5,3.5-4,acuminate,age,along,anther,apart,apex,articulated,articulation,bark,base,berry,brown,c.,calyx,capitate,clearly,cm,cordate,corolla,dark,diameter,differentiated,distal,ellipsoid,expanding,flattened,fruit,fruiting,glabrous,globose,growth,leaf-opposed,lengthening,liana,lobed,midrib,minute,minutely,mm,narrowly,oblique,ovary,ovate,ovoid,pale,papillose,pedicel,peduncle,petiole,pitted,point,pore,poricidal,purple,quarter,red,reddish,reniform,ripe,shape,shrub,simple,slit,stellate,stem,stigma,stout,style,surface,terminal,tip,trichome,truncate,tube,uniseriate,vining,violet,way,woody	.4,.5,.75,0,0.1,0.4-0.6,0.8-1,1-1.2,1.1-1.3,1.5-2,2-2.3,3-3.5,3-5,4-4.5,4.5-7,5,5-7,50-100,<,?,absent,aid,always,anthesi,appearing,atop,basal,branching,brow,cell,climbing,comical,conical,cucullate,cupped,deflexed,densely,distinct,drying,due,eaf,eed,elongate,entire,exserted,filament,flexuous,flower,free,inflated,later,leaving,lobe,lower,margin,mere,new,nflorescence,nodding,occasionally,older,outline,overall,pair,papillo,part,particularly,peg,per,perfect,pericarp,planar,plurifoliat,poin,portion,primary,pubescent,receptacle-like,rim,ruit,scar,series,shiny,sinuate,slender,slightly,somewhat,spaced,strongly,structure,support,swolle,testal,thin,time,tub,twisting,ud,undulation,unit,upper,vein,widely,x,ympodial,½	arrangement,color,connation,dehiscence,diminishing,form,height,history,inflorescence,interjected,lateral,leaf,leaflet,length,life,na,papillae,petiolule,plant,position,prickle,pseudostipule,seed,size,spacing,straightnes,texture,tuber-bearing
114	wfo-0001026606	success	213	107	62	151	45	0.291	0.4-0.8,0.5-1.6,2.4-3.6,3-4.6,3-6,5.8-7.2,acute,apart,apex,articulated,asymmetric,asymmetrically,base,berry,black,branched,broadly,cm,cordate,diameter,extra-axillary,flower,fruit,glabrate,globose,golden,lanceolate,lateral,lenticular,linear,minutely,mm,obtuse,ovate,pedicel,peduncle,pentagonal,petiole,pitted,present,prickle,puberulent,ripe,scabrous,shrub,simple,small,stellate,stelliform,stem,stigma,style,surface,tan,tree,truncate,tube,weakly,white,wider,x,yellow	0.5–0.8,1.3-1.9,1.4-2.1,1.7-2.1,10–20,12-17,12.5-22.5,15–20,15–25,1–1.5,1–3,2-3,2–2.5,2–4,3–10,3–4,3–5,3–6,4.2-5.2,4–20,4–7,5-merou,5–15,6–7,6–8,7.3-9.7,7–12,8–10,abaxial,abaxiall,abaxially,absent,adaxial,adaxially,almost,along,alyx,an¬ther,apiculate,apparently,armed,axe,ba,band,based,blade,blunt-tipped,broad,capitat,central,chartaceous,closely,coarsely,compressed,concentrated,cylindrical,densely,developed,difoliate,directed,distally,eaf,eed,entire,eventually,expanded,filament,forming,geminat,glabrou,glabrous,hair,homostylous,initially,internode,interpetalar,larger,laterally,lighter,lobe,lon,long,low,lower,main,margin,midpoint,midvein,moderately,much,nearly,nerve,nflorescence,obsolete,occasionally,often,of¬ten,older,open,orolla,perfect,peripherally,persistently,pore,prickly,pubescen,pubescence,pubescent,rachi,rarely,ray,rayed,recurved,reduced,rounded,ruit,scar,scattered,sessile,short,shortly,slightly,sometimes,spaced,sparingly,sparsely,spreading,stellae,stellate-pubescent,stout,subentire,tall,tamen,tapering,tem,thick,thickened,three,tissue,toothed,unarmed,usually,vary,vein,warty,wide,widely,woolly,yello,ympodia,young	0.5-0.8,1-3,15-20,3-10,4-20,7-12,8-10,anther,arrangement,articulation,bark,calyx,capitate,color,connation,corolla,dehiscence,diminishing,distal,form,fruiting,growth,height,history,inflorescence,leaf,leaflet,length,life,na,ovary,papillae,perennial,petiolule,plant,position,presence,seed,shape,size,spacing,straightnes,terminal,texture,tuber-bearing
115	wfo-0001026607	success	204	133	101	103	32	0.495	0-3,0-4,0.1-0.3,0.3-1.8,0.8-3.4,0.8-4.5,0.8-5,1-10,1-2,1-3.8,1.5-4,10-30,2.7-19,4-10,5,6-10,absent,acute,anther,apart,apex,articulated,attenuate,axillary,base,basiscopic,brownish,bud,chartaceous,clavate,cm,condition,connivent,corolla,decreasing,decurrent,deep,diameter,distal,drying,elliptic,forked,forming,fresh,fruit,globose,greatly,green,greenish,hair,half,herb,high,interjected,lanceolate,lateral,leaf,leaflet,like,long,medium,membranous,minute,mm,mucilaginous,obtuse,odd-pinnate,ovate,ovoid,pedicel,peduncle,pentagonal,petiole,petiolulate,plant,poricidal,pubescent,rarely,ripe,rosette,rounded,seed,sessile,short,side,size,stem,stigma,straight,style,subtending,terminal,tip,toward,tube,typically,violet,wet,whitish,x,yellow	0.5-5.8,1-5,1-8,2-10,2-2.5,2-3,2.4-5.8,2.5-3.8,3-8,4-6,5-merou,5.8-19.8,abaxially,acumen,adaxially,ag,along,alyx,apparently,axe,berry,blade,capitat,cell,ciliate,clearly,coarse,covering,digestion,dorsally,dot,eaf,edge,eed,enzyme,especially,exceeding,filament,finely,flat,flower,folded,geminat,generally,glabrou,glabrous,gree,green-white,hair-like,hal,homostylous,honeycomb,larger,lengthening,living,lobe,lower,make,margin,marked,midrib,minutely,moderately,much,nflorescence,often,orbicular,orolla,pair,perfect,plurifoliate,pore,present,puberulent,rachi,removed,ruit,scattered,semierec,seudostipule,shaped,simple,slit,sometimes,spaced,specimen,stamen,ste,tall,tamen,tem,testal,thick,throughout,tri-,unit,unwinged,usually,vary,wall,white,without,ympodial	arrangement,articulation,bark,calyx,capitate,color,connation,dehiscence,diminishing,form,fruiting,growth,height,history,inflorescence,length,life,na,ovary,papillae,petiolule,position,prickle,pseudostipule,semierect,shape,spacing,straightnes,surface,texture,true,tuber-bearing
116	wfo-0001026613	success	159	90	60	99	30	0.377	1-10,1-2,1.5-4,2-7.5,2.3-8,3-5,4.5-8.5,5,5-7,6-8,6.2-9.5,8-18,8.5-10,8.5-9,absent,anther,articulated,berry,chartaceous,cm,connivent,cordate,corolla,densely,diameter,forked,fruit,half,herb,interjected,lanceolate,lateral,leaf,leaflet,membranous,middle,minute,mm,odd-pinnate,ovate,pedicel,peduncle,petiole,plant,poricidal,proximal,pubescent,purple,rotate-pentagonal,size,stem,stigma,style,terminal,tip,tube,typically,unknown,x,yellow	0.5-1,0.6,11-19.5,2.5-2.8,3-10,4-5,5-6,5-merou,5.5-7,6-12,9.5-13.5,abaxially,acumen,acuminate,adaxially,ag,along,alyx,apart,apex,apparently,attenuate,axe,axillary,base,blade,borne,bud,capitat,ciliate,conical,decreasing,distal,dorsally,eaf,edge,eed,end,erec,especially,filament,flat,flower,folded,geminat,generally,glabrous,greatly,green,hair,hal,homostylous,immature,larger,lengthening,like,lobe,long,lower,m-1.2,margin,mature,midrib,minutely,mottled,nflorescence,orolla,pair,perfect,petiolule,plurifoliate,pore,puberulent,pubescen,ruit,secondary,semierect,seudostipule,singly,slit,spaced,sparsely,ste,stolo,subequal,subtending,symmetrical,tall,tamen,tem,toward,tri-,tuber,unit,unknow,unwinged,usually,vary,ympodial	0.6-1.2,arrangement,articulation,bark,calyx,capitate,color,connation,dehiscence,form,fruiting,growth,height,history,inflorescence,length,life,na,ovary,papillae,position,prickle,pseudostipule,seed,shape,spacing,straightnes,surface,texture,tuber-bearing
117	wfo-0001026614	success	200	104	61	139	43	0.305	0.4-0.7,0.5,2.5,3.2-5.2,4-7,5.3-8.2,acuminate,acute,adaxially,anther,apart,apex,articulated,base,berry,black,brown,calyx,cm,dark,diameter,dried,evenly,extra-axillary,flattened-reniform,flower,foveolate,fruit,fruiting,glabrous,globose,golden,lateral,leaf,linear,long,minutely,mm,mottled,orange,orange-red,ovate,pedicel,peduncle,petiole,prickle,ripe,rotate-pentagonal,shrub,simple,sparsely,stellate-pubescent,stem,stigma,style,surface,tube,white,x,yellow,yellowish	.8,0.2,0.2–0.3,0.5–2,1-,1.3-1.8,1.5–2,11-15,15–30,1–2,1–3,1–5,2.2,2.2-5.5,2.5–3,20–25,2–4,2–4-branched,2–6.5,3-foliate,3–10,4.5–11,4.5–5.5,5,5-merou,50,6.4-8.4,6–8,7.2-9.8,8–10,9–16,>,abaxially,absent,across,adaxiall,alyx,apparently,armed,axe,ba,blade,blunt-tipped,broad-based,campanulate,capitat,chartaceous,clavate,closely,commonly,concentrated,cylindrical,densely,denser,developed,directed,distally,eaf,eed,entire,erect,especially,expanded,filament,fleshy,geminate,glabrescent,gland-tipped,globo,hair,homostylous,internode,interpetalar,irregularly,lanceolate-attenuate,less,lobe,lobed,lon,lower,margin,midpoint,midvein,minute,nearly,nflorescence,oblique,obtuse,often,orolla,ovate-lanceolate,ovoid,pair,per,perfect,pore,pubescence,pubescent,rachi,rarely,ray,reflexed,repand,rounded,ruit,scattered,sessile,shallowly,shin,side,similar,slightly,smaller,sometimes,somewhat,soon,spaced,spreading,stellae,stellate,tall,tamen,tapering,tem,time,tissu,tissue,ud,unarme,unarmed,usually,vary,vein,weakly,well,wide,ympodia,young,–5	0.2-0.3,0.5-2,1-2,1-3,1-5,20-25,3-10,8-10,9-16,arrangement,articulation,bark,capitate,color,connation,corolla,dehiscence,diminishing,distal,form,growth,height,history,inflorescence,interjected,leaflet,length,life,na,ovary,papillae,petiolule,plant,position,pseudostipule,seed,shape,size,spacing,straightnes,terminal,texture,tuber-bearing
118	wfo-0001026632	success	108	94	54	54	40	0.5	.5,0,1-2,1.5,10-12,abaxially,abundantly,acuminate,adaxially,anther,apex,armed,base,broadly,cm,condensed,cyme,densely,diameter,divided,elliptic,erect,extra-axillary,flattened,flower,halfway,height,lamina,lateral,leaf,lobe,long,mm,moderately,ovate,pedicel,peduncle,petiole,prickle,prickly,reddish-brown,scarcely,short,shrub,simple,stellate,stellate-pubescent,stigma,straight,style,toward,truncate,tube,unknown	3-4,5-merou,6,7,acumen,acute,alyx,ba,blade,bu,capitat,cell,central,commonly,developed,eaf,eed,equal,exposed,filament,geminat,glandular,hair,interacuminal,lanceolat,less,little,lon,lower,margin,minute,nflorescence,orolla,porrect-stellate,prominent,pubescent,ray,rounded,ruit,sessile,shallow,sinus,structure,tamen,tem,tissue,triangular,unarme,unknow,vary,well,x,ympodial,young	arrangement,articulation,bark,calyx,capitate,color,connation,corolla,dehiscence,diminishing,distal,form,fruit,fruiting,growth,history,inflorescence,interjected,lanceolate,leaflet,length,life,na,ovary,papillae,petiolule,plant,position,pseudostipule,seed,shape,size,spacing,stem,straightnes,surface,terminal,texture,tuber-bearing,unarmed
119	wfo-0001026642	success	193	97	52	141	45	0.269	6,annual,anther,apex,articulated,base,bipinnate,black,blue,branched,brown,calyx,clavate,cm,dark,diameter,flattened,fruit,globose,green-purple,herb,lavender,leaf,length,lilac,mm,oblong,obtuse,ovate,pale,pedicel,peduncle,pentagonal,perennial,petiole,pinnate,pitted,poricidal,pubescent,shallowly,sparsely,stigma,straight,style,subglabrous,surface,time,tip,tube,violet,woody,yellow	.05,.1,.8,0.1,0.1–0.3,0.2,0.25,0.4,0.4–2.2,0.5,0.5–,0.5–0.7,0.5–1.7,0.5–2.0,0.5–3.5,0.6,0.6–1.0,0.75–1.0,0.75–2.0,0.7–1.6,0.8–1.2,1.0,1.0–2.0,1.2–1.7,1.2–2.0,1.2–3.5,1.2–6.2,1.6–8.0,1.9–3.0,12–30,1–10,1–3,2.0–4.0,2.5–3.5,2.5–4.0,2.8–3.0,3.0–5.1,3–5,4.0–6.0,4–7,5,5.0–7.0,50–100,<,abaxial,abaxially,acute,adaxiall,adaxially,ag,along,anthesi,apart,appressed,axe,axillary,ba,blade,borne,cell,chartaceous,circular,connivent,cylindrical,decreasing,decumbent,densely,denser,divided,eaf,eed,either,elliptic,equal,erect,filament,fleshy,flower,geminat,glabrescen,glabrous,gland,glandular,hair,half,indumentum,lobe,lon,long,longitudinal,lower,m.,moderately,multicellular,narrow,nflorescence,number,occasionally,often,opening,orolla,pair,perfect,pinnae,pore,present,primary,probably,rapidly,rounded,ruit,secondary,sessile,shoot,side,simple,slit,sometimes,spaced,stone,tal,tamen,tem,unicellular,unifoliate,uniseriate,unit,usually,vary,vein,white,wide,wing,x,ympodial,–1.2,–11.0,–2.0,–4.5,–6,–7	0.4-2.2,0.5-2.0,0.5-3.5,1-10,1-3,2.0-4.0,2.8-3.0,3.0-5.1,50-100,arrangement,articulation,bark,color,connation,corolla,dehiscence,diminishing,distal,form,fruiting,growth,height,history,inflorescence,interjected,lateral,leaflet,life,na,ovary,papillae,petiolule,plant,position,prickle,pseudostipule,seed,shape,size,spacing,stem,straightnes,terminal,texture,tuber-bearing
120	wfo-0001026651	success	222	99	62	160	37	0.279	1.8,3,8,acuminate,acute,anther,apex,articulated,attenuate,base,brownish-green,calyx,capitate,chartaceous,cm,connivent,cyme,densely,diameter,dull,exfoliating,flattened,fruit,glabrescent,globose,green,herb,lanceolate,lateral,leaf,length,mm,moderate,narrowly-elliptic,oblong-ellipsoid,obtuse,ovate-reniform,pedicel,peduncle,petiole,plant,poricidal,pubescent,rounded,seed,shape,simple,size,slightly,stellate,stem,stigma,straight,style,sub-opposite,surface,terminal,translucent,unbranched,undulate,white,yellow	-celled,0.2–1.3,0.35–2.6,0.9–3,1,1–2,2.2–10,2.8,2–11.5,2–13,2–3,2–3.3,2–4,2–4.5,2–8,3-plurifoliate,3–5,3–7,4,4–6,4–7.8,5-merou,6–10,6–14,abaxially,absent,accrescent,adaxiall,adaxially,along,alyx,anisophyllous,antror,antrorse,antrorsely,apar,appressed,arcuate,ark,asymmetric,axi,beneath,berry,beyond,branch,broadly,brochidodromous,brown,capitat,cell,ciliate,circular,cordate,cylindrical,dark,decumbent,decurrent,differing,directed,discolorous,drying,eaf,eed,elliptic,emarginate,entire,equal,erect,exserted,eye,filament,flexuous,flower,frui,geminate,geniculate,glabrou,glabrous,glandular,growt,hair,head,highly,hilum,hollow,impressed,introrsely,less,light,like,lobe,long,longitudinal,lower,lying,major,margin,markedly,matte,membranaceous,midrib,minor,moderately,mostly,much-branched,multicellular,naked,new,nflorescence,normally,older,one,onto,opening,orolla,ovate-deltate,ovate-lanceolate,parallel,pedunculate,per,perfect,pore,prominent,pubescence,reduce,region,revolute,ripe,ruit,secondary,shiny,shrub,similar,single-celled,slit,small,smaller,sometimes,spaced,stalk,stamen,subapical,tall,tamen,tem,trichome,turning,uniseriate,unit,upper,usually,vary,vein,venation,visible,wide,woody,ympodial,young,×	0.35-2.6,2-11.5,2-13,2-8,2.2-10,4-6,apart,arrangement,articulation,bark,color,connation,corolla,dehiscence,diminishing,distal,form,fruiting,growth,height,history,inflorescence,interjected,leaflet,life,na,ovary,papillae,petiolule,position,prickle,pseudostipule,spacing,straightnes,texture,tube,tuber-bearing
121	wfo-0001026656	success	211	134	101	110	33	0.479	0-4,0.3-3,0.3-4.2,0.4-6.5,0.7-10.5,0.9-13,1-10,1-2,1.1-8.1,2-6,20-60,4-10,4-13,5-35,9-11,abaxially,anther,articulated,blue,broadly,brownish,bud,capitate,cell,chartaceous,cm,condition,connate,connivent,corolla,covering,curved,densely,diameter,distal,dot,drying,elliptic,especially,forked,fresh,fruit,glabrous,glaucous,globose,green,greenish,hair-like,herb,interjected,lanceolate,lateral,leaflet,lengthening,light,long,lunate,make,membranous,mm,moderately,mucilaginous,narrowly,odd-pinnate,ovate,ovoid,pedicel,peduncle,pentagonal,petiole,plant,pore,poricidal,pubescent,purple,rotate-pentagonal,scale-like,scattered,seed,slit,sometimes,somewhat,stem,stigma,straight,style,subglabrous,subtending,terminal,testal,thick,tinged,tip,tube,violet,wall,wet,white,whitish,wide,yellow	1,1-1.8,1-3.8,1-4,1-5,1.5-7,10,2-8,2.5-17,4-8,5,5-18,5-merou,5.5-27,absent,acumen,acuminate,acute,adaxially,ag,along,alyx,apart,apex,attenuate,base,bearing,blade,borne,ciliate,clavat,cuneate,dark,decurrent,digestion,dorsally,eaf,edge,eed,end,enzyme,erec,exceeding,filament,flat,flower,folded,geminat,generally,greatly,green-white,greenish-yellow,hair,half,homostylous,honeycomb-shaped,larger,like,living,lobe,lower,margin,middl,midvein,minutely,mottled,nflorescence,non-glandular,oblique,occasionally,often,orolla,pair,petiolulate,petiolule,plurifoliate,puberulent,pubescen,rachi,ranging,removed,ruit,seudostipule,short,singly,slightly,spaced,specimen,stamen,star,ste,stolo,subequal,symmetrical,tall,tamen,tem,tertiary,therefore,throughout,tri-,truncate,tuber,typically,unit,unwinged,vary,wing,without,ympodial	age,arrangement,articulation,bark,calyx,clavate,color,connation,dehiscence,form,fruiting,growth,height,history,inflorescence,leaf,length,life,middle,na,ovary,papillae,position,prickle,pseudostipule,shape,size,spacing,straightnes,surface,texture,tuber-bearing,ye
122	wfo-0001026663	success	251	109	75	176	34	0.299	1,1-3.2,1-5,1.4-3.1,2-12,2.5-3.7,3.8-5.7,31,4.7-25.9,7.5-9,8-17,abaxially,accrescent,acuminate,adaxially,anther,apart,apex,articulated,attenuate,bark,base,blunt-tipped,branched,brown,calyx,cm,completely,constricted,corolla,covering,dark,diameter,drying,enveloping,flower,fruit,fruiting,globose,green,greenish-brown,lanceolate,lateral,leaf,length,less,light,long,many,mm,ovate-lanceolate,pale,pedicel,peduncle,petiole,poricidal,rich,scabrous,short,shrub,simple,slightly,small,stellate,stem,stigma,style,time,tip,tomentose,tree,tube,violet,white,yellow	-15,-2.9,-8,-9.7,.5-2.5,/25-1/15,/3,0-160,0.2-0.6,0.3-0.8,0.4-2.2,0.9-1.5,1-2.5,1.1,1.1-2.1,1.2-2,1.4-2.6,1.6-2.3,1.9-2.6,1/2,1/3,1/4-1/2,10-26,10.3-13.2,12-14,2.1-2.6,2.8-5.3,2.9-5,2/3,24-45,3-5,3.5-5,4.5-5.7,5-8,5.5-,5.5-8.8,acute,adaxiall,ag,along,angled,anthesi,apparently,appressed,around,ascending,axe,axillary,becoming,berry,blade,branch,broadly,bud,capitat,chartaceous,closely,conical,cylindrical,densely,directed,distally,distributed,eaf,echinoi,echinoid,echinoid-pubescent,edge,eed,elongated,entire,especially,evident,exserted,farinose,filament,flared,fleshy,free,glabrescen,glabrescent,glabrous,granular,granular-tomentose,grooved,hair,immature,inserted,lengthening,line,lined,lobe,lobed,long-stalke,long-stalked,longer,longitudinal,longitudinally,lower,m.,main,margin,matur,midrib,midvein,minute,multangulate,multangulate-pubescent,nearly,nflorescence,obtuse,occasional,occuring,older,opening,openly,orolla,ovate,ovate-lanceolat,perfect,persistent,plurifoliate,pore,porrect-stellate,present,pseudo-terminal,pubescence,pubescent,rachi,rather,ray,ridged,robust,ruit,runk,sessile,short-stalked,side,slit,sometimes,somewhat,soon,spaced,sparsely,stalk,stalked,stamen,strongly,subcampanulate,subcoriaceous,subglabrous,subglobose,suture,tall,tamen,tangled,terete,thick,thin,tomentose-pubescent,tomentum,touching,ud,unarme,unarmed,unit,upper,usually,vary,vein,way,whitish,wide,x,ympodial,young	arrangement,articulation,capitate,color,connation,dehiscence,diminishing,distal,form,growth,height,history,inflorescence,interjected,leaflet,life,na,ovary,papillae,perennial,petiolule,plant,position,prickle,pseudostipule,seed,shape,size,spacing,straightnes,surface,terminal,texture,tuber-bearing
123	wfo-0001026686	success	196	137	104	92	33	0.531	0.6-0.9,1-10,1-2,1-2.5,1.2-3.4,1.5-7,10-28,2-10,2-9,2.4-3.6,2.5-8,3.7-8,5,6.5-12.7,7-9,8-10,abaxially,acuminate,adaxially,anther,apart,apex,articulated,axillary,base,berry,borne,brownish,bud,cell,chartaceous,cm,condition,conical,connivent,corolla,covering,decreasing,densely,diameter,distal,drying,elliptic-lanceolate,end,forked,fresh,fruit,gradually,green,greenish,hair,hair-like,herb,interjected,lanceolate,lateral,leaf,leaflet,light,like,long,middle,minute,mm,mottled,obtuse,odd-pinnate,orbicular,ovate,ovoid,pedicel,peduncle,petiole,petiolule,plant,poricidal,pubescent,purple,purple-violet,ripe,rotate-stellate,round,seed,semierect,singly,size,sparsely,stigma,straight,style,subequal,subsessile,subtending,terminal,testal,thick,tip,toward,tube,typically,wall,whitish,x,yellow	.4,0.2-0.5,1,1.2-3.6,1.7-2.5,3-4,3-5,4-6,5-16.5,5-8,5-merou,8-14,8-27,absent,acumen,ag,along,alyx,apparently,axe,blade,capitat,ciliate,digestion,dorsally,eaf,edge,eed,enzyme,equal,erec,especially,exceeding,filament,flat,flower,folded,geminat,generally,glabrou,glabrous,green-white,half,homostylous,honeycomb-shaped,larger,lengthening,living,lobe,lower,make,margin,midrib,minutely,mucilaginous,nflorescence,often,orolla,pair,perfect,plurifoliate,pore,puberulent,pubescen,removed,ruit,secondary,seudostipule,slightly,slit,spaced,specimen,stamen,star,ste,stolo,stripe,symmetrical,tall,tamen,tem,throughout,tri-,tuber,unit,usually,vary,wet,white,wide,wing,ympodial	arrangement,articulation,bark,calyx,capitate,color,connation,dehiscence,diminishing,erect,form,fruiting,growth,height,history,inflorescence,length,life,na,ovary,papillae,position,prickle,pseudostipule,shape,spacing,stem,stolon,straightnes,surface,texture,tuber-bearing,¼
124	wfo-0001026695	success	128	108	70	58	38	0.547	0.6-8,2,2-3,2-6,2.5-5.2,3-4,4-5,6-12,6-7,6-8,6.5-13,acute,apex,apical,apically,articulate,base,branched,calyx,cm,connate,cordate,corolla,cuneate,cyme,dehiscent,diameter,dichasial,dichasially,distal,ebracteate,forked,generally,glabrescent,half,herbaceous,interjected,introrse,lateral,leaf,leaflet,maturing,mm,monochasial,oblique,odd-pinnate,often,ovate,ovate-lanceolate,pedicel,peduncle,perennial,petiole,plant,poricidally,proximal,pubescent,rounded,short,short-acuminate,simple,slit,stellate,stigma,straight,style,terminal,tuber-bearing,yellow,¼	1-1.5,1-2,1-4,1.6,11-14,2.5-3,2.5-7,3-6-foliat,3-8,4,4-5.5,8-16,8-17.5,abaxially,absen,acumen,acuminate,adaxially,compound,decurrent,dorsally,eaf,edge,eed,exceeding,filament,flat,flower,folded,globo,lobe,lon,long,lower,lunat,nflorescence,nther,one,orolla,pair,perfect,plan,ruit,sessile,seudostipule,stamen,tal,tem,triangular,typically,unit,unknow,unknown,vary,whit,wide,without,ympodial	absent,anther,arrangement,articulation,bark,color,connation,dehiscence,diminishing,form,fruit,fruiting,globose,growth,height,history,inflorescence,length,life,lunate,na,ovary,papillae,petiolule,position,prickle,pseudostipule,seed,shape,size,spacing,stem,straightnes,surface,texture,tube,white,ye
125	wfo-0001026696	success	139	100	72	67	28	0.518	0.3-4.5,0.8-7,0.9-7.2,1,2-17,2-3,3-17,3-6,3-8.5,4-16,9,apical,apically,articulate,branched,broadly,calyx,cell,cm,connate,corolla,covering,cyme,dehiscent,densely,diameter,dichasial,dichasially,distal,ebracteate,forked,globose,green,green-white,hair-like,herbaceous,introrse,lanceolate,lateral,light,linear,make,maturing,mm,monochasial,mucilaginous,odd-pinnate,often,ovate,ovoid,pedicel,peduncle,perennial,petiole,plant,poricidally,proximal,pubescent,seed,short,slit,stellate,stigma,style,testal,thick,throughout,tuber-bearing,wall,white-cream,yellow,¼	1-1.3,1-4,1.3-2.1,1.5-3,3-3.5,3-6-foliat,5-35,abaxially,acumen,acute,adaxially,apex,apiculate,base,cuneate,decurrent,digestion,dorsally,eaf,edge,eed,emoval,entire,enzyme,exceeding,filament,flat,flower,folded,generally,globo,half,honeycomb,light-yello,living,lobe,lon,long,lower,lunat,margin,nflorescence,nther,oblong,obtuse,orolla,pattern,perfect,plan,reveal,rounded,ruit,seudostipule,simple,sinuate,specimen,stamen,straight,tal,tem,throughou,typically,unit,vary,wide,without,ympodial	anther,arrangement,color,dehiscence,form,fruit,growth,height,history,inflorescence,interjected,leaf,leaflet,length,life,light-yellow,lunate,na,pseudostipule,shape,size,spacing,stem,surface,terminal,texture,wet,ye
126	wfo-0001026706	success	232	113	81	151	32	0.349	-4.4,0.2-0.3,0.2-0.5,0.8-2.8,1-5,1.5-3,12,2.2-3.3,3.6-5.7,4,4.5-5.5,5.3-6.4,6.1-,7-16,9.8-15.4,abaxially,accrescent,acute,adaxially,anther,apart,apex,articulated,attenuate,bark,base,blunt-tipped,branched,brown,calyx,cm,completely,corolla,covering,cuneate,diameter,enveloping,flower,fruit,fruiting,glabrate,globose,golden,green,lanceolate,lateral,leaf,length,long,many,mm,obtuse,ovate,ovate-elliptic,pale,pedicel,peduncle,petiole,poricidal,reticulate-punctate,shrub,simple,small,stellate,stem,stigma,style,suborbicular,surface,tall,time,tip,tomentose-pubescent,tree,tube,velutinous,white,whitish,x,yellow,yellowish-tan	-3.1,-5.5,-6.1,.5,/14-1/6,0-240,0.6-2.2,0.8-1.2,0.8-1.5,0.9-1.9,0.9-2,1-2.2,1.1-4,1/2-2/3,10-15,14-32,2.3-3.8,2.5-3,2.7-4,2.9-6,2/3-3/4,3-4.6,3.1-3.8,4.2-12,5-6.5,6-10,6-8,8-14,adaxiall,ag,anthesi,apparently,appearing,around,axe,axillary,ba,becoming,berry,blade,branch,bud,capitat,chartaceous,closely,coriaceous,crisped,cylindrical,dark,dendritic-echinoid,dendritic-multangulate,densely,directed,distally,eaf,edge,eed,entire,exserted,farinose,filament,fleshy,fourth,free,furfuraceou,glabrous,grayish,hair,herbarium,indument,inserted,lackin,lacking,lengthening,lobe,lobed,long-stalked,longitudinal,lower,m.,main,margin,matted,midrib,minute,mixed,multangulat,multangulate,nearly,nflorescence,oblong,obscured,occasionally,often,older,orolla,ovate-lanceolate,perfect,persistent,plurifoliate,pore,porrect-stellate,pseudo-terminal,pubescence,pubescent,rachi,rather,reddish,ruit,runk,semi-ovate,sessile,short-,short-stalked,side,slightly,slit,softly,somewhat,soon,spaced,sparsely,specimen,splitting,stalked,stamen,strongly,subcampanulate,subconical,subglobose,sulcate,suture,tamen,thin-walled,tomentu,touching,translucent,transparent,ud,unarme,unarmed,unevenly,unit,upper,vary,vein,wavy,way,wide,ympodial,young	arrangement,articulation,capitate,color,connation,dehiscence,diminishing,distal,form,growth,height,history,inflorescence,interjected,leaflet,life,na,ovary,papillae,petiolule,plant,position,prickle,pseudostipule,seed,shape,size,spacing,straightnes,terminal,texture,tuber-bearing
127	wfo-0001026707	success	196	103	72	124	31	0.367	-3,/3,0,0.5-1,0.6-0.7,0.7-1.4,1-5,2.5-4,3-4.5,4,5-10,8-15,?,acute,anther,apart,apex,apparently,articulated,attenuate,bark,base,berry,branched,calyx,clustered,cm,color,connivent,curved,diameter,elongating,erect,flattened-reniform,fruit,fruiting,gently,glabrescent,gray,green,lateral,leaf,length,lobed,long,mauve,mm,moderately,narrow-oblong,orange-brown,pedicel,peduncle,petiole,poricidal,prickle,red-brown,rounded,shrub,small,sometimes,spherical,stellate-pubescent,stem,style,surface,tapering,terminal,tip,tree,tube,way,white	-1/3,-5,.5,.8,0-20,0.05,0.05-0.15,0.1-0.2,0.3-0.8,0.5-3,0.6-0.8,0.7-1,0.7-1.5,1-1.7,1-3,1.5-1.8,1.6-2,1/3,1/3-1/2,1/3-3/4,1/4-1/3,1/8-1/4,11-16,2-10,2-2.3,2-6,2.5-3,2.5-6,3-4,3-7,3-8,5-25,5-7,5-8,5-merous,abaxially,alyx,apar,apically,blade,branche,broad-deltate,broadly,chartaceous,concolorous,cuspidat,decurrent,densely,discolorous,drying,eaf,eed,entire,equal,eye,filament,flower,foliaceous,free,fused,glabrou,glabrous,inflated,infructescence,juvenil,known,less,lobe,longer,lower,margin,mature,midpoint,naked,narrow-deltate,nflorescence,obtuse,older,one,open,orolla,oung,per,perfec,pericarp,plurifoliat,porrect,porrect-lepidote,portion,prickly,pubescent,ray,reflexed,ruit,scar,sessile,shorter,simple,slender,smooth,spaced,sparsely,spreading,stalk,stalked,stellate,stout,straight,tamen,terete,time,trichome,unarmed,unit,upper,variously,vary,venation,visible,weakly,wide,yellow-green,ympodial,¼	arrangement,articulation,branch,connation,corolla,dehiscence,diminishing,distal,form,growth,height,history,inflorescence,interjected,leaflet,life,na,ovary,papillae,petiolule,plant,position,pseudostipule,seed,shape,size,spacing,stigma,straightnes,texture,tuber-bearing
128	wfo-0001026711	success	210	104	70	140	34	0.333	-7,0,0-6,0.3-1,0.5-1.5,0.7-1.4,0.75-1,2-3.5,2-6,4.5-7,acute,anther,apart,apex,articulated,bark,base,branched,calyx,cell,cm,connivent,curved,densely,diameter,dull,elongating,evenly,flattened-reniform,fruit,fruiting,green,lateral,leaf,length,lobed,long,maturity,mauve,mm,moderately,obtuse,orange,orange-brown,outline,pale,pedicel,peduncle,petiole,pit,poricidal,prickle,purple,raised,red,shrub,small,smooth,spherical,stellate-pubescent,stem,style,surface,tapering,terminal,tip,tube,weakly,yellow,young	-15,-2,-5,-6,.2,.5,.8,0-0.2,0-25,0-4,0.1,0.15,0.2-0.3,0.7-,0.7-0.9,0.8,0.8-2.2,0.9-1.1,0.9-1.5,1-,1-2,1-30,1.5-,1.5-2.2,1.7-4,1/,1/2-2/3,1/3,1/4,1/4-1/3,2-2.2,2-2.5,2-4,2.1-2.5,3-4,3-4.5,3-5,3-7,3.5-5.2,4-8,5-merous,7-8,abaxially,acicular,acuminat,alyx,ame,apar,apically,apparently,berry,blade,brow,c.,concolorous,cuneate,deltate,difoliate,discolorous,distance,drying,eaf,eed,elliptic,equal,erect,extending,faint,filament,flower,free,geminat,glabrous,infructescence,less,lobe,longer,lower,margin,mature,midpoint,midvein,narrow-deltate,nflorescence,occasionally,older,one,open,orolla,oung,pair,pendulous,per,perfec,pericarp,perpendicular,porrect,portion,prickl,prickly,primary,ray,reduced,reflexed,rounded,ruit,scar,sessile,shallowly,shorter,side,slender,sometimes,somewhat,spaced,spreading,stalk,stalked,stellate,straight,tamen,terete,tertiary,thick-chartaceous,time,trichome,unarmed,uniform,unit,upper,variously,vary,vein,venation,visible,way,wide,woody,yellow-green,ympodial	arrangement,articulation,brown,color,connation,corolla,dehiscence,diminishing,distal,form,geminate,growth,height,history,inflorescence,interjected,leaflet,life,na,ovary,papillae,perennial,petiolule,plant,position,pseudostipule,seed,shape,size,spacing,stigma,straightnes,texture,tuber-bearing
129	wfo-0001026717	success	207	132	100	107	32	0.483	0.3-0.6,0.6-1.5,1-10,1-2,1.3-2.5,1.8-3,13-28,2.5-4.5,3.3-11,4-6,4-8,4-9,5,5-11,5-13.5,5-6,5.3-9,abaxially,adaxially,anther,apart,articulated,axillary,berry,borne,brownish,bud,cell,chartaceous,cm,condition,conical,connivent,corolla,covering,dark,diameter,distal,drying,elliptic,end,flower,forked,fresh,fruit,green,greenish,hair,hair-like,herb,interjected,lanceolate,lateral,leaf,leaflet,light,like,long,medium,membranous,middle,minute,mm,mottled,odd-pinnate,orbicular,ovate,ovoid,pedicel,peduncle,pentagonal,petiole,plant,poricidal,present,pubescent,purple,ripe,rotate,seed,semierect,sessile,singly,size,sparsely,stigma,straight,style,subtending,terminal,testal,thick,tip,tube,typically,violet,wall,whitish,x,yellow	0.3-2.5,0.3-5,0.8,1-2.5,1-3,1.4-2.2,14-22,15-34,2.2-5,2.5-5.5,3-4,3-5,3-6,5-merou,7-11,acumen,acuminate,ag,along,alyx,apex,apparently,attenuate,axe,base,blade,capitat,ciliate,darker,decreasing,decurrent,digestion,dorsally,eaf,edge,eed,enzyme,equal,erec,especially,exceeding,filament,flat,folded,geminat,generally,glabrou,glabrous,gradually,green-white,half,homostylous,honeycomb-shaped,larger,lengthening,living,lobe,lower,make,margin,midrib,minutely,mucilaginous,narrow,nflorescence,obtuse,often,one-quarte,orolla,pair,perfect,petiolule,plurifoliate,pore,puberulent,pubescen,removed,round,ruit,secondary,seudostipule,slightly,slit,spaced,specimen,stamen,ste,stolo,stripe,subequal,subglabrous,subsessile,symmetrical,tall,tamen,tem,throughout,toward,tri-,tuber,unit,usually,vary,wet,wide,wing,ympodial	arrangement,articulation,bark,calyx,capitate,color,connation,dehiscence,erect,form,fruiting,growth,height,history,inflorescence,length,life,na,one-quarter,ovary,papillae,position,prickle,pseudostipule,shape,spacing,stem,stolon,straightnes,surface,texture,tuber-bearing
130	wfo-0001026725	success	166	94	61	105	33	0.367	.5,0.7-1.2,1-1.2,1-4.5,1-5,1.5-2,5-6,acute,anther,apart,apex,bark,base,beneath,broadly,calyx,capitate,cm,corolla,cup-shaped,elliptic,flattened-reniform,fruit,fruiting,glabrous,globose,green,greenish-white,lateral,leaf,long,minutely,mm,opposite,ovary,ovate,paler,pedicel,petiole,pitted,poricidal,pubescent,reddish-brown,rounded,shaped,shrub,simple,size,slender,stem,stigma,straight,stretching,style,subshrub,surface,tear-drop,tip,tube,white,woody	.3,/4,0.2,1-1.5,1.2-1.7,1.5,1.6-2,1/2,2,2.2-4,3.5-4,3.6-7.7,5-20-flowered,5-5.5,8-18.6,8-9,accrescent,anthesi,attenuate,axil,becoming,berry,black,bluish,brownish-papillose,character,crackin,dark,deflexed,dia,differing,difoliate,dry,drying,eaf,edicel,eed,ellipsoid,evenly,extremely,filament,free,geminat,geographically,glandular-papillose,incrassate,inflorescenc,interpetalar,large,less,lobe,lobed,lon,lower,main,major,margin,margine,material,middle,minor,nflorescence,occasionally,often,older,one,onto,open,ovoid,pair,pale,papillo,papillose,planar,pore,portion,prominent,proximal,reflexed,ruit,scar,scarious,short,sinus,slightly,spaced,split,tall,tan,tapering,triangular,trichome,tuft,ud,uniseriate,unit,upper,varying,vein,way,widest,winged,x,ympodial,young	arrangement,articulation,color,connation,cracking,dehiscence,diameter,diminishing,distal,form,growth,height,history,inflorescence,interjected,leaflet,length,life,na,papillae,peduncle,petiolule,plant,position,prickle,pseudostipule,seed,shape,spacing,straightnes,terminal,texture,tuber-bearing
131	wfo-0001026733	success	188	105	64	124	41	0.34	-13,-4,0.3-0.5,0.5-2,0.5-4,1-2,1-7,1.5-14,10-20,2-3,3-15,3-7,4-23,5-8,acuminate,apart,apex,articulated,base,calyx,chartaceous,cm,color,connivent,cordate,diameter,ellipsoidal,elliptic-ovate,flattened,forked,fruit,fusiform,glabrate,green,greyish,immature,lanceolate,long,longitudinal,mm,near,oblique,ovate,pedicel,peduncle,petiole,simple,sometimes,stellate,stigma,stripe,style,submarginally,time,tree,truncate,tube,unbranched,white,white-puberulent,wide,x,yellow,yellowish	-1,-11,-14,-15,-2,-7,-8,.5-3,0.3-2,0.5,0.5-1,1,1-1.5,1-3,1.5-2,1.5-2.5,15-,2-2.5,2-4,2-6,2.5-7.5,20-50,25-40,3-3.5,3-4-foliat,4,4-5,4.5-5,7-10,8-12,abaxially,acute,acute-acuminate,adaxially,aggregate,ape,axe,basal,beyond,blade,capitat,cell,ciliat,connective,curled,cylindrical,deltate,dense,densely,dia,directed,distally,eaf,eed,eglandular-pilose,eglandular-pubescent,eglandular-villous,entire,equal,especially,exceeding,exserted,flower,glabrous,gland-tipped,glandula,glandular-,glandular-puberulent,glandular-tomentose,hair,hirsute,leaving,linear-triangular,lobe,lon,lower,margin,membranaceous,midrib,moderately,narrowly,nflorescence,nther,orolla,ovoid,ovum,pedicellar,perfect,pilose,pore,present,pubescent,pubescent-pilo,pubescent-pilose,rachi,radiu,remnant,ripe,round,ruit,shining,shorter,slightly,small,smooth,spaced,sparsely,stamen,stone,swelling,tal,tem,thecae,toward,triangular,ud,unit,unknow,unknown,usually,vary,vein,villous,ympodial	anther,arrangement,articulation,bark,capitate,connation,corolla,dehiscence,diminishing,distal,form,fruiting,growth,height,history,inflorescence,interjected,lateral,leaf,leaflet,length,life,na,ovary,papillae,perennial,petiolule,plant,position,prickle,pseudostipule,seed,shape,size,spacing,stem,straightnes,surface,terminal,texture,tuber-bearing
132	wfo-0001026734	success	266	114	81	185	33	0.305	0.5,1,3,absent,accrescent,acuminate,anther,apex,articulated,base,becoming,berry,branched,bright,broadly,brown,calyx,chartaceous,clavate,closely,congested,connivent,corolla,covering,cylindrical,cyme,diameter,distally,elliptic,flattened,flower,fruit,globose,green,growth,immature,internodal,irregular,lateral,leaf,length,lobed,long,long-attenuate,mature,maturity,membranaceous,mm,much,ovary,pale,pedicel,peduncle,petiole,pit,poricidal,purple,purplish,reniform,scandent,shape,shiny,shrub,simple,size,slightly,sometimes,spaced,stellate,stem,stigma,style,subopposite,surface,terminal,tube,unbranched,white,whole,yellow,yellowish	0.1,0.2,0.3,0.6,0.7–0.9,0.7–1,0.8–1,1.6–2,1.6–2.5,1.8–2.2,1.8–3,1/4,1–1.2,1–3,2.2–7,2.3–5,2.5–3,2–2.4,2–3,3.2–3.8,3–4,3–4-celled,3–8,4–6,4–7,4–8,4–9,5-merou,5–9,8,abaxial,abaxially,acute,adaxial,adaxiall,adaxially,ag,also,always,alyx,anthesi,apical,apice,archin,ark,associated,asymmetric,axi,barely,beneat,beneath,blade,branch,caly,camptodromous,capitate,celled,central,cm,commonly,covered,cuneate,dark,dense,densely,denser,differing,directed,discolorous,downward,dried,drying,due,eaf,eed,eglandular,emergent,entire,erect,f.,fewer,flat,foliate,forked,found,free,frequently,geminate,glabrescen,glabrescent,glabrous,glandular,gray,hair,held,ilament,initially,introrsely,j,lamina,lanceolate,large,less,lobe,longer,longitudinal,lower,lying,margin,material,maturit,midpoint,midri,minute,moderately,mostly,multiseriate,narrow,near,new,nflorescence,normally,oblong,obovate,observed,obtuse,often,old,older,one,one-celled,opening,orolla,other,oung,ovate,pair,paired,papillose,perfect,plane,pointing,pore,porrect,porrect-stellate,portion,pubescence,pubescent,rachi,raised,rarely,ray,rayed,reaching,rounded,ruit,secondary,sessile,short-stalked,shorter,slit,smaller,sparse,sparsely,spread,spreading,stalk,still,subsessile,surfac,trichome,tuft,ud,unequal,uniseriate,unit,upward,vary,vein,venation,vestiture,visible,wide,ympodial,¾	1.8-3,2.3-5,3-8,3/4,5-9,arrangement,articulation,bark,color,connation,dehiscence,diminishing,distal,form,fruiting,height,history,inflorescence,interjected,leaflet,life,na,papillae,petiolule,plant,position,prickle,pseudostipule,seed,spacing,straightnes,texture,tuber-bearing
133	wfo-0001026739	success	197	107	78	119	29	0.396	0-38,0.25-0.94,0.4-5,1-10,1-2,1-3,1.4-3.5,16-54,2-5.3,2-9,2.5-13.5,2.7-6.9,3.2-17.5,3.8-8.5,6-13,7-9,anther,articulated,axillary,brownish,bud,clavate,cm,condition,connivent,coriaceous,corolla,diameter,distal,drying,forked,fresh,fruit,globose,green,greenish,half,herb,high,interjected,lanceolate,lateral,leaf,leaflet,light,linear,mm,mucilaginous,oblanceolate,odd-pinnate,ovate,ovoid,pedicel,peduncle,pentagonal,petiole,plant,poricidal,purple,ripe,rotate,seed,size,sometimes,stem,stigma,straight,stripe,style,subtending,terminal,tip,tube,wet,white,whitish,x,yellow	0-0.34,0.5-1.2,1.2-2.1,10-60,2-4,2-6,2.6-4.8,3-4,4-8,5-merou,5.6-13.1,6.6-18,abaxiall,abaxially,acumen,acuminate,acute,adaxially,ag,along,alyx,apart,apex,apparently,arranged,asymmetric,attenuate,axe,base,basiscopic,bead,berry,blade,brown,capitat,cell,covering,dark,decreasing,densely,digestion,dorsally,eaf,edge,eed,enzyme,erec,exceeding,filament,flat,flower,folded,geminat,generally,glabrou,glabrous,green-white,hair,hair-like,hal,homostylous,honeycomb-shaped,larger,lengthening,like,living,lobe,long,lower,make,margin,moniliform,multiple,necklace,nflorescence,orbicular,orolla,pair,perfect,petal,plurifoliate,pore,pubescent,removed,rest,rounded,ruit,sessile,seudostipule,short,side,simple,slit,spaced,specimen,stamen,stolon,sub-glabrous,subequal,tall,tamen,tem,testal,thick,throughout,tissue,toward,tri-,tuber,typically,unit,usually,vary,wall,wide,wing,winged,yellowish,ympodial	arrangement,articulation,bark,calyx,capitate,color,connation,dehiscence,form,fruiting,growth,height,history,inflorescence,length,life,na,ovary,papillae,position,prickle,pseudostipule,shape,spacing,straightnes,surface,texture,tuber-bearing,ye
134	wfo-0001026740	success	171	98	58	113	40	0.339	0-10,0.5-1,1-10,1-2,1-5,10-20,2.5-27,2.5-6,3-15,3-5,6-10,acuminate,acute,apex,articulated,basal,base,branched,calyx,cm,connivent,cordate,densely,diameter,ellipsoidal,elliptic,flattened,fruit,glabrous,greenish,lanceolate,lobe,long,mm,moderately,near,ovate,pedicel,peduncle,petiole,pilose,puberulent,purple,reticulate,simple,small,stellate,stigma,style,tree,truncate,tube,unbranched,violet,white-puberulent,whitish,x,yellow	-17,-2,1-12,1-3,1-4,10-30,2-3,2-4,2.5-3,2.5-4.5,20-50,3-3.5,3-foliat,3.5-40,4-5,4.5-10,5-40,5-8,8-19,abaxially,absen,absent,acute-acuminate,adaxially,aggregate,also,apart,ape,apiculate,axe,beyond,blade,browni,cell,ciliate,connective,corky,curled,cylindrical,darker,deltate,directed,distally,eaf,eed,eglandular,entire,equal,especially,exceeding,exserted,fleshy,flower,glabrate,glandular-puberulent,hair,immature,leaving,lon,lower,margin,mature,narrowly,nearly,nflorescence,nther,oblong,obtuse,often,orange,orolla,ovoid,pedicellar,perfect,pilo,pore,present,pubescent,rachi,radiu,rarely,remnant,ruit,scar,sessile,shorter,slightly,sometimes,spaced,sparsely,stamen,stone,stripe,subcoriaceous,swelling,tal,tems,thecae,time,tomentose,toward,triangular,truncat,ud,unit,unlobed,vary,vein,villous,wide,woody,ympodial,young	anther,arrangement,articulation,bark,color,connation,corolla,dehiscence,diminishing,distal,form,fruiting,growth,height,history,inflorescence,interjected,lateral,leaf,leaflet,length,life,na,ovary,papillae,petiolule,plant,position,prickle,pseudostipule,seed,shape,size,spacing,stem,straightnes,surface,terminal,texture,tuber-bearing
135	wfo-0001026752	success	169	120	78	91	42	0.462	-25,-3,0-,1,1-12,1-2,1-5,1-6,1.5-2.5,10-20,2-3,3-18,4-5,abaxially,abruptly,adaxially,apart,apex,articulated,basal,base,black,branched,calyx,campanulate,chartaceous,cm,connivent,cordate,cuneate,darker,densely,diameter,dilated,distally,ellipsoidal,elliptic-oblong,elliptic-ovate,flattened,fleshy,forked,fruit,glabrous,globose,green,greenish-brown,immature,lanceolate,lobe,mm,near,papillose,pedicel,peduncle,petiole,possibly,pubescent,purplish,rarely,rather,ripe,short-acuminate,simple,slightly,small,stellate,stigma,stripe,style,tree,truncate,tube,unbranched,violet,white,whitish,x,yellow	-4,-50,1-1.5,1-3,1.5-12,1.5-2,15-35,2,2-2.5,2-4,2.5-20,2.5-5,20-30,3,3-4,3-5,3-foliat,3.5-4,4-45,7-15,8-16,absent,acute,aggregate,also,ape,apiculate,axe,beyond,blade,capitat,cell,connective,coriaceous,cylindrical,deltate,directed,eaf,eed,entire,equal,exceeding,exserted,finely,flower,hair,laterally,leaving,less,lon,long,lower,margin,moderately,narrowly,nearly,nflorescence,nther,obtuse,orolla,ovoid,pedicellar,perfect,pilo,pilose,pore,presence,present,pubescent-pilose,rachi,radiu,remnant,ruit,somewhat,spaced,stamen,stone,tal,tem,thecae,time,tomento,triangular,ud,unit,unknow,vary,vein,wide,yello,ympodial	anther,arrangement,articulation,bark,capitate,color,connation,corolla,dehiscence,diminishing,distal,form,fruiting,growth,height,history,inflorescence,interjected,lateral,leaf,leaflet,length,life,na,ovary,papillae,petiolule,plant,position,prickle,pseudostipule,seed,shape,size,spacing,stem,straightnes,surface,terminal,texture,tuber-bearing,unknown
136	wfo-0001026754	success	176	94	61	115	33	0.347	-6+,0.9-1.1,1-,1.5-3,10,2-2.5,2-3,5,5-lobed,9,acute,anther,apex,articulated,asymmetric,base,berry,calyx,clavate,cm,conical,connivent,corolla,deeply,diameter,distal,ellipsoid,elliptic,globose,growth,inflorescence,later,lateral,leaf,loosely,membranous,minutely,mm,narrowly,oblique,pedicel,peduncle,petiole,poricidal,simple,sleeve,small,stellate-rotate,stem,stigma,style,surface,terminal,tip,truncate,tube,vine,white,woody,yellow,yellowish	.5,0.5,0.5-1,1,1/2,198.,2,2-4,2.5-3.5,2/3,3-4-celled,30+,4-5,5-merou,5.5-9,7-9,9-11,abaxially,adaxially,ag,along,alyx,anthesi,apar,apparently,ark,axi,basal,branched,broadly,brow,cabrera,complete,cucullat,dendritic,densely,denser,divided,eaf,ed,entire,especially,exerted,extending,fide,filament,flower,free,glabrous,half,halfway,ilament,irregularly,lamina,leaving,lengthening,like,lobe,lobed,long,lower,many,margin,mature,midvein,minute,mixture,mostly,new,nflorescence,older,orolla,outline,pair,papillo,peg,perfect,pinnate,planar,plurifoliat,pore,portion,primary,puberulent,pubescent,ruit,scandent,scar,seen,slender,slit,sometimes,spaced,sparsely,splitting,spreading,tangled,tem,time,transparent,trichome,tub,twinin,twining,ud,uniseriate,unit,upper,vary,vein,way,weak,within,x,ympodial	apart,arrangement,articulation,bark,brown,color,connation,dehiscence,diminishing,form,fruit,fruiting,height,history,interjected,leaflet,length,life,na,ovary,papillae,petiolule,plant,position,prickle,pseudostipule,seed,shape,size,spacing,straightnes,texture,tuber-bearing
137	wfo-0001026756	success	147	98	62	85	36	0.422	0-7-1.2,0.5-3,1-1.5,1.5-10,1.8-3,5-10,acute,anther,apex,attenuate,bark,base,bilobed,broadly,brown,calyx,closely,cm,conical,corolla,dark,difoliate,distal,elliptic,fruiting,glabrous,globose,green,lateral,leaf,lobed,minutely,mm,nearly,opposite,ovary,ovate,ovoid-reniform,pale,pedicel,petiole,pinkish-white,pitted,poricidal,pubescent,shape,shaped,shrub,simple,spaced,sparsely,stem,stigma,style,surface,tear-drop,thick,tip,tree,tube,unifoliate,white	.25,.5,0.25-0.5,0.5-1,1-2,1.5-1.7,1.5-2,1.5-3,3-4,3.5-8.5,5-10-flowered,5-5.5,6-10,6-16,abaxial,abaxially,adaxially,along,anthesi,apiculate,ba,berry,corresponding,deflexed,deltate,dendritic,densely,denser,dia,differing,eaf,edicel,eed,erect,exserted,filament,fleshy,free,geminat,glabrescent,grayish-brow,hard,inflorescenc,irregular,lamina,lax,like,lobe,long,lower,main,major,middle,minor,nflorescence,occasionally,older,overlappin,pair,papillo,perhaps,pericarp,planar,pore,portion,present,pubescence,rest,ruit,scar,somewhat,soon,strongly,tall,trichome,tub,ud,uniseriate,unit,vein,wide,widest,woody,ympodial,young	arrangement,articulation,color,connation,dehiscence,diameter,diminishing,form,fruit,geminate,grayish-brown,growth,height,history,inflorescence,interjected,leaflet,length,life,na,overlapping,papillae,papillose,peduncle,petiolule,plant,position,prickle,pseudostipule,seed,size,spacing,straightnes,terminal,texture,tuber-bearing
138	wfo-0001026777	success	168	97	64	104	33	0.381	0.5-1.5,0.5-5,1-1.3,1-1.5,1-10,1-4,5-7,acuminate,acute,anther,apart,apex,base,beneath,blue,brown,calyx,capitate,cm,corolla,cup,distal,elliptic,fide,flattened,flattened-reniform,flexuous,fruiting,glabrous,globose,green,growth,lateral,leaf,lobed,long,minutely,mm,narrowly,nearly,opposite,ovary,papillose,pedicel,petiole,poricidal,pubescent,russet,seed,shaped,shiny,shrub,size,smooth,stem,stigma,straight,style,surface,tear-drop,tip,tube,vellozo,white	.25,.5,/3,0.25-0.5,0.5-1,0.9-3,1-2,1.2-1.8,1.5-3,1.5-5,2-4,2-4.5,2-5,3-3.5,4-8,5-14,5-50-flowered,anthesi,apiculate,axil,ba,beginning,berry,body,branching,campanulate,cell,decurrent,deflexed,dense,dia,differing,difoliate,eaf,edicel,eed,end,exserted,filament,filiform,free,geminat,glabrate,greyi,hyaline,incrassate,inflorescenc,irregularly,like,lobe,lon,lower,main,major,margin,matted,middle,minor,near,new,nflorescence,occasionally,often,older,one,onto,outline,overtopping,pair,papillo,pitted,planar,pore,portion,prominent,quadrate-deltoid,quite,rest,ruit,scar,sinuate,slightly,somewhat,soon,spaced,sparsely,tall,tapering,testa,thread-like,trichome,tuft,ud,uniseriate,unit,vein,wall,way,widest,woody,x,yellowish,ympodial,young	alternate,arrangement,articulation,bark,color,connation,dehiscence,diameter,diminishing,form,fruit,greyish,height,history,inflorescence,interjected,leaflet,length,life,na,papillae,peduncle,petiolule,plant,position,prickle,pseudostipule,shape,spacing,straightnes,terminal,texture,tuber-bearing
139	wfo-0001026782	success	206	114	75	131	39	0.364	-10,-4,-5,0.5-1,0.5-2,1,15,6-7,7,8-10,abundantly,accrescent,acicular,acute,annual,anther,anthesi,apex,armed,articulate,base,blue,bluish,brown,calyx,cm,cordate,dark,darker,diameter,enclosing,fruit,fruiting,globose,green,greenish,herb,immature,irregularly,length,light,lilac,long,maturity,minute,mm,mottling,obtuse,ovate,partially,pedicel,peduncle,petiole,pore,prickle,purple,pustulate,reniform,rotate-campanulate,simple,somewhat,stem,stigma,straight,style,surface,tapered,terminal,tomentose,tube,unbranched,white,x,yellow,yellowish-brown	0.5,0–1,0–10,1-1.5,1.3,1.4–2,1.5,1.5–2.5,1.8–3,1/3–1/2,10–15,1–3,1–5,2,2-5,2-foliate,2–4,3,3-4,3.5–8.5,3–12,4,4–10-rayed,4–13,4–6-rayed,4–9,5,6,abaxially,abundant,adaxiall,adaxially,additional,apiculate,axe,becoming,berr,blade,clavat,clustered,coarse,commonly,curved,dehiscent,deltoid,densely,dilated,divided,eaf,eed,exceeding,except,fertile,filament,finely,flower,geminat,glabrou,glabrous,gland-tipped,gradually,hair,internode,interpetalar,larger,like,lobe,lon,lower,lowermost,main,male,margin,midpoint,midrib,much,much-branched,narrowly,nearly,nflorescence,numerous,often,one,orolla,pair,perfect,porrect-stellate,pubescence,pubescent,rachi,radiu,rarely,ray,ruit,sessile,shallow,short,shorter,slightly,small,smaller,sparsely,spreading,stalk,staminate,ste,stellae,stellate,stellate-pubescent,stellate-tomentose,stipitate,strongly,tall,tamen,tem,thick-stalked,thin-textured,tip,tissue,tooth,triangular,two,upper,upward,vary,vein,way,woody,ympodia,–5,–6	0-1,1-5,10-15,2-4,arrangement,articulation,bark,berry,clavate,color,connation,corolla,dehiscence,diminishing,distal,form,growth,height,history,inflorescence,interjected,lateral,leaf,leaflet,life,na,ovary,papillae,petiolule,plant,position,pseudostipule,seed,shape,size,spacing,straightnes,texture,tuber-bearing
140	wfo-0001026788	success	291	101	57	234	44	0.196	4,6.4,acuminate,acute,alveolate,anther,apex,articulate,bark,base,branching,brown,calyx,chartaceous,cm,connivent,corolla,diameter,distal,flattened-orbicular,flattened-reniform,fruit,globose,lanceolate,lateral,leaf,long,mm,orange,oval,pedicel,peduncle,petiole,prickle,ray,reddish,rounded,shrub,sigmoid,simple,small,spaced,stellate,stem,stigma,style,subcoriaceous,surface,time,tree,tube,unbranched,well,white,wide,yellow,yellow-tan	.0,.04,.05,.3,/3,0.2–0.3,0.3–0.4,0.3–0.5,0.4–0.6,0.4–0.7,0.5–0.7,0.5–0.8,0.6–1.0,0.6–1.3,0.6–1.9,0.8–1.1,0.8–1.8,0.9–1.2,0.9–1.3,0.9–2.0,0–,1.0–1.5,1.0–2.0,1.1–1.3,1.2–1.6,1.2–1.7,1.3–1.6,1.3–1.8,1.3–2.5,1.4–2.2,1.5–1.9,1.5–2.2,1.7,1.7–1.9,1/3,1/4–1/3,10.8,1–3,2.0,2.1–2.9,2.5–11.0,2.7–5.7,2.8–3.1,2.9–4.0,2/3,2/3s,2–3,3,3.0,3.4,3.8,3.8–4.9,4.0,4.6–6.0,4–7,4–8,5,5-merou,7.0–8.9,7.8–11.0,8,8.3–10.9,8.5,90°,abaxially,absent,adaxially,adjacent,adnate,aequilateral,ag,alyx,anthesi,apart,apical,apparently,appearing,appressed,around,attachment,attenuate,axe,ba,basal,based,becoming,berry,blade,branch,broad,broad-based,broadly,brochidodromous,bud,capitat,channeled,clinate,curved,deciduous,deflexed,deltoid,densely,dentate,developed,development,difoliate,directed,distally,distinct,distinctly,dry,eaf,edge,eed,either,emerging,entire,erect,evenly,exocarp,extending,extra-axillary,fertile,filament,filiform,flat,flexed,flower,free,geminat,glabrous,glandular,glossy,gradually,hair,homostylous,hort,increasing,incurved,intact,internode,interpetalar,intersepalar,juic,layer,laying,less,lobe,lobed,lon,longer,lower,many,margin,markedly,mature,midpoint,midrib,midvein,minute,moderately,nearly,nflorescence,notched,oblique,occasionally,opaque,orolla,ovate,per,perforated,point,pore,porrect,porrect-stellate,portion,potentially,presen,primary,proximal,pubescent,raised,reflexe,remaining,restricted,retrorse,rigid,row,ruit,scandent,scarcely,scattered,sessile,shoot,side,sinuate,sinus,slightly,sloughing,smoot,sometimes,somewhat,soon,sparsely,splitting,spread,stamen,stellae,stellate-pubescent,straight,suture,swelling,tamen,tem,thin,tissue,transparent,triangular,two,ud,unarmed,upper,vary,vein,weakly,yellow-ferruginou,yellow-ferruginous,ympodia,young,±90°,±dense,±equal,±glabrous,×	0-11.0,0.2-0.3,0.3-0.4,0.6-1.9,0.8-1.1,1.0-1.5,1.5-1.9,2-3,2.7-5.7,4-8,7.8-11.0,arrangement,articulation,capitate,color,connation,dehiscence,diminishing,form,fruiting,growth,height,history,inflorescence,interjected,leaflet,length,life,na,ovary,papillae,perennial,petiolule,plant,position,pseudostipule,seed,shape,size,spacing,straightnes,terminal,texture,tuber-bearing
141	wfo-0001026790	success	236	101	69	167	32	0.292	-11,-4,0-10,0.2-1.5,0.5-4,0.7-3,1-1.5,2-11,2-7,7-15,7-20,anther,apex,apparently,articulated,bark,base,berry,calyx,cm,connivent,cream,curved,dark,densely,diameter,dull,elliptic,elongating,flattened-reniform,fruit,fruiting,gently,green,green-brown,lanceolate,lateral,leaf,length,lobed,long,marking,maturity,mauve,mm,moderately,orange-brown,ovate,pale,pedicel,peduncle,petiole,plant,poricidal,prickle,red-brown,shrub,spherical,stellate-pubescent,stem,straight,style,surface,tapering,terminal,tip,tube,yellow,young	-1/2,-1/3,-10,-19,-2,-3,-40,-6,-merous,0,0-150,0-20,0-30,0-5,0.2,0.2-0.4,0.2-0.6,0.2-2,0.5-2,0.6-10,0.7-1.5,0.8,1,1-2,1-3,1.5,1.5-2.5,1.5-3,1.5-4,1.5-5,1.8-4,1.9-2.6,1/2-3/,1/4,1/4-1/2,1/5-1/3,1/6-1/4,2,2-,2-3,2-30,2-5,2.5-4.5,2.7-3.2,3.5-17,4-,4-11,4-7,4-9,5,5-10,5-9,6-12,6-8,6.5-9,7-12,7-13,abaxially,acuminat,acute,adaxially,alyx,ame,andromonoecious,apar,apart,apically,becoming,blade,branched,broad-deltate,brown-green,c.,chartaceous,concolorous,conical,cordate,deltate,discolorous,distance,drying,eaf,eed,elongated,entire,equal,erect,extending,filament,flattened,flower,free,glabrous,glandular,hair,heterostylous,inflorescenc,infructescence,lobe,long-styled,longer,lower,margin,mature,midpoint,midvein,minute,narrow-deltate,near,nflorescence,obtuse,older,one,open,orolla,oung,pair,pendulous,per,pericarp,plurifoliat,porrect,portion,prickly,primary,ray,red-brow,reduced,reflexed,rounded,ruit,scar,sessile,short-styled,side,simple,smooth,sometimes,spaced,sparsely,spreading,stalk,stalked,stellate,stout,tamen,terete,tertiary,time,toward,trichome,unarme,unarmed,unit,upper,usually,variously,vary,vein,venation,visible,way,weakly,wide,woody,yellow-green,ympodial	arrangement,articulation,color,connation,corolla,dehiscence,diminishing,distal,form,growth,height,history,inflorescence,interjected,leaflet,life,na,ovary,papillae,perennial,petiolule,plurifoliate,position,pseudostipule,seed,shape,size,spacing,stigma,straightnes,texture,tuber-bearing
142	wfo-0001026818	success	252	102	70	182	32	0.278	-15,-3,0-1,0.5-1,0.5-2.5,0.7-2,2-3,5-15,8-11,8-15,accrescent,adaxially,anther,apart,apex,articulated,attenuate,base,broadly,calyx,cm,connivent,covering,density,diameter,distal,elliptic,elliptic-ovate,extra-axillary,fruit,fruiting,globose,inflorescence,lanceolate,lateral,leaf-opposed,length,lenticular,less,minutely,mm,orange,orange-red,pedicel,peduncle,perennial,petiole,pitted,prickle,pubescent,reniform-ovate,sessile,simple,size,somewhat,stellae,stellate,stem,stigma,style,surface,tan,thin-textured,truncate,tube,unbranched,variable,white,x,yellow	-1.5,-2,-2.5,-4.5,-7,0-1.5,0.1-0.3,0.3-0.8,0.3-1,0.3-2.5,0.5-1.5,1,1-4,1.5-,1.8-3.5,1/3,2,2-15,2-4,2-4.5,2-foliate,2.5-4,2.5-5,2.7-4,3-5,4-10,4-6,4-7,5-11,5-12,5-20,5-9,6-10,6.5-9.5,7-15,7-30,7-50,abaxially,abrupt,abundant,acute,acute-,adaxiall,along,always,apparent,ascending,average,axe,ba,becoming,blade,branched,broad-based,campanulate,capitat,capitate-glandular,cast,cauline,class,closely,coarsely,commonly,compresse,cordate,cream,cylindrical,deltoid,densely,dentate,depressed-deltoid,directed,distall,distinct,eaf,eed,elongate,entire,equaling,erect,especially,essentially,felty-pubescent,female-sterile,filament,flower,foliar,frui,geminate,glabrous,grading,hair,inserted,interlobal,large-leaved,larger,largest,laterally,lignescent,like,lobe,long,longest,lower,major,margin,maturit,mesocarp,middle,midpoint,midrib,mixture,mostly,multiseriate,nearly,nflorescence,numerous,oblique,obtuse,obtuse-,occasionally,often,one,orolla,oung,outline,ovate,ovate-lanceolate,per,perfect,persistent,pore,prickly,principal,prominent,pubescence,purplish,rachi,radiu,ray,ripe,round-tipped,ruit,scattered,shallowly,short,shorter,side,similar,sinus,smaller,sometimes,spaced,sparse,sparsely,spreading,spreading-hirsute,spreadingly,stalk,stalked,ste,stellate-pubescent,stipitate,tal,tamen,termination,thickened,time,tooth-like,transition,trichome,two,unarmed,unit,usually,vary,vein,vivo,weakly,wide,yellowish,ympodial	arrangement,articulation,bark,capitate,color,connation,corolla,dehiscence,diminishing,form,growth,height,herb,history,interjected,leaf,leaflet,life,na,ovary,papillae,petiolule,plant,position,pseudostipule,seed,shape,spacing,straightnes,terminal,texture,tuber-bearing
143	wfo-0001026819	success	218	136	104	114	32	0.477	0-27,0.3-4.7,0.5-1.5,1-10,1-2,1.2-36,1.5-10,1.5-12,10-26,3-120,3-18,4-10,5-30,6-11,7,acuminate,acute,anther,apex,articulated,base,blue,broadly,brownish,bud,capitate,cell,chartaceous,cm,condition,connate,connivent,corolla,covering,cuneate,curved,densely,diameter,distal,dot,drying,elliptic,forked,fresh,fruit,globose,green,greenish,hair-like,herb,interjected,lanceolate,lateral,leaflet,light,long,lunate,membranous,middle,mm,moderately,mottled,narrowly,oblique,odd-pinnate,ovate,ovoid,pedicel,peduncle,pentagonal,petiole,petiolule,plant,poricidal,pubescent,purple,rotate-pentagonal,scale-like,scattered,seed,slightly,somewhat,stem,stigma,straight,stripe,style,subglabrous,suborbicular,subtending,symmetrical,terminal,testal,thick,tinged,tip,truncate,tube,violet,wall,white,whitish,wide,yellow	1-2.3,1-5,1.5-3.0,1.5-3.3,1.5-3.5,1.6-3.5,10,2-5,2-6,2.5-5,3-20,3-35,3-38,4,4-7,5-merou,abaxially,absent,acumen,adaxially,ag,along,alyx,apart,ascending,attenuate,bearing,blade,borne,ciliate,clavat,dark,decurrent,digestion,dorsally,eaf,edge,eed,end,enzyme,erec,especially,exceeding,filament,flat,flower,folded,geminat,generally,glabrou,glabrous,glaucous,greatly,green-white,greenish-yellow,hair,half,homostylous,honeycomb-shaped,larger,lengthening,like,living,lobe,lower,make,margin,midvein,minutely,mucilaginous,nflorescence,non-glandular,often,orolla,pair,pedice,plurifoliate,pore,puberulent,rachi,ranging,removed,ruit,seudostipule,short,singly,slit,sometimes,spaced,specimen,stamen,star,ste,stolo,subequal,subrosette,tall,tamen,tem,tertiary,therefore,throughout,tri-,tuber,typically,unit,unwinged,usually,vary,wet,wing,within,without,ympodial	arrangement,articulation,bark,calyx,clavate,color,connation,dehiscence,diminishing,form,fruiting,growth,height,history,inflorescence,leaf,length,life,na,ovary,papillae,position,prickle,pseudostipule,shape,size,spacing,straightnes,surface,texture,tuber-bearing,ye
144	wfo-0001026821	success	204	126	92	112	34	0.451	.2,0.2-1.5,0.3-2.5,0.4-1.5,0.5-3.5,1-20,1-3,1-5,1.5-2.5,10-15,2-6,2.5-18,3-11,3-branched,4-4.5,5-12,5-20,acuminate,anther,apart,apex,appressed,articulated,auriculate,base,broadly,brown,cm,cordate,cuneate,dark,diameter,distal,due,ellipsoidal,elliptic,flattened,flower,forked,frequent,fruit,gglobose,green,herb,interjected,lanceolate,lateral,leaf-opposed,leaflet,length,light,long-attenuate,longitudinal,mature,mm,oblique,obliquely,oblong,obtuse,occasionally,odd-pinnate,opening,pale,pedicel,peduncle,petiole,petiolule,pilose,puberulent,rarely,remnant,reniform,rounded,scandent,slit,small,somewhat,stellate,stigma,stripe,style,subglabrous,substellate,surface,terminal,thickening,tube,unbranched,wall,white,x,yellow	/3,0-20,0.3-1.2,0.5-1.2,0.7-1.8,0.8-1,1-1.5,1-2,1.2-1.5,17,1977,2-15,2-3.5,2-celled,3-18,3-6,3-7,3-celled,5-10,5-34,5-merou,abaxially,acut,adaxial,adaxially,ag,alyx,anderson,angular,apical,apically,apiculate,axe,ba,basal,bayonet,berry,blade,bract,cell,chartaceous,ciliat,deltate,directed,distally,eaf,eed,equal,especially,exceeding,filament,fused,geminat,glabrou,glabrous,gland-tipped,greatly,hair,homostylous,incurved,interstaminal,large,lobe,long,lower,lowermost,many,margin,mean,membrane,membranous,minute,minutely,moderately,much,narrowly,nflorescence,occasional,one-celled,orolla,pair,paired,per,perfect,plurifoliate,pore,present,pseudostipular,pubescen,pubescent,rachi,reduced,ruit,seudostipule,short,slender,slightly,smaller,spaced,sparsely,stamen,subtended,tamen,tem,time,tri-,truncat,unit,vary,wide,winged,ympodial	age,arrangement,articulation,bark,calyx,color,connation,corolla,dehiscence,diminishing,form,fruiting,growth,height,history,inflorescence,leaf,life,na,ovary,papillae,plant,position,prickle,pseudostipule,seed,shape,size,spacing,stem,straightnes,texture,truncate,tuber-bearing
145	wfo-0001026827	success	143	91	59	84	32	0.413	/3,0.2-0.5,0.4-0.6,0.5-2,0.6-1,1-,1-1.1,1-2,1.3-1.6,2-2.5,acute,age,anther,anthesi,apart,apex,attenuate,bark,base,calyx,clavate,cm,corolla,diameter,glabrous,growth,inflorescence,lanceolate,leaf,lengthening,lobed,minutely,mm,narrowly,nodding,oblanceolate,ovary,papillate,pedicel,peduncle,petiole,pore,poricidal,reddish,shrub,simple,slender,slit,small,stem,stigma,straight,style,surface,terminal,tip,tube,way,white	.5,1-1.5,1-2.1,1.5-2,2-2.2,2-4,3-9,5-6,7-9,?,abaxially,adaxiall,and/or,appearing,arachnoid,branch,branched,broadly,conical,crowded,deciduou,deltate,dendritic,dense,densely,distally,dry,drying,eaf,ellipsoid,erect,especially,exerted,filament,fleshy,flower,free,glabrescent,internodal,irregularly,know,known,lamina,less,like,lobe,lower,margin,near,new,nflorescence,ot,pair,paler,papillat,perfect,planar,plane,plurifoliat,portion,primary,pubescent,rachi,revolute,scar,sinus,soon,sparsely,stout,strongly,surfac,thick,thickened,third,trichome,tub,ud,uniseriate,unit,upper,vein,widest,x,ympodial	arrangement,articulation,color,connation,dehiscence,diminishing,distal,form,fruit,fruiting,height,history,interjected,lateral,leaflet,length,life,na,papillae,petiolule,plant,plurifoliate,position,prickle,pseudostipule,seed,shape,size,spacing,straightnes,texture,tuber-bearing
146	wfo-0001026830	success	198	132	102	96	30	0.515	0-10,0.3-1.3,0.4-1,0.5-1.0,1-10,1-11,1-2,1.1-2.7,1.4-4,1.5-4,10-57,2.7-8,3.5-8.5,4-10,4.5-17.5,6-13,abaxially,adaxially,anther,articulated,axillary,brown,brownish,bud,cell,ciliate,clavate,cm,condition,connivent,coriaceous,corolla,covering,deep,diameter,distal,drying,elliptic,finely,forked,fresh,fruit,generally,glabrescent,glabrous,globose,green,green-white,greenish,hair,hair-like,half,herb,high,interjected,lanceolate,lateral,leaf,leaflet,lengthening,make,margin,medium,mm,moniliform,mucilaginous,odd-pinnate,ovate,ovoid,pedicel,peduncle,pentagonal,petiole,plant,pore,poricidal,purple,ripe,rotate,seed,short,size,slit,stigma,straight,stripe,style,subglabrous,subtending,terminal,testal,thick,throughout,tip,tube,typically,wall,wet,white,whitish,x,yellow	0.5-1.2,0.9-1.9,2-4,2-6,2.5-4.4,2.5-5,4-14.5,4-7,4.4-14.5,5-11,5-merou,7-18,acumen,acuminate,acute,adaxiall,ag,along,alyx,apart,apex,apparently,arranged,asymmetric,attenuate,axe,base,basiscopic,bead,berry,blade,capitat,decreasing,digestion,dorsally,eaf,edge,eed,enzyme,erec,exceeding,filament,flat,flower,folded,geminat,glabrou,hal,homostylous,honeycomb,light,like,linear,living,lobe,long,lower,moderately,multiple,necklace,nflorescence,orbicular,orolla,pair,perfect,petiolulate,plurifoliate,puberulent,pubescent,removed,rounded,ruit,sessile,seudostipule,shaped,side,simple,spaced,specimen,stamen,stolon,subequal,subglabrou,tall,tamen,tem,tissue,toward,tri-,tuber,unit,unwinged,usually,vary,yellowish,ympodial	age,arrangement,articulation,bark,calyx,capitate,color,connation,dehiscence,form,fruiting,growth,height,history,inflorescence,length,life,na,ovary,papillae,position,prickle,pseudostipule,shape,spacing,stem,straightnes,surface,texture,tuber-bearing
147	wfo-0001026831	success	207	99	65	142	34	0.314	0-6,0.2-1,0.3-0.65,0.5-1.2,0.6,1-2.5,1-6,2.5-4.5,3-5,anther,apex,articulated,bark,base,bright,calyx,cell,cm,connivent,cream,dark,diameter,dull,elliptic,elongating,flattened-reniform,fruit,fruiting,glabrescent,green,lateral,leaf,length,lobed,long,marking,maturity,mauve,mm,moderately,orange,orange-brown,outline,pale,pedicel,peduncle,petiole,poricidal,prickle,raised,shiny,shrub,smooth,spherical,stellate-pubescent,stem,style,surface,tapering,tip,tube,white,white-gray,yellow,young	-0.25,-5,-6.5,-9,.5,/4,0-10,0-20,0-3,0.1,0.1-0.2,0.1-0.25,0.15-0.25,0.2-0.4,0.3-0.6,0.6-2,0.65-1,0.7-1.1,0.7-2,1-10,1-2,1-2.2,1-3,1-4,1.2-2,1.5-2.5,1/3,1/3-1/,1/3-2/3,1/5-1/4,2-2.5,2-3,2-4,2.3-2.9,3-6,3.5-10,5-merous,7-10,7-8,abaxially,acute,alyx,apar,apart,apically,apparently,attenuate,berry,blade,branched,broad-deltate,brow,caudat,chartaceous,concolorous,curved,deltate,densely,difoliate,distance,drying,eaf,eed,equal,erect,extending,eye,filament,flower,free,fully,geminat,glabrous,gray-brown,herbaceous,infructescence,less,lobe,longer,lower,margin,mature,membranous,midpoint,midvein,multangulate,naked,narrow-cuneate,nflorescence,oblong,occasionally,older,one,open,opening,orolla,oung,ovate,pair,pendulous,per,perfec,pericarp,porrect,portion,prickl,prickly,primary,ray,red-brown,reduced,rounded,ruit,scandent,scar,sessile,shorter,side,slender,sometimes,spaced,sparsely,spreading,stalk,stellate,subsessile,tamen,terete,tertiary,time,trichome,unit,upper,usually,vary,vein,venation,visible,way,wide,yellow-green,ympodial	arrangement,articulation,brown,color,connation,corolla,dehiscence,diminishing,distal,form,growth,height,history,inflorescence,interjected,leaflet,life,na,ovary,papillae,perennial,petiolule,plant,position,pseudostipule,seed,shape,size,spacing,stigma,straightnes,terminal,texture,tuber-bearing
148	wfo-0001026841	success	139	86	51	88	35	0.367	0.5-1,0.5-2,0.8-1,0.8-3,1.5,3.5-5,4-8,acute,anther,apart,apex,bark,base,bi-lobed,broadly,calyx,clavate,cm,conical,corolla,deflexed,elliptic,fruiting,glabrous,globose,green,inflorescence,lateral,leaf,lobed,minutely,mm,opposite,ovary,papillose,pedicel,petiole,poricidal,shaped,shining,shrub,simple,stem,stigma,straight,style,tear-drop,terminal,tip,tube,white	.25,.5,/4,0.05,0.25-0.3,0.25-0.5,0.5-0.75,0.6-1,0.75-1,1.5-2,2-2.5,3-6.5,5-8-flowered,6-8,7-9,9.2-18,along,anthesi,arch,axi,ba,beneath,berry,coroll,curly-tipped,decurrent,deltoid,dia,eaf,edicel,eed,ellipsoid,exsertion,filament,filiform,free,glabrate,greyish-gree,hyaline,immature,joined,known,later,like,lobe,lon,long,lower,main,margin,middle,nflorescence,older,pair,paler,papillo,pore,portion,prominent,pubescent,raised,reddish,reflexed,rest,ruit,scar,series,slender,slightly,spaced,sparsely,tall,tapering,thickened,trichome,ud,unevenly,unifoliat,uniseriate,unit,vein,way,widest,winged,woody,x,ympodial,young	arrangement,articulation,color,connation,dehiscence,diameter,diminishing,distal,form,fruit,greyish-green,growth,height,history,interjected,leaflet,length,life,na,papillae,peduncle,petiolule,plant,position,prickle,pseudostipule,seed,shape,size,spacing,straightnes,surface,texture,tuber-bearing,unifoliate
149	wfo-0001026849	success	180	95	62	118	33	0.344	0-10,0.5-1,1,1-2,1-6,2-3,38/2,5-10,637/2,7-8,acute,anther,apex,aster,base,brown,calyx,capitate,cm,conical,corolla,cyme,discoidal,distinctly,expanded,flowered,fruiting,glabrous,green,grey-brown,growth,inflorescence,lavender,leaf,linear-lanceolate,long-cuneate,minutely,mm,oblong,oblong-lanceolate,ovary,pedicel,peduncle,petiole,poricidal,reticulate,rh,rotate,rounded,sea,seed,shrub,slightly,soft-wooded,stem,stigma,style,surface,tip,tube,violet,x	-50,1-1.5,1.5-2.5,1.75-2,100-130,11,2,30-,40,5,80-,adherent,adult,amongst,appearing,aspect,australian,axil,berry,cell,colour,composed,conspicuous,curved,cut,deflexed,developed,dia,distinct,eed,ellipsoid,emarginate,enlarge,entire,erect,exceeding,except,exerted,facetted,filament,filled,flesh,floral,flower,fork,free,general,glandular,globose,globular,granule,greater,gree,hair,half,interacuminal,large,leave,lengthening,less,little,lobe,lon,long,loosely,lower,margin,mature,maturity,mid-vein,minute,native,nflorescence,occasionally,often,pal,pale,pedicellate,petal,plurifoliat,pore,preparation,pruinose,purple,rarely,relatively,reproducing,rhachi,ruit,ruiting,shallow,shed,short-lived,simple,sinus,slende,slit,solanum,solitary,sometimes,somewhat,soon,stone,stony,stout,thus,tissue,tub,ud,unarmed,undulate,unit,uvenile,vegetatively,way,well,ympodial,young	arrangement,articulation,bark,color,connation,dehiscence,diameter,diminishing,distal,enlarged,form,fruit,height,history,interjected,lateral,leaflet,length,life,na,papillae,petiolule,plant,plurifoliate,position,prickle,shape,size,spacing,straightnes,terminal,texture,tuber-bearing
150	wfo-0001026851	success	267	135	98	169	37	0.367	0.3–1,0–1,10-15,175–415,1–7,2,2–10,300,5,acicular,acute,anther,apex,appearing,armed,articulated,average,base,berry,bilobed,branched,bright,broadly,c.,calyx,capitate,circular,cm,connivent,conspicuously,cordate,dark,diameter,directed,distally,enlarged,fading,flattened,flower,fruit,fruiting,globose,glossy,greenish,heavily,infructescence,inside,irregularly,lateral,leaf,less,light,lighter,lobe,lobed,long,long-styled,matte,membranous,minutely,mm,much,occasionally,orange,outside,ovate,pedicel,peduncle,per,petiole,plant,pore,poricidal,prickle,shrub,size,slightly,small,sprawling,stellate,stem,straight,straw-colored,style,suborbicular,surface,tall,tapering,thick,tip,tube,unbranched,way,white,winged,yellow,–13,–2	-2,-celled,.4,.8,0.8–1.5,1,1-7,1.5,1.5–2,1.5–2.8,15,1979,1–4.5,2.2–3.6,2.5–4,2/3,2–3,2–3.5,3–3.6,3–5,4-5,4–5-celled,4–6,4–6-celled,5-merous,5–6.5,5–7-celled,6–11,7–12,8–10.5,8–15,=,abaxial,abaxiall,abundant,adaxial,almost,alyx,andromonoecious,apar,ba,becoming,blade,ciliate,coarse,coarsely,coil,complete,conspicuous,curve,densely,dentate,difoliate,distall,dot,eaf,eed,elongating,endocarp,entire,equal,evenly,exceeding,except,eye,fertile,fide,filament,fine,flexuous,free,geminat,glabrous,gland,grading,gradually,green,hair,heterostylous,hyaline,lacking,large,larger,lenticel,little,live,lower,major,making,margin,merely,midrib,minor,minute,moderately,mostly,n,naked,narrowly,near,nearly,nee,nflorescence,often,one,orolla,otherwise,oung,pair,papillo,pattern,pericarp,pilose,portion,preserved,prickly,pubescence,pubescent,recurved,reflexed,rest,ruit,sap,scanden,scant,scar,scarious,scattered,sessile,shiny,short-styled,similar,simple,slender,smaller,sometimes,somewhat,spaced,sparsely,specimen,speckled,spongy,spreading,stamen,staminat,stipitate,stipitate-glandular,tamen,tasteles,terete,thickened,tooth,tough,triangular,trichome,twice,unarmed,uniform,unit,usually,vary,vein,visible,watery,well,wide,wing,yellowish,ympodial	apart,arrangement,articulation,bark,color,connation,corolla,dehiscence,diminishing,distal,form,geminate,growth,height,history,inflorescence,interjected,leaflet,length,life,na,number,ovary,papillae,papillose,petiolule,position,pseudostipule,scandent,seed,shape,spacing,stigma,straightnes,terminal,texture,tuber-bearing
151	wfo-0001026858	success	153	114	90	63	24	0.588	0.8,1-10,1-11.5,1-5,1.5-4,2-3,2-4,2.5-3,6-10,6-18,6-7,abaxially,abruptly,acute,adaxially,apex,apical,apically,articulate,base,branched,calyx,cell,cm,connate,cordate,corolla,covering,cuneate,cyme,dehiscent,diameter,dichasial,dichasially,diminishing,distal,ebracteate,forked,glabrescent,glabrous,globose,green,green-white,hair-like,herbaceous,interjected,introrse,lateral,leaf,leaflet,light,long,make,maturing,mm,monochasial,mucilaginous,oblique,obtuse,odd-pinnate,often,ovate,ovate-lanceolate,ovoid,pedicel,peduncle,perennial,petiole,plant,poricidally,proximal,rounded,seed,shiny,short,size,slightly,slit,stellate,stigma,style,testal,thick,throughout,toward,tuber-bearing,wall,wide,yellow,¼	-30,-4,0-.,0.5,0.8-1,1-,1-4,1.3-1.5,2-2.5,3-,3-4,3-6-foliat,4-24,4.5-10.5,5-15,acumen,digestion,dorsally,eaf,edge,eed,emoval,enzyme,exceeding,filament,flat,flower,folded,generally,globo,half,honeycomb,living,lobe,lon,lower,lunat,minute,mucronate,nflorescence,nther,oblong,orolla,pair,pattern,perfect,plan,reveal,ruit,seudostipule,specimen,stamen,straight,tal,tem,throughou,triangular,typically,unit,vary,white-crea,without,ympodial	0-2,anther,arrangement,color,dehiscence,form,fruit,growth,height,history,inflorescence,length,life,lunate,pseudostipule,shape,spacing,stem,surface,terminal,texture,wet,white-cream,ye
152	wfo-0001026870	success	206	98	69	137	29	0.335	0,0.4-0.8,0.5-1,0.7-1.4,1-11,1.4-1.8,2-6,2-7,3-12,4-9,9.5-12,accrescent,acute,anther,apex,articulated,base,black,brownish,calyx,chartaceous,cm,color,cuneate,diameter,directed,distal,elliptical,extra-axillary,female,finely,flower,forked,fruit,fruiting,globose,inflorescence,lanceolate,lateral,length,long,male,minute,mm,obtuse,ovate,ovate-reniform,pedicel,peduncle,perennial,petiole,plant,prickle,pseudo-racemose,purple,reticulate,rotate,rotate-stellate,shrub,simple,solitary,stem,stigma,straight,style,surface,tube,unknown,yellow	%,.05,.5,0-0.1,0-1,0.05-0.15,0.2-0.35,0.2-1.2,0.25-0.4,0.25-0.5,0.3-0.4,0.7-2,1,1-4,1-5,1.5-2,1.9-3,10-14,11-14,12-28,140-600,15-25,18-30,2-3,2-3.5,2-5,2-foliate,2.5-12,3-10,3-5,300-600,4-5,4-7,5-7.5,5-merou,6-70,7-11,7-8,abaxially,absent,abundant,acicular,adaxiall,adaxially,alyx,apart,armed,ascending,axe,ba,basal,blade,broad-based,broadly,brown,cylindrical,d.,deeply,deltate,densely,diamete,dioecious,distall,distributed,dult,eaf,eed,eglandular,enclosing,erect,filament,finger,flattened,functional,geminat,glabrou,glabrous,gland-tipped,grey,grey-green,hair,heterostylous,index,interpetalar,lamina,lobe,lobed,lobing,lon,longer,lower,margin,mature,midpoint,midvein,nflorescence,oblique,orolla,part,per,pore,porrect,presen,present,probably,ray,rhizomatous,ridged,ruit,rusty,sessile,short,side,spaced,stage,stalk,stellae,stellate-pubescent,tal,tamen,terete,thick,throughout,time,tissue,triangular,unbranched,unit,unknow,uvenile,vary,vein,white,wide,x,yellowish,ympodial	arrangement,articulation,bark,connation,corolla,dehiscence,diminishing,distally,form,growth,height,history,interjected,leaf,leaflet,life,na,ovary,papillae,position,pseudostipule,seed,shape,size,spacing,straightnes,terminal,texture,tuber-bearing
153	wfo-0001026874	success	222	114	72	150	42	0.324	.3,0-1,0.5,1.5,2,4.5,6-7,acuminate,acute,anther,apex,asymmetric,attenuate,base,based,broad,broadly,calyx,cm,compressed,connivent,diameter,flower,foveolate,fruit,fruiting,glabrate,glabrous,globose,growth,lanceolate,lateral,laterally,leaf,length,lenticular,long,mm,obtuse,orange,ovate,pedicel,peduncle,petiole,prickle,recurved,reddish,ripe,rounded,scabrous,sessile,shrub,simple,slender,somewhat,sparsely,spreading,stellate,stellate-pentagonal,stem,stigma,style,surface,tan,thin-textured,truncate,tube,usually,white,x,yellow,–5	.5,0,0.2–0.6,1.5–2.5,1.5–4,1.5–5,12–20,15-20,1–,1–3,2-foliate,2–2.5,2–3,2–4,2–5,2–6,2–several-branched,3-5,4–7.5,5.5,5.5–7.5,5–15,6–12,6–9,8-12,8–20,9.5–11.5,abaxially,absent,across,adaxiall,adaxially,along,apar,apical,axe,basally,berry,beset,blade,capitate,caudate,clavat,colored,dark,deltoid,dense,densely,depressed,developed,drying,eaf,eed,entire,erect,except,filament,filiform,finely,flowering,geminat,generally,glabrou,gland,glandular,glandular-pubescent,green,hair,hermaphroditic,internode,interpetalar,juvenile,lance,lanceolat,lanceoloid,larger,lighter,like,lobe,lon,lower,main,major,margin,midpoint,midrib,midvein,minute,moderately,narrowly,near,new,nflorescence,often,orolla,ovoid,per,perfect,pinnatifid,point,pore,portion,present,prickly,prominently,pubescen,pubescence,pubescent,rachi,reduced,repand,ruit,scattered,shiny,short,side,similar,slightly,small,sometimes,spaced,sparse,stalked,stellae,stellate-tomentose,straight,subulate,swollen,tall,tamen,tem,tip,tipped,tissue,tooth,ud,unarmed,upon,variable,vary,varying,vein,vestiture,warty,weakly,widely,widest,yello,ympodia,–many	0.2-0.6,1-,1-3,1.5-4,12-20,2-6,2-several-branched,6-12,9.5-11.5,apart,arrangement,articulation,bark,clavate,color,connation,corolla,dehiscence,diminishing,distal,form,height,history,inflorescence,interjected,leaflet,life,na,ovary,papillae,petiolule,plant,position,pseudostipule,seed,shape,size,spacing,straightnes,terminal,texture,tuber-bearing
154	wfo-0001026895	success	166	98	66	100	32	0.398	0.5-1.2,0.5-1.5,0.5-2,0.8-1,1-1.5,1.4-2.1,2/3,acute,anther,apically,bark,base,broadly,brown,calyx,capitate,closely,cm,conical,corolla,dark,drying,elliptic,flattened,fruiting,glabrous,globose,green,incrassate,internodal,lateral,leaf,lobed,margin,minutely,mm,mustard,narrowly,often,ovary,pale,pedicel,petiole,pitted,pointed,poricidal,pubescent,reniform,shape,shaped,shrub,shrublet,simple,size,spaced,stem,stigma,style,surface,tan,tear-drop,tip,tube,way,white,yellow	.5,0-0.5,0.5-1,1-5,1.5-2,2-2.3,2-2.5,2-3,2.5-3.2,3-12,4.5-5,5-6,5-8-flowered,abaxial,adaxial,along,anthesi,apex,apical,appearing,attenuate,ba,berry,borne,broad,campanulate,contracted,deflexed,deltoid,dendritic,denser,dia,differing,difoliate,eaf,edicel,eed,ellipsoid,elongate,erect,filament,filiform,free,geminat,glabrate,hard,lamina,like,lobe,lon,long,long-exserted,lower,main,major,middle,minor,minute,nflorescence,obovate,older,overlappin,pair,papillo,pericarp,pore,portion,present,projection,reddish,reddish-brow,ruit,scar,scattered,shoot,short,side,small,somewhat,soon,sparsely,swollen,swollen-based,tall,thin,toothed,trichome,tub,tuft,type,ud,uniseriate,unit,usually,vein,widest,woody,x,ympodial,young	alternate,arrangement,articulation,color,connation,dehiscence,diameter,form,fruit,growth,height,history,inflorescence,interjected,leaflet,length,life,na,overlapping,papillae,papillose,peduncle,plant,position,prickle,pseudostipule,reddish-brown,seed,spacing,straightnes,terminal,texture
155	wfo-0001026905	success	204	120	87	117	33	0.426	-2,0,0-2,0.4-1,0.5-0.7,0.5-1.5,0.6-0.7,1-2.5,1-4,1/2-3/4,2-3,3-5,anther,apart,apex,apically,articulated,attenuate,bark,base,berry,branched,calyx,cell,cm,connivent,cream,curved,dark,diameter,dull,elongating,flattened-reniform,fruit,fruiting,green,inflorescence,lateral,leaf,length,lobed,long,longer,marking,maturity,mauve,mm,moderately,oblong,orange,orange-brown,outline,ovate,pale,pedicel,peduncle,petiole,pit,poricidal,prickle,prickly,raised,red,rounded,shrub,small,smooth,sometimes,sparsely,spherical,stellate-pubescent,stem,style,subentire,surface,tapering,time,tip,tube,unarmed,usually,way,weakly,white,wide,yellow,young	-1.5,-10,-2/3,-3,-4,.2,.5,0-20,0-25,0.1,0.15,0.2-0.3,0.2-0.5,0.3-0.4,0.4,0.4-0.9,0.7-1.4,0.75-1.1,0.9-1.3,1,1-2,1-20,1-3.7,1-6,1.9-2.5,1/3,1/4,1/5-1/3,2.5-2.9,2.5-3.5,2/3-3/,3-8,5-6,5-merous,6-8,7-8,abaxially,acuminat,acute,alyx,ame,apar,apparently,blade,brow,c.,chartaceous,deltate,densely,difoliate,discolorous,distance,drying,eaf,eed,equal,erect,extending,eye,filament,flower,free,geminat,glabrous,gray-green,infructescence,lobe,lower,margin,mature,midpoint,midvein,naked,older,one,open,orolla,oung,pair,pendulous,per,perfec,pericarp,porrect,portion,prickl,primary,ray,reduced,ruit,scar,sessile,shallowly,shorter,side,slender,somewhat,spaced,spreading,stalk,stalked,stellate,straight,tamen,terete,tertiary,trichome,unit,upper,variously,vary,vein,venation,visible,woody,yellow-green,ympodial	alternate,arrangement,articulation,brown,color,connation,corolla,dehiscence,diminishing,distal,form,growth,height,history,interjected,leaflet,life,na,ovary,papillae,perennial,petiolule,plant,position,seed,shape,size,spacing,stigma,straightnes,terminal,texture,tuber-bearing
156	wfo-0001026923	success	177	115	85	92	30	0.48	0-5,0.25-0.5,0.5-1,1-1.5,2-2.5,2-6,3-5,5-10,5-15,5-9,abaxially,accrescent,acuminate,adaxially,anther,apart,apex,articulated,base,black,branched,brown,calyx,chartaceous,cm,connivent,cuneate,curved,densely,diameter,elliptic,elliptic-ovate,flattened,flower,forked,fruit,fruiting,glabrescent,globose,green,hair,lateral,leaf,leaf-opposed,light,like,longitudinal,mm,moderately,oblong,opening,orange,pedicel,peduncle,petiole,possibly,pubescence,pubescent,purple,red,ripening,rounded,rugulose,sessile,shrub,simple,slightly,slit,small,sparsely,stellate,stem,stigma,straight,strongly,style,surface,tree,trichome,tube,usually,white,x,yellow,yellowish	-5,.1-0.3,.5,0.5,0.6-0.8,0.8-1,1,1-3,1-4,1-7,1.5-2,1.5-4,10,2,2-3,20-50,3-4,4-18,4-5-,5-6,absent,acute,adaxiall,ag,apparently,axe,ba,blade,capitat,center,covering,cylindrical,deltate,denser,directed,distally,eaf,eed,eglandular,entire,equal,erect,filament,frui,fused,geminate,glabrous,gland-tippe,glandular,held,intermediate,lanceolate,large,lobe,long,lower,many-foliate,margin,midpoint,midvein,much,multangulate,nearly,nflorescence,orolla,paired,peltate,perfect,pore,rachi,ray,relatively,ruit,scale,short,smaller,sometimes,somewhat,spaced,ste,subtending,tal,tamen,tem,time,tip,unit,uprigh,vary,whitish,wide,ympodial	age,arrangement,articulation,capitate,color,connation,corolla,dehiscence,form,growth,height,history,inflorescence,interjected,leaflet,length,life,na,ovary,papillae,plant,position,pseudostipule,seed,shape,size,spacing,straightnes,terminal,texture
157	wfo-0001026924	success	190	107	72	118	35	0.379	0-2.3,0.2-0.4,0.5-6,0.8-2.6,2-4,3-6,5-7,8-9,abaxially,absent,accrescent,acute,adaxially,anther,apex,base,brown,calyx,cm,cordate,cuneate,densely,diameter,drab,drying,extra-axillary,finally,fruit,fruiting,globose,green,grey,grey-green,herbaceous,inflorescence,lanceolate,lateral,length,light,lobed,minutely,mm,obtuse,ovate,pale,pedicel,peduncle,petiole,present,prickle,pseudo-racemose,purple,resprouter,rostrate,rusty,shallowly,simple,slightly,stellate,stellate-pubescent,stem,stigma,style,surface,truncate,tube,unarmed,unbranched,undulate,white,yellow,yellowish	%,-4,0-0.2,0-1.5,0-2,0.05-0.1,0.05-0.2,0.1-0.3,0.4-0.5,0.5-0.6,0.5-0.7,0.5-0.8,0.5-1.5,0.7-1.1,0.7-1.2,0.8-1.2,0.9-1.3,1-1.5,1-4,1-6,1.1-4.2,10-13,17-40,2-,2-2.5,2-foliate,2.8-8.5,3,4-7,4.3-6.2,5,5-merou,6-8,7-10,7-8,absen,acicular,across,adaxiall,alyx,apart,apparently,appearance,axe,blade,capitat,chartaceous,connivent,curved,cylindrical,d.,directed,distall,distally,distributed,dult,eaf,eed,eglandular,entire,erect,finger,first,flower,geminat,glabrou,glabrous,gland-tipped,hair,half,lamina,less,lobe,long,longer,lower,margin,markedly,mature,mid-poin,midpoint,minute,narrowly,nflorescence,oblique,orolla,part,per,perfect,pore,porrect,rachi,raisin-like,ray,ruit,short,spaced,sparsely,stage,stalk,stellae,straight,tal,tamen,thick,thicker,thicknes,throughout,time,triangular,unarme,unit,unknow,uvenile,vary,wide,x,ympodial	arrangement,articulation,bark,capitate,color,connation,corolla,dehiscence,diminishing,distal,form,growth,height,herb,history,interjected,leaf,leaflet,life,linear,na,ovary,papillae,petiolule,plant,position,pseudostipule,seed,shape,size,spacing,straightnes,terminal,texture,tuber-bearing
158	wfo-0001026925	success	215	112	81	134	31	0.377	/6,0-20,0.5-1.5,0.9-1.8,1-1.4,1-25,1-3.5,1.5-4.5,2-5,3-20,3-7,7-12,anther,apart,apex,apparently,articulated,bark,base,berry,calyx,chartaceous,cm,connivent,cream,curved,dark,deltate,diameter,distal,elliptic,elongating,flattened,flattened-reniform,fruit,fruiting,gently,glabrescent,glabrous,green,green-brown,lateral,leaf,length,lobed,long,marking,mature,maturity,mauve,membranous,mm,moderately,orange-brown,ovate,pale,pedicel,peduncle,petiole,plant,poricidal,prickle,reflexed,shrub,spaced,sparsely,spherical,stellate-pubescent,stem,straight,style,surface,tapering,terminal,tip,tube,white,wide,yellow,yellow-orange,young	-2,.5,0,0-10,0-5,0-7,0.1,0.1-0.2,0.1-0.3,0.2,0.5-4,0.7-1.8,00-200,1-1.3,1-3,1-4,1.5-2,1.5-2.5,1.8-2,1.8-2.5,1/3,1/3-1/2,1/4-2/3,1/6-1/3,2-4,2.4-2.6,2.4-3,2.5-6,2/,4-10,4-14,4-5,4-7,5-6,5-8,5-merous,5.5-10,6-10,6-17,6-8,abaxially,acuminat,acute,alyx,ame,andromonoecious,apar,apically,attenuate,blade,branched,broad-deltate,brow,c.,concolorous,distance,drying,eaf,eed,equal,erect,extending,filament,flower,free,hair,hermaphrodite,heterostylous,infructescence,lobe,lobing,long-styled,longer,lower,lowermost,margin,midpoint,midvein,minute,narrow-deltate,nflorescence,oblong,older,one,open,orolla,oung,pair,pendent,pendulous,per,pericarp,plurifoliat,porrect,portion,prickl,prickly,primary,rarely,ray,red-brown,reduced,rounded,ruit,scar,secondary,sessile,short-styled,side,simple,smooth,sometimes,spreading,stalk,stalked,staminat,stellate,stout,tamen,terete,tertiary,time,translucent,trichome,unarmed,unit,upper,vary,vein,venation,visible,way,woody,ympodial	arrangement,articulation,brown,color,connation,corolla,dehiscence,diminishing,form,growth,height,history,inflorescence,interjected,leaflet,life,na,ovary,papillae,perennial,petiolule,position,pseudostipule,seed,shape,size,spacing,stigma,straightnes,texture,tuber-bearing
159	wfo-0001026946	success	205	112	81	124	31	0.395	0-20,0-5,0.5-2,0.9-3.5,0.9-4.3,1-10,1-2,1-4,12-23,2-15,2.5-10.5,2.7-9,3-20,3-5,3.5-10,4.1-9.4,8-15,acuminate,acute,anther,apex,articulation,base,chartaceous,clavate,cm,connivent,corolla,creamy,deeply,diameter,distal,elliptic,extremely,forked,fruit,globose,green,greenish,herb,interjected,lanceolate,lateral,leaflet,membranous,mm,mucilaginous,oblique,odd-pinnate,ovate,ovoid,pedicel,peduncle,pentagonal,petiole,petiolule,plant,poricidal,pure,purple,rounded,seed,size,slightly,stellate,stem,stigma,straight,streak,style,terminal,tip,truncate,tube,typically,variable,white,whitish,x,yellow,yellow-white	1,1.5-2,1.6-3.7,10-39,2,2-5,3-6,4-7,5-7,5-merou,6-24,8-25,abaxially,acumen,adaxially,ag,along,alyx,apart,apparently,attenuate,axe,axillary,berry,blade,borne,broadly,brownish,bud,capitat,cell,ciliate,condition,covering,densely,digestion,dorsally,dot,drying,eaf,edge,eed,end,enzyme,erec,especially,exceeding,except,filament,flat,flower,folded,fresh,geminat,generally,glabrou,glabrous,greatly,green-white,hair,hair-like,half,homostylous,honeycomb-shaped,lengthening,like,living,lobe,long,lower,make,margin,midrib,minutely,mottled,narrowly,nflorescence,often,orbicular,orolla,pair,perfect,petiolulate,plurifoliate,pore,proximal,puberulent,pubescen,pubescent,reduced,removed,ripe,ruit,scattered,sessile,seudostipule,short,short-pubescent,singly,slit,spaced,specimen,stamen,ste,stolo,subequal,subtending,tall,tamen,tem,testal,thick,thir,throughout,tri-,tuber,unit,unwinged,usually,vary,wall,wet,wing,ympodial	arrangement,bark,calyx,capitate,color,connation,dehiscence,diminishing,erect,form,fruiting,growth,height,history,inflorescence,leaf,length,life,na,ovary,papillae,position,prickle,pseudostipule,shape,spacing,straightnes,surface,texture,tuber-bearing,ye
160	wfo-0001026962	success	205	113	80	125	33	0.39	0.3-0.7,1-1.5,1-3,1.5-5,10-12,2-2.5,2-6,2/3-3/4,6-7,abaxially,accrescent,acute,adaxially,anther,apex,articulated,bark,base,calyx,cm,connivent,corolla,densely,diameter,difoliate,dry,elliptic,evenly,flattened-reniform,fruit,fruiting,globose,green,inflorescence,internodal,lateral,leaf,lobed,longitudinal,material,minutely,mm,narrowly,obconic,oblong,occasionally,opening,opposite,pale,pedicel,peduncle,petiole,pitted,pubescent,purplish,rounded,sagittate,shrub,size,slightly,slit,small,sometimes,somewhat,stellate,stem,stigma,straight,style,surface,tinged,tip,tree,tube,unbranched,unifoliate,way,white,yellow,yellowish	.05,.5,0,0.5,0.5-0.8,0.5-1,0.5-1.5,0.8-1,1,1-1.2,1-2,1-4.5,1-6,1.5-17,1.5-2,1.5-3,10-20,15-22,2-5,3-3.5,3-6,4-5,9-12,9-17,abrupt,abruptly,ag,alyx,anthesi,apparently,appearing,arising,axe,basebud,becoming,beneath,blade,brittle,broadly,bud,capitat,cell,chartaceous,closely,composed,constricted,cucullat,cylindrical,darker,deflexed,deltate,denser,differing,dimorphic,eaf,eed,elongate,entire,except,exerted,filament,flower,free,geminat,glabrate,glabrou,glabrous,ilament,incrassate,later,like,lobe,long,main,major,margin,minor,nflorescence,obovoid,often,older,one,orolla,oung,outline,ovate-lanceolate,overlapping,packed,pair,papillose,paten,pendent,perfect,pore,portion,prominent,pubescen,rachi,raised,reflexed,remaining,rest,rounder,ruit,shaped,simple,slender,soon,tal,tapering,tear-drop,tooth,triangular,trichome,trunk,unarmed,uniseriate,unit,vary,vein,whit,woody,x,ympodial,young	age,arrangement,articulation,capitate,color,connation,dehiscence,diminishing,distal,form,geminate,growth,height,history,interjected,leaflet,length,life,na,ovary,papillae,petiolule,plant,position,prickle,pseudostipule,seed,shape,spacing,straightnes,terminal,texture,tuber-bearing
161	wfo-0001026963	success	151	97	61	90	36	0.404	.4,0.2-0.6,1.2-1.5,1.5-4.5,1.5-6,2-2.5,2-4.5,acute,anther,apex,apical,articulated,bark,base,c.,calyx,capitate,closely,cm,coriaceous,corolla,dark,diameter,elliptic,elongate,flower,growth,herb,inflorescence,internodal,lobed,long-styled,markedly,membranous,minute,minutely,mm,oblique,ovary,ovate,pedicel,peduncle,petiole,poricidal,prickle,reddish,short-styled,simple,spaced,stem,stigma,style,subshrub,surface,tapering,tip,tooth,truncate,tube,way,white	-5,.5,0.5,0.5-0.6,0.8-3,1-1.5,1-2,1.1-1.4,3-5,3-5-rayed,4,4-5,5-6,6-7,<,abaxially,abruptly,absent,acicular,anthesi,armed,brow,clustered,conical,creeping,cup-shaped,curved,deep,densely,eaf,eed,ellipsoid,elongating,filament,free,glabrous,heterostylous,included,inflorescenc,know,known,like,lobe,long,long-triangular,lower,margin,mature,midpoint,new,nflorescence,nodding,node,older,outline,pair,papillo,per,plurifoliat,pore,porrect,portion,prickly,primary,prominent,pubescent,ray,reflexed,rooting,rootstock,ruit,scar,scattered,sessile,shallowly,side,slit,small,sometimes,sparsely,stellate,trichome,ud,unarmed,unit,vein,woody,x,yellowish,ympodial	arrangement,articulation,brown,color,connation,dehiscence,diminishing,distal,form,fruit,fruiting,height,history,interjected,lateral,leaf,leaflet,length,life,na,papillae,papillose,perennial,petiolule,plant,position,present,pseudostipule,seed,shape,size,spacing,straightnes,terminal,texture,tuber-bearing
162	wfo-0001026964	success	128	99	65	63	34	0.508	.5,0.5-1,1-1.2,1-2.5,10-30,2-2.5,3-5,3.5-7,4.5-8.5,acuminate,acute,along,anther,apex,attenuate,axillary,base,beak,calyx,cm,conical,corolla,diameter,elliptic,fruiting,glabrous,green,greenish,herb,lateral,leaflet,lobed,long-attenuate,margin,minutely,mm,nearly,obovate,onto,ovary,papillate,pedicel,petiole,petiolule,pinnate,poricidal,pubescent,purple,rachi,rugose,shape,simple,size,slender,smooth,somewhat,sparsely,stigma,style,surface,terminal,tip,tube,x,yellow	.2,0,0.5,10,2-4,7-8,?,anthesi,basal,bearing,berry,capitat,conspicuously,differentiated,distinct,eaf,edicel,equal,erec,exserted,filament,filiform,fleshy,flower,free,glabrou,globose,horizontal,immature,known,lenticellate,lightly,line,lobe,long,lower,nflorescence,noddin,often,one,open,ot,pair,portion,primary,purpli,reflexed,ruit,scar,side,small,tal,tem,time,trichome,tub,ud,unifoliat,uniseriate,unit,vein,winged,ympodial	arrangement,articulation,bark,capitate,color,connation,dehiscence,diminishing,distal,erect,form,fruit,growth,height,history,inflorescence,interjected,leaf,length,life,na,papillae,peduncle,perennial,plant,position,prickle,pseudostipule,seed,spacing,stem,straightnes,texture,tuber-bearing
163	wfo-0001026965	success	157	91	52	105	39	0.331	-2.5,0.6-2,0.7-1.5,1.5-4,1.7-2,2.5-4,3.5-6.2,acute,anther,apex,articulated,base,calyx,campanulate,capitate,cm,cuneate-attenuate,diameter,ellipsoidal,elliptical,evident,fruiting,globose,herb,mm,narrowly,obovate,ovate,pale,papery-scarious,papillae,petiole,poricidal,procumbent,pubescent,reticulate,seed,stem,stigma,straight,style,surface,tip,trans-ovoidal,tube,tuberculate,unifoliate,venation,violet,white,x,yellow	.3,.5,.6,0.2,0.4,0.5-,0.5-1.5,0.6-1.1,0.7-1,0.7-1.1,0.8-1.25,1.1-1.65,1.3-2,1.5-2,1.9-2.4,2/3,25,3-,3-4,3.5-9,5-15,6.4-12,8-17,abaxially,abundant,accrescent,adaxially,ag,antrorse,appressed,basal,berry,broadly,c.,coat,coiled,connectival,covering,cylindrical,difoliat,dorsal,eaf,eed,eglandular,elliptic,embryo,exserted,filament,flexuose,glabrous,glandular,herbaceous,hig,latitudinally,lobe,long,longer,longitudinal,longitudinally,lower,margin,mixed,multi-seeded,non-glandular,noticeable,opening,opposite,orolla,outer,ovat,pair,papillose,partially,pinnatifid,pinnatipartite,pore,portion,prolongation,prostrate,ree,ridged,rounded,ruit,segment,short,similar,simple,slightly,slit,small,smooth,striate,strongly,styl,subglobose,tem,time,trichome,unequal,uniseriate,unit,vary,wider,winged,ympodial	3-15,arrangement,articulation,bark,color,connation,corolla,dehiscence,difoliate,diminishing,distal,form,fruit,growth,height,history,inflorescence,interjected,lateral,leaf,leaflet,length,life,na,ovary,pedicel,peduncle,petiolule,plant,position,prickle,pseudostipule,shape,size,spacing,straightnes,terminal,texture,tuber-bearing
164	wfo-0001026981	success	252	143	118	134	25	0.468	-0.8,-14,-35,.2,0.05-0.1,0.1-0.2,0.1-0.3,0.2,0.2-0.4,0.3.6,0.4-2,0.5-30,0.6-2,0.8-6,1-3,1-3.3,1-4,1/3,2-3-branched,4,4-8,6-10,7.5,abaxially,acute,adaxially,adpressed,anther,apex,appearance,articulated,articulation,asymmetric,base,beak,brown,calyx,capitate,cell,cm,cordate,corolla,densely,diameter,distal,entire,fruit,fruiting,giving,glabrescent,globose,green,hair-like,herb,imparipinnate,interjected,interrupted,irregularly,jointles,lateral,leaf,leaflet,linear,lobed,long,maturity,minutely,mm,multicellular,narrowly,obovate,occasionally,orange,orbicular,outgrowth,ovary,ovate,pale,pedicel,peduncle,pentagonal,perennial,petiole,petiolule,plant,present,pronounced,pseudostipule,pubescent,rick,rounded,see,sessile,shaggy,short,silky,simple,sometimes,sparsely,stem,stigma,style,surface,terminal,testa,trichome,tube,uni-,uniseriate,usually,velvety,wall,wide,winged,without,yellow,‘,’	-0.4,-2,-2.5,-4,-8,.2-0.2,0-5,0.15-0.2,0.2-2,0.25-0.4,0.3-0.5,0.4-0.5,0.4-0.7,0.45-1.3,0.5,0.5-0.3,0.6-1.4,0.7-0.8,0.8-1.2,0.9-1.4,0.9-1.5,1,1-2,1-2-cellular,1-3-celled,1.5-2.0,1.5-5,1.5-8.5,1.8-2.8,11,196.,2-3,2-locular,3-foliate,3.5-14,4-celled,<,absen,absent,abundant,academy,accrescent,along,amongst,angled,anthesi,apical,appendage,appressed,axi,basiscopically,bay,becoming,bract,bracteole-like,citrus-like,coastal,column,composed,cone,conical,d,dark,deltate,eaf,ebracteate,edicel,eed,erect,exserted,filament,flower,glandular,gree,half,halfway,head,included,initially,internode,larger,later,less,like,lime,lobe,lon,lower,mainly,margin,mixed,much,nflorescence,pair,patent,per,population,primary,procumbent,proximal,pubescence,rachi,reflexed,robust,ruit,scen,secondary,several,shaped,shorter,slender,smaller,sparser,specimen,spreadin,staminal,sterile,straight,strong,tangled,tem,tertiary,thick,tightly,transparent,tub,type,unicellular,unit,upto,variously,villous,viny,ympodial	1967,arrangement,bark,color,connation,dehiscence,diminishing,form,growth,height,history,inflorescence,length,life,na,papillae,position,prickle,seed,shape,size,spacing,straightnes,texture,tuber-bearing
165	wfo-0001026987	success	214	91	58	156	33	0.271	0-1,0.4-1,0.5-2,1-2,1-3,2-5,4-6,5.5-7,absent,accrescent,anther,apex,articulated,base,bent,calyx,chartaceous,cm,connivent,diameter,extra-axillary,fruit,fruiting,globose,inflorescence,lanceolate,lateral,leaf,length,lilac,loosely,mm,often,ovate,pale,pedicel,peduncle,perennial,petiole,prickle,purple,red,scarcely,shrub,simple,stellate,stigma,straight,style,surface,thin,toward,triangular,tube,twisted,unbranched,white,yellow	%,0-0.1,0-0.2,0-10,0-4,0.05-0.1,0.2-0.4,0.2-0.5,0.2-1,0.25-0.4,0.4-0.5,0.4-0.7,0.5-0.7,0.5-1,0.5-2.5,0.7-0.8,0.7-1,0.7-1.5,1-11,1-4,1.1-2.6,1.1-6,1.4-3,1.5-2,15-35,2-7,2.5-11,2.5-6.5,3.5-3.8,3.5-5,4-7,4.5-6,5-10,5-8,5-merou,6-20,7-10,8-10,8-11.5,8-12,8-13,abaxially,absen,abundant,across,acute,adaxiall,adaxially,adult,alyx,apart,ascending,axe,ba,basal,berry,blade,branch,branche,broad-based,capitat,cordate,cuneate,curved,cylindrical,decimetre,deflexed,deltate,densely,directed,distall,distributed,dm,eaf,eed,eglandular,entire,erect,filament,finger,flower,glabrous,gland-tipped,glandular,glandular-hairy,green,grey,hair,half,hastate,homostylous,interpetalar,juicy,juvenile,lacking,lamina,less,lobe,lobed,long,longer,lower,margin,mature,mesocarp,mid-point,midpoint,minute,narrowly,nflorescence,oblique,obtuse,orolla,pair,part,per,perfect,pore,porrect,present,rachi,ray,rhizomatous,ruit,sessile,shallowly,shallowly-lobed,short,slightly,spaced,sparse,sparsely,stalk,stellae,stellate-pubescent,succulen,summit,tal,tamen,tem,thick,thickened,throughout,time,tissue,unarme,unarmed,unit,unknow,upper,upward,vary,wide,x,yellowish,ympodial	arrangement,articulation,bark,capitate,color,connation,corolla,dehiscence,diminishing,distal,form,growth,height,history,interjected,leaflet,life,na,ovary,papillae,petiolule,plant,position,pseudostipule,seed,shape,size,spacing,stem,straightnes,terminal,texture,tuber-bearing
166	wfo-0001026992	success	243	122	93	150	29	0.383	0.2-0.5,0.25-0.45,1-4,1.5-3.4,1.7-4.3,2-10,2.3-3.3,3-4,3.3-5.6,5.3-12.1,6-10,8,8-14,abaxially,abruptly,accrescent,acuminate,acute,adaxially,anther,apart,apex,approximately,articulated,attenuate,bark,base,blunt-tipped,branched,broadly,brown,calyx,cm,completely,corolla,covering,dark,deltoid,diameter,drying,elliptic,enveloping,equal,flower,fruit,fruiting,globose,greenish,lance-ovate,lanceolate,lateral,leaf,length,long,many,mm,orange-tan,ovate,pedicel,peduncle,petiole,plant,poricidal,reniform,reticulate-punctate,ripe,scabridulous-,short,shorter,shrub,simple,size,small,sometimes,stamen,stellate,stem,stigma,style,surface,tan,terminal,time,tip,tomentose,tree,tube,velutinous,violet,white,x,yellow,yellowish	-2.5,/7,0.5-1.2,0.6-1.5,0.8-3.4,00-170,1.2-1.4,1.2-1.7,1.3-2.6,1.3-4.3,1.4-1.6,1.4-1.9,1.7-1.9,1.7-2.4,1/2,10-12,12-33,2-5.6,2.6-4.6,2.8-4.6,2.8-4.7,3.3-5.5,4-8,5-15,5-merou,8-11,abaxial,adaxiall,ag,along,alyx,angled,anthesi,apparently,appressed,around,axe,axillary,ba,berry,blade,branch,capitat,chartaceous,coriaceous,crown,cylindrical,densely,directed,distally,eaf,echinoi,echinoid,edge,eed,entire,evident,exserted,farinose,filament,flat-topped,fleshy,forming,free,geminate,glabrescen,glabrous,granular-tomentose,grooved,hair,high,homostylous,immature,inserted,lacking,lengthening,less,line,lobe,lobed,long-stalked,longitudinal,longitudinally,lower,m.,main,margin,mature,maturity,midrib,minute,moderately,mostly,multangulate,nearly,nflorescence,oblong,obtuse,occasional,occasionally,often,older,orolla,ovate-lanceolate,overlapping,perfect,plurifoliate,pore,porrect-stellate,pubescence,pubescent,rachi,rare,rather,ruit,runk,semi-ovate,sessile,short-,short-stalked,side,slit,somewhat,spaced,sparingly,split,spreading,stalked,stout-stalked,subcampanulate,subglobose,suture,tamen,terete,thin-textured,ud,unarme,unarmed,unequal,unit,usually,vary,vein,way,weakly,whitish,wide,ympodial,young,½	arrangement,articulation,capitate,color,connation,dehiscence,diminishing,distal,form,growth,height,history,inflorescence,interjected,leaflet,life,na,ovary,papillae,petiolule,position,prickle,pseudostipule,seed,shape,spacing,straightnes,texture,tuber-bearing
167	wfo-0001026994	success	266	115	90	176	25	0.338	-0.7,-30,0.05-0.1,0.4-0.5,0.5-0.8,0.5-0.9,0.5-2,1,1-1.4,1-1.6,1.2-3.5,10-20,2-4,4,4-15,6-20,8-12,acuminate,acute,anther,apex,articulate,articulation,base,berry,bifurcate,branched,bright,broadly,brown,calyx,capitate,cm,corolla,crenate,dark,densely,diameter,distal,elliptic,fruit,fruiting,globose,grayish,green,greenish,hair-like,half,herb,imparipinnate,inflorescence,interjected,interrupted,investing,irregularly,lateral,leaf,leaflet,loosely,mm,narrowly,obovate,outgrowth,ovary,pedicel,peduncle,perennial,petiole,present,pseudostipule,pubescent,purple,rachi,regularly,rotate-stellate,size,spreading,stem,stigma,straight,stripe,style,surface,terminal,tube,usually,velvety,white,woody,yellow	-10,-20,-foliate,.2,.5,0.05-0.2,0.1,0.1-0.2,0.1-0.3,0.15-0.2,0.2-0.4,0.2-0.5,0.25,0.3-0.4,0.4-1.2,0.5,0.5-0.6,0.5-0.7,0.5-1.2,0.5-1.3,0.7-2.5,0.9-1.2,0.9-1.3,1-1.2,1-1.5,1-2,1.2-1.6,1.4-2.1,12-,2,2-,2-2.6,2-5-locular,2.2-3.2,2.5-6.5,20-50,3,3-branched,4-celled,5,5-,5-7,7-13,8,abaxially,absent,abundant,acroscopically,additional,adpressed,along,also,amongst,andscattered,anthesi,apical,apically,appearance,appendage,basal,basally,basiscopically,becoming,beneath,bent,bifurcation,bract,bracteate,broader,cell,celled,column,conical,crenat,crowded,darker,decreasing,decumbent,decurrent,deeply,developed,eaf,ebracteate,edicel,eed,eglandular,erect,especially,essentially,exserted,fewer,filament,flower,giving,glabrous,glandular,gree,habitat,hal,halfway,head,internode,lamina,lanceolate,large,larger,largest,leave,less,like,lobe,lobed,locule,lon,long,lower,margin,markedly,medial,midvein,minutely,moderately,much,narrower,narrowing,nearly,nflorescence,node,oblique,occasionally,often,pair,paler,papillate,petiolule,primary,puberulent,rarely,reflexed,ripe,robust,rocky,secondary,sessile,set,shaggy,short,silky,simple,sinus,slightly,sometimes,sparsely,specimen,spreadin,staminal,sterile,tall,tem,tertiary,testa,thick,tip,toward,trichome,ud,unicellular,uniseriate,unit,wall,weak-walled,well,wide,winged,ympodial,young	arrangement,bark,color,connation,decument,dehiscence,diminishing,form,growth,height,history,length,life,na,papillae,plant,position,prickle,seed,shape,spacing,straightnes,texture,tuber-bearing,ye
168	wfo-0001026996	success	188	112	80	108	32	0.426	0-6,0.6-1,0.9-2.7,1-2,1.3-7.7,15-28,3-10,3-5,3-7,3.3-6,4-4.4,4-8,4.5-10.5,6-8,6.9-10.9,acumen,anther,articulated,axillary,blue,brownish,bud,clavate,cm,condition,connivent,coriaceous,corolla,dark,deep,diameter,drying,elliptic,forked,fresh,fruit,glabrous,globose,green,greenish,herb,interjected,lanceolate,lateral,leaf,leaflet,lilac,medium,mm,moniliform,mottled,mucilaginous,odd-pinnate,ovate,ovoid,pedicel,peduncle,pentagonal,petiole,plant,poricidal,purple,rotate,seed,size,slightly,stigma,straight,stripe,style,subtending,terminal,tip,tube,typically,wet,white,whitish,x,yellow	1-3,1-4,1-5,1.2-1.8,1.8-4.4,14-33,2-3,3.8-14.1,5-8,5-merou,8.7-18.6,abaxiall,abaxially,acuminate,acute,adaxially,ag,along,alyx,apart,apex,apparently,arranged,asymmetric,attenuate,axe,base,basiscopic,bead,berry,blade,capitat,cell,considerably,covering,decreasing,digestion,distal,dorsally,eaf,edge,eed,enzyme,erec,exceeding,filament,flat,flower,folded,geminat,generally,glabrou,green-white,hair-like,half,homostylous,honeycomb-shaped,larger,lengthening,like,linear,living,lobe,long,lower,make,middl,multiple,necklace,nflorescence,orbicular,orolla,pair,perfect,petiolulate,plurifoliate,pore,removed,ripe,rounded,ruit,sessile,seudostipule,side,slit,sometimes,spaced,specimen,stamen,stolon,subglabrou,symmetric,tall,tamen,tem,testal,thick,throughout,tissue,toward,tri-,tuber,unit,unwinged,usually,vary,wall,ympodial	arrangement,articulation,bark,calyx,capitate,color,connation,dehiscence,erect,form,fruiting,growth,height,history,inflorescence,length,life,middle,na,ovary,papillae,position,prickle,pseudostipule,shape,spacing,stem,straightnes,subglabrous,surface,texture,tuber-bearing
169	wfo-0001027009	success	226	97	66	160	31	0.292	0-0.3,0-8,0.4-1,0.8-2.1,1-9,10-15,3-5,5-23,7-12.5,accrescent,acicular,acute,anther,apex,articulated,base,black,broad-based,brown,calyx,capitate,chartaceous,cm,connivent,cuneate,curved,diameter,distal,elliptical,extra-axillary,fruit,fruiting,globose,green,inflorescence,lanceolate,lateral,length,long,minutely,mm,obtuse,ovate,pale,pedicel,peduncle,perennial,petiole,plant,prickle,pseudo-racemose,purple,reticulate,rotate,shrub,simple,slightly,stem,stigma,straight,style,surface,tip,tube,yellow,yellowish-green	%,0-0.2,0-0.5,0-1.2,0-1.5,0-15,0-5,0.1-0.2,0.15-0.3,0.5-2,0.7-0.9,0.7-1,0.7-1.3,0.8-1.2,0.8-1.3,1-1.5,1-1.8,1-2,1-2.5,1-3,1-5,1.3-2.2,1.4-4,1.6-3.5,10-20,2-3,2-4,2-6,2-foliate,2.3-3,20-30,23-48,3-10,3-3.5,3.3-3.6,35-400,4-6.5,4-9.5,40-125,5,5-7,5-merous,6-8,6-9,6.5-11,7-11,7-8,abaxially,absent,abundant,adaxiall,adaxially,alyx,andromonoecious,apart,armed,ascending,attenuate,axe,ba,basal,bilobe,bisexual,blade,broadly,cylindrical,d.,deeply,deflexed,deltate,densely,dimorphic,directed,distall,distributed,dult,eaf,eed,eglandular,entire,erect,filament,finger,flower,functional,geminate,glabrous,gland-tipped,glandular,grey,grey-green,hair,half,heterostylous,incised,index,interpetalar,juic,lamina,larger,lobe,lobed,lobing,lon,longer,lower,male,margin,markedly,mature,mesocarp,midpoint,midvein,minute,moist,nflorescence,oblique,orolla,part,per,pore,porrect,presen,present,pricklie,probably,rarely,ray,rhizomatous,ridged,ripe,ruit,shallowly,short,side,spaced,stage,stalk,stellae,stellate-pubescent,strongly,tal,tamen,terete,thick,throughout,time,tissue,unarmed,unbranched,unit,unknow,uvenile,vary,vein,white,wide,x,yellowish,ympodial	arrangement,articulation,bark,bilobed,color,connation,corolla,dehiscence,diminishing,form,growth,height,history,interjected,leaf,leaflet,life,na,ovary,papillae,petiolule,position,pseudostipule,seed,shape,size,spacing,straightnes,terminal,texture,tuber-bearing
170	wfo-0001027010	success	198	110	81	117	29	0.409	0-2,0.4-5.1,0.5-1.5,1-10,1-2,1.4-6.9,14-46,2-9.4,2.1-15.3,2.2-12.9,3-10,3-5,3-8,3.5-13.6,4-12,5-13,anther,articulated,brownish,cell,clavate,cm,condition,connivent,coriaceous,corolla,covering,deep,diameter,distal,drying,elliptic,forked,fresh,fruit,glabrescent,glabrous,green,greenish,hair-like,half,herb,high,interjected,lanceolate,lateral,leaf,leaflet,light,mm,moniliform,odd-pinnate,ovate,ovoid,pedicel,peduncle,pentagonal,petiole,plant,poricidal,present,purple,rotate,scabrous,seed,size,stigma,straight,stripe,style,terminal,testal,thick,tip,tube,typically,wall,white,whitish,x,yellow	0-2.5,0-3,1-4,1-7,1.2-1.7,1.2-1.9,10-60,2-6,2.1-4.3,3-6,4-8,4.4-29,4.9-31,5-14,5-merou,abaxially,acumen,acuminate,acute,adaxiall,adaxially,ag,along,alyx,apart,apex,apparently,arranged,asymmetric,attenuate,axe,axillary,base,basiscopic,bead,blade,bud,capitat,coloration,decreasing,digestion,dorsally,eaf,edge,eed,enzyme,erec,exceeding,filament,flat,flower,folded,geminat,generally,glabrescen,glabrou,green-white,hair,hal,homostylous,honeycomb-shaped,larger,lengthening,like,living,lobe,long,lower,make,mucilaginous,multiple,narrow,necklace,nflorescence,occasionally,orbicular,orolla,pair,perfect,petiolulate,plurifoliate,pore,removed,ripe,rounded,ruit,scabrou,sessile,seudostipule,short,side,slightly,slit,sometimes,spaced,specimen,spot,stamen,stolon,subequal,subtending,tall,tamen,tem,throughout,tissue,toward,tri-,tuber,unit,usually,vary,wet,wide,wing,winged,ympodial	arrangement,articulation,bark,calyx,capitate,color,connation,dehiscence,form,fruiting,growth,height,history,inflorescence,length,life,na,ovary,papillae,position,prickle,pseudostipule,shape,spacing,stem,straightnes,surface,texture,tuber-bearing
171	wfo-0001027019	success	142	85	53	89	32	0.373	1-1.5,1.5-3,10,2-8,acute,anther,bark,branched,calyx,capitate,cm,corolla,densely,difoliate,flattened,fruiting,glabrous,globose,green,inflorescence,leaf,lobed,minutely,mm,obovate,opposite,ovary,ovoid-reniform,pale,papillose,pedicel,petiole,pitted,plant,poricidal,shaped,shrub,small,somewhat,spaced,stem,stigma,straight,style,surface,tan,tear-drop,tip,tree,trichome,tube,unit,white	.5,/4,0-0.5,0.5-1,1-2,1.5-2,1/2,10-40-flowered,12-30,2-3,2-5,4-5,4-8.5,7-14,abaxial,abaxially,abruptly,adaxially,along,anthesi,apex,apparent,attenuate,ba,base,berry,bright,constriction,cyathiform,deflexed,deltoid,dia,distal,eaf,edicel,eed,ellipsoid,elliptic,erect,even,exserted,filament,fleshy,free,geminat,glabrate,golden,inflorescenc,largely,later,like,live,lobe,lon,long,lower,major,midrib,minor,narrowed,nflorescence,older,onto,overlapping,papillo,planar,pore,portion,pubescent,reddish-brow,rest,ruit,scar,sparsely,strongly,tall,tapering,third,tub,ud,waxy,way,widest,wing,winged,woody,x,ympodial,young	arrangement,articulation,color,connation,dehiscence,diameter,form,fruit,geminate,growth,height,history,interjected,lateral,leaflet,length,life,na,papillae,peduncle,position,prickle,pseudostipule,reddish-brown,seed,shape,size,spacing,straightnes,sympodial,terminal,texture
172	wfo-0001027030	success	234	115	90	144	25	0.385	-11,0-4,0.05-0.1,0.1-0.7,0.1-0.9,0.2-1,0.3-,0.3-0.5,0.4-0.5,0.4-1.5,0.5-,0.5-1,0.6-1.8,0.7-1,0.8-0.9,1,1-,1-3,1-3.4,1.5-,2-,2-4,2-4.8,3-9,acuminate,anther,apex,articulated,articulation,base,berry,branched,bright,brown,calyx,capitate,cm,corolla,densely,diameter,distal,elliptic,fruit,fruiting,globose,grayish,green,hair-like,half,herb,imparipinnate,inflorescence,interjected,interrupted,investing,lateral,leaflet,long,loosely,minutely,narrowly,obovate,outgrowth,ovary,pale,pedicel,peduncle,perennial,petiole,petiolule,present,pseudostipule,pubescent,rotate-stellate,simple,size,soft,sometimes,stem,stigma,straight,style,surface,tall,terminal,truncate,tube,velvety,wide,yellow	-15,.2,.5,0.15-0.2,0.2,0.2-0.3,0.3-0.7,0.4-0.8,0.5,0.5-0.7,0.5-0.8,0.6-0.7,0.6-0.8,0.8-1,0.9-1.1,1-1.2,1-1.3,1.2-1.6,1.6-2,2-3,2-6,2-7,2-foliate,2-locular,2.2-3.2,3-4-celled,3-8,4-celled,5-12,8-celled,abaxial,abaxially,absent,abundant,acute,adaxially,adpressed,angled,anthesi,apical,appearance,appendage,axi,basal,basiscopically,beneath,beyond,bract,cell,column,conical,crenat,crenate,crenation,dark,darker,decurrent,deeper,deeply,denser,diamete,due,eaf,edicel,eed,eglandular,entire,evenly,exserted,extremely,filament,flower,giving,gland,glandular,gree,growt,hal,halfway,internode,interspersed,irregularly,lamina,lanceolate,larger,less,like,lobe,lon,longer,lower,margin,mm,multicellular,near,nflorescence,node,oblique,occasionally,often,pair,paler,papillate,primary,pubescence,reflexed,robust,ruit,secondary,sessile,silky,similar,slender,slightly,small,smaller,somewhat,sparsely,spread,spreadin,spreading,staminal,sterile,stripe,tem,tertiary,testa,thick,tiny,trailing,trichome,ud,unicellular,uniseriate,unit,usually,vein,wall,weak,white,winged,woody,ympodial,young	arrangement,bark,color,connation,dehiscence,diminishing,form,growth,height,history,leaf,length,life,na,papillae,plant,position,prickle,seed,shape,spacing,straightnes,texture,tuber-bearing,ye
173	wfo-0001027035	success	199	103	74	125	29	0.372	0-36,0.1-0.9,0.3-2.3,0.4-12.8,0.5-3.4,0.5-7,0.8-4.2,1-2,1-8,1.5-5.9,1.7-8,10-80,3-10,3-5,4-18,4-18.5,anther,articulated,blue,brownish,clavate,cm,condition,connivent,corolla,deep,diameter,distal,drying,elliptic,forked,fresh,fruit,glabrescent,glabrous,globose,green,greenish,half,herb,high,interjected,lanceolate,lateral,leaf,leaflet,light,lilac,medium,mm,mucilaginous,odd-pinnate,ovate,ovoid,pedicel,peduncle,pentagonal,petiole,plant,poricidal,rotate,seed,shape,size,stigma,straight,style,terminal,tip,tube,wet,whitish,x,yellow	0-7,0.5-5,0.8-3,0.9-3.1,1-3,1-3.4,1.8-5.2,2-38,2-7,2.8-10.3,4.9-23.5,5-merou,abaxially,acumen,acuminate,acute,adaxiall,adaxially,ag,along,alyx,apart,apex,apparently,arranged,asymmetric,attenuate,axe,axillary,base,basiscopic,bead,blade,bud,capitat,cell,coloration,completely,covering,decreasing,digestion,dorsally,eaf,edge,eed,enzyme,erec,exceeding,filament,flat,flower,folded,geminat,generally,glabrescen,glabrou,green-white,hair,hair-like,hal,homostylous,honeycomb,larger,lengthening,like,living,lobe,long,lower,make,moniliform,multiple,necklace,nflorescence,orbicular,orolla,pair,perfect,petiolulate,plurifoliate,pore,present,purple,removed,ripe,rounded,ruit,second,sessile,seudostipule,shaped,short,side,slightly,slit,smaller,sometimes,spaced,specimen,stamen,stolon,stripe,subequal,subglabrous,subtending,tall,tamen,tem,testal,thick,throughout,tissue,toward,tri-,tuber,typically,unit,unwinged,usually,variable,vary,wall,white,wide,ympodial	arrangement,articulation,bark,calyx,capitate,color,connation,dehiscence,form,fruiting,growth,height,history,inflorescence,length,life,na,ovary,papillae,position,prickle,pseudostipule,spacing,stem,straightnes,surface,texture,tuber-bearing,ye
174	wfo-0001027050	success	244	116	85	159	31	0.348	-12,-9,/3,0.3-1.5,0.5-3,1.5-6,10-13.5,2-5,2-8,5,5-10,absent,acuminate,acute,anther,apex,articulated,bark,base,branched,broadly,brown,calyx,capitate,chartaceous,closely,cm,connivent,deeply,diameter,distal,drying,elliptic,entire,flattened-reniform,fruit,fruiting,glabrous,glandular-puberulent,green,growth,inflorescence,lanceolate,lateral,leaf,leaf-opposed,length,lobed,minutely,mm,moderately,often,ovate,pale,pedicel,peduncle,petiole,plant,poricidal,present,prickle,pubescent,ripe,several,shrub,small,somewhat,spaced,sparsely,spherical,stem,stigma,style,surface,time,tip,touching,tree,tube,unarmed,unbranched,way,white,yellow,yellowish-green	.2,.5,0-0.2,0-3,0.1-0.3,0.1-3,0.2-0.5,0.2-1,0.8,0.9-2.1,1,1-1.5,1-2,1.5-2,12-15,15-50+,2-2.5,2-3,2-4,2.5-3,3-5,4-20,4-8,5-6,5-7,5-9,5-merous,50,6-8,7-30+,8-26,abaxial,abaxially,absen,abundant,adaxial,adaxiall,adult,alyx,andromonoeciou,apar,arme,axe,basal,berry,blade,branch,broad,broad-based,brow,coarsely,conical,cordate,cuneate,curved,densely,difoliate,directed,distall,distally,eaf,eed,eglandular,equal,erec,erect,except,ferruginous,filament,flattened,flower,free,geminat,hair,half,heterostylous,infructescence,inside,interpetalar,juicy,juvenile,larger,least,less,like,lobe,long,long-styled,longer,lower,margin,markedly,mature,mid-way,midpoint,midrib,midvein,minute,moist,mucilaginous,multiseriate,narrowly,near,nflorescence,numerous,oblique,obtuse,occasionally,older,orolla,oung,ovate-lanceolate,papillat,per,pericarp,pore,porrect,portion,pricklier,prickly,ray,rest,rounded,ruit,scar,scattered,secondary,sessile,shallowly,shiny,short-stalked,short-styled,shorter,side,slightly,stalk,stalked,stellate,stellate-pubescent,straight,tall,tamen,terete,thicker,tissue,toothed,triangular,trichome,truncate,unit,usually,vary,weakly,whitish,wide,woody,ympodial,young,younger	alternate,apart,arrangement,articulation,color,connation,corolla,dehiscence,diminishing,form,height,history,interjected,leaflet,life,na,ovary,papillae,papillate,perennial,petiolule,position,pseudostipule,seed,shape,size,spacing,straightnes,terminal,texture,tuber-bearing
175	wfo-0001027050	success	234	106	75	159	31	0.321	0.5-1,0.5-3,1.5-6,10-13.5,2-10,2-6,2-8,3-15,5,5-10,absent,accrescent,anther,apart,apex,articulated,base,branched,broadly,brown,calyx,chartaceous,cm,connivent,contiguous,cylindrical,diameter,directed,distally,elliptic,extra-axillary,flattened,forked,fruit,fruiting,globose,green,growth,inflorescence,lanceolate,lateral,leaf,leaf-opposed,length,minute,minutely,mm,nearly,ovate,pale,pedicel,peduncle,petiole,pitted,plant,present,prickle,shrub,simple,slightly,small,somewhat,spaced,stellate,stem,stigma,style,surface,tree,tube,unbranched,white,x,yellow,yellowish-green	.2,0-0.2,0-0.5,0-1,0-3,0.1-3,0.2-0.6,0.2-1,0.3-0.6,0.4-1,0.5-0.8,0.8,1-1.5,1-2,1-5,1.5-2,10-30,11-21,12-15,14-20,15-50+,16-40,2-2.5,2-3,2-3-locular,2-4,2-5,2-foliate,2.5-3,23-40+,3-5,4-19,4-40,4-8,5-6,5-7,5-9,5-merous,6-8,7-30+,8-26,8-40+,abaxially,absen,abundant,across,acuminate,acute,adaxiall,adaxially,adult,andromonoecious,anvil-shape,armed,axe,ba,blade,branche,broad-based,capitat,coarsely,cordate,cross-section,cuneate,curved,deeply,densely,distall,distributed,drying,eaf,eed,eglandular,entire,erect,except,exocarp,ferruginous,filament,flower,functional,geminat,glabrous,glandular-puberulent,hair,half,held,interpetalar,juicy,juvenile,less,like,lobe,lobed,long,longer,lower,margin,markedly,mature,mesocarp,midpoint,midvein,moderately,moist,mucilaginous,multiseriate,narrowly,nflorescence,oblique,obtuse,often,orolla,ovate-lanceolate,pair,per,pinnatifid,placenta,pore,porrect,rachi,ray,rounded,ruit,scattered,sessile,shallowly,shorter,side,sparsely,stalk,stalked,stellae,stellate-pubescent,straight,tal,tamen,tem,thick,thicker,throughout,time,tip,tissue,toothed,triangular,truncate,unarme,unarmed,unit,upper,upright,usually,vary,weakly,whitish,wide,ympodial,younger	arrangement,articulation,bark,capitate,color,connation,corolla,dehiscence,diminishing,distal,form,height,history,interjected,leaflet,life,na,ovary,papillae,perennial,petiolule,position,pseudostipule,seed,shape,size,spacing,straightnes,terminal,texture,tuber-bearing
176	wfo-0001027067	success	228	96	63	165	33	0.276	0-1.8,0-7,0.3-1,1.7-3.3,2.5-3.8,6-10,6-7,7-16,accrescent,anther,apex,articulated,base,black,broadly,brown,calyx,chartaceous,cm,connivent,curved,dark,diameter,extra-axillary,finally,firm,flattened,fruit,fruiting,globose,green,inflorescence,lanceolate,lateral,leaf,length,mm,ovate,pale,papery,pedicel,peduncle,perennial,petiole,plant,prickle,purple,rotate,shrub,simple,skin,slightly,somewhat,stem,stigma,straight,streak,style,truncate,tube,twisted,yellow,yellowish-green	%,.05,0-0.1,0-0.2,0-0.5,0-12,0-6,0.2-0.4,0.35-0.5,0.4-0.5,0.4-0.7,0.5-1,0.5-1.5,0.5-2,0.8-1,0.9-2.5,1-2,1-4,1-7,1.2-1.4,1.4-2.5,1.5-2,1.7-2.8,11-16,11-20,13-65,15-27,15-60,2-10,2-3,2-4.5,2-7,2-foliate,2-locular,2.5-4,2.7-5,2.9-3.7,20-45,20-50,20-65,3-10,3-4,3-5,3-6,3.5-5.5,3.5-9,4-5.5,4-9,5-12.5,5-6,5-9.5,5-merou,5.5-12.5,6-8,7-11,7-8,8-14,abaxial,abaxially,absent,abundant,acicular,across,acute,adaxiall,adaxially,adult,alyx,andromonoecious,apart,armed,attenuate,axe,ba,bilobe,blade,broad-based,cuneate,cylindrical,decimetr,deeply,densely,directed,distall,dult,eaf,eed,eglandular,erect,exocarp,filament,finger,flower,functional,geminate,glabrous,gland-tipped,grey,hair,half,heterostylous,hig,index,interpetalar,juic,juvenile,less,lobe,lobed,lobing,lon,long,longer,lower,margin,mature,mesocarp,mid-point,midpoint,midvein,minute,moist,nflorescence,oblique,obtuse,orolla,part,per,pink,pore,porrect,presen,present,pseudo-racemose,rachi,ray,rhizomatous,ruit,scattered,sessile,short,side,spaced,sparsely,sprawling,stalk,stellae,stellate,stellate-pubescent,tamen,thick,throughout,time,tissue,transparent,unbranched,unit,vary,vein,weakly,white,wide,x,yellowish,ympodial	arrangement,articulation,bark,bilobed,color,connation,corolla,dehiscence,diminishing,distal,form,growth,height,history,interjected,leaflet,life,na,ovary,papillae,petiolule,position,pseudoracemose,pseudostipule,seed,shape,size,spacing,straightnes,surface,terminal,texture,tuber-bearing
177	wfo-0001027069	success	200	133	102	98	31	0.51	0.15-0.8,0.2-3,0.5-5.5,0.8-3.3,1-10,1-2,1-5,1-7.7,1.5-12,1.5-6,10-25,2.5-12,3-11,3-19,4-8,4-9,7-10,acuminate,acute,anther,apex,articulated,axillary,base,blotch,broadly,brown,brownish,bud,cell,chartaceous,cm,condition,connivent,cordate,corolla,covering,cuneate,darker,diameter,drying,elliptic,elliptical-conical,forked,fresh,fruit,glabrescent,glabrous,green,greenish,hair,hair-like,herb,interjected,lanceolate,lateral,leaflet,light,like,make,membranous,mm,mucilaginous,obtuse,odd-pinnate,ovate,ovoid,pedicel,peduncle,petiole,plant,poricidal,pubescent,purple,rare,seed,short,simple,size,slightly,sparsely,stellate,stem,stigma,straight,stripe,style,subtending,terminal,testal,thick,tip,truncate,tube,typically,vertical,wall,wet,white,whitish,x,yellow	0-4,0.5-1.5,0.5-5,1-2.5,1.5-3,1.5-5,2-5,2-6,3.5-6,5-merou,abaxially,acumen,adaxially,ag,along,alyx,apart,apparently,axe,berry,blade,borne,capitat,ciliate,decreasing,decurrent,digestion,distal,dorsally,eaf,edge,eed,end,enzyme,erect,especially,exceeding,filament,flat,flower,folded,geminat,generally,glabrou,green-white,half,homostylous,honeycomb-shaped,lax,lengthening,linear,living,lobe,long,lower,margin,middl,midrib,minutely,narrowly,nflorescence,orolla,pair,perfect,petiolule,plurifoliate,pore,puberulent,pubescen,rachi,rarely,removed,ruit,seudostipule,singly,slit,sometimes,spaced,specimen,stamen,ste,stolo,subequal,tall,talle,tamen,tem,throughout,toward,tri-,tuber,unequal,unit,unwinged,usually,vary,wide,ympodial	arrangement,articulation,bark,calyx,capitate,color,connation,dehiscence,form,fruiting,growth,height,history,inflorescence,leaf,length,life,middle,na,ovary,papillae,position,present,prickle,pseudostipule,shape,spacing,straightnes,surface,texture,tuber-bearing
178	wfo-0001027091	success	142	148	104	38	44	0.732	.3,0.7,0.8,1-1.6,1.1-1.6,1.8-2.6,1/2-2/3,2.5-3.5,3-8,3-9,5-11,8.5-11.5,9-13,accrescent,across,acute-tipped,along,annual,anther,anthesi,arcuate,base,beneath,berry,blade,blue,branched,bristly,broadly,brown,calyx,campanulate,capitate-glandular,cm,dark,deltoid,densely,dm,dry,enveloped,extended,few-rayed,fully,glabrous,gland,glandular,hair,herb,internodal,lenticular,linear-lanceolate,lobe,long,longer,low,main,maturity,mm,mostly,narrowly,near,obtuse,occasionally,oriented,ovate,pedicel,petiole,pinnatifid,pinnatisect,prickly,radially,reticulately,ridge,rounded,scattered,sessile,short-stipitate,simple,sometimes,sparsely,spherical,splitting,spreadingly,stellae,stellate-pentagonal,stem,strait,suffused,surface,tapering,taprooted,terminally,tightly,tube,twice,undulate,uniseriate,usually,variously,vein,vestiture,violet,wholly,wrinkled	2.3-2.9,30-60,4-10,6-10,6-10-flowere,alyx,armed,cauline,developing,dia,difoliate,divided,eaf,eed,geminat,green,high,invested,lon,nflorescence,orolla,per,ruit,short,slende,somewhat,ste,tamen,terete,tigma,tub,tyle,unexpande,unit,vary,yello,ympodial,younger	6-10-flowered,apex,arrangement,bark,branching,color,corolla,dehiscence,diameter,diminishing,distal,form,fruit,growth,height,history,inflorescence,lateral,leaf,leaflet,length,life,na,ovary,papillae,petiolule,plant,position,prickle,root,seed,shape,size,slender,spacing,stigma,straightnes,style,terminal,texture,tuber-bearing,type,unexpanded,yellow
179	wfo-0001027102	success	167	99	67	100	32	0.401	.5,0.2-2,0.5-2,1-2,1-2.5,10-20,15-35,2-3,3,4-5,abaxially,accrescent,adaxially,anther,apart,articulated,base,calyx,cm,connivent,curved,diameter,elliptic,flattened,flower,forked,fruit,fruiting,glabrous,globose,lanceolate,leaf,leaf-opposed,longitudinal,mm,moderately,narrowly,oblong,often,opening,orange,pedicel,peduncle,petiole,pubescent,rarely,ripe,rugulose,shrub,simple,size,slender,slit,somewhat,stellate,stem,stigma,straight,style,surface,truncate,tube,unbranched,white,x,yellow,yellow-brown	.5-6,0.5,0.5-1,0.5-3,1-1.5,1-3,1-4,1-6,1.5-2,15,2-2.5,3-12,3-4,3-5,4-7,5-12,<,absen,absent,acuman,acuminate,acute,adaxial,adaxiall,ag,aggregate,almost,alyx,apex,appearance,axe,ba,blade,broad,broadly,cell,channe,chartaceous,ciliate,congested,corky,cuneate,cylindrical,deltate,densely,differing,difoliate,dimorphic,directed,distally,eaf,eed,entire,few-,filament,free,geminat,giving,hair,ilament,lobe,long,long-tapered,m.,major,margin,minor,multiseriate,nflorescence,obtuse,one,orolla,ovate,per,perfect,pore,portion,rachi,roughened,ruit,short,small,spaced,sparsely,stone,subcoriaceous,tal,tem,time,tip,tomentose,triangular,truncat,unarme,unit,usually,vary,wide,ympodial,young	age,arrangement,articulation,bark,color,connation,corolla,dehiscence,form,growth,height,history,inflorescence,interjected,lateral,leaflet,length,life,na,ovary,papillae,perennial,plant,position,prickle,pseudostipule,seed,shape,spacing,straightnes,terminal,texture
180	wfo-0001027104	success	141	102	65	76	37	0.461	0.15-0.35,1-3,1.2-6,10-15,2-3,2.2-5,5-15,6-7.5,acuminate,acute,apical,apically,articulate,branched,calyx,cm,connate,corolla,cyme,dehiscent,diameter,dichasial,dichasially,distal,ebracteate,finely,forked,globose,green,green-white,herbaceous,introrse,lateral,linear,maturing,mm,monochasial,mucilaginous,narrowly,odd-pinnate,often,ovate,ovoid,pedicel,peduncle,perennial,petiole,plant,poricidally,proximal,pubescent,seed,short,slit,stellate,stigma,straight,style,throughout,tone,tuber-bearing,white,yellow,yellow-green,¼	0.5-0.8,1-1.5,1-4,1.5-2.3,1.5-4.2,2-6,3-5.5,3-6-foliat,4-15,abaxially,acumen,adaxially,apex,attenuate,base,cell,condition,cordate,covering,digestion,dorsally,eaf,edge,eed,emoval,enzyme,epiphyti,epiphytic-like,exceeding,filament,flat,flower,folded,generally,globo,growing,hair-like,half,honeycomb,living,lobe,lon,long,lower,make,mos,mucronate,nflorescence,nther,orolla,ovat,pattern,perfect,plan,rarely,reveal,ruit,seudostipule,simple,specimen,stamen,tall,tem,terrestrial,testal,thick,throughou,truncate,typically,unit,vary,viole,wall,wide,without,ympodial	anther,arrangement,articulation,bark,color,connation,dehiscence,form,fruit,fruiting,growth,height,history,inflorescence,interjected,leaf,leaflet,length,life,na,ovary,papillae,position,prickle,pseudostipule,shape,size,spacing,stem,straightnes,surface,terminal,texture,tube,violet,wet,ye
181	wfo-0001027114	success	154	87	58	96	29	0.377	-30,1-1.5,1-2,1/2,13-21,2-3,3-4,3-7,6-8,acute,anther,appearing,bark,base,branched,bushy,calyx,capitate,cm,corolla,dark,elliptic,flattened-reniform,fruiting,glabrous,globose,green,inflorescence,lateral,leaf,lobed,many,margin,minutely,mm,opposite,ovary,pedicel,petiole,pitted,poricidal,reddish,reddish-brown,shoot-terminal,shrub,size,spaced,stem,stigma,style,surface,thickened,time,tip,tube,unevenly,way,white	-17,-2,.5,0.5-1,1-1.1,1-1.2,1.5-1.7,1.5-2,2-2.5,20-40,5,6-9,7-10,7-9,abaxial,abaxially,adaxially,along,alternating,anthesi,apar,apex,axillary,ba,berry,closely,commonly,conical,deltate,dendritic,densely,dia,differing,difoliate,drying,due,eaf,edicel,eed,erect,exserted,filament,flowered,free,geminate,glabrou,growt,halfway,inflorescenc,investing,lamina,like,lobe,lon,long,lower,main,major,minor,minute,nflorescence,occasionally,older,opening,pair,papillo,planar,plurifoliate,pore,portion,projection,pubescent,rapid,rest,ruit,scar,scattered,several,shoot,simple,slit,soft,tall,tapering,triangular,trichome,tub,ud,uniseriate,unit,vein,wide,woody,yellowish,ympodial,young	apart,arrangement,articulation,color,connation,dehiscence,diameter,form,fruit,growth,height,history,interjected,leaflet,length,life,na,papillae,peduncle,plant,position,prickle,pseudostipule,seed,shape,spacing,straightnes,terminal,texture
182	wfo-0001027117	success	235	111	77	158	34	0.328	0-10,0-20,0-5,0.1-0.7,0.6-0.9,0.7-1.5,1-2,1-4,2-3,5-11,accrescent,acute,almost,anther,apex,apparently,articulated,attenuate,bark,base,berry,black,brown,calyx,cell,cm,connivent,cordate,curved,dark,diameter,enclosing,evenly,fine,flattened-reniform,fruit,fruiting,gently,glabrescent,green,herb,lateral,leaf,length,lobed,mature,maturity,mauve,mm,moderately,narrow-lanceolate,oblong,outline,ovate,pedicel,peduncle,petiole,pit,poricidal,prickle,raised,red-brown,rounded,small,smooth,sparsely,spherical,spreading,stellate-pubescent,stem,style,surface,tapering,tip,tube,yellow,young	-1.5,-11,-12,-2.8,-3/4,.5,/3,0-15,0-25,0-40,0.1,0.1-,0.15-0.25,0.15-0.35,0.2,0.2-0.45,0.5,0.5-1.5,0.7-0.9,0.7-1.3,0.8-,1-6,1.2,1.5-,1.5-2.3,1.5-6.5,1.7-2.5,1.8-2.5,1/,1/3,1/4,1/8-1/2,10-20,2-6,2-8,2.3-2.8,25-100,3-10,3-15,3-6,4-6.5,4-7,4-8,4.5-6.5,4.5-8,5-14,5-merous,6-10,6-9,7-,8,abaxially,acicular,alyx,ame,apar,apart,apically,beyond,blade,branched,brittle,c.,chartaceous,concolorous,deltate,densely,discolorous,distance,drying,eaf,eed,elongating,erect,extending,fifth,filament,flower,four,free,glabrous,gra,herbarium,infructescence,irregularly,less,lobe,lon,long,long-acuminat,longer,lower,margin,membranous,midpoint,midvein,narrow-deltate,narrow-elliptic,nflorescence,obovate,older,one,open,orolla,oung,pair,pale,pendulous,per,perfec,pericarp,perpendicular,plurifoliat,porrect,portion,prickl,prickly,primary,ray,reduced,reflexed,ruit,scar,sessile,shallowly,shiny,shorter,side,sometimes,spaced,specimen,stalk,stalked,staman,stellate,straight,tamen,tearing,terete,tertiary,time,tissue,translucent,trichome,unequal,unit,upper,variously,vary,vein,venation,visible,way,weakly,wide,woody,yellow-green,ympodial	arrangement,articulation,color,connation,corolla,dehiscence,diminishing,distal,form,gray,growth,height,history,inflorescence,interjected,leaflet,life,na,ovary,papillae,perennial,petiolule,plant,position,pseudostipule,seed,shape,size,spacing,stigma,straightnes,terminal,texture,tuber-bearing
183	wfo-0001027123	success	181	91	60	121	31	0.331	-10,0.8-1.3,1,1-1.2,2-5.5,2-lobed,2.5-4,2.5-6,acute,anther,apex,attenuate,bark,base,branched,brown,calyx,clavate,cm,commonly,corolla,dark,diameter,drying,elliptic,flattened,fruiting,glabrous,glandular,inflorescence,leaf,less,mauve-purple,minutely,mm,narrowly,ovary,papillae,pedicel,peduncle,perhaps,petiole,pitted,reddish,reniform,shining,shiny,simple,spaced,stellate,stem,stigma,straight,style,subshrub,surface,terminal,tube,violet,widely	-20,.3,.5,0.3-1.6cm,0.5,0.5-0.8,0.7-3.5,0.9-1.3,1-1.5,1.5-2,2-2.2,2-2.5,2-2.6,2-3,2.5-10.4,3-15,3-4,4-5,4-6,5-10,5-6,abaxial,adaxial,adaxially,along,anthesi,appearing,axe,axi,bright,broadly,campanulate,cell,completely,conical,constricted,coriaceous,cup-shaped,darker,deltate,dendritic,densely,denser,eaf,edge,eed,enlarged,erect,exerted,fide,filament,flower,free,globose,green,inserted,lamina,lax,lewi,like,lobe,lobed,lon,long,loose,loosely,lower,margin,midvein,minute,monopodia,nflorescence,nodding,older,outline,pair,papillate,perfect,petal,planar,plurifoliate,portion,primary,prominent,pubescent,revolute,scar,scatted,scattered,shin,shinin,short,sinuate,sleeve,slightly,sometimes,soon,sparsely,stoutish,strongly,testal,thick,time,tip,trailing,trichome,tub,turned,ud,unit,upper,usually,vein,warty,way,white,wood,x,ympodial,young,¾	0.3-1.6,arrangement,articulation,color,connation,dehiscence,diminishing,distal,form,fruit,growth,height,history,interjected,lateral,leaflet,length,life,na,petiolule,plant,position,prickle,pseudostipule,seed,shape,size,spacing,straightnes,texture,tuber-bearing
184	wfo-0001027125	success	155	104	63	92	41	0.406	0.5,3,abaxially,acuminate,acute,anther,apex,armed,articulated,base,blue,branched,brown,calyx,campanulate,clavate,cm,connivent,coriaceous,corolla,diameter,elliptic,flattened,foveolate,fruit,glabrous,globose,green,lateral,lengthening,light,long,midrib,minutely,mm,narrowly,oblong,papillate,pedicel,peduncle,petiole,pore,poricidal,prickle,recurved,simple,slit,somewhat,spreading,stem,stigma,stout,strongly,style,surface,terminal,tip,truncate,tube,vine,woody,yellow,×	.5,/4,0,0.3,0.3-0.6,0.8,1,1.2-2,10–,10–15,12,12–17,1–,25–50,3–,3–10,3–5,3–7,4,4–6,5,50,5–10,5–7,6,6–,6–9,?,absent,adaxially,ag,alyx,anthesi,apiculate,axe,ba,becoming,bilobe,blade,bud,clustered,completely,cucullat,deeply,dr.,eaf,eed,ellipsoid,elongating,entire,equal,exserted,filament,fleshy,flower,internode,lobe,lobed,long-styled,lower,major,margin,middle,mostly,nflorescence,orolla,plurifoliat,rachi,recurve,robust,rounded,rugose,ruit,side,slender,stellate,subwoody,tamen,terminally,thick,thickened,time,triangular,unit,vary,vein,way,wide,widest,ympodial,youn,–9	0.3-0.8,1-3-7,10-15,10-25-50,3-5,5-7,age,arrangement,articulation,bark,bilobed,color,connation,dehiscence,diminishing,distal,form,fruiting,growth,height,history,inflorescence,interjected,leaf,leaflet,length,life,na,ovary,papillae,petiolule,plant,position,pseudostipule,seed,shape,size,spacing,straightnes,texture,tuber-bearing
185	wfo-0001027131	success	186	127	89	97	38	0.478	0-5,0.2-2.2,0.4-0.8,0.9-2.5,1-1.2,1-1.5,1-2,1-4,1.5-3.3,12-20,2.6-3,3-4,3-9,4-10,4-7,4-8,5.5-6.5,7-11,9.5-11.5,abaxially,absent,acute,adaxially,anther,apex,articulated,base,black,brown,calyx,circular,cm,cordate,dark,densely,diameter,distally,elliptical,extra-axillary,flower,fruit,fruiting,globose,green,grey,inflorescence,lateral,length,lobe,long,longer,markedly,midpoint,mm,obtuse,ovate,pale,pedicel,peduncle,per,perennial,petiole,plant,present,prickle,pseudo-racemose,purple,ray,rotate,shrub,simple,stalk,stalked,stellate-pubescent,stem,straight,streak,style,thicker,thicknes,throughout,time,tube,unarmed,white,wide,yellow,yellowish,yellowish-green	%,.05,.7,0-0.1,0-0.3,0-2,0-3,0.4-1,0.5-0.8,0.5-1,0.7-2.5,1-3,1.4-2,1.7-3.5,17-35,2-5,2.3-2.7,4-locular,4.5-8.5,5-merou,7-8,7-9,absen,across,adaxiall,alyx,andromonoecious,anvil-shape,apart,ascending,attenuate,axe,ba,blade,broad-based,chartaceous,cross-section,cylindrical,d.,directed,distall,distributed,dult,eaf,eed,eglandular,entire,erect,exocarp,finger,functional,geminat,gland-tipped,hair,half,heterostylous,hig,juicy,lamina,less,lower,margin,mature,mesocarp,mid-point,minute,moist,nflorescence,oblique,onl,orolla,part,placenta,plurifoliate,pore,porrect,possibly,rhizomatous,ridged,ruit,rusty,short,spaced,stage,stellae,tamen,terete,thick,unarme,unbranched,unit,unknow,uvenile,vary,weakly,x,ympodial	0.7,anvil-shaped,arrangement,articulation,bark,color,connation,corolla,dehiscence,diminishing,distal,dm,form,growth,height,history,interjected,leaf,leaflet,life,na,number,ovary,papillae,petiolule,position,pseudostipule,seed,shape,size,spacing,stigma,straightnes,surface,terminal,texture,tuber-bearing,width
186	wfo-0001027146	success	213	125	92	121	33	0.432	0-11,0.3-2.2,0.5-3.2,0.8-5.8,1-10,1-2,1-9.5,1.9-10,10,13-36,2-12.2,2-13,4-11,4-12.5,6-10,6-17.5,acuminate,anther,apex,articulated,axillary,base,berry,brownish,bud,clavate,cm,coarsely,condition,conical,connivent,corolla,deep,diameter,distal,drying,elliptic,finely,forked,fourth,fresh,fruit,green,greenish,herb,interjected,lanceolate,lateral,leaf,leaflet,medium,minute,mm,mottled,mucilaginous,odd-pinnate,ovate,ovoid,pedicel,peduncle,pentagonal,petiole,petiolule,plant,poricidal,proximal,puberulent,pubescent,purple,ripe,rotate,seed,semierect,size,stem,stigma,straight,style,subglabrous,subsessile,subtending,terminal,throughout,tinged,tip,tube,violet,wet,white,whitish,x,yellow	0.6-3.3,0.7-2.4,0.8,0.8-3.1,1-2.5,2-4.2,2-5,3.3-6.1,3.5-22,4-38,4-8,5-merou,6,6.5-52,abaxially,acumen,adaxially,ag,along,alyx,apart,apparently,arranged,asymmetrical,attenuate,axe,basiscopic,bead,blade,capitat,cell,chartaceous,ciliate,commonly,covering,dark,darker,decreasing,digestion,dorsally,eaf,edge,eed,enzyme,erec,especially,exceeding,filament,flat,flower,folded,fourt,geminat,generally,glabrou,glabrous,gradually,green-white,hair,hair-like,half,homostylous,honeycomb-shaped,lengthening,like,living,lobe,long,lower,make,margin,membranous,midrib,minutely,moniliform,multiple,necklace,nflorescence,orbicular,orolla,pair,perfect,plurifoliate,pore,rarely,ray,removed,ruit,secondary,sessile,seudostipule,side,simple,slit,sometimes,spaced,specimen,stamen,ste,stolon,subequal,subglabrou,symmetrical,tall,tamen,tem,testal,thick,tissue,toward,tri-,tuber,typically,unit,unwinged,usually,vary,wall,wide,wing,ympodial	1-6,arrangement,articulation,bark,calyx,capitate,color,connation,dehiscence,diminishing,erect,form,fruiting,growth,height,history,inflorescence,length,life,na,ovary,papillae,position,present,prickle,pseudostipule,shape,spacing,straightnes,surface,texture,tuber-bearing,ye
187	wfo-0001027154	success	215	103	64	151	39	0.298	0,0.4-0.5,3-7,5,accrescent,anther,apart,apex,articulated,attenuate,base,calyx,cm,color,connivent,curved,diameter,extra-axillary,flattened,flower,foveolate,fruit,fruiting,globose,green,immature,leaf,length,linear,mature,minutely,mm,nearly,opening,ovate,pedicel,peduncle,petiole,plant,prickle,pubescent,reniform,rotate-pentagonal,rounded,shape,shrub,simple,size,slightly,slit,sometimes,stem,stigma,stipitate,straight,style,surface,tan,tube,unknown,white,x,yellow,yellowish	-15,-16,.2,.5,.6,0.2,0.3–0.6,1-1.3,1.5–2.5,1.5–3,1.9,17–19,1–2,2,2-6,2.5-5,2.9,23,26,2–2.5,2–4,35,3–10,4.5–5,4.5–8,4–8,6–8,6–9-rayed,7.5-11,7–20,8,8-11,abaxially,absent,acute,adaxiall,adaxially,ag,alyx,ample,armed,axe,ba,basal,berry,blade,branch,branched,broad,broad-based,capitat,chartaceous,clavate,cylindrical,deltate,densely,difoliate,directed,distally,eaf,eed,entire,evidently,except,ferruginous,filament,finer,flowering,free,geminat,glabrescen,glabrous,hair,highly,ilament,interpetalar,irregularly,juvenile,lanceolate,larger,less,lighter,like,lobe,lobed,lognitudinal,long,m.,major,margin,midpoint,midrib,minute,mostly,much,near,nflorescence,normally,oblique,often,older,orolla,outline,paler,part,per,perfect,pinnately,pore,rachi,rarely,ray,reaching,recurved,reflexed,repand,ruit,sessile,shiny,side,sinus,smaller,spaced,sprout,ste,stellae,stellate-tomentose,stipe,stout,sulcate,tal,tardily,tem,third,three,tissue,tomentose,truncate,unarme,unarmed,underside,uniform,unit,usually,variable,vary,vein,within,ympodial,young,–4	0.3-0.6,1-2,1.5-3,17-19,2-4,4-8,age,arrangement,articulation,bark,capitate,connation,corolla,dehiscence,diminishing,distal,form,growth,height,history,inflorescence,interjected,lateral,leaflet,life,longitudinal,na,ovary,papillae,petiolule,position,present,pseudostipule,seed,spacing,straightnes,terminal,texture,tuber-bearing
188	wfo-0001027157	success	207	136	104	103	32	0.502	0-3,0.15-0.3,0.7-2,0.9-2.8,1,1-10,1-2,1-3,1-3.8,1.5-6.5,10-30,2,2-15,2.3-4,3-7,3.8-8.3,9-12,absent,acuminate,anther,apart,apex,articulated,axillary,base,broadly,brownish,bud,cell,chartaceous,clavate,cm,condition,conical,connivent,cordate,corolla,covering,decurrent,deeply,densely,diameter,distal,drying,elliptic,forked,fresh,fruit,glabrous,green,greenish,hair,hair-like,herb,interjected,lanceolate,lateral,leaf,leaflet,like,membranous,mm,oblique,odd-pinnate,orbicular,ovate,ovoid,pedicel,peduncle,petiole,petiolulate,petiolule,plant,poricidal,puberulent,pubescent,ripe,rounded,seed,sessile,short,size,slightly,sometimes,stellate,stem,stigma,straight,style,subsessile,subtending,terminal,testal,thick,tinged,tip,tube,typically,violet,wall,white,whitish,x,yellow	1-6,2-2.5,2-3,2-5,2.5-3,3-12,3.3-7.8,4-5,5-merou,6.5-14.5,abaxially,acumen,acute,adaxially,ag,along,alyx,among,apparently,attenuate,axe,berry,blade,capitat,ciliate,cuneate,decreasing,digestion,dorsally,eaf,edge,eed,end,enzyme,erec,especially,exceeding,filament,flat,flower,folded,geminat,generally,glabrou,grassland,greatly,green-white,half,homostylous,honeycomb-shaped,lengthening,living,lobe,long,low-growing,lower,make,margin,markedly,middl,midrib,minutely,mucilaginous,narrowly,nflorescence,obtuse,one,orolla,pair,perfect,placed,plurifoliate,pore,rarely,removed,ruit,semi-rosette,seudostipule,shady,situation,slit,spaced,specimen,stamen,ste,stolo,sunny,tall,tamen,tem,throughout,toward,tri-,tuber,unequal,unit,unwinged,usually,vary,wet,wide,woodland,ympodial	arrangement,articulation,bark,calyx,capitate,color,connation,dehiscence,diminishing,form,fruiting,growth,height,history,inflorescence,length,life,middle,na,ovary,papillae,position,present,prickle,pseudostipule,shape,spacing,straightnes,surface,texture,tuber-bearing,ye
189	wfo-0001027184	success	219	121	81	138	40	0.37	.5,0.2-0.4,0.4-2,0.5-2,1-2,4,accrescent,acute,anther,apex,articulated,base,blue,brown,calyx,cm,connivent,covered,diameter,elliptic,entire,epidermal,extension,flattened,fleshy,foliaceous,fruit,fruiting,globose,hairlike,herbaceous,imparipinnate,lateral,leaf,leaflet,least,light,longitudinal,membranous,meter,mm,narrowly,oblong,obtuse,often,opening,orange,ovate,pedicel,peduncle,petiole,petiolule,prominently,pseudostipule,pubescent,red,reticulate,ripe,several,shape,size,slightly,slit,soft-woody,sparsely,stellate,stem,stigma,straight,style,surface,terminal,truncate,tube,unbranched,unequal,vine,wall,white,x,yellow	.3,.7,.8,0-,0-0.2,0.4–0.9,0.8,0.8–1.6,0–3,1.5,1.5-5,1.8–3.5,13–18,19,1–2,1–2.5,1–4,2,2.8–4.1,2–4-celled,3-4-,3-foliolate,3.5–8,3–,3–4-celled,4–12,5,5-7,7,9,abaxially,absent,adaxiall,adaxially,adventitious,ag,along,always,alyx,apart,appressed,axe,axi,axillary,ba,basal,blade,borne,bract-like,branch,broad,broadly,cell,chartaceous,clavat,cluster,cordat,cylindrical,densely,directed,eaf,eed,especially,fasciculate,filament,flower,free,geminat,generally,glabrescent,glabrou,glabrous,grading,hair,half,ilament,introrsely,lanceolate,larger,largest,leafy,less,like,lobe,long,lower,m.,margin,midrib,minutely,mostly,much,nearly,nflorescence,node,older,opposite,orolla,ower,per,pilose,plurifoliate,pore,portion,prominent,puberulent,rachi,raised,rarely,revolute,root,ruit,scarcely,secondary,shoot,short,simple,small,somewhat,spaced,subopposite,sulcate,tertiary,tightly,tip,tree,trunk,unarme,uniform,unit,usually,vary,vein,visible,weak,ympodial,young,–9	0-3,0.8-1.6,1-2.5,1-4,1.8-3.5,13-18,2.8-4.1,3.5-8,age,arrangement,articulation,bark,clavate,color,connation,cordate,corolla,dehiscence,diminishing,distal,form,growth,height,history,inflorescence,length,life,na,ovary,papillae,plant,position,prickle,pubescence,seed,spacing,straightnes,texture,tuber-bearing,ye
190	wfo-0001027186	success	168	127	111	57	16	0.661	-6,.4,.5,0.5-1,1-1.5,1-2.5,1.4-1.6,1.5-2,1.5-2.5,15,2-6,2-lobed,3-4,30-40,4-9,5-10,6-7,9-10,abaxial,acute,adaxially,age,anther,apart,apex,attenuate,base,berry,branched,broadly,calyx,clavate,cm,conical,corolla,deltate,dendritic,densely,diameter,dry,ellipsoid,elliptic,entire,exerted,filament,flower,fruit,glabrous,globose,green,growth,irregularly,keeled,lengthening,less,lobe,lobed,longer,margin,maturity,midrib,minutely,mm,much,narrowly,new,ovary,ovoid,pair,pale,papillate,pedicel,peduncle,pericarp,petiole,pitted,plane,pointed,pore,poridical,primary,pubescent,rachi,reniform,rough,scar,seed,shiny,simple,slightly,slit,spaced,sparsely,stem,stigma,straight,strongly,style,surface,terminal,time,tip,tree,treelet,trichome,tube,variably,vein,way,woody,yellow	1.5,1.6-5,2.5-3,3.5-4,4-15,?,abaxially,always,anthesi,apparently,axil,bark,branch,brown,dark,dbh,deflexed,denditic,denser,eaf,enlarging,filiform,free,fruiting,glabrescent,golden,immature,incrassat,lamina,like,loose,lower,m.,nflorescence,occasionally,papillat,pendent,perfect,planar,plurifoliat,portion,pubescen,reddish,ruit,scattered,short,small,soon,spreading,stalk,tub,ud,uniseriate,unit,white,x,ympodial	arrangement,branching,bud,color,form,height,history,inflorescence,leaf,length,life,plant,position,shape,straightnes,texture
191	wfo-0001027187	success	224	110	69	155	41	0.308	0.6,7,9,accrescent,anther,apex,articulated,base,blue,broadly,calyx,cm,completely,connivent,cordate,covering,cuneate,darker,deltoid-ovate,densely,diameter,distal,extra-axillary,finely,flattened-reniform,forked,foveolate,fruit,fruiting,glandular-puberulent,globose,green,herb,lanceolate,lateral,leaf,lenticular,light,long,maturity,minutely,mm,moderately,mottling,narrowly,obtuse,pedicel,peduncle,perennial,petiole,prickle,rotate-stellate,rounded,simple,sky,stellate,stellate-pubescent,stem,stigma,straight,strongly,style,subglobose,surface,tube,unbranched,weakly,yellow,young	.5,0,0.05–0.1,0.15–0.4,0.2,0.3–1,0.4,0.5,0.5–1,0.5–1.5,0.8–2,1,1-celled,1.0,1.2,1.5–3.5,12,13–18,1–1.5,1–1.8,1–2,1–3,1–3-celled,2,2-,2.5–4,2.5–6,2–2.5,2–3,2–5,2–7,3-foliate,3.2,3.5–10,3–10,3–10.5,3–6,3–7,4,4.5–8,4–5,5,5-merous,5.4,5.5,5–10,5–11,5–15,5–6,5–8,6,6–8,7–12,7–15,abaxially,acute,acute-acuminate,adaxiall,adaxially,alyx,andromonoecious,apart,armed,axe,berry,blade,branched,bud,capitat,central,chartaceous,continuum,cylindrical,decumbent,deflexed,deltate,deltate-lanceolate,directed,distall,downward,eaf,eed,equal,erect,exserted,filament,flower,geminat,glabrous,grading,hair,hermaphroditic,irregularly,like,lobe,lobed,lon,long-stalked,lower,major,margin,morphology,nflorescence,node,offset,often,one,open,orolla,outline,perfect,plurifoliate,pore,prickle-like,producing,proximal,pubescent,rarely,ray,rind,root,rooting,ruit,serrate,sessile,shallowly,short-stalked,showing,side,sinus,small,sometimes,spaced,sparsely,spreading,stalk,staminate,stout,subequal,subsessile,tall,tamen,tapered,tem,toug,triangular,truncate,unequal,unit,usually,vary,vein,wide,ympodial,×	0.5-1.5,1.5-3.5,2-7,3-7,4.5-8,5-15,5-8,7-12,arrangement,articulation,bark,capitate,color,connation,corolla,dehiscence,diminishing,form,growth,height,history,inflorescence,interjected,leaflet,length,life,na,ovary,papillae,petiolule,plant,position,pseudostipule,seed,shape,size,spacing,straightnes,terminal,texture,tuber-bearing
192	wfo-0001027198	success	191	117	83	108	34	0.435	0.05-1.0,0.5-0.75,1-1.5,1-10,1.5-10,1.5-2,11-20,2-5.5,3/4,4-9,5-6,7.5-9,acuminate,acute,anther,apart,apex,attenuate,axil,base,beneath,bushy,calyx,clavate,cm,corolla,cyathiform,elliptic,entire,fruiting,furcate,glabrous,globose,green,inflorescence,lateral,leaf,lobed,long,many,medium,minutely,mm,obovate,often,opposite,ovary,ovoid-reniform,pale,paler,papillose,pedicel,petiole,pitted,plant,poricidal,pubescent,shaped,shining,short,shrub,size,slightly,small,speciman,stem,stigma,straight,style,styled,surface,tannish-yellow,tear-drop,time,tip,tree,tube,two,type,vein,way,white,x	.4,.5,0.5-1,0.7-1,0.8-1,1-5,10-11,5-120-flowered,abruptly,always,anthesi,ba,beginning,berry,broadening,caly,channeled,closely,complex,constriction,corky,corresponding,decurrent,deltoid,dendritic,densely,dia,differing,difoliate,dry,eaf,edge,edicel,eed,erect,evenly,exserted,extremely,eye,female,filament,flower,found,free,geminat,glabrate,golden,impressed,inflorescenc,invisible,large,like,live,lobe,lon,lower,main,major,male,margin,meet,middle,minor,minute,naked,nearly,nflorescence,older,overlapping,ovoid,papillo,pendan,planar,pore,portion,puberulent,pubescence,rather,reddi,reflexed,rest,rounded,ruit,scar,sessile,set,simple,slender,soon,spaced,specimen,strong,tall,testae,thickened,thin,top,trichome,ud,undersurface,uniseriate,unit,usually,widest,woody,yellowish,ympodial,young	arrangement,articulation,bark,color,connation,dehiscence,diameter,diminishing,distal,form,fruit,geminate,growth,height,history,interjected,leaflet,length,life,na,papillae,peduncle,petiolule,position,prickle,pseudostipule,reddish,seed,shape,spacing,straightnes,terminal,texture,tuber-bearing
193	wfo-0001027200	success	139	101	67	72	34	0.482	0.05-0.25,0.5-0.75,0.6-1,1-1.4,1-1.5,1.5-5,2-3,6-8,acute,anther,apex,bark,base,beneath,branch,broadly,brown,calyx,capitate,cm,conical,corolla,dark,deeply,elliptic,flattened,fruiting,glabrous,globose,golden,green,grey-brown,horizontally,inflorescence,lateral,leaf,lobed,mm,nearly,ovary,ovoid-reniform,pedicel,petiole,pitted,poricidal,puberulent,shaped,shrub,size,small,sparsely,spreading,stem,stigma,straight,style,surface,tear-drop,tip,tree,trichome,tube,unicellular,unifoliate,uniseriate,vein,white	0.25-0.5,0.5-1,0.7-2.5,1.2-1.5,1.5-2,1.6-6,2.5-3,3-3.5,3.5-6,8-15,9-11,across,anthesi,aspec,ba,berry,branche,converging,decurrent,deflexed,deltoid,densely,dia,differing,eaf,eed,except,filament,free,geminate,giving,impressed,lightly,like,lobe,lon,long,lower,main,major,margin,middle,minor,minute,minutely,near,node,non-reproductive,occasionally,older,onto,papillo,papillose,planar,pore,portion,prominent,reflexed,rest,ruit,slightly,sparse,tall,unit,widened,widest,winged,woody,x,yellowish,ympodial,young	arrangement,articulation,aspect,color,connation,dehiscence,diameter,diminishing,distal,form,fruit,growth,height,history,interjected,leaflet,length,life,na,papillae,peduncle,petiolule,plant,position,prickle,pseudostipule,seed,shape,spacing,straightnes,terminal,texture,tuber-bearing,width
194	wfo-0001027204	success	154	118	77	77	41	0.5	-40,-8,.5-1,0.5-4,1,1-14,1-3.5,1.5-6.5,1.5-9,2-4,2-8,3-20,5-19,5-30,6-10,acuminate,acute,angled,apart,apex,articulated,base,branched,brown,calyx,chartaceous,cm,connivent,cuneate,decurrent,dense,diameter,elliptic,forked,fruit,glabrate,glabrous,globose,greenish,lanceolate,leaving,long,mm,near,orange,ovate,pedicel,peduncle,peg,petiole,pink,pseudohair,puberulent,pubescent,purplish,reddish,rugose,scar,short,shrub,simple,sparsely,stellate,stellate-campanulate,stigma,style,subcoriaceous,time,tube,twice,unbranched,violet,white,wide,x,yellow,yellowish	-4.5,.8-2,1-10,1-7,1.5-3.5,15-35,2-2.5,2-5,3-5,4-5-foliat,4-6,5-9,6-12,8-15,abaxially,absen,adaxial,adaxially,aggregate,along,axe,blade,cell,channe,cylindrical,densely,denser,directed,distall,distally,eaf,eed,eglandular,entire,especially,except,expanded,flower,glandular,hair,lobe,lon,lower,margin,membranaceous,midrib,moderately,narrowed,narrowly,nearly,nflorescence,nther,obtuse,often,orolla,perfect,pore,present,pubescen,pubescent-pilose,rachi,radiu,ripe,ruit,spaced,stone,subacute,tal,tem,tip,triangular,triangular-deltate,truncat,unit,vary,x1-2,ympodial	2-4.5,anther,arrangement,articulation,bark,color,connation,corolla,dehiscence,diminishing,distal,form,growth,height,history,inflorescence,interjected,lateral,leaf,leaflet,length,life,na,ovary,papillae,petiolule,plant,position,prickle,pseudostipule,seed,shape,size,spacing,stem,straightnes,surface,terminal,texture,truncate,tuber-bearing
195	wfo-0001027213	success	231	121	87	144	34	0.377	-19,-3.3,0-2.5,0.2-0.4,0.2-0.5,1-5,1.8-2.8,12.3-16.3,2-5,2.9-4.8,4-9.5,4.2-5.9,5.7-6.2,8-24,9-13,abaxially,accrescent,acuminate,acute,adaxially,anther,apart,apex,articulated,base,blunt-tipped,branched,broadly,brown,calyx,cm,completely,corolla,covering,dark,deltoid,diameter,drying,elliptic,enveloping,flower,fruit,fruiting,globose,grayish-brown,green,immature,lanceolate,lateral,leaf,length,many,midrib,mm,oblanceolate,pale,pedicel,peduncle,petiole,poricidal,pubescent,reniform,reticulate-punctate,scabrous,short-attenuate,shrub,side,simple,sometimes,stellate,stem,stigma,style,surface,time,tip,tomentose-pubescent,tree,tube,unarmed,violet,white,whitish-green,x,yellow,yellow-green,yellow-tan	-230,-4.5,/10,0-160,0.7-2.3,0.8-1.8,1-2,1.1-1.7,1.2-1.6,1.2-1.7,1.2-2.5,1.3-2.2,1.7-3.6,1.7-3.9,1.8-3.2,1/2-2/3,10-24,2.4-4.7,2.5-5.1,2.9-3.8,2/3,3.5-5,3.5-8,5-7.5,5-8,5-merou,8.2-10.5,ag,along,alyx,anthesi,apparently,ark,around,attenuate,axe,axillary,ba,basal,blade,branch,capitat,cell,conical,cuneate,cylindrical,decurrent,directed,distally,eaf,early,edge,eed,entire,epidermal,eventually,exserted,farinose,few-rayed,filament,free,glabrescen,glabrescent,glabrous,granular,group,hair,high,homostylous,inserted,lackin,lengthening,lobe,lobed,long,long-,long-stalked,longitudinal,lower,m.,main,margin,mixed,moderately,mostly,multangulat,multangulate,nearly,nflorescence,obovate,obscured,obtuse,often,older,orbicular,orolla,ovate,ovate-lanceolate,partly,perfect,plurifoliate,pore,porrect-stellat,porrect-stellate,prominent,pseudo-terminal,pubescence,rachi,rather,relatively,ruit,sessile,short,short-,short-stalked,slit,somewhat,spaced,sparsely,stamen,subcampanulate,suture,tamen,terete,thick,thick-stalked,thin-stalked,ti,tomentose,tomentu,touching,ud,unarme,unit,unwinged,vary,vein,vestigial-rayed,way,whitish,wide,yellowish,ympodial,young	arrangement,articulation,bark,capitate,color,connation,dehiscence,diminishing,distal,form,growth,height,history,inflorescence,interjected,leaflet,life,na,ovary,papillae,petiolule,plant,position,prickle,pseudostipule,pseudoterminally,seed,shape,size,spacing,straightnes,terminal,texture,tuber-bearing
196	wfo-0001027214	success	181	99	72	109	27	0.398	.5,0.3-1.5,0.5-0.8,0.5-1,0.7-2.5,1-2.8,1.2-3,2,2-9,6-12,7-12,abaxially,acute,adaxially,anther,apex,base,calyx,climbing,cm,conical,corolla,decurrent,densely,diameter,elliptic,erect,flattened-round,fruit,fruiting,glabrous,green,greenish,grown,height,herb,inflorescence,lateral,leaflet,length,lobed,long-acuminate,long-conical,minutely,mm,nearly,oblique,occasionally,once-branched,ovary,pedicel,petiole,petiolule,pinnate,pointed,poricidal,pubescent,rachi,scrambling,seed,sharply,simple,somewhat,stigma,style,surface,terminal,tip,truncate,tube,white,x	-20,-38,-9,..,.25,0,0-16,0.25,0.3-1.7,0.7-2,0.8-1,1-1.5,1.5,1.5-1.8,1.5-6,10-,10-13,12-17,15-25,3-,3-6,4-5,5-6,6-,8-9,absent,acuminate,along,anthesi,anticlinal,apical,basal,berry,broadly,capitat,cell,composed,conspicuously,deltate,dr.,drying,eaf,edicel,eed,epidermal,exserted,extending,filament,finely,flower,free,globose,groove,horizontal,inflorescenc,irregular,lamina,lanceolate,less,like,lobe,lon,long,lower,margin,markedly,midrib,narrowly,nflorescence,noddin,nodding,obovate,often,onto,open,opposite,pair,paired,papilla,papillate,per,perfectly,portion,projection,reflexed,rest,rugose,rugosity,ruit,scar,scattered,sinuous,smaller,tem,thickening,time,triangular,trichome,tub,ud,unevenly,unifoliat,uniseriate,unit,vein,white-lenticellate,whitish,without,ympodial	arrangement,articulation,bark,capitate,color,connation,diminishing,distal,form,growth,history,leaf,life,na,papillae,plant,position,present,prickle,pubescence,shape,size,stem,straightnes,texture,tuber-bearing,ye
197	wfo-0001027219	success	143	97	59	84	38	0.413	0.4-0.6,0.5-0.8,1-2,2,2-4,6-8,acuminate,acute,age,anther,apex,bark,base,bright,broadly,calyx,capitate,closely,cm,conical,corolla,cup-shaped,diameter,elliptic,fruiting,glabrous,green,growth,leaf-opposed,lengthening,less,lobed,long-styled,minutely,mm,ovary,pedicel,peduncle,petiole,poricidal,purple,short-styled,shrub,simple,slightly,slit,somewhat,spaced,stem,stigma,stout,style,surface,terminal,tip,tube,violet,white,woody	.5,/4,0.3,0.5,1,1-15,1-3,1.5-2,1.5-2.5,2-2.5,2-3,2-3.5,3-5,3-6,7-8,absent,anthesi,axillary,berr,berry,brown,c.,completely,deltate,densely,drying,eaf,edge,eed,entire,erect,exerte,exfoliatin,filament,flower,free,glabrescent,glabrou,globose,greyish,hard,heterostylous,known,lobe,long-conical,lower,margin,maturity,new,nflorescence,overlappin,pair,pale,papillo,papillose-pubescent,pendent,pericarp,planar,plurifoliat,pointed,pore,portion,primary,pubescent,ruit,scar,sharply,shoot,short,sometimes,soon,thickened,trichome,tuft,ud,uniseriate,unit,vein,way,weight,x,yellowish,ympodial,–1/3	/,0-0.3,arrangement,articulation,color,connation,dehiscence,diminishing,distal,exfoliating,form,fruit,height,history,inflorescence,interjected,lateral,leaf,leaflet,length,life,na,overlapping,papillae,papillose,perennial,petiolule,plant,position,prickle,pseudostipule,seed,shape,size,spacing,straightnes,texture,tuber-bearing
198	wfo-0001027221	success	261	105	63	198	42	0.241	0.3-0.6,1,2.2-3.2,3.1-4.8,4,5-8,abaxially,acute,anther,apart,apex,articulated,attenuate,base,berry,blue,branched,bright,calyx,cm,diameter,distally,extra-axillary,flattened-reniform,flower,fruit,fruiting,globose,intensity,lanceolate,lateral,leaf,light,long,minutely,mm,orange,ovate,pale,pedicel,peduncle,petiole,pitted,plant,prickle,rounded,shrub,simple,size,slightly,stellate,stellate-tomentose,stem,stigma,style,subcordate,surface,tube,unbranched,variable,violet,x,yellow	-9.5,.5,0,0.4,0.4–0.6,0.5–2,0.8–1,1-4,1.4-2,1.5-2,1.6–2,11-17,11–14,13–16,14–17,1–2,2,2.5–2.8,2.5–5,2.9–3.6,2/3,25-30,2–2.5,2–3,2–5,3–6,4.5–11,4–8-rayed,5-merou,6-8,6.5–7,8.5–18,9,abaxial,abaxiall,acicular,actually,acutely,adaxially,along,also,always,alyx,ample,andromonoecious,apparent,apparently,appear,armed,aromatic,ba,becoming,blade,blunt-tipped,broad-based,bud,capitat,caudate,central,chartaceous,clavate,closely,common,contrasting,coroll,curved,cylindrical,darker,deeply,delicate,dense,densely,development,difoliate,directed,discrete,eaf,eed,entire,equal,eventually,evidently,exceeding,expanded,fewer,filament,frequently,fresh,geminat,glabrescent,glabrous,gland,glandular-pubescent,hair,half,herbarium,hermaphrodite,homostylous,interpetalar,juic,least,like,likely,lobe,lobed,lower,main,major,margin,material,microscope,midpoint,midrib,midvein,minor,mostly,much,nearly,nerve,nflorescence,obtuse,often,older,orolla,outline,ovate-oblong,ovate-triangular,pair,paired,per,perfect,perhaps,peripherally,persistently,plurifoliate,pore,predominately,probably,rachi,rarely,ray,reflexed,repand,ruit,sessile,short-stalked,side,similar,sinus,smaller,sometimes,somewhat,soon,source,spaced,sparsely,specimen,splitting,sprout,stalk,stalked,stamen,stellae,stellate-pubescent,straight,sulcate,tal,tapered,tem,thick-textured,thickened,time,tip,tissue,tomentose,toward,triangular-caudate,unarmed,underside,unequal,unit,unpleasantly,usually,vary,vein,viscid,viscidity,way,weakly,white,wide,ympodial,youn,young,–11.5,–15,–3,–4	0.4-0.6,0.5-2,1-2,11-14,11.5,13-16,2-3,2-5,2.5-5,3-6,arrangement,articulation,bark,capitate,color,connation,corolla,dehiscence,diminishing,distal,form,growth,height,history,inflorescence,interjected,leaflet,length,life,na,ovary,papillae,petiolule,position,pseudostipule,seed,shape,spacing,straightnes,terminal,texture,tuber-bearing
199	wfo-0001027223	success	189	115	83	106	32	0.439	0.19-0.75,0.3-1.2,1-2,1.3-2,1.5-3.5,1.8-3.5,16-41,3-10,3-11,3-5,3.5-6,3.5-7,3.7-9.3,4-6,5-21,9-15,acuminate,anther,apex,articulated,asymmetric,attenuate,base,brownish,clavate,cm,condition,conical,connivent,corolla,deep,densely,diameter,distal,dot,drying,elliptic,forked,fresh,fruit,green,greenish,half,herb,interjected,lanceolate,lateral,leaf,leaflet,middle,mm,mucilaginous,odd-pinnate,ovate,ovoid,pedicel,peduncle,pentagonal,petiole,plant,poricidal,pubescent,purple,ripe,rotate,rounded,seed,size,sometimes,stigma,straight,stripe,style,terminal,tip,tube,typically,usually,wet,white,whitish,x,yellow	.5,1-3,2-4,2-7,3-5.2,3.5-4,5-10,5-8,5-merou,5.9-12.2,9-22,9-35,abaxially,acumen,adaxiall,adaxially,ag,alyx,apart,apparently,axe,axillary,basiscopic,berry,blade,bud,capitat,cell,covering,decreasing,digestion,dorsally,eaf,edge,eed,end,enzyme,erec,exceeding,filament,flat,flower,folded,geminat,generally,glabrou,glabrous,green-white,hair,hair-like,hal,homostylous,honeycomb-shaped,hyaline,larger,lengthening,light,like,living,lobe,long,lower,make,nflorescence,one,orbicular,orolla,pair,perfect,petiolulate,placed,plurifoliate,pore,present,removed,ruit,sessile,seudostipule,short,shortly,side,slightly,slit,spaced,specimen,stamen,ste,stolo,subequal,subtending,tall,tamen,tem,testal,thick,throughout,tissue,toward,tri-,tuber,unit,unwinged,vary,wall,wide,ympodial	arrangement,articulation,bark,calyx,capitate,color,connation,dehiscence,diminishing,erect,form,fruiting,growth,height,history,inflorescence,length,life,na,ovary,papillae,petiolule,position,prickle,pseudostipule,shape,spacing,stem,straightnes,surface,texture,tuber-bearing
200	wfo-0001027229	success	206	100	65	141	35	0.316	0.1-3,0.6-1,1-8,1.5-3,1.8-2.7,3-6,3.5-6,4-7,5-6,8.5-12,accrescent,acute,anther,apex,articulated,base,broadly,calyx,chartaceous,cm,cordate,diameter,directed,erect,especially,extra-axillary,fruit,fruiting,globose,green,herbaceous,inflorescence,lanceolate,lateral,length,lilac,long,margin,minute,minutely,mm,obtuse,ovate,pale,pedicel,peduncle,pentagonal,petiole,prickle,prostrate,pseudo-racemose,reniform,resprouter,reticulate,simple,sprawling,stellate,stigma,straight,style,surface,tan,toward,tube,yellow	%,0-0.1,0-0.2,0-8,0.1-0.3,0.1-0.6,0.1-1,0.1-1.4,0.2-0.4,0.2-1.7,0.2-2,0.5-0.7,0.5-0.9,0.5-3,0.6-0.7,1-1.5,1-2,1-6,1-7,1.1-1.2,1.3-1.7,1.5-2.5,12-17,2-10,2-4,2-5,2-foliate,2-locular,2.5-6,20-65,25-35,3.5-5,30-145,30-300,4-10,4-5,4-6,40-55,5-15,5-9,5-merou,7-11,8-12,abaxially,absen,absent,abundant,acicular,across,adaxiall,adaxially,adult,alyx,apart,armed,attenuate,axe,ba,blade,branche,capitat,circular,cross-section,cylindrical,decimetre,densely,distall,eaf,eed,eglandular,elliptica,exceeding,exocarp,filament,finger,flattened,flower,geminat,glabrous,gland-tipped,glandular,hair,homostylous,index,interpetalar,juicy,lamina,lobe,lobed,lobing,lon,longer,lower,mature,mesocarp,mid-point,midpoint,midvein,moderately,moist,nflorescence,oblique,orolla,part,per,perfect,placenta,pore,porrect,presen,present,rachi,ray,ruit,shallowly,short,side,spaced,sparsely,stage,stalk,stalked,stellae,stellate-pubescent,tal,tamen,tem,thick,throughout,time,tissue,transparent,triangular,unbranched,unit,uvenile,vary,vein,wide,x,ympodial	arrangement,articulation,bark,capitate,color,connation,corolla,dehiscence,diminishing,distal,distally,form,growth,height,history,interjected,leaf,leaflet,life,na,ovary,papillae,petiolule,plant,position,pseudostipule,seed,shape,size,spacing,stem,straightnes,terminal,texture,tuber-bearing
201	wfo-0001027232	success	195	98	63	132	35	0.323	0.7-1.5,1.5-2.5,1.8-3.9,2-3.4,3-5,4-8,4.5-6.5,5-8,accrescent,acute,anther,apex,articulated,base,black,bluntly,broadly,brown,calyx,chartaceous,cm,cordate,diameter,directed,discoid,extra-axillary,flattened,forked,fruit,fruiting,globose,inflorescence,irregularly,lancolate,lateral,length,lilac,minute,minutely,mm,obtuse,orbicular,ovate,pale,pedicel,peduncle,perennial,petiole,present,prickle,purple,reticulate,shrub,simple,stellate,stigma,straight,style,surface,triangular,tube,unbranched,yellow	%,0-0.1,0-7,0.15-0.3,0.25-0.4,0.3-0.4,0.3-0.45,0.3-0.5,0.4-0.8,0.45-0.6,0.5-0.8,0.6-0.9,0.7-1.3,0.8-3.2,0.9-7.5,1-10,1-locular,1.1-1.5,1.5-3,10-30,14-18,14-30,15-100,2-25,2.1-2.8,2.5-3,25-35,3-9,3.5-10,350-800,4-10,4-5.5,4-6,5-11.5,5-merous,6-8,7-9,abaxially,absen,absent,acicular,across,adaxiall,adaxially,adult,apart,apparen,armed,axe,ba,blade,branche,capitat,confined,cylindrical,decimetre,deeply,deltate,distall,distributed,eaf,eed,eglandular,erect,exocarp,filament,finger,flower,glabrous,gland-tipped,green,hair,half,incomplete,index,juicy,lamina,less,lobe,lobed,lobing,long,longer,lower,margin,mature,mesocarp,mid-point,midpoint,midrib,midvein,moderately,nflorescence,oblique,orolla,outline,part,per,perfect,placenta,pore,porrect,ray,rhizomatous,rostrate,ruit,septum,sessile,short,side,spaced,sparse,sparsely,stalk,stellae,stellate-pubescent,succulent,tal,tamen,tem,thick,throughout,time,transparent,unarme,unit,unknow,vary,vein,wide,x,ympodial	arrangement,articulation,bark,capitate,color,connation,corolla,dehiscence,diminishing,distal,distally,form,growth,height,history,interjected,leaf,leaflet,life,na,ovary,papillae,petiolule,plant,position,pseudostipule,seed,shape,size,spacing,stem,straightnes,terminal,texture,tuber-bearing
202	wfo-0001027234	success	206	110	82	124	28	0.398	-6,0-4,0.1-2,0.15,0.2-1.3,0.3-1,0.5-3,0.8-0.9,1-2,1-4,1.5-4,2-4,2/3-4/5,absent,acute,almost,anther,apart,apex,apparently,articulated,bark,base,berry,black,brown,calyx,cell,cm,concolorous,curved,dark,diameter,drying,entire,erect,flattened-reniform,fruit,fruiting,glabrous,gray,herb,lateral,leaf,length,lobed,long,maturity,mauve,membranous,mm,near,orbicular,outline,ovate,pedicel,peduncle,petiole,pit,poricidal,prickle,purple,raised,red,rounded,scandent,shrub,simple,sometimes,spherical,spreading,stellate,stem,style,surface,tapering,tip,trichome,tube,unarmed,way,wide	-0.15,-1.5,-2,-3,-3.5,.5,0-20,0.05-0.1,0.1,0.3-0.4,0.5-0.7,0.5-2,0.6-0.8,0.7-1.3,0.7-1.5,0.9-1.6,1,1.2-2,1.5-2.2,1.5-3.5,1.8-3,1/3,1/4-1/3,12-18,3-10,3-5,3-6.5,4-5-merous,8-15,8-16,abaxially,acuminat,alyx,apar,apically,attenuate,beyond,blac,blade,branched,broad-deltate,cordate,deltate,difoliate,dot,eaf,eed,elongating,equal,eye,filament,filiform,flower,free,geminat,glabrescent,glabrou,glan,gland,globular,green,herbaceous,infructescence,lobe,longer,lower,margin,mature,midpoint,moderately,multangulate,naked,narrowly,nflorescence,oblong,obtuse,older,one,open,orolla,oung,pair,pale,pendulous,per,perfec,pericarp,perpendicular,porrect,portion,prickly,primary,protruding,ray,reduced,reflexed,ruit,scar,scattered,sessile,shorter,slightly,smooth,spaced,sparsely,stalk,stalked,stellate-pubescent,straight,tamen,terete,tertiary,time,unarme,unit,vary,vein,venation,visible,white,winged,yellow,yellowish,ympodial	arrangement,articulation,color,connation,corolla,dehiscence,form,growth,height,history,inflorescence,interjected,leaflet,life,na,ovary,papillae,plant,position,pseudostipule,seed,shape,size,spacing,stigma,straightnes,terminal,texture
203	wfo-0001027235	success	189	114	81	108	33	0.429	0.5,1,1.5,10,12,14,18,2,3,35,4,6,8,?,abaxial,abaxially,accrescent,acicular,adaxial,anther,apart,apex,armed,articulated,base,black,brown,calyx,chartaceous,chocolate-brown,cm,cylindrical,deeply,diameter,difoliate,extra-axillary,flower,fruit,fruiting,glabrous,globose,green,herb,leaf,length,linear-lanceolate,lobed,longitudinal,mm,moderately,narrowly,nearly,obtuse,opening,pedicel,peduncle,petiole,pinnatifid,pinnatisect,prickle,pubescent,raised,reniform,ridge,rotate-stellate,rounded,slit,sparsely,stem,stigma,strongly,style,surface,tan,triangular,tube,turning,unbranched,white,yellow,×	.5,1.2,11,13,2.5,30,40,5,5-merous,9,absent,abundant,acute,adaxially,alternating,alyx,asymmetrical,axe,ba,berry,blade,burr-like,c.,completely,cordate,covering,creating,curved,densely,dimorphic,directed,distally,dry,drying,eaf,eed,enantiostylou,filament,four,geminate,glabrou,gland-tipped,hair,interpetalar,introrsely,invested,irregularly,larger,left-handed,like,lobe,lon,long,lower,lowermost,margin,maturity,midpoint,midrib,midvein,multicellular,multiseriate,nflorescence,occasional,occasionally,often,one,opposite,orolla,pair,per,pinnate,pore,prickly,rachi,ray,right,ruit,secondary,shallowly,side,simple,slightly,spaced,stalk,ste,stellate,straight,tamen,tapering,tearing,tem,tightly,tissue,undulate,unequa,unicellular,uniseriate,unit,upper,upward,usually,vary,vein,venation,wid,ympodial,zygomorphic	armament,arrangement,articulation,bark,color,connation,corolla,dehiscence,diminishing,distal,form,growth,height,history,inflorescence,lateral,leaflet,life,na,ovary,papillae,petiolule,plant,position,seed,shape,size,spacing,straightnes,terminal,texture,tuber-bearing,wide
204	wfo-0001027236	success	199	120	88	111	32	0.442	-4.5,-5,1-2.5,1-3,10,10-20,2-3,2-5,2-6,3-4,4-5,5-6,acute,anther,anthesi,apex,articulated,asymmetric,bark,basal,base,becoming,berry,blue,branched,brown,calyx,chartaceous,clavate-truncate,closely,cm,cordate,corolla,diameter,distal,flattened,flower,foveolate,fruit,fruiting,glabrescent,globose,green,growth,internodal,lanceolate,lateral,length,light,lobed,long-styled,minutely,mm,ochraceous,ovary,ovate-cordate,pedicel,peduncle,petiole,plant,poricidal,prickle,reniform,reticulate,ripe,rounded,runcinate,short-styled,shrub,simple,stellate,stellate-pilose,stem,stigma,style,subcoriaceous,suborbicular,subsagittate,surface,tapering,tip,tube,unevenly,violet,woody,x,yellow-orange,¼	-82,/6,0.2-0.3,0.6-0.7,1,1-1.5,1-2,1.2-1.5,1.5-2,2-,2-2.5,2.5-,3-3.5,3-8,30-50,5-,5-8,5-9,7-14,8-10,abaxially,adaxially,armed,brow,caly,compressed,dark,densely,discolorous,eaf,eed,eglandular,erect,exserted,filament,free,fused,glabrous,gland-tipped,glandular,glandular-hirsute,heterostylous,lengthening,like,lobe,lobed-angulate,long,lower,margin,middle,midpoint,minute,mixed,multangulate,nearly,new,nflorescence,obverse,older,ovate-turbinate,papillo,partially,per,perfect,pericarp,plurifoliat,pore,porrect,portion,prickly,pubescence,pubescent,raise,ray,recurved,reflexe,ruit,rusty,scandent,scar,sessile,slightly,slit,smooth,somewhat,space,sparsely,stalked,staminate,stellate-glandular,striped,subglobose,tall,terete,testa,tiny,trichome,ud,unarmed,unit,upper,velutinous,villous,villous-glandular,viscid,viscid-tomentose,woolly,yellow,ympodial,young,½	2-5-8,2.5-5-9,5-7-14,arrangement,articulation,color,connation,dehiscence,diminishing,form,height,history,inflorescence,interjected,leaf,leaflet,life,na,papillae,papillose,petiolule,position,pseudostipule,seed,shape,size,spaced,spacing,straightnes,terminal,texture,tuber-bearing
205	wfo-0001027237	success	122	78	58	64	20	0.475	.5,/4,1-1.2,1.5-2,3-3.5,6-11,6-8,8,anther,apart,bark,base,black,branched,brown,calyx,clavate,cm,corolla,cup-shaped,dark,drying,flattened,glabrous,globose,green,greenish-white,inflorescence,internodal,leaf,lobed,many,margin,minutely,mm,paler,papillose,pedicel,pitted,poricidal,regularly,reniform,shaped,shining,shrub,small,stem,stigma,straight,style,surface,tall,tear-drop,time,tip,tree,way,white	0.5-1,1.5-2.5,2-3,3-4,30-100-flowered,5,anthesi,apiculae,apiculate,appearing,ba,berry,blac,branc,broadly,completely,cucullate,deflexed,deltoid,dia,difoliate,edicel,eed,ellipsoid,erect,exsertion,filament,free,fruiting,geminate,greyi,later,lobe,long,lower,nflorescence,occasionally,older,ovary,papillate,papillo,part,plurifoliat,pore,portion,reflexed,regulary,ruit,scar,slender,spaced,tapering,terminal,tube,ud,unit,upper,usually,widely,woody,x,x.,ympodial,young	arrangement,color,dehiscence,diameter,form,fruit,greyish,growth,height,history,length,life,na,perennial,plant,seed,shape,spacing,straightnes,texture
206	wfo-0001027238	success	204	109	72	132	37	0.353	.3,0-1,0-1.5,0.3-0.8,0.3-1,0.5-1,0.5-2,1.5-4,1.5-7,3-5,3-6,4-16,5-15,accrescent,acuminate,acute,anther,apex,articulated,base,black,brown,calyx,chartaceous,cm,connivent,contiguous,cuneate,diameter,elliptic,elliptic-ovate,extra-axillary,fruit,fruiting,globose,lavender,leaf,light,longitudinal,membranaceous,minutely,mm,nearly,oblong,opening,outline,pale,pedicel,peduncle,petiole,pitted,purple,reniform,ripe,rounded,shiny,shrub,simple,slit,small,stellate,stem,stigma,straight,style,surface,tree,tube,unbranched,white,x,yellow	-25,-5,.5,0-0.7,0.3-0.5,0.3-5,0.5-16,1-1.5,1-2,1.5-3,10,15-30,2-3,2-4,3-4,4-,4-10,4-5,4-8,5-7,5-merou,6-15,6-8,abaxially,adaxiall,adaxially,ag,alyx,apparently,axe,ba,berry,blade,branch,capitat,covering,cylindrical,dark,deltate,densely,differentiated,directed,discolorous,distally,eaf,eed,entire,equal,filament,flattened,fleshy,flower,foliaceous,fork,free,frui,geminate,glabrescent,glabrous,gland,gland-tipped,green,greenish,growt,hair,homostylous,interpetalar,introrsely,juic,large,lighter,like,lobe,long,lower,major,margin,midpoint,minor,mixed,multangulate,narrowly,near,new,nflorescence,oblique,obtuse,often,one,orolla,paired,part,perfect,pericarp,plurifoliate,pore,porrect-stellate,pubescent,rachi,ray,ruit,scandent,sessile,short-stalked,side,similar,sometimes,somewhat,sparse,sparsely,sprawling,ste,stellate-pubescent,strongly,subtending,tamen,tem,time,tip,tissue,toward,triangular,unarme,unequal,unit,vary,vein,whitish,wide,without,yellowish,ympodial	age,arrangement,articulation,bark,capitate,color,connation,corolla,dehiscence,diminishing,distal,form,growth,height,history,inflorescence,interjected,lateral,leaflet,length,life,na,ovary,papillae,petiolule,plant,position,prickle,pseudostipule,seed,shape,size,spacing,straightnes,terminal,texture,tuber-bearing
207	wfo-0001027242	success	238	102	70	168	32	0.294	0-0.7,0-15,0-20,0.25-0.5,0.3-1.1,0.6-3,1.5,2-3,3-4.5,5.5-7,6-21,accrescent,acicular,anther,apex,articulated,base,calyx,chartaceous,cm,connivent,contiguous,diameter,extra-axillary,flattened,fruit,fruiting,globose,inflorescence,lateral,leaf,length,light,loosely,margin,minutely,mm,narrowly,nearly,orange,ovate,pale,pedicel,peduncle,perennial,petiole,pink,plant,prickle,pseudo-racemose,pseudo-umbellate,purple,red,reticulate,shrub,simple,slightly,smooth,stellate,stigma,straight,style,subcoriaceous,surface,toward,tube,white,whitish,x,yellow	%,.05,.2,0-1.5,0-5,0.15-0.25,0.2-0.7,0.2-1,0.3-0.5,0.5-1,0.6-0.9,0.7-1.2,1-1.2,1-1.5,1-2,1-2.5,1-locular,1.5-2,1.5-3,1.9-5,10-22,12-16,15-25,2,2-2.9,2.5-3,2.8-3.7,3-12,3-6,3-7,3.5-4.5,4-30,4-5.5,4-7,4.5-10.5,4.5-11,5-merou,6-14,6-7,6-8,7-8,8-15,9-11,abaxially,absen,absent,across,acute,adaxially,adult,alyx,andromonoecious,apart,apparen,axe,ba,blade,bract-like,branch,branche,capitat,confined,cuneate,cylindrical,deltate,densely,directed,distall,dm,eaf,eed,entire,erect,exocarp,filament,finger,flower,forked,geminate,glabrous,gland-tipped,green,hair,half,heterostylous,incomplete,index,interpetalar,juicy,juvenile,lamina,less,lobe,lobed,lobing,long,longer,lower,mature,mesocarp,mid-point,midpoint,midrib,midvein,minute,mixed,moderately,much,nflorescence,oblique,obtuse,occasionally,often,one,orolla,pair,part,per,perfect,placenta,plurifoliate,pore,porrect,present,rachi,ray,rhizomatous,rooting,rostrate,rounde,ruit,septum,sessile,shallowly,short,side,smaller,spaced,sparse,sparsely,sprawling,stellae,stellate-pubescent,strongly,succulent,tall,tamen,tapered,tem,thick,throughout,time,tip,tissu,tissue,triangular,unarme,unarmed,unbranched,unit,upper,usually,vary,vein,weakly,wide,yellowish,ympodial	arrangement,articulation,bark,capitate,color,connation,corolla,dehiscence,diminishing,distal,form,growth,height,history,interjected,leaflet,life,na,ovary,papillae,petiolule,position,pseudostipule,seed,shape,size,spacing,stem,straightnes,terminal,texture,tuber-bearing
208	wfo-0001027244	success	294	109	82	212	27	0.279	-12,-2,0.05-1,0.2-1,0.3-0.6,0.3-0.8,0.4-1,0.7-1.5,0.7-3,1,1.1-1.3,2.1-8,4-12,5-10,7-12,acuminate,acute,anther,apex,articulated,articulation,base,branched,broadly,brown,calyx,capitate,cm,corolla,curved,dark,deltate,densely,diameter,distal,elliptic,fruit,fruiting,globose,green,greenish,hair-like,half,herb,imparipinnate,inflorescence,interjected,interrupted,lanceolate,lateral,leaflet,length,middle,mm,narrowly,obovate,orbicular,outgrowth,ovary,pedicel,peduncle,perennial,petiole,petiolule,present,pseudostipule,pubescent,purple,rotate-stellate,rounded,simple,size,stem,stigma,stripe,style,surface,terminal,tube,vivid,white,yellow	-1.2,-3.2,.5,0-,0.02-,0.04-,0.05,0.07-0.15,0.1-,0.1-0.3,0.1-0.5,0.1-0.6,0.15-0.2,0.2,0.2-,0.25-0.4,0.3,0.3-0.4,0.3-0.5,0.4-,0.4-0.6,0.45-0.6,0.5,0.5-0.8,0.5-1,0.6-0.9,0.6-09,0.7-1,0.7-2,0.8-1.2,0.9-1.3,0.9-1.7,1-2-celled,1-2.5,1-3.5,1-celled,1.2-1.6,1.5-2,1.5-2.1,1.5-2.4,1.5-6.5,1.7-3.0,1/2,2-,2-4,2-4-celled,2-9,2-foliate,2-locular,3-5,3.5-13,3/4,4-celled,5-,5-9-celled,8-16,8-celled,abaxially,absent,abundance,abundant,acroscopically,adaxially,adpressed,alfway,along,also,always,amongst,angled,anthesi,apical,apparently,appearance,appendage,arequipa,around,articulatio,axi,basal,berr,berry,bifurcate,bract,bracteate,c.,cage,cell,column,common,conical,cordate,crenate,deciduous,decumbent,decurrent,deeper,dense,density,dentate,developed,diamete,eaf,edicel,eed,eglandular,either,elliptical,erect,exserted,extremely,filament,flower,flushed,forming,general,giving,glabrescent,glabrous,gland,glandular,gree,halfway,head,hyaline,internode,investing,irregularly,lamina,larger,largest,leave,like,lobe,lobed,lobing,lon,long,longer,lower,margin,midvein,minute,mixed,mixture,multicellular,near,node,oblique,occasionally,often,onto,pair,papillate-pubescent,patent,population,primary,rachi,reflexed,rest,ripe,ruit,scattered,secondary,sessile,shaggy,short,shorter,silky,sinus,slender,small,sometimes,somewhat,sparse,sparsely,sparser,spreading,staminal,sterile,stout,straight,strongly,tall,tem,tertiary,testa,thick,tiny,tip,tipped,toward,trichome,truncate,two,ud,undulate,unicellular,uniseriate,unit,united,upper,usually,variable,variety,vein,velvety,wall,wide,winged,woody,ympodial	0.4-3.5,arrangement,bark,circular,color,connation,dehiscence,diminishing,form,growth,height,history,leaf,life,mentioned,na,papillae,plant,position,prickle,seed,shape,spacing,straightnes,texture,tuber-bearing,ye
209	wfo-0001027248	success	158	98	68	90	30	0.43	0.5-1,0.5-2.5,0.7-1.2,1-2,1-5,6.5-8,abaxially,acute,adaxially,anther,arachnoid,area,bark,base,broadened,broadly,brown,calyx,closely,cm,conical,corolla,dark,difoliate,dirty,elliptic,fruit,fruiting,geminate,glabrous,globose,green,lateral,leaf,lobed,merely,minutely,mm,nearly,occasionally,opposite,ovary,ovoid-reniform,pale,patch,pedicel,petiole,pitted,poricidal,pubescence,scattered,shaped,shrub,simple,size,small,spaced,stem,stigma,style,surface,tear-drop,tip,top,tree,tube,unifoliate,white	.5,0,1-1.5,1-3,2-2.5,2-4.5,3-4,3-7,3-7-flowered,3.5-4,4-8,5-5.5,6-13,7-9,abaxial,along,anthesi,ape,apex,appearing,arachnoid-pubescen,arachnoid-pubescent,beige,beneath,berry,brownish,brownish-gra,deflexed,deltate,densely,denser,dia,differing,eaf,edicel,eed,ellipsoid,erect,exserted,felty,filament,fleshy,free,glabrescent,grayish-green,impressed,lamina,later,lightly,lobe,long,lower,main,major,margin,minor,nflorescence,node,older,overlappin,pair,papillo,papillose,per,planar,pore,portion,present,pubescent,ruit,scar,shoot,somewhat,soon,sparsely,specimen,strongly,tall,thick,trichome,tub,ud,unit,vein,wid,wide,winged,woody,ympodial,young	arrangement,articulation,brownish-gray,color,connation,dehiscence,diameter,form,growth,height,history,inflorescence,interjected,leaflet,length,life,na,overlapping,papillae,peduncle,plant,position,prickle,pseudostipule,seed,shape,spacing,straightnes,terminal,texture
210	wfo-0001027258	success	178	100	69	109	31	0.388	/4,0.6-2,0.9-1.3,3-4,4-5,5-10-flowered,6-8,abaxially,acuminate,acute,adaxially,age,anther,apex,attenuate,bark,base,calyx,capitate,cm,corolla,elliptic,flattened-reniform,fruit,fruiting,glabrous,globose,green,greenish-yellow,internodal,large,lateral,leaf,length,lengthening,lenticel,lobed,minutely,mm,occasionally,opposite,ovary,ovate,pale,papillose,pedicel,petiole,pitted,poricidal,pubescent,reddish,shrub,simple,size,slit,sparsely,stem,stigma,straight,strongly,style,surface,swollen,tip,treelet,tube,way,white,yellowish-tan	.25,.5,0.25-0.5,0.5-1,1-1.5,1-2.3,1-4,1.2-2,1.5-1.6,2-2.5,2.5-8,3-6,3.5-4,4.5-5,7-13,7-9,abruptly,along,anthesi,apar,apical,apiculae,axil,ba,beneath,berry,broadly,crystal,darker,decurrent,deflexed,deltate,dense,densely,deposit,dia,differing,difoliate,dissecting,drying,eaf,edicel,eed,ellipsoid,enlarge,entire,evenly,exserted,extending,fide,filament,fragrant,free,geminat,glabrou,incrassate,lamina,lobe,long,lower,main,major,margin,microscope,middle,minor,minute,nee,nflorescence,often,older,onto,pair,papillo,planar,pore,portion,projection,prominent,red-papillose,ruit,sand,scar,scattered,slender,slightly,small,spaced,speck,sweetly,tall,tiny,trichome,tub,tuft,ud,uniseriate,unit,urceolate,vein,visible,widening,widest,winged,woody,x,yellowish,ympodial,young	alternate,apart,arrangement,articulation,color,connation,dehiscence,diameter,diminishing,distal,enlarged,form,growth,height,inflorescence,interjected,leaflet,na,papillae,peduncle,petiolule,plant,position,prickle,seed,shape,spacing,straightnes,terminal,texture,tuber-bearing
211	wfo-0001027260	success	176	110	69	107	41	0.392	-17,0.5-3,0.5-6.5,1-2,1-7,1.5-13,10-25,2-18,3-10,3-11,4-6,6-20,acuminate,acute-,age,apart,apex,articulated,basal,base,branched,clavate,cm,connivent,cordate,darker,densely,diameter,ellipsoidal,elliptic,elliptic-ovate,fading,flattened,fruit,glabrous,globose,greenish,lavender,leaving,lobe,long,longitudinal,mm,ovate,pedicel,pedicellar,peduncle,petiole,pilose,pink,puberulent,pubescent,purple,remnant,shrub,simple,small,stellate,stigma,stripe,style,tree,truncate,tube,unbranched,white,yellow,yellow-green,yellowish	-2,-60,-7,0.25-1,0.5-1,0.75-1,0.8-2,1-,1-3,1-4,1-6,1.5-2,15-30,2-,2-10,2-2.5,2.5-14,2.5-3.5,3-,3-4.5,3-6,3.5-25,4-25,4-32,4-5-foliat,4.5-14,5-,5-25,5-40,5-merous,abaxially,absent,acute,adaxially,aggregate,also,alyx,ape,axe,berry,beyond,blade,cell,chartaceous,connective,cylindrical,diamete,directed,distally,eaf,eed,eglandular,entire,equal,exceeding,exserted,flower,glabrate,hair,lanceolate,lon,lower,margin,membranaceous,moderately,narrowly,nearly,nflorescence,nther,obtuse,often,orolla,perfec,perfect,pilo,pore,presen,puberulent-pubescen,puberulent-pubescent,pubescent-pilose,rachi,radiu,ruit,shorter,slightly,spaced,sparsely,stamen,stone,strongly,subcoriaceous,tal,tapered,tem,thecae,time,tomento,triangular,ud,unit,usually,vary,vein,wide,x,yellow-orang,ympodial	anther,arrangement,articulation,bark,calyx,color,connation,corolla,dehiscence,diminishing,distal,form,fruiting,growth,height,history,inflorescence,interjected,lateral,leaf,leaflet,length,life,na,ovary,papillae,petiolule,plant,position,prickle,pseudostipule,seed,shape,size,spacing,stem,straightnes,surface,terminal,texture,tuber-bearing
212	wfo-0001027265	success	159	101	59	100	42	0.371	0.2-0.4,0.5-1,1-3,1.2-1.3,2,2-3,2-4,accrescent,acute,anther,apart,apex,articulated,base,berry,broad,calyx,chartaceous,cm,connivent,diameter,erect,extra-axillary,flattened-reniform,fruit,fruiting,globose,herb,leaf-opposed,light,long-attenuate,low,minutely,mm,oblong,orange,ovate-lanceolate,partially,pedicel,peduncle,petiole,pitted,pore,purple,red,rotate-stellate,scarcely,seed,simple,somewhat,stigma,style,subcoriaceous,surface,tip,tube,white,x,yellow	-2.5,.2,.3,.5,0.1–2,0.5,0.5–0.6,1-1.3,1-2.5,1.2-2,1.2–1.4,1.5-2.5,1.5–1.8,1.5–2,1.5–4,2-,2/3,20-30,2–2.5,2–3,3-,3-lobed,30–50,4-5,4.5–8,4–6,4–7-branched,5-merou,58409,abaxially,adaxiall,adaxially,alyx,apparently,axe,ba,blade,capitat,ciliate,covering,croat,cylindrical,dehiscent,eaf,eed,entire,filament,flower,foliate,frui,geminat,glabrous,granule,hair,hermaphroditic,juic,larger,lobe,lon,long,longitudinall,lower,margin,mesocarp,near,nearly,nflorescence,node,numerous,obtuse,orolla,paired,present,prominent,puberulent,pubescent,rachi,rarely,recurved,ripe,rooting,ruit,sclerotic,slightly,sometimes,spaced,sparsely,tall,tamen,tem,time,triangular,unit,usually,vary,weak,white-puberulent,wide,winged,ympodial	0.1-2,2-2.5,30-50,4-7-branched,arrangement,articulation,bark,capitate,color,connation,corolla,dehiscence,diminishing,distal,form,growth,height,history,inflorescence,interjected,lateral,leaf,leaflet,length,life,longitudinally,na,ovary,papillae,petiolule,plant,position,prickle,pseudostipule,shape,size,spacing,stem,straightnes,terminal,texture,tuber-bearing
213	wfo-0001027265	success	156	100	57	99	43	0.365	0.2-0.4,0.5-1,1-3,1.2-1.3,2,2-3,2-4,accrescent,acute,anther,apex,articulated,base,broad,calyx,chartaceous,cm,connivent,diameter,erect,extra-axillary,flattened-reniform,fruit,fruiting,globose,herb,leaf-opposed,light,long-attenuate,low,minutely,mm,oblong,orange,ovate-lanceolate,partially,pedicel,peduncle,petiole,pitted,pore,purple,red,rotate-stellate,scarcely,seed,simple,somewhat,stigma,style,subcoriaceous,surface,tip,tube,white,x,yellow	-2.5,.2,.3,.5,0.1–2,0.5,0.5–0.6,1-1.3,1-2.5,1.2-2,1.2–1.4,1.5-2.5,1.5–1.8,1.5–2,1.5–4,2-,2/3,20-30,2–2.5,2–3,3-,3-lobed,30–50,4-5,4.5–8,4–6,4–7-branched,5-merou,58409,abaxially,adaxiall,adaxially,alyx,apart,apparently,axe,ba,blade,capitat,ciliate,covering,croat,cylindrical,dehiscent,eaf,eed,entire,filament,flower,foliate,frui,geminat,glabrous,granule,hair,hermaphroditic,juic,larger,lobe,lon,long,longitudinall,lower,margin,mesocarp,near,nearly,nflorescence,node,numerous,obtuse,orolla,paired,prominent,puberulent,pubescent,rachi,rarely,recurved,ripe,rooting,ruit,sclerotic,slightly,sometimes,spaced,sparsely,tall,tamen,tem,time,triangular,unit,vary,weak,white-puberulent,wide,winged,ympodial	0.1-2,0.3,2-2.5,30-50,4-7-branched,arrangement,articulation,bark,capitate,color,connation,corolla,dehiscence,diminishing,distal,form,growth,height,history,inflorescence,interjected,lateral,leaf,leaflet,length,life,longitudinally,na,ovary,papillae,petiolule,plant,position,prickle,pseudostipule,shape,size,spacing,stem,straightnes,terminal,texture,tuber-bearing
214	wfo-0001027276	success	219	87	62	157	25	0.283	-22,.5,10,6,80,absent,acute,along,alternate,anther,armed,bifid,black-green,broadly,brown,calyx,clonal,cm,conspicuously,corolla,cyme,dense,densely,diameter,drying,fine,fruit,globular,green,growth,indumentum,inflorescence,lanceolate,least,length,linear,minutely,mm,oblong-lanceolate,pedicel,petiole,plant,poricidal,prickle,purple,reticulate,rotate,scabrous,scattered,short,somewhat,stellate,stem,stigma,straight,style,subshrub,surface,suture,tapered,trichome,×	0,0.5,0.5–1,1,1.2–1.5,1.5,1.5–2,1–1.5,1–2,2,2–5,2–6,4–5,4–9,5,5-merous,5–10,5–12mm,5–7,7,9–12,acuman,acumen,ale,alyx,anthesi,apex,apparently,around,aspect,ba,base,becoming,beneath,berry,beyond,boht,borne,branche,c.,caly,central,cone,covered,dark,detaching,different,dioeciou,drop,eaf,eduncle,eed,ending,entire,erect,even,eventually,except,expanding,exserted,extending,falling,female,filament,filiform,flower,following,functionally,fused,glabrous,gra,gray-green,growt,hermaphrodite,inaperturate,including,ingle,largest,lighter,lobe,lobed,lon,long,loose,lower,margin,mostly,mout,near,new,newer,next,older,open,opening,orphologically,ovary,petal,plurifoliat,pollen,porrect-stellate,prickly,producing,proportion,ra,rarely,red-tinged,remaining,resprout,retained,rickle,ruit,ruiting,scarcely-rooted,seaso,shed,shor,side,slender,slightly,small,solitary,sparsely,splitting,stalked,staman,stamen,staminate,stellate-funnelform,stellate-pubescent,stigmatic,stolon,successively,surrounding,taminate,tapering,tem,tending,throughout,time,tip,toward,type,unarme,underground,unequal,unit,verall,vestigial,wavy,wide,widened,without,woody,yellow-green,ympodial,–	-,1-1.5,4-5,4-9,5-10,5-12mm,5-7,arrangement,color,dehiscence,form,fruiting,height,history,leaf,leaflet,life,na,peduncle,seed,shape,size,spacing,terminal,texture
215	wfo-0001027284	success	172	109	72	100	37	0.419	.3,0.1–0.5,0.2–,1–1.5,1–3,2.5–3.5,4,4–12,4–6,5–8,9–18,abaxially,accrescent,acuminate,adaxially,anther,anthesi,apex,base,branched,brownish,calyx,cm,cordate,diameter,elliptic,flattened-reniform,flower,fruit,fruiting,glabrous,globose,green,herbaceous,inflorescence,long,maturity,minutely,mm,nearly,oblique,orangish,ovate,ovoid,pale,pedicel,peduncle,petiole,planar,reticulate-rugulose,rounded,scandent,shortly,shrub,simple,size,sometimes,somewhat,stellate,stigma,style,surface,tan,thickly,truncate,tube,unbranched,vine,weakly,white,woody,x	0.1–2,0.7–0.9,0.7–1,1.2–1.5,1.5–2,1.5–2.5,1.5–5.5,1.5–8,1.8–2,1–2,2.5–3,2–16,2–2.2,3.5–14,3–4,5-merous,5–7,acute,alyx,axe,axillary,berry,blade,branch,c.,capitat,ciliat,climbing,conspicuous,contiguousl,cylindrical,deflected,deltoid,densely,distally,eaf,eed,enlarged,entire,extra-axillary,filament,fine,flattened,fleshy,glabrescen,glabrou,gradually,immature,leafy,lobe,lower,m.,margin,midvein,near,nflorescence,nternode,one,orolla,pair,pendulou,perfec,pink,pinnate,plurifoliate,pointed,prominent,pubescence,pubescent,rachi,rarely,reduced,ruit,sand-punctat,sand-punctate,scar,secondary,seen,side,slightly,soon,spaced,sparsely,spreading,stem-terminal,tamen,tem,thickened,time,tip,toward,tree,understory,unifoliat,unit,vary,vein,venation,wide,ympodial	arrangement,articulation,bark,capitate,color,connation,contiguously,corolla,dehiscence,diminishing,distal,form,growth,height,history,interjected,lateral,leaf,leaflet,length,life,na,ovary,papillae,petiolule,plant,position,prickle,pseudostipule,seed,shape,spacing,stem,straightnes,terminal,texture,tuber-bearing
216	wfo-0001027289	success	194	98	65	129	33	0.335	0.3-1,0.5-1.4,0.8-2.6,1.1-1.5,10.5-12.5,3.5-5,4-11,7-10,absent,accrescent,acute,adaxially,anther,apex,articulated,bark,base,black,broadly,brown,calyx,cm,connivent,cordate,densely,diameter,flower,fruit,fruiting,globose,green,grey,inflorescence,lanceolate,lateral,leaf-opposed,length,lobed,midpoint,mm,obtuse,ovate,pedicel,peduncle,perennial,petiole,pink,plant,present,prickle,pseudo-racemose,purple,shallowly,shrub,simple,solitary,stellate,stellate-pubescent,straight,style,thick,tube,unbranched,yellow,yellowish-green	%,.05,0-0.7,0-1,0-3,0.05-0.1,0.25-0.7,0.3-0.9,0.4-0.8,0.5-0.7,1,1-2,1-5,1.2-2.5,1.3-1.5,1.4-1.8,1.5-2,1.5-2.3,1.5-3.5,10-16,12-17,16-35,2-foliate,2.4-3,2.5-2.8,3.5-7.5,30-160,4-7,4-locular,5-merou,5.5-7.5,6-8,6-9,7-13,7-8,abaxially,absen,acicular,across,adaxiall,alyx,andromonoecious,apart,ascending,axe,ba,blade,chartaceous,circular,cork,cross-section,cylindrical,deltate,directed,distall,distally,distributed,dm,eaf,eed,eglandular,elliptica,entire,erect,exocarp,finger,functional,furrowed,geminate,glabrou,glabrous,gland-tipped,hair,half,heterostylous,juicy,lamina,less,lobe,long,longer,lower,margin,markedly,mature,mesocarp,mid-point,minute,moist,nflorescence,oblique,orolla,part,per,placenta,pore,porrect,probably,ray,rhizomatous,ruit,rusty,short,spaced,stage,stalk,stalked,stellae,strongly,tal,tamen,tem,thicker,thicknes,throughout,time,transparent,unarme,unarmed,unit,unknow,uvenile,vary,weakly,white,wide,x,yellowish,ympodial	arrangement,articulation,color,connation,corky,corolla,dehiscence,diminishing,distal,form,growth,height,history,interjected,leaf,leaflet,life,na,ovary,papillae,petiolule,position,seed,shape,size,spacing,stem,stigma,straightnes,surface,terminal,texture,tuber-bearing
217	wfo-0001027290	success	165	93	61	104	32	0.37	.8,0-2.5,0.3-0.5,0.9-1.2,1.1-4.4,1.5-1.8,1.5-2,1.6-1.8,2-11,3-35,4-6,8-9,acicular,adaxially,anther,articulated,base,broadly,calyx,cm,cylindrical,densely,extra-axillary,flower,fruit,fruiting,globose,green,grey-green,inflorescence,lateral,length,lobed,long,mid-point,mm,obtuse,ovate,pedicel,peduncle,perennial,petiole,present,prickle,pseudo-racemose,purple,rusty,shallowly,shrub,simple,stellate-pubescent,straight,style,thick,time,tube,unbranched,unknown,wide,yellow,yellowish-green	%,0-0.7,0-1,0-3,0.05-0.25,0.1-0.9,0.2-0.4,0.7-0.9,0.7-1.2,0.8-1.2,1-1.7,1-2,1-5,1.4-1.6,11-15,180-420,2-6,2.8-5.5,20-45,3-5,3-6,3.5-5,5-20,5-9.5,5-merou,50-70,6-8,7-8,8-10,abaxially,absent,across,adaxiall,alyx,apart,apex,armed,ascending,attenuate,axe,ba,blade,chartaceous,cordate,d.,diameter,directed,distall,distributed,eaf,eed,eglandular,entire,erect,finger,functional,glabrous,gland-tipped,hair,half,juic,lamina,lobe,lon,longer,lower,margin,mature,mesocarp,midpoint,midvein,minute,moist,nflorescence,oblique,onl,orolla,part,per,pore,porrect,presen,ray,rhizomatous,ruit,short,spaced,sparsely,stage,stalk,stellae,tal,tamen,tem,throughout,unit,unknow,uvenile,vary,vein,white,x,yellowish,ympodial	arrangement,articulation,bark,color,connation,corolla,diminishing,distal,form,growth,height,history,leaf,leaflet,life,na,ovary,papillae,plant,position,seed,shape,size,spacing,stem,stigma,straightnes,surface,terminal,texture,tuber-bearing,ye
218	wfo-0001027299	success	237	133	88	149	45	0.371	15,abaxially,accrescent,acicular,acuminate,anther,apart,apex,appearing,articulated,ascending,asymmetric,barely,base,becoming,branched,calyx,cm,common,cordate,coriaceous,diameter,directed,distally,elongating,exceeding,expanded,flower,fruit,fruiting,glabrous,globose,inflorescence,initially,intense,lanceolate,lateral,leaf,length,lenticular,linear,lobe,long,minutely,mm,obtuse,orange,ovate,overtopped,pedicel,peduncle,pentagonal,petiole,pitted,plump,pore,prickle,purplish,racemose,reaching,reniform,ripe,rotate,shrub,simple,slightly,soon,spreading,spreadingly,stellate-pubescent,stem,stigma,straight,style,sun,surface,tan,tapering,tardily,terminal,thick-textured,truncate,tube,unarmed,usually,violet,weakly,yellow	.5,0.2–3,0.3–0.8,0.5–1.5,0.8–1,0.8–1.2,0–10,1.2–1.5,1.3–1.7,1.5,1.5–3,1.5–4,11–17,15–19,1–2,1–3.5,1–4,2.5–4,2.5–5,2.7,25-30,2–13,2–2.7,3–3.5,4.5–13,4–10,5,5-merou,5.2,5–10,5–12,6,6–10,6–8,6–9,7–11,7–9,8–13,8–20,9–25,abaxial,adaxially,along,alyx,apiculate,apparently,axe,blade,branch,bristle,bristle-like,broadly,c.,campanulate,cauline,composed,conduplicate,contiguous,deciduou,delicate,deltate,deltoid,dense,densely,densest,developed,distall,eaf,eed,entire,equalling,erect,erry,falcate,filament,filiform,geminat,glabrou,hair,hirsute,intergrading,internode,intervening,interwoven,like,long-stalked,lower,margin,maturit,midpoint,midvein,midzone,mixed,narrowly,nearly,nflorescence,often,one,orolla,ovoid,perfect,plurifoliate,prickly,principal,pubescence,pubescent,rachise,rarely,ray,repand,secondary,short,short-stalked,shorter,side,similar,slender,smaller,sometimes,somewhat,some­what,spaced,sparse,stalk,stalked,stellae,stellate,stellate-tomentose,stipitate-stellate,styl,tall,tamen,tem,tippe,ud,ultimate,unarme,undulate,vary,varying,vein,well,wooll,woolly,ympodia,young,×,–7,–9	0-10,1-2,1.5-3,1.5-4,11-17,2-13,2.5-4,5-10,5-12,6-9,7-11,8-13,8-20,9,arrangement,articulation,bark,color,connation,corolla,deciduous,dehiscence,diminishing,distal,form,growth,height,history,interjected,leaflet,life,na,ovary,papillae,petiolule,plant,position,pseudostipule,seed,shape,size,spacing,straightnes,texture,tuber-bearing
219	wfo-0001027302	success	188	106	73	115	33	0.388	0.4-5,0.5-1,0.6-1,1-1.3,1-1.5,1-3,10,2,2-6,2.2,2.7-7.5,3/4,7,7/8,acuminate,acute,age,anther,apex,appearing,bark,base,bright,brownish-yellow,calyx,capitate,clavate,cm,cordate,corolla,diameter,flat-topped,flattened,fruiting,glabrous,globose,growth,later,lateral,leaf,length,lenticular,lobed,minutely,narrowly,ovary,ovate,pale,petiole,pitted,plant,plurifoliate,poridical,puberulent,pyramidal,red,reddish-brown,shrub,slit-like,small,somewhat,stem,stigma,style,surface,terminal,tip,tree,truncate,tube,violet,way,x	.5,0.5,0.8-1,1,1-2,1.2-1.6,1.2-2.5,1.5-2,10-20,2-3,3.5-5,5-7,6-12,abaxial,abaxially,adaxial,adaxially,along,anthesi,apical,ba,basal,becoming,berry,blade,branching,broader,conical,crispate,cultivation,decurrent,deflexed,deltoid,dendritic,densely,denser,dichasia,discussion,eaf,edicel,eed,elliptic,entire,especially,ew,exserted,filament,fine,flower,free,growing,inserted,juvenile,larger,lax,less,like,lobe,lon,long,long-triangular,lower,m.,main,margin,mm,monochasial,nflorescence,nodding,occasionally,older,otherwise,overtopping,pair,papillo,pedicle,per,pericarp,planar,pore,portion,prominent,pubescent,reflexed,ruit,scar,scattered,scrambling,secondary,see,shade,shin,shoot,simple,sleeve,sparsely,stamen,strongly,tall,tapering,thin,time,tiny,trichome,tub,ud,undulate,unit,usually,vein,wide,winged,woody,ympodial,young	arrangement,articulation,color,connation,dehiscence,diminishing,distal,form,fruit,height,history,inflorescence,interjected,leaflet,life,na,papillae,papillose,pedicel,peduncle,perennial,petiolule,position,prickle,pseudostipule,seed,shape,shiny,size,spacing,straightnes,texture,tuber-bearing
220	wfo-0001027310	success	215	109	77	138	32	0.358	0-20,0.7-2,1-1.2,1-1.7,1-6,1.5-5,2-10,20-60,4-10,4-9,5-7,8-10,acute,anther,apex,apparently,articulated,bark,base,calyx,cm,connivent,cuneate,curved,diameter,distal,erect,evenly,flattened-reniform,fruit,fruiting,gently,glabrescent,gray,green,hair,lanceolate,lateral,leaf,length,lobed,long,maturity,mauve,minutely,mm,orange-brown,pale,pedicel,peduncle,petiole,pitted,plant,poricidal,prickle,purple,rounded,shallowly,shrub,simple,sometimes,sparse,spherical,stellate-pubescent,stem,straight,style,surface,tapering,terminal,tip,tree,truncate,tube,wide,yellow,young	-2.2,-20,.8,/3,0,0-5,0.05,0.05-0.15,0.1,0.1-0.2,0.15-0.3,0.6-1,0.9-0.17,1.1-1.5,1.5-2.2,1/10-1/6,1/3-1/2,1/3-3/4,11-16,2-3.1,2-4,2-5,2.2-2.5,2.8-3,2/3,22-30,3-15,4.5-5.5,4.5-7,5-10,5-20,5-merous,6-8,7-10,9-13,abaxial,abaxially,acut,adaxial,alyx,andromonoecious,apar,apart,apically,berry,blade,branched,branching,broadly,chartaceous,dark,deltate,densely,discolorous,drying,eaf,eed,elongating,entire,equal,faint,filament,flattened,flower,foliaceous,free,fused,glabrou,glabrous,glaucous,green-brown,hermaphrodite,heterostylous,inflated,infructescence,less,lobe,long-styled,longer,lower,lowermost,margin,mature,midpoint,moderately,nflorescence,older,one,open,orolla,oung,pair,pendulous,per,pericarp,plurifoliat,porrect,porrect-lepidote,portion,prickly,primary,pubescent,ray,red,reddi,reflexed,ruit,scar,secondary,sessile,short-styled,shorter,smooth,spaced,sparsely,spreading,stalk,stalked,staminat,stellate,stout,strongly,tamen,terete,tertiary,time,toward,trichome,unarme,unarmed,unit,vary,vein,venation,visible,way,woody,ympodial	arrangement,articulation,color,connation,corolla,dehiscence,diminishing,elengthating,form,growth,height,history,inflorescence,interjected,leaflet,life,na,ovary,papillae,petiolule,plurifoliate,position,pseudostipule,reddish,seed,shape,size,spacing,stigma,straightnes,texture,tuber-bearing
221	wfo-0001027313	success	173	143	87	86	56	0.503	0.15,1.5,4,5,abaxially,acute,adaxially,anther,apex,apical,articulated,atenuate,attenuate,base,broadbased,cm,cordate,dbh,densely,diameter,directed,entire,finely,flower,fruit,globose,green,high,internode,irregularly,lanceolate,lateral,leaf,long,loosely,margin,midpoint,minute,minutely,mm,much,nearly,obtuse,ovate,pedicel,peduncle,persistently,petiole,pitted,pore,porrect,prickle,purplish,rarely,ray,sessile-stellate,short-stalked,short-stipitate,shorter,shrub,side,similar,simple,sinuate,slender,small,stellae,stellate,stellate-tomentose,stem,stigma,style,surface,thick-chartaceous,tomentose,tree,tube,unarmed,undulate,usually,vigorous,violet,whitish,whitish-tomentose,yellow,yellowish,×	.5,.7,0.1–0.3,0.5–0.6,0.8–1,1.2–1.3,1.2–1.4,1.5–2,1–1.3,1–2,1–4,2–3-branched,2–4.5,2–8.5,3–3.5,3–4,3–5.5,3–9,4.5–5,5-merou,5.5–16,5.5–7,50,5–6,6–11,6–8,adaxiall,along,alyx,apar,apparently,axe,blade,branch,branched,capitat,difoliate,distall,dull,eaf,eed,filament,filiform,geminat,glabrous,hair,half,homostylous,immature,interpetalar,like,little,lobe,lon,lower,maturing,midvein,narrowly,nflorescence,orolla,ovoid,perfect,principal,ruit,scar,sinus,sometimes,sparse,splitting,stalk,stellate-pubescent,stellate-tomento,tamen,tem,time,tissue,triangular,ud,unarme,vary,vein,weak,wide,ympodia,–12,–3	-12,0.1-0.3,0.5-0.6,0.8-1,1-1.3,1-4,1.2-1.3,1.5-2,2-3-branched,2-8.5,3-4,3-5.5,3-9,5-6,5.5-16,5.5-7,6-11,apart,arrangement,articulation,bark,calyx,capitate,color,connation,corolla,dehiscence,diminishing,distal,distally,feature,form,fruiting,growth,height,history,inflorescence,leaflet,length,life,na,ovary,papillae,plant,position,present,pseudostipule,seed,shape,size,spacing,straightnes,terminal,texture,tuber-bearing,ye
222	wfo-0001027315	success	217	112	79	138	33	0.364	.5,0.15-0.2,0.2,0.2-0.5,0.3-0.6,0.3-1,0.4-0.7,0.6-0.6,0.6-0.7,2,<,acute,anther,apex,armed,articulated,bark,base,berry,blue-green,brown,calyx,capitate,cm,conical,corolla,diameter,dioecious,elliptic,filament,flattened,free,fruiting,glabrous,globose,greyish-white,growth,inflorescence,internodal,length,margin,midpoint,midrib,minutely,mm,oblique,ovary,pale,paler,pedicel,peduncle,pentagonal,petiole,pitted,plant,poricidal,portion,prickle,purple,ray,reddish,reniform,ripe,shiny,shorter,shrub,simple,somewhat,stellate,stem,stigma,straight,style,surface,tip,tube,unarmed,white,young	.15,.5x,.9,0.25-0.4,0.3-0.5,0.5,0.6-0.8,0365,1-1.3,1-1.5,1-2,1.3-3,1.5-1.7,1.5-2,1.5-3,10-20,2-2.5,2-5,2-7.5,2/3,3,3-3.5,3-5,3-7,5-7,8,?,abaxially,adaxially,age,almost,along,anthesi,arching,broad-based,consisting,correlated,dark,deltate,dense,densely,difoliate,discolorous,drying,eaf,echinoid,eed,ekman,ellipsoid,entire,especially,exerted,female,fide,filiform,flower,fused,geminat,glabrescen,globular,half,hangin,highly,immature,impressed,lamina,lengthening,lepidote,like,lobe,lobed,long,lower,male,marginal,markedly,minute,mixture,new,nflorescence,obscuring,occasionally,often,older,overlappin,packed,pair,papillo,per,pericarp,pistillate,plan,planar,pore,porrect,present,pricklines,primary,prominent,pubescent,rest,rhachi,rounded,ruit,scar,scattered,sessile,shoot,short,short-stalked,similar,slit,smaller,solitary,sparse,sparsely,stalked,staminate,stellate-lepidote,strongly,thin,throughout,tightly,trichome,ud,unisexual,unit,vein,venation,vestigial,visible,way,without,woody,x,yellowish,ympodial,½	1,arrangement,articulation,color,connation,dehiscence,diminishing,distal,form,fruit,glabrescent,height,history,interjected,lateral,leaf,leaflet,life,na,papillae,papillose,petiolule,position,pseudostipule,reproduction,seed,shape,size,spacing,straightnes,terminal,texture,tuber-bearing
223	wfo-0001027317	success	144	89	55	89	34	0.382	0.4-1.5,0.5-1,1,1-2,1.4-1.6,4.5-5,?,acuminate,acute,anther,apex,bark,base,bilobed,broadly,calyx,closely,cm,conical,corolla,deflexed,elliptic,fruit,fruiting,glabrous,globose,golden,green,lateral,leaf,lobed,minutely,mm,offset,opposite,ovary,pale,papillose,pedicel,petiole,poricidal,shaped,shrub,simple,size,slightly,spaced,stem,stigma,style,surface,tear-drop,tip,tube,white	.25,.5,0.1-0.2,0.3-1,0.5-3,0.8-3.5,1-1.5,1-5,1.5-2,2-3-flowered,2-9,3-3.5,7-9,abaxial,adaxially,along,anthesi,apical,apically,arch,ba,beneath,berry,cucullate,deciduous,deltoid,densely,dia,differing,difoliate,drying,eaf,edicel,eed,ellipsoid,elongated,erect,expanded,filament,filiform,free,geminat,greyish-whit,immature,inflorescenc,joined,known,like,lobe,lon,long,long-exserted,lower,main,major,margin,mature,minor,minute,nearly,nflorescence,older,overlappin,pair,papillo,pointed,pore,portion,projection,prominent,pubescent,reflexed,rest,ruit,scar,series,soon,sparsely,strongly,tall,trichome,tub,ud,uniseriate,vein,woody,x,ympodia,young	alternate,arrangement,articulation,color,connation,dehiscence,diameter,diminishing,distal,form,greyish-white,growth,height,history,inflorescence,interjected,leaflet,length,life,na,papillae,peduncle,petiolule,plant,position,prickle,pseudostipule,seed,shape,spacing,straightnes,terminal,texture,tuber-bearing
224	wfo-0001027323	success	175	97	64	111	33	0.366	/3,1.2-1.5,2-6,2.5-3,5-7,acute,along,anther,apex,area,asymmetric,attenuate,bark,base,berry,broadened,calyx,closely,cm,corolla,densely,elliptic,fleshy,flower,fruit,fruiting,glabrous,globose,grey,growing,lateral,leaf,lobed,minutely,mm,opposite,ovary,overlapping,ovoid-reniform,papillae,papillose,pedicel,petiole,pinkish-grey,pitted,plant,poricidal,reddish-grey,size,slightly,spaced,stem,stigma,straight,style,surface,tan,tiny,tip,treelet,tube,vein,way,white	.75,0.5-1,1-1.5,1-2,10-15,14-21,2-3,20-45,3-5,5-20-flowered,6-11,7-9,adaxial,anthesi,apparent,appearing,arising,ba,bud,campanulate,character,closed,cork,decurrent,deflexed,dia,differing,difoliate,dried,dry,eaf,edicel,eed,elongate,entire,erect,erose,exserted,filament,five-pointed,flopping,free,furcate,geminat,glabrate,held,higher,hood,hooded,immature,interpetalar,like,live,lobe,lon,long,long-triangular-deltoid,lower,main,major,margin,matte,mature,measured,middle,minor,nflorescence,occasionally,older,one,onto,ovoid,pair,papillo,partially,persistent,planar,pore,portion,prominent,proximal,rather,red-papillose,rest,ridge,ruit,scar,secondary,seen,shaped,sinus,small,smoot,soon,specimen,tall,tear-drop,thickened,thin,trunk,two,ud,unit,upper,visible,widest,winged,woody,x,ympodial,young	arrangement,articulation,color,connation,dehiscence,diameter,diminishing,distal,form,geminate,growth,height,history,inflorescence,interjected,leaflet,length,life,na,peduncle,perennial,petiolule,position,prickle,pseudostipule,seed,shape,smooth,spacing,straightnes,terminal,texture,tuber-bearing
225	wfo-0001027340	success	189	143	111	78	32	0.587	0.5-0.9,1-10,1-2,1.5-2.7,10-16,16-22,2-4,2.5-4.5,2.7-4.5,4-6,5-11,6-8.5,7-8,8-9.5,abaxially,absent,acuminate,adaxially,anther,apex,articulated,articulation,auriculate,axillary,base,brownish,bud,cell,chartaceous,cm,condition,connivent,cordate,corolla,covering,decreasing,developing,diameter,distal,distinct,drying,elliptic,forked,fresh,fruit,generally,glabrous,globose,green,green-white,greenish,hair-like,half,herb,high,indistinct,interjected,lanceolate,lateral,leaflet,lengthening,lilac-purple,make,membranous,minute,mm,mucilaginous,odd-pinnate,ovate,ovoid,papillose,pedicel,peduncle,petiole,petiolulate,plant,pore,poricidal,pubescent,purple,ripe,rotate,rounded,seed,semi-rosette,sessile,short,shortly,size,slightly,slit,sparsely,stem,stigma,straight,style,subtending,terminal,testal,thick,throughout,tinged,tip,truncate,tube,wall,wet,whitish,x,yellow,young	1-3,2-3,2-3.5,3-4,3.5-5,3.5-9,4-7.5,5-6,5-merou,7-18,8-14,abruptly,acumen,ag,along,alyx,apart,apparently,axe,berry,blade,capitat,ciliate,dark,digestion,dorsally,eaf,edge,eed,enzyme,especially,exceeding,filament,flat,flower,folded,geminat,glabrou,hair,hal,homostylous,honeycomb-shaped,like,living,lobe,long,lower,margin,midrib,minutely,narrow,narrowed,nflorescence,orolla,pair,perfect,plurifoliate,pointed,puberulent,purpl,removed,ruit,semi-erec,seudostipule,spaced,specimen,splotched,stamen,ste,tall,tamen,tem,tri-,unit,usually,vary,wing,ympodial	age,arrangement,bark,calyx,capitate,color,connation,dehiscence,diminishing,form,fruiting,growth,height,history,inflorescence,leaf,length,life,na,ovary,papillae,position,prickle,pseudostipule,semi-erect,shape,spacing,straightnes,surface,texture,tuber-bearing,ye
226	wfo-0001027354	success	166	106	76	90	30	0.458	.5,0.5-2,0.7-1.3,1-1.5,1-7,1.5-2,3.4-4,3/4,4-10,5-7,acute,age,anther,apex,appearing,bark,base,becoming,bi-lobed,branch,calyx,cm,conical,corolla,dark,diameter,elliptic,flattened,fork,fruit,fruiting,globose,golden,growth,inserted,later,lateral,leaf,length,lenticular,lobed,long,minutely,mm,narrowly,occasionally,ovary,pedicel,petiole,pitted,plurifoliate,pore,poricidal,pubescent,purplish-black,pyramidal,reddish-brown,shrub,sleeve,slit-like,small,sparsely,stem,stigma,style,surface,terminal,tip,tree,tree-like,trichome,tube,violet,way,white,wide	0,0.5,1,1-1.2,1.5-1.8,1.7-5,10,10-20,2.5-3.5,3-4,6.5-13,8-12,abaxial,abaxially,absent,adaxial,along,anthesi,apical,ba,basal,belo,berry,blade,branching,covered,deltoid,dendritic,densely,denser,dichasia,drying,eaf,edicel,eed,entire,erect,ew,exserted,filament,flower,free,glabrate,glabrous,less,like,lobe,loose,loosely,lower,m.,monochasial,mostly,near,nflorescence,nodding,older,pair,papillo,per,pericarp,planar,portion,pubescen,raised,ruit,scar,secondary,side,simple,slightly,somewhat,stamen,strongly,tall,tapering,thecalyx,thin,time,tiny,tub,type,ud,unit,vein,winged,woody,x,ympodial,young	arrangement,articulation,color,connation,dehiscence,diminishing,distal,form,height,history,inflorescence,interjected,leaflet,life,na,papillae,papillose,peduncle,petiolule,plant,position,prickle,pseudostipule,seed,shape,size,spacing,straightnes,texture,tuber-bearing
227	wfo-0001027359	success	224	111	79	145	32	0.353	-3,0,0-3,0-5,0-9,0.3-1.2,0.5-2,1-1.2,1-5,2-4,2.5-3.5,6-8,acute,anther,apex,articulated,bark,base,berry,bright,calyx,cell,chartaceous,cm,cream,dark,diameter,dull,entire,erect,flattened-reniform,fruit,fruiting,glabrescent,gray,green,lateral,leaf,length,lobed,marking,maturity,membranous,minutely,mm,moderately,orange-brown,outline,ovate,pale,pedicel,peduncle,petiole,pit,poricidal,prickle,purple,raised,red,reflexed,reticulate,scandent,shrub,small,smooth,sometimes,spherical,spreading,stellate-pubescent,stem,style,surface,tapering,terminal,tip,tube,white,yellow,young	-0.25,-2,-20,-4,-7,-9,.1,.2,.5,/3,/4,0-2,0.1,0.1-0.2,0.1-1.5,0.3-0.5,0.5,0.5-1,0.6-0.8,0.6-1,1-2,1-3,1-4,1.2-1.5,1.2-2,1.5-2,1.5-2.5,1.8-3.2,1/5-1/4,2-10,2-3,2.5-5.5,3-10,4-,4-5,5-,5-6.5,5-merous,7-8,abaxially,acut,alyx,apar,apart,apically,apparently,ba,blade,branched,brow,concolorous,coroll,cuneate,curved,deltate,densely,difoliate,distinctive,drying,eaf,eed,elongate,elongating,equal,eye,filament,filiform,flattened,flower,free,geminat,glabrous,herbaceous,infructescence,less,like,lobe,long,longer,lower,margin,mature,midpoint,naked,narrow-deltate,narrow-ovate,near,nflorescence,obtuse,occasional,often,older,one,open,orolla,oung,ovoid,pair,per,perfec,pericarp,porrect,portion,prickly,primary,rachi,rarely,ray,ruit,scar,sessile,shallowly,shorter,simple,slender,slightly,spaced,sparsely,stalk,stalked,stellate,stump,tamen,terete,tertiary,time,tinge,trichome,ud,unarme,unarmed,undulate,unit,usually,variously,vary,vein,venation,visible,way,weakly,wide,woody,yellow-brown,ympodial	arrangement,articulation,brown,color,connation,corolla,dehiscence,diminishing,distal,form,growth,height,history,inflorescence,interjected,leaflet,life,na,ovary,papillae,petiolule,plant,position,pseudostipule,seed,shape,size,spacing,stigma,straightnes,texture,tuber-bearing
228	wfo-0001027365	success	233	112	69	164	43	0.296	.5,0,anther,apart,apex,apparently,articulated,bark,base,becoming,blue,branched,broad-based,brown,calyx,capitate,chartaceous,cm,connivent,dark,diameter,elliptic,extraaxillary,fruit,fruiting,globose,green,inflated,inflorescence,juicy,knobby,lanceolate,leaf,length,light,longitudinal,maturity,mm,opening,orange,outline,pedicel,peduncle,petiole,plant,prickle,reniform,rotate-stellate,rugose,sharp,simple,slightly,slit,stellate,stem,stigma,stout,straight,style,subcoriaceous,surface,tan,tapered,tree,tube,unbranched,violet,yellow,×	.1,.1–0.3,.2,0.1–0.3,0.2–0.5,0–0.03,0–0.1,1,1.1–1.4,1.5–1.8,10–15,11–14,14–15,15–30,1–1.9,1–4,2,2.2–2.3,2.3–4.2,2.5–4.5,2.6–3,2.8,2–,2–5,3,3–10,3–3.5,3–3.9,4.5–5,4–4.5,4–5,5-merous,5–5.5,5–8,6–7.5,7–1,7–15,8–15,8–9,abaxial,abaxially,absent,acuminate,acute,adaxial,adaxially,ag,along,alyx,andromonoeciou,andromonoecious,anthesi,axe,ba,berry,bilobe,blade,broadly,central,column,congested,cuneate,curved,cylindrical,db,densely,difoliate,directed,discolorous,distally,dried,eaf,eed,eglandular,either,emergent,entire,equal,filament,flattened,flower,flowering,free,fresh,frui,functionally,geminat,glabrous,glandular,golden-tan,hair,half,hermaphroditic,heterstylous,included,interpetalar,lighter,like,lobe,lobed,long,lower,major,margin,membranaceous,midpoint,midvein,moderate,moderately,mostly,mpodial,multangulate,multangulate-stellate,multiseriate,multiseriate-stalked,nearly,nflorescence,oblique,obtuse,often,one,orolla,part,pericarp,pore,porrect-stellate,portion,pronounced,pubescent,rachi,ray,reduced-stellate,reflexed,repand,ruit,runk,sessile,shallowly,shiny,short-stalked,side,somewhat,spaced,sparsely,stalk,stalked,staminate,stellate-pubescent,strongly,subtending,tamen,thi,time,tissue,truncate,unarmed,unit,vary,vein,wide,within,young,–2,–20	0.2-0.5,1-4,10-15,14-15,2-5,2.5-4.5,20,3-10,4-5,6-7.5,age,arrangement,articulation,bilobed,color,connation,corolla,dbh,dehiscence,diminishing,distal,form,growth,height,history,interjected,lateral,leaflet,life,na,ovary,papillae,petiolule,position,pseudostipule,seed,shape,size,spacing,straightnes,terminal,texture,tuber-bearing
229	wfo-0001027366	success	136	107	71	65	36	0.522	/4,1-1.5,1-2,1-3,11-21,3-10-flowered,3-9,4-5,5-7,6-19,abaxially,acute,adaxially,anther,apex,bark,base,bright,broadly,brown,calyx,capitate,closely,cm,conical,corolla,dark,drying,elliptic,fruiting,glabrous,globose,golden,green,greenish-white,internodal,lateral,leaf,lobed,long,main,minutely,mm,opposite,orbicular,ovary,ovoid-reniform,packed,pair,pale,papillose,pedicel,petiole,pitted,poridical,rounded,shining,shrub,simple,sometimes,somewhat,stem,stigma,straight,style,surface,tip,tube,vein,way,wide	.5,/2,0.25-0.5,0.5-1,0.7-1,1.5-2,2-2.5,4-4.5,603,anthesi,ape,axe,ba,berry,conspicuously,deflexed,deltate,dia,eaf,edicel,eed,erect,et,except,exserted,fide,filament,free,lamina,less,lobe,lon,long-triangular,lower,margin,middle,nflorescence,older,overlappin,ovoid,papillo,parallel,planar,pointed,pore,portion,ramo,reddish,ruit,scar,secondary,shaped,tall,tear-drop,trichome,tub,ud,unifoliat,unit,venation,widest,woody,yellowish-gre,ympodial,young	arrangement,articulation,color,connation,dehiscence,diameter,diminishing,distal,form,fruit,growth,height,history,inflorescence,interjected,leaflet,length,life,na,overlapping,papillae,peduncle,petiolule,plant,position,prickle,seed,shape,size,spacing,straightnes,terminal,texture,tuber-bearing,unifoliate,yellowish-grey
230	wfo-0001027368	success	145	105	65	80	40	0.448	-15,-20,-5,.5,0.3-2.5,0.5-3.5,0.5-5,1-2,2-3,2-9,5-15,5-6,acuminate,acute,apart,apex,articulated,base,calyx,chartaceous,cm,color,connivent,cuneate,decurrent,diameter,ellipsiodal,elliptic,elliptic-ovate,forked,glabrous,globose,lanceolate,lenticular,lobe,margin,mm,narrowly,nearly,oblong,occasionally,otherwise,ovoid-fusiform,pedicel,peduncle,petiole,puberulent,purple,shrub,simple,small,stellate,stigma,style,subcoriaceous,subhastate,terminal,truncate,tube,unbranched,unknown,usually,white,x,yellow	-10,-2,0.8-2,1-15-flower,1-6,1.5-2,1.5-2.5,2,2-2.5,2-4,3,3-12.5,4-6,4-many-foliat,5-10,8-13,abaxially,abruptly,absen,adaxiall,adaxially,aggregate,also,axe,ba,blade,branched,cell,contiguous,cylindrical,darker,deltate,dendritically,densely,denser,directed,distally,eaf,eed,entire,except,gland,hair,lighter,long,long-stalked,lower,midvein,moderately,narrowed,nflorescence,nther,obtuse,often,orolla,pore,pubescen,pubescent,rachi,radiu,ray,ruit,sometimes,spaced,sparsely,stalked,star,stone,subcapitat,tal,tem,three,time,tip,triangular,unit,vary,vein,wide,ympodial	anther,arrangement,articulation,bark,connation,corolla,dehiscence,diminishing,distal,form,fruit,fruiting,growth,height,history,inflorescence,interjected,lateral,leaf,leaflet,length,life,na,ovary,papillae,petiolule,plant,position,prickle,pseudostipule,seed,shape,size,spacing,stem,straightnes,subcapitate,surface,texture,tuber-bearing
231	wfo-0001027369	success	191	91	59	132	32	0.309	.5,0-1,0.6-0.8,1-2.5,1.5-2,2-5,3-4,anther,apart,apex,articulated,bark,base,berry,branched,calyx,cm,color,concolorous,cordate,diameter,drying,elongating,fruit,fruiting,glabrous,glaucous,green,known,lateral,leaf,length,lobed,long,mauve,membranous,mm,orbicular,pedicel,peduncle,petiole,poricidal,prickle,reniform,rounded,scandent,shrub,simple,sparsely,spherical,spreading,stellate-pubescent,stem,style,surface,tapering,terminal,tip,tube	-1,-10,-11,-2,.1,.4,.7,/4,0,0-15,0-3,0-5,0-6,0.05-0.15,0.1,0.1-0.2,0.1-0.3,0.2-0.5,0.25-0.4,0.3-1.5,0.5,0.5-0.8,0.5-1.5,1-,1-2,1-3,1-4,1.2-2.5,1.2-3,1/3,2-3,2-4,3,3-10,4-5,4-8,5,5-merous,7-15,abaxially,acut,almost,alyx,ame,apar,apically,apparently,blade,broad-deltate,c.,curved,deltate,densely,difoliate,distance,eaf,eed,equal,erect,extending,eye,filament,filiform,flower,free,geminat,glabrou,gra,hair,herbaceous,infructescence,know,lanceolate,less,lobe,lon,lower,margin,mature,midpoint,midvein,moderately,multangulate,naked,narrowly,nflorescence,older,one,open,orolla,oung,pale,pendulous,per,perfec,pericarp,perpendicular,porrect,portion,prickl,prickly,ray,reflexed,ruit,scar,sessile,side,slender,slightly,smooth,spaced,stalk,stalked,stellate,straight,strongly,tamen,terete,time,trichome,unarmed,unequal,unit,vary,venation,visible,way,wide,wider,winged,yellow,ympodial	arrangement,articulation,connation,corolla,dehiscence,diminishing,distal,form,gray,growth,height,history,inflorescence,interjected,leaflet,life,na,ovary,papillae,petiolule,plant,position,present,pseudostipule,seed,shape,size,spacing,stigma,straightnes,texture,tuber-bearing
232	wfo-0001027378	success	149	100	50	99	50	0.336	.2,5-8,acuminate,anther,apex,base,blue,broadly,calyx,chartaceous,cm,color,cordate,deeply,diameter,extra-axillary,filament,fleshy,fruit,fruiting,herbaceous,leaf,light,mm,ovate,ovoid,palmate,pedicel,peduncle,pentagonal,petiole,primary,rotate-stellate,simple,slender,somewhat,sparsely,stem,stigma,style,terrestrial,trichome,tube,unbranched,unknown,vein,venation,vine,white,x	0.5–1,0.7–1,0.8–2.5,1.2–1.5,1.2–1.8,1.5–1.8,1.5–8,15–35,1–1.5,1–3,2.3–5,2.5–7,2–11,2–2.2,2–2.5,3–4.5,3–5,3–6,4–6,4–9,5-merous,5–10,5–13,5–7,6–10,6–7,abaxially,acute,adaxial,adaxially,alyx,apar,apicall,axe,berry,blade,c.,capitat,ciliate,clavate,climbin,cylindrical,deltoid,densely,eaf,eed,flattened,flower,glabrou,glabrous,hair,hair-tipped,half,lanceolate,like,lobe,lon,long,longer,lower,m.,margin,markedly,membranous,minutely,moderately,narrowly,nflorescence,nternode,obscure,often,orolla,papillose,perfec,plurifoliat,pointed,pubescent,rachi,revolute,rounded,ruit,sand-punctat,sand-punctate,scattered,short,side,slightly,small,spaced,tamen,tem,tip,tooth,unit,unknow,vary,wide,widely,ympodial	0.5-1,0.7-1,15-35,2-11,2-2.2,2.5-7,3-4.5,4-6,4-9,5-13,5-7,arrangement,articulation,bark,capitate,climbing,connation,corolla,dehiscence,diminishing,distal,form,growth,height,history,inflorescence,interjected,lateral,leaflet,length,life,na,number,ovary,papillae,petiolule,plant,position,prickle,pseudostipule,sand-punctation,seed,shape,size,spacing,straightnes,surface,terminal,texture,tuber-bearing
233	wfo-0001027378	success	141	105	66	75	39	0.468	.2,15-35,2-11,2-4,2.5-7,3-4.5,4-6,4-9,5-13,5-8,abaxially,acuminate,adaxially,anther,apart,apex,articulated,basally,base,blade,blue,broadly,calyx,chartaceous,climbing,cm,connivent,cordate,deeply,diameter,extra-axillary,fleshy,fruit,fruiting,glabrous,herb,leaf,light,longitudinal,mm,moderately,oblong,opening,ovate,pedicel,peduncle,petiole,pubescent,rotate-pentagonal,simple,slender,slit,somewhat,sparsely,stigma,style,terrestrial,trailing,tube,unbranched,unknown,vein,weakly,white,x,yellow	0.7-1,0.8-2.5,1-1.5,1-3,1.2-1.5,1.5-1.8,1.5-8,2-2.2,2.3-5,3-5,3-6,5-merou,6-10,6-7,acute,ag,alyx,apicall,apparently,axe,ba,capitat,ciliate,clavate,cylindrical,deltoid,densely,directed,distally,eaf,eed,equal,filament,flower,geminat,hair,hair-tipped,lanceolate,large,lobe,long,longer,lower,margin,minutely,multicellular,narrowly,nflorescence,node,obscure,often,orolla,perfect,plurifoliate,pore,pubescen,rachi,revolute,rooting,rounded,scattered,short,slightly,small,spaced,tamen,tem,tip,tooth,unit,unknow,vary,wide,widely,ympodial	age,arrangement,articulation,bark,capitate,color,connation,corolla,dehiscence,diminishing,distal,form,growth,height,history,inflorescence,interjected,lateral,leaflet,length,life,na,ovary,papillae,petiolule,plant,position,prickle,pseudostipule,seed,shape,size,spacing,stem,straightnes,surface,terminal,texture,tuber-bearing
234	wfo-0001027380	success	134	99	61	73	38	0.455	2-3,2-3.5,2.5-3,30-35,4-6.5,5,?,acuminate,anther,apex,articulated,bark,base,berry,calyx,chartaceous,cm,deeply,diameter,erect,extra-axillary,flattened,flower,forked,fruit,fruiting,globose,greenish-brown,hooked,leaf,loose,minutely,mm,oblique,occasionally,open,orange-red,ovate-lanceolate,pedicel,peduncle,petiole,prickle,red,reticulate,rounded,scarcely,scattered,shrub,simple,slightly,small,smooth,somewhat,sparse,stellate,stem,stigma,style,tree,unbranched,white	.5,0,1-1.5,11-17,1136.,3-4,5-8,5-merous,9-10,abaxially,accrescen,adaxiall,adaxially,almost,alyx,apparently,armed,axe,ba,blade,broadly,brown,capitat,conical,developed,distally,drying,eaf,eed,entire,filament,geminate,glabrous,hair,hartley,homostylous,len,lobe,lon,long,lower,margin,minute,mpodial,nflorescence,orolla,oung,pair,paler,perfec,perfect,primary,pubescent,rachi,rip,ruit,scramblin,shallow,slender,sparsely,structure,tall,tamen,testa,thickening,triangular,truncate,unarmed,unknown,vary,vein,visible,x	accrescent,arrangement,articulation,capitate,color,connation,corolla,dehiscence,diminishing,distal,form,growth,height,history,inflorescence,interjected,lateral,leaflet,length,life,na,ovary,papillae,petiolule,plant,position,pseudostipule,scrambling,seed,shape,size,spacing,straightnes,surface,terminal,texture,tube,tuber-bearing
235	wfo-0001027381	success	262	90	61	201	29	0.233	0-1,0.5,0.5-0.6,0.5-1,1-2.5,1.5-4,3-4,4-5,5-11,accrescent,anther,apex,bark,base,calyx,capitate,clavate,cm,diameter,distributed,elliptic,evenly,fruit,fruiting,globose,grey,lateral,leaf,length,less,light,lobed,maturity,mauve,mm,orange,ovate,pale,pedicel,peduncle,petiole,plant,poricidal,prickle,shrub,simple,size,slightly,stellate-pubescent,stem,stigma,striate,style,surface,tapering,terminal,tube,unarmed,white,yellow,yellowish	.3,.4,.8,/5,0-1.5,0.1,0.2,0.3-0.5,0.4-0.6,0.5-0.7,0.6-0.7,0°,1-1.5,1-2,1/3-1/2,1/4-1/3,2,2-2.5,2-3,2-4,2-6,3-5,3-7.5,3.5-4,4-8,5-8,5-merou,7-8,8-10,abaxially,absent,acute,adaxially,age,almost,along,alyx,angle,apically,apparently,area,articulated,attachment,berry,blackish,blade,branch,branched,brown,chartaceous,clearly,concolorous,cordate,covering,cream,curved,dark,delineated,deltoid,densely,density,difoliate,dilated,distance,divided,drying,dull,eaf,eed,ellipsoi,elongated,elongating,epidermi,equal,erect,even,exserted,extending,eye,faint,fertile,filament,filiform,flat,flattened,flower,free,geminat,glabrous,gland,green,greyi,higher,inconspicuous,indumentum,infructescence,irregula,known,lamina,lanceolate,lengthening,like,lobe,long,long-deltoid,longer,longitudinal,lower,main,margin,marking,mature,midpoint,midvein,minute,mostly,naked,never,nflorescence,obconical,oblique,oblong,obscuring,obtuse,often,orange-green,orolla,pair,papillose,part,pendulous,per,perfect,pericarp,point,pore,porrect,portion,present,primary,prominently,protruding,puffy,rachi,raised,rarely,ray,reduced,region,rest,right,rounded,ruit,scar,sessile,shallow,shiny,side,sinus,slender,slit,small,smoot,smooth,sometimes,sparse,sparsely,spreading,stalk,stellate,straight,stump,surrounded,tamen,tertiary,thin,time,tip,tissue,translucent,trichome,truncate,ud,unarme,unit,usually,variable,variously,vary,vein,venation,visibl,visible,wide,widening,without,woody,x,yellow-green,ympodial,young	arrangement,articulation,color,connation,corolla,dehiscence,diminishing,distal,form,growth,height,history,inflorescence,interjected,leaflet,life,na,ovary,papillae,perennial,petiolule,position,pseudostipule,seed,shape,spacing,straightnes,texture,tuber-bearing
236	wfo-0001027384	success	155	88	58	97	30	0.374	0.4-1.1,0.9-1,1-3,1-4,1.5-2,3/4,7.5-8,acute,anther,apart,apex,bark,base,brown,calyx,capitate,clavate,cm,corolla,cuneate,deep,distal,flattened-reniform,fruiting,glabrous,globose,green,lateral,leaf,lobed,minutely,mm,narrowly,obovate,opposite,ovary,papillose,pedicel,petiole,pitted,poricidal,pseudo-terminal,reddish-purple,rounded,shining,shrub,simple,small,stem,stigma,straight,style,surface,tip,tree,tube,way,white	.25,.5,.75,/3,0.5-1,1-1.3,1-1.5,2.5-6.5,3-3.5,3-4,4-7,5-15-flowered,5-5.5,7-14,abov,anothe,anthesi,ba,beginning,beneath,berry,breaking,broadly,bud,closely,dia,difoliate,drying,eaf,edicel,eed,ellipsoid,equal,erect,filament,free,geminate,hard,herbarium,incrassate,inflorescenc,later,lobe,long,long-exserted,lower,main,margin,member,middle,mustard,nflorescence,occasionally,older,overlapping,pair,pale,paler,papillo,peeling,planar,pore,portion,prominent,rarely,ruit,scar,section,shaped,siz,slender,spaced,specimen,subcoriaceous-fleshy,sulcate,tall,tapering,tear-drop,thick,transverse,triangular,trichome,tub,tuft,ud,uniseriate,unit,vein,widely,widest,without,woody,x,yellow,yellowish,ympodial,young	arrangement,articulation,color,connation,dehiscence,diminishing,form,fruit,growth,height,history,inflorescence,leaflet,length,life,na,papillae,perennial,petiolule,plant,position,prickle,seed,shape,size,spacing,straightnes,terminal,texture,tuber-bearing
237	wfo-0001027389	success	154	102	66	88	36	0.429	.1,.5,0.5-1.5,0.6-1,1-1.5,1-2,3-3.5,acuminate,acute,anther,apart,apex,bark,base,broadening,broadly,brown,calyx,cm,conical,corolla,dark,elliptic,erect,foetid,foliage,fruiting,glabrous,globose,green,inflorescence,lateral,leaf,lobed,long,minutely,mm,nearly,opposite,ovary,ovate,ovoid-reniform,papillose,pedicel,petiole,pitted,poricidal,reddish-golden,shaped,shrub,slight,stem,stigma,straight,style,surface,tear-drop,thread-like,tip,top,trichome,truncate,tube,uniseriate,white,young	.25,0.25-0.3,0.25-0.5,0.5-0.75,1,1.8-1.9,11-14,2-2.5,3-4.5,4-5-flowered,5-7,7-8,along,anthesi,ba,beneath,berry,bud,decurrent,deflexed,deltoid,dia,dry,eaf,edicel,eed,ellipsoid,evenly,except,expanded,exserted,filament,filiform,free,geminate,hispidulous,like,lobe,lon,lower,main,making,margin,material,middle,nflorescence,node,non-reproductive,obovoi,occasionally,often,older,one,pair,paler,papillo,pore,portion,prominent,prominently,proximal,puberulent,raise,raised,reflexed,rest,ruit,scar,shin,side,simple,slender,slightly,soon,spaced,sparsely,tall,tapering,ud,unifoliat,unit,vein,widest,winged,woody,x,yellowish,ympodial	arrangement,articulation,color,connation,decument,dehiscence,diameter,diminishing,distal,form,fruit,growth,height,history,interjected,leaflet,length,life,na,papillae,peduncle,petiolule,plant,position,prickle,pseudostipule,seed,shape,shiny,size,spacing,straightnes,terminal,texture,tuber-bearing,unifoliate
238	wfo-0001027395	success	153	116	82	71	34	0.536	0.25-0.5,0.6-1.1,0.75-1,1-5,1.1-1.5,1.5-1.9,1.5-2.5,2-3,acute,anther,apex,attenuate,bark,base,becoming,beneath,berry,black,calyx,capitate,closely,cm,conical,corolla,densely,dia,drying,enlarging,exfoliating,fleshy,fruit,fruiting,glabrous,globose,green,large,lateral,leaf,lobed,long,major,minor,mm,narrowly,nearly,obovate,occasionally,once-furcate,opposite,ovary,overlapping,pedicel,petiole,piece,pore,poricidal,primary,pubescent,restricted,robust,secondary,shaped,shining,shrub,simple,size,small,somewhat,spaced,stem,stigma,straight,style,tear-drop,tip,transverse,trichome,tube,uniseriate,vein,white,woody	.25,.5,1-1.5,1-2,1.6-2.9,10-20-flowered,11-15,12.5-17.3,2.2-7,3.5-4,4-6,5-6.5,8,anthesi,apically,apiculate,beginning,caly,constricted,cucullate,decurrent,deflexed,deltoid,depressed,differing,difoliate,eaf,edicel,eed,erect,exserted,filament,free,geminat,immature,imperceptibly,inflorescenc,known,lobe,lon,lower,main,margin,midrib,minutely,nflorescence,older,ovoid,pair,papillo,papillose,partially,planar,pointed,portion,raised,ruit,rusty-papillate,scar,shiny,tall,tapering,thick,thickened,ud,unit,within,without,x,ympodial,young	alternate,arrangement,articulation,color,connation,dehiscence,diameter,diminishing,distal,form,growth,height,history,inflorescence,interjected,leaflet,length,life,na,papillae,peduncle,petiolule,plant,position,prickle,pseudostipule,seed,shape,spacing,straightnes,surface,terminal,texture,tuber-bearing
239	wfo-0001027396	success	244	114	79	165	35	0.324	0-3,0-4,0.5-1,0.7-2.5,0.8-1.3,10-30,15-40,2-3,20-100,4-7,8-20,almost,anther,apart,apex,articulated,bark,base,black,brown,calyx,cm,connivent,cream,curved,dark,densely,diameter,distal,elliptic,elongate,elongating,flattened-reniform,fruit,fruiting,glabrescent,glandular,green,hair,herb,lateral,leaf,length,long,long-styled,marking,maturity,mauve,mm,orange,pale,pedicel,peduncle,petiole,plant,poricidal,prickle,pubescent,purple,rotate,short-styled,shrub,simple,sometimes,somewhat,sparsely,spherical,stem,straight,style,surface,tapering,tip,trichome,tube,unbranched,white,yellow,young	-2,-5,-6,/3,0-100,0-30,0-5,0.1-0.5,0.1-1,0.4-0.7,0.5-1.5,0.5-2,0.5-2.5,0.8,1,1-4,1.2-2,1.5-3,1.5-3.5,1.8-3,1/2-2/3,1/3,1/4-1/3,1/6,10-15,10-25,10-35,12-25,2-3.5,2-7,2.5-4,2.8-4.5,3-,3-9,3.5-6,4,4-5,4-6,5-10,5-20,5-30,5-50,5-8,5-merous,5.5-7.5,6-20,6.5-7.5,7-10,7-15,abaxial,abaxially,acute,adaxial,alyx,ame,andromonoecious,apar,apically,apparently,attenuate,ba,berry,blade,broad,broad-deltate,bulbous,c.,chartaceous,concolorous,cuneate,decurrent,deltate,difoliate,discolorous,distance,drying,eaf,eed,equal,erect,extending,extensive,fewer,filament,flattened,flower,free,fully,geminat,glabrous,gray-brow,hermaphrodite,heterostylous,infructescence,less,lignified,lobe,lobed,lobing,lon,long-acuminat,longer,lower,lowermost,margin,mature,midpoint,midvein,moderately,near,nflorescence,obtuse,often,older,one,open,opening,orolla,oung,pair,pendulous,per,pericarp,perpendicular,porrect,portion,prickl,prickly,primary,ray,red-brown,reflexed,ruit,scar,secondary,sessile,side,smooth,spaced,spreading,stalk,stalked,staminat,stellate-pubescent,stout,tamen,tearing,terete,tertiary,time,unarmed,unit,upper,usually,variously,vary,vein,venation,visible,way,wide,woody,yellow-green,yellowish,ympodial	/,arrangement,articulation,color,connation,corolla,dehiscence,diminishing,foetid,foliage,form,gray-brown,growth,height,history,inflorescence,interjected,leaflet,life,na,ovary,papillae,perennial,petiolule,position,pseudostipule,seed,shape,size,spacing,stigma,straightnes,terminal,texture,tuber-bearing
240	wfo-0001027416	success	137	96	55	82	41	0.401	.5,0.2-0.4,0.5-1.0,1.5-2.0,3-7,4-7,4-8,4.0-5.5,5.5-8.5,accrescent,acute,annual,anther,apically,base,blue,broadly,brown,calyx,campanulate,capitate,cm,dark,deltoid,dm,foveolate,hair,herb,incurved,internodal,lanceolate,lenticular,long,minutely,mm,narrowly,otherwise,ovary,ovate,pedicel,pentagonal-stellate,pinnatifid,prickle,prickly,short,slightly,smooth,spherical,stem,strigulose,tube,villous,violet,weakly,yellow	0.3-0.5,1.0,1.3-2.0,1/2-2/3,2.6-3.0,5-10,5-9-flowere,8-10,across,along,alyx,anthesi,appearance,beneath,berry,blade,borne,branching,capitate-glandular,cauline,developing,dia,difoliate,divided,dry,eaf,eed,enveloped,erect,externally,few-rayed,fine,geminat,glabrous,gland,green,heteromorphic,invested,linear,lobe,lon,main,maturity,much-dissected,nflorescence,often,orolla,quantity,reticulately,ruit,scattered,sessile,short-stipitate,simple,slende,slender,somewhat,splitting,spreading,stellae,straight,strait,tall,tamen,taprooted,terete,thrice,tightly,tigma,tub,twice,tyle,ultimate,uniseriate,unit,usually,varying,vein,viscid-villous,wholly,wrinkled,ympodial	arrangement,articulation,color,connation,corolla,dehiscence,diameter,foetid,foliage,form,fruit,fruiting,growth,height,history,inflorescence,interjected,lateral,leaf,leaflet,length,life,na,papillae,peduncle,petiole,plant,position,pseudostipule,seed,shape,size,spacing,stigma,straightnes,style,surface,terminal,texture,trichome,young
241	wfo-0001027432	success	215	117	85	130	32	0.395	0.1,0.3-0.4,0.3-1.0,0.5-0.1,0.5-1,1-3,1.5-,3,3-10,3-4,3-6,3-7,5-10,8-10,acute,anther,apart,apex,articulate,attenuate,bark,base,branched,brownish,calyx,chartaceous,clavate,cm,corolla,curved,diameter,distal,erect,flower,fruit,fruiting,glabrescent,globose,green,greenish,growth,leaf,light,lobed,maturing,mm,much,multangulate,ochraceous,ovary,ovate,ovate-elliptic,pedicel,peduncle,perfect,petiole,plant,poricidal,porrect,prickle,pubescent,reniform,reticulate,shrub,simple,slightly,sparsely,stellate,stem,stigma,straight,style,sub-coriaceous,surface,tan,tapering,terminal,tip,trichome,tube,white,woody,x,yellow,young	-1.5,.5,0.2-0.3,0.3-3.5,0.8-1.0,1-1.5,1-multicellular,1.4-2,1.5-2,1/3,1/4,10-22,2-2.5,2-3-lobed,20-30,3-5,3.5-4.5,30,4-5,4.5-,6-10,6-7,7-,8-16,abaxially,acicular,adaxially,angulate,apical,armed,basal,berry,blade,branching,brow,c.,campanulate,confined,conical,coriaceous,cream,cuspidate,densely,eaf,eed,eglandular,entire,epidermi,especially,exserte,ferruginous,fewer,filament,flattened,free,glabrous,glandular,glandular-pubescent,heterostylous,hirsute,irregularly,juvenile,laterally,leave,lengthening,like,linear-lanceolate,lobe,long,long-styled,lower,many,many-celled,margin,midpoint,minute,mucilaginous,multiangulate,near,new,nflorescence,older,one,partially,per,pericarp,plurifoliat,pore,porrect-stellate,portion,prickly,prominent,puberulent,raise,rarely,ray,recurved,ruit,scabrous,sessile,short-styled,similar,somewhat,spaced,staminate,stellate-pubescen,stellate-pubescent,stellate-tomentose,stipitate,subglobose,subsessile,terete,testa,thick,time,tomentose,tomentose-floccose,tomentose-scabrous,ud,unarmed,unevenly,unicellular,unit,upper,velutinous,villose,visible,way,yellowish,ympodial	4.5-8-16,7-10-22,arrangement,articulation,brown,color,connation,dehiscence,diminishing,foetid,foliage,form,height,history,inflorescence,interjected,lateral,leaflet,length,life,na,papillae,petiolule,position,pseudostipule,seed,shape,size,spacing,straightnes,texture,tuber-bearing
242	wfo-0001027437	success	193	96	68	125	28	0.352	0,1-3,1-4,2-3,2-4.5,2.5,4-5,5-12,acuminate,acute,anther,apex,articulated,attenuate,base,beige,berry,brown,calyx,clavate,cm,cordate,corolla,corymbose,cyme,dark,diameter,elliptic,erect,fruit,fruiting,globose,green,growth,internodal,lateral,lenticulate,linear-lanceolate,lobed,long,mm,oblanceolate,pedicel,peduncle,petiole,poricidal,porrect,prickle,recurved,reticulate,rugose,rusty,scabrous,shrub,slightly,spaced,stellate,stellate-rotate,stem,stigma,style,subreniform,surface,tip,trichome,unevenly,white,woody	0.2-0.4,0.4-0.5,1,1-1.5,1-2,1.2-1.5,2-2.5,2-2.5mm,2-several,2.8-6,30,4,4-4.5,5-6,6-8,7-17,abaxially,adaxially,anthesi,antrorse,armed,bark,basal,beneath,branched,chartaceous,compressed,curved,decurrent,densely,diamete,discolorous,distal,eaf,eed,egalndular,elongate,entire,erec,exceeding,filament,flower,free,glabrous,glandular,glandular-viscous,heterostylous,hirsute,impressed,inserted,laterally,leaving,lengthening,like,lobe,long-styled,lower,margin,middle,midpoint,minute,mixed,mixture,near,nerve,new,nflorescence,oblong,older,one,ovary,ovate,partially,perfect,pericarp,plurifoliat,pore,portion,prickly,prominent,puberulent,pubescence,pubescent,raise,ray,reddish,reduced,reflexed,ruit,scar,scarce,sessile,short-styled,simple,slit,sparse,sparsely,stalked,staminate,stipitate,straight,strongly,subcampanulate,subspherical,tall,terete,testa,thick,three,time,tinge,tomentose,triangular-lanceolate,tube,ud,unarmed,unicellular,unit,upper,velutinous,venation,within,x,yellow,ympodial	arrangement,articulation,color,dehiscence,foetid,foliage,form,height,history,inflorescence,interjected,leaf,leaflet,length,life,na,plant,plurifoliate,position,pseudostipule,raised,seed,shape,size,spacing,terminal,texture,young
243	wfo-0001027447	success	197	84	48	149	36	0.244	0-0.4,0.6-1,1-2.5,1.5-3,3.5-4.5,4-8,acuminate,acute,anther,apex,articulated,base,calyx,chartaceous,cm,cuneate,diameter,elliptical,extra-axillary,fruit,fruiting,globose,inflorescence,lateral,leaf,length,mm,obtuse,ovate,pale,pedicel,peduncle,perennial,petiole,plant,present,prickle,pseudo-racemose,red,shrub,simple,stellate,style,surface,tube,unarmed,white,yellow	%,.25,0-0.5,0-1,0-10,0-2.5,0-4,0.15-0.25,0.2-0.6,0.2-1,0.25-0.3,0.25-0.5,0.4-0.6,0.5-1.7,0.6-0.8,1-1.4,1-10,1-2,1-locular,1.2-1.7,1.3-1.7,10-20,13-18,17-28,2.1-3.2,2.3-5,2.5-4,25-30,3-4.5,3-6,3.8-4.3,4-6,4-9,5-13,5-8,5-merou,6-10,7-10,7-14,7-14.5,7-8,8-13,abaxially,absen,absent,acicular,across,adaxiall,adaxially,adult,alyx,andromonoecious,apart,axe,ba,blade,branch,branche,brown,confined,cross-section,cylindrical,decimetre,densely,directed,distall,distally,dm,eaf,eed,eglandular,elliptica,entire,erect,exocarp,finger,flower,functional,glabrous,gland-tipped,green,hair,half,heterostylous,incomplete,index,juicy,juvenile,lamina,less,lobe,lobed,lobing,long,longer,lower,margin,markedly,mature,mesocarp,midpoint,midrib,midvein,minute,moderately,nflorescence,oblique,orolla,pair,part,per,placenta,pore,porrect,pubescence,ray,rhizomatous,rostrate,ruit,septum,sessile,shallowly,short,side,spaced,sparsely,stellae,stellate-pubescent,straight,succulent,tal,tamen,tem,thick,thicker,throughout,time,transparent,unarme,unbranched,unit,unknow,upper,vary,vein,weakly,wide,x,ympodial	arrangement,articulation,bark,color,connation,corolla,dehiscence,diminishing,distal,foetid,foliage,form,growth,height,history,interjected,leaflet,life,na,ovary,papillae,petiolule,position,pseudostipule,seed,shape,size,spacing,stem,stigma,straightnes,terminal,texture,trichome,tuber-bearing,young
244	wfo-0001027449	success	160	100	65	95	35	0.406	/3,0.5-1,0.8-1.5,0.9-1.1,2-4,5-6,acute,anther,apex,area,bark,base,beneath,brown,calyx,closely,cm,corolla,dark,elliptic,fruit,fruiting,glabrous,globose,green,inflorescence,lateral,leaf,lobed,minutely,mm,narrowly,often,opposite,ovary,overlapping,ovoid-reniform,packed,pale,papillose,pedicel,persistent,petiole,pitted,poricidal,pubescent,red-papillose,shaped,shrub,simple,size,small,stem,stigma,straight,style,surface,tear-drop,tip,tree,trichome,tube,way,white,young	.4,.5,.75,0.5-1.5,1.2-1.5,1.4-1.5,1.5-2.5,10-15-flowered,2-3,3,3-3.5,3-7,4-6,8-15,acuminate,anthesi,appearing,arising,around,axil,becoming,beginning,berry,bud,cup,deciduous,deflexed,dense,densely,density,dia,differing,difoliate,dry,eaf,edicel,eed,ellipsoid,erect,exserted,extreme,filament,forming,free,frui,geminat,glabrate,inflorescenc,lamina,later,like,lobe,lon,long,long-acuminate,long-triangular,lower,main,major,material,minor,nflorescence,obconic,oblique,older,one,orangish,pair,pointed,pore,portion,prominent,raised,reddish-brow,reflexed,rest,ruit,scar,slender,soon,sparse,sparsely,styl,tall,tapering,trunk,tuft,ud,uniseriate,unit,varying,vein,woody,x,ympodial	1,arrangement,articulation,color,connation,dehiscence,diameter,diminishing,distal,foetid,foliage,form,growth,height,history,interjected,leaflet,length,life,na,papillae,peduncle,petiolule,plant,position,prickle,pseudostipule,reddish-brown,seed,shape,spacing,straightnes,terminal,texture,tuber-bearing
245	wfo-0001027452	success	152	91	48	104	43	0.316	0.5-1,0.5-2,1-3,10-20,2-foliate,3-9,4,4-6,5-12,absent,acute,anther,apex,base,brown,calyx,chartaceous,cm,diameter,dm,drying,elliptic,elliptic-ovoid,flower,fruit,globose,herb,immature,maturing,membranaceous,mm,nearly,oblong,obtuse,pedicel,peduncle,petiole,rotate,rounded,seed,semitransparent,stigma,style,tube,usually,white,x,yellow	.5,0.5-1.5,0.5-2.5,1,1-2,1-4.5,1-5,1.5,1.5-3,2-4,2-6,3-6,5-20,abaxially,abundant,adaxiall,adaxially,along,axe,berry,beyond,blade,branched,cell,celled,center,ciliate,connected,cordate,decurrent,dehiscing,densely,denser,eaf,eed,emarginat,entire,equal,explosively,exserted,filament,flat,frui,geminat,glabrous,growt,hair,held,interpetalar,large,linear-lanceolate,lobe,long,lower,lying,margin,maturit,mesocarp,moderately,new,nfloresence,notched,often,one-,orolla,outer,parallel,per,perpendicular,placenta,pressure,pubescen,pubescent,rachi,raised,ridge,ruit,running,short,significantly,single,slightly,smaller,smoother,sometimes,sparsely,stamen,straight,swollen,tal,tamen,tem,tissue,triangular,two-celled,unbranched,unit,vary,vein,wall,watery,wid,woody,ympodial	arrangement,articulation,bark,color,connation,corolla,dehiscence,diminishing,distal,foetid,foliage,form,fruiting,geminate,growth,height,history,inflorescence,interjected,lateral,leaf,leaflet,length,life,na,ovary,papillae,petiolule,plant,position,prickle,pseudostipule,shape,size,spacing,stem,straightnes,surface,terminal,texture,trichome,tuber-bearing,young
246	wfo-0001027471	success	165	99	70	95	29	0.424	0.1-0.2,0.2-0.4,0.2-0.5,0.5-0.6,0.5-1.5,1-1.5,2-lobed,4-5,acute,age,anther,anthesi,bark,base,bifid,branched,calyx,closely,cm,corolla,dendritic,diameter,elliptic,flattened,fruiting,glabrous,globose,growth,herb,inflorescence,internodal,leaf,leaf-opposed,lengthening,lobed,minutely,mm,nodding,ovary,ovate,pale,pedicel,peduncle,petiole,pitted,poridical,pubescent,red-orange,reniform,shape,shrub,simple,size,slit,small,somewhat,spaced,sparsely,stem,stigma,straight,style,subshrub,surface,tan,trichome,tube,uniseriate,white,yellowish	.5,/4,0.4-1,0.5,0.5-0.7,0.7-0.9,0.9-1,1-1.2,1-1.6,1.4-3,1.5-2,2-2.5,2-3,3-4,3-7,6-7,abaxially,adaxially,along,apex,appressed,ascending,berry,brittle,c.,conical,deltate,densely,desnsely,differing,difoliate,distant,drying,eaf,eed,entire,erec,erect,especially,filament,flower,free,furcate-dendritic,geminate,included,lamina,less,like,lobe,long-triangular,lower,major,margin,maturity,midvein,minor,mixture,new,nflorescence,node,occasionally,open-conical,orbicular,overlapping,pair,papillat,perfect,pericarp,petal,planar,plane,pore,portion,primary,pubscent,rachi,reflexed,ruit,scar,scattered,similar,slender,slightly,thickened,thin,tip,trifoliat,ud,unit,usually,vein,way,woody,x,ympodial	arrangement,articulation,color,connation,dehiscence,foetid,foliage,form,fruit,height,history,interjected,lateral,leaflet,length,life,na,papillae,papillate,plant,position,prickle,pseudostipule,seed,spacing,straightnes,terminal,texture,young
247	wfo-0001027473	success	138	90	52	86	38	0.377	0.5-1,0.8-1,1-1.5,8.5-37,?,acute,anther,apex,bark,base,brown,calyx,clavate,cm,corolla,dendritic,densely,di-,flattened-reniform,fruiting,globose,green,lateral,leaf,lobed,minutely,mm,obovate,ovary,pale,pedicel,petiole,pitted,poricidal,pubescent,rootstock,rusty,sessile,shape,shrub,stem,stigma,style,subshrub,surface,thick,trichome,trifoliate,tube,white,woody,young	.25,/2,0.25-0.5,1-2,1.3-2,1.5-2,1.8-2,1/3,2-2.5,2.5-3,3.5-5,4.5-13,5,6-9,abaxially,absen,adaxially,along,anthesi,ape,apparently,berry,conical,deccurent,decurrent,deep,deflexed,denser,dia,differing,drying,eaf,eed,empty,erect,filament,free,geminat,giving,glabrous,incrassate,later,less,like,lobe,long,long-triangular,lower,main,major,margin,middle,minor,minute,near,occasionally,older,overall,pair,papillo,planar,pointed,pore,portion,pubesent,ruit,sac,shaped,somewhat,sparsely,sterile,strongly,tall,tear-drop,tip,unit,usually,vein,way,wide,widest,wing,winged,yellowish,yellowish-brow,ympodial	absent,arrangement,articulation,color,connation,dehiscence,diameter,diminishing,distal,foetid,foliage,form,fruit,growth,height,history,inflorescence,interjected,leaflet,length,life,na,papillae,papillose,peduncle,petiolule,plant,position,prickle,pseudostipule,seed,size,spacing,straightnes,terminal,texture,tuber-bearing,yellowish-brown
248	wfo-0001027483	success	164	143	105	59	38	0.64	0.2-1.9,0.6,1-5,1.2-2.5,1.5-3,2,2-3,2-4,3-15,3-6,4.5-8,5-6,abaxially,acute,adaxially,apex,apical,apically,articulate,base,branched,calyx,cell,cm,coarsely,connate,corolla,covering,cuneate,cyme,dehiscent,diameter,dichasial,dichasially,diminishing,distal,dot,ebracteate,elliptical,finely,forked,generally,globose,gradually,green,green-white,hair-like,half,herbaceous,interjected,interpetiolar,introrse,lateral,leaf,leaflet,light,lighter,long,make,maturing,medium,mm,monochasial,mucilaginous,obtuse,odd-pinnate,often,ovate,ovoid,pedicel,peduncle,perennial,petiole,petiolule,plant,poricidally,proximal,pubescent,purple,ray,rotate,rounded,seed,short,size,slit,smooth,sometimes,stigma,straight,style,terminal,testal,thick,throughout,toward,tuber-bearing,uniform,violet,violet-purple,wall,white,wide,yellow,¼	0-1.,1,1-2,1-2.5,1-4,1.5-10,1.5-2.6,2-4.5,3-6-foliat,3.5-20,5-10,acumen,basal,decurrent,digestion,dorsally,eaf,edge,eed,emoval,enzyme,erec,exceeding,filament,flat,flower,folded,globo,honeycomb,living,lobe,lon,lower,lunat,minute,nflorescence,nther,orolla,pair,pattern,perfect,plan,rachi,reveal,rosette,ruit,sessile,seudostipule,specimen,stamen,subsessile,tall,tem,tissu,typically,unit,vary,varying,ympodial	0-10,anther,arrangement,articulation,bark,color,connation,dehiscence,foetid,foliage,form,fruit,fruiting,growth,height,history,inflorescence,length,life,lunate,na,ovary,papillae,position,prickle,pseudostipule,shape,spacing,stem,straightnes,surface,texture,tissue,trichome,tube,wet,ye,young
249	wfo-0001027503	success	197	117	83	114	34	0.421	.5,0.4-0.7,0.5,0.5-0.6,0.5-0.7,0.8-1,1,1-3,2-3,4,acute,anther,apex,armed,articulated,bark,base,beige,berry,bluntly,branched,broad-based,calyx,clavate,cm,corolla,densely,diameter,dioecious,echinoid,elliptic,enclosing,expanding,foliose,fruit,fruiting,glabrous,globose,greatly,greenish,grey,growth,inflorescence,internodal,leaf,lobed,long,male,minutely,mm,narrowly,nearly,ovary,pale,partially,pedicel,peduncle,petiole,plant,poricidal,prickle,pubescent,ripe,shiny,shrub,simple,small,stellate,stem,stigma,straight,style,surface,tan,time,tip,tree,trichome,truncate,tube,unarmed,white,yellowish	0.15-0.2,0.2,0.6-0.7,0.9-1.2,1-1.2,1.1-1.5,1.2-2.5,10,2.5-3,2.5-5.5,20-40,549,8-11,<,abaxially,adaxially,age,almost,along,anthesi,beneath,berr,broadly,common,conical,consisting,coriaceous,deflexed,deltate,dense,distally,due,eaf,eed,ellipsoid,elongate,entire,erect,female,fide,filament,flower,free,glabrescen,included,juvenile,known,lamina,lanceolate,large,lengthening,lepidote,less,like,likely,lobe,lower,margin,midrib,mixture,new,nflorescence,occasionally,often,older,overlappin,packed,pair,papillo,peguero,pericarp,pistillate,planar,plurifoliat,pore,porrect,portion,prickly,primary,prominent,pubescence,ray,rest,rhachi,rounded,rudimentary,ruit,scar,seen,shoot,short,similar,slit,solitary,somewhat,sparsely,staminate,stout,thick,thin,tightly,tiny,tubular,ud,unarme,underside,unisexual,unit,vein,visible,without,x,ympodial,½	arrangement,articulation,color,connation,dehiscence,diminishing,distal,foetid,foliage,form,glabrescent,height,history,interjected,lateral,leaflet,length,life,na,papillae,papillose,petiolule,position,pseudostipule,reproduction,seed,shape,size,spacing,straightnes,terminal,texture,tuber-bearing,young
250	wfo-0001027506	success	215	135	104	111	31	0.484	-20,-3,/2,/6,0-10,0.1-0.3,0.2,0.5-1.5,0.5-6,0.7-1.3,1-2,1-4,1.2-1.5,2.5-8,3-5,5-10,6-13,6.5-10,7-8,acuminate,acute,anther,apart,apex,articulated,bark,base,becoming,berry,branched,brown,calyx,cell,cm,connivent,cordate,cream,cuneate,curved,dark,densely,diameter,distal,elongating,erect,fine,flattened,flattened-reniform,fruit,fruiting,glabrescent,green,lateral,leaf,length,lobed,long,marking,mature,maturity,mauve,mm,moderately,orange,orange-brown,outline,ovate,pale,pedicel,peduncle,petiole,pit,plant,poricidal,porrect,prickle,purple,raised,ray,reddish,reflexed,shrub,simple,small,smooth,sometimes,spherical,stalk,stalked,stellate-pubescent,stem,style,surface,tapering,terminal,tip,tree,trichome,truncate,tube,way,wide,yellow,young	-0.35,-1,-7,-7.5,.2,.5,0,0-2,0-6,0-60,0.1-,0.2-0.3,0.25,0.8-1.5,1-3,1.5-2.2,1.8,1/3,1/6-1/4,10-40,2-3.2,2.2-3.5,2.5-5,3-10,3-6,3.5-5,5-7,5-merous,7-9,8-10,9-13,abaxially,acuminat,alyx,ame,andromonoecious,apar,apically,apparently,blade,brow,c.,chartaceous,concolorous,dry,drying,eaf,eed,entire,equal,filament,flower,free,glabrous,hard,hermaphrodite,heterostylous,infructescence,lengt,lobe,long-styled,longer,lower,lowermost,margin,midpoint,multangulate,narrow-deltate,nflorescence,occasionally,older,one,open,orolla,oung,pair,pendulous,per,pericarp,plurifoliat,portion,prickl,prickly,primary,reduced,ruit,scar,sessile,short-styled,spaced,spreading,staminat,stellate,stout,subentire,tamen,terete,tertiary,time,twice,unarmed,unit,upper,variously,vary,vein,venation,visible,woody,yellow-green,ympodial	arrangement,articulation,color,connation,corolla,dehiscence,diminishing,foetid,foliage,form,growth,height,history,inflorescence,interjected,leaflet,life,na,ovary,papillae,petiolule,position,pseudostipule,seed,shape,size,spacing,stigma,straightnes,texture,tuber-bearing
251	wfo-0001027510	success	195	93	59	136	34	0.303	0-0.4,0-0.5,0.4-0.9,0.9-3.4,10-15,2-2.2,4-9,6-7.5,6-8,absent,accrescent,anther,articulated,base,broadly,calyx,capitate,chartaceous,cm,connivent,contiguous,cordate,densely,diameter,extra-axillary,fruit,fruiting,globose,green,inflorescence,lanceolate,lateral,leaf,length,minutely,mm,nearly,obtuse,ovate,pale,pedicel,peduncle,perennial,petiole,prickle,purple,red,reticulate,rotate-stellate,shrub,simple,stellate-pubescent,stigma,style,surface,tube,unbranched,x,yellow	%,.5,.7,0-0.9,0-2,0-5,0.1-0.3,0.2-0.4,0.5-0.6,0.5-1.1,0.7-1.5,0.7-1.6,0.8-1.8,1-2,1-3,1-locular,1.5-2,1.5-2.5,1.5-3,1.5-4,1.6-2,10-12,10-13,17-35,2-3,2-5,2-foliate,2.5-3,2.6-5.5,2.6-6,3-5,3-6,4-5,4-5.5,4-6,4-8,5-10,5-merou,6,6-13,9-12,abaxially,absen,abundant,across,acute,adaxially,adult,alyx,apart,apex,apparen,axe,ba,blade,cylindrical,deltate,directed,distall,distributed,eaf,eed,eglandular,elliptic,entire,erect,exceeding,filament,finger,flower,forke,geminat,glabrous,gland-tipped,grey,hair,homostylous,incomplete,interpetalar,juicy,juvenile,lamina,leafy,lobe,lobed,long,lower,margin,mature,mesocarp,midpoint,minute,nflorescence,oblique,orolla,pair,part,per,perfect,placenta,pore,porrect,pseudo-umbellate,pubescent,rachi,ray,rhizomatous,ruit,septum,sessile,shallowly,short,soliary,spaced,stalk,stellae,stellate,succulent,tal,tamen,tem,thick,throughout,time,tissu,tissue,transparent,unarme,unarmed,unit,upper,usually,vary,wide,without,ympodial	abaxial,adaxial,arrangement,articulation,color,connation,corolla,dehiscence,foetid,foliage,forked,form,growth,height,history,interjected,leaflet,life,na,ovary,papillae,plant,position,pseudostipule,seed,shape,size,spacing,stem,straightnes,terminal,texture,trichome,young
252	wfo-0001027536	success	200	118	82	118	36	0.41	0.4-2.0,1-1.5,1-2,2-,2-10,2-3,2-4,2-5,3-4,3-5,3-forked,4-10,8-10,abaxially,accrescent,acute,adaxially,anther,apart,apex,apical,articulated,base,brown,calyx,cm,connivent,curved,decurrent,diameter,distal,eglandular,elliptic,ferruginous,fine,fruit,fruiting,glandular,glandular-stellate,globose,hair,inflorescence,leaf,lenticular,linear-lanceolate,mm,multiseriate-stalked,oblanceolate,ornamentation,pedicel,peduncle,perennial,persistent,persistently,petiole,pore,prickle,pubescent,recurved,reticulated,short,shrub,simple,slightly,small,somewhat,stellate,stem,stigma,straight,style,subreniform,surface,tomentose,trichome,tube,usually,velutinous,white,x,yellow,yellowish	-15,-3,1.5-2,2-2.5,20,3-3.5,30-50,4,4-12,4-5,4-8,5-10,5-6,5-7,8-,adaxiall,alyx,ape,apiculate,armed,asymmetric,axe,ba,basal,berry,bicolored,bisexua,blade,branch,branched,chartaceous,clavate-truncat,compressed,dark,densely,depressed-globose,dry,eaf,eed,enlarged,entire,epicarp,equal,erect,exceeding,ferruginous-tomentose,filament,fleshy,flower,free,glabrous,gland-tipped,gynoecia,held,impressed,introrse,laterally,leathery,like,lobe,long,longer,lower,many-foliat,margin,maturit,midpoint,mixed,mostly,multiseriate,nflorescence,one,opening,orolla,part,per,perfect,primary,prominent,rachi,reddish,reduced,reflexed,ruit,sessile,similar,single,slender,spaced,sparsely,splitting,stalk,stamen,staminate,subcampanulate,subcoriaceous,subulate,surrounded,tal,tamen,tem,terete,thick,time,tip,unarme,unarmed,unbranched,unisexual,unit,upper,upright,vary,vein,villose,wide,ympodial,zygomorphic	arrangement,articulation,bark,clavate-truncate,color,connation,corolla,dehiscence,diminishing,foetid,foliage,form,growth,height,history,interjected,lateral,leaflet,length,life,na,ovary,papillae,petiolule,plant,position,pseudostipule,seed,shape,size,spacing,straightnes,terminal,texture,tuber-bearing,young
253	wfo-0001027538	success	137	86	43	94	43	0.314	.5,0.4-0.85,0.9-1.8,1.5-3.5,2-4,4-5,absent,acute,anther,apex,articulated,base,calyx,cm,cordate,densely,diameter,directed,extra-axillary,flower,fruit,fruiting,inflorescence,lateral,length,minute,mm,obtuse,ovate,pedicel,peduncle,petiole,present,prickle,prostrate,simple,stellate,stellate-pubescent,tube,unbranched,x,yellow,yellowish	%,.9,0-0.1,0-1.5,0-2,0.05-0.15,0.1-0.2,0.3-0.4,0.3-0.45,0.4-0.5,0.5,0.5-1,0.5-1.5,0.6-1,0.9-1,0.9-1.2,1,1-4,1.9-2.4,20-25,5-merou,7-12,8,8-13,?,abaxially,absen,acicular,across,adaxiall,adaxially,alyx,apart,armed,attenuate,axe,ba,blade,brown,chartaceous,distall,distributed,eaf,eed,eglandular,entire,finger,glabrous,gland-tipped,globo,grey-green,hair,half,lamina,less,lobe,lon,long,lower,margin,mature,mid-point,midpoint,midvein,nflorescence,oblique,orolla,part,per,pore,porrect,ray,ruit,rusty,sessile,short,shru,spaced,stage,stalk,stellae,straight,tamen,tem,thick,throughout,time,unarmed,unit,unknow,unknown,uvenile,wide,ympodial	arrangement,articulation,bark,color,connation,corolla,dehiscence,diminishing,distal,distally,foetid,foliage,form,globose,growth,height,history,interjected,leaf,leaflet,life,na,ovary,papillae,petiolule,plant,position,pseudostipule,seed,shape,shrub,size,spacing,stem,stigma,straightnes,style,surface,terminal,texture,trichome,tuber-bearing,young
254	wfo-0001027548	success	216	111	77	139	34	0.356	0.3-1.2,0.5-2,1-1.5,1-10,1-2.5,4-8,6-9,acuminate,acute,anther,apart,apex,articulated,articulation,attenuate,base,berry,black,brown,calyx,capitate,cm,conical,connivent,corolla,dark,dendritic,densely,depressed-elliptic,diameter,ellipsoid,elliptic,flattened-reniform,fruiting,glabrous,glandular,globose,green,growth,immature,inflorescence,leaf,lilac,lobed,loose,loosely,membranous,minutely,mm,narrowly,pale,papillae,pedicel,peduncle,petiole,pitted,poricidal,pubescent,reddish,ripe,simple,size,sparse,stellate,stem,stigma,style,surface,terminal,tinged,tip,trichome,tube,vine,white,woody,yellow	-11.5,.3,0.2,0.5,1,1-3.5,1.2,1.5,1.5-2,1.5-2.5,10-12,10-50,3-7,4-6,4.5,5-merou,7-10,8-9,abaxiall,adaxially,ag,almost,along,also,although,alyx,anthesi,apical,apparently,appearing,area,ark,axi,basal,beneath,bent,branch,branched,branching,bu,c.,cell,darker,deflexe,deltate,denser,drying,dull,eaf,early,eed,elongate,em,entire,exserted,extending,filament,flexuous,flower,free,geminat,glabrescen,half,herbarium,ilament,irregularly,lamina,leaving,lengthening,less,like,lobe,lon,long,long-styled,lower,many,margin,matte,minute,mixed,near,new,nflorescence,occasionally,older,orolla,outline,pair,papillate,papillo,per,perfect,pericarp,planar,plurifoliate,point,pore,portion,primary,prominent,puberulent,rachi,rectangular,revolute,ruit,scar,scattered,slender,slit,small,sometimes,somewhat,spaced,sparsely,specimen,spreading,strongly,swollen,tapering,testal,thickened,thin,time,tiny,transparent,twinin,type,ud,uniseriate,unit,upper,usually,vary,vein,warty,way,x,ympodial	8,arrangement,bark,color,connation,dehiscence,diminishing,distal,foetid,foliage,form,fruit,glabrescent,height,history,interjected,lateral,leaflet,length,life,na,ovary,papillose,plant,position,prickle,pseudostipule,seed,shape,spacing,straightnes,texture,tuber-bearing,young
255	wfo-0001027581	success	200	96	58	142	38	0.29	acute,anther,articulated,base,berry,branched,broadly,brown,calyx,clavate,cm,connivent,corolla,dark,diameter,ellipsoidal,elliptic,evenly,flattened-reniform,fruiting,globose,golden,green,growth,inflorescence,leaf,length,lobed,loosely,many,minutely,mm,moderately,pedicel,peduncle,petiole,pitted,poricidal,pubescent,purple,reddish,ripe,shrub,simple,size,small,stellate,stem,stigma,style,surface,terminal,time,tip,tree,trichome,tube,yellow	0.2–0.3,0.3,0.3–1,0.5–1,0.5–1.5,1,1.2–1.5,1.3–1.5,1.5,1.5–2,1.5–3,10,100+,10–16,12,12–30,15–20,1–1.5,1–3-rayed,2.5–3,200,3.5–4.5,3–3.5,4.5–16,4–8,5-merou,6–7,7–10,7–9,8,8–10,9–11,9–9.5,>,abaxial,abaxially,adaxial,ag,along,alyx,anthesi,apar,apex,ark,axe,beneath,branching,brow,bulbous,c.,clearly,closely,cup-shaped,deltate,densely,dichasia,discolorous,distally,drying,eaf,echinoid,eed,entire,erec,exserted,filament,flower,free,glabrescent,glabrous,gradually,greyish,ilament,lamina,largest,lengthening,less,like,lobe,long,longest,lower,margin,midvei,minute,mixed,multangulate,multiseriate,narrowing,near,new,nflorescence,nodding,older,orolla,pair,papillo,part,per,perfect,pericarp,plane,plurifoliate,pore,porrect-stellate,portion,primary,ray,reflexed,rhachi,ruit,scar,scarcely,sessile,shiny,short-stalked,slit,smaller,spaced,sparsely,spreading,stalk,stout,tall,tem,thin,ud,undersurface,unevenly,unit,upper,vary,varying,vein,visible,way,weak,whit,wide,woody,yellowish,ympodial	1.5-3,15-20,3-3.5,4-8,7-10,7-9,9-9.5,apart,arrangement,articulation,bark,color,connation,dehiscence,foetid,foliage,form,fruit,height,history,interjected,lateral,leaflet,life,na,ovary,papillae,papillose,plant,position,prickle,pseudostipule,seed,shape,spacing,straightnes,texture,young
256	wfo-0001027584	success	144	96	58	86	38	0.403	-2,0.5-1.5,0.9-1,0.9-2.5,2,2-10,3,3-.,4-7,abruptly,acuminate,anther,apex,attenuate,bark,base,branched,calyx,cm,conical,corolla,darker,diameter,ellipsoid,elliptic,flattened,four,fruit,fruiting,glabrous,green,herb,lobed,long,minutely,mm,nearly,ovary,ovate,pale,papillate,pedicel,peduncle,petiole,reddish,reniform,smooth,stem,stigma,stripe,style,suffruticose,surface,tan,time,trichome,tube,white	-16,..,.5,0.5-1,1-1.2,1.2-1.4,1.5-2,1.5-8,1.6-1.9,10-15,100,11.5-45,2.5-3,4-6,4.5-20,7-10,8-9,absent,anthesi,apical,becoming,beginning,beneath,branch,brittle,broadly,brow,c.,capitat,cell,cucullate,deflexe,deltate,densely,dry,eaf,edicel,eed,erec,filament,flower,irregular,lamina,lobe,lower,margin,markedly,narrowly,nflorescence,open,outer,outline,pair,per,pericarp,planar,plurifoliat,pointed,present,primary,regularly,ruit,scar,scattered,shrub,single,single-stemmed,sinuate,small,sparse,sparsely,striate,testal,thickening,thin,tip,triangular,tuft,ud,uniseriate,unit,vein,wall,without,x,ympdoial	arrangement,articulation,brown,capitate,color,connation,dehiscence,diminishing,distal,foetid,foliage,form,growth,height,history,inflorescence,interjected,lateral,leaf,leaflet,length,life,na,papillae,plant,plurifoliate,position,prickle,pseudostipule,seed,shape,size,spacing,straightnes,terminal,texture,tuber-bearing,young
257	wfo-0001027585	success	217	102	66	151	36	0.304	0-1,0-2,1-3,1-4,12-23,2-3,2-5,3-7,7-10,absent,accrescent,acuminate,acute,anther,apex,articulated,base,broad-based,calyx,chartaceous,cm,connivent,cuneate,curved,diameter,elliptic,extra-axillary,flattened,fruit,fruiting,glabrous,globose,green,inflorescence,lanceolate,lateral,leaf,length,lilac,long,loosely,mm,oblate,ovate,pale,pedicel,peduncle,perennial,petiole,plant,present,prickle,ripe,rounded,scarcely,shrub,simple,stellate,stigma,style,surface,tube,unbranched,unripe,vine,yellow	%,.05,0,0-0.5,0-15,0-4,0.15-0.25,0.2-0.3,0.2-0.4,0.25-0.35,0.5-1,0.6-0.9,0.7-4.5,0.9-1.8,1,1.9-2.5,10-25,11-15,13-18,15-20,15-30,2-6,2-foliate,2-locular,2.3-2.8,22-25,29-40,3-3.5,3-4,3.8-4.2,4-8,4.5-20,5-17,5-7,5-8,5-merou,6-7,6-8,7-14.5,7-9,8-10,8-14,abaxially,absen,acicular,across,adaxiall,adaxially,adult,alyx,andromonoecious,anvil-shape,apart,axe,ba,blade,branch,branche,brown,capitat,confined,cross-section,cylindrical,decimetre,deltate,densely,directed,distall,distributed,dm,eaf,eed,eglandular,entire,erect,exocarp,finger,flower,functional,geminat,gland-tipped,hair,half,heterostylous,interpetalar,juicy,juvenile,lamina,less,lobe,lobed,longer,lower,margin,mature,mesocarp,mid-point,midpoint,midrib,midvein,minute,moist,narrowly,nflorescence,oblique,orolla,pair,part,per,placenta,pore,porrect,pubescent,purple,rachi,ray,rhizomatous,ruit,sessile,shallowly,short,side,spaced,sparse,sparsely,sprawling,stalked,stellae,stellate-pubescent,straight,tal,tamen,tem,thick,throughout,time,tissue,transparent,triangular,unarme,unarmed,unit,upper,vary,vein,weakly,white,wide,x,yellowish,ympodial	arrangement,articulation,bark,capitate,color,connation,corolla,dehiscence,diminishing,distal,foetid,foliage,form,growth,height,history,interjected,leaflet,life,na,ovary,papillae,petiolule,position,pseudostipule,seed,shape,size,spacing,stem,straightnes,terminal,texture,trichome,tuber-bearing,young
258	wfo-0001027594	success	168	113	76	92	37	0.452	.1,0.3-1.2,0.6-1.4,0.9-2.5,1,1-2,2-2.2,2-5,3-4,4-5,4.7-6.8,acute,anther,apex,attenuate,bark,base,berry,bright,brown,calyx,capitate,closely,cm,corolla,dark,deltoid,distal,flattened-reniform,fleshy,fruiting,glabrous,globose,green,hard,immature,lateral,lavendar,leaf,lobed,long,maroon,minute,minutely,mm,oblanceolate,often,opposite,orange,ovary,pale,papillose,pedicel,petiole,pitted,poricidal,ripe,rounded,seed,shrub,simple,spaced,stem,stigma,straight,style,surface,tinged,tip,trichome,tube,uniseriate,white,x,yellow-tan,young	.2,.5,0.7-1,0.7-1.2,1.5-2,10-15,2-3,2.5,2.5-4,3/4,5-20-flowered,across,age,anthesi,ba,becoming,bi-lobed,body,branch,constriction,curved,decurrent,dia,difoliate,eaf,edicel,eed,elliptic,erect,especially,extending,filament,free,geminat,geminate,glandular,incrassate,interpetalar,junction,lenticellat,less,lobe,locule,lon,lower,main,major,margin,middle,minor,nflorescence,non-reproductive,oblong,obovate,obovoid,occasionally,older,one,ovate,overlappin,pair,paler,papillo,pore,portion,prominent,puberulent,raised,reflexed,reproductive,ruit,scar,shaped,shoot,sinus,slender,slightly,small,straggly,tall,tapering,tear-drop,thin,two,ud,unit,vein,way,widest,winged,woody,ympodial	5,arrangement,articulation,color,connation,dehiscence,diameter,diminishing,foetid,foliage,form,fruit,growth,height,history,inflorescence,interjected,leaflet,length,lenticellate,life,na,papillae,peduncle,perennial,petiolule,plant,position,prickle,pseudostipule,shape,size,spacing,straightnes,terminal,texture,tuber-bearing
259	wfo-0001027600	success	185	125	83	102	42	0.449	-10,1,1-14,1-2,1-4,1-5,10-,15-25,2-4.5,2-5,2.5-6,20-30,3-15,3-5-lobed,3-6,abaxially,acuminate,adaxially,along,apart,apex,apical,articulated,basal,base,calyx,campanulate,cm,collection,concave,cordate,cuneate,densely,diameter,ellipsoidal,except,fading,flattened,forked,fruit,glabrous,gland,greenish-white,leaf,leaving,lobe,long,main,midrib,minutely,mm,oblong,orange,pedicel,pedicellar,peduncle,petiole,pilose,pinnately,puberulence,puberulent,pubescent,purple,purplish,rarely,remnant,rounded,simple,stigma,style,subcoriaceous,surface,tree,truncate,tube,two,unbranched,unlobed,vein,white,yellow,yellow-green,young	-3,0.5-1,0.5-1.5,1.5-2,1.5-2.5,1/2-3/4,10-20,2-11,2-18,2-3,2-3.5,2-4,2-6,2.5-21,3-5,4-6,4-foliat,5-13,8-17,abruptly,absen,absent,acute,adaxial,adpressed,aggregate,ape,apiculate,axe,beyond,blade,brow,cell,channe,connective,coriaceous,cream,deltate,dilated,directed,distally,divided,eaf,eed,elliptic,entire,especially,exceeding,exserted,fleshy,flower,glabrescent,glandular-puberulent,laterally,lobed,lon,lower,margin,mature,moderately,narrowed,nflorescence,nther,obconical,obtuse,occasionally,older,orolla,ovate,ovoid,papillose,perfect,pilo,pore,puberulen,rachi,radiu,ruit,shorter,sinus,slightly,small,somewhat,spaced,sparsely,stamen,stone,strongly,tal,tem,thecae,time,tip,tomento,triangular,ud,unit,vary,wide,x,yellowish,ympodial	anther,arrangement,articulation,bark,color,connation,corolla,dehiscence,diminishing,distal,foetid,foliage,form,fruiting,growth,height,history,inflorescence,interjected,lateral,leaflet,length,life,na,ovary,papillae,perennial,petiolule,plant,position,prickle,pseudostipule,seed,shape,size,spacing,stem,straightnes,terminal,texture,trichome,tuber-bearing
260	wfo-0001027601	success	204	90	53	151	37	0.26	0-3,0.4-2,0.5-2,2-15,absent,accrescent,angularly,anther,apex,articulated,base,buff,calyx,chartaceous,cm,connivent,contiguous,diameter,ellipsoidal,elliptical,extra-axillary,fruit,fruiting,globose,inflorescence,lanceolate,lateral,leaf-opposed,length,lilac,mm,nearly,ovate,pale,pedicel,peduncle,perennial,petiole,plant,present,prickle,pseudo-racemose,red,reniform,reticulate,shrub,simple,stellate,stigma,style,surface,tube,yellow	%,.05,0-0.1,0-10,0-7,0.1-0.5,0.2-0.4,0.2-0.8,0.25-0.4,0.3-0.5,0.4-0.5,0.5-0.8,0.5-1,0.5-1.5,1-1.3,1-1.4,1-2,1-locular,1.5-2,1.6-5,10-16,13-25,2-6,2.3-4.3,2.5-3,2.5-6,2.6-4,3-5,3-6,3-7,3-foliate,4-10,5-merou,6-8,7-18,7-20,7-8,8-9,abaxially,absen,acicular,across,acuminate,acute,adaxiall,adaxially,adult,alyx,andromonoecious,apart,apparen,around,axe,ba,blade,branche,brown,capitat,confined,congested,cuneate,cylindrical,decimetre,deltate,densely,directed,distall,eaf,eed,eglandular,entire,erect,exocarp,filament,finger,flattened,flower,functional,geminate,glabrous,gland-tipped,green,hair,half,heterostylous,incomplete,index,juicy,lamina,less,lobe,lobed,lobing,long,longer,lower,margin,mature,mesocarp,midpoint,midrib,midvein,minute,narrow,nflorescence,oblique,obtuse,orolla,outer,part,per,placenta,pore,porrect,rachi,ray,rhizomatous,ruit,septum,sessile,shallowly,short,side,spaced,sparsely,stalk,stellae,stellate-pubescent,straight,strongly,succulent,tal,tamen,tem,thick,throughout,time,toward,unarme,unarmed,unbranched,unit,vary,vein,weakly,white,wide,wing,x,yellowish,ympodial	arrangement,articulation,bark,capitate,color,connation,corolla,dehiscence,diminishing,distal,foetid,foliage,form,growth,height,history,interjected,leaf,leaflet,life,na,ovary,papillae,petiolule,position,pseudostipule,seed,shape,size,spacing,stem,straightnes,terminal,texture,trichome,tuber-bearing,young
261	wfo-0001027606	success	192	100	63	129	37	0.328	0-0.2,0-4,0.3-0.8,0.3-1.2,1-2,1-5,2-4,4-6.5,6-8,7-10,absent,accrescent,acicular,anther,apex,articulated,base,broadly,calyx,chartaceous,cm,cuneate,diameter,directed,distally,extra-axillary,flattened,fruit,fruiting,globose,inflorescence,lanceolate,leaf,length,lilac,long,midvein,minute,mm,obtuse,ovate,pale,pedicel,peduncle,perennial,petiole,pinkish,present,prickle,pseudo-racemose,red,reniform,rostrate,scarcely,shrub,simple,stellate,stigma,straight,style,surface,tube,yellow	%,-10,0-1.5,0.2-0.3,0.2-2.5,0.2-4,0.4-0.5,0.5-0.75,0.5-1,0.7-0.9,1,1-1.5,1-2.5,1-7,1-locular,1.5-2.9,10-19,12-25,2,2-,2-3,2-5,2-5.5,2-7,2.5-4,3-10,3-4,3-4.1,3-foliate,4-11,5-merou,5.5-7,6-9,7-22,9-13,abaxially,absen,acute,adaxiall,adaxially,adult,alyx,apart,apparen,apparently,axe,ba,blade,branch,branche,branched,brown,cylindrical,deeply,depression,distall,dm,eaf,eed,entire,erect,exocarp,filament,finger,flower,geminat,glabrous,gland-tipped,green,grey,hair,half,incomplete,index,juicy,juvenile,lamina,less,lobe,lobed,lobing,longer,lower,margin,markedly,mature,mesocarp,mid-point,midpoint,narrowly,nflorescence,oblique,occasionally,orolla,pair,part,per,perfect,placenta,pore,pubescence,rachi,rhizomatous,ruit,septum,short,side,spaced,succulent,tal,tamen,tem,thick,thicker,throughout,time,triangular,truncat,unarme,unarmed,unbranched,unit,upper,usually,vary,vein,wide,x,ympodial	arrangement,articulation,bark,color,connation,corolla,dehiscence,diminishing,distal,foetid,foliage,form,growth,height,history,interjected,lateral,leaflet,life,na,ovary,papillae,plant,position,pseudostipule,seed,shape,size,spacing,stem,straightnes,terminal,texture,trichome,truncate,tuber-bearing,young
262	wfo-0001027607	success	167	118	81	86	37	0.485	.5,0.5-1,0.8-1,1,1-4,1.5-3,2-3,2-4,3-3.5,3/4,4-10-flowered,5-10,8-9,acuminate,acute,anther,apex,arching,area,bark,base,branch,brown,calyx,cm,corky,corolla,curling,dark,decurrent,deflexed,dry,elliptic,filiform,flattened,fruiting,glabrate,glabrous,globose,golden,green,lateral,leaf,lobed,long,material,minutely,mm,narrowly,opposite,ovary,ovoid-reniform,papillose,pedicel,petiole,pitted,plant,poricidal,raised,reddish-brown,shrub,simple,slightly,stem,stigma,straight,style,surface,tan,tip,treelet,trichome,tube,uniseriate,way,white,widened,winged,woody,x,young	.1,.25,0.25-0.5,0.5,1.2-1.5,2-2.5,2.5-3,5-7,age,anthesi,apar,aspect,ba,basal,becoming,berry,branche,deltoid,densely,dia,eaf,edicel,eed,ellipsoid,elongate,erect,evenly,except,exserted,f,filament,free,geminate,gently,giving,lamina,lenticellat,less,like,lobe,lon,lower,m.,main,middle,midrib,minute,narrow,nflorescence,non-reproductive,obovoid,occasionally,older,pagoda-like,pair,pore,portion,present,prominent,pubescent,rarely,reflexed,ruit,scar,shaped,short,slender,slight,small,soon,spaced,strongly,styl,tall,tapering,tear-drop,tub,ud,unifoliate,unit,vein,widening,widest,yellowish,ympodial,zig-zag	0.1,alternate,apart,arrangement,articulation,color,connation,dehiscence,diameter,flower,foetid,foliage,form,fruit,growth,height,history,inflorescence,interjected,leaflet,length,life,na,papillae,peduncle,perennial,position,prickle,pseudostipule,seed,shape,size,spacing,straightnes,terminal,texture,width
263	wfo-0001027613	success	238	103	66	172	37	0.277	0.1-0.6,0.2-1.6,0.5-0.6,2-5.6,2-7,36-70,5-18,7-12,9-10.5,accrescent,anther,apex,articulated,base,broadly,brown,calyx,campanulate,chartaceous,circular,cm,connivent,corolla,dark,diameter,extra-axillary,flower,fruit,fruiting,globose,green,herbaceous,inflorescence,lateral,length,lilac,long,minutely,mm,nearly,ovate,pale,pedicel,peduncle,per,petiole,plant,prickle,prostrate,purple,reniform,resprouter,reticulate,rotate,simple,somewhat,sprawling,stigma,streak,style,surface,tan,tube,unbranched,yellow,yellowish-green	%,.5,0-0.1,0.1-0.7,0.3-0.4,0.3-1,0.4-0.5,0.4-1,0.4-1.2,0.4-1.5,0.5-0.7,0.7-1.5,0.8-1.7,1-1.5,1-1.7,1-10,1-2,1-7,1.2-1.4,1.2-2,1.3-1.8,1.5-2,1.5-3,10-17,12-15,15-100,15-28,2-2.2,2-2.5,2-3,2-5,2-8,2-foliate,2-locular,2.3-2.6,20-50,3-4,3-5,3-6,30-100,4-5,4-7,4-8,4.5-9.5,5,5-6,5-8,5-merou,6-12.5,7-8,80-180,9-17,abaxially,absen,absent,abundant,acicular,across,acute,adaxially,adult,alyx,and/or,andromonoecious,anvil-shape,apart,armed,attenuate,axe,ba,bitter,blade,branche,capitat,clear,contiguous,cordate,cross-section,curved,cylindrical,decimetre,deltate,densely,directed,distall,distally,distributed,eaf,eed,eglandular,exocarp,filament,finger,flattened,functional,geminat,glabrous,gland-tipped,glandular,hair,half,heterostylous,index,inserted,interpetalar,juicy,lamina,less,lobe,lobed,lobing,lon,lonf,longer,lower,margin,markedly,mature,mesocarp,mid-point,midpoint,midvein,minute,moderately,moist,nflorescence,oblique,obtuse,orolla,part,placenta,pore,porrect,presen,present,pubescent,rachi,ray,ruit,sessile,shallowly,short,side,spaced,sparsely,stage,stalk,stalked,stellae,stellate,stellate-pubescent,straight,tal,tamen,tem,thick,thicker,throughout,time,tissu,tissue,transparent,triangular,unit,uvenile,vary,vein,watery,weakly,wide,x,ympodial	15,arrangement,articulation,bark,capitate,color,connation,dehiscence,diminishing,distal,foetid,foliage,form,growth,height,history,interjected,leaf,leaflet,life,na,ovary,papillae,petiolule,position,pseudostipule,seed,shape,size,spacing,stem,straightnes,terminal,texture,trichome,tuber-bearing,young
264	wfo-0001027618	success	202	117	77	125	40	0.381	1-13,1-23,1-5,1.5-7,11-22,2-11,2-11.5,2-9,3-18,3-30,4,4-8,5-7.5,6-25,8-35,abaxially,apart,apex,articulated,base,branched,campanulate,capitate,chartaceous,cm,compound,cordate,cuneate,densely,diameter,ellipsoidal,elliptic,elliptic-ovate,fruit,fusiform,glabrous,globose,greenish,lateral,laterally,leaf,leaflet,length,membranaceous,minutely,mm,near,oblong,obovate,orange,pedicel,peduncle,per,petiole,petiolule,pinnately,puberulent,pubescent-pilose,purple,reticulate,ripe,shrub,simple,small,stigma,style,sympodial,terminal,tree,truncate,tube,unbranched,unit,urceolate,white,x,yellow	-10,-pubescent,0-10,0.5,0.5-1,0.5-6,1,1-,1-1.5,1-14,1-3,1-9,1.4-4,1.5-13,1.5-3,1.5-8.5,11-16,11-pinnate,12-27,15-30,15-35,2-12,2-27,2-5,2-8.5,2.5-6,3-5,3-7,3-7-pinnate,3.5-6,5-18,5-20,5-30,5-merous,5.5-12,6-40,7-25,8-16,acuminat,acut,acute,adaxially,aggregate,also,alyx,ape,ascending,axe,basal,beyond,blade,bud,cell,connective,cylindrical,darker,deltate,dia,diamete,dilated,directed,distally,eaf,eed,entire,exceeding,exserted,fleshy,flower,leaving,less,lobe,lon,long,longitudinal,lower,margin,mesocarp,moderately,nflorescence,nther,obtu,obtuse,often,orolla,ovate,papillose,pedicellar,perfec,perfect,pilo,pilose,pore,presen,puberulent-pilo,puberulent-pubescent,pubescent,rachi,radiu,ranch,ratio,remnant,rown,ruit,runk,shallowly,shorter,slightly,sometimes,somewhat,spaced,sparsely,spreading,stamen,stone,stripe,tal,thecae,tomentose,triangular,uni,vary,wide,width,without	acuminate,anther,arrangement,articulation,bark,calyx,color,connation,corolla,dehiscence,diminishing,distal,foetid,foliage,form,fruiting,growth,height,history,inflorescence,interjected,life,na,ovary,papillae,plant,position,prickle,pseudostipule,seed,shape,size,spacing,stem,straightnes,surface,texture,trichome,tuber-bearing,young
265	wfo-0001027622	success	203	144	107	96	37	0.527	0-14,0-16,0.3-10,1-10,1-2,1.5-3.5,1.5-4.2,1.6-4.5,2-25,2-6,3-16,3-4.5,3.5-11,4-9.5,5-11,6-17,6-7,abaxially,adaxially,anther,articulated,axillary,base,berry,blue,blue-purple,broadly,brownish,bud,cell,clavate,cm,condition,connivent,corolla,covering,diameter,distal,drying,elliptic,elliptical,forked,fresh,fruit,glabrescent,globose,green,green-white,greenish,hair,hair-like,herb,interjected,lanceolate,lateral,leaflet,lengthening,light,like,make,middle,mm,mottled,mucilaginous,narrowly,oblique,odd-pinnate,ovate,ovoid,pale,pedicel,peduncle,pentagonal,petal,petiole,petiolule,plant,pore,poricidal,pubescent,purple,rounded,seed,size,slightly,slit,star,stellate,stem,stigma,straight,striped,style,subglabrous,subtending,terminal,testal,thick,throughout,tip,truncate,tube,wall,wet,whitish,x,yellow	.5,1,1/,12-23,2-3,2.5-3.5,3-4,4-5,5-merou,8-16,8-20,acumen,acuminate,acute,ag,along,alyx,apart,apex,apparently,axe,blade,borne,capitat,chartaceous,ciliate,decumben,different,digestion,dorsally,eaf,edge,eed,end,enzyme,erect,especially,exceeding,except,filament,flat,flower,folded,geminat,generally,glabrou,glabrous,greatly,half,homostylous,honeycomb-shaped,living,lobe,long,lower,margin,membranous,midrib,minutely,nflorescence,often,orolla,ovate-lanceolate,pair,perfect,plurifoliate,population,proximal,puberulent,reduced,removed,ruit,seudostipule,shortly,singly,sometimes,spaced,specimen,stamen,ste,stolo,subequal,tall,tamen,tem,tri-,tuber,typically,unit,unwinged,usually,vary,varying,wide,wing,ympodial	1/3,age,arrangement,articulation,bark,calyx,capitate,color,connation,dehiscence,diminishing,foetid,foliage,form,fruiting,growth,height,history,inflorescence,leaf,length,life,na,ovary,papillae,position,prickle,pseudostipule,shape,spacing,straightnes,surface,texture,trichome,tuber-bearing,ye,young
266	wfo-0001027624	success	189	98	63	126	35	0.333	0-7,0.1-0.9,0.3-1,0.4-3,0.5-1.5,0.8-5.6,1-2,1.1-8.4,1.5-6.6,2.9-12,3-10,3-5,4-15.2,4-7,5-9,9-41,anther,articulated,base,clavate,cm,connivent,corolla,deep,densely,diameter,elliptic,forked,fruit,globose,green,greenish,herb,interjected,lanceolate,lateral,leaf,leaflet,mm,mucilaginous,odd-pinnate,ovate,ovoid,pedicel,peduncle,pentagonal,petiole,plant,poricidal,pubescent,purple,rotate,seed,size,stigma,straight,style,terminal,tip,tube,whitish,x,yellow	0-3,1-3,1-5,1.2-2.6,1.3-2.9,2-20,2-5,2-7,2.4-4.8,3-11,3-4,4-8,5-merou,6-18.5,abaxially,acuman,acumen,acuminate,acute,adaxially,ag,along,alyx,apart,apex,apparently,arranged,axe,axillary,bead,berry,blade,brownish,bud,capitat,cell,condition,considerably,covering,cuneate,decreasing,decumben,decurrent,digestion,distal,dorsally,drying,eaf,edge,eed,entirely,enzyme,erect,exceeding,filament,flat,flower,folded,fresh,geminat,glabrou,glabrous,green-white,hair,hair-like,half,homostylous,honeycomb-shaped,larger,leave,lengthening,light,like,living,lobe,long,lower,make,middl,moniliform,mottled,multiple,necklace,nflorescence,onto,orbicular,orolla,pair,perfect,plurifoliate,pore,present,rachi,removed,ruit,sessile,seudostipule,short,slightly,slit,sometimes,spaced,specimen,stamen,stolon,subtending,tall,tamen,tem,testal,thick,throughout,toward,tri-,tuber,typically,unit,unwinged,usually,vary,wall,wet,white,wide,widely,ympodial	arrangement,articulation,bark,calyx,capitate,color,connation,dehiscence,foetid,foliage,form,fruiting,growth,height,history,inflorescence,length,life,middle,na,ovary,papillae,position,prickle,pseudostipule,shape,spacing,stem,straightnes,surface,texture,trichome,tuber-bearing,ye,young
267	wfo-0001027626	success	152	89	52	100	37	0.342	.3,.5,1,8,along,anther,arrangement,calyx,chartaceous,clavate,cm,color,cordate,coriaceous,diameter,distichous,distinct,elliptical,extra-axillary,fleshy,flower,frequently,fruit,greenish-white,leaf-opposed,liana,line,membranous,mm,moderately,nearly,ovate,pedicel,peduncle,petiole,possibly,pubescent,rachi,shrub,slender,somewhat,sparsely,spindle-shaped,stellate,stigma,style,terminal,trichome,unbranched,unknown,white,x	0.1–0.2,0.2–0.6,0.5-1,0.5–1,0.7–1,0.7–2.8,1.3–4.5,1.5–2,1.5–8,13–14,14–116,2–3,2–49,2–5,3–4,3–4.5,3–5,3–55,4.4–11,4–6,5-merous,5–6,9–18,abaxially,accrescen,acuminate,acute,adaxially,alyx,apar,apex,axe,base,berry,blade,broadly,c.,capitat,center,ciliat,climbing,densely,distant,eaf,eed,entire,filament,fruiting,glabrou,glabrous,immature,lamina,lanceolate,lobe,long,lower,m.,margin,maturity,midvein,minutely,mor,nflorescence,nternode,oblique,orolla,pair,perfec,petal,pinnate,plurifoliat,pointed,reflexed,rounded,ruit,sand-punctat,sand-punctate,scandent,scar,secondary,seen,shortly,side,simple,spaced,ste,tamen,tem,time,tip,truncate,tube,two,unit,vary,vein,venation,wide,wiry-woody,ympodial	0.1-0.2,0.2-0.6,0.7-1,0.7-2.8,1.5-2,1.5-8,13-14,2-49,2-5,3-4,3-5,3-55,5-6,apart,capitate,corolla,dehiscence,form,frequency,growth,height,history,inflorescence,internode,leaf,length,life,na,perennial,plant,position,seed,shape,spacing,stem,surface,texture
268	wfo-0001027627	success	245	128	80	165	48	0.327	abaxially,accrescent,acuminate,adaxially,anther,apart,apex,articulated,base,bifurcate,branched,broadly,brown,calyx,cm,cordate,corolla,densely,diameter,distal,extensively,extra-axillary,flattened-reniform,fruit,glabrescent,globose,green,lateral,lavender,leaf,lighter,linear,long,loosely,minutely,mm,much,narrowly,near,obtuse,occasionally,ovary,ovate,pedicel,peduncle,petiole,pitted,present,prickle,pubescent,purple,rounded,short,shrub,simple,slender,small,smaller,sparsely,stalked,stellate,stellate-tomentose,stem,stigma,style,subeaqually,surface,tapering,tardily,time,tomentose,tree,triangular,tube,unequally,violet,weakly,wide,yellow,young	.1,.5,0.05–0.25,0.1–1,0.3,0.4,0.6–1,0–,1.5,1.5–2,1.5–2.5,1.8–2.5,11–14,12–25,13–17,1–1.5,1–5,2,2.5–4,2–15,2–4,2–5,2–6,3.5,3–3.5,3–6,4–,4–12,5-angled,5-merou,5–7,6–,6–15,7–10,7–15,9,9–13,9–15,abundant,across,along,alyx,ampliate,apparently,ascending,axe,ba,band,based,becoming,berry,blade,borne,branch,briefly,broad,bud,c.,capitat,caudate,central,chartaceous,contiguous,dense,difoliate,distally,eaf,eed,entire,erect,evident,except,exposed,fertile,filament,filiform,flower,flowering,free,geminat,glabrous,grayish,growt,hair,half,high,homostylous,internode,interpetalar,interwoven,juvenile,larger,like,line,linear-lanceolate,lobe,longer,lower,major,margin,middle,midpoint,midvein,minor,minute,mostly,narrow,nearly,nflorescence,numerous,oblong,often,ovoid,paired,par,portion,principal,prominently,pubescence,ray,recurved,reduced,ruit,scattered,shallowly,shorter,side,single,sinuate,sinus,sometimes,somewhat,spaced,sparse,splitting,spreading,stalk,stellae,stellate-pubescent,stellate-tomento,stellate-velvety,stemmed,stipe,stout,tamen,tawny,thick,thickened,tip,tissue,trunk,ud,unarmed,usually,vein,velvety,visible,yello,ympodia,zone,×,×1.5–1.7,–2.5,–30,–5	-2.5,0-2-15,0.6-1,1-5,1.5-2,13-17,2-4,2-6,3-6,5,5-merous,7-15,9-13,arrangement,articulation,bark,capitate,color,connation,dehiscence,diminishing,foetid,foliage,form,fruiting,growth,height,history,inflorescence,interjected,leaflet,length,life,na,papillae,petiolule,plant,position,pseudostipule,seed,shape,size,spacing,straightnes,terminal,texture,trichome,tuber-bearing
269	wfo-0001027630	success	149	87	50	99	37	0.336	0.5-1.2,0.5-2,1-5,1.5-2,4-6,acute,anther,apart,apex,bark,base,calyx,climbing,cm,corolla,fruit,fruiting,glabrate,globose,golden,green,hirsute,lanceolate,lateral,leaf,linear,lobed,long,long-acuminate,minutely,mm,opposite,ovary,papillose,partially,pedicel,petiole,poricidal,shrub,simple,stem,stigma,straight,style,terminal,trichome,tube,uniseriate,white,young	.1,.2,.5,0.05-0.1,0.5-1,1-1.5,1.4-1.7,2-3,2-6-flowered,3/4,5.5-11.2,6-10,8-9,also,anthesi,arising,beginning,berry,blunt,branchlet,broadly,ciliate,de,decurrent,deflexed,deltoid,densely,dia,distinguishable,eaf,edicel,eed,elongat,erose,except,extreme,filament,free,glabrous,globo,immature,indistinct,inflorescenc,internodal,irregularly,knob-like,known,lobe,lon,lower,main,margin,middle,midrib,near,nflorescence,novo,occasionally,older,pair,paler,pore,portion,prominent,proximal,puberulent,pubescent,raised,reflexed,rest,rounded,ruit,scar,seen,shaped,slender,spaced,sparsely,strongly,swollen,tall,tapering,tear-drop,thickened,ti,tip,ud,ultimate,unifoliat,unit,vein,way,wide,widest,wing,winged,x,yellowish,ympodial	alternate,arrangement,articulation,color,connation,dehiscence,diameter,diminishing,distal,foetid,foliage,form,growth,height,history,inflorescence,interjected,leaflet,length,life,na,papillae,peduncle,perennial,petiolule,plant,position,prickle,pseudostipule,seed,shape,size,spacing,straightnes,surface,texture,tuber-bearing
270	wfo-0001027646	success	166	92	51	115	41	0.307	0-0.1,0.2-1.1,1-3,2-4,5-10,absent,acuminate,acute,anther,apex,articulated,base,blade,calyx,chartaceous,cm,cuneate,diameter,extra-axillary,flattened,fruit,fruiting,glabrous,globose,green,hair,inflorescence,lateral,length,midrib,mm,obtuse,ovate,pale,pedicel,peduncle,perennial,petiole,present,prickle,red,reniform,shrub,simple,sparsely,stellate,stellate-pubescent,style,unarmed,unbranched,yellow	%,.4,0-0.2,0-1,0-10,0-2,0.1-0.25,0.15-0.25,0.4-0.5,0.4-0.6,0.5-0.6,0.6-0.7,0.7-1.2,0.7-1.5,0.7-2,1,1-2,1-6,1-locular,10-18,15-20,2-6,2-foliate,2.1-3.2,3.5-4,4-11,5-merou,6-13,6-7,6-8,abaxially,absen,acicular,across,adaxiall,adaxially,adult,alyx,apart,axe,ba,branche,brown,confined,cylindrical,densely,directed,distall,dm,eaf,eed,eglandular,entire,erect,finger,flower,functional,geminat,gland-tipped,grey,half,incomplete,juicy,lamina,less,lobe,long,longer,lower,margin,mature,mesocarp,midpoint,midvein,minute,moderately,multiradiate,nflorescence,oblique,onl,orolla,part,per,pore,porrect,probably,pseudo-umbellate,ray,rhizomatous,ruit,septum,short,solitary,spaced,stage,stalk,stellae,straight,succulen,tal,tamen,tem,thick,throughout,time,transparent,unarme,unit,unknow,uvenile,vary,wide,x,yellowish,ympodial	arrangement,articulation,bark,color,connation,corolla,dehiscence,diminishing,distal,foetid,foliage,form,growth,height,history,interjected,leaf,leaflet,life,na,ovary,papillae,petiolule,plant,position,pseudostipule,seed,shape,size,spacing,stem,stigma,straightnes,surface,terminal,texture,trichome,tube,tuber-bearing,width,young
271	wfo-0001027661	success	222	125	91	131	34	0.41	+,-10,0.5-,0.5-2,1-1.5,1-5,1-7,5-9,6-12,8-10,anther,apart,apex,articulate,base,branch,branched,bright,calyx,capitate,cm,column,connivent,cordate,corolla,deeply,dendritic,diameter,ellipsoid,extremely,flattened,fruiting,fused,glabrous,globose,green,grey,growth,herbaceous,hue,lateral,leaf,lobed,many,minutely,mm,moderately,pale,pedicel,peduncle,petiole,pinnatifid,pitted,poricidal,pubescent,purple,purplish,red,reniform,ripe,shape,short,simple,single,size,sleeve,small,stellate,stem,stigma,style,surface,tan,terminal,ternately,tightly,time,tip,trichome,truncate,tube,uniseriate,variable,vine,violet,way,white,woody,yellow,yellowish,¾	0.5,0.6-1.1,0.6-1.5,1-,1.2-6,1.3,1.5,1.5-2,2,2.5-3,2.5-7,30,4-15,4-8-celled,4.5-6,40,5-merou,6-8,6-9,<,>,abaxially,acuminate,acute,adaxiall,ag,along,alyx,anthesi,ark,axi,basal,berry,broadly,cell,commonly,conical,creeping,densely,denser,density,eaf,eed,elliptic,entire,even,filament,flower,free,gre,ground,ilament,irregularly,lamina,leaf-opposed,leaving,lengthening,like,lobe,long,long-exserted,lower,margin,markedly,membraneous,minute,mixture,narrowing,near,new,nflorescence,occasionally,often,older,open,orolla,outline,ovate,pair,papillat,papillate,papillo,peg,pentagonal,per,perfect,pericarp,plurifoliat,pointed,pore,portion,primary,prominent,pubescen,pubescence,rachi,rarely,reflexed,ruit,scar,shiny,sinus,slender,slit,spaced,sparsely,spot,spreadin,spreading,strongly,swollen,tangled,tem,testa,thin,trailing,triangular,turbinate,two,type,ud,underground,unieriate,unit,upper,usually,vary,vein,wide,ympodial,zig-za	1-15,arrangement,articulation,bark,color,connation,dehiscence,diminishing,distal,foetid,foliage,form,fruit,height,history,inflorescence,interjected,leaflet,length,life,na,ovary,papillae,petiolule,plant,position,prickle,pseudostipule,seed,spacing,straightnes,texture,tuber-bearing,young
272	wfo-0001027714	success	251	122	89	162	33	0.355	+,0.4,0.5,1-1.6,1.5-2,1.5-5,14-16,5,5-10,7-20,acuminate,acute,almost,anther,apex,articulated,base,berry,branched,bright,brown,calyx,capitate,cm,connivent,cordate,corky,corolla,deep,diameter,ellipsoid,elliptic,elongate,flattened,fruit,fruiting,glabrous,globose,growth,inflorescence,juicy,lateral,leaf,loosely,many,minutely,mm,obovate,occasionally,often,ovary,pale,pedicel,peduncle,petiole,petiolule,pitted,poricidal,purple,red,reddish,reniform,ripe,seed,shiny,simple,sleeve,small,somewhat,stellate-rotate,stem,stigma,style,surface,tangled,terminal,time,tiny,tip,trichome,truncate,tube,uniseriate,vine,violet,weak,woody,yellow,yellowish	.5,/3,0,0.5-0.7,0.6-0.7,0.9-1.5,1,1-,1-1.5,1-2,1.5-2.5,1.5-3,2-,2-2.5,2-8,2.5-,2.5-4,2373.,3-3.5,4-10,4-5,4.5-5,5-6,5-merou,6-7,80,<,abaxial,abaxially,adaxial,adaxially,age,aid,along,alyx,angle,anthesi,apar,apice,appearance,ark,around,axi,basal,canop,cell,channelled,climbin,confined,conical,connected,creating,cucullate,cupped,deflexed,dendritic,densely,denser,drying,eaf,eed,enlarged,entire,especially,exserted,fide,filament,fleshy,flower,free,furcate,giving,glabrate,glabrou,groove,hairy,hanging,ilament,immature,individual,inflated,irregularly,lamina,large,leaving,lengthening,like,lobe,lobed,lon,long,longer,lower,margin,marginal,mature,mere,minute,mpodial,nee,new,nflorescence,nodding,older,orolla,otherwise,outline,pair,papillate,papillo,peg,per,perfect,pericarp,petal,pinnatifid,plat,plurifoliat,pore,portion,primary,prominent,pubescence,pubescent,reaching,rectangular,rim,ruit,scar,showy,similar,slender,slightly,slit,spaced,sparsely,spreading,strongly,tem,testa,testal,thecae,thick,thickened,thin,third,tooth,twining,ud,uniformly,unit,upper,usually,vein,visible,wall,way,weight,widest,wing,x,younger	apart,arrangement,articulation,bark,color,connation,dehiscence,diminishing,distal,foetid,foliage,form,height,history,interjected,leaflet,length,life,na,papillae,papillose,plant,plate,position,prickle,pseudostipule,shape,size,spacing,straightnes,texture,tuber-bearing,young
273	wfo-0001027719	success	172	129	88	84	41	0.512	0-7,0.15-0.4,0.25-0.4,0.25-0.6,0.3-0.5,0.3-0.7,0.4-1.7,0.6-0.8,0.6-2.8,0.8-1,0.9-1.1,1-1.5,1-2,1-3,1.1-2,1.6-1.9,10-24,13-20,3-5,3-7.5,30-70,4-5,4-6,4-7,4.5-12.5,5-6,5-8,6-10,6-8,7-11,8-13,across,acute,anther,apart,apex,articulated,base,broadly,calyx,chartaceous,cm,cuneate,diameter,erect,extra-axillary,flower,fruit,fruiting,globose,green,herbaceous,inflorescence,lateral,length,lilac,lobed,long,longer,midpoint,mm,oblique,obtuse,ovate,pale,part,pedicel,peduncle,per,petiole,plant,prickle,pseudo-racemose,ray,resprouter,shallowly,simple,solitary,sprawling,stem,style,thick,time,tube,unbranched,wide,x,yellow	%,.25,0-0.15,0-0.2,0-1,0-20,13-25,2-2.3,3-7,5-merou,abaxially,absent,acicular,adaxiall,adaxially,alyx,andromonoecious,armed,attenuate,axe,ba,blade,brown,d.,densely,difoliate,directed,distall,distributed,dult,eaf,eed,eglandular,entire,exocarp,finger,functional,geminat,gland-tipped,greenish-white,hair,half,heterostylous,hig,juic,lamina,less,lobe,lower,margin,mature,mesocarp,mid-point,midvein,minute,moist,nflorescence,orolla,pore,porrect,presen,present,ruit,sessile,short,spaced,sparsely,stage,stalk,stellae,stellate,stellate-pubescent,straight,strongly,tamen,throughout,unarme,unit,unknow,uvenile,vary,vein,white,ympodial	5-merous,7-7.5,arrangement,articulation,bark,color,connation,corolla,dehiscence,diminishing,distal,dm,foetid,foliage,form,growth,height,history,interjected,leaf,leaflet,life,na,ovary,papillae,petiolule,position,pseudostipule,seed,shape,size,spacing,stigma,straightnes,surface,terminal,texture,trichome,tuber-bearing,unarmed,young
274	wfo-0001027720	success	184	97	60	124	37	0.326	0.25-0.35,0.5-0.8,1-2,1-3.5,1.5-2,2-4,2-7,2-branched,4-7,7-8,absent,acute,anther,apex,articulated,base,calyx,chartaceous,cm,connivent,cuneate,diameter,elliptic,extra-axillary,flattened,fruit,fruiting,globose,half,inflorescence,lanceolate,lateral,leaf,length,less,lilac,loosely,mature,mm,notched,ovate,pale,pedicel,peduncle,perennial,petiole,present,prickle,red,shrub,simple,slightly,stellate,stigma,straight,style,subreniform,surface,tube,yellow	%,.25-0.3,0,0-15,0.15-0.25,0.3-5,0.4-0.7,0.4-0.8,0.5-1,0.6-1.2,0.8-1,1-1.5,1-locular,13-23,13-35,15-25,2-3,2-foliate,2.8-3.1,23-35,3-13,4-,4-5.5,4.3-15,4.3-7.5,5-merous,6,7-10,7-9,8-11,8-16,9-15,abaxially,absen,adaxiall,adaxially,adult,alyx,apparently,axe,ba,berry,blade,brown,capitat,confined,cylindrical,deltate,densely,directed,distall,distally,eaf,eed,eglandular,entire,erect,filament,finger,flower,geminat,glabrous,gland-tipped,green,hair,hig,homostylous,incomplete,intepetalar,juicy,juvenile,lamina,lobe,long,lower,margin,markedly,mesocarp,mid-point,midpoint,midrib,minute,narrowly,nflorescence,oblique,orolla,part,per,perfec,perfect,pore,porrect,pubescent,rachi,ray,rhizomatous,ruit,scarce,septum,sessile,short,sparsely,stellae,stellate-pubescent,succulen,tamen,tem,thick,thicker,time,tissue,toward,triangular,unarme,unarmed,unit,upper,vary,white,wide,without,x,yellowi,ympodial	arrangement,articulation,bark,capitate,color,connation,corolla,dehiscence,diminishing,distal,foetid,foliage,form,growth,height,history,interjected,leaflet,life,na,ovary,papillae,petiolule,plant,position,pseudostipule,seed,shape,size,spacing,stem,straightnes,terminal,texture,trichome,tuber-bearing,young
275	wfo-0001027720	success	272	121	81	191	40	0.298	.2,1/2,2.0,acuminate,acute,anther,apex,apical,apiculate,attachment,attenuate,base,bilobed,broad,calyx,cancellate,capitate,cm,conical,connivent,corolla,curved,dehiscence,diameter,dry,elliptic,flattened-irregular,flattened-orbicular,flattened-reniform,flower,fruit,globose,growth,hooked,large,lateral,lavender,leaf,lobe,long,major,minute,mm,nearly,notched,occasionally,often,orange,ovate,pedicel,peduncle,petiole,point,pore,ray,red,short,shrub,simple,slightly,small,stellate,stem,stigma,straight,style,subacute,subcoriaceous,surface,tall,tip,toward,tree,truncate,tube,violet,yellow,yellow-ferruginous,yellow-tan,±equal,×	.0,.04,.3,.5,.9,0,0.1–0.6,0.2–0.4,0.3–0.4,0.7–0.9,0.7–1.1,0.7–1.2,0.8–1.3,0.8–1.9,0.8–2.0,0.9,1.4–1.9,1.5–1.7,1.5–2.0,1.5–2.5,1.5–3.3,1.5–9.0,1.7–1.8,1.7–2.0,1.7–2.5,1.8–2.0,1.9–2.2,1/3,1/3–1/2,10.0,10.8–18.2,12–16,13.0,19.7–30.0,2.5,2.5–2.8,2.5–2.9,2–3,3.2,3.6,3.7–5.7,3.9,4.0–12.6,4.0–18.0,4–5-merou,5.1–18.6,6.5–9.5,6–8,8.0,8.0–11.9,8.2–10.5,8.5–9.4,9.5–16.0,abaxially,adaxially,adnate,aequilateral,alyx,anthesi,apparently,appearing,armed,articulated,axe,ba,becoming,berry,blade,branch,broad-based,brochidodromous,bud,channel,channeled,colore,concave,congested,cream,crisped,deciduous,densely,dentate,developed,difoliate,distally,dorsally,eaf,eed,either,emerging,endocarp,entire,erect,especially,exocarp,extra-axillary,fertile,filament,filiform,free,geminat,glabrous,glandular,glossy,gradually,hair,heavily,homostylous,inclined,increasing,internode,interpetalar,intersepalar,juic,juvenile,lamina,least,like,line,lon,longer,lower,m.,margin,mature,midpoint,midrib,midvein,minor,moderately,narrowly,nflorescence,oblique,oblong,orolla,part,per,perforate,poorly,porrect,porrect-stellate,portion,potentially,presumably,prickle,proximal,pubescent,raised,reflexed,rigid,rip,row,ruit,scattered,sessile,shorter,side,sinus,soon,sparsely,splitting,spread,stamen,stellae,stellate-pubescen,stellate-pubescent,suture,tamen,tem,thin,time,tissue,translucent,triangular,twice-branched,two,ud,unarmed,upper,vary,vein,wavy,way,weakly,white,wide,yellow-ferruginou,ympodia,young,youngest,–4	1.4-1.9,1.5-2.5,1.5-3.3,1.5-9.0,19.7-30.0,2-3,4,4.0-12.6,5.1-18.6,6-8,6.5-9.5,9.5-16.0,arrangement,bark,color,connation,diminishing,distal,form,height,history,inflorescence,interjected,leaflet,length,life,na,ovary,papillae,petiolule,plant,pseudostipule,seed,shape,size,spacing,straightnes,terminal,texture,tuber-bearing
276	wfo-0001027735	success	166	88	46	120	42	0.277	.75,0.5-0.8,1.3-3.5,1.7-3.5,1.9-2.2,2-2.5,8-11,acuminate,acute,anther,apart,apex,articulated,base,calyx,chartaceous,cm,diameter,extra-axillary,fruit,fruiting,inflorescence,lateral,length,long,mm,obtuse,ovate,pale,pedicel,peduncle,perennial,petiole,present,prickle,pseudo-racemose,rotate-stellate,shrub,simple,stellate,style,time,tube,white,wide,yellow	%,.7,0-0.1,0-1,0-4,0-5,0.15-0.2,0.25-0.5,0.3-0.6,0.4-0.8,0.5-3,1,1-2,1.3-1.6,10-14,11-17,12-15,2-3.5,2-8,2.5-3,20-35,25-50,3-8,3.5-5,30-50,4-5,4-6,4-8,5,5-5.8,5-merou,7-10.5,9-12,abaxially,absent,abundant,acicular,across,adaxially,adult,alyx,armed,attenuate,axe,ba,blade,branche,brown,directed,distall,distributed,dm,eaf,eed,eglandular,erect,finger,flower,geminat,glabrou,gland-tipped,globo,green,hair,half,index,lamina,less,lobe,lobed,lobing,longer,lower,margin,mature,mid-point,midpoint,midvein,minute,moderately,nflorescence,oblique,orolla,part,per,pinkish,pore,porrect,presen,purpl,ray,rhizomatous,ruit,sessile,shallowly,short,side,spaced,sparse,sparsely,stage,stalk,stellae,stellate-pubescent,straight,tal,tamen,tem,thick,throughout,transparent,unarme,unbranched,unctional,unit,unknow,uvenile,vein,x,ympodial	arrangement,articulation,bark,color,connation,corolla,dehiscence,diminishing,distal,foetid,foliage,form,globose,growth,height,history,interjected,leaf,leaflet,life,na,ovary,papillae,petiolule,plant,position,pseudostipule,purple,seed,shape,size,spacing,stem,stigma,straightnes,surface,terminal,texture,trichome,tuber-bearing,unarmed,young
277	wfo-0001027742	success	239	113	76	163	37	0.318	-20,0.1-0.5,0.5-5,1-8,2.5-5,3-6,3-9,3.5-10,4-lobed,5-12,7-10,accrescent,acute,annual,anther,apex,articulated,attenuate,base,black,broadly,brown,calyx,chartaceous,cm,connivent,cordate,depressed,diameter,drying,enclosing,especially,extra-axillary,finally,fruit,fruiting,globose,inflorescence,ivory-green,lanceolate,lateral,length,lilac,long,loosely,margin,mature,minutely,mm,obtuse,ovate,ovate-lancelate,pale,pedicel,peduncle,perennial,petiole,prickle,pseudo-racemose,purple,reticulate,rostrate,shrub,simple,somewhat,square,stellate-pentagonal,stem,stigma,style,surface,toward,truncate,tube,yellow,yellowish-green	%,-13,-8,-9,0-0.2,0-0.8,0-1.1,0-12,0-3.5,0-9,0.05-0.1,0.1-0.4,0.4-0.8,0.6-0.8,0.6-0.9,0.7-0.9,0.8-1.8,1-,1-1.1,1-1.2,1-1.5,1-1.8,1-2,1-3,1-4,1-5,1.7-2,10-18,10-20,2-,2-2.3,2-2.5,2-3,2-5,2-5.5,2-6,2-foliate,200-660,25-55,3-4,3-5,3.5-9.5,4-6,4-locular,5-merou,60-300,7-8,7-9,9-14,abaxially,absent,abundant,acicular,adaxiall,adaxially,alyx,anthesi,anvil-shape,apart,armed,axe,ba,bent,blade,broad,capitat,cone,cross-section,curved,cylindrical,decimetr,densely,directed,distall,distally,distributed,dult,eaf,eed,eglandular,entire,erect,exceeding,exocarp,filament,finger,flower,geminat,glabrous,gland-tipped,grey-green,hair,homostylous,index,interpetalar,juicy,lamina,lobe,lobed,lobing,lon,longer,lower,markedly,mesocarp,mid-point,midpoint,midvein,minute,moderately,moist,nflorescence,oblique,one,orolla,outside,part,per,perfect,placenta,pore,porrect,presen,present,prostrate,rachi,ray,rhizomatous,rounded,ruit,rusty,shallowly,short,side,slightly,spaced,stage,stalk,stalked,stellae,stellate-pubescent,straight,strongly,tal,tamen,thick,thicker,thicknes,throughout,time,tip,tissue,unbranched,unit,unknow,uvenile,vary,vein,white,wide,x,yellowish,ympodial	arrangement,articulation,bark,capitate,color,connation,corolla,dehiscence,diminishing,distal,foetid,foliage,form,growth,height,history,interjected,leaf,leaflet,life,na,ovary,papillae,petiolule,plant,position,pseudostipule,seed,shape,size,spacing,straightnes,terminal,texture,trichome,tuber-bearing,young
278	wfo-0001027757	success	186	90	52	134	38	0.28	12,acute,anther,anthesi,apart,apex,base,blue,branching,brown,calyx,campanulate,clavate,cm,dark,deeply,diameter,erect,flattened,fruit,glabrous,globose,leaf,lilac,longitudinal,mm,moderately,oblong,obtuse,opening,ovate,pale,pedicel,peduncle,perennial,petiole,pitted,poricidal,pubescent,rotate,shrub,simple,slit,stigma,style,surface,tip,unbranched,unknown,violet,x,yellow	0.2,0.2–0.3,0.3–2.0,0.5,0.6,0.6–1.0,0.7,0–1.4,1.0–1.1,1.0–2.5,1.2–4.0,1.5–1.6,1.5–2.5,1.6–2.4,1.9–2.7,1–1.5,1–11,1–2,1–3,2,2.5,2.5–4,2.5–5.5,2.5–7,2–,2–10,3–12,3–5,4–9,5,5–,60–100,6–9,7–8,8–16,abaxially,absen,accrescent,adaxiall,adaxially,ag,along,apical,arising,articulated,axe,axillary,ba,basal,blade,borne,cell,chartaceous,colour,concave,connivent,convex,cylindrical,decurrent,densely,directed,distally,eaf,eed,elliptic,entire,equal,erose,filament,fleshy,flower,geminat,glabrescen,glabrou,hair,irregularly,lanceolate,leafy,lobe,lobed,lon,long,lower,m.,margin,multicellular,narrowly,nflorescence,occasionally,often,opposed,orolla,pair,perfect,plurifoliate,pore,primary,probably,regularly,rootstock,ruit,secondary,serrate,shoot,side,smaller,sometimes,spaced,sparsely,stone,straight,tall,tamen,tem,thic,thickened,time,toward,tube,unicellular,uniseriate,unit,vary,white,wide,woody,ympodial,–19,–2.7,–3.2,–4.0,–5.5,–6,–9	0-1.4,0.2-0.3,2-10,2.5-4,3-12,4-9,5-8,60-100,8-16,age,arrangement,color,corolla,decurren,dehiscence,diminishing,distal,form,growth,height,history,inflorescence,interjected,lateral,leaflet,length,life,na,petiolule,plant,pseudostipule,seed,shape,size,spacing,stem,terminal,texture
279	wfo-0001027765	success	167	128	107	60	21	0.641	-4,-44,0.8,1-,1-10,1-11.5,1-5,1.5-6,10-13,2-3,2-4,2.5-4.2,20-30,3-12,5-6,7-20,abaxial,abruptly,acuminate,acute,apex,apical,apically,articulate,base,branched,calyx,cell,cm,connate,cordate,corolla,covering,cyme,dehiscent,diameter,dichasial,dichasially,diminishing,distal,ebracteate,elliptic-lanceolate,forked,generally,glandular,globose,green,green-white,hair,hair-like,half,herbaceous,honeycomb,interjected,introrse,lateral,leaf,leaflet,light,lobe,long,maturing,mm,monochasial,oblique,obtuse,odd-pinnate,often,ovate,ovate-elliptic,ovate-lanceolate,ovoid,pattern,pedicel,peduncle,perennial,petiole,pilose,plant,poricidally,proximal,rounded,seed,short,side,simple,size,slightly,slit,stellate,stigma,style,terminal,testal,thick,throughout,tip,tone,toward,truncate,tuber-bearing,violet,wall,white,wide,yellow,¼	-30,0-.,1,1-2,1-4,2-2.5,2.5-4,3-,3-20,3-6-foliat,5,5-15,5-8,abaxially,acumen,apiculate,cuneate,digestion,dorsally,eaf,edge,eed,elliptic,emoval,enzyme,exceeding,filament,flat,flower,folded,globo,living,lon,lower,lunat,make,mucilaginous,nflorescence,nther,orolla,pair,perfect,petiolate,petiolule,plan,reveal,ruit,sessile,seudostipule,specimen,stamen,straight,tal,tem,throughou,typically,unit,vary,without,ympodial	0-2,anther,arrangement,color,dehiscence,form,fruit,growth,height,history,inflorescence,length,life,lunate,pseudostipule,shape,spacing,stem,surface,texture,ye
280	wfo-0001027767	success	184	102	66	118	36	0.359	1-1.5,1.0-2,1.5-2,2-3,3.5-5,4-5,7-8,accrescent,acute,anther,apex,articulate,attenuate,base,beige,brown,calyx,clavate,cm,curved,cyme,dark,deeply,diameter,distal,ferruginous,fruit,fruiting,globose,helicoid,lanuginose,leaf,long,mm,oblanceolate,oblong-lanceolate,oval-elliptic,parted,pedicel,peduncle,persistent,petiole,plant,prickle,recurved,reniform,rugose,shrub,small,solitary,somewhat,stellate,stem,stigma,straight,style,sub-conic,sub-truncate,subreniform,terminal,trichome,tube,villous,white,yellowish,young	0.3-0.5,1,1-2,1.5-1.8,10-12,10-20,15-25,2-2.5,2.6-3,3,3-6-branched,30-many-flowered,4-many-celled,5-6,5-7,5-8,5-merous,8-9,abaxial,across,along,alyx,anthesi,armed,attenuat,bicolorous,blade,branch,campanulate,central,coriaceous,dark-green,eaf,eed,enlarged,entire,epicarp,equal,erect-branched,exceeding,filament,floral,flower,free,geminat,glabrous,glandular,glandular-stalke,glandular-stalked,glandular-stellate,gynoeci,hirsute-glandular,indument,irregularly,lobe,lobed,long-exserted,longer,lower,many-celled,midrib,minutely,multiangulate,nflorescence,numerous,orolla,papillo,part,peduncl,pendent,perennia,perfect,persistently,plurifoliate,porrect-stellate,primary,prominent,pubescent,rachi,ranch,ray,reduced,reflexed,ruit,secondary,sessile,shiny,short,similar,sparse,sparsely,stalked,stamen,staminate,sub-globose,sub-sessile,subcoriaceous,surfac,surrounded,tall,tamen,terete,thick,tomentose,unarmed,uniseriate,unit,vary,vein,viscid-glandular,viscid-villous,wide,winged,withi,within,without,yellow,ympodial	arrangement,articulation,bark,color,connation,corolla,dehiscence,diminishing,foetid,foliage,form,growth,height,history,inflorescence,interjected,lateral,leaflet,length,life,midpoint,na,ovary,papillae,perennial,petiolule,position,pseudostipule,seed,shape,size,spacing,straightnes,surface,texture,tuber-bearing
281	wfo-0001027768	success	214	110	80	134	30	0.374	.5,0-0.1,0.1-0.3,0.1-0.4,0.3-1.5,0.5-3.4,0.6-0.9,3-15,3-4.5,6-12,6-6.5,acicular,anther,apex,attenuate,base,black,brown,calyx,chartaceous,cm,connivent,cuneate,curved,dark,densely,elliptical,flattened,fruit,globose,green,greenish-white,grey,grey-green,inflorescence,lanceolate,lateral,leaf,leaf-opposed,length,light,loosely,margin,minutely,mm,nearly,obtuse,pale,pear-shaped,pedicel,peduncle,perennial,petiole,prickle,pseudo-racemose,purple,reddish,reticulate,sessile,shrub,smooth,solitary,sparsely,stellate,stellate-pubescent,stigma,straight,streak,style,subcoriaceous,surface,toward,tube,turning,unbranched,violet,white,x,yellow,yellowish	%,0,0-0.2,0-0.3,0-2,0.15-0.25,0.15-0.3,0.2-0.3,0.25-1,0.3-0.6,0.3-0.7,0.5-1.5,0.6-1.5,1,1-2,1-2.5,1.2-1.4,1.2-1.8,1.2-3.4,1.5-2,1.7-2.6,10-15,11-14,15-50,18-35,2-2.5,2-7,2-locular,2.9-3.7,3,4-,4-5,5-7,5-merou,6-15,7-10,8-10,8-12,8-16,abaxiallly,abaxially,absent,accrescent,across,adaxiall,adaxially,adult,alyx,apart,articulated,axe,ba,blade,branchlet,capitat,confined,contiguous,cylindrical,deltate,diameter,difoliate,directed,distall,distributed,dm,eaf,eed,eglandular,entire,erect,exocarp,filament,finger,flower,fruiting,geminat,glabrous,gland-tipped,hair,half,hig,juicy,juvenile,lamina,less,lobe,long,longer,lower,mature,mesocarp,mid-point,midpoint,midrib,midvein,minute,moist,narrowly,nflorescence,oblique,orolla,part,per,perfect,placenta,pore,porrect,present,pubescent,rachi,ray,rhizomatous,ruit,semi-circula,short,simple,somewhat,spaced,spongy,sprawling,stellae,tamen,tem,thick,throughout,time,triangular,unarme,unarmed,unit,vary,wide,winged,ympodial	abaxial,adaxial,bark,capitate,color,connation,corolla,dehiscence,diminishing,distal,form,growth,height,history,leaflet,life,na,ovary,papillae,petiolule,plant,seed,shape,size,spacing,stem,straightnes,terminal,texture,tuber-bearing
282	wfo-0001027770	success	242	124	91	151	33	0.376	0.2-2,0.3-2,0.5,0.5-1,0.8-2.5,1-3,2,2-6,2/3,3-5,4,4-8,6,7-15,acute,anther,apart,apex,apparently,bark,base,berry,brown,c.,calyx,clavate,cm,cuneate,dark,densely,diameter,elliptic,elongating,flattened,fruit,fruiting,gray,herbaceous,lanceolate,lateral,leaf,length,less,lobed,long,markedly,mature,maturity,mm,narrowly,obtuse,orange,orange-brown,ovate,pale,pedicel,peduncle,petiole,plant,poricidal,prickle,pubescent,rarely,reflexed,reniform,rounded,sessile,simple,smooth,sometimes,sparse,spherical,spreading,stellate,stellate-pubescent,stem,stigma,style,subsessile,surface,tapering,terminal,tip,trichome,tube,violet,way,white,woody,yellow,young	0-45°,0.1-0.15,0.1-0.3,0.15,0.3,0.5-2,0.6-1.2,0.8-1.5,1-2,1-2.5,1-5,1.5,1.5-2,1/2-1/6,10-14,12,12-14,16,2-3,2-4,2.5-3,20,3,3-4,3-6,4-6,4-7,5-30,5-merous,50,6-10,7,9,abaxially,adaxially,ag,almost,alyx,anthesi,apically,armed,articulated,blade,branching,concolorous,cuspidate,deltate,dense,difoliate,dilated,distance,drying,eaf,eed,entire,equal,erect,extending,eye,filament,filiform,flat,flower,free,geminat,glabrous,globose,green,horizontal,infructescence,irregular,lengthening,like,lobe,lon,longer,lower,margin,midpoint,midvein,mostly,naked,nflorescence,oblique,obscured,often,older,orolla,oung,ovoid,pair,papillate,papillo,pendulous,per,perfect,pericarp,pore,porrect,portion,present,prickly,primary,prominent,pubescenc,raised,rare,ray,red,reduced,reduced-multangulat,ruit,scar,shallowly,short-styled,side,slightly,small,somewhat,spaced,sparsely,stalk,staminat,stolon,straight,stump,tall,tamen,terete,tertiary,thin,throughout,time,toward,unarme,unarmed,underground,uniform,unit,usually,variously,vary,vein,venation,visibl,visible,white-green,wide,yellow-green,ympodial,½	20-50,arrangement,articulation,color,connation,corolla,dehiscence,diminishing,distal,foetid,foliage,form,growth,height,history,inflorescence,interjected,leaflet,life,na,ovary,papillae,papillose,petiolule,position,pseudostipule,seed,shape,size,spacing,straightnes,texture,tuber-bearing
283	wfo-0001027807	success	116	105	63	53	42	0.543	0-0.2,0.1-1,0.2-0.9,1-1.5,2-5,acuminate,acute,apex,attenuate,bark,base,brown,closely,cm,diameter,dry,drying,elliptic,flattened,fruiting,glabrous,globose,gray,grayish,green,growth,internodal,lanceolate,leaf,leaf-opposed,margin,material,midrib,minutely,narrowly,occasionally,overlapping,pale,paler,papillae,pedicel,peduncle,petiole,pitted,plane,rachi,reddish,reniform,revolute,scar,shrub,simple,slender,slightly,small,spaced,stem,surface,thickened,tree,white,yellowish,young	.5,0.2-0.3,0.3-0.4,0.9-1,0.9-2.5,15-30,2-6,3.5-9,abaxially,adaxially,almost,barely,berry,brittle,bud,decurrent,deflexe,deflexed,difoliate,eaf,eed,ellipti,flower,geminat,know,known,maturity,mm,new,nflorescence,older,ot,pair,papillate,parallel,primary,prominent,reddi,reproductive,ruit,seemingly,shoot,somewhat,sparsely,ud,unifoliate,unit,usually,vein,visible,winged,x,ympodial	anther,arrangement,articulation,calyx,color,connation,corolla,dehiscence,diminishing,distal,foetid,foliage,form,fruit,height,history,inflorescence,interjected,lateral,leaflet,length,life,midpoint,na,ovary,petiolule,plant,position,prickle,pseudostipule,seed,shape,size,spacing,stigma,straightnes,style,terminal,texture,trichome,tube,tuber-bearing
284	wfo-0001027808	success	178	122	81	97	41	0.455	.5,0.2-0.3,0.4-0.8,0.6-1.2,1-2,1.1-1.3,1.6-3,12-18,2-4,2.5-3.5,2.5-4,5-7.5,7-8,70-90,8-12,acicular,acuminate,acute,anther,apex,articulated,base,broad-based,broadly,brown,calyx,chartaceous,cm,cuneate,curved,densely,diameter,extra-axillary,fruit,fruiting,globose,green,index,inflorescence,lateral,lavender,length,lobed,lobing,long,longer,margin,midpoint,midvein,mm,ovate,pale,pedicel,peduncle,per,perennial,petiole,plant,present,prickle,pseudo-racemose,ray,shallowly,simple,sparsely,stellate,stellate-pubescent,stigma,straight,style,throughout,time,tube,unarmed,vein,vine,white,wide,x,yellow,yellowish	%,.2,.7,0-0.1,0-7,0.05-0.2,0.2-0.35,0.25-0.35,0.3-0.6,0.4-1,0.5-0.6,0.5-1,0.5-3,0.6-1.4,1,1-1.3,1.4-1.8,1.9-2.4,15-30,2-foliate,20-30,23-28,3-11,40-120,5-7,5-merou,5.5-6.5,6-8,7-10,9-14,abaxially,absent,across,adaxiall,adaxially,alyx,andromonoecious,apart,armed,axe,ba,blade,capitat,d.,deltate,directed,distall,distributed,eaf,eed,eglandular,finger,flower,functional,geminat,gland-tipped,hair,half,heterostylous,lamina,less,lobe,lower,mature,mid-point,minute,nflorescence,oblique,orang,orolla,part,pore,porrect,presen,purple,rostrate,ruit,sessile,short,side,spaced,sprawling,stage,stalk,stellae,tal,tamen,tem,thick,unarme,unbranched,unit,unknow,uvenile,vary,weakly,ympodial	abaxial,adaxial,arrangement,articulation,bark,capitate,color,connation,corolla,dehiscence,density,diminishing,distal,distribution,dm,form,growth,height,history,interjected,leaf,leaflet,life,na,orange,ovary,papillae,petiolule,position,pseudostipule,seed,shape,size,spacing,stem,straightnes,surface,terminal,texture,tuber-bearing,width
285	wfo-0001027816	success	187	120	83	104	37	0.444	.5,0.5-1,0.6-0.8,1-1.5,1-3,1-4,2-4,2/3,4-5,acuminate,acute,anther,apex,articulated,attenuate,base,becoming,berry,bluish,branched,brown,calyx,capitate,cm,connivent,corolla,dark,dense,diameter,ellipsoid,flattened,fruiting,glabrous,globose,growth,inflorescence,lanceolate,lateral,leaf,lengthening,less,linear,lobed,loosely,minutely,mm,orange,patent,pedicel,peduncle,petiole,pitted,plant,pore,poricidal,pubescent,purple,reddish,reniform,ripe,rounded,several,shrub,simple,sleeve,slit,small,sparse,stellate,stem,stigma,style,surface,terminal,time,tip,trichome,tube,uniformly,uniseriate,way,yellowish,½	..,0.2,0.5,0.5-2,0.7-1,1,1-1,1.2-2,1.5-2,1.8-6,12-14,2-2.5,3-3.5,3.5-4,5-30,5-merou,6-9,<,ag,almost,along,alyx,anthesi,apar,ark,axi,cell,confined,conical,cupped,densely,drying,eaf,eed,em,entire,erect,exserted,filament,filiform,fleshy,flower,free,gland-tipped,glandular,half,ilament,irregularly,leaving,like,lobe,lower,m.,margin,markedly,minute,new,nflorescence,nodding,occasionally,often,older,orolla,pair,papillo,peg,per,perfect,perhaps,pericarp,plurifoliat,portion,primary,prominen,pubescen,rectangular,red,ruit,scar,shiny,slightly,sometimes,somewhat,spaced,sparsely,spreadin,spreading,square,testal,thin,triangular,twinin,ud,ultimate,unit,upper,usually,variable,vary,vein,viscous,woody,x,ympodial	age,apart,arrangement,articulation,bark,color,connation,dehiscence,diminishing,distal,foetid,foliage,form,fruit,height,history,interjected,leaflet,length,life,midpoint,na,ovary,papillae,papillose,petiolule,position,prickle,pseudostipule,seed,shape,size,spacing,straightnes,texture,tuber-bearing,young
286	wfo-0001027819	success	199	122	80	119	42	0.402	1,1-,1-2,10-20,10-50,2-15,20-35,3-5,4,4-10,9-12,abaxially,acute,adaxially,apart,apex,apical,articulated,base,branched,cm,color,concave,cordate,cuneate,densely,diameter,eglandular,ellipsoidal,fading,finely,forked,fruit,glabrous,globose,green,hair,leaf,leaving,length,lobed,long,mm,narrowly,near,oblong,occasionally,pedicel,pedicellar,peduncle,per,petiole,pilose,probably,protuberance,puberulent,purple,purplish,rarely,remnant,rugose,simple,small,sparsely,stellate,stigma,style,sympodial,tree,triangular,tube,two,umbrella-shaped,unbranched,unit,unknown,unlobed,whitish,yellow,young	-100,0.5-1,1-5,1.5-2,12-21,15-22,16-25,2,2-,2-3,20-25,20-40,22-35,25-35,3-40,3-5-lobed,4-15,4-25,4-5,5,5-6,5-merous,8-10,aggregate,also,alyx,ape,apiculat,axe,ba,basal,beyond,blade,cell,ciliate,connective,cylindrical,deeply,denser,dia,diamete,dilated,directed,distally,divided,eaf,eed,eglandular-pilose,elliptic,elliptic-ovate,entire,equal,especially,exceeding,except,exserted,fleshy,flower,halfway,lobe,lon,lower,main,margin,mesocarp,midrib,moderately,narrow,nflorescence,nther,oblique,obtu,obtuse,often,orolla,ovate,perfec,perfect,pinnately,pore,present,prominent,puberulen,puberulence,rachi,radiu,ranch,ratio,ripe,rounded,rown,ruit,runk,shallowly,short-acuminat,shorter,sinus,slightly,sometimes,spaced,stamen,stone,strongly,subcoriaceous,swelling,tal,thecae,toward,truncate,ud,uni,usually,vary,vein,villous,wide,width,without,x	anther,arrangement,articulation,bark,calyx,connation,corolla,dehiscence,diminishing,distal,foetid,foliage,form,fruiting,growth,height,history,inflorescence,interjected,lateral,leaflet,life,na,ovary,papillae,petiolule,plant,position,prickle,pseudostipule,seed,shape,short-acuminate,size,spacing,stem,straightnes,surface,terminal,texture,trichome,tuber-bearing
287	wfo-0001027829	success	197	128	93	104	35	0.472	0.1-0.8,0.5,0.6-0.9,0.7,1,1-1.5,1-3,1.5,12,4-6,5,5-8,6-6.5,acuminate,acute,anther,apex,armed,articulated,bark,base,berry,black,bright,brown,calyx,clavate,cm,commonly,corolla,diameter,elliptic,elongate,equal,evenly,flattened,fruiting,gland-tipped,globose,growth,inflorescence,larger,lateral,length,long,midpoint,minute,minutely,mixed,mm,multicellular,narrowly,oblique,orange,ovary,pale,pedicel,peduncle,petiole,pitted,poricidal,porrect,prickle,pubescent,ray,reddish,reniform,ripe,sessile,short,short-stalked,shorter,shrub,simple,small,somewhat,stellate,stem,stigma,style,surface,tan,tapering,tip,tree,trichome,truncate,tube,twice,unarmed,usually,white,yellowish	.1,.5,0.6-0.7,0.7-0.8,1-,1.5-2,1.5-2.5,1.7-2,1/3,10-20,2,20-31,3-7,30,5-18,5.5-6,8-10,abaxially,adaxially,along,anthesi,apar,axi,beneath,bent,cell,conical,dense,densely,denser,directed,distally,drying,eaf,eed,enmeshing,entire,erect,exceeding,exserted,filament,filiform,flower,free,glabrescen,glabrous,hang,like,lobe,lobed,lower,margin,midrib,midvein,mixture,nearly,new,nflorescence,nodding,often,older,one,open,pair,papillat,per,perfect,pericarp,plurifoliat,pointed,pore,porect,portion,primary,prominent,pubescence,rectangular,reflexed,regular,ruit,scar,scattered,sharply,shiny,side,sinuate,spaced,sparsely,straight,strongly,tangled,testal,thin,time,triangular,ud,un,unit,upper,vein,weak,within,x,ympodial	apart,arrangement,articulation,color,connation,dehiscence,diminishing,distal,foetid,foliage,form,fruit,glabrescent,height,history,interjected,leaf,leaflet,life,na,papillae,papillate,petiolule,plant,position,pseudostipule,seed,shape,size,spacing,straightnes,terminal,texture,tuber-bearing,young
288	wfo-0001027834	success	236	119	82	154	37	0.347	-6.1,0.2-0.3,0.2-0.4,0.2-0.6,1-10,1.6-2.7,2-3.8,2-8,25,4-5.2,4.8-6.9,5-20,6.9-18.1,accrescent,acuminate,acute,anther,apex,articulated,attenuate,bark,base,blunt-tipped,branched,brown,calyx,cm,corolla,deltoid,dendritic-echinoid,diameter,drying,echinoid,ellipsoid,finely,flower,fruit,fruiting,globose,gray,leaf,lenticular,light,many,mm,obovate,obtuse,orbicular,ovate,ovate-elliptic,pedicel,peduncle,petiole,poricidal,rarely,reticulate-punctate,ripe,rounded,scabridulous,short,shrub,simple,small,soft,sometimes,stellate,stem,stigma,style,surface,time,tip,tree,trichome,tube,velutinous-tomentose,white,x,yellow,yellowish-tan,yellowish-tomentose,young	.5-3,0-110,0.4-1.1,0.5-2,0.9-1.8,1-1.6,1-1.9,1-2.5,1.1-1.6,1.1-1.8,1.4-2,1.8-4.9,1/2,10-25,2.2-4.3,2.3-3.4,2.4-6.2,2.7-7.3,2.9-4.2,3-15,3-4.3,4-6,5-merous,5.1-8,9-11.9,9-13,abaxial,abaxially,absent,adaxial,adaxially,ag,alyx,angled,anthesi,apar,apical,around,axillary,ba,becoming,berry,blade,branch,branching,bud,capitat,closely,completely,concentrated,connivent,coriaceous,covering,crown,cylindrical,dendritic-echinoi,densely,dichasia,directed,discolorous,distally,eaf,echinoi,edge,eed,enclosing,entire,enveloping,equal,erec,exserted,farinose,filament,flat-topped,fleshy,forming,glabrescent,glabrous,granular-tomentose,grooved,hair,high,included,inserted,lengthening,less,lobe,lobed,long,long-stalked,longitudinal,longitudinally,lower,margin,mostly,multangulat,multangulate,near,nflorescence,numerous,obscured,older,orolla,ovate-lanceolate,pair,perfec,persistent,plurifoliate,pore,porrect-stellate,primary,pseudo-terminal,pubescence,pubescent,rachi,ray,ruit,runk,scar,semi-ovate,semi-spherical,sessile,short-stalked,slit,somewhat,spaced,sparsely,spreading,stalked,stamen,stellate-pubescent,subcampanulate,subcoriaceous,suture,tamen,though,tomentose,tomentu,tomentum,toward,turbinoid,ud,unarme,unit,usually,vary,vein,villous,way,whitish,whitish-tomentose,wide,yellowish,ympodial	apart,arrangement,articulation,capitate,color,connation,dehiscence,diminishing,distal,foetid,foliage,form,growth,height,history,inflorescence,interjected,lateral,leaflet,length,life,na,ovary,papillae,petiolule,plant,position,prickle,pseudostipule,seed,shape,size,spacing,straightnes,terminal,texture,tuber-bearing
289	wfo-0001027843	success	154	92	54	100	38	0.351	0.5-0.75,0.5-1,0.8-3.5,1-1.5,1.2-1.5,5-6,6-9,acute,anther,apex,bark,base,broadly,calyx,clavate,cm,conical,corolla,densely,fruiting,globose,green,lateral,leaf,lobed,long,long-acuminate,minutely,mm,opposite,ovary,ovate,papillose,pedicel,petiole,poricidal,pubescent,rounded,shape,shaped,shrub,size,slender,stem,stigma,straight,style,surface,tear-drop,trichome,tube,uniseriate,white,young	.5,.75,/3,1-1.2,1-1.3,1.2-2.5,2-2.5,2-4,3-15-flowered,3-6,6-13,along,anthesi,apart,apiculate,ba,bearing,becoming,beginning,beneath,berry,coroll,curly,deflexed,deltoid,denser,dia,differing,difoliate,distally,eaf,edicel,eed,ellipsoid,erose,exsertion,filament,flower,free,geminat,glabrate,glabrous,hairy,impressed,irregularly,known,lamina,larger,later,like,lobe,lon,lower,main,major,margin,middle,minor,near,nearly,nflorescence,occasionally,older,one,orbicular,pair,papillo,pleated,pore,portion,prominent,proximal,reddish-gre,reflexed,ruit,scar,simple,sinus,slightly,somewhat,spaced,sparsely,sparser,stiff,strongly,tall,tapering,time,tip,tipped,two,ud,unit,vein,way,widest,winged,woody,x,ympodial	1,arrangement,articulation,color,connation,dehiscence,diameter,diminishing,distal,foetid,foliage,form,fruit,growth,height,history,inflorescence,interjected,leaflet,length,life,midpoint,na,papillae,peduncle,perennial,petiolule,plant,position,prickle,pseudostipule,reddish-grey,seed,spacing,straightnes,terminal,texture,tuber-bearing
290	wfo-0001027847	success	219	102	78	141	24	0.356	-0.8,-2.5,-6,0-2,0-7,0.4-1,0.5,0.8-1.2,1.5-2,1.5-5,2-4,2.5-3.5,3-6,5-6,ame,anther,apparently,articulated,base,c.,calyx,cm,cordate,densely,diameter,dull,elliptic,elongating,evenly,finely,flattened-reniform,fruit,fruiting,green,lateral,leaf,length,lobed,long,maturity,mauve,midpoint,mm,orange,orange-brown,ovate,pedicel,peduncle,petiole,pitted,poricidal,porrect,prickle,purple,ray,red,rounded,seed,sessile,shrub,simple,size,sparsely,spherical,stalked,stellate-pubescent,stem,style,surface,tapering,terminal,tip,trichome,variously,white,wide,yellow,young	-2,-3,-4,-5,.35,.7,/2,/3,0,0.1-0.4,0.15-0.2,0.2,0.5-1,0.8,0.8-0.9,1,1-2,1-2.5,1.5-2.5,1.9-2.3,1/2,1/4,1/6-1/3,2-2.8,2-3,2-5,2.2-3,2/,3-15,3-5,3.5-6,4-5-merous,5-25,5.5-8,6-11,6-8,7-10,abaxially,acute,almost,alyx,apar,apart,apex,apically,bark,berry,blade,branched,broadly,brow,chartaceous,connivent,curved,deltate,dimorphic,discolorous,distance,drying,eaf,edge,eed,equal,erect,extending,faint,filament,filiform,filiform-acuminat,flattened,flower,free,geminate,glabrescent,glabrous,gray,increasing,infructescence,lobe,lon,longer,lower,margin,mature,middle,midvein,minor,moderately,narrow-deltate,nflorescence,older,one,open,orbicular,orolla,oung,pair,pendulous,per,perfec,pericarp,perpendicular,pit,plurifoliat,portion,prickl,prickly,primary,red-brown,reddish,retrorse,ruit,scandent,scar,side,slender,smooth,sometimes,spaced,spreading,stalk,stellate,straight,strongly,tamen,terete,tertiary,time,toward,tube,unarmed,unit,upper,usually,vary,vein,venation,visible,way,weakly,ympodial	arrangement,articulation,color,corolla,dehiscence,foetid,foliage,form,growth,height,history,inflorescence,interjected,leaflet,life,na,perennial,plant,position,pseudostipule,shape,spacing,stigma,texture
291	wfo-0001027850	success	221	130	98	123	32	0.443	-4,-5,-6,0.5-1,0.6-1,1-2,1-3,1-4,2-3,2-4,2-5,2-6,3-7,4-5,8-10,acuminate,acute,anther,apart,apex,articulated,bark,base,berry,blue,brown,calyx,cell,clavate,cm,corolla,curved,dark,diameter,distal,elliptic,expanding,flattened,flower,flowering,fruiting,glabrescent,globose,green,growth,inflorescence,internodal,laxly,leaving,length,linear,long-styled,mature,midpoint,minutely,mm,oblong,obovate,ornamented,ovary,ovate-lanceolate,pedicel,peduncle,persistent,petiole,plant,poricidal,porrect,prickle,purple,reniform,reticulate,rounded,rugose,sagittate,scabrous,scar,sessile,short-styled,shrub,simple,stellate,stem,stigma,straight,style,subreniform,subsessile,subtruncate,surface,tapered,time,tip,tomentose,trichome,tube,woody,yellowish	-10,-22,0.2-0.5,0.3-0.35,1,1-1.5,1-multicellular,1.5-2,2-2.5,2.5-3,3-4,3-6,3.5-13,4-6,50,6-10,6-7,7-18,<,>,abaxially,adaxially,adult,almost,angled,anthesi,armed,basal,branched,brow,caly,channelled,charataceous,coriaceous,discolorous,dry,eaf,eed,eglandular,enclosed,entire,erect,filament,foliaceous,free,glabrous,glandular,heterostylous,hirsute,impressed,juvenile,lengthening,like,lobe,lobed,lobed-angulate,long,longer,loosely,lower,margin,material,minute,mixed,mixture,multicellular,new,nflorescence,obliqu,oblong-lanceolate,obverse,occasionally,older,one,papillo,partially,per,perfect,pericarp,plurifoliat,pore,portion,prickly,prominent,pubescence,pubescent,raised,reddish,reduced,reflexed,rest,ruit,rusty,rusty-pubescent,scandent,single,slightly,slit,spaced,sparse,sparsely,stalked,staminate,stellate-apiculate,strongly,subglobose,tall,testa,triangular-lanceolate,turbinate,ud,unevenly,unit,upper,vein,velutinous,venation,whitish,wood,x,yellow,ympodial,¼	arrangement,articulation,color,connation,dehiscence,diminishing,foetid,foliage,form,fruit,height,history,interjected,lateral,leaf,leaflet,life,na,papillae,papillose,petiolule,position,pseudostipule,seed,shape,size,spacing,straightnes,terminal,texture,tuber-bearing,young
292	wfo-0001027864	success	222	110	73	149	37	0.329	0.05-0.4,0.1-0.4,0.25-0.5,0.4-1.4,1.4-4,1.5-8,3-5.5,5-9,6-7,7-10,absent,accrescent,acute,anther,apart,apex,articulated,base,brown,calyx,chartaceous,cm,connivent,cuneate,curved,diameter,ellipsoidal,extra-axillary,finely,fruit,fruiting,globose,green,grey,herbaceous,inflorescence,lanceolate,lateral,length,lilac,linear,lobed,loosely,mm,nearly,oblong,obtuse,pale,pedicel,peduncle,petiole,present,prickle,pseudo-racemose,purple,reniform,resprouter,reticulate,shallowly,simple,slightly,smooth,stem,stigma,straight,style,surface,tapered,tip,tube,x,yellow,yellowish-green	%,0-0.1,0-0.2,0-100,0-2,0-3,0.3-1,0.4-0.7,0.5-0.7,0.5-0.8,0.5-1,0.6-0.7,0.7-0.9,0.7-1,0.7-1.4,0.9-1.1,1-1.1,1-1.3,1-1.5,1-2,1-3,1-3.5,1-4,1.2-1.5,13-20,2-3,2-foliate,2-locular,2.5-3,3-10,3-4,3-4.2,3-5,3-6,3.5-5,3.8-14,4,4-,5-merou,6-12,6-8,6-9,7-20,8-12,8-13,8-14,abaxially,absen,abundant,acicular,adaxially,alyx,anvil-shape,attenuate,axe,ba,blade,broad-based,capitat,cross-section,cylindrical,decimetr,deflexed,deltate,densely,directed,distall,distributed,dult,eaf,eed,eglandular,entire,erect,exocarp,filament,finger,flattened,flower,geminate,glabrous,gland-tipped,grey-green,hair,half,homostylous,index,interpetalar,juicy,lamina,less,lobe,lobing,lon,long,longer,lower,margin,mature,mesocarp,mid-point,midpoint,minute,moderately,moist,nflorescence,oblique,orolla,part,per,perfect,placenta,pore,porrect,rachi,ray,ridged,rostrate,ruit,rusty-brown,scattered,sessile,short,side,spaced,sprawling,stage,stalk,stalked,stellae,stellate,stellate-pubescent,tal,tamen,terete,thick,throughout,time,tissu,tissue,unarmed,unbranched,unit,uvenile,vary,white,wide,yellowish,ympodial	arrangement,articulation,bark,capitate,color,connation,corolla,dehiscence,diminishing,distal,foetid,foliage,form,growth,height,history,interjected,leaf,leaflet,life,na,ovary,papillae,petiolule,plant,position,pseudostipule,seed,shape,size,spacing,straightnes,terminal,texture,trichome,tuber-bearing,young
293	wfo-0001027872	success	190	115	84	106	31	0.442	1,1-8,10,2-3,20,5-8,6-20,8-11,acuminate,acute,apex,apical,apically,articulate,base,branched,calyx,clasping,cm,connate,cordate,cuneate,cyme,decreasing,deep,dehiscent,densely,diameter,dichasial,dichasially,distal,ebracteate,elliptic,forked,glabrescent,glandular-pubescent,globose,green,green-white,herbaceous,homogeneously,interjected,introrse,lanceolate,lateral,leaflet,long,maturing,middle,mm,moderately,monochasial,mucilaginous,narrowly,nearly,obliquely,odd-pinnate,often,ovate,ovoid,pedicel,peduncle,perennial,plant,poricidally,purple,rarely,rhizomatous,rotate,rounded,seed,semi-lunate,shape,short,size,slightly,slit,stigma,straight,style,terminal,typically,wider,yellow	0.5,1-1.2,1-4,1.0-1.3,1.5-4,12-35,15,2,2.2-3.5,2.8,3-6-foliat,35,4-6,5-10,5-7,5-lobed,abaxially,acumen,adaxially,angular,apiculate,b,ba,basal,becoming,ca,caudate,cell,celled,commonly,covering,digestion,eaf,eed,emoval,enzyme,erect,exceeding,externally,filament,flower,four-celled,generally,gland,glandular,globo,gray-green,hair-like,half,honeycomb,light,living,lobe,lon,longer,lower,make,mottled,nflorescence,nther,oblong,orolla,pair,pattern,pentagonal,perfect,petiolate,petiolulate,petiolule,puberulent,pubescent,purpl,reduced,reveal,rhizome,rotate-,ruit,sessile,seudostipule,single,sometimes,somewhat,specimen,stamen,ste,subequal,symmetrically,tem,terete,testal,thick,tinged,tip,trailing,type,unbranched,uniformly,unit,usually,vary,viole,wall,wid,wide,yellowish-green,ympodial	anther,arrangement,bark,color,connation,corolla,dehiscence,diminishing,form,fruit,growth,height,history,inflorescence,leaf,length,life,na,ovary,papillae,petiole,pseudostipule,rotate-pentagonal,spacing,stem,straightnes,surface,texture,tube,violet,wet
294	wfo-0001027880	success	185	121	82	103	39	0.443	.25,0.3-3,0.5-5,0.6-1.5,1-15,1-2.5,1-3,1.5-3,10-15,4-10,4-6,8,acuminate,acute,anther,apart,apex,apiculate,articulated,base,calyx,clavate,cm,conical,connivent,contiguously,cordate,diameter,diminishing,distichous,epiphytic,extra-axillary,flower,fruit,fruiting,globose,green,greenish,inflorescence,leaf,leaf-opposed,longitudinal,minutely,mm,nearly,oblique,oblong,oblong-ovate,often,opening,ovate,ovoid,papillose,pedicel,peduncle,petiole,pink,pubescent,purple,red-brown,ripe,rounded,rugulose,shrub,size,slender,slit,sometimes,somewhat,stellate,stigma,style,surface,tan,trailing,truncate,tube,unbranched,vine,white,x,yellow	-3,-3.5,0.5-1.5,0.6-1,0.8-1.5,1-14,1-2,1.5-2,2-3,2-80,2/,3-4,5-11,5-8,5-merou,abaxially,absen,accrescen,adaxially,ag,aggregate,along,alyx,apparently,axe,ba,blade,branch,branching,cell,chartaceous,ciliat,coriaceous,curled,cylindrical,deltate,dense,densely,directed,discolorous,distally,distinct,distinctly,eaf,eed,entire,equal,filament,flattened,geminat,glabrous,growing,hair,increasing,internode,line,lobe,long,longer,lower,margin,midvein,multicellular,nflorescence,node,occasionally,orolla,pair,pale,perfect,plurifoliate,point,pore,pubescen,rachi,reddish,revolute,rooting,ruit,scar,secondary,simple,slightly,spaced,sparsely,ste,stone,tamen,tem,thickened,time,tip,tree,trunk,typically,undulate,uniseriate,unit,usually,vary,vein,wide,ympodial	accrescent,age,arrangement,articulation,bark,color,connation,corolla,dehiscence,distal,foetid,foliage,form,growth,height,history,interjected,lateral,leaflet,length,life,na,ovary,papillae,petiolule,plant,position,prickle,pseudostipule,seed,shape,spacing,stem,straightnes,terminal,texture,trichome,tuber-bearing,young
295	wfo-0001027880	success	170	106	76	94	30	0.447	.25,0.2-0.5,0.5,0.5–1.5,0.6–1.5,1.5–3,10–15,1–15,4–10,4–6,8,absent,acuminate,acute,anther,apex,apiculate,arrangement,base,blade,bluish-purple,calyx,chartaceous,cm,contiguously,cordate,coriaceous,curled,densely,diameter,distichous,flattened,flower,fruit,glabrous,globose,green,greenish,hair,leaf,longer,midvein,mm,mottled,nearly,oblong-ovate,ovate,ovoid,pedicel,peduncle,petiole,pink,pinnate,pubescent,red,reddish-brown,rounded,rugulose,shrubby,slightly,sometimes,somewhat,stellate,stigma,style,surface,tan,trichome,truncate,typically,unbranched,venation,vine,white,x,–3.5	0.3–3,0.5–5,0.6–1,0.8–1.5,1.5–2,1–14,1–2,1–2.5,1–3,2-80,2/3,2–3,3–4,5-merous,5–11,5–8,abaxially,accrescen,adaxially,along,alyx,apar,axe,berry,c.,capitat,ciliat,clavate,climbing,conical,cylindrical,deltate,dense,discolored,distinct,distinctly,eaf,eed,entire,extra-axillary,filament,fruiting,lanceolate,leaf-opposed,line,lobe,long,lower,m.,margin,membranous,minutely,nflorescence,nternode,oblique,occasionally,often,orolla,pair,pale,papillose,perfec,plurifoliat,rachi,reddish,revolute,rip,ruit,sand-punctat,sand-punctate,scar,secondary,simple,slender,spaced,sparsely,ste,tamen,tem,thickened,time,tip,tree,trunk,tube,undulate,uniseriate,unit,vary,vegetatio,vein,wide,woody,ympodial	abaxial,adaxial,apart,capitate,color,corolla,dehiscence,form,growth,height,history,inflorescence,interjected,internode,lateral,leaflet,length,life,na,perennial,plant,pseudostipule,ripe,seed,shape,size,spacing,stem,terminal,texture
296	wfo-0001027881	success	215	105	67	148	38	0.312	absent,acute,almost,anther,apex,articulated,attenuate,base,berry,blackish,calyx,chartaceous,cm,connivent,contiguous,cordate,cordiform,diameter,drying,extra-axillary,flattened,flower,fruit,giving,globose,greenish,groove,half,herb,immature,impression,larger,lateral,leaf,light-brown,longitudinal,margin,maturity,membranaceous,mm,netlike,one,opening,ovate-elliptic,parallel,pedicel,peduncle,petiole,projection,raised,reniform,rotate,seed,sessile,short,simple,size,slit,stem,stigma,style,subopposite,surface,translucent,tube,white,yellow	-3,.3–0.5,0.5–2.2,0.8–1.5,1-celled,1.3–2,1.8–2.9,10–25,1–2,1–2-celled,1–2.5,1–2.6,1–3,1–3-celled,1–4,2.5–3.6,20–40,2–4,2–6,2–7,4–6,4–9.5,5,5-merous,6–10,7–14,7–9,8,abaxially,abundant,accrescent,acuminate,adaxiall,adaxially,alyx,appressed,asymmetric,axe,ba,barely,blade,bulge,camptodromous,capitat,case,central,ciliate,closely,commonly,connected,curved,cylindrical,decurrent,dehiscing,densely,denser,difoliate,directed,dorsally,eaf,ed,eglandular,emarginate,emerging,entire,equal,erect,exceeding,exclusively,explosively,eye,few-,fewer,filament,forming,frequent,geminate,glabrous,glandular,hair,held,hollow,interpetalar,introrsely,less,like,lobe,long,longer,lower,mainly,many-branched,maturit,mesocarp,mixed,moderately,much,multicelled,multicellular,naked,near,nflorescence,normally,orolla,other,pair,part,per,perfec,placenta,pore,pressure,primary,prominent,pubescence,pubescent,rachi,ruit,secondary,side,similar,slightly,small,smaller,solitary,sometimes,sparsely,stalk,staman,stamen,subapically,tal,tamen,tem,tissue,triangular,two,unbranched,unit,vary,vein,venation,visible,watery,winged,woody,ympodial,×	0.3-0.5,0.5-2.2,1-2,2-7,20-40,6-10,7-14,7-9,arrangement,bark,capitate,color,connation,corolla,dehiscence,diminishing,distal,form,growth,height,history,inflorescence,interjected,leaflet,length,life,na,ovary,papillae,petiolule,plant,pseudostipule,shape,spacing,straightnes,terminal,texture,tuber-bearing
297	wfo-0001027882	success	184	116	94	90	22	0.511	0.1,0.5-1,1,1-1.5,1-5,1.5-,1.5-2.2,1.5-6,2-6,2-lobed,3-4,6-9,9-13,abaxially,acuminate,adaxially,along,anther,apart,apex,appearing,attenuate,axil,bark,base,berry,branched,broadly,brown,c.,calyx,clavate,cm,completely,conical,corolla,dark,diameter,elliptic,entire,filament,flattened,glabrous,globose,green,growth,hairy,hollow,inflorescence,less,lobed,margin,maturity,midrib,minutely,mm,occasionally,ovary,ovoid,pair,pale,pedicel,peduncle,perfect,petiole,pitted,poricidal,primary,rarely,reddish,reniform,shiny,shrub,simple,small,sometimes,sparse,stem,stigma,stout,straight,style,surface,sweet-scented,time,tip,tree,trichome,tube,uniseriate,vein,way,white,yellow	.25,.5,06a,1.5-2,1.6-2.2,10-25,10-40,2-3,2.1-2.6,2.5-3,3.2-6,3.5-4,3.5-5,4-5,7-,absent,age,anthesi,apparently,branch,branching,caly,cucullate,deltate,dense,densely,difoliate,dry,drying,eaf,eed,erect,et,exerted,fide,flower,fork,free,fruiting,fusiform,geminat,glabrou,hooked,irregularly,junction,kallunki,lamina,leaf-opposed,lengthening,lobe,lower,markedly,new,nflorescence,nodding,papillat,papillate,paulo,penden,planar,plane,pointed,population,pore,portion,pulp,rachi,red-papillat,ruit,scar,shattering,slender,slit,spaced,sparsely,specimen,sticky,strongly,structurally,swollen,são,thickened,tuft,ud,unit,usually,woody,x,yellowish,ympodial	arrangement,color,connation,form,fruit,height,history,leaf,length,life,na,papillae,perennial,plant,present,reproduction,scent,seed,shape,spacing,straightnes,texture
298	wfo-0001027889	success	151	96	65	86	31	0.43	-2.5,0.5-1,0.5-11,1,1-3,1.5,10-12,2-3,3-4,3-9,acute-acuminate,apart,apex,articulated,basal,base,beyond,calyx,chartaceous,cm,color,densely,diameter,directed,eglandular-pubescent,elliptic,exserted,fruit,glandular-,green,greenish,immature,introrse,laterally,length,light,lobe,mm,moderately,ovate,ovoid,pedicel,peduncle,petiole,probably,puberulent,puberulent-pubescent,ripe,shrub,simple,sparsely,stamen,stellate,stigma,style,subcordate,tree,truncate,tube,unbranched,unknown,violet,white,x,yellowish	-pubescent,.5,.5-2,0,0.7-2,1-10,1-3.5,1.5-2,10-20,10-30,2-20,3-8,4-foliat,5-10,abaxially,acuminate,acute,adaxially,aggregate,ape,apiculate,axe,blade,capitat,cell,connective,connivent,cylindrical,darker,deltate,dilated,distally,eaf,eed,eglandular-puberulent,entire,equal,exceeding,extending,finely,flower,glabrous,leaving,lon,long,longitudinal,lower,margin,narrow,nflorescence,nther,oblong,orolla,pedicellar,perfect,pore,presen,present,puberulen,puberulent-pubescen,rachi,radiu,remnant,ruit,slightly,small,somewhat,spaced,stone,stripe,subcoriaceous,swelling,tal,tem,thecae,time,tip,tomento,tomentose,triangular,ud,unit,vary,wide,yello,ympodial	abaxial,adaxial,anther,arrangement,articulation,capitate,corolla,dehiscence,diminishing,distal,form,growth,height,history,inflorescence,lateral,leaf,leaflet,life,na,petiolule,plant,seed,shape,size,spacing,stem,straightnes,surface,terminal,texture
299	wfo-0001027900	success	227	118	83	144	35	0.366	.5,0.1–0.3,0.2–0.5,14–15,18–22,1–3,1–4,3–5,3–9.5,4–10,6–8.2,accrescent,acute,age,anther,apart,apex,articulated,bark,base,becoming,blue,broad-based,brown,calyx,capitate,cm,connivent,cordate,coriaceous,curved,cylindrical,diameter,extraaxillary,fruit,fruiting,globose,green,grey-brown,inflorescence,lanceolate,leaf,length,likely,longitudinal,maturity,midpoint,mm,oblique,obtuse,opening,pedicel,peduncle,petiole,plant,prickle,reddish-dark,rotate-stellate,roughened,sharp,shrub,simple,slightly,slit,small,smooth,stellate,stem,stigma,stout,style,surface,tapered,thickened,tree,tube,unbranched,violet,yellow,young,×,–4,–5	.1,.1–0.2,.1–0.3,0,0.2–0.4,0–0.1,1.5–1.8,16–19,16–23,1–,2,2.8,2–3,2–8,3,3.5–4,3.5–4.5,3–8,5-merous,5–,5–10,5–6,5–7.5,7–10,7–10+,7–15,7–17,7–8,8–15,9–25,abaxial,abaxially,absent,abundant,abundantly,adaxial,adaxially,alyx,andromonoecious,anthesi,armed,axe,ba,beneath,berry,bilobe,blade,congested,connective,db,deeply,deltate,densely,difoliate,directed,discolorous,distally,dried,eaf,eed,either,enclosing,entire,equal,falcate,filament,flower,flowering,free,fresh,frui,functionally,geminat,glabrous,glandular,golden-tan,hair,half,hermaphroditic,heterstylou,interpetalar,light,lighter,like,lobe,lobed,long,long-stalked,lower,major,margin,membranaceous,midvein,mixed,moderately,multangulate,multangulate-stellate,multiseriate,multiseriate-stalked,nearly,nflorescence,often,older,one,orolla,part,pore,porrect-stellate,powdery,pronounced,pubescence,pubescent,rachi,ray,reflexed,repand,ruit,runk,sessile,short,short-stalked,side,spaced,sparsely,stalk,stalked,staminate,stellate-pubescen,stellate-pubescent,strongly,subtending,tamen,tan,time,tissue,unarmed,unit,unknown,vary,vein,vestigial,wide,ympodial,–6.2	arrangement,articulation,bilobed,color,connation,corolla,dbh,dehiscence,diminishing,distal,foetid,foliage,form,growth,height,history,interjected,lateral,leaflet,life,na,ovary,papillae,petiolule,position,pseudostipule,seed,shape,size,spacing,straightnes,terminal,texture,trichome,tuber-bearing
300	wfo-0001027901	success	156	119	81	75	38	0.519	.5,0.3-1.2,0.8-1,0.8-2,0.9-2.3,1-2.5,3-5,4-5,abaxially,acuminate,acute,adaxially,anther,apex,area,attenuate,bark,base,broadened,brown,calyx,closely,cm,corolla,curled,dark,direction,drying,elliptic,fruiting,glabrous,globose,inflorescence,keeled,lateral,leaf,lobed,long,midrib,minor,minutely,mm,nearly,opposite,orbicular,oriented,ovary,ovoid-reniform,pedicel,petiole,pitted,poricidal,prominently,pubescent,reddish,rounded,shape,shaped,shiny,shrub,simple,single,size,spaced,stem,stigma,straight,style,surface,swollen,tear-drop,tip,translucent,trichome,tube,uniseriate,usually,white,x,yellow,young	.25,0.5-1,1-1.5,1-2,1.5-1.8,1.8-4.5,2.5-3,4-10-flowered,4.7-12,6-7,?,abaxial,anthesi,ba,beneath,berry,bright,brow,conical,deflexed,densely,dia,differing,difoliate,dry,eaf,edicel,eed,ellipsoid,exserted,filament,firm,fleshy,free,fresh,geminat,green,imbedded,immature,later,like,lobe,lon,lower,main,major,material,matrix,middle,nflorescence,older,overlappin,pair,papillo,papillose,planar,pore,portion,reflexed,rest,ripe,ruit,scar,slender,sparsely,strongly,tall,triangular,tub,ud,unit,vein,widest,woody,ympodial	.5-1,arrangement,articulation,color,connation,dehiscence,diameter,diminishing,distal,foetid,foliage,form,fruit,growth,height,history,interjected,keeling,leaflet,length,life,midpoint,na,orientation,overlapping,papillae,peduncle,petiolule,plant,position,prickle,pseudostipule,seed,spacing,straightnes,terminal,texture,tuber-bearing
301	wfo-0001027902	success	128	95	52	76	43	0.406	0.5-1,1-2,10-20,2-15,2-3,2-8,2-9,3-5,5-20,7-9,acute,angled,apex,articulated,base,branched,calyx,chartaceous,cm,color,connivent,cordate,deeply,diameter,forked,fruit,globose,margin,mm,narrowly,ovate,pedicel,peduncle,petiole,puberulent,purple,purplish,reticulate,shrub,simple,small,stellate,stigma,style,tree,triangular,truncate,tube,unknown,whitish,x,yellow	-2.5,1-1.5,1-6,1.5-3,10-15,15-30,2,2-12,20-50,3-4,3-foliat,4-25,4-5,6-37,8-13,abaxially,absen,acuminate,adaxiall,adaxially,aggregate,apart,axe,blade,cell,cylindrical,densely,directed,distall,distally,eaf,eed,eglandular,entire,flower,glabrous,glandular,hair,inflated,leaving,like,lobe,lon,long,lower,moderately,nearly,nflorescence,nther,obtuse,orolla,pedicellar,pore,pubescen,pubescent,rachi,radiu,remnant,ripe,ruit,spaced,sparsely,ste,stone,subcoriaceous,tal,tem,time,tip,truncat,unbranched,unit,usually,vary,wide,ympodial	anther,arrangement,articulation,bark,connation,corolla,dehiscence,diminishing,distal,foetid,foliage,form,fruiting,growth,height,history,inflorescence,interjected,lateral,leaf,leaflet,length,life,na,ovary,papillae,petiolule,plant,position,prickle,pseudostipule,seed,shape,size,spacing,stem,straightnes,surface,terminal,texture,trichome,tuber-bearing,young
302	wfo-0001027920	success	228	130	96	132	34	0.421	-25,0.1-0.5,0.2-0.8,0.5-1,1-2.5,1.4-2.5,1.5-3,12-18,2-5,2-7,20-40,3.5-4,4-11,7-11,7-18,abaxially,acicular,acute,adaxially,almost,along,anther,apart,apex,appressed,articulated,ascending,attenuate,base,black,bristly,broadly,brown,calyx,cm,connivent,dark,deltoid,diameter,distal,ellipsoidal,elongate,extra-axillary,flower,fruit,hirsute,indument,inflorescence,lanceolate,lateral,leaf,length,lenticular,less,lignescent,midpoint,minutely,mm,multiseriate,narrowly,oblong,obovoid,obtuse,orange,outline,ovate,pedicel,peduncle,perennial,persistent,petiole,pitted,prickle,principal,pubescent,ray,ripe,scattered,simple,singled-stemmed,small,stellate,stem,stigma,style,surface,thin-textured,tree,trichome,truncate,tube,unbranched,vein,white,x,yellow	-3,.1-1.4,0.1-0.2,1-2,1-4,1/5-1/3,11-28,12-25,17-25,2-,2-8,2-foliate,25-45,3-5,3.5-4.5,4-10,4-6,4-7,4-locular,4.5-7,5-7,8-12,8-18,8-30,acute-,acute-tipped,adaxiall,approximately,axe,ba,basally,blade,bristle-like,bristly-hirsute,broad-based,bulbou,campanulate,capitat,cauline,class,close,coarsely,concealed,concentrated,cylindrical,densely,dentate,depressed-deltoid,descending,directed,distall,distinct,divergently,eaf,eed,enlarging,entire,equaling,erect,female-sterile,few-branched,flesh,frui,geminat,glabrous,green,hair,inserted,interlobal,intermixed,large,larger,lobe,locule,long,long-stalked,longitudinal,lower,major,margin,minute,much,nearly,nflorescence,obtuse-tipped,occasionally,often,one,orolla,ovate-lanceolate,pair,per,persistently,pore,prickly,proliferation,rachi,radiu,receptacular,recurved,rigid,ruit,section,sessile,short,side,similar,sinus,smaller,spaced,sparse,spreading,stalk,stalked,stella,stellae,stellate-pubescent,swollen,tal,tamen,tawny,tem,termination,time,two,unit,usually,vary,vestitur,weakly,wide,ympodial	arrangement,articulation,bark,capitate,color,connation,corolla,dehiscence,diminishing,foetid,foliage,form,fruiting,growth,height,history,interjected,leaflet,life,na,ovary,papillae,plant,position,pseudostipule,seed,shape,size,spacing,straightnes,terminal,texture,tuber-bearing,young
303	wfo-0001027929	success	193	145	116	77	29	0.601	1,1-10,1-8,1.5-4,10,2,2-3,2.0-3.0,20,3.5-5,4-6,5-10,5-6,6-15,acuminate,acute,along,apex,apical,apically,articulate,base,beyond,branched,calyx,cell,center,clasping,cm,coat,color,connate,cordate,corolla,covering,cuneate,cyme,darker-violet-blue,decreasing,deep,dehiscent,diameter,dichasial,dichasially,distal,ebracteate,elliptic,embryo,except,forked,formed,generally,glabrous,globose,green,green-white,hair,hair-like,half,herbaceous,interjected,introrse,lanceolate,lateral,leaflet,light,long,make,maturing,middle,mm,monochasial,mucilaginous,narrowly,nearly,obliquely,occasional,odd-pinnate,often,ovate,ovoid,pedicel,peduncle,perennial,plant,poricidally,puberulent,purple,rhizomatous,rotate,rounded,seed,semi-lunate,shape,short,size,slightly,slit,somewhat,spot,stigma,straight,style,subequal,terminal,testal,thick,usually,vein,violet,violet-blue,visible,wall,wide,wider,yellow	0.2-0.9,1-4,1.0-1.3,15,3-6-foliat,35,4-30,4-5,5-lobed,abaxially,acumen,adaxially,angular,apiculate,ba,basal,becoming,caudate,cente,dark,digestion,eaf,eed,emoval,enzyme,erect,exceeding,filament,flower,globo,honeycomb,included,living,lobe,lon,lower,mostly,nflorescence,nther,oblong,orolla,pair,pattern,pentagonal,perfect,petiolate,petiolulate,petiolule,purpl,radiating,rarely,reduced,reveal,rhizome,rotate-,ruit,sessile,seudostipule,sometimes,specimen,stamen,star,ste,symmetrically,tem,terete,tinged,tip,trailing,typically,unbranched,unit,vary,white,wid,without,ympodial	anther,arrangement,bark,connation,dehiscence,diminishing,form,fruit,growth,height,history,inflorescence,leaf,length,life,na,ovary,papillae,petiole,pseudostipule,rotate-pentagonal,spacing,stem,straightnes,surface,texture,tube,tuber-bearing,wet
304	wfo-0001027930	success	210	94	57	153	37	0.271	0-0.7,0-2,0.4-1,0.4-1.5,1-2,2-2.5,2-3,3-3.6,4.5-6.5,6-13,acute,anther,apex,articulated,base,calyx,chartaceous,cm,connivent,cuneate,diameter,extra-axillary,fruit,fruiting,globose,hastate,inflorescence,lanceolate,lateral,leaf,length,lilac,linear,linear-hastate,loosely,mm,obtuse,pale,pedicel,peduncle,perennial,petiole,plant,present,prickle,red,shrub,simple,stellate,stigma,style,tube,unarmed,unbranched,white,x,yellow	%,-2,.1,.4,0,0-0.5,0-0.8,0-1,0-4,0.05-0.7,0.2-0.4,0.2-0.7,0.2-1.2,0.25-0.35,0.25-0.4,0.3-0.5,0.4-0.8,0.5-0.6,0.5-1,0.6-0.9,0.7-1.5,0.8-1.2,1-4,1-locular,13-16,15-60,2-10,2-6,2-9,2-foliate,3-12,3-7.5,3.5-5.5,4-,4-8,5-merou,6-12,6-8,7-12,7-8,8-20,9-13,9-26,abaxially,absen,absent,acicular,across,adaxiall,adaxially,adult,alyx,and/or,andromonoecious,apart,apparen,axe,ba,basal,blade,branch,branche,brown,capitat,confined,cylindrical,decimetre,deltate,densely,directed,distall,distributed,dm,eaf,eed,eglandular,entire,erect,exocarp,filament,finger,flower,functional,geminat,glabrous,gland-tipped,green,grey,hair,half,heterostylous,homo-,incomplete,interpetalar,juicy,juvenile,lamina,less,lobe,long,longer,lower,margin,mature,mesocarp,mid-point,midpoint,midrib,midvein,minute,moderately,narrowly,nflorescence,oblique,orolla,part,per,perfect,placenta,pore,porrect,rachi,ray,rhizomatous,rostrate,ruit,scattered,septum,sessile,short,spaced,sparse,sparsely,stellae,stellate-pubescent,straight,strongly,succulent,tal,tamen,tem,thick,throughout,time,tissue,triangular,unarme,unit,vary,weakly,wide,yellowish,ympodial	arrangement,articulation,bark,capitate,color,connation,corolla,dehiscence,diminishing,distal,foetid,foliage,form,growth,height,history,interjected,leaflet,life,na,ovary,papillae,petiolule,position,pseudostipule,seed,shape,size,spacing,stem,straightnes,surface,terminal,texture,trichome,tuber-bearing,young
305	wfo-0001027943	success	208	115	89	119	26	0.428	-4,0.2-2,0.5-1,0.5-1.5,0.5-4,0.5-6,0.8-1.5,1-1.5,1-3,1-4,1-5,1.5-3,10-15,2-10,2-14,2-2.5,2-3,2-3-lobed,2-4,3-15,3-20,3-8,4-20,4-6,4-7,5-8,5-9,7-10,abaxially,acute,adaxially,anther,brown,calyx,chartaceous,cm,densely,diameter,elliptic,elliptic-ovate,flattened,forked,fruit,globose,green,inflorescence,leaf,long,longitudinal,membanaceous,midpoint,minutely,mm,moderately,narrowly,nearly,opening,outline,pedicel,peduncle,petiole,plant,reniform,ripe,rugulose,short,shrub,simple,slightly,slit,smooth,stellate,stellate-pubescent,stem,stigma,strongly,style,surface,tan,tapered,time,triangular,truncate,turning,unbranched,white,wide,x,yellow	-1.5,.1,.5,0,0.3-0.5,5-merou,6-.,7-15,accrescent,ag,alyx,andromonoecious,apart,apex,armed,articulated,axe,ba,base,berry,blade,broad,broad-based,brownish,capitat,coarsely,connivent,covering,curved,cylindrical,difoliate,directed,distally,eaf,eed,entire,equal,erect,extra-axillary,ferruginous,filament,flower,free,frui,fruiting,geminat,glabrescent,glabrous,gland-tipped,glandular,hair,half,heterostylous,homo-,initially,interpetalar,interspersed,interwoven,like,linear-acuminate,linear-apiculate,lobe,lower,major,margin,mature,midline,midrib,nflorescence,numerous,oblique,obtuse,often,orolla,part,perfect,pericarp,pore,porrect-stellate,prickle,pubescent,rachi,rarely,ray,recurved,reflexed,rounded,ruit,sessile,shallowly,short-stalked,side,sinus,small,somewhat,spaced,sparse,sparsely,splitting,staminate,straight,subtending,tamen,tem,thi,tip,tissu,tissue,toward,tube,unarme,unarmed,unit,vary,vein,whitish,woody,ympodial,young	0.1,0.5,5-merous,age,arrangement,capitate,color,corolla,dehiscence,form,growth,height,history,interjected,lateral,leaflet,length,life,na,pseudostipule,seed,shape,size,spacing,terminal,texture
306	wfo-0001027944	success	175	82	46	129	36	0.263	0-0.3,0.1-0.2,0.3-0.4,0.4-0.8,1-2,1.5-2,4-7,5-7,absent,acute,anther,apex,articulated,base,calyx,chartaceous,cm,cuneate,diameter,extra-axillary,fruit,fruiting,globose,inflorescence,lanceolate,lateral,lavender,length,mm,ovate,pale,pedicel,peduncle,perennial,petiole,present,prickle,red,shrub,simple,stellate,stigma,style,tube,unarmed,yellow	%,.8,0-4,0.2-0.3,0.2-0.4,0.25-0.4,0.4-0.5,0.5-0.8,0.5-1,0.5-1.2,0.9-1.2,1-1.2,1-3,1-locular,13-16,15-23,2-3,2-4.5,2-6,2-foliate,2.5-5.2,3-20,3-3.5,3-4,3-4.5,3-5,3-7,5-merou,7-20,7-8,7.5-14,abaxially,absen,acicular,across,adaxiall,adaxially,adult,alyx,apart,apparen,axe,ba,blade,branche,brown,capitat,confined,cylindrical,deltate,densely,directed,distall,dm,eaf,eed,eglandular,entire,erect,exocarp,finger,flower,geminat,glabrous,gland-tipped,green,hair,half,incomplete,index,juicy,lamina,less,lobe,lobed,lobing,long,longer,lower,margin,mature,mesocarp,mid-point,midpoint,midrib,minute,nflorescence,oblique,obtuse,orolla,part,per,perfect,placenta,pore,porrect,pseudo-racemose,ray,rhizomatous,ruit,rusty,septum,sessile,shallowly,short,side,spaced,stage,stellae,stellate-pubescent,straight,succulent,tal,tamen,tem,thick,throughout,time,unarme,unbranched,unit,unknow,uvenile,vary,white,wide,x,yellowish,ympodial	arrangement,articulation,bark,capitate,color,connation,corolla,dehiscence,diminishing,distal,form,growth,height,history,interjected,leaf,leaflet,life,na,ovary,papillae,petiolule,plant,position,pseudoracemose,pseudostipule,seed,shape,size,spacing,stem,straightnes,surface,terminal,texture,tuber-bearing
307	wfo-0001027948	success	186	92	51	135	41	0.274	-6,0.5-2,1.5-4.5,10-14,2.5-,3.2-5.2,7.5-10,abaxially,acuminate,adaxially,anther,apex,attenuate,base,calyx,campanulate,cm,corolla,diameter,ellipsoidal,elliptical,fruiting,glandular,globose,herb,hollow,ill-smelling,leaf,length,light,long-stalked,mm,narrowly,ovate,petiole,poricidal,pubescent,purple,seed,simple,slightly,stem,stigma,straight,style,sub-shrub,tip,trichome,tube,unequal,violet	-15,-16,.5,0-,0.4,0.5-0.7,0.6,0.8-,1-1.2,1-2,1.2-2.2,1.3-1.8,1.6,1/10,13,14,2-,2.2-,3-8.2,3.5,3.7-4,5,5-,6-celled,7,7-15,8-celled,abundant,accrescen,ag,aggregate,antrorse,ape,articulate,ature,basal,berry,bicellular,branch,c.,cell,connectival,crushed,cuticle,dark,delicate,diamete,difoliate,directed,dorsally,eaf,edentate,erect,filament,finely,flexuous,fragrance,free,generally,glabrous,head,herbaceous,hig,inconspicuous,inserted,lamina,lobe,long,longer,longitudinal,longitudinally,lower,many-,margin,midvein,narrow,near,non-glandular,occasionally,odorles,opening,orolla,ovoid,pair,papillate,patent,pericarp,pore,portion,prolongation,pubescence,reduced,ree,ridged,ruit,saddle-shape,scarce,scarcely,secondary,seeded,seen,separated,serrulate,short-stalked,shorter,single-celled,sinus,slit,small,smooth,solitary,spur-like,stalk,stone,striat,striate,sub-opposite,tem,thecae,thickened,time,tooth,triangular,twice,unit,upward,vary,vein,ventrifixed,verrucate,viscid-pubescent,x,ympodial,¼,½	accrescent,arrangement,articulation,bark,color,connation,dehiscence,diminishing,distal,foetid,foliage,form,fruit,growth,height,history,inflorescence,interjected,lateral,leaflet,life,na,ovary,papillae,pedicel,peduncle,petiolule,plant,position,prickle,pseudostipule,saddle-shaped,shape,size,spacing,straightnes,surface,terminal,texture,tuber-bearing,young
308	wfo-0001027961	success	177	115	76	101	39	0.429	0.25-0.5,0.5-1,1-1.5,1-3,1-4,1-5,1-9,2-2.5,2.5-9,8-10,?,acute,anther,apex,articulated,asymmetric,base,branched,calyx,clavate,cm,conical,connivent,cordate,corolla,diameter,ellipsoid,elliptic,fading,fruiting,glabrous,globose,green,growth,immature,inflorescence,lateral,loosely,many,minutely,mm,obovate,occasionally,often,pedicel,peduncle,petiole,pinnatifid,poricidal,pubescent,purple,reddish,rotate-stellate,simple,sleeve,slightly,small,sparsely,stem,stigma,style,surface,terminal,time,tip,triangular,trichome,truncate,tube,uniseriate,vine,violet,white,woody,x,yellow	.5,0.25,0.9-1,1,10-50,2.3-2.5,3-3.5,4.5-5,5-8,5-merou,6-9,7-9,<,abaxially,adaxiall,adaxially,age,always,alyx,anthesi,apar,ark,axil,berry,broadly,brow,c.,clear,curling,deltate,densely,distributed,eaf,early,eed,entire,equalling,exserted,filament,flower,free,fusiform,geminat,ilament,irregularly,lamina,lengthening,lobe,lobed,lon,long,lower,margin,mature,maturity,membranous,midrib,minute,new,nflorescence,observed,older,one,orolla,other,pair,papillo,pendan,perfect,pericarp,pinched,planar,plurifoliate,pore,portion,present,primary,probably,pubescen,ruit,scar,shiny,slender,slit,spaced,spreading,tem,thin,transition,tuft,twinin,twining,ud,unequal,unit,upper,vary,vein,way,white-pubescent,ympodial	apart,arrangement,articulation,bark,brown,color,connation,dehiscence,diminishing,distal,foetid,foliage,form,fruit,height,history,interjected,leaf,leaflet,length,life,midpoint,na,ovary,papillae,papillose,petiolule,plant,position,prickle,pseudostipule,seed,shape,size,spacing,straightnes,texture,tuber-bearing,young
309	wfo-0001027965	success	265	154	120	145	34	0.453	.1,.25,.5,.9,/3,0.1-0.2,0.2,0.4,0.5,0.6-0.9,0.8-1.6,1-2,1.2,1.5-2,1/4-1/3,2-2.5,2-3,2-3.5,2-4,2.2-2.6,2.8-3.3,3.5,6-9,abaxially,accrescent,adaxially,almost,along,ame,anther,anthesi,apex,apparently,articulated,bark,base,berry,branch,branched,brown,brown-green,c.,calyx,capitate,chartaceous,clavate,clustered,cm,corolla,curved,diameter,discolorous,distributed,drying,dull,evenly,extending,fairly,fasciculate,filiform,finely,flattened,forming,free,fruit,fruiting,green,grey-brown,lateral,leaf,length,liana,lobed,long,mature,maturity,midpoint,mixture,mm,often,orange,orange-brown,ovate,pale,pedicel,peduncle,petiole,pit,pitted,poricidal,porrect,prickle,ray,red-brown,reniform,rounded,sessile,shiny,shrub,smooth,somewhat,sparse,spheroidal,stalk,stalked,stem,stigma,straight,style,surface,tapering,tip,toward,translucent,trichome,tube,white,widening,x,young	-2,.2,.3,.7,0.15,0.15-0.3,0.3,0.4-0.5,0.5-3,0°,1,1-8,1.5-2.5,1.5-3.2,1/3-1/4,1/3-2/3,3.5-10,4-7,4-merou,4.5,7-8,abaxial,absent,acicular,acuminate,acute,adaxial,adjacent,age,alternate,alyx,apar,ape,apically,armed,becoming,beneath,canaliculate,cordate,covered,cupular,deltoid,dense,densely,density,detaching,development,divided,dry,eaf,early,eed,ellipsoi,elongated,entire,equal,erect,even,except,filament,fissure,flat,flexuous,flower,glabrescent,glabrous,increasing,indumentum,inside,leave,lengt,lengthening,less,like,lobe,loop,lower,m.,main,midvein,minor,nflorescence,nther,obconical,oblique,oblong,occasional,orolla,outside,pair,papillose,patch,pendulous,perfect,pericarp,plurifoliat,pore,portion,present,primary,protruding,pubescent,rachi,raised,reduced,regular,remnant,ridged,ruit,scar,series,short,simple,sinus,small,sometimes,sparsely,spreading,stellate,stellate-pubescent,strongly,stump,tearing,terete,tertiary,thin,throughout,transverse,ud,unarme,unarmed,underneath,unequal,uneven,unit,usually,variable,vary,vein,venation,visible,wide,wrinkled,ympodial,youngest	60-100,arrangement,articulation,color,connation,dehiscence,diminishing,distal,foetid,foliage,form,growth,height,history,inflorescence,interjected,leaflet,life,na,ovary,papillae,perennial,petiolule,plant,position,pseudostipule,seed,shape,size,spacing,straightnes,terminal,texture,tuber-bearing
310	wfo-0001027966	success	207	109	84	123	25	0.406	0.8-2.5,1-10,1-2,1-4.2,1-5,1.2-4.5,1.5-5.2,10,10-30,2.8-9,3-5,4,40-80,5-6,5-9.5,6-11,absent,acuminate,anther,apex,base,berry,blue-violet,brownish,chartaceous,cm,condition,conical,connivent,corolla,densely,diameter,drying,elliptic,forked,fresh,fruit,green,greenish,hair,herb,interjected,lanceolate,lateral,leaf,leaflet,light,like,membranous,minute,mm,moniliform,mucilaginous,odd-pinnate,ovate,ovoid,pedicel,peduncle,pentagonal,petiole,plant,poricidal,pubescent,purple,rarely,ripe,rotate,seed,sessile,size,somewhat,stem,stigma,straight,subsessile,terminal,tip,tube,typically,usually,wet,whitish,x,yellow	0.4-0.5,0.7-3,0.8,1-1.8,1-3,1.3-2.2,1.5-3,2.2-2.9,2.5-10.5,3-4,3-7,5-10,5-merou,5.5-14,abaxially,acumen,adaxially,ag,along,alyx,apart,apparently,arranged,articulated,asymmetrical,attenuate,axe,axillary,basiscopic,bead,blade,bud,capitat,cell,ciliate,commonly,covering,decreasing,digestion,distal,dorsally,eaf,edge,eed,enzyme,erec,especially,exceeding,filament,flat,flower,folded,geminat,generally,glabrou,glabrous,gradually,green-white,hair-like,half,homostylous,honeycomb-shaped,larger,lengthening,less,living,lobe,long,lower,make,margin,medium,middle,mottled,multiple,narrow,necklace,nflorescence,orbicular,orolla,pair,pale,perfect,petiolule,plurifoliate,pore,proximal,ray,removed,ruit,secondary,semierect,seudostipule,shorter,side,slightly,slit,spaced,sparsely,specimen,stamen,ste,stolon,subequal,subtending,symmetrical,tall,tamen,tem,testal,thick,throughout,tissue,tri-,tuber,tyle,unit,violet,wall,white,wide,wing,ympodial	arrangement,bark,calyx,capitate,color,connation,dehiscence,form,growth,height,history,inflorescence,length,life,na,ovary,papillae,pseudostipule,shape,spacing,straightnes,style,surface,texture,tuber-bearing
311	wfo-0001027978	success	197	132	97	100	35	0.492	0.5-1,1-2,1-3,1-6,10-14,3-5,3-6,4-10,4-5,4-6,5-8,6,6-10,7-10,absent,accrescent,acute,anther,apex,apical,attenuate,base,brown,calyx,chartaceous,cm,connivent,diameter,directed,distal,extra-axillary,filiform,flower,fruit,fruiting,functionally,geminate,globose,green,hair,hermaphroditic,immature,leaf,length,like,lilac,lobe,lobed,long,male,many,mature,midpoint,mm,moderately,narrowly,nearly,netlike,often,orange,orange-red,ovary,ovate,pedicel,peduncle,petiole,pit,plant,porrect-stellate,prickle,pubescent,raised,recurved,reflexed,ridge,roselike,round,scandent,separated,shrub,slightly,small,spaced,stellate,stem,stigma,style,surface,tan,tapering,triangular,tube,unbranched,white,wide,x,yellow	0.2-0.5,0.5-1x,1,1-1.5,1.5,1.5-2.5,1/6,11,2-2.5,2-3,2.5-3,2.5-5.5,20-40,4-8,7-9,8-12,abaxial,abaxially,absen,adaxial,adaxially,along,alyx,andormonoeciou,andromonoecious,apar,apparently,armed,asymmetrical,axe,becoming,berry,beyond,blade,cordate,cut,cylindrical,dark,densely,difoliate,discolorous,eaf,eed,either,end,entire,except,exserted,filament,flattened,frui,glabrou,glabrous,gree,heteromorphic,initially,introrsel,less,lower,major,margin,midrib,midvei,midvein,multicellular,multiseriate,nflorescence,obtuse,occasionally,orolla,pair,per,pore,proximal,rachi,ray,ruit,scattered,short,side,simple,sinus,sparsely,stalk,stamen,staminate,ste,straight,tamen,tem,thin-skinned,unarmed,unequa,unicellular,unit,vary,vegetatio,vein,way,ympodial	apart,arrangement,articulation,bark,color,connation,corolla,dehiscence,diminishing,foetid,foliage,form,growth,height,history,inflorescence,interjected,introrsely,lateral,leaflet,life,na,papillae,position,pseudostipule,seed,shape,size,spacing,straightnes,terminal,texture,trichome,tuber-bearing,young
312	wfo-0001027997	success	174	104	68	106	36	0.391	.2,0.2-2,0.9-1,1-2,1-4,acute,anther,apex,attenuate,auriculate,bark,base,becoming,bi-lobed,bright,calyx,cm,corolla,dirty,distal,fruiting,glabrous,globose,green,greenish-yellow,inflorescence,lateral,leaf,lobed,minutely,mm,obovate,occasionally,opposite,ovary,ovoid-reniform,pale,papillose,pedicel,petiole,pitted,plant,poricidal,pubescent,ribbed,ripe,shaped,shrub,simple,small,soft,somewhat,sparsely,stem,stigma,straight,strongly,style,surface,tan,tear-drop,tip,tree,trichome,tube,uniseriate,white,young	.1,.5,.6,0.1-0.7,0.1-0.8,1,1.5-1.7,1.5-1.8,1.5-2,10-20-flowered,10-23,2,3.5-10,7-10,7/8,abaxially,along,anthesi,apar,ba,beneath,berry,black,blade,breaking,brittle,consisting,corky,decurrent,deflexed,deltoid,dense,densely,denser,dia,dry,eaf,edicel,eed,entire,erect,even,evenly,exserted,filament,free,glabrate,impressed,inflorescenc,keel,keeled,later,like,live,living,lobe,long,long-acuminate-triangular,long-ellipsoid,lower,main,margin,middle,nflorescence,often,old,older,onto,ovoid,pair,partially,planar,pore,portion,prominent,pubesent,raised,reddish-brown,remaining,rest,ruit,scar,scattered,sessile,short,slender,slightly,soon,spaced,specimen,tall,tapering,trunk,ud,ultimately,unifoliat,unit,vasculature,vein,way,widest,wing,winged,woody,x,ympodial	apart,arrangement,articulation,color,connation,dehiscence,diameter,diminishing,foetid,foliage,form,fruit,growth,height,history,interjected,leaflet,length,life,midpoint,na,papillae,peduncle,petiolule,position,prickle,pseudostipule,seed,shape,size,spacing,straightnes,terminal,texture,tuber-bearing,unifoliate
313	wfo-0001028014	success	222	105	71	151	34	0.32	-10,-15,-2.5,0,0.2-1,0.2-1.6,0.5-1,0.5-1.5,0.9-1.2,1-4,2-4.5,2-6.5,almost,anther,apart,apex,articulated,bark,base,black,calyx,cell,chartaceous,cm,connivent,cordate,diameter,flattened-reniform,fruit,fruiting,lateral,leaf,length,lobed,maturity,mauve,membranous,midpoint,mm,orange,outline,ovate,pedicel,peduncle,petiole,pit,poricidal,porrect,prickle,purple,raised,red,rough,rounded,seed,sessile,shiny,shrub,simple,spherical,spreading,stalked,stem,style,surface,tapering,terminal,tip,trichome,tube,visibly	-0.5,-1,-1/2,-3,-4,-5,-6,.5,/5,0.1-0.2,0.15,0.15-0.3,0.2,0.2-0.4,0.25,0.3-0.4,0.5,0.5-2,0.5-3,0.6-0.9,0.7-1,0.7-1.6,1-,1-10,1-2,1-3,1.3-2.4,1.5,1.5-2,1.8-3,1/4,1/4-2/3,2,2-20,2-3,2.5-4,3-10,4-10,4.5-7,5-merous,6-10,6-11,abaxially,acuminat,alyx,ame,apar,apically,apparently,around,berry,blade,branched,broad-deltate,brown,brown-green,c.,concolorous,curved,decurrent,deltate,densely,difoliate,discolorous,distance,drying,eaf,edge,eed,elongating,equal,erect,extending,eye,filament,flattened,flower,free,geminat,glabrescent,glabrou,glabrous,gland,globular,gray,gray-green,herbaceous,infructescence,lobe,lon,long,longer,lower,margin,mature,midvein,moderately,naked,nflorescence,obtuse,occasionally,older,one,open,orange-gra,orolla,oung,outer,pair,pale,pendulous,per,perfec,pericarp,portion,prickl,prickly,primary,ray,reduced,reflexed,ruit,scandent,scar,shorter,side,slender,smooth,sometimes,spaced,stalk,stellate,stellate-pubescent,straight,strongly,tamen,terete,tertiary,time,unit,vary,vein,venation,visible,way,weakly,wide,winged,yellow,yellow-green,ympodial	arrangement,articulation,color,connation,corolla,dehiscence,diminishing,distal,foetid,foliage,form,growth,height,history,inflorescence,interjected,leaflet,life,na,ovary,papillae,perennial,petiolule,plant,position,pseudostipule,shape,size,spacing,stigma,straightnes,texture,tuber-bearing,young
314	wfo-0001028017	success	158	115	69	89	46	0.437	0.3-1,1-3,1.5-2,15-35,2,2-4,2.5-5,3-12,3-14,3-4,6-8,acute,apex,articulated,base,beyond,brown,calyx,clavate,cm,connivent,cuneate,diameter,directed,distally,eglandular-pubescent,ellipsoidal,elliptic,exserted,flattened,forked,fruit,fusiform,glabrous,glandular-puberulent,green,greenish,immature,introrse,lanceolate,long,mm,near,oblique,ovate,pedicel,peduncle,petiole,purplish,rarely,ripe,short-acuminate,simple,sometimes,sparsely,stamen,stellate,stellate-campanulate,stigma,style,time,tree,truncate,tube,unbranched,white,wide,x,yellow	-2.5,1,1-10,1-2,10-22,13-40,15-50-flower,2-3,3,3-foliat,40-50,5,5-7,5-9,6-7,9-11,abaxially,absen,absent,acuminate,adaxially,aggregate,apart,ape,apiculate,axe,basal,blade,cell,chartaceous,ciliat,connective,cream,cylindrical,densely,eaf,eed,eglandular,eglandular-puberulent,entire,exceeding,fleshy,flower,glandular,glandular-,hair,leaving,lobe,lon,lower,margin,moderately,narrowly,nflorescence,nther,obtuse,orolla,ovoid,pedicellar,perfect,pointed,pore,puberulen,pubescent,purple,rachi,radiu,remnant,ruit,shorter,slightly,small,spaced,stone,subcoriaceous,tal,tan,tem,thecae,tip,tomentose,triangular,truncat,ud,unit,vary,vein,without,ympodial	anther,arrangement,articulation,bark,color,connation,corolla,dehiscence,diminishing,distal,foetid,foliage,form,fruiting,growth,height,history,inflorescence,interjected,lateral,leaf,leaflet,length,life,midpoint,na,ovary,papillae,perennial,petiolule,plant,position,prickle,pseudostipule,seed,shape,size,spacing,stem,straightnes,surface,terminal,texture,trichome,tuber-bearing,young
315	wfo-0001028025	success	182	85	51	131	34	0.28	0,0.1-2.2,0.15-0.25,0.4-3,1.6-3.5,2.5-4,3.5-4.5,7-13,acute,anther,apex,articulated,base,calyx,chartaceous,cm,cordate,diameter,extra-axillary,fruit,fruiting,globose,green,inflorescence,lateral,lavender,length,lobed,mm,obtuse,ovate,pale,pedicel,peduncle,perennial,petiole,present,prickle,pseudo-racemose,sessile,shallowly,shrub,simple,stellate,stem,straight,style,tube,white,yellow,yellowish-green	%,.8,0-0.5,0-11,0.2-0.3,0.2-0.7,0.3-0.8,0.3-1,0.5-0.7,0.9-1.2,1-1.4,1-8,1.1-1.4,1.4-2.2,1.5-7,1.9-2.4,10-140,11-18,12-17,13-21,16-23,2-2.3,2-6,2-locular,3-5,3-6,4-10,4-8,5-,5-11,5-20,5-7,50-90,6-,6.5-10,7-8,7-9,9-14,abaxially,absen,absent,acicular,across,adaxiall,adaxially,alyx,anvil-shape,apart,armed,attenuate,axe,ba,blade,broad-based,brown,cross-section,cylindrical,d.,directed,distall,distributed,dult,eaf,eed,eglandular,erect,exocarp,finger,flower,glabrous,gland-tipped,hair,half,hig,index,juicy,lamina,less,lobe,lobing,lon,long,longer,lower,margin,mature,merou,mesocarp,mid-point,midpoint,midvein,minute,moderately,moist,nflorescence,oblique,onl,orolla,part,per,perfect,placenta,pore,porrect,ray,rhizomatous,ridged,ruit,short,side,spaced,sparsely,stage,stalked,stellae,stellate-pubescent,tamen,thick,throughout,time,transparent,unarmed,unbranched,unit,unknow,uvenile,vary,vein,wide,x,ympodial	arrangement,articulation,bark,color,connation,corolla,dehiscence,diminishing,distal,form,growth,height,history,interjected,leaf,leaflet,life,na,ovary,papillae,petiolule,plant,position,pseudostipule,seed,shape,size,spacing,stigma,straightnes,surface,terminal,texture,tuber-bearing
316	wfo-0001028033	success	157	98	52	105	46	0.331	.6,3,50,acuminate,acute,anther,apex,attenuate,base,brown,calyx,cell,chartaceous,cm,connivent,cyme,diameter,elliptic,fruit,glabrescent,growth,herb,lateral,length,light,like,long,mm,nearly,oblong,pedicel,petiole,poricidal,pubescent,shrub,simple,slightly,sparsely,spreading,stellate,stem,stigma,straight,style,surface,trichome,tube,unbranched,uniseriate,upright,white,yellow	1.4–1.8,1.5,1–4,1–5,2–3,2–4,2–foliate,3–11,3–4,3–5,4–12,4–5,5-merou,5–7,6–12,abaxially,adaxiall,adaxially,along,alyx,anthesi,ark,ascending,becoming,blade,branch,brochidodromous,capitat,ciliate,contiguou,cordate,cylindrical,darker,decurrent,deeply,densely,denser,directed,discolorous,drying,eaf,eed,emarginate,entire,equal,eye,few-branched,filament,florescence,flower,geminat,glabrous,green,greenish,high,hispid-pubescent,introrsely,know,known,linear-lanceolate,lobe,lobed,longitudinal,lower,mainly,margin,membranaceous,midrib,naked,new,older,onto,opening,order,orolla,ovate-lanceolate,perfect,pore,prominent,prostrat,pubescence,recurved,rhizomatous,ruit,secondary,sessile,shin,shiny,shorter,slit,solitary,strongly,subapical,tamen,tem,unit,unknown,vary,vein,venation,visible,wide,woody,ympodial,×	1,3-5,4-12,4-5,6-12,arrangement,articulation,bark,capitate,color,connation,contiguous,corolla,dehiscence,diminishing,distal,foetid,foliage,form,fruiting,height,history,inflorescence,interjected,leaf,leaflet,life,midpoint,na,ovary,papillae,peduncle,petiolule,plant,position,prickle,pseudostipule,seed,shape,size,spacing,straightnes,terminal,texture,tuber-bearing,young
317	wfo-0001028035	success	172	90	51	121	39	0.297	1,1.3-1.8,1/4-1/3,2,2.5-4,3-6,5-10,annual,anther,apically,base,blade,brown,calyx,capitate,cm,dark,diameter,flattened-ovoid,foveolate,fruit,herb,internodal,leaf,long,markedly,minutely,mm,narrowly,oblong,ovate,pedicel,pentagonal,petiole,pinnatifid,prickle,reticulately,seed,short,slightly,spherical,stellate-pubescent,stem,surface,tapering,terminal,tube,twice,undulate,wrinkled,yellow	1.5,2.5-3.1,2/3,3,3.7-4.2,4-8,4.2-5.5,5,50-90,6-13,7-10,7-10-flowered,9-13,accrescent,acicular,across,almost,along,alyx,ample,anthesi,armed,berry,bristle,bristly,broad,broad-based,broadly,campanulate,cauline,closely,confluent,congested,da,dark-based,deep,densely,developing,dia,difoliate,distinct,divided,dry,eaf,erect,exceeding,externall,felty,flattened,flower,geminat,glabrous,hardly,hilum,incurved,interpetalar,invested,lanceolate,lobe,lon,long-rayed,m.,main,maturity,midpoint,n,nflorescence,notch,noticeably,numerous,often,one,orolla,other,per,pigmentation,plicate,prickly,prominent,purple,ray,reaching,recurved,red,rounded,ruit,scattered,shorter,slende,sometimes,somewhat,spaced,splitting,spreading,stalk,stellae,stellate,stellate-wooll,stout,styl,suffused,sunken,symmetrically,tall,tamen,taprooted,tightly,tigma,tissue,tub,tyle,ultimate,unit,upper,usually,vary,vein,well,wide,yello,ympodial	apex,arrangement,articulation,bark,color,connation,corolla,dehiscence,diminishing,distal,foetid,foliage,form,fruiting,growth,height,history,inflorescence,lateral,leaflet,length,life,na,ovary,papillae,peduncle,petiolule,plant,position,present,shape,size,stigma,straightnes,style,texture,trichome,tuber-bearing,young
318	wfo-0001028044	success	195	100	60	135	40	0.308	0.3,0.4-0.5,19-22,2-3,2.8-3.3,20-21,3-6,4-5,6.5-7.2,accrescent,anther,apex,articulated,attenuate,base,black,branched,calyx,cm,corolla,creamy,dendritic,diameter,drying,fruit,fruiting,glabrate,globose,lateral,leaf,length,long-attenuate,many,mm,multangulate,oblong,obovate-elliptic,pale,pedicel,peduncle,petiole,poricidal,porrect-stellate,rough-granular,seed,shrub,simple,stellate,stigma,style,surface,thin-textured,time,tip,tube,white,x,yellow,yellow-brown,young	-3.5,-5,.6,.9,1.2-1.4,1.3-2.2,1.4-1.6,1.5-2,1/3-1/2,11-13,11-16,16,2-4,2.7-4,3-4,3.4-4.3,3.5-4.6,31-46,5-merou,50,6-8,7.5-9,9.5-13,abaxial,abaxially,acute,adaxiall,adaxially,ag,along,alyx,anthesi,apart,around,ature,axe,axillary,becoming,berry,blade,blunt-tipped,branch,brown,bud,bulbous-based,capitat,closely,concentrated,connivent,cylindrical,dark,decurrent,directed,distally,eaf,edge,entire,except,exserted,few-rayed,filament,fleshy,flower,frui,geminate,glabrescen,glabrous,green,greenish,hair,high,homostylous,immature,lackin,lengthening,lobe,lobed,long,long-stalked,longitudinal,lower,main,margin,midrib,moderately,mostly,much,multangulat,nearly,nflorescence,obscured,obtuse,occur,orolla,ovate-lanceolate,plurifoliate,pore,presumably,pubescent,rachi,rather,resorption,ruit,runk,semi-obtuse,side,slender,slit,somewhat,spaced,sparse,sparsely,stalked,stamen,subcampanulate,suture,tamen,terete,thick,thick-stalked,tissue,tomentose,tomentu,unarme,unbranched,unit,unknown,vary,vein,way,weakly,wide,winged,yellowish,ympodial	0.6,4.9,arrangement,articulation,bark,capitate,color,connation,dehiscence,diminishing,distal,foetid,foliage,form,growth,height,history,inflorescence,interjected,leaflet,life,midpoint,na,ovary,papillae,perennial,petiolule,plant,position,prickle,pseudostipule,shape,size,spacing,stem,straightnes,terminal,texture,trichome,tuber-bearing
319	wfo-0001028046	success	186	123	91	95	32	0.489	0.2-0.3,0.3-0.5,0.5-1,1-7,12-13,2-3,2-4,3-12,4-5,acuminate,acute,anther,apex,articulated,attenuate,bark,base,blue,brown,c.,calyx,chartaceous,clavate,cm,compressed,corolla,dark-brown,diameter,distal,elliptic,flattened,foveolate,fruiting,glandular,globose,grayish,green,growth,inflorescence,lanceolate-subulate,leaf,length,like,lilac,long-styled,midpoint,minute,mixed,mm,multicellular,obovate,opposite,ovary,pedicel,peduncle,petiole,poricidal,porrect,prickle,prominent,pubescent,ray,red,reduced,reniform,rusty,rusty-red,sessile,short-styled,shrub,simple,slightly,spaced,sparse,stalked,stellate,stem,stigma,style,sub,subhirsute,subsessile,surface,tapering,tip,trichome,truncate,tube,unevenly,unicellular,yellow	0.4-0.5,1-1.3,1-1.5,1-multicellular,1.2-1.5,1.5-2,10,10-15,13-38,2.5-3,20,5-18,6-7,8-9,abaxially,adaxially,anthesi,approximately,armed,basal,berry,campanulate,coriaceous,cylindrical,decurrent,deflexe,densely,denser,difoliat,eaf,eed,entire,erect,exserted,filament,flower,foliaceous,free,glabrescent,glabrous,gland-tipped,half,heterostylous,large,lengthening,lightly,lobe,lobed,long,lower,margin,minutely,multangulate,nearly,new,nflorescence,obverse,occasionally,older,ovoid,papillo,per,perfect,pericarp,pore,portion,prickly,pubescence,raise,reflexed,rest,rigid,ruit,scabrous,scar,slit,somewhat,sparsely,staminate,subcordate,subglobose,subscandent,tall,testa,thick,tomentose,tomentose-scabrous,ud,unarmed,unit,upper,winged,x,ympodial,¼	/,arrangement,articulation,color,connation,dehiscence,diminishing,foetid,foliage,form,fruit,height,history,interjected,lateral,leaflet,life,na,papillae,petiolule,plant,position,pseudostipule,seed,shape,size,spacing,straightnes,terminal,texture,tuber-bearing,young
320	wfo-0001028059	success	221	111	76	145	35	0.344	-4.5,0-1.2,0-2,0.5-1.3,1-3,1.5-2,1.5-3.5,2-10,2.5-2.6,2.5-3.5,3-10,8.5-10,absent,accrescent,acicular,acuminate,acute,anther,apex,articulated,bark,base,brown,brownish,calyx,chartaceous,cm,connivent,contiguous,corky,cuneate,densely,diameter,elliptic,fruit,fruiting,furrowed,globose,green,inflorescence,lateral,leaf,leaf-opposed,length,lilac,long,loosely,mm,nearly,oblate,oblong,obtuse,ovate,pale,pedicel,peduncle,perennial,petiole,plant,present,prickle,pseudo-racemose,purple,shrub,simple,somewhat,stellate,stellate-pubescent,straight,style,surface,tube,upper,x,yellow,yellowish-green	%,.4,0-0.2,0-0.3,0-15,0-7,0.1-0.3,0.1-0.6,0.1-0.7,0.4-0.7,0.4-0.8,0.4-0.9,0.5-0.7,0.5-0.8,0.6-0.8,0.6-1,1,1-1.5,1-2,1.1-12,1.1-4.5,1.5-2.1,15,2-2.6,2-3,2-5,2-foliate,2-locular,2.1-2.7,2.5-12,3-11.5,3-17,4-10,4-7,4-8,4.5-7,5-7,5-9,5-merou,6-17,60-90,8-18,9-12,9-17,abaxially,absen,across,adaxiall,adaxially,adult,alyx,andromonoecious,anvil-shape,apart,ascending,attenuate,axe,ba,blade,branch,branche,cross-section,cylindrical,decimetre,deltate,directed,distall,distributed,dm,eaf,eed,eglandular,entire,erect,exocarp,filament,finger,flower,functional,geminat,glabrous,gland-tipped,glandular,hair,half,heterostylous,interpetalar,juicy,juvenile,lamina,less,lobe,lobed,longer,lower,margin,mature,mesocarp,mid-point,midpoint,midvein,minute,moderately,moist,nflorescence,oblique,often,orolla,pair,part,per,placenta,pore,porrect,rachi,ray,rhizomatous,ruit,rusty,shallowly,short,spaced,sparse,sparsely,stalk,stalked,stellae,tal,tamen,tem,thick,throughout,time,tissue,toward,transparent,unarme,unarmed,unbranched,unit,vary,weakly,wide,yellowish,ympodial	arrangement,articulation,color,connation,corolla,dehiscence,diminishing,distal,foetid,foliage,form,growth,height,history,interjected,leaflet,life,na,ovary,papillae,petiolule,position,pseudostipule,seed,shape,size,spacing,stem,stigma,straightnes,terminal,texture,trichome,tuber-bearing,young
321	wfo-0001028067	success	139	100	60	79	40	0.432	-30,0.5-1,0.5-2,1-10,1-7,10-25,2-3,3-5,3-7,6-18,7-11-compound,7-9,acuminate,acute,apart,apex,articulated,base,calyx,cm,color,connivent,cuneate,dark,diameter,elliptic-fusiform,elliptic-ovate,flattened,fruit,glabrous,lateral,leaf,leaflet,mm,moderately,narrowly,pedicel,peduncle,petiole,pink,pinnately,puberulent,purple,rarely,shrub,simple,slightly,sparsely,stellate,stigma,strongly,style,tomentulose,triangular,truncate,tube,unbranched,unknown,x,yellow	0.5-1.5,1,1-11,1-2,1-3,1.5-2.5,2,2-2.5,2.5-3,3-17,3-4,4-foliat,5-7,6-12,7-20,8-13,abaxially,adaxiall,adaxially,aggregate,along,axe,basiscopically,blade,cell,chartaceous,compound,cylindrical,decurrent,directed,distall,eaf,eed,entire,especially,flower,glabrou,hair,leaving,lobe,lon,long,lower,margin,midrib,nearly,nflorescence,nther,obtuse,often,orolla,pedicellar,per,pore,puberulen,rachi,radiu,remnant,ripe,ruit,several,smal,spaced,stone,subcoriaceous,tal,tem,time,tip,triangular-deltate,truncat,unequal,unit,upper,usually,vary,wide,ympodial,zigzag	anther,arrangement,articulation,bark,connation,corolla,dehiscence,diminishing,distal,foetid,foliage,form,fruiting,growth,height,history,inflorescence,interjected,length,life,na,ovary,papillae,petiolule,plant,position,prickle,pseudostipule,seed,shape,size,spacing,stem,straightnes,surface,terminal,texture,trichome,tuber-bearing,young
322	wfo-0001028069	success	253	103	74	179	29	0.292	0.05-0.1,0.2-0.3,0.4-0.8,0.5-0.7,0.5-1.8,0.5-2,0.6-4,1-3.5,10,10-12,2-3-branched,2-7,3,accrescent,acute,anther,apex,articulated,base,basioscopically,brown,calyx,cm,corolla,decurrent,deep,densely,diameter,fruit,fruiting,globose,green,hair-like,herb,imparipinnate,interjected,interrupted,lateral,leaf,leaflet,length,linear,minute,mm,oblique,obovate,occasionally,orange,outgrowth,ovary,ovate,pale,pedicel,peduncle,pentagonal,perennial,petiole,petiolule,plant,present,pseudostipule,pubescent,rounded,simple,size,stem,stigma,straight,style,surface,terminal,trichome,tube,yellow	-0.4,-30,-6,.1,.1-0.2,.2,.5,0.1-0.15,0.1-0.2,0.1-0.3,0.1-0.5,0.1-0.6,0.2-0.5,0.3,0.3-0.4,0.3-0.45,0.3-0.6,0.3-0.7,0.3-1,0.4,0.4-0.5,0.4-1,0.5,0.6-1.1,0.7-1,0.7-1.3,0.7-1.5,0.8-1.2,1-2-celled,1-2.7,1-4.5,1.4,1.5-2.0,1.5-3.5,1.6-3.2,10-30,12,2-17,2-4,2-locular,3-,3-foliate,4-celled,5-22,5-25,6-,<,abaxially,absen,abundant,adjacent,adpressed,along,alternate,always,among,anthesi,apical,appearance,appendage,appressed,axi,ba,basal,becoming,berry,bilaterally,bract,bracteole-like,bright,cell,citru,column,composed,cone-shaped,conical,cordate,cuneate,curving,deeply,dense,due,eaf,ebracteate,edicel,eed,eglandular,erect,exserted,filament,flower,forming,fusion,giving,glabrescent,gland,gland-tippe,gland-tipped,glandular,glandular-villous,gree,half,halfway,head,included,initially,internode,larger,later,less,like,lime,lobe,lobed,lon,long,longer,longest,lower,margin,maturity,middl,midvein,minutely,multicellular,narrowly,nflorescence,often,one,pair,patent,per,population,primary,procumbent,pubescence,quaternary,rarely,reflexed,robust,ruit,scarcely,scent,secondary,sessile,several,shaggy,short,shorter,silky,single-celled,slender,smaller,somewhat,staminal,sterile,strong,subopposite,symmetric,tangled,tem,tertiary,testa,thick,tightly,toward,transparent,ud,unicellular,uniseriate,unit,usually,varying,viny,wall,weak,wide,winged,ympodial	absent,arrangement,articulation,bark,color,connation,dehiscence,diminishing,distal,foetid,foliage,form,growth,height,history,inflorescence,life,middle,na,papillae,position,prickle,seed,shape,spacing,straightnes,texture,tuber-bearing,young
323	wfo-0001028070	success	185	105	68	117	37	0.368	0-0.4,0.15-0.4,0.2-0.3,0.4-0.6,0.5-1.5,1-2,3-8,4-6,5-9,8-13,8-9.5,accrescent,acute,anther,apart,apex,articulated,base,brown,calyx,chartaceous,cm,cuneate,dark,diameter,extra-axillary,flower,fruit,fruiting,globose,green,half,inflorescence,lanceolate,lateral,lavender,length,less,linear,lobe,long,longer,mature,mm,obtuse,pale,pedicel,peduncle,perennial,petiole,plant,prickle,pseudo-racemose,pseudo-umbellate,shrub,simple,stellate,stem,stigma,straight,streak,style,thick,time,tube,white,wide,yellow	%,.05,0-0.1,0-0.15,0-2,0-6,0.25-0.35,0.3-0.4,0.3-0.6,0.35-0.5,0.4-0.5,0.4-0.8,0.5-0.9,0.5-1,0.6-1.4,0.7-1.3,1-1.5,1-4,1-locular,1.5-2.5,1.5-7,10-40,3-7,3.5-4,4-5.5,4-7,4-9,5-7,5-merou,7-11,7-8,8-9,8.5-17,abaxially,absen,absent,acicular,across,adaxiall,adaxially,alyx,andromonoecious,axe,ba,blade,connivent,cross-section,cylindrical,d.,deltate,densely,directed,distall,distributed,dult,eaf,eed,eglandular,entire,erect,exocarp,finger,functional,geminat,gland-tipped,hair,heterostylous,hig,incomplete,juicy,lamina,lower,margin,mesocarp,mid-point,midpoint,midvein,minute,moderately,moist,nflorescence,oblique,orolla,part,per,placenta,pore,porrect,present,purple,ray,rhizomatous,ruit,rusty,semi-circula,septum,sessile,short,spaced,sparsely,stage,stalk,stellae,stellate-pubescent,tamen,throughout,truncat,unarme,unarmed,unbranched,unit,unknow,uvenile,vary,weakly,x,ympodial	arrangement,articulation,bark,color,connation,corolla,dehiscence,diminishing,distal,foetid,foliage,form,growth,height,history,interjected,leaf,leaflet,life,na,ovary,papillae,petiolule,position,pseudostipule,seed,shape,size,spacing,straightnes,surface,terminal,texture,trichome,truncate,tuber-bearing,young
324	wfo-0001028075	success	196	122	86	110	36	0.439	1-10,1-2,1.5-7,10-35,2-4.5,2-6,2.5-10,3-11,5-14,5-17,5-8,5-9,7-13,7-30,8-12,absent,acuminate,acute,anther,apex,articulated,axillary,base,borne,bud,chartaceous,cm,connivent,corolla,dark,decreasing,diameter,distal,elliptic-lanceolate,end,forked,fruit,glabrescent,glabrous,globose,green,greenish,herb,interjected,lanceolate,lateral,leaf,leaflet,light,membranous,mm,mucilaginous,oblique,obtuse,odd-pinnate,ovate,ovate-elliptic,ovoid,pale,pedicel,peduncle,pentagonal,petiole,plant,poricidal,rotate,rounded,seed,singly,size,slightly,stigma,straight,style,subcordate,subtending,terminal,tip,toward,tube,typically,wet,white,whitish,x,yellow	.5,1-2.7,1-3,1.5-2.5,1.6-2.7,2-3,3-23.5,4-12,4-7,5-12,5-7,5-merou,abaxially,acuman,acumen,adaxially,ag,along,alyx,apart,apparently,axe,berry,blade,broadly,brownish,capitat,cell,ciliate,condition,covering,cuneate,differentiated,digestion,distally,distinctively,dorsally,dot,drying,eaf,edge,eed,enzyme,erec,especially,exceeding,filament,flat,flower,folded,fresh,geminat,generally,glabrescen,green-white,hair-like,half,homostylous,honeycomb-shaped,larger,lengthening,ligulate,living,lobe,long,lower,make,margin,middl,midrib,minutely,much,narrow,nflorescence,often,orolla,pair,perfect,petiolule,plurifoliate,pore,puberulent,purple,reflexed,removed,ruit,scattered,seudostipule,slit,sometimes,spaced,specimen,stamen,star,stolo,tall,tamen,tem,testal,thick,throughout,tri-,tuber,unit,usually,vary,wall,wide,wing,ympodial	arrangement,articulation,bark,calyx,capitate,color,connation,dehiscence,diminishing,foetid,foliage,form,fruiting,growth,height,history,inflorescence,length,life,middle,na,ovary,papillae,position,prickle,pseudostipule,shape,spacing,stem,stolon,straightnes,surface,texture,trichome,tuber-bearing,young
325	wfo-0001028076	success	195	124	98	97	26	0.503	.5,0.4-0.5,1-10,1-2,110,12-22,2-3,2-5.4,2.2-3.7,2.5-4,4.5-7,5,5-20,5-6,7-8,abaxially,absent,adaxially,anther,apart,berry,borne,brownish,cell,chartaceous,cm,condition,conical,connivent,corolla,covering,densely,diameter,drying,elliptic,end,flower,forked,fresh,fruit,glabrous,green,green-white,greenish,hair,hair-like,herb,interjected,lanceolate,lateral,leaf,leaflet,lengthening,less,light,like,long,make,membranous,minute,mm,mucilaginous,odd-pinnate,ovate,ovoid,pedicel,peduncle,pentagonal,petiole,plant,pore,poricidal,pubescent,purple,rarely,ripe,rotate,seed,singly,size,slit,stem,stigma,straight,style,tall,terminal,testal,thick,throughout,tip,tube,typically,wall,wet,whitish,x,yellow	0.5,1-1.3,1-3,1.2-2.2,1.8-2.2,13-14,2-12,2.2-2.6,2.5-3,2.6-3.8,4-5,5-6.5,5-merou,?,acumen,acuminate,ag,alyx,apex,apparently,articulated,attenuate,axe,axillary,base,blade,bud,capitat,ciliate,decreasing,digestion,distal,dorsally,eaf,edge,eed,enzyme,erec,especially,exceeding,filament,flat,folded,geminat,generally,glabrou,gradually,half,homostylous,honeycomb-shaped,larger,living,lobe,lower,margin,medium,nflorescence,obtuse,orolla,pair,perfect,petiolule,plurifoliate,proximal,pubescen,ray,removed,round,ruit,secondary,semierect,sessile,seudostipule,slightly,spaced,specimen,stamen,ste,stolo,subequal,subsessile,subtending,symmetrical,tamen,tem,thir,toward,tri-,tuber,unit,unwinged,usually,vary,white,wide,wing,ympodial	age,arrangement,bark,calyx,capitate,color,connation,dehiscence,form,growth,height,history,inflorescence,length,life,na,ovary,papillae,pseudostipule,shape,spacing,stolon,straightnes,surface,texture,tuber-bearing
326	wfo-0001028080	success	187	103	66	121	37	0.353	0.5-1.5,0.5-2,0.5-3,1-1.5,2-10,2-5,20-30,5-6,8-10,acute,adaxially,anther,apex,articulated,bark,base,brown,brownish,calyx,chartaceous,clavate,cm,diameter,ellipsoidal,extra-axillary,form,fruit,fruiting,green,lanceolate,lateral,leaf-opposed,long,mm,moderately,needle-like,ovate,ovoid,pedicel,peduncle,petiole,plant,prickle,pubescent,recurved,reniform,rugulose,scandent,short-stalked,shrub,simple,sparsely,stellate,stellate-multangulate,stem,stigma,straight,style,subcordate,surface,truncate,tube,unbranched,white,whitish,yellow	0.2-1.5,0.25-0.5,1,1-2,1-3,1.5-2,1.5-5,2-2.5,2-3,2-8,2.5-3,2.5-9,3-4,30-40,4-6,5-12,5-merous,6-7,abaxially,absent,accrescen,acuminate,adaxiall,alyx,andromonoeciou,andromonoecious,apart,armed,axe,ba,berry,blade,branch,capitat,connivent,cylindrical,densely,directed,distally,eaf,eed,eglandular,entire,equal,filament,fine,fissure,flattened,flower,formed,free,geminat,glabrous,glandular,gradually,hair,hermaphroditic,heteromorphic,interpetalar,like,linear-lanceolate,lobe,long-,long-stalked,longitudinal,lower,lowering,major,margin,midpoint,midvein,multangulate,narrowly,nflorescence,opening,orolla,outline,part,pendent,perfect,pericarp,persistent,plurifoliate,pore,porrect-stellate,projection,puberulent,rachi,ray,ruit,sessile,short-,short-styled,shorter,side,slit,small,sometimes,spaced,staminate,stellate-pubescent,strongly,tall,tamen,tapered,thi,time,tissue,triangular,unarmed,unequal,unit,vary,vein,vertical,weakly,white-pubescent,wide,without,x,ympodial	accrescent,arrangement,articulation,capitate,color,connation,corolla,dehiscence,diminishing,distal,foetid,foliage,growth,height,history,inflorescence,interjected,leaf,leaflet,length,life,na,ovary,papillae,petiolule,position,pseudostipule,seed,shape,size,spacing,straightnes,terminal,texture,trichome,tuber-bearing,young
327	wfo-0001028105	success	150	101	67	83	34	0.447	.5,0.3-1.5,0.5-2,0.6-1,1-1.2,1-1.5,1.5-2,2-2.2,3-5-celled,abaxially,acuminate,adaxially,anther,attenuate,axil,bark,base,bilobed,calyx,clavate,cm,corolla,dark,dense,elliptic,flattened-reniform,fruiting,glabrous,glandular,globose,green,lateral,leaf,lobed,long,minutely,mm,nearly,opposite,ovary,pale,pedicel,petiole,pitted,poricidal,pubescent,reddish-brown,shrub,simple,size,slightly,small,stem,stigma,straight,style,surface,tip,tree,trichome,tube,tuft,uniseriate,vein,white,woody,young	.1,.4,0.5,0.5-1,1-2.5,1.5,1.5-1.8,1.5-4.5,2,2-5,3-6,3.5-4,5-7-flowered,6-7,9.5-15,acute,anthesi,apar,apex,apical,axi,ba,berry,conical,deflexed,dia,differing,difoliate,distinct,drying,eaf,edicel,eed,ellipsoid,erect,evenly,exserted,filament,filiform,free,geminat,greenish-yello,incrassate,lamina,like,lobe,lon,lower,main,major,margin,middle,minor,nflorescence,occasionally,older,olive-green,pair,papillo,papillose,planar,pore,portion,projection,quadrate,reflexed,ruit,scar,scattered,shaped,spaced,sparsely,spreading,strongly,tall,tear-drop,tub,ud,unit,widest,x,yellowish,ympodial	apart,arrangement,articulation,color,connation,dehiscence,diameter,foetid,foliage,form,fruit,greenish-yellow,growth,height,history,inflorescence,interjected,leaflet,length,life,midpoint,na,papillae,peduncle,plant,position,prickle,pseudostipule,seed,shape,spacing,straightnes,terminal,texture
328	wfo-0001028109	success	205	117	84	121	33	0.41	-20,-7,/3,0.4-1.5,0.45-0.65,1.5-10,1.5-5.5,2-4,2.5-5,2/3-3/4,20-60,3-7,5-13,acuminate,acute,anther,apart,apex,apparently,articulated,bark,base,berry,bright,calyx,chartaceous,cm,connivent,cuneate,curved,densely,diameter,dull,elliptic,elongating,evenly,flattened-reniform,fruit,fruiting,gently,glabrescent,glabrous,green,lateral,leaf,length,light,lobed,long,mature,maturity,mauve,mm,moderately,multangulate,orange-brown,pedicel,peduncle,petiole,poricidal,prickle,red,shrub,simple,small,sometimes,spherical,stalked,stellate,stellate-pubescent,stem,straight,style,surface,tapering,terminal,tip,tree,trichome,tube,way,white,yellow,young	-4,.5,0.05-0.15,0.05-0.2,0.1,0.1-0.2,0.3,0.4-0.8,0.5-1.2,0.5-2.5,0.6-0.8,0.7,0.8-1.5,0.8-1.6,1.5-2.5,1/8-1/4,10-25,10-30,12-40,15-100,2-15,2.3-2.9,2.5-3,3-,3.5-6,3/4,30-150,4-13,4-5-merous,5-30,8-12,8-15,8-25,abaxial,abaxially,acut,adaxial,almost,alyx,ame,apar,apically,blade,branching,brow,c.,deltate,dimorphic,discolorous,drying,eaf,eed,entire,equal,erect,filament,flower,free,fully,geminate,glabrou,gray-green,green-brown,infructescence,lobe,long-styled,longer,lower,margin,midpoint,minor,nflorescence,obtuse,occasionally,older,one,open,opening,orolla,oung,pair,per,perfec,pericarp,perpendicular,plurifoliat,porrect,portion,prickl,prickly,primary,ray,recurved,red-brown,reflexed,ruit,scar,secondary,sessile,slender,smooth,spaced,spreading,stalk,strongly,tamen,terete,tertiary,time,unarme,unarmed,unit,usually,vary,vein,venation,visible,weakly,wide,woody,ympodial	arrangement,articulation,brown,color,connation,corolla,dehiscence,diminishing,distal,foetid,foliage,form,growth,height,history,inflorescence,interjected,leaflet,life,na,ovary,papillae,perennial,plant,position,pseudostipule,seed,shape,size,spacing,stigma,straightnes,texture
329	wfo-0001028115	success	165	92	51	114	41	0.309	2-3.2,5-15,6-10,abaxially,acute,adaxially,anther,apex,attenuate,base,blue,calyx,campanulate,capitate,cm,curved,diameter,ellipsoidal,elliptical,evident,fruiting,glabrescent,globose,herb,length,light,mm,moderately,narrowly,ovate,pale,papery-scarious,petiole,poricidal,pubescent,reticulate,seed,simple,slender,slightly,stem,stigma,style,tip,trans-ovoidal,trichome,tube,tuberculate,venation,violet,yellow	-1.1,-2.5,-5.2,.2,.6,0.2-0.3,0.42,0.5,0.6-0.7,0.7-0.8,0.8-,1-2.4,1-3,1.1-1.8,1.3-1.8,1.4-1.7,1.7-2.2,1.8-3.5,12-13.5,2-,2.5-,3-4.5,3-5,3-6.5,4.7-,5-8.5,7-7.5,9-17,abundant,accrescent,acuminat,ag,alternate,amply,annular,antrorse,articulate,basal,berry,blade,coat,connectival,difoliat,dorsal,eaf,eed,embryo,entire,especially,exceeding,filament,glabrous,glandular,growing,half,herbaceous,hig,inflated,linear,lobe,long,longer,longitudinal,longitudinally,lower,margin,mixed,much,multi-seeded,near,nerve,non-glandular,oblong,one,opening,opposite,orolla,pair,papillo,pinnatifid,pinnatipartite,pinnatisect,pore,portion,prolongation,prostrate,rarely,ree,ridged,ruit,scarce,segment,similar,slit,small,smooth,sometimes,strongly,styl,subsessil,tem,time,triangular,unequal,unifoliate,uniseriate,unit,vary,wide,wider,width,winged,x,ympodial	2.5-4.5,arrangement,bark,color,connation,corolla,dehiscence,diminishing,distal,foetid,foliage,form,fruit,growth,height,history,inflorescence,interjected,lateral,leaf,leaflet,life,midpoint,na,ovary,papillae,pedicel,peduncle,perennial,petiolule,plant,pseudostipule,shape,size,spacing,straightnes,surface,terminal,texture,tuber-bearing,young
330	wfo-0001028131	success	208	122	87	121	35	0.418	0-2,0.3-0.7,0.5-1.1,0.8-1.1,1-4,1.5-3,4-6,absent,anther,apart,apex,apparently,articulated,attenuate,bark,base,berry,calyx,cell,chartaceous,cm,connivent,cream,dark,densely,diameter,dull,erect,flattened-reniform,fruit,fruiting,glabrescent,glabrous,green,herb,lateral,leaf,length,lobed,marking,maturity,mauve,membranous,midpoint,mm,narrow-obovate,narrow-ovate,obtuse,orange,orange-brown,outline,pale,pale-brown,pedicel,peduncle,petiole,pit,poricidal,porrect,prickle,prickly,purple,raised,red,reflexed,rounded,sessile,shiny,simple,small,smooth,sparsely,spherical,spreading,stellate-pubescent,stem,straight,style,surface,tapering,terete,tip,trichome,tube,unarmed,yellow,young	-1.2,.1,.5,/5,0-0.6,0-3,0-30,0-4,0.05-0.2,0.1-0.15,0.1-0.3,0.2-1.5,0.4-0.8,0.7-1.1,0.8-1,1-10,1-3,1-5,1.5-5,1.8-2,1.8-2.2,1/4-2/3,1/5,2-2.8,2-4,2-5,2-6.5,2/3,3-6,5-6.5,5-8,5-merous,6-7,7-8,abaxial,abaxially,acuminat,adaxial,alyx,apar,apically,blade,branched,broad-deltate,concolorous,curved,deltate,difoliate,distance,drying,eaf,eed,elongating,epidermi,equal,extending,eye,filament,filiform,flattened,flower,free,geminat,gland,infructescence,lanceolate,lengt,like,lobe,long,longer,lower,margin,mature,midvein,moderately,naked,nflorescence,oblong,often,older,one,open,orolla,oung,pair,pale-gra,pendulous,per,perfec,pericarp,portion,prickl,primary,ray,reduced,ruit,scar,sessil,shorter,side,sometimes,spaced,stellate,strongly,sunk,tamen,tertiary,time,unarme,unit,upper,vary,vein,venation,visible,way,wide,woody,yellow-green,ympodial	arrangement,articulation,color,connation,corolla,dehiscence,diminishing,distal,foetid,foliage,form,growth,height,history,inflorescence,interjected,leaflet,life,na,ovary,pale-gray,papillae,petiolule,plant,position,pseudostipule,seed,shape,size,spacing,stigma,straightnes,terminal,texture,tuber-bearing
331	wfo-0001028147	success	185	126	91	94	35	0.492	0.25,0.5,0.6,15–20,1–2,1–4,2–4,5–10,7–10,abaxially,acuminate,adaxially,anther,apex,appearing,base,becoming,berry,branched,break,brown,calyx,campanulate,cell,chartaceous,cm,connivent,corolla,cuneate,dark,decurrent,diameter,elongate,flattened-reniform,fruiting,glabrous,globose,green,hairy,herbaceous,immature,lateral,lengthening,light,long,mature,minutely,mm,mottled,narrowly,oblong,orange,orange-red,outer,ovate,ovoid,pale,pedicel,peduncle,pentagonal,petiole,pitted,pore,poricidal,pulp,seed,shape,simple,slit,somewhat,stellate,stem,stigma,straight,style,surface,terminal,testal,tip,tube,turning,vine,wall,white,wide,woody,x,yellow,yellow-green,yellowish-orange,×	.5,1.5–2,1.5–5.5,1.6–2.3,10–15,1–5,2–7,2–8,3-5,3.5–4.5,3.5–9,3–4,3–6,4-5,5–12,6–9,absent,acute,ag,alyx,anthesi,armed,articulated,axe,blade,broadly,bud,deciduous,deltate,dr.,dry,eaf,eed,ellipsoid,elongating,entire,equal,except,exserted,fifth,filament,five,flower,four,internode,interpetalar,lanceolate,larger,lobe,lobed,long-styled,longer,lower,major,margin,midrib,nearly,nflorescence,often,one,orolla,paired,pericarp,plurifoliat,prickle,puberulent,rachi,rarely,recurve,recurved,robust,rugose,ruit,season,seen,shallowly,short-styled,side,slender,slightly,spine,spreading,stout,subcaudate,tamen,time,tissue,truncat,unequal,unit,vary,vein,wood,ympodial	age,arrangement,bark,color,connation,dehiscence,diminishing,distal,foetid,foliage,form,fruit,growth,height,history,inflorescence,interjected,leaf,leaflet,length,life,na,ovary,papillae,petiolule,plant,pseudostipule,size,spacing,straightnes,texture,trichome,truncate,tuber-bearing,young
332	wfo-0001028148	success	157	102	59	98	43	0.376	0.25-0.5,1-15,1-3.5,1.5,12-15,2-3,3.5-9,5-7,5-8,acute,angled,apart,apex,articulated,base,blue-black,branched,calyx,cm,connivent,dark,decurrent,diameter,distal,elliptic,fruit,glaucous,globose,less,minute,mm,narrowly,orange,ovate,pedicel,peduncle,petiole,pink,plicate,purple,rhizomatous,ridge,rotate-stellate,scalloped,shrub,simple,slender,smooth,stigma,style,surface,tapered,treelet,tube,violet,whitish,x,yellow,young	-6,.5-4,0.5-1.5,0.6-3.5,0.75-2,1.5-2.5,10-30,15,2,2-7,2.5-4,20-50,3.5-4,4-10,4.5-10,5,5-10,5-20,6-18,abaxially,absen,adaxially,aggregate,apiculate,axe,ba,blade,broadly,cell,central,chartaceous,cylindrical,deltate,densely,directed,distall,eaf,eed,entire,especially,except,fleshy,flower,fresh,glabrous,hair,highly,light-colored,lobe,long,lower,many-foliat,margi,margin,material,mature,midrib,moderately,nflorescence,nther,obtuse,often,orolla,part,perfect,plicae,pore,puberulence,puberulent,puberulent-pubescent,rachi,radiu,rarely,ripe,ruit,slightly,smoot,sometimes,spaced,sparse,star,stone,succulent,tal,tem,thickened,time,tip,triangular,truncat,unbranched,unit,usually,vary,white,wide,winge,ympodial	0.5-4,anther,arrangement,articulation,bark,color,connation,corolla,dehiscence,diminishing,foetid,foliage,form,fruiting,growth,height,history,inflorescence,interjected,lateral,leaf,leaflet,length,life,na,ovary,papillae,petiolule,plant,position,prickle,pseudostipule,seed,shape,size,spacing,stem,straightnes,terminal,texture,trichome,truncate,tuber-bearing
333	wfo-0001028161	success	124	92	50	74	42	0.403	0.1-0.25,0.25-0.5,1-1.5,2-9,3-7,4-5,acuminate,acute,apex,attenuate,bark,base,branched,brown,calyx,closely,corolla,dendritic,densely,distal,elliptic,fruiting,globose,green,lanceolate,lateral,leaf,long,minutely,mm,narrowly,opposite,ovoid-reniform,pale,pedicel,petiole,pitted,pubescent,reddish-brown,rounded,shape,shrub,simple,size,spaced,stem,surface,tan,trichome,young	.5,0.7-1.7,1-1.3,1-2,1-2.3,1.5-4.5,1/3,2-5-flowered,2.5-3,3-4,6-9,7.5-12,9-11,abaxially,adaxially,along,anthesi,arising,ba,berry,branch,cell,cm,congested,consisting,deflexed,denser,dia,differing,difoliate,eaf,edicel,eed,exserted,geminat,glabrescen,incrassate,inflorescenc,later,like,lon,main,major,margin,middle,minor,nflorescence,obovoid,often,older,orbicular,outline,overlappin,pair,probably,pubescence,rest,ruit,scar,short,sinuate,somewhat,sparsely,strongly,tall,tapering,thin,tub,ud,unit,vein,widest,x,ympodial	alternate,anther,arrangement,articulation,color,connation,dehiscence,diameter,diminishing,foetid,foliage,form,fruit,glabrescent,growth,height,history,inflorescence,interjected,leaflet,length,life,midpoint,na,ovary,overlapping,papillae,peduncle,petiolule,plant,position,prickle,pseudostipule,seed,spacing,stigma,straightnes,style,terminal,texture,tube,tuber-bearing
334	wfo-0001028164	success	197	131	93	104	38	0.472	-1,-6,/4,0.4-0.8,0.5-0.8,0.5-1,1,1-4.5,1/3,2.5-4.5,3-17,acuminate,acute,almost,ame,anther,apex,apparently,articulated,attenuate,bark,base,branched,bright,c.,calyx,cm,concolorous,connivent,curved,diameter,drying,dull,elliptic,elongating,evenly,flattened-reniform,fruit,fruiting,glabrescent,glabrous,glandular,gray,green,hair,lateral,leaf,length,less,lobed,mature,maturity,mauve,membranous,midpoint,midvein,minute,mm,moderately,multangulate,obtuse,orange-brown,pale,pedicel,peduncle,petiole,poricidal,ray,red,sessile,shorter,shrub,simple,sometimes,spherical,spreading,stalked,stellate-pubescent,stem,straight,style,surface,tapering,terminal,tip,trichome,tube,upper,variously,way,white,yellow,young	-14,-8,0-20,0.05-0.2,0.05-1.5,0.1,0.3-0.8,0.7-1.1,0.8-1.5,0.9-1.6,1-1.5,1.5-2.5,1.8-2.5,1/6-1/4,12-20,2-2.5,2.5-4,2.8-4,3-7,3.6-4.8,4-13,4-5-merous,4-7,4-8,6-8,8-15,8-17,abaxial,abaxially,alyx,apar,apically,berry,blade,dark,deltate,densely,difoliate,eaf,eed,entire,equal,erect,eye,filament,filiform,flower,free,geminat,glabrescen,glabrou,infructescence,lobe,long,long-acuminat,longer,lower,margin,naked,narrow-deltate,nflorescence,often,older,one,open,orolla,oung,pair,per,perfec,pericarp,porrect,portion,primary,recurved,red-brown,reflexe,ruit,scar,shallowly,shorte,side,smooth,spaced,sparsely,stalk,stellate,tamen,terete,tertiary,time,unarme,unarmed,undulate,unit,vary,vein,venation,visible,wide,woody,yellow-gra,yellow-green,ympodial	apart,arrangement,articulation,color,connation,corolla,dehiscence,diminishing,distal,foetid,foliage,form,growth,height,history,inflorescence,interjected,leaflet,life,na,ovary,papillae,perennial,petiolule,plant,position,prickle,pseudostipule,reflexed,seed,shape,size,spacing,stigma,straightnes,texture,tuber-bearing,yellow-gray
335	wfo-0001028180	success	147	85	55	92	30	0.374	1-1.5,1-3,2-3,5-6,7,acute,anther,apex,attenuate,bark,base,calyx,capitate,closely,cm,corolla,elliptic,glabrous,globose,green,lateral,leaf,lobed,minutely,mm,opposite,ovary,ovoid-reniform,pale,papillose,pedicel,petiole,pinkish-white,pitted,poricidal,shaped,shiny,simple,size,spaced,stem,stigma,straight,style,surface,tan,tear-drop,tip,tree,trichome,tube,uniseriate,white,yellow-gray,young	.05,.5,/2,0.7-1,1-1.2,1-1.8,1.5-5,15-28,2-2.2,2.5-3,20-30-flowered,3-10,3-4,4.5-5,5-8,8-10,abaxially,adaxially,along,anthesi,ba,beginning,berry,c.,conical,cucullate,dark,darker,deflexed,deltate,densely,dia,differing,difoliate,distinctly,drying,eaf,eed,elongate,erect,falcate,filament,fleshy,four-angled,free,fruiting,geminat,glabrat,gold,golden,irregularly,know,larger,leathery,lobe,lon,long,lower,main,major,margin,midrib,minor,nearly,nflorescence,obscure,older,onto,overlappin,pair,planar,pore,portion,puberulent,pubescent,ruit,scar,small,somewhat,sparsely,styl,tall,thick,ud,underside,unit,vein,way,winged,woody,x,ympodial	0.5,arrangement,color,connation,dehiscence,diameter,diminishing,distal,form,fruit,glabrate,growth,height,history,inflorescence,interjected,leaflet,length,life,na,papillae,peduncle,plant,pseudostipule,seed,shape,spacing,straightnes,terminal,texture
336	wfo-0001028182	success	150	73	54	96	19	0.36	.5,0.1-0.2,0.8-1,0.9-1,1-1.5,2-2.5,2-6.5,3-5,anther,base,beneath,black,calyx,capitate,cm,conical,corolla,deflexed,dia,dry,filament,filiform,glabrous,hemiepiphyte,inflorescence,leaf,lobed,long,material,minutely,mm,narrowly,nearly,ovate,papillose,pedicel,petiole,poricidal,pubescent,purplish,shiny,shrub,simple,sparsely,stem,stigma,style,surface,tip,trichome,tube,uniseriate,white,x	0-90,0.5,0.5-0.6,0.5-1,2,3,4-6,5-15-flowered,5-ribbed,6-9,along,anthesi,apart,apex,apiculae,apiculate,arching,axi,bark,bending,blade,branch,brown,ciliate,cordate,deltoid,densely,eaf,edicel,eed,ellipsoid,evenly,except,extreme,flower,free,globose,gre,internodal,keeled,know,known,later,lateral,lax,less,like,lobe,long-acuminate,lower,main,margin,midrib,minute,nflorescence,obovoid,older,opposite,ovary,pair,papillo,planar,pore,portion,present,prominent,proximal,reflexed,rib,rounded,ruit,sca,scar,shaped,slender,slightly,somewhat,spaced,sparser,specimen,spindly,still,strongly,tapering,tear-drop,third,time,truncate,ud,unifoliat,unit,vein,widest,ympodial,young,zig-zag	arrangement,color,diameter,form,fruit,growth,height,history,length,life,na,perennial,plant,reproduction,seed,shape,size,texture,unifoliate
337	wfo-0001028183	success	237	121	85	152	36	0.359	-10,0.2-0.3,0.2-0.5,0.5-2.5,1.7-2.7,1.9-3.7,10-15,2-4.2,2-5,3.5-6.6,4.6-6.4,5.2-6.2,6.6-20,7.5-23,abaxial,abaxially,accrescent,adaxially,along,anther,apart,apex,articulated,axi,bark,base,blunt-tipped,branched,brown,calyx,capitate,central,cm,corolla,dark,deltoid,diameter,drying,dull,elliptic,elongated,flower,fruit,fruiting,globose,granular-punctate,lanceolate,lateral,leaf,many,mm,oblong,orangish-tan,pedicel,peduncle,petiole,poricidal,pseudoterminal,purple,reportedly,reticulate-punctate,ripe,scabrous,shrub,simple,small,somewhat,stellate,stem,stigma,streak,style,sub-lenticular,surface,tan,time,tip,tree,tube,violet,white,x,yellow,yellowish,young	-5.3,.5-3,0.1,0.1-0.2,0.1-0.4,0.1-0.9,0.2-0.4,0.5,0.6,0.7-1.2,0.7-2,0.8-1.4,0.8-3.1,1.1-1.8,1.2-1.4,1.3-1.4,1.3-1.7,1.4-2.8,1.5-3.4,1.6-2.3,1/3-1/2,11-30,2.2-5.7,2.5-4.1,2.6-4.4,2.8-4.2,3.2-,4.5-9,5-8,5-8.5,50-400,8-9.1,9-13,acute,ag,alyx,anthesi,apparently,around,attenuate,axillary,berry,blade,branch,bud,cell,chartaceous,closely,cuneate,cylindrical,dendritic-multangulate,directed,distally,distantly,eaf,earl,edge,eed,entire,epidermal,especially,evident,except,exserted,farinose,few-rayed,filament,free,glabrescen,glabrescent,glabrous,group,hair,half,high,inserted,lackin,lengthening,lobe,lobed,lon,long,long-decurrent,longitudinal,lower,m.,main,margin,midrib,multangulate,narrowly,nearly,nflorescence,obovoid,older,open,orolla,ovate-lanceolate,overlapping,perfec,plurifoliate,pore,porrect-stellat,porrect-stellate,present,prominent,pubescence,pubescent,rachi,rarely,relatively,ruit,runk,sessile,short,short-,side,slit,soon,spaced,sparingly,sparse,spherical,splitting,stage,stalk,stamen,stipitate-glandular,stout,strongly,subcampanulate,suture,tamen,terete,thick,thin,thin-textured,tomentose,touching,translucent,ud,unarme,unit,upper,usually,vary,vein,way,whitish,wide,yellowish-tomentose,ympodial	arrangement,articulation,color,connation,dehiscence,diminishing,distal,foetid,foliage,form,growth,height,history,inflorescence,interjected,leaflet,length,life,na,ovary,papillae,petiolule,plant,position,prickle,pseudostipule,seed,shape,size,spacing,straightnes,terminal,texture,trichome,tuber-bearing,unarmed
338	wfo-0001028226	success	185	102	59	126	43	0.319	0-0.1,0.15-0.3,0.15-0.45,0.3-0.7,0.3-1,0.5-1,0.5-1.2,2.5-3,5.5-8.5,9-15,accrescent,anther,apex,articulated,base,calyx,chartaceous,cm,cuneate,diameter,elliptical,extra-axillary,fruit,fruiting,globose,green,herbaceous,inflorescence,lateral,lavender,leaf-opposed,length,long,midpoint,mm,obtuse,ovate,pale,pedicel,peduncle,petiole,plant,present,prickle,prostrate,pseudo-umbellate,ray,resprouter,simple,solitary,somewhat,sprawling,stellate,straight,style,time,tube,unbranched,yellow	%,.5,0-1,0-2,0.1-0.3,0.2-0.3,0.25-0.4,0.25-0.5,0.4-0.6,0.4-0.7,0.6-1.3,0.7-0.9,1,1-2,1-3,1-5,1.2-2.6,1.5-3,1.5-5,1.6-2.4,10-16,10-45,13-22,15-27,18-50,2-3,2-5,2-5.5,2.5-9,2.7-3.2,3.5-4.5,5-8,5-merou,6-8,7-8,9-14,abaxially,absen,absent,acicular,across,adaxiall,adaxially,adult,alyx,andromonoecious,apart,apparently,armed,axe,ba,blade,branche,brown,confined,cylindrical,deeply,deltate,densely,directed,distall,distributed,dm,eaf,eed,eglandular,finger,flower,functional,geminat,glabrous,gland-tipped,hair,half,heterostylous,index,juic,lamina,less,lobe,lobed,lobing,lon,longer,lower,margin,mature,mesocarp,midrib,midvein,minute,moderately,moist,nflorescence,oblique,onl,orolla,part,per,plurifoliate,pore,porrect,rostrate,ruit,sessile,shallowly,short,side,spaced,sparsely,stage,stellae,stellate-pubescent,strongly,tal,tamen,tem,thick,throughout,transparent,unit,uvenile,vary,wide,x,ympodial	0.5-1.5,0.5-2,0.5-2.4,0.5-3,0.5-3.2,arrangement,articulation,bark,color,connation,corolla,dehiscence,diminishing,distal,foetid,foliage,form,growth,height,history,interjected,leaf,leaflet,life,na,ovary,papillae,petiolule,position,pseudostipule,seed,shape,size,spacing,stem,stigma,straightnes,surface,terminal,texture,trichome,tuber-bearing,young
339	wfo-0001028227	success	236	145	113	123	32	0.479	-6.2,0.2-0.3,0.2-0.4,0.3,0.5,0.7-2.1,1-4.2,1.1-3.1,1.3-4,1.4,1.9-4.2,1/2,10,2-12,3.7-7,4.8-7.6,6-16,6.7-15,8.5-22,abaxial,abaxially,acuminate,acute,adaxially,anther,apart,apex,articulated,attenuate,bark,base,blade,blunt-tipped,branched,brown,brownish,bud,closely,cm,corolla,cuneate,dark,decurrent,deltoid,dendritic-echinoid,diameter,directed,distally,drying,echinoid,elliptic,elongate,entire,fruit,glabrescent,globose,granular-tomentose,gray,green,hair,lanceolate,lateral,leaf,less,long,many,margin,mm,mostly,multangulate,oblong,obtuse,older,orangish-tan,orbicular,pale,pedicel,peduncle,petiole,plurifoliate,pore,poricidal,porrect-stellate,pseudoterminal,purple,rachi,reticulate-punctate,ripe,rounded,scabridulous,sessile,shrub,somewhat,spaced,stalk,stellate,stem,stigma,style,sublenticular,surface,thin,time,tip,tomentose,tree,tube,velutinous,violet,x,yellow,yellowish,young	-2/3,.5-4,0-250,0.1,0.2,0.2-0.5,0.4,0.8,0.8-1.4,0.9,0.9-1.2,0.9-1.4,1,1-1.7,1-2.5,1.2-2,1.4-2.6,1.5-2.3,1.7-2.8,1.9,1.9-5.8,1/2-3/4,10-24,11-15,2-3.8,2.5-7.8,2.6-5.9,2.9-4.7,3-4.9,3.7-6.3,4-13,5-7.5,8.1-18,accrescent,ag,age,along,alyx,anthesi,apparently,appressed,around,axillary,becoming,berry,blunt-tippe,branch,c.,calyx,cylindrical,eaf,early,echinoi,edge,eed,ength,exserted,farinose,filament,fleshy,flower,free,fruiting,glabrous,grayish,high,inserted,lacking,lengthening,lobe,lobed,lon,longitudinal,lower,m.,main,midrib,midvein,nflorescence,oblong-lanceolate,obscured,occasionally,often,orolla,ovate-lanceolate,ovate-orbicula,overlapping,perfec,present,prominent,pubescence,pubescent,quarter,relatively,ruit,runk,side,simple,slightly,slit,sparsely,stamen,stout,subcampanulate,subspherical,sulcate,suture,tamen,thick,thicker,tomentu,touching,ud,unarme,unit,upper,usually,vary,vein,way,well,wide,ympodial	arrangement,articulation,color,connation,dehiscence,diminishing,distal,form,growth,height,history,inflorescence,leaflet,length,life,na,ovary,ovate-orbicular,papillae,petiolule,plant,pseudostipule,seed,shape,size,spacing,straightnes,terminal,texture,trichome,tuber-bearing,unarmed
340	wfo-0001028228	success	143	97	62	81	35	0.434	0.1-1.7,0.75,1.1-1.2,1.5-2,1.8-3.4,2-8,6-7,acute,anther,apex,area,bark,base,brown,calyx,campanulate,closely,cm,corolla,dark,distal,elliptic,fruiting,glabrous,globose,green,greenish-yellow,lateral,leaf,minute,minutely,mm,obovate,ovary,overlapping,ovoid-reniform,pale,papillose,pedicel,petiole,poricidal,reticulate,rounded,shaped,shining,shrub,simple,small,spaced,stem,stigma,straight,style,surface,tear-drop,terminal,tip,tree,tube,white,woody,young	.5,1-1.5,1.1-2.5,1.2-1.8,10-30-flowered,2,2-5,2.1-4.2,2.8-6.5,3/4,6-8,7.5-12.5,abruptly,age,anthesi,ba,becoming,beginning,beneath,berry,caly,clavate,coriaceous,deflexed,deltoid,dia,difoliate,dry,eaf,edicel,eed,erect,exserted,filament,fragrant,free,geminat,impressed,inflorescenc,lobe,lobed,lon,long,lower,main,major,margin,material,middle,minor,narrowing,nflorescence,occasionally,older,opposite,ovoid,pair,planar,pore,portion,prominent,ruit,scar,shinin,slender,slightly,styl,sweetly,tall,tapering,thick-margined,thickened,ud,unit,usually,vein,way,weight,widest,x,ympodial	1.5,alternate,arrangement,color,connation,dehiscence,diameter,diminishing,foetid,foliage,form,fruit,growth,height,history,inflorescence,interjected,leaflet,length,life,midpoint,na,papillae,peduncle,petiolule,plant,pseudostipule,seed,shape,size,spacing,straightnes,texture,trichome,tuber-bearing
341	wfo-0001028234	success	155	112	81	74	31	0.523	/2,/3,0.15-0.35,0.25-0.5,0.5-1.0,1-2.5,1.0-1.8,2.6.3.2,3-10,3.5-7,4-10,5-11,520,8-11,acute,along,annual,anther,armed,around,basally,base,blade,blue-tinged,broadly,brown,calyx,campanulate,capitate,capitate-glandular,cauline,cm,dark,deltoid,density,dia,dm,fleshy,glabrous,green,hair,herb,leaf,lobe,long,main,many,margin,mm,mostly,narrowly,often,ovate,pedicel,petiole,plump,prickle,prickly,purple,purplish-tinged,radially,ridged,sessile,short,short-stipitate,simple,spherical,stellate,stem,stout,subulate,thrice,triangular,tube,twice,ultimate,unexpanded,unicellular,uniseriate,vein,white	15-30,5-20-flowere,accrescent,acro,across,alyx,and,anthesi,beneath,berry,black,branched,caly,central,closely,developing,difoliate,dissected,divergently,divided,dry,eaf,earliest,eed,enveloped,erect,extended,few-rayed,fully,geminat,gland,heteromorphic,high,internodal,invested,largest,later,linear-lanceolate,lon,marking,maturity,nflorescence,occasionally,one,orolla,per,persisting,pinnatifid,reduced,ruit,scattered,second,slende,somewhat,spaced,splitting,starlike,ste,stellae,stipitate,strait,tamen,taprooted,tightly,tigma,tub,tyle,unit,vary,varying,wholly,year,yello,ympodial	5-20-flowered,armament,color,corolla,division,flower,form,fruit,glabrousnes,glandularity,growth,height,history,inflorescence,length,life,number,ovary,pinnation,plant,pricklines,seed,shape,size,slender,slendernes,stigma,straith,style,type,yellow
342	wfo-0001028250	success	256	119	80	176	39	0.312	0.3–0.6,0.3–3.9,0.5–1.3,1,1.0–1.6,1.2–1.7,1.2–6.3,1.8,1.9–2.2,1/3,1/4–3/4,1–3,2.3–5.1,2.7,3.9–12.2,5.0,5.8–6.6,8.3–18.0,acute,anther,apart,apex,articulate,attachment,base,branched,calyx,chartaceous,cm,corolla,cuneate,curved,deltate,diameter,dry,extra-axillary,flattened-orbicular,flower,fruit,globose,hooked,internode,large,lateral,leaf,major,mature,mm,notched,oblong,ovate,pedicel,peduncle,petiole,point,porrect,red,rounded,shrub,simple,small,spreading,stellate,stigma,style,surface,time,toward,tree,tube,typically,unarmed,upper,white,yellow,yellow-tan,young,±smooth,×,–3	.2,.3,.4,.7,.8,0.08,0.13,0.17,0.2–0.6,0.3–0.5,0.4–0.8,0.5–1.0,0.6–0.7,0.7–0.8,0.8–1.0,0.8–1.3,0.9–1.3,1.0–2.0,1.1–1.6,1.3–1.6,1.3–2.0,1.5,1.5–3.4,1.6–1.8,1.7,1.7–2.5,1.8–2.2,12.5,2.1,2.2–2.9,2.3–2.5,2.8,4–11,4–6,4–8,5-merou,5.1–6.2,5.7–7.7,6–10,90°,95,abaxially,adaxially,adnate,aequilateral,alyx,anthesi,apical,apically,apiculate,apparently,appearing,appressed,axe,ba,berry,blade,branch,broad,brochidodromous,bud,caudate,channeled,climate,clinate,congested,continuing,densely,dentate,depression,development,difoliate,directed,disc-shape,distinct,eaf,edge,eed,egandular,either,emerging,endocarp,entir,entire,erect,evenly,exocarp,fertile,filament,filiform,free,frui,geminate,glabrescent,glabrous,glandular,glossy,growt,hair,homostylous,increasing,interpetalar,intersepalar,juic,lanceolate,less,lobe,lobed,lon,long,longer,lower,margin,midpoint,midrib,midvein,minor,minute,moderately,nearly,new,nflorescence,oblique,occasionally,opaque,orolla,overlapping,per,poorly-developed,pore,portion,potentially,pubescent,raised,ray,restricted,rigid,row,ruit,sessile,shallow,short-stipitate,shorter,side,sinuate,sinus,smoot,sparsely,split,splitting,spread,stamen,stella,stellae,stellate-pubescent,stipe,straight,suture,tamen,tardily,tem,thin,tip,tissue,truncate,two,ud,upright,vary,vein,weakly,wide,yellow-ferruginous,ympodia,±equal,–1.6	arrangement,articulation,bark,color,connation,dehiscence,diminishing,disc-shaped,distal,foetid,foliage,form,fruiting,growth,height,history,inflorescence,interjected,leaflet,length,life,na,ovary,papillae,petiolule,plant,position,prickle,pseudostipule,seed,shape,size,spacing,stem,straightnes,terminal,texture,trichome,tuber-bearing
343	wfo-0001028263	success	156	118	94	62	24	0.603	0.25,1-3,11-23,2-3,2-4,3.4,3.5-4.2,4,5-7,5-7.5,6-8,9,abaxially,acuminate,acute,adaxially,apex,apical,apically,articulate,base,branched,broadly,calyx,cell,cm,conical,connate,cordate,corolla,covering,cuneate,cyme,darker,deep,dehiscent,diameter,dichasial,dichasially,diminishing,distal,ebracteate,elliptical,forked,green,green-white,hair-like,herbaceous,interjected,introrse,lateral,leaf,leaflet,light,long,make,maturing,medium,mm,monochasial,mucilaginous,oblique,odd-pinnate,often,ovate,ovoid,pedicel,peduncle,perennial,petiole,plant,poricidally,proximal,puberulent,pubescent,rotate,seed,short,size,slit,stigma,straight,strigose,style,terminal,testal,thick,throughout,tuber-bearing,violet,wall,wide,yellow,¼	1-2,1-4,11-13,14-44,2,2.6,3,3-6-foliat,4-5,6,8-1.,8-14,abaxiall,acumen,atenuate,digestion,dorsally,eaf,edge,eed,emoval,enzyme,equal,exceeding,filament,first,flat,flower,folded,generally,globo,gradually,half,honeycomb,living,lobe,lon,lower,lunat,nflorescence,nther,orolla,pair,pattern,perfect,plan,reveal,ruit,sessile,seudostipule,specimen,stamen,tal,tem,throughou,toward,truncate,two,typically,unit,vary,ympodial	8-19,anther,arrangement,color,dehiscence,form,fruit,globose,growth,height,history,inflorescence,length,life,lunate,pseudostipule,shape,spacing,stem,straightnes,surface,texture,wet,ye
344	wfo-0001028273	success	225	110	82	143	28	0.364	-2,0,0.4-0.5,0.5-1,0.6-0.8,1,1.2,2,2.5-6,4-11,acute,anther,apart,apex,articulated,bark,base,berry,brown,calyx,cm,color,coriaceous,corolla,densely,diameter,elliptic,flattened,flower,fruit,fruiting,globose,greyish,growth,height,holly-like,inflorescence,known,leaf,lobed,long,long-stalked,long-styled,markedly,minutely,mm,mucronate,ovary,ovate,papillae,pedicel,peduncle,petiole,pitted,poricidal,prickle,puberulent,pubescent,reddish,reniform,short,shrub,simple,size,sparsely,stellate,stem,stigma,style,styled,surface,tapering,terminal,tip,trichome,truncate,tube,unknown,urceolate,way,white,½-2/3	-8,.5,0.1,0.2,0.4,0.4-1,0.5,0.6-1,1-1.5,1-2,1-4,1.5-,1.5-2,2-3,2-6,2.3-3,2.5-,2.6-5,3-5,30,4,4-10,4-7,4-7-lobed,4-8.5,5-8,6-8,<,>,?,abaxial,abaxially,abruptly,absent,acicular,adaxial,adaxially,age,alfway,along,also,anthesi,armed,basal,beneath,branched,broad-based,c.,cell,closer,conical,deep,dense,discolorous,distall,eaf,eed,equalling,erect,evenly,exfoliatin,exserted,filament,free,glabrous,heterostylous,impressed,less,like,linear,lobe,lon,long-triangular,longer,lower,major,margin,midpoint,midvein,minute,mixture,multangulate,multiseriate,new,nflorescence,nodding,occasionally,often,older,orange,pair,per,pericarp,persisting,planar,plurifoliat,porrect,portion,prickly,primary,pubescence,rachi,ray,rest,rim,ruit,scar,scattered,sessile,shallowly,shiny,shorter,sinuate,slightly,small,smaller,sometimes,spaced,sparse,splitting,spreading-campanulate,stalk,stalked,stellate-pubescent,stout,straight,terminating,testal,time,together,tooth,toothed,truncat,ud,unicellular,unit,variable,vein,widely,woody,x,yellow,ympodial	arrangement,articulation,connation,dehiscence,diminishing,distal,exfoliating,foetid,foliage,form,history,interjected,lateral,leaflet,length,life,na,petiolule,plant,position,pseudostipule,seed,shape,spacing,straightnes,texture,tuber-bearing,young
345	wfo-0001028278	success	219	97	61	158	36	0.279	0.4-2.1,0.8-3,1,1-10,1-5,4-5,5-11,6-11,7-12,absent,accrescent,acute,anther,apex,articulated,base,broadly,brown,calyx,cm,connivent,cordate,densely,diameter,ellipsoidal,extra-axillary,fruit,fruiting,inflorescence,lanceolate,lateral,leaf,length,light,mm,obtuse,ovate,pale,pedicel,peduncle,perennial,petiole,pink,prickle,pseudo-racemose,purple,red,reniform,rugose,shape,shrub,simple,somewhat,stellate,stellate-pubescent,stigma,style,surface,truncate,tube,yellow	%,.5,0-0.15,0-0.7,0-1,0-3,0.1-0.25,0.1-0.5,0.2-0.3,0.45-0.7,0.5-0.75,0.5-0.9,0.5-1.5,0.5-2.5,0.7-1,0.7-1.2,0.8-1.3,0.8-2,1-1.2,1-2,1-3,1-4,1-locular,1.2-1.6,1.4-1.9,1.5,1.5-2,1.5-3,11-15,17-30,2,2-3,2-4,2.2-7,2.5-3,2.5-9,2.7-2.9,3-4,3-5,3-7,4,4-,4-12,4.5-6,5-10,5-merou,6-8,7-10,7-15,7-8,8-10,abaxially,absen,across,adaxially,adult,alyx,andromonoecious,apart,apparen,ascending,axe,ba,bilobe,blade,chartaceous,cylindrical,dense,difoliate,directed,distall,eaf,eed,elliptic,entire,erect,exceeding,exocarp,filament,finger,flattened,flower,functional,geminat,glabrous,gland-tipped,glandular,green,grey-green,hair,heterostylous,incomplete,index,interpetalar,juicy,juvenile,lamina,leave,lobe,lobed,lobing,long,lower,margin,mature,mesocarp,mid-point,midpoint,midrib,minute,nflorescence,oblique,orolla,pair,part,per,perfect,placenta,pore,porrect,present,rachi,ray,rhizomatous,ruit,septum,shallowly,shallowly-lobed,short,side,spaced,sparse,sparsely,stalk,stellae,succulent,tal,tamen,tem,thick,throughout,time,tissu,tissue,transparent,triangular,unarme,unarmed,unbranched,unit,upper,vary,weakly,white,wide,without,x,ympodial	arrangement,articulation,bark,bilobed,color,connation,corolla,dehiscence,diminishing,distal,foetid,foliage,form,growth,height,history,interjected,leaflet,life,na,ovary,papillae,petiolule,plant,position,pseudostipule,seed,size,spacing,stem,straightnes,terminal,texture,trichome,tuber-bearing,young
346	wfo-0001028280	success	87	74	42	45	32	0.483	.5,0.7-1,1-2,2-2.5,2-3,acuminate,almost,apex,attenuate,bark,base,ciliate,closely,cm,completely,dark,decurrent,elliptic,fruiting,glabrous,globose,green,lanceolate,lateral,leaf,margin,minutely,mm,narrowly,onto,opposite,papillae,pedicel,petiole,present,shrub,simple,small,spaced,stem,surface,young	1-2-flowered,1.5-2.7,6-9,7-8,anthesi,ape,arching,axil,berry,branch,brow,dia,eaf,eed,flattened,immature,know,known,lon,long,lower,main,middle,new,nflorescence,older,pair,pendant,rounded,ruit,scar,sessil,somewhat,tall,tip,ud,ultimate,unifoliat,unit,vein,widest,winged,woody,x,ympodial	arrangement,articulation,brown,calyx,color,decurrence,diameter,foetid,foliage,form,fruit,growth,height,history,inflorescence,interjected,leaflet,length,life,na,plant,position,pseudostipule,seed,sessile,shape,size,spacing,terminal,texture,trichome,unifoliate
347	wfo-0001028281	success	267	101	77	190	24	0.288	-1,-10,-45,0.1-0.15,0.2-0.5,0.3-1,1-3,1.1-1.4,10-18,10-30,2-6.5,3-8.5,6,acuminate,acute,anther,apex,base,basiscopically,broadly,brown,calyx,capitate,cm,corolla,dark,deep,diameter,distal,elliptic,elongate-triangular,extended,form,fruit,globose,golden,green,hair-like,half,imparipinnate,inflorescence,interjected,interrupted,lateral,leaf,leaflet,long,narrowly,oblique,obovate,once-branched,orbicular,outgrowth,ovary,ovate,pale,pedicel,peduncle,petiole,petiolule,pseudostipule,pubescent,rotate,shrub,size,small,sometimes,stem,stigma,straight,stripe,style,surface,terminal,tube,vine,yellow	+,-0.9,-20,-3,-36,-5,-7,-8,.2,.4,.5,0.05-0.4,0.15-0.2,0.2-0.3,0.2-0.7,0.3-0.5,0.5-,0.5-0.6,0.5-0.7,0.5-1,0.5-1.1,0.5-1.2,0.7-,0.7-1.2,0.7-2.5,0.75-1,0.8-1,1,1-,1-1.5,1-5,1.0-1.6,1.1-2.4,1.2-1.5,1.2-1.6,1.4-4,1.5-2,1.5-6,1.7-2.5,2-13,2-4,2-4-celled,2-locular,2.1-3.0,2.5-,20-30,3-16,3-5,3-foliate,5-8-celled,6-15,7-30,abaxial,abaxially,absent,adaxial,almost,alternate,anthesi,apical,appearance,appendage,appressed,arising,articulation,autogamous,axi,bent,berr,blade,bract,bracteate,branching,cell,column,composed,conical,covering,darker,decreasing,decurrent,densely,developed,doubly,dry,eaf,edicel,eed,eglandular,either,elongate,enclosing,entire,exerted,exserted,filament,flower,fragile,free,fruiting,generally,giving,glabrous,gland,glandular,gree,hal,halfway,head,included,internode,large,largest,less,like,lobe,lon,longest,lower,margin,material,medial,midvein,minute,mixture,mm,multi-celled,multi-cellular,multicellular,nflorescence,node,occasionally,opposite,other,pair,paler,patent,point,population,portion,present,primarily,primary,probably,proximal,rachi,regularly,rest,ruit,secondary,serrat,serrate,sessile,set,shorter,silky,smaller,smooth,sparsely,sparser,sprawling,staminal,sterile,stiff,strongly,subopposite,tem,tertiary,testa,thick,thin,three,tip,toward,transparent,trichome,type,ud,unicellular,uniseriate,unit,usually,vein,wall,weak,weak-walled,well,wide,winged,ympodial	0.7-1.5,2.5-15,arrangement,bark,color,connation,dehiscence,diminishing,growth,height,history,length,life,na,papillae,perennial,plant,seed,shape,spacing,straightnes,texture,tuber-bearing,ye
348	wfo-0001028294	success	222	106	70	152	36	0.315	0-1,0.5-1,0.5-2,0.7-1.2,0.7-1.5,0.8-1.2,1-2,1.3-1.5,1.5-7,1.9-7,2-2.5,2-3.5,4-8,8-10,8-18,accrescent,anther,apex,articulated,base,broadly,calyx,chartaceous,cm,connivent,cordate,cuneate,curved,diameter,extra-axillary,fruit,fruiting,globose,green,inflorescence,lanceolate,lateral,leaf,length,lilac,lobed,long,loosely,midpoint,mm,obtuse,ovate,pale,pedicel,peduncle,perennial,petiole,plant,present,prickle,ray,shallowly,simple,slightly,stellate,stigma,straight,style,surface,time,tube,unbranched,vine,yellow,yellowish-green	%,0-0.2,0-0.4,0-10,0-6,0.1-0.15,0.2-0.3,0.25-0.4,0.25-0.5,0.3-0.4,0.3-0.5,0.5-0.6,0.8-1,1,1-2.5,1-3.5,1-6,1.5-3.5,1.7-2.4,11-15,11-22,17-25,18-22,18-40,2-3,2-5,2-foliate,2-locular,2.5-7,30-40,4-6,4.5-6,5-12,5-13,5-8,5-merou,50-100,50-140,6-8,7-10,7-8,9-13,9-15,abaxially,absent,across,acuminate,acute,adaxiall,adaxially,adult,alyx,andromonoecious,anvil-shape,apart,armed,ascending,axe,ba,blade,branch,branche,broad-based,brown,capitat,cross-section,cylindrical,decimetre,deltate,densely,directed,distall,distally,distributed,dm,eaf,eed,eglandular,elliptic,entire,erect,exocarp,finger,flower,functional,geminat,glabrous,gland-tipped,grey,grey-green,hair,half,heterostylous,juicy,juvenile,lamina,less,lobe,longer,lower,margin,markedly,mature,mesocarp,mid-point,midvein,minute,moist,nflorescence,oblique,orolla,pair,part,per,placenta,pore,porrect,presen,rachi,repand,ruit,rusty,scattered,scrambling,semi-circular,sessile,short,spaced,sparsely,stalk,stalked,stellae,stellate-pubescent,tal,tamen,tem,thick,thicker,throughout,toward,unarme,unarmed,unit,upper,vary,vein,weakly,white,wide,x,yellowish,ympodial	arrangement,articulation,bark,capitate,color,connation,corolla,dehiscence,diminishing,distal,foetid,foliage,form,growth,height,history,interjected,leaflet,life,na,ovary,papillae,petiolule,position,pseudostipule,seed,shape,size,spacing,stem,straightnes,terminal,texture,trichome,tuber-bearing,young
349	wfo-0001028298	success	188	88	51	137	37	0.271	0.5-1,0.8-1.7,2-7,5-7,5-8,9-10,absent,accrescent,acute,anther,apex,articulated,base,calyx,cm,contiguous,cordate,diameter,fruit,fruiting,globose,inflorescence,lanceolate,lateral,leaf,length,lilac,mm,nearly,obtuse,ovate,pale,pedicel,peduncle,perennial,petiole,prickle,red,reniform,reticulate,rotate-stellate,sessile,shrub,simple,stellate-pubescent,stigma,style,surface,truncate,tube,yellow	%,.5,0-0.1,0.1-0.2,0.15-0.3,0.2-0.4,0.25-0.4,0.3-0.4,0.3-0.5,0.4-0.5,0.4-0.65,0.6-0.7,0.7-1,1-1.5,1-2,1-3,1-4,1-locular,1.5-2,1.5-3.5,1.9-2.5,10-11,17-25,2-3,2-foliate,2.2-2.5,2.5-3,3-5,3-7,4-5,4-9,4.5-8,5-6,5-merou,6-8,7-12,7-8,8-11,abaxially,absen,across,acuminate,adaxially,adult,alyx,apart,apparen,axe,ba,blade,broadly,brown,capitat,chartaceous,connivent,cylindrical,deltate,densely,directed,distall,distributed,eaf,eed,eglandular,elliptic,entire,erect,exceeding,exocarp,extra-axillary,filament,finger,flower,geminat,glabrous,gland-tipped,grey-green,hair,incomplete,interpetalar,juicy,juvenile,lamina,lobe,lobed,long,lower,margin,mature,mesocarp,midpoint,minute,moderately,nflorescence,oblique,orolla,part,per,perfect,placenta,pore,porrect,present,probably,pseudo-umbellate,rachi,ray,rhizomatous,ruit,septum,shallowly,short,soliary,somewhat,spaced,stalk,stellae,succulent,tal,tamen,tem,thick,throughout,time,tissu,tissue,transparent,unarme,unarmed,unbranched,unit,vary,white,wide,x,yellowish,ympodial	arrangement,articulation,bark,capitate,color,connation,corolla,dehiscence,diminishing,distal,foetid,foliage,form,growth,height,history,interjected,leaflet,life,na,ovary,papillae,petiolule,plant,position,pseudostipule,seed,shape,size,spacing,stem,straightnes,terminal,texture,trichome,tuber-bearing,young
350	wfo-0001028317	success	204	130	97	107	33	0.475	-1.5,0-5,0.1,0.1-0.3,0.3-1,0.5-3.5,0.6-1.2,0.6-1.5,1-1.3,1-3,1-4,4-6,5-8,absent,acute,almost,anther,apart,apex,articulated,bark,base,berry,bright,brown,calyx,chartaceous,cm,cream,cuneate,curved,dark,diameter,dull,erect,flattened-reniform,fruit,fruiting,glabrous,gray,green,herb,lanceolate,lateral,leaf,length,lobed,long,marking,maturity,mauve,midpoint,mm,moderately,obtuse,orange-brown,ovate,pale,pedicel,peduncle,petiole,poricidal,porrect,prickle,purple,ray,red,reduced,reflexed,scandent,sessile,shrub,simple,sometimes,sparsely,spherical,spreading,stalk,stalked,stellate-pubescent,stem,straight,style,surface,tapering,terminal,tip,toward,trichome,truncate,tube,unarmed,variously,white,wide,yellow,young	-5,/5,0,0-1,0.1-0.25,0.1-0.4,0.3-0.4,0.6-0.8,0.8-1.1,0.8-2.5,1.1-1.9,1.4-2,1.8-2.5,1/,1/3-1/4,1/4-2/3,1/5,2-2.8,2-4,2-4.5,2.5-6.5,2.8-3.3,2/3,3-10,3-4,3-5,4-5-merous,4-8,6-10,abaxially,acuminat,alyx,apar,apically,apparently,blade,branched,broad-deltate,brow,concolorous,deltate,densely,difoliate,distance,drying,eaf,eed,elongating,equal,extending,eye,filament,filiform,flower,free,geminat,hair,herbaceous,infructescence,lobe,longer,lower,margin,mature,midvein,minute,naked,nflorescence,oblong,older,one,open,orolla,oung,pair,pendulous,per,perfec,pericarp,portion,prickl,prickly,primary,rounded,ruit,scar,shorter,side,smooth,spaced,stellate,subsessile,tamen,terete,tertiary,time,translucent,unarme,unit,upper,vary,vein,venation,visible,way,yellow-green,ympodial	arrangement,articulation,color,connation,corolla,dehiscence,diminishing,distal,foetid,foliage,form,growth,height,history,inflorescence,interjected,leaflet,life,na,ovary,papillae,petiolule,plant,position,pseudostipule,seed,shape,size,spacing,stigma,straightnes,texture,tuber-bearing
351	wfo-0001028323	success	164	109	70	94	39	0.427	-2,0.2-0.5,0.2-1,0.4-1.3,0.5,0.6-1,1-2,3,7.5-9,acute,anther,apart,apex,appressed,articulated,attenuate,bark,base,blue-green,brown,c.,calyx,cm,corolla,dark,dendritic,diameter,ellipsoid,elliptic,fading,fruiting,glabrous,grey,growth,inflorescence,leaf-opposed,lobed,maturity,minute,minutely,mm,occasionally,ovary,ovoid,pale,pedicel,peduncle,peg,petiole,pitted,poricidal,reddish,remaining,rounded,shiny,shrub,simple,small,sometimes,stem,stigma,style,surface,tip,trichome,tube,uniseriate,violet,way,white	0.5-1,0.8,0.9-1.2,1,1-1.2,1-1.5,1.1-4.5,1.5,1.5-2.5,2-3,2-9,3-5,3-6,3.5-4,5-6,abaxially,abscissio,absent,along,anthesi,apparently,ba,berry,capiatate,cell,conical,coriaceous,cup-shaped,deltate,densely,drying,eaf,eed,entire,erect,filament,fleshy,flower,free,glabrescen,glabrescent,globose,included,internodal,lanceolate,lengthening,less,like,lobe,longer,lower,main,margin,new,nflorescence,ovate,pair,papillat,papillose,perfect,pericarp,planar,plurifoliat,pore,portion,primary,proceed,pubescent,revolute,ruit,scar,scattered,shoot,short,sinus,soft,somewhat,soon,sparely,sparsely,splitting,straight,tearing,testal,thick,thin,tuft,ud,unit,vein,wall,woody,x,ympodial	abscission,arrangement,articulation,capitate,color,connation,dehiscence,diminishing,distal,foetid,foliage,form,fruit,height,history,interjected,lateral,leaf,leaflet,length,life,midpoint,na,papillae,papillate,petiolule,plant,position,prickle,pseudostipule,seed,shape,size,spacing,straightnes,terminal,texture,tuber-bearing,young
352	wfo-0001028328	success	215	122	85	130	37	0.395	-15,0-0.3,0-4,0.5-1,1,1-1.5,1-6,2-10,2-3,2-4,2-9,5-10,5-7,abundantly,accrescent,acuminate,acute,anther,apart,apex,apparently,armed,articulated,base,branched,broad-based,brown,calyx,chartaceous,cm,compressed,connivent,dark,diameter,elliptic,elliptic-ovate,extra-axillary,forked,fruit,fruiting,globose,green,inflorescence,leaf,leaf-opposed,light,long,longitudinal,membanaceous,midpoint,minutely,mm,nearly,oblique,opening,outline,pedicel,peduncle,petiole,plant,prickle,reniform,ripe,rounded,rugulose,simple,slightly,slit,small,smooth,stem,stigma,straight,style,subcoriaceous,subcuneate,surface,tapered,tree,truncate,tube,white,x,yellow,young	.2,.5-2,0.2-0.5,1-2,1-7,1.5-2,14,15-20,16-30,2-2.5,2-4-lobed,2.5-3,20-30,20-35,3-4,4-7,5-merou,50,6-18,6-8,7-.,7-10,7-14,7-30,7-9,8-18,abaxially,absent,adaxiall,adaxially,ag,alyx,andromonoecious,apiculate,axe,ba,berry,blade,capitat,coarsely,congested,covering,cylindrical,densely,differentiated,difoliate,directed,discolorous,distally,eaf,eed,entire,equal,except,ferruginous,filament,flattened,flower,flowering,free,frui,geminat,glabrous,hair,half,heterostylous,highly,interpetalar,juvenile,leave,lighter,like,lobe,lobed,lower,major,margin,minor,moderately,multangulate,narrowly,nflorescence,obtuse,often,one,orolla,paired,part,perfect,perhaps,pericarp,pore,porrect,pubescent,rachi,ray,reflexed,ruit,runk,sessile,shallowly,sharp,shiny,short,short-stalked,side,somewhat,spaced,sparse,stalk,staminate,stellate,stellate-pubescent,strongly,subtending,tamen,thi,time,tip,tissue,tomentose,triangular,tubevery,unarmed,unit,vary,vein,whitish,wide,ympodial	age,arrangement,articulation,bark,capitate,color,connation,corolla,dehiscence,diminishing,distal,foetid,foliage,form,growth,height,history,interjected,lateral,leaflet,length,life,na,ovary,papillae,petiolule,position,pseudostipule,seed,shape,size,spacing,straightnes,terminal,texture,trichome,tuber-bearing
353	wfo-0001028329	success	215	130	101	114	29	0.47	.5-3,.75-5.75,0.2-0.3,1-6,12,2-4,3-8,4-15,5-10,6-8,7-19,abaxially,acuminate,acute,adaxially,anther,apart,apex,apical-lateral,asperous,axillary,bark,base,berry,blunt-tipped,brown,calyx,closely,cm,corolla,deltoid,diameter,distantly,finely,fleshy,flower,fruit,gray,green,growth,hair,honeycombed,introrse,large,lateral,leaf,length,long,long-attenuate,minutely,mm,moderately,mostly,multangulate,obelliptic,oblong,obovate,obtuse,ovate,ovate-elliptic,pale,pedicel,peduncle,petiole,plurifoliate,pore,porrect-stellate,present,pubescent,rather,reniform,reticulate-punctate,ripe,sessile,short-,shrub,simple,slightly,small,sometimes,spaced,sparse,stellate-rotate,stem,stigma,style,subglobose,suborbicular,testa,tomentose,touching,tree,tube,turning,velutinous,vestigial,white,whitish,x,yellow,yellowish	.75-2,/10-3/10,0-100,0.8-1.1,0.8-1.4,0.9-1.3,1.0-1.4,1.1-2.5,1.3-1.8,1.3-2,1.5-2.3,1.5-2.75,1.5-3.5,1.5-8,10-34,2-3,2.2-3.9,2.6-5,2.75-4.5,3-14,3.75-7,3/4,4-5,6-11,6-9,absen,ag,angled,anthesi,apparently,articulated,axe,ba,becoming,blade,branch,branched,bud,chartaceous,conical,continued,cylindrical,dehiscing,dendritic-echinoi,dendritic-echinoid,dichotomously,distinct,due,eaf,echinoid,eed,entire,filament,free,glabrescen,glabrous,granular,granular-tomentose,grooved,high,inserted,lengthening,lobe,lobed,longitudinally,lower,main,margin,midvein,multangulat,nflorescence,obscured,occasional,older,orbicular,orolla,perfect,pseudo-terminal,rachi,receptacle,relatively,ruit,runk,sessil,several,short-stalked,side,slit,sparsely,stalked,stellat,stellate,stellate-pubescent,stelliform,subcapitat,suture,swollen,tamen,thick,thickened,thin,time,tomentu,toward,unarme,unarmed,unit,usually,vary,vein,way,wide,ympodial,young	absent,arrangement,color,connation,dehiscence,diminishing,distal,form,height,history,inflorescence,leaflet,life,na,ovary,papillae,petiolule,plant,pseudostipule,seed,shape,size,spacing,straightnes,subcapitate,surface,terminal,texture,tuber-bearing
354	wfo-0001028337	success	195	130	97	98	33	0.497	.5,0.05-0.15,0.05-1,0.3-0.5,0.4-0.8,0.7-1,1-2,1.5-4,1/2,1/3-2/3,1/4-1/3,11-16,15-50,2-4,5-6,5-8,8-10,anther,apart,apex,apparently,articulated,bark,base,calyx,chartaceous,cm,color,conical,connivent,cuneate,curved,dark,densely,diameter,elongating,evenly,flattened-reniform,fruit,fruiting,fused,gently,glabrous,glaucous,gray,gray-brown,green,hair,inflorescence,lateral,leaf,length,lobed,long,marking,mature,mauve,midpoint,minutely,mm,narrow-oblong,orange-brown,pale,pedicel,peduncle,petiole,pitted,poricidal,porrect-lepidote,prickle,ray,reddish,rounded,sessile,shallowly,shorter,shrub,simple,smooth,spaced,sparse,spherical,stellate-pubescent,stem,straight,style,surface,tapering,terminal,tip,toward,trichome,tube,unarmed,white,wide,young	-2,-2.5,-4,-6,.8,/3,0,0.1-0.3,0.4-0.7,0.7-0.9,1,1-1.8,1-3,1.5-3,1.8-2,1/8-1/4,2-2.2,3-4,4-5,5-25,5-merous,6-7,8-14,abaxial,abaxially,acut,adaxial,alyx,apar,ape,apically,berry,blade,branched,deltate,discolorous,drying,eaf,eed,entire,equal,erect,eye,filament,flower,free,glabrescent,glabrou,green-brown,infructescence,juvenil,juvenile,known,lobe,long-styled,longer,lower,margin,moderately,naked,nflorescence,occasionally,older,one,open,orolla,oung,per,perfect,pericarp,plurifoliat,porrect,portion,prickly,primary,reflexed,ruit,scar,shoot,short,short-styled,slender,small,staminate,stellate,stout,strongly,tamen,terete,time,unarme,unit,usually,vary,vein,visible,way,ympodial	0-6,arrangement,articulation,connation,corolla,dehiscence,diminishing,distal,foetid,foliage,form,growth,height,history,interjected,leaflet,life,na,ovary,papillae,perennial,petiolule,plant,position,pseudostipule,seed,shape,size,spacing,stigma,straightnes,texture,tuber-bearing
355	wfo-0001028339	success	195	102	76	119	26	0.39	0.05-0.1,1-2,1-5,1.1-1.4,1.5-2,1.7-3.2,5-7,8182,acuminate,acute,anther,appressed,bark,base,beneath,berry,blue,broadly,brown,calyx,capitate,closely,cm,connate,corolla,cuneate,dark,dried,evenly,flattened,flower,glabrate,glabrous,globose,growth,lateral,leaf,lobed,long,minutely,mm,mustard,nearly,ovary,ovate,ovoid-reniform,papillate,pedicel,petiole,pitted,poricidal,red-brown,schwarz,shrub,simple,size,small,somewhat,spaced,specimen,stem,stigma,straight,style,surface,texture,tightly,tip,tree,trichome,tube,uniseriate,vein,white,yellow,young	.5,0.8-1.2,1-1.2,1-1.5,1.2-1.5,1.5,10-30-flowered,10.2-18.5,2.5-5,3.4-5.5,3.5-4,43191,5-angled,5.8-7.9,7-11,8-10,across,almost,anthesi,apex,appearance,appearing,attenuate,becoming,bud,carinate,carpel,covered,crystalline,cup-shaped,decurrent,deflexed,densely,dia,differing,difoliate,distinctly,dry,eaf,edicel,eed,enclosed,epidermi,erect,exserted,fide,filament,filiform,first,floccose,free,frui,fruiting,geminat,grainy,greyish-brown,irregular,large-celled,later,leave,like,little,lobe,lon,long-triangular,lower,main,major,margin,middle,minor,nee,nflorescence,oblique,obscure,occasionally,older,one,opposite,overlappin,ovoid,papery,papillose,planar,pore,portion,proximal,pulp,reflexed,ruit,scar,secondary,septum,shaped,shining,slender,slightly,sparsely,speckled,strong,strongly,tall,tapering,tear-drop,tub,ud,unit,urceolate,venation,white-lenticellat,white-papillo,white-speckled,wide,widest,winged,woody,x,yellowish,ympodial	alternate,arrangement,color,connation,dehiscence,diameter,form,fruit,height,history,inflorescence,interjected,leaflet,length,life,midpoint,na,papillae,peduncle,plant,pseudostipule,seed,shape,spacing,straightnes,terminal
356	wfo-0001028351	success	175	99	71	104	28	0.406	0,0.2,0.5,0–,1.0–2.0,1.0–2.5,2.0–2.5,2–2.5,40,5.0,5.5–10.5,5–7,8–15,abaxially,acute,adaxially,along,annual,anther,anthesi,apart,blue,brown,calyx,capitate,clavate,cm,connivent,densely,diameter,erect,flattened,fruit,glandular,globose,hair,herb,leaf,long,longitudinal,midvein,mm,moderately,multicellular,oblong,opening,ovate,pale,pedicel,peduncle,pentagonal,perennial,petiole,pitted,shallowly,shiny,simple,slit,stem,stigma,straight,style,surface,tardily,tube,unicellular,uniseriate,unknown,velutinous,x,–3.0	.2,.8,.8–1.0,0.1,0.6,1.0–,1.0–1.6,1.4–1.5,1.5–4.0,1.6–,10,2,2.0–5.0,2.1–3.5,2/3,2–4,3,3.4–5.0,3–4,4,5,5.0–5.5,6.5–8.5,6–12,absent,adaxiall,ag,apex,apical,articulated,axe,ba,basal,base,becoming,blade,branching,cell,chartaceous,colour,convex,cylindrical,directed,distally,eaf,eed,equal,filament,fleshy,flower,geminat,glabrous,green,indumentum,lamin,lanceolate,like,lobe,lobed,lon,lower,m.,margin,narrowly,nfloresence,number,obtuse,occasionally,opposed,orolla,pair,perfect,plurifoliate,pore,present,probably,pubescent,regularly,ruit,serrate,shaped,side,slender,smaller,spaced,sparsely,stone,tal,tamen,teardrop,tem,time,truncate,unbranched,unit,vary,white,wide,wing,winged,woody,ympodial,young,–	age,arrangement,color,connation,corolla,dehiscence,form,growth,height,history,inflorescence,interjected,lateral,leaflet,length,life,na,ovary,papillae,plant,pseudostipule,seed,shape,size,spacing,straightnes,terminal,texture
357	wfo-0001028353	success	177	111	77	100	34	0.435	0.2-0.4,0.5,1,1.4-2,6-8,accrescent,acute,age,anther,apart,apex,base,beneath,bluntly,bright,calyx,campanulate,capitate,cell,centre,cm,cordate,corolla,dark,deep,deeply,diameter,elliptic,fruiting,glabrous,globose,greenish,herb,honey-comb,internodal,leaf,lengthening,less,like,midrib,minutely,mm,ovary,ovoid,pale,papillose,pedicel,peduncle,petiole,pitted,plant,plump,pore,poricidal,pubescent,purple,rhomboid,ripe,scattered,simple,size,slit,sparsely,stem,stigma,straight,style,surface,tan,testal,tip,trichome,truncate,tube,uniseriate,vein,yellow	.5,/3,0.5-,0.9-1.2,1-2,1-4,1.5-2,1.5-5,2,2-3,2-4,3,3-5,4-7,7,8-10,abaxially,along,anthesi,area,becoming,berry,ciliate,clasping,coarsely,conical,cup-shaped,curved,decreasing,decumben,densely,difoliate,distally,dry,drying,eaf,edicel,eed,ellipsoid,emarginated,erect,exerted,filament,fleshy,flower,fracturing,free,frui,geminat,gree,green,growing,heteromorphic,hollow,horn,horned,inserted,lobe,lon,long,lower,m.,margin,material,minute,nflorescence,nodding,often,open,outline,pair,papery,papillate,pericarp,point,portion,primary,principal,reddish,ruit,scar,sessil,sessile,shallow,short,sleeve,slender,slightly,somewhat,strongly,thin,toothed,toward,ud,unit,wall,way,wrinkled,x,ympodial	arrangement,articulation,bark,color,connation,dehiscence,foetid,foliage,form,fruit,growth,habit,height,herbaceous,history,inflorescence,interjected,lateral,leaflet,length,life,na,papillae,position,present,prickle,pseudostipule,seed,shape,spacing,straightnes,terminal,texture,young
358	wfo-0001028367	success	178	93	48	130	45	0.27	60,anther,anthesi,articulated,base,black,blue,branched,brown,calyx,cm,dark,densely,diameter,flattened,fruit,glabrous,globose,lanceolate,leaf,mm,narrowly,oblong,ovate,pedicel,peduncle,pentagonal,perennial,petiole,poricidal,pubescent,purple,shiny,shrub,simple,stigma,straight,style,surface,texture,time,tip,tomentose,tube,unknown,white,x,yellow	0.2,0.2–0.4,0.4–2.3,0.5,0.5–3,0.8–0.9,1,1.0–1.8,1.2–3.0,1.3–9.0,1.4–2.0,1.5,1.5–1.7,1–,1–1.5,1–2,2.0–4.2,2.0–4.5,2.8–3.1,2–10,2–3,3.5–6.9,3–3.5,3–5,4–10,4–7,5,5–5.8,5–6,6.5–8.5,6–8,6–9,7–15,8.5–9.5,8–17,8–23,abaxially,absen,accrescent,adaxiall,adaxially,ag,apart,apex,apical,arising,axe,ba,basal,blade,cell,chartaceous,colour,concave,connivent,cuneate,cylindrical,deeply,diamete,directed,eaf,eed,equal,erect,filament,flower,geminat,glabrescen,grey-green,hair,half,laterally,lobe,lobed,lon,long,longer,longitudinal,lower,margin,marking,moderately,multicellular,nflorescence,obliquely,obtuse,opening,opposed,orolla,pair,pale,perfect,pitted,pore,primary,probably,regularly,rounded,ruit,secondary,shorter,side,slit,smaller,spaced,stone,strongly,tal,tamen,tapering,tem,three,toward,two,unequal,unicellular,unifoliate,uniseriate,unit,usually,vary,wide,width,woody,ympodial,–10.0,–25,–5.0,–5.5,–7	0.2-0.4,1-1.5,1.3-9.0,2-3,25,4-10,5-6,6-8,8-17,8.5-9.5,abaxial,absence,absent,adaxial,arrangement,articulation,branching,color,connation,corolla,dehiscence,form,fruiting,growth,height,history,inflorescence,interjected,lateral,leaflet,length,life,na,ovary,papillae,plant,pseudostipule,pubescence,seed,shape,size,spacing,stem,straightnes,terminal
359	wfo-0001028370	success	147	106	58	89	48	0.395	1.5-2.2,1/2-2/3,3-5,3-7,4-10,along,annual,anther,base,beneath,berry,blade,blue,broadly,brown,calyx,capitate,cm,coarsely,dark,deltoid,dm,extended,few-rayed,foveolate,fully,gland,glandular,herb,internodal,lenticular,long,main,minutely,mm,oblong,ovate,pentagonal,petiole,pinnatisect,prickle,prickly,purple-tinged,ridged,scattered,seed,sessile,short,short-stipitate,spherical,stellae,stem,terminal,tube,variously,vein,violet,yellow	-0.6,/3,0.2-0.4,0.8,1.0-1.7,2-4,2-8,2.5-2.9,3.5-5.0,4-11,40-70,5-9-flowere,9-12,accrescent,acicular,acro,across,alyx,ample,anthesi,armed,attenuate,ature,branched,broad,bud,campanulate,densely,developing,dia,difoliate,distinct,divided,dry,eaf,eglandular,geminat,glabrous,gland-tipped,green,hair,hardly,high,incurved,interpetalar,invested,lanceolate,lobe,lon,markedly,maturity,narrowly,near,nflorescence,obovoid,obtuse,often,one,orolla,per,pinnatifid,plicat,rounded,ruit,simple,slende,slightly,somewhat,sparsely,splitting,spreadingly,strait,subulate,surrounding,tamen,taprooted,terete,tightly,tigma,tissue,tub,twice,tyle,ultimate,unti,usually,vary,viscid,ympodial	apex,arrangement,articulation,bark,color,connation,corolla,dehiscence,diameter,diminishing,distal,foetid,foliage,form,fruit,fruiting,growth,height,history,inflorescence,interjected,lateral,leaf,leaflet,length,life,na,ovary,papillae,pedicel,peduncle,petiolule,plant,position,present,pseudostipule,shape,size,slender,spacing,stigma,straightnes,style,surface,texture,trichome,tuber-bearing,young
360	wfo-0001028390	success	147	96	62	85	34	0.422	-10,0.5,0.5-1,0.5-1.5,1,1-2.5,1-5,1.5-3.5,10-15,2,3-5,7-8,acute,angled,apart,apex,articulated,base,calyx,chartaceous,cm,cuneate,dense,densely,diameter,elliptic,felty-pubescent,forked,globose,hair,lanceolate,less,long,margin,midvein,mm,near,orange,ovate,pedicel,peduncle,petiole,pseudohair,pubescent,rarely,scar,shrub,simple,sparsely,stellate,stigma,style,subcordate,subcoriaceous,truncate,tube,unbranched,violet,white,white-pubescent,x,yellow	.5-3.3,0,0.5-2.5,1-3,1.5-2,1.5-5.5,2.5,3-4,4-11,4-5,5-7,6-many-foliat,7,9,abaxially,absen,adaxiall,adaxially,aggregate,apiculate,axe,blade,branched,cell,connivent,curled,cylindrical,deltate,dendritically,dendritically-branched,directed,distall,divided,eaf,eed,eglandular,entire,flower,glabrous,gland,leaving,like,lobe,lon,lower,mixed,moderately,mostly,narrowly,nflorescence,nther,obtuse,occasionally,often,orolla,peg,perfect,pore,presen,puberulent,pubescen,rachi,radiu,ripe,ruit,short,slightly,small,spaced,stalked,ste,stone,subcapitat,subclavate,tal,tem,time,tip,triangular,unequally,unit,usually,vary,wide,ympodial	abaxial,adaxial,anther,arrangement,articulation,color,corolla,dehiscence,density,form,fruit,growth,height,history,inflorescence,interjected,lateral,leaf,leaflet,length,life,na,perennial,plant,pseudostipule,seed,shape,size,spacing,stem,subcapitate,surface,terminal,texture
361	wfo-0001028399	success	273	102	74	199	28	0.271	.8,0.4–0.6,0.7–2.3,1.0–5.5,1.1–1.4,1.2–1.7,1.4–2.4,1.5–2.1,1.6–2.5,1.7–2.7,5.0,9.1,9.8,anther,apart,apex,attachment,attenuate,bark,base,brown,calyx,chartaceous,cm,corolla,dehiscent,developed,diameter,distal,dry,elliptic,extra-axillary,flattened-orbicular,flattened-reniform,flower,fruit,glabrous,globose,incurved,interpetalar,lateral,leaf,length,long,longitudinally,mature,mm,notched,oblong,orange,ovate,pedicel,peduncle,petiole,point,porrect,probably,red,reddish,reticulate,short,shrub,simple,somewhat,spreading,stellate,stem,stigma,style,surface,tissue,tube,well,yellow-tan	.3,.4,.5,.5–2.4,/3,0.04,0.06,0.13,0.2–0.3,0.3–0.4,0.3–0.5,0.3–0.6,0.4–0.5,0.4–0.7,0.4–0.9,0.5–1.1,0.5–1.3,0.7–1.0,0.8–2.5,0.9–1.9,1.1–1.7,1.2–1.5,1.2–2.0,1.3–2.0,1.6–2.3,1/2–2/3,1/3–1/2,1/4–1/3,2.0–3.9,2.2–2.6,2.2–2.8,2.2–2.9,2.4–3.2,2.5–11.2,2.8–3.0,3.1–3.8,3.2–3.8,3.4–3.6,4.0–5.4,4.2,4.3,4.4,5,5-merou,5.2–17.8,5.4,5–8,5–9,6.0–6.6,7.0,7–11,8–120,abaxially,absent,acute,adaxially,adnate,aequilateral,age,alyx,anthe,anthesi,apiculate,apparently,appearing,appressed,arching,articulate,axe,ba,basal,based,becoming,berry,blade,branch,branching,broad,broad-based,brochidodromous,bud,capitat,channeled,cunate,deciduous,deltoid,densely,dentate,difoliate,distinct,eaf,eed,either,emerging,entire,erect,exocarp,extending,fertile,filament,filiform,flexed,free,geminat,glandular,glossy,gradually,hair,heterostylous,increasing,internodal,internode,intersepalar,juic,lanceolate,large,layer,lobe,lobed,lon,longer,lower,major,many,margin,midpoint,midrib,midvein,minor,minute,moderately,narrowly,nearly,nflorescence,oblique,orolla,per,porrect-stellate,portion,position,potentially,prickle,primary,pubescent,raised,ray,red-orang,reflexe,restricted,ridge,rigid,rounded,row,ruit,scattered,secondary,sessile,shorter,side,sinuate,sinus,slit,sloughing,soon,spaced,sparse,splitting,spread,stamen,stellae,stellate-pubescent,stipe,stipitate,straight,tamen,tem,thin,time,tip,toward,translucent,transparent,triangular,truncate,two,ud,unarmed,upper,various,vary,vein,weakly,wide,yellow-ferruginous,ympodia,young,±90°,±equal,×	arrangement,capitate,color,connation,dehiscence,diminishing,form,growth,height,history,inflorescence,interjected,leaflet,life,na,ovary,papillae,petiolule,plant,pseudostipule,seed,shape,size,spacing,straightnes,terminal,texture,tuber-bearing
362	wfo-0001028405	success	149	107	68	81	39	0.456	0.4-0.5,1-9,1.5-6.5,10-11,2-3,3-4,3.5-10,3.5-6.5,6-7,8-15,9-15,acute,apex,apical,apically,articulate,base,branched,calyx,cm,conical,connate,corolla,dehiscent,diameter,dichasially,diminishing,distal,elliptic-lanceolate,forked,green,green-white,herbaceous,interjected,introrse,lanceolate,lateral,leaf,leaflet,long,maturing,mm,mucilaginous,oblique,odd-pinnate,often,ovoid,pedicel,peduncle,perennial,petiole,plant,poricidally,proximal,puberulent,seed,short,size,slit,stellate,stigma,straight,style,terminal,throughout,tuber-bearing,yellow,¼	0.5-3,1-4,1.3-8,2,2-2.5,2-4,3-20,3-6-foliat,4-11.5,4-6,7-14.5,abaxially,absen,acumen,adaxially,apiculate,attenuate,cell,covering,cyme,decurrent,dichasial,digestion,dorsally,eaf,ebracteate,edge,eed,elliptic,emoval,enzyme,exceeding,filament,flat,flower,folded,generally,globo,gradually,hair-like,half,honeycomb,living,lobe,lon,lower,lunat,make,monochasial,nflorescence,nther,oblong,orolla,ovate-elliptic,pair,pattern,perfect,plan,rachi,reveal,ruit,seudostipule,short-acuminate,short-petiolate,specimen,stamen,subsessile,tal,tem,testal,thick,throughou,toward,typically,unit,vary,wall,whit,wide,without,ympodial	absent,anther,arrangement,articulation,bark,color,connation,dehiscence,foetid,foliage,form,fruit,fruiting,globose,growth,height,history,inflorescence,length,life,lunate,na,ovary,papillae,petiolule,position,prickle,pseudostipule,shape,spacing,stem,straightnes,surface,texture,trichome,tube,white,ye,young
363	wfo-0001028424	success	253	135	107	146	28	0.423	-0.8,-3,-9,0-1,0.15-0.4,0.2-0.35,0.3-0.7,0.5,0.7-2,3-12,3-5,3-8,5-15,8-15,accrescent,acicular,acute,adaxially,anther,apart,apex,articulated,attenuate,base,broadly,calyx,cm,commonly,connivent,covering,deeply,deltoid-orbicular,diameter,directed,distally,distributed,diverging,elongate-lanceolate,entire,extra-axillary,felty,fruit,fruiting,globose,inflorescence,interlobal,larger,lateral,leaf-opposed,length,lenticular,less,light,lobe,long,major,midpoint,minutely,mm,narrower,obtuse,occasionally,orange,outline,ovate,pedicel,peduncle,pentagonal-stellate,perennial,petiole,pitted,prickle,prickly,ray,ripe,sessile,side,similar,simple,sinus,size,sometimes,somewhat,sparsely,stellae,stellate,stellate-puberulent,stem,stigma,style,subcordate,suffrutescent,surface,tan,thin-textured,trichome,truncate,typically,unbranched,usually,variable,vein,weakly,white,wide,x,yellow	-1.2,-28,0-0.5,0.1-0.2,0.2-0.7,0.3-0.6,1,1-3,1-7,1.5-2.5,1.8-3,1/3-1/2,10-16,12,12-19,2,2-2.5,2-3,2-4,2-foliate,3,3-16,3-6,3-7,4-12,4-5,4-6,4-7,5-10,5-22,5-8,5.5-10,8-25,abaxially,acute-,adaxiall,almost,along,and/or,ascending,axe,ba,blade,branched,broad-based,broader,campanulate,capitat,capitate-glandular,cauline,closely,coarsely,conspicuously,convex,curved,cylindrical,deltoid,dense,densely,dentate,depressed-deltoid,diffusely,distal,divergently,eaf,eed,elongate,equaling,exceeding,female-sterile,filament,flexuous,flower,geminat,glabrous,gland-tipped,glandular,hair,inserted,laterall,like,longer,lower,margin,midrib,mixture,mostly,much,multiple-stemmed,multiseriate,nflorescence,numerous,obsolete,obtuse-,often,orolla,ovate-lanceolate,per,perfect,persistently,pore,principal,puberulent,pubescent,rachi,radiu,rarely,recurved,reduced,reflexe,resembling,round-tipped,ruit,scattered,section,short,short-styled,shorter,single-,slender,small,smaller,spaced,species,spreading-hirsute,stalk,stalked,ste,stellate-pubescent,stout,strongly,tal,tamen,tem,termination,thickened,time,tip,tube,unarmed,unit,upward,vary,white-pubescent,widely,ympodial	arrangement,articulation,capitate,color,corolla,dehiscence,foetid,foliage,form,growth,height,history,interjected,laterally,leaf,leaflet,life,na,number,plant,position,pseudostipule,seed,shape,spacing,terminal,texture,young
364	wfo-0001028429	success	162	142	106	56	36	0.654	0.2-0.4,0.9-2.3,1-2.5,1.5-3,10-11,10-27,2-3,2-4,2.5-12,2.5-4,3-6,4-14,6-28,7-7,abaxially,acuminate,acute,adaxially,apex,apical,apically,articulate,base,branched,broadly,calyx,cell,cm,connate,cordate,corolla,covering,cuneate,cyme,darker,dehiscent,diameter,dichasial,dichasially,diminishing,distal,ebracteate,elliptical,forked,generally,glabrescent,glabrous,globose,gradually,green,green-white,greenish,hair,hair-like,half,herbaceous,interjected,introrse,lateral,leaf,leaflet,light,long,maturing,medium,mm,monochasial,narrowly,oblique,obovate,odd-pinnate,often,ovate,ovoid,pedicel,peduncle,pentagonal,perennial,petiole,petiolule,plant,poricidally,proximal,rotate,scattered,seed,short,size,slightly,slit,spot,stigma,straight,style,terminal,testal,thick,throughout,toward,tuber-bearing,violet,wall,white,wide,yellow,¼	0.8-1.2,1-4,1.5-4,10.5-21,2-1.,2-8,2.5-7.5,2.7-3.6,3-6-foliat,5-12,6-18,abaxiall,acumen,digestion,dorsally,eaf,edge,eed,emoval,enzyme,especially,exceeding,filament,flat,flower,folded,globo,honeycomb,living,lobe,lon,long-attenuate,lower,lunat,make,mucilaginous,nflorescence,nther,orolla,pair,pattern,perfect,plan,reveal,ruit,seudostipule,specimen,stamen,tal,tem,throughou,typically,unit,vary,vein,ympodial	2-19,anther,arrangement,articulation,bark,color,connation,dehiscence,foetid,foliage,form,fruit,fruiting,growth,height,history,inflorescence,length,life,lunate,na,ovary,papillae,position,prickle,pseudostipule,shape,spacing,stem,straightnes,surface,texture,trichome,tube,ye,young
365	wfo-0001028436	success	150	79	54	96	25	0.36	0.2-0.4,1.5-2.5,10-20,2-4,2.5-3,4,5-10,5-8,7,absent,anther,brown,calyx,center,chartaceous,diameter,dm,dried,edge,elliptic,fine,flower,fruit,glabrous,globose,leaf,linear,margin,membranaceous,mm,moderately,nearly,oblong,parallel,pedicel,peduncle,petiole,pubescent,radiating,raised,ridge,rotate,running,shallow,shrub,stem,stigma,style,surface,taproot,tube,unifoliate,white,x	.5,0.5,0.5-1,0.8-1.5,1-2,1-2-celled,1-3,1.5,1.5-2,1st,2-3,2nd,5-12,5-15,8-12,abaxially,abundant,acute,adaxiall,adaxially,along,apex,apically,appearance,appearing,axe,base,berry,beyond,blade,cell,ciliate,cm,connected,cordat,decurrent,deflated,dehiscent,difficult,due,eaf,eed,entire,evaluat,explosively,exserted,filament,flat,frui,fruiting,geniculate,glabrescen,hair,interpetalar,lengt,like,linear-lancolate,lobe,long,lower,lying,much-branched,nflorescence,notch,often,older,orolla,oung,per,placenta,pointing,presence,pubescen,rachi,reaching,rhizomatous,ruit,small,sparsely,stamen,structure,swollen,tal,tamen,tear,thick,tissue,triangular,two-celled,unbranched,unit,vary,wid,woody,wrinkled,ympodial	arrangement,bark,color,connation,corolla,dehiscence,form,growth,height,history,inflorescence,leaflet,length,life,na,ovary,papillae,perennial,plant,pubescence,seed,shape,spacing,straightnes,texture
366	wfo-0001028465	success	159	124	85	74	39	0.535	0.75,1.5-2.9,11-23,2-3,2-4,2-6,2-9.3,3-5,3-8,3.8-7,4-8,5-7,8-10,apical,apically,articulate,base,branched,broadly,calyx,cell,cm,connate,corolla,covering,cyme,dehiscent,diameter,dichasial,dichasially,distal,ebracteate,elliptical,forked,globose,green,green-white,hair-like,herbaceous,interjected,interpetalar,introrse,lateral,leaf,leaflet,long,make,maturing,medium,mm,monochasial,mucilaginous,odd-pinnate,often,ovoid,pedicel,peduncle,perennial,petiole,plant,poricidally,proximal,puberulent,pubescent,purple,rotate,seed,short,size,slit,spot,stigma,straight,strigose,style,terminal,testal,thick,throughout,tuber-bearing,wall,white,wide,yellow,¼	1-2,1-4,1.2-2,10,10-24,2,2.4-2.8,2.5-4,3-4,3-6-foliat,4-1.,4.5-5.5,7-15,9-19,abaxially,acumen,acuminate,acute,adaxially,apex,attenuate,cuneate,decurrent,digestion,diminishing,dorsally,eaf,edge,eed,emoval,enzyme,equal,exceeding,filament,first,flat,flower,folded,generally,globo,gradually,half,honeycomb,living,lobe,lon,lower,lunat,nflorescence,nther,oblique,orolla,pair,pattern,perfect,petiolule,plan,rachi,rarely,reveal,ruit,sessile,seudostipule,specimen,stamen,tal,tem,tissu,toward,two,typically,unit,vary,ympodial	4-18,anther,arrangement,articulation,bark,color,connation,dehiscence,foetid,foliage,form,fruit,fruiting,growth,height,history,inflorescence,length,life,lunate,midpoint,na,ovary,papillae,position,prickle,pseudostipule,shape,spacing,stem,straightnes,surface,texture,tissue,trichome,tube,wet,ye,young
367	wfo-0001028468	success	255	113	75	180	38	0.294	-1.3,-7,.5-1.5,0.2-0.3,0.4-4,0.5-8,0.7-2.5,0.8-3.5,16,2.5-4,5-9,6-9,accrescent,anther,apart,apex,articulated,base,berry,blue,brown,calyx,chartaceous,cm,connivent,corolla,diameter,distal,extra-axillary,flattened,flower,foveate,fruit,fruiting,gray,greenish,lateral,length,light,long,minutely,mm,oblique,oblong-lanceolate,orange,orangish,pale,pedicel,peduncle,petiole,prickle,purple,reticulate,rhombic,rotate-stellate,shrub,similar,simple,somewhat,stem,stigma,style,subcapitate,subelliptic,subglobose,sublenticular,subreniform,subshrub,surface,tube,unbranched,x,yellow,yellowish,young	-10,-3,-4,-5.5,.1-0.2,.1-0.3,.1-0.4,.2,.2-0.4,.3,.3-0.4,.5,.5-1.6,.6-1,/10-1/5,/4-1/3,0.05,0.1,0.2-0.6,0.2-1.5,0.4-1,0.5-2,0.5-3,0.5-3.3,0.5-3.5,0.6-1.2,0.6-2,1,1.2-1.5,1.3-2,1.5-2.2,1.5-3.1,1.6,1/3-1/2,1/5-1/2,2,2-9,2.2-3,2.8-4.1,2/3-3/4,20,3-4,4-6,4-9,5-21,6-10,abaxially,acuminate,acute,adaxially,along,appressed,ark,armed,attenuate,axe,becoming,beyond,blade,broad-based,broadly,bu,bud,c.,campanulate,cauline,central,clavate,commonly,compresse,compressed,d.,dark,decreasing,densely,density,directed,distally,distantly,dry,eaf,eed,ellipsoid,equal,exserted,filament,geminat,glabrescent,glabrous,gradually,green,hair,half,increasing,inserted,interpetalar,introrsel,lamin,laterally,lobe,lobed,longer,lower,m.,main,margin,midpoint,midvein,mixed,moderately,mostly,multangulat,multangulate,narrowly,nflorescence,oblong-conical,obtuse,occasionally,older,orolla,ovate,overlapping,ovoid,pair,papillo,per,perfect,pore,porrect-stellate,proximal,pubescence,pubescent,rachi,ray,recurved,reduced,relatively,ruit,sessile,shallowly,short,short-,short-stalked,side,similarly,slightly,spaced,sparsely,specimen,stalk,stamen,stellate-pubescent,stelliform,straight,subacuminate,subchartaceous,subcuneate,subsessile,tal,tamen,terete,testa,thick,thick-stalked,thicknes,time,tissue,touching,toward,triangular,unarmed,unifoliate,unit,upper,usually,vary,vein,way,wide,ympodial	.7-2.5,arrangement,articulation,bark,color,connation,dehiscence,diminishing,foetid,foliage,form,growth,height,history,inflorescence,interjected,lamina,leaf,leaflet,life,na,ovary,papillae,papillose,petiolule,plant,position,pseudostipule,seed,shape,size,spacing,straightnes,tall,terminal,texture,trichome,tuber-bearing
368	wfo-0001028470	success	185	116	80	105	36	0.432	0-18,0.25-0.75,1-12.3,1-2,1.5-2.8,1.6-3.2,12-44,2-10,2-8,3-10,3-5,3.2-5.5,3.5-16,3.5-7,anther,articulated,attenuate,axillary,base,berry,brownish,bud,chartaceous,clavate,cm,condition,connivent,corolla,deep,diameter,distal,dot,drying,elliptic,forked,fresh,fruit,glabrous,green,greenish,half,herb,high,interjected,lanceolate,lateral,leaf,leaflet,medium,mm,mottled,mucilaginous,odd-pinnate,ovate,ovoid,pedicel,peduncle,pentagonal,petiole,petiolulate,plant,poricidal,purple,rounded,seed,size,stigma,straight,style,substellate,subtending,terminal,tip,tube,typically,wet,white,whitish,x,yellow	0.9-2.2,0.9-2.3,1-3,11.8-21,2-5,2-7,2.1-3.9,4-6,4-7,5-merou,5.5-11.6,6-33,abaxially,acumen,acute,adaxiall,adaxially,ag,alyx,apart,apex,apparently,asymmetric,axe,basiscopic,blade,capitat,cell,covering,dark,decreasing,digestion,dorsally,eaf,edge,eed,end,enzyme,erec,exceeding,filament,flat,flower,folded,geminat,generally,glabrescent,glabrou,green-white,hair,hair-like,hal,homostylous,honeycomb-shaped,lengthening,light,living,lobe,long,lower,make,nflorescence,one,orbicular,orolla,pair,perfect,placed,plurifoliate,pore,pubescent,removed,ripe,ruit,scarce,sessile,seudostipule,short,side,slit,sometimes,spaced,specimen,stamen,stolo,subequal,subglabrou,tall,tamen,tem,testal,thick,throughout,tissue,toward,tri-,tuber,unit,unwinged,usually,vary,wall,wide,wing,ympodial	arrangement,articulation,bark,calyx,capitate,color,connation,dehiscence,erect,foetid,foliage,form,fruiting,growth,height,history,inflorescence,length,life,midpoint,na,ovary,papillae,position,prickle,pseudostipule,shape,spacing,stem,straightnes,subglabrous,surface,texture,trichome,tuber-bearing,young
369	wfo-0001028476	success	246	112	81	165	31	0.329	-1,-6,0.2-0.5,0.3-0.4,0.4-0.6,0.5,0.7-2.5,0.8-1.2,0.8-1.6,1,1-1.2,1-4,1.2-2.5,2,3-7,5-15,7-10,anther,articulated,base,bifurcate,branched,brown,calyx,capitate,cm,conical,corolla,dark,diameter,distal,elliptic,fruit,fruiting,globose,green,hair-like,half,herb,imparipinnate,inflorescence,interjected,interrupted,lateral,leaf,leaflet,less,long,minutely,mm,narrowly,obovate,outgrowth,ovary,pair,pale,pedicel,peduncle,perennial,petiole,petiolule,primary,pseudostipule,puberulent,pubescent,purple,regularly,set,stellate,stem,stigma,stripe,style,surface,tall,terminal,trichome,tube,unpaired,usually,yellow	-16,-20,-8,.05-0.1,.5,0-,0-0.5,0.1-0.15,0.1-0.4,0.15-0.2,0.15-0.4,0.2-0.3,0.2-0.6,0.25-0.4,0.25-0.5,0.3-0.5,0.3-0.7,0.3-1.2,0.4-0.5,0.4-1.5,0.5-0.6,0.5-1.7,1-1.4,1-1.5,1-2,1-2-celled,1-6,1-celled,1.1-1.5,1.1-1.6,1.8-2.5,12-30,2-6,2-foliate,2-locular,2.4-3,3-12,3-foliate,3.5-13,4-celled,6-,8-30,abaxially,absent,abundant,acroscopically,acuminate,acute,age,almost,along,also,alternate,anthesi,ape,apex,apical,appearance,appendage,axi,basal,basiscopically,becoming,bifurcation,bract,bracteate,bright,cell,column,curved,decurrent,deeply,diamete,eaf,ebracteate,edicel,eed,elongate,entire,especially,exserted,filament,first,flower,fortaleza,give,glabrescent,glandular,gradually,gree,hal,head,hyaline,incurved,internode,irregularly,lanceolate,largest,like,lobe,lobed,lon,lower,main,margin,maturity,midvein,minute,mixed,nflorescence,node,numerous,oblique,occasionally,often,population,present,prominent,pubescence,rachi,rarely,recurve,reflexed,rest,rounded,ruit,río,scattered,secondary,sessile,short,silky,simple,sinus,slightly,smaller,sparsely,sprawling,spreading,staminal,sterile,stiff,straight,subopposite,tem,tertiary,testa,thick,tip,toward,truncate,ud,unicellular,uniformly,uniseriate,unit,vein,wall,weak-walled,white,wid,wide,winged,woody,ympodial	6-30,arrangement,articulation,bark,bud,color,connation,dehiscence,diminishing,foetid,foliage,form,growth,height,history,length,life,midpoint,na,papillae,plant,position,prickle,seed,shape,size,straightnes,texture,tuber-bearing,ye,young
370	wfo-0001028478	success	267	128	82	185	46	0.307	2,acuminate,adjacent,aequilateral,anther,apex,apical,apparently,articulate,attachment,attenuate,bark,base,bilobed,brown,calyx,cm,connivent,corolla,deeply,deflexed,diameter,distal,dry,elliptic,emerging,flattened-orbicular,flower,fruit,globose,incurved,lanceolate,lateral,leaf,length,long,markedly,minute,mm,nearly,notched,oblique,obtuse,occasionally,orange-red,ovate,pedicel,peduncle,petiole,pitted,point,pore,prickle,reddish,rounded,shallowly,shoot,short,shrub,side,simple,slightly,somewhat,stamen,stellate,stem,stigma,style,sub-cordate,sub-coriaceous,suborbicular,surface,terminal,truncate,tube,two,typically,unbranched,white,yellow,yellow-tan,young	.0,.04,.2,.3,.5,.8,.9,0.0,0.1,0.2,0.2–0.4,0.3–0.4,0.3–0.5,0.4,0.4–0.5,0.5–0.6,0.5–0.8,0.5–0.9,0.6–1.3,0.9–1.1,1.0–1.3,1.0–1.5,1.1–1.6,1.3–1.6,1.4–2.3,1.4–4.4,1.5–2.4,1.5–4,1.8–2.0,1/2–1/3,2.0–11.0,2.1–2.3,2.2–4.0,2.3,2.5,3.3–4.9,3.4,3–6,4,4.6,4.6–7.0,4.8,4–6,4–7,5-merou,5.5–6.6,7,7.7–9.2,abaxially,adaxially,adnate,ag,alyx,anthesi,apart,appearing,appresse,around,axe,ba,based,berry,blade,borne,broad,broad-based,broadly,brochidodromous,bud,capitat,channeled,clinate,deciduous,deltate,densely,developed,development,difoliate,directed,distally,distinct,distinctly,eaf,edge,eed,either,endocarp,entire,erect,exocarp,extending,fertile,filament,filiform,flexed,free,geminat,glabrous,glandular,glossy,gradually,hair,hort,increasing,individually,internode,interpetalar,intersepalar,juic,layer,lobe,lobed,lon,longer,lower,margin,mature,midpoint,midrib,midvein,moderately,nflorescence,oblong,opaque,orolla,per,perforated,poorly,porrect,porrect-stellate,portion,potentially,presen,probably,pubescent,raised,ray,retrorse,rigid,row,ruit,scattered,seen,sessile,sigmoid,sinuate,sinus,sloughing,smoot,soon,spaced,sparsely,spatulate,splitting,spread,stellae,stellate-pubescent,stipe,stipitate,straight,strongly,suture,tamen,tem,thin,time,tip,tissue,toward,transparent,triangular,ud,unarmed,various,vary,vein,well,wide,yellow-ferruginou,ympodia,±45°,±90°,±equal,×,–10	0.2-0.4,0.5-0.8,0.9,1.0-1.5,1.1-1.6,1.3-1.6,1.4-2.3,10.0,2.0-11.0,3.3-4.9,4.6-7.0,7.7-9.2,arrangement,articulation,capitate,color,connation,dehiscence,diminishing,foetid,foliage,form,fruiting,growth,height,history,inflorescence,interjected,leaflet,life,na,ovary,papillae,petiolule,plant,position,present,pseudostipule,seed,shape,size,spacing,straightnes,texture,trichome,tuber-bearing
371	wfo-0001028481	success	194	99	63	131	36	0.325	.1,0-2,0.6-1,1.8-2.5,1/2-2/3,3-4,8,acuminate,almost,along,anther,anthesi,apex,articulated,bark,base,branch,chartaceous,clavate,cm,corolla,dendritic,diameter,discolorous,distributed,drying,elliptic,erect,evenly,flaking,leaf,length,less,liana,lobed,long,longitudinally,main,mm,oblong,often,orange-brown,pedicel,peduncle,petiole,poricidal,ridged,shortly,shrub,size,slender,stem,stigma,style,surface,terminal,thickly,tip,trichome,tube,unknown,white,young	.3,.5,0.1-0.2,0.15,0.5-1,0°,1-1.4,1-2,1-3,1-4,1.5,1.5-2,2-3,2.5-3,3,3-3.5,3-4.5,3-6,5.5-7.5,abaxially,absent,acute,adaxially,age,alyx,apar,apically,apparently,attenuate,branched,brown,canaliculate,clearly,close,colour,conical,cuneate,cupular,deeply,delineated,deltoid,dendritic-pubescent,density,different,dilated,divided,domatia,dorsifixed,dry,eaf,eed,ellipsoi,entire,equal,except,extending,extent,eye,faint,filament,flat,flexuous,flower,free,glabrous,green,increasing,know,known,lamina,lengthening,like,linear,lobe,lon,long-acuminate,longer,lower,m.,margin,midvein,mostly,naked,narrowly,nflorescence,nther,oblique,occasional,orolla,ovate,pair,perfec,plurifoliat,pore,portion,primary,protruding,pubescent,rachi,raised,ray,reddish,ribbed,ruit,scar,see,side,simple,sinus,small,smoot,smoothly,sparsely,spreading,stump,tearing,tertiary,together,toward,ud,unarmed,uneven,unit,vary,vein,venation,visible,wide,x,yellowish,ympodial	arrangement,articulation,calyx,color,connation,dehiscence,diminishing,distal,foetid,foliage,form,fruit,fruiting,growth,height,history,inflorescence,interjected,lateral,leaflet,life,na,ovary,papillae,petiolule,plant,position,prickle,pseudostipule,seed,shape,smooth,spacing,straightnes,texture,tuber-bearing
372	wfo-0001028482	success	224	132	98	126	34	0.438	0.5-1,0.5-5,00,1-11,1-4,10,2-3,2-celled,4-5,acuminate,acute,age,anther,anthesi,apex,bark,base,bilobed,branched,bright,brownish,calyx,capitate,chartaceous,closely,cm,corolla,creamy,cymose,diameter,diffusely,difoliate,distinct,dry,elliptic,emarginate,expanding,flattened-reniform,flower,fresh,fruit,fruiting,glabrous,glandular,globose,golden,green,growth,hard,internodal,leaf-opposed,lengthening,lobed,long,material,maturity,minutely,mm,nodding,obovate,olive,ovary,pale,pedicel,peduncle,petiole,pitted,poricidal,pubescent,row,shaped,short,simple,size,slit,small,spaced,stem,stigma,straight,style,subcoriaceous,subglobose,surface,tan,tear-drop,tip,tree,trichome,tube,twice,two,unifoliate,white,yellow,yellowish,young,µm	.1,.5,/3,0,0.2,0.5,0.7-1.1,1-1.5,1-2,1.1-5,1.2-1.6,1.5-2,1.5-3,3-12,3-4,5-25,6-50,7-14,abaxially,adaxially,alternate,angled,apiculae,ascending,asymmetric,basal,becoming,berr,berry,bifid,bifurcate,broadly,brochiodromous,bud,campanulate,channeled,circinate,constriction,coriaceous,corky,corrugated,cucullate,curved,deciduous,deflexed,deltate,densely,discolorous,distally,drying,eaf,eed,ellipsoid,embryo,enlarged,entire,exerted,exfoliating,filament,fleshy,free,geminat,glabrou,grayish,halfway,heterostylous,impressed,incrassate,individual,investing,irregular,keeled,less,lobe,lower,margin,markedly,materia,midrib,midvein,minute,new,nflorescence,occasionally,overlappin,pair,papillat,pentamerous,per,pericarp,petal,pore,portion,primary,reddish,revolute,ruit,scandent,scar,shiny,slightly,sometimes,somewhat,soon,sparsely,stout,subpyramidal,tightly,tiny,transparent,transversely,truncate,tub,tuberculate,tuft,ud,uniseriate,unit,usually,vegetative,vein,venation,way,woody,x,ympodial	abaxial,adaxial,arrangement,articulation,color,connation,dehiscence,diminishing,distal,foetid,foliage,form,height,history,inflorescence,lateral,leaf,leaflet,length,life,na,papillae,petiolule,plant,position,prickle,pseudostipule,seed,shape,spacing,straightnes,terminal,texture,tuber-bearing
373	wfo-0001028487	success	195	141	104	91	37	0.533	0-9,0.3-0.7,0.9-3,1-2,1-3.2,1.7-7,10-4.3,15-28,2-4.8,2-6,3-10,3-19,3-5,3.4-7.8,4-7,abaxially,adaxially,anther,articulated,attenuate,axillary,base,berry,brownish,bud,cell,central,clavate,cm,condition,connivent,coriaceous,corolla,covering,deep,diameter,distal,drying,elliptic,forked,fresh,fruit,glabrescent,glabrous,green,green-white,greenish,hair,hair-like,half,herb,high,interjected,lanceolate,lateral,leaf,leaflet,lengthening,light,long,make,medium,mm,moniliform,mucilaginous,odd-pinnate,ovate,ovoid,pedicel,peduncle,pentagonal,petiole,petiolulate,plant,pore,poricidal,purple,ripe,rounded,scabrous,scarce,seed,short,size,slit,star,stigma,straight,style,substellate,subtending,terminal,testal,thick,throughout,tip,tube,typically,wall,wet,white,whitish,x,yellow	0.4-1.5,1-3,1.1-1.5,1.4-1.7,10-41,2-4,2.5-3.5,3-4,4.6-13.6,5-6,5-merou,7.8-16.4,acumen,acuminate,acute,adaxiall,ag,along,alyx,apart,apex,apparently,arranged,asymmetric,axe,basiscopic,bead,blade,capitat,considerably,dark,decreasing,digestion,dorsally,eaf,edge,eed,enzyme,erec,exceeding,filament,flat,flower,folded,geminat,generally,glabrou,hal,homostylous,honeycomb-shaped,like,living,lobe,lower,multiple,narrow,necklace,nflorescence,orbicular,orolla,pair,perfect,plurifoliate,removed,ruit,second,sessile,seudostipule,side,smaller,sometimes,spaced,specimen,stamen,stolon,subequal,subglabrou,tall,tamen,tem,tissue,toward,tri-,tuber,unit,unwinged,usually,vary,wide,wing,ympodial	age,arrangement,articulation,bark,calyx,capitate,color,connation,dehiscence,erect,foetid,foliage,form,fruiting,growth,height,history,inflorescence,length,life,midpoint,na,ovary,papillae,position,prickle,pseudostipule,shape,spacing,stem,straightnes,subglabrous,surface,texture,trichome,tuber-bearing,young
374	wfo-0001028489	success	224	143	107	117	36	0.478	-10,-2.5,-4,0-10,0-20,0-3,0-50,0.1-0.6,0.2,0.2-0.6,0.3-1,0.3-1.2,0.5-1,0.5-1.1,0.5-1.5,1-6,1-7,1.5-4,1/3-1/2,3-7,4-13,5-8,acicular,anther,apart,apex,articulated,bark,base,berry,calyx,cell,chartaceous,cm,connivent,cordate,cream,cuneate,curved,dark,diameter,dull,elliptic,elongating,flattened-reniform,fruit,fruiting,glabrous,gray,green,hair,lateral,leaf,length,lobed,long,marking,mature,maturity,mauve,membranous,midpoint,minute,mm,moderately,orange,orange-brown,orange-green,outline,ovate,pale,pedicel,peduncle,perpendicular,petiole,poricidal,porrect,prickle,purple,raised,ray,sessile,shiny,shrub,simple,smooth,sometimes,spaced,spherical,stalk,stellate-pubescent,stem,straight,style,subsessile,surface,tapering,tip,trichome,truncate,tube,weakly,white,wide,yellow,yellow-orange,young	-0.6,-5,-6,/4,0-15,0.1,0.2-,0.2-0.4,0.2-0.5,0.2-0.7,0.3-0.5,0.3-0.7,0.4-0.8,0.5-0.8,0.6-1.2,0.7-3,1-3,1-4,1.5-3,1.8-2.2,1.8-4,1.8-5.5,1/3,1/4-1/2,2-3,2-4,2-6,2.1-3,3.5-6,4-10,4-8,5-25,5-merous,7.5,abaxially,acute,alyx,apar,apically,apparently,ba,beyond,blade,branched,broad-deltate,caudat,concolorous,deltate,densely,difoliate,distance,drying,eaf,eed,equal,erect,extending,eye,filament,flower,free,geminat,herbaceous,infructescence,less,lobe,lon,longer,lower,margin,midvein,naked,nflorescence,obtuse,occasionally,often,older,one,open,orolla,oung,pair,pendulous,per,perfec,pericarp,portion,prickly,primary,protruding,red-brown,rounded,ruit,scar,side,slender,sparsely,spreading,stellate,tamen,terete,tertiary,time,toward,unarme,unarmed,unit,upper,vary,vein,venation,visible,way,white-gra,woody,yellow-green,ympodial	arrangement,articulation,color,connation,corolla,dehiscence,diminishing,distal,foetid,foliage,form,growth,height,history,inflorescence,interjected,leaflet,life,na,ovary,papillae,perennial,petiolule,plant,position,pseudostipule,seed,shape,size,spacing,stigma,straightnes,terminal,texture,tuber-bearing,white-gray
375	wfo-0001028492	success	130	103	76	54	27	0.585	0.2-2,0.5-1,1-2.5,1-4,1-5,1.5-2.5,1.5-3,1.5-6,1.75-3.5,15-20,2-2.5,2-3,2-4,2-5,2.5-9,3,3-6,4,5-15,5-8,6-11,6-12,8-15,angled,apart,articulated,base,calyx,chartaceous,cm,color,colored,cylindrical,dark,deltate,diameter,directed,elliptic-ovate,forked,fruit,glabrous,globose,herb,lobe,long,mm,narrowly,pedicel,peduncle,petiole,pubescent,punctate,purple,rachi,radiu,rarely,reticulate,ripe,sand-punctate,shrub,stellate,stigma,style,time,triangular,triangular-ovate,tube,unbranched,unit,unknown,veiny,white,white-punctate,whitish,wide,x	-5-foliat,5-25-flower,abaxially,absen,acute,adaxially,aggregate,apex,apiculate,axe,axi,blade,cell,ciliolate,connivent,containing,crystal,distall,eaf,eed,entire,except,glabrou,hair,irregularly,leaving,lower,margin,nflorescence,nther,obtuse,orolla,pore,rounded,ruit,san,scar,simple,somewhat,spaced,sparse,splitting,stone,subcordate,subcoriaceous,succulent,tal,tem,tip,truncat,unevenly,vary,x1-3,ympodial	-5-foliate,1-3,anther,articulation,corolla,dehiscence,distally,form,growth,history,inflorescence,leaf,length,life,ovary,ratio,seed,shape,size,spacing,stem,surface,sympodial,tall,texture,truncate,width
376	wfo-0001028501	success	195	105	78	117	27	0.4	0-3.2,0-4,0.3-0.7,0.3-3.3,0.6-5.8,1-2,1-8,1.8-10.7,13-41,2.8-18,3-10,3-5,3.1-10.4,4.8-18,8-10,adaxially,anther,brownish,clavate,cm,condition,connivent,coriaceous,corolla,diameter,drying,elliptic,forked,fresh,fruit,glabrescent,glabrous,green,greenish,hair,herb,interjected,lanceolate,lateral,leaf,leaflet,light,medium,mm,moniliform,mottled,mucilaginous,odd-pinnate,ovate,ovoid,pedicel,peduncle,petiole,plant,poricidal,purple,pyriform,ripe,rotate,scarce,seed,short,simple,size,sometimes,spot,stigma,straight,style,terminal,tip,tube,typically,wet,white,whitish,x,yellow	0-3,0.8-1.6,0.8-1.7,1,1-3,2-4,2-5,2.8-4.9,3-7,3.1-12,4-8,5-merou,6.6-21.1,8-34,abaxially,acumen,acuminate,acute,adaxiall,ag,along,alyx,apart,apex,apparently,arranged,articulated,attenuate,axe,axillary,base,bead,berry,blade,broadly,bud,capitat,cell,considerably,covering,dark,decreasing,decurrent,digestion,distal,dorsally,eaf,edge,eed,enzyme,erec,exceeding,filament,flat,flower,folded,geminat,generally,glabrou,green-white,hair-like,hal,half,high,homostylous,honeycomb-shaped,larger,lengthening,like,linear,living,lobe,long,lower,make,multiple,narrow,narrowly,necklace,nflorescence,onto,orbicular,orolla,pair,perfect,plurifoliate,pore,present,rachi,removed,ruit,sessile,seudostipule,slit,spaced,specimen,stamen,stolon,subglabrou,subtending,tall,tamen,tem,testal,thick,throughout,toward,tri-,tuber,unit,unwinged,usually,vary,wall,wide,wing,ympodial	arrangement,bark,calyx,capitate,color,connation,dehiscence,erect,form,growth,height,history,inflorescence,length,life,na,ovary,papillae,pseudostipule,shape,spacing,stem,straightnes,subglabrous,surface,texture,tuber-bearing
377	wfo-0001028502	success	158	87	58	100	29	0.367	0.5-1,1-2,1.5-2.5,2-4,2-7,2-8,abaxially,acute,adaxially,anther,bark,base,beige,brown,calyx,clavate,cm,congested,corolla,dark,dendritic,densely,elliptic,fawn,flattened-reniform,glabrous,globose,inflorescence,later,lateral,leaf,light,lobed,minutely,mm,obovate,ovary,pedicel,petiole,pitted,poricidal,pubescent,reddish-brown,seed,shining,shrub,small,stem,stigma,style,surface,terminal,tip,tree,trichome,tube,white,young	.5,/2,1.5-2,1.5-3,1.5-6,1.6-2.4,2-2.5,2-5,3.5-15,3.5-4,5-15,5-6,6-8,?,abaxial,age,along,anthesi,apar,apex,ba,blade,body,branch,branched,campanulate,cazalet,christmas-tree-like,closely,cone,constricted,deltate,denser,dia,eaf,edicel,eed,erect,exserted,fide,filament,flat,fleshy,flower,free,fruiting,glabrat,heteromorphic,impressed,included,incrassate,inflorescenc,lengthening,like,lobe,lon,long,long-styled,lower,main,margin,matted,middle,narrower,nflorescence,often,older,packed,pair,papillo,papillose,planar,plurifoliat,pore,portion,prominent,rest,ruit,scar,scattered,short-styled,slit,spaced,structure,tall,thick,time,tree-like,tub,ud,unclear,unevenly,vein,warty,way,wide,widest,within,woody,ympodia	4-6,apart,arrangement,color,connation,dehiscence,diameter,form,fruit,glabrate,growth,height,history,interjected,leaflet,length,life,midpoint,na,papillae,peduncle,plant,plurifoliate,pseudostipule,shape,size,spacing,straightnes,texture
378	wfo-0001028505	success	168	96	60	108	36	0.357	.01,0.8-1,0.8-1.5,1-3,acuminate,acute,anther,apex,bark,base,calyx,cm,corolla,drying,erect,fruiting,glabrous,globose,green,grey,lateral,leaf,lobed,long,minutely,mm,narrowly,opposite,ovary,ovate,ovoid-reniform,pale,pedicel,petiole,pitted,plant,poricidal,pubescent,rounded,seed,shape,shaped,shrub,simple,size,stem,stigma,straight,style,surface,tan,tear-drop,tip,trichome,truncate,tube,unicellular,uniseriate,white,young	.1,.3,.5,/3,0.25-0.5,1,1.2-2.5,1/3,10-14-flowered,10-15,2,2.5-4.5,3-5,3.5-5,7-8,anthesi,aspect,ba,barely,basal,beneath,berry,black,blade,body,branch,bright,broadly,bud,characteristic,conical,darker,deciduous,decurrent,deflexed,delicate,deltoid,dia,differentiated,differing,difoliate,distance,distinct,dried,dry,eaf,edicel,eed,elliptic,expanded,exserted,exsertion,f,filament,flattened,free,geminat,gently,greatly,incrassate,live,lobe,lon,lower,m.,main,major,margin,materia,material,member,minor,minute,nflorescence,obovoid,obvious,older,overlapping,pair,papillose,pore,portion,prominent,proximal,purple,reflexed,ruit,scar,short,slightly,somewhat,soon,specimen,strongly,tall,tapering,touching,ud,unit,usually,vein,way,whit,widest,woody,x,yellowish,ympodial	5,alternate,arrangement,articulation,color,connation,dehiscence,diameter,diminishing,distal,foetid,foliage,form,fruit,growth,height,history,inflorescence,interjected,leaflet,length,life,midpoint,na,papillae,peduncle,perennial,petiolule,position,prickle,pseudostipule,spacing,straightnes,terminal,texture,tuber-bearing
379	wfo-0001028513	success	240	115	88	152	27	0.367	-0.8,-17,-6,0.1-0.15,0.3-0.5,0.5-0.6,0.5-2,1-3,1-4,2-4,2-5,30,5-10,8-15,9-11,abaxially,accrescent,adaxially,anther,apart,articulated,attenuate,base,broadly,brown,calyx,cm,densely,diameter,directed,ellipsoidal,extra-axillary,flower,fruit,fruiting,globose,inflorescence,lateral,lavender,leaf,length,lenticular,light,lignescent,linear-lanceolate,long,midpoint,minute,mm,often,orange,outline,ovate,ovate-lanceolate,pedicel,peduncle,perennial,petiole,pitted,prickle,prickly,purple,reaching,recurved,ripe,scabrous,silvery-gray,simple,small,somewhat,sparsely,stellate,stellate-pubescent,stigma,style,subcordate,surface,texture,thin-textured,tree,trichome,truncate,unarmed,unbranched,weakly,white,x,yellow	-0.7,-5,.1-1.3,.2,.3-0.5,/3,0-0.4,0.1-0.4,0.2-0.8,1,1-2,1-2.5,1.5-5,1/5-1/3,15-40,2,2-4.5,2-6,2-foliate,2.75-3.25,20-35,25-45,3-4,3-4.5,3.5-4,4-6,4-8,4-locular,4.5-6,5-6,5-9,7-11,8-11,8-16,8-25,acute,acute-,acute-tipped,adaxiall,along,apex,apiculate,appearing,appressed,approaching,approximately,armed,axe,ba,berr,blade,bristly,broad,broad-based,bud,campanulate,capitat,cauline,close,closely,coarsely,commonly,compresse,connivent,cylindrical,deciduous,deltoid,dentate,depressed-deltoid,distal,distall,doubling,eaf,eed,enclosing,entire,erect,exceeding,female-sterile,filament,flexible,geminat,glabrous,hair,horizontal,inserted,interlobal,large,larger,laterally,less,lobe,lower,major,many,margin,mature,near,nflorescence,numerous,obtuse,obtuse-,one,oriented,orolla,pair,partially,per,pericarp,persisting,plane,pore,present,prickl,principal,pubescent,rachi,radiu,rarely,ray,rigid,round-tipped,rounded,ruit,rust-colored,scattered,sessile,short,short-stalked,side,sinus,siz,smaller,soft,spaced,stalk,stellae,tal,tamen,tem,termination,time,tooth-like,tube,underdeveloped,unit,usually,variable,vary,vein,wide,ympodial	arrangement,articulation,capitate,color,corolla,dehiscence,distally,foetid,foliage,form,growth,height,history,interjected,leaflet,life,na,plant,position,pseudostipule,seed,shape,size,spacing,stem,terminal,young
380	wfo-0001028524	success	236	116	80	156	36	0.339	0.3,0.5-3.5,1-5,1.5-3,11,2-6,3-15,4-6,4-8,4.3-6,8-13,9-14,accrescent,acuminate,acute,anther,apart,apex,apical-lateral,articulated,bark,base,becoming,blunt-tipped,brown,calyx,chartaceous,cm,corolla,cream,deltoid,diameter,distal,dm,extend,flower,fruit,fruiting,gray,greenish,growth,honeycombed,introrse,lanceolate,large,lateral,leaf,length,longitudinal,mm,oblong,obtuse,ovate,pale,pedicel,peduncle,petiole,plurifoliate,pore,probably,reniform,reticulate-punctate,ripe,rounded,slightly,slit,somewhat,stellate,stem,stigma,style,subcoriaceous,subglobose,suborbicular,tree,tube,x,yellow,yellowish,young	-2.7,-3,.5-1,/10-3/10,0-150,0.3-0.8,0.6-1.4,1.1-1.2,1.2-1.3,1.5-1.6,1.8-2.5,1/3-2/3,10-20,2-3.8,2.5-3.4,2.5-3.8,2.5-4,2.8-3.5,3-10,3-4.3,3.3-4,3.4-3.6,6-7,6-9,7-10,7-11,abaxially,adaxially,ag,along,anthesi,apparently,ascending,axe,axillary,ba,berry,blade,branch,branched,bud,capitat,closely,conical,continued,dark,dehiscing,densely,due,eaf,echinoi,echinoid,eed,elliptic,entire,exserted,ferrugineous,few-,few-rayed,filament,first,fleshy,free,glabrescen,glabrescent,glabrous,granular-tomentose,green,hair,half,high,indument,inserted,interpetalar,lacking,lanceolat,late,later,lobe,lobed,long,lower,m.,main,many-rayed,margin,matted,midvei,midvein,mixed,multangulate,nearly,nflorescence,obscured,often,older,orbicular,orolla,ovate-lanceolate,overlapping,partly,perfect,persistent,porrect-stellate,present,prominent,pseudo-terminal,pubescent,rachi,rather,ray,relatively,ruit,runk,scabridulous,sessile,short,short-stalked,side,simple,small,spaced,sparingly,sparsely,stalked,stamen,stelliform,stout-stalked,strongly,sulcate,suture,tamen,terete,testa,thick,thick-stalked,thin,thin-stalked,time,tissue,tomentose,tomentu,touching,translucent,unarme,unarmed,unit,usually,vary,vein,velutinous,warty,way,wide,yellowish-green,ympodial	age,arrangement,articulation,capitate,color,connation,dehiscence,diminishing,foetid,foliage,form,height,history,inflorescence,leaflet,life,na,ovary,papillae,perennial,petiolule,plant,position,prickle,pseud-terminal,pseudostipule,seed,shape,size,spacing,straightnes,surface,terminal,texture,trichome,tuber-bearing
381	wfo-0001028525	success	257	109	84	173	25	0.327	0.2-0.6,0.5-1.5,0.5-2.5,1-1.5,1-4,1.1-1.7,1/3-3/4,10,10-13,2,2-3,3-5,3-7,acuminate,acute,anther,anthesi,apart,apex,attenuate,bark,base,black,brachyblast,branch,branched,broadly,brown,calyx,capitate,chartaceous,clavate,clustered,cm,cordate,corolla,dark,developed,diameter,discolorous,drying,elongated,form,frequently,fruit,grey,lateral,leaf,liana,light,long,longitudinally,lumpy,mature,mauve,membranous,mm,oblong,orange-brown,ovate,partly,pedicel,peduncle,petiole,poricidal,pyriform,ridged,shrub,size,slender,somewhat,spheroidal,stem,stigma,style,surface,terminal,tip,toward,truncate,tube,weakly,whitish,x	.25,.4,0.2-0.3,0.5,0°,1-2,1-2.5,1.2-1.6,1.5,1.5-3,1mm,2-2.5,2.5-5,3,4,4-15,4-5,4-7,6,7,7-13,7.5,accrescent,age,almost,along,alternate,alyx,apar,apically,apice,apparently,around,articulated,axil,becoming,berry,branching,centre,clearly,clum,conical,cup,curved,deeply,delineated,deltoid,dendritic,dendritic-pubescent,densely,density,detaching,developing,dilated,divided,domatia-like,dorsal,dorsifixed,eaf,eed,ellipsoi,entire,equal,erect,eye,fertilisation,fewer,filament,fine,flat,flattened,flexible,flexuous,flower,formed,forming,free,frui,fruiting,glabrescent,glabrous,green-brown,increasing,inside,known,lamina,laterally,leave,lengthening,less,like,linear,lobe,lobed,longer,loop,loose,lower,m.,main,margin,midvein,minute,much,multicellular-dendritic,naked,narrowly,nflorescence,nther,obconical,obscuring,often,one,orolla,outside,overlapping,ovoid,pair,pendulous,perfec,pericarp,plurifoliat,pore,portion,primary,prominent,protruding,puberulous,pubescent,rachi,ray,red-brown,rounded,ruit,scar,scattered,sessile,side,simple,sinus,slightly,small,smaller,smoot,smooth,sometimes,soon,sparsely,spreading,stripe,structure,stump,tangling,tearing,terete,tertiary,thick,thin,trichome,ud,unarmed,uneven,unit,vary,vein,venation,visible,well-developed,white,wide,wider,ympodial,young	arrangement,color,connation,dehiscence,diminishing,distal,growth,height,history,inflorescence,interjected,leaflet,length,life,na,ovary,papillae,petiolule,plant,seed,shape,spacing,straightnes,texture,tuber-bearing
382	wfo-0001028528	success	155	97	61	94	36	0.394	0.9-1.2,2-4,3/4,4-6,8-9,acute,anther,apex,attenuate,bark,base,bi-lobed,blackish,branch,calyx,cm,corolla,decurrent,dendritic,diameter,elliptic,flattened,fork,fruiting,glabrous,globose,growth,later,leaf,lobed,minutely,mm,mucronate,narrowly,obovate,occasionally,outline,ovary,pedicel,petiole,pitted,plurifoliate,poricidal,pyramidal,reddish-brown,round,shiny,shrub,stem,stigma,strongly,style,surface,terminal,tip,trichome,tube,violet,way,white,young	.5,1-2,1.1-1.2,1.5,1.8-2,2-3,2.5-3,3.5-4,3.5-6,4-5,6-10,6-7,?,abaxial,absent,acuminate,adaxial,adaxially,age,along,anthesi,apical,ba,basal,becoming,berry,branching,conical,coriaceous,densely,denser,dichasia,eaf,edicel,eed,erect,ew,except,exserted,filament,flower,free,glabrat,glandular,immature,impressed,inserted,leave,like,lobe,long,lower,m.,margin,midvein,minute,nflorescence,nodding,older,pair,papillo,per,pericarp,petal,planar,pore,portion,prominent,pubescent,revolute,ruit,scar,secondary,short,sleeve,slit-like,somewhat,sparsely,stamen,ste,tall,tapering,thin,time,triangular,tub,ud,unit,vein,wide,winged,woody,x,ympodial	arrangement,articulation,color,connation,dehiscence,diminishing,distal,foetid,foliage,form,fruit,glabrate,height,history,inflorescence,interjected,lateral,leaflet,length,life,midpoint,na,papillae,peduncle,petiolule,plant,position,prickle,pseudostipule,seed,shape,size,spacing,straightnes,texture,tuber-bearing
383	wfo-0001028529	success	164	107	71	93	36	0.433	0.5-2,0.8-1.3,1-1.5,2/3,5-6,acuminate,anther,apart,apex,apiculate,attenuate,bark,base,bluish,brown,calyx,capitate,cast,cm,corolla,dark,deltoid,distal,exfoliating,fruiting,furcate,glabrous,globose,green,hyaline,internodal,lanceolate,lateral,leaf,lobed,metallic,minutely,mm,narrowly,nearly,oblanceolate,occasionally,older,opposite,ovary,ovoid-reniform,paler,papillae,papillose,pedicel,petiole,pitted,poricidal,shape,shrub,simple,size,slender,smooth,somewhat,stem,stigma,straight,style,subshrub,surface,tip,tube,way,white,young	.2,0.1,0.5,0.8-3,0.8-3.2,1,1-1.2,1.5,2.5-3,3-40-flowered,3-5,6-9,7-8,8-14,across,acute,age,anthesi,becoming,beginning,beneath,berry,bud,close,cork,course,decurrent,deflexe,dia,eaf,edicel,eed,ellipsoi,elliptic,erect,evenly,exserted,filament,flower,free,growing,heterostylous,hrub,immature,indistinct,inflorescenc,lenticellat,less,linear,lobe,lon,long,lower,main,major,middle,minor,minute,much,nflorescence,one,pair,papillo,planar,pore,portion,present,prominent,range,reflexed,river,ruit,scar,scattered,shaped,short,slightly,small,soon,spaced,species,tall,tapering,tear-drop,ud,umbonate,variable,vein,widest,winged,woody,x,yellowish	arrangement,articulation,color,connation,dehiscence,diameter,diminishing,foetid,foliage,form,fruit,growth,height,history,inflorescence,interjected,leaflet,length,lenticellate,life,midpoint,na,peduncle,perennial,petiolule,plant,position,prickle,pseudostipule,seed,spacing,straightnes,terminal,texture,trichome,tuber-bearing
384	wfo-0001028532	success	186	122	93	93	29	0.5	0-19,0.2-1,1-1.6,1-2,1-3,1.3-8.7,1.4-1.6,17-42,2-8,3-10,3-5,3-7,3.3-4.4,3.9-5,5-9,5.5-15,6.5-9.2,7.5-15.2,abaxially,acuminate,adaxially,anther,apex,attenuate,base,brownish,cell,chartaceous,clavate,cm,condition,connivent,corolla,covering,dark,decreasing,deep,diameter,distal,drying,forked,fresh,fruit,glabrous,globose,green,greenish,hair-like,herb,interjected,lanceolate,lateral,leaf,leaflet,medium,mm,moniliform,mottled,odd-pinnate,ovate,ovate-lanceolate,ovoid,pedicel,peduncle,pentagonal,petiole,petiolulate,plant,poricidal,purple,ripe,rotate,rounded,seed,size,slightly,sometimes,spot,stigma,straight,style,terminal,testal,thick,tip,toward,tube,tuber,wall,white,whitish,x,yellow	1-1.7,1-5,15-36,2-3,2-6,2.2-4.2,4-7,5-merou,abaxiall,acumen,acute,ag,along,alyx,apart,apparently,arranged,articulated,asymmetric,axe,axillary,basiscopic,bead,berry,blade,bud,capitat,digestion,dorsally,eaf,edge,eed,enzyme,erec,exceeding,filament,flat,flower,folded,geminat,generally,glabrou,green-white,half,homostylous,honeycomb-shaped,larger,lengthening,like,linear,living,lobe,long,lower,make,middl,mucilaginous,multiple,necklace,nflorescence,orbicular,orolla,pair,perfect,plurifoliate,pore,removed,ruit,second,sessile,seudostipule,side,slit,spaced,specimen,stamen,stolon,subequal,subtending,symmetric,tall,tamen,tem,throughout,tissue,tri-,typically,unit,unwinged,usually,vary,wet,ympodial	arrangement,bark,calyx,capitate,color,connation,dehiscence,diminishing,erect,form,growth,height,history,inflorescence,length,life,na,ovary,papillae,petiolule,pseudostipule,shape,spacing,stem,straightnes,surface,texture,tuber-bearing,typical
385	wfo-0001028546	success	239	105	69	170	36	0.289	0-0.5,0-1,1-3.5,1-7,1.1-2.2,1.5-2,1.5-6,3-7,5-10,7-24,7.5-10,accrescent,acuminate,acute,anther,apex,articulated,base,calyx,capitate,chartaceous,cm,connivent,cuneate,diameter,ellipsoidal,elliptical,extra-axillary,finely,flattened,fruit,fruiting,globose,inflorescence,lanceolate,lateral,leaf,length,long,midpoint,mm,obtuse,ovate,pale,pedicel,peduncle,perennial,petiole,plant,prickle,pseudo-racemose,purple,ray,red,reticulate,rotate,shrub,simple,slightly,somewhat,stellate,stigma,style,surface,tan,time,tube,white,yellow	%,0-0.1,0-18,0-9,0.15-0.25,0.3-0.5,0.3-1,0.4-0.5,0.5-0.75,0.5-1,0.5-1.3,0.5-1.5,0.5-2,0.6-2,0.8-1.4,1-2,1-3,1-4,1-locular,1.1-1.8,1.5-1.75,10-14,10-22,100-150,11-12,120-400,16-24,2-,2-3.5,2-4,2-9,2.3-2.7,2.5-3,2.6-3.4,26-38,3-,3-11,3-4,3-5,3.5-19,3.5-7.5,4-13,4-8,4-9,4.5-6,5-55,5-8,5-merou,6-10,8-15,8-40,9-16,9.5-19,9.5-24,abaxially,absen,absent,acicular,across,adaxially,adult,also,alyx,ample,andromonoecious,apart,apparen,attenuate,axe,ba,bilobe,blade,branch,branche,brown,cylindrical,deeply,directed,distall,distally,distributed,dm,eaf,eed,eglandular,erect,exocarp,filament,finger,flower,foliate,functional,geminat,glabrous,gland-tipped,green,hair,half,heterostylous,incomplete,index,interpetalar,juicy,juvenile,lamina,less,lobe,lobed,lobing,longer,lower,main,margin,markedly,mature,mesocarp,mid-point,midvein,minute,moderately,nflorescence,oblique,often,orolla,pair,part,pendent,per,pinkish,placenta,pore,porrect,present,rachi,rhizomatous,ruit,septum,sessile,shallowly,short,side,spaced,sparsely,stalk,stellae,stellate-pubescent,straight,succulent,tal,tamen,tem,thick,thicker,thicknes,throughout,tissu,tissue,triangular,unarme,unarmed,unbranched,unit,upper,usually,vary,vein,weakly,wide,x,ympodial	arrangement,articulation,bark,bilobed,color,connation,corolla,dehiscence,diminishing,distal,foetid,foliage,form,growth,height,history,interjected,leaflet,life,na,ovary,papillae,petiolule,position,pseudostipule,seed,shape,size,spacing,stem,straightnes,terminal,texture,trichome,tuber-bearing,young
386	wfo-0001028547	success	224	125	92	132	33	0.411	-3,.2,.5,.8,0-15,0-5,0.05-0.15,0.1-0.2,0.2-0.35,0.5-,0.7-1,1-2,1-2.5,1-4,1-5,1.5-2.5,10-12,2-2.5,2-6,3-5,3.5-4.5,4-5,4-6,7-9,absent,anther,apart,apex,articulated,bark,base,berry,bright,calyx,cell,chartaceous,cm,connivent,cuneate,diameter,dull,elongating,flattened-reniform,fruit,fruiting,glabrescent,inflorescence,lateral,leaf,length,lobed,long,maturity,mauve,midpoint,mm,moderately,orange,orange-brown,outline,ovate,pedicel,peduncle,petiole,pit,poricidal,porrect,prickle,purple,raised,red,reddish,scandent,shrub,simple,small,smooth,spherical,stalked,stellate-pubescent,stem,style,subsessile,surface,tapering,terminal,tip,trichome,truncate,tube,yellow,young	-1/2,-13,-6,.7,/2,/5,0,0-1,0-10,0-2,0-30,0.15,0.3-0.4,0.8-1,1.2-1.4,1.7-2,1/3,1/5-1/4,2-1.5,2-4,2.5-2.8,2.8-3.2,5-merous,6-8,7-10,abaxial,abaxially,acute,adaxial,alyx,apar,ape,apically,apparently,appearing,blade,branched,branching,bulbous,conical,cream,curved,dark,deltate,densely,discolorous,distance,drying,eaf,eed,elongate,entire,equal,erect,extending,faint,filament,flattened,flower,free,gently,glabrou,glabrous,gray-brow,green,infructescence,lobe,lon,long-acuminate,long-styled,longer,lower,margin,marking,mature,midvein,narrow-deltate,nflorescence,oblong,occasionally,often,older,one,open,orolla,oung,pair,pale,pendulous,per,perfect,pericarp,plurifoliat,portion,prickl,prickly,primary,ray,reflexed,rounded,ruit,scar,sessile,shallowly,short-styled,side,slender,sometimes,somewhat,spaced,spreading,stalk,staminate,stellate,straight,tamen,terete,tertiary,thin-acuminat,time,unit,usually,vary,vein,venation,villous,way,wide,woody,yellow-green,yellow-orange,ympodial	arrangement,articulation,color,connation,corolla,dehiscence,diminishing,distal,foetid,foliage,form,gray-brown,growth,height,history,interjected,leaflet,life,na,ovary,papillae,petiolule,plant,position,pseudostipule,seed,shape,size,spacing,stigma,straightnes,texture,tuber-bearing
387	wfo-0001028548	success	266	117	77	189	40	0.289	.4,.7,.8,.9,0.06,3.1,4.9,5.6,acuminate,anther,apart,apex,apical,articulate,attachment,attenuate,bark,base,brown,calyx,chartaceous,cm,color,corolla,cuneate,deltoid,diameter,distal,dry,extra-axillary,filiform,flattened-orbicular,flower,fruit,globose,growth,incurved,lanceolate,lateral,leaf,length,long,margin,minute,mm,nearly,notched,oblong,ovate,pedicel,peduncle,petiole,pitted,point,pore,porrect,probably,reddish,rounded,short,shortly,shrub,simple,smooth,somewhat,spreading,stem,stigma,straight,style,surface,tube,unarmed,unknown,white,yellow,young	.2,.6,.8–2.4,/3,0,0.3–0.8,0.4,0.4–0.5,0.4–0.6,0.4–0.7,0.6,0.7–0.8,0.7–1.7,0.8–1.2,0.8–1.9,0.8–2.0,0.8–2.9,0.9–1.2,1.0–4.1,1.1–1.2,1.1–1.4,1.1–1.5,1.3–1.6,1.4–2.3,1.6–2.7,1.7–2.1,1/3,1/3–1/2,2.0,2.2–2.8,2.3,2.4–2.7,2.8,3.1–3.8,3.6–8.1,3.7–4.0,3.8–4.6,4,4–8,5-merou,5.5–6.6,6.4–19.8,6–10,6–9,90°,abaxially,absent,acute,adaxially,adnate,aequilateral,ag,alyx,anthesi,apiculate,apparently,appearing,arching,area,around,axe,ba,berry,blade,branch,branching,broad,brochidodromous,bud,capitat,central,channeled,clinate,congested,deciduous,densely,dentate,developed,development,difolate,directed,distinct,eaf,edge,eed,either,elliptic,emerging,endocarp,entire,erect,exocarp,extending,fertile,filament,flexed,free,geminat,glabrous,glandular,glossy,gradually,hair,heterostylous,increasing,intact,internode,interpetalar,intersepalar,juic,juvenile,large,layer,less,lobe,lobed,lon,longer,lower,major,many,mature,midpoint,midrib,midvein,minor,moderately,nflorescence,oblique,occasionally,opaque,orolla,per,poorly,porrect-stellate,portion,potentially,pubescenc,pubescent,raised,ray,reflexe,remaining,rigid,row,scarcely,seen,sessile,short-stipitate,shorter,side,sinus,sloughing,smoot,soon,sparsely,splitting,spread,stamen,stellae,stellate,stellate-pubescent,stipe,suture,swelling,tamen,tem,thin,time,tip,tissue,transparent,truncate,two,ud,unbranched,upper,various,vary,vein,wave,weakly,wide,yellow-ferruginous,ympodia,±90°,±equal,±glabrous,×	0.4-0.7,0.7-0.8,0.8-1.9,0.8-2.9,1.0-4.1,1.1-1.4,1.7-2.1,arrangement,articulation,capitate,connation,dehiscence,diminishing,foetid,foliage,form,fruiting,height,history,inflorescence,interjected,leaflet,life,na,ovary,papillae,petiolule,plant,position,prickle,pseudostipule,seed,shape,size,spacing,straightnes,terminal,texture,trichome,tuber-bearing
388	wfo-0001028551	success	243	130	85	158	45	0.35	.0,.5,.6,.8,1.0,1/3,2,2.5,acuminate,aequilateral,anther,apart,apex,articulated,attachment,attenuate,base,broad-based,calyx,chartaceous,cm,connivent,corolla,cuneate,dark,dehiscence,deltate,diameter,dry,elliptic,extra-axillary,flattened-suborbicular,flower,forking,fruit,glabrous,glandular,globose,green,hair,internode,lacking,lanceolate,lateral,leaf,lilac,markedly,mature,maturing,minute,mm,narrowly,nearly,notched,oblique,oblong,pedicel,petiole,point,porrect,prickle,red,ripe,shiny,shrub,simple,slender,smooth,stellae,stigma,straight,style,subcoriaceous,tan,tree,triangular,tube,unbranched,upper,violet,white,yellow,young,±appressed,×	.06,.1,.3–0.5,0,0.4–0.5,0.5–0.6,0.7–1.0,0.7–2.3,0.8–1.4,1.0–1.5,1.0–1.6,1.1,1.1–1.4,1.1–2.2,1.3,1.4–2.0,1.5–1.8,1.5–1.9,1.6–1.7,1.7,1.7–2.6,1.8–2.5,2.0–2.6,2.0–3.5,2.0–3.7,2.2–3.4,2.2–5.2,2.2–7.5,2.3–3.4,2.75–4.0,3/4,4.2–5.9,4.5–7.0,4–6-merou,5–11,7.5–10.5,8.0–11.4,8.0–12.0,8.5–20.5,9.0,abaxially,adaxially,adnate,almost,alveolate,alyx,anthesi,apical,apiculate,apparently,appearing,area,armed,axe,ba,becoming,berry,blade,branch,brochidodromous,bud,capitat,caudate,central,channeled,closely,conical,continuing,densely,dentate,development,difoliate,distally,distinctly,dorsally,eaf,eed,either,endocarp,enlargement,entir,entire,equal,exocarp,fertile,filament,filiform,free,frui,geminat,glabrou,gradually,homostylous,immature,inclined,increasing,interpetalar,juic,large,line,lobe,lobed,lon,long,longer,lower,major,margin,midrib,midvein,minor,nflorescence,numerous,occasionally,orolla,outline,poorly-developed,pore,portion,potentially,prominent,pseudo-peduncle,pubescent,row,ruit,scattered,side,sinus,somewhat,spaced,split,splitting,spread,stamen,stellate,stellate-pubescent,suture,tamen,tem,thin,time,tip,tissue,toward,two,typically,ud,unarme,unarmed,vary,vein,wavy,weakly,wide,yellow-ferruginou,ympodia,±globose,–4.8	0.7-2.3,1.4-2.0,1.6-1.7,4.5-7.0,arrangement,articulation,bark,capitate,color,connation,diminishing,distal,foetid,foliage,form,fruiting,growth,height,history,inflorescence,interjected,leaflet,length,life,midpoint,na,ovary,papillae,peduncle,petiolule,plant,position,pseudostipule,seed,shape,size,spacing,stem,straightnes,surface,terminal,texture,trichome,tuber-bearing,yellow-ferruginous
389	wfo-0001028558	success	224	98	66	158	32	0.295	0-30,0.4-1.5,0.8-1.5,1-1.3,1-4,1-9,2-5,3-8,6-10,anther,apex,articulated,bark,base,calyx,chartaceous,cm,connivent,cordate,curved,densely,diameter,distal,dull,flattened-reniform,fruit,fruiting,gently,glabrescent,herb,lateral,leaf,length,lobed,maturity,mauve,midpoint,mm,orange-brown,ovate,pedicel,peduncle,petiole,plant,poricidal,porrect,prickle,reflexed,rounded,sessile,shrub,simple,spherical,stalked,stellate-pubescent,stem,straight,style,surface,tapering,terminal,tip,trichome,tube,yellow,young	-2,-5,.5,/6,0-10,0-4,0-5,0.1,0.1-0.3,0.1-0.4,0.15-0.5,0.2,0.5-0.9,0.5-2,0.6,00-200,1,1-3,1.3-1.8,1.5-2.3,1.5-2.5,1.5-3,1.5-6,1.8-2.3,1/3,1/3-1/2,1/4,1/4-1/3,15-60,2.2-2.8,2.4-3,2.5-3.5,2.5-5,3-,3-50,3-9,3/,4,4-15,4.2-7,4.5-8,5-10,5-60,5-7,5-merous,6-20,6-22,6-7.5,6-9,7-10,8-12,abaxially,acute,adaxially,almost,alyx,ame,andromonoecious,apar,apart,apically,apparently,berry,blade,branched,broad-deltate,c.,clearly,concolorous,conical,cream,dark,deltate,discolorous,distance,drying,eaf,eed,elongated,elongating,entire,equal,erect,extending,filament,flattened,flower,free,glabrous,gra,green,hermaphrodite,heterostylous,infructescence,least,lobe,long,long-styled,longer,lower,lowermost,margin,marking,mature,midvein,moderately,multangulate,narrow-deltate,nflorescence,obtu,often,older,one,open,orolla,oung,pair,pale,pendent,pendulous,per,pericarp,plurifoliat,portion,prickl,prickly,primary,ray,ruit,scar,short-styled,side,smooth,spaced,sparsely,spreading,stalk,staminat,stellate,stout,tamen,terete,tertiary,time,unarmed,unit,upper,variously,vary,vein,venation,visible,way,weakly,wide,woody,yellowish,ympodial	arrangement,articulation,color,connation,corolla,dehiscence,diminishing,foetid,foliage,form,gray,growth,height,history,inflorescence,interjected,leaflet,life,na,ovary,papillae,petiolule,position,pseudostipule,seed,shape,size,spacing,stigma,straightnes,texture,tuber-bearing
390	wfo-0001028571	success	230	114	66	164	48	0.287	0.4,1.1-1.4,2.5,accrescent,anther,apex,base,broadly,brown,calyx,cm,curved,dark,diameter,elongated,extra-axillary,fertile,fewer,finely,flattened,flower,free,fruit,fruiting,glandular-puberulent,globose,highly,lanceolate,length,light,lobed,long,minutely,mm,ovate,pale,pedicel,peduncle,perhaps,petiole,prickle,recurved,scattered,sessile,shrub,simple,size,somewhat,spreading,stellate,stem,stigma,stout,straight,style,surface,thin-textured,tip,triangular,tube,unbranched,undulate,usually,white,x,yellow	'',.1,.2,.5,/3,0.2–0.4,0.3–0.4,0.3–0.6,0.4–0.8,0.5–1,0.6–0.8,0.6–1.4,0.75–4,0.9–1.7,0–,1,1.5–2.4,1.7–2.6,1/2,1/3,10–21,11–12,12,13–25,18,1–1.4,1–1.5,1–2,1–5,2,2-foliate,2.5–15,2–10,2–3.4,3,3.4–3.7,3.5–16,3–13,3–5-celled,3–7.5,3–8,4-rayed,40–80,4–10,4–15,5,5.2–9.2,5–15,5–8,62,7–16,8–12,8–14,8–15,9,=,``,abaxially,absent,acicular,acute,adaxially,almost,also,apical,average,axe,ba,bacca,blade,capitat,cell,compressed,contiguou,cordate,cover,cylindrical,dense,densely,differing,dilated,dimorphic,directed,distall,divided,eaf,eed,enlarged,entire,erect,especially,exclusively,extreme,filament,geminat,geminate,glabrou,gland,gland-tipped,glaziou,hair,half,hyaline,interlocking,larger,linear,lobe,longer,longest,lower,lutea,margin,marginal,matura,maturing,merely,minute,multangulate,n,narrowly,near,nearly,nflorescence,one,orolla,p,pair,per,pore,proportion,pubescence,pubescent,rachi,ray,rounded,ruit,shallow,similar,slender,small,smaller,sparsely,stellae,stipitate,summit,surrounded,tal,tamen,tem,terete,time,tomentose,unarmed,unit,variable,vary,varying,vestigial,visible,wide,wing,ympodial,–1.6,–19	0.3-0.6,0.75-4,1-5,11-12,13-25,3-8,4-10,5-8,8-15,arrangement,articulation,bark,capitate,color,connation,corolla,dehiscence,diminishing,distal,foetid,foliage,form,growth,height,history,inflorescence,interjected,lateral,leaf,leaflet,life,na,ovary,papillae,perennial,petiolule,plant,position,pseudostipule,seed,shape,spacing,straightnes,terminal,texture,trichome,tuber-bearing,young
391	wfo-0001028583	success	294	107	82	212	25	0.279	.0,.5,.9,0.2–0.6,1.0–2.1,1.1–7.7,1.4–4.7,1.5–2.4,1/2,2.2–3.1,6.5–16.0,7.0–1.4,acute,aequilateral,anther,apex,apical,bark,base,brown,calyx,capitate,central,chartaceous,cm,corolla,cuneate,deciduous,deeply,diameter,distal,dry,evenly,flattened-reniform,fruit,globose,green,incurved,large,lateral,leaf,lightly,long,major,margin,mature,minute,mm,oblique,oblong,orange,ovate,pedicel,peduncle,petiole,pitted,pore,portion,purple,red,red-brown,reddish,rounded,short,shrub,simple,somewhat,spreading,stellate,stem,stigma,style,subacute,subcoriaceous,surface,tardily,time,vein,white,wide,yellow,±equal	.2,.6,0,0.01,0.06,0.08,0.13,0.3–0.6,0.4,0.4–0.6,0.6,0.6–0.9,0.6–1.0,0.6–1.3,0.6–2.2,0.8–1.2,0.8–1.4,0.8–1.5,0.9–1.3,0.9–1.5,1.0–1.2,1.2–1.9,1.4,1.4–1.5,1.4–1.9,1.5–3.1,1.8–2.3,1.9–2.6,1.9–3.2,1/3,1/3–1/2,2.0,2.3,2.3–6.8,2.5–2.9,2.6,2.6–3.7,2.6–4.8,2/3,3.1–4.0,3.2–6.2,3.5–3.8,4,4.3,4–8,5-merou,5.1–15.4,5.2,5.2–6.3,5.7,5–9,6.3,6.9–9.2,6–8,abaxially,absent,adaxially,adnate,ag,alyx,anthesi,apart,ape,apparently,appearing,appressed,around,articulate,attenuate,axe,ba,basal,based,bent,berry,blade,borne,branch,branching,broad,bud,channeled,congested,craspedodromous,deltate,deltoid,densely,dentate,developed,difoliate,directed,distinct,eaf,edge,eed,either,emerging,endocarp,erect,exocarp,extending,extra-axillary,ferruginous,fertile,filament,filiform,flexed,flower,free,geminate,glabrous,glandular,glossy,gradually,gree,hair,heterostylous,immature,immediately,increasing,individually,intact,internode,interpetalar,intersepalar,juic,lanceolate,layer,lobe,lobed,lon,longer,lower,many,midpoint,midrib,midvein,minor,moderately,narrowly,nearly,nflorescence,occasionally,opaque,orolla,per,perforated,poorly,porrect,porrect-stellate,potentially,present,prickle,primary,pubescence,pubescent,raised,ray,red-orang,reflexed,remaining,restricted,ridge,rigid,row,ruit,scattered,secondary,semicraspedodromous,sessile,several,shorter,shot,side,sinuate,sinus,slightly,sloughing,spaced,sparsely,splitting,spread,stamen,stellae,stellate-pubescent,stipe,stipitate,straight,suture,tamen,tem,thin,tip,tissue,toward,transparent,triangular,truncate,tube,two,ud,unarmed,unbranched,upper,vary,well,yellow-ferruginous,ympodia,young,±90°,±erect,×	arrangement,color,dehiscence,diminishing,form,growth,height,history,inflorescence,interjected,leaflet,length,life,na,papillae,petiolule,plant,pseudostipule,seed,shape,size,spacing,terminal,texture,tuber-bearing
392	wfo-0001028587	success	178	101	66	112	35	0.371	0.3,0.3-1,0.8-1.8,1-2,1-4,6-8,accrescent,acuminate,acute,anther,apex,bark,base,brown,calyx,closely,cm,corolla,distal,fruit,fruiting,geminate,glabrous,globose,green,greenish-white,lateral,leaf,length,lobed,long,minute,minutely,mm,nearly,obe,obovate,opposite,ovary,ovate,ovoid-reniform,papillose,pedicel,petiole,pitted,poricidal,pubescent,seed,shrub,spaced,stem,stigma,straight,straw-colored,style,subumbellate,surface,terminal,tip,triangular,trichome,tube,unicellular,uniseriate,white,young	.4,.5,.75,0,0.5,0.5-1,0.7-1.2,0.8-1.6,0.8-2.9,1-1.3,1-1.5,1.3-5.1,1/4,2-5,2.1-6.9,2.5,3-8,6.5-17.7,8-10,8-10-flowered,abruptly,across,anthesi,baseflower,becoming,berry,ca,chartaceou,coat,cracking,cup,deflexed,degree,densely,dia,different,difoliate,drying,eaf,edicel,eed,ellipsoid,erect,filament,flower,forming,free,geminat,impressed,keeled,lamina,layer,like,lobe,lon,long-styled,lower,main,major,middle,midrib,minor,narrowing,nflorescence,obovoid,occasionally,often,older,open,outer,overlappin,pair,paler,papillo,peeling,per,persistent,pore,portion,puberulent,pubescence,pubesent,reflexed,ruit,scar,scattered,short,simple,slender,slightly,slit-like,sparsely,stiff,tall,thickened,thin,transversel,two,type,ud,umbonate,unit,upon,upper,usually,variable,vein,wide,widest,woody,x,ympodial	1,6,arrangement,articulation,color,connation,dehiscence,diameter,diminishing,foetid,foliage,form,growth,height,history,inflorescence,interjected,leaflet,life,midpoint,na,overlapping,papillae,peduncle,petiolule,plant,position,prickle,pseudostipule,shape,size,spacing,straightnes,texture,tuber-bearing
393	wfo-0001028594	success	142	96	68	74	28	0.479	.5,0.8-1.8,1-1.2,1-2,1.5-9,12,12-14,2,3-4,acuminate,acute,anther,apex,base,becoming,black,bottle-shaped,calyx,cm,conical,corolla,densely,diameter,drying,ellipsoid,elliptic,especially,flattened-reniform,fruit,glabrous,globose,green,hair-like,herb,immature,inflorescence,leaf,length,long,margin,maturity,minutely,mm,orange-brown,ovary,ovate,pedicel,petiole,planar,projection,pubescent,purple,rectangular,reddish,reflexed,regular,rounded,simple,slightly,smooth,somewhat,sparsely,stigma,style,surface,tube,violet,x	0-100,0.3-1.0,1-1.3,1-1.5,1-3,3-6,3-9,5-6,6-20,6-7,abaxially,adaxially,along,anthesi,axil,axillary,bearing,berry,capitat,cell,climbing,denser,eaf,edicel,eed,epidermal,exserted,filament,floo,flower,forest,free,fruiting,glabrat,inflorescenc,lax,like,lobe,lon,lower,minute,nflorescence,noddin,obtuse,often,open,pair,papillate,pendent,per,portion,primary,quit,rest,ruit,scar,scattered,side,soft,spreading,strait,strongly,tem,time,tip,trailing,trichome,tub,ud,unifoliat,uniseriate,unit,vein,ympodial	arrangement,bark,capitate,color,connation,dehiscence,diminishing,distal,form,growth,height,history,lateral,leaflet,life,na,papillae,peduncle,perennial,plant,seed,shape,size,stem,straight,straightnes,texture,tuber-bearing
394	wfo-0001028660	success	204	127	89	115	38	0.436	0.2-1.1,0.3-1.1,0.5-2.8,0.5-5.5,0.7-4.2,0.9-2.5,1-10,1-2,1.5-4,2-11,2-6,2-9,3-30,5-8,6,7-10,absent,anther,articulated,axillary,base,blue,broadly,brownish,bud,chartaceous,clavate,cm,condition,connivent,corolla,decumbent,decurrent,diameter,distal,drying,elliptic,entirely,forked,fresh,fruit,globose,green,greenish,herb,honeycomb-shaped,interjected,lanceolate,lateral,leaflet,lengthening,linear,membranous,mm,narrowly,oblique,odd-pinnate,ovoid,pedicel,peduncle,pentagonal,petiole,plant,pore,poricidal,pubescent,purple,rarely,ripe,rotate,seed,size,slit,stem,stigma,straight,style,substellate,subtending,tall,terminal,tinged,tip,tube,typically,white,whitish,x,yellow	0-5,0.1-0.3,0.8-1,1.5-2.8,1.5-7.6,2-5,20,3-5,3-7,3-9,3.8-13,4-6,5-merou,abaxially,acumen,acute,adaxially,ag,along,alyx,apart,apex,apparently,attenuate,axe,berry,blade,borne,capitat,cell,ciliate,covering,densely,digestion,dorsally,dot,eaf,edge,eed,end,enzyme,erec,especially,exceeding,except,filament,flat,flower,folded,geminat,generally,glabrou,glabrous,greatly,green-white,hair,hair-like,half,homostylous,less,like,living,lobe,long,lower,make,margin,middl,midrib,minutely,mucilaginous,nflorescence,obtuse,often,orbicular,orolla,ovate,pair,perfect,petiolulate,petiolule,plurifoliate,proximal,puberulent,reduced,removed,ruit,scabrous,scattered,sessile,seudostipule,short,singly,spaced,sparsely,specimen,stamen,ste,stolo,subequal,sunny,tamen,tem,testal,thick,throughout,tri-,tuber,unit,unwinged,usually,vary,wall,wet,ympodial	age,arrangement,articulation,bark,calyx,capitate,color,connation,dehiscence,erect,foetid,foliage,form,fruiting,growth,height,history,inflorescence,leaf,length,life,middle,midpoint,na,ovary,papillae,position,prickle,pseudostipule,shape,spacing,straightnes,surface,texture,trichome,tuber-bearing,ye,young
395	wfo-0001028666	success	159	99	59	100	40	0.371	0.3-0.6,0.4-0.8,1-1.5,4-5,5-11,absent,accrescent,acute,adaxially,anther,apex,articulated,base,calyx,chartaceous,cm,cordate,cylindrical,densely,diameter,ellipsoidal,elliptic,extra-axillary,fruit,fruiting,glabrous,gland-tipped,grey-green,hair,inflorescence,lanceolate,lateral,lavender,length,mm,moderately,obtuse,ovate,pale,pedicel,peduncle,perennial,petiole,prickle,purple,red,scattered,short,shrub,simple,stellate,stellate-pubescent,stigma,style,tube,unbranched,white,yellow,yellowish	%,0-0.1,0-2,0.05-0.1,0.1-0.15,0.2-0.25,0.2-0.3,0.25-0.4,0.3-0.45,0.7-0.8,0.8-2,1,1-2,1-locular,11-19,2.2-2.3,2.5-5,2.5-7,2.6-4.2,3-4,3-4.5,3-6,4-5-merou,4-5.5,7-11,7-8,7-9,abaxially,absen,across,adaxiall,alyx,apart,apparen,axe,ba,blade,brown,capitat,connivent,directed,distall,distributed,eaf,eed,eglandular,entire,erect,exceeding,exocarp,finger,flower,incomplete,juicy,lamina,lobe,long,lower,margin,mature,mesocarp,midpoint,minute,nflorescence,oblique,orolla,part,per,perfect,placenta,pore,porrect,pseudo-umbellate,pubescent,ray,rhizomatous,ruit,septum,sessile,solitary,somewhat,spaced,stalk,stellae,succulent,tal,tamen,tem,thick,throughout,time,transparent,unarme,unarmed,unit,unknow,vary,wide,x,ympodial	abaxial,adaxial,arrangement,articulation,bark,capitate,color,connation,corolla,dehiscence,diminishing,distal,foetid,foliage,form,growth,height,history,leaf,leaflet,life,na,ovary,papillae,plant,position,pseudostipule,pubescence,seed,shape,size,spacing,stem,straightnes,surface,terminal,texture,trichome,tuber-bearing,young
396	wfo-0001028667	success	129	92	51	78	41	0.395	-2.6,0.4-0.7,0.7-4,1-1.5,1-6,3-11,acute,apex,articulated,base,branched,calyx,climbing,cm,completely,corolla,creamy,diameter,elliptic,exfoliating,flattened,fruiting,glabrous,growth,inflorescence,irregularly,leaf,minutely,mm,narrowly,pale,pedicel,peduncle,petiole,pitted,reniform,shiny,simple,sleeve,small,spaced,stem,straw-colored,surface,terminal,tube,twice,vine,white,woody,yellow	.5,1-2-1.5,1-4.5,1.3-2,3,5,5-20,5-merou,8-10,aid,alyx,anthesi,apar,appearing,ark,around,axillary,berry,branch,cell,climbin,clustered,conical,coriaceous,curling,deciduous,discolorous,dry,eaf,eed,ellipsoid,entire,exfoliatin,exserted,fide,flower,fragrant,like,lobe,long,lower,margin,mentz,midrib,new,nflorescence,occasionally,older,orolla,other,outer,papilla,papillat,pendan,per,perfect,plurifoliat,primary,revolute,scar,shoot,short,slender,slightly,soon,strongly,support,tem,tip,triangular,twining,ud,unit,vein,visible,wrinkling,x,ympodial	anther,arrangement,articulation,bark,color,connation,dehiscence,diminishing,distal,foetid,foliage,form,fruit,height,history,interjected,lateral,leaflet,length,life,midpoint,na,ovary,papillae,papillate,petiolule,plant,position,prickle,pseudostipule,seed,shape,size,spacing,stigma,straightnes,style,texture,trichome,tuber-bearing,young
397	wfo-0001028672	success	207	108	75	132	33	0.362	0-13,0.5-0.7,0.5-1,0.7-3,0.8-1,1,1-2,2-20,2-30,2.5-3.5,3-8,5-10,almost,ame,anther,apex,articulated,bark,base,broad,c.,calyx,chartaceous,cm,connivent,diameter,distal,elongated,flattened-reniform,fruit,fruiting,glabrescent,gray,lateral,leaf,length,long,maturity,mauve,midpoint,mm,moderately,obtuse,orange-brown,ovate,pedicel,peduncle,petiole,plant,poricidal,porrect,prickle,ray,reflexed,rotate,shrub,simple,sometimes,spherical,stalked,stellate-pubescent,stem,straight,style,surface,tapering,terminal,tip,translucent,trichome,truncate,tube,variously,yellow,young	-6,-merous,.5,/4,0,0-15,0-150,0-5,0.2,0.2-0.4,0.2-0.7,0.3-1,0.5-1.2,0.5-5,1-3,1.3-8,1.5-2.2,1.5-3,1.8-2.2,1.8-2.5,1/,1/4,1/4-1/3,2-10,2-3,2.4-2.8,2.5-12,3-5,4-6,4-8,5,5-8,6-12,9-15,abaxially,acut,acute,adaxially,alyx,andromonoecious,apar,apart,apically,apparently,berry,black,blade,branched,broad-deltate,brow,concolorous,cream,dark,deltate,difoliate,discolorous,distance,drying,eaf,eed,elongating,equal,erect,extending,filament,flattened,flower,free,geminat,glabrous,green,hair,hermaphrodite,heterostylous,infructescence,lobe,lobed,long-styled,longer,lower,lowermost,margin,marking,mature,midvein,minute,nflorescence,older,one,open,orolla,oung,pair,pale,pendulous,per,pericarp,portion,prickl,prickly,primary,rounded,ruit,scar,sessile,short-styled,side,smooth,spaced,sparsely,spreading,stalk,staminat,tamen,terete,tertiary,time,unarmed,unit,upper,usually,vary,vein,venation,visible,way,weakly,wide,woody,yellow-green,yellow-orange,ympodial	arrangement,articulation,brown,color,connation,corolla,dehiscence,diminishing,foetid,foliage,form,growth,height,history,inflorescence,interjected,leaflet,life,na,ovary,papillae,perennial,petiolule,position,pseudostipule,seed,shape,size,spacing,stigma,straightnes,texture,tuber-bearing
398	wfo-0001028674	success	196	116	86	110	30	0.439	0.1,0.5-0.8,0.7-1,1-3,1.5-3,10-15,2-3,2-5.5,3-11,4-5,acuminate,acute,anther,apex,apiculate,articulate,attenuate,bark,base,branched,brown,calyx,chartaceous,cm,corolla,curved,dark,diameter,distal,eglandular,elliptic,erect,flattened,fruit,fruiting,glabrescent,glandular,globose,green,greenish,growth,lateral,laterally,leaf,leaf-opposed,lenticular,lobed,maturing,midpoint,mm,much,ovary,pedicel,peduncle,petiole,plant,poricidal,prickle,recurved,reddish,reniform,reticulate,rounded,rusty,sessile,shrub,simple,slightly,stellate,stem,stigma,straight,style,subcapitate,subsessile,surface,tapering,tip,trichome,tube,variegated,white,woody,x,yellow,young	-1,0.2-0.25,0.2-0.3,0.5-0.7,0.7-1.0,1-1.5,1-2,1/3,1/4,10-30,2-2.5,2.5-3,3-10,3-3.5,3-4-lobed,4-4.2,5-6,5-7,8-10,abaxially,adaxial,adaxially,angulate,armed,basal,berry,blade,branching,brow,c.,caly,campanulate,confined,conical,coriaceous,cream,densely,directed,distally,eaf,eed,entire,erec,especially,exserted,face,fewer,filament,flower,free,glabrous,glandular-puberulent,glandular-pubescent,heterostylous,hirsute,juvenile,larger,leave,lengthening,like,linear-lanceolate,lobe,long-styled,lower,margin,minute,mucilaginous,new,nflorescence,ochraceous,older,one,partially,perfect,pericarp,plurifoliat,pore,porrect,portion,prickly,pubescent,raise,ray,reduced,ruit,scar,scattered,shallowly,short-styled,similar,sparsely,staminate,stellate-pubescent,stellate-tomentose,subglobose,terete,testa,thick,time,tomentose,triangular-lanceolate,ud,unarmed,unicellular,unit,upper,way,whitish,yellowish,ympodial	arrangement,articulation,color,connation,dehiscence,diminishing,foetid,foliage,form,height,history,inflorescence,interjected,leaflet,length,life,na,papillae,pellate,petiolule,position,pseudostipule,seed,shape,size,spacing,straightnes,terminal,texture,tuber-bearing
399	wfo-0001028680	success	236	124	87	149	37	0.369	.0,0.3–2.1,1,1.4–1.8,1.7–2.1,1/2,acuminate,aequilateral,anther,apex,apical,appearing,articulate,attachment,attenuate,bark,base,brown,calyx,cm,connivent,coriaceous,corolla,diameter,distal,dry,elliptic,extra-axillary,fast,flattened-orbicular,flattened-reniform,fruit,glabrous,glandular,globose,growth,hair,lanceolate,lateral,layer,lower,markedly,mature,minute,mm,notched,obtuse,occasionally,ovate,pedicel,petiole,pitted,point,pore,porrect,prickle,pubescent,reddish,rounded,scattered,sessile,shoot,short,shortly,shrub,simple,sloughing,sometimes,sparsely,stellae,stellate,stem,stigma,style,sub-cordate,surface,terminal,transparent,tube,unbranched,white,yellow,yellow-tan,young,±glabrous,±straight,–1.75	.2,.3,.5,.8,0.2–0.3,0.4,0.5–0.8,0.5–2.3,0.9,0.9–1.0,0.9–1.2,1.1,1.1–6.5,1.2,1.2–2.2,1.6–2.5,1.7–2.2,1.9–2.4,1/3,1/4–1/3,1–2,2.1–3.0,2.2–2.5,2.2–3.0,2–3,3.2–3.5,3.8–4.6,4.3–5.9,4–5,4–5-merou,5.2–7.2,6–8,?,abaxially,adaxially,adnate,ag,alyx,anthesi,apiculate,apparently,appresse,around,ba,based,berry,blade,borne,broad,brochidodromous,capitat,channeled,deltoid,dentate,developed,development,directed,distally,distinct,eaf,edge,eed,either,emerging,endocarp,entire,exocarp,extending,fertile,filament,filiform,flexed,flower,free,glossy,gradually,homostylous,hort,increasing,individually,intact,internode,interpetalar,intersepalar,isolated,juic,limp,lobe,lon,long,longer,many,margin,middle,midpoint,midrib,midvein,nearly,nflorescence,opaque,orolla,per,perforated,plurifoliate,poorly,portion,potentially,presen,rachi,raised,ray,remaining,retrorse,revolute,ruit,see,shorter,side,sinuate,sinus,slightly,splitting,spread,stamen,straight,suture,tamen,tem,thin,time,tip,tissue,toward,truncate,typically,ud,unarmed,vary,vein,weakly,wide,yellow-ferruginou,ympodia,±90°,±absent,±equal,×,–3,–6	1.8–3.0,arrangement,articulation,capitate,color,connation,dehiscence,diminishing,foetid,foliage,form,fruiting,height,history,inflorescence,interjected,leaf,leaflet,length,life,na,ovary,papillae,peduncle,petiolule,plant,position,present,pseudostipule,seed,shape,size,spacing,straightnes,texture,trichome,tuber-bearing
400	wfo-0001028688	success	137	100	60	77	40	0.438	0.4-1,0.5-0.75,0.5-1.5,0.9-1,1-5,2-3,5-6,acuminate,acute,along,anther,apex,area,bark,base,beneath,bi-cellular,calyx,cm,corolla,curl-tipped,deltoid,densest,glabrous,golden,lanceolate,leaf,like,lobed,long,mm,near,nearly,often,opposite,ovary,overtopping,papillose,pedicel,petiole,pilose,poricidal,reddish-brown,shiny,shoot,shrub,size,slightly,stem,stigma,straight,style,terminal,tip,trichome,tube,uniseriate,vein,white,young	.5,0.5,0.5-1,1-1.5,1-1.8,1-3,1.1-1.2,1.4-2.8,2.2-4.8,5-11,across,anthesi,apar,branch,clavate,deciduous,decreasing,deflexed,densely,dia,differing,difoliate,eaf,edicel,eed,elliptic,exfoliatin,exserted,filament,free,furcate,geminat,globose,interpetalar,irregularly,know,known,lobe,lon,lower,major,markedly,membraneous,middle,minor,minutely,nflorescence,occasionally,older,paler,planar,pore,portion,proximal,pubescent,ruit,scar,shaped,sinus,slender,soon,spaced,sparsely,styl,tall,tapering,tear-drop,thickened,thin,tub,ud,unit,usually,wide,widest,x,ympodial	apart,arrangement,articulation,color,connation,dehiscence,diameter,diminishing,distal,exfoliating,foetid,foliage,form,fruit,fruiting,growth,height,history,inflorescence,interjected,lateral,leaflet,length,life,midpoint,na,papillae,peduncle,petiolule,plant,position,prickle,pseudostipule,seed,shape,spacing,straightnes,surface,texture,tuber-bearing
401	wfo-0001028690	success	191	116	85	106	31	0.445	0-0.5,0-5,0.1-0.2,0.3-2.5,0.5-0.8,0.5-6,0.8-1,0.8-2,1-7,1.3-6.5,2-7,3-4.5,30-50,4-7,4-9,4.5-16.5,7-10,8-9,abaxially,absent,acute,adaxially,adult,anther,apart,apex,base,branch,broad-based,calyx,chartaceous,cm,cuneate,densely,directed,dm,entire,flower,fruit,glabrous,globose,green,inflorescence,juvenile,lanceolate,lateral,leaf,length,lobed,long,longer,margin,mid-point,minute,mm,moderately,obtuse,ovate,pale,pedicel,peduncle,per,perennial,petiole,plant,present,prickle,pseudo-racemose,pseudo-umbellate,purple,shallowly,shrub,stellate-pubescent,stigma,straight,style,surface,thick,time,tube,unbranched,white,wide,x,yellow	%,.3,0-0.1,0-0.2,0-7,0.05-0.1,0.15-0.25,0.2-0.6,0.25-0.4,0.3-0.5,0.3-0.7,0.4-0.6,0.5-1,1-2,1-5,1.5-1.7,2-3,2-locular,2.1-4.5,2.3-2.8,4-10,4-5.5.5,5-6,5-merou,5.5-6,6-8,7-30,7-8,9-13,9.5-14,absen,accrescent,across,adaxiall,alyx,andromonoecious,articulated,ascending,attenuate,axe,ba,blade,branche,capitat,connivent,cross-section,cylindrical,diameter,distall,distributed,eaf,eed,eglandular,erect,exocarp,extra-axillary,finger,fruiting,functional,geminat,gland-tipped,grey-green,hair,half,heterostylous,juicy,lamina,less,linea,lobe,lower,mature,mesocarp,midpoint,moist,nflorescence,oblique,orolla,pair,part,placenta,pore,porrect,ray,rhizomatous,ruit,sessile,short,simple,somewhat,spaced,sparsely,stalk,stellae,stellate,tal,tamen,tem,throughout,unarme,unarmed,unit,upper,vary,weakly,ympodial	bark,capitate,color,connation,corolla,dehiscence,density,diminishing,distal,distally,form,growth,height,history,leaflet,life,linear,na,ovary,papillae,petiolule,presence,seed,shape,size,spacing,stem,straightnes,terminal,texture,tuber-bearing
402	wfo-0001028696	success	224	68	38	186	30	0.17	adaxially,anther,attenuate,blue,calyx,cm,color,diameter,finely,fruit,globose,lateral,lavender,length,lenticular,midpoint,mm,oblong,ovate,pedicel,peduncle,petiole,pilose,pitted,plump,reniform,rotate-pentagonal,shiny,shrub,simple,stellate,stem,stigma,style,surface,tan,weakly,yellow	.5,0.8–,1.5–4,12–20,15–17,15–30,1–2,1–4,1–6,2.4,2.5,2.8–3.5,2–2.3,2–5,2–7,3.5–5.5,3–5,3–6.5,4–5,4–7,5,5-merou,5–15,6–13,6–8,7–8,7–9,8–13,8–20,9–10,9–12,abaxially,accrescent,acicular,acuminate,adaxiall,along,alyx,ample,anthesi,apart,apex,apparently,armed,articulated,ascending,asymmetric,axe,ba,base,bifi,blade,borne,branch,branched,bristle,bristle-like,bristly,broadly,chartaceous,coarsely,connivent,cordate,deltoid,densely,density,developed,difoliate,directed,distally,diverse,drie,eaf,eed,elongate,entire,erect,filament,flower,fruiting,geminat,glabrou,glabrous,gland,gland-tipped,glandular,hair,hirsute,homostylous,intergrading,intermixed,internode,interpetalar,known,lamina,larger,like,linear-caudate,linear-lanceolate,lobe,lobed,lon,long,long-stipitate,longitudinally,lower,margin,mature,middle,midvein,midzone,moderately,narrowly,near,nflorescence,numerous,obtuse,occasionally,often,one,orange,orolla,overtopped,ovoid,per,perfect,pericarp,pore,prickle,prickly,principal,prominent,pubescence,pubescent,ray,reflexed,repand,resembling,ruit,scattered,sessile,several-celled,short,short-,shorter,side,sinuate,slender,slightly,small,smaller,sometimes,somewhat,soon,spaced,sparser,splitting,spreading,stalked,stellae,stellate-hirsute,stellate-pilose,stellate-pubescent,subterminal,tall,tamen,tem,tippe,tipped,tissue,toothed,trichome,truncate,tube,ud,ultimate,vary,varying,vein,well,wide,widely,woolly,ympodia,young,×	0.5,0.8-2.5,1-6,1.5-4,12-20,5-15,9-10,9-12,arrangement,bifid,corolla,dehiscence,form,growth,height,history,inflorescence,interjected,leaf,leaflet,life,na,plant,pseudostipule,seed,shape,size,spacing,terminal,texture
403	wfo-0001028698	success	166	119	88	78	31	0.53	0.3-0.75,1-9.8,1.8-5,13-25,2-10,2-3,2-4,3-5,4-14,5-15,5-8,6,6-13,8-10,acuminate,acute,apex,apical,apically,articulate,base,branched,broadly,calyx,cm,conical,connate,corolla,cyme,dark,dehiscent,diameter,dichasial,dichasially,diminishing,distal,ebracteate,ellipsoid,elliptical,forked,green,green-white,herbaceous,interjected,introrse,lateral,leaf,leaflet,light,long,maturing,medium,mm,monochasial,mucilaginous,oblique,odd-pinnate,often,ovate,ovoid,pedicel,peduncle,pentagonal,perennial,petiole,petiolule,plant,poricidally,proximal,puberulent,pubescent,rachi,rotate,seed,short,size,slit,stigma,strigose,style,terminal,throughout,tuber-bearing,violet,white,wide,yellow,¼	0-1.,1-2,1-4,1.9-4,3-17,3-6-foliat,3.5,5-6,6-27,9-35,abaxiall,abaxially,acumen,adaxially,cell,commonly,covering,cuneate,darker,decurrent,digestion,dorsally,dot,eaf,edge,eed,emoval,enzyme,equal,exceeding,filament,first,flat,flower,folded,generally,globo,gradually,hair-like,half,honeycomb,living,lobe,lon,long-attenuate,lower,lunat,make,minute,nflorescence,nther,orolla,pair,pattern,perfect,plan,raised,rarely,reveal,ruit,sessile,seudostipule,smooth,specimen,stamen,straight,tal,tem,testal,thick,toward,two,typically,unit,usually,vary,wall,ympodial	0-10,anther,arrangement,color,decument,dehiscence,foetid,foliage,form,fruit,fruiting,globose,growth,height,history,inflorescence,length,life,lunate,midpoint,na,present,pseudostipule,shape,spacing,stem,surface,texture,trichome,ye,young
404	wfo-0001028716	success	145	91	52	93	39	0.359	.5,0.6-1.9,0.75,1-2,2.5-8,8-9,acuminate,anther,apart,apex,bark,base,bi-cellular,brown,calyx,cm,corolla,cuneate,dark,deflexed,fruit,glabrous,glandular,lateral,leaf,lobed,long,minutely,mm,often,opposite,ovary,ovate,papillose,pedicel,petiole,poricidal,shape,shrub,simple,size,stem,straight,style,tip,trichome,truncate,tube,uniseriate,white,x,young	.2,0.5,1.9-5.5,10-40-flowered,11-16.4,2-4,2.2-7.9,3.6-8.8,5-6,7-8,9-10,across,anisophyllou,anthesi,appearing,asymmetric,ba,becoming,beginning,beneath,branched,decurrent,dia,differing,difoliate,eaf,edicel,eed,ellipsoid,elliptic,evenly,except,fertilization,fifth,filament,filiform,free,geminate,hirsute,inflorescenc,intermediate,know,known,lengthening,lenticellat,less,like,lobe,lon,long-triangular,lower,main,major,markedly,middle,minor,much,nearly,nflorescence,node,older,one,orbicular,pair,pointed,pore,portion,prominent,proximal,puberulent,pubescent,raised,reflexed,remaining,rounded,ruit,scar,shaped,slightly,spaced,sparsely,stigm,strongly,tall,tear-drop,triangular,two,ud,unit,vein,widening,widest,ympodial	arrangement,articulation,color,connation,dehiscence,diameter,diminishing,distal,foetid,foliage,form,fruiting,growth,height,history,inflorescence,interjected,leaflet,length,lenticellate,life,midpoint,na,papillae,peduncle,perennial,petiolule,plant,position,prickle,pseudostipule,seed,spacing,stigma,straightnes,surface,terminal,texture,tuber-bearing
405	wfo-0001028723	success	211	113	77	134	36	0.365	.5,0-0.5,0.2,0.8-1,1-1.8,1-2.2,1-2.5,1/5-1/3,10-15,2-2.7,2-4,4-5,5,acute,almost,another,anther,anthesi,apex,articulated,bark,base,brachyblast,branch,branched,broadly,calyx,capitate,clearly,clustered,cm,corolla,curved,dark,dendritic,densely,diameter,drying,elliptic,free,leaf,length,liana,lobed,long,long-attenuate,longitudinally,membranous,minutely,mm,oblong,obovate,one,orange-brown,pedicel,peduncle,petiole,poricidal,ray,ridged,separated,short,shrub,slender,sparsely,stem,stigma,style,surface,terminal,tip,trichome,tube,unarmed,white,wrinkled,young	-1.5,.3,0.8-2,0°,1,1-1.5,1/3-1/2,10-16,2-2.5,2.5,3-4,3.5-4,4,5-6,5-7,abaxial,abaxially,adaxially,age,alternate,alyx,apar,apically,apice,apparently,becoming,branching,brown,common,concolorous,conical,decurrent,delineated,deltoid,density,developed,dilated,divided,domatia,dorsifixed,eaf,eed,ellipsoi,entire,equal,except,ey,faint,filament,fine,flat,flexuous,flower,formed,frequent,glabrous,gradual,green,increasing,inner,junction,know,known,lengthening,less,like,lobe,lower,m.,main,margin,middle,midvein,mostly,much,multiply,naked,narrowly,nflorescence,nther,obconical,obtuse,occasional,orolla,outer,ovate,overlapping,pair,pale,papillo,perfec,plurifoliat,poorly,pore,portion,primary,prominent,protruding,pubescent,rachi,raised,region,regular,ruit,scar,side,simple,sinus,small,smaller,smooth,spreading,stump,surrounding,tearing,tertiary,tissu,toward,transition,tuft,ud,uneven,unevenly,unit,vary,vein,venation,visible,wide,widely,x,yellow,ympodial,youngest	arrangement,articulation,color,connation,dehiscence,diminishing,distal,foetid,foliage,form,fruit,fruiting,growth,height,history,inflorescence,interjected,lateral,leaflet,life,na,ovary,papillae,papillose,petiolule,plant,position,prickle,pseudostipule,seed,shape,size,spacing,straightnes,texture,tuber-bearing
406	wfo-0001028725	success	197	129	96	101	33	0.487	-10,0.1-0.2,0.2-0.5,0.6-1,1-2,1.5-2,1.5-4,10-12,2.5-8,3-4,3-6,4-12,4-5,7,acicular,acute,anther,apex,armed,articulated,bark,basal,base,berry,brown,calyx,chartaceous,clavate-truncate,closely,cm,connate,cordate,corolla,diameter,distal,elliptic-ovate,elongate,finely,flattened,flower,fruiting,glabrescent,gland-tipped,globose,green,greyish,growth,inflorescence,internodal,lanceolate-subulate,leaf,lobed,long-styled,midpoint,midrib,minutely,mm,nearly,oblique,ovary,ovate,pedicel,peduncle,petiole,poricidal,prickle,ray,recurved,reduced,reniform,reticulate,rounded,rusty,sessile,short-styled,short-talked,shrub,simple,size,slightly,stellate,stem,stigma,straight,style,surface,terminal,tip,trichome,tube,undulate,unevenly,vein,violet,x,yellow	.1,0.3-0.4,1-1.5,1.2-1.5,1.5-1.7,1/4,2,2.5-3,3-plurifoliat,4-6-celled,4-locular,5-10,7-8,abaxially,adaxially,anthesi,bud,clearly,curved,densely,denser,depressed,discolorous,eaf,eed,eglandular,enlarged,entire,exserted,filament,free,glabrous,glandular,glandular-pubescent,glandular-tomentose,glandular-villose,greatly,heterostylous,inconspicuous,leathery,lengthening,like,linear-lanceolate,lobe,long,longer,lower,margin,minute,mixed,moderately,multicellular,new,nflorescence,obverse,older,papillo,perfect,pericarp,persistently,pore,porrect,portion,prickly,pubescence,pubescent,reflexe,reflexed,repand-angular,rest,ruit,rusty-brown,rusty-tomentose,scar,similar,slender,slit,small,somewhat,space,sparsely,stalked,staminate,stellate-tomentose,strongly,tall,tapering,terete,testa,tomentose,turbinate,ud,unarmed,unit,upper,varying,velutinous,viscid,whit,yellowish,ympodial	arrangement,articulation,color,connation,dehiscence,diminishing,foetid,foliage,form,fruit,height,history,interjected,lateral,leaflet,length,life,na,papillae,papillose,petiolule,plant,position,pseudostipule,seed,shape,spaced,spacing,straightnes,texture,tuber-bearing,white,young
407	wfo-0001028736	success	180	136	97	83	39	0.539	0.5,0.5-1.5,0.5-2,1,1-2,1-3,10-15,2-4,2-5,2-7,4-6,4-9,5-10,abaxially,absent,accrescent,acute,adaxially,anther,apex,apical,attenuate,base,beyond,brown,calyx,chartaceous,cm,connivent,contiguous,created,cylindrical,dark,diameter,directed,discolorous,exserted,extra-axillary,flower,fruit,fruiting,globose,green,hair,immature,leaf,length,light,like,lobe,lobed,long,many,mature,mm,moderately,mottled,nearly,netlike,obtuse,orange,pedicel,peduncle,per,petiole,pit,porrect-stellate,prickle,pubescent,raised,recurved,red,reniform,rhombic,ridge,roselike,shrub,side,simple,slightly,small,spaced,sparsely,stamen,stellate,stem,stigma,style,surface,tapering,tube,unbranched,unlobed,white,x,yellow,yellow-white	0.2-0.4,0.5-1,0.5-1mm,1-1.5,1.5,1.5-3,1/6,3-5,3-6,3-8,3.5-5,4-12,40-70,5-15,5-merou,6-13x3-8,6-8,adaxiall,alyx,apar,apparently,armed,axe,berry,blade,cordate,cut,decurrent,densely,difoliate,eaf,eed,either,filament,filiform,flattened,frui,geminate,glabrou,glabrous,glandular,gree,introsel,less,lower,m.,major,midpoint,midrib,midvein,multicellular,multiseriate,narrowly,nflorescence,occasional,occasionally,onto,orolla,pair,perfect,pore,purple,rachi,ray,ruit,scanden,sinus,stalk,ste,tamen,tem,thin-skinned,triangular,unarmed,unequa,unicellular,uniseriate,unit,vary,vein,way,wide,ympodial	apart,arrangement,articulation,bark,color,connation,corolla,dehiscence,diminishing,distal,foetid,foliage,form,growth,height,history,inflorescence,interjected,introsely,lateral,leaflet,life,na,ovary,papillae,petiolule,plant,position,pseudostipule,seed,shape,size,spacing,straightnes,terminal,texture,trichome,tuber-bearing,young
408	wfo-0001028737	success	151	125	87	64	38	0.576	0.2-0.5,0.7-2,1-2.5,1-6,1.5-3.5,10,12-14,16-30,2-3,2-5,3-5,4-6.5,6,acuminate,acute,apex,apical,apically,articulate,base,branched,calyx,cell,cm,connate,corolla,covering,cyme,dehiscent,diameter,dichasial,dichasially,diminishing,distal,ebracteate,forked,generally,glabrescent,glandular,globose,gradually,green,green-white,hair-like,half,herbaceous,interjected,introrse,lanceolate,lateral,leaf,leaflet,long,make,maturing,mm,monochasial,mucilaginous,oblique,odd-pinnate,often,ovoid,pedicel,peduncle,perennial,petiole,plant,poricidally,proximal,seed,short,size,slit,stellate,stigma,straight,style,terminal,testal,thick,throughout,toward,tuber-bearing,wall,wide,yellow,¼	1,1-4,2.8-3.5,3-4,3-6-foliat,4-10,4-9,5-6,7-15,abaxially,absen,acumen,adaxially,apiculate,attenuate,caudate,decurrent,digestion,dorsally,eaf,edge,eed,elliptic-lanceolate,emoval,enzyme,exceeding,filament,flat,flower,folded,globo,honeycomb,larger,living,lobe,lon,lower,nflorescence,nther,oblong,orolla,pair,pattern,perfect,pinnatifi,plan,rachi,reveal,ruit,second,sessile,seudostipule,specimen,stamen,strongly,tal,tem,throughou,typically,unit,vary,whit,without,ympodial	absent,anther,arrangement,articulation,bark,color,connation,dehiscence,foetid,foliage,form,fruit,fruiting,growth,height,history,inflorescence,length,life,na,ovary,papillae,pinnatifid,position,prickle,pseudostipule,shape,spacing,stem,straightnes,surface,texture,trichome,tube,wet,white,ye,young
409	wfo-0001028773	success	169	96	67	102	29	0.396	0-0.2,0.1-0.2,0.15-0.3,0.4-0.5,0.9-2.8,1-3,1.4-2,10-16,2,4-7,5-6.5,adult,anther,apart,apex,base,broadly,brown,calyx,chartaceous,cm,cordate,densely,diameter,directed,entire,flower,fruit,glabrous,globose,grey,inflorescence,juvenile,lateral,leaf,length,lilac,lobe,lobed,long,margin,minute,mm,obtuse,ovate,pair,pale,pedicel,peduncle,perennial,petiole,red,rotate,rotate-stellate,rusty,shallowly,shrub,simple,stellae,stellate-pubescent,style,surface,time,tube,unbranched,wide,yellow	%,.7,0-1,0.15-0.25,0.15-0.35,0.3-0.4,0.3-0.5,0.3-0.6,0.5-0.58,0.8-0.9,1-2,1-4.3,1-locular,2-5,2-6,2-foliate,2.2-2.8,3-4.5,3-5,3.3-3.8,30-55,4-6.5,4.5-5.5,5-merou,6-11,7-8,7-9,abaxially,absen,absent,accrescent,across,adaxiall,adaxially,alyx,apparen,articulated,axe,ba,blade,distall,distributed,eaf,eed,eglandular,elliptic,erect,exceeding,exocarp,extra-axillary,finger,fruiting,geminate,gland-tipped,glandular,green,greenish-white,hair,homostylous,incomplete,juicy,lamina,lower,mature,mesocarp,midpoint,nflorescence,oblique,onl,orolla,part,per,perfect,placenta,pore,porrect,prickle,probably,pseudo-racemose,ray,rhizomatous,ruit,septum,sessile,short,solitary,spaced,succulent,tal,tamen,tem,thick,throughout,unarme,unarmed,unit,upper,vary,white,without,x,ympodial	arrangement,bark,color,connation,corolla,diminishing,distal,distally,form,growth,height,history,leaflet,life,na,ovary,papillae,petiolule,plant,seed,shape,size,spacing,stem,stigma,straightnes,terminal,texture,tuber-bearing
410	wfo-0001028774	success	141	85	43	98	42	0.305	0.4-0.7,1.4-1.8,1/2-2/3,10-20,2.5-3.5,2.5-4.0,3-5,3-8,4-8,anther,arcuate,armed,base,blade,bright,broadly,calyx,chocolate-brown,cm,dm,dry,elongate,foveolate,glabrous,herb,lenticular,linear-lanceolate,long,minutely,mm,ovate,pentagonal-stellate,perennial,petiole,pinnatifid,prickle,spherical,stellate-pubescent,stem,surface,tube,vestiture,yellow	0.5-0.8,12-20-rayed,2.7-3.3,3-7,30-60,5-9,6-10-flowere,8-12,9-12,accrescent,acro,almost,along,alyx,annually,anthesi,appearance,beneath,berry,broad,campanulate,closely,deeply,density,developing,dia,difoliate,distinctive,divided,eaf,eed,emerging,erect,extended,externally,fine,fully,geminat,giving,grayish-green,hair,herbage,hetermorphic,internodal,invested,irregular,least,lengt,lobe,lon,lowermost,margin,maturity,merely,midvein,nflorescence,numerous,often,orolla,otherwise,per,prickly,rounded,ruit,scattered,separated,short,short-stipitate,slende,smooth,somewhat,spaced,splitting,spreading,stellate,stellate-woolly,stout,straight,strait-yellow,surrounding,tall,tamen,thick,tightly,tigma,tub,tyle,unarmed,undulate,unexpande,unit,vary,varying,velvety-farinaceous,weakly,woody,ympodial,zygomorphic	armament,arrangement,articulation,bark,color,connation,corolla,diameter,diminishing,distal,foetid,foliage,form,fruit,fruiting,growth,height,history,inflorescence,lateral,leaf,leaflet,length,life,midpoint,na,ovary,papillae,pedicel,plant,position,seed,shape,size,stigma,straightnes,style,texture,trichome,tuber-bearing,unexpanded,young
411	wfo-0001028777	success	205	127	91	114	36	0.444	-2.5,-4,0-2,0.1-0.2,0.4-0.8,0.5-1.3,0.7-1.2,0.8-2.2,1,1-2.5,1.5-3,1.5-4,1/4,2.5-5,3.5-5,3/4-4/5,anther,apex,articulated,attenuate,bark,base,calyx,chartaceous,cm,concolorous,connivent,curved,dark,diameter,discolorous,drying,elongating,flattened-reniform,fruit,fruiting,glabrescent,glabrous,green,inflorescence,leaf,length,less,lobed,long,marking,mature,maturity,mauve,midpoint,minute,mm,moderately,multangulate,obovate,orange,orange-brown,ovate,pale,pedicel,peduncle,petiole,poricidal,red-brown,reflexed,retuse,rounded,sessile,shrub,simple,small,smooth,sometimes,spherical,stalked,stellate-pubescent,stem,style,surface,tapering,terminal,tip,tree,trichome,truncate,tube,variously,way,white,wide,young	-10,-12,-3,.5,.8,.9,0-30,0.1-0.3,0.2,0.6-1,0.7-1.3,0.8-1,1-2,1-3,1.5,1.8-2.5,1/4-1/2,2-,2.5,2.5-3,3,4-5-merous,4.5-8,6-10,7-11,8,8-15,abaxially,acuminat,acute,alyx,ame,apar,ape,apically,berry,blade,branched,briefly,c.,deciduou,deltate,eaf,eed,entire,equal,erect,faint,filament,flower,free,glabrescen,green-brown,infructescence,lengt,lobe,long-styled,longer,lower,margin,narrow-deltate,nflorescence,occasionally,older,one,open,orolla,oung,pair,per,perfect,pericarp,plurifoliat,porrect,portion,present,primary,ray,recurved,reflexe,ruit,scar,shoot,short,short-styled,shorte,shorter,somewhat,soon,spaced,sparsely,spreading,stalk,staminate,stellate,stout,strongly,tamen,terete,tertiary,time,unarme,unarmed,unit,usually,vary,vein,venation,visible,whole,wider,woody,yellow-green,ympodial	apart,arrangement,articulation,color,connation,corolla,dehiscence,diminishing,distal,foetid,foliage,form,growth,height,history,interjected,lateral,leaflet,life,na,ovary,papillae,perennial,petiolule,plant,position,prickle,pseudostipule,seed,shape,size,spacing,stigma,straightnes,texture,tuber-bearing
412	wfo-0001028788	success	189	93	56	133	37	0.296	0.4-1.3,0.6-1.2,0.7-1.8,2.5-4.5,3-10,8-10,absent,acute,anther,apex,articulated,base,black,brown,calyx,chartaceous,cm,cordate,dark,diameter,extra-axillary,fruit,fruiting,globose,green,half,inflorescence,lanceolate,lateral,length,less,lilac,mature,mm,obtuse,ovate,pale,pedicel,peduncle,perennial,petiole,plant,present,prickle,pseudo-racemose,purple,shrub,simple,stellate,stem,straight,streak,style,tube,yellow,yellowish-green	%,0-0.3,0-0.4,0-10,0-3.5,0.05-0.1,0.1-0.4,0.15-0.4,0.2-0.4,0.3-0.5,0.5-1,0.7-1.3,0.7-1.4,0.8-1.1,0.8-1.5,0.8=2.5,1,1-1.5,1-10,1-2,1.1-2.3,1.4-1.6,10-14,10-20,2-3,2-5,2.3-3.6,2.5-3.5,2.5-8.5,4-locular,4.5-6.5,5-15,5-merou,6-10,6-14,6-8,7-10,7-9,8-11,abaxially,absen,acicular,across,adaxiall,adaxially,alyx,andromonoecious,anvil-shape,apart,ascending,attenuate,axe,ba,blade,broad-based,cross-section,cylindrical,decimetr,densely,directed,distall,distally,distributed,dult,eaf,eed,eglandular,entire,erect,exocarp,finger,flower,functional,gland-tipped,grey,grey-green,hair,heterostylous,hig,juicy,lamina,lobe,long,longer,lower,margin,markedly,mesocarp,mid-point,midpoint,minute,moist,multiradiate,nflorescence,oblique,onl,orolla,part,per,placenta,pore,porrect,ray,rhizomatous,rostrate,ruit,rusty,sessile,short,spaced,stage,stalk,stalked,stellae,stellate-pubescent,tamen,thick,thicker,throughout,time,unarme,unarmed,unbranched,unit,unknow,uvenile,vary,weakly,white,wide,x,yellowish,ympodial	arrangement,articulation,bark,color,connation,corolla,dehiscence,diminishing,distal,foetid,foliage,form,growth,height,history,interjected,leaf,leaflet,life,na,ovary,papillae,petiolule,position,pseudostipule,seed,shape,size,spacing,stigma,straightnes,surface,terminal,texture,trichome,tuber-bearing,young
413	wfo-0001028791	success	257	122	93	164	29	0.362	+,-9,0-6,0.3-0.4,0.3-0.6,0.4-1.1,0.8-1.3,1-1.5,1.5-,1.6-4.5,10,2-7,2.5-4.5,3-,4-11.5,4-5+,5-10,5-15,50-80,9-30,absent,acute,anther,apex,articulated,articulation,base,branched,breaking,broadly,brown,calyx,capitate,clambering,cm,corolla,deciduous,densely,developed,diameter,dichotomously,elliptic,fruit,fruiting,globose,green,hair-like,imparipinnate,interjected,interrupted,lateral,leaf,leaflet,liana,long,many,middle,mm,near,oblique,obovate,outgrowth,ovary,pale,pedicel,peduncle,per,petiole,petiolule,plant,poorly,present,pseudostipule,pubescent,scandent,seed,somewhat,sparsely,stellate,stem,stigma,style,surface,terminal,time,trichome,truncate,tube,usually,vine,wide,woody,yellow	-0.6,-1.5,.5,0.05,0.05-0.2,0.2-0.3,0.2-0.4,0.2-0.8,0.25-0.3,0.3-0.5,0.3-0.8,0.4-0.5,0.4-0.6,0.4-0.65,0.45-0.55,0.5,0.6-0.8,0.6-0.9,0.7-1.5,0.8-1,1-2,1-2-celled,1-3,1-3-celled,1-celled,1.5-2,1.7-2.1,1.8-3.3,100,2-3,2-3.5,2-7-celled,2-locular,2.8-3.0,20-to,3-4,4-15,4-celled,5-,5-22,5-plurifoliate,8-10-celled,9-35,abaxially,absen,abundant,acuminate,adaxially,addition,ag,along,anthesi,apical,appearance,appendage,basal,basiscopically,beneath,berr,border,bullate,cell,colo.,column,conical,consistently,dark,darker,deltate,densest,eaf,ebracteate,edicel,eed,eglandular,elongating,enlarged,entire,even,exserted,extended,filament,flower,free,give,glabrescent,glabrous,glandular,gree,grow,growing,half,halfway,head,internode,lamina,large,leaving,less,like,lobe,lon,lower,margin,midvein,minutely,mixture,much,multicellular,nflorescence,occasionally,often,pair,paler,papillate,primary,protuberance,pubescence,rachi,reflexed,rest,rough,round,ruit,sandpapery,secondary,sessile,short,shorter,silky,simple,single,slightly,small,smaller,sometimes,sparse,spreading,stamen,staminal,sterile,stiff,straight,tal,tem,tertiary,testa,thick,thickened,tip,touch,transparent,ud,unicellular,uniseriate,unit,upper,vegetation,vein,wall,white,winged,ympodial,–1-2-celled	arrangement,bark,color,connation,dehiscence,diminishing,distal,foetid,foliage,form,growth,height,history,inflorescence,length,life,na,papillae,position,prickle,shape,size,spacing,straightnes,tall,texture,tuber-bearing,ye,young
414	wfo-0001028798	success	214	110	72	142	38	0.336	0-1,0.2-0.4,1-4.5,1-6,10,2-7,2.5-3.5,3-5,5-8,5.25-7.5,7-8,accrescent,acute,anther,apart,apex,apical-lateral,articulated,attenuate,base,becoming,calyx,chartaceous,cm,continued,corolla,diameter,distal,dm,due,extend,flower,fruit,fruiting,greenish,growth,introrse,lanceolate,large,lateral,leaf,length,long,longitudinal,mm,oblanceolate,oblong,obovate,pale,pedicel,peduncle,petiole,pore,probably,ripe,rotate-stellate,short,shrub,simple,slightly,slit,small,somewhat,stem,stigma,style,subcoriaceous,subglobose,tube,unarmed,x,yellow	.5-5,0-60,0.5-2,0.9-1.2,1-3,1.1-2,1.5-1.8,1/2-2/3,1/20,15-19,2-3,2-3.75,2-6,2.4-4.4,2.6-4,2/3,3-4,3.3-5.6,3.8-4.2,4-5.4,6-10,6-8,8-18,8.5-13,abaxially,acuminate,adaxially,ag,anthesi,apparently,axe,axillary,ba,berry,blade,blunt-tipped,boat-shaped,branch,branched,bud,capitat,conical,curved,cylindrical,decurrent,dehiscing,densely,downward,eaf,echinoi,echinoid,eed,entire,exserted,filament,fleshy,free,glabrous,granular,granular-tomentose,green,hair,hal,high,included,inserted,irregularly,lacking,less,lined,lobe,lobed,lower,m.,main,many,margin,midvein,minutely,mixed,multangulat,multangulate,nearly,nflorescence,oblanceolat,obscured,obtuse,often,orbicular,orolla,oung,ovate-lanceolate,overlapping,perfect,persistent,persistently,plurifoliate,porrect-stellate,present,prominent,pseudo-terminal,pubescent,quite,rachi,rather,ray,rough,rough-granular,ruit,semi-ovate,sessile,short-stalked,side,spaced,sparingly,splitting,stalked,stamen,stellate-pubescent,strongly,subcampanulate,sulcate,suture,tamen,thick,time,tip,tomentose,tomentu,tomentum,toward,translucent,unarme,unit,unknow,vary,vein,velutinous,way,wide,yellowish,ympodial	age,arrangement,articulation,bark,capitate,color,connation,dehiscence,diminishing,foetid,foliage,form,height,history,inflorescence,interjected,leaflet,life,na,ovary,papillae,petiolule,plant,position,prickle,pseudostipule,pseudoterminally,seed,shape,size,spacing,straightnes,surface,terminal,texture,trichome,tuber-bearing,young
415	wfo-0001028803	success	204	117	83	121	34	0.407	.5,0.5,0.5–1,0.5–3,10,12–14,1–2,1–3,1–3.5,2–10,2–4,4–10,5–8,8–14,acute,anther,anthesi,apart,apex,attenuate,base,branched,brown,bud,calyx,chartaceous,cm,connivent,curve,curving,diameter,distal,downward,end,erect,flower,fruit,functionally,globose,green,hair,hermaphroditic,leaf,length,liana,light,like,lobed,long,longitudinal,male,mm,moderately,nearly,obtuse,opening,ovate,pedicel,peduncle,petiole,plant,proximally,pubescent,purple,reniform,rounded,scandent,shrub,simple,slit,small,spreading,stem,stigma,style,surface,tapering,tree,upward,violet,weakly,yellow,×	1,14–20,1–1.2,1–1.5,2,2–3,2–3.5,3–10,3–4,3–6,4–7,5,5-merous,6–10,75-120,8-12,8–12,abaxial,absent,actinomorphic,adaxial,ag,alyx,andromonoecious,apical,apparently,appearing,armed,articulated,asymmetrical,axe,ba,bearing,becoming,berry,blade,branch,cordate,cupular,curved,cylindrical,darker,densely,developed,difoliate,due,eaf,early,eed,elongated,em,entire,exceeding,extra-axillary,field,filament,flowering,fruiting,geminate,glabrou,glabrous,glandular,held,herbarium,infructescenc,lacking,late,lobe,main,margin,midpoint,midrib,midvein,multiseriate,narrowly,nflorescence,occasional,often,older,orolla,ower,pair,per,pinnate,pore,prickle,rachi,ray,recurved,ruit,secondary,sheet,side,slightly,spaced,sparsely,splitting,stalk,ste,stellate,stellate-pubescent,surfac,tamen,tan,tomentose,triangula,triangular,typically,unarmed,unequa,unit,upright,usually,vary,vein,venation,white,wid,ympodial,young,zygomorphic	1–20,age,arrangement,bark,color,connation,corolla,dehiscence,diminishing,form,growth,height,history,inflorescence,interjected,lateral,leaflet,life,na,ovary,papillae,perennial,petiolule,pseudostipule,seed,shape,size,spacing,straightnes,terminal,texture,tube,tuber-bearing,wide
416	wfo-0001028815	success	196	118	96	100	22	0.49	0.4-0.8,1-10,1-3.5,1-4,1-5,10-15,2-4,2.5-6.5,22-35,3-7,4-10,5-6,6-8,7-16,abaxially,acute,adaxially,anther,apex,auriculate,base,broadly,brownish,cell,cm,condition,corolla,covering,cuneate,dark,decreasing,developing,diameter,distal,drying,elliptic,forked,fresh,fruit,globose,green,green-white,greenish,hair-like,herb,interjected,lanceolate,lateral,leaflet,lengthening,lilac-purple,make,medium,mm,mucilaginous,obtuse,odd-pinnate,ovate,ovoid,pedicel,peduncle,petiole,petiolulate,plant,pore,poricidal,pubescent,purple,red-purple,ripe,rotate,rounded,rugose,seed,semi-rosette,sessile,short,size,slit,sparsely,stem,stigma,straight,style,terminal,testal,thick,throughout,tinged,tip,wall,wet,whitish,x,yellow,young	0.5-1,1-2,14-28,2-4.5,2-9,3-4,3-5,5-7,5-merou,6-10,acumen,ag,along,alyx,apart,apparently,articulated,articulation,axe,axillary,basiscopic,berry,blade,bud,capitat,chartaceous,ciliate,connivent,decurrent,digestion,distinct,dorsally,eaf,edge,eed,elliptic-lanceolate,enzyme,especially,exceeding,filament,flat,flower,folded,geminat,generally,glabrou,glabrous,hair,hal,half,high,homostylous,honeycomb-shaped,indistinct,like,living,lobe,long,lower,margin,membranous,midrib,minutely,narrowly,nflorescence,onto,orolla,pair,papillose,perfect,plurifoliate,pointed,puberulent,purpl,rachi,removed,ruit,semi-erec,seudostipule,side,slightly,spaced,specimen,splotched,stamen,ste,subtending,tall,tamen,tem,terminated,tri-,triangular-lanceolate,tube,unit,unwinged,usually,vary,winged,ympodial	age,arrangement,calyx,capitate,color,dehiscence,diminishing,form,growth,height,history,inflorescence,leaf,length,life,pseudostipule,semi-erect,shape,spacing,straightnes,surface,texture
417	wfo-0001028876	success	127	93	72	55	21	0.567	.5,/4,0.4-1,0.5-2,1-2,1.5-2,5-6,abaxial,abaxially,adaxially,along,anther,apex,bark,base,branched,brown,calyx,capitate,cm,conical,corolla,dark,dendritic,densely,elliptic,filament,glabrous,golden,leaf,like,lobe,lobed,long,midrib,minutely,mm,occasionally,older,ovary,papillae,papillose,pedicel,petiole,pore,poricidal,pubescent,reddish,rest,sagittate,shaped,shining,shrub,simple,small,sparsely,speciman,stem,stigma,straight,style,subshrub,surface,tear-drop,tip,trichome,tube,type,uniseriate,way,white,young	1.5-3,2-2.3,3-5,3-8,4-5,4-8,acute,anthesi,attenuate,closely,dia,difoliate,drying,eaf,edicel,eed,ellipsoid,flower,free,geminat,glabrat,hroughout,included,inflorescenc,internodal,know,known,lamina,lateral,leave,long-triangular,lower,main,middle,nflorescence,nodding,opposite,overlappin,pair,papillo,planar,portion,rounded,ruti,scar,slender,spaced,tall,tub,ud,unit,vein,widest,x,ympodial	alternate,arrangement,color,dehiscence,diameter,form,glabrate,glabrousnes,growth,height,herb,history,inflorescence,length,life,na,perennial,plant,shape,straightnes,texture
418	wfo-0001028883	success	207	114	66	141	48	0.319	1,2,5,50,acuminate,acute,almost,anther,apex,articulated,attenuate,base,berry,calyx,capitate,chartaceous,cm,completely,connivent,coriaceous,cyme,dark,diameter,dull,elliptic,exfoliating,flower,fruit,glabrous,globose,green,greenish,growth,herb,lateral,leaf,length,long,mm,narrowly,oblong,pedicel,peduncle,petiole,poricidal,reniform,ripe,seed,simple,size,slightly,stellate,stem,stigma,straight,style,subopposite,surface,trichome,unbranched,undulate,uniseriate,white,whitish,yellow,×	0.3–0.6,0.4–1.2,0.5–2,0.6,1.5–7,1–2,1–6,2–3,2–5,3–5,4,4–6,5-merou,6,6–10,6–12,abaxially,absent,accrescent,adaxiall,adaxially,along,alyx,antrorse,antrorsely,apar,arched,ark,ascending,axi,becoming,blade,branch,brochidodromous,brow,capitat,cell,ciliate,circular,common,concolorous,curved,cylindrical,decurrent,deltate,densely,differing,directed,drying,eaf,eed,elliptic-ovate,emarginate,entire,equal,erect,eye,filament,flattened,frui,geminate,geniculat,glabrescent,glabrou,glandular,head,hilum,hollow,impressed,introrsely,less,light,like,lobe,longitudinal,lower,lying,margin,membranaceous,midrib,minor,moderately,multicellular,naked,new,nflorescence,normally,notably,obtuse,often,older,onto,opening,orolla,ovate-lanceolate,parallel,pendan,per,perfect,plurifoliate,pore,present,primarily,prominent,pubescence,pubescent,rachi,rarely,region,rounded,ruit,secondary,sessile,shap,shiny,shrub,similar,single,single-celled,slit,small,sometimes,spaced,sparse,sparsely,spreading,stalk,subapical,subsessile,swollen,tall,tamen,tem,unit,vary,vein,venation,visible,wide,woody,ympodial	0.3-0.6,0.4-1.2,0.5-2,1-2,1.5-7,2-5,3-5,4-6,6-12,apart,arrangement,articulation,bark,brown,color,connation,corolla,dehiscence,diminishing,distal,dried,foetid,foliage,form,fruiting,height,history,inflorescence,interjected,leaflet,life,midpoint,na,ovary,papillae,petiolule,plant,position,prickle,pseudostipule,shape,spacing,straightnes,terminal,texture,tube,tuber-bearing,young
419	wfo-0001028885	success	214	103	70	144	33	0.327	0.5-1,0.5-5,0.7-2,1-1.2,1.5-3.5,2-2.5,7-8,9-11,acute,anther,apart,apex,articulated,attenuate,base,berry,black,brown,calyx,capitate,cm,connivent,corolla,dark,diameter,distal,ellipsoid,elliptic,fruiting,globose,growth,height,inflorescence,lanceolate,lateral,leaf,lobed,long,loosely,minutely,mm,multicellular,narrowly,pedicel,peduncle,petiole,plant,poricidal,pubescent,purple,recorded,reddish,ripe,scandent,shiny,shrub,simple,sparsely,stellate,stem,stigma,style,surface,terminal,tip,trichome,tube,uniseriate,vine,woody	-1,.5,0.3-0.5,1-1.5,1-2,1-3,1.5-1.7,10-20,2,2-,2.3-2.5,2.5-3.5,2/3,3-5,3.5-4.5,3.5-8.5,4-5,5-merou,7-9,9-12,?,abaxial,adaxial,adaxially,ag,along,alyx,anthesi,apiculate,apparently,archin,ark,basal,blackish,branch,branched,broadly,cell,collapsing,cup-shaped,dark-pigmented,decurrent,deltate,dendriti,densely,dried,drying,eaf,eed,entire,erect,exserted,extending,filament,fleshy,flower,free,furcate,glabrescent,glabrou,glabrous,glandular,golden,gradually,groove,groupe,ilament,immature,inserted,irregularly,known,lamina,leaving,lengthening,less,like,live,lobe,lower,margin,material,midvein,minute,mostly,narrowing,new,nflorescence,noddin,nodding,occasionally,often,older,orolla,pair,papillo,part,peg,perfect,pericarp,pigmentation,plurifoliat,pore,portion,primary,quarter,retaining,revolute,rhachi,ruit,scar,scattered,shin,short,sleeve,slender,slightly,slit,small,smaller,sometimes,spaced,spheroidal,spreading,strongly,tangled,tem,thin,third,time,twinin,ud,unit,upper,usually,vary,vein,wall,way,weak,weak-walled,wide,winged,ympodial,¾	arrangement,articulation,bark,color,connation,dehiscence,diminishing,foetid,foliage,form,fruit,history,interjected,leaflet,length,life,midpoint,na,ovary,papillae,papillose,petiolule,position,prickle,pseudostipule,seed,shape,size,spacing,straightnes,texture,tuber-bearing,young
420	wfo-0001028888	success	207	126	90	117	36	0.435	0-3.5,0-5,0-7,0.15-0.5,1-10,1-2,1.5-4,10-25,2.3-5,2.3-7,3-4,3.6-12.5,3.8-8.3,4-7,5-10,6-11,8-11,acuminate,acute,anther,apex,articulated,axillary,base,broadly,bud,chartaceous,clavate,cm,connivent,corolla,covered,diameter,distal,elliptic,forked,fruit,globose,green,greenish,hair,herb,interjected,lanceolate,lateral,leaflet,like,membranous,middle,mm,mottled,mucilaginous,oblique,odd-pinnate,ovate,ovoid,pedicel,peduncle,pentagonal,petiole,petiolule,plant,poricidal,pubescent,purple,ripe,rounded,seed,short,size,slightly,sparsely,stem,stigma,straight,streak,style,subglabrous,substellate,subtending,terminal,tip,tube,typically,violet,wet,white,whitish,x,yellow	1,1-1.5,1-3,12.5-25,2-5,2-6,2.5-3.3,3-5,4-25,5-7,5-merou,8-13.5,abaxially,acumen,adaxially,ag,along,alyx,apart,apiculate,apparently,axe,berry,blade,brownish,capitat,cell,center,central,ciliate,condition,covering,cuneate,digestion,dorsally,dot,drying,eaf,edge,eed,end,enzyme,erec,especially,exceeding,except,filament,flat,flower,folded,fresh,geminat,generally,glabrou,glabrous,glaucous,greatly,green-white,hair-like,hal,half,homostylous,honeycomb-shaped,lengthening,less,living,lobe,long,low,lower,make,margin,midrib,minutely,nflorescence,often,one,orbicular,orolla,pair,perfect,petiolulate,placed,plurifoliate,pore,proximal,puberulent,reduced,removed,ruit,scattered,sessile,seudostipule,slit,sometimes,spaced,specimen,stamen,ste,stolo,subequal,tall,tamen,tem,testal,thick,throughout,tri-,truncate,tuber,unit,unwinged,usually,vary,wall,wing,ympodial	arrangement,articulation,bark,calyx,capitate,color,connation,dehiscence,diminishing,erect,foetid,foliage,form,fruiting,growth,height,history,inflorescence,leaf,length,life,na,ovary,papillae,position,prickle,pseudostipule,shape,spacing,straightnes,surface,texture,trichome,tuber-bearing,ye,young
421	wfo-0001028905	success	210	107	76	134	31	0.362	-5,1,1-3,1.5-3,10,10-15,15-30,3-4,4,5,5-15,6-9,acuminate,anther,apex,base,bilobed,blunt,broadly,brown,calyx,capitate,cm,concentrically,corolla,cuneate,cyme,deep,deeply,distinctly,filament,floral,form,green,lasting,later,leaf,line,lobe,lobing,mm,oblong,obovoid,orange-yellow,ovary,ovate,ovoid,paling,pedicel,peduncle,petiole,pinnatisect,plant,poricidal,purple-blue,reddish,reticulate,rhachi,rotate,rugose,scorpioid,several,shortly,shrub,size,soft-wooded,stem,stigma,style,surface,tip,tube,x,year,yellow,young	-20,-3.5,-4,-9,1-,1.5,1.5-2,10-20,2,2-2.5,2-3,2.5-3,200-300,3-5,38/1-38/2,40-60,5-,7,acuman,acumen,adult,age,almost,also,appearing,appressed,aspect,aster,axil,becoming,berry,bluntly,broad,bud,cell,close,completely,conical,continued,covering,developed,dia,distance,eaf,eed,ellipsoid,emarginate,enlarged,entire,equal,even,exceeding,except,exerted,facetted,firming,first,flower,fork,forked,free,frui,fruiting,general,glabrescent,glabrous,glandular,growing,hair,herbarium,inadequate,interacuminal,intermediate,lanceolate,lengthening,less,lobed,lon,long,lower,main,margin,may,midrib,minute,mucronate,narrowly,nflorescence,occur,often,pair,papillo,pedicellate,plurifoliat,pore,purpli,range,rarely,reaching,readily,rh,ripe,rounded,ruit,ruiting,scarious,seedling,shed,short,show,showy,simple,sinus,slende,slit,smaller,soon,sparse,specimen,spreading,stone,straggly,succulent,suffused,tall,tissue,tub,ud,unit,usually,variable,violet,well,ympodial	1-7,arrangement,bark,color,connation,dehiscence,diameter,diminishing,distal,foetid,foliage,fruit,growth,height,history,inflorescence,lateral,leaflet,length,life,na,papillae,papillose,plurifoliate,seed,shape,straightnes,terminal,texture,trichome,tuber-bearing
422	wfo-0001028916	success	212	102	65	147	37	0.307	0.2-0.4,0.5-3.2,1-4.6,1.5-2.5,2-12,2-5,2.5-5,5-7.5,7-18,accrescent,anther,apex,articulated,base,calyx,chartaceous,cm,connivent,depressed-globose,diameter,ellipsoidal,elliptical,extra-axillary,fruit,fruiting,globose,green,grey,herbaceous,inflorescence,later,lateral,length,light,lilac,loosely,marbled,minutely,mm,oblong-attenuate,obtuse,ovate,pale,pedicel,peduncle,petiole,pitted,plant,present,prickle,prostrate,purple,resprouter,rotate,rotate-pentagonal,simple,somewhat,sprawling,stigma,straight,style,surface,tube,unbranched,yellow	%,-8,0-0.4,0-0.5,0-2,0.05-0.1,0.2-0.3,0.25-0.3,0.25-0.35,0.3-0.4,0.4-0.8,0.4-1.3,0.5-3,0.5-3.5,0.5-5,0.9-1.1,1-1.5,1-2,1-3,1-4,1-7,1.5-3,1.8-2.2,10-16,14-21,15-25,3-4,3-5,3.5-4.5,35-50,35-55,4-,4-8,5-10,5-12,5-35,5-9,5-merou,6-20,7-10,7-8,8-10,8-9,abaxially,absen,absent,abundant,acicular,across,adaxiall,adaxially,adult,alyx,andromonoecious,apart,armed,axe,ba,blade,branche,broad-based,broadly,brown,cuneate,cut,cylindrical,decimetre,deeply,deflexed,deltate,densely,directed,distall,distributed,eaf,eed,eglandular,filament,finger,flower,functional,glabrous,gland-tipped,hair,half,heterostylous,index,interpetalar,lamina,less,lobe,lobed,lobing,lon,long,longer,lower,margin,mature,mesocarp,midpoint,midvein,minute,moderately,nflorescence,notably,oblique,orolla,part,per,pore,porrect,presen,rachi,ray,ruit,sessile,shallowly,short,side,spaced,sparsely,stage,stellae,stellate,stellate-pubescent,succulen,tal,tamen,tem,thick,throughout,time,tissue,triangular,truncat,unit,unknow,uvenile,vary,vein,weakly,white,wide,winged,x,ympodial	arrangement,articulation,bark,color,connation,corolla,dehiscence,diminishing,distal,foetid,foliage,form,growth,height,history,interjected,leaf,leaflet,life,na,ovary,papillae,petiolule,position,pseudostipule,seed,shape,size,spacing,stem,straightnes,terminal,texture,trichome,truncate,tuber-bearing,young
423	wfo-0001028920	success	152	93	68	84	25	0.447	0.2-1,0.5-1,0.8-1.1,1-1.5,1-3,6-6.5,abaxially,acuminate,acute,adaxially,anther,arachnoid,area,attenuate,base,brown,brownish,calyx,closely,cm,congested,corolla,dark,dendritic,dense,difoliate,elliptic,glabrous,globose,green,lateral,leaf,lobed,long-styled,minutely,mm,nearly,obovate,occasionally,ovoid-reniform,papillose,pedicel,petiole,pitted,poricidal,pubescence,pubescent,shape,shaped,short-styled,shrub,simple,size,small,spaced,stem,stigma,style,surface,tear-drop,tip,tree,trichome,tuft,unifoliate,uniseriate,white,young	.25,.5,1-1.2,1-2.4,1.5-2,2-2.5,2-7,3-15-flowered,3-3.5,3-4,5-9,6-15,anthesi,apex,arachnoid-pubescent,axil,ba,bark,berry,broadly,conical,cucullate,decurrent,deflexed,deltate,densely,dia,differing,eaf,edicel,eed,ellipsoid,erect,exserted,felty,filament,fleshy,flower,free,fruiting,geminat,glabrate,gray-brow,later,lightly,lobe,lon,long,lower,main,major,middle,minor,nflorescence,obovoid,older,opposite,ovary,overlappin,pair,planar,pore,portion,present,ruit,scar,somewhat,soon,sparsely,strongly,styl,tall,tapering,thick,tub,tube,ud,unit,vein,widest,winged,woody,x,ympodial	arrangement,color,dehiscence,diameter,form,fruit,geminate,growth,height,history,inflorescence,interjected,leaflet,length,life,midpoint,na,overlapping,peduncle,plant,pseudostipule,seed,spacing,terminal,texture
424	wfo-0001028929	success	210	113	77	133	36	0.367	.9,0-20,0-3,0.4-0.8,0.5-2,0.7-2,2-3,2-6,2-9,4-6,8-10,acute,anther,apex,apparently,articulated,bark,base,calyx,cell,chartaceous,cm,connivent,cuneate,curved,densely,diameter,dull,elliptic,elongating,flattened-reniform,fruit,fruiting,gently,glabrescent,inflorescence,lateral,leaf,length,lobed,long,maturity,minutely,mm,obovate,obtuse,orange-brown,outline,patch,pedicel,peduncle,petiole,pit,poricidal,porrect,prickle,raised,red,red-brown,reticulate,sessile,shrub,simple,small,smooth,spherical,stalked,stellate-pubescent,stem,style,surface,tapering,tip,trichome,tube,white,yellow	-2,-2/3,.5,.7,/5,0,0-1,0-10,0.1,0.15-0.3,0.2-0.3,0.2-0.4,0.2-0.8,0.3-0.6,0.5-1.5,0.7-1,0.8-1,1,1-1.1,1-3,1.5-2.4,1/2,1/4-1/3,2-4,2.2-2.3,2.5-4,2.7-3,2/3-3/4,3-20,3-4,5-25,5-6,5-7.5,5-merous,6-8,7-9,abaxial,abaxially,acicular,adaxial,alyx,apar,apart,ape,apically,berry,blade,branched,concolorous,difoliate,discolorous,distance,drying,eaf,eed,equal,erect,extending,filament,flower,foliaceous,free,geminat,glabrou,glabrous,gra,hair,infructescence,lobe,lon,long-styled,longer,lower,margin,mature,midpoint,midvein,minute,narrow-deltate,narrow-ovate,nflorescence,oblong,obtu,occasionally,older,one,open,orolla,oung,pair,pale,pendulous,per,perfect,pericarp,perpendicular,portion,prickl,prickly,primary,ray,red-green,rounded,ruit,scar,short-styled,side,slender,sometimes,spaced,spreading,stalk,staminate,stellate,straight,subsessile,tamen,terete,tertiary,time,unarmed,unit,usually,variously,vary,vein,venation,visible,way,wide,woody,yellow-green,ympodial	arrangement,articulation,color,connation,corolla,dehiscence,diminishing,distal,foetid,foliage,form,gray,growth,height,history,interjected,leaflet,life,na,ovary,papillae,perennial,petiolule,plant,position,pseudostipule,seed,shape,size,spacing,stigma,straightnes,terminal,texture,tuber-bearing,young
425	wfo-0001028934	success	177	116	85	92	31	0.48	0.5-0.75,0.5-1,0.5-1.5,0.5-2,1-2,1-3,10-30,2-3,2-4,5-10,6-7,6-9,abaxially,acute,adaxially,anther,apex,asymmetrical,attenuate,base,berry,brown,bud,calyx,chartaceous,cm,connivent,created,cylindrical,dark,densely,diameter,filament,flower,fruit,glabrous,globose,green,hair,immature,leaf,leathery,light,like,lobed,many,margin,mature,mm,moderately,narrowly,nearly,netlike,often,orange,ovate,pedicel,peduncle,petiole,pit,prickle,pubescent,raised,recurved,red,reniform,ridge,simple,skinned,small,spreading,stem,stigma,style,surface,tapering,triangular,tube,unbranched,unlobed,vine,white,wide,x,yellow	0.5,1,1-.,1.5,1.5-2,1.5-2.5,15-25,2-2.5,3-5,3-6,3-7,5-15,5-6,5-8,5-merou,8-14,absent,accrescent,adaxiall,alyx,apar,apical,apparently,armed,axe,beyond,blade,cordate,difoliate,directed,discolorous,distally,eaf,eed,either,em,expanded,exserted,extra-axillary,filiform,flattened,frui,fruiting,geminate,glabrou,gree,introrsel,lanceolate,lobe,long,lower,m.,major,midpoint,midrib,midvein,multicellular,multiseriate,nflorescence,obscure,obtuse,orolla,pair,per,perfect,pirckle,pore,porrect-stellate,rachi,ray,reflexed,roselike,ruit,secondary,side,slightly,spaced,stalk,stamen,ste,stellate,tamen,tan,thin,unarmed,unequa,unicellular,unit,vary,vein,x1-3,ympodial	1-4,apart,arrangement,bark,color,connation,corolla,dehiscence,form,growth,height,history,inflorescence,interjected,leaflet,length,life,na,ovary,papillae,plant,pseudostipule,seed,shape,size,spacing,staman,straightnes,terminal,texture,tuber-bearing
426	wfo-0001028944	success	212	111	74	138	37	0.349	0.5-0.75,0.8-5,1-3,1-4,1-5,2.5-10,4-5,5-10,6-15,accrescent,acute,anther,apex,articulated,base,branched,broad,brown,calyx,chartaceous,cm,connivent,cordate,cuneate,curved,diameter,elliptic,extra-axillary,ferruginous,forked,fruit,fruiting,globose,growth,hair,lanceolate,leaf,light,long,longitudinal,midpoint,mm,multangulate,nearly,opening,outline,ovate,pedicel,peduncle,petiole,porrect-stellate,prickle,purple,reniform,rotate-stellate,rounded,shrub,simple,slightly,slit,small,smooth,stellate,stem,stigma,straight,style,surface,tree,tube,unbranched,whitish,yellow,young	.5-2.5,0.5-1,0.5-1.5,0.75-1.25,0.8-1.5,1-1.5,1-2,1-3-lobed,1.5-7,10-20,2-15,2-2.5,2-3,2.5-4,20-50,3-4,4-6,4-8,5-25,5-merou,6-7,6-8,7-17,8-10,8-13,abaxially,abundant,adaxially,ag,alyx,apart,apparently,armed,axe,ba,berry,blade,bright,broad-based,brownish,capitat,coarsely,covering,cylindrical,dark,deltate,densely,denser,difoliate,directed,discolorous,distally,divided,eaf,eed,entire,equal,erect,especially,filament,flattened,flower,free,frui,geminate,glabrescent,glabrou,glabrous,green,halfway,highly,homostylous,interpetalar,like,linear-acuminate,lobe,long-stalked,lower,main,major,margin,mature,membanaceous,midrib,moderately,mucilaginou,narrowly,nflorescence,numerous,oblique,obtuse,occasionally,often,orolla,part,perfect,pericarp,pore,pubescent,rachi,ray,recurved,ripe,ruit,sessile,shallowly,short-,short-stalked,shorter,side,sometimes,spaced,sparse,sparsely,stalk,stellate-pubescent,strongly,subtending,tal,tamen,tapered,tem,thin,time,tip,tissue,toward,triangular,unarmed,unit,vary,vein,white,white-pubescent,wide,x,yellowish,ympodial	age,arrangement,articulation,bark,capitate,color,connation,corolla,dehiscence,diminishing,distal,foetid,foliage,form,height,history,inflorescence,interjected,lateral,leaflet,length,life,na,ovary,papillae,plant,position,pseudostipule,seed,shape,size,spacing,straightnes,terminal,texture,trichome,tuber-bearing
427	wfo-0001028963	success	197	92	69	128	23	0.35	/2,0-0.4,0-2,0.1,0.1-0.25,0.3-1,0.45-0.6,0.6-1,1-4,1.5-2,2-4,anther,base,berry,bright,calyx,cell,chartaceous,cm,concolorous,diameter,discolorous,drying,dull,erect,evenly,flattened-reniform,gray-green,green,herb,inflorescence,lanceolate,lateral,leaf,length,lobed,maturity,mauve,midpoint,mm,narrow-elliptic,orange,outline,pale,pedicel,peduncle,petiole,pit,poricidal,purple,raised,ray,red,shrub,simple,small,smooth,spherical,stem,style,surface,tapering,terminal,tip,trichome,unbranched,way,yellow-orange,young	.5,0.1-0.2,0.15-0.3,0.3-0.6,0.3-0.7,0.3-1.5,0.6-0.9,0.8-1.8,0.9-1.5,1/,1/4-1/3,1/5,1/6,2-2.3,2-3,2-5,2-9,2.4-2.8,3-4.5,3.5-4.2,4-10,4-8,5-25,5-merous,6-10,7-8,abaxially,acute,alyx,apar,ape,apex,apically,apparently,articulated,attenuate,bark,becoming,blade,broad-deltate,brown,connivent,curved,cuspidat,deltate,densely,difoliate,eaf,eed,elongating,entire,equal,eye,filament,flower,free,frui,fruiting,geminat,glabrescent,glabrous,gra,herbaceous,infructescence,less,light,lobe,long,long-styled,longer,lower,margin,mature,moderately,naked,narrow-cuneate,narrowly,nflorescence,obtuse,occasionally,older,one,open,orolla,oung,pair,pendulous,per,perfect,pericarp,porrect,portion,primary,ruit,scar,sessile,short-styled,shorter,slender,slightly,spaced,spreading,stalk,stalked,staminate,stellate,stellate-pubescent,straight,subsessile,tamen,terete,tertiary,time,tube,unarme,unarmed,unit,upper,usually,variously,vary,vein,venation,visible,wide,winged,woody,ympodial	0.1-0.3,apart,arrangement,color,corolla,dehiscence,form,fruit,growth,height,history,interjected,leaflet,life,na,plant,pseudostipule,seed,shape,size,spacing,stigma,texture
428	wfo-0001028971	success	225	123	89	136	34	0.396	0.1-0.4,0.25-0.6,0.25-1.25,0.4-0.9,0.8-2.5,1-2,1/5-1/2,10-15,2.5-4.5,3-14,4-5,4-9,5-10,6-9,acute,adaxially,anther,apart,apex,appearance,articulated,attenuate,base,blade,broadly,calyx,cm,connivent,diameter,directed,distal,entire,farinaceous,flower,form,fruit,globose,inflorescence,interlobal,lateral,leaf,length,lenticular,lignescent,linear-lanceolate,lobe,longer,major,manifestly,midpoint,minute,minutely,mm,obtuse,orange,outline,ovate,pedicel,peduncle,perennial,petiole,pitted,prickle,pubescent,ray,reniform-ovate,sericeous,shorter,side,simple,sinus,smaller,stellate,stem,stigma,style,surface,tan,thin-textured,tooth-like,trichome,truncate,tube,unbranched,variable,vein,white,x,yellow	-0.8,-1.4,.1-0.2,0.1-0.5,0.2-0.5,0.3-0.6,0.4-1.5,05-2.5,1-5,1.5-2.2,1.5-4,1.75-2.5,15-30,2-5,2-foliate,2.2-3.5,2.5-3.5,2.5-5,20-35,3-5,3-6,5-15,5-8,6-16,6-8.5,7-16,abaxially,acute-,adaxiall,along,also,appearing,armed,ascending,axe,ba,bearing,becoming,branched,broad-based,campanulate,capitat,cauline,close,coarsely,compressed,cylindrical,delicate,deltoid,densely,dentate,distall,eaf,eed,elongate,elongate-deltoid,erect,essentially,extra-axillary,felty,felty-pubescent,female-sterile,filament,frequently,geminat,glabrous,grading,growt,hair,inserted,invested,lanceolate,largest,later,laterally,least,like,lon,long,longest,lower,margin,maturit,midrib,mixture,much,multiseriate,narrowly,nflorescence,numerous,occasionally,often,one,orolla,other,ovate-apiculate,ovate-lanceolate,pair,per,persistent,pore,prickly,principal,rachi,reduced,ripe,round-tipped,ruit,scattered,sessile,short,short-stalked,similar,sometimes,spaced,sparse,spreading-hirsute,spreadingly,stalk,ste,stellae,stellate-pubescent,stipitate,tal,tamen,tem,termination,time,underdeveloped,unit,usually,variously,vary,well-developed,wide,ympodial	arrangement,articulation,bark,capitate,color,connation,corolla,dehiscence,diminishing,distally,foetid,foliage,fruiting,growth,height,history,interjected,leaflet,life,na,ovary,papillae,plant,position,pseudostipule,seed,shape,size,spacing,straightnes,terminal,texture,tuber-bearing,young
429	wfo-0001028975	success	163	93	61	102	32	0.374	1-3,1-5,1.5-2,6-6.5,8-9,acuminate,acute,anther,apart,area,bark,base,broad,brown,calyx,cm,corolla,dark,elliptic,fruit,fruiting,glabrous,globose,golden,green,lateral,leaf,length,lobed,minutely,mm,nearly,once-furcate,opposite,ovary,ovoid-reniform,pedicel,petiole,pitted,poricidal,pubescent,shaped,shiny,shrub,simple,size,small,sparsely,stem,stigma,straight,style,surface,tear-drop,tip,tree,trichome,tube,uniseriate,white,young	.2,.5,0.1-1,0.5-1,1,1.2-1.5,1.5-1.8,2.2-6,3-10-flowered,3-3.5,3-6.5,5-ribbed,5.5-10,7.5-15,?,along,anthesi,apex,appearing,beneath,berry,closely,conical,conically,corky,cup-shaped,decurrent,deflexed,densely,denser,dia,differing,difoliate,eaf,edicel,eed,entire,epidermi,equal,erect,exserted,extension,filament,free,geminat,hyaline,immature,large-celled,late,like,lobe,lon,long,lower,main,mainly,major,margin,member,mere,middle,minor,narrowly,nflorescence,obscured,occasionally,older,one,pair,papillo,pore,portion,prominent,pubescenc,raised,reddi,reflexed,remaining,rib,ruit,scar,short,sinus,slender,slightly,somewhat,spaced,strongly,tall,tapering,triangular,tub,ud,unit,upper,varying,vein,wide,widest,woody,x,ympodial	9,arrangement,articulation,color,connation,dehiscence,diameter,foetid,foliage,form,growth,height,history,inflorescence,interjected,leaflet,life,na,papillae,papillose,peduncle,plant,position,prickle,pseudostipule,reddish,seed,shape,spacing,straightnes,terminal,texture
430	wfo-0001028980	success	168	116	82	86	34	0.488	.1,1.2-1.8,1.5-2,1.5-6,3/4,5-6,6,acuminate,acute,anther,anthesi,apart,apex,bark,base,berry,calyx,capitate,clearly,cm,coarsely,corolla,densely,dia,differentiated,elliptic,flattened-reniform,fleshy,fruiting,furcate,glabrate,glandular,globose,green,lateral,leaf,lobed,long,minutely,mm,opposite,ovary,ovate,pedicel,peduncle,petiole,pit,pitted,planar,pore,poricidal,pubescent,reddish,reflexed,seed,shaped,sharply,shining,shrub,simple,size,slightly,small,soon,speciman,stem,stigma,style,surface,tall,tear-drop,tip,tree,trichome,tube,type,usually,way,white,woody,yellowish,young	.5,.75,/3,0.5-1.5,1-1.2,1.2-3,1.5-1.8,2.5,2.5-5,20-25-flowered,3-4,4-5,5-8,6-8,7-12,along,axil,basal,beginning,beneath,black,broadly,conical,corky,cucullate,deflexed,deltoid,differing,difoliate,dry,drying,eaf,edicel,eed,expanded,exserted,extending,f,filament,free,frui,geminat,glabrous,impressed,incrassate,inflorescenc,lamina,lenticellat,like,lobe,lon,lower,m.,main,major,margin,material,member,middle,minor,nflorescence,occasionally,older,one,ovoid,pair,pale,paler,papillose,portion,prominent,ruit,scar,scarious,sparsely,strongly,tapering,thick,ti,ud,uniseriate,unit,vein,widest,x,ympodial	arrangement,articulation,color,connation,dehiscence,diameter,diminishing,distal,foetid,foliage,form,fruit,growth,height,history,inflorescence,interjected,leaflet,length,lenticellate,life,na,papillae,petiolule,plant,position,prickle,pseudostipule,shape,spacing,straightnes,terminal,texture,tuber-bearing
431	wfo-0001028982	success	213	97	61	152	36	0.286	0-0.2,0.3-0.6,0.4-1.1,4-5,4-6,8-18,accrescent,acute,angled,anther,apex,articulated,base,calyx,chartaceous,cm,connivent,contiguous,cuneate,diameter,extra-axillary,fruit,fruiting,globose,hastate,inflorescence,lanceolate,lateral,leaf,length,lilac,loosely,mm,narrowly,nearly,obtuse,pale,pedicel,peduncle,perennial,petiole,present,prickle,pseudo-umbellate,red,reniform,rugose,shape,shrub,simple,solitary,stellate,stigma,straight,style,surface,tan,truncate,tube,unbranched,yellow	%,.3,.5,0-2.5,0-3,0.2-0.3,0.2-0.4,0.25-0.5,0.3-0.7,0.3-0.8,0.3-2,0.35-0.5,0.4-0.65,0.5-0.6,0.5-1,0.5-1.3,0.8-1.5,0.8-2.5,1,1-1.5,1-2,1-3,1-locular,1.5-2,1.5-2.5,1.5-3,1.5-4.5,1.6-2.3,13-18,14-24,15-30,2-6,2.5-4.5,3-4.5,35-50,4-,4-7,4.5-7.5,5-6,5-9,5-merou,6-8,8-16,9-16,abaxially,absen,absent,acicular,across,adaxially,adult,alyx,apart,apparen,armed,attemuate,axe,ba,basal,blade,branch,branche,capitat,confined,cylindrical,decimetre,deeply,directed,distall,distributed,dm,eaf,eed,eglandular,entire,erect,exocarp,filament,finger,flower,geminat,glabrous,gland-tipped,green,hair,half,hig,homostylous,incomplete,interpetalar,juicy,juvenile,lamina,less,linear-hastate,lobe,lobed,long,longer,lower,margin,mature,mesocarp,mid-point,midpoint,midrib,midvein,minute,moderately,nflorescence,oblique,orolla,overall,pair,part,per,perfect,placenta,pore,porrect,rachi,ray,rhizomatous,ruit,scattered,septum,sessile,shallowly,short,spaced,sparse,sparsely,stellae,stellate-pubescent,succulent,tamen,tem,thick,throughout,time,tissu,tissue,transparent,triangular,unarme,unarmed,unit,upper,vary,wide,x,ympodial	arrangement,articulation,bark,capitate,color,connation,corolla,dehiscence,diminishing,distal,foetid,foliage,form,growth,height,history,interjected,leaflet,life,na,ovary,papillae,petiolule,plant,position,pseudostipule,seed,size,spacing,stem,straightnes,terminal,texture,trichome,tuber-bearing,young
432	wfo-0001028984	success	180	110	66	114	44	0.367	-14,-3,-9,0.5-,1,1-6,1-9,1.2-4,1.5,10-20,2,2-2.5,4-30,4-6,4-7,7-14,acuminate,age,apart,apex,apical,articulated,basal,base,calyx,campanulate,chartaceous,cm,color,concave,cordate,diameter,ellipsoid-fusiform,forked,fruit,gland,greenish,lanceolate,lobe,long,minutely,mm,ovate,pale,papillose,pedicel,peduncle,petiole,purple,rarely,shrub,simple,small,stigma,style,subcoriaceous,tomentose,tree,tube,turning,two,unbranched,unknown,violet,x,yellow	-2,-2.5,-6,-65,1-,1-1.7,1-2,1-2.5,12-20,15-35,2-,2-16,2-3,2-4,20-40,3-10,3-26,3-28,3-6,4-5,4-6.3,4-foliat,5,5-10,8-15,abaxially,abruptly,absen,acute,adaxially,adpressed,aggregate,almost,also,ape,axe,blade,broad,broadly,cell,connective,densely,dilated,directed,distally,eaf,eed,eglandular,entire,equalling,especially,exceeding,fleshy,flower,glabrous,glandular-puberulent,globose,hair,laterally,leaving,lon,longer,lower,margin,moderately,narrowed,near,nflorescence,nther,obconical,obtuse,often,orolla,ovoid,pedicellar,perfect,pilo,pilose,pore,possibly,presence,present,puberulent,puberulent-pubescent,pubescent-pilo,pubescent-pilose,rachi,radiu,remnant,ripe,ruit,shorter,slightly,spaced,sparsely,stamen,stone,strongly,swelling,tal,tem,thecae,time,tip,tomento,toward,triangular,truncate,ud,unit,unknow,vary,wide,ympodial	2-10,anther,arrangement,articulation,bark,connation,corolla,dehiscence,diminishing,distal,foetid,foliage,form,fruiting,growth,height,history,inflorescence,interjected,lateral,leaf,leaflet,length,life,na,ovary,papillae,petiolule,plant,position,prickle,pseudostipule,seed,shape,size,spacing,stem,straightnes,surface,terminal,texture,trichome,tuber-bearing,young
433	wfo-0001028997	success	136	94	64	72	30	0.471	0.5-0.7,0.5-1.5,0.8-1.1,1-1.5,4-10,5-6,6-10,anther,appearing,area,attenuate,bark,base,branched,broadened,calyx,cm,conical,coriaceous,corolla,difoliate,dry,elliptic-obovate,flattened-reniform,fruiting,glabrous,globose,green,height,leaf,lobed,many,margin,minutely,mm,mustard,nearly,opposite,ovary,pale,papillose,pedicel,petiole,pitted,poricidal,revolute,shaped,shiny,shrub,stem,stigma,style,surface,tan,tear-drop,terminal,time,tip,trifoliate,tube,unknown,white,yellow,young	.5,0.5-1,1-1.2,2-2.5,2-3.5,20-50-flowered,3-4,3.3.5,4-4.5,4-angled,6-7,abaxially,acute,adaxially,anthesi,apar,apex,ba,berry,cucullate,deflexed,dia,drying,eaf,edicel,eed,elliptic,erect,exserted,filament,filiform,fragrant,free,geminat,glabrou,golden,greenish-brow,incrassate,later,lateral,lobe,lon,long,lower,main,matte,merely,middle,nflorescence,older,pair,partially,pericarp,pore,portion,quadrate,ruit,scar,spaced,specimen,strongly,styl,thick,thickened,tub,ud,unevenly,vein,widest,woody,x,ympodia	apart,arrangement,articulation,color,connation,dehiscence,diameter,foetid,foliage,form,fruit,greenish-brown,growth,history,inflorescence,length,life,midpoint,na,papillae,plant,position,prickle,seed,shape,spacing,straightnes,sympodia,texture,trichome
434	wfo-0001029003	success	207	163	127	80	36	0.614	0-6,0.3-0.5,0.5,1-10,1-2,1-3,11-32,2-6,2.5-10,2.5-7.5,3,3-20,3.5-7.5,5,5-10.5,5-12.5,7-9,9-14,abaxially,acuminate,adaxially,anther,apart,apex,articulated,axillary,base,berry,blue-violet,brownish,bud,cell,chartaceous,cm,condition,conical,connivent,corolla,covering,diameter,distal,drying,elliptic,end,flower,forked,fourth,fresh,fruit,glabrous,gradually,green,green-white,greenish,hair,hair-like,half,herb,highly,interjected,lanceolate,lateral,leaf,leaflet,lengthening,light,like,long,make,membranous,middle,minute,mm,mottled,mucilaginous,obtuse,odd-pinnate,one,orbicular,ovate,ovoid,pale,pedicel,peduncle,pentagonal,petiole,petiolule,placed,plant,pore,poricidal,prostrate,proximal,pubescent,purple,rarely,ripe,rotate,rounded,seed,sessile,size,slit,sparsely,stem,stigma,straight,style,subcapitate,subglabrous,subtending,symmetrical,tall,terminal,testal,thick,throughout,tip,toward,tube,typically,violet,wall,wet,whitish,x,yellow	0.4-3,1,1-2.5,1-5,1.2-1.9,1.2-2.5,1.5-2.3,12.2-30,13-36,3-5,4-8,5-merou,7-15.5,absent,acumen,ag,alyx,apparently,attenuate,axe,blade,capitat,ciliate,decreasing,digestion,dorsally,eaf,edge,eed,elongated,enzyme,equal,erec,especially,exceeding,filament,flat,folded,geminat,generally,glabrou,hal,homostylous,honeycomb-shaped,larger,living,lobe,lower,margin,medium,nflorescence,orolla,pair,perfect,pigmentation,plurifoliate,ray,removed,ruit,secondary,seudostipule,slightly,sometimes,spaced,specimen,stamen,ste,stolo,subequal,tamen,tem,tri-,tuber,unit,usually,vary,white,wide,wing,ympodial	age,arrangement,articulation,bark,calyx,capitate,color,connation,dehiscence,diminishing,erect,foetid,foliage,form,fruiting,growth,height,history,inflorescence,length,life,na,ovary,papillae,position,prickle,pseudostipule,shape,spacing,stolon,straightnes,surface,texture,trichome,tuber-bearing,young
435	wfo-0001029006	success	217	121	87	130	34	0.401	-+,0.4-2.5,0.5,0.5-4,1-1.5,10,2-6,5,7-8,<,>,acuminate,acute,anther,apex,area,articulated,asymmetrical,base,berry,blackish,calyx,chartaceous,cm,conical,connivent,corolla,deeply,diameter,ellipsoid,elliptic,flattened,fruiting,glabrous,globose,green,growth,inflorescence,irregularly,later,lateral,long,loosely,membranous,minutely,mm,narrowly,oblique,occasionally,often,pale,papillate,pedicel,peduncle,petiole,pinnatifid,pitted,poricidal,purple,purplish,reddish,reniform,ripe,rotate-stellate,simple,size,sleeve,small,sometimes,somewhat,spaced,stem,stigma,style,surface,tan,terminal,tip,trichome,truncate,tube,uniseriate,vine,violet,white,woody,young	.5,0.2,0.5-2,1,1-4,1-5,1.2-1.5,1.8-2.2,1/3,10-20,2-3,2.5,3.5-4,4-6,5-6,5-merou,50,7-9,abaxially,adaxial,adaxiall,ag,age,along,alyx,anthesi,apar,ark,axi,axil,basal,beyond,bilobed,black,branched,bright,broadest,c.,cell,clavat,deltate,dense,depending,drying,eaf,eed,elongate,entire,exserted,extending,filament,filiform,flower,free,groove,growing,ilament,inflated,intramarginal,irregular,keeled,lamina,leaving,lengthening,lobe,lobed,lower,many,margin,markedly,midrib,minute,nearly,new,nflorescence,nodding,obvious,older,one,orolla,pair,part,peg,pendan,pentagonal,per,perfect,pericarp,planar,plurifoliat,pore,portion,primary,puberulen,puberulent,pubescent,reaching,ruit,sagittate,scar,shiny,slit,smaller,sparsely,spreading,strong,strongly,sunligh,tem,testal,thin,time,tiny,tuft,twinin,twining,ud,unit,upper,usually,variable,variously,vary,vein,way,widest,within,x,ympodial,zig-zag	apart,arrangement,articulation,bark,color,connation,dehiscence,diminishing,distal,foetid,foliage,form,fruit,height,history,interjected,leaf,leaflet,length,life,na,ovary,papillae,petiolule,plant,position,prickle,pseudostipule,seed,shape,spacing,straightnes,texture,tuber-bearing
436	wfo-0001029021	success	161	103	70	91	33	0.435	0.8-1,0.8-2.1,1-2,1-3.4,1.1-1.3,1.5-2,1.5-3,2,3/4,acute,anther,apex,bark,base,bi-lobed,black,branching,broadly,calyx,cm,coriaceous,corolla,darker,dendritic,diameter,elliptic,flattened,fleshy,fruit,fruiting,glabrate,glabrous,globose,grey-brown,growth,lateral,lax,leaf,lenticular,lobed,long,long-triangular,loosely,minutely,mm,ovary,ovate,pedicel,petiole,pitted,plurifoliate,poricidal,pubescent,purple,reddish-brown,shiny,shrub,sparsely,stem,stigma,style,surface,terminal,tip,trichome,tube,violet,way,x,young	0.5-1,0.8-1.2,1-1.5,1-4,1.8-2,2-2.5,3,3-6,3.5,5.5-6,8-10,abaxial,abaxially,absent,adaxial,adaxially,age,along,anthesi,apical,appearing,axi,ba,basal,becoming,berry,blade,caudate,conical,deciduous,decurrent,deflexed,densely,denser,eaf,edicel,eed,ew,exserted,filament,flower,free,im.,impressed,inserted,lamina,later,lobe,loose,lower,m.,margin,monochasia,nflorescence,nodding,older,outline,overtopping,pair,papillo,per,pericarp,planar,pore,portion,prominently,raised,revolute,ruit,scar,scattered,secondary,shoot,simple,sleeve,slit-like,stamen,ste,strongly,tapering,thin,time,tiny,tub,ud,unit,vein,wide,winged,woody,ympodial	arrangement,articulation,color,connation,dehiscence,diminishing,distal,foetid,foliage,form,height,history,inflorescence,interjected,leaflet,length,life,midpoint,na,papillae,peduncle,petiolule,plant,position,prickle,pseudostipule,seed,shape,size,spacing,straightnes,texture,tuber-bearing
437	wfo-0001029031	success	213	131	97	116	34	0.455	-11.4,-12.3,-8,0-5,0.1-0.5,0.5-1.5,0.7-1.1,1-2,1-5,1-9.4,1.8-2.7,13.5,2-10.7,2-3.3,2-5,2.5-5.5,3-10,5-17,6-21,abaxially,adaxially,anther,apart,base,black,bluish,branched,calyx,capitate,chartaceous,cm,corolla,cuneate,curved,densely,diameter,elliptic,elliptic-ovate,flattened,flower,forked,fruit,glabrescent,globose,green,hair,lateral,leaf,length,like,long,longitudinal,midpoint,mm,oblong,occasionally,opening,orange,outline,pedicel,peduncle,peltate,peltate-stellate,petiole,possibly,pubescent,rarely,reniform,ripening,rounded,rugulose,sessile,short-stalked,shrub,silvery,simple,slit,small,sparsely,stellate,stem,stigma,straight,strongly,style,suborbicular,surface,tall,tree,trichome,tube,unbranched,white,whitish,x,yellow,yellowish	-3.6,.1-0.3,.5-1.2,0.5,0.5-4,0.6-1.2,1-1.5,1-2.5,1-2.6,1-3,1.3-3.3,1.5-2.8,1.5-3.5,1.8-4,1/3,10,2-3,2.5-5.6,20-150,4-5-,4-7.5,6-12,absent,accrescent,acuminate,acute,adaxiall,ag,angle,apex,apexacute,apparently,around,articulated,axe,ba,becoming,berry,bilobe,blade,brown,center,connivent,covering,cylindrical,deltate,denser,directed,distally,eaf,edge,eed,eglandula,eglandular,entire,equal,erect,farinose,filament,fleshy,frui,fruiting,fused,geminate,glabrous,held,immature,impressed,inserted,lanceolate,large,leaf-opposed,least,light,lobe,lower,major,many-foliate,margin,midvein,nearly,nflorescence,obtuse,orolla,paired,perfect,pore,porrect-stellate,prominent,pseudoterminal,pubescen,pubescence,rachi,ray,ruit,short,side,slightly,smaller,sometimes,somewhat,spaced,ste,stellate-pubescent,subtending,tamen,tem,time,tip,unarme,unit,usually,vary,vein,wide,ympodial	0.1-0.3,age,arrangement,bark,bilobed,color,connation,dehiscence,distal,foetid,foliage,form,growth,height,history,inflorescence,interjected,leaflet,life,na,ovary,papillae,perennial,plant,pseudostipule,seed,shape,size,spacing,straightnes,terminal,texture,tuber-bearing,young
438	wfo-0001029047	success	168	107	69	99	38	0.411	0.1-0.5,0.5-1,0.5-2,0.7-1,0.7-3,1-4,3-5,4-5,acuminate,acute,anther,apex,bark,base,beneath,broadly,brown,calyx,campanulate,cm,corolla,deflexed,elliptic,fruiting,glabrous,globose,green,herbarium,lateral,leaf,like,long,minutely,mm,mustard,opposite,ovary,ovate,ovoid-reniform,pale,papillose,part,pedicel,petiole,pitted,poricidal,pubescent,reddish-brown,shape,shaped,shining,shrub,slender,smooth,soft,specimen,stem,stigma,style,surface,tear-drop,tip,trichome,tube,uniseriate,white,woody,yellow,young	'',.25,.5,0-2,0.05-0.5,0.1-0.75,0.3-1.9,1,1-1.2,1.25,10-11,2.1-2.6,2.5,3.6-8.5,5-20-flowered,5-9,6-7,8365,9.5-19.6,``,across,amd,anisophyllou,anthesi,arching,aspec,ba,back,bearing,beginning,berry,branch,bud,deltoid,dia,differing,difoliate,distinctly,eaf,edicel,eed,evenly,filament,filiform,flattened,flower,free,geminate,giving,glabrou,herb,impressed,inflorescenc,kruckoff,lenticellate,lobe,lobed,lon,lower,main,major,margin,markedly,middle,midrib,minor,much-branched,nearly,nflorescence,occasionally,older,orbicular,pically,pore,portion,principal,prominent,reflexed,rounded,ruit,scar,shorter,simple,smaller,somewhat,spaced,sparsely,strongly,styl,tall,tapering,thread-like,time,ud,unit,vein,widest,x,ympodial	alternate,arrangement,articulation,color,connation,dehiscence,diameter,diminishing,distal,foetid,foliage,form,fruit,growth,height,history,inflorescence,interjected,leaflet,length,life,midpoint,na,papillae,peduncle,perennial,petiolule,plant,position,prickle,pseudostipule,seed,size,spacing,straightnes,terminal,texture,tuber-bearing
439	wfo-0001029048	success	162	101	63	99	38	0.389	.01,/3,0.5-1.7,1-2,1-8,1.5-2,3-4,3-7,acuminate,anther,apex,base,bicellular,bright,broadly,calyx,cm,conical,corolla,elliptic,filiform,fruiting,glabrous,globose,golden,green,greenish-white,greenish-yellow,hispidulous,lateral,leaf,lobed,long,matte,minute,minutely,mm,obtuse,opposite,ovary,ovoid-reniform,pale,papillose,pedicel,petiole,pitted,poricidal,shaped,shrub,small-capitate,stem,stigma,straight,style,surface,tan,tear-drop,tip,trichome,tube,uni-,way,young	.2,.5,0.5,0.5-1,0.8-1,1,11,14,2,25,26,3.5-4,4-6,5-8,8-10,9-15,angle,another,anthesi,apar,apparent,arching,attenuate,basal,bearing,becoming,beneath,berry,blade,branch,decurrent,dia,eaf,edicel,eed,elongated,except,expanded,f,filament,flower,free,geminate,glabrate,greatly,greenish-yello,hanging,incrassate,less,like,live,lobe,lower,main,margin,middle,midrib,much,nflorescence,node,non-reproductive,obovoid,older,one,pair,papillo,parallel,planar,pore,portion,puberulent,reflexed,right,ripe,rounded,ruit,scar,sharply,slender,slightly,somewhat,spaced,specimen,tall,tapering,thread-like,time,translucent,ud,unevenly,unifoliate,unit,vein,widely,widest,winged,x,ympodial,zig-zag	alternate,arrangement,articulation,bark,color,connation,dehiscence,diameter,diminishing,distal,foetid,foliage,form,fruit,growth,height,history,inflorescence,interjected,leaflet,length,life,na,papillae,peduncle,perennial,petiolule,plant,position,prickle,seed,shape,size,spacing,straightnes,terminal,texture,tuber-bearing
440	wfo-0001029053	success	275	122	86	189	36	0.313	0.2–0.6,0.5–1.1,0.7–1.2,1.5,1.5–2.7,2.4–2.8,3.5,4.9,5.4–7.1,6.6,6.8–15.2,8.0–14.5,across,acuminate,along,anther,apart,apex,apical,articulate,attachment,attenuate,bark,base,blade,borne,calyx,cm,corolla,densely,diameter,distal,dry,extra-axillary,flattened-oval,flower,fruit,glabrous,glandular-pubescent,globose,individually,interpetalar,lanceolate,lateral,length,long,markedly,mature,minute,mm,notched,oblong,orange,ovate,pedicel,peduncle,petiole,point,pore,porrect,probably,red,short,shrub,simple,smooth,spreading,stellae,stellate,stellate-pubescent,stem,stigma,straight,style,surface,tissue,tube,twice-branched,unarmed,unbranched,vein,well-developed,white,yellow,yellow-tan,young	.04,.3,.7,.9,0.1,0.2,0.3–0.4,0.3–0.7,0.4–0.8,0.5–0.6,0.6–1.3,0.7–1.0,0.7–1.1,0.7–1.3,0.7–1.7,0.7–3.4,0.8–1.0,0.8–1.2,1.0–1.6,1.1–1.3,1.3–2.0,1.4–2.0,1.5–2.5,1.6–9.2,1.7–1.8,1/2–2/3,1/3,1/3–1/2,2.0–2.3,2.0–2.8,2.1–2.4,2.1–3.8,2.4–5.1,2.5,21,3.5–7.2,4.5–6.2,5-merou,5–8,6–12,7.1–9.7,7–8,8,8.5–15.8,90°,abaxially,accrescent,acute,adaxially,adnate,aequilateral,ag,alyx,anthesi,apiculate,apparently,appearing,appressed,around,axe,ba,basal,becoming,beneath,bent,berry,branch,broad,brochidodromous,bud,capitat,caudate,channeled,clinate,coat,congested,criss-cros,deciduous,deltoid,dentate,development,difoliate,directed,distally,distinct,eaf,edge,eed,either,emerging,endocarp,entire,erect,exocarp,extending,fertile,filament,filiform,free,geminat,glandular,glossy,gradually,hair,heterostylous,increasing,intact,internode,intersepalar,juic,lacking,layer,less,lobe,lon,longer,lower,main,many,margin,midpoint,midrib,midvein,moderately,much,nearly,nflorescence,oblique,opaque,ove,overlapping,pattern,per,perforated,portion,potentially,pubescence,pubescent,raised,ray,remaining,revealing,rigid,rounded,row,ruit,seen,semisucculent,sessile,short-stipitate,shorter,side,sinus,slightly,sloughing,smoot,sometimes,soon,spaced,sparsely,splitting,spread,stamen,stipe,subopposite,suture,tamen,tem,thin,time,tip,transparent,truncate,two,ud,unit,upper,various,vary,weakly,well,wide,yellow-ferruginous,ympodial,±90°,±equal,±glabrous,×,–10	arrangement,articulation,capitate,color,connation,dehiscence,diminishing,foetid,foliage,form,fruiting,growth,height,history,inflorescence,interjected,leaf,leaflet,life,na,ovary,papillae,petiolule,plant,position,prickle,pseudostipule,seed,shape,size,spacing,straightnes,terminal,texture,trichome,tuber-bearing
441	wfo-0001029055	success	169	128	88	81	40	0.521	0.4-1.5,1-2.6,1-5,1.6-3.5,14-50,2-3,2.5-8,3-10,4-10,4-7,5.5-9,8-9,apical,apically,articulate,base,branched,calyx,cell,cm,connate,cordate,corolla,covering,cuneate,cyme,dark,dehiscent,diameter,dichasial,dichasially,distal,ebracteate,elliptical,forked,green,green-white,hair-like,herbaceous,interjected,introrse,lateral,leaf,leaflet,long,longitudional,make,maturing,mm,monochasial,mucilaginous,oblique,odd-pinnate,often,outline,ovate,ovoid,pedicel,peduncle,pentagonal,perennial,petiole,pilose,plant,poricidally,proximal,pubescent,purple,rotate,seed,short,size,slit,sometimes,stigma,straight,stripe,style,terminal,testal,thick,throughout,triangular,tuber-bearing,wall,wide,yellow,¼	1-4,1.7-2.2,1.8-3.5,2-1.,2-4,2.2-3,3,3-6,3-6-foliat,4-6,5-24,6-14,9-22,abaxially,acumen,acuminate,acute,adaxially,apex,attenuate,covered,decurrent,densely,digestion,diminishing,dorsally,eaf,edge,eed,elliptcal,emoval,enzyme,exceeding,filament,first,flat,flower,folded,generally,gland,globo,hair,half,honeycomb,living,lobe,lon,long-attenuate,longer,lower,lunat,near,nflorescence,nther,orolla,pair,pattern,perfect,plan,rarely,reveal,ruit,second,sessile,seudostipule,short-petiolate,short-stalked,specimen,spreading,stamen,tal,tem,time,toward,type,typically,unit,vary,whit,widest,ympodial	2-11,anther,arrangement,articulation,bark,color,connation,dehiscence,foetid,foliage,form,fruit,fruiting,globose,growth,height,history,inflorescence,length,life,lunate,midpoint,na,ovary,papillae,position,prickle,pseudostipule,shape,spacing,stem,straightnes,surface,texture,trichome,tube,wet,white,ye,young
442	wfo-0001029056	invalid_json_followup	140	112	56	84	56	0.4	.5,0,0.3-0.5,1/3-1/2,3-5-lobed,3-5-rayed,3-6,5-9,acute,along,annual,anther,anthesi,basally,base,blade,broadly,calyx,campanulate,capitate,cm,coarsely,dm,elongated,glabrous,hair,herb,length,linear-lanceolate,lobe,long,major,midpoint,mm,obtuse,often,ovate,petiole,pinnately,prickle,prickly,purplish,scattered,sessile,spreading,stellate,stem,strongly,subulate,surface,swollen,terminally,tube,vein,white,yellow	-5,.2,0.7-1.0,4,6-10,6-8-flowere,7-10,across,also,alyx,ample,attenuate,black,branched,cauline,central,consisting,densely,dentate,developing,dia,difoliate,divided,eaf,eed,erect,externall,externally,flanking,geminat,gland,glandular,green,intermixed,internod,invested,irregularly,know,known,lacking,large,lon,lower,marking,much,nflorescence,numerous,occasional,one,orolla,present,ray,reduced,ruit,separated,sharply,short-stipitate,shorte,side,simple,slende,slender,somewhat,sparse,starlike,stellae,stellate-pubescent,strait,tall,tamen,taprooted,terete,tightly,tigma,tip,tub,tyle,uniseriate,unit,upturned,vary,vestiture,villous,ympodial	'',3-5,[,``,apex,arrangement,articulation,bark,characteristic,color,connation,corolla,dehiscence,diam,diameter,diminishing,distal,foetid,foliage,form,fruit,fruiting,growth,height,history,inflorescence,interjected,internoda,lateral,leaf,leaflet,life,na,ovary,papillae,pedicel,peduncle,petiolule,plant,position,pseudostipule,seed,shape,size,spacing,stigma,straightnes,style,terminal,texture,trichome,tuber-bearing,value,young,{,}
443	wfo-0001029059	success	199	107	81	118	26	0.407	0.2,1-3,1-4,1-6,1.2-3,1.3-1.7,7-9,acute,along,anther,anthesi,bark,base,berry,calyx,clavate,cm,connivent,corolla,deep,densely,difoliate,dirty,elliptic,extremely,flattened-reniform,foetid,geminate,glabrous,globose,hispidulous,inflorescence,lateral,leaf,lobed,long,minute,minutely,mm,nearly,occasionally,orange,orangish-yellow,ovary,pale,papillose,pedicel,petiole,pitted,poricidal,pubescence,purplish,ripe,shape,shrub,simple,size,small,stem,stigma,straight,style,surface,terminal,tightly,tinge,tip,tree,trichome,tube,underside,unicellular,uniseriate,usually,variable,vein,waxy,white,yellowish-green,yellowish-tan,young	.5,0.1-0.5,0.1-1,0.2-0.5,0.5,0.5-1,1-1.2,1-1.5,1.5-2,1.5-2.8,10-19,2.5,3-3.5,3-6.5,3.5-6,3.5-8,4-10.5,5,5-15-flowered,6-10,anisophyllou,apar,ape,apex,apiculae,apiculate,arising,beneath,bout,branched,bud,closely,coiba,cordate,covered,cuneate,de,deflexed,deltoid,dense,dia,differing,eaf,edicel,eed,ellipsoid,expanded,exserted,extending,filament,free,fruiting,glabrate,greatly,impressed,incrassate,interpetalar,isla,lamina,lobe,lon,longest,lower,main,major,margin,member,membranous,middle,minor,narrowly,nflorescence,oblique,often,older,one,opposite,orbiculate,pair,paler,panama,papillo,partially,planar,pointed,population,pore,portion,prominent,pubescent,reddish-gre,rest,rounded,ruit,scar,shallowly,shaped,sinus,slender,somewhat,soon,spaced,sparse,specimen,tall,tapering,tear-drop,thickened,ti,triangular,ud,unit,wide,widest,woody,x,yellowish,ympodial	anisophyllous,apart,arrangement,color,connation,dehiscence,diameter,form,fruit,growth,height,history,interjected,leaflet,length,life,na,papillae,peduncle,plant,pseudostipule,reddish-grey,seed,spacing,straightnes,texture
444	wfo-0001029065	success	202	114	82	120	32	0.406	0.5-1.5,0.5-4,1-5,10-20,2-3,2-4,3-7,5-10,5-15,7-10,8,8-12,accrescent,anther,apical,asymmetrical,attenuate,base,brown,calyx,chartaceous,cm,connivent,contiguous,cylindrical,densely,diameter,directed,extra-axillary,flower,fruit,fruiting,functionally,globose,green,hermaphroditic,immature,leaf,like,lobed,male,many,mature,midpoint,mm,moderately,nearly,netlike,obtuse,often,orange,ovate,pedicel,peduncle,petiole,pit,plant,porrect-stellate,prickle,pubescent,raised,red,reniform,ridge,roselike,separated,simple,slightly,small,spaced,stem,stigma,style,surface,tapering,unbranched,vine,white,woody,x,yellow,young	0.2-0.4,0.5,0.5-1,0.5-1mm,1,1-2,1-2.5,1-3,1-6,1.,1.5-2,1.5-2.5,1.5-3,1/3,2,2-15,2-2.5,2-5,2-ranke,3-6,30-60,4-7,4-8,5,5-7,8-20,abaxial,abaxially,absent,acute,adaxial,adaxiall,adaxially,alyx,andromonoecious,apar,apex,armed,axe,berry,beyond,blade,charteacous,cordate,cut,dark,difoliate,discolorous,eaf,eed,either,em,exserted,filament,flattened,frui,geminate,generally,glabrou,glabrous,glandular,gree,green-brown,hair,heteromorphic,introsel,leathery,less,light,lobe,long,long-styeld,lower,m.,major,margin,merou,midrib,midvein,multicellular,multiseriate,narrowly,nflorescence,older,orolla,ovary,pair,per,pore,rachi,ray,recurved,ruit,sessile,short-styled,side,sinus,sparsely,stalk,stamen,staminate,stellate,straight,strongly,tamen,triangular,tube,unarmed,unequa,unicellular,uniseriate,unit,unlobed,usually,vary,vein,way,wide,ympodial,¼	0-2,10,apart,arrangement,articulation,color,corolla,dehiscence,foetid,foliage,form,growth,height,history,inflorescence,interjected,introsely,lateral,leaflet,length,life,na,position,pseudostipule,recurrved,seed,shape,size,spacing,terminal,texture,trichome
445	wfo-0001029072	success	235	97	65	170	32	0.277	0.5-2,0.8-1.5,1-1.2,1-25,2-7,2-8,3-10,3-8,7-15,anther,apex,articulated,bark,base,bright,calyx,cm,connivent,cordate,cuneate,curved,diameter,distal,dull,flattened-reniform,fruit,fruiting,gently,herb,lateral,leaf,length,lobed,mauve,midpoint,mm,orange-brown,ovate,pedicel,peduncle,petiole,plant,poricidal,porrect,prickle,reflexed,sessile,shrub,simple,sometimes,spherical,stalked,stellate-pubescent,stem,straight,style,surface,tapering,terminal,tip,trichome,tube,white,yellow,young	-1/2,-15,-2.5,.5,/6,0,0-2,0-20,0-4,0-8,0.1-0.4,0.2-0.3,0.2-0.4,0.3,0.4-0.9,0.5-3,0.7,0.8,00-200,1,1-1.5,1-3,1.5-2.5,1.5-2.6,1.5-3.2,1/3,1/4-1/2,1/4-1/3,12-19,2-10,2-5,2.2-2.5,2.2-3.2,2.5-3.5,2.5-3.8,2.5-4.5,20-50,3-20,3-5,3-50,3.5-6,3/,4-,4-10,4.2-6.5,4.5-9,5-10,5-50,5-7,5-9,5-merous,7-10,8-20,8-27,abaxial,abaxially,acute,adaxial,adaxially,alyx,ame,andromonoecious,angled,apar,apart,apically,apparently,berry,blade,branched,broad-deltate,broadly,c.,chartaceous,clearly,conical,cream,dark,deltate,densely,dirty,discolorous,distance,drying,eaf,eed,elongated,elongating,equal,erect,extending,filament,flattened,flower,free,glabrous,gra,green,green-brown,hermaphrodite,heterostylous,infructescence,least,lobe,long,long-styled,longer,longitudinal,lower,lowermost,margin,marking,mature,maturity,midvein,moderately,multangulate,narrow-deltate,nflorescence,obtu,older,one,open,orolla,oung,pair,pale,pendent,pendulous,per,pericarp,plurifoliat,portion,prickl,prickly,primary,raised,ray,ridge,rounded,ruit,scar,short-styled,side,smooth,spaced,sparsely,spreading,stalk,staminat,stellate,stout,strongly,tamen,tertiary,time,unarmed,unit,upper,variously,vary,vein,venation,visible,way,weakly,whitish,wide,woody,ympodial	arrangement,articulation,color,connation,corolla,dehiscence,diminishing,foetid,foliage,form,gray,growth,height,history,inflorescence,interjected,leaflet,life,na,ovary,papillae,petiolule,position,pseudostipule,seed,shape,size,spacing,stigma,straightnes,texture,tuber-bearing
446	wfo-0001029073	success	211	111	78	133	33	0.37	0.3-1,0.6-2,1-1.5,1-3,10-16,2,2-3,2-4,4-5,acuminate,acute,anther,apart,apex,armed,articulated,bark,base,berry,broad-based,brown,calyx,chartaceous,cm,corolla,dark,darker,densely,diameter,dimorphic,elliptic,flattened,fruiting,globose,growth,inflorescence,internodal,lanceolate,leaf,length,lobed,long,maturity,minutely,mm,narrowly,occasionally,opposite,orange,pale,papillose,pedicel,peduncle,petiole,poricidal,porrect,prickle,pubescent,purple,reniform,reticulate,sessile,short-stalked,shrub,simple,splitting,stellate,stem,stigma,straight,style,surface,tan,trichome,truncate,tube,unequally,yellowish	.5,.7,0.5,0.5-1,0.6-0.7,1-1.2,1-2.5,1.1-1.5,1.2-1.6,1.5-2,10-15,2/3,3.5-9,4-6,5-6,5-8,5-merous,6-9,7-10,8-14,abaxially,adaxially,along,another,anthesi,away,awn-like,ba,basal,beneath,cell,conical,cream,curved,dense,difoliate,discolorous,drying,eaf,eed,enlarged,entire,equal,erect,except,exserted,filament,flower,four,free,frui,geminat,glabrous,golden,gre,hooked,interpetalar,lamina,lengthening,like,linear,lobe,long-styled,lower,margin,midpoint,midvein,mixture,multangulate,new,nflorescence,nodding,oblique,older,one,pair,paler,per,perfect,pericarp,planar,plurifoliate,pore,portion,prickly,primary,pubescence,ray,rectangular,ruit,scar,shallowly,shiny,short,shorter,sinuate,slightly,slit,sometimes,somewhat,spaced,sparsely,strongly,styled,tapering,testal,thin,three,ti,tip,tissue,triangular,two,ud,unarmed,underside,unequal,unisexual,unit,upper,upward,vein,visible,wall,way,whitish,wide,woody,x,yellow,ympodial,zygomorphic,½	arrangement,articulation,color,connation,dehiscence,diminishing,distal,foetid,foliage,form,fruit,grey,height,history,lateral,leaflet,life,na,ovary,papillae,petiolule,plant,position,pseudostipule,seed,shape,size,spacing,straightnes,terminal,texture,tuber-bearing,young
447	wfo-0001029074	success	174	107	70	104	37	0.402	0.2-1,0.3-0.8,0.5-1,0.5-1.2,0.7-0.8,1-1.5,1-2,acute,anther,apart,apex,articulation,bark,base,berry,black,broadly,calyx,capitate,cm,corolla,cuneate,densely,diameter,expanding,flattened,fruiting,glabrous,globose,green,grey,growth,herb,immature,internodal,leaf,less,lignescent,minutely,mm,opposite,ovary,ovate,pedicel,peduncle,petiole,pitted,poricidal,pubescent,purplish,reniform,ripening,rounded,sagittate,simple,sparsely,stellate,stem,stigma,style,subshrub,surface,tip,trichome,truncate,tube,uniformly,white,yellow,yellowish	.1,.5,0,0.3-0.4,0.7-0.95,1,1-,1-1.2,1.4-1.8,1.5-2,1.5-4,11,2-2.3,2-4,2-5,2-7,3-,3-6,3.5-5,5-6,5-7,abaxially,absent,adaxially,age,almost,along,anthesi,apparently,appearing,basa,conical,deflexed,denser,eaf,eed,ellipsoid,entire,exerted,filament,flower,free,frui,glabrescen,lacking,lengthening,like,lobe,lobed,longest,lower,margin,markedly,midpoint,midvein,mixture,new,nflorescence,obscuring,often,older,pair,pale,papillat,per,perfect,pericarp,petal,planar,plurifoliat,pore,portion,primary,prominent,pulp,ray,reflexed,ruit,scar,scattered,sessile,slit,small,somewhat,stalk,stalked,stellate-pubescent,strongly,swollen,thin,triangular,tub,ud,underside,uniseriate,unit,usually,vein,watery,way,woody,x,ympodial,¾	arrangement,basal,color,connation,dehiscence,diminishing,distal,foetid,foliage,form,fruit,glabrescent,height,history,inflorescence,interjected,lateral,leaflet,length,life,na,papillae,papillate,petiolule,plant,position,prickle,pseudostipule,seed,shape,size,spacing,straightnes,terminal,texture,tuber-bearing,young
448	wfo-0001029075	success	217	118	91	126	27	0.419	0-3,0-8,0.8-1.2,0.8-1.5,1-10,1-2,1-2.5,10-20,2-4,2-5,2.7-4.2,30-60,4-7,5-10,5-8.5,6-12,7-9,8-9,abaxially,adaxially,anther,apex,attenuate-acuminate,base,berry,brownish,canescent,cm,condition,connivent,corolla,cuneate,dark,densely,diameter,distal,dot,drying,elliptic-lanceolate,flecked,forked,fresh,fruit,glabrescent,glandular-puberulent,green,greenish,hair,herb,honeycomb-shaped,interjected,lanceolate,lateral,leaf,leaflet,lengthening,like,mm,narrowly,odd-pinnate,ovoid,pedicel,peduncle,pentagonal,petiole,petiolule,plant,pointed,pore,poricidal,pubescent,rounded,seed,short,size,slit,small,stem,stigma,straight,style,subobtuse,substellate,terminal,tip,tube,white,whitish,x,yellow,yellowish-white	.3,.5,0.5-0.8,1-3,2.5-3,4-10,4-14,4-5,4.5-6.5,5-8,5-merou,7-17,abruptly,acumen,ag,along,alyx,apart,apparently,articulated,atypically,axe,axillary,blade,broadly,brown,bud,cell,ciliate,clavifor,covering,decreasing,decurrent,digestion,dorsally,eaf,edge,eed,end,enzyme,erect,erect-ascendin,especially,etota,exceeding,filament,flat,flower,folded,geminat,generally,glabrou,glabrous,glandular-pilose,gradually,gray-green,greatly,green-white,hair-like,half,homostylous,larger,light,living,lobe,long,long-spatulate,lower,make,margin,middl,midrib,minutely,mucilaginous,narrowed,nflorescence,orbicular,orne,orolla,ovate,pair,perfect,petal,petiolulate,plurifoliate,puberulent,purple,rachi,removed,ruit,sec,sessile,seudostipule,singly,slightly,sometimes,spaced,specimen,stamen,ste,stolo,subequal,subquadrate,subtending,tall,tamen,tem,testal,thick,throughout,toward,tri-,tuber,typically,unit,unwinged,upper,usually,vary,wall,wet,whitish-gray,wide,woody,yellow-green,ympodial	age,arrangement,bark,calyx,claviform,color,connation,dehiscence,diminishing,form,growth,height,history,inflorescence,length,life,na,ovary,papillae,pseudostipule,shape,spacing,straightnes,surface,texture,tuber-bearing,ye
449	wfo-0001029084	success	192	116	80	112	36	0.417	1-10,1-2,1-4,1.5-2.5,10-50,2-3.5,3-6,3.5-7.5,3.5-8,4.5-6.5,5,5-7,7-9,8-23,absent,acuminate,anther,apex,axillary,base,berry,brownish,bud,chartaceous,cm,condition,conical,connivent,corolla,diameter,drying,forked,fresh,fruit,glabrous,green,greenish,herb,interjected,lanceolate,lateral,leaf,leaflet,light,lilac,middle,minute,mm,moniliform,mottled,mucilaginous,obtuse,odd-pinnate,ovate-lanceolate,ovoid,pedicel,peduncle,petiole,plant,poricidal,proximal,pubescent,purple,ripe,rotate,seed,size,sparsely,stigma,style,subglabrous,subtending,terminal,tip,tube,typically,wet,whitish,x,yellow	.5,0.8-2,0.8-2.1,1-3,1.1-2.2,2-4,2-5,4-17,4-7,4.5-10,5-merou,6-13,abaxially,acumen,adaxially,ag,along,alyx,apart,apparently,arranged,articulated,axe,bead,blade,capitat,cell,ciliate,covering,darker,decreasing,digestion,distal,dorsally,eaf,edge,eed,enzyme,especially,exceeding,filament,flat,flower,folded,geminat,generally,glabrou,gradually,green-white,hair-like,half,homostylous,honeycomb-shaped,interpetalar,larger,lengthening,like,living,lobe,lon,long,lower,make,margin,midrib,minutely,multiple,narrow,necklace,nflorescence,orolla,pair,perfect,petiolule,pilose,plurifoliate,pore,puberulent,ray,removed,ruit,secondary,semierec,seudostipule,slit,spaced,specimen,stamen,stolon,subequal,subglabrou,subsessile,symmetrical,tall,tamen,tem,testal,thick,thir,throughout,tissue,toward,tri-,tuber,unit,unwinged,usually,vary,wall,wide,wing,ympodial	arrangement,articulation,bark,calyx,capitate,color,connation,dehiscence,foetid,foliage,form,fruiting,growth,height,history,inflorescence,length,life,midpoint,na,ovary,papillae,position,prickle,pseudostipule,semierect,shape,spacing,stem,straightnes,surface,texture,third,trichome,tuber-bearing,young
450	wfo-0001029087	success	226	98	62	164	36	0.274	0-0.5,0-14,0.3-0.8,0.5-2.3,0.7-2.2,11-20,2-7,2.5-4,5-15,6-7,8-12,accrescent,acute,anther,apex,articulated,base,calyx,chartaceous,cm,dark,diameter,extra-axillary,finely,flattened,fruit,fruiting,globose,green,herbaceous,inflorescence,lanceolate,lateral,leaf,length,long,midpoint,mm,obtuse,ovate,pale,pedicel,peduncle,petiole,plant,prickle,pseudo-racemose,purple,resprouter,reticulate,rhizomatous,rotate,rotate-stellate,simple,slightly,stigma,streak,style,surface,tube,white,yellow	%,.05,.5,0-0.1,0-2,0-6,0-7,0.1-2,0.2-0.6,0.25-0.4,0.3-0.4,0.3-0.45,0.3-0.5,0.35-0.45,0.5-0.75,0.5-1,0.7-0.9,0.9-1.7,0.9-8,1-1.5,1-3,1-3.5,1-4,1-6,1.3-1.6,1.4-1.7,1.5-1.75,10-30,16-20,2-,2-3,2-locular,2.7-2.9,3,3-5,3-7,3-8,3-foliate,3.5-5.5,4.5-8,4.5-8.5,5-merou,6-8,6.5-13,7-10.5,7-8,7-9,8-20,8-30,8-9,9-15,abaxially,absen,absent,acicular,across,adaxially,adult,alyx,ample,andromonoecious,anvil-shape,apart,attenuate,axe,ba,blade,branchlet,broadly,capitat,connivent,cross-section,cylindrical,deeply,deltate,densely,directed,distall,distributed,dm,eaf,eed,eglandular,entire,erect,exocarp,filament,finger,flower,functional,geminat,glabrous,gland-tipped,grey,grey-green,hair,half,heterostylous,interpetalar,juicy,juvenile,lamina,less,lobe,lobed,longer,lower,margin,mature,mesocarp,mid-point,midvein,minute,moderately,moist,narrowly,nflorescence,oblique,orolla,pair,part,pendent,per,placenta,pore,porrect,present,proximal,rachi,ray,ruit,rusty,sessile,shallowly,short,spaced,sparsely,stalk,stalked,stellae,stellate,stellate-pubescent,straight,tal,tamen,tem,thick,throughout,time,tissu,tissue,transparent,triangular,unarme,unarmed,unbranched,unit,upper,vary,weakly,wide,x,yellowish,ympodial	arrangement,articulation,bark,capitate,color,connation,corolla,dehiscence,diminishing,distal,foetid,foliage,form,growth,height,history,interjected,leaflet,life,na,ovary,papillae,petiolule,position,pseudostipule,seed,shape,size,spacing,stem,straightnes,terminal,texture,trichome,tuber-bearing,young
451	wfo-0001029088	success	149	125	98	51	27	0.658	.3,0.1,0.9–1.5,1.3–4.5,1.5–2,15–25,1–1.6,2.5–20,2.5–4.2,25–30,2–2.5,3–16,4–8,5,5-merous,5–8,<,abaxially,acuminate,adaxially,anther,apex,base,bronze-brown,calyx,capitate,cm,cordate,cylindrical,densely,diameter,entire,extra-axillary,flattened,flavor,fleshy,flower,fragrant,fruit,glabrous,greenish-brown,hair,half,heavy,herbaceous,immature,juicy,leaf,lenticular,light,lower,margin,mature,membranous,minutely,mm,moderately,near,obtuse,ovoid-rhomboid,palmate,papillose,pedicel,peduncle,petiole,primary,pubescent,purplish,rachi,reddish-brown,revolute,rounded,rugose,sand-punctate,scent,shortly,simple,slender,slightly,somewhat,sparsely,stellate,stigma,stout,straight,strongly,style,surface,sweet,tip,tube,unbranched,vein,venation,vine,white,x,–7	.2,0.6–3.2,1.5–3,1–1.2,1–1.5,1–3,2-lobe,2–3,3.5–7,3.5–8,6-10,accrescent,acute,alyx,apar,apicall,axe,berry,blade,c.,ciliate,climbing,eaf,eed,emarginate,filament,fruiting,glabrou,groun,lanceolate,lobe,long,m.,narrowly,nflorescence,nternode,orolla,perfec,plurifoliat,ruit,spaced,swee,tamen,tem,terrestrial,truncate,truncate-acuminat,unit,vary,wider,ympodial	2-lobed,apart,arrangement,color,corolla,dehiscence,form,fragrance,ground,growth,height,history,inflorescence,internode,juicines,length,life,na,perfect,plant,plurifoliate,seed,shape,spacing,stem,texture,type
452	wfo-0001029089	success	177	106	69	108	37	0.39	.5,0.8-1,1-1.5,1.5-2,1.5-6,5-9,6-7,acute,anther,apart,apex,bark,base,beneath,bilobed,calyx,campanulate,cm,corolla,dark,deflexed,densely,drying,elliptic,flattened-reniform,fruiting,furcate,glabrous,globose,golden,green,lateral,leaf,minutely,mm,occasionally,opposite,ovary,papillose,pedicel,persistent,petiole,pitted,poricidal,pubescent,purplish,reddish-grey,rounded,shaped,shiny,shrub,simple,size,small,smooth,somewhat,stem,stigma,straight,style,surface,tan,tear-drop,tip,tree,trichome,tube,white,young	.75,/4,0.1-0.25,0.5-0.6,0.5-1,0.8-1.2,1,1/2,10-25,2.5-3.5,4.5-5,5-10,5-20-flowered,5-6,8-9,abrupt,along,anthesi,apiculate,axil,ba,beginning,berry,branched,bud,caniculate,closely,completely,covered,covering,cracking,decurrent,dia,differing,difoliate,eaf,edicel,eed,either,enclosed,entire,erect,expand,exserted,filament,free,geminat,glabrou,impressed,incrassate,inflorescenc,lamina,later,like,lobe,lobed,lon,long,lower,main,major,margin,material,member,middle,minor,nflorescence,obovoid,older,one,otherwise,overlapping,pair,papillo,part,peeling,pinkish,planar,pore,portion,primary,prominent,resinou,resinous,rounded-deltoid,ruit,scar,secretion,slightly,spaced,still,tall,tapering,tub,ud,underside,uniseriate,unit,usually,varnish,varnished,vein,way,widening,widest,woody,x,ympodial	0.75,alternate,arrangement,articulation,color,connation,dehiscence,diameter,diminishing,distal,foetid,foliage,form,fruit,growth,height,history,inflorescence,interjected,leaflet,length,life,na,papillae,peduncle,petiolule,plant,position,prickle,pseudostipule,seed,shape,spacing,straightnes,terminal,texture,tuber-bearing
453	wfo-0001029091	success	212	119	78	134	41	0.368	-1,-15,-4,0.3-,0.5-0.8,0.5-1,1-10,1-2,1.5-,10,2-12,2-3,3-,3-4,5-7,7-8,acuminate,anther,apex,articulation,base,broadly,buff,calyx,capitate,cm,corolla,cuneate,cyme,discoidal,elliptic,flushed,fruiting,globular,grey,intense,irregular,irregularly,larger,lateral,leaf,light,linear-lanceolate,long,long-triangular,minutely,mm,oblong,obovate,ochre-yellow,ovate,overlain,ovoid,pale,pattern,pedicel,peduncle,pentagonal,petiole,poricidal,pubescent,reddish-purple,reticulate-concentric,ridge,ridged,shrub,slightly,speckled,stellate-rotate,stem,stigma,style,subulate,surface,tip,transverse,violet-purple,x	-4.5,1,1.5-2,10-20,10-toothed,15-40,170-210,2-2.5,2.5-,20-30,3,3-11-lobed,4,46/1,5,635/1,acute,age,appearing,aromatic,articulated,aspect,axil,ba,becoming,berry,blunt,bluntly,brownish,campanulate,cell,clonal,close,colour,common,conspicuous,cut,dark,deeply,develop,developed,dia,downward,eed,effect,ellipsoid,emarginated,erect,exceeding,exerted,filament,flattened,floral,flower,fork,forked,fresh,general,giving,glandular,globose,gree,growing,hair,half,interacuminal,juvenile,lacking,lasting,later,lavende,lavender,lengthening,line,linear,lobe,lower,may,mid-vein,mineral,narrowly,nflorescence,obscure,occasionally,ower,pedicellate,petiol,petiolate,plurifoliat,point,pore,rachi,raised,readily,relatively,rh,ripe,rounded,ruit,scarcely,separate,several,shallowly,shed,shortly,sigmoid,simple,sinus,slender,slit,soft,soft-wooded,soon,sparsely,stone,straggly,succulent,swollen,tall,tissue,toward,triangular,tub,ud,unit,upper,usually,violet,well,winged,without,woody,year,ympodial	arrangement,bark,color,connation,dehiscence,diameter,diminishing,distal,foetid,foliage,form,fruit,growth,height,history,inflorescence,interjected,leaflet,length,life,na,ovary,papillae,perennial,petiolule,plant,plurifoliate,position,prickle,pseudostipule,seed,shape,size,spacing,straightnes,terminal,texture,trichome,tube,tuber-bearing,young
454	wfo-0001029101	success	233	128	96	137	32	0.412	.5,/3,0-2,0.4-1.5,0.5-1,1-3,1-8,1.3-2,10-14,2.5-6,3-7,5-20,5.5-8,8-15,abaxial,adaxial,almost,anther,apart,apex,apparently,articulated,bark,base,berry,calyx,cell,chartaceous,cm,concolorous,connivent,cream,cuneate,dark,darker,diameter,discolorous,drying,dull,elliptic,elongating,flattened-reniform,fruit,fruiting,glabrescent,green,lateral,leaf,length,lobed,long,long-styled,margin,marking,maturity,mauve,mm,obovate,obtuse,orange-brown,outline,ovate,pale,pedicel,peduncle,petiole,pit,plant,poricidal,porrect,prickle,raised,rounded,sessile,short-styled,shrub,simple,small,smooth,sometimes,sparsely,spherical,stalked,stellate-pubescent,stem,straight,style,surface,tapering,tip,trichome,tube,variously,way,yellow,young	-15,-3,/4,0-100,0-20,0-5,0-8,0.1,0.1-0.4,0.1-0.5,0.1-0.7,0.1-1,0.2,0.7-,0.8-3.5,00-200,1,1-1.5,1-4,1.3-2.6,1.4-2.2,1.5-2,1.5-2.5,1.7,1.8-3,1/5-1/4,10-20,2-,2-20,2-6,2.5-3.5,2.8-3.3,2/3-3/4,3-,3-10,3-4,30-100,4-12,4-7,5-,5-6,5-7,5-8,5-9,5-merous,6-8,7-13,abaxially,acute,always,alyx,andromonoecious,apar,apically,blade,branched,broad-deltate,brown-green,deltate,distal,distance,eaf,eed,equal,erect,extending,filament,flattened,flower,free,glabrous,green-brow,hermaphrodite,heterostylous,infructescence,lengt,like,lobe,lon,longer,lower,lowermost,mature,midpoint,midvein,moderately,multangulate,narrow-deltate,nflorescence,oblong,often,older,one,open,orolla,oung,pair,pendulous,per,pericarp,plurifoliat,portion,present,prickl,prickly,primary,rarely,ray,reduced,reflexed,rounde,ruit,scar,secondary,side,spaced,spreading,stalk,staminat,stellate,suborbicular,tamen,terete,tertiary,thick,time,unit,vary,vein,venation,visible,well-developed,wide,woody,yellow-green,yellow-orange,ympodial	arrangement,articulation,color,connation,corolla,dehiscence,foetid,foliage,form,green-brown,growth,height,history,inflorescence,interjected,leaflet,life,na,ovary,papillae,perennial,position,pseudostipule,seed,shape,size,spacing,stigma,straightnes,terminal,texture,tuber-bearing
455	wfo-0001029106	success	200	122	88	112	34	0.44	.1,/3,0-2,0-6,0.2-1,0.25-0.7,0.5-0.9,1.5-1.8,2-5.5,2-6,2-8,3-4,4-6,anther,apart,apex,apparently,articulated,bark,base,berry,calyx,cell,cm,concolorous,cuneate,diameter,discolorous,drying,elliptic,elongating,flattened-reniform,fruit,fruiting,glabrescent,lateral,leaf,length,light,lobed,long,longer,maturity,mauve,membranous,midpoint,mm,obtuse,orange,orange-brown,outline,ovate,pale,pedicel,peduncle,petiole,pit,poricidal,porrect,prickle,raised,red,rounded,scandent,sessile,shiny,shrub,simple,size,small,smooth,spherical,spreading,stalked,stem,style,surface,tapering,time,tip,trichome,tube,variously,way,weakly,white,wide,yellow-orange	-6,.5,0,0-0.3,0-10,0-20,0-5,0.1,0.2-0.4,0.5,0.5-0.8,0.5-1,0.5-2.5,0.9-1.2,1-1.6,1-2,1-5,1.5-2,1.5-3.5,1/4,1/5-1/4,2-3.5,2-4,2.2-3,2/,3-25,3-3.5,4-8,5-14,5-8,5-merous,6-8,abaxially,acuminat,acute,alyx,ame,apar,apically,appearing,blade,branched,c.,curved,deltate,densely,distance,eaf,eed,equal,erect,extending,eye,filament,flattened,flower,free,gently,glabrous,infructescence,lobe,lon,lower,margin,mature,midvein,naked,nflorescence,older,one,open,orange-brow,orbicular,orolla,oung,pair,pendulous,per,perfec,pericarp,plurifoliat,portion,prickl,prickly,primary,ray,reflexed,scar,shallow,shorter,side,slender,sometimes,spaced,sparsely,stalk,stellate,stellate-pubescent,straight,subentire,tamen,terete,tertiary,uit,unit,vary,vein,venation,visible,woody,yellowish-green,ympodial	arrangement,articulation,color,connation,corolla,dehiscence,diminishing,distal,foetid,foliage,form,growth,height,history,inflorescence,interjected,leaflet,life,na,ovary,papillae,petiolule,plant,position,pseudostipule,seed,shape,spacing,stigma,straightnes,terminal,texture,tuber-bearing,young
456	wfo-0001029112	success	190	116	80	110	36	0.421	1-10,1-2,1.5-1.8,1.5-2,10-21,2-3.5,2.5-4.5,2.7-3.5,2.7-4.2,2.7-5.7,20,3-6,3-7,3.5-7,5,anther,articulated,axillary,base,berry,brownish,bud,chartaceous,cm,condition,conical,connivent,corolla,densely,diameter,distal,drying,elliptic-lanceolate,forked,fresh,fruit,green,greenish,herb,interjected,lanceolate,lateral,leaf,leaflet,light,middle,minute,mm,moniliform,mottled,mucilaginous,obtuse,odd-pinnate,ovate,ovoid,pale,pedicel,peduncle,petiole,plant,poricidal,present,pubescent,purple,ripe,rotate,seed,size,stigma,style,subtending,terminal,tip,tube,typically,violet,wet,whitish,x,yellow	0-2,0.5,0.9-1.7,1-3,1-4,1.4-2.5,10-17,2.6-3,3-4,3-5,3.5-4.5,5-8,5-merou,6.5-5.5,9.5-13,abaxially,acumen,acuminate,adaxially,ag,along,alyx,apart,apex,apparently,arranged,axe,bead,blade,capitat,cell,ciliate,covering,decreasing,digestion,dorsally,eaf,edge,eed,enzyme,equal,especially,exceeding,filament,flat,flower,folded,geminat,generally,glabrou,glabrous,gradually,green-white,hair,hair-like,half,homostylous,honeycomb-shaped,larger,lengthening,like,living,lobe,long,lower,make,margin,multiple,narrow,necklace,nflorescence,orolla,pair,perfect,petiolule,plurifoliate,pore,pubescen,ray,removed,ruit,secondary,semierec,seudostipule,slightly,slit,spaced,specimen,stamen,ste,stolon,subequal,symmetrical,tall,tamen,tem,testal,thick,thir,throughout,toward,tri-,tuber,unit,usually,vary,wall,wide,wing,ympodial	arrangement,articulation,bark,calyx,capitate,color,connation,dehiscence,foetid,foliage,form,fruiting,growth,height,history,inflorescence,length,life,midpoint,na,ovary,papillae,position,prickle,pseudostipule,semierect,shape,spacing,stem,straightnes,surface,texture,third,trichome,tuber-bearing,young
457	wfo-0001029120	success	168	93	55	113	38	0.327	0.1-0.5,0.7-1,1-1.5,1.1-1.5,6-8,acuminate,acute,anther,apart,apex,bark,base,beneath,calyx,cm,corolla,dark,deflexed,golden,greenish-brown,internodal,lateral,leaf,lobed,long,long-triangular,mm,narrowly,nearly,opposite,ovary,ovate,paler,pedicel,peduncle,petiole,poricidal,pubescent,shrub,simple,sparsely,stem,stigma,straight,style,surface,terminal,tip,trichome,tube,unifoliate,uniseriate,vein,white,young	.05,.5,.75,/2,0.5-1.5,1.1-2,2.5-3.5,2.6-7,3-3.5,5-10-flowered,5-8,6.5-16.5,8511,abrupt,anthesi,basal,beginning,black,bud,bullate,cell,decurrent,densely,dia,difoliate,dry,drying,eaf,edicel,eed,epidermi,erose,especially,evenly,f,fide,filament,fleshy,free,geminat,glabrous,globose,hirsute,inflorescenc,infloresence,know,known,lanceolate,large,larger,later,lehmann,like,lobe,lon,lower,main,margin,middle,midrib,minor,minutely,narrow,narrower,nflorescence,occasionally,often,older,outer,pair,pale,papillose,peduncl,petaloid,point,pore,portion,present,prominently,proximal,raised,reproductive,rest,ruit,scar,scattered,shaped,slender,slightly,spaced,specimen,speckle,sympodial,tall,tapering,tear-drop,thickened,tub,ud,unbranched,unit,upper,urceolate,venation,way,white-papillo,wide,widening,widest,x,yellow,yellow-green,ympodial	arrangement,articulation,color,connation,decument,dehiscence,diameter,diminishing,distal,foetid,foliage,form,fruit,fruiting,growth,height,history,inflorescence,interjected,leaflet,length,life,midpoint,na,papillae,perennial,petiolule,plant,position,prickle,pseudostipule,seed,shape,size,spacing,straightnes,texture,tuber-bearing
458	wfo-0001029121	invalid_json_followup	161	146	100	61	46	0.621	0,0.2-2,1-5,1.2-2.5,1.2-3.3,10,15-30,2-10,2-13,2-3,2-3-celled,3.6-9,3.8-11,4-10,4.5-10.0,5-8,acuminate,acute,apex,apical,apically,articulate,base,blue,branched,calyx,cell,cm,conical,connate,corolla,covering,cuneate,cyme,deep,dehiscent,diameter,dichasial,dichasially,diminishing,distal,ebracteate,elliptical,forked,generally,glabrous,gradually,green,green-white,hair,half,herbaceous,interjected,introrse,lateral,leaf,leaflet,long,maturing,medium,mm,monochasial,narrowly,oblique,obtuse,odd-pinnate,often,ovate,ovoid,pedicel,peduncle,perennial,petiole,petiolule,plant,poricidally,proximal,purple,rarely,rotate,rounded,scattered,seed,short,size,slit,stigma,straight,style,terminal,testal,thick,throughout,tip,toward,tuber-bearing,wall,wide,yellow,¼	-6,0-2,1-4,1.1-3.9,2-,3-5,3-6-foliat,4-5.5,5-20,8-16,9-33,abaxiall,abaxially,acumen,adaxially,attenuate,commonly,digestion,dorsally,eaf,edge,eed,emoval,enzyme,exceeding,filament,flat,flower,folded,globo,hair-like,honeycomb,living,lobe,lon,lower,lunat,make,mucilaginous,nflorescence,nther,orolla,pair,pattern,perfect,plan,reveal,ruit,sessile,seudostipule,short-attenuate,specimen,stamen,subequal,tal,tem,throughou,typically,unit,vary,ympodial	'','hair-like,6,[,],``,anther,arrangement,articulation,bark,characteristic,color,connation,dehiscence,foetid,foliage,form,fruit,fruiting,globose,growth,height,history,inflorescence,length,life,lunate,na,ovary,papillae,position,prickle,pseudostipule,shape,spacing,stem,straightnes,surface,texture,trichome,tube,value,ye,young,{,}
459	wfo-0001029125	success	197	104	68	129	36	0.345	1,acute,anther,apex,base,berry,black,brownish,calyx,central,closely,cm,concave-reniform,corolla,deltate,densely,diameter,ellipsoid,fruit,glabrous,globose,green,herb,lateral,leaf,live,lobe,lower,maturity,maximum,minutely,mm,orange,ovary,ovate-lanceolate,pale,papillate,pedicel,peduncle,petiole,plant,poricidal,pubescent,purple,purplish,ripe,seed,shiny,simple,small,spaced,sparsely,star,stellate,stem,stigma,style,subshrub,surface,tip,trichome,tube,turning,uniseriate,white,woody,yellow,¼	.0–3.5,.1,.1–1.4,.2,.4,.5–2.0,.6,0.5,0.5–0.6,0.5–1.0,0.8–0.9,0.9,1.0–1.2,1.0–1.5,1.0–4.0,1.5–2.0,1.5–3.0,1.7-,1.8–3.5,1–2-celled,2.5–12.0,2/3,20–100,2–3-celled,2–4,3.0–3.4,3.5–4,35–45,3–5,3–5-celled,4–8,5-merous,5–6,6,6–7,abaxial,abaxially,acuminate,adaxial,adaxially,age,along,anthesi,apar,apparently,appressed,arising,articulated,attenuate,ba,beyond,branching,cell,cone,conical,cuneate,delicate,difoliate,eaf,eed,end,entire,especially,exerted,filament,flower,free,fruiting,geminat,growt,hilum,internodal,later,lengthening,like,lobed,lon,long,margin,narrower,nearly,nflorescence,oblique,occasionally,often,one,outline,pair,pentagonal,per,perfect,place,pore,portion,positioned,primary,purple-tinged,reflexe,reflexed,ridged,ruit,scar,scattered,shorter,single,slightly,slit,spreading,stemmed,stone,straight,strongly,sub-lateral,tall,tem,terete,testal,tinged,toward,traingular,ud,unequal,unit,usually,vein,whitewith,wide,ympodial,young	0.5-0.6,0.5-1.0,1.0-1.5,1.5-2.0,1.5-3.0,2-3-celled,2-4,20-100,3.5-4,apart,arrangement,bark,color,connation,dehiscence,distal,form,growth,height,history,inflorescence,interjected,leaflet,length,life,na,papillae,pseudostipule,shape,size,spacing,straightnes,terminal,texture,triangular,tuber-bearing
460	wfo-0001029138	success	170	90	52	118	38	0.306	0.15-0.3,0.25-0.5,2.4-5.5,2.5-3.5,3.5-6.7,4-6,6-6.5,absent,accrescent,acute,anther,apart,apex,articulated,base,broadly,brown,calyx,cm,cuneate,diameter,directed,distally,extra-axillary,fruit,fruiting,inflorescence,lateral,length,midpoint,minute,mm,oblate,obtuse,ovate,pedicel,peduncle,perennial,petiole,present,prickle,pseudo-racemose,purple,rotate,shrub,simple,stellate-pubescent,stem,straight,style,tube,yellow	%,0,0-0.1,0-0.6,0-1.5,0-5,0.5-0.9,0.6-0.7,0.6-0.8,0.6-1.1,0.8-1.5,0.9-1.2,1-1.5,1-1.8,1-2,1-2.5,1-5,1.6-2.1,1.7-4,2-foliate,2-locular,20-100,20-30,3-4,3-8,3-80,3.5-4.5,5-8,5-merou,6-10,6-8,65-115,7-10,7-8,abaxially,absen,acicular,adaxiall,adaxially,alyx,apparently,armed,axe,ba,blade,broad-based,chartaceous,cylindrical,d.,deltate,densely,distall,distributed,dult,eaf,eed,eglandular,enclosing,entire,finger,flower,functional,geminat,glabrou,glabrous,gland-tipped,green,grey-green,hair,juic,lamina,lobe,lon,long,longer,lower,margin,markedly,mature,mesocarp,mid-point,midvein,moist,nflorescence,oblique,orolla,part,per,pore,porrect,prostrate,ray,rhizomatous,ruit,rusty,short,spaced,sparsely,stage,stalk,stellae,tal,tamen,thick,thicker,thicknes,throughout,time,unbranched,unit,unknow,unknown,uvenile,vary,wide,x,yellowish,ympodial	arrangement,articulation,bark,color,connation,corolla,dehiscence,diminishing,distal,foetid,foliage,form,growth,height,history,interjected,leaf,leaflet,life,na,ovary,papillae,petiolule,plant,position,pseudostipule,seed,shape,size,spacing,stigma,straightnes,surface,terminal,texture,trichome,tuber-bearing,young
461	wfo-0001029150	success	177	98	75	102	23	0.424	0.3,0.3–0.5,1.2–1.5,1.5–2.2,15,1–11,1–5,1–6,2.5–3,2.5–5,2–10,3–10,6,8-shaped,9–12,acute,adaxially,anther,apex,apically,base,branched,calyx,ciliate,cm,color,conical,cros,cylindrical,diameter,ellipsoidal,elliptical,except,extra-axillary,flower,fruit,glabrous,larger,leaf,light,margin,membranaceous,midvein,minutely,mm,moderately,nearly,oblique,opposed,ovate,pedicel,peduncle,petiole,pubescent,rachi,rarely,rounded,rugose,sand-punctate,section,simple,sparsely,stellate,stem,stigma,style,surface,tan,teardrop-shaped,truncate,tube,vine,white,woody,x	.5,0.3-0.5,0.5–1.1,0.8-1,0.8–1,0.8–1.5,0.8–3.5,1.5,1.5–2,1–1.5,1–2,2.5–8,2–2.5,2–3,3-5,3–4,3–50,5-merous,7–8,abaxially,accrescent,across,adaxiall,alyx,apar,apicall,apiculate,attenuate,axe,berry,blade,c.,canopy,capitat,climbing,delicate,distant,dried,eaf,eed,enlarged,entire,filament,flattened,fleshy,flush,fruiting,glabrou,inconspicuous,lamina,lanceolate,living,lobe,lon,long,lower,m.,material,mor,nflorescence,nternode,older,orolla,pair,pale,perfec,pinkish-white,pinnate,plurifoliat,pointed,reaching,rounded-deltoid,ruit,scar,secondary,shortly,side,slender,slightly,small,somewhat,spaced,specimen,strong,tamen,tem,thick,thickened,time,tip,translucent,tree,trichome,understory,unit,vary,vegetation,vein,venation,wide,wiry,ympodial	3,apart,arrangement,capitate,corolla,dehiscence,form,growth,height,history,inflorescence,internode,length,life,na,papillae,plant,position,seed,shape,spacing,straightnes,texture
462	wfo-0001029151	success	197	118	79	118	39	0.401	-10,0.1-0.3,0.2-0.6,0.25-0.5,0.5-1,1-2,1-5,10-15,2-15,2-4,4.5-5,5-10,8-10,8-15,accrescent,acicular,annual,anther,apex,articulated,base,brown,calyx,chartaceous,close,cm,connivent,dark,densely,diameter,elliptic,flattened,forked,fruit,fruiting,globose,green,hair,herb,lateral,leaf,leaf-opposed,long,loosely,midpoint,minute,minutely,mm,multangulate,narrowly,oblique,oblong,ovate,pedicel,peduncle,petiole,porrect,prickle,pubescent,purple,rarely,reniform,reticulate,rounded,simple,stellate,stem,stigma,straight,style,subcordate,surface,truncate,tube,unbranched,whitish,x,yellow,yellowish	0-0.5,1-1.5,1-2.5,1-6,1.5-2,1.5-3,1.5-6,15-20,2-2.5,2-3,2-6,2-8,3.5-5,4-10,5,5-7,5-8,6-10,7-10,7-9,8,abaxially,abundantly,acro,acumen,acute,adaxial,adaxially,apart,apparently,armed,axe,ba,blade,capitat,completely,cone,covered,covering,curved,cylindrical,deflexed,developed,difoliate,directed,discolorous,distall,downward,eaf,eed,eglandular,entire,equal,filament,flower,frui,geminat,glabrous,held,high,interpetalar,juic,juvenile,larger,like,lobe,lon,lower,main,margin,markedly,mesocarp,midrib,moderately,moist,nearly,nflorescence,obtuse,orolla,outside,pale,perfect,pore,prickly,probably,rachi,ray,ruit,scarcely,shallow,shorter,side,silvery,small,spaced,sparse,sparsely,sparser,spiny,sprawling,stalk,stellate-pubescent,tamen,tem,time,tissu,tissue,triangular,unarmed,undulate,unit,usually,vary,vein,vigorous,white,wide,ympodial	arrangement,articulation,bark,capitate,color,connation,corolla,dehiscence,diminishing,distal,foetid,foliage,form,growth,height,history,inflorescence,interjected,leaflet,length,life,na,ovary,papillae,petiolule,plant,position,pseudostipule,seed,shape,size,spacing,straightnes,terminal,texture,trichome,tuber-bearing,width,young
463	wfo-0001029152	success	197	112	80	117	32	0.406	.1,0.5-1,0.9-1.3,1-1.5,1-4,2-5,acuminate,acute,anther,apex,appressed,area,attenuate,bark,base,brown,calyx,closely,cm,corolla,cuneate,dark,deciduous,deep,deflexed,distal,elliptic,fruit,fruiting,glabrous,globose,green,greyish-red,inflorescence,lateral,leaf,lobed,long,midrib,minutely,mm,nearly,obovate,often,opposite,ovary,overlapping,ovoid-reniform,pale,papillose,pedicel,petiole,pitted,plane,plant,poricidal,shape,shaped,shiny,shrub,simple,single,size,small,soon,spaced,stem,stigma,straight,style,surface,tear-drop,terminal,tip,tree,trichome,tube,weak,white,young	.5,0.25-0.5,0.75-1,0.8-1,1,1-2,1-3,1.1-1.3,1.5-1.7,1.5-2,2-2.5,2-3,2-4,2.5-3,3-5,3-8-flowered,4-6,6-8,61-25,8.5-16,anthesi,appearanc,appearing,ba,beginning,beneath,berry,blade,branch,broadened,broadly,bud,citronella,completely,conical,corky,decurrent,deltoid,densely,dia,differing,difoliate,dry,eaf,edicel,eed,ellipsoi,enclosing,erect,et,exsertion,fide,filament,flattened,floccose,flower,fragrance,free,geminat,giving,held,hyaline,inflorescenc,keeled,large-lenticellate,late,lightly,live,lobe,lon,long-styled,longer,lower,main,major,margin,material,middle,minor,nflorescence,older,one,pair,per,planar,pore,portion,prominent,prominently,quite,red,red-floccose,reddish,reddish-floccose,reflexed,reminiscent,rounded,ruit,scar,short-styled,slender,slightly,somewhat,styl,tall,tapering,third,tillett,ud,unit,usually,vein,widest,winged,woody,x,ympodial	1.5-6,arrangement,articulation,color,connation,dehiscence,diameter,diminishing,foetid,foliage,form,growth,height,history,interjected,leaflet,length,life,midpoint,na,papillae,peduncle,petiolule,position,prickle,pseudostipule,seed,spacing,straightnes,texture,tuber-bearing,width
464	wfo-0001029156	success	65	77	32	33	45	0.492	0.5,1.5-2,6,<,apex,bark,cm,diameter,exfoliating,fruiting,glabrous,golden,growth,lateral,liana,long,markedly,minute,minutely,mm,multiseriate,pale,pedicel,pitted,reniform,seed,stem,surface,tan,trichome,vine,woody	-3,1,10-12,2,4-6,6-8,almost,apparently,berry,cell,center,completely,deeply,eed,epiphytic,fide,flattened,margin,nee,new,noddin,occasionally,older,per,rectangular,rib-like,shiny,shreddy,sinuate,testal,thickening,wall,wide	anther,arrangement,articulation,base,calyx,color,connation,corolla,dehiscence,diminishing,distal,foetid,foliage,form,fruit,height,history,inflorescence,interjected,leaf,leaflet,length,life,midpoint,na,ovary,papillae,peduncle,petiole,petiolule,plant,position,prickle,pseudostipule,shape,size,spacing,stigma,straightnes,style,terminal,texture,tube,tuber-bearing,young
465	wfo-0001029156	success	65	75	25	40	50	0.385	1.5-2,apex,cm,diameter,exfoliating,flattened,fruiting,glabrous,golden,growth,lateral,liana,minutely,multiseriate,pale,pedicel,pitted,reniform,seed,stem,surface,tan,trichome,vine,woody	-3,0.5,1,10-12,2,4-6,6-8,<,almost,apparently,ark,berry,cell,center,completely,deeply,eed,em,epiphytic,fide,lon,margin,markedly,minute,mm,nee,new,noddin,occasionally,older,per,rectangular,rib-like,shiny,shreddy,sinuate,testal,thickening,wall,x	6,anther,arrangement,articulation,bark,base,calyx,color,connation,corolla,dehiscence,diminishing,distal,foetid,foliage,form,fruit,height,history,inflorescence,interjected,leaf,leaflet,length,life,na,ovary,ovoid,papillae,peduncle,perennial,petiole,petiolule,plant,position,prickle,pseudostipule,shape,size,spacing,stigma,straightnes,style,terminal,texture,tube,tuber-bearing,yellow,yellow-green,young
466	wfo-0001029160	success	150	101	76	74	25	0.507	/2,0.5,0.7,1.3-1.8,1.8-2.2,2-7,20-40,3-8,3.0-3.5,4-8,6-8,accrescent,acicular,across,annual,anther,beneath,berry,blade,broadly,brown,calyx,capitate,cm,dark,dm,dry,eglandular,enveloped,few-rayed,fully,glabrous,gland,hair,herb,heteromorphic,including,incurved,internodal,less,linear-lanceolate,lobe,long,maturity,mm,mostly,occasionally,ovate,ovoid,petiole,pinnatifid,plump,prickle,prickly,purple,radially,ridged,scattered,sessile,short-stipitate,sometimes,spherical,splitting,spreading,stellae,stellate,stem,strait,terminally,thrice,tightly,tinged,twice,vestiture,wholly,yellow	0.35-0.50,1.11.4,1.3-1.6,4.5-6.0,5-13,5.6-7.5,6-10-flowered,6.5-8.6,acro,acute,adjacent,also,alyx,among,anthesi,appearance,armed,base,branched,bristly,campanulate,deep,deltoi,developing,dia,difoliate,divergently,divided,eaf,eed,erect,exceeding,extende,finer,geminat,giving,hilum,invested,lon,lowermost,main,many,much,much-dissected,narrowly,nflorescence,notch,often,one,orolla,pair,ruit,shorter,shortest,size,slende,somewhat,stout,straigh,sunken,tall,tamen,three,tigma,tub,tube,tyle,ultimate,unit,uppermost,vary,vein,whitish-tinged,ympodial	arrangement,color,corolla,diameter,extended,form,fruit,fruiting,growth,height,history,inflorescence,leaf,length,life,ovary,plant,position,seed,shape,staman,stigma,style,surface,texture
467	wfo-0001029163	success	149	98	56	93	42	0.376	0.3-2.5,0.5-1,10-,2,2-6,20-30,3-14,3-4,4-20,4-6,5-8,acuminate,acute,apart,apex,articulated,base,calyx,chartaceous,cm,color,connivent,cuneate,decurrent,densely,diameter,elliptic,elliptic-ovate,free,fruit,globose,herb,lanceolate,lenticular,mm,pedicel,peduncle,perennial,petiole,pseudohair,puberulent,purple,simple,slightly,stellate,stem,stigma,style,surface,tube,unbranched,unknown,white,whitish,x,yellow	-25,-4,-9,1,1-2,1.5-2,1.5-2.5,1.5-3,13-18,2-18,2-3,2-7,2.5-3,3-5,4-5-foliat,4.5-23,5-12,7-9,9-15,abaxial,abaxially,absen,adaxiall,adaxially,aggregate,axe,band,blade,cell,cylindrical,deltate,denser,directed,distall,distally,eaf,eed,eglandular,entire,flower,glabrous,glandular,hair,leaving,like,lobe,lon,long,lower,margin,moderately,narrowed,narrowly,nearly,nflorescence,nther,obtuse,orolla,papillose,pedicellar,pore,projection,puberulent-pubescen,puberulent-pubescent,pubescence,rachi,radiu,remnant,ripe,roughened,ruit,scale-like,shrub,small,sometimes,spaced,sparsely,stalked,stone,subapical,subcoriaceous,tal,tem,thickened,time,tip,triangular,truncat,unit,vary,vein,wide,ympodial	anther,arrangement,articulation,bark,connation,corolla,dehiscence,diminishing,distal,foetid,foliage,form,fruiting,growth,height,history,inflorescence,interjected,lateral,leaf,leaflet,length,life,na,ovary,papillae,petiolule,plant,position,prickle,pseudostipule,seed,shape,size,spacing,straightnes,terminal,texture,trichome,truncate,tuber-bearing,young
468	wfo-0001029171	success	137	94	58	79	36	0.423	-10,-15,0.5,1-3,1-4.5,10-25,3-4,3.5-6.5,4-10,7-9,acuminate,acute,angled,apart,apex,articulated,base,branched,calyx,chartaceous,cm,connivent,cuneate,decurrent,densely,diameter,elliptic,forked,fruit,globose,lanceolate,mm,moderately,orange,ovate-elliptic,pedicel,peduncle,petiole,pubescent,purple,rarely,red,ripe,rugose,shrub,simple,slightly,smooth,sometimes,stellate,stigma,style,tube,unbranched,usually,white,x,yellow	-,1-5,1.5-2,1.5-7.5,10-35,11-20,2-3,3.5-18,4-5,5-6,5-8,6-,8-17,abaxially,abruptly,absen,adaxially,aggregate,also,and/or,axe,ba,blade,cell,cylindrical,deltate,dendritically,dense,directed,distall,eaf,eed,eglandular,entire,except,flower,glabrous,gland,glandula,glandular,hair,like,lobe,long,lower,many-foliat,margin,midrib,narrowed,narrowly,near,nearly,nflorescence,nther,obtuse,often,orolla,perfect,pore,puberulent,rachi,radiu,ruit,shoot,short-stalked,spaced,sparsely,ste,stone,tal,tem,time,tip,triangular,truncat,unit,vary,wide,ympodial	abaxial,adaxial,anther,arrangement,articulation,color,connation,corolla,dehiscence,form,growth,height,history,inflorescence,interjected,lateral,leaf,leaflet,length,life,na,ovary,papillae,plant,pseudostipule,pubescence,seed,shape,size,spacing,stem,straightnes,surface,terminal,texture,truncate
469	wfo-0001029215	success	49	42	25	24	17	0.51	-1.8-2.3,0.3-0.5,0.5-0.7,0.5-2.5,1,2.3-2.9,appearance,brown,calyx,cm,coarse,diameter,hair-like,herb,mm,obovate,outgrowth,pubescent,shrub,silky,small,smelling,strong,surface,woody	.2,border,cell,eed,elongating,entire,fide,fruit,give,lateral,lobe,long,markedly,narrowly,round,spreadin,tall,testa,thick,wall,weigend,wide,winged,xyledecor	0.2,color,feature,form,growth,height,history,length,life,plant,reproduction,seed,shape,spreading,texture,thicknes,width
470	wfo-0001029216	success	243	103	77	166	26	0.317	0.2-0.4,0.5,0.5-1.5,0.6-1,1-1.2,1.2-6,10,10-14,2-4.5,3,3-7,4,6-10,accrescent,acute,annual,anther,apex,articulated,articulation,attenuate,base,basiscopically,biennial,bright,brown,calyx,capitate,cm,corolla,decurrent,deep,diameter,distal,elliptic,fruit,fruiting,globose,hair-like,herb,imparipinnate,inflorescence,interjected,interrupted,lateral,leaflet,length,less,linear,mm,oblique,obovate,orange,outgrowth,ovary,ovate,pale,pedicel,peduncle,pentagonal,perennial,petiole,petiolule,plant,pseudostipule,pubescent,red,shape,simple,stem,stigma,style,surface,terminal,trichome,tube,yellow	+,-0.5,-10,-5,.5,.8-1,0.1-0.3,0.1-0.5,0.1-0.6,0.1-0.8,0.2-0.25,0.2-0.3,0.2-0.8,0.3-0.4,0.3-0.5,0.3-2,0.4,0.4-0.5,0.5-0.8,0.5-2,0.6-0.8,0.8-2.5,1-2,1-3,1-4,1-6,1.5-2.3,1.5-2.5,1.5-3,1/,10-,2,2-locular,2.5-3.3,20-35,3-,3-4,3-5,3-foliate,5,5-15-flower,7-10,<,absen,absent,acroscopically,adpressed,allogamous,always,and/or,angeld,anthesi,apical,appearance,appendage,axi,basal,becoming,branch,cell,cente,column,composed,cone,conical,cordate,crenate,cultivar,deeply,dentate,eaf,edicel,eed,entire,erect,exserted,extending,facultatively,fasciated,filament,fruited,giving,glabrescent,gland-tipped,glandular,gree,green,half,halfway,included,initially,internode,lanceolate,large,larger,later,like,lobe,lobulate,lon,long,longer,lower,mainly,margin,maturity,minute,minutely,mixture,multicellular,multilocular,narrowly,near,nflorescence,numerous,often,one,pair,particularly,population,present,primary,procumbent,rarely,reflexe,ruit,scen,secondary,sessile,shaggy,shaped,short,silky,sometimes,somewhat,sparse,sparsely,spreading,staminal,sterile,straight,strong,strongly,tangled,tem,tertiary,testa,thick,thickening,tip,total,toward,truncate,ud,unicellular,uniseriate,unit,usually,variety,varying,villous,viny,wall,wide,winged,ympodial	1/3,arrangement,bark,color,connation,dehiscence,diminishing,foetid,foliage,form,growth,height,history,leaf,life,na,papillae,position,prickle,seed,size,spacing,straightnes,texture,tuber-bearing,young
471	wfo-0001029226	success	206	116	81	125	35	0.393	-9,1-1.5,1-2,1-3,2-6,2-9,2.5-10,5-7,7-11,acuminate,acute,anther,apart,apex,articulated,base,black,blue,branched,bright,calyx,capitate,cm,connivent,cordate,corolla,dark,densely,diameter,ellipsoid,flattened,fruiting,glabrescent,globose,growth,herbaceous,lateral,lavender,leaf,lobed,long,loosely,lyrate,many,minutely,mm,often,open,pale,pedicel,peduncle,petiole,pinnatifid,pitted,poricidal,pubescent,red,reniform,seed,shrub,simple,sleeve,small,sparsely,stellate,stem,stigma,style,surface,tan,terminal,time,tip,trichome,tube,uniformly,vine,way,white,yellowish,¾	-7,.5,.75,0-1,0.5,0.5-5,1-celled,10-40+,2,2-3,3-3.5,3-6,30,4,4-6,5-merou,8-13,>,ag,alyx,anthesi,apparently,ark,ba,basal,berry,breaking,cell,completely,congested,conical,decurrent,deltate,distall,divided,dry,eaf,eed,elongate,enation,entire,exserted,filament,flexuous,flower,free,glabrous,gland,glandular,green,hairy,ilament,irregularly,juice,lengthening,like,lobe,longer,lower,margin,material,mature,membranous,mere,minute,new,nflorescence,occasionally,older,one,orolla,overtopping,pair,papillat,papillate,papillo,per,perfect,pinnate,plurifoliat,pore,portion,primary,reflexed,remainin,rim,ripe,ruit,sagittate,scar,scarlet,shiny,short-glandular,shorter,slender,slit,sometimes,spaced,spot,sprawling,spreadin,spreading,staining,strongly,tangled,tem,testal,thin,third,translucent,truncate,twinin,ud,uniseriate,unit,usually,vary,vein,wall,weak,wide,widest,winged,woody,ympodial	arrangement,articulation,bark,color,connation,dehiscence,diminishing,distal,foetid,foliage,form,fruit,height,history,inflorescence,interjected,leaflet,length,life,na,ovary,papillae,perennial,petiolule,plant,position,prickle,pseudostipule,shape,size,spacing,straightnes,texture,tuber-bearing,young
472	wfo-0001029234	success	204	98	60	144	38	0.294	0-2,0.3-0.9,0.5-2,0.9-2.1,1-10,2-3,4-7.5,5.5-7,9-24,absent,accrescent,acute,anther,apex,articulated,base,brown,calyx,capitate,chartaceous,cm,connivent,cuneate,cylindrical,diameter,flattened,fruit,fruiting,globose,inflorescence,lanceolate,lateral,leaf-opposed,length,loosely,midvein,mm,narrowly,ovate,pale,pedicel,peduncle,perennial,petiole,present,prickle,pseudo-racemose,purple,red,rotate-stellate,rugose,shrub,simple,stellate,stigma,style,surface,triangular,tube,yellow	%,0-0.1,0-1,0-2.5,0-3,0-4,0-6,0.1-0.5,0.15-0.3,0.2-0.3,0.4-0.5,0.4-0.7,0.5-1,0.5-1.5,0.5-5,0.6-0.8,0.8-1.1,1-1.5,1-4,1-locular,1.1-1.5,1.5-2,1.5-2.5,11-23,18-24,2-2.5,2-6,20-,3-3.7,3-5,3-7,3-8,4-,4-8,4.7-7,5-9.5,5-merou,7-10,7-11,abaxially,absen,acicular,across,adaxiall,adaxially,adult,alyx,apart,apparen,attenuate,axe,ba,bilobe,blade,branche,confined,dense,directed,distall,distally,dm,eaf,eed,eglandular,entire,erect,exocarp,few-,filament,finger,flower,geminat,glabrous,gland-tipped,glandular-puberulent,green,hair,half,incomplete,juicy,lamina,less,lobe,long,longer,lower,margin,markedly,mature,mesocarp,mid-point,midpoint,midrib,minute,moderately,nflorescence,oblique,orolla,part,per,perfect,placenta,plurifoliate,pore,porrect,pubescent,rachi,ray,rhizomatous,ruit,seeded,septum,sessile,short,spaced,sparse,sparsely,stage,stalk,stellae,stellate-pubescent,straight,succulent,tal,tamen,tem,thick,thicker,thicknes,throughout,time,tip,toward,unarme,unarmed,unbranched,unit,unknow,uvenile,vary,white,wide,x,ympodial	arrangement,articulation,bark,bilobed,color,connation,corolla,dehiscence,diminishing,distal,foetid,foliage,form,growth,height,history,interjected,leaf,leaflet,life,na,ovary,papillae,petiolule,plant,position,pseudostipule,seed,shape,size,spacing,stem,straightnes,terminal,texture,trichome,tuber-bearing,young
473	wfo-0001029236	success	159	97	70	89	27	0.44	.5,0.2-1,0.45-0.5,0.5-1.5,1-1.5,1-2,1/2,adaxial,age,anther,apically,bark,base,becoming,calyx,cm,conical,coriaceous,corolla,dendritic,diameter,elliptic,except,flattened,fleshy,fruit,glabrous,globose,grey-brown,growth,lateral,leaf,lenticular,lobed,long,margin,midvein,minutely,mm,narrowly,obscurely,ovary,pale,pedicel,petiole,pitted,pointed,pore,poricidal,pubescent,purplish-black,reddish-brown,revolute,shiny,shrub,slightly,slit-like,sparsely,stem,stigma,style,surface,terminal,tip,trichome,tube,violet,way,wide,young	0.2-0.7,0.5,0.9-2.3,1.4-1.7,2-4,2-5,3,6-9,abaxially,absent,anthesi,apex,apical,apparently,appearing,axi,ba,basal,berry,bi-lobe,branch,branching,branchlet,broadly,compact,completely,cupulate,decurrent,deflexed,deltate,densely,dichasial,eaf,edicel,eed,erect,ew,exserted,filament,flower,free,fruiting,inserted,later,less,lobe,lower,m.,many,middle,near,nflorescence,nodding,obscure,occasionally,older,overtopping,packe,per,pericarp,persistent,plurifoliate,portion,prominent,purplish,ruit,scar,scattered,secondary,shoot,short,simple,sleeve,stamen,strongly,tall,tapering,thin,time,trongly,tub,ud,unit,usually,venation,winged,woody,x,ympodial	arrangement,bi-lobed,color,connation,decurred,dehiscence,form,height,history,inflorescence,interjected,leaflet,length,life,midpoint,na,papillae,peduncle,perennial,plant,pseudostipule,seed,shape,size,spacing,straightnes,texture
474	wfo-0001029244	success	233	154	120	113	34	0.515	0-0.5,0-2,0-2.5,0-55,0.4-0.7,1-1.5,1-4,1.4-6,100-150,12-25,2-12,2-3,2-4,2.1-3.2,2.5-3.6,22-31,3-10,3-5,3-7,3-7.5,4-7,5-10,5-7,6-12,7-12,7-9,8-10,9-16,9-25,90-200,accrescent,acicular,acuminate,acute,adaxially,adult,anther,apex,articulated,base,blade,branch,brown,calyx,chartaceous,cm,connivent,contiguous,cuneate,decimetre,deltate,densely,dm,elliptic,entire,especially,extra-axillary,filament,flower,fruit,fruiting,globose,green,inflorescence,juvenile,lanceolate,leaf,length,lilac,lobe,lobed,long,longer,loosely,margin,midpoint,minutely,mm,nearly,obovate,obtuse,occasionally,orange,ovate,pair,pedicel,peduncle,per,perennial,petiole,plant,prickle,purple,rachi,red,reniform,rostrate,rugose,rusty,scarcely,shallowly,shrub,side,sparsely,stellate,stellate-pubescent,stigma,straight,style,surface,thick,throughout,time,toward,tube,unbranched,upper,wide,x,yellow	%,0-0.2,0-0.3,0-1,0-16,0-80,0-9,0.15-0.25,0.2-0.25,0.2-0.3,0.2-0.5,0.25-0.4,0.5-2,0.8-5,1-2,1.1-1.8,1.5-2.5,1.8-3.5,10-18,2-foliate,2-locular,3-8,4-5.5,4.7-5,5-merou,6-8,6-9,7-10,7-30,abaxially,absen,absent,across,adaxiall,alyx,andromonoecious,anvil-shape,apart,apiculate,axe,ba,branche,capitat,confined,cross-section,cylindrical,diameter,directed,distall,distally,distributed,eaf,eed,eglandular,erect,exocarp,finger,flattened,functional,geminat,gland-tipped,hair,half,hetereostylous,juicy,lamina,lateral,less,lower,markedly,mature,mesocarp,mid-point,midrib,midvein,minute,moderately,moist,narrowly,nflorescence,oblique,orolla,pale,part,placenta,pore,porrect,present,ray,rhizomatous,ruit,sessile,short,simple,sometimes,spaced,stalked,stellae,summit,tal,tamen,tem,thicker,tip,transparent,triangular,unarme,unarmed,unit,vary,vein,weakly,ympodial	5-merous,bark,capitate,color,connation,corolla,dehiscence,density,foetid,foliage,form,growth,height,history,interjected,leaflet,life,na,ovary,papillae,petiolule,position,pseudostipule,seed,shape,size,staman,stem,straightnes,terminal,texture,thicknes,trichome,young
475	wfo-0001029246	success	209	117	81	128	36	0.388	-1.5,0.1-0.4,0.15-0.3,0.2-1.5,0.7-1.3,0.7-1.5,0.7-2,0.8-1.1,1-4,1-5,1.5-2.5,1.5-6,2,6-8,7-12,8-16,acuminate,acute,almost,anther,apart,apex,apparently,articulated,bark,base,c.,calyx,chartaceous,cm,connivent,cuneate,curved,diameter,dull,elliptic,elongating,flattened-reniform,fruit,fruiting,glabrescent,lateral,leaf,length,less,lobed,long,mature,mauve,midpoint,mm,moderately,obtuse,orange-brown,orange-red,pale,pedicel,peduncle,petiole,poricidal,porrect,prickle,ray,sessile,shrub,simple,sometimes,spherical,stellate-pubescent,stem,straight,style,surface,tapering,tip,trichome,tube,unbranched,white,wide,yellow	-1,-4,/5,0,0-15,0-5,0.1-0.3,0.3-0.5,0.3-0.8,0.5,0.5-1.5,0.8-3,0.9-1.3,1-1.5,1-1.8,1-10,1-3,1-8,1.2-2,1.5-2.3,1.7-6,1.8-3,1/10-1/5,1/3,2-3,2-3.5,2-5,2.5-3.2,2.8-4,2/3,2/3-3/,3-20,3-5,3.5-5,4-6,5-,5-20,5-merous,6-10,abaxial,abaxially,acuminat,adaxial,alyx,apar,apically,berry,blade,broad-deltate,concolorous,deltate,densely,discolorous,distance,drying,eaf,eed,entire,equal,erect,extending,eye,filament,flattened,flower,free,glabrous,infructescence,lobe,lon,longer,lower,margin,maturity,midvein,naked,narrow-deltate,narrow-ovate,nflorescence,oblong,older,one,open,orange-brow,orolla,oung,pair,pendulous,per,perfec,pericarp,plurifoliat,portion,prickl,prickly,primary,procumbent,pubescent,purple,recurved,rounded,ruit,scar,side,smooth,spaced,sparsely,spreading,stellate,stout,strongly,tamen,terete,tertiary,time,unarmed,unit,upper,usually,vary,vein,venation,visible,way,woody,yellow-orange,ympodial,¼	arrangement,articulation,color,connation,corolla,dehiscence,diminishing,distal,foetid,foliage,form,growth,height,history,inflorescence,interjected,leaflet,life,na,ovary,papillae,perennial,petiolule,plant,position,pseudostipule,seed,shape,size,spacing,stigma,straightnes,terminal,texture,tuber-bearing,young
476	wfo-0001029263	success	211	132	94	117	38	0.445	0-2.5,0-5,0.3-1,0.5-1,0.6-1.5,1,1/3-3/4,12-35,2-3,3-5,30-60,6-20,almost,anther,apex,articulated,attenuate,bark,base,becoming,black,broad,calyx,cell,chartaceous,cm,connivent,corolla,cream,cultivar,cuneate,curved,dark,deep,diameter,distal,dull,elliptic,elongating,evenly,flattened-reniform,fruit,fruiting,glabrous,glandular,green,hair,herb,lateral,leaf,length,long,long-styled,marking,mature,maturity,mauve,minute,mm,obtuse,orange,orange-brown,outline,pale,pedicel,peduncle,petiole,pit,plant,poricidal,purple,raised,reflexed,rotate,short-styled,simple,small,smooth,sometimes,spherical,stem,stout,straight,style,surface,tapering,tip,trichome,tube,unbranched,usually,white,yellow,young	-2,0-100,0.5-1.5,1-10,1-4,1-7,1.2-2.5,1/2,1/3-2/3,1/4-1/3,1/6,10-20,10-35,2-4,2.2-3.2,2.8-3.8,3.5-5,4-10,4-6,4-7,5-10,5-8,5-merous,6-30,7-10,acute,alyx,andromonoecious,apar,apically,apparently,ba,berry,blade,broad-deltate,concolorous,decurren,deltate,difoliate,distance,drying,eaf,eed,entire,equal,erect,extending,extensive,filament,flower,foliaceou,free,fully,geminat,glabrescent,hermaphrodite,heterostylous,infructescence,less,lobe,lobed,lobing,long-acuminat,longer,lower,lowermost,margin,midvein,near,nflorescence,often,older,one,onl,open,opening,orolla,oung,ovoi,pair,part,pendulous,per,pericarp,portion,primary,red-brown,reddi,rounded,ruit,scar,secondary,side,spaced,sparsely,spreading,staminat,stellate-pubescent,tamen,tearing,terete,tertiary,time,ud,unarme,unarmed,unit,upper,vary,vein,venation,visible,way,wide,wider,woody,ympodial	/,apart,arrangement,articulation,color,connation,dehiscence,diminishing,foetid,foliaceous,foliage,form,growth,height,history,inflorescence,interjected,leaflet,life,midpoint,na,ovary,papillae,perennial,petiolule,position,prickle,pseudostipule,reddish,seed,shape,size,spacing,stigma,straightnes,terminal,texture,tuber-bearing
477	wfo-0001029286	success	224	118	88	136	30	0.393	0.8,0°,1.5-2,1.5-4,1.5-8,4-5,4-6,4.5-7,5-6,6-9,7-10,abaxial,abaxially,acute,adaxially,almost,anther,apart,apex,apiculate,attenuate,bark,base,branch,broadly,brown,capitate,chartaceous,clustered,cm,corolla,curved,dendritic,diameter,domatia,drying,entire,faint,flat,flexuous,formed,glabrous,grey,junction,leaf,length,liana,light,lilac,lobed,long,margin,mauve,membranous,midvein,minutely,mm,multicellular,obconical,oblong,obovate,pair,pedicel,peduncle,petiole,poricidal,primary,prominent,raised,side,slender,smooth,sometimes,spreading,stem,stigma,style,surface,terminal,tertiary,tip,trichome,tube,unarmed,vein,venation,widely,yellowish	.4,.5,0-0.5,0.1,0.15-0.4,0.4-1.2,0.6-1.2,1-1.5,1-2,1/8,15-50,2-3,2.5-3,3-4,4.5,5,6-8,abscising,age,along,altered,alyx,another,anthesi,apar,apically,apice,apparently,arising,around,articulated,articulation,axil,becoming,branched,branching,canaliculate,clearly,closer,concave,concolorous,conical,crenulate,cuspidate,delineated,deltoid,density,dilated,distributed,eaf,eed,equal,except,extending,fertilization,filament,flower,forming,free,fresh,glabrescent,globo,green,hair,increasing,inflorescenc,inside,isolated,know,known,lamina,lengthening,less,lobe,lower,m.,main,margi,mas,meeting,middle,much,narrowly,nflorescence,nther,occasional,often,one,orolla,outside,ovate,papillo,perfec,plurifoliat,pore,portion,protruding,rachi,rarely,regular,rounded,ruit,scar,separated,shallowly,simple,smaller,somewhat,soon,sparsely,specimen,stretchy,stump,tangled,tearing,terete,textur,thick,thickened,thinner,time,tissue,together,toward,translucent,translucent-violet,tuft,ud,uneven,unit,vary,visible,wide,x,ympodial,young	arrangement,calyx,color,connation,dehiscence,diminishing,distal,form,fruit,growth,height,history,inflorescence,lateral,leaflet,life,na,number,ovary,papillae,papillose,petiolule,plant,seed,shape,size,spacing,straightnes,texture,tuber-bearing
478	wfo-0001029289	success	292	135	107	185	28	0.366	.05,0-2,0.4-1.1,0.4-2,1-4,1.5-5,1/6-1/3,12,2-3,2.5,25,3-7,5-20,6-12,accrescent,almost,along,always,anther,anthesi,apex,articulation,bark,base,berry,black,branch,branched,broadly,brown,calyx,canaliculate,capitate,chartaceous,clavate,cm,corolla,curved,deeply,dendritic,development,diameter,distributed,drying,erect,evenly,finely,flattened,fruiting,glabrous,green,honeycomb,leaf,length,liana,lobed,long,longitudinally,maturity,mm,oblong,obovate,often,orange,pale,papillae,pattern,pedicel,peduncle,petiole,pili,pitted,poricidal,pubescent,reddish,reniform,ridged,seed,shape,shiny,simple,size,slightly,smooth,sparsely,spheroidal,stem,stigma,straight,sturdy,style,surface,terminal,thick,thin-coriaceous,tip,trichome,tube,unarmed,undulate,unicellular,usually,violet,white,yellow,yellowish,young	.2,.5,0.15-0.25,0.2-1.5,0.4-1,0.5,0.5-0.7,0.5-1,0.5-1.2,1-1.2,1-2,1-2.5,1.2,1.5-2,1.5-4,100,15,15-45,1mm,2.5-4,3,4-9,4.5,5-12,60-90°,8,abaxially,acuminate,acute,adaxial,adaxially,age,alyx,apar,apically,apice,apparently,appendage,arachnoid,arising,aristate,around,articulated,attenuate,becoming,boundary,branching,clear,clearly,close,collapsing,complex-dendritic,complexity,concolorous,conical,covering,crenulate,cuneate,cupular,cuspidate,delineated,deltoid,dense,detaching,developing,dilated,discolorous,domatia,dorsally,eaf,eed,ellipsoi,elongated,entire,equal,eye,faint,fertilisation,filament,flexuous,flower,forming,found,free,glabrescent,globose,hair,half,hard,indumentum,inner,inside,irregular,lamina,leave,lengthening,less,light-coloured,line,linear,lobe,loop,lower,m.,main,margi,margin,may,middle,midvein,minute,minutely,mixture,multicellular,naked,narrowly,nflorescence,nther,obconical,one,orolla,outer,outline,outside,pair,papillo,papillose,pendulous,perfec,pericarp,pit,plurifoliat,point,pointed,pore,portion,primary,prominent,pronounced,protruding,puberulous,rachi,raised,rarely,reveal,rising,rounded,ruit,scar,see,shallow,shallowly,short,side,sinus,sometimes,somewhat,soon,sparse,spreading,strongly,stump,sunken,tearing,terete,tertiary,thickened,thin,time,together,toward,truncate,tuft,ud,unit,variable,various,vary,vein,venation,visible,wide,widely,x,ympodial	apart,arrangement,color,connation,dehiscence,diminishing,distal,foetid,foliage,form,fruit,growth,height,history,inflorescence,lateral,leaflet,life,na,ovary,plant,position,prickle,pseudostipule,spacing,straightnes,texture,tuber-bearing
479	wfo-0001029295	success	191	108	79	112	29	0.414	0.5,0.7-1,2-3,2/3,3/4,<,acuminate,acute,anther,articulated,bark,base,become,calyx,capitate,closely,cm,corolla,diameter,drying,elliptic,elongate,fide,fruit,fruiting,glabrous,globose,green,grey,height,herb,known,lateral,leaf,length,lengthen,lobed,long,minutely,mm,obtusely,opening,ovary,ovoid,pale,papillate,pedicel,peduncle,petiole,pitted,pointed,pore,prolonged,purple,red,reniform,rhomboidal,ripe,shrub,simple,slightly,slit,small,spaced,splitting,stem,stigma,style,surface,tan,tip,trichome,tube,uniseriate,urban,way,whitish,yellowish,young	-5,-9,.5,0,1,1-1.5,1.2-3.5,2,2-4,2.5-3.5,2.5-6,4-4.5,4-5-celled,4-6,4-merous,5-6,6-8,?,abaxial,along,anthesi,apex,apparently,appearing,attenuate,berry,cell,continuous,crystal,cup-shaped,dark,deciduous,defined,defoliate,dense,distal,eaf,eed,ellipsoid,entire,erect,essentially,exserted,filament,flower,free,geminat,glabrescent,glabrou,half,internodal,irregular,lamina,lobe,lobe-lik,lower,margin,membranous,midrib,minute,narrowly,nflorescence,nodding,older,orientation,outline,pair,papillat,peduncl,peelin,pentagonal,per,perfect,pericarp,portion,primary,puberulent,pubescent,rim,rooting,rounded,ruit,sand,scar,scattered,seen,sessile,shallowly,short,sinuate,soon,sparsely,sprawling,strongly,testal,thin,tissue,top,ud,unarmed,undulation,unifoliate,unit,upper,usually,vein,widest,wing,wiry,woody,x,ympodial	arrangement,articulation,color,connation,dehiscence,foetid,foliage,form,growth,history,inflorescence,interjected,leaflet,life,lobe-like,na,papillae,perennial,plant,position,prickle,pseudostipule,seed,shape,size,spacing,straightnes,terminal,texture
480	wfo-0001029299	success	201	105	71	130	34	0.353	0-3,0.5-1.5,1-10,1-2,1.6-5,10-21,3-12,3-13,3-5,3-7.5,3.5-7.5,4-10,4-16,5-15,7-8,anther,articulated,base,broadly,clavate,cm,connate,corolla,diameter,elliptic,forked,fruit,glandular,greenish,herb,interjected,lanceolate,lateral,leaf,leaflet,medium,mm,moderately,mucilaginous,multicellular,non-glandular,oblique,odd-pinnate,ovate,ovoid,pedicel,peduncle,pentagonal,petiole,plant,poricidal,pubescent,rotate,rounded,seed,singly,size,stem,stigma,straight,style,terminal,tip,trichome,truncate,tube,wet,white,whitish,x,yellow	0-5,1-4,10-16,16-28.6,2-4,2.3-3.3,3,3-4.5,5-merou,6-5-15.3,8.5-19,abaxially,acumen,acuminate,acute,adaxially,ag,along,alyx,apart,apex,apparently,attenuate,axe,axillary,blade,borne,brownish,bud,capitat,cell,chartaceous,ciliate,condition,cordate,covering,cuneate,decreasing,decurrent,dense,digestion,distal,dorsally,drying,eaf,edge,eed,end,enzyme,erec,especially,exceeding,filament,flat,flower,folded,fresh,geminat,generally,glabrous,grading,gradually,green,green-white,hair,hair-like,half,homostylous,honeycomb-shaped,invested,lengthening,like,living,lobe,long,lower,make,margin,membranous,middl,midrib,minutely,mottled,nflorescence,orbicular,orolla,pair,perfect,petiolulate,petiolule,plurifoliate,pore,puberulent,pubescence,purple,removed,ruit,sessile,seudostipule,shallowly,short,slightly,slit,spaced,specimen,spreading,stamen,ste,stolo,subsessile,subtending,tall,tamen,tem,testal,thick,throughout,tissue,toward,tri-,tuber,typically,unit,unknow,usually,vary,wall,wide,wing,ympodial	6-15.3,arrangement,articulation,bark,calyx,capitate,color,connation,dehiscence,foetid,foliage,form,fruiting,growth,height,history,inflorescence,length,life,middle,midpoint,na,ovary,papillae,position,prickle,pseudostipule,shape,spacing,straightnes,surface,texture,tuber-bearing,young
481	wfo-0001029308	success	221	114	80	141	34	0.362	0.2-1.5,0.25-1,1-5,1.5-2.5,1.5-4,2-6,2.2-2.7,30-50,4-15,4-5,7-8,acicular,acuminate,acute,adaxially,adult,anther,apart,apex,base,branch,broad-based,broadly,brown,calyx,chartaceous,cm,cuneate,densely,directed,dm,elliptic,elliptical,flattened,fruit,globose,inflorescence,juvenile,lanceolate,lateral,leaf,length,lilac,lobed,long,margin,minute,minutely,mm,ovate,pale,pedicel,peduncle,per,perennial,petiole,plant,prickle,purple,reticulate,rotate-stellate,rusty,seed,shallowly,shrub,simple,sparsely,stellate,stellate-pubescent,stigma,straight,style,surface,time,toward,tube,unbranched,wide,yellow,yellowish-green	%,0-10,0-25,0-4.5,0.05-0.3,0.2-0.3,0.25-0.3,0.25-0.35,0.25-0.4,0.4-0.7,1,1-4,1.2-2.5,1.5-2.7,1.5-3,1.5-5.5,168,19-30,1981,2-5,2-foliate,2-locular,2.5-3,2.7-3.1,20-40,3-4,3-6,3.5-4.5,4-6,4-8,4.3-15,4.5-6,5-merou,6-11,6-18,6-8,7-10,8-19,9-18,9.5-28,abaxially,absen,absent,across,adaxiall,alyx,andromonoecious,anvil-shape,articulated,axe,ba,blade,branche,capitat,confined,connivent,counted,cross-section,cylindrical,decimetre,deltate,diameter,distall,distributed,eaf,eed,eglandular,entire,erect,exocarp,extra-axillary,finger,flower,fruiting,functional,furrowed,geminat,glabrous,gland-tipped,green,hair,half,heterostylous,interpetalar,juicy,lamina,less,lobe,longer,loosely,lower,margi,mature,mesocarp,mid-point,midpoint,midrib,midvein,moderately,moist,nearly,nflorescence,oblique,one,orolla,pair,part,placenta,pore,porrect,present,rachi,ray,rhizomatous,ruit,sessile,short,side,spaced,stalked,star,stellae,tal,tamen,tem,thick,thickened,throughout,tissue,triangular,unarme,unarmed,unit,upper,vary,vein,weakly,x,yellowish,ymon,ympodial	arrangement,bark,capitate,color,connation,corolla,dehiscence,density,diminishing,distal,distally,foetid,foliage,form,growth,height,history,leaflet,life,lobing,na,ovary,papillae,petiolule,shape,size,spacing,stem,straightnes,terminal,texture,trichome,tuber-bearing,young
482	wfo-0001029310	success	216	147	112	104	35	0.519	/4,0.1-0.2,0.2-0.8,0.5,0.5-3,0.6-1.1,1-1.5,1-4,1.2-1.5,10,2-3.5,2-4,20-60,3-4,3.5,5,5-10,5-12,5-8,6-8,7-12,7-13,8,abaxially,accrescent,acute,anther,apart,apex,apically,apparently,articulated,bark,base,berry,branched,brown,calyx,cm,concolorous,conical,connivent,dark,deltate,diameter,distal,drying,dull,elliptic,enclosing,flattened-reniform,flower,fruit,fruiting,gently,glabrescent,glabrous,gray,herb,lateral,leaf,length,lobe,lobed,long,long-styled,lower,mature,maturity,mauve,membranous,midpoint,mm,orange-green,pedicel,peduncle,perpendicular,petiole,pinnatifid,plant,poricidal,porrect,prickle,ray,recurved,retrorse,sessile,short-styled,shorter,shrub,sometimes,spaced,sparsely,spherical,spreading,stalk,stalked,stellate,stellate-pubescent,stem,stout,straight,strongly,style,surface,tapering,tip,trichome,tube,way,wide,yellow	-16,-25,.1,.5,.6,/6,0-20,0-5,0.2-0.3,00,1,1-2,1.8-3,1/,10-13,10-15,10-20,15-20,2.5-6,2/3-3/4,20-40,200-500,3-5,4-10,4-8,45-60,5-20,5-30,5-6,5-7,5-merous,alyx,ame,andromonoecious,apar,beyond,blade,c.,cordate,difoliate,distance,eaf,eed,elongating,equal,erect,extending,filament,filifor,free,geminat,hair,hermaphrodite,heterostylous,inflated,infructescence,lobing,lon,longer,lowermost,margin,midvein,minute,moderately,narrow-deltate,nflorescence,older,one,open,ornately,orolla,oung,pair,pendent,pendulous,per,pericarp,portion,prickl,prickly,primary,red-brow,ruit,scar,secondary,side,simple,smooth,staminat,tamen,terete,tertiary,time,tissue,toward,truncate,unit,variously,vary,vein,venation,visible,woody,ympodial	1/3,arrangement,articulation,color,connation,corolla,diminishing,foetid,foliage,form,growth,height,history,inflorescence,interjected,leaflet,life,na,ovary,papillae,perennial,petiolule,position,pseudostipule,red-brown,seed,shape,size,spacing,stigma,straightnes,terminal,texture,tuber-bearing,young
483	wfo-0001029317	success	151	99	60	91	39	0.397	0.5,1,1-1.5,2-3,7-8,8-9,acuminate,anther,apex,area,attenuate,base,ca,calyx,cm,corolla,densely,fruiting,grayish,inflorescence,lateral,leaf,lobed,long,minutely,mm,narrowly,nearly,occasionally,opposite,ovary,ovate,overlapping,paler,papillose,pedicel,petiole,poricidal,probably,pubescent,rounded,shaped,shrub,simple,size,slightly,soft,sparsely,stem,stigma,straight,style,tear-drop,thickened,tip,trichome,tube,uniseriate,white,young	.5,0.25,0.5-0.75,0.5-1,0.8-1,1.5-3.5,10-16,10-30-flowered,11-14,2.5-5,6-8,6.5-11,along,anthesi,apar,barely,beneath,broadly,brow,bud,channeled,closely,cup-like,deciduou,deflexed,deltoid,denser,dia,differing,difoliate,dry,eaf,edicel,eed,ellipsoi,epidermi,erect,exserted,extreme,filament,free,frui,geminate,glabrate,glabrous,globose,immature,known,like,lobe,lon,lower,main,major,margin,middle,minor,nflorescence,often,older,one,otherwise,ovoid,pair,pore,portion,prominent,proximal,rachi,raised,reflexed,remaining,rest,ruit,scar,slender,soon,spaced,specimen,styl,tall,tapering,tuft,ud,unit,vein,visible,widest,x,yellowish,ympodial	apart,arrangement,articulation,bark,brown,color,connation,dehiscence,diameter,diminishing,distal,foetid,foliage,form,fruit,growth,height,history,interjected,leaflet,length,life,midpoint,na,papillae,peduncle,petiolule,plant,position,prickle,pseudostipule,seed,shape,spacing,straightnes,surface,terminal,texture,tuber-bearing
484	wfo-0001029332	success	197	100	67	130	33	0.34	0,0-5,0.5-1,1-3,1-4,1.3-1.5,1.5-2,2,2-4,3-4,5-8,anther,apex,articulated,bark,base,calyx,chartaceous,cm,connivent,cordate,curved,diameter,distal,elongating,erect,flattened-reniform,fruit,fruiting,glabrescent,glabrous,lateral,leaf,length,lobed,long,maturity,mauve,midpoint,mm,orange-brown,ovate,pedicel,peduncle,petiole,plant,poricidal,porrect,prickle,rounded,scandent,shrub,simple,spherical,spreading,stellate-pubescent,stem,style,subsessile,surface,tapering,terminal,tip,trichome,tube,unbranched,yellow	-5,.5,/3,0-0.5,0-100,0-2,0-20,0-4,0.1,0.1-0.2,0.15-0.2,0.15-0.25,0.8-1,1-1.5,1-2,1/2,1/3,1/4,1/4-1/3,10-30,2-2.5,2.5-3.5,2.8-3.7,2/,2/3-3/4,3-6,3.5-5,4-10,4-15,5-6,5-merous,6-8,8.5-9.5,abaxial,abaxially,adaxial,alyx,andromonoecious,apar,apart,apically,apparently,becoming,berry,blade,broad-deltate,concolorous,conical,densely,difoliate,distance,drying,eaf,eed,equal,extending,filament,flattened,flower,free,geminat,gland,globular,grayi,herbaceous,hermaphrodite,heterostylous,infructescence,less,lobe,long-acuminat,long-styled,longer,lower,lowermost,margin,mature,midvein,moderately,narrow-deltate,nflorescence,often,older,one,open,orolla,oung,pair,pale,pendulous,per,pericarp,portion,prickl,prickly,primary,pubescent,ray,reduced,ruit,scar,sessile,short-styled,shorter,side,slender,smooth,spaced,stalk,stalked,staminat,stellate,tamen,terete,tertiary,time,unit,upper,variously,vary,vein,venation,visible,way,weakly,wide,woody,yellow-green,yellow-orange,ympodial	arrangement,articulation,color,connation,corolla,dehiscence,diminishing,foetid,foliage,form,grayish,growth,height,history,inflorescence,interjected,leaflet,life,na,ovary,papillae,petiolule,position,pseudostipule,seed,shape,size,spacing,stigma,straightnes,texture,tuber-bearing,young
485	wfo-0001029333	success	155	98	66	89	32	0.426	/4,0.7-1,1-1.5,1-15,1-7,1.5-3,5-6,abaxially,acuminate,acute,adaxially,anther,apex,bark,base,broadly,calyx,clavate,cm,conical,corolla,dendritic,densely,elliptic-obovate,flattened-reniform,glabrous,globose,green,lateral,leaf,lobed,long,long-styled,minutely,mm,obovate,ovary,pale,pedicel,petiole,pitted,poricidal,pubescent,reddish-brown,rounded,sessile,shape,shaped,shining,short-styled,shrub,simple,size,spaced,sparsely,stem,stigma,style,surface,tear-drop,tip,trichome,truncate,tube,way,young	.25,.5,0.5,0.5-1,1-1.2,1-2,1-3,1.5-2,1.5-2.5,10-15-flowered,100,17-26,2-2.5,3-7,3-7.5,8-15,9-13,abaxial,along,anisophyllou,anthesi,auriculate,ba,beige,beneath,berry,contracted,deflexed,dendritic-pubescent,denser,dia,differing,difoliate,dry,eaf,edicel,eed,erect,exserted,filament,flower,free,fresh,fruiting,geminate,golden,heteromorphic,incrassate,inflorescenc,like,lobe,lon,lower,main,major,margin,minor,nflorescence,occasionally,older,opposite,orbicular,overlappin,pair,paler,papillo,planar,pore,portion,present,pubescence,rest,ruit,scar,slender,small,somewhat,strongly,tall,time,tree,triangular,type,ud,unit,vein,wide,woody,ympodial	anisophyllous,arrangement,color,connation,dehiscence,diameter,diminishing,distal,form,fruit,growth,height,history,inflorescence,interjected,leaflet,length,life,na,overlapping,papillae,papillose,peduncle,perennial,plant,pseudostipule,seed,spacing,straightnes,terminal,texture,tuber-bearing
486	wfo-0001029334	success	211	117	83	128	34	0.393	0-4,0.15-0.3,1,1-10,1-2,1-3,1.3-4.5,1.5-3.9,1.5-6,2-4,3-7,3.2-5.8,3.3-6.5,5-10,8-30,9-12,absent,almost,anther,articulated,axillary,broadly,brownish,bud,chartaceous,clavate,cm,condition,connivent,corolla,densely,diameter,drying,elliptic,forked,fresh,fruit,glabrous,globose,green,greenish,hair,herb,interjected,lanceolate,lateral,leaflet,like,membranous,mm,mucilaginous,odd-pinnate,orbicular,ovate,ovoid,pedicel,peduncle,petiole,plant,poricidal,puberulent,pubescent,pure,ripe,seed,size,stellate,stem,stigma,straight,style,subtending,terminal,tinged,tip,tube,typically,violet,wet,white,whitish,x,yellow	.2,1-6,1.8-2.9,2,2-2.5,2-5,2-8,2.5-3,3-5,4-5.5,4-8.5,5-merou,7.5-15.5,abaxially,acumen,acute,adaxially,ag,along,alyx,among,apart,apex,apparently,attenuate,axe,base,berry,blade,borne,capitat,cell,ciliate,cordate,covering,cuneate,decreasing,decurrent,digestion,distal,dorsally,eaf,edge,eed,end,enzyme,erect,especially,exceeding,except,filament,flat,flower,folded,geminat,generally,glabrou,gradually,grassland,greatly,green-white,hair-like,half,homostylous,honeycomb-shaped,lengthening,living,lobe,long,low-growin,lower,make,margin,middl,midrib,minutely,narrowly,nflorescence,oblique,obtuse,often,orolla,pair,perfect,petiolulate,petiolule,plurifoliate,pore,proximal,rarely,reduced,removed,rounded,ruit,semi-rosette,sessile,seudostipule,shady,short,singly,situation,slightly,slit,spaced,specimen,stamen,ste,stolo,subequal,subsessile,sunny,tall,tamen,tem,testal,thick,throughout,toward,tri-,tuber,unit,unwinged,usually,vary,wall,wide,woodland,ympodial	arrangement,articulation,bark,calyx,capitate,color,connation,dehiscence,foetid,foliage,form,fruiting,growth,height,history,inflorescence,leaf,length,life,middle,ovary,papillae,position,present,prickle,pseudostipule,shape,spacing,straightnes,surface,texture,trichome,tuber-bearing,young
487	wfo-0001029340	success	286	113	70	216	43	0.245	.2,0,1-2,2,4,absent,anther,apex,armed,articulated,base,bluish,bright,brown,calyx,capitate,cm,connivent,cordate,densely,depressed-spherical,diameter,expanding,flattened-reniform,foveolate,fruit,fruiting,glandular,hyaline,lateral,leaf,long,midpoint,minute,minutely,mixture,mm,orange-yellow,pale,pedicel,peduncle,petiole,pilose,poricidal,prickle,purple,shrub,simple,size,soft,soft-pilose,spherical,spreading,stellate,stem,stigma,strongly,style,suborbicular,surface,thin-textured,tip,trichome,tube,unbranched,uniseriate,variously,wide,yellow,yellowish	'',-celled,.05,.2–1.6,0.15–0.6,0.2–0.5,0.4,0.5,0.5–2,0.5–2.5,0.8–3.2,0–,1,1.2–2.0,1.2–2.2,1.4–1.8,1.5-3,1/2,1/4,10,100,13–15,1–,1–1.2,1–2,1–2-celled,2.5,20,2–10,2–2.2,2–3,2–3.2,2–5-celled,2–8,3,3.5–5.5,3–3.5,3–5-celled,3–5.3,3–6-celled,3–7,4–4.5,4–8,5,5-merous,5°,5–12,8–12.5,8–17,9–20,>,``,abaxial,abaxially,abruptly,acicular,acute,adaxial,age,almost,alyx,angle,anthesi,apical,apicall,around,ba,basal,becoming,berry,bilobed,blade,branched,broad-based,coarse,column,compressed,concentrated,conical,curved,curving,cylindrical,darker,developin,difoliate,directed,duller,eaf,eed,elongate,embedded,equal,evenly,exceeding,exceptionally,expanded,extending,falling,fertile,filament,flower,free,frui,geminat,geminate,glabrous,gland,gland-tipped,glandular-puberulent,grading,gradually,greater,green,greenish,hair,held,heterostylous,infructescence,irregularly,lanceolate,larger,largest,less,light,like,linea,lobe,lobed,lon,long-styled,lower,lowermost,main,major,many,margin,mature,maturity,mesocarp,midrib,mostly,much,narrowed,narrowly,near,nearly,nflorescence,nipple,occasionally,often,one,orange,orolla,oung,ovoid,pair,papillat,per,pericarp,perpendicular,pore,portion,prickly,pulp,rarely,ray,recurved,reflexed,ruit,secondary,senescent,sessile,sharp,shiny,short,short-styled,shorter,shrivelling,similar,single,slightly,small,smaller,smooth,somewhat,soon,sparsely,spongy,spreading-pilose,ste,stipitate,stipitate-glandular,stout,straight,tall,tamen,tapering,terete,thin,tinged,tooth,tough,triangular,twice,two,unarme,unarmed,unit,usually,vary,vein,viciously,way,white,whole,ympodial	0.2-0.5,0.5-2,1-2-celled,1.4-1.8,2-3.2,3-5-celled,4-8,5-12,arrangement,articulation,bark,color,connation,corolla,dehiscence,diminishing,distal,foetid,foliage,form,growth,height,history,inflorescence,interjected,leaflet,length,life,na,ovary,papillae,petiolule,plant,position,pseudostipule,seed,shape,spacing,straightnes,terminal,texture,tuber-bearing,young
488	wfo-0001029344	success	147	84	55	92	29	0.374	0.5-1,1.5-4,10-20,3-10,4-6,5-15,absent,acute,anther,apex,base,brown,calyx,center,cm,diameter,dm,drying,edge,elliptic,elliptic-ovoid,fine,flower,fruit,glabrous,globose,herb,immature,margin,maturing,mm,nearly,oblong,obtuse,parallel,pedicel,peduncle,petiole,pubescent,radiating,raised,rhizomatous,ridge,rotate,rounded,running,semitransparent,shallow,sparsely,stigma,style,surface,white,x,yellow	.5,0.4-1,0.5-1.5,0.5-3,1,1-2,1-3,1-5,1-6,1.5,1.5-3,10-35,2-3,2-3-celled,2-4,2-7,5-12,abaxially,abundant,adaxiall,adaxially,along,axe,berry,beyond,blade,chartaceous,ciliate,connected,cordate,decurrent,dehiscing,densely,denser,difoliate,eaf,eed,emarginat,entire,equal,explosively,exserted,filament,flat,frui,geminat,hair,held,interpetalar,lacking,linear-lanceolate,lobe,long,lower,lying,maturit,membranaceous,mesocarp,moderately,nflorescence,notch,obvious,often,one-,orolla,per,placenta,pressure,pubescen,rachi,ruit,short,slightly,sometimes,stamen,straight,swollen,tal,tamen,tem,tissue,triangular,tube,two-celled,unbranched,unit,vary,vein,watery,wid,woody,ympodial	arrangement,color,corolla,dehiscence,diminishing,distal,form,geminate,growth,height,history,inflorescence,interjected,lateral,leaf,leaflet,length,life,na,petiolule,plant,pseudostipule,seed,shape,size,spacing,stem,terminal,texture
489	wfo-0001029363	success	152	105	70	82	35	0.461	0.2-1.1,2-6,3-7,6-7,acuminate,acute,anther,apex,bark,base,becoming,beneath,bi-lobed,calyx,capitate,closely,cm,corolla,cup-shaped,deep,edge,elliptic,fruit,fruiting,glabrous,globose,green,greyish,internodal,larger,lateral,leaf,lobed,maroon,meeting,minute,minutely,mm,much,narrowly,obtuse,occasionally,opposite,ovary,overlapping,pedicel,petiole,poricidal,pubescent,shiny,shrub,simple,small,somewhat,spaced,stem,stigma,straight,style,surface,terminal,tip,tree,trichome,tube,tuft,uniseriate,white,white-papillose,young	.25,.75,/4,0-0.1,0.1-0.5,0.5,0.5-1,1,1-1.2,1.5-1.7,1.5-3.5,4-11,5-7-flowered,6-8,7-10,anthesi,axil,ba,beginning,berry,bud,coroll,deflexed,deltoid,densely,dia,drying,eaf,edicel,eed,erect,except,exsertion,filament,free,immature,inflorescenc,known,lamina,later,lobe,lon,long,lower,main,margin,mature,middle,near,nflorescence,often,older,pair,pale,paler,papillo,papillose,pore,portion,prominent,reflexed,ruit,scar,slender,slit-like,sparse,sparsely,tall,tapering,thickened,ud,unifoliat,unit,upon,usually,vein,way,wide,widest,woody,yellowish,ympodial	arrangement,articulation,color,connation,dehiscence,diameter,diminishing,distal,foetid,foliage,form,growth,height,history,inflorescence,interjected,leaflet,length,life,na,papillae,peduncle,petiolule,plant,position,prickle,pseudostipule,seed,shape,size,spacing,straightnes,texture,tuber-bearing,unifoliate
490	wfo-0001029364	success	153	97	76	77	21	0.497	-2,0.2-0.5,1-,1-3,1-4,1-5,1.5-2,2,2-6,3-4,4-9,5-9,6-8,?,abaxially,acuminate,adaxially,anther,apart,apex,articulated,base,calyx,chartaceous,cm,color,corolla,cuneate,cylindrical,diameter,distally,elliptic,entire,extra-axillary,finger,fruit,glabrous,gland-tipped,globose,green,hair,herb,immature,lobe,margin,minutely,mm,narrowly,nearly,obtuse,ovate,pedicel,peduncle,petiole,puberulent,pubescent,rachi,radiu,sagittate,shallow,shrub,simple,sparsely,spot,stellate,stigma,strongly,style,tapered,triangular,tube,unbranched,unknown,white,x,yellow	-3,-6,.5,1,10-27,191.,2-,2-foliat,4-12,5-,5-11,7-9,8-10,8-15,according,acute,aggregate,around,axe,ba,bitter,blade,blue,cell,center,connivent,cream,curled,darker,deep,directed,distall,eaf,ed,fide,filament,flower,free,glandular-puberulen,greenish,inserted,long,lower,major,membranaceous,mesocarp,moderately,nflorescence,orolla,part,perfect,pore,presence,present,puberulen,ripe,ruit,rusby,short-tomentose,shorter,side,small,spaced,stone,tal,tamen,tem,thecae,tightly,time,tomento,truncat,unit,vary,vein,wide,ympodial	arrangement,articulation,form,growth,height,history,inflorescence,leaf,length,life,plant,position,seed,shape,size,spacing,stem,surface,tall,texture,truncate
491	wfo-0001029368	success	139	99	64	75	35	0.46	0.5-2,1.5-3,1.5-4,2-5,2.5-4,5-6,abaxially,acuminate,acute,adaxially,along,anther,apex,bark,base,broadly,calyx,capitate,closely,cm,conical,corolla,densely,dia,distal,elliptic,erect,fruit,fruiting,glabrous,globose,golden,green,herb,inflorescence,internodal,lateral,leaf,midrib,minutely,mm,obtuse,opposite,ovary,pedicel,petiole,poricidal,puberulent,shaped,shrub,simple,somewhat,spaced,stem,stigma,straight,style,tear-drop,tip,trichome,tube,uniseriate,white,young	.2,.25,.5,0,0.9-1,1.5-1.6,1.5-2,11-13,16-25,?,anthesi,apparently,bearing,berry,bitter,borne,breaking,brow,coarse,crumpled,cup,deflexed,eaf,edicel,eed,exserted,few-branched,fide,filament,flattened,flower,free,half,indistinct,inflorescenc,known,lamina,lanceolate,leaving,like,lobe,long,lower,main,margi,margin,middle,minute,nflorescence,non-flower,older,one,overlappin,pair,papillo,papillose,parallel,pore,portion,reflexed,rest,ruit,scar,strongly,tall,ud,unifoliat,unit,upper,vein,widest,winged,woody,x,ympodial	arrangement,articulation,brown,color,connation,dehiscence,diameter,diminishing,foetid,foliage,form,growth,height,history,interjected,leaflet,length,life,na,papillae,peduncle,petiolule,plant,position,prickle,seed,shape,size,spacing,straightnes,surface,terminal,texture,tuber-bearing,unifoliate
492	wfo-0001029370	success	224	123	91	133	32	0.406	.3,0-35,0.5-2.2,1-2,1-4,1.5-6,1/4-1/3,10-40,12-17,15-30,3.5-8,5-12,7-13,8-23,almost,anther,apart,apex,articulated,bark,basal,base,berry,branched,calyx,chartaceous,cm,connivent,cordate,cream,curved,dark,densely,diameter,distal,elongating,fine,flattened-reniform,fruit,fruiting,gently,green,herb,lateral,leaf,length,lobe,lobed,long,margin,marking,maturity,mauve,mm,moderately,multangulate,obtuse,orange-brown,ornate,ovate,overlapping,pale,pattern,pedicel,peduncle,petiole,plant,poricidal,prickle,reticulate,rotate,rounded,shiny,shrub,simple,smooth,spherical,stalked,stellate-pubescent,stem,style,surface,tapering,tip,trichome,tube,variously,way,white,yellow,young	-20,-32,.1,.5,/4,0-10,0-100,0-3,0.1,0.1-0.15,0.2,0.3,0.5-1,1,1-3,1.8-2.5,1.8-2.8,1/3-1/2,10-17,10-50,2-10,2-20,2-3,2-6,2.5-3.5,3-4,3.5-4,3/,4-6,4-7,4-9,5-10,5-merous,5.5-7,6-15,7-11,8-14,8-20,abaxial,abaxially,acut,adaxial,alyx,ame,andromonoecious,apar,apically,apparently,blade,broad-deltate,c.,clearly,conical,discolorous,distance,drying,eaf,eed,elongate,equal,erect,extending,fewer,filament,flattened,flower,free,fully,glabrescent,glabrous,greenish,hermaphrodite,heterostylous,infructescence,long-styled,longer,lower,lowermost,mature,midpoint,midvein,mixture,nflorescence,often,older,one,open,opening,orange,orolla,oung,pair,pendulous,per,pericarp,perpendicular,plurifoliat,porrect,portion,prickl,prickly,primary,ray,red-brown,ruit,scar,sessile,short-styled,side,slightly,sometimes,spaced,spreading,stalk,staminat,stout,straight,strongly,tamen,terete,tertiary,time,unarmed,unit,vary,vein,venation,visible,white-gra,whitish,wide,woody,ympodial	arrangement,articulation,color,connation,corolla,dehiscence,diminishing,foetid,foliage,form,growth,height,history,inflorescence,leaflet,life,na,ovary,overlap,papillae,position,pseudostipule,seed,shape,size,spacing,stigma,straightnes,terminal,texture,tuber-bearing,white-gray
493	wfo-0001029373	success	199	85	52	147	33	0.261	5,acute,anther,apex,bark,base,berry,calyx,clavate,cm,corolla,densely,diameter,distal,ellipsoid,flattened-reniform,fruit,green,grey-brown,growth,herb,lateral,leaf,minutely,mm,moderately,obtuse,ovary,ovate-lanceolate,pedicel,peduncle,petiole,pitted,plant,poricidal,pubescent,rounded,shallowly,shape,simple,stellate,stem,stigma,style,surface,tip,trailing,tube,white,yellow,yellow-green,yellowish	.0–1.2,.2,.3,.5,.5–2.0,0.3–0.5,0.4–1.6,0.5–1.2,0.5–1.8,0.6–0.7,1.0–1.2,1.0–1.6,1.2–1.5,1.3–2.2,1.4–3.5,1.5–2.0,1.5–2.5,1.5–2.7,1.8–2.0,1.8–2.3,180°,2-celled,2.0–2.5,2.7–3.0,20–30,2–4-celled,3,3.5–4.0,30–40,3–5,4–5,4–6,5-merous,5–6,6.8,8–9,abaxial,abaxially,accrescent,acuminate,adaxial,adaxially,age,anthesi,apar,appearanc,appressed,arising,articulated,basal,bayonet,beyond,broadly,bud,capped,cell,cone,conical,curved,deltate,developing,eaf,eed,elongate,enclosed,enclosing,entire,exerted,filament,finger,flower,free,fruiting,fully,geminat,glabrous,glandular-tipped,globose,hair,half,halfway,hilum,immature,individual,internodal,laterally,lengthening,less,like,live,lobe,lobed,lon,long,lower,margin,mature,mesocarp,middle,minute,mouth,new,nflorescence,node,older,outline,pair,papillate,pentagonal,per,perfect,plurifoliate,pore,portion,positioned,primary,reflexed,resembling,root,ruit,scar,seen,seudostipule,short,slightly,slit,smoot,spaced,spreading,still,straight,tall,tem,terete,testal,thicker-walled,trichome,tub,ud,uniseriate,unit,upper,vein,wide,woody,ympodial,–5	.5-2.0,0.4-1.6,0.5-1.2,0.6-0.7,1.5-2.5,1.5-2.7,20-30,5-6,apart,arrangement,color,connation,dehiscence,diminishing,form,height,history,inflorescence,leaflet,length,life,na,papillae,petiolule,pseudostipule,seed,size,smooth,spacing,straightnes,terminal,texture,tuber-bearing
494	wfo-0001029402	success	113	84	39	74	45	0.345	0.5-1,0.5-2,2,2-10,3-6,4-6,5-25,7-8,8-15,acute,apex,articulated,base,branched,calyx,cm,color,connivent,diameter,elliptic,free,glabrous,lanceolate,mm,narrowly,pedicel,peduncle,petiole,shrub,simple,stellate,stigma,style,surface,tapered,tube,unknown,violet,x	1-2.5,11-17,15-30,2-3,3-4,3-5,4-7,4-8,6-16,7-11,7-9,abaxial,abaxially,acuminate,adaxially,apart,axe,band,blade,chartaceous,ciliolate,cylindrical,deltate,denser,directed,distall,eaf,eed,fleshy,flower,forked,glabrate,glabrou,hair,inrolled,leaving,lobe,long,lower,many-foliat,margin,moderately,narrowed,nearly,nflorescence,nther,often,orolla,papillose,pore,pubescence,pubescent,rachi,rachise,radiu,roughened,ruit,scale-like,scar,somewhat,spaced,sparsely,tal,tem,thickened,time,tip,triangular,truncat,unit,unknow,vary,wide,ympodial	anther,arrangement,articulation,bark,connation,corolla,dehiscence,diminishing,distal,foetid,foliage,form,fruit,fruiting,growth,height,history,inflorescence,interjected,lateral,leaf,leaflet,length,life,na,ovary,papillae,perennial,petiolule,plant,position,prickle,pseudostipule,seed,shape,size,spacing,stem,straightnes,terminal,texture,trichome,truncate,tuber-bearing,young
495	wfo-0001029404	success	154	98	54	100	44	0.351	-10,0.5-1,1-4,2-4,2.5-22,3-4,5-10,5-20,6-8,6-9,acuminate,anther,apart,apex,articulated,auriculate,base,branched,calyx,chartaceous,cm,connivent,cordate,cream,darker,densely,diameter,ellipsoidal,flattened,fruit,lanceolate,light,mm,orange,ovate,pedicel,peduncle,petiole,pink,pubescent,purple,shrub,simple,small,star,stellate,stigma,style,tree,tube,unbranched,white,x,yellow	-1.5,-3,-5,0-60-flower,1,1.5-2,15-25,2,2-3,2-5,2-8,2.5-3,20-35,3-5,3-8.5,4-foliat,5-24,5-6,6.5-34,8-12,abaxially,absent,acute,adaxially,aggregate,ape,apiculate,axe,basal,beyond,blade,cell,center,connective,cylindrical,dark,deltate,directed,distally,eaf,eed,eglandular,entire,exserted,fleshy,flower,glabrous,glandular,glandular-puberulen,green,hair,leaving,lemon,less,lobe,lon,long,longitudinal,lower,margin,moderately,mottling,narrowly,nflorescence,nther,obtuse,orang,orolla,ovoid,pedicellar,perfect,pore,presen,puberulent,rachi,radiu,remnant,ripe,ruit,shorter,slightly,somewhat,spaced,sparsely,stone,subcoriaceous,tal,tem,thecae,time,tomento,toward,triangular,truncat,ud,unit,vary,vein,wide,ympodial	arrangement,articulation,bark,color,connation,corolla,dehiscence,diminishing,distal,foetid,foliage,form,fruiting,growth,height,history,inflorescence,interjected,lateral,leaf,leaflet,length,life,na,ovary,papillae,petiolule,plant,position,prickle,pseudostipule,seed,shape,size,spacing,stem,straightnes,surface,terminal,texture,trichome,truncate,tuber-bearing,young
496	wfo-0001029406	success	136	92	55	81	37	0.404	0.3-1,0.6-1,1-10,1-2,acute,anther,apex,arachnoid-pubescent,bark,base,brown,calyx,clavate,cm,corolla,dark,elliptic,fruiting,glabrous,globose,grayish-brown,grayish-green,green,greenish-white,lateral,leaf,lobed,maturity,minutely,mm,often,ovary,ovoid,ovoid-reniform,pedicel,petiole,pitted,poricidal,shaped,shiny,shrub,size,slightly,small,stem,stigma,style,surface,tear-drop,tip,tree,trichome,tube,white,young	.5,0.5-1,0.7-1.5,1-1.5,1.5-2.2,1.5-2.5,1.5-5,2,2-11,2-3,2.5-3.5,28,3-9,30,4-18,4-6,7-12,abaxially,adaxially,along,anthesi,arachnoid,ba,berry,broadly,brownish,bullate,conical,conspicuously,deciduous,deflexed,deltate,densely,dia,differing,difoliate,dry,eaf,eed,felt-like,filament,free,geminat,impressed,large,lenticel,lilac,lobe,lon,long,lower,main,major,margin,matted,middle,minor,nearly,occasionally,older,pair,pale,papillo,papillose,planar,pointed,population,pore,portion,pubescent,ruit,soon,tall,tinge,unit,vein,waxy,wide,widest,woody,ympodial	arrangement,articulation,color,connation,dehiscence,diameter,diminishing,distal,foetid,foliage,form,fruit,geminate,growth,height,history,inflorescence,interjected,leaflet,length,life,midpoint,na,papillae,peduncle,petiolule,plant,position,prickle,pseudostipule,seed,shape,spacing,straightnes,terminal,texture,tuber-bearing
497	wfo-0001029407	success	208	125	89	119	36	0.428	-2,-25,-6,0-5,0.4-0.7,0.5-0.7,0.5-1.5,0.5-2,1-3,1-4,1/3-1/2,2-4,2.5-3,3-4,3-6,4-15,4.5-6,acute,anther,apart,apex,articulated,bark,base,bright-red,calyx,cm,connivent,cuneate,curved,dark,densely,diameter,dull,elongating,evenly,flattened,flattened-reniform,fruit,fruiting,glabrescent,gray-greenish,green,lateral,leaf,length,lobed,long,longer,mature,maturity,mauve,mm,obtuse,occasionally,orange,orange-brown,ovate,pale,pedicel,peduncle,petiole,poricidal,porrect,prickle,recurved,rounded,sessile,shrub,simple,sometimes,spherical,stalked,stellate-pubescent,stem,straight,straw-yellow,style,surface,tapering,time,tip,trichome,tube,unbranched,white,wide,yellow,young	-10,-4,-7,.5,/3,0,0-15,0-2,0-4,0.1-0.2,0.1-0.25,0.15-0.4,0.2-0.3,0.4-1,0.6,0.6-0.9,0.7-1.2,1,1-1.4,1-2,1-4.5,1.5,1.8-2.5,1/3,1/5,1/8-1/5,2-3,2-5,3.5-4.5,4-9,5-7,5-merous,6-13,6-20,7-8,abaxial,abaxially,acut,adaxial,almost,alyx,apar,apically,apparently,berry,blade,brow,chartaceous,deltate,difoliate,discolorous,drying,eaf,eed,elliptic,entire,equal,erect,filament,flower,free,geminat,geminate,glabrous,green-brown,infructescence,lengt,lobe,lower,margin,midpoint,moderately,nflorescence,older,one,open,orolla,oung,pair,pendulous,per,perfec,pericarp,portion,prickl,prickly,primary,pubescent,rarely,ray,reflexed,ruit,scar,shorter,side,slender,smooth,spaced,sparsely,spreading,stalk,stellate,stout,strongly,tamen,terete,tertiary,thick,unit,upper,vary,vein,venation,visible,way,weakly,woody,yellow-green,ympodial	arrangement,articulation,brown,color,connation,corolla,dehiscence,diminishing,distal,foetid,foliage,form,growth,height,history,inflorescence,interjected,leaflet,life,na,ovary,papillae,perennial,petiolule,plant,position,pseudostipule,seed,shape,size,spacing,stigma,straightnes,terminal,texture,tuber-bearing
498	wfo-0001029408	success	244	128	93	151	35	0.381	0,0.2-0.3,0.3-5,1-8,1.5-3,2-12,2-5,4-20,4-7.5,5-24,5-6.5,7-12,abaxially,accrescent,acute,adaxially,anther,apart,apex,apical-lateral,articulated,bark,base,becoming,blunt-tipped,broadly,brown,calyx,clavate,cm,continued,corolla,cuneate,deltoid,diameter,distal,due,elliptic,extend,fruit,fruiting,globose,gray,growth,honeycombed,introrse,large,lateral,leaf,length,lilac,long-attenuate,longitudinal,main,midvein,mm,mostly,oblong,ovate,pale,pedicel,peduncle,petiole,plurifoliate,pore,purplish,rarely,reniform,reticulate-punctate,ripe,rotate-stellate,short-attenuate,shrub,side,slightly,slit,small,stem,stigma,style,suborbicular,tomentose,tree,tube,unarmed,vein,velutinous,white,whitish,x,yellow,yellowish,young	-1.5,-10.5,-4.5,.2-3.5,/10,0-100,0.5-2.5,0.7-1.2,0.9-1.3,0.9-1.6,1.1-1.5,1.4-1.9,1.6-2.8,1.7-2.4,1.8-3.5,1/2,1/2-3/4,1/4,11-31,2-3.5,2-4,2.2-3.7,2.5-7,2/3,3-5,3.5-5,4-14,5-6,5-8,5-merou,acuminate,adaxiall,ag,alyx,anthesi,axe,axillary,ba,barely,berry,blade,branch,branched,bud,capitat,chartaceous,conical,dark,decurrent,dehiscing,dendritic-echinoi,dendritic-multangulate,densely,develope,directed,distall,eaf,echinoi,echinoid,eed,entire,exserted,faintly,few-rayed,filament,fleshy,flower,free,glabrous,green,hair,high,homostylous,indument,inserted,interpetalar,lacking,lanate,lanceolate,lobe,lobed,long,long-,long-stalked,lower,m.,many,margin,mixed,moderately,multangulate,near,nearly,nflorescence,obscured,obtuse,often,older,orbicular,orolla,ovate-lanceolate,overlapping,part,partly,perfect,persistent,porrect-stellate,present,pseudo-terminal,pubescent,rachi,rather,ray,relatively,ribbed,ruit,runk,sessile,short-,short-stalked,simple,sometimes,spaced,stamen,stelliform,subcampanulate,subovate,suture,tamen,terete,testa,thick,thick-stalked,thick-textured,thin-stalked,time,tissue,tomentu,tomentum,top,touching,toward,turbinate,unarme,unit,usually,vary,way,well,wide,ympodial	age,arrangement,articulation,capitate,color,connation,dehiscence,diminishing,foetid,foliage,form,height,history,inflorescence,leaflet,life,na,ovary,papillae,petiolule,plant,position,prickle,pseudostipule,pseudoterminal,seed,shape,size,spacing,straightnes,surface,terminal,texture,trichome,tuber-bearing
499	wfo-0001029417	success	213	149	114	99	35	0.535	0-7,0.2-0.6,0.4-8,0.7-3,1-10,1-2,1-8,1.3-8,1.5-10,1.5-8,12,2.5-10,3-14,3-5,6-11,8-9,acuminate,acute,anther,apex,articulated,attenuate,axillary,base,blue,borne,broadly,brownish,bud,cell,chartaceous,clavate,cm,coarsely,condition,connivent,corolla,covering,dark,decreasing,decurrent,deep,diameter,distal,drying,end,erect,forked,fresh,fruit,glabrous,globose,greatly,green,greenish,hair-like,half,herb,interjected,lanceolate,lateral,leaflet,linear,long,lunate,medium,membranous,minute,mm,narrowly,non-glandular,odd-pinnate,orbicular,ovate,ovoid,pedicel,peduncle,pentagonal,petiole,pilose,plant,poricidal,purple,rapidly,rarely,ripe,rotate,seed,sessile,short,singly,size,slightly,sometimes,stem,stigma,straight,style,subequal,subtending,terminal,testal,thick,tinged,tip,trichome,tube,typically,violet,wall,whitish,widely,x,yellow	.5,1,1-1.5,1-4,1.5-1.8,2-4,2.8-3.5,4-7,5-15,5-merou,8-15,abaxially,acumen,adaxially,ag,along,alyx,apart,apiculate,apparently,axe,basiscopic,berry,blade,capitat,central,ciliate,digestion,dorsally,dot,eaf,edge,eed,enzyme,erec,especially,exceeding,filament,flat,flower,folded,geminat,generally,glabrou,green-white,hair,hal,homostylous,honeycomb-shaped,lengthening,like,living,lobe,lower,make,margin,midrib,minutely,moderately,mucilaginous,nflorescence,often,orolla,pair,perfect,petiolulate,plurifoliate,pore,puberulent,pubescent,removed,rounded,ruit,scattered,seudostipule,short-petiolulate,side,slit,spaced,specimen,stamen,star,ste,stolo,tall,tamen,tem,throughout,tri-,tuber,unit,unwinged,usually,vary,wet,white,wide,wing,ympodial	arrangement,articulation,bark,calyx,capitate,color,connation,dehiscence,diminishing,foetid,foliage,form,fruiting,growth,height,history,inflorescence,leaf,length,life,na,ovary,papillae,petiolule,position,prickle,pseudostipule,shape,spacing,stolon,straightnes,surface,texture,tuber-bearing,young
500	wfo-0001029437	success	198	116	85	113	31	0.429	.5,0.5-1,1,1-3,1.5-2,10-12,2-3,3-5,7-10,acicular,anther,articulated,bark,base,beige,berry,blue,branched,brownish,calyx,clavate-truncate,cm,compressed,cordate,corolla,dark-green,diameter,elliptic,elliptic-lanceolate,flattened,flower,fruiting,glabrescent,globose,green,greyish,growth,inflorescence,internodal,juvenile,lamina,leaf,long-styled,maturity,midpoint,minutely,mm,oblong-lanceolate,orange,ovary,ovate,ovate-elliptic,pedicel,peduncle,petiole,plant,poricidal,prickle,reniform,reticulate,rounded,rusty,shrub,simple,stellate,stem,stigma,style,subcordate,suborbicular,subscabrous,subulate,surface,tip,tomentose,trichome,tube,velutinous,villous,violet,visible,whitish,woody,x,yellow	-10,1-1.5,1-2,1/3,2.5-3.5,2.5-5,3-3.5,3-7,30-50,4-5,5-9,6-8,9-13,abaxially,acute,adaxially,anthesi,antrorse,apar,apex,apical,armed,axi,basal,brow,c.,chartaceous,coriaceous,cylindrical,densely,distal,eaf,eed,eglandular,enclosed,entire,erect,except,filament,free,glabrous,gland,glandular,golden,heterostylous,hirsute,irregularly,leaving,lengthening,like,linear-oblong,lobe,lobed,lobed-angulate,long,loose,lower,margin,membranous,minute,multangulate,multicellular,near,nearly,new,nflorescence,oblong,obverse,older,ovoid,packed,papillo,per,perfect,pericarp,persistently,plurifoliat,pore,porrect,portion,prickly,pubescence,pubescent,recurved,rest,rotate,ruit,scar,sessile,short-styled,similar,slit,spaced,sparsely,stalked,staminate,stellate-pubescent,subglobose,subscandent,tall,tapering,testa,thick,triangular,ud,unarmed,unevenly,unicellular,unit,upper,without,ympodial,¼	apart,arrangement,articulation,brown,color,connation,dehiscence,foetid,foliage,form,fruit,height,history,interjected,lateral,leaflet,length,life,na,papillae,papillose,position,pseudostipule,seed,shape,size,spacing,straightnes,terminal,texture,young
501	wfo-0001029440	success	218	108	77	141	31	0.353	0.3-1,1-1.2,1-1.5,2-3,2-4,2-6,4-6,5-15,8-10,accrescent,acute,anther,apex,articulate,bark,base,beige,brown,calyx,clavate,cm,coriaceous,curved,cyme,dark,deciduous,deeply,diameter,distal,entire,ferruginous,finely,fruit,fruiting,glabrescent,glabrous,globose,lanceolate-attenuate,leaf,length,minutely,mm,oblong-elliptic,oval-elliptic,papillose,parted,pedicel,peduncle,perennial,persistent,petiole,plant,porrect-stellate,prickle,reduced,reticulated,rounded,rugose,scabrous,shrub,small,solitary,somewhat,sparse,stem,stigma,straight,style,sub-coriaceous,sub-truncate,subreniform,surface,terminal,trichome,tube,white,young	-10,0.2-0.3,0.5-0.6,0.9-1,1,1-2,1-2-celled,1-nerved,1.5-2,2,2-2.5,2.5-7,20,30,4-5,4-6-forked,4-8,5-5.5,5-6,5-merous,6.5-8,9-10,9-12,<,>,abaxial,acicular,across,adpressed,along,alyx,anthesi,ape,apical,armed,basal,bicolorous,blade,branch,brow,caly,canaliculate,central,compressed,dark-green,eaf,eed,elongate,enclosed,enlarged,epicarp,equal,erect,exceeding,exserted,filament,floral,flower,free,functional,fused,geminat,glandular-pubescent,glandular-stellate,glandular-tipped,gynoeci,held,indument,lanate,leathery,leaving,lobe,lobed,long,longer,lower,midrib,mucilaginous,nflorescence,numerous,oblong-lanceolate,obver,older,orolla,part,partially,peg,perfect,petiol,plurifoliate,pore,primary,prominent,rachi,rarely,ray,recurved,reddish,reflexed,ruit,secondary,sepal,sessile,shiny,short,similar,slender,sparsely,stalked,stamen,staminate,stellate,stellate-glandular,stiff,strigose,strongly,sub-terete,subcampanulate,subsagittate,surfac,tall,tamen,terete,testa,tomentose,touch,tri-,triangular,unarmed,unit,upright,vary,vein,velutinous,wide,within,without,yellowish,ympodial,¼,¾	arrangement,articulation,color,connation,corolla,dehiscence,diminishing,foetid,foliage,form,growth,height,history,inflorescence,interjected,lateral,leaflet,life,na,ovary,papillae,petiolule,position,pseudostipule,seed,shape,size,spacing,straightnes,texture,tuber-bearing
502	wfo-0001029461	success	217	116	80	137	36	0.369	-1.5,-2,-3,0,0.6-1,1-1.6,3-20,4-6.5,almost,anther,apex,attenuate,bark,base,berry,black,broad-deltate,calyx,cell,chartaceous,cm,concolorous,cuneate,curved,dark,diameter,discolorous,distal,drying,elliptic,erect,evenly,fine,flattened-reniform,fruit,fruiting,glabrescent,green,leaf,length,maturity,mauve,midpoint,mm,moderately,oblong,outline,ovate,pedicel,petiole,pit,plant,poricidal,porrect,prickle,raised,reddish,rounded,sessile,shiny,shrub,simple,small,smooth,sparsely,spherical,spreading,stalked,stellate-pubescent,stem,strongly,style,surface,tip,trichome,tube,unarmed,weakly,yellow,young	-14,-3.2,-3/4,-4,-4.5,-5,.5,0.1,0.1-0.25,0.15-0.25,0.7-1,0.8,0.8-1.5,1-,1-2,1-3,1-4,1-6,1.2-1.7,1.2-1.8,1.3-2.2,1.5-,1.5-2,1/3,1/3-2/3,1/4,1/4-1/2,2-2.4,2-2.8,2-3,2-4,2.5-3,3-6,4-10,4-7,4.5-7,4.7-7.2,5-10,5-25,5-merous,7-10,7-12,8-9,abaxially,acuminat,alyx,ame,andromonoecious,apart,apically,becoming,blade,breaking,brittle,brown,c.,densely,distance,dull,eaf,eed,elongating,extending,faint,fifth,filament,flattened,flower,four,free,glabrous,gra,hermaphrodite,heterostylous,infructescence,lengt,lobe,lobed,long,long-styled,longer,lower,lowermost,margin,mature,midvein,obovate,obtuse,older,orange,orolla,oung,pair,pendulous,per,pericarp,plurifoliat,portion,prickl,prickly,primary,ray,reduced,reflexed,ruit,shallow,short-styled,shorter,side,slender,slightly,sometimes,spaced,stalk,staman,staminat,stellate,straight,subentire,tamen,terete,tertiary,time,unarme,unequal,unit,upper,variously,vary,vein,venation,visible,way,wide,woody,ympodial,zygomorphic	arrangement,articulation,color,connation,corolla,dehiscence,diminishing,foetid,foliage,form,gray,growth,height,history,inflorescence,interjected,lateral,leaflet,life,na,ovary,papillae,peduncle,perennial,petiolule,position,pseudostipule,seed,shape,size,spacing,stigma,straightnes,terminal,texture,tuber-bearing
503	wfo-0001029462	success	166	108	64	102	44	0.386	-30,-4,0.5-1,0.5-2,1-,1-6,1.5-3,1.5-7,10-,15-25,2-6.5,3-18,3-4,3-7,4-15,5-30,6-9,acuminate,apart,apex,articulated,base,calyx,campanulate,chartaceous,cm,connivent,cuneate,dark,diameter,ellipsoidal,elliptic,flattened,fruit,green,lanceolate,light,long,longitudinal,membranaceous,mm,near,ovate,pedicel,peduncle,petiole,purplish,reticulate,rounded,simple,small,stellate-,stigma,stripe,style,time,tree,truncate,tube,unbranched,white,wide,x,yellow	-2,-5,1,1-2,1-3,1.5,1.5-2,10-22,2-3,2.5-3.5,2.5-5.5,20-35,3,3-27,3-5,3-6,4-20,4-foliat,7-19,7-8,8-9,abaxially,abruptly,absent,acute,adaxially,aggregate,ape,axe,basal,beyond,blade,broad,cell,ciliate,connective,constricted,curled,cylindrical,densely,dentate,directed,eaf,eed,eglandular,entire,equal,exceeding,exserted,flower,glabrous,hair,laterally,leaving,lobe,lon,lower,m.,margin,minutely,moderately,narrowly,nflorescence,nther,obtuse,occasionally,often,orolla,oval,ovoid,pedicellar,perfect,pore,puberulent,pubescent,pubescent-pilo,pubescent-pilose,purpl,rachi,radiu,remnant,ruit,shorter,slightly,smooth,somewhat,spaced,sparsely,stamen,stone,tal,tem,thecae,tip,tomentose,triangular,truncat,ud,unit,vary,without,ympodial	anther,arrangement,articulation,bark,color,connation,corolla,dehiscence,diminishing,distal,foetid,foliage,form,fruiting,growth,height,history,inflorescence,interjected,lateral,leaf,leaflet,length,life,na,ovary,papillae,petiolule,plant,position,prickle,pseudostipule,seed,shape,size,spacing,stem,straightnes,surface,terminal,texture,trichome,tuber-bearing,young
504	wfo-0001029464	success	235	118	87	148	31	0.37	-5,.9,0,0-80,0.2-0.5,1-10,10-40,12-50,2-3.5,3-5,6-15,ame,annual,anther,apex,articulated,bark,base,black,broad,brown,c.,calyx,chartaceous,cm,connivent,cordate,curved,dark,diameter,distal,ellipsoid,elongating,flattened-reniform,fruit,fruiting,glabrescent,globular,green,green-brown,herb,lateral,leaf,length,lobed,long,maroon,maturity,mauve,midpoint,mm,moderately,mottled,oblong,obtuse,orange-brown,ovate,ovoid,pedicel,peduncle,petiole,pink,plant,poricidal,porrect,prickle,purple,ray,sessile,simple,sometimes,stalked,stellate-pubescent,stem,straight,striped,style,surface,tapering,terminal,tip,trichome,tube,usually,variously,white,young	-2/3,-3,-30,0-2,0.2,0.2-0.7,0.3-0.7,0.3-1,0.5,0.5-2,0.8-2,00-200,1,1-3,1-8,1.2-3,1.5-2,1/,1/4,1/4-1/2,1/4-1/3,10-15,10-23,10-50,2,2-3,2-4,2.2-2.5,2.4-4,2.5-5,2.5-8,2.9-3.2,3-20,3-7,3.5-5,4-7,4-8,4-8-merous,5-17,5-8,5.5-6,5.5-7.5,7-10,8-13,8-15,9-15,abaxial,abaxially,acicular,acute,adaxial,alyx,andromonoecious,apar,apart,apically,apparently,around,berry,blade,branched,broad-deltate,brow,cultivar,cup-shaped,deltate,difoliate,discolorous,distance,drying,eaf,eed,elongated,equal,erect,extending,filament,flower,free,fully,geminat,glabrous,glaucous,hair,hermaphrodite,heterostylous,infructescence,less,lobe,long-acuminat,long-styled,longer,lower,lowermost,margin,mature,midvein,minute,narrow-deltate,nflorescence,occasionally,often,older,one,open,opening,orolla,oung,pair,pendent,pendulous,per,pericarp,portion,prickl,prickly,primary,red-brown,rounded,ruit,scar,short-styled,side,smooth,spaced,sparsely,spreading,stalk,staminat,stellate,tamen,terete,tertiary,time,translucent,unarmed,unit,upper,vary,vein,venation,visible,way,wide,woody,yellow-green,yellow-orange,ympodial	arrangement,articulation,color,connation,corolla,dehiscence,diminishing,foetid,foliage,form,growth,height,history,inflorescence,interjected,leaflet,life,na,ovary,papillae,petiolule,position,pseudostipule,seed,shape,size,spacing,stigma,straightnes,texture,tuber-bearing
505	wfo-0001029505	success	169	79	53	116	26	0.314	.05,.1,0-0.3,0.5-1.1,2-4,5.5-7,6-18,absent,anther,apart,articulated,base,calyx,chartaceous,cm,cuneateor,cylindrical,densely,diameter,directed,elliptical,extra-axillary,fruit,fruiting,globose,half,inflorescence,length,less,mature,midpoint,minute,mm,obtuse,ovate,pale,pedicel,peduncle,perennial,petiole,plant,present,prickle,red,rotate-stellate,shrub,simple,stellate,stellate-pubescent,style,unbranched,white,yellow	%,0-10,0-3,0-3.5,0.15-0.2,0.15-0.25,0.2-0.3,0.3-0.5,0.8-1,1-1.2,1-3,1-6,1-locular,1.5-2.2,2-5,2-7,2.4-3.2,2.7-4,22-25,4.5-5.5,5-7.5,5-merou,6-8,7-12,7-20,7-8,8-10,abaxially,absen,acicular,across,adaxiall,adaxially,adult,alyx,andromonoecious,apex,axe,ba,blade,branche,brown,confined,cross-section,decimetre,deltate,distall,eaf,eed,elliptic,elliptica,entire,exocarp,finger,flower,functional,glabrous,gland-tipped,green,hair,heterostylous,incomplete,juicy,lamina,lateral,lobe,long,longer,lower,margin,mesocarp,midrib,midvein,moderately,moist,nflorescence,oblique,onl,orolla,part,per,placenta,pore,porrect,prostrate,pseudo-racemose,ray,ruit,semi-circular,septum,sessile,short,solitary,spaced,sparsely,stellae,stoloniferous,straight,tal,tamen,tem,thick,throughout,time,transparent,tube,unarme,unarmed,unit,unknow,vary,weakly,wide,x,yellowish,ympodial	arrangement,articulation,color,corolla,dehiscence,distally,foetid,foliage,form,growth,height,history,leaf,life,na,position,seed,shape,spacing,stem,stigma,straightnes,surface,texture,trichome,young
506	wfo-0001029524	success	212	136	100	112	36	0.472	-5,-6,-8,0.1-0.3,0.7-0.8,1-,1-2,2-,2-4,3-8,4-4.5,4-6,7-9,acuminate,acute,adult,anther,apex,articulated,bark,base,beige,berry,brown,calyx,campanulate,cm,congested,corolla,corymbose,cyme,diameter,distal,doubling,flattened,flower,flowering,fruiting,glandular,globose,green,growth,internodal,lanate,light,linear-oblong,lobed,long-styled,loosely,maturity,mm,oblique,obtuse,occasionally,ovary,ovate,ovate-elliptic,ovate-lanceolate,pedicel,peduncle,petiole,plant,poricidal,porrect,prickle,recurved,reniform,reticulate,rounded,rugose,rusty,short-styled,shrub,size,somewhat,spaced,stellate,stellate-pilose,stem,stigma,style,sub-cordate,subcordate,suborbicular,subscabrous,surface,tapering,tip,trichome,tube,unevenly,villous,way,white,woody,x,yellow,yellow-green,yellowish,¾	.5,0.2-0.3,0.9-1.2,1-1.5,1-3,1.2-1.5,1.5-2,10,12-25,2-2.5,2-3,25,3-,3-3.5,4-7,5-15,6,6-7,9-10,abaxially,acicular,adaxially,angulate,anthesi,basal,branched,cell,channelled,clavate-truncat,decumbent,densely,discolorous,distall,eaf,eed,eglandular,elongating,entire,erec,erect,exceeding,exserted,filament,filamentous,flexuous,foliaceous,free,glabrescen,glabrous,glandular-hirsute,grey,heterostylous,impressed,leaving,like,lobe,long,long-stalked,lower,m.,margin,membranous,midpoint,minute,mixture,multicellular,new,nflorescence,numerous,oblong,oblong-lanceolate,obverse,older,one,partially,perfect,pericarp,plurifoliat,pore,portion,prickly,pubescence,pubescent,ruit,scar,sessile,single,slightly,slit,sparsely,stalked,staminate,stellate-pubescent,subbsessile,subcoriaceous,subspherical,tall,testa,time,tiny,tomentose,triangular-lanceolate,turbinate,ud,unarmed,unit,upper,vein,velvety,venation,viscid,ympodial	arrangement,articulation,clavate-truncate,color,connation,dehiscence,diminishing,distally,foetid,foliage,form,fruit,glabrescent,height,history,inflorescence,interjected,lateral,leaf,leaflet,length,life,na,papillae,petiolule,plurifoliate,position,pseudostipule,seed,shape,spacing,straightnes,terminal,texture,tuber-bearing,young
507	wfo-0001029546	success	203	115	96	107	19	0.473	0.3-1,1-10,1-3.2,1-4.5,1.5-6.2,1.6-6.5,2-9,4-10,4.5-12.5,4.5-7,5-10,6.3-19.5,7-10,8,8-17,8-19.5,abaxially,absent,acuminate,acute,adaxially,anther,apex,base,blue,broadly,brownish,cell,chartaceous,clavate,cm,condition,cordate,corolla,covering,decreasing,densely,diameter,distal,drying,elliptic,elliptical,forked,fresh,fruit,globose,greatly,green,greenish,hair-like,herb,interjected,lanceolate,lateral,leaf,leaflet,long,lunate,membranous,mm,oblique,odd-pinnate,ovate,ovoid,pedicel,peduncle,pentagonal,petiole,petiolule,plant,poricidal,pubescent,rarely,regular,ripe,rotate-pentagonal,seed,simple,size,slightly,stem,stigma,straight,style,subequal,terminal,testal,thick,tinged,tip,typically,wall,white,whitish,x,yellow	0-2,1-2,1-5,1.5-2,2-4,2.2-2.8,3-8,3.5-5,5,5-18,5-8,5-merou,acumen,adaxiall,ag,alyx,apart,apiculate,apparently,articulated,attenuate,axe,axillary,berry,blade,bud,capitat,connivent,covered,curved,decumben,decurrent,digestion,dorsally,dot,eaf,edge,eed,enzyme,erect,exceeding,filament,flat,flower,folded,frequently,geminat,generally,glabrou,glabrous,glandular,green-white,hair,half,homostylous,honeycomb-shaped,lengthening,like,living,lobe,longer,lower,make,middl,minutely,mottle,mucilaginous,nearly,nflorescence,non-glandular,often,orbicular,pair,perfect,plurifoliate,pore,purple,rachi,removed,ruit,sessile,seudostipule,short,slit,soft,sometimes,spaced,specimen,stamen,ste,subtending,tall,tamen,tem,throughout,tri-,trichome,truncate,tube,unit,unwinged,usually,vary,wet,wide,wing,ympodial	arrangement,calyx,capitate,color,dehiscence,diminishing,form,growth,height,history,inflorescence,length,life,pseudostipule,shape,spacing,straightnes,surface,texture
508	wfo-0001029552	success	161	116	78	83	38	0.484	0.6-1,1-1.5,1-3,1-5,1.5-2,12,abaxially,acuminate,acute,adaxially,along,anther,apex,area,bark,base,branched,broadened,calyx,closely,cm,corolla,dendritic,densely,elliptic,erect,flattened-reniform,fruiting,glabrous,globose,green,incrassate,inflorescence,lateral,leaf,lobe,lobed,long,long-styled,margin,minutely,mm,nearly,occasionally,opposite,ovary,pale,paler,pedicel,petiole,pitted,poricidal,pubescent,shape,shaped,shining,short-styled,shrub,simple,size,small,spaced,sparsely,stem,stigma,style,surface,swollen,tan,tear-drop,tip,tree,tree-like,trichome,tube,vein,white,young	.25,.5,0.1-0.5,0.5,1-1.3,1-2,1.5-6.5,10-20,2-2.5,2-9,2.5-3,5-10-flowered,5.5-8,6-9,abaxial,abruptly,anthesi,berry,broadly,clavate,conical,contracted,decurrent,deflexed,deltate,denser,dia,differing,difoliate,drying,eaf,edicel,eed,exserted,filament,flower,free,geminat,greyish-brow,heteromorphic,inflorescenc,lamina,later,like,lon,lower,main,major,middle,minor,minute,nflorescence,older,onto,orbicular,overlappin,pair,papillo,persistent,planar,pore,portion,present,reflexed,rest,rounded,ruit,scar,scattered,slender,slightly,somewhat,strongly,tall,tub,ud,unit,wide,widest,woody,x,yellowish,ympodial	alternate,arrangement,articulation,color,connation,dehiscence,diameter,diminishing,distal,foetid,foliage,form,fruit,greyish-brown,growth,height,history,interjected,leaflet,length,life,midpoint,na,overlapping,papillae,papillose,peduncle,petiolule,plant,position,prickle,pseudostipule,seed,spacing,straightnes,terminal,texture,tuber-bearing
509	wfo-0001029558	success	184	111	76	108	35	0.413	0.05-0.1,0.1-0.2,0.1-0.9,1-1.1,1-1.5,1.5-2,2-4,acute,anther,apex,articulated,bark,base,berry,calyx,capitate,closely,cm,corolla,densely,diameter,elongate,equal,flattened,fruiting,geminate,globose,growth,inflorescence,internodal,leaf,lobed,midpoint,minutely,mm,narrowly,nearly,obovate,obspathulate,obtuse,ovary,overlapping,pale,pedicel,peduncle,petiole,pitted,poricidal,porrect,prickle,pubescent,ray,red,reddish,reniform,rhombic,rounded,sessile,shape,shorter,shrub,simple,size,spaced,stellate,stem,stigma,style,surface,tan,tapering,thin,tip,trichome,tube,white	.5,0.1-,0.15-0.2,0.2-,0.3-0.5,0.4,0.4-0.6,0.4-1.1,0.5,0.5-2,1,1-3,1-4,10-16,2,2-3,2.5-3.5,4-merous,6-10,6-9,<,?,abaxially,adaxially,along,anthesi,armed,bearing,branched,cell,conical,deflexe,difoliate,divaricately,eaf,easily,eed,ellipsoid,elliptic,enclosed,entire,erect,filament,filiform,flower,free,geminat,glabrescent,glabrous,gre,highly,hyaline,including,interlocking,larger,later,leave,lengthening,like,lobe,long,long-triangular,lower,margin,mere,midvein,mixture,new,nflorescence,node,occasionally,older,pair,paired,papillo,per,perfect,pericarp,planar,pore,portion,prickly,primary,rest,rhachi,ruit,scar,shiny,short-stalked,sinus,slit,small,sparsely,square,stalked,straight,testal,tiny,ud,unit,upper,usually,vein,visible,wall,widening,x,ympodial	arrangement,articulation,color,connation,dehiscence,diminishing,distal,foetid,foliage,form,fruit,grey,height,history,interjected,lateral,leaflet,length,life,na,papillae,papillose,perennial,petiolule,plant,position,present,pseudostipule,seed,spacing,straightnes,terminal,texture,tuber-bearing,young
510	wfo-0001029569	success	265	108	63	202	45	0.238	2,3.2,5.1,8.1,acuminate,aequilateral,anther,apart,apex,articulate,bark,base,blade,calyx,chartaceous,cm,corolla,cuneate,dentate,diameter,distal,dry,elliptic,entire,evenly,extra-axillary,flattened-reniform,flower,fruit,globose,lateral,length,long,mature,midpoint,mm,oblique,orange,ovate,pedicel,peduncle,petiole,probably,red,reticulate,rounded,shrub,simple,spaced,spreading,stellate,stem,stigma,straight,style,surface,tube,unarmed,well,white,yellow,yellow-tan,young	.0,.2,.3,.4,.9,/2,/3,0.03,0.05,0.1,0.2,0.2–0.5,0.3–0.5,0.4–0.6,0.5–0.8,0.6–0.8,0.6–0.9,0.7–0.9,0.8–1.0,0.9,0.9–1.3,0.9–1.4,0.9–2.0,1.0–1.3,1.3–1.8,1.4–2.4,1.5–1.7,1.6,1.6–4.5,1.7–2.3,1.8–2.5,1/2–2/3,1/3,130,14.6–16.5,2.0–3.2,2.3–3.0,2.3–4.4,3.2–3.8,3.4–3.7,4.0,4.5,4.9,4–6,5-merou,5.0,5.3–16.6,5.7–6.6,6.3–18.5,6.8–7.8,6–12,6–8,7.4–9.1,7–10,90°,abaxially,across,adaxially,adnate,ag,along,alyx,anthesi,apical,apiculate,apparently,appearing,around,attenuate,axe,ba,basal,becoming,berry,branch,branching,broad,brochidodromous,bud,capitat,channeled,clinate,deciduous,densely,development,difoliate,directed,distally,distinct,eaf,edge,eed,either,emerging,endocarp,exocarp,extending,fertile,filament,filiform,flexed,free,geminat,glabrous,glandular,glossy,gradually,hair,homostylous,increasing,intact,internode,interpetalar,intersepalar,juic,lacking,lamina,layer,less,light,lobe,lon,longer,lower,many,margin,middle,midrib,midvein,minute,moderately,nearly,nflorescence,oblong,orolla,ove,per,perforated,pore,porrect,porrect-stellate,portion,potentially,pubescent,raised,ray,reduced,reflexe,remaining,restricted,rigid,row,ruit,scarcely,sessile,short,short-stipitate,shorter,side,sinuate,sinus,sloughing,smoot,sparsely,splitting,spread,stamen,stellae,stellate-pubescent,stipe,stipitate,suture,tamen,tardily,tem,terete,thin,time,tip,tissue,toward,translucent,transparent,triangular,truncate,two,ud,unit,upper,various,vary,vein,weakly,well-developed,wide,yellow-ferruginous,ympodial,±90°,±equal,±glabrous,±well,×	0.3-0.5,0.4-0.6,0.9-1.3,0.9-1.4,0.9-2.0,14.6-16.5,2.3-3.0,5.7-6.6,6.3-18.5,arrangement,articulation,capitate,color,connation,dehiscence,diminishing,foetid,foliage,form,fruiting,growth,height,history,inflorescence,interjected,leaf,leaflet,life,na,ovary,papillae,petiolule,plant,position,prickle,pseudostipule,seed,shape,size,spacing,straightnes,terminal,texture,trichome,tuber-bearing
511	wfo-0001029584	success	180	100	72	108	28	0.4	0-30,1,1-2,1-6,1.5-6.5,3-10,3-5,3-7,4-14,4.5-11.5,6.1-9.4,7-14,8-15,9.8-17,abaxially,adaxially,anther,brownish,clavate,cm,condition,connivent,coriaceous,corolla,dark,densely,diameter,drying,elliptic,forked,fresh,fruit,glabrescent,green,greenish,hair,herb,interjected,lateral,leaf,leaflet,light,mm,mucilaginous,oblong-lanceolate,odd-pinnate,ovate,ovoid,pedicel,peduncle,pentagonal,petiole,plant,poricidal,pubescent,purple,seed,short,simple,size,stigma,straight,style,substellate,terminal,tip,tube,wet,white,whitish,x,yellow	1-3,16.2-33,2-3,2-4,2.4-6.3,4-15,4-5,5-merou,5.3-13.3,6-7,9.7-23.4,acumen,acuminate,acute,ag,alyx,apart,apex,apparently,articulated,asymmetric,attenuate,axe,axillary,base,basiscopic,blade,borne,bud,capitat,cell,considerably,covering,decreasing,dense,digestion,distal,dorsally,eaf,edge,eed,end,enzyme,erry,filament,finer,flat,flower,folded,geminat,generally,glabrous,green-white,hair-like,hal,half,homostylous,honeycomb-shaped,larger,lengthening,linear,living,lobe,long,lower,make,margin,middle,nflorescence,orbicular,orolla,pair,perfect,petiolulate,plurifoliate,pore,present,proximal,removed,second,semi-erec,sessile,seudostipule,side,singly,slit,spaced,specimen,stolo,subtending,tall,tamen,tem,testal,thick,throughout,tissue,toward,tri-,tuber,typically,unit,unknow,unwinged,usually,vary,wall,ympodial	arrangement,bark,calyx,capitate,color,connation,dehiscence,form,growth,height,history,inflorescence,length,life,na,ovary,papillae,pseudostipule,semi-erect,shape,spacing,stem,straightnes,surface,texture,tuber-bearing,unknown,ye
512	wfo-0001029592	success	207	89	51	156	38	0.246	0.5-1.5,0.5-1.8,1-10,1-3,1.1-2.8,2-3-branched,2.1-4,3-6,6.5-8.5,acute,anther,apart,apex,articulated,base,black,brown,calyx,chartaceous,cm,cordate,diameter,directed,distally,extra-axillary,fruit,fruiting,globose,inflorescence,lateral,leaf,length,long,minute,mm,obtuse,ovate,pedicel,peduncle,perennial,petiole,prickle,purple,shrub,simple,stellate,style,surface,tube,unbranched,yellow	%,.05,.4,0,0-0.1,0-0.15,0-0.3,0-3.5,0.1-0.2,0.25-0.5,0.25-0.7,0.3-0.6,0.4-0.7,0.5-0.8,0.5-1,0.8-0.9,0.8-1.2,0.8-1.5,1-1.5,1-1.9,1-8,1-locular,1.5,1.5-3,1.8-2.4,1.8-6.5,1.8-8,14-20,18-30,2-10,2-3.5,2-foliate,240-1400,3-4,3.5-5.5,4-8,5-8,5-merou,5.5-10.5,5.5-11.5,6-8,7-10,7-17,7-25,7-9,8,8-10,8-20,abaxially,absent,acicular,across,adaxiall,adaxially,adult,alyx,apparen,apparently,armed,attenuate,axe,ba,blade,branch,branche,decimetre,deeply,deltate,densely,depression,distall,distributed,dm,eaf,eed,eglandular,entire,erect,exocarp,finger,flower,geminat,glabrous,gland-tipped,green,hair,half,hemispherical,homostylous,incomplete,index,juicy,juvenile,lamina,less,lobe,lobed,lobing,longer,lower,margin,markedly,mature,mesocarp,mid-point,midpoint,midvein,moderately,nflorescence,oblique,orolla,pair,part,per,perfect,placenta,pore,porrect,presen,present,ray,rhizomatous,ridged,ruit,septum,sessile,shallowly,short,side,spaced,sparse,sparsely,stalk,stellae,stellate-pubescent,straight,succulent,tal,tamen,tem,terete,thick,thicker,thicknes,throughout,time,transparent,unarme,unit,upper,vary,vein,white,wide,x,ympodial	arrangement,articulation,bark,color,connation,corolla,dehiscence,diminishing,distal,foetid,foliage,form,growth,height,history,interjected,leaflet,life,na,ovary,papillae,petiolule,plant,position,pseudostipule,seed,shape,size,spacing,stem,stigma,straightnes,terminal,texture,trichome,tuber-bearing,unarmed,young
513	wfo-0001029593	success	181	100	64	117	36	0.354	-10,0.5-5,1,1-1.5,2-3,2.3,3-4,3.5-8,4-6,5-15,7.5-15,9-15,abaxially,acuminate,acute,anther,apex,attenuate,axillary,base,broadly,brown,calyx,capitate,cm,conical,densely,diameter,elliptic,fruit,fruiting,glabrous,globose,green,lateral,leaf,leaflet,long,mm,obovate,ovary,ovoid-reniform,papillose,pedicel,petiole,petiolule,pinnate,plant,poricidal,pubescent,seed,shape,shrub,simple,slightly,stigma,style,surface,terminal,tip,trichome,tube,uniseriate,x	0.05,0.5-1,0.8-1,0.8-1.2,1-1.2,1-2,1-8,1.6-2.3,10-50,100,2,2-14,2-5,2.3-3.0,35-60,5-10,7-25,abruptly,adaxially,age,always,anthesi,anticlinal,apically,arising,axil,basal,basiscopically,bearing,berry,cateniform,cell,clavat,colony,cone,decurrent,deltate,dry,drying,eaf,edicel,eed,enlarged,entire,epidermal,exserted,extremely,filament,filiform,flower,free,glabrescent,growing,half,hollow,included,irregular,lamina,large,lobe,lower,markedly,minutely,much,narrowing,nflorescence,noddin,oblique,occasionally,often,once-branched,onto,open,opposite,pair,per,perfectly,place,pointed,portion,primary,projection,pubescen,pubescence,purple,rachi,rarely,reflecting,rest,ruit,scar,short-styled,similar,single-stemmed,sinuous,small,smaller,smooth,somewhat,sparsely,tall,tem,thickening,tub,ud,unifoliat,unit,usually,variable,vein,white,white-lenticellate,wider,winged,without,woody,ympodial	arrangement,articulation,bark,clavate,color,connation,corolla,dehiscence,diminishing,distal,foetid,foliage,form,growth,height,history,inflorescence,interjected,length,life,midpoint,na,nodding,papillae,peduncle,perennial,position,prickle,pseudostipule,size,spacing,stem,straightnes,texture,tuber-bearing,young
514	wfo-0001029601	success	187	119	83	104	36	0.444	0-37,0.2-0.8,0.5-5.8,1-2,1-3,1.2-2.3,1.7-6.5,2-12,2-9,2.2-4.5,2.8-10.5,3-10,3-5,3-7,5-41,6.8-14.5,abaxially,adaxially,anther,articulated,attenuate,base,brownish,cell,clavate,cm,condition,connivent,coriaceous,corolla,covering,diameter,dot,drying,elliptic,forked,fresh,fruit,glabrous,globose,green,greenish,hair-like,herb,interjected,lanceolate,lateral,leaf,leaflet,light,middle,mm,odd-pinnate,ovate,ovoid,pedicel,peduncle,pentagonal,petiole,plant,poricidal,puberulent,ripe,rotate,rounded,seed,size,slightly,small,stigma,straight,style,terminal,testal,thick,tip,tube,typically,wall,white,whitish,x,yellow	0.5-8,1-4,1-53,1.1-2.7,2,2-3,2-7,2.3-5.9,4-13.5,5-merou,6-10,6.6-22,abaxiall,acumen,acuminate,acute,ag,alyx,apart,apex,apparently,asymmetric,axe,axillary,basiscopic,berry,blade,borne,bud,capitat,dark,decreasing,digestion,distal,dorsally,eaf,edge,eed,end,enzyme,erec,exceeding,filament,flat,flower,folded,geminat,generally,glabrescent,glabrou,green-white,hair,half,homostylous,honeycomb-shaped,larger,lengthening,linear,living,lobe,long,lower,make,middl,mucilaginous,narrow,nflorescence,orbicular,orolla,pair,perfect,petiolulate,plurifoliate,pore,removed,ruit,sessile,seudostipule,short,side,singly,slit,spaced,specimen,stamen,stolo,subequal,subglabrou,subtending,tall,tamen,tem,throughout,tissue,toward,tri-,tuber,unit,unwinged,usually,vary,wet,wing,ympodial	arrangement,articulation,bark,calyx,capitate,color,connation,dehiscence,erect,foetid,foliage,form,fruiting,growth,height,history,inflorescence,length,life,midpoint,na,ovary,papillae,position,prickle,pseudostipule,shape,spacing,stem,straightnes,subglabrous,surface,texture,trichome,tuber-bearing,young
515	wfo-0001029606	success	179	117	81	98	36	0.453	/2,0.2-0.5,0.4-0.5,0.5-1,1,2-2.5,2-3,3,7,7-9,acuminate,acute,along,anther,apex,armed,articulated,bark,base,beneath,berry,bilobed,broadly,brown,brownish,calyx,closely,cm,color,coriaceous,corolla,diameter,elliptic,elongate,elongation,flattened,flower,form,fruiting,glabrous,globose,growth,inflorescence,internodal,leaf,lobe,lobed,long,long-styled,midpoint,midrib,minutely,mm,narrowly,oblong,once-branched,orbicular,pedicel,peduncle,petiole,poricidal,prickle,pubescent,reddish,reniform,shiny,simple,stalked,stellate,stem,stigma,style,surface,tapering,terminal,tip,trichome,tube,way,white,woody	.5,0.5,1.5-2,1.5-3,1.5-3.5,1.8-2.5,15,3-9,4-5,4-6,4-8,4.5-5,5,5-6,abaxially,aciculate,adaxially,anthesi,apparently,arching,cell,deciduous,defoliate,dense,densely,eaf,eed,ellipsoidal,entire,equalling,erect,especially,exerted,filament,free,geminat,gre,herbarium,heterostylous,impressed,inshort-styled,known,lengthening,like,long-stalked,lower,m.,many,margin,marginal,mixture,multangulate,multiseriate,new,nflorescence,nodding,older,pair,papillat,per,pericarp,pore,porrect,portion,primary,prominent,pubescence,ray,red,redder,revolute,ruit,rusty,scar,sessile,shrub,slightly,slit,sometimes,soon,space,specimen,stalk,stellate-pubescent,straggling,straight,strongly,testal,thin,triangular,ud,unit,urceolate,usually,vein,x,yellowish,ympodial	arrangement,articulation,connation,dehiscence,diminishing,distal,foetid,foliage,fruit,grey,height,history,interjected,lateral,leaflet,length,life,na,ovary,papillae,papillate,petiolule,plant,position,pseudostipule,seed,shape,short-styled,shrubby,size,spaced,spacing,straightnes,texture,tuber-bearing,young
516	wfo-0001029619	success	188	125	87	101	38	0.463	0.25-0.75,0.5-2,1,1-2,1-2.5,1-3,1-5,10-12,2-11,2-5,3-4,5-20,7,7-10,accrescent,acute,anther,apart,apex,attenuate,base,brown,bud,calyx,chartaceous,cm,connivent,contiguous,densely,diameter,extra-axillary,flower,fruit,fruiting,geminate,gland-tipped,globose,green,hair,immature,leaf,leaf-opposed,length,lobe,lobed,long,many,mature,midpoint,mm,moderately,nearly,netlike,obtuse,orange,ovate,pedicel,peduncle,petiole,pit,porrect-stellate,prickle,pubescent,raised,recurved,reniform,ridge,roselike,rusty,scandent,separated,shrub,small,spaced,spreading,stem,stigma,style,surface,tan,tapering,triangular,tube,unbranched,white,x,yellow	0.5-1,0.5-1.5,1-.,1-1.5,1-3.5,1.5-2,2,2-3,25-40,3-8,4-6,5-merou,6,6-10,6-8,7-12,8-12,abaxially,absent,adaxiall,adaxially,alyx,andromonoecy,apar,apical,apparently,appearing,armed,axe,berry,beyond,blade,clavat,cordate,cut,cylindrical,dark,difoliate,directed,discolorous,eaf,eed,either,elongated,em,exserted,filament,flattedned,frui,glabrou,glabrous,glandular,implying,introrsel,less,like,lower,m.,major,margin,midrib,midvein,multicellular,multiseriate,narrowly,nflorescence,occasionally,often,orolla,pair,per,perfect,pore,rachi,ray,reduced,ruit,side,simple,sinus,slightly,sparse,sparsely,stalk,stamen,ste,stellate,tamen,unarmed,unequa,unicellular,unit,unlobed,usually,vary,vein,way,whitish,wide,ympodial,¼	arrangement,articulation,bark,clavate,color,connation,corolla,dehiscence,diminishing,distal,foetid,foliage,form,growth,height,history,inflorescence,interjected,lateral,leaflet,life,na,ovary,papillae,petiolule,plant,position,pseudostipule,seed,shape,size,spacing,straightnes,terminal,texture,trichome,tuber-bearing,young
517	wfo-0001029621	success	165	116	79	86	37	0.479	.1,0.5-1.5,0.7-1.1,1-1.5,1.5-2.5,1.5-5,2/3,7-9,accrescent,acute,anther,apex,appressed,area,attenuate,bark,base,becoming,brown,calyx,cluster,cm,corolla,dark,decurrent,distal,dry,fruit,fruiting,glabrous,globose,green,lanceolate,later,lateral,leaf,live,lobed,long,material,merely,minutely,mm,oblanceolate,onto,ovary,ovoid-reniform,pale,papillate,pedicel,pitted,plant,poricidal,reddish,ripe,sessile,shaped,shiny,shrub,somewhat,stem,stigma,straight,style,surface,tan,tear-drop,terminal,tip,trichome,tube,uniseriate,way,white,whorl-like,widened,woody,yellowish,young	0.5-0.75,0.5-1,0.5-1.2,0.8-1,0.8-4.5,1-2,1.5-2,1/3,2.5-3,3-3.5,3.5-4.5,5-20-flowered,6-20,6-8,along,anthesi,apar,appearing,beneath,berry,borne,branched,caudate,completely,constricted,course,cup-shaped,deltoid,densely,dia,eaf,edicel,eed,ellipsoid,elongate,enclosed,erect,exsertio,filament,fleshy,free,geminate,glabrate,irregularly,late,like,lobe,lon,lower,main,many,margin,middle,nflorescence,occasionally,often,older,pair,papillo,papillose,planar,plurifoliat,pore,portion,prominent,puberulent,quite,rarely,reddish-gre,river,ruit,scar,small,spaced,ste,tall,tapering,thick,time,ud,unit,vein,widest,x,yellow,ympodial	apart,arrangement,articulation,color,connation,dehiscence,diameter,diminishing,foetid,foliage,form,growth,height,history,inflorescence,interjected,leaflet,length,life,midpoint,na,papillae,peduncle,perennial,petiole,petiolule,position,prickle,pseudostipule,reddish-grey,seed,shape,size,spacing,straightnes,texture,tuber-bearing
518	wfo-0001029622	success	182	123	87	95	36	0.478	.1,/3,0.5-0.7,0.5-1,0.6-0.9,1-1.5,1.5,3-4,30-35,4-6.5,40,abaxially,accrescent,acute,adaxially,anther,apex,attenuate,axil,bark,base,brown,calyx,chartaceous,cm,connivent,corolla,diameter,elliptic,flower,fruit,fruiting,glabrous,globose,green,inflorescence,internodal,jointed,lateral,leaf,lobed,long-acuminate,longitudinal,major,measured,minor,minutely,mm,narrowly,obconic,oblong,occasionally,onto,opening,opposite,ovate,papillose,pedicel,peduncle,petiole,reddish,rounded,sagittate,shiny,shrub,simple,single,size,slightly,slit,somewhat,stellate,stem,stigma,straight,style,tip,trichome,tube,tuft,uniseriate,vein,way,white,x,yellow,young	.2,.5,0.3,0.5,0.8-1,1-1.2,1-2.7,1-4,2-11,2-4,2-5,2.5-3,3-5,45-50,5-6,7-11,absent,ag,alyx,anthesi,apparently,appearing,arising,axe,beneath,blade,bud,capitat,consisting,cylindrical,deciduous,deflexed,differing,difoliate,dimorphic,eaf,eed,elongate,entire,except,filament,free,geminate,glabrou,ilament,immature,included,interlaced,known,lamina,less,lobe,long,long-triangular,m.,main,margin,mature,midrib,minute,nflorescence,often,older,one,orolla,oung,ovate-lanceolate,pair,pendent,pore,portion,present,probably,rachi,raised,reflexed,remaining,ruit,scar,second,shaped,slende,slender,tal,tapering,tear-drop,thin,thus,ud,unarme,unifoliat,unit,vary,within,ympodial	age,arrangement,articulation,capitate,color,connation,dehiscence,diminishing,distal,foetid,foliage,form,growth,height,history,interjected,leaflet,length,life,midpoint,na,ovary,papillae,petiolule,plant,position,prickle,pseudostipule,seed,shape,spacing,straightnes,surface,terminal,texture,tuber-bearing
519	wfo-0001029625	success	168	87	48	120	39	0.286	0.5-1,0.5-1.3,0.5-2,3-,4-9,5-6,5-8,anther,bark,base,calyx,cm,corolla,darker,diameter,elliptic,flattened,four,fruit,fruiting,globose,green,greenish,growth,herb,inflorescence,lobed,long,mm,ovary,ovate-reniform,pale,pedicel,peduncle,pubescent,reddish,shrub,stem,stigma,stripe,style,surface,tan,trichome,tube,uniseriate,white,young	-15,..,.1-0.2,.5,0.5-2mm,0.8-1.4,0.8-1.8,1-1.5,1-2,1-3,1.2-1.6,100,2,2.5-.,3,3-3,3-3.5,4-10,4-4,4-5-celled,4-7-celled,5,5-10,6-9,8-13,9-25,abaxial,along,anthesi,apical,beneath,branc,branch,branched,brittle,brow,capitat,cel,cell,conical,cucullate,deflexe,deflexed,deltate,densely,denser,distinct,dry,eaf,edicel,eed,erect,filament,flower,frui,glabrescent,glabrous,gland,gland-tipped,glandular,hyaline,lamina,later,lighter,like,lobe,lower,margin,markedly,middle,midline,minute,mixed,narrowly,nearly,new,nflorescence,occasionally,open,outer,outline,pair,papillate,per,pericarp,planar,plurifoliat,point,pointed,primary,purplish,rarely,regularly,ruit,scar,scattered,single,single-stemmed,sinuate,slightly,small,smooth,sparsely,striate,strongly,testa,thin,time,tinged,tip,triangular,tuft,ud,unit,vein,wall,weight,without,x,ympodial	apex,arrangement,articulation,brown,capitate,color,connation,dehiscence,diminishing,distal,foetid,foliage,form,height,history,interjected,lateral,leaf,leaflet,length,life,midpoint,na,papillae,petiole,petiolule,plant,plurifoliate,position,prickle,pseudostipule,seed,shape,size,spacing,straightnes,terminal,texture,tuber-bearing
520	wfo-0001029630	success	286	133	111	175	22	0.388	/6,0-5,0.1-0.2,0.5,0.5-1.5,0.5-4.5,1-3,1/3-2/3,12-17,3.5-5,45-60°,5-9,6-8,abaxially,accrescent,acuminate,acute,adaxially,along,anther,apart,apex,apparently,armed,articulated,base,berry,brachyblast,branched,calyx,capitate,cell,clavate,climber,cm,corolla,cuneate,cupular,dark,densely,diameter,distributed,divided,drying,dull-yellow,elliptic,evenly,eye,finely,flat,flattened-reniform,fruit,fruiting,globose,lateral,leaf,length,less,like,lobed,maturity,mauve,midpoint,midvein,mm,naked,oblique,often,orange,orange-brown,outline,ovate,papillose,pedicel,peduncle,petiole,pit,poricidal,porrect,primary,purple,rachi,raised,red-brown,rounded,side,small,smooth,sometimes,somewhat,sparsely,stalked,stellate-pubescent,stem,stigma,style,suborbicular,sunk,surface,tapering,terminal,tertiary,tip,trichome,unequal,vein,venation,visible,white-translucent,yellow-brown,young	.1,.15,.5,.7,.8,/2,0,0-10,0-8,0.15-0.3,0.2-0.3,0.2-0.4,0.2-0.7,0.3-0.5,0.4,0.5-1,0.5-2,0.6-0.8,1,1.2-1.5,1.5-2,1.5-4,1/3,1/3-1/5,10-30,12-15,2-6,2.5,2.5-3,2.5-6,3-10,4-5,4-8,5,5-20,5-merou,7-10,8,8-9,abaxial,across,age,almost,always,alyx,apar,apically,area,ascendant,attachment,bark,beyond,blade,branch,broadly,brown,chartaceous,clearly,coroll,curved,delineated,deltoid,development,difoliate,discolorous,distance,downward,eaf,eed,ellpsoid,elongating,entire,equal,exserted,extending,fertile,filament,flattened,flower,free,geminat,glabrescent,glabrous,glaucous,green-brown,grey-brown,greyi,hooked,infructescence,irregula,lengthening,lighter,lobe,lon,long,longer,longitudinal,lower,main,margin,mature,mostly,narrow-ovate,nflorescence,orolla,ovoid,pair,pale,papillo,patchily,pendulous,per,perfect,pericarp,point,pore,portion,prickle,prominently,ray,recurved,reduced,reflexe,relatively,rest,robust,ruit,scar,secondary,shiny,shorter,simple,sinus,slender,slit,spaced,species,spherical,spreading,stalk,stellate,stout,straight,strong,strongly,stump,tamen,terete,thicker,thin,throughout,time,toward,translucent,tube,ud,undulate,unequal-deltoid,uniform,unit,usually,variously,vary,visibl,visibly,weakly,white,wide,widest,woody,yellow,yellow-green,yellow-translucent,ympodial,×	arrangement,articulation,color,foetid,foliage,form,growth,height,history,inflorescence,interjected,leaflet,life,na,plant,position,seed,shape,size,spacing,texture,visibility
521	wfo-0001029632	success	202	110	64	138	46	0.317	.5,0.2,anther,anthesi,apart,articulated,base,black,brown,calyx,clavate,cm,dark,decurrent,deeply,densely,diameter,elliptic,flattened,fruit,glabrous,globose,green,herb,leaf,lilac,lobed,margin,mm,moderately,oblong,ovate,pale,pedicel,peduncle,pentagonal,perennial,petiole,pitted,poricidal,pubescent,purple,rarely,sparsely,stigma,straight,style,subentire,surface,tip,tube,unifoliate,violet,white,whitish,x,yellow,–11.5,–15,–19.0,–2.0,–4.5,–40,–50	.0,0.3–2.0,0.4–1.0,0.5,0.5–0.7,0.5–1.4,0.6–1.1,0.7,0.8–,0.8–1.0,0.8–1.5,0.8–2.2,0.9,0–1.5,1,1.0–1.5,1.0–2.0,1.0–3.5,1.0–6.0,1.1–,1.2,1.2–1.4,1.2–2.5,1.5–,1.5–2.6,1.7–8.5,10–30,11–25,2,2.0–11.5,2.0–2.2,2.7–3.5,2–3,3.5–5.0,3–8,4.5–6.0,4–8,5,5.5–9.5,5–10,6–13,7.5–13,75,abaxial,abaxially,absent,acute,adaxiall,adaxially,ag,along,angular,apex,appressed,arising,associated,axe,ba,blade,branching,caudex,cell,chartaceous,connivent,cylindrical,eaf,eed,elongate,equal,especially,filament,flower,geminat,hair,indistinct,lamin,like,lobe,lon,long,longitudinal,lower,m.,marking,midrib,midvein,midway,multicellular,nflorescence,obtuse,occasionally,often,opening,orolla,pair,particularly,perfect,pore,present,prostrate,purplish,rapidly,ruit,scandent,semi-succulent,shaped,side,simple,slender,slit,sometimes,spaced,spheroidal,stone,subterranean,succulent,swollen,tall,tamen,tear-drop,tem,time,unbranched,unicellular,uniseriate,unit,vary,vein,wide,wing,ympodial,–1.4,–10,–11.0,–13.5,–2.2,–4.0,–5.2	0-1.5,0.5-1.4,1.0-1.5,1.5-3-8,10-30,11-25,2.0-11.5,5-10,5.5-9.5,arrangement,articulation,bark,color,connation,corolla,dehiscence,foetid,foliage,form,fruiting,growth,height,history,inflorescence,interjected,leaflet,length,life,na,ovary,papillae,plant,position,prickle,pseudostipule,seed,shape,size,spacing,stem,straightnes,terminal,texture,trichome,tuber-bearing,young
522	wfo-0001029645	success	160	107	63	97	44	0.394	0.2-0.5,0.5-2.5,0.5-7,1-2,1-4,3-15,3-7,337,750,abundantly,acuminate,anther,apart,apex,around,articulated,base,blue,brown,calyx,chartaceous,cm,connivent,corolla,cuneate,diameter,et,extra-axillary,fide,flattened,fruit,globose,green,greenish,herb,kayap,line,membranaceous,mm,ovate,ovate-elliptic,pedicel,peduncle,petiole,purple,red,rotate-stellate,rugose-verrucate,sand-punctate,simple,smith,stigma,style,subcordate,tightly,triangular,truncate,tube,unbranched,white,x,yellow,±	-1,.5-1,0.3-0.5,1,1-1.5,1.3-7,1.5,1.5-2,2-3-foliat,2-4,2.5-17,2.5-4,3-10,3.5-4,4-5,4-8,5,5-8,6-12,7-12,?,abaxially,acute,adaxially,aggregate,along,axe,ba,blade,cell,cylindrical,decurrent,deltate,directed,distall,distally,eaf,eed,entire,except,filament,finger,flower,free,glabrou,glabrous,gland-tipped,hair,immature,inserted,knapp,lobe,long,lower,major,margin,mesocarp,minutely,moderately,nearly,nflorescence,obtuse,orolla,part,perfect,pore,puberulen,puberulent,rachi,radiu,rarely,ruit,sagittate,short,short-tomentose,shorter,shru,side,small,spaced,sparsely,stone,strongly,tal,tamen,tapered,tem,thecae,time,tomento,truncat,unit,vary,vein,veiny,wide,ympodial	0.5-1,arrangement,articulation,bark,color,connation,dehiscence,diminishing,distal,foetid,foliage,form,fruiting,growth,height,history,inflorescence,interjected,lateral,leaf,leaflet,length,life,na,ovary,papillae,petiolule,plant,position,prickle,pseudostipule,seed,shape,shrub,size,spacing,stem,straightnes,surface,terminal,texture,trichome,tuber-bearing,young
523	wfo-0001029646	success	141	102	73	68	29	0.518	0.1-0.6,0.7-2.2,1-4,1.5-2,1.5-4.9,10-15,2-3,3-14,5-15,6-8,acuminate,acute,apex,apical,apically,articulate,attenuate,base,branched,calyx,cm,corolla,cyme,dehiscent,diameter,dichasial,dichasially,distal,ebracteate,elliptic,finely,forked,free,generally,globose,green,green-white,half,herbaceous,introrse,leaf,linear,maturing,mm,monochasial,mucilaginous,narrowly,often,ovate,ovoid,pedicel,peduncle,perennial,petiole,plant,poricidally,proximal,pubescent,seed,short,simple,slit,stellate,stigma,straight,style,throughout,tone,tuber-bearing,white,yellow,yellow-green,¼	0.5,0.5-0.8,3-6-foliat,4-5.5,7-15,abaxially,acumen,adaxially,cell,commonly,covering,digestion,dorsally,eaf,edge,eed,emoval,enzyme,epiphytic,equaling,filament,flat,flower,folded,globo,ground,growing,hair-like,honeycomb,lateral,living,lobe,lon,long,lower,make,mos,mould,mucronate,nflorescence,nther,oak,orolla,ovat,pattern,perfect,pine,plan,rarely,reveal,ruit,seudostipule,specimen,stamen,tall,tem,testal,thick,throughou,tree,typically,unit,vary,viole,wall,wide,without,ympodial	anther,arrangement,color,connation,dehiscence,form,fruit,growth,height,history,inflorescence,length,life,na,ovary,papillae,position,pseudostipule,shape,spacing,stem,straightnes,surface,texture,tube,violet,wet,width,ye
524	wfo-0001029652	success	160	102	66	94	36	0.412	0.5-1,0.5-4,0.8-1,1-3,1.5-2,3/4,4-4.5,abaxially,adaxially,anther,apex,attenuate,bark,base,calyx,cm,conical,corolla,curling,elliptic-ovate,fruiting,glabrous,globose,golden,green,greenish-white,hispid,lateral,leaf,lobed,long-acuminate,long-styled,minutely,mm,narrowly,occasionally,opposite,ovary,ovoid-reniform,pale,papillose,pedicel,petiole,pitted,poricidal,pubescent,reddish-brown,shaped,short-styled,shrub,simple,size,slender,stem,stigma,style,surface,tan,tear-drop,tip,trichome,tube,uniseriate,way,white,young	.25,.3,.5,0.75-1,1,1-2,2,2-2.5,2-4,2.5-3,25,3.5-4,6-15,7-9,along,anthesi,apar,ape,apical,arch,arching,ba,bearing,berry,broadly,cone,deciduous,deflexed,deltate,denser,dia,differing,difoliate,drying,eaf,edicel,eed,evenly,exserted,filament,filiform,flower,free,geminat,golden-red,hard,heteromorphic,included,joining,lamina,like,lobe,lon,long,lower,main,major,margin,maturity,middle,midrib,minor,minute,near,nflorescence,older,pair,papillo,pericarp,pore,portion,projection,reflexed,ruit,scar,series,slende,slightly,soon,spaced,sparsely,swollen,tall,thickened,time,tub,ud,undulate,unit,vein,widest,within,x,ympodial	0.5,alternate,apart,arrangement,articulation,color,connation,dehiscence,diameter,diminishing,distal,foetid,foliage,form,fruit,growth,height,history,inflorescence,interjected,leaflet,length,life,na,papillae,peduncle,plant,position,prickle,pseudostipule,seed,shape,spacing,straightnes,terminal,texture
525	wfo-0001029662	success	181	140	110	71	30	0.608	.5,0.5,0.7–1,0.7–3,1,1.7–3.5,15,20,2–3-celled,3.5–6,3–4,4-rayed,4–5,5-6,5–7.5,6-7,7-14,9–11,abaxially,adaxially,anther,apart,apex,armed,articulated,base,blade,calyx,campanulate,chartaceous,cm,color,connivent,creeping,cylindrical,diameter,equal,erect,flower,fruit,glabrous,hair,half,herb,lateral,leaf,less,like,linear-tapered,lobe,lobed,long,longitudinal,margin,mm,nearly,node,oblong-ovoid,obtuse,offset,one,opening,ovate,pedicel,peduncle,per,petiole,pilose,plant,prickle,pubescent,rachi,reflexed,repand,ripe,rooting,rounded,sessile,shallowly,shape,side,simple,size,slightly,slit,somewhat,spaced,sparsely,stellae,stellate,stellate-pentagonal,stem,stigma,straight,style,subcordate,thickened,truncate,tube,unbranched,unequal,uniform,unknown,vine,way,white,wide,widely,x,yellow	.3,1.4,1.5,12,1–3.5,2,2-,2–3,3-foliate,3.2,3.5,absent,accrescent,acicular,adaxiall,ag,andromonecious,axe,ba,capitat,caudate,curve,directed,distally,eaf,eed,expanded,extra-axillary,fertile,filament,fragrant,free,fruiting,geminat,glabrou,ilament,immature,including,lightly,lower,lowest,m.,major,midpoint,minute,nflorescence,oblong-ovate,opposite,orolla,perhaps,pore,portion,probably,ray,recurved,ruit,shorter,slender,small,striaght,tal,tem,tip,tomentose,triangular,two,unarmed,unit,vary,vein,ympodial	age,arrangement,bark,capitate,connation,corolla,curved,dehiscence,diminishing,distal,form,growth,height,history,inflorescence,leaflet,length,life,na,ovary,papillae,pseudostipule,seed,spacing,straightnes,surface,tall,terminal,texture,tuber-bearing
526	wfo-0001029673	success	159	100	67	92	33	0.421	0.7-1.1,1-10,1-2,1-5,1.5-2,4-6,accrescent,acuminate,acute,anther,apex,bark,base,black,broadly,calyx,clavate,cm,corolla,deep,deltoid,dendritic,densely,diameter,elliptic,fruit,fruiting,globose,greyish,greyish-yellow,growth,inserted,lateral,leaf,length,lenticular,long,minutely,mm,narrowly,ovary,pedicel,petiole,pitted,plurifoliate,poricidal,pubescent,purple,pyramidal,reddish-brown,shrub,sleeve,small,somewhat,sparsely,stem,stigma,style,surface,terminal,tip,tree,triangular,trichome,tube,violet,young	.5,0.5-1,0.75-1,0.8-1,1.2-3.5,1.5-1.8,10-20,2-2.5,2-3,2-4,2.5,3-5,3/4,5-25,5.5-15,abaxial,abaxially,absent,adaxial,adaxially,age,along,anthesi,apical,appearing,basal,becoming,berry,blade,branch,branching,conical,decurrent,deflexed,denser,dichasia,eaf,edicel,eed,ew,exserted,filament,flower,fork,free,glabrous,greyish-yello,individual,lamina,later,like,lobe,lon,longer,lower,m.,monochasial,nflorescence,nodding,occasionally,older,overtopping,pair,papillo,pericarp,petal,planar,pore,portion,prominent,reflexed,ruit,scar,secondary,shoot,slightly,slit-like,stamen,strongly,tall,tapering,thin,time,tub,ud,unit,vein,wide,winged,woody,x,ympodial	arrangement,articulation,color,connation,dehiscence,diminishing,distal,foetid,foliage,form,height,history,inflorescence,interjected,leaflet,life,midpoint,na,papillae,papillose,peduncle,petiolule,plant,position,prickle,pseudostipule,seed,shape,size,spacing,straightnes,texture,tuber-bearing
527	wfo-0001029680	success	212	120	78	134	42	0.368	0.1,12,50,abaxially,acute,adaxially,annual,anther,anthesi,apart,apex,base,bipinnate,blue,branched,brown,calyx,clavate,cm,diameter,entire,flattened,fleshy,fruit,glabrous,globose,green,herb,indistinct,leaf,length,light,longitudinal,mm,moderately,oblong,obovate,obtuse,opening,pale,pedicel,peduncle,pentagonal,petiole,pinnate,pitted,pore,poricidal,pubescent,purple,rapidly,rarely,red,ripe,rotate,shallowly,shaped,size,sometimes,sparsely,split,stem,stigma,straight,style,surface,tear-drop,terminal,time,tip,tripinnate,tube,turning,violet,white,winged,x,yellow	.0,0.4,0.5–1.5,0.6,0.6–1.2,0.6–2.0,0.9–1.0,1,1.0,1.0–1.1,1.0–1.5,1.0–1.8,1.1–1.2,1.4–2.5,1.4–7.5,1.5,1.6–2.7,1.7–7,1.8–3.8,10,11–16,11–25,1–2,1–3,1–6,1–8,2.2–4.2,2–20,3.0–4.2,3.3–5.5,3–22,3–6,4.0–16,4.0–6.5,4.5–20,4.5–7.0,4–10,4–30,5,5.5–8.5,5–11,7–10,8–32,absen,adaxiall,ag,along,appressed,arequipa,arranged,articulated,asymmetrically,axe,axillary,ba,becoming,beyond,blade,borne,cell,connivent,cylindrical,decreasing,decurrent,densely,difoliate,divided,eaf,eed,equal,erect,extending,filament,flange,flower,forming,geminat,hair,irregularly,lobe,lon,long,lower,m.,margin,midrib,multicellular,narrow,nflorescence,node,occasionally,often,orolla,ovate,pair,parallel,pendant,perfect,pinnae,plurifoliate,primary,prostrate,ruit,running,secondary,shoot,side,simple,spaced,specimen,stone,subglabrous,tacna,tal,tamen,tem,tertiary,unicellular,uniseriate,unit,usually,vary,wide,wing,winge,woody,ympodial,–10,–12.5,–19,–3,–3.2,–46,–48	0.6-2.0,1-2,1.7-7,11-25,12.5,3,3.3-5.5,4-10,4.5-20,4.5-7.0,5-11,age,arrangement,bark,color,connation,corolla,decurrence,dehiscence,diminishing,distal,form,growth,height,history,inflorescence,interjected,lateral,leaflet,life,na,ovary,papillae,petiolule,plant,pseudostipule,seed,shape,spacing,straightnes,texture,tuber-bearing
528	wfo-0001029685	success	288	158	124	164	34	0.431	0.5,0.5-1.5,0.7-1.8,1-2,1-4,1-5,1.5-6,1/3,1/3-2/3,10,2-3,20,3-20,3-7,3.5,4-10,4-7,4-9,5-11,5.5-7,accrescent,adaxially,almost,anther,apart,apex,apparently,articulated,bark,base,berry,branched,breaking,bright,brittle,brown,calyx,cell,clavate,cm,corolla,covering,cuneate,curved,densely,diameter,drying,elongating,finely,flattened,flattened-reniform,fruit,fruiting,glabrescent,glabrous,globose,lateral,leaf,length,less,lobed,long,lower,mature,maturity,mauve,midpoint,mm,moderately,oblique,often,orange,orange-brown,orange-translucent,outline,ovate,papillae,pedicel,peduncle,petiole,pit,point,poricidal,porrect,prickle,primary,pubescent,raised,rarely,red-brown,reflexed,ridged,secondary,sessile,shrub,side,simple,slightly,small,smooth,spaced,sparsely,specimen,stalked,stellate,stellate-pubescent,stem,stigma,straight,style,surface,tapering,terminal,tip,translucent,trichome,truncate,tube,unbranched,usually,vein,wide,widest,yellow	.2,.4,.5,.8,/3,0-15,0.1,0.1-0.2,0.1-0.3,0.2,0.2-0.8,0.5-1,0.7-1.5,1-1.3,1-7,1.3-1.5,1.5,1.5-5,1/2-2/3,1/3-4/5,1/6-1/3,10-20,2-6,2.1-3,2.5-3,2.5-3.7,3,3-5,3-6,3.5-16,3.5-4,3/4-1/2,30-60°,4,4.5-6,5,5-20,5-merou,6-8,6.5-9,abaxially,acute,age,alyx,apar,apically,armed,axe,beyond,black,blade,broad-deltate,chartaceous,clearly,clump,cupular,dark,deep,deltate,dense,development,difoliate,discolorous,distance,divided,dorsal,downward,eaf,eed,equal,erect,exserted,extending,faint,filament,filiform,finger-hair,flat,flower,free,geminat,grey-brow,growing,inflated,infructescence,irregula,irregular,lengthening,lobe,long-acuminate,long-deltate,longer,longitudinal,margin,midvein,minute,mixture,much,nflorescence,obconical,obovate,older,one,open,opening,orolla,oung,ovoi,ovoid,pair,papillo,partly,patch,per,perfect,pericarp,persisting,pore,portion,pronounced,rachi,ray,reduced,regular,rest,ri,robust,rounded,ruit,scar,shiny,sinus,slender,slit,sometimes,somewhat,spherical,spreading,stalk,stout,strongly,stump,tamen,terete,tertiary,thick,thin,throughout,time,toward,ud,unarmed,unit,upper,variously,vary,venation,visible,well-developed,woody,x1.5-2,yellow-green,ympodial,×	arrangement,articulation,color,connation,dehiscence,diminishing,distal,foetid,foliage,form,grey-brown,growth,height,history,inflorescence,interjected,leaflet,life,na,ovary,papillose,perennial,petiolule,plant,position,pseudostipule,seed,shape,size,spacing,straightnes,texture,tuber-bearing,young
529	wfo-0001029691	success	223	119	82	141	37	0.368	0.2-0.4,1-6,1.2-1.7,1.5-4,1.7-2.7,10,100-400,11-14,13-20,140-320,2.5-4,2.5-8,5.5-9,8-14,accrescent,acicular,acute,adult,anther,apex,articulated,base,broadly,calyx,chartaceous,cm,connivent,cuneate,decimetre,diameter,extra-axillary,fruit,fruiting,globose,green,half,herbaceous,inflorescence,lanceolate,lateral,length,less,lilac,lobe,long,longer,mature,midvein,minutely,mm,obtuse,orbicular,ovate,pale,pedicel,peduncle,per,petiole,plant,present,prickle,prostrate,resprouter,reticulate,rotate,shape,simple,slightly,sprawling,stellate,stigma,straight,style,surface,time,tube,unbranched,vein,white,wide,yellow,yellowish-green	%,-8,0-0.1,0-6,0.25-0.45,0.3-0.45,0.3-0.7,0.3-1.4,0.4-0.5,0.5-0.7,0.5-0.8,0.5-1,0.8-1.2,0.8-1.6,0.8-2.5,1-1.1,1-2,1-5,1-locular,1.1-2.1,1.4-2,1.6-2.1,13-18,13-25,18-23,2-3,3-4,3-6,3-7,3.3-3.5,36-50,4-8,40-250,5-,5-8,5-merou,6-10,6-8,6.5-10,6.5-8.5,abaxially,absen,absent,abundant,across,adaxiall,adaxially,alyx,andromonoecious,apart,armed,attenuate,axe,ba,blade,branche,brown,bursting,cone,cross-section,curved,cylindrical,densely,directed,distall,eaf,eed,eglandular,elliptica,entire,equalling,exocarp,filament,finger,flower,functional,glabrous,gland-tipped,hair,heterostylous,included,incomplete,index,interpetalar,juicy,lamina,lobed,lobing,lon,lower,margin,maturity,mesocarp,mid-point,midpoint,minute,moderately,moist,nflorescence,oblique,orolla,part,petal,placenta,pore,porrect,presen,rachi,ray,readily,rounded,ruit,septum,sessile,shallowly,short,side,spaced,sparsely,stage,stalk,stellae,stellate-pubescent,summit,tal,tamen,tem,thick,throughout,tip,tissue,toward,transparent,truncat,unit,unknow,uvenile,vary,weakly,x,ympodial	arrangement,articulation,bark,branch,color,connation,corolla,dehiscence,diminishing,distal,foetid,foliage,form,growth,height,history,interjected,leaf,leaflet,life,na,ovary,papillae,petiolule,position,pseudostipule,seed,size,spacing,stem,straightnes,terminal,texture,trichome,truncate,tuber-bearing,young
530	wfo-0001029704	success	146	80	61	85	19	0.418	0-1.5,1,1.5-2.5,1.5-3,7-10,along,anther,base,blue,broadly,brown,calyx,cm,composed,corolla,dark,deeply,ellipsoid,few-flowered,flower,glabrous,globose,green,halfway,leaf,lengthening,less,lobed,minutely,mm,mottled,obovate,occasionally,one,pedicel,peduncle,petiole,pinnatisect,pore,poricidal,pubescent,purple,record,reddish,reticulate,shrub,simple,single,slit,stellate,stigma,stout,straight,striped,style,subdiscoidal,surface,tip,variable,vein,white	-17,-3,.5,0.5,1-2,1-4,1.5,10-14,1000-1200,140-185,15-25,2-2.5,2-3,2-5,3-4-celled,3-5,4,4-7,5,7-,9-20,acuman,acuminate,acute,also,anthesi,apex,apparently,aspect,axi,berry,branch,c.,cell,conical,cunate,cuneate,cut,deflexed,dia,diam,eaf,eed,enlarged,erect,especially,exerted,extra-axillary,filament,flowering,fork,fruiting,gradually,lanceolate,lobe,long,lower,midrib,minute,moderately,nflorescence,obovoid,ovary,plurifoliat,rounded,ruit,shoot,short,sinus,sombre,sprawling,stone,subglobo,swollen,trichome,tub,tube,twig,ud,unit,variously,within,x,ympodial,young	arrangement,color,dehiscence,form,fruit,growth,height,history,inflorescence,length,life,na,perennial,plant,seed,shape,straightnes,subglobose,texture
531	wfo-0001029727	success	260	109	79	181	30	0.304	-3,/3,0-2,0-4,0-8,0.1-5,0.4-1,0.5,1-1.2,1-4,1/3-1/2,2.5-5.5,3-7,ame,anther,anthesi,apart,apex,articulated,bark,base,branched,c.,calyx,chartaceous,clavate,climber,cm,connivent,cordate,corolla,curved,diameter,erect,finely,flattened-reniform,lateral,leaf,length,lobed,long,mauve,midpoint,mm,moderately,orange-brown,ovate,pedicel,peduncle,petiole,pitted,poricidal,porrect,prickle,ray,red-brown,rounded,scandent,seed,sessile,shape,shrub,simple,size,stalked,stellate-pubescent,stem,stigma,straight,style,surface,tapering,terminal,tip,trichome,tube,variously,wide,young	-1/3,-10,.5,0-15,0-20,0-30,0-40,0-5,0.15-0.2,0.15-0.3,0.2,0.2-0.5,0.2-2.5,0.3,0.4,0.5-1.2,0.5-3,0.7-0.9,0.7-1,1,1-,1-2,1.2-2,1.5-2.3,1.5-2.5,1.5-3,1.5-5.5,1.6-3,1/2-2/3,1/4,1/8-1/5,2-5,2.5,2.5-3.2,2.8-4,3-11,3-6,3/,4-7,4-merou,4-merous,4.5,4.5-,5-12,5-8,5-9,5.5-7,6-11,7-10,abaxial,abaxially,acicular,acuminate,acute,adaxial,age,almost,along,alternate,alyx,apar,apically,apparently,berry,blade,bristle,brown,colourles,covered,cupular,darker,deltate,deltoid,densely,developing,different,dimorphic,discolorous,divided,drying,eaf,edge,eed,elongating,equal,except,extending,ferrugineous,filament,filiform,filiform-acuminat,fissure,flower,free,geminate,glabrous,increasing,inside,lengthening,less,like,lobe,lon,longer,lower,m.,margin,mature,middle,midvein,minor,minutely,mixture,narrow-deltate,nflorescence,nther,obconical,oblong,occasional,older,one,open,orolla,oung,outside,pair,papillo,papillose,per,perfec,perfect,pit,plurifoliat,pore,portion,prickl,prickly,primary,protruding,pubescent,raised,rarely,red-brow,reddish,reduced,regular,scar,series,shallowly,short,sinus,smooth,sometimes,spaced,spreading,stalk,stellate,strongly,subentire,tamen,tearing,terete,tertiary,time,toward,translucent,transverse,unarmed,uneven,unit,upper,variable,vary,vein,venation,violet,visible,way,x,yellowish,ympodial	arrangement,articulation,color,connation,dehiscence,diminishing,distal,foetid,foliage,form,fruit,fruiting,growth,height,history,inflorescence,interjected,leaflet,life,na,ovary,papillae,petiolule,plant,position,pseudostipule,spacing,straightnes,texture,tuber-bearing
532	wfo-0001029728	success	238	111	66	172	45	0.277	0.5-1.5,accrescent,acute,anther,anthesi,apex,base,becoming,broadly,brownish,bud,calyx,cm,diameter,early,extra-axillary,fertile,flattened-reniform,flower,free,fruit,fruiting,glandular,globose,golden,green,lanceolate,late,leaf,length,light,mature,maturity,minutely,mm,narrowly,nearly,numerous,ovate,pedicel,peduncle,petiole,pitted,prickle,shrub,simple,size,stellate,stem,stigma,straight,style,subcordate,suborbicular,surface,tan,terminal,thin-textured,triangular,truncate,tube,unbranched,white,x,yellow,yellowish	.6,0.2,0.3,0.3–0.4,0.4–2,0.5–0.9,0.6–1.5,0.7–1.2,0.8,0.8–1.6,0.8–2.5,0–0.5,1.2–2.3,1.5–2,1.6,1.7–2.5,1/3,11,12–20,1–,1–2,1–2-celled,2,2-foliate,2.4–3.6,2.7-3.1,2.8,200-310,260,2–3,2–4,2–4-celled,3,3.4–4.5,3.5–5.5,3–18,3–5,4,4.5-5.5,4–10,4–14cm,4–15,4–6-rayed,5,6.2–8.1,7,7-10,7–12,7–14,7–15,8–10.5,9,=,abaxially,absent,abundantly,acicular,adaxiall,adaxially,admixture,armed,around,ascending,auxiliary,axe,blade,branche,capitat,cell,column,compressed,contiguou,curled,curved,cylindrical,densely,differing,dimorphic,directed,distall,eaf,eed,enlarged,erect,exceeding,fallen,fewer,filament,frui,geminate,generally,glabrou,glabrous,gland-tipped,glandular-pilose,grading,hair,half,horizontally,hyaline,intermixed,larger,least,lobe,lobed,long,longer,lower,lowermost,main,major,many,margin,midpoint,minute,mixed,much,n,nflorescence,obtuse,often,one,orolla,pair,per,pilose,plane,pore,pubescence,pubescent,rachi,ray,recurved,reflexed,relatively,ruit,scarcely,scattered,sessile,shallowly,short-pilose,shorter,similar,similarly,single-stemmed,slender,slightly,small,smaller,sparsely,spine,spreading,stellae,stout,tall,tamen,tem,terete,tip,triangular-lanceolate,undulate,unit,usually,various,vary,vein,wid,wide,withered,ympodial,–4,–5	0-0.5,0.3-0.4,1-2,12-20,3.5-5.5,4-10,7-12,arrangement,articulation,bark,capitate,color,connation,contiguous,corolla,dehiscence,diminishing,distal,foetid,foliage,form,growth,height,history,inflorescence,interjected,lateral,leaflet,life,na,ovary,papillae,perennial,petiolule,plant,position,pseudostipule,seed,shape,spacing,straightnes,texture,trichome,tuber-bearing,young
533	wfo-0001029731	success	246	136	108	138	28	0.439	.6,0.1-0.8,1,1-2,1-2.5,1.5,1.5-2.5,2.5,3,3-4,4,4-9,6-7,7-11,8-9,abaxially,acquiring,adaxially,almost,along,anther,apex,bark,base,berry,black,boundary,branch,branched,brown,bumpy,calyx,clavate,clearly,cm,conical,connate,corolla,cuneate,darker,delimited,diameter,different,distributed,dorsal,drying,dull,elliptic,epiphyte,evenly,finely,flaring,fruit,fruiting,glabrous,ground,large,lateral,leaf,less,liana,linear,lobed,long,long-ellipsoid,longitudinal,longitudinally,maturity,mauve,midvein,mm,obconical,oblong,obovate,orange-brown,papillae,papillose,pedicel,peduncle,petiole,pyriform,raised,ridge,ridged,rounded,several,slender,sometimes,sparsely,stem,stigma,straight,style,sunk,surface,terminal,thick,toward,trichome,tube,ventral,white,wide,widely,woody,x,yellow,young	.5,0.05,0.25-0.3,1-1.5,1.5-3,1/3,10-20,1994,2,2-3,2-6,2.5-4.5,3-10,31,4-5,6,accrescent,acuminate,acute,age,alyx,anthesi,apar,apically,apparently,arcy,articulated,basal,basally,beak,becoming,branching,broadly,concolorous,coriaceous,crinkled,delineated,deltoid,dense,development,dilated,domatia,dorsifixed,dry,eaf,early,elongating,enlarge,entire,equal,erect,even,exserted,faint,filament,filiform,fine,flattened,fleshy,flower,free,hair,iscoid,lamina,later,lengthening,like,lobe,lon,lower,main,margin,mature,much,narrowly,nflorescence,nther,obtuse,occasionally,often,orolla,pair,part,pendulous,perfec,pericarp,persisting,plurifoliat,pore,poricidal,portion,primary,prominent,protruding,rachi,rakotozafy,rarely,reflexed,reported,revolute,ribbed,ruit,scar,see,shallowly,shorter,simple,sinus,slightly,small,smaller,smoot,stretched,stump,succulent,tearing,thickened,thinner,though,time,tip,tub,tuft,ud,unit,usually,vary,vein,venation,visibl,visible,well-developed,wing,winged,wrinkling,yellow-green,ympodial,’	arrangement,articulation,color,connation,diminishing,disc,distal,form,growth,height,history,inflorescence,leaflet,length,life,midpoint,na,ovary,petiolule,plant,seed,shape,size,smooth,straightnes,texture,tuber-bearing,width
534	wfo-0001029741	success	137	100	64	73	36	0.467	.5,1-3.5,1.1-1.3,1.5-4,1.5-6,?,accrescent,acute,anther,apex,attenuate,base,becoming,black,calyx,capitate,closely,cm,completely,corolla,dark,drying,elliptic,fruit,fruiting,furcate,glabrous,globose,green,growth,inflorescence,lateral,leaf,lenticellate,lobed,minutely,mm,nearly,opposite,ovary,ovate,overlapping,papillose,pedicel,petiole,poricidal,quite,shaped,shrub,size,slightly,spaced,stem,stigma,straight,style,tear-drop,tip,tree,tube,usually,variable,weak,white	.4,0.5-1.5,0.8-3.5,0.9-1.2,1-1.5,1.5,10-50-flowered,2-2.5,2.2-9,2.5-7.8,3,9.5-22.5,age,anthesi,apiculate,berry,branched,ca,caly,deflexed,deltoid,dia,differing,difoliate,divisio,dry,eaf,early,edicel,eed,erect,exserted,filament,flower,free,geminat,glabrou,immature,known,lighter,lobe,lon,long,lower,main,major,middle,minor,new,nflorescence,pair,papillo,planar,pore,portion,produced,prominent,proximal,raised,reddish-brown,ruit,scar,slender,tall,tapering,ud,unit,vein,widest,wood,woody,x,ympodial	arrangement,articulation,bark,color,connation,dehiscence,diameter,diminishing,distal,foetid,foliage,form,height,history,interjected,leaflet,length,life,na,papillae,peduncle,petiolule,plant,position,prickle,pseudostipule,seed,shape,spacing,straightnes,surface,terminal,texture,trichome,tuber-bearing,young
535	wfo-0001029744	success	113	62	46	67	16	0.407	0.3-0.6,2,2-4,5-8,50,abaxially,adaxially,apart,calyx,cm,deltate,dendritic,densely,elliptic,flattened,form,fruit,glabrous,golden,incrassate,lanceolate,leaf,lobe,margin,minutely,mm,narrowly,oblanceolate,ovoid-reniform,pedicel,petiole,pitted,pubescence,pubescent,scar,shape,shrub,simple,slightly,small,stem,surface,trichome,unifoliate,white,x	0.5-1,1,1.5,1.5-3.2,7-15,8-10-flowered,8-11,acute,along,apex,bark,base,beginning,blunt,branch,brow,denser,difoliate,distinct,eaf,eed,entire,examined,extreme,fide,flexuous,geminate,glabrescent,inflorescenc,lamina,leave,long-acuminate,looping,lower,major,marginal,mature,minor,nflorescence,node,non-reproductive,oblique,occasionally,older,opposite,pair,pale,primary,revolute,see,similar,single-celled,smaller,smith,sometimes,somewhat,spaced,thee,thin,tip,ud,unicellular,uniseriate,unit,vein,ympodial,young	arrangement,color,diameter,flower,growth,height,history,inflorescence,length,life,na,plant,seed,size,spacing,texture
536	wfo-0001029746	success	179	117	82	97	35	0.458	0.3-2,0.7-1,1,1-1.3,1.5,2-2.5,2-8,acuminate,acute,age,anther,apart,apex,base,berry,blackish,brown,calyx,capitate,centre,cm,color,cordate,corolla,curved,dark,darker,densely,diameter,enlarged,flattened,fleshy,fruit,fruiting,glandular,globose,herb,hollow,inflorescence,internodal,leaf,lengthening,lobe,minutely,mm,occasionally,orange,ovary,ovate,ovoid,pale,papillose,pedicel,peduncle,petiole,pitted,poricidal,principal,pubescent,purple,red,reddish,reflexed,shallowly,simple,single,slightly,slit,spreading,stem,stigma,strongly,style,subshrub,surface,tip,triangular,trichome,tube,upward,vein,–3	.5,0.5-1,1-1.5,1.2-1.5,2,2-4,2-7,3,3-4,3-4-pluri-foliate,3-4.5,3-6,4-9,6,6-7,8-10,8-11,abaxially,adaxially,anthesi,bearing,becoming,broadly,c.,cell,ciliate,conical,crenate,crowded,cup-shaped,eaf,edicel,eed,ellipsoid,elliptic,entire,erect,exerted,filament,flower,flush,free,glabrous,gland-tipped,greenish,growing,heteromorphic,horn,irregularly,lamina,less,lon,long,longer,longest,lower,margin,markedly,mature,maturit,mid-length,mixed,narrowly,near,nflorescence,nodding,pair,papillo,pericarp,plan,pore,portion,primary,pubescen,rachi,ruit,scar,shortest,slender,somewhat,spaced,sparse,sparsely,straight,testal,thin,third,ud,uniseriate,unit,upper,wall,widely,widest,woody,x,ympodial	arrangement,articulation,bark,connation,dehiscence,diminishing,distal,foetid,foliage,form,growth,height,history,interjected,lateral,leaflet,length,life,maturity,na,papillae,petiolule,plant,position,prickle,pseudostipule,seed,shape,size,spacing,straightnes,terminal,texture,tuber-bearing,young
537	wfo-0001029751	success	158	87	47	111	40	0.297	1.7,3,anther,apex,apical,attenuate,base,calyx,capitate,clavate,cm,compressed,corolla,cuneate,deltoid,diameter,extra-axillary,fruit,geminate,globose-ellipsoid,lateral,leaf,length,membranaceous,mm,orbicular,ovary,pedicel,peduncle,petiole,pore,prickle,scorpioid,shrub,size,solitary,sometimes,stellate,stigma,style,subcordate,surface,trichome,truncate,white,winged,yellow	.5,0.6–1.6,1,1.2,1.3–2.6,1.8–4,10–11,10–19,12–14,1–2,1–3,2,2.2–2.5,2.5–5,2–3,2–4-celled,2–5,3–9,4,4.5–6,5-merous,5–10,5–25-flowered,6,8–9,9–18,acicular,also,armed,blade,broad-based,broadly,celled,central,covered,di-,diam,eaf,eed,eglandular,elongate,enlarged,equal,geminat,glabrous,glandular,globose,gree,hair,immature,inner,lanceolate,linear,linear-lanceolate,little,lobe,lon,long,longer,lower,midpoint,midvein,moderately,needlelike,nflorescence,one,opening,outside,pair,pedunculate,perfect,planar,prickly,pubescent,ray,recurved,ripe,ruit,sessile,shallow,short,short-stalked,shorter,simple,small,smaller,somewhat,sparsely,spreading,stalked,straight,subtended,tal,tem,tooth,toward,triangular,trifoliate,twice,unarmed,unbranched,unequal,unit,upper,usually,variegated,whitish,wide,ympodial,±,×	0.6-1.6,1.8-4,10-11,3-9,arrangement,articulation,bark,color,connation,dehiscence,diminishing,distal,foetid,foliage,form,fruiting,growth,height,history,inflorescence,interjected,leaflet,life,na,papillae,petiolule,plant,position,present,pseudostipule,seed,shape,spacing,stem,straightnes,terminal,texture,tube,tuber-bearing,young
538	wfo-0001029758	success	261	116	73	188	43	0.28	1.8,7.6,acuminate,anther,apart,apex,apical,arcuate,articulate,attachment,attenuate,base,black,calyx,capitate,chartaceous,cm,cordate,corolla,cream,dark,deltoid,diameter,distal,dry,evenly,extra-axillary,flattened-orbicular,flattened-reniform,fruit,globose,green,lateral,length,markedly,mature,minute,mm,notched,obtuse,orbicular,oval,ovate,pedicel,peduncle,petiole,point,pore,porrect,prostrate,purple,red-brown,reticulate,rounded,shrub,simple,spreading,stellae,stellate,stem,stigma,straight,style,sub-coriaceous,surface,tube,unarmed,unbranched,vein,white,yellow,yellow-brown,young	.2,.3,.5,/4,0.2,0.4–1.2,0.5–0.7,0.6–0.9,0.7–0.8,0.7–1.3,0.8–1.1,0.8–1.3,0.9–1.0,0.9–1.2,0.9–1.5,1.0–3.4,1.1–1.5,1.1–1.8,1.2–1.4,1.2–1.9,1.3–1.7,1.7–2.8,1.9–2.6,1.9–2.7,1/3,1/4–1/3,10.3–14.5,2.1–6.2,2.2–2.9,2.3–3.3,2.3–6.4,2.8–2.9,2.8–4.2,3.1–3.8,3.2–3.5,3.5–4.8,3.6,4.1–6.3,4.3–4.8,4.3–6.2,4–6,5-merou,5.7–7.8,5.8,7–17,7–9,8.0–33.1,8–11,abaxially,absent,adaxially,adnate,aequilateral,ag,alyx,anthesi,apparently,appearing,appresse,arching,around,axe,ba,basal,bent,berry,blade,broad,brochidodromous,bud,bulge,channeled,curved,cylindrical,densely,dentate,development,directed,directly,distally,distinct,eaf,edge,eed,either,emerging,endocarp,entire,equal,erect,exocarp,extending,fertile,filament,filiform,flexed,flower,free,geminat,glabrous,glossy,gradually,gree,heterostylous,immature,increasing,intact,internode,interpetalar,intersepalar,juic,lanceolate,layer,least,lobe,lobed,lon,long,longer,lower,many,margin,midpoint,midrib,midvein,moderately,nearly,nflorescence,observed,occasionally,often,opaque,orolla,ove,per,perforated,persistent,petalar,portion,potentially,presumably,pubescent,raised,ray,remaining,ridge,rigid,row,ruit,short,short-stipitate,shorter,side,sinus,sloughing,spaced,splitting,spread,stamen,stellate-pubescent,stipe,stipitate,suture,tamen,tem,tetrafoliate,thin,though,tip,tissue,toward,transparent,trifoliate,two,ud,unit,various,vary,weakly,well,well-developed,wide,yellow-ferruginous,ympodial,±90°,±a,¼,×	0.5-0.7,0.7-1.3,1.0-3.4,1.2-1.9,1.7-2.8,10.3-14.5,2.8-4.2,arrangement,articulation,bark,color,connation,dehiscence,diminishing,foetid,foliage,form,fruiting,growth,height,history,inflorescence,interjected,leaf,leaflet,life,na,ovary,papillae,petiolule,plant,position,prickle,pseudostipule,seed,shape,size,spacing,straightnes,terminal,texture,trichome,tuber-bearing
539	wfo-0001029769	success	142	95	56	86	39	0.394	.5,0.5-1.5,1-3,4-5,5-8,6-17,acuminate,acute,anther,apex,bark,base,brown,calyx,capitate,cm,corolla,curl-tipped,dark,deflexed,densely,elliptic,fruiting,glabrous,globose,golden,green,internodal,lateral,leaf,lobed,minutely,mm,opposite,ovary,ovoid-reniform,pedicel,petiole,pitted,poricidal,pubescent,shaped,shrub,simple,smooth,sparsely,stem,stigma,straight,style,surface,tear-drop,trichome,tube,white,young	.25,1-1.2,1.5-2,1.5-2.5,2.5-3,2.5-8,3.5-4,30-60-flowered,4,7-8,8-9,8.5-17,abaxially,adaxially,along,anthesi,apar,ape,archin,ba,bearing,berry,branch,brochidodromu,cerro,conical,cyathiform,deltoid,dia,eaf,edicel,eed,exserted,filament,filiform,flower,free,fresh,hen,horizontally,inglé,less,like,lobe,lon,long,lower,main,margin,midrib,nearly,nflorescence,older,onto,pair,papillo,papillose,pore,portion,puberulent,reflexed,ried,ruit,scar,scattered,somewhat,spaced,swollen,tall,three,time,tip,tub,two,ud,unevenly,unifoliat,uniseriate,unit,vein,wide,widely,winged,woody,x,ympodial	apart,arrangement,articulation,color,connation,dehiscence,diameter,diminishing,distal,foetid,foliage,form,fruit,growth,height,history,inflorescence,interjected,leaflet,length,life,midpoint,na,papillae,peduncle,petiolule,plant,position,prickle,pseudostipule,seed,shape,size,spacing,straightnes,terminal,texture,tuber-bearing,unifoliate
540	wfo-0001029771	success	196	83	52	144	31	0.265	0-0.5,0.3-0.6,0.4-1.4,4-7,4.5-12,5.5-8,6-11,acute,anther,apex,base,calyx,chartaceous,cm,connivent,cordate,curved,diameter,flower,fruit,globose,inflorescence,lanceolate,lateral,leaf,length,lilac,mm,obtuse,ovate,pale,pedicel,peduncle,perennial,petiole,pseudo-umbellate,purple,red,reniform,reticulate,rotate,rotate-stellate,shrub,simple,slightly,stigma,straight,style,surface,tube,unbranched,yellow	%,.5,0-0.25,0-0.6,0-3,0-4,0-5,0.05-0.15,0.1-0.3,0.2-0.25,0.2-0.4,0.3-1,0.4-0.7,0.4-1,0.45-0.9,0.5-0.7,0.5-1.2,0.7-1.2,0.7-1.8,0.8-1.2,0.9-1,1,1-1.5,1-2,1-5,1-locular,1.2-2.8,1.8-3,15-35,2,2-2.3,2-3,2-3-foliate,2.5-10,2.5-7,3-4,4-,5-10,5-9,5-merou,7-10,7-8,abaxially,absen,absent,accrescent,across,adaxially,adult,alyx,apart,apparen,articulated,axe,ba,blade,branch,capitat,contiguous,cylindrical,deltate,densely,directed,distall,distributed,dm,eaf,eed,eglandular,elliptic,entire,erect,exceeding,exocarp,extra-axillary,filament,finger,fruiting,geminate,glabrous,gland-tipped,green,grey,grey-green,hair,incomplete,interpetalar,juicy,juvenile,lamina,lobe,lon,long,lower,margin,mature,mesocarp,mid-point,midpoint,minute,nearly,nflorescence,oblique,orolla,part,per,perfect,placenta,pore,porrect,present,prickle,pubescent,rachi,ray,rhizomatous,ruit,scattered,septum,short,somewhat,spaced,stalk,stellae,stellate-pubescent,succulent,tal,tamen,tem,thick,throughout,time,tissu,tissue,unarme,unarmed,unit,upper,vary,white,wide,x,yellowish,ympodial	arrangement,bark,capitate,color,connation,corolla,dehiscence,diminishing,distal,form,growth,height,history,interjected,leaflet,life,na,ovary,papillae,petiolule,plant,pseudostipule,seed,shape,size,spacing,stem,straightnes,terminal,texture,tuber-bearing
541	wfo-0001029775	success	54	75	35	19	40	0.648	0.25-1.5,0.5-4,2-6,2-8,3-4,4-5.5,6-16,alveolate,brown,cm,diameter,flattened,glabrous,globose,internode,light,margin,mm,orange,perennial,prickle,puberulent,sparsely,stigma,straight,strongly,subshrub,surface,thickened,trichome,unbranched,unifoliate,vine,x,yellow	absen,aggregate,base,ecuador,eed,hollow,long,recurve,ripe,robust,ruit,shin,tal,tem,tone-cell,truncat,unit,wide,ympodial	anther,arrangement,articulation,bark,calyx,color,connation,corolla,foetid,foliage,form,fruit,fruiting,growth,height,history,inflorescence,leaf,length,life,na,ovary,papillae,pedicel,plant,position,present,recurved,seed,shape,shiny,size,stem,straightnes,style,texture,truncate,tube,tuber-bearing,young
542	wfo-0001029780	success	204	120	86	118	34	0.422	1-10,1-2,1.4-1.9,15-22,15-45,2-12,2-2.5,2-3.5,2-5.5,2.4-4.2,3,3-6,3.5-7.3,4.5-6,8-12,absent,anther,articulated,axillary,base,borne,bud,cm,connivent,cordate,corolla,cuneate,dark,decumbent,densely,diameter,distal,end,forked,fruit,globose,green,greenish,hair,half,herb,high,interjected,lanceolate,lateral,leaflet,length,like,minute,mm,mucilaginous,non-glandular,odd-pinnate,ovate,ovoid,pedicel,peduncle,petiole,petiolule,plant,poricidal,pubescent,rarely,rotate,seed,short,singly,size,stem,stigma,straight,streak,stripe,style,subtending,terminal,tip,trichome,truncate,tube,typically,wet,white,whitish,x,yellow	1-1.2,1.5-2,11-24,120-210,2-2.8,20-60,4-6,5-7,5-merou,5.5,5.5-13,50-70,600-950,?,abaxially,acumen,acute,adaxially,ag,along,alyx,apart,apex,apparently,attenuate,axe,berry,blade,brownish,capitat,cell,chartaceous,ciliate,condition,covering,digestion,dorsally,drying,eaf,edge,eed,enzyme,erec,especially,exceeding,except,filament,flat,flower,folded,fresh,geminat,generally,glabrou,glabrous,gland,glandular,greatly,green-white,hair-like,hal,head,homostylous,honeycomb-shaped,invested,lengthening,living,lobe,long,longer,lower,make,margin,membranous,midrib,minutely,nflorescence,obtuse,often,orbicular,orolla,pair,pale,perfect,petiolulate,pinkish,plurifoliate,pore,proximal,puberulent,reduced,removed,ripe,ruit,sessile,seudostipule,slit,spaced,specimen,stamen,ste,stolo,subequal,tall,tamen,tem,testal,tetralobulate,thick,throughout,tri-,tuber,unit,unwinged,usually,vary,wall,ympodial	arrangement,articulation,bark,calyx,capitate,color,connation,dehiscence,erect,foetid,foliage,form,fruiting,growth,height,history,inflorescence,leaf,life,midpoint,na,ovary,papillae,position,prickle,pseudostipule,shape,spacing,stolon,straightnes,surface,texture,tuber-bearing,young
543	wfo-0001029784	success	237	109	79	158	30	0.333	-5,0-4,0.1-0.15,0.25-0.3,0.3-0.5,0.3-1,0.4-0.45,0.4-0.5,0.5-1.5,0.6-1,1-4,2,2-2.5,abaxial,acuminate,acute,anther,apex,articulated,base,brown,calyx,capitate,cm,corolla,dark,densely,diameter,distal,due,eglandular,elliptic,fruit,globose,golden,green,hair-like,half,herb,imparipinnate,inflorescence,interjected,interrupted,lateral,leaflet,long,long-acuminate,mm,narrowly,obovate,outgrowth,ovary,pale,paler,pedicel,peduncle,pentagonal,perennial,petiole,petiolule,plant,pseudostipule,pubescence,pubescent,simple,soft,sparsely,stem,stigma,stripe,style,surface,terminal,trichome,truncate,tube,velvety,wide,yellow	-12,.1,.2,.5,0.1-,0.1-0.5,0.2,0.2-,0.2-0.3,0.2-0.5,0.3-0.35,0.3-0.4,0.4-,0.4-0.6,0.5,0.5-,0.7-1.2,0.9-1.2,1,1-,1-1.1,1-1.2,1-1.5,1-2,1-2-celled,1.0-1.3,1.2-2.5,1.5-,1.7-2.6,1/3,2-,2-3-celled,2-4,2-4.5,2-foliate,2-locular,2.5-3.5,2/3,3-,3-5,5-10,5-14,5-8,abaxially,absent,abundant,adaxially,adpressed,along,angled,anthesi,apical,appearance,appendage,arising,articulation,axi,basal,basicopically,beneath,berry,bract,broadly,cell,column,conical,crenate-serrate,crenation,decurrent,deeper,developed,distributed,eaf,edicel,eed,enclosing,entire,evenly,exserted,filament,flower,fruiting,giving,glabrescent,glabrous,glandular,gree,hal,halfway,head,included,internode,interspersed,irregularly,lamina,lanceolate,larger,like,live,lobe,lon,loosely,lower,margin,markedly,maturing,mostly,multicellular,nflorescence,node,northern,occasionally,often,orbicular,pair,patent,population,present,primary,proximal,rarely,reflexed,ripe,robust,ruit,scattered,secondary,sessile,silky,smaller,sometimes,somewhat,sparse,spreadin,staminal,sterile,stout,straight,strongly,tem,tertiary,testa,thick,trailing,ud,undulate,unicellular,uniseriate,unit,unseriate,usually,vein,wall,white,winged,woody,x,ympodial	0.1,0.1-0.3,0.2-1.2,0.4-2,0.5-2.5,1.2-3.5,2-14,adaxial,arrangement,bark,color,connation,dehiscence,diminishing,form,growth,height,history,leaf,length,life,na,papillae,seed,shape,size,spacing,straightnes,texture,tuber-bearing
544	wfo-0001029785	success	223	162	127	96	35	0.57	0-2,0.1-0.5,0.3-2.2,0.4-4.9,1-10,1-2,1.2-3.2,1.5-3.6,1.8-7,10-26,2-4,3-6,4-10.5,5-9,6,8-11,abaxially,absent,adaxially,anther,apart,articulation,axillary,borne,broadly,brownish,bud,cell,chartaceous,clavate,cm,commonly,condition,connivent,corolla,covering,dark,darker,decumbent,diameter,distal,drying,elliptic,end,forked,fresh,fruit,generally,glabrous,globose,green,greenish,hair,hair-like,half,herb,interjected,invested,lanceolate,lateral,leaf,leaflet,lengthening,like,long,make,margin,membranous,middle,minute,mm,mottled,mucilaginous,multiple-celled,non-glandular,obovate,odd-pinnate,orbicular,outer,ovate,ovoid,pedicel,peduncle,pentagonal,petiole,petiolulate,plant,point,pore,poricidal,present,pubescent,purple,quite,ripe,rotate,rounded,scale-like,seed,sessile,short,singly,size,slightly,slit,sparsely,stem,stigma,straight,style,subglabrous,subtending,terminal,testal,thick,tip,tube,typically,unbranched,unwinged,variable,violet,wall,wet,whitish,x,yellow	0-3,0.8-1,1-1.2,1-5,1.8-3.5,3-4,3-8,3.5-5,3.8-7.2,5-16,5-merou,acumen,acute,ag,along,alyx,apex,apparently,attenuate,axe,base,berry,blade,capitat,cordate,cuneate,decreasing,denser,digestion,dorsally,eaf,edge,eed,enzyme,erec,especially,exceeding,filament,flat,flower,folded,geminat,glabrou,greatly,green-white,homostylous,honeycomb-shaped,larger,living,lobe,lower,markedly,medium,midrib,minutely,much,nflorescence,oblique,obtuse,one-quarte,orolla,pair,pale,perfect,petiolule,plurifoliate,puberulent,purple-tinged,rarely,removed,ruit,seudostipule,shallowly,sometimes,spaced,specimen,stamen,ste,stolo,stripe,tall,tamen,tem,throughout,toward,tri-,truncate,tuber,unequal,unit,usually,vary,vein,white,wide,ympodial	age,arrangement,bark,calyx,capitate,color,connation,dehiscence,erect,foetid,foliage,form,fruiting,growth,height,history,inflorescence,length,life,na,one-quarter,ovary,papillae,position,prickle,pseudostipule,shape,spacing,stolon,straightnes,surface,texture,trichome,tuber-bearing,young
545	wfo-0001029788	success	194	119	82	112	37	0.423	0-5,0.7-2,1-10,1-2,1.2-2,1.5-2,12-15,2.4-5.5,25-30,3.5-6,4-6,4.5-5,5,6,6.5-7,abaxially,adaxially,anther,articulated,axillary,base,berry,brownish,bud,chartaceous,cm,condition,conical,connivent,corolla,densely,diameter,distal,drying,elliptic-lanceolate,end,forked,fresh,green,greenish,half,herb,interjected,lanceolate,lateral,leaf,leaflet,light,long,minute,mm,mottled,mucilaginous,odd-pinnate,ovoid,pedicel,peduncle,petiole,plant,poricidal,pubescent,purple,ripe,rotate,seed,semierect,singly,size,sparsely,stigma,style,subsessile,subtending,terminal,tip,tube,typically,violet,wet,whitish,x,yellow	.4,.7,0.5,2-2.5,2-4,3-4,4,4-5,5-13,5-merou,7-21,absent,acumen,acuminate,ag,along,alyx,apart,apex,asymmetrical,attenuate,axe,basiscopic,blade,borne,c.,capitat,cell,ciliate,commonly,covering,decreasing,digestion,dorsally,eaf,edge,eed,elliptic,enzyme,equal,erec,especially,filament,flat,flower,folded,geminat,generally,glabrou,glabrous,gradually,green-white,hair-like,hal,homostylous,honeycomb-shaped,increasing,larger,lengthening,living,lobe,lon,lower,make,margin,middle,midrib,minutely,narrow,nflorescence,orbicular,orolla,pair,petiolule,pilo,plurifoliate,pore,puberulent,ray,removed,ruit,secondary,sessile,seudostipule,side,slightly,slit,spaced,specimen,stolo,straight,subequal,symmetrical,tall,tamen,tem,testal,thick,throughout,tissue,toward,tri-,tuber,unit,unwinged,usually,vary,wall,white,wide,wing,ympodial	arrangement,articulation,bark,calyx,capitate,color,connation,dehiscence,erect,foetid,foliage,form,fruit,fruiting,growth,height,history,inflorescence,length,life,midpoint,na,ovary,papillae,position,prickle,pseudostipule,shape,spacing,stem,stolon,straightnes,surface,texture,trichome,tuber-bearing,young
546	wfo-0001029789	success	167	88	64	103	24	0.383	0-2,0.2-0.5,0.5-2.8,0.8-3.5,1-10,1-3,1.7-8.5,1.8-6.5,12,2-6,2-6.5,3-8.5,6-7,7-21,8-9,acuminate,acute,anther,apex,attenuate,base,blue,broadly,clavate,cm,corolla,decurrent,diameter,distal,forked,fruit,herb,interjected,lanceolate,lateral,leaf,leaflet,lilac,lunate,minute,mm,narrowly,odd-pinnate,ovate,pedicel,peduncle,pentagonal,petiole,plant,poricidal,pubescent,rotate,sessile,short,size,sparsely,stigma,style,subglabrous,terminal,tip,white,x,yellow	1-2,1.5-2,2-25,2-3,2.7-4.7,3-5,4-10,4-13,5-7,5-merou,6,7-16.6,abaxially,acumen,adaxiall,adaxially,ag,alyx,apart,apparently,articulated,axe,axillary,basiscopic,blade,bud,capitat,chartaceous,connivent,dark,decreasing,dorsally,eaf,edge,eed,erec,exceeding,filament,flat,flower,folded,formed,geminat,generally,glabrous,greatly,green,hair,hal,half,homostylous,lant,lengthening,light,like,linear,lobe,long,long-attenuate,lower,maturing,membranous,minutely,mottled,never,nflorescence,orbicular,orolla,ovary,pair,perfect,petiolulate,plurifoliate,pore,pubescen,purpl,rachi,rarely,seudostipule,side,simple,slightly,slit,spaced,stamen,star,ste,sterile,straight,subequal,subtending,tall,tamen,tem,tinged,toward,tri-,tube,typically,unit,usually,vary,ympodial	arrangement,calyx,capitate,color,dehiscence,diminishing,erect,form,growth,height,history,inflorescence,length,life,na,petiolule,pseudostipule,seed,shape,spacing,stem,surface,texture,ye
547	wfo-0001029810	success	149	112	75	74	37	0.503	0.5-3,1-1.5,1-10,1.1-2.3,1.5-3,5-6,acuminate,acute,adaxially,along,anther,apex,apically,arachnoid,attenuate,bark,base,brown,calyx,capitate,closely,cm,compact,compressed,corolla,dark,dendritic,elliptic,fruiting,glabrous,globose,green,inflorescence,internodal,lateral,leaf,lobed,minutely,mm,narrowly,nearly,occasionally,opposite,ovary,ovoid-reniform,pale,papillose,pedicel,petiole,pitted,pointed,poricidal,pubescent,reddish-brown,shaped,shining,shrub,simple,size,small,spaced,sparsely,stem,stigma,style,surface,tan,tear-drop,tip,tree,trichome,tube,vein,white,young	.25,.5,0.5-1,1-1.3,1-2,1-3,2-3,2-5,2.5-3,3-3.5,3-4,3-6,4-10,5-15-flowered,5-16,8-12,abaxially,anthesi,ape,berry,congested,conical,deflexed,deltate,densely,dia,differing,difoliate,drying,eaf,edicel,eed,ellipsoid,exserted,filament,fleshy,free,geminat,glabrou,large,later,lenticel,less,like,lobe,lon,long,lower,main,major,margin,middle,minor,nflorescence,older,overlappin,papillo,planar,pore,portion,rest,ruit,scar,slender,tall,tapering,tub,ud,unit,wide,widest,woody,yellowish,ympodial	alternate,arrangement,articulation,color,connation,dehiscence,diameter,diminishing,distal,foetid,foliage,form,fruit,growth,height,history,interjected,leaflet,length,life,midpoint,na,overlapping,papillae,peduncle,petiolule,plant,position,prickle,pseudostipule,seed,shape,spacing,straightnes,terminal,texture,tuber-bearing
548	wfo-0001029811	success	225	111	78	147	33	0.347	-3,0-35,0.3-1,1.3-1.7,1.5-2.5,1.5-6,13-20,15-23,15-50,3-5.5,5-9,8-12,anther,apart,apex,apparently,articulated,bark,base,berry,calyx,cell,chartaceous,cm,connivent,cordate,dark,diameter,distal,elongating,flattened-reniform,fruit,fruiting,glandular,hair,herb,lateral,leaf,length,lobed,long,maturity,mauve,midpoint,mm,moderately,obtuse,orange-brown,outline,ovate,pedicel,peduncle,petiole,pit,plant,poricidal,porrect,prickle,raised,scandent,sessile,shrub,simple,small,smooth,spherical,stellate-pubescent,stem,straight,style,surface,tapering,tip,trichome,tube,unbranched,yellow,young	-6,-merous,.5,/3,0,0-30,0.1-0.3,0.1-0.4,0.2,0.2-0.6,0.3-1.5,0.5-2,0.8-1.5,1,1-1.5,1-2.5,1-3,1/,1/2-2/3,1/3,1/3-2/3,10-22,2-2.5,2-5,2-5.5,2.5-3,2.8-3.2,20-100,3-5,3-7,3.5-4.5,4-8,4.5-5,5,5-11,5-17,5-40,6-12,7-18,7-9,8-18,abaxial,abaxially,acicular,adaxial,alyx,andromonoecious,apar,apically,blade,broad-deltate,brown,cream,cuneate,densely,discolorous,distance,drying,eaf,eed,elongate,equal,erect,extending,eye,faint,fewer,filament,flattened,flower,free,glabrous,green,green-brow,hermaphrodite,heterostylous,inflated,infructescence,less,lobe,lobing,long-acuminat,long-styled,longer,lower,lowermost,margin,marking,mature,midvein,minute,multangulate,naked,narrow-deltate,nflorescence,often,older,one,open,orolla,oung,pair,pale,pendulous,per,pericarp,perpendicular,plurifoliat,portion,prickl,prickly,primary,ray,ruit,scar,secondary,short,short-styled,shorter,side,slightly,sometimes,spaced,sparsely,spreading,stalk,stalked,staminat,stellate,stout,tamen,terete,tertiary,time,unarmed,unit,upper,usually,vary,vein,venation,visible,way,wide,woody,yellow-green,ympodial	arrangement,articulation,color,connation,corolla,dehiscence,diminishing,foetid,foliage,form,green-brown,growth,height,history,inflorescence,interjected,leaflet,life,na,ovary,papillae,petiolule,position,pseudostipule,seed,shape,size,spacing,stigma,straightnes,terminal,texture,tuber-bearing
549	wfo-0001029938	success	179	106	74	105	32	0.413	0.7-1.2,1-1.5,1-2.5,1-4,3-7,3/4,6-8,acute,anther,apex,appearing,bark,base,becoming,berry,black,bright,calyx,capitate,clavate,cm,corolla,dendritic,densely,diameter,elliptic,fine,flattened,fruit,fruiting,glabrous,globose,greenish,grey,growth,later,lateral,leaf,length,lenticular,lobe,long,maturity,minutely,mm,narrowly,occasionally,ovary,pedicel,petiole,pitted,plant,plurifoliate,poricidal,pubescent,pyramidal,red,reddish-brown,shrub,small,stem,stigma,style,surface,tall,terminal,tip,tree,trichome,tube,violet,way,white,young	.5,0,0.5,0.7-1,1,1-3,1.2-1.5,1.5-2,1.5-2.5,1/2,10-20,12,12-15,2-2.5,2.5-3,4,5,6-9,8-10,abaxially,absent,accrescent,adaxially,along,anthesi,apical,ba,basal,blade,branching,broader,conical,deciduous,deflexed,deltoid,denser,dichasia,discussion,drying,eaf,edicel,eed,elliptical,entire,ew,exserted,filament,flower,free,glabrate,glabrou,growing,horizontal,inserted,larger,lon,long-triangular,lower,m.,margin,monochasial,near,nflorescence,older,overtopping,pair,papillo,parallel,per,perhaps,pericarp,planar,plane,pore,portion,prominent,raised,ruit,scar,secondary,see,shade,shoot,sleeve,slit-like,somewhat,soon,sparsely,specimen,stamen,strongly,tapering,thin,time,tub,ud,unit,upon,upper,vein,wide,winged,woody,x,ympodial	arrangement,articulation,color,connation,dehiscence,diminishing,distal,foetid,foliage,form,height,history,inflorescence,interjected,leaflet,life,midpoint,na,papillae,papillose,peduncle,petiolule,position,prickle,pseudostipule,seed,shape,size,spacing,straightnes,texture,tuber-bearing
550	wfo-0001029945	success	211	100	65	146	35	0.308	0-0.6,0-10,1.3-3.5,1.5-4,10-17,15-24,3-6,3-9,4-10,6-10,9-10,accrescent,acicular,acute,anther,apex,articulated,base,broadly,calyx,chartaceous,cm,connivent,cordate,dark,diameter,extra-axillary,flower,fruit,fruiting,globose,green,inflorescence,lanceolate,lateral,leaf,length,long,longer,midpoint,mm,obtuse,ovate,pale,pedicel,peduncle,perennial,petiole,plant,prickle,pseudo-racemose,purple,rotate,shrub,simple,stem,stigma,straight,streak,style,surface,time,tube,wide,yellow	%,.05,0,0-0.3,0-0.5,0-1,0-2,0.15-0.25,0.2-0.3,0.35-0.45,0.4-0.5,0.4-0.7,0.5,0.7-1.2,0.8-1,1-1.3,1-1.5,1-3,1-8,1.2-1.6,1.4-2.7,1.7-4,1.8-2.4,17-26,2-30,2-4,2-5,2-locular,2.1-3.3,2.5-2.8,3-17,3-5,4-5.5,4-7,4-9,5-8,5-merou,5.5-17,6-7,6-8,7-14,7-24,7-9,9-24,abaxial,abaxially,absen,absent,across,adaxial,adaxiall,adaxially,adult,alyx,andromonoecious,anvil-shape,apart,armed,attenuate,ba,blade,broad-based,cross-section,cylindrical,d.,deeply,densely,directed,distall,distally,dult,eaf,eed,eglandular,erect,exocarp,filament,finger,functional,geminate,glabrous,gland-tipped,grey,hair,half,heterostylous,hig,index,juicy,juvenile,less,lobe,lobed,lobing,lon,lower,margin,markedly,mature,mesocarp,mid-point,midvein,minute,mixed,moist,nflorescence,oblique,orolla,pair,part,per,placenta,pore,porrect,present,ray,rhizomatous,ruit,sessile,shallowly,short,side,sparsely,stalk,stalked,stellae,stellate,stellate-pubescent,tamen,thick,thicker,throughout,transparent,triangular,truncat,unarmed,unbranched,unit,upper,vary,vein,weakly,white,x,yellowish,ympodial	arrangement,articulation,bark,color,connation,corolla,dehiscence,diminishing,distal,foetid,foliage,form,growth,height,history,interjected,leaflet,life,na,ovary,papillae,petiolule,position,pseudostipule,seed,shape,size,spacing,straightnes,terminal,texture,trichome,truncate,tuber-bearing,young
551	wfo-0001029968	success	299	150	123	176	27	0.411	.5,0.1-0.25,0.25,0.25-0.3,0.3,0.3-1,0.4,0.5,0.7-2,0.8-1.2,1-3,1.5-3,1/4-1/3,2-3,2.5-3.5,3-4,4,6-8,absent,accrescent,along,anther,anthesi,apex,armed,articulated,articulation,bark,base,berry,black,branch,branched,brown,calyx,capitate,chartaceous,clavate,clustered,cm,cordate,corolla,cuneate,curved,dark,dehiscence,deltoid,diameter,discolorous,distributed,drying,erect,evenly,extending,fasciculate,filiform,finely,flattened,flattened-reniform,forming,fruit,fruiting,gray,greyish,inflorescence,irregular,large,lateral,leaf,length,less,long,mature,maturity,midpoint,mixture,mm,oblique,often,orange,orange-brown,ovate,pale,pedicel,peduncle,petiole,pitted,poricidal,porrect,prickle,ray,red,rounded,seed,sessile,shoot,shorter,shrub,size,small,smooth,sometimes,somewhat,spheroidal,stalk,stalked,stem,stigma,straight,strongly,style,surface,tapering,terminal,tip,translucent,trichome,tube,unarmed,usually,virtually,widening,young	-2,-3,.2,.25,.7,/3,0,0.15,0.2-0.4,0.3-0.4,0.4-0.6,0.7-0.9,0.7-1,0°,1,1-2.5,1.2-5.5,1.5,1.5-2.5,1/6-1/8,2-2.3,2.5-4,2.5-5.5,2.8-3,3-11,4-6,4-7,4-8,4-merou,7-9,abaxially,acicular,acuminate,acute,adaxially,adjacent,age,almost,alternate,alyx,apart,apically,apparently,area,arising,basally,becoming,brachyblast,branching,ca,canaliculate,central,covered,cupular,densely,detaching,development,dilated,divided,dry,eaf,early,edge,eed,ellipsoi,elongating,entire,equal,except,filament,flat,flexuous,flower,free,glabrescent,glabrous,grey-green,increasing,indumentum,inside,invisible,irregularly,large-leaved,leave,leaved,lengt,lengthening,like,line,lobe,lobed,lobing,looping,lower,m.,main,margin,middle,midvein,minor,network,nflorescence,nther,obconical,oblong,obscured,obscurely,occasionally,opposite,orolla,outside,ovoid,pair,paler,papillose,patch,pendulous,per,perfect,pericarp,pit,plurifoliat,pore,portion,present,primary,prior,prominent,protruding,pubescent,rachi,raised,reddish,reduced,regular,remnant,ridged,rounded-undulate,ruit,scar,secondary,seemingly,seen,shiny,simple,sinus,small-leaved,smoot,sparse,sparsely,specimen,spreading,stellate,stellate-pubescent,stump,tearing,terete,tertiary,thicker,thin,toward,ud,unarme,undulate,uneven,unit,variable,vary,vein,venation,visible,white,wide,wrinkled,x,ympodial	apical,arrangement,color,connation,diminishing,distal,foetid,foliage,form,growth,height,history,interjected,leaflet,life,na,ovary,papillae,petiolule,plant,position,pseudostipule,shape,spacing,straightnes,texture,tuber-bearing
552	wfo-0001029978	success	208	115	79	129	36	0.38	0.5-0.6,0.7-1.9,0.9-2.3,1-10,1-2,1.5-3.1,1.8-5,15-27,2-4,3-5,3.1-6.3,3.7-8.1,4-11,4-7,5,8-10,acuminate,anther,apex,articulated,base,berry,brownish,chartaceous,clavate,cm,condition,conical,connivent,corolla,diameter,distal,drying,elliptic,forked,fresh,fruit,green,greenish,herb,interjected,lanceolate,lateral,leaf,leaflet,light,membranous,middle,minute,mm,mucilaginous,odd-pinnate,ovate,ovoid,pedicel,peduncle,pentagonal,petiole,petiolule,plant,poricidal,purple,ripe,rotate,seed,semierect,size,stem,stigma,straight,style,subsessile,terminal,tip,tube,wet,whitish,x,yellow	0.3-0.4,0.3-0.7,0.8,1.3-1.5,1.4-1.5,11-19,3-7,3.2-2.5,3.5-9.5,4.2-5.2,5-16.5,5-merou,abaxially,acumen,adaxially,ag,along,alyx,apart,apparently,arranged,asymmetrical,attenuate,axe,axillary,basiscopic,bead,blade,bud,capitat,cell,ciliate,coarsely,commonly,covering,dark,darker,decreasing,digestion,dorsally,eaf,edge,eed,enzyme,erec,especially,exceeding,filament,finely,flat,flower,folded,fourt,geminat,generally,glabrou,glabrous,gradually,green-white,hair,hair-like,half,homostylous,honeycomb-shaped,larger,lengthening,less,like,living,lobe,long,lower,make,margin,medium,midrib,minutely,moniliform,mottled,multiple,narrow,necklace,nflorescence,orbicular,orolla,pair,perfect,plurifoliate,pore,puberulent,pubescen,pubescent,ray,removed,ruit,secondary,sessile,seudostipule,side,simple,slightly,slit,spaced,sparsely,specimen,stamen,ste,stolon,subequal,subtending,symmetrical,tall,tamen,tem,testal,thick,throughout,tissue,toward,tri-,tuber,typically,unit,usually,vary,wall,wide,wing,ympodial	arrangement,articulation,bark,calyx,capitate,color,connation,dehiscence,diminishing,erect,foetid,foliage,form,fourth,fruiting,growth,height,history,inflorescence,length,life,na,ovary,papillae,position,prickle,pseudostipule,shape,spacing,straightnes,surface,texture,trichome,tuber-bearing,ye,young
553	wfo-0001029980	success	173	88	62	111	26	0.358	.5,0.1-0.25,0.5-2.5,0.5-5,0.7-1.3,1-1.5,2-5,acute,anther,appressed,bark,base,brown,calyx,cm,corolla,curved,dark,deltoid,elliptic,flattened-reniform,glabrous,globose,gray,green,greenish-white,lateral,leaf,lobed,minutely,mm,opposite,ovary,ovate,pale,pedicel,petiole,pitted,plant,poricidal,puberulent,rounded,shape,shiny,shrub,simple,size,slightly,small-capitate,stem,stigma,straight,style,surface,tan,tip,trichome,tube,unicellular,uniseriate,white,young	.1,0.25-0.5,0.25-1,0.5-1,0.5-1.2,0.8-1.2,0.9-4.5,1-1.7,1.2-2.5,1.5-2,1.5-6,2-6,2/3,3-4,3-9,5-10,5-50-flowered,6.4-17,abaxially,adaxially,anthesi,apar,apex,appearing,axil,ba,berry,black,bright,bud,closely,conical,decurrent,deflexed,density,dia,differing,difoliate,dried,drying,eaf,edicel,eed,elevation,especially,exserted,filament,five,free,fruiting,geminat,greatly,high,impressed,incrassate,knob,live,lobe,lon,long,lower,main,major,margin,material,middle,minor,near,nflorescence,node,often,older,one,onto,orbicular,overlapping,pair,paler,papillose,pore,portion,prominent,proximal,race,reflexed,ruit,scar,shaped,side,slender,somewhat,soon,spaced,specimen,tall,tapering,tear-drop,tuft,ud,unit,varying,vein,venezuelan,way,whit,widest,winged,woody,x,yellowish,ympodial	apart,arrangement,color,connation,dehiscence,diameter,form,fruit,growth,height,history,inflorescence,interjected,leaflet,length,life,midpoint,na,papillae,peduncle,pseudostipule,seed,spacing,straightnes,terminal,texture
554	wfo-0001029989	success	161	94	63	98	31	0.391	0.5-1,0.5-1.5,1-2.5,3-8,abaxially,acute,adaxially,anther,bark,base,calyx,capitate,closely,cm,conical,corolla,dendritic,densely,difoliate,elliptic,flattened,glabrous,globose,golden,gray,green,greenish-black,incrassate,inflorescence,lateral,leaf,lenticular,lobed,margin,minutely,mm,nearly,ovary,pedicel,petiole,pitted,poricidal,pubescent,reddish-brown,shaped,shining,shrub,simple,small,spaced,stem,stigma,style,surface,tear-drop,tip,tree,tree-like,trichome,tube,unifoliate,white,young	.2,.5,/2,0.25-0.5,1-1.5,1-2,1-4,1.3-2.3,1.5-2.5,10-14,2.5-3,3-5,3.5-8,4-4.5,5-10-flowered,5-6,7-20,abaxial,anthesi,apex,berry,branch,branched,broadly,brownish-re,central,collection,congested,deflexed,deltoid,dense,described,dia,dimaeter,discussion,drying,due,eaf,edicel,eed,erect,exserted,filament,fleshy,free,fruiting,geminat,heteromorphic,inflorescenc,internodal,lamina,like,lobe,lon,long,lower,main,middle,nflorescence,nodding,northern,occasionally,older,opposite,overlappin,pair,papillo,peru,peruvian,perú,petal,petaloid,planar,population,pore,portion,probably,pubescence,reddish,rest,ruit,scar,scattered,see,short-style,somewhat,sparsely,tall,ud,unit,vein,way,wide,widest,woody,x,yellow,ympodial	2.5-6,arrangement,brownish-red,color,connation,dehiscence,diameter,form,fruit,growth,height,history,interjected,leaflet,length,life,midpoint,na,overlapping,papillae,papillose,peduncle,plant,pseudostipule,seed,shape,size,spacing,straightnes,terminal,texture
555	wfo-0001030000	success	155	101	54	101	47	0.348	-4,0.5-1,0.5-3,1-10,1.5-,15-25,2-3,2-5,3-16,4-5,acute,apart,apex,articulated,base,calyx,cm,connivent,densely,diameter,ellipsoidal,flattened,fruit,glabrous,globose,green,immature,mature,mm,oblong,obtuse,orange,ovoid,pedicel,peduncle,puberulent,pubescent,purplish,shrub,small,spotted,stellate,stigma,style,tinge,tree,truncate,tube,unbranched,white,x,yellow,yellow-brown,yellowish	-5,-50,-7,-pilose,0.5-,0.5-14,1,1-,1-2,1.5-2,10-,10-20,2-2.5,2-4,2.5-,2.5-3,2.5-3.5,25-30,3-,3-4,3.5-5,30-50,4,4-4.5,4-foliat,7-15,abaxially,absent,adaxially,aggregate,also,ape,apiculate,axe,biglandula,cell,chartaceous,ciliat,connective,conspicuous,coriaceous,creamy-whit,cucullate,deltate,dia,dilated,directed,distally,eed,eglandular,equal,exceeding,flower,hair,laterally,leaving,lobe,lon,long,lower,margin,moderately,narrowly,nflorescence,nther,occasionally,orolla,pedicellar,perfect,pilose,pore,produced,pubescen,rachi,radiu,rarely,remnant,ruit,scar,shorter,slightly,smal,spaced,sparsely,stamen,stone,strongly,subcoriaceous,swelling,tal,tem,thecae,tip,tomentose,triangular,ud,umbrella-shaped,unit,vary,wide,ympodial	4-foliate,anther,arrangement,articulation,bark,biglandular,color,connation,corolla,dehiscence,diminishing,distal,foetid,foliage,form,fruiting,growth,height,history,inflorescence,interjected,lateral,leaf,leaflet,length,life,na,ovary,papillae,petiole,petiolule,plant,position,prickle,pseudostipule,seed,shape,size,spacing,stem,straightnes,surface,terminal,texture,trichome,tuber-bearing,young
556	wfo-0001030000	success	178	118	73	105	45	0.41	-4,0.5-,0.5-1,0.5-13,0.5-3,1,1-10,1-5,1.5-,15-25,2-3,2-5,3-16,4-5,acuminate,acute,apart,apex,articulated,basal,base,calyx,cm,connivent,conspicuous,cordate,densely,diameter,ellipsoidal,flattened,fruit,glabrous,globose,green,immature,leaving,lobe,long,mature,mm,oblique,oblong,occasionally,often,orange,ovate,pedicel,pedicellar,peduncle,petiole,pubescent,purplish,rachi,remnant,scar,shrub,simple,small,spotted,stellate,stigma,style,subcoriaceous,tinge,tree,truncate,tube,unbranched,white,x,yellow,yellow-brown,yellowish	-2,-5,-50,-7,-pilose,0.5-14,1-,1-1.5,1-2,1.5-2,10-,10-20,2-,2-2.5,2-4,2.5-,2.5-3,2.5-3.5,25-30,3-,3-4,3.5-5,30-50,4,4-25,4-4.5,4-foliat,5-25,7-15,abaxially,absent,adaxially,aggregate,also,ape,apiculate,axe,biglandula,blade,cell,chartaceous,ciliat,connective,coriaceous,creamy-whit,cucullate,deltate,dia,dilated,directed,distally,eaf,eed,eglandular,elliptic,entire,equal,exceeding,flower,glabrescent,hair,laterally,lon,lower,margin,moderately,narrowly,nflorescence,nther,obtuse,orolla,ovoid,perfect,pilo,pilose,pore,produced,puberulent,pubescen,radiu,rarely,ruit,shorter,slightly,smal,spaced,sparsely,stamen,stone,strongly,swelling,tal,tem,thecae,time,tip,tomentose,triangular,ud,umbrella-shaped,unit,vary,vein,wide,ympodial	anther,arrangement,articulation,bark,biglandular,color,connation,corolla,dehiscence,diminishing,distal,foetid,foliage,form,fruiting,growth,height,history,inflorescence,interjected,lateral,leaf,leaflet,length,life,na,ovary,papillae,petiolule,plant,position,prickle,pseudostipule,seed,shape,size,spacing,stem,straightnes,surface,terminal,texture,trichome,tuber-bearing,young
557	wfo-0001030004	success	177	103	69	108	34	0.39	0-1.5,0.2-1,1-2,1.5-2.5,2-20,5-25,acuminate,acute,adaxially,anther,apex,bark,base,calyx,capitate,cm,corolla,dendritic,distal,elliptic,flattened-reniform,fruiting,glabrous,globose,green,inflorescence,later,lateral,leaf,lobed,long,loose,minutely,mm,nearly,obovate,occasionally,ovary,pale,pedicel,petiole,pitted,plant,plurifoliate,poricidal,pubescent,seed,sessile,shaped,shrub,small,sparsely,stem,stigma,style,surface,tan,tear-drop,terminal,thick,tip,translucent,tree,trichome,tube,variously,white,yellowish-green,young	.3,0-0.5,0.3-1,0.8-1.1,1-1.5,1.2-2,15,15-20,20-200-flowered,3-3.5,3-4,3.5-5,4-15,9-30,abaxial,abaxially,across,along,always,anthesi,apar,appearanc,axillary,barely,basal,berry,blade,body,branched,branching,broadly,bushy,collection,cone,conical,crotaloid,decurrent,deltate,dense,densely,denser,dia,diamete,drying,eaf,edicel,eed,erect,especially,exserted,filament,flat,fleshy,free,giving,greenish-yello,hard,incrassate,juvenile,knob,lamina,large,like,lobe,lower,main,many,margin,middle,much,nflorescence,obovoid,often,older,onto,pair,papillate,papillo,pericarp,planar,pore,portion,possessing,prominent,pubescence,rest,ruit,scar,simple,spaced,stout,strongly,surpassing,tall,thin,time,tub,tuft,ud,unevenly,vein,wide,widest,winged,woody,x,yellowish,ympodia	apart,arrangement,articulation,color,connation,dehiscence,diameter,diminishing,foetid,foliage,form,fruit,greenish-yellow,growth,height,history,interjected,leaflet,length,life,midpoint,na,papillae,peduncle,petiolule,position,prickle,pseudostipule,shape,size,spacing,straightnes,texture,tuber-bearing
558	wfo-0001030007	success	168	113	75	93	38	0.446	.5,0.2-1,0.8-1,1-15,1-2,1.5-5,15-20,2-4,2-7,3/4,7-10,7-9,acuminate,acute,along,anther,apart,apex,bark,base,beneath,brown,calyx,clavate,cm,corolla,dry,elliptic,flattened,fruiting,glabrous,globose,golden,green,lateral,leaf,live,lobed,long,material,midrib,minutely,mm,oblique,opposite,ovary,pale,papillose,pedicel,petiole,pitted,plant,poricidal,pubescent,reniform,rounded,shrub,simple,slightly,small,soft,stem,stigma,straight,style,surface,tip,tree,trichome,tube,uniseriate,way,white,x,young	.05,.4,0.1-0.5,0.5-1,1-1.5,1.6-2.2,3-5,4.5-5,6-10-flowered,abrupt,anthesi,ba,becoming,berry,branched,broadly,bud,campanulate,closely,cork,dark,decurrent,deltoid,densely,dia,difoliate,edicel,eed,erect,exserted,filament,fleshy,free,geminateleaf,glabrate,golden-pubescent,gre,hooded,impressed,incrassate,inflorescenc,like,lobe,lon,longer,lower,main,major,margin,middle,minor,nflorescence,obovoid,occasionally,older,one,onto,outline,pair,papillo,planar,pore,portion,prominent,raised,rest,ruit,scar,shaped,short,shorter,slender,soon,spaced,sparsely,specimen,tall,tapering,tear-drop,thick,thickened,trunk,tub,two,type,ud,unit,vein,widening,widest,winged,woody,ympodial	alternate,arrangement,articulation,color,connation,dehiscence,diameter,diminishing,distal,foetid,foliage,form,fruit,grey,growth,height,history,inflorescence,interjected,leaflet,length,life,midpoint,na,papillae,peduncle,petiolule,position,prickle,pseudostipule,seed,shape,size,spacing,straightnes,terminal,texture,tuber-bearing
559	wfo-0001030010	success	156	101	65	91	36	0.417	0.5-5,0.9-1.1,1.5-2,2-7,5-7,acuminate,acute,anther,apex,attenuate,bark,base,brown,calyx,closely,cm,corolla,dark,deflexed,deltate,distal,fruit,fruiting,furcate,glabrous,globose,green,grey,lateral,leaf,lobed,long,minutely,mm,nearly,obovate,opposite,ovary,ovoid-reniform,papillose,pedicel,persistent,petiole,pitted,poricidal,puberulent,reddish,shrub,simple,size,small,smooth,spaced,stem,stigma,straight,style,surface,tiny,tree,trichome,tube,white,woody,young	.5,.75,/4,0.7-1,1-1.3,1-1.5,1-2,1.2-1.5,10-15,10-50-flowered,11-12,2-2.2,2.5,20-40,3-5,4-4.5,7-10,anthesi,appearing,area,basal,beneath,berry,bud,cyathiform,deciduous,decurrent,dia,differing,difoliate,dry,eaf,edicel,eed,ellipsoid,exserted,f,filament,fleshy,free,geminat,glabrate,hooded,lobe,lon,lower,m.,main,major,margin,materia,material,middle,midrib,minor,minute,near,nflorescence,occasionally,often,older,one,orange,overlappin,pair,planar,pore,portion,prominent,rather,ruit,scar,shaped,shin,slightly,soon,styl,tall,tapering,tear-drop,tip,trunk,ud,uniseriate,unit,vein,way,widest,winged,x,ympodial	2,arrangement,articulation,color,connation,dehiscence,diameter,diminishing,foetid,foliage,form,growth,height,history,inflorescence,interjected,leaflet,length,life,midpoint,na,papillae,peduncle,petiolule,plant,position,prickle,pseudostipule,seed,shape,shiny,spacing,straightnes,terminal,texture,tuber-bearing
560	wfo-0001030023	success	171	102	59	112	43	0.345	0.5-1,1-,1-2,1-8,1.5-7,10-,10-25,2-3,30-50+,4-10,4-12,7-9,acute,apart,apex,articulated,base,calyx,cm,color,connivent,cordate,cuneate,deeply,diameter,ellipsoidal,elliptic,flattened,fruit,globose,greenish-white,loosely,mm,narrowly,near,oblong,ovate,pedicel,peduncle,peltiform,petiole,probably,puberulent,purplish-,short-acuminate,simple,small,stellate,stigma,style,subcoriaceous,tree,triangular,truncate,tube,unknown,x,yellowish,young	-,0-100+,1,1.5-2,11-40+,12-18,13-20,2,2.5-3.5,20-30,3-4.5,3-5,4,4-foliat,5,5-,5-16,5-6,6-26,6-7,abaxially,adaxially,aggregate,ape,apiculate,axe,basal,beyond,blade,branched,capitat,cell,ciliate,connective,cylindrical,densely,denser,dilated,directed,distally,eaf,eed,entire,especially,exceeding,except,exserted,finely,fleshy,flower,forked,glabrous,glandular-puberulen,glandular-puberulent,hair,highly,lanceolate,leaving,lobe,lon,long,lower,main,margin,membranaceous,moderately,narrow,nflorescence,nther,oblique,obtuse,occasionally,often,orolla,pedicellar,perfect,pore,presen,present,prominent,pubescen,pubescence,pubescent,pubescent-pilo,rachi,radiu,remnant,ripe,ruit,shorter,slightly,somewhat,spaced,sparsely,stamen,stone,swelling,tal,tem,thecae,time,tip,ud,unbranched,unit,unknow,usually,vary,vein,villous,wide,ympodial	anther,arrangement,articulation,bark,capitate,connation,corolla,dehiscence,diminishing,distal,foetid,foliage,form,fruiting,growth,height,history,inflorescence,interjected,lateral,leaf,leaflet,length,life,na,ovary,papillae,petiolule,plant,position,prickle,pseudostipule,seed,shape,size,spacing,stem,straightnes,surface,terminal,texture,trichome,tuber-bearing
561	wfo-0001030032	success	250	122	92	158	30	0.368	0.25-0.4,0.5-1.5,0.6-1.1,0.8-1.1,1-1.3,1-1.5,2-3-locular,2-3.5,2-4,2-lobed,3.5-12,30,6-11,60-80,7-16,7.5-10,8-10,8-20,absent,acuminate,acute,anther,apex,articulated,articulation,base,basiscopically,branched,bright,brown,calyx,capitate,cm,completely,corolla,decurrent,densely,diameter,elliptic,fruit,fruiting,glabrous,golden,green,greenish-brown,hair-like,imparipinnate,interjected,interrupted,lateral,leaf,leaflet,length,long,many,middle,mm,oblanceolate,oblique,obovate,occasionally,opposite,orbicular,outgrowth,ovary,pale,pedicel,peduncle,petiole,petiolule,pithy,present,pseudostipule,pubescent,rotate,rotate-stellate,seed,somewhat,stem,stigma,style,subopposite,surface,terminal,time,trichome,truncate,tube,vine,wide,woody,yellow	+,.05,.5,0.1-0.4,0.1-0.5,0.2,0.2-0.3,0.2-0.5,0.4-1.5,0.5,0.5-0.6,0.5-0.7,0.5-1,0.5-2,0.7-0.8,0.8-1.0,1-2-celled,1-3,1-celled,1.5-2,1.5-2.5,11-20,13-35,2,2-10,2-5,2-60,2.4-3.5,3,3-5,3.0-3.5,4-5,4-6-celled,4-celled,4.3-5.0,5-plurifoliate,8-10-celled,abaxially,abundant,adaxial,adaxially,along,also,anthesi,apical,appearance,appendage,basal,basally,bent,border,branche,breaking,cell,clambering,column,conical,conspicuou,dark,deltate,densest,desne,dry,eaf,ebracteate,edicel,eed,entire,exserted,filament,flower,free,give,glandular,gree,halfway,hea,head,herbarium,internode,irregularly,lamina,large,larger,leave,like,lobe,longest,lower,margin,markedly,midvein,mixed,moderately,much,multicellular,nflorescence,node,often,older,onto,pair,paler,patent,primary,pubescence,rachi,reflexed,rest,rough,round,ruit,secondary,set,shorter,silky,simple,slightly,smaller,soft,sometimes,sparsely,sparser,specimen,splitting,spreading,stamen,staminal,sterile,straight,swollen,tall,tangled,tem,tertiary,testa,thick,thickened,tiny,tip,touch,transparent,ud,unicellular,uniseriate,unit,usually,vegetatio,vein,venation,wall,weaker-walled,well-developed,white,winged,ympodial,younger,½-3/4	arrangement,bark,climber,color,connation,decument,dehiscence,diminishing,distal,foetid,foliage,form,growth,height,history,inflorescence,life,na,papillae,plant,position,prickle,shape,size,spacing,straightnes,texture,tuber-bearing,ye,young
562	wfo-0001030048	success	156	106	68	88	38	0.436	0.5-1.5,1.3-1.6,2-3,2-5,5-8,abaxially,acute,adaxially,anther,apex,apically,arachnoid,bark,base,bi-colored,bi-lobed,blue,calyx,clavate,closely,cm,corolla,densely,elliptic,felt-like,fruiting,glabrate,glabrous,globose,green,greyish,internodal,lateral,leaf,lobed,matted,minutely,mm,nearly,opposite,ovary,ovoid-reniform,pale,pedicel,petiole,pitted,pointed,poricidal,reddish-brown,shaped,shiny,shrub,simple,small,spaced,stem,stigma,strongly,style,surface,tan,tear-drop,tip,tree,trichome,tube,white,young	.5,1-1.5,1-2,1.2-2,1.5-3.5,1.5-7,10-16,3-3.5,3-5,4-15,4-4.5,5-10-flowered,5973,abaxial,along,anthesi,ape,apparently,becoming,berry,broadly,brown,completely,conical,covered,decurrent,deflexed,deltate,dia,difoliate,drying,eaf,edicel,eed,ellipsoid,exserted,fide,filament,fleshy,four-angle,free,geminat,golden,impressed,inflorescenc,lamina,lightly,like,lobe,lon,long,lower,main,margin,middle,nflorescence,occasionally,older,onto,overlappin,pair,papillo,papillose,planar,pore,portion,prominent,pubescent,rather,rest,ruit,scar,solomon,somewhat,sparsely,tall,thick,thickened,trifoliate,tub,ud,unit,vein,wide,widest,woody,yellowish,ympodial	arrangement,articulation,color,connation,dehiscence,diameter,diminishing,distal,foetid,foliage,form,fruit,growth,height,history,inflorescence,interjected,leaflet,length,life,midpoint,na,overlapping,papillae,peduncle,petiolule,plant,position,prickle,pseudostipule,seed,shape,size,spacing,straightnes,terminal,texture,tuber-bearing
563	wfo-0001030053	success	141	104	62	79	42	0.44	0.5-1,1-1.3,1-13,1.3-3.5,1.8-2,2-2.5,5,abruptly,abscission,acuminate,acute,apart,apex,articulated,base,branch,branched,brown,calyx,cm,completely,corolla,decurrent,diameter,elliptic,flattened,fruiting,glabrous,greenish,growth,inflorescence,irregularly,leaving,many,minutely,mm,near,pale,pedicel,peduncle,peg,petiole,pitted,reniform,shiny,simple,sleeve,slightly,small,spaced,stem,surface,terminal,time,tiny,tip,truncate,tube,vine,white,woody,yellowish	0.5,1.5-5.5,10-20,100,2.5-3,3.5-4,4-,5-merou,7-11,7-9,<,aiding,alyx,anthesi,apical,apiculae,ark,around,berry,bfeore,cell,climbin,coriaceous,cyathiform,eaf,eed,entire,exserted,far,fide,filiform,fine,flower,fragrant,frui,hyaline,lobe,lobed,long,lower,margin,mentz,new,nflorescence,nipple,older,orolla,pair,papilla,papillo,parallel,pendant,per,perfect,plurifoliat,primary,rectangular,revolute,rim,scar,secondary,shallowly,shin,shining,spreadin,spreading,strongly,support,tem,testal,turbinate,twining,ud,unit,usually,vein,venation,x,ympodial	anther,arrangement,articulation,bark,color,connation,dehiscence,diminishing,distal,foetid,foliage,form,fruit,height,history,interjected,lateral,leaf,leaflet,length,life,midpoint,na,ovary,papillae,papillose,petiolule,plant,position,prickle,pseudostipule,seed,shape,size,spacing,stigma,straightnes,style,texture,trichome,tuber-bearing,young
564	wfo-0001030057	success	141	66	49	92	17	0.348	-2,1-10,1-2,2-4,2-4.5,20-30,20-80,3.5-8,4-10,5.5-12,8,absent,articulated,broadly,cm,diameter,distal,elliptic,forked,fruit,globose,green,greenish,herb,high,interjected,lateral,leaf,leaflet,long,mm,mucilaginous,odd-pinnate,ovate,ovoid,pedicel,peduncle,petiole,plant,pubescent,scale-like,seed,size,stem,subglabrous,suborbicular,terminal,whitish,x	2-3-celled,2-6,2.1-4.1,3-5,4.3-8.2,7-14,8-19,abaxially,acuminate,acute,adaxially,apart,apex,apparently,axe,axillary,base,berry,blade,borne,brownish,bud,cell,chartaceous,condition,cordate,covering,cuneate,decreasing,digestion,drying,eaf,eed,end,enzyme,erec,extremely,flower,fresh,geminat,generally,glabrou,greatly,green-white,hair,hair-like,half,honeycomb-shaped,larger,like,living,lunate,make,membranous,mottled,narrow,nflorescence,pair,perfect,petiolule,plurifoliate,purple,removed,ruit,seudostipule,short,singly,small,sometimes,spaced,specimen,ste,stolo,subtending,tall,tem,testal,thick,thir,throughout,toward,tri-,truncate,tuber,typically,unit,unwinged,usually,wall,wet,wing,ympodial	arrangement,articulation,color,form,growth,height,history,inflorescence,length,life,pseudostipule,pubescence,shape,spacing,surface,texture,third
565	wfo-0001030057	success	197	114	80	117	34	0.406	-10,1-10,1-2,2-4,2-4.5,20-30,20-80,3.5-8,4-10,5-10,5.5-12,8,abaxially,absent,adaxially,anther,articulated,base,broadly,brownish,cell,chartaceous,cm,condition,connivent,cordate,corolla,covering,cuneate,diameter,distal,drying,elliptic,forked,fresh,fruit,globose,green,greenish,hair-like,herb,high,interjected,lanceolate,lateral,leaf,leaflet,lunate,membranous,mm,odd-pinnate,ovate,ovoid,pedicel,peduncle,pentagonal,petiole,plant,poricidal,pubescent,rotate,seed,size,stem,stigma,straight,style,suborbicular,terminal,testal,thick,tip,truncate,tube,typically,wall,white,whitish,x,yellow	-2,.5-3.5,2-3,2-3-celled,2-5,2-6,2.1-4.1,3-5,4.3-8.2,5-6,5-merou,7-14,8-19,acumen,acuminate,acute,ag,along,alyx,apart,apex,apparently,axe,axillary,berry,blade,borne,bud,ciliate,decreasing,digestion,dorsally,eaf,edge,eed,end,enzyme,erec,especially,exceeding,extremely,filament,flat,flower,folded,geminat,generally,glabrou,glabrous,globo,greatly,green-white,greenish-yellow,hair,half,homostylous,honeycomb-shaped,larger,lengthening,like,linear,living,lobe,long,lower,make,margin,middle,midrib,minutely,mottled,mucilaginous,narrow,nflorescence,orolla,ovate-lanceolate,pair,perfect,petal,petiolule,plurifoliate,pore,puberulent,purple,removed,ruit,scale-like,seudostipule,short,singly,slit,small,sometimes,spaced,specimen,stamen,star,ste,stolo,striped,subglabrous,subtending,tall,tamen,tem,thir,throughout,toward,tri-,tuber,unit,unwinged,usually,vary,wet,wing,ympodial	arrangement,articulation,bark,calyx,color,connation,dehiscence,foetid,foliage,form,fruiting,growth,height,history,inflorescence,length,life,midpoint,na,ovary,papillae,position,prickle,pseudostipule,pubescence,shape,spacing,straightnes,surface,texture,third,trichome,tuber-bearing,young
566	wfo-0001030067	success	206	101	63	143	38	0.306	0-0.7,0-1,0-1.5,0.1-0.3,0.2-1,2-3,2.5-7,4.5-6,7-8,absent,accrescent,anther,apex,articulated,base,black,broadly,brown,calyx,chartaceous,cm,connivent,cordate,depressed-globose,diameter,extra-axillary,fruit,fruiting,globose,herbaceous,inflorescence,lateral,length,long,loosely,midpoint,mm,obtuse,orbicular,ovate,ovate-oblong,pedicel,peduncle,perennial,petiole,present,prickle,pseudo-racemose,purple,ray,resprouter,rhizomatous,rotate,shrub,simple,slightly,stem,stigma,straight,style,time,tube,yellow	%,.05,.5,0-0.1,0-0.2,0-2,0-30,0.1-0.25,0.1-0.5,0.15-0.3,0.2-0.35,0.2-0.4,0.3-0.4,0.3-0.8,0.4-1.1,0.5-0.8,0.5-13,0.6-0.9,0.7-1.3,0.8-1.4,0.9-2.8,1-3,1-6,1-7,10-16,12-16,13-15,2-2.5,2-foliate,2.5-3.5,3-8,3.5-5.5,3.6-5.3,5-merou,6-18,8-11,9-18,?,abaxially,absen,abundant,acicular,adaxiall,adaxially,alyx,apart,armed,axe,ba,basal,blade,broad,capitat,coating,cylindrical,decimetr,deltate,densely,directed,distall,distinct,distributed,dult,eaf,eed,eglandular,entire,equal,erect,filament,finger,flower,frequently,functional,geminat,glabrous,gland-tipped,green,grey,hair,half,homostylous,interpetalar,juic,lamina,less,lobe,longer,lower,margin,mature,mesocarp,mid-point,midvein,minute,moderately,moist,multiradiate,nflorescence,oblique,obscure,obscured,often,orolla,part,per,perfect,petal,pore,porrect,probably,pubescent,rachi,recurved,resinous,ruit,sessile,shallow,short,spaced,stage,stalk,stellae,stellate-pubescent,tal,tamen,thick,thickened,throughout,tip,tissue,triangular,unarmed,unbranched,undulate,unit,unknow,uvenile,vary,white,wide,x,ympodial	arrangement,articulation,bark,capitate,color,connation,corolla,dehiscence,diminishing,distal,foetid,foliage,form,growth,height,history,interjected,leaf,leaflet,life,na,ovary,papillae,petiolule,plant,position,pseudostipule,seed,shape,size,spacing,straightnes,surface,terminal,texture,trichome,tuber-bearing,young
567	wfo-0001030080	success	186	110	75	111	35	0.403	0.3-7,0.4-1.5,0.5-4,1-2,1-3,1.8-4.5,2.1-7.1,3-10,3-5,3.3-7.7,4-12,4-7,5-13.5,5.5-9.9,8-23,acuminate,anther,apex,articulated,axillary,base,bud,clavate,cm,connivent,coriaceous,corolla,cuneate,decurrent,diameter,distal,elliptic,forked,fruit,glabrous,green,greenish,half,herb,high,lanceolate,lateral,leaf,leaflet,mm,moniliform,mottled,mucilaginous,odd-pinnate,ovate,ovoid,pedicel,peduncle,petiole,plant,poricidal,purple,pyriform,seed,size,stellate,stigma,straight,strongly,style,subtending,terminal,throughout,tip,tube,typically,white,whitish,x,yellow	1.5-2,1.5-2.5,1999,2-3,2-4,5-7,5-merou,6.5-18.6,8-16,9.9-33,abaxiall,abaxially,absent,acumen,adaxially,ag,along,alyx,apart,apparently,arranged,axe,bead,berry,blade,brownish,capitat,ccording,cell,condition,covering,dark,decreasing,digestion,dorsally,dot,drying,eaf,edge,eed,enzyme,erec,exceeding,filament,flat,flower,folded,fresh,geminat,generally,glabrescent,glabrou,green-white,hair,hair-like,hal,homostylous,honeycomb-shaped,inconspicuous,interjected,larger,lengthening,light,like,linear,living,lobe,long,lower,make,medium,multiple,necklace,nflorescence,ochoa,onto,orolla,pair,perfect,plurifoliate,pore,rachi,removed,second,seudostipule,slightly,slit,sometimes,spaced,specimen,stamen,stolon,subequal,tall,tamen,tem,testal,thick,tiny,toward,tri-,tuber,unit,unknown,usually,vary,wall,wet,width,winged,ympodial	arrangement,articulation,bark,calyx,capitate,color,connation,dehiscence,erect,foetid,foliage,form,fruiting,growth,height,history,inflorescence,length,life,midpoint,na,ovary,papillae,position,prickle,pseudostipule,shape,spacing,stem,straightnes,surface,texture,trichome,tuber-bearing,young
568	wfo-0001030081	success	157	109	76	81	33	0.484	.5,0.5-1,0.5-1.5,0.5-2.5,1,1-4,1.5,1.5-3,10-20,2-foliate,3-10,4-6,5-15,abaxially,absent,adaxially,anther,berry,beyond,blade,brown,calyx,center,chartaceous,cm,densely,diameter,dm,drying,edge,elliptic,elliptic-ovoid,equal,exserted,few-branched,filament,fine,flower,fruit,geniculate,glabrous,globose,hair,herb,immature,long,margin,maturing,membranaceous,mm,moderately,nearly,oblong,parallel,pedicel,peduncle,petiole,pubescent,radiating,raised,ridge,rotate,running,semitransparent,shallow,single-,sparsely,stamen,stigma,style,surface,unbranched,usually,white,x,yellow	0.25-0.5,1-2,1-2-celled,1-3,1-5,1.5-7,10-35,1st,2-4,2-7,2nd,3-6,5-12,abundant,acute,adaxiall,along,apex,apically,axe,base,cell,ciliate,connected,cordate,decurrent,dehiscing,denser,eaf,eed,emarginat,entire,explosively,flat,frui,geminat,held,interpetalar,linear-lanceolate,lobe,longer,lower,lying,maturit,mesocarp,nfloresence,notch,obtuse,often,one,orolla,other,per,placenta,pointing,pressure,pubescen,rachi,rarely,rounded,ruit,short,slightly,small,sometimes,straight,swollen,tal,tamen,tem,tissue,triangular,tube,two-celled,unit,vary,vein,watery,wid,woody,ympodial	arrangement,color,corolla,dehiscence,feature,form,geminate,growth,height,history,inflorescence,interjected,lateral,leaf,leaflet,length,life,na,ovary,plant,pseudostipule,pubescence,seed,shape,size,spacing,stem,straightnes,tall,terminal,texture,wide,width
569	wfo-0001030083	success	146	103	65	81	38	0.445	0.5-1,0.5-2,0.8-1,0.8-3,1-2,4-6,accrescent,acute,anther,apex,bark,base,calyx,closely,cm,corolla,deeply,deflexed,elliptic,fruit,fruiting,glabrous,globose,green,greenish-white,internodal,lateral,leaf,lobed,long-acuminate,minutely,mm,narrowly,opposite,ovary,ovate,ovoid-reniform,pale,papillae,papillose,pedicel,petiole,pitted,poricidal,red-papillose,shaped,shrub,simple,small-capitate,somewhat,spaced,stem,stigma,straight,style,surface,tan,tear-drop,terminal,tip,translucent,tube,white,woody,young	.5,.75,0.1,0.25-0.5,1-1.5,1.5-3,10-30,2,2-3,2-5-flowered,3-4,3/4,4-15,9-11,anthesi,beginning,berry,broadly,cup-shaped,dar,deciduous,decurrent,deltoid,dia,dry,drying,eaf,edicel,eed,elongate,exserted,fleshy,flower,greyish-re,hyaline,inflorescenc,lobe,lon,long,long-styled,lower,main,membranous,middle,near,nflorescence,older,onto,overlapping,pair,paler,pore,prominent,proximal,raised,reddish-gold,reflexed,ruit,scar,shallowly,short-styled,single-stemmed,slender,slightly,soon,specimen,strongly,tall,tapering,thickened,thin,tub,ud,unifoliat,unit,vein,way,widest,winged,x,ympodial	arrangement,articulation,color,connation,dehiscence,diameter,diminishing,distal,foetid,foliage,form,greyish-red,growth,height,history,inflorescence,interjected,leaflet,length,life,midpoint,na,peduncle,perennial,petiolule,plant,position,prickle,pseudostipule,seed,shape,size,spacing,straightnes,texture,trichome,tuber-bearing,unifoliate
570	wfo-0001030093	success	181	105	71	110	34	0.392	0.5-1.1,1-1.5,1-12,1-5,4-6,acuminate,acute,anther,attenuate,bark,base,beneath,brownish-tan,calyx,clavate,cm,corolla,cuneate,deflexed,elliptic,erect,fruiting,furcate,glabrous,globose,green,greenish-white,growth,hirsutulous,lateral,leaf,lobed,many,minutely,mm,nearly,obovate,often,opposite,ovary,ovoid-reniform,pale,pedicel,petiole,pitted,plant,poricidal,shaped,shiny,shrub,simple,size,slightly,small,stem,stigma,straight,style,surface,tear-drop,terminal,time,tip,tree,trichome,tube,uniseriate,vein,white,woody,young	.2,.5,0,0.1-0.3,0.2,0.2-0.5,0.2-1,0.6-1.5,0.75-1,1.3-4.5,2-2.5,2.5-11,3-4,3.5-12,5-50-flowered,5-8,7-30,7-9,8-9,anthesi,apar,apex,becoming,berry,branched,campanulate,case,closely,collection,commonly,continues,deltoid,densely,dia,differing,difoliate,eaf,edicel,eed,ellipsoid,especially,evenly,except,expanded,exserted,filament,flower,forest,free,geminat,golden,greyish-brow,guyanese,hyaline,impressed,inundated,like,lobe,lon,long,long-styled,lower,main,major,margin,member,middle,minor,narrowly,new,nflorescence,occasionally,older,one,onto,open,orbicular,pair,paler,papillo,persisting,population,pore,portion,present,puberulent,pubescent,quite,reflexed,remaining,ruit,scar,shoot,short-styled,slender,soon,southern,spaced,tall,tapering,thickened,tiny,tub,ud,underside,unit,widest,x,yellowish,ympodial	1.5-4,alternate,apart,arrangement,articulation,color,connation,dehiscence,diameter,foetid,foliage,form,fruit,greyish-brown,height,history,inflorescence,interjected,leaflet,length,life,midpoint,na,papillae,papillose,peduncle,position,prickle,pseudostipule,seed,shape,spacing,straightnes,texture
571	wfo-0001030115	success	192	119	93	99	26	0.484	-30,1-1.2,1.5-2,1.5-3,12,12-22,2.5-3,3.5-5,5-10,5-8,abaxially,acuminate,acute,adaxially,anther,apex,bark,base,berry,branched,calyx,cm,conical,cordate,corolla,dark,densely,diameter,echinoid,echinoid-stellate,elliptic,entire,flower,glabrescent,glabrous,glandular,globose,green,growth,inflorescence,irregular,lanceolate-elliptic,leaf,like,lobed,long-styled,many,margin,minutely,mm,near,oblique,occasionally,ovary,papillate,pedicel,peduncle,pentagonal,petiole,poricidal,pubescent,purple,reddish,scattered,shallowly,shiny,short-styled,shrub,simple,slightly,small,somewhat,stellate,stem,stigma,style,surface,tapering,terminal,thin,time,tip,tree,trichome,truncate,tube,underside,undulate,usually,violet,white,x,yellowish	-100,.2,.5,0.1,0.2,0.5,0.5-0.6,1,10,10-,3,3-4,30-60,4,5-5.5,7,9-11,<,>,anthesi,apart,armed,basal,basall,beneath,broad-based,brow,c.,closely,completely,curved,deep,discolorous,distant,drying,eaf,eed,ellipsoid,equalling,erect,exserted,filament,free,fruiting,heterostylous,impressed,included,irregularl,know,known,lamina,later,lengthening,linear,lobe,long,long-triangular,lower,midpoint,new,nflorescence,obscured,obvious,often,older,pair,pale,papillo,pericarp,planar,plurifoliat,pore,portion,prickle,prickly,primary,prominent,ray,ruit,scar,sessile,sinus,slit,spaced,sparsely,splitting,stout,strongly,tearing,translucent,trichoem,ud,unarmed,unit,upper,vein,way,ympodial,young	arrangement,brown,color,connation,dehiscence,diminishing,distal,form,fruit,height,history,lateral,leaflet,length,life,na,papillae,papillose,plant,pseudostipule,seed,shape,size,straightnes,texture,tuber-bearing
572	wfo-0001030145	success	153	109	69	84	40	0.451	0.2-2,0.3-,0.5,0.5-1,1,1-2,1-2.5,1-5,2-4,2.5-6.5,3-10,3-4,3-5,abaxially,acute,adaxially,apart,apex,articulated,basal,base,calyx,campanulate,cm,color,compound,cuneate,densely,diameter,ellipsoidal,elliptic,elliptic-ovate,forked,fruit,globose,herb,lateral,leaf,leaflet,leaving,less,lobe,long,mm,moderately,near,ovate-elliptic,pedicel,pedicellar,peduncle,petiole,puberulent,remnant,shrub,simple,slender,stigma,style,subcordate,subcoriaceous,terminal,ternately,truncate,tube,unbranched,unknown,violet,x,yellow	-2,-3,0.5-4,1-1.5,1-3,1.5,1.5-2,1.5-4.5,1.5-7,10-12,2-3,3,4-5,4-8,4-foliat,6-40,8-11,absent,adpressed,aggregate,also,ape,axe,beyond,blade,cell,chartaceous,connective,cylindrical,deltate,directed,distally,dunal,eaf,eed,entire,exceeding,exserted,fide,fleshy,flower,glabrous,glandular,hair,lanceolate,larger,lon,lower,margin,narrowly,nflorescence,nther,obtuse,orolla,pilose,pore,presen,puberulen,rachi,radiu,reddish,ripe,ruit,shorter,sinuate,slightly,somewhat,spaced,sparsely,stamen,stone,tal,tem,thecae,time,tomento,toward,triangular,truncat,ud,unit,vary,wide,ympodial	anther,arrangement,articulation,bark,connation,corolla,dehiscence,diminishing,distal,foetid,foliage,form,fruiting,growth,height,history,inflorescence,interjected,length,life,midpoint,na,ovary,papillae,petiolule,plant,position,prickle,pseudostipule,seed,shape,size,spacing,stem,straightnes,surface,texture,trichome,tuber-bearing,young
573	wfo-0001030146	success	210	114	79	131	35	0.376	0.2–0.4,0.5–1,0.6–2,1.5–2,2.5–9,3–6,5–8,8–15,9–9.5,acuminate,acute,anther,apex,articulated,base,berry,brown,brownish,c.,calyx,capitate,cm,connivent,coriaceous,corolla,diameter,ellipsoidal,elliptic,flattened-reniform,fruiting,globose,golden,green,growth,inflorescence,leaf,length,lengthening,lobed,long,loosely,midpoint,minutely,mm,narrowly,pale,papillose,pedicel,peduncle,peltate,persistent,petiole,pitted,plant,pore,poricidal,reddish,ripe,short-stalked,simple,slit,small,stellate,stem,stigma,style,surface,tall,tan,terminal,tip,tree,treelet,trichome,tube,way,white,yellow,–18	.1,.2,.5,0.5,0.6–0.7,0.9–1,1.2–1.5,16–20,1–1.1,1–1.5,20,20–30,2–5,3–4,40–50,4–30,4–4.5,5-merou,6.5–16,60+,6–7,>,abaxial,abaxially,absent,adaxial,ag,almost,along,alyx,anthesi,apar,appearing,ark,axe,beig,beneath,branched,branching,bright,cell,center,closely,covered,cup-shaped,dark,deeply,deltate,dense,densely,dichasia,discolorous,drying,eaf,echinoid,edge,eed,elongate,entire,erec,exserted,filament,flower,free,fresh,fused,glabrous,gradually,halfway,ilament,impressed,lamina,layer,less,like,lobe,lower,many,margin,multangulate,narrowing,new,nflorescence,nodding,older,olive,orolla,pair,part,per,perfect,pericarp,plurifoliate,portion,primary,projection,pubescence,pubescent,ray,reflexed,regularly,revolute,rhachi,ruit,scar,scurfy,sessile,shiny,spaced,sparsely,stout,strongly,subtended,tangled,tem,testal,thin,time,tiny,ud,undersurface,unevenly,unit,upper,vary,varying,vein,visible,wide,woody,ympodial	age,apart,arrangement,articulation,bark,color,connation,dehiscence,diminishing,distal,foetid,foliage,form,fruit,height,history,interjected,lateral,leaflet,life,na,ovary,papillae,petiolule,position,prickle,pseudostipule,seed,shape,size,spacing,straightnes,texture,tuber-bearing,young
574	wfo-0001030147	success	158	126	89	69	37	0.563	0-5,0.5-2,1-5,1.0-2.0,1.0-2.2,15-30,2,2-10,2-10.5,2-13,2-3,2.5-7.5,4.2-7.5,4.5-10,5-8,acuminate,apex,apical,apically,articulate,base,blue,branched,calyx,cm,conical,connate,corolla,cuneate,cyme,deep,dehiscent,diameter,dichasial,dichasially,diminishing,distal,ebracteate,elliptical,finely,forked,generally,gradually,green,green-white,half,herbaceous,interjected,introrse,lateral,leaf,leaflet,long,maturing,medium,mm,monochasial,mucilaginous,narrowly,oblique,odd-pinnate,often,ovate,ovoid,pedicel,peduncle,perennial,petiole,petiolule,plant,poricidally,proximal,pubescent,purple,rotate,rounded,seed,short,size,slit,stigma,straight,style,terminal,toward,tuber-bearing,wide,yellow,¼	-8,1-4,10-19,14-35,2-5,3-,3-6-foliat,4-3.,4-5.5,5-7,8-38,abaxiall,abaxially,acumen,acute,adaxially,attenuate,cell,covering,digestion,dorsally,eaf,edge,eed,emoval,enzyme,exceeding,filament,flat,flower,folded,globo,hair-like,honeycomb,living,lobe,lon,long-attenuate,lower,lunat,make,nflorescence,nther,obtuse,orolla,pair,pattern,perfect,plan,reveal,ruit,sessile,seudostipule,specimen,stamen,subequal,subsessile,tal,tem,testal,thick,throughou,throughout,tip,typically,unit,vary,wall,ympodial	4-31,anther,arrangement,articulation,bark,color,connation,dehiscence,foetid,foliage,form,fruit,fruiting,globose,growth,height,history,inflorescence,length,life,lunate,na,ovary,papillae,position,prickle,pseudostipule,shape,spacing,stem,straightnes,surface,texture,trichome,tube,ye,young
575	wfo-0001030151	success	175	108	66	109	42	0.377	0.2-0.5,1-17,1-2,1-3,1-5,10-25,2-3,2-6,2-7-compound,3-14,6-9,acuminate,apex,around,articulated,base,blotch,calyx,chartaceous,cm,connate,cordate,cuneate,cylindrical,diameter,elliptic,fruit,glabrous,globose,leaf,leaflet,lilac-tinged,longitudinal,membranaceous,mm,narrowly,near,oblique,oblong,obovate,often,pedicel,peduncle,petiole,pinnately,puberulent,pyriform,ring,shallowly,simple,small,sometimes,sparsely,stellate,stigma,stripe,style,surface,tree,truncate,tube,unbranched,white,x,yellow,yellow-green	-3,-50,0.3-0.5,0.5,0.5-1,1,1-1.5,1.5-2,1.5-2.5,10-20,15-35,2-11,2-25,20-30,3-5,3.5-32,4-5,4-foliat,5-6,?,abaxially,absent,abundantly,acute,adaxial,adaxially,aggregate,apart,ape,apiculate,axe,basal,beyond,blade,cell,channe,ciliat,compound,connective,decurrent,deltate,directed,distally,eaf,eed,eglandular,entire,exceeding,except,exserted,flower,glabrate,glandular,glandular-puberulent,hair,lanceolate,leaving,less,line,lobe,lon,long,lower,margin,nflorescence,nther,obtuse,orolla,pedicellar,perfect,pore,presence,probably,purplish,rachi,radiu,remnant,ripe,ruit,sand-punctat,sand-punctate,scattered,short,shorter,slender,slightly,somewhat,spaced,stalked,stamen,stone,tal,tem,thecae,time,tip,toward,triangular,truncat,ud,unit,unknow,vary,vein,veiny,white-puberulent,whitish,wide,ympodial	anther,arrangement,articulation,bark,color,connation,corolla,dehiscence,diminishing,distal,foetid,foliage,form,fruiting,growth,height,history,inflorescence,interjected,lateral,length,life,midpoint,na,ovary,papillae,petiolule,plant,position,prickle,pseudostipule,seed,shape,size,spacing,stem,straightnes,terminal,texture,trichome,tuber-bearing,young
576	wfo-0001030153	success	147	87	62	85	25	0.422	/3,0.2-1,1-10,1-2,1.3-1.5,1.5-2,2-8,2-lobed,3-4,3-5,5-6,age,anther,apart,bark,base,berry,branched,calyx,clavate,cm,corolla,dark,diameter,elliptic,glabrous,globose,green,growth,lanceolate,lengthening,lobed,minutely,mm,narrowly,older,ovary,papillate,pedicel,peduncle,petiole,poricidal,ripe,simple,slightly,slit,small,stem,stigma,straight,style,surface,terminal,time,tip,tree,treelet,tube,way,white,yellowish,young	.1,.2,0.8-0.9,0.8-1.3,1-1.2,1-1.5,1-2.5,1.3-1.9,2.5-4,3-50,3.5-10.5,6-8,abaxially,absent,acuminate,acute,adaxially,anthesi,ape,apex,apiculate,apparently,attenuate,axil,brittle,broadly,caly,campanulate,conical,deltate,densely,distinct,domatia,dot,dry,eaf,ellipsoid,enlarged,entire,erect,exerted,filament,flower,free,fruiting,glabrou,impressed,internodal,irregularly,known,less,lobe,lower,margin,markedly,membranous,new,nflorescence,nodding,occasionally,ot,pair,paler,papillat,perfect,pit-like,plane,plurifoliat,pore,portion,primary,rachi,resinous,revolute,ruit,scar,spaced,specimen,strongly,thin,ud,unit,vein,x,ympodial	arrangement,color,connation,dehiscence,form,fruit,height,history,inflorescence,interjected,lateral,leaf,leaflet,length,life,na,papillae,plant,pseudostipule,seed,shape,size,spacing,straightnes,texture
577	wfo-0001030155	success	183	86	52	131	34	0.284	2-4,acuminate,acute,anther,apex,base,branched,brown,calyx,cm,connivent,corolla,diameter,flattened,fruit,glabrous,globose,immature,imparipinnately,lateral,leaflet,light,lobed,mature,minutely,mm,oblong,papillate,pedicel,peduncle,petiole,pinnatifid,pitted,plant,poricidal,purple,rounded,size,stellate,stem,stigma,straight,strongly,style,surface,tapering,terminal,tip,tube,vine,white,yellow	0,0.2,0.4,0.5,0.5-0.6,0.5–1.2,0.7,1-1.2,1/2,12–19,12–20,1–2,2,2.5,2.5-3,2/3,2–,2–3,3,3.5,3–5,4,4–5,4–6,4–8,4–9,5–10,5–6,5–8,607,6–8,abaxially,ag,alyx,anthesi,armed,articulated,ba,basal,basally,becoming,berry,blade,bud,campanulate,cell,central,chartaceous,clustered,confluent,connecting,corresponding,decurrent,deeply,degree,deltate,densely,eaf,eed,ellipsoid,elongating,entire,equal,et,exserted,filament,flower,fresh,glabrou,green,internode,knob,lengthening,lobe,long,long-styled,lower,major,margin,middle,midrib,narrowly,nflorescence,often,orolla,outline,part,pericarp,petiolulate,plurifoliat,pore,present,prickle,prominent,protuberant,rachi,rectangular,recurve,recurved,robust,rodriguez,rounde,ruit,side,slender,slit,soon,spreading,stout,subwoody,tamen,terminally,testal,third,time,tissue,truncat,ttriangular,tub,unit,vary,vein,way,wide,widest,wing,woody,ympodial,×,–17,–27	0.4-0.7,1-2,10,12-20,2-3,4-5,5-8,arrangement,bark,color,connation,dehiscence,diminishing,distal,form,growth,height,history,inflorescence,interjected,leaf,length,life,na,ovary,papillae,petiolule,seed,shape,spacing,straightnes,texture,truncate,tuber-bearing
578	wfo-0001030160	success	177	96	66	111	30	0.373	.5,1,1-1.5,1-5,3,?,acuminate,acute,anther,apart,armed,bark,base,bluish-violet,calyx,cm,coriaceous,corolla,diameter,dioecious,dry,elliptic,elongate,fruit,fruiting,glabrous,globose,growth,height,inflorescence,internodal,lobed,long,midpoint,minute,minutely,mm,narrowly,nearly,orange-red,ovary,pale,pedicel,peduncle,petiole,pitted,plant,poricidal,prickle,red,reniform,shrub,simple,stem,stiff,stigma,style,surface,tiny,tip,trichome,truncate,tube,unknown,yellow,young	.2,.8,0.2,00,1-2,1-3,1.5-2,1.5-4.5,1030.,10300,2,2.5-3,3-11,3-3.5,3-4,4-rayed,5-6,7-10,8-9,absent,acicular,almost,amshoff,apex,apparently,beneath,berry,broad-based,bud,capitat,closely,completely,conical,consisting,conspicuous,densely,eaf,eed,ekman,entire,exserted,female,fide,filament,flattened,flower,flowered,forming,free,glabrescen,irregularly,like,lobe,long-triangular,m.,male,margin,marginal,markedly,mere,midrib,near,new,nflorescence,oblique,occasionally,often,older,other,ower,pair,per,pericarp,plurifoliat,portion,primary,prominent,pubescent,ray,ruit,scar,scattered,several,shallow,shiny,short-stalked,single,small,sometimes,somewhat,spaced,sparsely,stellate,strongly,stub,terete,terminating,thin,ti,triangular,ud,undulate-toothed,unisexual,unit,usually,vein,vestigial,winged,woody,x,ympodial	arrangement,articulation,capitate,color,connation,dehiscence,foetid,foliage,form,glabrescent,history,interjected,lateral,leaf,leaflet,length,life,na,papillae,position,present,pseudostipule,reproduction,seed,shape,size,spacing,straightnes,terminal,texture
579	wfo-0001030161	success	179	105	68	111	37	0.38	0.1-0.2,0.2-0.5,0.2-1.3,0.4-0.8,4,4-5,acuminate,acute,anther,apex,articulated,bark,base,breaking,calyx,clavate,cm,coriaceous,corolla,diameter,elliptic,exserted,flattened,fruit,fruiting,furcate,globose,growth,internodal,leaf,lepidote,lobed,long,midpoint,minutely,mm,narrowly,nearly,orange,ovary,pale,pedicel,peduncle,petiole,pitted,poricidal,porrect,prickle,red,reddish,reniform,sessile,simple,somewhat,stellate,stem,stigma,strongly,style,surface,tapering,thick,tip,treelet,trichome,tube,white,yellowish	.1,.2,.25,.5,0,0.1,0.5,0.5-0.6,0.8-1,1,1.1-1.3,1.5-2,1.5-5,12-16,2-2.5,2-3,2.5-3,3-15,3-3.5,4-20,5197,8-9,9-10,<,?,abaxially,adaxially,almost,anthesi,apar,apparently,bearing,beneath,berry,broad-based,cell,conical,curved,densely,difoliate,eaf,eed,egger,ellipsoid,entire,erect,especially,fide,filament,filiform,flower,free,fused,geminat,glabrescent,glabrous,impressed,irregularly,later,leave,lengthening,like,lobe,long-triangular,looping,lower,margin,marginal,midvein,near,new,nflorescence,occasionally,older,outline,pair,papillo,per,perfect,pericarp,planar,pore,portion,prickly,primary,prominent,pubescent,ray,rhomboid,ruit,scar,scattered,shiny,shorter,slightly,slit,small,spaced,sparsely,stalked,straight,testal,tooth,tub,ud,undulate-toothed,unit,vein,woody,x,ympodial	apart,arrangement,articulation,color,connation,dehiscence,diminishing,distal,foetid,foliage,form,height,herb,history,inflorescence,interjected,lateral,leaflet,length,life,na,papillae,papillose,petiolule,plant,position,present,pseudostipule,seed,shape,size,spacing,straightnes,terminal,texture,tuber-bearing,young
580	wfo-0001030167	success	141	82	46	95	36	0.326	12,acuminate,anther,apex,base,calyx,chartaceous,cm,contiguously,densely,diameter,flattened,flower,fruit,glabrous,green,herbaceous,lanceolate,margin,membranaceous,mm,moderately,near,nearly,obtuse,ovate,ovoid,pedicel,peduncle,petal,petiole,pointed,rounded,sand-punctate,simple,slender,somewhat,stellate,stigma,style,thinly,unbranched,unknown,vine,white,x	.8,.9,0.1–0.2,0.5–0.6,0.5–0.7,0.6,0.6–0.8,0.7–1.2,0.8–1,1.2–2.5,1.5–2,1.5–7,14–19,15–20,17–58,1–1.2,1–1.5,2–3,2–4.5,4.5–8,4–10,4–4.5,4–5,4–7,5-merous,8–10,abaxially,accrescent,acute,adaxially,along,alyx,apar,apically,axe,berry,blade,branch,c.,ciliat,ciliate,clavate,climbing,eaf,eed,enlarged,entire,extra-axillary,fertile,filament,fruiting,gap,glabrou,immature,less,lobe,long,lower,m.,maturity,membranous,minutely,nflorescence,nternode,orolla,pair,penden,perfec,pinnate,plurifoliat,rachi,reflexed,ruit,scar,secondary,seen,slightly,spaced,sparsely,subequal,symmetrical,tamen,tem,time,tip,truncat,tube,unit,vary,vegetation,vein,venation,weakly,wide,ympodial	0.1-0.2,0.7-1.2,1-1.2,1-1.5,1.5-2,1.5-7,14-19,15-20,2-4.5,4-10,4-4.5,8-10,apart,arrangement,color,corolla,feature,form,growth,height,history,inflorescence,internode,leaf,length,life,na,ovary,plant,seed,shape,spacing,stem,surface,texture,truncate
581	wfo-0001030170	success	230	106	62	168	44	0.27	-6,0,1,2,accrescent,acute,anther,apart,apex,around,articulated,base,blue,calyx,cm,connivent,cordate,curved,diameter,extra-axillary,flattened,flower,fruit,fruiting,globose,lanceolate,leaf,less,maturity,mm,nearly,numerous,obtuse,orbicular,pedicel,peduncle,perennial,petiole,prickle,rarely,reniform,shrub,simple,size,slightly,smooth,stellate,stem,stigma,straight,style,subdeltoid,surface,thin-textured,truncate,tube,unbranched,violet,white,x,yellow,yellowish	.2,/2,0.1,0.15–0.35,0.2–0.5,0.2–2,0.5–15,0.5–2,0–30,1.5,10–15,12.5,15–20,1–2-celled,1–2.5,1–4.5,2-foliate,2.5–3,20–25,20–30,2–3-celled,2–4,2–5,2–8,3,3.5–4,3.5–4.4,3–10,4,4–13-rayed,4–22,5,5–10,5–12,5–15,5–apiculate,8.5,abaxially,absent,acicular,adaxially,also,appearing,axe,ba,blade,bud,capitat,coarse,confined,conspicuously,cylindrical,densely,directed,disappearing,distall,eaf,eed,enlarged,entire,erect,eventually,falling,fertile,few-branched,few-rayed,filament,flexuous,frui,geminat,geminate,glabrous,gland,gland-tipped,glandular,glandular-puberulent,ground,hair,horizontal,hyaline,interpetalar,larger,like,lobe,lobed,lon,long,longer,longest,lower,lowest,major,male,many,margin,mesocarp,minute,minutely,mostly,multangulate,near,nflorescence,oblique,oblong-apiculate,often,one,orolla,pair,perfect,pore,puberulent,pubescence,pubescent,rachi,ranging,rare,ray,reflexed,rootstock,ruit,scarcely,scattered,senescent,sessile,shallow,short-puberulent,shorter,similar,single,small,solitary,sometimes,somewhat,spaced,spongy,spreading,stella,stellae,sterile,stiffly,stipitate,stipitate-glandular,stout,strongly,surfac,tall,tamen,tem,thic,thick,tissue,tooth,toward,triangular,twice,ultimately,unit,upper,usually,various,vary,vein,vestigial,way,wide,without,ympodial,–4	0.2-2,1-2.5,10-15,2-5,2-8,20-30,arrangement,articulation,bark,capitate,color,connation,corolla,dehiscence,diminishing,distal,foetid,foliage,form,growth,height,history,inflorescence,interjected,lateral,leaflet,length,life,na,ovary,papillae,petiolule,plant,position,pseudostipule,seed,shape,spacing,straightnes,terminal,texture,trichome,tuber-bearing,young
582	wfo-0001030176	success	171	110	70	101	40	0.409	-4.25,.2,0.5-2,0.7-1.4,1-5,1.2-2.5,2-3,2.25-3.25,2.5,3-5,6-8,accrescent,acute,anther,apart,apex,articulated,attenuate,base,bilobed,broad,broadly,calyx,chartaceous,cm,connivent,decumbent,depressed-globose,diameter,especially,extra-axillary,few-branched,flattened-reniform,flower,fruit,fruiting,glabrous,herb,lateral,light,long,mm,oblong,ovate,pale,partially,pedicel,peduncle,petiole,plant,pore,prostrate,rarely,ripe,rotate-stellate,simple,slightly,somewhat,stigma,style,terminal,tip,tube,unbranched,violet,white,x,yellow,yellow-orange,young	-1.4,-6.25,.7,.75-1.5,0.4-1.5,0.5,0.6-0.9,0.7–0.8,1,1-2,1.2,1.5-2,1.5-2.5,1.6,1/3,1/6,2-foliate,2.5–7.5,2.5–9,2–3,3-lobed,3.75-5,4-9,5-merou,6–8,abaxially,adaxiall,adaxially,alyx,angulate,apparently,asymmetrically,axe,ba,basal,berry,bi-lobed,blade,branch,capitat,ciliate,contact,covering,cylindrical,dehiscent,downward,eaf,eed,erec,filament,forming,geminat,hair,hermaphroditic,hold,interlobal,juic,lance-ovate,lanceolate-oblong,line,lobe,lon,longitudinall,lower,major,margin,mesocarp,midrib,minutely,near,nearly,nflorescence,node,numerous,often,orolla,patch,perfect,pubescent,rachi,recurve,recurved,rooting,round,ruit,sinus,soil,sometimes,spaced,sparsely,tamen,tem,time,triangular,unit,vary,vein,white-puberulent,wide,winged,ympodial	arrangement,articulation,bark,capitate,color,connation,corolla,dehiscence,diminishing,distal,foetid,foliage,form,growth,height,history,inflorescence,interjected,leaf,leaflet,length,life,longitudinally,na,ovary,papillae,petiolule,position,prickle,pseudostipule,seed,shape,size,spacing,stem,straightnes,surface,texture,trichome,tuber-bearing
583	wfo-0001030180	success	135	92	56	79	36	0.415	0.05-1,0.8-2,1-1.5,3-8,4.5-5,6,anther,apart,apex,attenuate,bark,base,becoming,calyx,clavate,cm,corolla,dark,fruit,fruiting,furcate,glabrate,glabrous,globose,green,height,lateral,leaf,linear,lobed,long,long-acuminate,mm,opposite,ovary,papillate,pedicel,petiole,poricidal,rounded,shaped,shrub,soon,stem,stigma,straight,style,surface,tear-drop,terminal,trichome,tube,uniseriate,unknown,white,young	.1,.5,.75,0.5-1,0.9-1.8,1.1-1.2,10-30-flowered,3-4,8-10,8.5-23,?,abruptly,accrescent,anthesi,apiculate,appearing,berry,clu,decurrent,deflexe,deltoid,dia,eaf,edicel,eed,ellipsoid,erect,exserted,filament,free,immature,inflorescenc,interpetalar,known,lenticellat,lobe,lon,lower,main,middle,minute,minutely,narrowing,nearly,nflorescence,occasionally,older,overlapping,pair,papillose,peduncl,planar,plurifoliat,pore,portion,prominent,proximal,puberulent,raised,ruit,scar,sinus,slender,slightly,spaced,sparsely,thin,tip,ud,unevenly,unit,vein,widely,widest,winged,woody,x,yellowish,ympodial	arrangement,articulation,color,connation,dehiscence,diameter,diminishing,distal,foetid,foliage,form,growth,history,inflorescence,interjected,leaflet,length,lenticellate,life,midpoint,na,papillae,peduncle,petiolule,plant,plurifoliate,position,prickle,pseudostipule,seed,shape,size,spacing,straightnes,texture,tuber-bearing
584	wfo-0001030182	success	205	117	86	119	31	0.42	0.5-1,1-4.5,15-20,2-3,2-5,3-12,3-5,accrescent,acute,anther,apex,articulated,bark,base,berry,blue,branched,brown,brownish,calyx,clavate-truncate,closely,cm,coriaceous,corolla,diameter,distal,elliptic,erect,ferruginous-tomentose,finely,flattened,flower,fruit,fruiting,glabrescent,globose,green,growth,immature,internodal,leaf,linear-lanceolate,long-styled,microscope,minutely,mm,oblique,obtuse,ovary,ovate,ovate-elliptic,papillose,pedicel,peduncle,petiole,plant,poricidal,prickle,reticulate,ripe,rounded,rusty,seen,short-styled,shrub,simple,stellate,stem,stigma,style,subcoriaceous,subreniform,surface,tapering,terminal,tip,tomentose,treelet,trichome,tube,variegated,velutinous,violet,yellow,yellowish	-12,0.2-0.3,0.3-0.5,1,1-1.5,1-1.7,1-celle,1-celled,1-multicellular,1-nerved,1.2-1.5,1.5-2,1/4,12-15,2-15,2-2.2,2-8,2.4-2.5,3-4,3-8,4-10,4-5,abaxially,adaxially,adult,angulate-lobed,anthesi,armed,asymmetric,basal,cell,dark,den,discolorous,e,eaf,eed,eglandular,entire,evident,exserted,filament,free,glandular,heterostylous,hirsute,juvenile,later,lengthening,like,lobe,lobed,long,lower,many,margin,midpoint,midrib,minute,mixed,mixture,multangulat,multicellular,nearly,new,nflorescence,older,one,ovoid,papillo,per,perfect,pericarp,plurifoliat,pore,porrect,porrect-,porrect-stellate,portion,prickly,pubescence,pubescent,ray,recurved,red,reddish,reduced,reflexed,repand,ruit,scar,sessile,short,similar,slightly,slit,space,sparse,sparsely,stalked,staminate,stellate-glandular,strongly,subsessile,tall,testa,triangular-lanceolate,tub,turbinate,ud,unarmed,uniseriate,unit,upper,vein,wood,x,ympodial,¼	arrangement,articulation,color,connation,dehiscence,diminishing,foetid,foliage,form,height,history,inflorescence,interjected,lateral,leaflet,length,life,na,papillae,petiolule,position,pseudostipule,seed,shape,size,spaced,spacing,straightnes,texture,tuber-bearing,young
585	wfo-0001030185	success	206	123	105	101	18	0.51	1,1-10,1-8,1.5-4,10,2,2-3,21,25,3.5-4.2,35,4-7,5-10,8-11,9-18,acuminate,acute,apex,apical,apically,base,beyond,blue,blue-violet,branched,calyx,cell,center,clasping,cm,color,cordate,corolla,covering,cuneate,cyme,darker,decreasing,deep,dehiscent,diameter,dichasial,dichasially,distal,ebracteate,elliptic,forked,generally,globose,green,green-white,hair-like,half,herbaceous,interjected,introrse,lanceolate,lateral,leaflet,light,long,maturing,middle,mm,monochasial,narrowly,nearly,obliquely,odd-pinnate,often,ovate,ovoid,pedicel,peduncle,perennial,petiolule,plant,poricidally,purple,rhizomatous,rotate,rounded,seed,semi-lunate,shape,short,size,slightly,slit,somewhat,spot,star,stem,stigma,style,terminal,testal,thick,violet,wall,white,wide,wider,without,yellow	-0.5-1.3,0.2,1-4,1.0-1.3,1.7,15,2.0-3.0,20-65,3-6-foliat,4,5-7,5-lobed,abaxially,acumen,adaxially,angular,apiculate,articulate,b,ba,basal,becoming,caudate,cente,coat,collection,commonly,connate,dark,densely,digestion,eaf,eed,embryo,emoval,enzyme,erect,exceeding,filament,flower,formed,glabrescent,glabrous,gland,glandular-pubescent,globo,hair,honeycomb,living,lobe,lon,lower,make,medium,moderately,mucilaginous,nflorescence,nther,oblong,occasional,one,orolla,pair,pattern,pentagonal,perfect,petiolate,petiolulate,puberulent,purpl,radiating,rare,reduced,reveal,rhizome,rotate-,ruit,scarcely,sessile,seudostipule,sometimes,specimen,stamen,ste,straight,subequal,symmetrically,tem,terete,tinged,tip,trailing,type,typically,unbranched,unit,usually,vary,visible,wid,ympodial	anther,arrangement,dehiscence,diminishing,form,fruit,growth,height,history,inflorescence,leaf,length,life,petiole,pseudostipule,rotate-pentagonal,surface,texture
586	wfo-0001030189	success	188	124	88	100	36	0.468	0-1,0-15,0.1-0.2,0.2-0.3,0.2-0.5,0.5-1.6,0.9-1.1,1,1-1.5,1-2,1-3-cellular,1-4-cellular,1.1-2.7,1.3-4.2,1.5-2,1.5-4.5,1.5-5,2.5-4,5-10,5-6,5-merous,6-10,6-12,8-10,8-18,anther,apex,articulated,bark,base,berry,calyx,chartaceous,cm,connivent,cordate,curved,diameter,dull,elongating,evenly,flattened-reniform,fruit,fruiting,glabrescent,glabrous,gray,green,lateral,leaf,length,lobed,long,maturity,mauve,midpoint,mm,moderately,oblong,obtuse,orange,ovate,pedicel,peduncle,petiole,poricidal,purple,red,rounded,scandent,shrub,simple,sometimes,spherical,spreading,stellate-pubescent,stem,style,surface,tapering,terete,terminal,tip,trichome,tube,unarmed,yellow,young	-1/2,-4,.2,/3,0-30,0.1,1-4-cellula,1/,1/3,1/6-1/3,2,2-3,2-5.5,3-4,3.2-4.5,4-13,4-5.5,5-,8,abaxially,acut,alyx,apar,apically,apparently,appressed,blade,branched,concolorous,deltate,densely,drying,eaf,eed,elliptic,entire,equal,erect,faint,filament,flower,foliaceous,free,frui,glabrescen,gland-tipped,infructescence,lobe,longer,lower,margin,mature,nflorescence,often,older,one,open,orolla,oung,pair,per,perfec,pericarp,plurifoliat,porrect,portion,primary,ray,recurved,red-brow,reflexed,ruit,scar,sessile,shorter,slender,smooth,somewhat,spaced,sparsely,stalk,stalked,stellate,strongly,tamen,tertiary,time,unarme,unit,upper,variously,vary,vein,venation,visible,way,wide,woody,yellow-green,ympodial	apart,arrangement,articulation,color,connation,corolla,dehiscence,diminishing,distal,foetid,foliage,form,growth,height,history,inflorescence,interjected,leaflet,life,na,ovary,papillae,petiolule,plant,position,prickle,pseudostipule,red-brown,seed,shape,size,spacing,stigma,straightnes,texture,tuber-bearing
587	wfo-0001030195	success	255	87	48	207	39	0.188	2,acuminate,anther,apex,articulate,bark,base,brown,calyx,capitate,chartaceous,cm,connivent,corolla,diameter,distal,evenly,flattened-orbicular,fruit,globose,lateral,leaf,mm,notched,pedicel,petiole,pitted,prickle,red,reddish,scattered,sessile,shrub,simple,spatulate,stellate,stem,stigma,straight,style,subcoriaceous,surface,terminal,tube,white,yellow,yellow-tan,young	.2,.3,.5,.6,.7,/3,0.1–0.2,0.2–0.3,0.2–0.5,0.2–1.0,0.3–0.7,0.5,0.5–0.6,0.5–1.3,0.5–4.0,0.7–1.0,0.8,0.8–0.9,0.9–4.8,1,1.0,1.0–1.4,1.0–1.5,1.2–1.6,1.3–1.5,1.3–2.6,1.4–1.6,1.5–1.7,1.5–1.9,1.7–2.2,1.7–3.2,1.8–2.0,1.8–2.5,1/3,2.2–2.7,2.3,3.8–4.8,3–6,3–7.3,4-merou,4.9–7.0,5.5–6.5,6.3–7.7,6–8,6–9,abaxially,adaxial,adaxially,adnate,aequilateral,ag,along,alyx,anthesi,apical,apiculate,apparently,appearing,appresse,around,attachment,attenuate,ba,based,berry,blade,borne,broad,broad-based,brochidodromous,bud,channeled,cuneate,dark,deltate,densely,dentate,developed,directed,distally,distinct,dry,eaf,edge,eed,either,elliptic,emerging,endocarp,entire,exocarp,extending,extra-axillary,fertile,filament,filiform,flat,flattened-irregular,flexed,flower,free,glabrous,glandular,glossy,gradually,gree,green,hair,homostylous,hort,immature,increasing,indistinct,individually,intact,internode,interpetalar,intersepalar,isolated,juic,layer,laying,light,lobe,lon,long,longer,lower,m.,many,margin,markedly,mature,middle,midpoint,midrib,midvein,minute,moderately,mottled,narrowly,nearly,nflorescence,nodding,oblique,oblong,obtuse,occasionally,opaque,orolla,ovate,per,perforated,plurifoliat,point,poorly,pore,porrect,portion,potentially,presen,pubescent,raised,ray,reflexed,remaining,restricted,rounded,ruit,shoot,short,shot,side,sinus,slightly,sloughing,smoot,sparsely,splitting,stamen,stellae,stellate-pubescent,striped,suture,tamen,tem,thin,time,tip,tissue,transparent,truncate,typically,ud,unarmed,unit,vary,vein,weakly,wide,yellow-ferruginou,yellow-ferruginous,ympodial,±90°,±equal,±glabrous,×	0.5-4.0,1.0-1.5,1.3-2.6,1.5-1.7,5.5-6.5,arrangement,articulation,color,connation,dehiscence,diminishing,foetid,foliage,form,fruiting,growth,height,history,inflorescence,interjected,leaflet,length,life,na,ovary,papillae,peduncle,petiolule,plant,position,pseudostipule,seed,shape,size,spacing,straightnes,texture,trichome,tuber-bearing
588	wfo-0001030198	success	234	113	87	147	26	0.372	0.7–,0.7–1.1,1.5–3.5,1.5–6.5,10–12,16,1–2.5,2.5–14,3.5–7,3–3.5,4–12-branched,5.5–13,5–12,7.5–10,acute,angulate,anther,apart,apex,articulated,attenuate,base,blade,branch,calyx,closely,cm,deltoid,densely,diameter,entire,filiform,flattened-reniform,flower,free,fruit,glabrate,glabrous,globose,internode,irregularly,lateral,leaf,lilac,long,margin,midpoint,midrib,midvein,minutely,mm,orange,ovate,overtopped,pedicel,peduncle,petiole,pitted,purple,ray,rounded,shorter,shrub,simple,sinuate,slightly,soon,stellate,stellate-tomentose,stem,stigma,style,surface,tan,terminal,tomentose,triangular,truncate,tube,whitish,yellow,yellowish,–17,–18,–20,–3,–3.5	.2,0.6,0.7–0.8,0.7–0.9,0.8,0.8–1.4,0.9–1.7,0.9–2,1,1.2,1.4–1.6,13–20,2,2.5,2.5–3.0,2–2.8,2–3,2–3-lobed,3.4–4.0,3–4,3–9,4,4.5,5-merou,5.3–7,60–150,6–10,abaxially,acicular,adaxiall,adaxially,alyx,ampliate,apical,apparently,appearing,axe,basal,berry,black,broad,broadly,capitat,caudate,contrasting,cordate,coroll,dark,darker,deeply,directed,distall,distally,drying,eaf,eed,except,extra-axillary,fewer,filament,finely,formed,frui,geminat,glabrescent,gland-tipped,gradually,green,hair,hal,high,homostylous,immature,initially,interpetalar,interwoven,larger,like,lobe,lobed,lon,lower,major,many,midri,midzone,minute,much,near,nearly,nflorescence,oblong-lanceolate,often,one,orolla,ovoid,part,perfect,persistently,plurifoliate,pore,porrect,prickle,principal,recurved,reflexed,relatively,ruit,sessile,shiny,short-stalked,side,sinus,sometimes,somewhat,spaced,sparse,splitting,spreading,stalk,stella,stellae,stout,straight,strongly,tamen,tem,thickened,time,tip,tissue,turning,ud,unarmed,unit,upper,usually,vary,vein,weak,well-developed,white,white-tomentose,whitish-tomentose,wide,ympodial,×	0.2,arrangement,capitate,color,connation,corolla,dehiscence,form,growth,height,history,inflorescence,interjected,leaflet,length,life,na,ovary,plant,pseudostipule,seed,shape,size,spacing,texture,width
589	wfo-0001030212	success	188	91	69	119	22	0.367	0.2-0.4,0.5-0.6,1-1.5,1-15,1-3,2-5,2.1-3.4,2.4-3.3,4-23,4.5-6,6-9,abaxially,adaxially,anther,articulated,base,broadly,brown,calyx,capitate,chartaceous,cm,compound,cuneate,cylindrical,deeply,depressed-globose,directed,fruit,glabrous,gland-tipped,green,hair,herbaceous,inflorescence,length,lobed,margin,mesocarp,minute,mm,moist,narrowly,ovate,pedicel,peduncle,petiole,pinnately,plant,present,prickle,prostrate,purple,rachi,resprouter,rotate,rotate-stellate,short,simple,slightly,sprawling,stigma,style,surface,tube,unbranched,x,yellow,yellowish-green	%,0-4,0.5-1,0.5-7,0.9-1.3,1-1.2,1-2,1-5,1-6,1.2-1.8,1.4-1.8,1.5-2,12-40,15-40,2-2.5,2-4,2.5-6,2.6-6.5,20-50,25-60,28-37,3-5,3.5-5,30-150,4-27,4-6,4-9,5-merou,7-11,8-9,9-10,abaxial,absen,absent,abundant,accrescent,acicular,acute,adaxial,adaxiall,alyx,andromonoecious,apart,apex,apparently,armed,attenuate,axe,ba,bilobe,blade,bristle-like,center,connivent,d.,deltate,diameter,distall,divided,eaf,eed,filament,finger,flower,fruiting,functional,geminat,glandular-puberulent,half,heterostylous,index,interpetalar,juic,lamina,lateral,leaf-opposed,lobe,lobing,lon,long,lower,mature,mid-point,midvein,nflorescence,oblique,orolla,part,per,plurifoliate,pore,presen,pricke,ruit,side,spaced,sparse,sparsely,stage,straight,strongly,tal,tamen,tem,thick,throughout,time,tissue,toothed,triangular,unit,unknown,uvenile,vary,vein,weakly,wide,winged,ympodial	arrangement,articulation,bilobed,color,corolla,dehiscence,distally,form,growth,height,history,juicy,leaf,life,na,ovary,seed,shape,spacing,stem,texture,thicknes
590	wfo-0001030219	success	191	115	69	122	46	0.361	0.1–0.3,0.2–2.3,0.5–,0.8–3.0,1.0–2.2,2–2.5,3,4–7,5–8,60,6–10,9–10,abaxially,acute,adaxially,anther,anthesi,apart,apex,articulated,base,black,blue,branched,brown,calyx,cm,diameter,erect,flattened,fruit,globose,green,leaf,lilac,long,longitudinal,marking,mm,moderately,oblong,opening,ovate,pale,pedicel,peduncle,pentagonal,perennial,petiole,pitted,procumbent,pubescent,purple,rapidly,shallowly,shrub,size,sparsely,split,stigma,straight,style,surface,time,tube,velutinous,x,yellow,–9.5	0.4–1.0,0.5,0.7–1.1,0–,1.0–1.2,1.0–1.5,1.0–2.0,1.3–2.9,1.4–2.8,1.5,1.6–,10,15,1–2.5,2.0–2.5,2.0–3.2,2.0–5.5,2.4–6.0,2–,2–3,2–4.5,4.5–5.5,4.8–11.5,4–5,5,5–,6–,6–8,7–11,8–18,9–12,abaxiall,acut,adaxiall,adnate,ag,along,anisophyllous,apical,apparently,appearing,arising,arranged,axe,ba,basal,blade,bract–like,cell,chartaceous,clavat,concave,connivent,convex,cylindrical,decreasing,decurrent,deeply,densely,diamete,difoliate,directed,distally,eaf,eed,elliptic,equal,filament,flower,geminat,glabrescent,glabrous,hair,incised,indistinct,internode,lanceolate,lobe,lower,margin,multicellular,nflorescence,number,olive,opposed,oppositely,orolla,pair,paler,perfect,pore,present,red–purple,regularly,rounded,ruit,serrate,sessile,sid,side,simple,smaller,spaced,stone,stripe,strongly,tal,tamen,tem,two,unicellular,uniseriate,unit,vary,white,wide,wing,winged,woody,ympodial,–3.0,–7.0	5–7–11,age,arrangement,articulation,bark,bract-like,clavate,color,connation,corolla,dehiscence,diminishing,distal,foetid,foliage,form,fruiting,growth,height,history,inflorescence,interjected,lateral,leaflet,length,life,na,opposite,ovary,papillae,petiolule,plant,position,prickle,pseudostipule,seed,shape,spacing,stem,straightnes,tall,terminal,texture,trichome,tuber-bearing,young
591	wfo-0001030224	success	191	112	89	102	23	0.466	0.5-1,0.5-1.5,1-3.5,1.5-9,10-20,14-17,2-10,2-5,4-10,4-6,6-10,6-15,8-12,abaxially,acute,adaxially,anther,apart,apex,armed,articulated,base,black,brown,calyx,cell,chartaceous,clavate,cm,cylindrical,dark,densely,diameter,elliptic,ferruginous,flattened,forked,form,fruit,glabrous,globose,hair,lateral,linear-lanceolate,lobe,longitudinal,major,midvein,mm,moderately,narrowly,occasionally,opening,orange,outline,pedicel,peduncle,petiole,pink,plant,pseudohair,pubescent,purple,rachi,red,reniform,scandent,shrub,side,simple,slit,sparsely,stellate,stellate-pubescent,stem,stigma,style,subcoriaceous,suborbicular,surface,tan,testal,triangular,tube,unbranched,vein,wall,x,yellow	-2.5,.25,.5,0.5-3,1-1.5,1-2,12-14,2-3-celled,2-4,2.5-4,2.5-4.5,2.5-8,20-25,3-4-foliate,4-4.5,4.5-5,5-10,5-merous,6-8,7-10,absent,accrescen,acuminate,adaxiall,ag,alyx,andromonoeciou,andromonoecious,axe,ba,bark,berry,blade,broad-based,capitat,connivent,deflexed,directed,distally,dry,eaf,eed,eglandular,equal,extra-axillary,filament,finely,fissure,flower,free,fruiting,functionally,geminat,gradually,green,greyish,hermaphroditic,heteromorphic,interpetalar,lighter,like,long,long-,longer,lower,lowering,mature,maturit,midpoint,nflorescence,one,orolla,other,part,perfect,pericarp,pore,prickle,ray,recurved,reddish-brown,reflexed,ruit,sessile,shiny,short-styled,small,spaced,sparse,staminate,strongly,tamen,tapered,tightly,time,tissue,unit,vary,wide,wtih,yellowish,ympodial	age,armament,arrangement,articulation,capitate,color,corolla,dehiscence,growth,height,history,inflorescence,leaf,length,life,na,ovary,seed,shape,size,spacing,texture,type
592	wfo-0001030225	success	155	113	71	84	42	0.458	-1.5,-11,-30,0-5,1,1-4,1-6,10-15,2-3,2-6,3-11-compound,3-5,4-5,abaxially,acuminate,acute,adaxially,apart,apex,articulated,basal,base,calyx,campanulate,cm,color,cordate,cuneate,densely,diameter,elliptic-ovate,expanded,forked,fruit,glabrous,globose,leaf,leaflet,leaving,less,lobe,long,mm,moderately,oblong,obtuse,pedicel,peduncle,petiole,pinnately,possibly,prominent,puberulent,purple,rachi,scar,shallowly,shrub,simple,small,stellate,stigma,style,time,tree,truncate,tube,unbranched,unknown,wide,x	-4,-45,-7,.5,.5-2.5,0,0-20,1.5,1.5-2.5,10-30,2,2-18,2-2.5,3-20,3-4,3-foliat,8-15,absent,ape,apical,apically,ature,axe,beyond,bilobed,blade,compound,conivent,connective,coriaceous,cylindrical,deltate,dilated,directed,distally,eaf,eed,entire,equal,especially,exceeding,exserted,fleshy,flower,glabrate,gland,immature,laterally,lower,margin,minutely,narrowly,nflorescence,nther,one,orolla,papillose,perfect,pore,puberulen,radiu,see,seen,slightly,somewhat,spaced,sparsely,stalked,stamen,strongly,succulent,tal,tem,thecae,tip,tomento,toward,triangular,two,ud,unit,unknow,vary,ympodial	anther,arrangement,articulation,bark,connation,corolla,dehiscence,diminishing,distal,foetid,foliage,form,fruiting,growth,height,history,inflorescence,interjected,lateral,length,life,na,ovary,papillae,petiolule,plant,position,prickle,pseudostipule,seed,shape,size,spacing,stem,straightnes,surface,tall,terminal,texture,trichome,tuber-bearing,young
593	wfo-0001030244	success	226	111	74	152	37	0.327	0-0.6,0-1,0.2-1.3,0.5-1.2,0.5-7,1-2,1-20,2-4,3.5-9,4-5,7-24,8-18,accrescent,acicular,acute,anther,apex,articulated,base,blue,calyx,chartaceous,cm,connivent,cuneate,decimetre,diameter,extra-axillary,flower,fruit,fruiting,globose,inflorescence,lanceolate,lateral,length,linear,long,longer,mm,narrow,narrowly,oblong,obtuse,pale,pedicel,peduncle,per,perennial,petiole,plant,prickle,pseudo-racemose,purple,red,reniform,reticulate,rotate,shrub,simple,slightly,solitary,stellate,stigma,straight,style,surface,tan,time,tube,unbranched,white,wide,yellow	%,.05,.3,0-0.1,0-0.3,0-3,0.1-1.5,0.2,0.2-0.5,0.2-0.6,0.2-1,0.25-0.4,0.25-0.5,0.3-0.4,0.3-0.5,0.3-5,0.4-0.7,0.5-1,0.5-3.5,0.6-0.8,0.8-1.2,1-1.5,1-5,1-6,1-8,1-locular,1.5-,1.5-2,1.5-2.3,1.5-3,11-33,2-2.5,2-foliate,2.5-13.5,2.5-6.5,3.3-7.5,4-5-merou,4-6,5-6,6-8,7-15,7-16,7-8,7-9,abaxially,absen,absent,across,adaxially,alyx,andromonoecious,apart,apparen,attenuate,axe,ba,blade,brown,capitat,common,confined,cylindrical,deltate,densely,directed,distall,distally,distributed,eaf,eed,eglandular,entire,erect,exocarp,filament,finger,geminat,glabrous,gland-tipped,green,grey,hair,half,heterostylous,homostylous,incomplete,interpetalar,juicy,lamina,less,lobe,lower,margin,markedly,mature,mesocarp,mid-point,midpoint,midrib,minute,moderately,nflorescence,oblique,orolla,part,perfect,placenta,plump,pore,porrect,present,pubescent,rachi,ray,rhizomatous,ruit,scattered,septum,sessile,short,spaced,sparse,sparsely,stage,stalk,stalked,stellae,stellate-pubescent,strongly,succulent,tal,tamen,tem,thick,thicker,thicknes,throughout,tissu,tissue,triangular,unarme,unarmed,unit,unknow,usually,uvenile,vary,weakly,wid,x,yellowish,ympodial	arrangement,articulation,bark,capitate,color,connation,corolla,dehiscence,diminishing,distal,foetid,foliage,form,growth,height,history,interjected,leaf,leaflet,life,na,ovary,papillae,petiolule,position,pseudostipule,seed,shape,size,spacing,stem,straightnes,terminal,texture,trichome,tuber-bearing,young
594	wfo-0001030250	success	169	96	58	111	38	0.343	0.5-1,1-3,1.4-1.5,1.7-7,5-6,anther,apart,apex,bark,base,broadly,brown,calyx,capitate,cm,corolla,cup-shaped,curved,elliptic-ovate,fruiting,glabrous,globose,green,greenish-white,greenish-yellow,inflorescence,irregularly,lateral,leaf,long-acuminate,minutely,mm,opposite,ovary,ovoid-reniform,pale,pedicel,petiole,pitted,poricidal,seed,shape,shaped,shrub,simple,size,spaced,stem,stigma,straight,style,surface,tan,tear-drop,tip,translucent-green,tube,white-lenticellate	.5,/4,0-seeded,1-1.5,1.1-1.2,1.1-3.5,1.25-1.5,1.9-2.6,11.2-22,11.3,2-2.5,2.1-6,2.5-3.25,25,3-5,3.4-6.6,3.5-4,4-7,5-50-flowered,6-8,across,anthesi,appearing,arching,attenuate,beginning,beneath,berry,bullate,carinate-hooded,conical,consisting,cuneate,dark,decurrent,deflexed,dia,differing,difoliate,dry,eaf,edicel,eed,elliptic,exerted,filament,five,free,fresh,geminat,glabrou,horizontally,inflorescenc,lobe,lobed,lon,long,lower,main,major,maturity,middle,minor,n,nflorescence,node,occasionally,older,one,orbicular,orbiculate,pair,paler,papillo,papillose,pendulous,pit,pore,portion,projection,prominent,proximal,raised,reflexed,rim,ruit,scar,sea-green,shallow,slender,slightly,smooth,soon,specimen,spreading,tall,tapering,translucent,two,ud,unit,usually,vein,way,white-lenticellat,wide,widest,winged,woody,x,ympodial	1.5,arrangement,articulation,color,connation,decurren,dehiscence,diameter,diminishing,distal,foetid,foliage,form,fruit,growth,height,history,interjected,leaflet,length,life,midpoint,na,papillae,peduncle,perennial,petiolule,plant,position,prickle,pseudostipule,spacing,straightnes,terminal,texture,trichome,tuber-bearing,young
595	wfo-0001030271	success	195	122	93	102	29	0.477	0-2,0.15-0.75,0.5-1.2,0.7-9.5,0.9-2.5,0.9-3.6,1-2,1-2.5,1-7,1.4-2.1,15-61,2-2.7,2-6,3-10,3-5,3.4-7.5,5-8,6-15,abaxially,acute,adaxially,anther,apex,attenuate,base,berry,blue,brownish,clavate,cm,coloration,condition,connivent,coriaceous,corolla,dark,decreasing,deep,diameter,distal,drying,elliptic,erect,forked,fresh,fruit,glabrous,green,greenish,herb,interjected,lanceolate,lateral,leaf,leaflet,light,lilac,medium,mm,moniliform,mottled,mucilaginous,odd-pinnate,ovate,ovoid,pedicel,peduncle,pentagonal,petiole,petiolulate,plant,poricidal,purple,rosette,rotate,rounded,seed,size,spot,stigma,straight,style,terminal,tip,toward,tube,tuber,typically,wet,white,whitish,x,yellow	1-3,1-4,1-6,1.9-6.6,2-3,2-4,2.4-5.6,4-22,4-7,5-merou,5.6-12.3,acumen,adaxiall,ag,along,alyx,apart,apparently,arranged,articulated,asymmetric,axe,axillary,basiscopic,bead,blade,bud,capitat,cell,completely,considerably,covering,digestion,dorsally,eaf,edge,eed,enzyme,exceeding,filament,flat,flower,folded,geminat,generally,glabrou,green-white,habi,hair-like,half,homostylous,honeycomb-shaped,larger,lengthening,like,linear,living,lobe,long,lower,make,middl,multiple,necklace,nflorescence,orbicular,orolla,pair,perfect,plurifoliate,pore,removed,ripe,ruit,sessile,seudostipule,side,slightly,slit,sometimes,spaced,specimen,stamen,stolon,subtending,symmetric,tall,tamen,tem,testal,thick,throughout,tissue,tri-,unit,unwinged,usually,vary,vein,wall,wide,ympodial	arrangement,bark,calyx,capitate,color,connation,dehiscence,diminishing,form,growth,habit,height,history,inflorescence,length,life,na,ovary,papillae,petiolule,pseudostipule,shape,spacing,stem,straightnes,surface,texture,tuber-bearing,width
596	wfo-0001030272	success	179	103	65	114	38	0.363	0.5-1.5,0.65-1,0.7-2.5,0.8-1.5,1,1.5-2.5,2.5-3,almost,anther,apex,articulated,bark,base,bright,calyx,cm,connivent,densely,diameter,elliptic,evenly,flattened-reniform,fruit,fruiting,glabrescent,glandular,green,hair,lateral,leaf,length,less,lobed,long-attenuate,maturity,mauve,membranous,midpoint,minute,mm,obtuse,orange-brown,pedicel,peduncle,petiole,poricidal,red,rounded,shrub,simple,sparsely,spherical,spreading,stellate-pubescent,stem,straight,style,surface,tapering,terminal,tip,trichome,tube,unbranched,young	-6,.3,.5,/4,0-20,0.05-0.1,0.05-1.5,0.5-1,0.5-2,0.6-0.9,1-1.5,1-2.8,1.2-1.8,1.5-3,1/3,1/3-2/3,10-20,2-2.5,2-6.5,2.5-3.5,2.8-3.5,3-8,3.5-5,4-10,4-15,4-6,4-8,5-7,5-merous,abaxially,acut,acute,alyx,ame,apar,apically,apparently,ba,berry,blade,c.,concolorous,deltate,difoliate,drying,eaf,eed,elongating,entire,equal,erect,filament,flower,free,geminat,glabrescen,glabrous,gland,gra,infructescence,lobe,long,longer,lower,margin,mature,moderately,multangulate,narrow-deltate,near,nflorescence,older,one,open,orolla,oung,pair,per,perfec,pericarp,porrect,portion,primary,ray,red-brown,reduced,reflexe,ruit,scar,sessile,shallowly,shorte,slender,smooth,sometimes,spaced,stellate,tamen,terete,tertiary,time,unarme,unarmed,undulate,unit,upper,vary,vein,venation,visible,way,wide,woody,ympodial	apart,arrangement,articulation,color,connation,corolla,dehiscence,diminishing,distal,foetid,foliage,form,gray,growth,height,history,inflorescence,interjected,leaflet,life,na,ovary,papillae,perennial,petiolule,plant,position,prickle,pseudostipule,reflexed,seed,shape,size,spacing,stigma,straightnes,texture,tuber-bearing
597	wfo-0001030278	success	235	109	73	162	36	0.311	0-0.2,0.6-1,1-2,10-20,2-4,3-7,5-20,6-12,7-10,accrescent,anther,apex,articulated,base,broadly,brown,calyx,cm,connivent,contiguous,cordate,corolla,dark,diameter,distal,ellipsoid,elliptic,extra-axillary,fruit,fruiting,hair,inflorescence,lateral,length,lenticular,linear-lanceolate,long,midpoint,minutely,mm,nearly,orange,ovate,pedicel,peduncle,perennial,petiole,pitted,prickle,prominent,simple,slender,spaced,spreading,stellate,stem,stigma,straight,style,subglobose,surface,tan,thin-textured,trichome,truncate,tube,unbranched,uniseriate,weakly,white,widely,x,yellow	0-1,0.1-0.3,1-several,1/3-1/2,10-30,12-25,15-20,2,2-6,2-7,2-foliate,2.5-3,3-4,3-5,3.5-5,3.5-7,4-12,4-8,4-locular,5-8,6-18,7-12,7-20,8-30,9-18,abaxially,absent,achlorophyllous,acute,acute-,adaxial,adaxiall,adaxially,along,also,armed,ascending,attenuate,axe,ba,basally,blade,branched,breaking,broad-based,capitat,capitate-glandular,cauline,closely,coarsely,collection,commonly,completely,compressed,concentrated,covering,cylindrical,deltoid,densely,density,dentate,directed,distall,divergently,eaf,eed,elongate,entire,erect,female-sterile,filament,finally,fine,flesh,flexuous,flower,geminat,glabrou,glabrous,gland-tipped,glandular-puberulen,hermaphroditic,hirsute,immature,inserted,interlobal,intermixed,large,laterally,less,lignescent,lobe,longer,lower,major,margin,maturit,medium-sized,midrib,mixed,moderately,mostly,much,narrowly,nflorescence,numerous,obtuse,obtuse-tipped,occasionally,often,open-campanulate,orolla,outline,ovate-lanceolate,pale,per,petaloid,pore,prickly,principal,pubescent,rachi,ray,recurved,reduced,resembling,rigid,ripe,ruit,section,sessile,short-stalked,short-styled,side,similar,sinus,small,smaller,sometimes,somewhat,sparsely,spreading-hirsute,stalked,ste,stellae,straighter,subequal,surrounding,tal,tamen,tem,termination,tip,toothlike,unarmed,unit,usually,vary,varying,vein,wide,ympodial	arrangement,articulation,bark,capitate,color,connation,dehiscence,diminishing,distally,foetid,foliage,form,growth,height,herb,history,interjected,leaf,leaflet,life,na,ovary,papillae,petiolule,plant,position,pseudostipule,seed,shape,size,spacing,straightnes,terminal,texture,tuber-bearing,young
598	wfo-0001030281	success	193	111	81	112	30	0.42	0.5-1.0,0.5-3,1-2.5,12-16,12-20,2-4,3-6,4-6,4-7,5-10,absent,accrescent,anther,apical,asymmetrical,attenuate,base,brown,calyx,capitate,chartaceous,cm,connivent,curved,densely,diameter,directed,distally,expanded,extra-axillary,flower,fruit,fruiting,functionally,globose,hair,hermaphroditic,leaf,lobed,male,many,midpoint,mm,moderately,nearly,netlike,obtuse,orange,ovate,pedicel,peduncle,petiole,pit,plant,porrect-stellate,prickle,pubescent,raised,recurved,red,reniform,ridge,roselike,rusty,separated,simple,slightly,small,stellate,stem,stigma,style,surface,tan,tapering,unbranched,vine,white,x,yellow,young	0.2-0.8,0.5,0.5-1,0.5-1.5,1,1-.,1-2,1.5,1.5-3,10-13,10-14,10-25,2-4.5,2-5,2.5-3,2.5-3.5,2.5-5,20-30,3-12,4-8,5-16,5-merou,6-8,abaxial,abaxially,absen,acute,adaxial,adaxiall,adaxially,alyx,andromonoecious,anthesi,apar,apex,armed,axe,berry,beyond,blade,cordate,cylindrical,dark,difoliate,discolorous,eaf,eed,either,em,exserted,filament,flattened,frui,geminate,glabrou,glabrous,glandular,gree,green,heteromorphic,interpetelar,introrsel,lacking,leathery,like,lobe,long,long-styeld,lower,major,mature,midrib,midvein,multicellular,multiseriate,narrowly,nflorescence,often,older,orolla,pair,per,planst,pore,rachi,ray,reflexed,ruit,short,short0styled,side,spaced,sparsely,stalk,stamen,staminate,ste,tamen,tissue,triangular,tube,unarmed,unequa,unicellular,unit,unlobed,usually,vary,vein,whitish-green,wide,ympodial	1-4,apart,arrangement,articulation,color,corolla,dehiscence,foetid,foliage,form,growth,height,history,inflorescence,interjected,introrsely,lateral,leaflet,length,life,na,position,pseudostipule,seed,shape,size,spacing,terminal,texture,trichome
599	wfo-0001030285	success	279	120	84	195	36	0.301	.1,1.3–1.8,1.6–2.3,1.6–5.0,1/3,1984,3.5–6.0,3.7–5.4,4,4.3–11.8,5,9.2–15.2,acuminate,alveolate,anther,apex,apical,area,armed,articulated,attenuate,base,bud,calyx,capitate,central,chartaceous,cm,connivent,corolla,cuneate,dehiscence,diameter,dry,elliptic,enclosing,extra-axillary,flattened-irregular,flattened-orbicular,flattened-reniform,flower,fruit,fully,globose,green,growth,internode,lateral,lavender,leaf,long,lower,margin,maturing,minute,mm,nearly,obovate,pedicel,peduncle,peekel,petiole,pore,prickle,purple,red,reported,rounded,shrub,simple,slightly,smooth,stellate,stem,stigma,straight,style,surface,tube,upper,white,yellow,yellow-ferruginous,young	.04,.4,.6,.8,0.1–1.1,0.2–0.3,0.3–0.4,0.3–0.6,0.3–0.7,0.4–0.5,0.4–0.6,0.5–0.7,0.6–0.9,0.7–1.1,0.7–1.3,0.7–1.5,0.7–1.7,0.9–1.5,1.0–1.3,1.0–2.2,1.2–2.1,1.2–2.3,1.4–1.9,1.4–2.0,1.9–4.0,10.8–12.3,10–14,13.5,15.0–25.5,2.2–4.8,2.4–3.2,2.8–3.1,3/4,4.0–7.0,4.6–8.8,45,4–5-merou,5.7–6.5,6.0–9.0,6–10,6–8-ray,9.9–14.9,90°,abaxially,adaxial,adaxially,adnate,aequilateral,age,alyx,anthesi,apart,apiculate,apparently,appearing,appressed,attached,attachment,axe,ba,basal,becoming,berry,bilobe,blade,branch,brochidodromous,bu,channel,channeled,clinate,congested,conical,deciduous,densely,dentate,difoliate,distally,dorsally,eaf,eed,either,emerging,endocarp,entire,erect,exocarp,fertile,filament,filiform,flat,flexed,fork,forking,free,frui,geminat,glabrous,glandular,gradually,hair,homostylous,immature,inclined,increasing,interpetalar,intersepalar,juic,lanceolate,large,laying,less,line,lobe,lon,major,many-flowered,mature,midpoint,midrib,midvein,minor,moderate,moderately,nflorescence,notched,oblique,occasionally,often,orolla,ovoid,per,perforate,point,poorly-developed,porrect,porrect-stellate,portion,potentially,protuberance,pubescence,pubescent,raised,ray,reduced,restricted,rigid,ripe,row,ruit,sessile,shiny,shorter,side,single,sinus,small,soon,sparse,sparsely,splitting,spread,stellae,stellate-pubescent,suture,tall,tamen,tem,thin,time,tip,tissue,toward,transparent,tree,triangular,truncate,two,ud,unarme,unarmed,unbranched,vary,vein,vigorous,wavy,weakly,wide,ympodia,±90°,±90°and,±equal,±glabrous,±overlapping,×	arrangement,articulation,bark,bilobed,color,connation,diminishing,distal,foetid,foliage,form,fruiting,height,history,inflorescence,interjected,leaflet,length,life,na,ovary,papillae,perennial,petiolule,plant,position,pseudostipule,seed,shape,size,spacing,straightnes,terminal,texture,trichome,tuber-bearing
600	wfo-0001030287	success	150	98	64	86	34	0.427	-11,0-15,0.5-1,1-15,1-4,1-5.5,1966,2-,2-12,2-5,3,3-9,4-5,apart,apex,base,bluish,calyx,chartaceous,cm,color,compound,connivent,dendritically,diameter,down,ellipsoidal,elliptic-ovate,fide,flattened,forked,glabrous,herb,lanceolate,lateral,leaf,leaflet,lilac,mm,narrowly,oblong,often,ovoid,pedicel,peduncle,petiole,pinnately,pubescent,purple,rugulose,shrub,simple,smith,stellate,stigma,strongly,style,subcoriaceous,truncate,tube,unbranched,unknown,x,yellow	-40,-foliat,-many,.5-2.5,1,1-10,1-2,1-2.5,1-3,1.5-10,1.5-2.5,2,2-10,2.5-4,4-6,4.5-6,5-10,8-13,?,abaxially,acute,adaxiall,adaxially,aggregate,articulated,axe,basiscopically,blade,branched,cell,cylindrical,decurrent,deltate,dendritic,dendritic-pubescen,densely,directed,distall,eaf,eed,eglandular,entire,flower,gland,glandular,hair,leaving,lobe,lon,long,long-stalked,lower,margin,membranaceous,moderately,nflorescence,nther,obtuse,orolla,pedicellar,pore,presen,puberulent,rachi,radiu,ruit,scar,scattered,slightly,spaced,sparsely,sparser,stalked,stone,subcapitat,subcordate,tal,tem,time,tip,triangular,unit,upper,vary,wide,ympodial	anther,arrangement,bark,connation,corolla,dehiscence,diminishing,distal,form,fruit,growth,height,history,inflorescence,interjected,length,life,na,ovary,papillae,petiolule,plant,pseudostipule,seed,shape,size,spacing,stem,straightnes,subcapitate,surface,terminal,texture,tuber-bearing
601	wfo-0001030299	success	179	104	64	115	40	0.358	-50,1-1.5,1-10,10-20,2-,2-10,2-20,3-13,3-9-compound,4-8,5-8,6-22,6-9,acuminate,apart,apex,articulated,basal,base,calyx,campanulate,capitate,chartaceous,cm,color,connivent,cordate,diameter,ellipsoidal,flattened,forked,fruit,lateral,leaf,leaflet,lobe,long,mm,moderately,narrowly,ovate,pedicel,peduncle,petiole,pink,pinnately,pubescent-pilose,purple,rugose-reticulate,shrub,simple,small,sparsely,stigma,style,tree,truncate,tube,unbranched,urceolate-,violet,white,x,yellow	-2,-40,-6,.5-2,0.5-1,1-2,1-3,1-5,1.5-2,1.5-3,1.5-4,10-16,2,2-4,2.5-12,20-30,25-50,3,3-30,3-4,3-5,4,4-5,4-6,4-foliat,5-10,5-40,?,abaxially,absen,absent,acute,adaxially,aggregate,also,ape,apiculate,axe,basiscopically,beyond,blade,cell,compound,connective,coriaceous,cylindrical,decurrent,densely,diamete,dilated,directed,distally,eaf,eed,entire,equal,exceeding,expanded,exserted,fide,flower,glabrous,globose,hair,laterally,leaving,lon,lower,margin,midnerve,nflorescence,nther,obtuse,often,orolla,pavón,pedicellar,perfect,perhaps,pilose-hirsute,pore,present,prominent,puberulent-pubescen,puberulent-pubescent,pubescent,pubescent-pilo,rachi,radiu,remnant,ruit,ruiz,shorter,slightly,spaced,stamen,stone,tal,tem,thecae,thickened,time,tip,tomento,tomentose,toward,triangular,ud,unequal,unit,unknow,upper,vary,wide,ympodial	anther,arrangement,articulation,bark,connation,corolla,dehiscence,diminishing,distal,foetid,foliage,form,fruiting,growth,height,history,inflorescence,interjected,length,life,na,ovary,papillae,petiolule,plant,position,prickle,pseudostipule,seed,shape,size,spacing,stem,straightnes,surface,terminal,texture,trichome,tuber-bearing,young
602	wfo-0001030300	success	235	96	72	163	24	0.306	-7,0.4-1.5,0.5,0.5-1,0.5-4,0.5-5,0.7-0.8,0.8-3,0.9-1,1-2,1-4,4-11,9-12,absent,anther,apex,base,bifid,broadly,brown,calyx,capitate,cm,coherent,corolla,diameter,distal,elliptical,fruit,globose,golden,green,hair-like,herb,imparipinnate,inflorescence,interjected,interrupted,large,lateral,leaflet,mm,obovate,once-branched,orbicular,outgrowth,ovary,pale,papillae,partially,pedicel,peduncle,pentagonal,perennial,petiole,petiolule,plant,pseudostipule,pubescent,rounded,simple,slightly,stem,stigma,style,surface,terminal,trichome,tube,usually,yellow,zygomorphic	-0.9,-1,.5,0.1,0.1-0.15,0.15-1,0.2,0.2-0.5,0.2-1.5,0.4-0.5,0.4-4.5,0.5-0.6,0.6-0.7,0.6-0.8,0.7-1.2,0.7-1.5,0.8-1,0.8-4,1,1-1.3,1-2-celled,1-6,1-celled,1.2-,1.4-2.4,1.5-,1.5-2.5,2-2.1,2-2.5,2-3,2-4,2-foliate,2-locular,2.2-7.5,3.5-13,3/4,4-celled,6-15,6-8-celled,abaxially,abundant,acute,adaxial,adaxially,almost,although,always,anthesi,apical,appearance,appendage,articulated,articulation,ba,basal,bent,beyond,bract,bracteate,brittle,cell,column,cordate,crenat,crenate,curved,deltate,densely,developed,diamete,eaf,edicel,eed,eglandular,ellipsoidal,elongate,entire,even,exserted,face,filament,finely,flower,frequently,fruiting,give,glabrous,glandular,glutinous-viscose,gree,halfway,head,internode,introrse,irregularly,lamina,larger,leave,less,like,lobe,lon,long,longer,margin,markedly,midvein,minute,moderately,multicellular,narrowly,nflorescence,node,oblique,occasionally,pair,petal,pith,population,pore,present,primary,pubescence,reflexed,rest,ruit,secondary,silky,sparsely,spathulate,spreadin,spreading,staminal,sterile,straight,strongly,tall,tem,tertiary,testa,thick,tip,triangular,two,ud,underlying,unicellular,uniseriate,unit,united,upper,vein,velvety,wall,weak,well,wide,wider,winged,woody,yellowish,yellowish-green,ympodial	0.1-1,arrangement,bark,color,connation,dehiscence,diminishing,foetid,foliage,form,growth,height,history,leaf,length,life,na,seed,shape,size,straightnes,texture,tuber-bearing,young
603	wfo-0001030311	success	182	106	62	120	44	0.341	.2,5-pinnate,acuminate,acute,anther,apex,base,brown,calyx,chartaceous,cm,color,cuneate,diameter,distal,elliptical,fallen,flattened,flower,fruit,granular,green,ground,herbaceous,lateral,leaflet,lenticular,log,lower,membranaceous,minutely,mm,oblique,obovate,obtuse,orangish,ovoid-rhomboid,pedicel,peduncle,petiole,petiolule,pubescent,purplish,rounded,sand-punctate,shortly,side,sparsely,stellate,stem,stigma,style,surface,tan,terrestrial,trailing,tube,unbranched,upper,vine,white,x	.5,.5–1.8,0.1,0.1–0.2,0.3–1.5,0.4–2,0.5–0.8,0.5–1,0.5–2,0.5–2.5,0.6–1,0.6–2.4,0.8–1.2,0.8–4,0.8–4.5,1.2–7,1.5–2,1.5–3,1.5–5.5,1.5–6,1.5–8,1.8–2,15–22,1–1.2,1–1.5,1–2,1–2.5,1–3,2.2–2.5,2.2–3,2.5–9,2–10,2–2.5,2–6,3–5,3–7,5–10,<,abaxially,accrescent,adaxial,adaxially,along,alyx,apar,apical,appearance,axe,basal,berry,blade,c.,capitat,ciliat,ciliate,clavate,cordate,deltoid,dense,densely,eaf,eed,entire,especially,extra-axillary,falcate,filament,fruiting,giving,glabrou,glabrous,groov,groove,hair,half,lanceolate,like,lobe,lon,long,m.,margin,membranous,midvein,nflorescence,nternode,occasionally,orolla,pair,papillose,petiolulate,plurifoliat,present,proximal,pubescence,rachi,rhomboid,ruit,scattered,sessile,short,slender,slightly,smaller,spaced,strongly,tamen,tem,thick,thickened,thinner,tip,trichome,unit,vary,vein,wide,wide-diameter,widely,ympodial	0.4-2,0.5-2.5,0.6-2.4,0.8-4,0.8-4.5,1-3,1.5-2,1.5-5.5,15-22,2-10,2-6,3-5,3-7,5-10,apart,arrangement,bark,capitate,connation,corolla,dehiscence,diminishing,form,growth,height,history,inflorescence,interjected,leaf,length,life,na,ovary,papillae,plant,pseudostipule,seed,shape,size,spacing,straightnes,terminal,texture,tuber-bearing
604	wfo-0001030311	success	203	111	80	123	31	0.394	.2,0.4-2,0.5-2,0.6-2.4,0.8-4,0.8-4.5,1-3,1.5-2,1.5-5.5,15-22,2-10,2-6,3-5,3-7,5-10,5-pinnate,abaxially,absent,acuminate,acute,adaxially,anther,apart,apex,basally,base,brown,chartaceous,cm,color,connivent,cordate,diameter,distal,flattened,flower,fruit,glabrous,granular,green,herb,interjected,lateral,leaflet,lenticular,longitudinal,membranaceous,minutely,mm,oblique,oblong,obovate,obtuse,opening,orangish,ovoid-rhomboid,pedicel,peduncle,petiole,petiolule,present,pubescent,purplish,rhomboid,rounded,slightly,slit,sparsely,stellate,stem,stigma,style,surface,tan,trailing,tube,unbranched,white,x,yellow	.5,.5-1.8,0-2.5,0.1,0.5-0.8,0.5-1,0.6-1,0.8-1.2,1-1.2,1-1.5,1-2.5,1.2-7,1.5-3,1.5-6,1.5-8,1.8-2,2-2.5,2.2-2.5,2.2-3,2224,5-merou,8031,<,[,],absen,accrescent,adaxial,ag,aggregate,along,alyx,apical,apparently,appearance,articulated,axe,ba,basal,blade,capitat,cell,ciliat,ciliate,clavate,cuneate,deltoid,dense,densely,dig,directed,distally,eaf,eed,elliptical,entire,equal,especially,falcate,fallen,filament,formation,g,geminat,gh,giving,groov,groove,ground,hair,half,large,like,lobe,log,lon,long,lower,m.,margin,midvein,nflorescence,node,occasionally,orolla,pair,papillose,perfect,petiolulate,pittier,plurifoliate,pore,proximal,rachi,rooting,ruit,scattered,sessile,short,shortly,side,simple,sinple,slender,smaller,spaced,stone,strongly,tamayo,tamen,tem,thick,thickened,thinner,tip,uniseriate,unit,upper,vary,vein,wide,widely,ympodial	1.5,age,arrangement,bark,calyx,capitate,connation,corolla,dehiscence,diminishing,form,growth,height,history,inflorescence,leaf,length,life,na,ovary,papillae,plant,pseudostipule,seed,shape,size,spacing,straightnes,terminal,texture,tuber-bearing
605	wfo-0001030335	success	153	102	70	83	32	0.458	0-5,0.5-1,1-2,1.1-1.4,2-5,3/4,5-6,acuminate,acute,along,anther,apex,bark,base,beneath,berry,bi-lobed,branch,bud,calyx,cm,conical,corolla,dark,decurrent,densely,dry,elliptic,glabrous,globose,green,greyish-red,horizontally,lateral,leaf,lenticellate,lobed,material,minutely,mm,narrowly,onto,ovary,ovoid-reniform,pale,papillose,pedicel,petiole,pitted,poricidal,prominent,pubescent,ripe,shrub,simple,spreading,stem,stigma,straight,style,surface,tan,tip,tube,vein,way,white,yellow,yellowish-green,young	.1,.25,.5,.75,0.05-0.2,0.1-0.5,0.25-0.5,0.7-1,1-1.5,1-3-flowered,1.1.5,2-2.2,2-2.5,2-4.5,2.5-3,5-7,7-13,anthesi,aspec,ba,deciduous,deflexed,deltoid,dia,eaf,edicel,eed,erect,except,expanded,exserted,filament,filiform,flattened,free,fruiting,geminate,gently,giving,lamina,lightly,like,lobe,lon,long,lower,main,middle,minute,nflorescence,obovoid,occasionally,often,older,opposite,pair,papillo,pore,portion,puberulen,puberulent,raised,reflexed,ruit,shaped,slightly,soon,sparsely,strongly,tall,tapering,tear-drop,trichome,ud,underside,unifoliat,uniseriate,unit,widest,winged,woody,x,ympodial	arrangement,color,connation,dehiscence,diameter,diminishing,distal,form,fruit,growth,height,history,inflorescence,interjected,leaflet,length,life,na,papillae,peduncle,plant,pseudostipule,seed,shape,size,spacing,straightnes,terminal,texture,tuber-bearing,undersurface,unifoliate
606	wfo-0001030336	success	266	115	85	181	30	0.32	0-,0.2-0.8,0.2-1,0.5,0.5-0.7,0.6-0.8,0.8-3,1,1-1.5,1-3,1.5-3.5,2-9,3-5,4-10,acute,almost,anther,apex,articulated,articulation,base,bifurcate,bluntly,bright,brown,calyx,capitate,cm,cordate,corolla,dark,densely,diameter,distal,elliptic,fruit,fruiting,globose,grayish,green,greenish,hair-like,half,herb,imparipinnate,inflorescence,interjected,interrupted,lanceolate,lateral,leaf,leaflet,mm,obovate,once-branched,orbicular,outgrowth,ovary,pale,pedicel,peduncle,perennial,petiole,petiolule,proximal,pseudostipule,pubescent,rotate,rounded,slightly,stellate,stem,stigma,style,surface,terminal,trichome,truncate,tube,uniformly,usually,velvety,white,yellow,young	-1.5,-10,-19,-2,.5,0.1-0.3,0.1-0.5,0.1-0.7,0.1-1,0.15-0.2,0.15-0.9,0.2,0.2-0.25,0.2-1.5,0.3-0.4,0.3-1.1,0.5-1,0.5-1.5,0.6-1.5,0.8-0.9,0.8-1.2,0.8-1.3,1-1.4,1-celled,1.0-1.4,1.5-,1.5-2,1.5-5,1.6-7,1.7-2.3,1.8-3.0,1/4-1/3,10,2-4,2-foliate,2-locular,2/3,4,4-,4-celled,6,8-16,8-20,8-celled,absent,adpressed,amongst,anthesi,apical,appearance,appearing,appendage,basal,basiscopically,bent,berry,bract,bracteate,branch,cell,clavat,coat,column,completely,conical,crenate,curved,darker,decurrent,deeply,developed,diamete,divided,eaf,edicel,eed,eglandular,elongate,entir,entire,erect,essentially,exserted,extremely,filament,first,flower,flushed,giving,glandula,glandular,halfway,head,internode,investing,large,larger,largest,leave,less,like,lobe,lobed,lon,long,longer,loosely,lower,margin,markedly,maturity,mere,middl,midvein,minute,minutely,mixed,mostly,narrowing,narrowly,nflorescence,node,oblique,occasionally,often,pair,papillate,part,population,present,primary,puberulent,purple,rachi,range,reflexed,rest,ruit,scattered,secondary,sessile,shaggy,shorter,shrub,silky,simple,sinus,small,soft,sometimes,southern,sparse,spreadin,spreading,staminal,sterile,straight,stripe,strongly,surrounding,tall,tem,ten,tertiary,testa,thick,tip,two,ud,unicellular,uniseriate,unit,united,upper,wall,way,weak-walled,wide,winged,woody,ympodial	1.5-4,arrangement,bark,clavate,color,connation,decurrence,dehiscence,diminishing,foetid,foliage,form,growth,height,history,length,life,middle,na,papillae,plant,position,prickle,seed,shape,size,spacing,straightnes,texture,tuber-bearing
607	wfo-0001030342	success	155	100	68	87	32	0.439	.2,0.5–3,0.5–5,0.8–1.5,0.8–4,1.5–13,1.5–2,1.5–5,10–25,1–3,1–5.5,1–6,3-pinnate,3–12,4–5,4–8,acuminate,adaxially,anther,apex,apiculate,base,broadly,brown,calyx,chartaceous,cm,cordate,cuneate,dense,diameter,elliptical,fruit,glabrous,greenish,herbaceous,lateral,leaf,leaflet,lenticular,light,membranous,mm,oblique,obtuse,ovoid-rhomboid,pedicel,peduncle,petiole,petiolule,rhomboid,scattered,slender,smooth,stellate,stem,stigma,style,surface,trichome,tube,unbranched,vine,white,wide-diameter,widely,x,yellowish	.5,0.1–0.2,0.3–1.2,0.5–1,1-5,1-6.5,1.2–3,1.5,1.5–7.5,1–1.2,1–1.5,1–2.5,1–7,2–,2–2.5,2–4,3,5-merous,6–7,abaxially,abundant,accrescent,acute,along,alyx,apar,apical,axe,berry,blade,c.,capitat,ciliat,cylindrical,deltoid,eaf,eed,entire,extra-axillary,filament,flattened,flower,fruiting,glabrou,lanceolate,like,lobe,lon,long,lower,m.,margin,minutely,mottled,nflorescence,nternode,often,orolla,perfec,plurifoliat,pointed,proximal,pubescen,pubescent,rachi,rarely,revolute,rounded,ruit,sand-punctate,side,slightly,spaced,sparsely,tamen,tem,terrestria,tip,truncate,truncate-acuminat,undulate,unit,vary,vein,wide,ympodial,–7	apart,arrangement,bark,capitate,color,connation,corolla,dehiscence,diminishing,distal,form,growth,height,history,inflorescence,interjected,length,life,na,ovary,papillae,plant,pseudostipule,seed,shape,size,spacing,straightnes,terminal,terrestrial,texture,tuber-bearing
608	wfo-0001030342	success	153	99	72	81	27	0.471	.2,0.5-3,0.5-5,0.8-4,1-5.5,1-6,1.5-13,1.5-2,1.5-5,10-25,2-3,3-12,3-pinnate,4-5,4-8,absent,acuminate,adaxially,anther,apart,apex,apiculate,basally,base,broadly,brown,calyx,chartaceous,cm,cordate,cuneate,diameter,elliptical,fruit,glabrous,hair,herb,interjected,lateral,leaf,leaflet,lenticular,light,longitudinal,membraceous,mm,oblique,oblong,obtuse,opening,pedicel,peduncle,petiole,petiolule,rhomboid,sagittate,scattered,simple,slender,slit,smooth,stellate,stigma,style,surface,terrestrial,unbranched,uniseriate,white,widely,x,yellow	-7,.5,0.5-1,1-1.2,1-1.5,1-3,1-5,1-6.5,1-7,1.2-3,1.5-7.5,2-,2-2.5,3,5-merou,6-7,abaxially,abundant,accrescent,acute,ag,along,alyx,apical,apparently,articulated,axe,ba,blade,capitat,ciliat,connivent,cylindrical,deltoid,directed,distally,eaf,eed,entire,equal,extra-axillary,filament,flower,fruiting,geminat,lanceolate,lobe,long,lower,margin,minutely,nflorescence,node,orolla,perfect,plurifoliate,pore,proximal,pubescen,pubescent,rachi,rarely,revolute,rooting,rounded,side,slightly,spaced,tamen,tem,tip,trailing,truncate,truncate-acuminat,tube,undulate,unit,vary,vein,wide,ympodial	age,arrangement,capitate,color,corolla,dehiscence,diminishing,distal,form,growth,height,history,inflorescence,length,life,na,plant,present,pseudostipule,seed,shape,size,spacing,stem,terminal,texture,ye
609	wfo-0001030353	success	227	109	78	149	31	0.344	.7,0-6,0.5-0.9,0.8-1.2,1-2,1-6,1.8-3,2-10,3-5.5,5,acute,almost,anther,apart,apex,apically,articulated,bark,base,berry,brown,calyx,chartaceous,cm,connivent,cuneate,diameter,distal,ellipsoid,elliptic,elongating,erect,evenly,flattened-reniform,fruit,fruiting,glabrescent,glabrous,green,lateral,leaf,length,lobed,long,long-styled,maturity,mauve,midpoint,mm,multangulate,patch,pedicel,peduncle,petiole,plant,poricidal,prickle,red-brown,rounded,sessile,shape,short-styled,shrub,simple,small,stem,straight,style,surface,tapering,terminal,tip,tree,trichome,tube,unbranched,yellow,young	-0.2,-1.5,-1/2,-2,-3,-5,-6,-merous,.1,.2,.5,0,0-15,0-2,0.1-0.2,0.1-0.3,0.15-0.3,0.5,0.8,1,1-3,1-7,1.2-1.8,1.8-2.2,1/,1/2-2/3,1/3,1/5,1/6,1/6-1/4,10-15,11-16,2-7,2.5-4,2.8-3.7,20-200,3-4,3.5-4,4-,4-4.5,4-5,5-6,6,6-15,6-8,7-10,8-15,abaxial,abaxially,adaxial,alyx,andromonoecious,apar,apiculat,apparently,blade,broad-deltate,c.,conical,curved,deltate,densely,development,discolorous,distance,drying,eaf,eed,equal,extending,filament,flattened,flower,free,half,hermaphrodite,heterostylous,infructescence,less,lobe,longer,lower,lowermost,margin,mature,midvein,moderately,narrow-deltate,nflorescence,older,one,open,orange-brown,orolla,oung,pair,pendulous,per,pericarp,plurifoliat,pointed,porrect,portion,prickly,primary,ray,reddish-green,reflexed,retaining,ruit,scar,shorter,side,smooth,sometimes,somewhat,spaced,sparsely,spreading,stalk,stalked,staminat,stellate,stellate-pubescent,stout,strongly,subentire,tamen,terete,tertiary,throughout,time,unarme,unarmed,unit,upper,vary,vein,venation,visible,warty,way,weakly,whit,white-gray,wide,wo,woody,ympodial	arrangement,articulation,color,connation,corolla,dehiscence,diminishing,foetid,foliage,form,growth,height,history,inflorescence,interjected,leaflet,life,na,ovary,papillae,petiolule,position,pseudostipule,seed,size,spacing,stigma,straightnes,texture,tuber-bearing,white
610	wfo-0001030407	success	182	123	86	96	37	0.473	0.7-3.2,1-10,1-2,1-4,1.5-5,12-14,2-5,2-6.7,2-7,3-10.5,3-6.5,3.5-9.5,30-60,5,6-7,7-8,absent,acuminate,anther,apex,articulated,axillary,base,berry,brownish,bud,chartaceous,cm,condition,conical,connivent,corolla,densely,diameter,distal,drying,elliptic-lanceolate,forked,fresh,fruit,glabrous,gradually,green,greenish,herb,interjected,lanceolate,lateral,leaf,leaflet,light,long,middle,minute,mm,mottled,mucilaginous,obtuse,odd-pinnate,ovate,ovoid,pedicel,peduncle,pentagonal,petiole,petiolule,plant,poricidal,proximal,pubescent,purple,ripe,round,seed,size,stigma,style,subtending,terminal,tip,tube,typically,wet,whitish,x,yellow	.2,.5,1-3,12-15,2-2.5,3-4,3-9,4-5,5-merou,6.5-18.5,abaxially,acumen,adaxially,ag,alyx,apart,apparently,axe,blade,capitat,cell,ciliate,covering,decreasing,digestion,dorsally,eaf,edge,eed,end,enzyme,especially,exceeding,filament,flat,flower,folded,geminat,generally,glabrou,green-white,hair,hair-like,half,homostylous,honeycomb-shaped,larger,lengthening,like,living,lobe,lower,make,margin,nflorescence,one,orolla,pair,perfect,placed,plurifoliate,pore,pubescen,ray,removed,ruit,secondary,semierec,seudostipule,slit,spaced,specimen,stamen,ste,stolo,subequal,subsessile,symmetrical,tall,tamen,tem,testal,thick,thir,throughout,toward,tri-,tuber,unit,unwinged,usually,vary,wall,white,wide,ympodial	arrangement,articulation,bark,calyx,capitate,color,connation,dehiscence,diminishing,foetid,foliage,form,fruiting,growth,height,history,inflorescence,length,life,na,ovary,papillae,position,prickle,pseudostipule,semierect,shape,spacing,stem,straightnes,subessile,surface,texture,third,trichome,tuber-bearing,young
611	wfo-0001030417	success	242	111	86	156	25	0.355	-5,0.05-0.1,0.1-0.25,0.5-2,0.7-1,1-1.3,1-4,1.5-3.5,2-3,2.5-5,3,4-25,8-11,acuminate,acute,annual,anther,apex,base,basiscopically,biennial,bright,broadly,brown,calyx,capitate,cm,corolla,decurrent,densely,diameter,distal,elliptic,extremely,fruit,fruiting,generally,globose,hair-like,herb,imparipinnate,inflorescence,interjected,interrupted,lateral,leaf,leaflet,length,long,mm,obovate,occasionally,once-branched,outgrowth,ovary,ovate,pair,pale,parallel,pedicel,peduncle,perennial,petiole,petiolule,pseudostipule,pubescent,red,reflexed,rounded,simple,size,somewhat,sparsely,stellate,stem,stigma,straight,strongly,style,surface,terminal,trichome,tube,usually,variable,yellow	.5,0.2,0.2-0.4,0.2-0.7,0.25-0.4,0.25-0.5,0.3-0.4,0.5-0.7,0.5-0.8,0.5-1,0.5-1.2,0.8,1,1-1.2,1-1.5,1-2,1-2-celled,1-2.3,1-3.5,1.2-3,1.5-2,1.5-5,1.5-8,1/3,2-4,2-8,2-locular,2/3,3-foliate,3/4,4-12,7-30,abaxially,absen,absent,abundant,along,also,anthesi,apical,appearance,appendage,articulation,basal,bent,branch,cell,cente,column,common,conical,cordate,crenate,decreasing,dentate,eaf,ebracteate,edicel,eed,eglandular,elongate,entire,erect,exserted,extended,extending,filament,flower,free,giving,glabrous,glandular,gree,green,hal,head,hybrid,included,initially,internode,lanceolate,larger,largest,later,like,lobe,lon,lower,margin,maturation,mature,minute,minutely,mixture,multicellular,narrowly,nflorescence,northern,oblique,often,part,patent,pedice,peruvian,point,population,portion,primary,procumbent,proximal,pubescence,putatively,rachi,range,rarely,rest,ripe,robust,round-crenate,ruit,scattered,secondary,sessile,several,shaggy,short,silky,slightly,sometimes,species,staminal,sterile,tem,tertiary,testa,theseadpressed,thick,thin,third,tip,toward,truncate,type,ud,unicellular,uniseriate,unit,vein,velvety,viny,wall,way,white,wide,winged,ympodial	0.8-5,arrangement,bark,color,connation,dehiscence,diminishing,foetid,foliage,form,growth,height,history,life,na,papillae,plant,seed,shape,spacing,straightnes,texture,tuber-bearing,ye,young
612	wfo-0001030420	success	170	115	73	97	42	0.429	-2,-30,-4,-9,0.5-1,0.5-4,0.5-8,1,1-,1-2,1-3,1-4,1-7.5,10-,15-25,2-,2-14.5,2-3,2-5,2-6,2-9,3-lobed,4-7,acuminate,apart,apex,articulated,basal,base,beyond,calyx,chartaceous,cm,color,connivent,cordate,diameter,ellipsoidal,elliptic-ovate,elongated,exserted,forked,fruit,lanceolate,leaf,lobe,long,mm,ovate,pedicel,peduncle,petiole,pinnately,purple,rarely,shrub,simple,small,stamen,stellate,stigma,style,subcoriaceous,time,tree,truncate,tube,unbranched,unknown,unlobed,wide,x,yellow	-20,-35,-pubescent,0.5-,1-1.5,1-6,1.5-3,1.5-5,1/2,10-25,3-7,4-foliat,5-,5-15,5-6,6-7,7-19,7-22,7/8,abaxially,absent,acute,adaxially,aggregate,also,ape,axe,blade,cell,connective,cylindrical,dark,deltate,densely,directed,distally,divided,eaf,eed,eglandular,eglandular-pilo,eglandular-puberulent,entire,equal,flower,glabrate,glabrous,glandular-,glandular-puberulent,hair,leaving,lobed,lon,lower,margin,midrib,moderately,narrowly,nearly,nflorescence,nther,obtuse,often,orolla,pedicellar,perfect,pilose,pore,presen,puberulent,puberulent-pubescent,pubescent,pubescent-pilo,pubescent-pilose,rachi,radiu,remnant,ripe,ruit,shorter,sinus,spaced,sparsely,stone,tal,tem,thecae,tip,tomento,triangular,truncat,ud,unit,vary,vein,yello,ympodial	anther,arrangement,articulation,bark,connation,corolla,dehiscence,diminishing,distal,foetid,foliage,form,fruiting,growth,height,history,inflorescence,interjected,lateral,leaflet,length,life,na,ovary,papillae,petiolule,plant,position,prickle,pseudostipule,seed,shape,size,spacing,stem,straightnes,surface,terminal,texture,trichome,tuber-bearing,young
613	wfo-0001030426	invalid_json_followup	158	124	87	71	37	0.551	-30,0.3-7,0.3-8,0.4-0.7,1-4.2,1.5-3,1.7-3.2,10,15-25,2-3,2.5-6,3-6,4-10,9,acute,apex,apical,apically,articulate,base,branched,calyx,cell,cm,connate,corolla,covering,cyme,dehiscent,diameter,dichasial,dichasially,distal,ebracteate,elliptic-lanceolate,forked,generally,glandular,globose,green,green-white,half,heart-shaped,herbaceous,interjected,introrse,lanceolate,lateral,leaf,leaflet,linear,long,maturing,mm,monochasial,oblique,odd-pinnate,often,ovoid,pedicel,peduncle,perennial,petiole,pilose,plant,poricidally,proximal,rounded,seed,short,size,slit,spot,stellate,stigma,straight,style,terminal,testal,thick,throughout,tuber-bearing,wall,white,wide,yellow,¼	1-4,1.5-6.5,2,2.5-4,3-12,3-4,3-6-foliat,4-6.5,6-11.5,6-8,abaxially,absen,acumen,adaxially,apiculate,caudate,decurrent,digestion,diminishing,dorsally,eaf,edge,eed,emoval,enzyme,exceeding,filament,flat,flower,folded,globo,gradually,hair-like,honeycomb,larger,linear-lanceolate,linear-oblong,living,lobe,lon,lower,make,mucilaginous,nflorescence,nther,oblong,obtuse,orolla,pair,pattern,perfect,pinnatifi,plan,rachi,reveal,ruit,second,sessile,seudostipule,specimen,stamen,stripe,tal,tem,toward,typically,unit,vary,whit,without,ympodial	'','hair-like,[,],``,absent,anther,arrangement,bark,characteristic,color,connation,dehiscence,form,fruit,growth,height,history,inflorescence,length,life,na,ovary,papillae,pinnatifid,pseudostipule,shape,spacing,stem,straightnes,surface,texture,tube,value,ye,{,}
614	wfo-0001030430	success	171	104	61	110	43	0.357	.2,0.25,acute,anther,anthesi,apart,apex,base,blue,branched,brown,calyx,capitate,clavate,cm,densely,diameter,erect,flattened,fleshy,fruit,glabrous,globose,green,leaf,long,mm,moderately,multicellular,oblong,occasionally,pale,pedicel,peduncle,pentagonal,perennial,petiole,pitted,poricidal,pubescent,purple,rounded,shallowly,shrub,simple,stigma,straight,style,subglabrous,surface,terminal,time,tip,tube,unifoliate,uniseriate,violet,white,woody,x,yellow	.5,0.3,0.4,0.5,0.5–12,0.6,0.6–0.8,0.6–1.0,0.8–3.0,0.8–5.6,0.9–1.0,0–20,1.0–1.2,1.0–1.5,1.0–2.0,1.2–2.0,1.3–8.0,1.4–1.5,1.5–1.7,1.6–1.8,1.8–5.0,12–20,12–30,1–3,1–9,2.0–3.0,2.0–4.2,2–3,3.0–4.5,30–200,3–17,3–24,3–4,3–5,3–8,5,5.5–12,5–10,5–6,6–10,abaxially,abundant,adaxiall,adaxially,ag,apical,appressed,articulated,axe,axillary,ba,basal,blade,borne,brittle,bud,cell,chartaceous,connivent,convex,cylindrical,decurrent,dentate,diamete,eaf,eed,elliptic,equal,especially,few-seeded,filament,flower,geminat,hair,indumentum,lobe,lobed,lon,longitudinal,lower,m.,margin,nflorescence,opening,orolla,ovate,pair,perfect,pore,present,regularly,ruit,serrate,shaped,shoot,side,slit,spaced,stone,tal,tamen,tear-drop,tem,toward,unit,vary,wide,ympodial,–2.7,–40	0-20,0.5-12,1-3,2-3,3-17,3-5,3-8,30-200,5-10,5-6,arrangement,bark,color,connation,corolla,decurred,dehiscence,diminishing,distal,form,growth,height,history,inflorescence,interjected,lateral,leaflet,length,life,na,ovary,papillae,petiolule,plant,pseudostipule,seed,shape,size,spacing,stem,straightnes,texture,tuber-bearing
615	wfo-0001030441	invalid_json	178	89	60	118	29	0.337	.5,0.5-3,2,2-10,2-5.5,5-7.5,6-11,acuminate,acute,anther,apart,berry,branched,bright,calyx,capitate,cm,corolla,diameter,ellipsoid,elliptic,flattened,globose,green,growth,lateral,lobed,long,many,membranous,mm,narrowly,open,pale,pedicel,peduncle,petiole,plant,poricidal,red,reniform,scandent,shrub,simple,spot,stellate,stem,stigma,style,surface,terminal,time,tip,trailing,usually,vine,violet,white,woody,yellow	+,0.5,0.5-0.75,0.5-1,1,1-1.4,1-1.5,1-2-celled,1.2-1.4,1.5-2,10-40,2-3,2.5,3-4,30,4-5,5-14,5-6,5-7,5-merou,<,>,ag,along,alyx,anthesi,apex,ark,articulated,attenuate,base,brow,c.,cell,closely,decurrent,deltate,distall,eaf,eed,entire,exerted,eye,filament,flexuous,flower,free,fruiting,glabrou,glabrous,glandula,glandular,hair,ilament,impressed,irregularly,juicy,leaving,lengthening,lobe,lon,lower,making,margin,markedly,midvein,minutely,new,nflorescence,occasionally,older,onto,orolla,otherwise,pair,papillat,papillose,peg,per,perfect,pericarp,plurifoliat,pore,portion,primary,pubescent,reflexed,ridged,ripe,ruit,scar,shiny,short,shrubby,slightly,slit,small,somewhat,spaced,spreadin,spreading,strongly,tem,thin,triangular,trichome,tube,ud,undulate,uniseriate,unit,upper,vary,vein,wall,way,wide,ympodial	'','hair,[,],``,arrangement,characteristic,color,dehiscence,form,fruit,height,history,inflorescence,interjected,leaf,leaflet,length,life,na,pseudostipule,seed,shape,size,spacing,texture,value,{,}
616	wfo-0001030444	success	196	92	65	131	27	0.332	0-24,0.15-0.8,0.8-2,1-10,1-4,1-5,11-45,2-8,2.3-3.6,3-10,3-5,4-17,5.3-9,7.1-17.5,anther,berry,blue,clavate,cm,connivent,coriaceous,corolla,deep,diameter,elliptic,forked,fruit,glabrous,green,greenish,herb,interjected,lanceolate,lateral,leaf,leaflet,lilac,linear,medium,mm,moniliform,mucilaginous,odd-pinnate,ovate,ovoid,pedicel,peduncle,pentagonal,petiole,plant,poricidal,purple,rotate,seed,size,stigma,straight,style,terminal,tip,tube,typically,whitish,x,yellow	1,1-2,1.1-2.7,1.2-1.8,2-3,2-6,2.4-3.8,3.7-6.8,4-39,4-7,5-merou,6.1-12.8,9.4-20.1,abaxiall,abaxially,acumen,acuminate,acute,adaxially,ag,along,alyx,apart,apex,apparently,arranged,articulated,asymmetric,attenuate,axe,axillary,base,basiscopic,bead,blade,brownish,bud,capitat,cell,ciliate,condition,covering,dark,decreasing,digestion,distal,dorsally,dot,drying,eaf,edge,eed,enzyme,erec,exceeding,filament,flat,flower,folded,fresh,geminat,general,generally,glabrou,green-white,hair-like,hal,half,high,homostylous,honeycomb-shaped,larger,lengthening,light,like,living,lobe,long,lower,make,margin,multiple,narrow,necklace,nflorescence,orbicular,orolla,pair,perfect,petiolulate,plurifoliate,pore,removed,ripe,rough,rounded,ruit,sessile,seudostipule,shortly,side,slit,sometimes,spaced,specimen,stamen,stolon,subequal,subtending,symmetric,tall,tamen,tem,testal,thick,throughout,tissue,touch,toward,tri-,tuber,unit,unwinged,usually,vary,wall,wet,white,wide,wing,ympodial	arrangement,bark,calyx,capitate,color,connation,dehiscence,erect,form,growth,height,history,inflorescence,length,life,na,ovary,papillae,present,pseudostipule,shape,spacing,stem,straightnes,surface,texture,tuber-bearing
617	wfo-0001030445	success	226	118	83	143	35	0.367	0.2-0.4,0.2-0.5,0.6-2.2,1-7,1.1-4.3,1.3,14,2.1-5.2,4.1-8.7,4.2-10,5.2-7.1,6.1-9.1,7.5-16,8.2-18,abaxially,accrescent,acuminate,adaxially,anther,apart,apex,articulated,bark,base,black,blunt-tipped,branched,brown,calyx,capitate,cm,corolla,decurrent,deltoid-reniform,diameter,drying,elliptic,elliptical,elongated,ferruginous-tomentose,flower,fruit,fruiting,glabrate,globose,green,greyish-tan,high,lateral,leaf,long,many,mm,oblong,oblong-lanceolate,orange,orangish-tan,pedicel,peduncle,petiole,poricidal,pseudoterminal,reniform,reticulate-punctate,shrub,simple,small,stellate,stem,stigma,style,surface,time,tip,tomentose,tree,tube,white,x,yellow,yellowish,yellowish-tan,young	.1,.5,/5-2/3,0.1-0.7,0.2,0.2-0.7,0.3,0.4,0.5,0.6-3.5,0.7,0.8,1,1-1.3,1.3-1.8,1.3-2,1.5-2.1,1.6-2,1.7-2.4,1.8-3.5,10-14,10-16,15-35,2.2-2.9,2.2-3.5,2.4-4.7,3-5.4,3.1-5,3.4-5.6,3.5-4.2,5-125,5-merou,5.9-15,5.9-8.3,8.1-10,abaxial,acute,ag,along,alyx,appressed,around,axillary,berry,blade,blunt-tippe,branch,brownish-yellow,bud,bulbous-based,concentrated,cylindrical,directed,distally,eaf,earl,edge,eed,entire,erect,exserted,ferruginous,ferruginous-granular,filament,free,geminate,glabrescen,glabrous,hair,homostylous,inserted,intermediate,lackin,lengthening,lobe,lobed,lon,longitudinal,lower,m.,main,margin,midrib,midvein,mostly,multangulat,multangulate,nflorescence,obovate,obscured,obtuse,older,open,orbicular,orolla,ovate,ovate-lanceolate,plurifoliate,pore,porrect-stellat,porrect-stellate,pubescence,pubescent,rachi,ray,relatively,resorption,rounded,ruit,runk,semi-spherical,sessile,side,slightly,slit,somewhat,soon,spaced,sparse,sparsely,splitting,stalk,stamen,stout,subcampanulate,sulcate,suture,tamen,thick,thick-textured,thicknes,thin,thin-,tissue,tomentum,unarme,unit,vary,vein,vestigial-rayed,way,wide,ympodial	arrangement,articulation,color,connation,dehiscence,diminishing,distal,foetid,foliage,form,growth,height,history,inflorescence,interjected,leaflet,length,life,na,ovary,papillae,petiolule,plant,position,prickle,pseudostipule,seed,shape,size,spacing,straightnes,terminal,texture,trichome,tuber-bearing
618	wfo-0001030447	success	276	112	78	198	34	0.283	0.5,0.5-0.65,0.5-10,0.7-1,0.8-3.5,1-10,1-6,2-4,3,3-4.5,3-5,7-8,accrescent,anther,apex,articulated,bark,base,berry,calyx,cell,clavate,cm,corolla,cuneate,diameter,drying,finely,flattened-reniform,fruit,fruiting,globose,lateral,leaf,length,less,lobed,maturity,midpoint,midvein,mm,moderately,orange,orange-brown,orange-red,outline,ovate,pedicel,peduncle,petiole,pit,poricidal,prickle,purple,raised,red-brown,ridged,rounded,shrub,simple,small,smooth,sometimes,sparsely,stellate,stellate-pubescent,stem,stigma,style,surface,tapering,terminal,tip,trichome,tube,unbranched,white,yellow	.2,.3,.5,/5,0,0.1,0.1-0.3,0.15-0.3,0.2,0.2-0.4,0.4-0.7,0.4-0.9,0.5-3,0.8-1.7,1,1-1.5,1-2,1-2.5,1-3,1-5,1.5,1.5-2.5,1.5-7,1.8-2.5,1/3,1/3-1/2,1/3-2/3,1/4-1/3,2.2-2.8,2.5-10,2.5-6.5,30-45°,4-8,5,5-15,5-merou,6,6-10,6-16,6-7,6-8,6-9,6.5-9,8,abaxially,acute,adaxially,age,always,alyx,apar,apart,apical,apically,apparently,armed,axe,beyond,blade,branche,broad-deltate,c.,characteristically,chartaceous,covering,cupular,curved,dark,deltate,densely,development,difoliate,discolorous,distance,divided,eaf,eed,elongating,equal,erect,exserted,extending,filament,filiform,fine,finger-hair,flat,flattened,flower,free,geminat,gently,glabrescent,glabrous,herbaceous,infructescence,irregula,irregular,lengthening,lobe,long,long-ovoi,long-styled,longer,longitudinal,lower,margin,mature,minute,mostly,narrow-deltate,nflorescence,obconical,oblique,oblong,obtuse,often,older,one,open,opening,orange-translucent,orolla,oung,pair,pale,papillo,pendulous,per,perfect,pericarp,persisting,point,pore,porrect,portion,primary,pronounced,prostrate,pubescent,rachi,ray,reduced,rest,ri,ridge,ruit,scar,sessile,shallow,shallowly,shiny,short-styled,shorter,shortly,side,sinus,slender,slit,somewhat,spaced,sparse,spherical,spreading,stalk,stalked,stout,straight,straw-yellow,stump,subsessile,tamen,terete,tertiary,thick,thin,throughout,time,toward,translucent,ud,unarmed,unequal,unit,usually,variously,vary,vein,venation,visible,weakly,wide,widest,woody,x,yellow-orange,ympodial,×	arrangement,articulation,color,connation,dehiscence,diminishing,distal,foetid,foliage,form,growth,height,history,inflorescence,interjected,leaflet,life,na,ovary,papillae,papillose,perennial,petiolule,plant,position,pseudostipule,seed,shape,size,spacing,straightnes,texture,tuber-bearing,young
619	wfo-0001030452	success	199	105	58	141	47	0.291	80,accrescent,acuminate,acute,anther,apex,attenuate,base,black,broadly,calyx,cm,cordate,diameter,dull,flattened,flower,free,fruit,fruiting,glandular-puberulent,globose,immature,leaf,long,mature,mm,nearly,opposite,orbicular,ovate,pedicel,petiole,prickle,reddish,sessile,shape,shrub,simple,size,slightly,smooth,somewhat,stellate,stem,stigma,strongly,style,subopposite,surface,thin-textured,tip,truncate,tube,white,x,yellow,yellowish	.5–4.5,.6,0.1–0.4,0.2–0.3,0.4,0.6,0.7,0.8,1.2,1.2–1.6,1.5–3,100,10–15,1–1.3,1–2,1–3-celled,1–4,2,2.5–3,2.5–4,2.5–6,20–30,2–2.5,2–4,2–5.5,2–foliate,3,3.7–5.2,4,4–5-rayed,5,5–6,5–7,6–12,8–11,911,abaxially,absent,adaxially,also,apparently,appressed,axe,blade,broad,canthophora,capitat,central,collected,contiguou,counted,curved,cylindrical,deflexed,dense,developing,directed,distall,drying,eaf,eed,eglandular,enlarged,enlarging,f,filament,fully,geminat,glabrou,glabrous,gland-tipped,gland–tipped,gradually,hair,half,herter,hig,hyaline,imple,initially,internode,larger,less,lobe,lon,longer,lower,major,margin,matur,maturity,minutely,moderately,narrowly,nflorescence,numerous,often,one,orolla,per,pilose,pore,probably,proximal,pubescence,pubescent,rachi,ray,reflexed,ruit,sec,short,similar,sinuate,small,sof,sometimes,sparse,sprawling,spreading,ste,stellae,straight,sulcate,tamen,tem,terete,thin–textured,toward,triangular,ultimately,uniform,unit,usual,various,vary,vein,wide,wing,ympodial,–9	-9,0.2-0.3,1-4,1.5-3,10-15,2-4,20-30,5-7,arrangement,articulation,bark,capitate,color,connation,corolla,dehiscence,diminishing,distal,foetid,foliage,form,growth,height,history,inflorescence,interjected,lateral,leaflet,length,life,na,ovary,papillae,peduncle,perennial,petiolule,plant,position,pseudostipule,seed,spacing,straightnes,terminal,texture,trichome,tuber-bearing,young
620	wfo-0001030453	success	127	88	53	74	35	0.417	1-1.3,1-1.5,1.5-1.6,1.5-2.5,abaxially,acuminate,acute,adaxially,anther,apex,arachnoid,arachnoid-pubescent,attenuate,bark,base,broadly,calyx,clavate,closely,cm,corolla,cup-shaped,dark,elliptic,flat,glabrous,lateral,leaf,minutely,mm,narrowly,nearly,ovary,papillose,pedicel,petiole,poricidal,shaped,shiny,shrub,simple,spaced,stem,stigma,straight,style,surface,tear-drop,tip,trichome,tube,white,young	.25,.5,/4,0.25-0.5,0.8-1.5,3-3.5,4-5,9-12,9-14,along,anthesi,axi,deflexed,delicate,deltate,dendritic,densely,dia,divided,eaf,edicel,eed,ellipsoid,especially,exserted,filament,fine,floccose,free,glabrate,know,known,later,less,lobe,lon,long,lower,main,margin,middle,midrib,minute,near,nflorescence,occasionally,older,opposite,overlappin,pair,papillat,planar,pore,portion,pubescent,reddish,reddish-brow,rounded,ruit,scar,slender,soon,sparsely,strongly,tall,tub,ud,unifoliat,unit,vein,way,wide,widest,ympodial	arrangement,color,connation,dehiscence,diameter,diminishing,distal,form,fruit,growth,height,history,inflorescence,interjected,leaflet,length,life,midpoint,na,overlapping,papillae,peduncle,petiolule,plant,pseudostipule,reddish-brown,seed,shape,size,spacing,straightnes,terminal,texture,tuber-bearing,unifoliate
621	wfo-0001030486	success	141	104	66	75	38	0.468	1-1.5,1-5,1.1-1.4,1.5-2,2-3,6-7,acute,anther,apex,bark,base,brown,calyx,clavate,closely,cm,completely,corolla,dark,deflexed,distal,dry,elliptic,erect,fresh,fruiting,glabrous,globose,green,internodal,lateral,leaf,lobed,material,minutely,mm,opposite,ovary,overlapping,ovoid-reniform,pale,papillose,pedicel,petiole,pitted,poricidal,shaped,shrub,simple,size,slightly,small,spaced,stem,stigma,stout,style,surface,tan,tear-drop,tip,treelet,tube,white,yellow-green,young	.5,0.8-2.2,1.7-2,1/2,1/4,10-12,10-14.5,2-5.5,3-3.5,3-5,3/4,4-4.5,4-6.5,4.5-5,5-8-flowered,abaxially,adaxially,anthesi,ba,basal,beneath,berry,clustered,conical,deltate,dia,differing,difoliate,drying,eaf,edicel,eed,ellipsoid,exserted,f,filament,fleshy,free,geminat,inflorescenc,later,lobe,lon,long,lower,m.,main,major,margin,middle,minor,nflorescence,older,pair,papillo,planar,pore,portion,reddish,ruit,scar,shin,tall,tapering,thickened,tub,ud,unit,usually,vein,way,widest,woody,x,ympodial	alternate,arrangement,articulation,color,connation,dehiscence,diameter,diminishing,foetid,foliage,form,fruit,growth,height,history,inflorescence,interjected,leaflet,length,life,midpoint,na,papillae,peduncle,petiolule,plant,position,prickle,pseudostipule,seed,shape,shiny,spacing,straightnes,terminal,texture,trichome,tuber-bearing
622	wfo-0001030489	success	196	125	84	112	41	0.429	0.5-3,1-3,3-8,4-8,5,7-15,abaxially,abruptly,adaxially,anther,apart,apex,apical-lateral,appressed-pubescent,articulated,attenuate,axillary,bark,base,becoming,berry,blunt-tipped,broadly,brown,calyx,chartaceous,cinereous,cm,continued,corolla,deltoid,diameter,due,elliptic,fleshy,fruit,glabrate,greenish,growth,high,honeycombed,introrse,large,lateral,leaf,length,long-acuminate,longitudinal,minutely,mm,narrowly,oblong,obtuse,ovate-lanceolate,pedicel,peduncle,petiole,plurifoliate,pore,probably,reniform,reticulate-punctate,ripe,short,shrub,simple,slit,small,smooth,somewhat,stellate-rotate,stem,stigma,style,subglobose,suborbicular,tree,tube,turn,unarmed,white,yellow,yellowish,young	-6.5,.5-2.8,.5-3,.75-5.25,0.25-0.4,0.6-0.9,0.75-0.9,0.9-1.1,1-1.3,1-3.75,1.1-1.3,1.2-1.5,1.2-1.6,1.6-2.1,1.7-2,1.75-2,1.9-2.6,1/3-1/2,1/5-1/2,100,12-24,2.1-2.9,3-6,4.5-9,5-6,6-8,absen,acuminate,acute,adaxiall,ag,anthesi,apparently,appressed,axe,ba,blade,branch,branched,bud,closely,conical,cylindrical,dehiscing,densely,dichotomously,eaf,echinoi,echinoid,eed,elongate,entire,filament,flower,free,glabrous,globose,hair,inserted,lobe,lobed,long,long-exserted,lower,main,margin,midvein,minute,mostly,multangulate,nflorescence,older,orolla,ovate,pale,perfect,porrect-stellate,pseudo-terminal,puberulent,pubescent,pulverulen,pulverulent,rachi,ruit,runk,sessile,several,short-stalked,side,slender,spaced,sparingly,sparse,stellate-pubescent,subcampanulate,subcapitat,tamen,terete,testa,thick,time,tomentose,toward,unarme,unit,usually,vary,vein,way,wide,x,ympodial	2.5-2.8,5-6.5,absent,age,arrangement,articulation,color,connation,dehiscence,diminishing,distal,foetid,foliage,form,fruiting,height,history,inflorescence,interjected,leaflet,life,na,ovary,papillae,petiolule,plant,position,prickle,pseudostipule,pseudoterminally,seed,shape,size,spacing,straightnes,subcapitate,surface,terminal,texture,trichome,tuber-bearing
623	wfo-0001030492	success	221	104	70	151	34	0.317	0.1-0.5,0.5-1,1-1.5,1.5-6,2-4,2-5,3-10,3-8,4-8,9-11,?,accrescent,anther,apex,articulated,base,branched,brown,calyx,chartaceous,cm,connivent,diameter,elliptic,extra-axillary,flattened,forked,fruit,fruiting,fully,globose,green,lateral,leaf,light,long,midpoint,minutely,mm,ovate,pedicel,peduncle,perhaps,petiole,pitted,plant,prickle,ripe,shape,short,shrub,simple,size,slightly,small,stellate,stem,stigma,straight,style,subcordate,surface,tapered,tree,truncate,tube,unbranched,white,yellow,yellowish	-2,.1,.5,0.1-1,0.25-0.5,0.3-0.5,1,1-8,1.5,1.5-2,10,10-35+,10-50+,12-25,15-20,2,2-2.5,2-3,25-50+,3-5,3-7,30-40+,4,4-6,4-7,5-30+,5-6,5-7,7-18,abaxially,acute,adaxiall,adaxially,also,apart,apparently,armed,axe,ba,blade,broad-based,capitat,caudate-acuminate,coarse,coarsely,covering,cylindrical,deeply,densely,difoliate,directed,distall,divided,eaf,eed,eglandular,emerging,entire,erect,female-sterile,ferruginous,ferruginous-pubescent,filament,first,flower,frui,geminat,glabrous,gland,glandular,glandular-puberulent,hair,halfway,held,interpetalar,juvenile,lanceolate,larger,later,less,like,lobe,lobed,lon,longer,lower,lowering,major,margin,maturity,midrib,midvein,moderately,mostly,much,narrow,near,nearly,nflorescence,oblique,occasionally,often,orolla,pair,part,perfect,pinnatifid,pore,pubescent,rachi,ray,rectangular,recurved,ruit,rusty,scattered,sessile,short-stalked,shorter,similar,sinus,sometimes,somewhat,spaced,sparse,sparsely,splitting,sprout,stalk,ste,stellae,stellate-pubescent,tal,tamen,time,tip,tissue,toothed,unarmed,uniform,unit,upper,uprigh,vary,vein,wide,woody,x,ympodial,younger,youngest	arrangement,articulation,bark,capitate,color,connation,corolla,dehiscence,diminishing,distal,foetid,foliage,form,growth,height,history,inflorescence,interjected,leaflet,length,life,na,ovary,papillae,position,pseudostipule,seed,spacing,straightnes,terminal,texture,trichome,tuber-bearing,young
624	wfo-0001030509	success	220	100	68	152	32	0.309	0-15,0-5,0.3-2.5,0.8-1.2,1-1.5,1-2,1-6,2-4.5,8-16,anther,apart,apex,articulated,bark,base,calyx,cm,connivent,cordate,cuneate,curved,densely,diameter,distal,erect,flattened-reniform,fruit,fruiting,glabrescent,gray,herb,lateral,leaf,length,lobed,mauve,midpoint,mm,orange,orange-brown,ovate,pale,pedicel,peduncle,petiole,plant,poricidal,porrect,prickle,purple,rounded,shrub,simple,sometimes,spherical,stellate-pubescent,stem,style,subsessile,surface,tapering,terminal,tip,trichome,tube,unbranched,yellow,young	-10,-2,-6,/3,0,0-0.3,0-100,0-3,0.1,0.1-0.2,0.1-0.25,0.1-0.3,0.2,0.5-1.5,0.6-1,0.8-4,1,1-3,1-4,1.3-2,1.5-2,1.7-2,1/,1/3-2/3,1/4,2-2.5,2-3,2-4.2,2-6,2.8-3,2/3-3/4,3-10,3-4,4.5-10,4.5-12,4.5-8,5-10,5-merous,7-15,7-9,abaxially,alyx,andromonoecious,apar,apical,apically,apparently,becoming,berry,blade,broad-deltate,brow,chartaceous,cream,dark,difoliate,discolorous,distance,drying,eaf,eed,elongating,entire,equal,extending,eye,filament,flower,free,geminat,glabrous,gland,globular,green,half,herbaceous,hermaphrodite,heterostylous,inflated,infructescence,lobe,long,long-acuminat,long-styled,longer,lower,lowermost,margin,marking,mature,maturity,midvein,moderately,naked,narrow-deltate,narrow-oblong,nflorescence,obtuse,occasional,occasionally,often,older,one,open,orolla,oung,pair,pendulous,per,pericarp,perpendicular,portion,prickly,primary,ray,reduced,ruit,scar,short-styled,shorte,shorter,side,slender,smooth,spaced,sparsely,spreading,stalk,stalked,staminat,stellate,straight,tamen,terete,tertiary,time,unarme,unarmed,unit,upper,usually,variously,vary,vein,venation,visible,way,weakly,wide,woody,yellow-green,ympodial	arrangement,articulation,brown,color,connation,corolla,dehiscence,diminishing,foetid,foliage,form,growth,height,history,inflorescence,interjected,leaflet,life,na,ovary,papillae,petiolule,position,pseudostipule,seed,shape,size,spacing,stigma,straightnes,texture,tuber-bearing
625	wfo-0001030511	success	166	116	89	77	27	0.536	.5,0.1-0.15,0.4-0.5,0.5,0.5-1,1,4-7,4-8,abaxially,absent,acicular,adaxially,almost,anther,apex,articulated,attenuate,bark,base,berry,bright,calyx,cell,closely,cm,corolla,deeply,diameter,entire,especially,flattened,fruiting,glabrous,globose,growth,inflorescence,internodal,lanceolate,leaf,lengthening,like,linear,lobed,long,margin,midvein,minute,minutely,mm,nearly,ovary,pale,pedicel,peduncle,petiole,pitted,plant,poricidal,porrect,prickle,pubescent,ray,red,reniform,ripe,rounded,sessile,shiny,shrub,simple,sinuate,spaced,sparsely,stellate,stem,stigma,style,surface,tan,tapering,testal,thin,tip,trichome,tube,violet,white,yellow,yellowish	-6,0.1,0.5-0.6,0.8-1,1-2,1.5,1.5-4,4-merous,5-7,5-9,6-8,?,along,also,anthesi,arising,barely,brow,conical,curved,deltate,densely,difoliate,eaf,eed,either,ellipsoid,erect,exserted,filament,filiform,flower,free,geminat,leave,less,lobe,lower,membranous,midpoint,midrib,new,nflorescence,noddin,nodding,older,overlappin,pair,papillo,per,perfect,pericarp,planar,pore,portion,prickly,primary,rarely,rest,ruit,scar,short-stalked,sometimes,strongly,tall,toward,triangular,ud,unit,upper,vein,visible,woody,x,ympodial,½,¾	arrangement,articulation,brown,color,connation,dehiscence,foetid,foliage,form,fruit,height,history,length,life,na,overlapping,papillae,papillose,perennial,position,present,seed,shape,spacing,straightnes,texture,young
626	wfo-0001030516	success	172	133	93	79	40	0.541	0.4-1.5,1-7,2-12,2-3,3-8,4-22,4-7,4.2-10.7,8-9,acuminate,acute,apex,apical,apically,articulate,base,branched,calyx,cell,cm,connate,cordate,corolla,covering,cuneate,cyme,darker,dehiscent,diameter,dichasial,dichasially,diminished,distal,ebracteate,elliptical,forked,generally,globose,gradually,green,green-white,hair-like,half,herbaceous,interjected,introrse,lateral,leaf,leaflet,light,make,maturing,mm,monochasial,mucilaginous,oblique,odd-pinnate,often,outline,ovate,ovoid,pedicel,peduncle,pentagonal,perennial,petiole,pilose,plant,poricidally,proximal,puberulent,pubescent,rotate,seed,short,size,slightly,slit,sometimes,stigma,straight,stripe,style,terminal,testal,thick,throughout,toward,triangular,tuber-bearing,wall,yellow,¼	1-2.5,1-4,1.1-3.5,1.1-4.1,1.5-2,1.7,1.8-2.4,2-2.,2-4,3-6,3-6-foliat,3-9.8,4-4,4-6,6-15,9-22,9-32,abaxially,acumen,adaxially,covered,decurrent,densely,digestion,dorsally,eaf,edge,eed,emoval,enzyme,exceeding,filament,first,flat,flower,folded,gland,globo,hair,honeycomb,less,living,lobe,lon,long,long-attenuate,longer,lower,lunat,nflorescence,nther,orolla,pair,pattern,perfect,plan,rarely,reveal,ruit,second,sessile,seudostipule,short-petiolate,short-stalked,specimen,spreading,stamen,tal,tem,time,triangulat,type,typically,unit,vary,whit,wide,ympodial,’	2-21,anther,arrangement,articulation,bark,color,connation,dehiscence,diminishing,foetid,foliage,form,fruit,fruiting,growth,height,history,inflorescence,length,life,lunate,na,ovary,papillae,petiolule,position,prickle,pseudostipule,shape,spacing,stem,straightnes,surface,texture,trichome,tube,wet,white,ye,young
627	wfo-0001030522	success	192	112	79	113	33	0.411	-4,-8,/4,0.3-0.7,0.5,0.5-0.6,0.7,1-1.5,1.5,1.7-3,2-lobed,2.5-6,3-5,4,acute,anther,apart,apex,articulated,bark,base,berry,brown,calyx,cm,cordate,corolla,dark,densely,diameter,difoliate,directed,ellipsoid,elliptic,flattened,fruit,fruiting,globose,green,growth,inflorescence,internodal,leaf,lobed,long,membranous,midpoint,minutely,mm,obtuse,orange,ovary,ovate,pedicel,petiole,pitted,plant,poricidal,prickle,pubescent,reddish,reniform,ripening,shrub,small,stellate,stem,stigma,style,surface,tip,treelet,trichome,tube,unit,upwardly,way,white,x	.2,.5,.7,0,0.05-0.15,0.3-0.4,0.5-1,0.9-1.3,1,1-1.4,1-5-2,2,2.5-2.8,20-30,3,3-4,3-4.5,4-10,4-9,5-10,6-7,7-10,abaxially,absent,adaxially,almost,also,anthesi,armed,ba,bearing,broad-based,brow,cell,completely,conical,consisting,cup-shaped,darker,dense,diamete,dioecious,eaf,eed,entire,erect,female,filament,fleshy,flower,free,geminat,glabrous,impressed,included,irregularly,juvenile,lamina,le,less,like,lobe,lon,lower,male,margin,mature,minute,mixture,new,nflorescence,notably,oblique,obscured,occasionally,often,orbicular,pair,per,pericarp,pistillate,planar,pollen-bearing,pore,porrect,portion,primary,pubescence,ray,rounded,ruit,scar,sessile,shallowly,short-stalked,single,somewhat,sparsely,sparser,staminate,straight,testal,thin,toward,ud,unarmed,unisexual,upper,usually,vein,vestigial,woody,ynpodial	arrangement,articulation,color,connation,dehiscence,diminishing,distal,foetid,foliage,form,height,history,interjected,lateral,leaflet,length,life,na,papillae,peduncle,petiolule,position,pseudostipule,seed,shape,size,spacing,straightnes,synpodial,terminal,texture,tuber-bearing,young
628	wfo-0001030551	success	167	104	60	107	44	0.359	-12,0-2,0.5-1,1-2,1-3.5,1-4,1-5,10-20,2-6,3-,3-12,3-5,4-,4-7,5-6,acuminate,acute,apart,apex,articulated,basal,base,blue,calyx,campanulate,chartaceous,cm,color,concave,cordate,diameter,fading,fruit,globose,lanceolate,leaving,lobe,long,mm,oblong-fusiform,ovate,ovate-elliptic,pedicel,pedicellar,peduncle,petiole,remnant,shrub,simple,stellate,stigma,style,subcoriaceous,truncate,tube,unbranched,unknown,violet,x,yellowish	-30,-5,0.6-1.5,1,1-,1-10,1-2.5,1.5-,1.5-2.5,10-40,13.,2,2-3,2.5-4,2.5-5,20-25,3-8,4-5,4-foliat,5-17,9-20,abaxially,abruptly,absent,adaxially,adpressed,aggregate,also,ape,axe,beyond,bilobe,blade,broad,cell,clavate,connective,densely,dia,dilated,directed,distally,eaf,ed,ellipsoidal,entire,equal,et,exceeding,exserted,fleshy,flower,glabrous,glandular-puberulent,hair,laterally,lon,lower,margin,martinelli,moderately,narrow,narrowed,narrowly,nflorescence,nther,obtuse,often,orolla,ovoid,papillose,perfect,pilose,pore,puberulen,puberulent,puberulent-pubescent,pubescent-pilo,pubescent-pilose,rachi,radiu,ripe,round,ruit,seen,shorter,slightly,small,spaced,sparsely,stamen,stone,tal,tem,thecae,time,tip,tomento,triangular,triangular-elliptic,ud,unit,unknow,vary,wide,widening,ympodial	anther,arrangement,articulation,bark,bilobed,connation,corolla,dehiscence,diminishing,distal,foetid,foliage,form,fruiting,growth,height,history,inflorescence,interjected,lateral,leaf,leaflet,length,life,na,ovary,papillae,petiolule,plant,position,prickle,pseudostipule,seed,shape,size,spacing,stem,straightnes,surface,terminal,texture,trichome,tuber-bearing,young
629	wfo-0001030570	success	173	113	71	102	42	0.41	0.3-0.5,1-3,1-4,1-5,1-8,1.5,10-25,2-7-lobed,2-8,3-10,3-6,4-5,abaxially,acuminate,acute,adaxially,apart,apex,articulated,basal,base,calyx,campanulate,cm,color,connivent,cordate,diameter,ellipsoidal,flattened,forked,fruit,glabrous,glandular-puberulent,globose,green,lanceolate,leaf,lobe,long,mm,near,occasionally,pedicel,peduncle,petiole,pilose,pinnately,pubescent,purplish,rarely,rounded,rugose,simple,small,sparsely,stellate,stigma,style,subcoriaceous,submarginally,tree,truncate,tube,unbranched,unknown,unlobed,vein,white,x,yellow	-1,.3-0.5,0-,0.5-,0.5-1,1,1-,1-1.5,1-2,1.5-2.5,1/2,10-17,15-20,15-35,2-2.5,2-3,2-4,2-5,2-7,2.5-22,20-30,3-5,3.5-5,4-25,4-7,4-foliat,4/5,5-,8-,absent,aggregate,ape,apiculate,axe,beyond,blade,cell,connective,cylindrical,dilated,directed,distally,divided,eaf,eed,eglandular,elliptic-oblong,entire,exceeding,exserted,fleshy,flower,glabrat,hair,leaving,lobed,lon,lower,margin,midrib,narrowly,nflorescence,nther,obtuse,often,orolla,ovate,ovoid,pedicellar,perfect,pilo,pore,presen,punctate,purpl,rachi,radiu,remnant,ripe,ruit,shorter,sinus,slightly,sometimes,somewhat,spaced,stamen,stone,tal,tem,thecae,time,tip,tomento,triangular,truncat,ud,unequal,unit,vary,wide,ympodial	anther,arrangement,articulation,bark,connation,corolla,dehiscence,diminishing,distal,foetid,foliage,form,fruiting,growth,height,history,inflorescence,interjected,lateral,leaflet,length,life,na,ovary,papillae,petiolule,plant,position,prickle,pseudostipule,seed,shape,size,spacing,stem,straightnes,surface,terminal,texture,trichome,tuber-bearing,young
630	wfo-0001030580	success	230	90	46	184	44	0.2	2,anther,apex,area,articulate,attenuate,base,black,brown,calyx,central,chartaceous,cm,connivent,corolla,diameter,distal,elliptic,flattened-orbicular,flattened-reniform,fruit,globose,lateral,leaf,margin,mm,nearly,ovate,pedicel,petiole,pitted,sessile,shrub,simple,smooth,stellate,stem,stigma,straight,style,surface,tube,unarmed,white,yellow,young	.0,.0–6.2,.2,.3,.5,.7,/2,/3,0.2–0.3,0.3–0.4,0.3–0.7,0.4–0.5,0.4–0.7,0.6–1.1,0.6–2.1,0.7–0.8,0.9–1.2,1.2–1.5,1.3–1.5,1.3–3.0,1.5–,1.5–2.0,1.5–4.0,1.5–9.0,1.6–1.8,1.6–2.5,1.7–1.8,1/3,1–2,2.0–2.2,2.0–3.1,2.3–5.5,3,3.7–5.4,3–5,4–6,4–8,5-merou,5–5.4,6–8,8.3–10.0,abaxially,acute,adaxially,adnate,ag,along,alyx,anthesi,apical,apparently,appearing,appresse,arching,around,attachment,ba,becoming,berry,blade,broad,brochidodromous,bud,capitat,caudate,channeled,curved,deltoid,densely,dentate,developed,difoliate,directed,distally,distinct,dramatically,dry,eaf,edge,eed,either,emerging,endocarp,entire,erect,exocarp,extending,extra-axillary,ferruginous,fertile,filament,filiform,flat,flexed,flower,free,geminat,glabrescent,glabrous,glossy,gradually,hair,homostylous,increasing,indistinct,inter-sepalar,internode,interpetalar,intersepalar,juic,laying,lobe,lon,long,longer,lower,mainly,many,mature,middle,midpoint,midrib,midvein,minute,moderately,much,nflorescence,notched,oblong,orolla,per,perforate,persistent,point,pore,porrect,portion,potentially,probably,pubescent,raised,ray,rounded,ruit,scattered,sepal,side,sinus,slightly,smoot,sometimes,sparsely,splitting,spread,stamen,stellae,stellate-pubescent,strongly,suture,tamen,tardily,tem,thin,though,time,tip,tissue,toward,translucent,truncate,typically,ud,unit,vary,vein,weakly,well,wide,ympodial,±90°,±aequilateral,×,–2.5,–8	0.3,1.5-2.0,1.5-9.0,1.6-1.8,2.3-5.5,7.0,arrangement,articulation,bark,capitate,color,connation,dehiscence,diminishing,foetid,foliage,form,fruiting,growth,height,history,inflorescence,interjected,leaflet,length,life,na,ovary,papillae,peduncle,petiolule,plant,position,prickle,pseudostipule,seed,shape,size,spacing,straightnes,terminal,texture,trichome,tuber-bearing
631	wfo-0001030581	success	187	101	61	126	40	0.326	1-4-celled,acute,anther,apex,appressed,articulated,base,berry,black,calyx,capitate,central,cm,corolla,decurrent,diameter,ellipsoid,elliptic,flattened-reniform,fruit,fruiting,globose,green,growth,herb,inflorescence,intermodal,lateral,leaf,maturity,minutely,mm,near,once-branched,ovary,ovate,pedicel,peduncle,petiole,pitted,plant,portion,pubescent,purplish,ripe,simple,sparsely,spreading,stellate,stem,stigma,style,surface,trichome,tube,turning,uniseriate,white,woody,yellow,yellowish	.3,.5,0.2–0.8,0.4–0.6,0.4–1.6,0.5,0.5–0.7,0.5–2.5,0.6–0.7,0.7–0.8,0.9–1,1,1.2–1.5,1.8–8,1–2,1–2-celled,1–2.5,1–4-celled,2,20–50,2–3-celled,35–45,3–4,3–5,4.5–12,4–7,4–9,5-merous,5–6,5–8,9,abaxial,abaxially,adaxial,adaxially,aggregate,along,angle,angled,anthesi,apar,basal,becoming,beyond,branched,bright,cell,clustered,cone,conical,densely,denser,difoliate,drop,eaf,eed,entire,exserted,filament,florescence,flower,free,geminat,glabrous,halfway,individual,lacking,later,leave,less,like,live,lobe,lobed,lon,long,lower,margin,markedly,minute,narrowly,new,occasionally,often,outline,pair,papillate,pentagonal,per,perfect,primary,rachi,reflexe,reflexed,remaining,ridge,rounded,ruit,scar,shallow,shiny,shorter,slightly,somewhat,spaced,sprawlin,stone,straight,strongly,tall,tangled,tem,terete,testal,third,translucent,ud,unit,upper,usually,vein,wide,winged,ympodial,–15,–5	0.4-1.6,0.5-2.5,0.6-0.7,1-2.5,20-50,3-4,5,apart,arrangement,articulation,bark,color,connation,dehiscence,diminishing,distal,foetid,foliage,form,height,history,interjected,leaflet,length,life,na,papillae,petiolule,position,prickle,pseudostipule,seed,shape,size,spacing,straightnes,terminal,texture,tuber-bearing,young
632	wfo-0001030582	success	190	85	44	146	41	0.232	0.1,acute,anther,apex,attenuate,base,blue,brown,cm,cordate,diameter,flattened-reniform,free,fruit,globose,internode,lateral,leaf,light,linear-attenuate,midpoint,minutely,mm,moderately,orange,ovate-lanceolate,pedicel,peduncle,petiole,pitted,red,rounded,short,shrub,simple,stellate-pentagonal,stem,stigma,style,surface,terminal,tomentose,tube,yellow	.1,.5,0,0.2,0.4,0.4–0.5,0.4–1,0.6,0.8–1,1.4–2,1.5,1.5–3,10,10–12,12,1–1.5,2.5–3,2–10-branched,2–2.5,2–4.5,3.5–9.5,3–3.2,3–3.5,3–5,4–4.5,4–9-rayed,5,5-merou,5–8,6–8-rayed,7–11,7–20,abaxially,adaxiall,adaxially,age,alyx,apart,apparently,articulated,axe,ba,becoming,blade,branch,branched,broad,c.,capitat,caudate,closely,dark,densely,dichotomously,directed,distall,eaf,eed,ellipsoid,entire,evenly,except,extra-axillary,filament,filiform,finely,flower,geminat,glabrescent,glabrous,gland-tipped,hair,homostylous,initially,interpetalar,larger,later,lea,less,lighter-colored,like,lobe,lon,long,lower,margin,maturit,midzone,minute,narrowly,nearly,nflorescence,numerous,obscurely,often,orolla,overtopped,ovoid,part,per,perfect,plurifoliate,pore,principal,probably,ripe,ruit,sessile,shiny,short-stipitate,side,sinuate,sinus,slender,somewhat,soon,spaced,sparsely,splitting,stellae,stellate-tomento,stellate-tomentose,stipe,tall,taller,tamen,tardily,tem,thick-chartaceous,tip,tissue,triangular,truncate,ud,ultimate,unarme,unarmed,underside,vary,vein,visible,well-developed,wide,ympodia,young,×	0.4-1,1.4-2,1.5-3,10-12,2-2.5,2-4.5,3-3.5,3-5,7-11,arrangement,bark,calyx,capitate,color,connation,corolla,dehiscence,diminishing,distal,form,growth,height,history,inflorescence,interjected,leaflet,length,life,na,ovary,papillae,plant,pseudostipule,seed,shape,size,spacing,straightnes,texture,tuber-bearing,width
633	wfo-0001030583	success	166	128	94	72	34	0.566	.5,0.1-0.5,0.2-1,0.3-1,0.4-2.7,0.7-4.5,0.9-3.5,1,1-2,1/2,2.5-9,3/4,5-6,abaxially,acute,adaxially,along,anther,apex,bark,base,berry,calyx,closely,cm,corolla,cultivated,dark,deep,dendritic,densely,dia,elliptic,enlarged,especially,flattened-reniform,form,fruit,fruiting,glabrous,globose,golden,green,immature,incrassate,lateral,leaf,live,lobed,long,margin,midvein,minutely,mm,narrowly,occasionally,opposite,orange-red,ovary,overlapping,pale,papillose,pedicel,petiole,pitted,plant,poricidal,prostrate,pubescent,ripe,rounded,shaped,shrub,simple,size,small,small-capitate,spaced,stem,stigma,style,surface,tall,tan,tear-drop,tip,trichome,tube,uniseriate,way,white,x,yellow,young	.2,0.5-1,0.8-1,1-1.5,1-8,1.5-4,2.5,2.5-3,3-4,4-6,5-7,6-7,abaxial,anthesi,ba,brow,cell,conical,corky,crisped,cultivar,deflexed,differing,difoliate,dry,eaf,edicel,eed,ellipsoid,erect,filament,flower,free,frui,geminat,included,irregular,leave,like,lobe,lon,long-rectangular,long-triangular,lower,main,major,minor,nflorescence,often,older,outline,pair,papery,papillo,pericarp,planar,pore,portion,rest,ruit,scar,soon,spathulate,specimen,stout,testal,thin,ud,unit,vein,woody,ympodial	arrangement,articulation,brown,color,connation,dehiscence,diameter,diminishing,distal,foetid,foliage,growth,height,history,inflorescence,interjected,leaflet,length,life,midpoint,na,papillae,peduncle,petiolule,position,prickle,pseudostipule,seed,shape,spacing,straightnes,terminal,texture,tuber-bearing
634	wfo-0001030605	success	144	104	64	80	40	0.444	.4,0.3-0.5,1-4,1.7,2,7,acute,anther,apart,apex,area,attenuate,base,branched,brown,calyx,cm,coriaceous,corolla,dendritic-echinoid,difoliate,fruiting,globose,green,growth,inflorescence,internodal,leaf,lobed,long,minutely,mm,nearly,obovate,obtuse,occasionally,opposite,ovary,overlapping,ovoid-reniform,pedicel,peduncle,petiole,pitted,poricidal,rarely,rounded,shaped,shiny,shrub,simple,slightly,smooth,stigma,style,surface,tear-drop,thickened,tip,trichome,tube,unifoliate,way,white	.5,0.1,1,1.5-2,1.5-5.5,1/3-1/2,12-19-flowered,2-3,2.5,5-12.5,abaxially,adaxially,almost,along,anthesi,ape,apical,beginning,beneath,berry,branch,cinereous,commonly,conical,covered,cylindrical,dark,deflexed,densely,dia,dry,drying,eaf,edicel,eed,ellipsoid,entire,exerted,filament,free,geminat,glabrate,glabrous,gold,inflorescenc,less,light,lobe,lower,margin,material,midrib,new,nflorescence,olive,otherwise,ovate,papillate,papillosefruit,pore,portion,pubescent,reflexed,revolute,scar,scattered,slender,somewhat,soon,sparesly,sparsely,tinged,tub,ud,unit,vein,woody,x,yellow,ympodial	arrangement,articulation,bark,color,connation,dehiscence,diameter,diminishing,distal,foetid,foliage,form,fruit,geminate,height,history,interjected,lateral,leaflet,length,life,midpoint,na,papillae,papillose,petiolule,plant,position,prickle,pseudostipule,seed,shape,size,spacing,stem,straightnes,terminal,texture,tuber-bearing,young
635	wfo-0001030611	success	217	114	74	143	40	0.341	0,0-0.5,0.5,0.5-1.5,1.5-10,1mm,2-7,4-5,4-6,5-10,abaxially,acicular,acute,adaxially,anther,apart,apex,articulated,base,blunt-tipped,broadly,calyx,cm,connivent,crowded,densely,diameter,distal,elliptic,elongated,felty-pubescent,flower,fruit,globose,inflorescence,lateral,leaf-opposed,length,lenticular,less,long,minutely,mm,oblong-tapering,obtuse,orange,outline,ovate,pedicel,peduncle,perennial,petiole,pitted,prickle,pubescent,ripe,simple,slightly,sometimes,spreading,stellate,stigma,style,surface,tan,thin-textured,truncate,tube,unbranched,white,whitish,x,yellow,yellow-orange	-1.3,-35,0.1-0.3,0.5-2.5,0.7-1.5,1,1-2,1-3,1.5-2,1.5-3,1/4-1/3,12-10,12-15,15,2,2-3.5,2-4,2-6,2-foliate,2.2-2.5,3,3-4,3-5,3.5-5.5,4-8,5-15,5-8,6-9,7-25,9-30,abaxiall,adaxiall,along,appearing,attenuate,axe,ba,basally,blade,branched,campanulate,capitat,cauline,coarsely,commonly,composed,connate,cylindrical,deltoid,dentate,depressed-deltoid,development,directed,distally,divergently,eaf,eed,elongate,entire,equaling,erect,exceeding,female-sterile,filament,finally,flesh,free,geminat,glabrou,glabrous,glandula,hair,hermaphroditic,inserted,interlaced,interlobal,intermixed,lacking,larger,light,lobe,lon,long-stalked,longer,longest,lower,main,margin,midpoint,midrib,midvein,much,nflorescence,numerous,often,one,orolla,ovate-lanceolate,part,per,pore,predominantly,present,principal,prominent,rachi,radiu,ray,reduced,resembling,round-tipped,ruit,section,sessile,short,short-stalked,short-styled,side,sinus,small,somewhat,spaced,spreading-hirsute,stalk,ste,stellae,stellate-pubescent,stellate-woolly,stipitate,suffrutescent,tal,tamen,tem,termination,time,unarmed,unit,usually,vary,vein,wide,widely,ympodial	arrangement,articulation,bark,capitate,color,connation,corolla,dehiscence,diminishing,foetid,foliage,form,fruiting,glandular,growth,height,herb,history,interjected,leaf,leaflet,life,na,ovary,papillae,petiolule,plant,position,pseudostipule,seed,shape,size,spacing,stem,straightnes,terminal,texture,trichome,tuber-bearing,young
636	wfo-0001030624	success	170	103	67	103	36	0.394	.5,0.5-1.5,0.9-1,1-3,1.5-2,2-10,acute,anther,anthesi,apart,apex,attenuate,bark,base,calyx,clavate,cm,corolla,distal,elliptic,except,falcate,flattened-reniform,fruiting,furcate,glabrous,glandular,globose,green,greyish,lateral,leaf,lobed,long,minutely,mm,narrowly,nearly,occasionally,opposite,ovary,pedicel,petiole,pitted,planar,poricidal,puberulent,shining,shrub,simple,size,small,stem,stigma,straight,style,surface,tip,tree,trichome,tube,tuft,uniseriate,white,yellowish,yellowish-green,young	.25,0.5,0.5-1,1.2-1.8,1.2-2,2,2-3,2.5-5.5,25-40-flowered,3,3-3.5,3.5-4,4.5-8,6-13,7-9,apiculate,appearing,axil,ba,beginning,berry,branch,caly,cell,decurrent,deflexed,dia,differing,difoliate,dimorphic,dry,eaf,edicel,eed,ellipsoid,end,erect,expanded,exserted,extreme,filament,free,geminat,glabrate,hyaline,incrassate,inflorescenc,large,later,like,lobe,lon,longitudinally,lower,main,major,margin,material,middle,midrib,minor,near,nflorescence,older,one,outer,pair,pale,papillose,pore,portion,prominent,raised,remaining,round,rugo,ruit,scar,short,slender,slightly,somewhat,soon,spaced,square,tall,tapering,thickened,three,ti,trunk,two,ud,unevenly,unit,vein,wall,widest,woody,x,yellow,yellowish-grey,ympodial	alternate,arrangement,articulation,color,connation,dehiscence,diameter,diminishing,foetid,foliage,form,fruit,growth,height,history,inflorescence,interjected,leaflet,length,life,na,papillae,peduncle,perennial,petiolule,plant,position,prickle,pseudostipule,seed,shape,spacing,straightnes,terminal,texture,tuber-bearing
637	wfo-0001030628	success	229	124	79	150	45	0.345	.1,abaxial,adaxial,anther,apart,apex,bark,base,branched,brown,calyx,capitate,chartaceous,cm,connivent,curved,dark,densely,diameter,discolorous,ellipsoidal,elliptical,fissure,flattened,flower,fruit,glandular,green,hair,hermaphroditic,inflorescence,juicy,lanceolate,leaf,length,light,like,longitudinal,maturity,mm,moderately,opening,ovary,ovate,pedicel,peduncle,petiole,plant,porrect-stellate,pubescent,purple,rachi,reddish,reniform,rotate-stellate,rugose,shallow,simple,slightly,slit,stalked,stellate,stem,stigma,strongly,style,surface,tapered,thin,tree,tube,turbinate,violet,whitish-,whitish-golden,yellow,yellowish-green,young,×	.2,.5,.5–1.7,0.1–0.3,0.5–3,0.7–0.9,1,10+,10–20,10–40,10–55,11–16,12–20,16–18,1–1.5,1–10,1–2,2.5–8,20–35,2–10,2–3,3.5–4,3.5–5,4,4–4.4,4–6,4–6.5,4–8,5-merous,5–,5–6,5–8.5,6–10,6–8,7–25,7–40,8–1,8–25,abaxially,acuminate,acute,adaxially,age,along,alyx,andromoneciou,andromonoecious,anthesi,articulated,axe,ba,becoming,berry,bilobe,blade,broad-based,broadly,central,congested,cordate,cylindrical,db,difoliate,directed,distally,dried,eaf,eed,eglandular,either,entire,extra-axillary,filament,flowering,free,fresh,frui,fruiting,functionally,geminat,glabrous,half,heterstylous,inclusion,inflated,interpetalar,knobby,lobe,lobed,long,lower,major,margin,maturit,membranaceous,midpoint,midvein,moderate,multangulate,multangulate-stellate,multiseriate,near,nearly,nflorescence,oblique,often,one,orolla,part,pericarp,point,pore,portion,prickle,ratio,ray,reddish-tan,remaining,rounded,ruit,runk,sclerified,sessile,shallowly,sharp,side,similar,spaced,sparsely,stalk,staminate,stellate-pubescent,stout,straight,subtending,tamen,thick,tissue,unarmed,unequal,unit,vary,vein,width,woody,ympodial,–30,–5,–50,–9	1-2,10-20,10-55,12-20,16-18,2-10,2.5-8,30,5,5-6,7-40,8-25,9,arrangement,bilobed,color,colour,connation,corolla,dbh,dehiscence,diminishing,distal,foetid,foliage,form,growth,height,history,interjected,lateral,leaflet,life,na,papillae,pseudostipule,seed,shape,size,spacing,straightnes,terminal,texture,trichome,tuber-bearing
638	wfo-0001030638	success	177	105	73	104	32	0.412	0.1,0.5-1.5,0.7-1.5,1-1.2,1-2,1.5-2,2.5-4,3-10,8,8-9,acute,anther,apex,bark,base,calyx,closely,cm,corolla,cucullate,deflexed,elliptic,exfoliating,fruit,fruiting,glandular,globose,green,inflorescence,lateral,leaf,less,lobed,long,minutely,mm,obovate,opposite,ovary,pale,paler,papillae,papillose,pedicel,petiole,poricidal,red,roundish,rugose,seed,shape,shaped,shrub,simple,size,spaced,stem,stigma,straight,style,surface,tear-drop,terminal,thickening,tip,transversely,tree,trichome,tube,white,woody,x,young	0.5,0.5-0.7,0.5-1,0.5-2,1-1.5,1.4-1.7,1.6-2.2,2-3,2-5,2-7-flowered,3-13,4-6,8-11,along,anthesi,apically,appear,appearing,axi,axil,ba,beginning,beneath,berry,blade,branched,broadly,bud,conspicuously,corky,cup-shaped,deltoid,densely,dia,differing,difoliate,dry,eaf,eed,entire,erect,extending,filament,flattened,fleshy,free,geminat,geminate,glabrate,glabrous,gre,impressed,irregular,known,lamina,large,later,like,lobe,lon,lower,main,major,margin,material,middle,minor,near,nearly,nflorescence,occasionally,often,older,one,open,overlapping,ovoi,pair,papillo,persistent,planar,pore,portion,present,prominent,rather,red-glandular,reddish,rest,ruit,scar,soon,speciman,tall,tapering,thick,thickened,uniseriate,unit,usually,vein,wall,widest,ympodial	alternate,arrangement,articulation,color,connation,dehiscence,diameter,diminishing,distal,foetid,foliage,form,grey,growth,height,history,interjected,leaflet,length,life,midpoint,na,peduncle,petiolule,plant,position,prickle,pseudostipule,spacing,straightnes,texture,tuber-bearing
639	wfo-0001030661	success	183	117	80	103	37	0.437	.5,0.5-0.6,0.5-2,1-1.3,1.5-7,4-15,5-5.5,acute,anther,apex,articulated,attenuate,base,berry,branched,brown,calyx,capitate,cm,connivent,corolla,diameter,ellipsoid,elliptic,erect,flattened,fruiting,globose,growth,inflorescence,lateral,leaf,lengthening,lobed,long,loosely,many,mature,membranous,minutely,mm,narrowly,occasionally,pale,pedicel,peduncle,petiole,pitted,pore,poricidal,red,reddish,reniform,shrub,simple,sleeve,slightly,slit,small,stellate,stem,stigma,style,surface,terminal,time,tinged,tip,tree,trichome,tube,uniseriate,usually,violet,way,white,woody,yellowish,½,¾	-24,.2,0,0.5-0.75,0.7-0.8,1-,1-.,1-1.2,1-1.4,1-1.5,1.2-7,1.5-2,12-16,2-,2-2.5,3-20,3-3.5,3-4,4-6,5-10,5-merou,50-100+,ag,along,alyx,anthesi,ark,branch,brow,cell,clustered,conical,dar,deltate,densely,denser,drying,eaf,eed,em,entire,erec,exserted,extending,filament,flower,free,glabrescent,glabrou,glabrous,group,ilament,insertion,lamina,lobe,lon,lower,margin,midrib,minute,near,never,new,nflorescence,nodding,older,onto,orolla,otherwise,pair,papillo,per,perfect,pericarp,planar,platform,plurifoliat,point,portion,primary,pubescent,rectangular,ruit,scar,scattered,shiny,slender,sparsely,spreading,strongly,tangled,testal,thin,twinin,ud,unit,upper,vary,vein,winged,x,yellow,ympodial	1-5,age,arrangement,articulation,bark,color,connation,dehiscence,diminishing,distal,foetid,foliage,form,fruit,height,history,interjected,leaflet,length,life,midpoint,na,ovary,papillae,petiolule,plant,position,prickle,pseudostipule,seed,shape,size,spacing,straightnes,texture,tuber-bearing,young
640	wfo-0001030665	success	191	144	115	76	29	0.602	-5,-7,0.2-0.4,0.2-0.6,0.4-0.6,0.5-2,0.8-1.1,1-17,1-2,1-4,1.1-2.8,1.5-3,1.6-4.5,10-200,2-16,2-6,2.3-10,2.5-3.5,2.5-9,3-3.8,3-5,4-5,5-8,accrescent,acicular,adaxially,adult,anther,appessed,armed,articulated,base,broad-based,brown,calyx,campanulate,chartaceous,cm,cordate,decimetre,deeply,deflexed,deltate,depressed-globose,depression,diameter,directed,ellipoidal,elliptical,finally,flower,flushed,fruit,fruiting,glabrous,gland-tipped,globose,green,greenish,grey,grey-green,hair,half,herbaceous,index,inflorescence,lateral,length,less,light,lilac,lobe,lobed,lobing,long,margin,mature,midvein,minute,minutely,mm,obtuse,ovate,pale,papery,pedicel,peduncle,per,petiole,present,prickle,prostrate,puberulent,purple,rather,reflexed,resprouter,reticulate,rotate,scarcely,short,sparsely,sprawling,stigma,straight,style,surface,thin,throughout,tube,unbranched,unifoliate,vein,x,yellow	%,0.5-1,0.5-11,0.7-1,1.4-1.7,1.5-2,1.5-2.5,2-3,2-5,2-8,20-30,3-10,5-merou,6-8,abaxially,absen,absent,abundant,acute,adaxiall,alyx,apex,appearance,axe,ba,blade,branche,broad,capitat,cut,cylindrical,distall,dr.,eaf,eed,extra-axillary,filament,finger,folded,geminat,give,homostylous,interpetalar,inward,lamina,leaf-opposed,lon,longer,lower,mesocarp,nflorescence,oblique,orolla,part,perfect,pore,rachi,rounded,ruit,side,simple,sinus,stage,stellate-campanulate,tal,tamen,tem,thick,time,tissue,unit,uvenile,vary,wide,ympodial,¾	arrangement,articulation,branch,capitate,color,connation,corolla,deflexion,dehiscence,density,distally,form,growth,height,history,leaf,life,na,ovary,papillae,plant,presence,seed,shape,size,stem,straightnes,texture,thicknes
641	wfo-0001030676	success	220	119	85	135	34	0.386	0.4,1-3,1/4,14-17,16,2.2-5.7,2.5-5.5,3-6,4-6,4-6.5,7-8,8-10,abaxially,adaxially,anther,anthesi,apart,apical-lateral,appressed-tomentose,articulated,base,blunt-tipped,branched,brown,calyx,cm,corolla,deltoid,diameter,dichotomously,exserted,finely,fruit,granular-tomentose,green,growth,honeycombed,introrse,large,lateral,leaf,length,lengthen,lined,lobed,longitudinal,longitudinally,minutely,mm,oblique,oblong,oblong-elliptic,often,openly,pedicel,peduncle,petiole,pore,probably,reniform,reticulate-punctate,ridged,ripe,scabrous,shrub,simple,slit,small,stem,stigma,strongly,style,subglobose,suborbicular,testa,tree,tube,velutinous,way,white,whitish,x,yellow,yellowish,young	-1.6,-2.5,-3.9,-8.5,/10-1/5,0-100,0.6-1.2,1,1-1.2,1.1-1.4,1.1-1.9,1.2-1.3,1.3-1.5,1.7-2,11-14,19-35,2.1-2.3,2.1-2.6,2.4-3.1,2.75-3.25,3-3.5,3-5,7-10,7-9,8-12,abruptly,acute,along,angled,apex,apparently,appearing,axillary,ba,bark,becoming,berry,blade,branch,bud,chartaceous,closely,conical,continued,crown,cylindrical,dehiscing,densely,due,eaf,echinoi,echinoid,eed,elongate,entire,except,filament,flat-topped,fleshy,flower,forming,free,glabrescen,glabrescent,glabrous,globose,greenish,grooved,hair,high,horizontal,initially,inserted,lackin,lamina,lobe,long,lower,main,margin,midvei,midvein,minute,moderately,mostly,multangulate,nearly,nflorescence,obtuse,occasional,older,opening,orolla,ovate,ovate-lanceolate,parallel,perfect,plurifoliate,pseudo-terminal,pubescent,pulverulent,rachi,rather,ray,ruit,runk,scattered,sessile,short-attenuate,short-stalked,side,somewhat,spaced,sparsely,spreading,stellate,stellate-pubescent,subcampanulate,subcapitat,tamen,tending,terete,thick,thin,time,tip,tomentose,tuft,unarme,unit,usually,vary,vein,wide,ympodial	arrangement,articulation,color,connation,dehiscence,foetid,foliage,form,fruiting,height,history,inflorescence,interjected,leaflet,life,midpoint,na,ovary,papillae,plant,position,prickle,pseudostipule,pseudoterminally,seed,shape,size,spacing,straightnes,subcapitate,surface,terminal,texture,trichome
642	wfo-0001030686	success	182	99	73	109	26	0.401	.5-1,1-1.1,1-1.2,1.5-4.5,1.6-3,15,2-2.5,2.5-8,5-25,acute,age,anther,apart,bark,base,berry,bifid,black,branched,brown,calyx,centre,cm,corolla,cup-shaped,dark,darker,deeply,diameter,elliptic,flattened,form,fruit,fruiting,globose,golden,height,leaf,lengthening,lepidote,lilac,lobe,lobed,mm,orange,ovary,pale,papillae,pedicel,peduncle,petiole,pitted,plant,poricidal,pubescent,purple,seed,shallowly,shiny,simple,slit,spreading,stellate,stem,stigma,style,surface,tip,tree,trichome,tube,uniformly,yellow	.2,.5,0.5-1,1-1.5,1-2,1.2-1.5,1.5-2,1972,2-3,2-6.5,2.5-4,3-3.5,5-12,5-30,5-6,8-9,?,abaxially,aborted,abruptly,acuminate,adam,adaxially,anthesi,apex,basal,beneath,breast,brittle,bu,c.,closely,conical,densely,denser,different,difoliate,discolorous,dry,drying,eaf,edicel,eed,empty,entire,erect,exerted,fide,filament,flower,fragrant,free,geminat,glabrescen,glabrous,half,heteromorphic,internodal,lamina,leaf-opposed,less,long,lower,many,margin,maturity,midrib,midvein,minutely,nflorescence,noddin,oblique,older,overlapping,pair,paler,papillose,pericarp,planar,pore,portion,primary,pubescen,rachi,ruit,scar,scarious,shallow,short,slightly,somewhat,space,spaced,sparsely,strongly,styl,thin,time,tissue,ud,unit,usually,vein,visible,way,woody,x,ympodial,–	arrangement,color,connation,dehiscence,foetid,foliage,glabrescent,growth,history,inflorescence,interjected,lateral,leaflet,length,life,midpoint,na,nodding,pseudostipule,shape,size,spacing,straightnes,terminal,texture,young
643	wfo-0001030696	success	202	106	68	134	38	0.337	0.1-0.3,0.4-0.6,0.8-1.8,1-9,1.5-2,10-50,3-6,4-4.5,absent,accrescent,acicular,acute,anther,apex,articulated,base,calyx,chartaceous,cm,contiguous,cuneate,cylindrical,diameter,directed,distally,elliptical,extra-axillary,flower,fruit,fruiting,globose,green,half,herbaceous,inflorescence,lanceolate,lateral,length,less,lobe,long,mature,midpoint,minute,mm,nearly,obtuse,ovate,pale,pedicel,peduncle,petiole,plant,prickle,prostrate,pseudo-umbellate,resprouter,simple,solitary,sprawling,stellate,straight,style,thick,tube,unbranched,white,yellow	%,.5,0-0.1,0-3,0.05-0.2,0.1-0.4,0.2-1,0.3-1.1,0.5-3,0.7-1,0.7-1.1,0.8-1.2,0.8-1.3,0.8-1.5,0.8-1.7,0.9-1.5,1,1-1.5,1-2.5,1-3,1-4,1.5-3,1.6-2.2,10-16,12-18,2-3-foliate,2-4,2-5.5,2-8,2-locular,2.3-4,2.5-6,20-35,3-4,3.8-4,4-17,4-7,4-8,5-merou,7-10,8-18,abaxially,absen,across,adaxiall,adaxially,adult,alyx,andromonoecious,apart,armed,ascending,axe,ba,blade,branche,brown,cross-section,decimetre,deeply,deltate,densely,distall,distributed,eaf,eed,eglandular,exocarp,filament,finger,frui,functional,geminate,glabrous,gland-tipped,hair,heterostylous,index,juicy,lamina,lobed,lobing,longer,lower,margin,markedly,mesocarp,mid-point,midvein,moderately,moist,nflorescence,oblique,onl,orolla,part,per,placenta,pore,porrect,present,probably,rachi,ray,ruit,semi-circula,sessile,short,side,spaced,sparse,sparsely,stage,stalk,stellae,stellate-pubescent,strongly,tal,tamen,tem,thicker,thicknes,throughout,time,unit,usuallu,uvenile,vary,vein,wide,winged,x,yellowish,ympodial	arrangement,articulation,bark,color,connation,corolla,dehiscence,diminishing,distal,foetid,foliage,form,growth,height,history,interjected,leaf,leaflet,life,na,ovary,papillae,petiolule,position,pseudostipule,seed,shape,size,spacing,stem,stigma,straightnes,surface,terminal,texture,trichome,tuber-bearing,young
644	wfo-0001030699	success	195	111	79	116	32	0.405	0.5-0.7,1-2,12-15,2-3,2-5,2.5-3,3-10,3-6,4-5,4-6,4-7,acute,anther,apart,apex,articulated,bark,base,berry,blue,branched,brown,calyx,cell,clavate,cm,cordate,corolla,corymbose,curved,cyme,diameter,distal,elongate,fruiting,globose,green,greenish,growth,inflorescence,lanate,length,lobed,long,long-styled,midpoint,mm,multicellular,nearly,ovary,ovate,ovate-elliptic,ovate-lanceolate,pedicel,peduncle,petiole,plant,poricidal,prickle,purple,rusty,short-styled,shrub,simple,slightly,stellate,stem,stigma,straight,style,subrounded,subscabrous,surface,tapering,tip,trichome,tube,velutinous,yellow	-13,-8.5,0,0.2-0.3,1-1.5,1.4-1,1.5-2,1/10,1/6,11-12,2-2.5,2-4,3-5,4-6-celled,5,5-6,6-,8-10,9-11,abaxially,adaxially,anthesi,antrorse,apical,apically,armed,basal,brow,compressed,decurrent,densely,discolorous,eaf,eed,entire,erect,exserted,filament,flower,foliaceous,free,glabrous,glandular,glandular-lanate,golden,grey,half,heterostylous,hirsute,immersed,induman,juvenile,known,lengthening,like,linear-lanceolate,lobe,lobed-angulate,lower,many,margin,middle,minute,mixed,multangulate,new,nflorescence,older,onto,ovoid,papillat,partially,perfect,pericarp,plurifoliat,pore,porrect,portion,prickly,pubescence,pubescent,rarely,ray,red,reduced,reflexed,rotate,ruit,scar,sessile,single,slit,spaced,sparsely,stalked,staminate,stellate-puberulent,subcoriaceous,subscandent,subsessile,tall,time,tomentose-lanate,ud,unevenly,unit,upper,vein,villous,winged,without,wood,x,yellowish,ympodial,¼	arrangement,articulation,color,connation,dehiscence,diminishing,foetid,foliage,form,fruit,height,history,interjected,lateral,leaf,leaflet,life,na,papillae,papillate,petiolule,position,pseudostipule,seed,shape,size,spacing,straightnes,terminal,texture,tuber-bearing,young
645	wfo-0001030709	success	217	107	74	143	33	0.341	0.3-1.5,0.7-1,1-1.6,1-4.5,1.3-1.4,10-14,10-50,2-6,5-20,5-6,8-11,8-15,acuminate,acute,almost,anther,apex,apparently,articulated,bark,base,calyx,chartaceous,cm,connivent,cordate,diameter,dull,elliptic,elongating,finely,flattened-reniform,fruit,fruiting,glabrescent,inflorescence,lateral,leaf,length,lobed,long,maturity,mauve,mm,moderately,orange-brown,pedicel,peduncle,petiole,pitted,poricidal,porrect,prickle,purple,seed,shrub,simple,size,spherical,stalked,stellate-pubescent,stem,straight,style,surface,tapering,terminal,tip,trichome,truncate,tube,variously,wide,yellow	-2,-5,-9,0,0-,0-20,0-30,0.1-0.2,0.15-0.5,0.2-0.5,0.4,0.8-4,0.9-1.5,1-1.2,1-6,1.4-2,1.6-2.1,1.9-2.8,1/2-2/3,1/3-1/2,1/4,1/4-1/3,2-4,2-5,2-8,2.3-3,2/3-3/4,3-,4-5-merous,5-10,5-7,5-9,6-10,6-21,6-7,6-8,7-8,7-9,abaxially,adaxially,alyx,ame,apar,apart,ape,apically,berry,blade,branched,bright,broad-deltate,brow,c.,conical,cuspidate,deltate,discolorous,distance,drying,eaf,edge,eed,equal,erect,extending,filament,flower,free,glabrous,increasing,infructescence,lanceolate,lengt,lobe,lobing,lon,long-acuminat,longer,lower,margin,mature,middle,midpoint,midvein,narrow-deltate,nflorescence,occasionally,often,older,one,open,orolla,oung,pair,pendulous,per,perfect,pericarp,perpendicular,pit,plurifoliat,portion,prickl,prickly,primary,ray,red-green,red-orange,reflexed,retrorse,rounded,ruit,scar,secondary,short-styled,shorter,side,slender,smooth,sometimes,spaced,sparsely,spreading,stalk,stellate,tamen,terete,tertiary,time,toward,unarmed,unit,upper,usually,vary,vein,venation,visible,way,weakly,woody,yellow-green,ympodial	arrangement,articulation,brown,color,connation,corolla,dehiscence,diminishing,distal,foetid,foliage,form,growth,height,history,interjected,leaflet,life,na,ovary,papillae,perennial,petiolule,plant,position,pseudostipule,shape,spacing,stigma,straightnes,texture,tuber-bearing,young
646	wfo-0001030714	success	178	128	94	84	34	0.528	-3,/3,0.1-0.3,0.5,0.5-0.8,0.5-1.9,0.7-0.8,1-1.3,1.2-1.5,1.2-4,1.5-2,1/3,7-17,acuminate,acute,age,along,anther,articulating,bark,basal,base,beneath,berry,blue,blue-black,calyx,clavate,cm,cordate,corolla,dark,diameter,elliptic,except,flattened,fruit,glabrous,globose,greyish,growth,herbaceous,leaf-opposed,leaving,lengthening,liana,lobed,long,membranous,midrib,minute,minutely,mm,narrowly,ob-ellipsoid,ob-elliptic,oblique,occasionally,ovary,pale,paler,papillate,pedicel,peduncle,peg,petiole,pitted,pore,poricidal,pubescent,quadrate,reniform,ripe,shape,simple,slightly,slit,stellate,stem,stigma,style,surface,terminal,tip,trichome,truncate,tube,uniseriate,vein,vine,violet,way,woody,yellow	.2,.5,0.3-0.4,0.8-1,1-1.2,1-1.5,1-2.5,1.4-3.5,2-2.5,2-2.6,20,3-3.5,3-7,5-100,5-6,>,abaxial,abaxially,adaxially,aid,anthesi,apar,apex,becoming,branching,campanulate,climbin,conical,cup,densely,denser,eaf,eed,ellipsoid,entire,especially,exserted,fide,filament,flower,free,grading,gradually,gree,howard,joined,like,lobe,lower,many,margin,narrow,new,nflorescence,nodding,node,older,overall,pair,papillat,pedice,per,perfect,planar,plurifoliat,portion,primary,prominent,ruit,scar,spaced,sparsely,strongly,submarginal,tapering,thickened,time,tub,twining,ud,unit,widely,x,ympodial	apart,arrangement,articulation,color,connation,dehiscence,foetid,foliage,form,fruiting,green,height,history,inflorescence,interjected,lateral,leaf,leaflet,length,life,midpoint,na,papillae,plant,position,prickle,pseudostipule,seed,size,spacing,straight,straightnes,texture,young
647	wfo-0001030730	success	205	109	78	127	31	0.38	0.1-0.3,0.8-4.4,1-1.2,1-1.7,1-8,2-2.5,2-2.9,2-4,2-8,2.3-6,2.5-7,240-700,3-15,4-11,4-7,5.5-14.5,5.5-6.5,9-10.5,acicular,acute,adaxially,anther,apex,base,calyx,cm,connivent,cuneate,densely,depressed,diameter,fruit,glabrous,globose,grey,herbaceous,inflorescence,lanceolate,lateral,length,lobed,loosely,margin,minutely,mm,obtuse,ovate,pale,pedicel,peduncle,per,perennial,petiole,pink,prickle,pseudo-racemose,purple,rachi,resprouter,rhizomatous,rugose,rusty,shallowly,shrub,simple,smooth,stellate,stellate-pubescent,stigma,straight,style,subcordate,surface,toward,tube,unbranched,x,yellow	%,0-0.8,0-1,0-1.2,0-1.6,0-6,0.05-0.1,0.05-0.2,0.5-0.9,0.5-1,0.6-1.2,0.7-1.2,0.8-1.2,1-10,1-3,1.1-1.9,1.5-4.5,1.7-2.3,10,11-17,11-20,15-60,2-5,2-foliate,3-20,4-locular,5-40,5-merou,7-8,9-15,abaxially,absent,accrescent,across,adaxiall,alyx,apart,armed,articulated,ascending,attenuate,axe,ba,blade,bony,chartaceous,curved,cylindrical,d.,deltate,directed,distall,distributed,drooping,eaf,eed,eglandular,entire,extra-axillary,filament,finally,finger,first,flower,fruiting,geminate,glabrou,gland-tipped,green,hair,half,hard,lamina,later,less,light,lobe,lon,long,longer,lower,marbled,mature,mid-point,midpoint,midvein,minute,nflorescence,oblique,orolla,part,perfect,pore,porrect,presen,present,probably,ray,ridged,ruit,short,slightly,spaced,sprawling,spreading,stage,stalk,stellae,tal,tamen,tem,thick,throughout,time,truncat,unarmed,unit,unknow,uvenile,vary,vein,white,wide,yellow-brown,yellowish,yellowish-green,ympodial	arrangement,bark,color,connation,corolla,density,diminishing,distal,dm,form,growth,height,history,leaf,leaflet,life,na,ovary,papillae,petiolule,plant,seed,shape,size,stem,straightnes,terminal,texture,thicknes,truncate,tuber-bearing
648	wfo-0001030733	success	130	101	61	69	40	0.469	/4,0.5-1,1-1.5,1-2,3-5,6-7,abaxially,acuminate,acute,adaxially,anther,apex,bark,base,bi-lobed,brown,calyx,capitate,closely,cm,corolla,dark,densely,elliptic,fruiting,glabrous,globose,green,lateral,leaf,lobed,long,minutely,mm,moderately,narrowly,opposite,ovary,ovoid-reniform,pedicel,petiole,poricidal,pubescent,shaped,shrub,simple,smooth,spaced,stem,stigma,style,surface,tear-drop,tip,treelet,trichome,tube,uniseriate,way,white,young	.5,1-1.2,1.5-5,1.7-2.7,2-2.5,3-4,4-15,4.5-5,5-8-flowered,6-9,?,along,anthesi,ape,berry,broadly,clearly,conical,coriaceous,decurrent,deltate,denser,dia,eaf,eed,ellipsoid,elongate,embryo,erect,exserted,filament,free,grayish-brow,lamina,later,like,lobe,lon,lower,main,margin,middle,nflorescence,older,onto,overlappin,pair,papillo,planar,pore,portion,rounded,ruit,scar,somewhat,sparsely,strongly,tall,testa,thick,ud,unifoliat,unit,vein,visible,widest,woody,x,ympodial	arrangement,articulation,color,connation,dehiscence,diameter,diminishing,distal,foetid,foliage,form,fruit,grayish-brown,growth,height,history,inflorescence,interjected,leaflet,length,life,midpoint,na,overlapping,papillae,peduncle,petiolule,plant,position,prickle,pseudostipule,seed,shape,size,spacing,straightnes,terminal,texture,tuber-bearing,unifoliate
649	wfo-0001030751	success	226	98	72	154	26	0.319	-5,0,0-0.5,0.1-0.3,0.1-0.4,0.5-1.5,0.5-1mm,0.6-1.5,1,1-2,1-3,1-4,14-20,2-3,3.5-4.5,4-6,5-15,accrescent,anther,apart,articulated,attenuate,base,broad,broadly,calyx,cm,cordate,diameter,elliptic,felty-pubescent,form,fruit,fruiting,globose,inflorescence,lanceolate,lateral,leaf-opposed,length,lenticular,light,long,midpoint,minutely,mm,orange,ovate,pedicel,peduncle,perennial,petiole,pitted,prickle,shallowly,simple,somewhat,stellate,stellate-woolly,stem,stigma,style,surface,tan,thin-textured,trichome,truncate,unbranched,white,x,yellow,young	-7,.2,.5,0-1,1-24,1/4-1/2,10-15,11-40,13-50,2,2-3.5,2-foliate,2.5-4,20-25,3-5,3-6.5,5-6,5-7,5-8,6-9,7-13,7-15,8-13,abaxially,acute,acute-,adaxiall,adaxially,along,also,among,apex,axe,ba,basally,blade,branched,campanulate,capitat,cast,cauline,clas,closely,coarsely,commonly,completely,connivent,covering,cylindrical,deciduou,deltoid,densely,dentate,depressed-deltoid,directed,distal,distall,distinct,divergent,divergently,dominant,eaf,eed,elongate,entire,equaling,erect,especially,essentially,female-sterile,filament,finally,flesh,flower,foliar,frui,geminat,glabrous,green,hair,inserted,interlobal,interwoven,larger,less,lignescent,like,lobe,longest,lower,major,margin,mixture,mostly,multiseriate,nflorescence,numerous,obtuse-tipped,occasionally,often,one,orolla,ovate-lanceolate,per,petaloid,pore,present,prickl,prickly,principal,prolonged,pubescence,pubescent,purplish,rachi,ray,recurve,ripe,ruit,scattered,sessile,short,shorter,side,sinus,small,smaller,spaced,sparsely,spreading,spreading-hirsute,stalk,stalked,stellae,stellate-pubescent,stipitate,straight,tal,tamen,tem,termination,tip,tooth-like,tube,typically,unarmed,unit,usually,variable,vary,vein,vivo,wide,ympodial	arrangement,articulation,capitate,color,corolla,dehiscence,foetid,foliage,growth,height,herb,history,interjected,leaf,leaflet,life,na,plant,position,pseudostipule,seed,shape,size,spacing,terminal,texture
650	wfo-0001030772	success	155	91	60	95	31	0.387	-2,0.2-0.8,0.5-1,0.9-1,1-2,3-3.5,3-5,acuminate,anther,attenuate,bark,base,calyx,capitate,closely,cm,corolla,deflexed,elliptic,erect,fruit,fruiting,glabrous,globose,green,grey,lateral,leaf,lenticellate,lobed,minutely,mm,occasionally,opposite,ovary,overlapping,ovoid-reniform,pale,papillose,pedicel,petiole,pitted,poricidal,shape,shrub,simple,size,spaced,stem,stigma,straight,style,surface,tan,tip,trichome,tube,white,woody,young	.05,.2,.25,.5,0.25-0.5,0.75-1,0.9-3.1,1-2.5,1.2-5,1.4-1.6,1.5-2,2-7,4.2-6.5,5-10-flowered,5-6,8-10,9-15,acute,anthesi,apex,archin,ba,becoming,beginning,beneath,berry,branch,bud,dark,dia,differing,difoliate,eaf,edicel,eed,ellipsoid,extreme,filament,free,geminat,gently,impressed,inflorescenc,large,later,lobe,lon,long,long-acuminate,long-triangular,lower,main,major,margin,methyl,middle,minor,nearly,nflorescence,node,older,one,pair,paler,papillo,per,pore,portion,prominent,reflexed,ripe,rounded,ruit,salicylate,scar,shaped,shining,slender,slightly,smelling,soon,strongly,swollen,tall,tapering,tear-drop,ud,uniseriate,unit,usually,vein,widest,wintergreen,x,ympodial	alternate,arrangement,articulation,color,connation,dehiscence,diameter,foetid,foliage,form,growth,height,history,inflorescence,interjected,leaflet,length,life,midpoint,na,papillae,peduncle,plant,position,prickle,pseudostipule,seed,spacing,straightnes,terminal,texture
651	wfo-0001030781	success	213	114	78	135	36	0.366	0-5,0.2-4,0.5-6,0.5-8,1-10,1-2,1-8,1.5-12,10-40,15-35,2.5-14,3-4,4-15,5-7,6-7,7.5-9,anther,apex,apiculate,articulated,base,broadly,chartaceous,cm,connivent,corolla,cuneate,deep,diameter,distal,elliptic,forked,fruit,globose,green,greenish,half,herb,high,interjected,lanceolate,lateral,leaf,leaflet,light,membranous,mm,mucilaginous,obovate,odd-pinnate,ovate,ovoid,pedicel,peduncle,pentagonal,petiole,plant,pointed,poricidal,purple,rachi,rotate-pentagonal,rounded,seed,size,slightly,stem,stigma,straight,style,subovoid,terminal,tip,tube,violet,whitish,x,yellow	1-1.5,1-12,1-4,1.5-2,1.5-9,1.6-2.2,2-20,2-3,2.5-3.5,3-6,5-6,5-8,5-merou,abaxially,abruptly,acumen,adaxially,ag,along,alyx,apart,apparently,axe,axillary,berry,blade,borne,brown,brownish,bud,caly,capitat,cell,ciliate,condition,covering,dark,decreasing,decurrent,densely,digestion,dorsally,dot,drying,eaf,edge,eed,end,enzyme,erect,especially,exceeding,filament,finely,flat,flower,folded,fresh,geminat,generally,glabrou,glabrous,glandular,gradually,gray-green,green-white,hair,hair-like,homostylous,honeycomb-shaped,larger,lengthening,like,living,lobe,long,low-growin,lower,make,margin,midrib,minutely,narrowed,nflorescence,orbicular,orolla,ovate-lanceolate,pair,papillose,perfect,petiolulate,pilose,plurifoliate,pore,puberulent,pubescent,rarely,removed,ruit,scattered,sessile,seudostipule,short,simple,singly,slit,small,sometimes,somewhat,spaced,sparsely,specimen,stamen,ste,stolo,subtending,tall,tamen,tem,testal,thick,throughout,toward,tri-,tuber,typically,unit,unwinged,usually,vary,wall,wet,white,wide,ympodial	arrangement,articulation,bark,calyx,capitate,color,connation,decument,dehiscence,diminishing,foetid,foliage,form,fruiting,growth,height,history,inflorescence,length,life,na,ovary,papillae,petiolule,position,prickle,pseudostipule,shape,spacing,straightnes,surface,texture,trichome,tuber-bearing,ye,young
652	wfo-0001030782	success	198	112	78	120	34	0.394	0-7,0.4-1.5,1-2,1.5-7.5,13-22,15,2,3-10,3-5,4-11.6,4-6,5-20,7-15.6,anther,articulated,axillary,base,brownish,bud,clavate,cm,condition,connivent,coriaceous,corolla,decreasing,deep,diameter,distal,drying,elliptic,forked,fresh,fruit,glabrous,globose,green,greenish,half,herb,high,interjected,lanceolate,lateral,leaf,leaflet,lilac,medium,mm,moniliform,mucilaginous,odd-pinnate,ovate,ovoid,pedicel,peduncle,pentagonal,petiole,plant,poricidal,ripe,rotate,seed,size,stigma,straight,style,subtending,terminal,tip,toward,tube,typically,usually,wet,white,whitish,yellow	0-1,1-3,1-5,1-6,1.2-3.9,1.3-1.6,1.5-2,1.6-4.6,11-47,12-30,2-3,2.2-4,2.4-11.5,4.6-26,5-merou,6-8,abaxiall,abaxially,acumen,acuminate,acute,adaxially,ag,along,alyx,apart,apex,apparently,arranged,asymmetric,attenuate,axe,basiscopic,bead,berry,blade,broadly,capitat,cell,covering,cuneate,dark,digestion,dorsally,eaf,edge,eed,enzyme,exceeding,filament,flat,flower,folded,geminat,generally,glabrescent,glabrou,green-white,hair,hair-like,hal,homostylous,honeycomb-shaped,inconspicuous,lengthening,light,like,living,lobe,long,lower,make,mottled,multiple,necklace,nflorescence,orbicular,orolla,pair,perfect,petiolulate,plurifoliate,pore,prominently,purple,rachi,removed,rounded,ruit,scarce,second,sessile,seudostipule,short,side,slit,smaller,sometimes,spaced,specimen,stamen,stolon,subequal,tal,tamen,tem,testal,thick,throughout,tissue,totally,tri-,tuber,unit,vary,wall,wide,winged,x,ympodial	arrangement,articulation,bark,calyx,capitate,color,connation,dehiscence,foetid,foliage,form,fruiting,growth,height,history,inflorescence,length,life,midpoint,na,ovary,papillae,position,prickle,pseudostipule,shape,spacing,stem,straightnes,surface,texture,trichome,tuber-bearing,young
653	wfo-0001030802	success	171	105	70	101	35	0.409	0.5-1,1,1-1.1,1-1.5,2-3,acuminate,acute,anther,apex,bark,base,brown,calyx,cm,cordate,corolla,deeply,difoliate,flattened-reniform,fruit,fruiting,gland,glandular,globose,halfway,heart-shaped,internodal,irregularly,lateral,leaf,length,lobed,long-triangular,minutely,mm,ovary,ovoid,pale,papillate,pedicel,persistently,petiole,pitted,plant,poricidal,pubescent,red,reddish,shrub,simple,single-celled,somewhat,spaced,stem,stigma,straight,style,subshrub,surface,tip,tipped,trichome,tube,unifoliate,variable,white,widely,yellow,yellowish,young	.3,.5,.5mm,0,0.25-0.4,0.5-0.75,0.5-1.5,0.7-1cm,0.75-1,0.9-1,1-1.2,2-2.5,2-5,2.5-3,3-3.5x,3-4,3-6,4-5mm,4-6,5-10-flowered,abaxially,abrupt,adaxially,along,anthesi,appearing,basal,becoming,beginning,beneath,berry,bud,campanulate,cucullate,deflexed,densely,denser,dia,dry,eaf,edicel,eed,ellipsoid,evenly,except,exerted,exudate,filament,filiform,free,geminat,glabrous,glandurla,hanging,incrassate,inflorescenc,invest,lamina,later,line,live,lobe,long,lower,m.,main,margin,markedly,material,midvein,near,nflorescence,obconic,older,pair,palmate,papillose,per,pore,portion,prominent,pubescen,raised,ruit,scar,shaped,slender,soon,specimen,stigm,strongly,tapering,tear-drop,trichoem,ud,uniseriate,unit,vein,woody,x,ympodial	4-5,arrangement,articulation,color,connation,dehiscence,diameter,diminishing,distal,foetid,foliage,form,growth,height,history,inflorescence,interjected,leaflet,life,midpoint,na,papillae,peduncle,petiolule,position,prickle,pseudostipule,seed,shape,size,spacing,straightnes,terminal,texture,tuber-bearing
654	wfo-0001030803	success	185	126	95	90	31	0.514	0.2,0.3,0.5,0.5–1.5,1-,1.5-,1.5-3,10–15,1–2.5,1–3,20–40,3-6,3–5,?,abaxially,absent,acuminate,acute,adaxially,anther,apex,articulated,base,becoming,berry,branched,brown,calyx,campanulate,chartaceous,cm,connivent,corolla,diameter,flattened-reniform,flower,fruiting,glabrous,globose,green,imparipinnately,lateral,leaf,leaflet,lengthening,light,lobed,long,long-styled,minute,minutely,mm,papillae,pedicel,peduncle,petiole,petiolule,pinnatifid,pitted,pore,poricidal,present,prickle,puberulent,ranging,rarely,recurved,rounded,shape,simple,size,slit,somewhat,stellate,stem,stigma,stout,straight,strongly,style,surface,tapering,terminal,tip,truncate,tube,variable,vine,wide,woody,yellow,yellowish,×,–10,–5	.5,0.2–0.3,0.4,0.75–1,0.9–1.5,1,1.5,1/3,10967,2.5,2–,3–10,3–4,4–10,5,6–12,6–8,7–9,adaxiall,adjacent,ag,almost,alyx,anthesi,armed,axe,basal,blade,broadly,bud,confluent,connecting,corresponding,dr.,eaf,eed,elliptic,elongating,entire,equal,exserted,filament,hair,hinton,internode,lanceolate,lobe,lower,major,margin,middle,midri,midrib,narrowly,nflorescence,often,orolla,outline,ovate,pericarp,pinnate,plurifoliat,pointed,purple,rachi,recurve,rugose,ruit,sharply,side,slender,spreading,subwoody,swolle,tamen,time,tissue,triangular,truncat,turbinate,unit,usually,variously,vary,vein,widest,wing,wood,ympodial,–16	age,arrangement,articulation,bark,color,connation,dehiscence,diminishing,distal,foetid,foliage,form,fruit,growth,height,history,inflorescence,interjected,length,life,na,ovary,plant,position,seed,spacing,straightnes,texture,trichome,tuber-bearing,young
655	wfo-0001030809	success	154	108	70	84	38	0.455	0.5-1,1-1.5,1.4-1.5,1.5-2.4,1.5-3.5,2.3-5.5,4.5-5,6-8,8,9.9-12,acute,anther,apex,appearing,bark,base,beneath,branched,calyx,clavate,cm,corolla,curl-tipped,curved,densely,elliptic,falcate,fruit,fruiting,glabrous,globose,golden,green,lateral,leaf,lobed,long,minutely,mm,nearly,opposite,ovary,ovate,overtopping,pedicel,petiole,poricidal,several,shining,shoot,simple,size,slightly,small,stem,stigma,straight,style,terminal,time,tip,tomentose,tree,trichome,tube,uniseriate,white,x,yellow-brown,young	.5,0.2,1-1.25,1.2-1.4,2-2.5,20-60-flowered,5-8,across,along,also,anthesi,apar,berry,broadly,caly,campanulate,dark-papillo,deciduous,deflexed,deltoid,dense,dia,difoliate,distally,eaf,edicel,eed,ellipsoid,erect,especially,evenly,exserted,filament,free,geminat,hair,hidden,interpetalar,known,large,leave,like,lobe,lon,long-papillose,lower,main,major,markedly,mature,membranous,middle,midrib,minor,nflorescence,older,one,planar,pore,portion,present,pubescent,round,ruit,scar,scattered,shinin,sinus,slender,soon,spaced,tall,tapering,three,triangular,two,ud,underside,unequal,unit,vein,wide,widest,ympodial	alternate,apart,arrangement,articulation,color,connation,dark-papillose,dehiscence,diameter,diminishing,distal,foetid,foliage,form,growth,height,history,inflorescence,interjected,leaflet,length,life,midpoint,na,papillae,peduncle,petiolule,plant,position,prickle,pseudostipule,seed,shape,spacing,straightnes,surface,texture,tuber-bearing
656	wfo-0001030810	success	191	112	70	121	42	0.366	0.2,0.3,1,abaxially,acute,adaxially,anther,apart,apex,bipinnate,blue,branched,brown,calyx,clavate,cm,connivent,dark,densely,denser,diameter,elliptical,flattened,fleshy,fruit,globose,hair,indumentum,leaf,long,longitudinal,midvein,mm,moderately,oblong,opening,pale,pedicel,peduncle,pentagonal,petiole,pinnae,pinnate,pitted,poricidal,primary,rounded,secondary,shallowly,shiny,shrub,size,slit,stem,stigma,straight,style,surface,tardily,time,tip,tomentose,tube,unknown,violet,wide,wing,woody,x,yellow	0.2–0.3,0.4,0.5–,0.5–0.8,0.6–1.0,0.7–1.4,0.8–5.5,0.95–2.0,0–,1.0–1.5,1.0–2.0,1.0–3.0,1.1–2.0,1.1–2.2,1.2–1.5,1.5–1.9,1–2,1–3,1–5,2.9–4.5,20–100,2–3,2–4,3.0–5.0,3.3–5.5,3.3–8.5,3.5–4.6,3–19,4–14,4–5,4–7,5,5–15,5–30,5–32,6–10,6–22,7–10,7–11,8–10,absen,accrescent,adaxiall,ag,along,anthesi,articulated,axe,axillary,ba,base,blade,borne,cell,chartaceous,colour,cylindrical,decreasing,divided,eaf,eed,elliptic,equal,erect,especially,filament,flower,geminat,glabrous,green,greyish,half,hig,irregular,leafy,lobe,lon,lower,m.,margin,midrib,multicellular,narrow,nflorescence,obtu,occasionally,older,opposed,orolla,oung,pair,perfect,plurifoliate,pore,pubescent,rarely,reflexed,ruit,shaped,shoot,side,simple,sometimes,spaced,sparsely,stone,subglabrous,tamen,tear-drop,unicellular,uniseriate,unit,vary,white,ympodial,–2.5,–3,–3.4,–4.5,–5.0,–8	0.2-0.3,1-2,1.0-1.5,2.9-4.5,20-100,3,3.3-5.5,4-14,5-15,5-32,5.0,7-10,8-10,age,arrangement,color,connation,corolla,dehiscence,density,form,growth,height,history,inflorescence,interjected,lateral,leaflet,length,life,na,ovary,papillae,plant,pseudostipule,seed,shape,spacing,straightnes,terminal,texture,width
657	wfo-0001030814	success	223	137	106	117	31	0.475	0-0.3,0.1-0.2,0.1-0.3,0.3-0.6,0.4,0.5-1.5,1-4,1.5,1.5-2,15-20,3-5,5-15,5-8,5.5,6-15,7.5-11,acute,adaxially,almost,anther,apart,apex,appressed,ascending,asymmetric,attenuate,base,becoming,broadly,calyx,cm,connivent,cultivated,cylindrical,diameter,directly,distal,divided,elongate,elongating,essentially,flower,form,fruit,glabrescent,glabrous,globose,hair,inflorescence,lanceolate,lateral,length,lenticular,long,mature,midpoint,minutely,mm,much,narrower,obsolete,obtuse,often,oval,ovate,ovoid,pedicel,peduncle,perennial,petiole,pitted,pubescence,pubescent,ray,ripe,scattered,sericeous,sessile,short,shorter,simple,simple-,slightly,small,somewhat,soon,specimen,spreading,stellae,stellate,stellate-,stem,stigma,style,tan,thin-textured,trichome,truncate,tube,uniseriate,weakly,white,wide,x,yellow,young	-0.5,-1.5,-3.5,-4,.5,.5-3,0-0.2,1-2,1.8-3.5,1/8-1/3,10-12,10-25,14-15,15-16,16-30,2-3,2-foliate,23-31,3-7,4-,4-5,4-6,5,5-12,5-9,6-9,6-locular,7-11,abaxially,absent,acute-tipped,adaxiall,along,apiculate,articulated,axe,ba,basal,become,blade,branched,bulge,campanulate,capitat,capitate-glandular,coarsely,densely,dentate,depressed-deltoid,developed,diffusely,distall,divergently,eaf,eed,entire,extra-axillary,felty,female-sterile,filament,geminat,hirsute,immature,inserted,interlobal,intermixed,interwoven,invested,less,lignescent,lobe,lon,lower,major,margin,midvein,minute,nflorescence,obtuse-tipped,orolla,oung,ovate-lanceolate,per,pericarp,pore,prominent,rachi,replaced,rip,rounded,ruit,short-stalked,side,similar,simple-haired,sinus,sometimes,spaced,stalk,stellate-pubescen,stellate-pubescent,strongly,swollen,tal,tamen,termination,time,unarme,unarmed,unbranched,unit,unknown,usually,vary,vein,weak,ympodial	arrangement,bark,capitate,color,connation,corolla,dehiscence,diminishing,distally,growth,height,herb,history,interjected,leaf,leaflet,life,na,ovary,papillae,plant,pseudostipule,seed,shape,size,spacing,straightnes,surface,terminal,texture,tuber-bearing
658	wfo-0001030822	success	146	87	49	97	38	0.336	0.5-1.5,0.9-1,1.5-2,2-2.5,2-5,5-6,acute,anther,apex,attenuate,base,calyx,clavate,closely,cm,corolla,elliptic-obovate,flattened-reniform,fruiting,glabrous,globose,green,inflorescence,internodal,lateral,leaf,lobed,minutely,mm,ovary,pale,pedicel,petiole,pitted,poricidal,shiny,shrub,simple,size,spaced,stem,stigma,style,surface,tan,tip,tube,white,young	.2,0-0.5,0.1-0.2,0.4,0.4-1,0.8-1,1-1.2,1-1.5,11-15.5,2-3.8,3-3.5,3-5,3.5-7,5-7,8-9,abaxially,adaxially,anthesi,ba,beneath,berry,broadly,clustered,completely,cucullat,cucullate,cup,decurrent,deflexed,deltate,dia,differing,difoliate,eaf,edicel,eed,erect,exserted,filament,filiform,fleshy,flower,free,geminat,incrassate,inflorescenc,later,lobe,lon,long,long-ellipsoid,lower,main,major,margin,middle,minor,minute,near,nearly,nflorescence,occasionally,older,onto,open,opposite,pair,papillo,papillose,perhaps,planar,pore,portion,present,red-papillose,revolute,ruit,scar,shaped,slightly,somewhat,sparsely,strongly,tall,tapering,tear-drop,ud,unit,usually,vein,widest,winged,woody,x,yellowish,yellowish-brown,ympodial	alternate,arrangement,articulation,bark,color,connation,dehiscence,diameter,diminishing,distal,foetid,foliage,form,fruit,growth,height,history,interjected,leaflet,length,life,midpoint,na,papillae,peduncle,petiolule,plant,position,prickle,pseudostipule,seed,shape,spacing,straightnes,terminal,texture,trichome,tuber-bearing
659	wfo-0001030846	success	214	115	90	124	25	0.421	-0.8,-4,0.1,0.2-0.4,0.2-0.5,0.5-0.7,1-2,1-2-celled,1-3,1-4,1.5-2,10-15,2-10,2-3,5-15,anther,apart,articulating,assymetric,bark,base,beige,berry,branching,brown,brownish,calyx,clavate,cm,corolla,cuneate,curved,diameter,elliptic,erect,flattened,flower,fruit,fruiting,golden,growth,inflorescence,lateral,leaf,lengthening,lobed,midpoint,mm,multicellular,nearly,oblanceolate,obovate,opposite,ovary,ovate-elliptic,pedicel,peduncle,perfect,petiole,plant,poridical,porrect,prickle,pubescent,red,reniform,rhombic,rugose,rusty,scabrous,shrub,simple,slit,sparsely,stellate,stem,stigma,straight,style,subglobose,surface,time,tip,tomentose,trichome,tube,undulate-reticulate,white,x,young	-11,.3,0.1-0.3,0.8-1,1-1.2,1-1.5,1-2.5,1-multicellular,2.5-3,3-,3-3.5,3/4,4-4.5,4-5,4-6,5-8,6-18,6-8,8-10,abaxial,abaxially,acuminate,acute,adaxially,adult,angulate,anthesi,anthesisflower,antrorse,apex,apical,armed,basal,chartaceous,cream,dark-green,deciduous,decurrent,densely,discolorous,distal,eaf,eed,entire,exserted,ferruginous,filament,free,glabrescent,gland,glandular,glandular-viscous,grey,heterostylous,hirsute,juvenile,lanceolate,larger,like,linear,linear-lanceolate,lobe,long,long-styled,longer,lower,many,margin,midrib,mixture,much-branched,multiangulate,near,new,nflorescence,obliqu,oblong,obverse,ochraceous,older,oval,papillat,pendant,pericarp,persistent,plurifoliat,pore,portion,prickly,prominent,puberulent,pubescence,rachi,raised,ray,reddish,reflexed,relatively,rest,rotate,ruit,scar,sessile,short,short-styled,similar,slightly,sometimes,stalked,staminate,stipitate,terete,testa,thick,tomentose-velutinous,ud,unarmed,unit,upper,wide,without,yellowish,ympodial,¼	arrangement,articulation,color,connation,dehiscence,foetid,foliage,form,height,history,interjected,leaflet,length,life,na,papillae,position,pseudostipule,seed,shape,size,spacing,straightnes,terminal,texture
660	wfo-0001030850	success	240	133	101	139	32	0.421	/4,0-30,0.1-0.3,0.1-0.4,0.1-0.5,1-10,1-2,1-2.5,1-5,1-8,1.5,10-100,15-20,2-25,3-15,4,6-11,7-15,anther,apart,apex,articulated,bark,base,berry,bright,calyx,cell,chartaceous,climber,cm,connivent,cordate,cuneate,curved,densely,diameter,distal,elliptic,elongating,flattened,flattened-reniform,fruit,fruiting,gently,glabrescent,gray,lateral,leaf,length,lobed,long,mature,mauve,midpoint,mm,orange,orange-brown,outline,ovate,pale,pedicel,peduncle,petiole,pit,plant,poricidal,porrect,prickle,prickly,purple,raised,red-brown,red-orange,scandent,sessile,shrub,simple,small,smooth,sometimes,sparsely,spherical,stalked,stellate,stellate-pubescent,stem,straight,style,surface,tapering,terete,terminal,tip,trichome,truncate,tube,variously,wide,yellow,young	-6,.5,0-,0-0.5,0-40,0.1-0.2,0.2,0.5-2,00,1-,1-20,1-3,1-4,1.2,1.5-2.5,1/2,1/2-1/5,1/2-3/4,1/3,1/3-3/,1/3-3/4,10-20,2-15,2-3,2-4,2-6,3-10,3-3.7,3-4,3-5,3-6,3.5-6,4-8,5-10,5-12,5-13,5-merous,6-8,7-22,8-20,8.5-11.5,abaxial,abaxially,acuminat,acuminate,acute,adaxial,alyx,andromonoecious,apar,apically,apparently,blade,branched,broad-deltate,broadly,brow,cream,dark,deltate,difoliate,discolorous,distance,drying,eaf,eed,elongate,elongated,entire,equal,erect,extending,filament,flower,free,geminat,glabrous,green,green-brown,hermaphrodite,heterostylous,infructescence,lobe,lobing,long-styled,longer,lower,lowermost,margin,marking,maturity,midvein,moderately,nflorescence,oblong,obovate,obtuse,often,older,one,open,orolla,oung,pair,pendulous,per,pericarp,portion,prickl,primary,pubescent,ray,red-green,reduced,rounded,ruit,scar,secondary,short-styled,shorter,side,somewhat,spaced,spreading,stalk,staminat,stout,tamen,tertiary,time,unit,upper,vary,vein,venation,visible,way,woody,ympodial	arrangement,articulation,brown,color,connation,corolla,dehiscence,diminishing,foetid,foliage,form,growth,height,history,inflorescence,interjected,leaflet,life,na,ovary,papillae,petiolule,position,pseudostipule,seed,shape,size,spacing,stigma,straightnes,texture,tuber-bearing
661	wfo-0001030867	success	259	107	78	181	29	0.301	0.6-1.5,1-1.5,1-2.5,1-5,1.5-4.5,12-15,2-6,4-4.5,acute,anther,apart,apex,articulated,attenuate,bark,base,berry,branched,brown,calyx,chartaceous,cm,corolla,dark,diameter,distal,elliptic,expanded,fruit,fruiting,globose,greyish,growth,herbaceous,inflorescence,lateral,leaf,length,long,membranous,midpoint,mm,opposite,outline,ovary,ovoid,pale,pedicel,peduncle,pentagonal,petiole,plant,poricidal,prickle,reniform,shrub,simple,sinuate,size,slightly,somewhat,splitting,stellate,stem,stigma,style,subshrub,surface,tan,tapering,tip,translucent,trichome,tube,violet,white,yellow,yellowish	-1/3,-6,.25,.3,.5,0-,0.3,0.5,0.6,1,1-2,1.5,1/4,10,100,14,18,2-2.5,2-3,2-5,2.5-3,2.5-3.5,3-4,3-5,3.5-8.5,4,4-5,4-6,4.5-14,5-25,5-6,5-merous,6,6-7,<,>,abaxially,abundant,acumen,adaxially,alyx,andromonoecious,anthesi,approximately,area,armed,band,bi-lobe,borne,broad-based,bud,cast,cell,concolorous,cup-shaped,curve,curved,decurrent,densely,denser,difoliate,directed,distall,distance,dry,drying,eaf,easily,eed,either,ellipsoid,elongate,equal,erect,exposed,exserted,filament,flower,flowering,free,functionally,geminate,glabrescen,glabrous,greatest,green,halfway,hermaphroditic,heterostylous,immature,infructescence,internodal,interpetalar,lamina,larger,leathery,less,like,lobe,lobed,lon,long-styled,longer,lower,lowermost,mal,margin,markedly,mature,maturing,maturit,midrib,midvein,mottled,narrowly,near,new,nflorescence,nodding,occasionally,often,older,onto,orolla,pair,pendent,per,pericarp,petal,planar,pore,portion,prickly,primary,pubescent,ray,re,reflexed,rest,ruit,scar,sessile,shallowly,shap,short-stalked,short-styled,side,small,spaced,sparsely,stellate-pubescent,still,stouter,straight,strongly,tall,tamen,testal,thick,thickened,thinne,tissue,triangular,type,ud,unevenly,unit,upper,usually,vary,varying,vein,visible,way,whitish,wide,winged,woody,x,ympodial,¼	0-1-2,arrangement,articulation,bi-lobed,color,connation,dehiscence,diminishing,foetid,foliage,form,height,history,interjected,leaflet,life,na,papillae,petiolule,position,pseudostipule,seed,shape,spacing,straightnes,terminal,texture,tuber-bearing,young
662	wfo-0001030871	success	248	123	89	159	34	0.359	.2-3,0.2-0.4,0.3-4,1-18,2-3,2-8,2.8-4.5,3-32,30,4.5-6.5,5-33,abruptly,accrescent,acuminate,acute,anther,apart,apex,apical-lateral,articulated,attenuate,bark,base,becoming,berry,blunt-tipped,brown,calyx,cm,continued,corolla,dark,deltoid,diameter,distal,due,extend,fleshy,fruit,fruiting,greenish,growth,honeycombed,introrse,large,lateral,leaf,length,long,longitudinal,mm,mostly,narrowly,oblong,orbicular,ovate,pale,pedicel,peduncle,petiole,plurifoliate,pore,probably,purple,reniform,reticulate-punctate,ripe,rotate-stellate,scabridulous,short,shrub,slit,somewhat,stem,stigma,style,suborbicular,terminal,testa,tree,tube,unarmed,velutinous,violet,white,x,yellow,yellowish,young	.8-3.5,.9-1.2,/30-1/5,0-120,0.4-1.8,0.6-1.5,0.7-1.3,0.7-2.5,1-1.3,1.3-2,1.3-3,1.4-2.7,1.5-3,1.5-6,1.8-2.6,1.8-3.5,1/2,1/2-3/4,1/4,1/4-1/3,11,3-4.4,3-5,3-6,3.5-14,4.8-9.5,5-7,6-40,7-12,9-13,abaxially,adaxial,adaxially,ag,along,anthesi,apparently,appressed,appressed-tomentose,axe,axillary,ba,blade,branch,branched,bud,campanulate,capitat,chartaceous,closely,conical,decurrent,dehiscing,dendritic-echinoi,dendritic-echinoid,dendritic-multangulate,densely,directed,eaf,earl,early,echinoi,echinoid,eed,elliptic,elongate,entire,equal,erect,evident,exserted,filament,flower,free,glabrescen,glabrescent,glabrous,granular-tomentose,grayish,green,hair,held,high,inserted,lobe,lobed,long-,long-stalked,longer,lower,m.,main,margin,midvein,minute,mixed,multangulat,multangulate,nearly,nflorescence,nodding,obtuse,occasionally,often,older,open,orbicula,orolla,ovate-lanceolate,overlapping,partly,perfect,plait,porrect-stellate,present,prominent,pubescent,rachi,rather,ray,reflexed,relatively,ruit,runk,sessile,short-,short-stalked,side,simple,small,sometimes,soon,spaced,sparingly,sparsely,splitting,stamen,stellate-tomentose,striate,strongly,subglobose,sulcate,suture,tamen,terete,thick,thick-stalked,thin-stalked,time,tomentose,toward,unarme,unit,usually,vary,vein,way,wide,ympodial	age,arrangement,articulation,capitate,color,connation,dehiscence,diminishing,foetid,foliage,form,height,history,inflorescence,interjected,leaflet,life,na,ovary,papillae,petiolule,plant,position,prickle,pseudostipule,seed,shape,size,spacing,straightnes,surface,texture,trichome,tuber-bearing
663	wfo-0001030872	success	166	103	61	105	42	0.367	0.8-1,1-1.5,1-2,1.5-5,2-5,4-6,5.5-7,acuminate,acute,anther,apex,area,bark,base,black,broadly,brown,calyx,closely,cm,corolla,crateriform,dark,deflexed,difoliate,elliptic,erect,fruiting,glabrous,globose,green,leaf,minutely,mm,opposite,ovary,ovate,papillose,pedicel,petiole,poricidal,red-glandular-puberulent,reddish-glandular-puberulent,shaped,shining,simple,size,small,spaced,stem,stigma,straight,style,tear-drop,tip,tree,treelet,tube,unit,white,young	.5,0.5,0.5-1,0.8-2,1-1.2,1.2-1.5,1.2-3,1.5-2,12-18,3-7,4-6-flowered,5-6,6-12.5,adaxial,age,along,anthesi,appearing,beginning,berry,caly,center,closed,completely,consisting,corky,cucullate,darker,deltoid,densely,dia,dry,eaf,edicel,eed,ellipsoid-ovoid,exserted,filament,fleshy,free,full,geminat,glabrate,hooded,incurved,inflorescenc,known,large,lenticel,lenticellate,less,like,live,lobe,lobed,lon,long,lower,major,margin,material,middle,minor,nearly,nerve,nflorescence,oblique,older,one,overlapping,pair,pale,paler,petal,planar,pore,portion,primary,prominent,proximal,puberulent,raised,rather,reddish-glandular,relative,rest,ridge,rounded,ruit,scar,shorter,side,slightly,soon,specimen,strongly,styl,tall,tapering,thickened,ud,widest,woody,x,ympodial	arrangement,articulation,color,connation,dehiscence,diameter,diminishing,distal,foetid,foliage,form,fruit,geminate,growth,height,history,inflorescence,interjected,lateral,leaflet,length,life,midpoint,na,papillae,peduncle,perennial,petiolule,plant,position,prickle,pseudostipule,seed,shape,spacing,straightnes,surface,sympodial,terminal,texture,trichome,tuber-bearing
664	wfo-0001030877	success	223	101	66	157	35	0.296	0-5,0.1-0.6,0.1-1,0.5-1,0.7-1.4,1-2,5-11,6-11,7-9,7.5-10,absent,accrescent,anther,apex,articulated,base,broadly,calyx,chartaceous,cm,connivent,cuneate,diameter,extra-axillary,flattened,fruit,fruiting,globose,green,inflorescence,lanceolate,lateral,leaf,length,long,loosely,midpoint,minutely,mm,obtuse,ovate,pale,pedicel,peduncle,perennial,petiole,plant,present,prickle,pseudo-racemose,purple,ray,reticulate,rotate-stellate,shrub,simple,stem,stigma,style,surface,time,tube,unbranched,x,yellow,yellowish-green	%,0-0.2,0-0.5,0-10,0-15,0-4,0.1-0.4,0.2-0.6,0.3-0.4,0.4-0.5,0.4-0.8,0.5-0.6,0.5-0.8,0.7-1.6,0.9-1.2,1-1.3,1-1.4,1-1.5,1-3,1.5-2,1.5-2.4,1.5-3,1.8-2.6,10-14,10-30,10-40,17-26,2,2-15,2-3,2-3-locular,2-foliate,2.2-2.7,2.9-4.8,2.9-8,3-10,4-10,4-6,4-8,5,5-6,5-merou,6-12,6-15,6-9,8-14,8-15,8-9,9-14,9-15,abaxially,absen,abundant,acicular,across,acute,adaxially,adult,alyx,andromonoecious,anvil-shape,apart,ascending,attenuate,axe,ba,blade,branch,branche,brown,capitat,cross-section,cylindrical,densely,directed,distall,distributed,dm,dult,eaf,eed,eglandular,entire,erect,exocarp,filament,finger,flower,functional,geminat,glabrous,gland-tipped,hair,half,heterostylous,index,interpetalar,juicy,juvenile,lamina,less,lobe,lobed,lobing,longer,lower,margin,mature,mesocarp,mid-point,midrib,midvein,minute,moderately,moist,nflorescence,oblique,orolla,pair,part,per,placenta,pore,porrect,pubescent,rachi,rhizomatous,ruit,rusty,shallowly,short,side,spaced,sparsely,stalk,stalked,stellae,stellate,stellate-pubescent,straight,tal,tamen,thick,throughout,tissu,tissue,triangular,unarme,unarmed,unit,upper,vary,vein,weakly,wide,yellowish,ympodial	arrangement,articulation,bark,capitate,color,connation,corolla,dehiscence,diminishing,distal,foetid,foliage,form,growth,height,history,interjected,leaflet,life,na,ovary,papillae,petiolule,position,pseudostipule,seed,shape,size,spacing,straightnes,terminal,texture,trichome,tuber-bearing,young
665	wfo-0001030882	success	144	99	64	80	35	0.444	.5,0.5-1,0.5-1.1,0.9-1.1,1-1.5,1-4,3/4,accrescent,acuminate,anther,apex,attenuate,bark,base,calyx,capitate,closely,cm,conical,corolla,elliptic,fruit,fruiting,glabrous,globose,green,lateral,leaf,lobed,minutely,mm,narrowly,opposite,ovary,overlapping,ovoid-reniform,pale,papillose,pedicel,petiole,pitted,poricidal,shaped,shrub,simple,size,slightly,small,spaced,stem,stigma,straight,style,surface,tan,tear-drop,terminal,tip,tree,tube,way,white,woody,young	.1,0.5-0.75,0.75-1,0.8-1.1,0.8-2.4,1-1.3,1.6-2,2,2-5.4,2-6,2.2-4.6,3-3.5,6.5-15.6,8-12,?,anthesi,beginning,beneath,berry,crenulate,deflexed,deltoid,dia,differing,difoliate,eaf,edicel,eed,erect,exserted,extreme,filament,free,geminat,inflorescenc,lightly,lobe,lon,long,lower,main,major,margin,middle,minor,nearly,nflorescence,occasionally,older,one,ovoid,pair,paler,papillo,peelin,planar,pore,portion,prominent,raised,ruguse,ruit,scar,short,slender,soon,tall,tapering,thick,thickened,transversely,truncate,tub,ud,unit,vein,widest,x,yellowish,ympodial	arrangement,articulation,color,connation,dehiscence,diameter,diminishing,distal,foetid,foliage,form,growth,height,history,inflorescence,interjected,leaflet,length,life,na,papillae,peduncle,petiolule,plant,position,prickle,pseudostipule,rugose,seed,shape,spacing,straightnes,texture,trichome,tuber-bearing
666	wfo-0001030883	success	179	112	78	101	34	0.436	.05,.5,0.5-3,0.5-5,1-1.3,1-1.5,2-5,3/4,5-6,acuminate,acute,anther,apart,apex,bark,base,brown,calyx,clavate,cm,corolla,dark,dry,elliptic,fruit,fruiting,glabrous,glandular,globose,green,inflorescence,lateral,leaf,less,live,lobed,long,malodorous,massive,material,minute,minutely,mm,occasionally,opposite,ovary,ovate,ovoid-reniform,pale,papillate,pedicel,petiole,pitted,plant,poricidal,puberulent,quite,russet,seed,shaped,shrub,size,stem,stigma,stout,straight,style,surface,tan,tear-drop,thick,tip,trichome,tube,uniseriate,way,white,young	-3,.1,1-1.1,1-1.2,1-4,1.5-2,1.5-3.5,10-18,18-44.5,20-50-flowered,3-3.5,3-4,9.5-27.5,accrescent,across,anthesi,appearing,approximatately,arching,becoming,berry,branched,bu,cell,collapsed,collection,deflexed,dia,differing,difoliate,eaf,edicel,eed,epidermal,erect,evenly,filament,finely,fleshy,free,furcate,geminat,geminate,hard,hollow,imbedded,laminar,large,later,lenticellat,like,little,living,lobe,lon,long-acuminate,lower,main,markedly,middle,midrib,narrowly,nflorescence,oblique,older,pair,papillo,papillose,perpendicular,petaloid,placenta,pore,portion,present,proximal,pulp,rather,reflexed,reticulate,ruit,scar,slender,slightly,sometimes,soon,spaced,strongly,tall,tapering,time,triangular,two,ud,unit,upper,vein,wall,widest,woody,x,ympodial	alternate,arrangement,articulation,color,connation,dehiscence,diameter,diminishing,distal,foetid,foliage,form,growth,height,history,interjected,leaflet,length,life,midpoint,na,papillae,peduncle,perennial,petiolule,position,prickle,pseudostipule,shape,spacing,straightnes,terminal,texture,tuber-bearing
667	wfo-0001030884	success	218	126	96	122	30	0.44	0.4-3,0.5,0.5-1.2,0.8-1,0.9-5,1,10,2-5,5,5.5-7,6-8,9-11,abruptly,acute,along,anther,apex,articulated,bark,base,broad-based,brown,calyx,capitate,cm,connivent,curved,dark,decurrent,diameter,distal,elliptic,extend,fruiting,glabrous,green,greenish,growth,inflorescence,lateral,leaf,leafy,length,lobe,lobed,long,mature,midpoint,minutely,mm,moderately,node,onto,ovary,ovoid-reniform,pale,pedicel,peduncle,petiole,plant,poricidal,porrect,prickle,principal,pubescent,ray,red,reddish,reflexed,sagittate,sessile,short-stalked,shrub,simple,size,sparsely,spherical,stellate,stem,stigma,strongly,style,surface,tannish,tapering,tip,treelet,trichome,tube,usually,vein,white,wide,wing,yellow,young	.2,.5,.7,0.3,0.3-0.5,1-1.2,1-1.5,1-3,1.5,1.5-2,1.5-2.5,100,2,4-13,4-5,4.5-5,5-30,5-6,5-merous,6-10,6-25,7-8,>,abaxial,abaxially,adaxial,adaxiall,also,alyx,andromonoeciou,anthesi,apar,arme,basal,berry,blade,c.,conical,densely,di-,differing,directed,discolorous,eaf,eed,equal,extending,filament,flower,flowering,free,geminate,glandular,gray-tinged,gree,half,herbaceous,heterostylous,infructescence,like,long-stalked,long-styled,long-triangular,lower,magnification,margin,midrib,minute,mixture,new,nflorescence,occasionally,older,one,open,orolla,oung,outlin,pair,papillat,per,pore,portion,present,prickly,primary,reflexe,regularly,rest,ruit,scar,scattered,shallowly,shap,short,short-styled,similar,slender,spaced,spreading,stellate-pubescent,stiff,still,tall,tamen,time,trifoliate,unarmed,unicellular,uniformly,uniseriate,unit,upward,vary,varying,visible,way,weakly,winged,without,woody,ympodial	apart,arrangement,articulation,color,connation,corolla,dehiscence,diminishing,foetid,foliage,form,fruit,height,history,interjected,leaflet,life,na,papillae,papillate,petiolule,position,pseudostipule,seed,shape,spacing,straightnes,terminal,texture,tuber-bearing
668	wfo-0001030899	success	146	99	54	92	45	0.37	0.3-0.5,1-3,10-20,2,2-3,2-3.5,2.5-3.5,3-12,3-4,?,acuminate,apex,articulated,base,bronze,calyx,cm,connivent,cordate,deeply,densely,diameter,directed,ellipsoidal,end,extrorse,flattened,fruit,green,inside,mm,oblong,outside,ovate,pedicel,peduncle,petiole,puberulent,pubescent,purple,shrub,simple,slightly,splotch,stellate,stigma,stripe,style,tube,unbranched,upward,white,x,yellow	-45,.5-2,0.5,0.5-1,1,1-1.5,1-2,1-6,1.5-2,10-13,20-25,3-5,3-foliate,3.5-4,4-5,5-10,5-6.5,6.5-31,7-27,8-11,abaxially,absent,acute,adaxially,aggregate,apart,ape,axe,basal,beyond,blade,cell,chartaceous,connective,coriaceous,desc,dilated,distally,eaf,eed,entire,ex,exceeding,exserted,flower,glabrous,glandular-puberulent,globose,leaving,less,light,lobe,lon,long,lower,margin,mucronate,narrowly,nflorescence,nther,obconical,obtuse,orang,orolla,ovoid,pedicellar,peltifor,perfect,pore,presen,puberulen,rachi,radiu,remnant,ruit,shorter,spaced,stamen,stone,strongly,tal,tem,thecae,time,tomento,triangular,ud,unit,vary,vein,wide,ympodial	anther,arrangement,articulation,bark,color,connation,corolla,dehiscence,diminishing,distal,foetid,foliage,form,fruiting,growth,height,history,inflorescence,interjected,lateral,leaf,leaflet,length,life,na,ovary,papillae,peltiform,petiolule,plant,position,prickle,pseudostipule,seed,shape,size,spacing,stem,straightnes,surface,terminal,texture,trichome,tuber-bearing,young
669	wfo-0001030902	success	159	102	55	104	47	0.346	-20,-5,0.6-1.5,1-6,1.5-13,10-15,2-3,2-5,3-4,4,4-22,5-7,acuminate,angled,apart,apex,articulated,base,brown-pilose,calyx,cm,connivent,cordate,dark,diameter,ellipsoidal,flattened,forked,fruit,globose,long,mm,oblong,orange,ovate,pedicel,peduncle,petiole,pinkish,purple,purplish,reddish,simple,stellate,stigma,style,subcoriaceous,time,tree,truncate,tube,unbranched,wide,x,yellow	-2,0-15,1-2,1.5-,1.5-2,1.5-2.5,15-50,2,2.5,2.5-4,3-13,3-20,3.5-4,30-50,4-6,4-7,4-foliat,5-9,6-24,8-14,abaxially,absent,acute,adaxially,aggregate,along,ape,apically,apiculate,axe,basal,beyond,blade,branched,brow,cell,connective,cylindrical,deltate,densely,dilated,directed,distally,eaf,eed,eglandular,entire,equalling,exceeding,except,exserted,fleshy,flower,glabrat,glabrescent,glabrous,glandular,glandular-puberulen,hair,laterally,leaving,lobe,lon,lower,margin,mature,narrowly,nflorescence,nther,obtuse,occasionally,orolla,pedicellar,perfect,pore,presen,present,puberulence,rachi,radiu,rarely,remnant,ruit,shorter,slightly,small,somewhat,spaced,sparse,sparsely,stamen,stone,subcapitat,tal,tem,thecae,tip,tomento,triangular,ud,unit,vary,vein,ympodial	anther,arrangement,articulation,bark,color,connation,corolla,dehiscence,dense,diminishing,distal,foetid,foliage,form,fruiting,growth,height,history,inflorescence,interjected,lateral,leaf,leaflet,length,life,na,ovary,papillae,perennial,petiolule,plant,position,prickle,pseudostipule,seed,shape,size,spacing,stem,straightnes,subcapitate,surface,terminal,texture,trichome,tuber-bearing,young
670	wfo-0001030906	success	134	91	46	88	45	0.343	1,1-1.4,1.5-2.5,1/3-2/3,38,4-11,6-10,8-13,along,annual,anther,arcuate,base,blade,broadly,calyx,campanulate,cm,flattened-ovoid,foveolate,herb,internodal,lateral,length,long,long-stalked,main,minutely,mm,obtuse,ovate,pedicel,pentagonal,petiole,pinnatifid,prickle,prickly,rounded,seed,spherical,stellate-pubescent,stem,surface,tube,vein,yellow	1.0-1.4,2.0-2.6,2.3-3.5,40-80,6-8,7-12-flowere,7-16,9-12,accrescent,across,almost,alyx,ample,anthesi,armed,ascending,bearing,berry,branched,bristly,broad-based,cauline,da,densely,developing,dia,difoliate,divided,dry,eaf,essentially,exceeding,externall,faces,flat,geminat,glabrous,interpetalar,invested,linear,lobe,maturity,n,near,nearly,nflorescence,numerous,often,orolla,partly,per,pinnatisect,plicate,prickl,purple,purpli,red,ruit,sessil,short,slender,slightly,sometimes,somewhat,splitting,spreadingly,stellae,stellate-tomentose,strait,subulate,suffused,tamen,taprooted,throughout,tightly,tigma,tissue,tub,twice,tyle,ultimate,undulate,unexpande,unit,usually,vary,yello,ympodial	apex,arrangement,articulation,bark,color,connation,corolla,dehiscence,diameter,diminishing,distal,foetid,foliage,form,fruit,fruiting,growth,height,history,inflorescence,interjected,leaf,leaflet,life,midpoint,na,ovary,papillae,peduncle,petiolule,plant,position,pseudostipule,shape,size,spacing,stigma,straightnes,style,terminal,texture,trichome,tuber-bearing,unexpanded,young
671	wfo-0001030914	success	186	117	87	99	30	0.468	/4,0.1-0.5,0.7-1,1-1.5,1-2,1.5-3,1.5-8,2-10,7-8,acute,along,anther,apex,attenuate,bark,base,beneath,calyx,campanulate,capitate,closely,cm,corolla,dark,distal,dry,elliptic,erect,evenly,furcate,glabrous,globose,golden,green,inflorescence,lateral,leaf,lemon-yellow,length,lobed,long,long-styled,many,minutely,mm,narowly,obovate,occasionally,ovary,ovoid-reniform,pale,papillose,pedicel,petiole,pitted,plant,poricidal,puberulent,reddish-brown,ripe,shape,shaped,short-styled,shrub,simple,size,small,spaced,specimen,stem,stigma,straight,style,surface,tan,tear-drop,time,tip,tree,trichome,tube,uniseriate,usually,vein,way,white,young	.1,.5,0-0.25,0.5-1,0.8-1,0.8-1.3,1.2-1.5,1.5-2,2-2.5,2.5-11,2.5-3,3-4,3.5-17,5-17,5-25-flowered,7-10,9-35,anthesi,berry,blade,bud,constriction,decurrent,deflexed,deltoid,densely,dia,differing,difoliate,eaf,edicel,eed,ellipsoid,equal,even,exserted,filament,flower,free,fruiting,geminat,glabrate,greyish-brow,individual,later,like,live,lobe,lon,lower,main,major,margin,middle,minor,nflorescence,often,older,one,onto,opposite,otherwise,overlappin,pair,papillo,planar,pore,portion,prominent,pubescent,quite,raised,rest,rounded,ruit,scar,slender,slightly,sometimes,soon,sparsely,tall,tapering,thick,third,ti,trunk,tub,ud,unit,variable,weight,widest,winged,within,woody,x,yellow,ympodial	alternate,arrangement,color,connation,dehiscence,diameter,diminishing,foetid,foliage,form,fruit,greyish-brown,growth,height,history,interjected,leaflet,life,na,overlapping,papillae,peduncle,pseudostipule,seed,spacing,straightnes,terminal,texture,tuber-bearing,unripe
672	wfo-0001030918	success	230	166	130	100	36	0.565	-4.5,-40,.7,0-20,0.1,0.25-0.45,0.5-2.5,0.6,0.6-2.5,0.7-1.2,0.7-1.7,1,1-1.5,1-2,1-4,1/2-2/3,1/3-1/2,2-10,2-25,2-7,3-15,3-6.5,5-8,6-8,acicular,acute,anther,apart,apex,apparently,articulated,bark,base,berry,branched,calyx,cell,chartaceous,cm,connivent,curved,dark,diameter,discolorous,drying,dull,elliptic,elongated,elongating,evenly,flattened,flattened-reniform,fruit,fruiting,glabrescent,glabrous,green,green-brown,infructescence,lateral,leaf,length,lobed,long,lower,mature,maturity,mauve,midpoint,mixture,mm,moderately,obtuse,occasionally,orange,orange-brown,outline,pale,pedicel,peduncle,per,perpendicular,petiole,pit,poricidal,porrect,prickle,prickly,pubescent,purple,raised,ray,red,red-brown,reduced,reflexed,seed,sessile,shrub,simple,slender,small,smooth,sometimes,somewhat,spaced,sparsely,spherical,spreading,stalk,stalked,stellate,stellate-pubescent,stem,straight,strongly,style,surface,tapering,terete,terminal,tip,trichome,tube,usually,way,weakly,wide,yellow,young	-12,-2.3,-3.2,-4,-5,-6,-9,.5,0-10,0-25,0-4,0-6,0.1-0.25,0.2-0.4,0.3-1.5,0.5-0.7,0.5-2,1-1.8,1.5-2,1.5-2.5,1.5-5.5,1/2-3/4,1/3,1/3-,1/4-1/3,2-2.5,2-3,2-4,2-8,2.8-3,2/,3-4,3-7,3.5-6,4-7,5-7,5-merous,5.5-7,7-10,abaxial,abaxially,adaxial,alyx,ame,apar,apically,blade,brow,c.,caudat,cuneate,deltate,densely,difoliate,distance,eaf,equal,erect,extending,faint,filament,flower,free,geminat,lobe,lobing,longer,margin,midvein,narrow-deltate,nflorescence,oblong,older,one,open,orolla,oung,pair,pendulous,perfec,pericarp,portion,prickl,primary,ruit,scandent,scar,secondary,side,tamen,tertiary,time,unit,upper,vary,vein,venation,visible,woody,ympodial	2/3,arrangement,articulation,brown,color,connation,corolla,dehiscence,diminishing,distal,foetid,foliage,form,growth,height,history,inflorescence,interjected,leaflet,life,na,ovary,papillae,perennial,petiolule,plant,position,present,pseudostipule,shape,size,spacing,stigma,straightnes,texture,tuber-bearing
673	wfo-0001030919	success	219	136	93	126	43	0.425	12,2,5-merous,abaxial,accrescent,acute,adaxial,anther,apart,apex,apparently,articulated,asymmetrical,attenuate,base,branched,brown,calyx,chartaceous,cm,connivent,coriaceous,covering,densely,diameter,elliptic,entire,extra-axillary,flower,fruit,fruiting,glandular,globose,green,hair,incompletely,interpetalar,lateral,leaf,length,like,linear-lanceolate,longitudinal,margin,mm,moderate,moderately,multicellular,narrowly,obtuse,often,opening,orange,ovate,pedicel,peduncle,petiole,pinnate,plant,prickle,protrusion,pubescent,reddish,reniform,roselike,rugose,scandent,shrub,simple,slightly,slit,small,stellate,stellate-pubescent,stem,stigma,style,subopposite,surface,tan,tapering,tissue,triangular-ovate,tube,twice,unbranched,uniseriate,venation,white,whitish,yellow,young,×	.2–0.4,.2–0.6,0.1–0.2,0.1–0.3,0.3–0.6,0.5–1,0.5–1.5,0.5–3,1.2–2,1.5,10–13,10–14,10–20,12–16,12–18,1971,1–2,1–3,2.5,25–50,2–3,2–4,2–8,3,3–4,3–6,3–8,4–7,4–8,5–10,5–7,5–8,7–10,7–11,8–12,abaxially,absent,adaxially,alyx,andromonoecious,anthesi,armed,axe,ba,berry,beyond,blade,capitat,connected,cordate,cylindrical,directed,discolorous,distally,eaf,eed,exserted,festooning,filament,flattened,frui,functionally,fused,glabrou,glabrous,hard,hermaphroditic,horizontal,introrsely,lobe,lobed,long,lower,male,maturity,midpoint,midrib,midvein,multiseriate,nearly,nflorescence,notch,occasionally,older,orolla,partially,per,perfec,petiolate,placenta,plurifoliat,pore,porrect-stellate,positioning,proximally,rachi,ray,recurved,reflexed,roe,ruit,rusty,secondary,see,shortly,side,spaced,sparsely,spine,stalk,stamen,ste,subsessile,swollen,tal,tamen,tem,terminology,triangular,unarmed,unicellular,unit,vary,vein,wide,ympodial	0.5-1.5,0.5-3,1-3,10-20,2-3,2-4,4-7,7-11,arrangement,articulation,bark,capitate,color,connation,corolla,dehiscence,diminishing,distal,foetid,foliage,form,growth,height,history,inflorescence,leaflet,life,na,ovary,papillae,perfect,petiolule,position,recurrved,seed,shape,size,spacing,straightnes,terminal,texture,trichome,tuber-bearing
674	wfo-0001030921	success	185	115	83	102	32	0.449	0,0.4-0.5,1-3,2-2.5,2-3,2-6,3-4,3-5,4-10,6-7,acuminate,acute,anther,apart,apex,appressed,articulated,asymmetric,bark,base,berry,brown,calyx,campanulate,cm,corolla,corymbose,curved,cyme,deep,diameter,distal,elliptic,flattened,fruit,fruiting,globose,green,growth,inflorescence,internodal,lanceolate-elliptic,liana,linear-lanceolate,lobed,long,mm,nearly,ovary,pedicel,peduncle,petiole,poricidal,porrect,porrect-stellate,prickle,purple,ray,recurved,reddish,reniform,reticulate-undulate,rugose,scabrous,sessile,sparse,stellate,stem,stigma,straight,style,subequal,subtruncate,surface,tapering,tip,trichome,tube,violet,white,woody,yellowish,young	.5,1-1.2,1-1.5,1-2,1/3,10,3-3.5,3.5-5,4-6,7-8,9-15,abaxially,adaxially,anthesi,antrorse,armed,basal,branched,caly,channelled,compressed,congested,coriaceous,deeply,densely,diamete,discolorous,eed,elongating,entire,erec,erect,exceeding,exserted,filament,flower,free,glabrescent,glabrous,grey,half,hermaphroditic,heterostylous,included,like,lobe,long-styled,longer,lower,many,margin,midpoint,minute,multicellular,near,new,nflorescence,oblong,obverse,older,one,ovoid-conical,partially,perfect,pericarp,plurifoliateleaf,pore,portion,prickly,puberulent,pubescence,pubescent,raise,reduced,reflexed,ruit,rusty,scar,short-styled,shorter,shrub,slightly,slit,spaced,sparsely,staminate,stellate-pubescent,strongly,subspherical,terete,testa,time,tomentose,triangular,ud,unevenly,unicellular,unit,upper,velutinous,x,ympodial	arrangement,articulation,color,connation,dehiscence,diminishing,foetid,foliage,form,height,history,interjected,lateral,leaf,leaflet,length,life,na,papillae,petiolule,plant,plurifoliate,position,pseudostipule,seed,shape,size,spacing,straightnes,terminal,texture,tuber-bearing
675	wfo-0001030941	success	259	123	94	165	29	0.363	-1.5,.2-0.8,.5-5,0.02-0.4,0.04-0.08,0.1-0.3,1-9,1.3-2.5,10,10-25,2-5,3-4.5,3.5-10,4-6,6-22,7-23,9,abaxially,acuminate,adaxially,along,anther,apart,apex,apical-lateral,bark,base,becoming,blunt-tipped,brown,calyx,cm,color,continued,corolla,decurrent,deltoid,diameter,due,elliptic,entire,extend,flower,fruit,globose,gray,growth,honeycombed,introrse,large,lateral,leaf,length,long,long-attenuate,longitudinal,minutely,mm,moderately,mostly,narrowly,nearly,oblong,obovate,obtuse,pale,pedicel,peduncle,petiole,pore,porrect-stellate,pubescent,reticulate-punctate,ripe,scabrous,short,shrub,simple,slit,small,stelliform,stem,stigma,style,suborbicular,subreniform,terminal,testa,tree,tube,white,x,yellow,yellowish	-16,-4,-6,.01-0.3,.03-0.25,.04-0.1,.04-0.12,.04-0.22,.04-0.4,/50-1/15,0-100,0.01-0.22,0.02-0.04,0.02-0.06,0.02-0.25,0.02-0.3,0.03-0.05,0.03-0.06,0.03-0.6,0.04-0.1,0.04-0.35,0.04-0.5,0.04-0.6,0.06-0.35,0.06-0.42,0.07-0.4,0.08-0.35,0.08-0.5,0.5-1.5,0.8-1.1,0.8-1.3,1-1.4,1.1-1.3,1.1-1.7,1.1-2.8,1.2-2.1,1.2-2.2,1.3-4.5,1.4-1.6,1.4-3.5,1.5-3.5,1.5-4.5,1/3-1/2,2-3.2,2-3.3,3-5,3/4,4-12,4-8,4-9,5-9,5-merou,6-10,6-9,7-10,absen,accrescent,acute,ag,alyx,anthesi,apparently,appressed-tomentose,articulated,axe,axillary,berry,blade,branch,branched,bud,campanulate,chartaceous,conical,darker,dehiscing,dense,densely,directed,eaf,eed,ellipsoid,exserted,few-rayed,filament,fleshy,free,fruiting,glabrescent,glabrous,glandular,hair,high,inserted,lanceolate,less,lobe,lobed,lon,longer,lower,m.,main,margin,midpoint,midvein,mixed,multangulat,multangulate,multiseriate,nflorescence,obscured,occasionally,often,older,orolla,ovate,ovoidal,perfect,plurifoliate,porrect-stellat,rachi,rarely,rather,ray,ruit,runk,scabridulous,sessile,short-stalked,side,sometimes,somewhat,spaced,sparingly,sparse,sparsely,stalk,stamen,stipitate-glandular,strongly,subcapitat,subcoriaceous,suture,tamen,terete,thick,thick-stalked,time,tomentose,tomentu,touching,toward,triangular,unarme,unarmed,unit,usually,vary,vein,way,weakly,wide,ympodial,young	absent,age,arrangement,connation,dehiscence,diminishing,distal,form,height,history,inflorescence,interjected,leaflet,life,na,ovary,papillae,petiolule,plant,pseudostipule,seed,shape,size,spacing,straightnes,subcapitate,surface,texture,tuber-bearing
676	wfo-0001030943	success	167	105	69	98	36	0.413	1-1.2,1-1.5,1.8-2.2,1/2,12-15,2-6,3/4,4-6,acuminate,acute,age,anther,apex,bark,base,becoming,bi-lobed,calyx,cm,corolla,diameter,echinoid,elliptic,flattened,fruiting,globose,golden,golden-yellow,growth,lateral,leaf,lenticular,lobed,long,minutely,mm,narrowly,ovary,overtopping,pale,pedicel,petiole,pitted,plurifoliate,pore,poricidal,pubescent,purplish-black,reddish-brown,shoot,shrub,slit-like,small,stem,stigma,style,surface,terminal,tip,tree,tree-like,trichome,tube,violet,way,wide,yellow,yellowish-white,young	.5,0,0.5-1,0.5-3,1.1,1.5-2,10-25,3,3-4,4-4.5,4-5,7-13.5,7-8,8-10,abaxial,abaxially,absent,adaxial,adaxially,along,anthesi,apical,basal,belo,berry,black,branch,branching,conical,cupulate,dark,decurrent,deflexed,dendritic,densely,denser,drying,eaf,edicel,eed,elongate,erect,ew,exserted,fide,filament,flower,free,glabrat,glabrous,horizontal,im,inserted,large,lobe,lon,lower,m.,main,minute,monochasia,nflorescence,nodding,often,older,outline,pair,papillo,pearce,per,pericarp,planar,portion,raised,ruit,scar,scattered,secondary,showy,sleeve,slightly,somewhat,sparsely,stamen,strongly,tall,tapering,thin,time,triangular,tub,ud,unit,upper,vein,woody,x,ympodial	arrangement,articulation,color,connation,dehiscence,diminishing,distal,foetid,foliage,form,fruit,glabrate,height,history,inflorescence,interjected,leaflet,length,life,midpoint,na,papillae,papillose,peduncle,petiolule,plant,position,prickle,pseudostipule,seed,shape,size,spacing,straightnes,texture,tuber-bearing
677	wfo-0001030959	success	164	111	73	91	38	0.445	.05,.2,.8,0.5-1.5,0.7-1.2,1-10,1-7,10-15,2-4,2.5-5,4-6,4-8,5-9,almost,ame,anther,apart,apex,apparently,articulated,bark,base,branched,brown,c.,cm,color,connivent,cuneate,curved,diameter,elliptic,fresh,gently,glabrous,glandular,hair,inflorescence,known,lateral,leaf,length,long,long-acuminate,membranous,midpoint,minute,mm,pedicel,peduncle,perpendicular,petiole,poricidal,porrect,present,prickle,ray,sessile,shrub,simple,spaced,stellate,stem,straight,straw,style,surface,tapering,tip,trichome,tube,wide,yellow	/5,0.5,1-2,1.2-1.8,1.5-2,1.5-3.5,1/5-1/10,2.5-4,2.5-4.5,5-6,5-merous,6-8,9-12,abaxially,alyx,apar,apically,armed,blade,brown-green,concolorous,deltate,densely,difoliate,distributed,drying,eaf,eed,equal,erect,evenly,filament,flower,free,geminat,glabrescent,glabrou,green-brow,know,less,like,lobe,lobed,long-acuminat,longer,lower,margin,narrow-deltate,nflorescence,numerous,older,one,open,orolla,oung,pair,part,perfec,portion,prickl,prickly,primary,prominent,ruit,scar,scrambling,secondary,several,short,side,slender,sparsely,spreading,stellate-pubescent,subentire,tamen,terete,tertiary,time,toward,unarmed,unit,usually,vary,vein,venation,visible,way,whole,ympodial,youngest	arrangement,articulation,calyx,connation,corolla,dehiscence,diminishing,distal,foetid,foliage,form,fruit,fruiting,green-brown,growth,height,history,interjected,leaflet,life,na,ovary,papillae,perennial,petiolule,plant,position,pseudostipule,seed,shape,size,spacing,stigma,straightnes,terminal,texture,tuber-bearing,young
678	wfo-0001030982	success	215	116	86	129	30	0.4	0.05,0.05-0.5,0.1-0.15,0.2-3,0.5,0.5-0.9,0.5-1,1.5,6-8,acute,anther,apex,appressed,base,berry,broadly,brown,brownish,calyx,capitate,closely,cm,conic,corolla,cuneate,curved,diameter,dry,drying,elliptic,flattened-reniform,foliage,form,fresh,fruit,fruiting,glabrescent,glabrous,globose,green,growth,leaf,less,lobed,long,material,maturity,minutely,mm,opposite,ovary,ovate,packed,pale,papillae,papillate,papillose,pedicel,peduncle,petiole,pitted,plant,poricidal,pubescent,reddish,reflexed,rhizomatous,sagittate,seed,sigmoidally,simple,size,sparsely,stem,stigma,straight,style,subshrub,surface,tightly,tip,trichome,tube,uniseriate,white,young	-2-2.5,.1,.2,.5,0.1,0.3-2,0.5-3,1,1-1.5,1-8,1.5-2,1.5-3,2/3,3-21,3-8,4-12,4-5,abaxially,acuminate,adaxially,age,angular,anisophyllous,anthesi,ape,ba,beneath,bud,caducous,central,channelled,chartaceous,ciliate,conical,cream,cucullate,dark,deflexed,deltate,differing,difoliate,distall,distally,distichou,eaf,edicel,eed,ellipsoid,enlarged,entire,exerted,extension,external,filament,fleshy,flower,free,geminate,glandular,glandular-papillose,golden-green,greenish,hilum,impressed,inconspicuously,internal,isostylous,larger,later,lengthening,like,live,lobe,lower,major,margin,materia,midvein,minor,mostly,near,new,nflorescence,oblique,obovate,occasionally,often,olive,one,overlappin,pair,papillat,planar,pore,portion,primary,projection,prominent,prominently,puberulent,rest,revolute,ruit,scar,separated,shoot,sinuate,situated,slightly,slit,somewhat,stamen,stripe,strongly,testa,tetramerous,time,transverse,tub,ud,unit,vegetative,vein,veined,way,weakly,x,yellowish,ympodial	arrangement,articulation,bark,color,connation,dehiscence,diminishing,distal,distichous,foetid,height,history,inflorescence,interjected,lateral,leaflet,length,life,midpoint,na,petiolule,position,prickle,pseudostipule,shape,spacing,straightnes,terminal,texture,tuber-bearing
679	wfo-0001030989	success	177	144	107	70	37	0.605	.5,0.5-1,1-10,1-2,12-15,2-3.5,3-4,3-5.5,3-7.5,4-5,4-7,4-8,5,5.5-7.9,6-13,9-10,abaxially,acuminate,adaxially,anther,apart,apex,articulated,axillary,base,berry,brownish,bud,cell,chartaceous,cm,condition,conical,connivent,corolla,covering,decreasing,densely,diameter,distal,drying,forked,fresh,fruit,generally,gradually,green,green-white,greenish,hair,hair-like,half,herb,interjected,lanceolate,lateral,leaf,leaflet,lengthening,light,like,long,make,minute,mm,mucilaginous,obtuse,odd-pinnate,orbicular,ovate,ovate-lanceolate,ovoid,pedicel,peduncle,petiole,petiolule,plant,pore,poricidal,proximal,pubescent,ripe,rotate,seed,semierect,size,slit,sparsely,stem,stigma,style,subequal,subsessile,subtending,terminal,testal,thick,throughout,tip,toward,tube,violet,wall,wet,whitish,x,yellow	1-1.5,15-27.5,3-20,5-merou,6-6.5,ag,alyx,apparently,axe,blade,capitat,ciliate,digestion,dorsally,eaf,edge,eed,end,enzyme,erec,especially,filament,flat,flower,folded,geminat,glabrou,glabrous,homostylous,honeycomb-shaped,larger,living,lobe,lower,margin,nflorescence,occurring,orolla,pair,pale,perfect,plurifoliate,present,pubescen,ray,removed,ruit,secondary,seudostipule,singly,spaced,specimen,ste,stolo,symmetrical,tall,tamen,tem,thir,tri-,triangular,tuber,typically,unit,unwinged,usually,vary,wide,wider,ympodial	age,arrangement,articulation,bark,calyx,capitate,color,connation,dehiscence,diminishing,erect,foetid,foliage,form,fruiting,growth,height,history,inflorescence,length,life,na,ovary,papillae,position,prickle,pseudostipule,shape,spacing,straightnes,surface,texture,third,trichome,true,tuber-bearing,young
680	wfo-0001030991	success	204	115	80	124	35	0.392	0.5,0.5-1.5,0.7-1.2,1-1.5,1-2.2,1-2.5,9-11,absent,acuminate,acute,along,anther,apex,apparently,articulated,attenuate,base,brown,calyx,capitate,cm,color,connivent,corolla,diameter,ellipsoidal,elliptic,flattened,fruiting,furcate,glabrous,globose,grey,growth,herb,inflorescence,lanceolate,lateral,leaf,lobed,loosely,minutely,mm,narrowly,nearly,occasionally,pedicel,peduncle,petiole,pinnatifid,pitted,poricidal,red,reniform,ripe,scattered,short,shrub,simple,sleeve,small,somewhat,spreading,stellate,stem,stigma,style,suffrutescent,surface,terminal,tip,trichome,tube,uniseriate,variably,violet,white,winged,yellowish,young	.5,0,0.1,0.2,0.2-0.7,0.3-0.4,0.5-0.7,0.5-1,0.5-3.5,0.6-0.8,1-1.6,1-7,1.5,10-20,2-plurifoliat,2.5-10,2.5-3,2/3,3-,3-5-lobed,4-10,5-5.5,5-merou,<,abaxially,adaxiall,adaxially,ag,alyx,angled,anthesi,appressed,arising,ark,ascending,basal,berry,bulbous,cell,conical,densely,different,distally,drying,eaf,eed,ellipsoid,elongate,enlarged,entire,exerted,eye,filament,filiform,flower,free,frui,fusiform,glabrescen,ilament,incised,leaf-opposed,leave,lengthening,less,like,lobe,long-triangular,lower,margin,midrib,minute,new,nflorescence,nodding,often,older,orolla,outline,packed,pair,papillo,part,particularly,pendant,per,perfect,pericarp,platfor,pointing,pore,portion,primary,pseudoumbel,pubescent,rectangular,reflexed,rest,rootstoc,ruit,scar,shallowly,shiny,slightly,slit,sparsely,strongly,tangled,tem,testal,thin,tightly,twinin,ud,uniformly,unit,upper,vary,vein,weak,weight,woody,x,ympodial	arrangement,articulation,bark,connation,dehiscence,diminishing,distal,foetid,foliage,form,fruit,glabrescent,height,history,interjected,leaflet,length,life,midpoint,na,ovary,papillae,papillose,petiolule,plant,position,prickle,pseudostipule,seed,shape,size,spacing,straightnes,texture,tuber-bearing
681	wfo-0001031005	success	231	130	101	130	29	0.437	.5,/3-1/2,0-0.5,0.1,1,1-1.5,1-2,1-2.5,1-3,1.5-4,2-3.2,2.5,3-4,3-6.5,6-12,accrescent,acuminate,acute,almost,anther,anthesi,apex,articulated,attenuate,bark,base,berry,black,blue,brachyblast,branch,branched,brown,calyx,capitate,chartaceous,clustered,cm,corolla,curved,dark,dendritic,developing,diameter,drying,elliptic,equal,extending,eye,form,fruit,fruiting,increasing,lateral,leaf,length,liana,lobe,lobed,long,longitudinally,membranous,mm,naked,oblong,obovate,occasionally,older,orange-brown,ovoid,pedicel,peduncle,petiole,poricidal,purple,ray,ridged,seed,short,slender,smooth,sometimes,somewhat,sparsely,spread,stem,stigma,strongly,style,surface,terminal,thick-chartaceous,tip,toward,trichome,tube,unarmed,visible,white,x,young	.4,0.3-0.5,0.5-1.5,0.8,0.9,1.5-2.5,10,2.3-3,2.5-4,3-10,4-6,5,5-7,5-8,5°,abaxial,abaxially,adaxially,age,along,alyx,apar,apically,apparently,branching,clearly,clum,common,concolorous,conical,cupular,datum,deeply,delineated,deltoid,dendritic-pubescent,denser,density,detaching,dilated,discolorous,divided,domatia,eaf,ellipsoi,elongated,entire,evenly,fertilisation,filament,fine,flat,flattened,flexuous,flower,forming,free,glabrous,greenish,immature,inside,junction,known,leave,lengthening,like,linear,loop,lower,m.,main,margin,midvein,minute,much,network,nflorescence,nther,obscure,occasional,often,onl,orolla,ou,outside,ovate,pair,pendulous,perfec,pericarp,plurifoliat,pointed,pore,portion,primary,prominent,protruding,pubescent,rachi,raised,region,rest,ruit,scar,secondary,side,simple,smaller,smoot,soon,spreading,standing,stump,surrounding,tangling,tearing,terete,tertiary,thin,ud,uneven,unit,usually,vary,vein,venation,weakly,well-developed,wide,ympodial	apart,arrangement,articulation,color,connation,dehiscence,diminishing,distal,foetid,foliage,growth,height,history,inflorescence,leaflet,life,na,ovary,papillae,petiolule,plant,position,prickle,shape,size,spacing,straightnes,texture,tuber-bearing
682	wfo-0001031007	success	207	110	71	136	39	0.343	0.5-10,1,1-1.5,1-3.5,1.2-1.5,15,6,7-10,acute,along,anther,apex,articulated,base,berry,bifid,black,brown,calyx,capitate,cm,connivent,corolla,cuneate,dendritic,diameter,elliptic,extending,flattened-reniform,fruit,fruiting,glabrous,globose,growth,inflorescence,lamina,lax,lilac,long,loose,loosely,lower,margin,minutely,mm,narrowly,occasionally,pedicel,peduncle,petiole,pitted,poricidal,reddish,sagittate,shrub,simple,stellate,stellate-pentagonal,stem,stigma,style,surface,tangled,terminal,tip,trichome,tube,vein,vine,woody,yellow	.5,0.2,0.5,0.5-1,0.75-1.5,1-1.2,1.3-,1.5-2,1.6-2,1.9-3,1/3,11-14,2.5-,2.5-5,3-4,4-6,4-7,4.5-5,5,5-12,5-merou,5.5-6,50-100,8-10,<,abaxiall,abruptly,ag,alfway,almost,alyx,anthesi,apar,apparently,ark,becoming,beginning,branched,branching,broad,broadly,c.,campanulate,cell,chartaceous,clustered,completely,cup-shaped,dark,deltate,densely,dilated,drying,dull,eaf,eed,ellipsoid,entire,exserted,filament,fleshy,flower,free,geminat,glabrescen,glabrou,herbarium,ilament,impressed,intramarginal,irregularly,junction,leaving,lengthening,lobe,lobed,looping,m.,many,markedly,matte,midvein,multi-celled,narrowing,near,new,nflorescence,nodding,often,older,orolla,outline,pale,papillat,papillate,peg,per,perfect,pericarp,planar,plurifoliate,pore,portion,primary,prominent,pubescent,rat,revolute,round-rectangular,ruit,scar,shiny,sleeve,slender,slightly,slit,spaced,sparsely,specimen,splitting,spreading,stout,strongly,testal,thin,time,tiny,twining,ud,unit,upper,usually,vary,way,x,ympodial	apart,arrangement,articulation,bark,color,connation,dehiscence,diminishing,distal,foetid,foliage,form,glabrescent,height,history,interjected,lateral,leaf,leaflet,length,life,midpoint,na,ovary,paler,papillae,petiolule,plant,position,prickle,pseudostipule,seed,shape,size,spacing,straightnes,texture,tuber-bearing,young
683	wfo-0001031007	success	206	110	72	134	38	0.35	0.2,0.5-10,1,1-1.5,1-3.5,1.2-1.5,15,5,6,7-10,<,acute,anther,apex,articulated,bark,base,berry,bifid,black,broad,brown,calyx,capitate,chartaceous,cm,corolla,cuneate,cup-shaped,dendritic,diameter,elliptic,flattened,fleshy,fruit,fruiting,globose,growth,inflorescence,lax,lilac,long,loose,margin,minutely,mm,narrowly,papillate,pedicel,peduncle,petiole,pitted,poricidal,reddish,reniform,sagittate,shrub,simple,stellate,stellate-rotate,stem,stigma,style,surface,tall,tangled,terminal,tip,trichome,tube,vine,woody	.5,0.5,0.5-1,0.75-1.5,1-1.2,1.3-,1.5-2,1.6-2,1.9-3,1/3,11-14,2.5-,2.5-5,3-4,4-6,4-7,4.5-5,5-12,5-merou,5.5-6,50-100,8-10,abaxially,abruptly,adaxial,ag,alfway,almost,along,alyx,anthesi,apar,apparently,becoming,beginning,branched,branching,broadly,c.,campanulate,cell,clustered,completely,dark,deltate,densely,dilated,drying,dull,eaf,eed,ellipsoid,entire,exserted,extending,filament,flower,free,glabrescen,glabrou,glabrous,herbarium,ilament,impressed,intramarginal,irregularly,junction,lamina,leaving,lengthening,lobe,lobed,looping,lower,m.,many,markedly,matte,midvein,multi-celled,narrowing,near,new,nflorescence,nodding,occasionally,often,older,orolla,outline,pale,papillat,peg,per,perfect,pericarp,planar,plurifoliat,pore,portion,primary,prominent,pubescent,rat,revolute,round-rectangular,ruit,scar,shiny,sleeve,slender,slightly,slit,spaced,sparsely,specimen,splitting,spreading,stout,strongly,testal,thin,time,tiny,twinin,ud,unit,upper,usually,vary,vein,way,wide,ympodial	apart,arrangement,articulation,color,connation,dehiscence,diminishing,distal,foetid,foliage,form,glabrescent,height,history,interjected,lateral,leaf,leaflet,length,life,midpoint,na,ovary,paler,papillae,petiolule,plant,position,prickle,pseudostipule,seed,shape,size,spacing,straightnes,texture,tuber-bearing,young
684	wfo-0001031022	success	287	125	98	189	27	0.341	0.3–0.8,0.5–5.8,0.6–1.2,0.6–1.6,0.8–3.4,0.9–1.9,1.1–8.3,1.2–2.6,1.4–4.0,1.5–2.5,10,12.9,14.9,2.3–3.1,2/3,8.8,acuminate,acute,along,anther,apart,apex,apical,arcuate,area,attenuate,bark,base,black,brown,calyx,capitate,central,chartaceous,cm,corolla,cream,cuneate,deciduous,diameter,distal,dry,evenly,flattened-reniform,flower,forking,fruit,globose,green,lanceolate,large,lateral,leaf,length,less,long,major,margin,markedly,mature,minute,mm,ovate,pedicel,peduncle,petiole,pore,purple,reddish,reticulate,rounded,short,shrub,simple,small,smooth,spaced,spreading,stellate,stem,stigma,straight,style,surface,tardily,time,tree,truncate,tube,unarmed,unbranched,vein,well,white,wide,yellow,yellow-tan,±equal	.04,0.1,0.2–0.3,0.2–0.9,0.3–0.6,0.4–0.5,0.4–1.2,0.4–1.3,0.5–1.4,0.5–1.5,0.5–2.2,0.6–1.0,0.6–2.4,0.6–2.6,0.7,0.7–1.7,0.8–1.2,0.8–1.3,0.8–2.9,1.0–2.6,1.0–4.5,1.1–3.4,1.2–2.3,1.6–4.8,1.8–12.1,1.9–2.8,1/3,1/4,1/4–1/3,10.5,17–145,2.8–6.3,3.2–4.9,3.2–7.0,3.8,3.9–6.5,4.5–21.9,4–6-merou,4–9,5.1–8.7,5.8–11.4,5–7,5–8,6.9,6–10,8.2,8.9,90°,abaxially,absent,adaxially,adnate,aequilateral,alyx,anthesi,apiculate,apparently,appearing,appressed,arching,around,articulate,axe,ba,basal,becoming,bent,berry,blade,branch,broad,brochidodromous,bud,bulge,caudate,channeled,clinate,crea,densely,dentate,development,difoliate,directed,directly,distally,distinct,eaf,edge,eed,either,emerging,endocarp,entire,erect,exocarp,extending,extra-axillary,ferruginous,fertile,filament,filiform,free,geminat,glabrous,glandular,glossy,gradually,hair,heterostylous,immature,increasing,intac,internode,interpetalar,intersepalar,juic,layer,lobe,lobed,lon,longer,lower,many,midpoint,midrib,midvein,minor,moderately,nearly,nflorescence,oblique,opaque,opposed,orolla,oval,ove,per,perforated,poorly,porrect,portion,potentially,pubescent,raised,ray,reflexe,remaining,ridge,rigid,row,ruit,semicraspedodromous,sessile,several,shorter,side,sinus,sloughing,sometimes,sparsely,splitting,spread,stellae,stellate-pubescent,stipe,stipitate,suture,tamen,tem,terete,thin,tip,tissue,toward,transparent,two,ud,unit,upper,various,vary,weakly,well-developed,yellow-ferruginous,ympodial,young,±90°,±glabrous,×	arrangement,color,connation,dehiscence,diminishing,form,growth,height,history,inflorescence,interjected,leaflet,life,na,ovary,papillae,petiolule,plant,pseudostipule,seed,shape,size,spacing,straightnes,terminal,texture,tuber-bearing
685	wfo-0001031036	success	150	100	62	88	38	0.413	.5,0.8-1.2,1-2.5,1.2-1.5,1.5-3,5-6,acuminate,acute,along,angle,anther,apex,base,bi-lobed,brown,calyx,closely,cm,corolla,dark,decurrent,dry,elliptic,flattened-reniform,fruiting,glabrous,globose,green,greenish-white,lateral,leaf,lobed,margin,material,minutely,mm,nearly,oblique,onto,opposite,ovary,pedicel,petiole,pitted,poricidal,sagittate,shiny,shrub,simple,size,slightly,spaced,stem,stigma,style,surface,thickened,tip,trichome,tube,uniseriate,young	.2,.25,0.5-1,0.8-1,1-1.3,10-20-flowered,12-15,2-2.5,2.2-3.7,3-4,3-5,3.5-5.5,4.5-6.5,7-8,abaxially,adaxially,anthesi,arising,axil,ba,becoming,berry,broadly,conical,crisped,deflexed,dia,differing,difoliate,drying,eaf,edicel,eed,ellipsoid,enlarged,erect,exserted,filament,filiform,fleshy,free,fresh,geminat,knob-like,lamina,lobe,lon,long,lower,main,major,middle,minor,nflorescence,older,overlappin,pair,papillo,papillose,perhaps,planar,pointed,pore,portion,rounded,ruit,scar,shaped,short,sinus,soon,spathulate,strongly,tall,tapering,tear-drop,tub,ud,unit,usually,vein,white,widest,winged,woody,x,yellowish,ympodial	alternate,arrangement,articulation,bark,color,connation,dehiscence,diameter,diminishing,distal,foetid,foliage,form,fruit,growth,height,history,inflorescence,interjected,leaflet,length,life,midpoint,na,papillae,peduncle,petiolule,plant,position,prickle,pseudostipule,seed,shape,spacing,straightnes,terminal,texture,tuber-bearing
686	wfo-0001031040	success	217	147	125	92	22	0.576	.5,0.1–0.3,0.3–3,0.8–7.5,1.2–2.1,1.5–4,10,10–10.5,12–14,15–23,2.5–4,2.5–9,2–10,2–5-branched,3–5,5,6,abaxially,accrescent,acuminate,acute,adaxially,age,anther,anthesi,apart,apex,apical,articulated,attenuate,base,becoming,branch,broad-based,broadly,calyx,cm,deeply,diameter,directed,dull,entire,filiform,flattened-reniform,flower,flowering,fruit,glabrous,gland-tipped,globose,green,hair,inflorescence,internode,interpetalar,lanceolate,lateral,lavender,leaf,lighter,long,longer,major,margin,midpoint,minute,minutely,mm,much,numerous,older,ovate,pedicel,peduncle,persistent,petiole,pinnatifid,pitted,plant,pore,prickle,purple,rarely,ray,rounded,scabrous,scarcely,sessile,sessile-stellate,shape,short,shrub,similar,simple,slightly,small,sometimes,somewhat,sparse,sparsely,splitting,sprout,stellae,stellate,stem,stigma,straight,style,subcordate,surface,thickened,tissue,tree,triangular-attenuate,tube,turning,unarmed,upward,vein,vigorous,violet,white,yellow,yellow-brown,–6	0.2–0.6,1.2–1.3,1.4–2.7,1.5–5,1.7,1.7–3.1,10–13,1–1.4,2,2.2–2.5,2.4–3,3,3.5–5,3–26,3–4.5,4–6,5-merou,6.5–25,6–6.5,6–8,7–9,8–30,adaxiall,also,alyx,apparently,axe,ba,berry,blade,capitat,contrasting,dark,densely,depending,difoliate,distall,eaf,eed,either,especially,filament,finely,free,geminat,glabrescent,glabrou,glandular,highly,homostylous,immature,larger,like,lobe,lobed,lon,lower,midvein,midzone,narrowly,nflorescence,orolla,outside,ovoid,pale,perfect,porrect,principal,probably,recurved,ruit,several-celled,side,size,soon,spaced,stellate-pubescent,subcoriaceous,tamen,tem,time,triangular,ud,unit,usually,variable,vary,vigor,wide,yellowish-tawny,ympodial,×	arrangement,articulation,bark,capitate,color,connation,corolla,distally,form,growth,height,history,length,life,na,ovary,papillae,seed,spacing,staman,straightnes,texture
687	wfo-0001031062	success	216	131	93	123	38	0.431	-5.5,.5,0.5,1,2,20,3-8,4,?,abaxially,absent,adaxially,anther,apart,appearing,articulated,base,bud,calyx,campanulate,cm,cuneate,curved,cylindrical,densely,diameter,difoliate,entire,extra-axillary,ferruginous-tomentose,flattened-reniform,flower,forked,foveolate,fruit,fully,glabrous,globose,green,hair,lateral,leaf,lobe,longitudinal,margin,midpoint,minutely,mm,opening,ovate-lanceolate,pedicel,pentagonal,per,perhaps,petiole,plant,prickle,recurved,ripe,rotate-stellate,sessile,shallow,shape,short-stalked,side,size,slightly,slit,sometimes,stellae,stellate,stellate-tomentose,stem,stigma,stipitate,straight,style,surface,tapered,terminal,thick-based,tip,tomentose,treelet,truncate,tube,unarmed,unbranched,unifoliate,usually,white,x,yellow	0,0.3,0.5–0.6,0.7–0.8,1.2–1.4,1/3,13–15,15,16,17,1–2.5,1–4,2-3.5,2.5,22,2–3,2–5.5,3,3–10,4–10,4–4.5,5,5–7-rayed,7,7–15,7–8-rayed,9–11,accrescent,acute,adaxiall,ag,ample,apex,apiculate,armed,axe,ba,blade,bottom,branch,brownish,capitat,chartaceous,clustered,colored,connivent,count,diamete,directed,distally,eaf,eed,even,eventually,except,fertile,filament,fragrance,fruiting,geminat,glabrou,grading,heavily,ilament,interpetalar,juvenile,larger,least,less,lighter,lobed,long,loosely,lower,m.,main,midrib,much,nearly,nflorescence,numerous,obscuring,obsolete,often,one,orolla,overtopped,part,partially,perfect,pore,pubescent,rachi,rarely,rest,ruit,scabrous,short,shub,simple,small,spaced,sparsely,sprout,sweet,tall,tem,thick,tissue,toward,triangular,unarme,uniform,unit,uppermost,vary,vigorous,visible,wide,ympodial,young,younger,–3	0.7-0.8,1-2.5,1-4,1.2-1.4,13-15,2-5.5,4-10,7-15,7-8-rayed,age,arrangement,articulation,capitate,color,corolla,dehiscence,feature,form,geminate,growth,height,history,inflorescence,interjected,leaflet,length,life,na,ovary,peduncle,perennial,position,pseudostipule,reproduction,seed,shrub,spacing,texture
688	wfo-0001031064	success	179	108	83	96	25	0.464	.5,0.5-0.7,1-3,1.2,1.5-2,10-12.5,3-5.5,3-7,3.5-4,5-6,6-16,abaxially,acuminate,anther,anticlinal,apex,attenuate,base,bright,calyx,cell,cm,completely,conical,corolla,densely,diameter,distal,elongate,epidermal,filament,fleshy,free,fruit,glabrous,green,half,highly,inflorescence,irregular,lateral,leaf,leaflet,lobed,long,lower,minutely,mm,nearly,obovate,ovary,ovoid-reniform,pedicel,petiole,pinnate,poricidal,portion,projection,pubescent,purple,rachi,scattered,short-pubescent,shrub,simple,sinuous,somewhat,sparsely,stem,stigma,style,surface,terminal,thickening,tip,translucent,trichome,tube,uniseriate,white,winged,without,x	.0-2.5,.05,.5-1,0,0-15,0.5,0.5-0.8,1,1-1.2,1-2,1.7-4.2,10-12,10-17,2,2.5-3,3,4-5-celled,5-10.5,7-16,8-10-celled,acroscopic,adaxially,along,anthesi,arising,axil,basal,bearing,berry,blade,broader,clavat,commentary,conspicuous,dark,deltate,denser,dr.,eaf,edicel,eed,erec,exserted,flower,fruiting,globose,irregularly,lamina,leave,lenticel,lightly,like,lobe,lon,lost,margin,minute,narrower,near,nflorescence,nodding,node,occasionally,often,open,ovate,pair,papillate,per,petiolule,planar,prominent,pubescen,rugose,ruit,scar,see,side,single,sinus,slender,smaller,splitting,strongly,swollen,tal,tem,time,tub,ud,unifoliat,unit,usually,vein,wand-like,ympodial	arrangement,bark,clavate,color,connation,dehiscence,diminishing,form,growth,height,history,length,life,na,papillae,peduncle,perennial,plant,seed,shape,size,spacing,straightnes,texture,tuber-bearing
689	wfo-0001031065	success	140	83	43	97	40	0.307	.3,anther,apex,attenuate,base,beyond,calyx,chestnut,cm,color,corolla,extra-axillary,fruit,green,green-striate,held,herb,lateral,light,lilac,margin,mm,ovary,ovate-lanceolate,ovoid,pale,pedicel,peduncle,petiole,puberulous,rarely,simple,sometimes,spheroid,stellate,stem,stigma,style,subshrub,surface,trichome,umbelliform,white	.1–0.3,.2,.4,.5–2,.6,0.2–1.1,0.5–1.6,0.5–5,0–30,1,1-,1-celled,1.8–7.8,2,4,4-merous,5-merous,accrescent,acicular,aculeate,acuminate,acute,almost,also,alyx,apical,apparently,armed,asymmetrical,berry,cell,celled,central,composed,concolorous,deltate,dense,dia,difoliate,eaf,eed,eglandular,either,entire,erect,externally,ferruginous,filament,flower,frui,geminate,glabrous,glandular,indumentum,lamina,lobe,lobed,lower,many,many-celled,midpoint,midvein,multi-celled,narrowly,nflorescence,non-glandular,nonglandular,occasionally,orolla,per,perfec,perhaps,persistent,porrect-stellate,portion,radial,rare,rough,rounded,ruit,scabrid,sessile,shor,short,short-pedunculate,slightly,solitary,sparse,spine,tall,terete,unifoliat,unit,upper,usually,x,ympodial	0-30,0.2-1.1,0.5-1.6,arrangement,articulation,bark,connation,dehiscence,diameter,diminishing,distal,foetid,foliage,form,fruiting,growth,height,history,inflorescence,interjected,leaf,leaflet,length,life,na,papillae,petiolule,plant,position,prickle,seed,shape,size,spacing,straightnes,terminal,texture,tube,tuber-bearing,young
690	wfo-0001031071	success	186	116	81	105	35	0.435	0-10,0.2-0.8,1-2,1.5-2.2,2-8,2.1-3,3-10,3-5,3.8-5.4,5.7-8.8,6-8,7-8,8-28,anther,articulated,base,blue,brownish,clavate,cm,color,condition,connivent,coriaceous,corolla,dark,deep,diameter,distal,drying,elliptic,forked,fresh,fruit,generally,glabrous,globose,green,greenish,half,herb,interjected,lanceolate,lateral,leaf,leaflet,lilac,medium,mm,moniliform,mottled,mucilaginous,odd-pinnate,ovate,ovoid,pedicel,peduncle,pentagonal,petiole,plant,poricidal,purple,ripe,rotate,seed,size,slightly,spot,star,stigma,straight,style,terminal,tip,tube,typically,wet,white,whitish,x,yellow	0.4-2,1-1.5,1-3,1-7,2-3,2-5,2.4-3.4,3-6,4-25,4-6,5-9.4,5-merou,7-16.5,abaxiall,abaxially,acumen,acute,adaxially,ag,along,alyx,apart,apex,apparently,arranged,asymmetric,attenuate,axe,axillary,basiscopic,bead,berry,blade,bud,capitat,cell,covering,decreasing,digestion,dorsally,eaf,edge,eed,enzyme,erec,exceeding,filament,flat,flower,folded,geminat,glabrou,green-white,hair-like,homostylous,honeycomb-shaped,lengthening,like,living,lobe,long,lower,make,middl,multiple,narrowly,necklace,nflorescence,orbicular,orolla,pair,perfect,petiolulate,plurifoliate,pore,removed,round,ruit,sessile,seudostipule,short,side,slit,spaced,specimen,stamen,stolon,subequal,subtending,tall,tamen,tem,testal,thick,throughout,tissue,toward,tri-,tuber,unit,usually,vary,wall,winged,ympodial	arrangement,articulation,bark,calyx,capitate,connation,dehiscence,erect,foetid,foliage,form,fruiting,growth,height,history,inflorescence,length,life,middle,midpoint,na,ovary,papillae,position,prickle,pseudostipule,shape,spacing,stem,straightnes,surface,texture,trichome,tuber-bearing,young
691	wfo-0001031097	invalid_json_followup	174	158	111	63	47	0.638	0.45,1,1-4,1-4.5,1.5,1.8-2.6,13-30,2-3,2-4,3-5,3.5-6,3.7-8.4,5-11,5-12,8-11,abaxial,abaxially,acuminate,acute,adaxially,along,apex,apical,apically,articulate,base,branched,calyx,cell,cm,connate,corolla,covering,cuneate,cyme,darker,deep,dehiscent,diameter,dichasial,dichasially,diminishing,distal,dotted,ebracteate,edge,elliptical,forked,frequently,generally,green,green-white,half,herbaceous,interjected,introrse,lateral,leaf,leaflet,light,lighter,long,make,margin,maturing,medium,mm,monochasial,mottled,mucilaginous,narrow,oblique,obovate,odd-pinnate,often,ovate,ovoid,pedicel,peduncle,pentagonal,perennial,petiole,petiolule,plant,poricidally,proximal,puberulent,pubescent,purple,rarely,rotate,seed,short,side,size,slit,stigma,straight,strigose,style,terminal,testal,thick,throughout,tuber-bearing,violet,violet-blue,wall,wide,yellow,¼	0.5,1-3,1.6-5.5,1.8-2.5,2-3.3,3-6-foliat,4-6,4-7,5-9,9-21,acumen,decurrent,digestion,dorsally,eaf,eed,emoval,enzyme,exceeding,filament,flat,flower,folded,globo,gree,hair-like,highly,honeycomb,interpetalar,living,lobe,lon,lower,lunat,nflorescence,noticeably,nther,orolla,pair,pattern,perfect,petal,petiolulate,plan,rachi,rapidly,reveal,ruit,sessile,seudostipule,sometimes,specimen,stamen,tal,tem,tissu,toward,typically,unit,vary,vbase,without,ympodial	'','hair-like,2,[,],``,anther,arrangement,articulation,bark,characteristic,color,connation,dehiscence,foetid,foliage,form,fruit,fruiting,globose,growth,height,history,inflorescence,length,life,lunate,na,ovary,papillae,position,prickle,pseudostipule,shape,spacing,stem,straightnes,surface,texture,trichome,tube,value,wet,ye,young,{,}
692	wfo-0001031101	success	197	115	77	120	38	0.391	-5,0.5-0.8,0.5-3,0.8-,1-2,1-2.3,1-3,2-6,3-15,3-8,4.5-9,acuminate,almost,ame,anther,apex,articulated,bark,base,bright,c.,calyx,cm,connivent,diameter,dull,elongating,flattened-reniform,fruiting,glabrescent,glandular,hair,lateral,leaf,length,lobed,long,long-acute,mauve,membranous,midpoint,minute,mm,moderately,multangulate,obtuse,orange-brown,orange-red,ovate,pale,pedicel,peduncle,petiole,poricidal,porrect,ray,red,rounded,sessile,shrub,simple,spherical,stalked,stellate-pubescent,stem,straight,style,surface,tapering,terminal,tip,trichome,tube,umbel,white,yellow,young	-1,-16,-20,-30,-8,/2,/2-equal,0.05-0.2,0.1-0.2,0.1-0.3,0.3-0.5,0.6-0.8,0.7-0.8,1-,1.3-2,1.3-2.5,1.4-1.7,1.5-3,1/3-1/2,1/4-1/2,10-30,2-2.8,2-4,2-5,2.5-,2.5-3.5,2.5-3.8,3-10,3.5-4.5,4-10,4-5-merous,4-7,5-20,5-6,6-10,8-15,abaxial,abaxially,adaxial,alyx,apar,apical,apically,apparently,ba,berry,blade,branched,concolorous,deltate,difoliate,drying,eaf,eed,entire,equal,erect,evenly,filament,filiform,flower,free,frui,geminat,glabrous,green,green-brown,herbaceous,infructescence,lobe,long-acuminat,longer,lower,margin,mature,maturity,narrow-deltate,near,nflorescence,often,older,one,open,orolla,oung,pair,pendulous,per,perfec,pericarp,portion,primary,red-brow,resembling,ruit,scandent,scar,smooth,spaced,sparsely,spreading,stalk,stellate,stellate-pubescen,tamen,terete,tertiary,time,unarme,unarmed,unit,variously,vary,vein,venation,visible,way,wide,yellow-green,ympodial	apart,arrangement,articulation,color,connation,corolla,dehiscence,diminishing,distal,foetid,foliage,form,fruit,growth,height,history,inflorescence,interjected,leaflet,life,na,ovary,papillae,perennial,petiolule,plant,position,prickle,pseudostipule,red-brown,seed,shape,size,spacing,stigma,straightnes,texture,tuber-bearing
693	wfo-0001031114	success	208	117	89	119	28	0.428	.2,.5,0-0.3,0.3-0.5,0.5,0.5-1,0.7-1.5,0.8-1.2,1-1.5,1-10,1-2,1-4.5,1-7,1-8,1.5-2.5,1.5-4,10-15,2-17,2-3,2-4,2-7,2.5-3,3-10,3-4,3-5,3-7,4-10,4-5,4-8,4.5-6,5-10,5-8,6-7,7-15,anther,becoming,branched,brown,calyx,chartaceous,cm,diameter,elliptic-ovate,especially,first,flattened,fruit,globose,green,leaf,light,long,longitudinal,margin,membanaceous,midpoint,mm,oblong,opening,outline,ovate,pedicel,peduncle,petiole,purple,reniform,ripe,rugulose,shrub,simple,slit,small,stellate,stem,stigma,strongly,style,subcoriaceous,surface,thickened,time,toward,tree,truncate,white,wide,x,yellow,yellowish	.1,2/3,25-50,5-merou,abaxially,absen,accrescent,acuminate,acute,adaxiall,adaxially,ag,alyx,apart,apex,apparently,articulated,axe,ba,base,berry,blade,capitat,connivent,covering,cylindrical,dark,deltate,densely,differentiated,directed,discolorous,distal,distally,dried,eaf,echinoid,eed,entire,equal,erect,filament,fleshy,flower,free,frui,fruiting,geminate,glabrous,hair,highly,homostylous,impressed,interpetalar,introrsely,juic,lacking,large,leaf-opposed,like,lobe,long-stalked,lower,major,minor,multangulate,nearly,nflorescence,nodding,obtuse,often,one,orolla,paired,part,perfect,pericarp,plurifoliate,pore,porrect,prominent,pubescent,rachi,ray,rounded,ruit,sessile,short,short-,short-stalked,side,slightly,somewhat,spaced,sparsely,stalk,ste,stellate-pubescent,straight,subcucullate,subcuneate,subtending,tall,tamen,tem,thin,tip,tissue,triangular,tube,unarme,unit,vary,vein,white-pubescent,white-stellate,whitish,without,ympodial	2.5-7,5-merous,age,arrangement,capitate,color,corolla,dehiscence,form,growth,height,history,inflorescence,interjected,lateral,leaflet,length,life,na,plant,pseudostipule,seed,shape,size,spacing,terminal,texture,unarmed
694	wfo-0001031116	success	191	119	81	110	38	0.424	.5,/4,0.05-0.15,0.3-0.5,0.4-0.7,0.7-0.9,0.7-1,1,1-5,2-5,4-7,8-11,acuminate,almost,anther,apart,apex,apparently,articulated,attenuate,bark,base,berry,calyx,caudate,cm,connivent,diameter,discolorous,drying,dull,elliptic,evenly,flattened-reniform,fruit,fruiting,glabrescent,glaucous-green,green,lateral,leaf,length,less,lobed,maturity,mauve,membranous,midpoint,mm,obovate,obtuse,orange-brown,orange-red,pedicel,peduncle,petiole,poricidal,red-brown,reflexed,rounded,sharply,shortly,shrub,simple,small,sometimes,spherical,stem,straight,style,surface,tapering,tip,tree,trichome,tube,unarmed,way,weakly,yellow,young	-10,.2,.8,0,0.1,1/2,1/3-2/,1/6-1/4,10-14,15-25,2.7-3.2,3.5-4,30-100,30-50,4-10,5,5-15,5-merous,9-13,abaxial,abaxially,adaxial,alyx,ame,apar,apically,arachnoid,blade,branching,bristle,broad-deltate,brow,c.,clearly,collapsed,densely,dirty-white,eaf,eed,elongated,elongating,epidermi,equal,erect,filament,flat,flexuous,flower,fragile,free,glabrous,hair,infructescence,lobe,long,longer,lower,margin,mature,minute,moderately,multangulate,narrow-deltate,nflorescence,obtu,often,older,one,open,orolla,oung,pair,per,perfec,pericarp,perpendicular,plurifoliat,portion,primary,ray,recurved,ruit,scar,secondary,sessile,single,slender,smooth,soft,spaced,sparsely,stalk,stalked,stellate,stellate-pubescent,subentire,tamen,terete,tertiary,time,unarme,unit,upper,vary,vein,venation,visible,wide,woody,ympodial	0.2,arrangement,articulation,brown,color,connation,corolla,dehiscence,diminishing,distal,foetid,foliage,form,growth,height,history,inflorescence,interjected,leaflet,life,na,ovary,papillae,perennial,petiolule,plant,position,prickle,pseudostipule,seed,shape,size,spacing,stigma,straightnes,terminal,texture,tuber-bearing
695	wfo-0001031127	success	196	126	92	104	34	0.469	+,0.5,0.5-1,0.5-1.3,0.8-2,1,1-1.5,1.5-2.5,12268,2,2-lobed,3-5,3.5-4,4,7-30,8,acicular,acute,anther,apex,armed,articulated,attenuate,bark,base,berry,brown,calyx,capitate,chartaceous,cm,corolla,deep,diameter,ekman,elliptic,elongate,fide,flattened,flower,fruit,fruiting,globose,growth,inflorescence,internodal,lamina,lanceolate-elliptic,leaf,long,long-styled,membranous,midpoint,minutely,mm,opposite,ovary,pale,pedicel,peduncle,pentagonal,petiole,pitted,poricidal,porrect,prickle,pubescent,purple,ray,red-violet,reddish,reniform,sessile,shiny,short-stalked,short-styled,shrub,simple,somewhat,sparsely,stellate,stem,stigma,style,surface,tan,tapering,tip,trichome,tube,vein,yellowish	-2,.5,0.3-0.4,0.4-1.5,0.5-3,0.8-1,1-5-2,1.5-2,1.5-3,2-3,3-4,3.5-7,3/4,30-100,5,5-8,6-6.5,8-16,?,abaxially,adaxially,almost,anthesi,apar,apparently,cell,conical,cupuliform,densely,eaf,eed,ellipsoid,elongating,equal,even,extremely,filament,free,glabrous,heterostylous,hyaline,included,individual,like,linear,lobe,lobed,long-triangular,lower,m.,margin,midrib,minute,near,new,nflorescence,nodding,number,older,open,outline,pair,papillat,per,pericarp,pinnatifid,planar,plurifoliat,pore,portion,prickly,primary,prominent,rectangular,reduced,relatively,rest,ruit,scar,scattered,shallowly,shin,sinuate,sinus,slightly,slit,sometimes,spaced,spreading,stout,testal,thin,time,ud,unit,upper,variable,way,widely,woody,x,yellow,ympodial,½	apart,arrangement,articulation,color,connation,dehiscence,diminishing,distal,foetid,foliage,form,height,history,interjected,lateral,leaflet,length,life,na,papillae,papillate,petiolule,plant,position,pseudostipule,seed,shape,size,spacing,straightnes,terminal,texture,tuber-bearing,young
696	wfo-0001031128	success	213	113	78	135	35	0.366	-100,-6.5,0.5-0.7,0.5-5,0.6-1,1-,1.5-3,1.5-3.5,2-5,20-60,5-19,almost,anther,apex,articulated,bark,base,branched,brown,calyx,cm,connivent,cuneate,diameter,dull,elliptic,evenly,filiform,flattened-reniform,fruit,fruiting,glabrescent,glandular,green,hair,inflorescence,lateral,leaf,length,lobed,long-acuminate,maturity,mauve,membranous,minute,mm,multangualte,near,orange-brown,pale,pedicel,peduncle,petiole,poricidal,purple-black,red,reflexed,sessile,short-attenuate,shrub,simple,spherical,stalked,stellate,stem,straight,style,surface,tapering,terminal,tip,trichome,tube,unarmed,variously,white,yellow,young	-10,-4.5,/4,0,0-30,0.05-0.2,0.05-0.25,0.2,0.2-0.4,0.3-0.8,0.5-0.8,0.5-1.5,0.8-1.7,1,1-1.6,1.2-2,1/,1/6-1/3,10-20,10-35,2-9.5,2.3-,2.5-10,2.5-3.5,20-50,3-4,3.5-4.5,4-5-merous,4-7,5-,5-15,5-30,8-12,8-23,abaxial,abaxially,acute,alyx,apar,apart,ape,apically,apparently,berry,blade,branching,bristle,concolorous,deltate,densely,drying,eaf,eed,elongated,elongating,entire,equal,erect,eye,filament,flexuous,flower,free,glabrous,gland,gra,infructescence,less,lobe,lon,long,long-acuminat,longer,lower,margin,mature,midpoint,moderately,multangulate,naked,narrow-deltate,nflorescence,occasionally,often,older,one,open,orolla,oung,pair,per,perfect,pericarp,perpendicular,plurifoliat,portion,primary,ray,recurved,red-brown,reduced,ruit,scar,secondary,shallowly,short-styled,side,single,smooth,soft,spaced,spreading,stalk,staminate,stellate-pubescent,tamen,terete,tertiary,time,unarme,undulate,unit,usually,vary,vein,venation,visible,way,weakly,whitish,wide,woody,yellow-brown,yellow-green,ympodial	arrangement,articulation,color,connation,corolla,dehiscence,diminishing,distal,foetid,foliage,form,gray,growth,height,history,interjected,leaflet,life,na,ovary,papillae,perennial,petiolule,plant,position,prickle,pseudostipule,seed,shape,size,spacing,stigma,straightnes,texture,tuber-bearing
697	wfo-0001031135	success	189	132	91	98	41	0.481	0-2,1-,1-1.5,1-10,1-3,1-4,1.5-3,10-20,2-,2-4,3-10,3-4,3-5,3.5-12,5-30,5-9-pinnate,abaxially,acuminate,adaxially,also,apart,apex,articulated,basal,base,calyx,campanulate,cm,color,compound,cordate,cuneate,darker,densely,diameter,ellipsoidal,fading,flattened,frequently,fruit,fusiform,green,interstitial,irregularly,lateral,leaf,leaflet,leaving,light,lobe,lobed,long,longitudinal,mm,moderately,oblong,occasionally,ovoid,pedicel,pedicellar,peduncle,peltiform,petiole,pilose,pink,pinnatifid,puberulent,pubescent,purple,remnant,ripe,shrub,simple,small,smaller,spaced,sparsely,stigma,stripe,style,tree,truncate,tube,unbranched,unlobed,violet,white,whitish,x,yellow-green,yellowish	-7,0.5-2,0.7-2,1-2.5,1.5-2,1.5-9,2,2-2.5,2-23,2-3,2-3.5,2-5,2.5-28,4-5,4-foliat,5-11,7-15,absent,acute,adpressed,aggregate,along,ape,axe,basiscopically,beyond,biglandula,blade,broad,cell,chartaceous,connective,coriaceous,cylindrical,decurrent,deflexed,deltate,dilated,directed,distally,eaf,eed,eglandular-pubescent,ellipsoida,elliptic,entire,equal,especially,exceeding,exserted,flower,glabrous,glandular-,hair,laterally,lon,lower,margin,midrib,narrowed,nflorescence,nther,obconical,oblique,obtuse,often,orolla,ovate,papillose,perfect,pilo,pinnately,pore,present,rachi,radiu,ruit,shorter,slightly,stamen,stone,strongly,subcoriaceous,tal,tem,thecae,time,tip,tomento,toward,triangular,ud,unit,unknow,upper,vary,wide,ympodial	anther,arrangement,articulation,bark,biglandular,connation,corolla,dehiscence,diminishing,distal,foetid,foliage,form,fruiting,growth,height,history,inflorescence,interjected,length,life,na,ovary,papillae,petiolule,plant,position,prickle,pseudostipule,seed,shape,size,spacing,stem,straightnes,surface,terminal,texture,trichome,tuber-bearing,young
698	wfo-0001031143	success	217	123	68	149	55	0.313	2,2.5,4,5,9,acute,anther,apart,apex,articulated,attenuate,base,broad,broadly,cm,densely,diameter,elliptic,evenly,extra-axillary,flattened-reniform,flower,free,fruit,glabrous,globose,green,interpetalar,lanceolate,lateral,leaf,length,long,maturing,midpoint,midrib,minutely,mm,moderately,narrowly,nearly,ovate,pale,pedicel,peduncle,petiole,pitted,prickle,rarely,ray,shrub,simple,slender,smooth,stellate,stellate-tomentose,stem,stigma,style,subcordate,surface,tissue,truncate,tube,well-developed,white,yellow,yellow-orange	0.3–0.5,0.3–0.8,0.4–0.8,0.4–1,0.7–0.9,0.9–1,0–50,1.1–2,1.4–1.7,1.5,1.5–1.9,1.5–2.5,1.5–3,1.5–5.5,10,10.5–11,15–23,1–1.2,1–1.5,1–4,2.3–2.5,2.5–4,2.5–4.5,2–2.5,2–3,2–3-branched,2–9,3,3–3.5,4–8-rayed,5-merou,5–7,6–8,7–12,8–10,abaxially,acicular,adaxially,alyx,apical,apparently,appearing,armed,axe,ba,berry,bifoliate,blad,blade,branch,broad-based,bud,capitat,contrast,dark,directed,distall,dried,eaf,eed,entire,except,fertile,filament,filiform,finely,forming,geminat,glabrescent,glabrou,hair,half,high,homostylous,immature,internode,irregularly,large,layer,leaving,like,lobe,lon,lower,major,margin,material,midvei,midvein,minor,minute,mixed,mostly,much,near,nflorescence,oblong,often,orolla,overlapping,ovoid,per,pore,porrect,potentially,principal,remaining,repand,ruit,sessile,set,several,shallow,short-caudate,shorter,side,sinus,soon,spaced,splitting,stellae,stellate-tomento,stipe,stipitate,straight,tamen,tardily,tem,thick-chartaceous,time,tip,tomentum,ud,unarme,unarmed,usually,various,vary,vein,weak,wide,yellow-ferruginous,ympodia,×,–11,–2.5,–4,–4.5,–8	0.3-0.8,0.4-0.8,0.4-1,1-1.5,1.1-2,1.5-2.5,1.5-3,10.5-11,2-3-branched,2.5-4.5,3-3.5,4.5,6-8,8,8-10,arrangement,articulation,bark,calyx,capitate,color,connation,corolla,dehiscence,diminishing,distal,foetid,foliage,form,fruiting,growth,height,history,inflorescence,interjected,leaflet,life,na,ovary,papillae,petiolule,plant,position,pseudostipule,seed,shape,size,spacing,stipule,straightnes,terminal,texture,trichome,tuber-bearing,young
699	wfo-0001031144	success	231	118	92	139	26	0.398	-11,-13,.5,0.8-1.4,1-,1-4,100,2-,2-6,2-9,2/3,25,3.5-10,4,6,7-10,acuminate,acute,anther,apart,apex,away,base,berry,bright,broadly,brown,calyx,capitate,cm,connivent,cordate,corolla,curved,diameter,ellipsoid,elliptic,flattened-reniform,form,glabrous,globose,growth,inflorescence,irregularly,later,lateral,leaf,leaflet,lobed,loosely,minutely,mm,pair,pale,pedicel,peduncle,petiole,pinnately,pinnatifid,pitted,poricidal,red,reddish,ripe,seed,shiny,simple,slightly,spaced,stellate-rotate,stem,stigma,strongly,style,surface,tan,terminal,tiny,tip,triangular,trichome,truncate,tube,uniseriate,vine,violet,way,woody,x,yellow,yellowish,½	.2,0.2,0.5,1-1.5,1.1-2.5,2,2-3,2.5-3,3-4.5,3-7,4-20,4-4.5,4-6,5,5-9,5-merou,<,adaxially,ag,alyx,anthesi,apicula,apiculae,appearing,ark,around,articulated,asymmetric,axi,basal,basiscopically,blac,branch,branche,brow,cell,closer,commonly,corresponding,cupped,densely,divaricate,drying,eaf,eed,elongate,elongating,entire,exserted,extending,filament,flattened,flower,four,free,fruiting,geminat,groove,ilament,inflated,lamina,larger,leaving,lengthening,less,like,lobe,long,longer,longest,lower,many,margin,markedly,membranous,mere,minute,near,new,nflorescence,number,oblique,occasionally,often,older,one,open,orolla,outline,papillo,peg,pendant,pentagonal,per,perfect,pericarp,plurifoliate,pore,portion,primary,progress,pubescent,quite,rim,ruit,scar,sleeve,slit,small,smaller,sometimes,sparsely,spreading,tangle,tem,terete,testal,thin,third,together,tuft,twinin,twining,two,ud,unequal,unit,upper,usually,variable,vary,vein,wall,weight,white,widest,wing,wood,ympodial	arrangement,bark,color,connation,dehiscence,diminishing,distal,fruit,height,history,interjected,length,life,na,ovary,papillae,papillose,petiolule,plant,pseudostipule,shape,size,spacing,straightnes,texture,tuber-bearing
700	wfo-0001031152	success	232	128	93	139	35	0.401	-10,0.2-0.3,0.2-1.5,0.3-3,1-6,1.5-3,11,3.7-7,4-19,4-6,4-8,8-20,abaxially,accrescent,acuminate,acute,adaxially,anther,apart,apex,apical-lateral,articulated,attenuate,base,becoming,blunt-tipped,brown,bullate,calyx,closely,cm,continued,corolla,dehiscing,deltoid,diameter,due,extend,flower,fruit,fruiting,globose,greenish,growth,high,honeycombed,introrse,lanceolate,large,lateral,lavender,leaf,length,lilac,long,longitudinal,mm,mostly,narrowly,oblanceolate,oblong,obtuse,pale,pedicel,peduncle,petiole,pore,probably,reniform,reticulate-punctate,ripe,rotate-stellate,scabrous,shrub,simple,slit,somewhat,spaced,stem,stigma,style,suborbicular,surface,terminal,testa,tree,tube,unarmed,violet,x,yellow,yellowish,young	-1.5,-5.5,.4,/100-1/16,0-100,0.3-1.3,1-1.5,1-3,1.1-2.2,1.1-3,1.2-1.8,1.3-4,1.4-2.6,1.5-3.5,1/2-2/3,1/2-3/4,13-27,2-5,2.5-7.5,2.7-3.7,2.7-4.5,2.7-6,2.8-4,4-7,5-6,6.5-10,9-13,ag,along,anthesi,apparently,axe,axillary,ba,basal,berry,blade,blister,branch,branched,bud,capitat,chartaceous,conical,decurrent,densely,directed,eaf,earl,eed,entire,evident,exserted,few-rayed,filament,fleshy,free,glabrescen,glabrous,granular-tomentose,green,hair,inserted,lackin,less,lobe,lobed,long-,longer,lower,m.,main,margin,midvein,mixed,moderately,multangulat,multangulate,nearly,nflorescence,occasionally,one,open,openly,orbicular,orolla,ovate,partly,perfect,persistently,pitted,plurifoliate,porrect-stellate,pubescent,rachi,rather,ray,reddish,reddish-brown,relatively,ruit,runk,sessile,short-,short-stalked,side,slightly,soon,sparingly,sparsely,splitting,stamen,stellate-pubescent,stelliform,stipitate-glandular,stout-stalked,strongly,suture,swelling,tamen,terete,thick,thick-stalked,thin,thin-,thin-stalked,time,tomentose,touching,toward,unarme,unit,usually,variously,vary,vein,way,wide,ympodial	age,arrangement,articulation,bark,capitate,color,connation,dehiscence,diminishing,distal,foetid,foliage,form,height,history,inflorescence,interjected,leaflet,life,na,ovary,papillae,petiolule,plant,position,prickle,pseudostipule,seed,shape,size,spacing,straightnes,texture,trichome,tuber-bearing
701	wfo-0001031155	success	193	89	61	132	28	0.316	.5,1-1.2,1.5,1.5-2,2-5,4-,7-15,anther,apart,articulate,bark,base,beneath,bilobed,calyx,climbing,cm,corolla,cream,densely,diameter,elliptic,evenly,glabrous,growth,height,inflorescence,internodal,lanceolate,leaf-opposed,lobed,midpoint,minutely,mm,oblique,obtuse,once-branched,pale,pedicel,peduncle,petiole,poricidal,prickle,pubescent,shiny,shrub,simple,stellate,stem,stigma,strongly,style,surface,tan,terminal,tip,trichome,tube,unknown,white,whitish	0,0.1,0.2,0.2-1.2,0.3-0.4,0.5,0.7,0.7-1.5,1,1-1.5,1.5-1.6,1.5-5,2.5-3.2,3-4-foliate,4-6,4.5-7,5-20,5-7,8.5-13,abaxially,acuminate,acute,adaxially,age,almost,along,anthesi,apex,apparently,appearing,armed,axi,broader,bullate,cell,central,closely,common,cup-shaped,dark,deeply,deltate,discolorous,distall,distally,due,eaf,echinoid,eed,enlarged,equal,exserted,ferrugineous,filament,fine,flower,glabrescen,glandular,globose,halfway,heavily,heterostylous,hub-like,intertwined,know,known,larger,leaving,lengthening,like,lobe,long,longer,los,lower,margin,midrib,mixed,mixture,multangulate,multiseriate,narrowly,new,nflorescence,occasionally,older,open,orange,outline,pair,papillat,part,peg,plurifoliate,pore,porrect,prickly,primary,principal,purple,ray,reddish,ruit,scar,seen,sessile,shallowly,short-stalked,short-styled,size,slightly,small,somewhat,spaced,sparse,sparsely,sparser,split,stalk,stout,straight,tapering,ud,unevenly,unit,variable,vein,widely,within,x,yellowish,ympodial	arrangement,articulation,color,connation,dehiscence,foetid,foliage,form,fruit,fruiting,glabrescent,history,leaf,length,life,na,ovary,papillae,papillate,plant,position,present,seed,shape,spacing,straightnes,texture,young
702	wfo-0001031162	success	241	110	73	168	37	0.303	0.5-1.5,0.5-7,0.7-5,1-15,1.5-3,1.7-4.5,2-,3-10,3-branched,5-10,5-6,5-7,7-70,7-9,accrescent,acicular,acute,angled,anther,apex,articulated,base,black,broadly,calyx,chartaceous,cm,connivent,cordate,densely,diameter,extra-axillary,fruit,fruiting,globose,inflorescence,irregularly,lanceolate,lateral,leaf,length,long,midpoint,minutely,mm,obtuse,outline,ovate,pale,pedicel,peduncle,perennial,petiole,prickle,pseudohair,pubescent,purple,ray,reniform,reticulate,shrub,simple,somewhat,stellate,stigma,straight,style,surface,tan,time,tube,unbranched,yellow	%,-74,.5,0,0-1.2,0-1.5,0-2.5,0-25,0.05-0.1,0.1-0.15,0.1-0.2,0.1-0.8,0.15-0.4,0.25,0.4-0.8,0.5-0.7,0.5-0.8,0.5-2,0.5-3,0.6-0.8,0.7-1.2,0.8-1.2,1-1.5,1-1.7,1-10,1-13,1-2,1-5,1-locular,1.2-1.4,1.5-1.9,1.5-2,1.5-2.5,1.5-8,10,10-12,10-30,15-20,2-2.8,2-7,2-foliate,20-40,26-,3-4,3.5-10,3.5-5.5,35-200,4-5,4-6,4-8,4-9,5-merou,6,6-7,6-8,60,600-1400,7-17,8-14,abaxially,absent,across,adaxially,adult,alyx,apart,apparen,armed,ascending,attenuate,axe,ba,blade,branch,branche,capitat,cylindrical,decimetre,deeply,deltate,directed,distall,distributed,dm,eaf,eed,eglandular,erect,exocarp,filament,finger,flower,geminat,generally,glabrous,gland-tipped,green,hair,half,homostylous,incomplete,index,interpetalar,juicy,juvenile,lamina,less,lobe,lobed,lobing,lon,longer,lower,margin,mature,mesocarp,mid-point,midvein,minute,moderate,moderately,narrow,nflorescence,oblique,orolla,pair,part,pendant,per,perfect,placenta,pore,porrect,presen,present,rachi,rhizomatous,ruit,septum,sessile,short,side,spaced,sparse,sparsely,stalk,stellae,stellate-pubescent,succulent,tal,tamen,tem,thick,throughout,tissu,tissue,transparent,triangular,unit,upper,vary,vein,white,wide,wing,x,yellowish,ympodial	arrangement,articulation,bark,capitate,color,connation,corolla,dehiscence,diminishing,distal,foetid,foliage,form,growth,height,history,interjected,leaflet,life,na,ovary,papillae,petiolule,plant,position,pseudostipule,seed,shape,size,spacing,stem,straightnes,terminal,texture,trichome,tuber-bearing,young
703	wfo-0001031178	success	167	90	52	115	38	0.311	0-0.2,0.3-0.6,0.6-1.2,0.7-1.7,2-3.5,5-11,7.5-8.5,accrescent,acute,anther,apex,articulated,base,calyx,chartaceous,cm,cuneate,diameter,extra-axillary,fruit,fruiting,globose,green,inflorescence,lanceolate,lateral,length,lobed,long,midpoint,mm,ovate,pedicel,peduncle,perennial,petiole,porrect,present,prickle,purple,ray,shallowly,shrub,simple,stellate,stem,straight,style,time,tube,unbranched,yellow	%,0-0.25,0-0.4,0-0.6,0-10,0-5,0-6,0.1-0.2,0.1-0.25,0.4-0.6,0.6-0.9,0.6-1,0.7-1,0.8-1.2,0.9-1.2,1-2,1-3,1-4,1.2-1.4,1.2-1.5,1.2-3.4,1.5-5.2,1.5-6,11-18,180-400,19-30,2-5,3.5-9,4-4.5,4-9,40-65,5-merou,6-14,6-8,7-11,7-8,abaxially,absent,acicular,across,adaxiall,adaxially,alyx,apart,armed,ascending,attenuate,axe,ba,blade,brown,cylindrical,d.,densely,directed,distall,distributed,dult,eaf,eed,eglandular,entire,erect,finger,flower,glabrou,glabrous,gland-tipped,grey,hair,half,hig,juic,lamina,lobe,lon,longer,lower,margin,mature,mesocarp,midvein,minute,moist,nflorescence,oblique,orolla,part,per,pore,presen,pseudo-racemose,rhizomatous,ruit,rusty,short,solitary,spaced,sparsely,stage,stalk,stellae,stellate-pubescent,tamen,thick,throughout,unit,unknow,unknown,uvenile,vary,vein,wide,x,ympodial	arrangement,articulation,bark,color,connation,corolla,dehiscence,diminishing,distal,foetid,foliage,form,growth,height,history,interjected,leaf,leaflet,life,na,ovary,papillae,petiolule,plant,position,pseudostipule,seed,shape,size,spacing,stigma,straightnes,surface,terminal,texture,trichome,tuber-bearing,young
704	wfo-0001031185	success	213	119	88	125	31	0.413	0.5-3,1-1.5,1-10,1-5,2.5-16,4.5-7.5,7-10,acuminate,acute,anther,apart,apex,articulated,base,branched,bright,broadly,brown,calyx,capitate,cm,conical,connivent,corolla,curved,diameter,distal,ellipsoid,eye,flattened,fruiting,globose,green,growth,inflorescence,lateral,lax,leaf,lobed,long,loosely,many,meter,minutely,mm,moderately,open,ovate,pale,papillate,pedicel,peduncle,petiole,pinnatifid,pitted,poricidal,pubescent,red,reniform,ripe,rounded,seed,several,shape,shrub,simple,size,slightly,sparsely,stellate,stem,stigma,style,surface,tan,terminal,time,tip,trichome,truncate,tube,uniseriate,vine,violet,white,woody,yellow,yellowish	-10,-8,.2,.5,0.5,0.5-1.5,0.8-1,0.8-1.3,0.9-,1,1-,1-1.2,1-4,1.2-5,1.5-4,10-40,2-9,2/3,20,3-4,4-6,5-merou,>,ag,alyx,anthesi,apically,appearing,appressed,ark,attenuate,away,axi,basal,berry,blade,cell,closer,commonly,deeply,deltate,densely,dry,eaf,eed,elongate,entire,exserted,extremely,filament,flower,free,glabrescen,glabrous,ilament,inflorescenc,irregular,irregularly,leaving,lengthening,like,living,lobbing,lobe,lon,lower,margin,materia,material,mature,midrib,new,nflorescence,older,onto,orolla,outline,pair,part,particularly,peg,per,perfect,pericarp,plurifoliat,pointing,pore,portion,reflexed,ruit,scar,shiny,sinus,slender,slit,small,spaced,spreadin,spreading,still,strongly,tem,thickened,thin,third,toward,ud,ultimate,unit,upper,usually,variable,variously,vary,visible,wall,way,weak,whitish,wide,widest,winged,within,ympodial,½	arrangement,articulation,bark,color,connation,dehiscence,diminishing,foetid,foliage,form,fruit,glabrescent,height,history,interjected,leaflet,length,life,na,ovary,papillae,petiolule,plant,position,prickle,pseudostipule,spacing,straightnes,texture,tuber-bearing,young
705	wfo-0001031195	success	216	129	94	122	35	0.435	0-0.7,0-8,0.3,0.5-1,0.6-0.8,0.6-1.5,1,1.5-2.5,10-14,11-28,15-35,2,3-6,4-9,5-9,7.5-8,9-15,absent,accrescent,acicular,acute,anther,apart,apex,articulated,base,broadly,calyx,chartaceous,cm,connivent,cuneate,deeply,diameter,distal,ellipsoidal,extra-axillary,finely,flattened,flower,fruit,fruiting,globose,green,half,inflorescence,irregularly,lateral,leaf,length,less,lobe,lobed,long,longer,loosely,mature,midpoint,midvein,mm,narrowly,obtuse,ovate,pale,pedicel,peduncle,per,perennial,petiole,plant,present,prickle,purple,ray,reticulate,shallowly,shrub,simple,splitting,stigma,straight,style,surface,thick,time,tube,unarmed,unbranched,vein,whitish,wide,x,yellow,yellowish-green	%,0-3,0.05-0.3,0.2-0.4,0.2-0.5,0.25-0.35,0.3-0.4,0.5-0.7,0.6-3,1-1.5,1-2,1-4,1-locular,1.4-1.6,1.4-2.9,10-13,10-19,2-2.5,2-4,2-5,2.5-4,20-32,3-3.5,3-4,3-5,3.5-4,3.5-5.5,4-5,4-7,5-merou,5.5-10,6-10,7-8,8-9,abaxially,absen,across,adaxially,alyx,andromonoecious,attenuate,axe,ba,blade,capitat,center,confined,cylindrical,d.,densely,difoliate,directed,distall,distributed,eaf,eed,eglandular,entire,exocarp,filament,filiform,finger,functional,geminate,glabrous,gland-tipped,grey,hair,heterostylous,incomplete,interpetalar,juic,lamina,lower,margin,mesocarp,midrib,minute,moderately,moist,nflorescence,oblique,orolla,part,pore,porrect,presen,probably,prostrate,pseudo-racemose,rachi,ruit,rusty,septum,sessile,short,solitary,spaced,sparse,sparsely,stage,stellae,stellate,stellate-pubescent,stoloniferous,tal,tamen,tem,throughout,tip,tissu,tissue,transparent,triangular,unarme,unit,uvenile,vary,weakly,white,yellowish,ympodial	arrangement,articulation,bark,capitate,color,connation,corolla,dehiscence,diminishing,dm,foetid,foliage,form,growth,height,history,interjected,leaflet,life,na,ovary,papillae,position,pseudostipule,seed,shape,size,spacing,stem,straightnes,terminal,texture,trichome,tuber-bearing,young
706	wfo-0001031202	success	198	118	89	109	29	0.449	.1,0-1,0.6-1.1,0.8-1,1-5,2-8,2.5-3.5,6-25,accrescent,acute,along,anther,apart,bark,base,beneath,broadly,calyx,capitate,cm,complex,cordate,corolla,cup-shaped,deflexed,dry,erect,fleshy,fruit,fruiting,furcate,glabrous,globose,golden,green,inflorescence,later,lateral,leaf,long,many,minute,minutely,mm,obovate,occasionally,opposite,ovary,overtopping,ovoid-reniform,pale,paler,papillose,pedicel,petiole,pitted,plant,poricidal,puberulent,reddish-brown,sessile,shape,shaped,shoot,shrub,size,slightly,small,specimen,stem,stigma,straight,style,surface,tan,tear-drop,terminal,time,tip,tree,trichome,tube,uniseriate,unit,variable,vein,white,woody,young	.5,0-0.5,0.1-0.3,0.5,0.5-1,1-1.5,1-1.7,1.5-2,1.5-2.5,1.5-9,15-40,2-3,2.5-13,2.5-4,2/3,20-100-flowered,3.5-4,9-11,9-20,abrupt,anthesi,apex,apiculate,axi,berry,bud,completely,condition,corky,decurrent,deltoid,densely,dia,differing,difoliate,distal,due,eaf,edicel,eed,enclosed,exserted,extremely,filament,flower,free,frui,geminat,glabrate,greenish-white,greyi,hard,irregularly,large,like,live,lobe,lobed,lon,long-ellipsoid,long-styled,longer,lower,main,major,margin,material,middle,minor,narrowing,nflorescence,occasional,often,older,one,orbicular,pair,papillo,planar,pore,portion,prominent,pubescent,quite,raised,rounded,ruit,scar,scattered,short-styled,slender,spaced,sparsely,tall,tapering,thick,thickened,thicker,third,tub,ud,usually,way,weight,whitish,widest,winged,x,ympodial	arrangement,articulation,color,connation,dehiscence,diameter,foetid,foliage,form,greyish,growth,height,history,interjected,leaflet,length,life,midpoint,na,papillae,peduncle,position,prickle,pseudostipule,seed,spacing,straightnes,sympodial,texture
707	wfo-0001031203	success	218	106	66	152	40	0.303	0-0.5,0-2.5,0.05-0.15,0.1-0.8,0.4-1,0.5-1.8,1-2,1-3,1-5,1.5-2.5,1.8-2.8,2-3.5,2-7,3-10,4-16,8-11,almost,anther,apex,articulated,base,broadly,calyx,cm,connivent,deep,diameter,extra-axillary,foveolate,fruit,globose,greenish-white,inflorescence,lanceolate,lateral,length,lenticular,lignescent,linear-lanceolate,midpoint,minutely,mm,orange-red,ovate,ovoid,pedicel,peduncle,perennial,petiole,rarely,red,reniform-ovate,sessile,simple,smooth,stellate,stem,stigma,style,surface,thin-textured,truncate,tube,unbranched,white,yellow	-1.5,-2,.2,.7-1,0-0.8,0.05-0.2,0.1,0.3,0.3-0.6,1/10-1/4,11-18,15-22,15-50,2-5,2-foliate,2.1-2.7,2.5-9.5,21-39,25-45,3.2-4,4-12,4-6-locular,4-6.5,5-7,5-8,5-8.5,5-9,5.5-8,6-16,6.5-9.5,8-14,abaxiall,abaxially,acute,acute-tipped,adaxiall,adaxially,along,apart,apparently,asymmetric,attenuate,axe,ba,berry,blade,campanulate,capitat,cinereous-tomentose,coarsely,consisting,curved,cylindrical,deciduous,deltoid,densely,dentate,directed,distall,distributed,downcurved,eaf,eed,elongate,erect,essentially,filament,first,flesh,flower,geminat,glabrous,hair,interlobal,interwoven,invested,less,lobe,lon,long,longer,lower,lowermost,lying,major,margin,maturity,midvein,much,nflorescence,numerous,obsolete,obtuse,often,orolla,outline,ovate-lanceolate,pair,parallel,per,perfect,plane,pore,present,prickl,projecting,prominent,pubescence,rachi,ray,reduced,relatively,ripe,ruit,sericeous,short,short-stalked,shorter,side,sinus,smaller,somewhat,spaced,sparsely,spreading,stalk,stellae,stellate-pubescen,stellate-pubescent,surfac,tal,tamen,tem,terete,termination,thickened,three,time,tip,tooth-like,unarmed,unit,uppermost,upward,usually,vary,vein,weakly,well-developed,wide,x,ympodial	arrangement,articulation,bark,capitate,color,connation,corolla,dehiscence,diminishing,distal,distally,foetid,foliage,form,fruiting,growth,height,history,interjected,leaf,leaflet,life,na,ovary,papillae,petiolule,plant,position,prickle,pseudostipule,seed,shape,size,spacing,straightnes,terminal,texture,trichome,tuber-bearing,young
708	wfo-0001031207	success	219	120	85	134	35	0.388	-8,0,0.5-1,0.6-1.2,0.85-1.4,1/3-equal,2-3,3.5-7,anther,apart,apex,articulated,bark,base,berry,calyx,cell,chartaceous,cm,cordate,curved,dark,densely,diameter,dull,elongating,evenly,flattened-reniform,fruit,fruiting,glabrescent,gray,green,herb,lateral,leaf,length,lobed,mature,maturity,mauve,mm,moderately,multangulate,obtuse,occasionally,orange-brown,outline,ovate,pale,pedicel,peduncle,persistent,petiole,pit,poricidal,porrect,prickle,raised,red,scandent,shrub,simple,small,smooth,sometimes,spherical,spreading,stalk,stalked,stellate-pubescent,stem,straight,style,surface,tapering,terminal,tip,toward,trichome,tube,variously,white,yellow,young	-0.4,-1/2,-11,-4,-5,-7,.1,/5,0-0.5,0-10,0-20,0.1-0.2,0.1-0.3,0.1-0.5,0.2,0.2-0.3,0.25-0.5,0.3-0.5,0.6-0.9,0.7-2,0.8,0.9-1.6,1,1-3,1-4,1-5,1.4-2,1.5-5,1/,1/3,1/4-1/3,2-4,2.1-2.3,2.5-,2.8-3,3-5,5-8,5-merous,6-8,6.5-8,9,abaxially,acuminat,acute,alyx,ame,apar,apically,apparently,blade,branched,bristle,bristly,broad-deltate,brow,c.,concolorous,difoliate,discolorous,distance,drying,eaf,eed,elongated,equal,erect,extending,eye,filament,filiform,flower,free,geminat,gently,glabrous,herbaceous,infructescence,lanceolate,less,like,lobe,long,longer,lower,margin,midpoint,midvein,naked,narrow-deltate,nflorescence,oblong,older,one,open,orolla,oung,pair,pendulous,per,perfec,pericarp,perpendicular,portion,prickl,prickly,primary,ray,reflexed,rounded,ruit,scar,sessile,shorter,side,spaced,stellate,subentire,tamen,terete,tertiary,time,unarmed,unit,upper,usually,vary,vein,venation,visible,way,weakly,wide,yellow-green,ympodial	arrangement,articulation,brown,color,connation,corolla,dehiscence,diminishing,distal,foetid,foliage,form,growth,height,history,inflorescence,interjected,leaflet,life,na,ovary,papillae,petiolule,plant,position,present,pseudostipule,seed,shape,size,spacing,stigma,straightnes,texture,tuber-bearing
709	wfo-0001031217	success	222	107	71	151	36	0.32	0.1-0.3,0.25-1.3,0.5-3,0.6-1.8,1-2,2.5-4,5.5-7,7-17,absent,accrescent,acuminate,acute,anther,apex,articulated,base,brown,calyx,chartaceous,cm,connivent,contiguous,cuneate,diameter,eglandular,elliptical,extra-axillary,fruit,fruiting,globose,hair,inflorescence,lanceolate,lateral,leaf,length,light,long,loosely,midpoint,midrib,midvein,mm,narrowly,nearly,ovate,overlapping,pale,pedicel,peduncle,perennial,petiole,present,prickle,pseudo-umbellate,purple,ray,red,reticulate,scarcely,shape,shrub,simple,stellate,stigma,style,surface,time,tube,violet,yellow	%,.5,.5-2,0-0.1,0-3.5,0-5,0-6,0.1-0.2,0.15-0.25,0.2-0.3,0.25-0.4,0.3-0.4,0.3-0.5,0.3-1,0.35-0.6,0.4-0.7,0.5-0.75,0.8-4,1,1-1.5,1-20,1-4,1-locular,1.5-2,1.5-4,1.5-4.2,13-21,2-2.5,2-3,2-5,2-8,2-9,2.6-3,3-4,3-4.2,3.5-4.5,4-11,4-6,5-12,5-7,5-merou,6-12,6-8,7-8,7-9,9-10,abaxially,absen,acicular,across,adaxially,adult,alyx,apart,apparen,axe,ba,blade,borwn,branch,branche,broad-based,confined,cylindrical,densely,directed,distall,distributed,dm,eaf,eed,elliptic,entire,erect,exocarp,filament,finger,flower,geminate,glabrous,gland-tipped,green,greenish-white,half,incomplete,interpetalar,juicy,juvenile,lamina,less,lobe,lobed,longer,lower,margin,mature,mesocarp,mid-point,minute,moderately,much,nflorescence,oblique,orolla,pair,paired,part,pendent,per,perfect,placenta,plurifoliate,pore,porrect,rachi,rhizomatous,ruit,scattered,septum,sessile,shallowly,short,smaller,sometimes,spaced,sparse,sparsely,stalk,stellae,stellate-pubescent,straight,succulent,tal,tamen,tem,thick,throughout,tissu,tissue,transparent,triangular,truncat,unarme,unarmed,unbranched,unit,upper,vary,wide,x,ympodial	arrangement,articulation,bark,color,connation,corolla,dehiscence,diminishing,distal,foetid,foliage,form,growth,height,history,interjected,leaflet,life,na,ovary,papillae,petiolule,plant,position,pseudostipule,seed,size,spacing,stem,straightnes,terminal,texture,trichome,truncate,tuber-bearing,young
710	wfo-0001031218	success	154	96	57	97	39	0.37	-5,0.5,0.5-1,1-2,15-25,2-22,3-5,4-5,4-8,6-7,8-20,acuminate,apex,base,branched,calyx,cm,connivent,cordate,dark,densely,diameter,directed,distally,ellipsoidal,flattened,fruit,globose,greenish-purple,introrse,lanceolate,lavender,less,long,minutely,mm,mottled,orange,ovate,ovate-elliptic,ovoid,pedicel,peduncle,petiole,pubescent,purple,ripe,simple,stellate,stigma,style,subcoriaceous,tree,tube,violet,x,yellow	1-3,1-4,10-19,2-2.5,2-3,2.5-3,3,3-14,4-28,4-7,4-foliat,40,40-100+,5-37,5-7,5.5-7,6-10,6-9,8-17,abaxially,acute,adaxially,aggregate,apart,ape,apiculate,articulated,axe,basal,beyond,blade,cell,connective,coriaceous,cylindrical,eaf,eed,eglandular,eglandular-pilose,entire,equal,especially,exceeding,exserted,flower,glabrou,glabrous,glandular,glandular-puberulent,hair,leaving,lobe,lon,lower,margin,moderately,narrowly,nflorescence,nther,oblique,obtuse,orolla,papillo,pedicellar,perfect,pore,presen,present,puberulent,purpl,rachi,radiu,remnant,ruit,shorter,slightly,small,sometimes,spaced,sparsely,stamen,stone,succulent,tal,tem,thecae,time,tip,tomento,toward,triangular,truncat,ud,unit,vary,wide,ympodial	anther,arrangement,bark,color,connation,corolla,dehiscence,diminishing,distal,form,growth,height,history,inflorescence,interjected,lateral,leaf,leaflet,length,life,na,ovary,papillae,papillose,perennial,petiolule,plant,pseudostipule,seed,shape,size,spacing,stem,straightnes,surface,terminal,texture,truncate,tuber-bearing
711	wfo-0001031225	success	163	104	70	93	34	0.429	0.2-0.75,0.5,0.7-6,0.75-1,1-1.5,1-5,5-6,7-9,acute,along,anther,apart,apex,bark,base,broadly,calyx,closely,cm,corolla,cup-shaped,elliptic,fruiting,furcate,glabrous,globose,green,growth,inflorescence,lateral,leaf,long,minutely,mm,often,opposite,ovary,ovate,ovoid-reniform,pale,papillose,pedicel,petiole,pitted,plant,poricidal,pubescent,red-papillose,shape,shaped,shrub,size,slender,small,spaced,stem,stigma,straight,style,surface,tan,tear-drop,tip,tree,trichome,tube,uniseriate,vein,white,young	.25,.5,/3,0.1-0.75,0.2,0.5-1,0.8-1,1-1.7,1-3,1.5-5,2,2.5-3,3-9,3/4,5-50-flowered,6-8,9-16,anthesi,beginning,berry,bud,characteristic,conspicuous,darker,decurrent,deltoid,dia,differentiated,differing,difoliate,dry,eaf,edicel,eed,ellipsoid,erect,exserted,filament,flattene,fragrant,free,geminat,glabrate,greyish-brow,inflorescenc,less,like,live,lobe,lobed,lon,lower,main,major,margin,middle,minor,minute,much,narrowly,nflorescence,older,one,outline,pair,papillo,pore,portion,prominent,proximal,raised,reflexed,rest,rhomboidal,rounded,ruit,scar,slightly,soon,specimen,strongly,sweetly,swelling,tall,tapering,ud,unevenly,unit,way,widest,woody,x,ympodial	alternate,arrangement,articulation,color,connation,dehiscence,diameter,diminishing,distal,foetid,foliage,form,fruit,greyish-brown,height,history,interjected,leaflet,length,life,midpoint,na,papillae,peduncle,petiolule,position,prickle,pseudostipule,seed,spacing,straightnes,terminal,texture,tuber-bearing
712	wfo-0001031231	success	175	128	87	88	41	0.497	-2,.5,0.5-1.5,1-2,1-4,13,3-4,37/2,37/3,4-8,5-7,8-10,absent,acuminate,acute,almost,anther,apex,axillary,base,branch,brown,calyx,campanula,campanulate,cluster,cm,corolla,dark,declinate,discoidal,entire,equal,erect,except,flower,fork,glabrous,globose,green,greyish,hair,juvenile,leaf,len,lengthening,less,lobe,long,loosely,marbled,minute,mm,oblong,often,ovary,pedicel,pedicellate,peduncle,petal,pinnatisect,plant,pore,poricidal,purple,rarely,rh,ripening,rounded,rugose-ruminate,seed,sessile,short,shrub,simple,slit,small,sometimes,stigma,stout,style,surface,tinged,tip,toward,violet,x	1-1.5,1-3,1.5-2,2-3,2-4,2.5-3,25-35,80-110,acumen,adherent,along,anthesi,aromatic,aspect,axi,basal,becoming,berry,beyond,blunt,bluntly,branched,cell,clonal,colour,developed,dia,eaf,eed,ellipsoid,elliptic,exceeding,exerted,expanded,facetted,filament,fleshy,flowering,folded,general,glandular,gree,habit,herbarium,interacuminal,lanceolate,lasting,lon,lower,margin,mature,mauve,midrib,nflorescence,occasionally,pedice,pentagonal,plurifoliat,projecting,readily,recurve,ripe,rotate,ruit,several,shallow,shed,sinus,slightly,soft,specimen,stone,stonrgly,succulent,tissue,translucent,triangular,tub,ud,unit,usually,variable,vigorous,well,without,wooded,year,ympodial	arrangement,articulation,bark,color,connation,dehiscence,diameter,diminishing,distal,foetid,foliage,form,fruit,fruiting,growth,height,history,inflorescence,interjected,lateral,leaflet,length,life,na,papillae,petiole,petiolule,position,prickle,pseudostipule,shape,size,spacing,stem,straightnes,terminal,texture,trichome,tube,tuber-bearing,young
713	wfo-0001031252	success	170	116	84	86	32	0.494	0.2-1.5,0.3-1.1,1-2,1.75-5.2,16-33,3-10,3-5,3-6,5-9,5.5-6.5,7-18,absent,acute,anther,apex,articulated,attenuate,axillary,base,brownish,bud,cell,ciliate,clavate,cm,condition,coriaceous,corolla,covering,cuneate,dark,deep,diameter,distal,drying,elliptic,forked,fresh,fruit,glabrous,globose,green,greenish,hair-like,half,herb,high,interjected,lanceolate,lateral,leaflet,margin,medium,mm,moniliform,ovate,ovoid,pedicel,peduncle,petiole,plant,poricidal,purple,rotate,rounded,seed,serrate,simple,sometimes,stigma,straight,stripe,style,subtending,terminal,testal,thick,tip,tube,typically,wall,white,whitish,yellow	0.4-3,1-3,1.3-1.9,12-20,2-3,2.5-7,2.8-3.6,5-17,5-8,5-merou,abaxially,acumen,adaxiall,adaxially,ag,along,alyx,apart,apparently,arranged,axe,bead,berry,blade,capitat,connivent,digestion,dorsally,eaf,edge,eed,entire,enzyme,erec,exceeding,filament,flat,flower,folded,geminat,generally,glabrou,green-white,hal,homostylous,honeycomb-shaped,lengthening,light,like,linear,living,lobe,long,lower,make,mottled,mucilaginous,multiple,necklace,nflorescence,orolla,perfect,plurifoliate,pore,removed,ripe,ruit,seudostipule,slit,spaced,specimen,stamen,stolon,tall,tamen,tem,throughout,tri-,tuber,unit,unwinged,usually,vary,wet,x,ympodial	arrangement,articulation,calyx,capitate,color,dehiscence,diminishing,erect,foetid,foliage,form,fruiting,growth,height,history,inflorescence,leaf,length,life,na,position,pseudostipule,shape,size,spacing,stem,straightnes,surface,texture,trichome,tuber-bearing,young
714	wfo-0001031257	success	206	104	63	143	41	0.306	-12,-6,0.75-2.5,2-4.5,5-8.5,7.5-9,abundant,acuminate,anther,anthesi,apex,attenuate,base,blue-violet,bud,calyx,campanulate,cm,corolla,cuneate,dark,diameter,ellipsoidal,flexuous,foliage,fruiting,glandular,globose,herb,honey-combed,lateral,leaf,length,light,long,longitudinal,mm,odorles,opening,ovate,patent,petiole,pore,poricidal,pubescent,purple,ring,robust,seed,shrub,simple,slightly,slit,stem,stigma,style,tip,trans-ovoidal,trichome,tube,white,within,yellow	-22.5,-5,0,0.4,0.5,0.5-0.8,0.7-1,1-1.2,1-1.3,1.1-1.2,1.5,1.5-1.7,1.5-2,1/10,10-16,11.5-15,2-,3,3.5-,3.5-5.7,4-10,4-4.5,4.5-,5,5-,6-12,6-celled,7-,8,8-celled,abaxially,accrescen,adaxially,ag,aggregate,antrorse,ascending,basal,berry,bicellular,branch,broad,cell,coarsely,coat,connectival,cotyledon,curved,cuticle,deep,densely,dentate,diamete,difoliate,directed,dorsally,eaf,edentate,eed,elliptical,embryo,endosperm,epidermal,erect,filament,finely,free,geminat,glabrous,hair-like,half,head,herbaceous,high,hollow,inconspicuous,inserted,lamina,like,little,lobe,lon,long-stalked,longer,longitudinally,lower,many-seeded,margin,midvein,narrowly,non-glandular,orolla,outward,pair,papillate,pericarp,portion,prolongation,rarely,reduced,ree,rest,ridged,ruit,saddle-shape,scarce,scarcely,secondary,separated,serrate,short-stalked,shorter,single-celled,sinus,small,smooth,solitary,somewhat,spur-like,stalk,stone,strand,striate,subglobose,tem,thecae,thickened,thickening,time,tooth,triangular,unequal,unit,upward,vary,vein,ventrifixed,verrucate,viscid,viscid-pubescen,wall,x,ympodial	accrescent,age,arrangement,articulation,bark,color,connation,dehiscence,diminishing,distal,foetid,form,fruit,growth,height,history,inflorescence,interjected,leaflet,life,midpoint,na,ovary,papillae,pedicel,peduncle,petiolule,plant,position,prickle,pseudostipule,saddle-shaped,shape,size,spacing,straightnes,surface,terminal,texture,tuber-bearing,young
715	wfo-0001031270	success	234	138	108	126	30	0.462	+,0.4-1.5,1,1-1.2,1-4,1/3,10-12,2-3,2-4,3-10,3-20,5-15,6-17,accrescent,anther,anthesi,apart,apex,articulated,bark,base,beginning,berry,bipinnatifid,bright,brown,calyx,capitate,clavate,cm,connivent,densely,depressed-spherical,diameter,differentiated,distal,elliptic,flower,fruiting,glabrous,glandular,glandular-pubescent,growth,herb,inflorescence,investing,later,lateral,leaf,leaf-opposed,length,lobed,long,long-styled,loosely,membranous,midpoint,minute,minutely,mm,obovate,often,ovoid,pale,pedicel,peduncle,petiole,pinnatifid,pitted,plant,poricidal,prickle,prickly,pubescent,red,reddish,reflexed,reniform,ripe,shallowly,short-styled,simple,size,slightly,sparsely,spherical,spreading,stellate,stem,stigma,straight,strongly,style,surface,tan,tapering,tightly,tip,trichome,truncate,tube,uniseriate,way,well,white,yellow,yellowish,½	.5,0.5-1,1-3,1.2-1.6,1.5,1.5-2,10,100,2-2.5,2-20,2-7,2.5-3,3-5,4-5,5,5-10,5-6,5-merous,6-50,7-12,8,9-10,>,abaxial,abaxially,acute,adaxial,adaxiall,along,alyx,arme,associated,basal,blade,brow,c.,cell,celled,colored,conical,consistently,curved,deeply,difoliate,directed,eed,ellipti,entire,equal,erect,few-rayed,filament,free,frui,geminat,gland,green,heavily,heterostylous,infructescence,leafy,like,live,lobe,lon,longer,lower,margin,midvein,mixture,multangulate,multiseriate,narrowly,new,nflorescence,occasionally,older,orolla,oung,outline,pair,papillo,per,pericarp,pore,portion,primary,rachi,ray,rest,rounded,ruit,scar,scattered,secondary,sessile,shallow,shining,short-stalked,shrub,single,sinuate,slender,small,stalk,staminat,straw-colored,tall,tamen,terete,testal,thin,thus,tissue,unit,upward,usually,vary,varying,vein,wice,wid,wide,wing,woody,ympodial	arrangement,articulation,color,connation,corolla,dehiscence,diminishing,foetid,foliage,form,fruit,height,history,interjected,leaflet,life,na,ovary,papillae,petiolule,position,pseudostipule,seed,shape,spacing,straightnes,terminal,texture,tuber-bearing,young
716	wfo-0001031283	success	52	79	23	29	56	0.442	-0.25,0.1-0.15,0.4-0.5,0.7,30-40,acute,apex,base,brown,calyx,cm,diameter,fruit,lateral,narrowly,obovate,pale,pleasant,pubescent,shrub,surface,winged,woody	.7-2.3,0.5-0.7,2.2-2.8,appearance,cell,eed,elongating,erect,fide,give,hair-like,lo,lobe,long,markedly,mm,moore,outgrowth,silky,small,smelling,somewhat,sprawling,spreadin,tall,testa,thick,wall,wide	anther,arrangement,articulation,bark,color,connation,corolla,dehiscence,diminishing,distal,foetid,foliage,form,fruiting,growth,height,history,inflorescence,interjected,leaf,leaflet,length,life,lobed,midpoint,na,ovary,ovoid,papillae,pedicel,peduncle,perennial,petiole,petiolule,plant,position,prickle,pseudostipule,seed,shape,size,spacing,spreading,stem,stigma,straightnes,style,terminal,texture,trichome,tube,tuber-bearing,width,yellow,yellow-green,young
717	wfo-0001031287	success	147	95	60	87	35	0.408	0.5-1.5,0.9-1,1,1-5,1.5-2,3-5,6-7,abaxially,acute,adaxially,anther,bark,base,bi-lobed,branch,calyx,cm,corolla,dark,dendritic,divergently,elliptic,erect,fruiting,glabrous,globose,green,greenish-white,lateral,leaf,lobed,minutely,mm,nearly,ovary,ovoid-reniform,pale,pedicel,petiole,pitted,poricidal,pubescent,reflexed,rounded,shaped,shrub,simple,stem,stigma,strongly,style,surface,tan,tear-drop,tip,trichome,tube,tuft,white,young	.5,1-1.2,1-1.3,1-1.5,1.5-5.5,2-2.5,3-4,4-5,4-6,4.5-5,5-14,6-10-flowered,anthesi,apar,ape,apex,attenuate,axil,bearing,berry,conical,connective,coriaceous,deflexed,deltate,densely,dia,difoliate,eaf,edicel,eed,ellipsoid,elongate,enlarged,exserted,filament,fleshy,free,frui,geminate,internodal,knob,lamina,later,lobe,lon,long,lower,main,many,margin,membranous,middle,nflorescence,occasionally,older,onto,pair,papillo,papillose,planar,plurifoliate,pointed,pore,portion,red-papillose,reddish-brow,ruit,scar,shoot,short,sinus,small,somewhat,spaced,thick,thin,tub,ud,unevenly,unit,vein,widest,winged,woody,x,ympodial	apart,arrangement,articulation,color,connation,dehiscence,diameter,foetid,foliage,form,fruit,growth,height,history,inflorescence,interjected,leaflet,length,life,na,papillae,peduncle,plant,position,present,prickle,pseudostipule,reddish-brown,seed,shape,size,spacing,straightnes,terminal,texture
718	wfo-0001031300	success	219	137	101	118	36	0.461	-4,-5,-6,0.1-0.6,0.2-0.4,0.2-0.7,0.3,0.5-0.9,0.5-18,0.5-2,0.6-1,0.6-1.2,0.7-0.9,0.8-1.5,1-4,1.5-3.5,1/3-1/2,10-30,2-3,3-4,5-15,6-8,absent,acute,anther,apart,apex,apparently,articulated,attenuate,bark,base,berry,calyx,cell,chartaceous,cm,connivent,creeping,curved,diameter,dull,elongating,filiform,flattened,flattened-reniform,fruit,fruiting,glabrescent,glabrous,highly,lateral,leaf,length,lobed,long,mature,maturity,membranous,midpoint,mm,oblanceolate,orange,orange-brown,orange-green,outline,pale,pedicel,peduncle,petiole,pit,poricidal,porrect,prickle,raised,ray,red,reduced,rounded,shrub,simple,small,smooth,spaced,spherical,stalk,stalked,stem,style,surface,tapering,thin,tip,trichome,tube,uniradiate,white,wide,wider,yellow,yellow-orange	-2.2,.5,/4,0-15,0-20,0-3,0-8,0.1,0.1-0.5,0.15-0.7,0.2-0.5,0.2-1,0.3-0.6,0.3-1.3,0.5-1.5,0.6-0.8,0.7-1.2,1-2,1-5,1.2-1.7,1.3-2,1/2-3/4,1/6-1/4,2-,2-4,2-5.5,2-6,2.2-2.3,2.2-2.7,2.5-3.2,3-,4,4.5-6,5-merous,abaxially,also,alyx,apar,apically,ba,blade,branched,brow,brown-green,bulbous,caudat,concolorous,deltate,densely,difoliate,distance,drying,eaf,eed,equal,erect,extending,eye,filament,flower,free,geminat,geniculate,gray-green,hair,herbaceous,infructescence,lobe,lon,longer,lower,margin,midvein,minute,moderately,naked,near,nflorescence,oblong,obtuse,older,one,open,orolla,oung,pair,pendulous,per,perfec,pericarp,portion,prickl,prickly,primary,pubescent,rarely,ruit,scar,sessile,side,sparsely,spreading,stellate,stellate-pubescent,tamen,terete,tertiary,time,unit,vary,vein,venation,visible,way,weakly,winged,yellow-green,ympodial	arrangement,articulation,brown,color,connation,corolla,dehiscence,diminishing,distal,foetid,foliage,form,growth,height,history,inflorescence,interjected,leaflet,life,na,ovary,papillae,petiolule,plant,position,pseudostipule,seed,shape,size,spacing,stigma,straightnes,terminal,texture,tuber-bearing,young
719	wfo-0001031310	success	203	138	103	100	35	0.507	0-3,0.5-3,1-10,1-2,1-3,1-5.5,1-6,1.5-4,15-40,2-3,2.5-5.5,3-10,4-12,5-7,6-7,absent,anther,apex,articulated,attenuate,axillary,base,blue,blue-purple,borne,broadly,brown,brownish,bud,chartaceous,cm,condition,connivent,conspicuously,corolla,cuneate,decreasing,decurrent,diameter,distal,drying,elliptic,end,forked,fresh,fruit,globose,gradually,green,greenish,half,herb,high,interjected,lanceolate,lateral,leaf,leaflet,light,membranous,mm,mucilaginous,narrowly,obtuse,odd-pinnate,ovate,ovate-elliptic,ovoid,pale,pedicel,peduncle,petiole,petiolule,pilose,plant,pointed,poricidal,rachi,rosette-forming,rotate,seed,simple,singly,size,slightly,sometimes,sparsely,stem,stigma,straight,streak,style,subrosette-forming,subtending,terminal,tip,toward,tube,typically,wet,whitish,x,yellow	.5,0-4,2.5-8.5,4-10,4.5-4.8,5-6,5-merou,5.5-21,abaxially,acumen,acuminate,adaxially,ag,along,alyx,apart,apparently,axe,berry,blade,caly,cell,ciliate,covering,digestion,dorsally,eaf,edge,eed,enzyme,erect-decumben,especially,exceeding,extremely,filament,flat,flower,folded,geminat,generally,glabrou,glabrous,green-white,hair,hair-like,homostylous,honeycomb-shaped,larger,lengthening,less,like,living,lobe,long,lower,make,margin,midrib,minutely,mottled,multicellular,nflorescence,orolla,ovate-lanceolate,pair,perfect,plurifoliate,pore,puberulent,pubescent,purple,removed,ruit,seudostipule,shortly,slit,small,somewhat,spaced,specimen,stamen,ste,stolo,subellipsoi,tall,tamen,tem,testal,thick,throughout,tissue,tri-,tuber,unit,unwinged,usually,vary,wall,white,ympodial	arrangement,articulation,bark,calyx,color,connation,dehiscence,diminishing,erect-decumbent,foetid,foliage,form,fruiting,growth,height,history,inflorescence,length,life,na,ovary,papillae,position,prickle,pseudostipule,shape,spacing,stolon,straightnes,subellipsoid,surface,texture,trichome,tuber-bearing,young
720	wfo-0001031316	success	207	112	76	131	36	0.367	-2,0.3-1,0.5-2,0.8-1.8,0.9-1.3,1-5,3-8,4-7,5-10,acuminate,acute,almost,ame,anther,apex,articulated,bark,base,becoming,blue-mauve,bright,broad,c.,calyx,cm,colored,connivent,curved,dark,diameter,dull,flattened-reniform,fruit,fruiting,glabrescent,gray,lateral,leaf,length,lobed,membranous,midpoint,mm,moderately,multangulate,obtuse,orange,orange-brown,ovate,pedicel,peduncle,petiole,poricidal,purple,ray,red-brown,reflexed,sessile,shrub,simple,spherical,stalked,stellate-pubescent,stem,strongly,style,surface,tapering,terminal,tip,trichome,tube,unarmed,white,yellow,young	.1,/3,0.05-0.1,0.05-0.15,0.1-0.2,0.4-0.6,0.4-0.8,0.6-1,0.8-1.2,1.2-2.1,1.3-3.5,1.5-,1.5-2,1.5-3.5,1.5-5,1/3-1/2,1/3-2/3,2-20,2-3,2-4,2.5-8,3-10,3.5-3.8,3.8-5,4,4-9,5-15,5-6,5-8,5-merous,6-20,8-11,8-12,8-25,abaxial,abaxially,adaxial,alyx,apar,apically,apparently,berry,blade,branched,concolorous,contrast,cream,densely,difoliate,discolorous,drying,eaf,eed,elongating,entire,erect,eye,fifth,filament,flower,foliaceou,four,free,geminat,glabrou,glabrous,green,hair,held,herbaceous,infructescence,inward,lobe,long,long-acuminat,longer,lower,lowermost,margin,marking,mature,maturity,minute,naked,narrow-deltate,nflorescence,older,one,open,orolla,oung,pair,pale,pendulous,per,perfec,pericarp,porrect,portion,primary,red-brow,ruit,scar,slender,smooth,sometimes,spaced,sparsely,spreading,stalk,stellate,stellate-pubescen,tamen,terete,tertiary,time,unarme,unequal,unit,usually,variously,vary,vein,venation,visible,way,white-green,whitish,wide,yellow-green,ympodial	arrangement,articulation,color,connation,corolla,dehiscence,diminishing,distal,foetid,foliaceous,foliage,form,growth,height,history,inflorescence,interjected,leaflet,life,na,ovary,papillae,perennial,petiolule,plant,position,prickle,pseudostipule,seed,shape,size,spacing,stigma,straightnes,texture,tuber-bearing
721	wfo-0001031333	success	194	109	71	123	38	0.366	0.1-0.5,1-1.5,1-4,1.5-2,3-4,7-10,7-9,?,acuminate,acute,anther,apart,apex,articulated,base,berry,bilobed,broadly,brown,calyx,capitate,cm,conical,diameter,ellipsoidal,elliptic,flattened,glabrescent,glabrous,globose,golden,green,greenish,growth,immature,inflorescence,membranous,minutely,mm,narrowly,near,ovate,pale,pedicel,peduncle,pentagonal,petiole,pitted,poricidal,pubescent,reniform,simple,somewhat,sparsely,stellate,stem,stigma,style,surface,terminal,tip,trailing,triangular,trichome,truncate,tube,vine,white,whitish,woody,yellow	+,.5,0.5,1-5,1.2-2,1.5,1.5-1.7,1/2,2,2-3,2.5-3,2.7-7,3/4,30-40,5-7,5-8,5-merou,50,<,>,abaxially,adaxiall,adaxially,adjacent,ag,almost,alyx,anthesi,appearing,ark,branche,branched,cell,clustered,collection,composed,crea,cupped,densely,denser,eaf,eed,entire,exserted,filament,flower,free,fruting,glabrescen,half,high,ilament,lamina,leaving,lengthening,less,like,lobe,lobed,long,lower,m.,many,margin,matte,mere,minute,new,nflorescence,nodding,occasionally,older,orolla,outline,pair,papillat,peg,penden,per,perfect,pericarp,planar,plurifoliat,pore,portion,primary,pubescent-papillate,quadrate,rest,rhachi,ruit,scar,sinus,slightly,slit,small,soon,splitting,ste,striped,strongly,tangled,tem,testal,thickened,thin,time,twining,ud,undersurface,undulation,unequal,unevenly,uniseriate,unit,upper,vary,vein,venation,way,x,yellowish,ympodial	arrangement,articulation,bark,color,connation,corolla,cream,dehiscence,diminishing,distal,foetid,foliage,form,fruit,fruiting,height,history,interjected,lateral,leaf,leaflet,length,life,na,ovary,papillae,plant,position,present,prickle,pseudostipule,seed,shape,size,spacing,straightnes,texture,young
722	wfo-0001031333	success	194	105	70	124	35	0.361	0.1-0.5,1-1.5,1-4,1.5-2,3-4,7-10,7-9,?,acuminate,acute,anther,apart,apex,articulated,bark,base,berry,bilobed,broadly,brown,calyx,capitate,cm,conical,corolla,cream,diameter,ellipsoid,elliptic,flattened,fruiting,globose,golden,green,greenish,growth,immature,inflorescence,membranous,minutely,mm,narrowly,near,ovate,pale,pedicel,peduncle,petiole,pitted,poricidal,reniform,rotate-stellate,simple,somewhat,stellate,stem,stigma,style,surface,terminal,tip,trailing,triangular,trichome,truncate,tube,vine,white,whitish,woody	+,.5,0.5,1-5,1-5-2,1.5,1.5-1.7,1/2,2,2-3,2.5-3,2.7-7,3,3/4,30-40,5-7,5-8,5-merou,50,<,>,abaxially,adaxiall,adaxially,adjacent,ag,almost,alyx,anthesi,appearing,branche,branched,cell,clustered,composed,cupped,densely,denser,eaf,eed,entire,exserted,filament,flower,free,glabrescen,glabrescent,glabrous,half,high,ilament,lamina,leaving,lengthening,less,like,lobe,lobed,long,lower,m.,many,margin,matte,mere,minute,new,nflorescence,nodding,occasionally,older,orolla,outline,pair,papillat,peg,penden,per,perfect,pericarp,planar,plurifoliat,pore,portion,primary,pubescent,pubescent-papillate,quadrate,rest,rhachi,ruit,scar,sinus,slightly,slit,small,soon,spaced,sparsely,splitting,striped,strongly,tangled,testal,thickened,thin,time,tub,twinin,ud,undersurface,undulation,unequal,unevenly,uniseriate,unit,upper,vary,vein,venation,way,wide,yellowish,ympodial	arrangement,articulation,color,connation,dehiscence,diminishing,distal,foetid,foliage,form,fruit,height,history,interjected,lateral,leaf,leaflet,length,life,na,ovary,papillae,petiolule,plant,position,prickle,pseudostipule,seed,shape,size,spacing,straightnes,texture,tuber-bearing,young
723	wfo-0001031359	success	166	100	74	92	26	0.446	.02,/4,0.5-1,0.5-6,1-4,1.2-1.6,1.2-2.5,1.5-2,6-7,acuminate,anther,apart,attenuate,axil,bark,base,beneath,berry,bi-lobed,brown,calyx,cm,corolla,dark,dull,elliptic,flattened-reniform,glabrous,globose,lateral,leaf,live,lobed,long,main,minutely,mm,narrowly,nearly,outline,ovary,papillae,papillose,pedicel,petiole,pit,pitted,plant,poricidal,ripe,round,shaped,shiny,shrub,simple,size,stem,stigma,straight,style,surface,tan,tear-drop,tip,trichome,tube,tuft,uniseriate,vein,way,white,yellow,yellow-orange,young	.25,.5,0.75-1,1.1-1.6,1.3-1.6,1.6-2.8,1.9-2.3,12-21,2.5-3,3-3.5,3.6-8.8,5-30-flowered,5-7,5-angled,5.3-7.5,angle,anthesi,apex,apiculate,appearing,ba,beginning,broadly,curled,deflexed,dia,differing,difoliate,distal,dried,eaf,edicel,eed,evenly,extending,filament,free,fruiting,geminat,green,incrassate,inflorescenc,internodal,interpetalar,lamina,lobe,lon,lower,major,margin,membraneous,middle,minor,near,nflorescence,obovoid,occasionally,often,older,one,opposite,originating,pair,paler,papillo,planar,pore,portion,reflexed,ridged,ruit,rusty,scar,sinus,slender,slightly,somewhat,spaced,specimen,strongly,tall,tapering,triangular,tub,ud,undulate,unit,white-lenticellat,widest,woody,x,ympodial	arrangement,color,connation,dehiscence,diameter,form,fruit,growth,height,history,inflorescence,interjected,leaflet,length,life,midpoint,na,peduncle,pseudostipule,seed,shape,spacing,straightnes,terminal,texture,white-lenticellate
724	wfo-0001031362	success	138	97	65	73	32	0.471	.2,1-1.5,1-4,3-4,3-6,?,abaxially,acute,adaxially,anther,apex,attenuate,bark,base,brown,calyx,closely,conical,corolla,dendritic,densely,flattened-reniform,glabrous,globose,incrassate,lanceolate,lateral,leaf,lobed,long,main,margin,minutely,mm,nearly,orange-red,ovary,pair,pale,pedicel,petiole,pitted,poricidal,pubescent,pubesent,red,rounded,shrub,simple,small-capitate,somewhat,spaced,sparsely,stem,stigma,straight,style,subshrub,surface,tan,tip,trichome,tube,vein,white	.3,.5,0.4-0.5,0.5-1,0.7-1,1-1.1,1-3,1-3-flowered,1.5-2,2-2.5,along,anthesi,appearance,berry,branch,bushy,cell,cm,denser,dia,eaf,edicel,eed,ellipsoid,erect,exceeding,exserted,filament,flattened,free,fruiting,giving,golden,golden-brow,inflorescenc,internodal,lamina,like,lobe,lon,long-triangular,lower,middle,nflorescence,nodding,older,opposite,outline,overlappin,packed,papillo,papillose,pericarp,planar,plurifoliat,pore,portion,rectangular,rest,ruit,scar,shaped,shiny,slender,tear-drop,thin,ud,unit,widest,woody,x,ympodial,young	arrangement,color,connation,dehiscence,diameter,diminishing,distal,form,fruit,golden-brown,growth,height,history,inflorescence,interjected,leaflet,length,life,na,overlapping,papillae,peduncle,petiolule,plant,seed,shape,size,spacing,straightnes,terminal,texture,tuber-bearing
725	wfo-0001031363	success	198	95	60	138	35	0.303	0.3-0.7,1-2.2,1.1-1.6,1.5-4,10-11.5,2-3,5-10,absent,acute,anther,apex,articulated,bark,base,broadly,brown,calyx,chartaceous,cm,corky,diameter,extra-axillary,fruit,fruiting,furrowed,globose,green,inflorescence,lateral,leaf,length,lobed,long,midpoint,mm,obtuse,ovate,pale,pedicel,peduncle,perennial,petiole,plant,present,prickle,pseudo-racemose,purple,ray,shallowly,shrub,simple,sparsely,stellate,stellate-pubescent,style,surface,time,tube,unarmed,yellow	%,.3,.5,0-15,0-3,0-30,0-6,0.3-0.5,0.3-0.6,0.4-0.5,0.4-0.8,0.5-0.8,0.5-0.9,0.5-1,0.7-1.5,0.9-1.6,1-2,1-5,1-6,1-locular,1.1-1.4,1.6-2.1,10-12,13-25,2-foliate,2.3-2.5,2.5-7.5,3-4,3-5,3-7,3.5-5.5,3.5-6,30,4-7,4-8,4.5-7.5,5-6,5-7,5-8,5-merou,6-13,6-8,6.5-11,6.5-8.5,7-12,80-120,abaxially,absen,acicular,across,adaxiall,adaxially,adult,alyx,andromonoecious,apart,attenuate,axe,ba,blade,branch,branche,cross-section,cylindrica,decimetre,deltate,densely,directed,distall,distributed,dm,eaf,eed,eglandular,erect,exocarp,finger,flower,functional,geminat,glabrous,gland-tipped,hair,half,heterostylous,incomplete,index,juicy,juvenile,lamina,less,lobe,lobing,longer,lower,margin,mature,mesocarp,midvein,minute,moderately,moist,nflorescence,oblique,orolla,pair,part,per,placenta,pore,porrect,rhizomatous,ruit,semi-circula,septum,sessile,short,side,spaced,stalks-0.1,stellae,straight,tal,tamen,tem,thick,throughout,transparent,unarme,unbranched,unit,upper,vary,vein,weakly,wide,x,ympodial	arrangement,articulation,color,connation,corolla,dehiscence,diminishing,distal,foetid,foliage,form,growth,height,history,interjected,leaflet,life,na,ovary,papillae,petiolule,position,pseudostipule,seed,shape,size,spacing,stem,stigma,straightnes,terminal,texture,trichome,tuber-bearing,young
726	wfo-0001031372	success	192	122	90	102	32	0.469	0,0.05-0.2,0.2-0.8,0.4-0.6,1,1-2,1/4-1/3,10,10-14,2-5,2-7,5-10,accrescent,acute,adaxially,along,anther,apart,apex,articulated,base,blade,blunt-tipped,broad-based,broadly,brown,calyx,central,cm,completely,compressed,connivent,covering,dark,decurrent,densely,diameter,elliptic,enveloping,extra-axillary,flattened,flower,fruit,fruiting,glabrous,globose,green,lanceolate,lateral,laterally,leaf-opposed,length,light,lighter,lilac,long,midpoint,minutely,mm,obtuse,ovate,pedicel,peduncle,perennial,petiole,pitted,prickle,pubescent,ray,recurved,several,simple,somewhat,sparsely,spreading,star,stellate,stellate-pubescent,stem,stigma,style,thin-textured,tube,ultimately,unbranched,weakly,well-developed,white,x,yellow	-1.5,0-15,1.5,10-12,10-30,2-2.5,2-foliate,2.5,2.5-4.5,25-30,3,4-5,5-20,6-9,7,7-10,8-10,8-15,abaxiall,abaxially,acute-,adaxiall,armed,axe,ba,capitat,closely,coarsely,concealing,cylindrical,deltoid,directed,distal,distally,eaf,eed,entirely,female-sterile,filament,foliaceous,geminat,glabrou,hair,interwoven,large,lobe,longer,lower,m.,main,margin,midrib,minute,mostly,much,multiseriate,nflorescence,often,onto,orolla,ovate-lanceolate,perfect,pore,present,prickly,probably,rachi,reaching,reddish,repand,round-tipped,ruit,scattered,short,short-styled,shorter,side,similar,soft-wooded,spaced,stalk,ste,stellae,stellate-woolly,stelliform,stipitate,tal,tamen,tem,termination,time,unarmed,unit,vary,vein,whitish,wide,widely,winged,woolly,ympodial,young	arrangement,articulation,capitate,color,connation,corolla,dehiscence,form,growth,height,herb,history,inflorescence,interjected,leaf,leaflet,life,na,ovary,papillae,plant,position,pseudostipule,seed,shape,size,spacing,straightnes,surface,tall,terminal,texture
727	wfo-0001031389	success	242	104	68	174	36	0.281	0-1,0-2,0.4-1.8,0.8-2.5,1-4,2-6,4-5,5.5-8,8-15,absent,accrescent,almost,anther,apex,articulated,base,calyx,chartaceous,cm,connivent,cuneate,diameter,extra-axillary,fruit,fruiting,globose,inflorescence,lanceolate,lateral,leaf,length,lilac,long,loosely,midpoint,minutely,mm,obtuse,ovate,pale,pedicel,peduncle,perennial,petiole,pitted,plant,present,prickle,pseudo-racemose,pseudo-umbellate,purple,ray,red,reniform,reticulate,reticulately,rotate-stellate,shrub,simple,somewhat,stellate,stigma,style,surface,time,tube,white,yellow	%,0-0.1,0-0.4,0-0.5,0-0.6,0-10,0-3,0.05-0.1,0.25-0.4,0.25-0.5,0.25-0.75mm,0.3-0.5,0.3-0.6,0.3-0.8,0.4-0.6,0.5-1,0.5-1.5,0.5-3,0.6-0.7,0.65-1,0.9-4.5,1-1.5,1-2,1-3,1-5,1-locular,1.3-2.4,1.5-2.5,1.5-3,1.5-4,1.5-5,1.8-3.5,1.9-2.2,11-16,14-18,14-30,2-foliate,2.5-13,20-60,4-5.5,4-7,4-8,5-8,5-merou,6-10,6-12,6-7,6-9,7-8,abaxially,absen,acicular,across,acute,adaxially,adult,alyx,andromonoecious,apart,apparen,axe,ba,becoming,blade,branch,branche,brown,capitat,confined,cylindrical,dark,decimetre,deltate,densely,directed,distall,distally,distributed,dm,eaf,eed,eglandular,entire,erect,exocarp,filament,finger,first,flower,functional,geminat,glabrous,gland-tipped,green,hair,half,heterostylous,homo-,incomplete,interpetalar,juicy,juvenile,lamina,less,lobe,lobed,longer,lower,margin,markedly,mature,mesocarp,mid-point,midrib,midvein,minute,moderate,narrowly,nflorescence,oblique,often,orolla,pair,part,per,perfect,placenta,plump,pore,porrect,rachi,reddish,rhizomatous,rostrate,ruit,scattered,septum,sessile,shallowly,short,solitary,sometimes,spaced,sparse,sparsely,stalk,stellae,stellate-pubescent,straight,succulent,summit,tal,tamen,tem,thick,thicker,thicknes,throughout,tightly,tip,tissu,tissue,triangular,unarme,unarmed,unbranched,unit,upper,vary,weakly,wide,x,yellowish,ympodial	arrangement,articulation,bark,capitate,color,connation,corolla,dehiscence,diminishing,distal,foetid,foliage,form,growth,height,history,interjected,leaflet,life,na,ovary,papillae,petiolule,position,pseudostipule,seed,shape,size,spacing,stem,straightnes,terminal,texture,trichome,tuber-bearing,young
728	wfo-0001031394	success	217	94	49	168	45	0.226	0.5,accrescent,alternate,anther,apex,articulated,base,calyx,cm,diameter,distal,extra-axillary,finely,free,fruit,fruiting,globose,lanceolate,length,light,many,mm,ovate,pedicel,peduncle,petiole,pitted,plant,prickle,purple,red,scattered,sometimes,stellate,stem,stigma,straight,style,subreniform,subshrub,tan,taprooted,terminal,thin-textured,tube,unbranched,white,yellow,yellow-orange	-celled,-rayed,0.2–0.4,0.3,0.3–1.5,0.5–1,0.6–1.6,0.8,1,1.1–1.6,1.2–3.2,1.4–2.1,1.7–4.5,1/2,1/3,1–,1–1.5,1–2,1–3,1–4,2,2-foliat,2.2–2.5,2.5–3,2–3,2–3-celled,2–3.2,2–4,3,3.7–7.6,33–80,3–4,3–5,3–6,4,4–8,5,5–8,64,6–11,6–8,9–13,=,?,abaxially,acicular,acute,adaxially,additional,almost,apart,apparently,appearing,armed,axe,ba,basal,beginning,blade,bottom,branch,branched,broadly,bulbous,caudate,crenulate,curved,cylindrical,densely,directed,distall,eaf,eed,enlarging,even,eventually,fertile,filament,flattened,flower,glabrou,glabrous,gland-tippe,gland-tipped,glandular-pilosulose,glandular-pubescent,hair,halfway,hyaline,investing,leafy,least,less,lobe,lon,long,longest,lower,main,male,margin,maturity,midpoint,midrib,minute,n,narrowly,nflorescence,numerous,one,orolla,overtopped,per,pilose,pore,pubescence,pubescent,quite,rachi,reaching,recurved,reflexed,rounded,ruit,sessile,short,shorter,side,similar,simple,single-celled,slightly,small,smaller,somewhat,spaced,sparse,spreadin,staminate,stellae,sterile,stipitate-glandular,stout,subcordate,tall,taman,tem,thick,thickened,time,tip,tooth,triangular,truncat,unit,usually,variable,vary,vein,wide,x,ympodial,±,–1.5,–2,–3,–5,–6	0.3-1.5,1-2,1-3,1-4,1.7-4.5,2-4,4-8,5-8,arrangement,articulation,bark,color,connation,corolla,dehiscence,diminishing,foetid,foliage,form,growth,height,history,inflorescence,interjected,lateral,leaf,leaflet,life,na,ovary,papillae,petiolule,position,pseudostipule,seed,shape,size,spacing,straightnes,surface,texture,trichome,truncate,tuber-bearing,young
729	wfo-0001031400	success	161	132	95	66	37	0.59	0.25-0.8,0.4-1.7,0.6-1.8,0.7-6,1.5-5,10-11,2-3,2-5,2-9,4-13,4-7,6-23,7-28,abaxial,abruptly,acute,apex,apical,apically,articulate,base,branched,calyx,cell,cm,connate,corolla,covering,cyme,dark,deeply,dehiscent,diameter,dichasial,dichasially,diminishing,distal,ebracteate,forked,globose,green,green-white,hair-like,herbaceous,interjected,introrse,lateral,leaf,leaflet,linear,linear-lanceolate,lobe,long,make,maturing,mm,monochasial,mucilaginous,oblique,odd-pinnate,often,ovoid,pedicel,peduncle,perennial,petiole,plant,poricidally,proximal,puberulent,seed,short,side,size,slit,stellate,stigma,straight,stripe,style,subglabrous,terminal,testal,thick,throughout,tip,tone,toward,tuber-bearing,violet,wall,white,wide,yellow,¼	-3,0.8-1.1,1,1-,1-4,1.2-2,2,3-6-foliat,4-,4-17,4-6.5,5-12.5,7-25,abaxially,absen,acumen,adaxially,apiculate,cuneate,decurrent,digestion,dorsally,eaf,edge,eed,emoval,enzyme,exceeding,filament,flat,flower,folded,forming,generally,globo,half,honeycomb,living,lon,lower,lunat,nflorescence,nther,oblong,occasionally,orolla,pair,pattern,perfect,plan,rachi,reveal,ruit,sessile,seudostipule,specimen,stamen,structure,tal,tem,trilobe,typically,unit,vary,without,ympodial	absent,anther,arrangement,articulation,bark,color,connation,dehiscence,foetid,foliage,form,fruit,fruiting,growth,height,history,inflorescence,length,life,lunate,na,ovary,papillae,position,prickle,pseudostipule,shape,spacing,stem,straightnes,surface,texture,trichome,tube,wet,ye,young
730	wfo-0001031401	success	182	103	73	109	30	0.401	0.6-1.2,1-6,1/2,2-5,2.5-4,3/4,7-9,acute,age,anther,attenuate,bark,base,becoming,bi-lobed,brown,calyx,cm,conical,corolla,dark,dendritic,densely,diameter,elliptic,flattened,fruit,fruiting,globose,golden,golden-yellow,growth,lateral,leaf,lenticular,lobed,matted,minutely,mm,narrowly,occasionally,outline,ovary,pedicel,petiole,pitted,plurifoliate,poricidal,pubescent,purplish-black,pyramidal,reddish-brown,rounded,roundish,short,shrub,slit-like,small,somewhat,stem,stigma,style,surface,terminal,tip,tree,tree-like,trichome,tube,violet,way,white,young	0.5,0.8-1.2,1,1-1.4,1-1.5,1.1-3,1.5-2,2-2.4,3,3.5-4,5,5-7,5-9,8-10,abaxial,abaxially,adaxial,adaxially,along,anthesi,apex,apical,appearing,axi,basal,berry,black,blade,branch,branching,clearly,deciduous,deflexed,deltoid,denser,dichasial,differentiated,drying,eaf,ecuador,ecuadorian,edicel,eed,ew,exserted,filament,finely,flower,fork,free,glabrous,impressed,inserted,less,lobe,long,long-triangular,lower,m.,mesophyll,monochasia,near,new,nflorescence,noddin,nodding,node,often,older,overtopping,pair,papillo,per,pericarp,planar,pore,portion,prominently,puberulent,pubescen,raised,ruit,scar,secondary,shiny,shoot,sleev,sometimes,sparsely,specimen,stamen,ste,strongly,tall,tapering,thin,time,tub,ud,unit,usually,vein,visible,wide,winged,woody,x,yellow,ympodial	arrangement,articulation,color,connation,dehiscence,foetid,foliage,form,height,history,inflorescence,interjected,leaflet,length,life,midpoint,na,papillae,papillose,peduncle,plant,position,prickle,pseudostipule,seed,shape,size,spacing,straightnes,texture
731	wfo-0001031402	success	200	92	57	143	35	0.285	0-0.2,0-0.3,0.2-0.4,0.5-1.3,1-4,10-38,2-3,3-4,7.5-8.5,accrescent,acute,anther,apex,articulated,base,calyx,cm,color,connivent,contiguous,cuneate,diameter,fruit,fruiting,globose,herbaceous,inflorescence,lateral,leaf,leaf-opposed,length,linear,long,mm,moderately,nearly,ovate,ovoid,pedicel,peduncle,petiole,plant,prickle,pseudo-umbellate,purple,resprouter,rotate-stellate,simple,single-flowered,sparsely,stellate-pubescent,stem,stigma,style,tube,unknown,yellow	%,0-3,0.3-0.6,0.3-1.1,0.4-1.2,0.5-0.7,0.5-1,0.5-2.6,0.6-1.2,0.7-1.4,0.8-2.5,0.8-3,1,1-15,1-2,1-3,1-5,1.5-2,1.5-2.5,10-15,10-18,14-18,2-2.5,2-4,2-6,2-8,2-foliate,2.2-12,3-15,3-5,3-5.5,4-7,4-8,5-40,5-merou,6-9,7-15,8-10,abaxially,absen,absent,abundant,acicular,across,adaxiall,adaxially,adult,alyx,andromonoecious,apart,armed,axe,ba,blade,branche,capitat,chartaceous,confined,cylindrical,deeply,deltate,densely,directed,distall,distributed,dm,dult,eaf,eed,eglandular,entire,erect,filament,finger,flower,functional,geminate,glabrou,glabrous,gland-tipped,green,hair,half,heterostylous,index,interpetalar,lamina,lobe,lobed,lobing,lon,longer,lower,margin,mature,midpoint,midrib,midvein,minute,narrowly,nflorescence,oblique,obtuse,orolla,part,per,pore,porrect,possibly,present,projecting,rachi,ray,ripe,ruit,sessile,shallowly,short,shorter,side,spaced,sprawling,stage,stellae,straight,strongly,tal,tamen,thick,throughout,time,tissue,unarmed,unbranched,unit,uvenile,vary,vein,weakly,wide,winged,x,ympodial	arrangement,articulation,bark,capitate,connation,corolla,dehiscence,diminishing,distal,foetid,foliage,form,growth,height,history,interjected,leaflet,life,na,ovary,papillae,petiolule,position,pseudostipule,seed,shape,size,spacing,straightnes,surface,terminal,texture,trichome,tuber-bearing,young
732	wfo-0001031480	success	237	142	113	124	29	0.477	/3,0.1-0.3,0.1-0.4,0.15-0.3,0.2-0.35,0.4,0.5-2,0.7,0.8,0.8-1,1-1.3,1-1.5,1-3,1.5-2.2,1.7-2.2,1/3,2-,2-2.7,2-3,2-6,3-10,3-7,3.5-7,4-6,5-8,6-13,6-30,6-8,7-8,8-12,acute,anther,apart,apex,bark,base,berry,bright,calyx,cell,cm,cream,cuneate,curved,dark,diameter,distal,dull,ellipsoid,elongating,flattened-reniform,fruit,fruiting,glabrescent,glandular,green,hair,lateral,leaf,length,lobed,long,marking,mature,maturity,mauve,midpoint,minutely,mm,obtuse,orange-brown,outline,ovate,pale,pedicel,peduncle,persistent,petiole,pit,plant,poricidal,porrect,purple,raised,red,red-brown,reticulate,scandent,shrub,simple,slender,small,smooth,spherical,spreading,stalk,stalked,stem,straight,style,surface,tapering,terminal,thick-chartaceous,tip,trichome,truncate,tube,unarmed,upper,variously,yellow,young	-0.25,-2,0,0-0.5,0-1,0-2,0-30,0-5,0.1,0.4-0.8,0.5-,0.6-0.8,1-2,1-4,1.8-3,1/2,1/4,1/6-1/5,2-5,3,3-6,4-5,5-merous,abaxial,abaxially,acuminat,adaxial,alyx,andromonoecious,apar,apically,apparently,articulated,ba,blade,branched,branching,broad-deltate,deltate,densely,difoliate,discolorous,distance,drying,eaf,eed,elongate,entire,equal,erect,extending,eye,faint,filament,flattened,flower,free,geminat,glabrous,hermaphrodite,heterostylous,inconspicuous,infructescence,lobe,long-styled,longer,lower,lowermost,margin,midvein,moderately,naked,near,nflorescence,often,older,one,open,orolla,oung,pair,pendulous,per,pericarp,portion,prickle,prickly,primary,pubescent,ray,red-brow,red-green,red-yellow-green,reduced,rounded,ruit,scar,sessile,shallowly,short-styled,shorter,side,slightly,somewhat,spaced,sparsely,staminat,stellate,stellate-pubescent,tamen,terete,tertiary,time,unarme,unit,vary,vein,venation,visible,way,weakly,wide,woody,ympodial	arrangement,color,connation,corolla,dehiscence,diminishing,foetid,foliage,form,growth,height,history,inflorescence,interjected,leaflet,life,na,ovary,papillae,petiolule,pseudostipule,seed,shape,size,spacing,stigma,straightnes,texture,tuber-bearing
733	wfo-0001031482	success	275	121	92	183	29	0.335	-0.6,-16,-18,.5-5,0-0.2,0.02-0.03,0.2-0.3,1-4.5,2-4.6,2.5-10,4-13,4-5,4-6,4-7,8,abaxially,acuminate,acute,adaxially,anther,apart,apex,apical-lateral,attenuate,bark,base,becoming,blue,blunt-tipped,brown,calyx,cm,commonly,continued,corolla,deltoid,diameter,due,elliptic,elongate,extend,flower,fruit,grayish,green,growth,honeycombed,introrse,lanceolate,large,lateral,leaf,length,longitudinal,mm,mostly,oblong,obtuse,pale,pedicel,peduncle,petiole,pore,possibly,reniform,reticulate-punctate,ripe,rotate-stellate,rounded,scabridulous,shrub,simple,slender,slightly,slit,small,somewhat,stellate,stem,stigma,style,subcapitate,subglobose,suborbicular,terminal,tomentose,tree,tube,velutinous,x,yellow,yellowish	-0.06,-0.2,-0.4,-0.5,-1.4,-150,-5,-5.3,-5.5,-6,.04-0.1,.04-0.35,.04-0.5,.06-1,.2-1.6,.5-0.7,.5-3.5,/20-,0-0.3,0-0.4,0-0.6,0-0.7,0.02-0.04,0.02-0.06,0.03-0.04,0.03-0.3,0.04-0.3,0.04-0.4,0.04-0.5,0.04-0.6,0.04-1.4,0.3-0.5,0.5-1.5,0.6-1.8,0.7-1.3,1,1.2-1.5,1.2-3,1.3-4,1.4-2.2,1.6-2.8,1.9-2.5,1/10-1/4,1/2-2/3,2-3.3,2-3.5,2-4.7,2.5-4,2.5-4.5,3.5-4.8,3.7-8,3/4,4.5,5-7,5-80,5-merou,6-11,6-16,9-13,accrescent,adaxiall,ag,along,alyx,anthesi,ape,apparently,appressed,articulated,axe,axillary,ba,berry,beyond,blade,branch,branched,bud,decurrent,dehiscing,densely,directed,eaf,echinoid,eed,ellipti,entire,evident,exserted,farinose,few-rayed,filament,free,fruiting,glabrescent,glabrous,granular-tomentose,hair,high,immature,inserted,interpetalar,irregular,lacking,later,line,lobe,lobed,long,long-stalked,longer,lower,m.,main,margin,midvein,minute,mixed,moderately,multangulate,multiseriate,narrowly,nearly,nflorescence,oblong-orbicular,occasionally,often,older,orolla,ovate,overlapping,perfect,persistent,plurifoliate,porrect-stellate,present,prominent,pubescence,pubescent,rachi,rather,ray,relatively,ribbed,ruit,runk,sessile,short-,short-stalked,side,sometimes,spaced,sparsely,splitting,stalk,stamen,stelliform,subcampanulate,subconical,subspherical,sulcate,suture,tamen,terete,testa,thick,thin,time,tissue,toward,unarme,unarmed,unevenly,unit,usually,vary,vein,way,weakly,white,wide,ympodial,young	0.5-3.5,age,arrangement,color,connation,dehiscence,diminishing,distal,form,height,history,inflorescence,interjected,leaflet,life,na,ovary,papillae,petiolule,plant,pseudostipule,seed,shape,size,spacing,straightnes,surface,texture,tuber-bearing
734	wfo-0001031483	success	154	97	57	97	40	0.37	.5,/2,0.5-2,1-2,2-3,acuminate,acute,almost,anther,apart,apex,attenuate,base,calyx,clavate,cm,corky,corolla,distal,dry,filiform,fresh,fruiting,glabrous,green,indistinct,lateral,leaf,linear,lobed,minutely,mm,oblanceolate,obovate,opposite,ovary,ovoid-reniform,pale,papillose,pedicel,petiole,poricidal,rounded,shape,shrub,slightly,stem,stigma,straight,style,subshrub,tan,tip,tube,turbinate,way,white	0,0.5,1,1.1-2.5,1.2-1.4,1.7-5.5,1/3,11-20.5,2-2.5,2.5-3.2,3-4,3-8-flowered,6-10,7-10,across,anew,anthesi,ba,bearing,beginning,beneath,berry,blade,ca,caly,continuous,cork,decurrent,deflexed,deltoid,dia,difoliate,eaf,edicel,eed,end,evenly,exserted,filament,flower,free,fusiform,geminat,indistinc,internode,larger,lea,lenticellate,less,lobe,long,lower,main,major,markedly,minor,nflorescence,oblong,obovoid,often,orbiculate,pair,paler,papillo,per,planar,pointed,pore,portion,prominent,quite,raised,ruit,scar,shaped,short,short-triangular,simple,slender,somewhat,soon,spaced,strongly,tall,tapering,tear-drop,third,ud,unit,variable,vein,widest,wing,winged,woody,x,ympodial	arrangement,articulation,bark,color,connation,decurrenct,dehiscence,diameter,diminishing,foetid,foliage,form,fruit,growth,height,history,inflorescence,interjected,leaflet,length,life,midpoint,na,papillae,peduncle,petiolule,plant,position,prickle,pseudostipule,seed,size,spacing,straightnes,surface,terminal,texture,trichome,tuber-bearing,young
735	wfo-0001031486	success	166	145	108	58	37	0.651	0.2-0.7,1-2.2,1.5-4,1.5-6,11-37,2-3,2-6,2.5-3.2,2.8-6,3.4-10,5-10,5-16,9-37,abaxially,acuminate,acute,adaxially,almost,apex,apical,apically,articulate,base,branched,calyx,cell,cm,commonly,connate,cordate,corolla,covering,cuneate,cyme,darker,deep,dehiscent,diameter,dichasial,dichasially,diminishing,distal,ebracteate,elliptic,forked,globose,green,green-white,hair-like,half,herbaceous,interjected,introrse,lateral,leaf,leaflet,less,light,lightly,long,make,maturing,mm,monochasial,mucilaginous,oblique,obovate,odd-pinnate,often,ovoid,pedicel,peduncle,pentagonal,perennial,petiole,petiolule,plant,poricidally,proximal,puberulent,pubescent,pure,purple,rotate,seed,short,size,slit,sometimes,spot,stigma,straight,strigose,stripe,style,terminal,testal,thick,throughout,tinged,tip,tuber-bearing,usually,wall,white,wide,yellow,¼	0-1.,0-4.5,0.9-1.7,1-3,1-4,1.8-3.3,2-3.5,3-26,3-6-foliat,3.5-6.5,3.5-8,7.5-22,abruptly,acumen,decurrent,digestion,dorsally,eaf,edge,eed,emoval,enzyme,exceeding,filament,flat,flower,folded,generally,globo,highly,honeycomb,living,lobe,lon,long-attenuate,lower,lunat,nflorescence,nther,orolla,ovate,pair,pattern,perfect,plan,reveal,ruit,seudostipule,specimen,stamen,tal,tem,throughou,toward,typically,unit,vary,ympodial	0-15,anther,arrangement,articulation,bark,color,connation,dehiscence,foetid,foliage,form,fruit,fruiting,growth,height,history,inflorescence,length,life,lunate,na,ovary,papillae,position,prickle,pseudostipule,shape,spacing,stem,straightnes,surface,texture,trichome,tube,wet,ye,young
736	wfo-0001031492	success	175	99	67	108	32	0.383	0.7-1.3,0.9-1.1,2-10,2-3,20,3-5,6-8,acuminate,acute,anther,apex,appearing,attenuate,bark,base,bi-lobed,calyx,cm,corolla,dark,decurrent,diameter,drying,dull,echinoid,elliptic,flattened,fruit,fruiting,globose,golden,grey,growth,lateral,leaf,lenticular,lobed,medium,minutely,mm,narrowly,ovary,pedicel,petiole,pitted,poricidal,pubescent,purplish-black,pyramidal,reddish-brown,shiny,shrub,size,sometimes,sparsely,stem,stigma,style,surface,terminal,tip,tree,tree-like,trichome,tube,violet,young	.5,/4,0.5,08,1-1.3,1-1.5,1.3-2,1.5-1.8,1.5-2.5,10-15,2-5,3-4,4-10,4-4.5,8-11,8-9,abaxially,absent,adaxially,age,anthesi,apical,axe,ba,basal,becoming,beneath,berry,bitter,branching,conical,dbh,deciduous,deltoid,dendritic,densely,denser,distinguishable,eaf,edicel,eed,erect,ew,exserted,filament,flower,free,glabrous,inserted,juice,lamina,lightly,lobe,long,lower,m.,monochasia,nflorescence,nodding,occasionally,older,overtopping,pair,papillo,per,pericarp,planar,plurifoliate,pore,portion,predominantly,prominent,rather,remaining,ruit,scar,scarcely,scattered,secondary,shoot,short,sleeve,slightly,slit-like,somewhat,stamen,ste,sticky,strongly,sunken,tall,tapering,thin,time,tub,ud,undersurface,unit,upper,upturned,vein,way,wide,winged,woody,x,ympodial,younger	arrangement,articulation,color,connation,dehiscence,diminishing,distal,foetid,foliage,form,height,history,inflorescence,interjected,leaflet,length,life,midpoint,na,papillae,peduncle,petiolule,plant,position,prickle,pseudostipule,seed,shape,spacing,straightnes,texture,tuber-bearing
737	wfo-0001031497	success	264	99	61	203	38	0.231	0.1-0.8,0.5-2.5,1-2,2-5,3-10,3-6,3-9,6-9,actinomorphic,adaxially,anther,apex,articulated,attenuate,base,broadly,calyx,cm,coarsely,connivent,diameter,distal,extra-axillary,fruit,globose,inflorescence,lanceolate,lateral,leaf,length,lenticular,light,midpoint,minutely,mm,orange,ovate,pedicel,peduncle,perennial,petiole,pitted,prickle,prickly,pubescent,red,reniform-ovate,simple,stem,stigma,style,surface,tan,thin-textured,tube,unarmed,unbranched,weakly,white,yellow,zygomorphic	-1.4,-30,-35,-7,.1,.1-0.2,0.05-0.2,0.1-0.2,0.2-0.4,0.2-0.5,0.4-1,1,1.2-2,1.2-2.4,1.5-2.5,1.5-4,1/3,1/5-1/3,10-25,12-30,14-,15-,18-25,2-foliate,2.25-3,2.25-4.75,2.5-4,2.5-5,2.8-3.5,20-30,3-15,3-5,4-12,4-locular,4.5-7,4.5-9,5-15,5-8,6-13,7-12,abaxially,acuminate,acute,along,apart,ape,appearance,appearing,appressed,axe,ba,berry,blade,broa,c.,campanulate,cast,cauline,clearly,close,closely,compressed,curved,cylindrical,deciduous,deeply,deltoid,dense,densely,denser,depressed-deltoid,directed,distall,distributed,downcurved,due,eaf,eed,entire,equaling,erect,essentially,external,falcate,female-sterile,filament,flower,foliar,geminat,giving,glabrescent,glabrous,green,hair,high,incised,interlobal,intermixed,large,largely,larger,laterally,less,lignescent,lobe,lon,long,longer,lower,main,major,margin,mature,maturity,minute,nectary,never,nflorescence,numerous,oblique,obsolete,obtuse,occasionally,often,one,orolla,other,otherwise,oung,outer,outline,ovate-lanceolate,pair,per,perfect,persistent,pigmented,pore,presence,present,projecting,pubescence,purple,purplish,rachi,ray,readily,recurved,reduced,rigid,ring,ripe,ruit,scabrous,scattered,section,seldom,sessile,sharp-tipped,short,short-stalked,short-stipitate,side,similar,sinus,slightly,small,smaller,sometimes,somewhat,spaced,species,spreading,stalk,stellae,stellate,stellate-puberulent,stellate-pubescent,strongly,subcapitat,summi,tamen,thickened,three,time,tip,toothlike,truncate,two,type,unit,unlobed,uppermost,upward,usually,vary,varyingly,vein,vestiture,wide,widely,x,ympodial	arrangement,articulation,bark,color,connation,corolla,dehiscence,diminishing,distally,foetid,foliage,form,fruiting,growth,height,herb,history,interjected,leaflet,life,na,ovary,papillae,petiolule,plant,position,pseudostipule,seed,shape,size,spacing,straightnes,subcapitate,terminal,texture,trichome,tuber-bearing,young
738	wfo-0001031503	success	142	91	48	94	43	0.338	-15,-7,0.3-3,0.5-1,0.5-4,1-5,1-7,2.5-10,3-6,7-10,acuminate,acute,angled,apart,articulated,base,branched,calyx,chartaceous,cm,connivent,diameter,elliptic,forked,globose,lanceolate,mm,orange,ovate,pedicel,peduncle,petiole,present,rarely,reddish,rugose-pubescent,shrub,simple,stellate,stigma,style,truncate,tube,unbranched,usually,white,x,yellow	-10,-25,-30,-6,1-,1-2.5,1-3,1.5-2,1.5-3,1.5-7,1.5-8,1.7-3.5,10-19,2-3,3-15,3-4,3-5,5613,6-7,6-many-foliat,7-15,abaxially,abruptly,absen,adaxially,aggregate,apex,axe,ba,blade,cell,cuneate,curled,cylindrical,decurrent,deltate,densely,directed,distall,distally,eaf,eed,eglandular,entire,except,fide,flower,glabrous,gland,hair,lobe,long,lower,margin,moderately,mostly,narrowed,narrowly,nflorescence,nther,obtuse,occasionally,often,orolla,perfect,pore,puberulent,pubescent,rachi,radiu,ripe,rounded,ruit,slightly,spaced,sparsely,stalked,stone,subcapitat,subclavate,tal,tem,time,tip,toward,triangular,unequal,uniseriate,unit,vary,vein,venturi,wide,ympodial	absent,anther,arrangement,articulation,bark,color,connation,corolla,dehiscence,foetid,foliage,form,fruit,fruiting,growth,height,history,inflorescence,interjected,lateral,leaf,leaflet,length,life,na,ovary,papillae,plant,position,prickle,pseudostipule,seed,shape,size,spacing,stem,straightnes,subcapitate,surface,terminal,texture,trichome,young
739	wfo-0001031511	success	231	106	71	160	35	0.307	-3.5,0,0.7-2.1,0.8-2,1-2,10-25,2-6,25-45,5-15,7-11,accrescent,anther,apex,articulated,base,black,brown,calyx,cm,connivent,contiguous,cylindrical,diameter,directed,discoid,distal,dm,ellipsoidal,extra-axillary,forked,fruit,fruiting,globose,inflorescence,lanceolate,lateral,length,light,lobed,minute,minutely,mm,nearly,orange,ovate,pale,pedicel,peduncle,per,perennial,petiole,pitted,plant,prickle,pseudo-racemose,purple,rotate,shallowly,shrub,simple,somewhat,stellate-pubescent,stem,stigma,style,surface,tube,violet,white,x,yellow	%,-12,-15,-5,-7,0-0.3,0-1.1,0-2,0-3,0.1-0.2,0.3-0.5,0.3-0.8,0.3-1.7,0.4-0.7,0.5-0.7,0.5-0.9,0.5-1,0.5-5,0.6-1.5,1,1-1.5,1-3,1-7,1.1-1.6,1.7-2.4,1.8-2.6,10-12,10-18,15-25,17-25,2-3,2-4,2-locular,2.2-3,2.2-4.3,2.5-3,2.8-3.5,3-5,4-10,4.5-7,4.5-9,5-10,5-6,5-7,5-9,5-merou,6-8,6-9,7-8,8-15,9-15,9-20,abaxially,absen,absent,acicular,across,acute,adaxiall,adaxially,alyx,ample,andromonoecious,anvil-shape,apart,armed,axe,ba,basal,bisexual,blade,broadly,chartaceous,conspicuously,cordate,cross-section,cuneate,deltate,dense,densely,distall,dult,eaf,eed,eglandular,entire,erect,exocarp,filament,finger,flower,functional,geminat,glabrous,gland-tipped,green,hair,half,heterostylous,hig,interpetalar,juicy,lamina,less,lobe,lon,long,longer,lower,male,margin,mature,mesocarp,mid-point,midpoint,midrib,midvein,moderately,moist,nflorescence,oblique,obtuse,orolla,part,placenta,plurifoliate,pore,porrect,present,pubescent,rachi,ray,rhizomatous,ripe,ruit,rusty,short,spaced,sparsely,stage,stalk,stalked,stellae,straight,strongly,tamen,thick,throughout,time,tissue,tomentose,triangular,unbranched,unit,unknow,uvenile,vary,wid,wide,ympodial	arrangement,articulation,bark,color,connation,corolla,dehiscence,diminishing,distally,foetid,foliage,form,growth,height,history,interjected,leaf,leaflet,life,na,ovary,papillae,petiolule,position,pseudostipule,seed,shape,size,spacing,straightnes,terminal,texture,trichome,tuber-bearing,young
740	wfo-0001031512	success	199	105	70	129	35	0.352	-3,0.3-1,0.3-1.5,0.5-0.8,0.5-1.5,1-1.5,1.5-3,3-4,4-8,7-10,absent,accrescent,acute,anther,apex,articulated,base,black,brown,brownish-black,calyx,chartaceous,cm,connivent,cuneate,diameter,extra-axillary,first,flat,flower,fruit,fruiting,globose,green,inflorescence,lanceolate,later,lateral,length,lilac,loosely,marbled,minute,mm,obtuse,pedicel,peduncle,perennial,petiole,plant,present,prickle,pseudo-racemose,purple,raised,rotate-stellate,scarcely,shrub,simple,slightly,stem,stigma,straight,style,surface,though,tube,tubercle,twisted,yellow	%,0-10,0-3,0.05-0.1,0.1-0.2,0.15-0.2,0.15-0.25,0.15-0.3,0.2-0.3,0.3-0.5,0.5-0.6,0.5-1.8,0.8-1,0.9-1.5,1-2,1-2.5,1-3,12-15,12-16,13-15,13-16,15-25,2-6,2-foliate,3-5.1,3.8-5.7,4.5-6,4.5-7,5-12,5-7,5-merou,6-13,7-12,8-10,abaxially,absen,abundant,adaxiall,adaxially,alyx,and/or,andromonoecious,apart,axe,ba,blade,broad,broad-based,capitat,cylindrical,decimetr,deltate,densely,directed,distall,distinct,distributed,dr.,dult,eaf,eed,entire,erect,filament,finger,functional,geminat,glabrous,gland-tipped,grey,grey-green,hair,half,heterostylous,interpetalar,lamina,less,lobe,long,longer,lower,margin,mature,mesocarp,mid-point,midpoint,moderately,nflorescence,oblique,orolla,part,per,pore,porrect,pubescent,rachi,ray,rhizomatous,rounded,ruit,sessile,short,smooth,sometimes,spaced,stage,stellae,stellate,stellate-pubescent,strongly,tal,tamen,thick,throughout,time,tissue,unarmed,unbranched,undulate,unit,unknow,uvenile,vary,weakly,white,wide,x,yellowish,ympodial	arrangement,articulation,bark,capitate,color,connation,corolla,dehiscence,diminishing,distal,foetid,foliage,form,growth,height,history,interjected,leaf,leaflet,life,na,ovary,papillae,position,pseudostipule,seed,shape,size,spacing,straightnes,terminal,texture,trichome,tuber-bearing,young
741	wfo-0001031586	success	167	97	59	108	38	0.353	0.1-1,0.5-1,1-1.2,1-2,1.5-2,2,acute,anther,apart,apex,attenuate,bark,base,broadly,calyx,capitate,cm,completely,conical,corolla,cream-colored,elliptic,glabrous,green,greenish,inflorescence,lateral,leaf,minutely,mm,onto,open,opposite,ovary,pale,paler,papillate,pedicel,petiole,poricidal,shaped,shiny,shrub,simple,size,somewhat,sparsely,stem,stigma,straight,style,surface,tear-drop,tip,trichome,truncate,tube,white,young	-2,.25,0.5-0.8,1,1-1.5,1.3-5,1.4-2.5,2-2.5,3-11,5-10,5-6,7-10-flowered,abrupt,absent,anthesi,apparently,appearing,becoming,beneath,borne,branch,bright,bud,campanulate,closer,cucullate,deflexed,deltate,dia,differing,difoliate,distance,drying,eaf,edicel,eed,ellipsoid,exerted,exfoliatin,filament,fleshy,flower,free,fresh,geminate,globose,gree,inflorescenc,know,known,later,leave,lobe,lobed,long,lower,main,major,margin,material,may,minor,mucro,near,nearly,new,nflorescence,notched,occasionally,older,olive,one,overtopping,pair,papillose,planar,pore,portion,present,prominent,raised,remaining,ridged,rounded,ruit,scar,shap,shin,slender,small,sometimes,soon,spaced,swollen,tall,tapering,thick,thickened,trunk,ud,uniseriate,unit,vein,widely,x,yellow,yellowish,ympodial	alternate,arrangement,articulation,color,connation,dehiscence,diameter,diminishing,distal,foetid,foliage,form,fruit,fruiting,growth,height,history,interjected,leaflet,length,life,midpoint,na,papillae,peduncle,perennial,petiolule,plant,position,prickle,pseudostipule,seed,shape,spacing,straightnes,terminal,texture,tuber-bearing
742	wfo-0001031587	success	142	94	56	86	38	0.394	0.8-1,1.7-2,12-16,17-30,2,3-4,5,acute,anther,apex,attenuate,bark,base,bi-lobed,broadly,calyx,clavate,closely,cm,conical,corolla,dendritic,elliptic-ovoid,fleshy,globose,inflorescence,lateral,leaf,lobed,minutely,mm,oblique,ocasionally,ovary,pale,pedicel,petiole,poricidal,pubescent,reddish-grey,shape,shaped,size,soft,spaced,stem,stigma,style,surface,tear-drop,tree,trichome,tube,white,x,young	.5,1-1.5,1.5-2,10-15,2-2.5,2-9-celled,2/3,6-7,6-8,7-9,abaxially,adaxially,along,anthesi,apart,axi,cone,decurrent,deflexed,deltate,densely,denser,dia,differing,drying,eaf,edicel,eed,elliptic,erect,evenly,exserted,fide,filament,free,furcate,glabrous,golden-red,included,irregular,know,known,lamina,later,like,lobe,long,loose,lower,lowered,main,major,middle,minor,mostly,occasional,older,overlappin,pair,papillate,papillo,parallel,perpendicular,persisten,pore,portion,rarely,rect,rest,ruit,scar,simple,somewhat,steinbach,tall,thick,thickened,tip,tub,ud,uniseriate,vein,verrucose,way,widest,winged	arrangement,articulation,color,connation,dehiscence,diameter,diminishing,distal,foetid,foliage,form,fruit,fruiting,growth,height,history,interjected,leaflet,length,life,midpoint,na,overlapping,papillae,papillose,peduncle,perennial,petiolule,plant,position,prickle,pseudostipule,seed,spacing,straightnes,terminal,texture,tuber-bearing
743	wfo-0001031589	success	222	117	82	140	35	0.369	-6,0-10,0.1-0.5,0.2-3,0.4,0.5-1,0.55-0.7,1-1.8,1-5,1.5-5,4-6.5,8-14,anther,apart,apex,articulated,bark,base,bright,calyx,cell,chartaceous,cm,connivent,cream,dark,diameter,dull,elliptic,elongating,flattened-reniform,fruit,fruiting,green,lateral,leaf,length,lobed,long,long-obovate,marking,maturity,mauve,membranous,midpoint,mm,moderately,orange-brown,orange-green,outline,pale,pedicel,petiole,pit,plant,poricidal,porrect,prickle,raised,scandent,sessile,shiny,shrub,simple,small,smooth,sometimes,spherical,stalked,stellate-pubescent,stem,straight,style,surface,tapering,tip,trichome,tube,white,wide,yellow,young	-0.5,-15,-6.5,.5,/6,0,0-1,0-3,0-30,0.1,0.15-0.3,0.2-0.4,0.2-0.5,0.6-1.2,0.7,0.8-2.3,0.9-1.3,0.9-1.6,1,1.2-1.5,1.7-2.5,1.8-2.9,1/3,1/3-1/2,1/3-1/4,10-30,2-,2-10,2-3.5,2.5-4.5,2.5-6,2.8-4,3-4,3-5,3/4,4/5,5-8,5-merous,6-8,8-30,abaxially,acute,alyx,ame,apically,apparently,attenuate,berry,blade,broadly,brow,brown-green,c.,caudat,concolorous,deltate,densely,density,difoliate,discolorous,distance,drying,eed,equal,erect,extending,eye,filament,flower,free,geminat,glabrescent,glabrous,gray-green,higher,infructescence,lengt,lobe,lon,longer,lower,margin,mature,midvein,multangulate,naked,narrow,narrow-cuneate,nflorescence,oblong,obovate,occasionally,often,older,orolla,oung,pair,part,pendulous,per,perfec,pericarp,portion,prickl,prickly,primary,ray,reflexed,rounded,ruit,shorter,side,solitary,somewhat,spaced,sparsely,spreading,stalk,stellate,stout,subentire,subsessile,tamen,terete,tertiary,time,unit,upper,vary,vein,venation,visible,way,weakly,whole,winged,woody,yellow-green,yellow-orange,ympodial	arrangement,articulation,brown,color,connation,corolla,dehiscence,diminishing,distal,foetid,foliage,form,growth,height,history,inflorescence,interjected,leaflet,life,na,ovary,papillae,peduncle,petiolule,position,pseudostipule,seed,shape,size,spacing,stigma,straightnes,terminal,texture,tuber-bearing
744	wfo-0001031609	success	154	114	72	82	42	0.468	0.5-3,1-10,1-6,10-25,2-,2-3,3-24,3-5,3-9-lobed,4-6,4.5-60,abaxially,acute,adaxially,apex,around,articulated,barely,base,beyond,branch,brownish,calyx,campanulate,cm,connivent,contiguous,cuneate,dia,diameter,elliptic,emerging,exserted,flattened,forked,fruit,glabrous,globose,green,inflorescence,leaf,margin,mm,nearly,obovate,obtuse,occasionally,orange,pedicel,peduncle,petiole,pinnately,point,puberulent,reticulate,ripe,shrub,simple,small,stamen,stellate,stigma,style,succulent,tree,truncate,tube,two,unbranched,unlobed,x,yellow	.5,/4,0-30,0.4-3,0.5-1,1.3-3,1.5-2,1.5-3,2,2.5-4,20-25,3-foliat,4,4-5,5-25,5/6,8-20,absen,absent,aggregate,ape,apiculate,axe,bilobe,blade,brow,cell,connective,conspicuous,dark,deltate,dilated,directed,distally,divided,eaf,eed,ellipsoidal,elliptic-ovate,entire,equal,exceeding,fleshy,flower,glabrou,laterally,leaving,lobe,lobed,long,lower,midrib,minutely,nflorescence,nther,obconical,orolla,papillose,pedicellar,pore,rachi,radiu,rounded,ruit,scar,shallowly,sinus,stone,strongly,succulen,tal,tem,thecae,time,tip,tomento,triangular,ud,unit,vary,wide,ympodial	anther,arrangement,articulation,bark,bilobed,color,connation,corolla,dehiscence,diminishing,distal,foetid,foliage,form,fruiting,growth,height,history,interjected,lateral,leaflet,length,life,na,ovary,papillae,plant,position,prickle,pseudostipule,seed,shape,size,spacing,stem,straightnes,surface,terminal,texture,trichome,tuber-bearing,young
745	wfo-0001031615	success	154	105	71	83	34	0.461	.5,0.8-1,0.9-1.1,1-1.6,1.5-5,2-3,5-6,acuminate,acute,anther,apex,attenuate,bark,base,bilobed,brown,calyx,capitate,closely,cm,corolla,deep,dia,distal,elliptic,expanded,flattened-reniform,fruit,fruiting,glabrous,glandular,globose,green,inflorescence,lateral,leaf,lobed,minutely,mm,nearly,opposite,ovary,packed,papillae,papillose,pedicel,petiole,pitted,poricidal,shaped,shrub,size,small,somewhat,stem,stigma,straight,style,subumbellate,surface,tear-drop,terminal,tip,tree,trichome,tube,tuft,uniseriate,urceolate,white,young	0,0.5,0.5-1,1.3-1.8,1.5,11-15.5,2-4.2,3.8-6.1,4-6.5,5-20-flowered,6-8,8-10,anthesi,arising,axil,ba,becoming,berry,caly,dark,dark-papillo,decurrent,deflexed,deltoid,differing,difoliate,eaf,edicel,eed,exserted,filament,free,furcate,geminat,impressed,incrassate,interpetalar,lamina,less,lobe,lon,long,lower,main,major,margin,maroo,middle,minor,minute,nflorescence,occasionally,older,one,overlappin,pair,paler,per,pore,portion,prominent,reflexed,ruit,scar,scarcely,shiny,simple,sinus,slender,slightly,tall,tapering,thickened,thin,ud,unicellular,unit,vein,widest,winged,woody,x,ympodial	alternate,arrangement,articulation,color,connation,dark-papillose,dehiscence,diameter,diminishing,foetid,foliage,form,growth,height,history,interjected,leaflet,length,life,maroon,na,peduncle,perennial,petiolule,plant,position,prickle,pseudostipule,seed,shape,spacing,straightnes,texture,tuber-bearing
746	wfo-0001031618	success	184	107	63	121	44	0.342	-2,0-3,1-1.5,2-3,4-5,5,acute,anther,apex,base,calyx,capitate,cm,corolla,cuneate,cyme,darker,discoidal,equal,except,finely,glabrous,glandular,green,greyish,hair,lavender-purple,leaf,less,long,marbled,maturity,minute,mm,oblong,obovoid,ovary,ovoid,pale,pedicel,peduncle,petiole,pinatisect,poricidal,purple,reddish-brown,reticulate,rotate,rounded,rugose,scorpioid,shrub,simple,somewhat,stem,stigma,stripe,surface,tinged,tip,unequal,variable,young	0.5-1.5,1-7,1.5-2,1.5-3.5,10-18,10-lobed,13,2-2.5,3,3-4,3-8,40-60,5-12,90-110,acuman,almost,also,anthesi,appearance,appearing,aspect,axil,becoming,berry,beyond,blunt,bluntly,branch,broadly,c.,cell,clonal,cluster,column,conical,covering,cut,developed,dia,eaf,eed,ellipsoid,elliptic,emarginate,enlarged,erect,exerted,extending,facetted,filament,fleshy,floral,flower,fork,forked,frui,general,giving,greatly,gree,growing,habit,half,interacuminal,lanceolate,lasting,lengthening,lobe,lobed,lon,loosely,lower,mauve,may,mid-vein,midrib,narrowly,nflorescence,occasional,occur,often,ovate-lanceolate,pal,pedicellate,petal,plurifoliat,point,pore,rarely,rhachi,ripe,ruit,sessile,several,shallowly,side,single,sinus,slit,soft-wooded,sometimes,specimen,stone,stout,strongly,styl,succulent,tapering,terete,tissue,triangular,tub,ud,unit,vigorous,way,well,x,year,ympodial,younger	arrangement,articulation,bark,color,connation,dehiscence,diameter,diminishing,distal,foetid,foliage,form,fruit,fruiting,growth,height,history,inflorescence,interjected,lateral,leaflet,length,life,midpoint,na,papillae,perennial,petiolule,plant,plurifoliate,position,prickle,pseudostipule,seed,shape,size,spacing,straightnes,style,terminal,texture,trichome,tube,tuber-bearing
747	wfo-0001031646	success	171	109	86	85	23	0.503	-7,-pinnate,.2,0.2-0.8,0.5-2,1-10,1-6,1.5-3.5,1.5-4,15-25,2.5-10,20,4-8,5,5-6,5-7.5,7-8,8-15,abaxially,absent,acuminate,acute,adaxially,anther,apart,apex,base,blue,branched,brown,calyx,chartaceous,cm,cuneate,darker,densely,diameter,directed,ellipsoidal,elliptic,elliptic-lanceolate,flattened,flower,fruit,globose,green,high,highly,immature,interjected,lateral,leaf,leaflet,light,maroon,mature,mm,oblique,obliquely,oblong,pedicel,peduncle,petiole,petiolule,pubescent,red,rotate-pentagonal,rounded,rugulose,scandent,shortly,shrub,size,small,smooth,stem,stigma,stout,style,surface,toward,tree,vine,violet,x,yellow	.5,0.8-1.5,1-1.8,1.2-2.5,18-38,1962,2-10,2-2.5,2-3,3.5-4,4-18,4-20,4-5,4-foliate,5-7,5-merou,absen,accrescent,acut,aggregate,alyx,apical,apparently,articulated,axe,ba,basally,berry,blade,cell,ciliat,climbing,connivent,correll,covered,cylindrical,decreasing,distall,eaf,eed,entire,equal,fide,filament,fruiting,geminat,glabrous,glandular,hair,homostylous,hyaline,lobe,long,lower,margin,multicellular,nflorescence,obtuse,orolla,ovate-lanceolat,ovate-lanceolate,part,perfect,pore,present,pubescen,pubescence,rachi,ruit,seudostipule,simple,slightly,spaced,spreading,stone,tamen,tawny,tem,tip,truncat,tube,uniseriate,unit,vary,ympodial	arrangement,color,corolla,dehiscence,diminishing,distal,distally,form,growth,height,history,inflorescence,length,life,perennial,plant,pseudostipule,seed,shape,spacing,terminal,texture,truncate
748	wfo-0001031651	success	201	125	91	110	34	0.453	-2,/3,0.2-0.5,0.3-0.8,0.3-1.5,0.6-1,0.7-1,1,1-4,1.2-2,4-5,absent,anther,apart,apex,apparently,articulated,bark,base,branched,brown,calyx,cell,chartaceous,cm,cordate,curved,dark,densely,diameter,dull,elliptic,elongating,erect,flattened-reniform,fruit,fruiting,glabrescent,gray,herb,lateral,leaf,length,lobed,long,mature,maturity,midpoint,mm,obtuse,orange-brown,outline,ovate,pedicel,peduncle,persistent,petiole,pit,poricidal,porrect,prickle,purple,raised,red,reflexed,rounded,scandent,shrub,simple,small,smooth,sometimes,spherical,spreading,stalk,stalked,stellate-pubescent,stem,straight,style,surface,tapering,terminal,tip,toward,trichome,tube,variously,white,wide,yellow	-3,-3.5,.1,.6,.7,/5,0-20,0.1,0.1-0.15,0.1-0.2,0.1-0.25,0.15-0.2,0.3-0.5,0.6-1.3,1-1.7,1-2,1.2-3,1.3-1.6,1.5-2,1/5,1/6-1/4,2-10,2-3,2-3.5,2/3-3/,3-5,4-6,4.5-7,5-merous,abaxial,abaxially,acuminat,acute,adaxial,alyx,ame,apar,apically,berry,blade,c.,concolorous,deltate,difoliate,discolorous,drying,eaf,eed,entire,equal,eye,faint,filament,filiform,flower,free,geminat,glabrous,gra,herbaceous,infructescence,lanceolate,lobe,longer,lower,margin,naked,nflorescence,oblong,older,one,open,orolla,oung,pair,pendulous,per,perfec,pericarp,portion,prickl,prickly,primary,ray,red-green,ruit,scar,shorter,spaced,stellate,subentire,subsessile,tamen,terete,tertiary,thick,thick-stalked,time,unarme,unarmed,unit,upper,vary,vein,venation,visible,way,weakly,yellow-green,ympodial	arrangement,articulation,color,connation,corolla,dehiscence,diminishing,distal,foetid,foliage,form,growth,height,history,inflorescence,interjected,leaflet,life,na,ovary,papillae,petiolule,plant,position,pseudostipule,seed,shape,size,spacing,stigma,straightnes,texture,tuber-bearing,young
749	wfo-0001031654	success	191	118	78	113	40	0.408	0.5-0.75,0.5-1,0.5-1.5,0.5-2,1-2,1-4,2-5,4-6,4-7,accrescent,anther,apex,attenuate,base,brown,bud,calyx,chartaceous,cm,connivent,contiguous,cream,cylindrical,diameter,extra-axillary,flower,fruit,fruiting,globose,green,hair,immature,leaf,leaf-opposed,like,lobed,many,mature,midpoint,mm,nearly,netlike,often,ovate,parallel,pedicel,peduncle,perpendicular,petiole,pit,porrect-stellate,prickle,pubescent,raised,red,reniform,ridge,rusty,scandent,separated,shrub,simple,small,spaced,sparsely,spreading,stamen,stem,stigma,style,surface,tan,tapering,tube,unbranched,white,x,yellow	0.5,0.5-3.5,1,1-.,1-1.5,1-3,1.5-2,1.5-2.0,1.5-3,1/3-1/2,10-20,2-3,2-6,2-8,2-ranked,3,3-10,3-6,4-16,5-8,5-merou,8-15,abaxial,abaxially,absent,acute,adaxial,adaxiall,adaxially,alyx,apar,apical,apparently,armed,axe,berry,beyond,blade,cordate,cut,cylindrica,dark,decurrent,densely,difoliate,directed,discolorous,eaf,eed,either,em,equa,exserted,filament,flattened,frui,geminate,glabrou,glabrous,interpetaler,introrsel,lacking,less,lobe,long,lower,m.,major,margin,midrib,midvein,moderately,multicellular,multiseriate,narrowly,nflorescence,obscure,obtuse,occasional,occasionally,onto,orolla,pair,per,perfect,pore,rachi,ray,recurved,ruit,secondary,side,sinus,slightly,spine,stalk,ste,stellate,straight,tamen,thin-skinned,tissue,triangular,unarmed,unicellular,unit,usually,vary,vein,way,whitish,wide,ympodial	apart,arrangement,articulation,bark,color,connation,corolla,dehiscence,diminishing,distal,foetid,foliage,form,growth,height,history,inflorescence,interjected,lateral,leaflet,length,life,na,ovary,papillae,petiolule,plant,position,pseudostipule,recurred,seed,shape,size,spacing,straightnes,terminal,texture,trichome,tuber-bearing,young
750	wfo-0001031656	success	154	85	68	86	17	0.442	/4,0.5-1,1-1.5,1-2.5,1.5-2,1.5-5,2.5-3.5,5-ribbed,6-8,anther,bark,base,bright,calyx,capitate,cm,corolla,dia,drying,ellipsoid,elliptic,fleshy,fruit,fruiting,glabrous,globose,green,greyish,leaf,live,lobe,lobed,lower,matte,minor,minutely,mm,often,opposite,ovate,pale,pedicel,petiole,plant,pore,poricidal,rather,red-papillose,reddish,sessile,shaped,shiny,shrub,size,stem,stigma,strongly,style,surface,tear-drop,thick,tip,transversely,tube,way,white,x,young	.5,0.5,1-2,1.2-1.5,10-20,3-3.5,3-5,4-9,5-7,acuminate,acute,also,anthesi,apex,arising,ba,berry,closely,cork,densely,differing,difoliate,directly,eaf,edicel,eed,enclosing,erect,extremely,filament,flower,free,geminat,hooded,known,lateral,lon,long,long-acuminate,main,major,margin,mature,middle,minute,nflorescence,node,oblique,older,one,ovary,pair,paler,papillo,papillose,peelin,persistent,planar,portion,prominent,proximal,reflexed,rib,ridged,rounded,ruit,scar,slightly,somewhat,spaced,specimen,straight,swollen,tall,terminal,thickened,top,ud,unit,upper,vein,visible,wide,widest,woody,ympodial	color,form,growth,height,history,inflorescence,length,life,na,papillae,peeling,perennial,position,seed,shape,texture,trichome
751	wfo-0001031667	success	153	118	81	72	37	0.529	0.6-1,0.6-1.5,1-1.5,10-13,12-35,2-3,2-5,2.5-5,3-13,3-5,8-13,apical,apically,articulate,branched,calyx,cell,cm,connate,corolla,covering,cyme,dark,dehiscent,diameter,dichasial,dichasially,distal,ebracteate,elliptic-lanceolate,forked,generally,globose,green,green-white,hair-like,half,herbaceous,interjected,introrse,lanceolate,lateral,leaf,leaflet,long,make,maturing,mm,monochasial,mucilaginous,odd-pinnate,often,ovoid,pedicel,peduncle,perennial,petiole,pilose,plant,poricidally,proximal,seed,short,size,slit,spot,stellate,stigma,straight,stripe,style,terminal,testal,thick,throughout,tuber-bearing,wall,white,wide,yellow,¼	1-4,1.4-3,1.5-2,2-6,3-6-foliat,3-8,4-1.,5-15,5-9,6-10,8-15,abaxially,abruptly,acumen,acuminate,acute,adaxially,apex,apiculate,base,caudate,cordate,cuneate,digestion,diminishing,dorsally,eaf,edge,eed,emoval,enzyme,exceeding,filament,flat,flower,folded,globo,honeycomb,irregularly,living,lobe,lobed,lon,lower,lunat,nflorescence,nther,oblique,oblong,orolla,pair,pattern,perfect,petiolate,petiolule,plan,reveal,rounded,ruit,sessile,seudostipule,specimen,stamen,tal,tem,toward,typically,unit,vary,whit,without,ympodial	4-10,anther,arrangement,articulation,bark,color,connation,dehiscence,foetid,foliage,form,fruit,fruiting,growth,height,history,inflorescence,length,life,lunate,na,ovary,papillae,position,prickle,pseudostipule,shape,spacing,stem,straightnes,surface,texture,trichome,tube,wet,ye,young
752	wfo-0001031672	success	157	100	56	101	44	0.357	0-2,0.3-0.5,0.5,0.5-1.5,1,1-5,1.5-2,1.5-5,10-20,2-12,6,acuminate,apart,apex,articulated,basal,base,calyx,chartaceous,cm,cordate,diameter,flattened,fruit,glabrous,globose,green,greenish-brown,leaf,leaving,lobe,long,mm,narrowly,near,ovate,ovoid,pedicel,pedicellar,peduncle,petiole,remant,simple,stellate,stigma,style,subcoriaceous,tree,triangular,truncate,tube,unbranched,white,whitish,x,yellow	0,0.5-1,1-,1-1.5,1-10,1-2,1.5-2.5,1.5-3.5,15-20,15-50,2-28,3-4-foliat,3/4,4,4-34,4.5-5,4/5,5-6,9-lobed,abaxially,absent,acute,adaxially,aggregate,ape,apiculate,aublet,axe,beyond,blade,cell,ciliat,connective,cylindrical,densely,directed,distally,divided,eaf,eed,entire,exceeding,exserted,fide,fleshy,flower,glandular-puberulent,hair,lanceolate,lobed,lon,lower,margin,mature,membranaceous,midrib,moderately,nflorescence,nther,obtuse,occasionally,often,one,orolla,perfect,pilo,pilose,pinnately,pore,presen,present,puberulent,pubescent,purple,rachi,radiu,represented,rounded,ruit,shorter,sinus,slightly,small,spaced,sparsely,stamen,stone,tal,tem,thecae,time,tip,toward,truncat,ud,unit,unlobed,vary,wide,yello,ympodial	anther,arrangement,articulation,bark,color,connation,corolla,dehiscence,diminishing,distal,foetid,foliage,form,fruiting,growth,height,history,inflorescence,interjected,lateral,leaflet,length,life,na,ovary,papillae,perennial,petiolule,plant,position,prickle,pseudostipule,seed,shape,size,spacing,stem,straightnes,surface,terminal,texture,trichome,tuber-bearing,young
753	wfo-0001031684	success	161	108	76	85	32	0.472	.75,/4,0.4-1.5,0.5-0.8,0.5-1,1-1.2,1-5,3-3.5,3-30,acuminate,acute,anther,apex,base,calyx,clavate,cm,corolla,curly,densely,difoliate,elliptic,fruiting,geminate,glabrous,globose,green,inflorescence,irregularly,lateral,leaf,lobed,long,midrib,minutely,mm,obconic,occasionally,ovary,ovoid-reniform,pale,papillose,pedicel,petiole,pitted,poricidal,pubescent,raised,scar,shaped,short,shrub,size,slender,slightly,small,spaced,stem,stigma,straight,style,surface,tan,tear-drop,tip,tipped,tree,trichome,tube,unevenly,unifoliate,uniseriate,way,white,widely,young	.25,.5,0.1,0.5-0.7,0.7-1,0.75-1,10-100,2,2-9,4-17,5-7,along,anthesi,apar,bark,bearing,beneath,berry,black,borne,branched,causing,decurrent,deflexed,denser,dia,differing,drying,eaf,edicel,eed,elongated,except,expanded,exserted,extremely,filament,filiform,flower,free,gre,greatly,internodal,less,like,lobe,lon,long-triangular,lower,main,major,middle,minor,nflorescence,older,one,opposite,pair,papillo,persistently,planar,pore,portion,present,previously,pulled,reflexe,reflexed,rest,ruit,single,siz,soon,sparsely,tall,tapering,time,ud,unit,varying,vein,widest,winged,x,ympodial	apart,arrangement,branching,color,connation,decurrence,dehiscence,diam,diameter,expansion,form,fruit,growth,height,history,interjected,leaflet,length,life,na,papillae,peduncle,plant,pseudostipule,raisednes,seed,shape,spacing,straightnes,terminal,texture,winging
754	wfo-0001031690	success	140	146	110	30	36	0.786	.5,1.2-2.0,1/2-2/3,2-3,2-5,2-8,2.5-3.5,2.7-3.6,2/3,4-9,7-10,accrescent,acute,along,always,anther,apex,apically,arcuate,base,bearing,beneath,berry,blade,blue,broadly,brown,calyx,campanulate,cm,completely,corky,da,dark,depressed-spherical,developing,dm,dry,eglandular,erect,exceeded,foveolate,glabrate,glabrous,green,hair,herb,internodal,invested,lanceolate,least,length,linear,lobe,long,main,maturity,minutely,mm,numerous,obtuse,often,ovate,pedicel,perennial,persistent,petiole,pinnatifid,prickle,prickly,rarely,reflexed,reniform,rhizome,root,rounded,scattered,separated,sessile,shape,short,slender,slightly,somewhat,splitting,spreading,stellae,stellate,stem,stipitate-glandular,strait,tapering,terete,thrice,tightly,tube,twice,ultimate,uniseriate,usually,variable,vein,violet,violet-tinged,viscid-glandular,widely,yearly,yellow,young,zygomorphic	6-9-flowere,8-40,acro,alyx,anthesi,cauline,covered,difoliate,divided,eaf,eed,emerging,geminat,lon,nflorescence,orolla,per,ruit,slende,space,tall,tamen,throughout,tigma,tub,tyle,unexpande,unit,vary,ympodial	6-9-flowered,across,alternate,arrangement,color,corolla,covering,dehiscence,difoliation,division,emergence,form,frequency,fruit,geminate,growth,height,history,inflorescence,leaf,life,ovary,pinnation,plant,seed,size,spaced,staman,stigma,stipule,straightnes,style,surface,texture,type,unexpanded
755	wfo-0001031695	success	185	102	66	119	36	0.357	0.5-1,1-9,1.5-8,20-30,3-10,3-7,4-5,6-10,6-20,abruptly,acuminate,also,apex,base,branched,calyx,campanulate,chartaceous,cm,color,connivent,cordate,dark,deep,densely,diameter,ellipsoidal,flattened,fruit,green,greenish,immature,lateral,lavender,leaf,mm,moderately,mottled,narrowly,oblique,occasionally,ovate,pedicel,peduncle,petiole,pilose-hirsute,puberulent,pubescent,purple,purplish,shrub,simple,small,sometimes,somewhat,sparsely,stigma,stripe,style,subcoriaceous,tree,triangular,tube,unbranched,x,yellow	0.5-2,1,1-2,1-3,1.5-2,1/2,1/3,10-,10-15,10-35,15-20,2-3,2-4,2-5,2.5-5,3-,3-17,3-19,30-40,4-10,4-6,4-foliat,5,5-20,5-7,6-8,7-,?,abaxially,acute,adaxially,aggregate,apart,ape,apically,apiculate,articulated,axe,basal,beyond,blade,broadened,capitat,cell,connective,cylindrical,d,dilated,directed,divided,eaf,eed,eglandular,eglandular-pilose,entire,exceeding,exserted,fleshy,flower,glabrate,glabrescent,glabrous,glandular-puberulent,hair,hard,lanceolate,laterally,leaving,lilac,lobe,lobed,lon,long,lower,margin,midrib,nflorescence,nther,oblong,obtuse,often,orolla,ovoid,pedicellar,perfect,pilo,pilose,pilose-hirsut,pore,presen,present,puberulent-pubescent,rachi,radiu,remnant,ripe,rounded,ruit,shorter,sinus,slight,slightly,spaced,stamen,stone,swelling,tal,tem,thecae,time,tip,tomento,unequal,unit,unknown,unlobed,vary,wide,ympodial	anther,arrangement,bark,capitate,connation,corolla,dehiscence,foetid,foliage,form,fruiting,growth,height,history,inflorescence,interjected,leaflet,length,life,na,ovary,papillae,plant,pseudostipule,pubescence,seed,shape,size,spacing,stem,straightnes,surface,terminal,texture,trichome,young
756	wfo-0001031697	success	185	117	74	111	43	0.4	.5,.8,1.2,1.4,1.5–7,15,4,?,accrescent,anther,apex,around,attenuate,base,calyx,cm,completely,cordate,covering,cylindrical,densely,diameter,divergent,except,face,flattened,flower,foveolate,free,fruit,fruiting,globose,herbaceous,lacking,lobe,long,lowest,margin,mm,mostly,ovate-lanceolate,pedicel,peduncle,petiole,pilose,plant,pore,prickle,purple,raised,scattered,shallowly,sharp,simple,size,slender,somewhat,stellate,stem,stigma,straight,style,subreniform,subshrub,terminal,thin-textured,tip,tube,tuberculate,unbranched,white,x,yellow,yellow-brown	-celled,.4,.6,.7,0.1,0.3,0.4,0.5,0.6–1.0,0.8,1,1.2–2.5,10-celled,15–60,1–1.6,1–2,2-celled,2-foliate,2.2,2–3,2–4,3,3.5,3–4,3–8,4-rayed,4.5,4–5,5,6–13,abaxially,acute,adaxially,apparently,axe,blade,branch,consistently,directed,distall,eaf,eed,entire,especially,fertile,few-celled,filament,flowering,frui,geminat,glabrou,glabrous,gland-tippe,gland-tipped,hair,hilum,hyaline,indentation,less,linear,lon,longer,longest,lower,lowermost,major,many,midpoint,minute,mixed,nflorescence,non-glandular,often,orolla,ovate,part,per,pigment,pubescence,pubescent,ruit,sessile,several-celled,shiny,short,shorter,similar,single,small,smaller,sparsely,ste,stellae,tall,tamen,taproo,tem,thick,time,truncat,ultimate,unarme,unarmed,unit,upper,vary,varying,vein,wide,ympodial,–3	1.2-2.5,15-60,3-4,3-8,6-13,arrangement,articulation,bark,color,connation,corolla,dehiscence,diminishing,distal,foetid,foliage,form,growth,height,history,inflorescence,interjected,lateral,leaf,leaflet,length,life,na,ovary,papillae,petiolule,position,pseudostipule,seed,shape,spacing,straightnes,surface,texture,trichome,truncate,tuber-bearing,young
757	wfo-0001031698	success	58	84	37	21	47	0.638	2-2.5,2.5,bark,base,branch,cm,decurrent,deflexed,difoliate,dull,elliptic,fruiting,glabrous,green,leaf,minutely,pale,papillae,pedicel,pitted,reddish-brown,reniform,repandly,rugose,shrub,stem,stout,strongly,surface,tall,wing,winged,woody,x,yellowish,ympodial,young	'',2.5-3,4-4.5,``,ape,dia,eaf,eed,fide,flattened,geminat,incrassate,long,maguire,margin,mm,older,otherwise,paler,persistin,unit	anther,apex,arrangement,articulation,calyx,color,connation,corolla,dehiscence,diameter,diminishing,distal,foetid,foliage,form,fruit,geminate,growth,height,history,inflorescence,interjected,lateral,leaflet,length,life,na,ovary,peduncle,petiole,petiolule,plant,position,prickle,pseudostipule,seed,shape,size,spacing,stigma,straightnes,style,terminal,texture,trichome,tube,tuber-bearing
758	wfo-0001031707	success	178	105	71	107	34	0.399	0.5-1,1-1.3,1-3,1.5-6,2,2-10,2-6,6-7,acuminate,acute,almost,anther,apex,apically,attenuate,axillary,base,brown,calyx,capitate,cm,corolla,diameter,distal,flattened,fruiting,globose,green,greenish,lateral,leaf,leaflet,lobed,minutely,mm,narrower,obovate,occasionally,ovary,papillate,pedicel,petiole,petiolule,pink,pinnate,plant,pointed,poricidal,pubescent,reddish,round,sagittate,simple,slightly,smooth,spaced,stigma,style,surface,terminal,ternate,tip,trichome,tube,uniseriate,usually,vine,white,widely,woody,x	-3,.5,/4,1-1.2,1-1.5,1.2-1.8,1.2-2,1.5-1.7,1.5-2,1/3,16-20,2-3,2-4,24,3,4-5,4-6,5-10-celled,8-12,80-140,9-15,abaxially,absent,adaxially,along,anthesi,apical,axil,basal,basiscopically,bearing,berry,c.,cateniform,cell,clavat,climbing,conical,conspicuously,cucullate,dense,densely,distinct,drying,eaf,edicel,eed,elliptic,endrophilum,enlarged,epidermal,erect,exserted,filament,flap-like,flat,fleshy,flower,four-lobed,free,glabrous,high,horizonta,inflorescenc,lanceolate,less,like,lobe,lon,long,lower,margin,narrowly,nflorescence,oblique,open,pair,penden,per,planar,portion,primary,quadrate,quite,raised,regular,rest,ruit,scar,scattered,smaller,somewhat,sparsely,stout,strongly,tem,thickening,time,tub,type,ud,unifoliat,unit,vein,way,white-lenticellate,ympodial	0.5,8,arrangement,articulation,bark,clavate,color,connation,dehiscence,diminishing,foetid,foliage,form,fruit,growth,height,history,inflorescence,length,life,na,papillae,peduncle,position,prickle,seed,shape,size,spacing,stem,straightnes,texture,tuber-bearing,young
759	wfo-0001031714	success	201	95	71	130	24	0.353	-6,-8,0.2-0.5,1-1.4,1-2,1-3,2-3,3-4,7,absent,anther,armed,articulated,base,berry,bright,broadly,calyx,capitate,closely,cm,corolla,densely,diameter,elliptic,enlarged,flattened,fruiting,globose,growth,inflorescence,juicy,leaf,lobed,markedly,midpoint,minutely,mm,narrowly,nearly,orbicular,pale,pedicel,peduncle,petiole,pitted,poricidal,prickle,pubescent,red,reniform,ripe,shoot,short,shrub,simple,size,spaced,stellate,stem,stigma,style,surface,tapered,terminal,tip,trichome,unarmed,upper,white,yellow	-3.5,.25,0.15-0.3,0.3-0.5,0.4-,0.5,0.5-,0.5-0.6,0.5-0.8,0.7-2.2,0.8-1.2,1,1-4,1.5-2,1.5-2.4,2,2-3.5,2-4,3-3.5,3-6,4-merous,6,6-8.5,7-10,7-8,<,?,abaxial,abaxially,adaxially,anthesi,apex,appearing,arising,axi,bark,basal,broad,broad-based,caly,cell,conical,cup-shaped,dense,eaf,eed,ellipsoid,elongate,entire,equal,erect,especially,exserted,extending,filament,flower,foliose,free,frui,glabrous,greyish,irregular,leafy,lengthening,less,like,lobe,lon,long,longer,lower,margin,membranous,midrib,mixture,new,nflorescence,numerous,oblique,obvious,occasionally,often,older,ovary,pair,papillo,per,perfect,pericarp,planar,plate,plurifoliat,pore,portion,prickly,primary,pubescence,rarely,ray,rectangular,rounded,ruit,scar,sessile,shallowly,short-stalked,shorter,sinuate,slightly,slit,smaller,sometimes,sparsely,spreading,stalked,stout,straight,strongly,testal,thin,tiny,truncate,tube,ud,unit,usually,vein,woody,x,ympodial	arrangement,articulation,color,dehiscence,foetid,foliage,form,fruit,height,history,interjected,lateral,leaflet,length,life,na,plant,position,pseudostipule,seed,shape,spacing,texture,young
760	wfo-0001031721	success	208	101	65	143	36	0.312	0-5,0.2-0.5,0.3-1.1,0.4-2.2,1-1.5,3-10,3-4.5,4-7,5-20,8.5-12.5,accrescent,acicular,anther,apex,articulated,base,black,brown,calyx,chartaceous,cm,cuneate,dark,diameter,elliptic,extra-axillary,flattened,fruit,fruiting,globose,green,herbaceous,inflorescence,lanceolate,lateral,lavender,leaf-opposed,length,long,minutely,mm,obtuse,ovate,pale,pedicel,peduncle,petiole,plant,prickle,purple,resprouter,reticulate,simple,somewhat,stellate,stem,stigma,straight,streak,style,surface,tube,unbranched,yellow,yellowish-green	%,.1,0-0.1,0-1,0-3,0.1-0.2,0.1-0.5,0.25-0.4,0.25-0.5,0.4-0.6,0.4-0.7,0.4-1.6,0.6-1.1,0.6-1.2,0.7-1.2,0.7-1.3,0.8-1.3,1,1-20,1-3,1-3.5,1.1-3.2,1.2-1.7,1.5,11-30,2-4,2.2-3.2,2.5-3,2.7-3.5,3-7,3-foliate,4-5,4-locular,5-11,5-7,5-merou,6-15,6-9,7-10,7-8,7-9,8-15,8-20,abaxially,absen,absent,across,adaxiall,adaxially,alyx,andromonoecious,anvil-shape,apart,axe,ba,blade,capitat,confined,connivent,cross-section,curved,cylindrical,d.,deltate,densely,directed,distall,distributed,dult,eaf,eed,eglandular,entire,erect,exocarp,filament,finger,flower,functional,geminat,glabrous,gland-tipped,grey,hair,half,heterostylous,hig,juicy,lamina,less,lobe,longer,lower,margin,mature,mesocarp,mid-point,midpoint,midrib,midvein,minute,moderately,moist,nflorescence,oblique,orolla,part,per,placenta,pore,porrect,possibly,present,pseudo-racemose,rachi,ray,ruit,semi-circular,sessile,short,solitary,spaced,sparsely,stage,stalk,stalked,stellae,stellate-pubescent,tamen,thick,throughout,time,unarme,unarmed,unit,uvenile,vary,weakly,white,wide,x,yellowish,ympodial	arrangement,articulation,bark,capitate,color,connation,corolla,dehiscence,diminishing,distal,foetid,foliage,form,growth,height,history,interjected,leaf,leaflet,life,na,ovary,papillae,petiolule,position,pseudostipule,seed,shape,size,spacing,straightnes,terminal,texture,trichome,tuber-bearing,young
761	wfo-0001031723	success	228	118	84	144	34	0.368	-1.5,-5,0.1-0.2,0.4-,0.4-1,0.6-1,1-,1-2.5,1-3,1-5,1.5-10,15-45,2-,2-7,2.5-5,4-11,8-20,ame,anther,apex,articulated,bark,base,brown,c.,calyx,chartaceous,cm,connivent,curved,dark,diameter,dull,evenly,flattened-reniform,fruit,fruiting,gently,glabrescent,gray,green,lateral,leaf,length,lobed,long,marking,maturity,mauve,midpoint,mm,moderately,multangulate,orange-brown,ovate,pale,pedicel,peduncle,petiole,poricidal,prickle,ray,red,reflexed,sessile,shrub,simple,sometimes,spherical,stellate-pubescent,stem,straight,style,surface,tapering,terminal,tip,trichome,tube,unarmed,white,wide,yellow,young	-1/2,-15,-16,-2,-6,-6.5,-8,-merous,0,0.05-0.2,0.1-0.3,0.1-0.5,0.15,0.2-1,0.4,0.4-0.9,0.55-0.9,0.7-1,0.8-1.5,1-2,1.2-2,1.5-,1.5-2.5,1/3-1/2,1/4-1/3,1/6-,10-30,2-3.5,2-5.5,2.5-4.5,2/3,2/3-3/4,3-10,3-15,4-,4-10,4-20,4-5,4-6,5-40,5-9,abaxial,abaxially,acuminate,acut,acute,adaxial,alyx,apar,apart,apically,apparently,ba,berry,blade,branched,branching,brow,conical,cuneate,deltate,densely,discolorous,drying,eaf,eed,elongated,elongating,entire,equal,erect,eye,filament,filiform,finely,flower,free,glabrous,gland,gland-tipped,glandular,hair,herbaceous,inflated,infructescence,lobe,longer,lower,margin,mature,minute,naked,narrow-deltate,near,nflorescence,obtuse,older,one,open,orange,orolla,oung,pair,per,perfec,pericarp,perpendicular,plurifoliat,porrect,portion,prickly,primary,recurved,rounded,ruit,scar,secondary,smooth,spaced,sparsely,spreading,stalk,stalked,stellate,strongly,subentire,tamen,terete,tertiary,time,unarme,unit,usually,variously,vary,vein,venation,visible,way,weakly,whitish,woody,yellow-green,ympodial	arrangement,articulation,color,connation,corolla,dehiscence,diminishing,distal,foetid,foliage,form,growth,height,history,inflorescence,interjected,leaflet,life,na,ovary,papillae,perennial,petiolule,plant,position,pseudostipule,seed,shape,size,spacing,stigma,straightnes,texture,tuber-bearing
762	wfo-0001031729	success	161	113	72	89	41	0.447	-0.5,-2,..,0.5,0.5-1,0.6-,1-1.5,1-2,1-2.5,1.5,2.5-,2.5-5,3-4,3.5-4,5-6,5-7,abruptly,acuminate,anther,apex,attenuate,base,calyx,cm,conical,corolla,dark,darker,diameter,elliptic,flattened,fruit,fruiting,glabrous,globose,green,greenish,less,lobed,long,middle,minute,mm,mottling,obovate,occasionally,ovary,ovate-reniform,pair,pale,papillae,pedicel,peduncle,petiole,pink,purplish,reddish,scattered,short,shrub,small,somewhat,stem,stigma,stripe,surface,tan,trichome,tube,white,x,young	-45,0.5-4,1.0-1.3,1.5-2,10-20,11-30,12-13,2-2.5,2-3,3-celled,4.1-16,5-,50,8-9,along,anthesi,apicula,apiculate-deltate,beneath,branc,branch,branched,brittle,brow,c.,cell,cucullate,curve,deltate,dry,drying,eaf,edicel,eed,elongate,erec,filament,flattened-capitat,flower,glandular,gradually,later,lobe,lower,markedly,membranous,minutely,narrowly,nearly,never,nflorescence,noddin,open,outer,outline,papillate,papillose,per,pericarp,planar,plurifoliat,point,pointed,primary,quadrate,regularly,ruit,scar,single,single-stemmed,sinuate,smooth,striate,testa,thin,thing,time,tip,toward,triangular,tuft,ud,unit,usually,vein,wall,wand-like,widening,ympodial	arrangement,articulation,bark,brown,color,connation,dehiscence,diminishing,distal,flattened-capitate,foetid,foliage,form,growth,height,history,inflorescence,interjected,lateral,leaf,leaflet,length,life,midpoint,na,perennial,petiolule,plant,plurifoliate,position,prickle,pseudostipule,seed,shape,size,spacing,straightnes,style,terminal,texture,tuber-bearing
763	wfo-0001031738	success	231	104	71	160	33	0.307	-15,0,0.7-1.1,1-1.5,1-4,1.5-4,10-15,15-40,4-8,almost,anther,apex,articulated,bark,base,calyx,cell,chartaceous,cm,connivent,diameter,distal,dull,elongating,evenly,flattened-reniform,fruit,fruiting,glabrescent,green,lateral,leaf,length,lobed,maturity,midpoint,mm,orange,orange-brown,outline,ovate,pale,pedicel,peduncle,petiole,pit,plant,poricidal,porrect,prickle,raised,sessile,shrub,simple,small,smooth,spherical,stellate-pubescent,stem,straight,style,surface,tapering,terminal,tip,tree,trichome,tube,white,yellow,young	-5,-6,-merous,.5,0-2,0-3,0.1-0.25,0.2-0.3,0.25-0.8,0.3-1,0.7-1,0.9-2.1,1-1.8,1-3,1.4-1.7,1.5-,1/,1/2-2/3,1/3,1/3-2/3,1/4-1/3,1/6-1/4,2-,2-4,2.3-3,20-200,3-4,3-6,3-7,3.5-3.8,3.5-4.5,4,4-10,4-5,4-6,5,5-8,6-15,7-12,7-12.5,8-10,8-18,abaxial,abaxially,acuminat,acute,adaxial,adaxially,always,alyx,andromonoecious,apar,apart,apically,apparently,auriculate,berry,blade,branched,cordate,curved,dark,deltate,densely,discolorous,distance,drying,eaf,eed,equal,erect,extending,filament,flattened,flower,free,frequently,glabrous,gray,held,hermaphrodite,heterostylous,infructescence,inside,lobe,lobing,long,long-styled,longer,lower,lowermost,margin,mature,midvein,multangulate,narrow-deltate,nflorescence,oblong,obovate,often,older,one,open,orolla,oung,pair,per,pericarp,plurifoliat,poorly,portion,prickl,prickly,primary,prominent,pubescent,ray,reflexed,resin,rounded,ruit,scar,secondary,short-styled,shorter,side,sometimes,spaced,sparsely,spreading,stalk,stalked,staminat,stellate,sticky,stout,strongly,tamen,terete,tertiary,time,truncate,unarmed,unit,upper,usually,variously,vary,vein,venation,visible,way,weakly,white-brow,wide,woody,yellow-green,yellow-orange,yellowish,ympodial	arrangement,articulation,color,connation,corolla,dehiscence,diminishing,foetid,foliage,form,growth,height,history,inflorescence,interjected,leaflet,life,na,ovary,papillae,perennial,petiolule,position,pseudostipule,seed,shape,size,spacing,stigma,straightnes,texture,tuber-bearing,white-brown
764	wfo-0001031752	success	172	114	71	101	43	0.413	-10,-47,-6,0.5-1,1,1-2,1-3,1-4,1.5-3.5,15-25,2-3,2-5,3.5-15,5-8,acuminate,acute,apex,articulated,basal,base,calyx,chartaceous,cm,connivent,cuneate,darker,diameter,ellipsoidal,elliptic,flattened,fruit,fusiform,green,immature,lanceolate,leaving,less,light,lobe,long,mm,near,oblong,ovate,pedicel,pedicellar,peduncle,petiole,pink,purplish,remnant,ripe,rounded,rugose,shrub,simple,small,stellate,stigma,stripe,style,subcordate,subcoriaceous,tree,truncate,tube,unbranched,white,x,yellow,young	-100,-3,-44,-pubescent,0.5-1.5,1-,1-1.5,1.5-10.5,1.5-2,1.5-2.5,1.5-3,15-40,2-2.5,20-35,3-11.5,3-4,3-4-foliat,3-7,3.5-5,5-23,5-6,8-15,9-16,abaxially,adaxially,aggregate,apart,ape,apiculate,axe,beyond,blade,cell,ciliat,ciliate,connective,cylindrical,deltate,densely,directed,distally,eaf,eed,entire,equal,exceeding,exserted,fleshy,flower,glabrate,glabrescent,glabrous,gland,glandular-puberulen,glandular-puberulent,linear,lon,lower,margin,membranaceous,moderately,narrowly,nearly,nflorescence,nther,obtuse,often,olde,older,orolla,ovoid,perfect,pore,presen,present,puberulent,pubescent,purpl,rachi,radiu,ruit,slightly,spaced,sparsely,stalked,stamen,stone,swelling,tal,tem,thecae,time,tip,tomentose,triangular,truncat,ud,unit,vary,wide,ympodial	anther,arrangement,articulation,bark,color,connation,corolla,dehiscence,diminishing,distal,foetid,foliage,form,fruiting,growth,height,history,inflorescence,interjected,lateral,leaf,leaflet,length,life,na,ovary,papillae,petiolule,plant,position,prickle,pseudostipule,seed,shape,size,spacing,stem,straightnes,surface,terminal,texture,trichome,tuber-bearing
765	wfo-0001031756	success	186	107	72	114	35	0.387	0-2,0-5,0.1,0.4-1.6,0.5-1,0.8-1,1-4,1.5-3.5,2-6,3-7,4-5,accrescent,anther,apex,articulated,bark,base,calyx,cm,color,connivent,cordate,curved,densely,diameter,enclosing,evenly,finely,flattened-reniform,fruit,fruiting,fully,glabrescent,gray,green,known,leaf,lobed,long,mature,mauve,midpoint,mm,orange-brown,ovate,pale,pedicel,peduncle,petiole,pitted,poricidal,porrect,prickle,rounded,shrub,simple,spherical,stalked,stellate-pubescent,stem,style,surface,tapering,terminal,tip,trichome,truncate,tube,variously,white,wide,young	-1,-5,.1,.5,.8,/2,0,0.02-0.2,0.15-0.25,0.2,0.5-1.3,0.6-1.2,0.6-1.6,0.7-1.7,00,1-1.8,1-2,1-3,1.5-2,1.8-2.5,1/2,1/3,10,3-15,3-5,4.5,5-merous,6-9,7-10,9-14,abaxially,acut,alyx,apar,apart,apically,apparently,berry,blade,branched,broad-deltate,chartaceous,concolorous,conical,deltate,drying,eaf,eed,elongating,entire,equal,erect,eye,filament,flower,free,glabrou,glabrous,herbaceous,inflated,infructescence,invested,lobe,longer,lower,margin,moderately,naked,nflorescence,older,one,open,orolla,oung,pair,pendulous,per,perfec,pericarp,perpendicular,plurifoliat,portion,prickl,prickly,primary,ray,red-brown,ruit,scandent,scar,sessile,shoot,short,shorter,slender,small,smooth,spaced,sparsely,spreading,stalk,stellate,straight,tamen,terete,time,unarmed,unit,vary,vein,visible,way,yellow-green,ympodial	arrangement,articulation,connation,corolla,dehiscence,diminishing,distal,foetid,foliage,form,growth,height,history,inflorescence,interjected,lateral,leaflet,length,life,na,ovary,papillae,perennial,petiolule,plant,position,pseudostipule,seed,shape,size,spacing,stigma,straightnes,texture,tuber-bearing
766	wfo-0001031761	success	207	112	75	132	37	0.362	-6.5,0,0-12,0-4,0.3-0.4,0.3-2.8,0.5-0.7,0.7-1.3,1,1-4,2-3.5,2-8,2.5-5.5,4-7,acute,anther,apart,apex,articulated,bark,base,calyx,cell,cm,connivent,cordate,curved,densely,diameter,dull,elongating,flattened-reniform,fruit,fruiting,lateral,leaf,length,lobed,long,maturity,mauve,midpoint,mm,moderately,orange,orange-brown,outline,ovate,pedicel,peduncle,petiole,pit,poricidal,porrect,prickle,purple,raised,red,rounded,shrub,simple,small,smooth,spherical,stalked,stellate-pubescent,stem,style,surface,tapering,tip,trichome,tube,variously,yellow	-12,-20,-3/,-7,.4,.5,0-0.4,0-10,0-15,0-25,0-5,0.2-0.4,0.3,0.5,0.5-1.5,0.6-1.2,0.7-1.6,0.75-1.7,0.9-2,1-3,1-8,1.5,1.5-4.2,1.5-6,1.8-2.3,1/2,1/2-2/3,1/3,1/3-2/3,1/4-1/3,2,2-4,2.5-3.1,3-15,3-5,3.2-3.5,4-6,5-merous,7-9,abaxially,acicular,acut,alyx,ame,apar,apically,apparently,berry,blade,branched,brow,c.,concolorous,deltate,difoliate,discolorous,distance,drying,eaf,eed,equal,erect,extending,faint,filament,flattened,flower,free,fully,geminat,glabrous,gray-green,infructescence,lobe,longer,lower,margin,mature,midvein,narrow-oblong,nflorescence,older,one,open,opening,orolla,oung,pair,pale,per,perfec,pericarp,perpendicular,portion,prickly,primary,ray,recurved,red-green,scandent,scar,sessile,shallow,side,slender,sometimes,spaced,sparsely,spreading,stalk,stellate,straight,tamen,terete,tertiary,thick-chartaceous,time,uit,unarme,unarmed,unit,upper,vary,vein,venation,visible,way,weakly,wide,woody,yellow-green,ympodial	arrangement,articulation,brown,color,connation,corolla,dehiscence,diminishing,distal,foetid,foliage,form,growth,height,history,inflorescence,interjected,leaflet,life,na,ovary,papillae,perennial,petiolule,plant,position,pseudostipule,seed,shape,size,spacing,stigma,straightnes,terminal,texture,tuber-bearing,young
767	wfo-0001031786	success	209	115	80	129	35	0.383	0-3,0.1-0.4,0.2-2.5,0.5-1.5,0.7-1.6,0.7-4,1-4,1.2-1.6,2-3,2-7,4-5,anther,apart,apex,articulated,bark,base,calyx,cell,chartaceous,cm,connivent,curved,deep,diameter,elliptic,elongating,erect,flattened-reniform,fruit,fruiting,glabrous,herb,lateral,leaf,length,lobed,long,maturity,mauve,membranous,midpoint,minute,mm,orange,outline,ovate,pale,pedicel,peduncle,petiole,pit,poricidal,porrect,prickle,raised,red,scandent,sessile,shiny,shrub,simple,small,smooth,spherical,spreading,stalked,stem,stigma,style,surface,tapering,tip,trichome,tube,variously,white,wide,yellow-orange,young	-5,.4,.5,/2,/3,0,0-2,0-20,0-5,0.1,0.2-0.3,0.25-0.5,0.7-1,0.8,0.8-1.2,1,1-2,1-3,1-6,1.5-1.9,1.5-2.5,1/3-1/2,2-13,2-8,2.5-3.5,3-4,3-5.5,5-7,5-merous,6-8,8-12,abaxially,acut,acute,almost,alyx,ame,apar,apically,apparently,becoming,berry,blade,branched,c.,clavat,concolorous,cuneate,dark,deltate,densely,distance,drying,eaf,eed,equal,evenly,extending,eye,filament,filiform,flattened,flower,free,glabrescent,gray,gray-brow,green,herbaceous,inconspicuous,infructescence,lobe,lon,longer,lower,margin,mature,midvein,naked,nflorescence,obtuse,older,one,open,orange-brown,orolla,oung,pair,pendulous,per,perfec,pericarp,plurifoliat,portion,prickl,prickly,primary,ray,red-brown,reflexed,rounded,ruit,scar,shorter,side,slightly,sometimes,spaced,sparsely,stalk,stellate,stellate-pubescent,straight,tamen,terete,tertiary,thick,time,truncate,unarmed,unit,vary,vein,venation,visible,way,weakly,woody,ympodial	arrangement,articulation,clavate,color,connation,corolla,dehiscence,diminishing,distal,foetid,foliage,form,gray-brown,growth,height,history,inflorescence,interjected,leaflet,life,na,ovary,papillae,petiolule,plant,position,pseudostipule,seed,shape,size,spacing,straightnes,terminal,texture,tuber-bearing
768	wfo-0001031791	success	288	130	85	203	45	0.295	1.6,1/3,3,3.0,acute,alveolate,anther,apex,apical,area,articulated,attenuate,backward,base,calyx,central,chartaceous,cm,connivent,cordate,corolla,dehiscence,diameter,dry,erect,extra-axillary,flattened-reniform,flattened-suborbicular,flower,fruit,globose,green,immature,inclined,inflorescence,internode,lanceolate,lateral,lavender,leaf,length,light,margin,mature,middle,midpoint,minute,mm,nearly,oblique,one,orange-red,oval,pedicel,peduncle,petiole,pore,prickle,ray,rounded,shrub,side,simple,slender,slightly,small,smooth,sometimes,stem,stigma,straight,style,subcoriaceous,surface,thrice-branched,tree,triangular,truncate,tube,twice,white,yellow,yellow-tan,young,×	.08,.2,.3,.4,.5,.9,0.04,0.2,0.3–0.5,0.3–0.6,0.3–0.7,0.4–0.6,0.5,0.5–0.6,0.5–1.0,0.7,0.7–0.8,0.7–1.0,1.1–1.4,1.3–1.8,1.5,1.5–1.9,1.5–2.3,1.5–3.0,1.6–2.2,1.7–2.3,1.8,1.9–2.2,11–14,11–15,13.0–30.0,15.0,2.0–11.0,2.0–2.5,2.6–3.4,2.8–3.3,2/3,3.0–3.5,33–54,4.6–5.4,4.9,4.9–7.4,5-merou,6.0,6.0–14.0,6.2–8.5,7.0–9.0,7–10,7–8,8.0–11.0,8–12,9.0–16.0,abaxially,across,adaxiall,adaxially,adnate,alyx,anthesi,apiculate,apparently,appearing,appressed,around,attachment,axe,ba,berry,blade,branch,broad,broad-based,brochidodromous,bud,capitat,channeled,congested,curved,densely,dentate,developed,development,difoliate,distally,distinct,dorsally,drying,eaf,eed,either,emerging,endocarp,entir,entire,especially,fertile,filament,filiform,first,flexed,fork,free,frui,geminat,glabrescent,glabrous,glandular,gradually,hair,homostylous,increasing,interpetalar,intersepalar,juic,juvenile,lamina,large,largest,like,line,lobe,lon,long,longer,lower,m.,major,material,maturing,membranaceous,midrib,midvein,minor,moderately,multangulate,nflorescence,notched,numerous,obscured,often,orolla,oung,ovoid,particularly,persisting,point,poorly,porrect,porrect-stellate,portion,potentially,preserved,project,pubescent,raised,rigid,ripe,row,rugose,ruit,scarcely,scattered,sessile,shiny,short,shorter,single,sinus,smaller,somewhat,sparsely,splitting,stamen,stellae,stellate,stellate-pubescen,stipe,stipitate,suture,tamen,tardily,time,tip,tissue,totally,translucent,two,ud,unarmed,undulate,various,vary,vein,wavy,weakly,well,wide,yellow-brown,ympodia,±90°at,±equal,±glabrous,±laterally	0.3-0.5,0.5-1.0,1.5-1.9,2.0-11.0,2.0-2.5,2.8-3.3,3.0-3.5,5.5,6.2-8.5,7-8,8.0-11.0,arrangement,articulation,bark,capitate,color,connation,diminishing,distal,foetid,foliage,form,fruiting,growth,height,history,interjected,leaflet,life,na,ovary,papillae,petiolule,plant,position,pseudostipule,seed,shape,size,spacing,straightnes,terminal,texture,trichome,tuber-bearing
769	wfo-0001031793	success	188	120	82	106	38	0.436	-4,0,1-2,1-8,1.5-4,1/3,1/5,10-15,2-3,26,3-8,accrescent,acuminate,acute,aging,almost,anther,apex,articulated,base,black,branched,broadly,brownish,calyx,capitate,cm,cuneate,densely,diameter,distal,elliptic,erect,evident,extra-axillary,forked,fruit,fruiting,globose,inflorescence,leaf,lobing,long,midpoint,midrib,minutely,mm,oblong-lanceolate,obtuse,older,orange-yellow,orbicular-ovate,ovate,pedicel,peduncle,petiole,porocidal,prickle,reduced,rounded,scarcely,shrub,simple,sinus,size,small,stellate,stellate-pubescent,stem,stigma,style,surface,tip,tree,trichome,tube,unbranched,way,white,x,yellow,yellow-brown	.5,1,1-1.5,1-3,1.5-2,1/4,13-20,15-20,2-5,20,3-4,3/4,4,40,5-merous,7,8-11,absent,abundant,acumen,adult,alyx,apparently,armed,aspect,axe,ba,berry,bilobe,blade,branche,broad,brown,central,chartaceous,cut,difoliate,eaf,eed,elongatin,erec,extreme,ferrugineous,filament,flattened,flower,geminat,general,glandular,hair,homostylou,interpetalar,larger,linear,lobe,lon,lower,main,many,margin,maturing,mostly,mucilaginous,nflorescence,oblique,often,orolla,per,perfect,pore,porrect,principal,pubescent,rachi,reddish,reticulation,ruit,rusty,scattered,sessile,shallow,side,similar,single,smaller,sparsely,stellate-pubescen,stipitate,stout,tall,tamen,tem,testa,thickened,tissue,triangular,triangular-acuminat,unarmed,unit,upward,usually,uvenile,vary,well-developed,woody,ympodial	arrangement,articulation,bark,bilobed,color,connation,corolla,dehiscence,depth,diminishing,foetid,foliage,form,growth,height,history,interjected,juvenile,lateral,leaflet,length,life,na,ovary,papillae,perennial,petiolule,plant,position,pseudostipule,seed,shape,spacing,straightnes,terminal,texture,tuber-bearing,young
770	wfo-0001031795	success	234	134	100	134	34	0.427	0.5,0.5-1,0.5-2,1-1.2,1-3,1-4,1.5-4,10,10-12,2-6,2/3,3,4-6,5,acuminate,acute,anther,apex,armed,articulated,bark,base,berry,branched,broad-based,brownish,calyx,capitate,cm,connivent,curved,dark,densely,diameter,elliptic,evenly,flattened,fruiting,globose,grayish,green,growth,irregularly,lateral,leaf,leaf-opposed,live,lobe,lobed,long,long-stalked,many-branched,midpoint,minutely,mixture,mm,oblique,occasionally,ovate,pale,pedicel,peduncle,persistent,petiole,pitted,plant,poricidal,porrect,prickle,prickly,pubescent,reniform,ripe,sessile,shape,short-,shrub,simple,size,smooth,spaced,sparsely,stellate,stem,stigma,style,surface,tan,tapering,time,tip,trichome,truncate,tube,unarmed,way,white,yellowish,young,½	..,.2,.5,1,1-1.3,1.5-2,1/3,100,2-2.5,2.5-3,3-4,4-,4-5,5-12,5-40+,5-merous,5.5-,50,6-8,7-9,9-17,<,>,abaxial,abaxially,absent,adaxial,adaxiall,alf,almost,along,always,alyx,anthesi,apar,around,blade,broadly,c.,caudate,cell,clearly,conical,deeply,denser,differing,difoliate,directed,discolorous,distally,dry,eaf,eed,entire,equal,filament,flower,free,geminat,geminate,glabrescent,glabrous,gland-tipped,glandular,gra,infructescence,lamina,like,lon,longer,lower,major,margin,matte,membranous,midrib,midvein,minor,much,multangulate,multiseriate,never,new,nflorescence,often,older,orolla,oung,outline,pair,papillat,pendant,per,perfec,pericarp,pore,portion,primary,ray,reduced,reflexed,ruit,scar,scattered,shallowly,shiny,short,short-stalked,sinuate,slender,slightly,somewhat,spreading,stalk,stellate-pubescent,straigh,tamen,terete,testal,thicker,thin,toward,triangular,unarme,unicellular,unit,upward,usually,vary,vein,visible,wide,woody,ympodial	apart,arrangement,articulation,color,connation,corolla,dehiscence,diminishing,distal,foetid,foliage,form,fruit,gray,height,history,inflorescence,interjected,leaflet,length,life,na,ovary,papillae,papillate,petiolule,position,pseudostipule,seed,spacing,straightnes,terminal,texture,tuber-bearing
771	wfo-0001031829	success	138	81	45	93	36	0.326	0.7-1,1-2,1.5-2.5,2-4,acute,anther,apex,bark,base,calyx,capitate,cm,corolla,deflexed,elliptic,fruiting,globose,green,greenish-brown,growth,inflorescence,lateral,leaf,lobed,mm,opposite,ovary,pedicel,petiole,poricidal,pubescent,shaped,shrub,simple,size,stem,stigma,style,surface,tear-drop,trichome,tube,uniseriate,white,young	.25,.5,0.5-2.1,1,1.3-1.5,1.5-2,1.5-3.5,1.5-4.5,3-5-flowered,3/4,4-4.5,4-8.5,7-10,abaxially,absent,adaxial,adaxially,along,anthesi,ape,apiculae,bae,berry,branched,broadly,conical,crystalline,densely,denser,dia,differing,difoliate,drying,eaf,edicel,eed,epidermi,erect,exserted,filament,free,geminat,glabrat,glabrous,immature,known,large-celled,leathery,like,lobe,lon,long,lower,main,major,margin,minor,minute,minutely,nflorescence,occasionally,often,older,overlappin,packed,pair,papillo,papillose,planar,pore,portion,quadrate,revolute,ruit,scar,soft,somewhat,sparsely,tall,tapering,thick,tip,tub,tuft,ud,unit,vein,waxy,way,woody,x,yellowish,ympodial	arrangement,articulation,color,connation,dehiscence,diameter,diminishing,distal,foetid,foliage,form,fruit,glabrate,height,history,interjected,leaflet,length,life,midpoint,na,papillae,peduncle,perennial,petiolule,plant,position,prickle,pseudostipule,seed,shape,spacing,straightnes,terminal,texture,tuber-bearing
772	wfo-0001031832	success	232	118	87	145	31	0.375	0.1-0.3,0.2-1.5,0.3-3,1-12,1.2-2.5,14,2-6,2.5-6.5,3-6.5,4-20,5-21,9,acuminate,adaxially,anther,apart,apex,apical-lateral,attenuate,bark,base,becoming,blunt-tipped,brown,bullate,calyx,closely,cm,connate,continued,corolla,deltoid,diameter,due,extend,flower,fruit,globose,greenish,growth,high,honeycombed,introrse,lanceolate,large,lateral,leaf,length,long,longitudinal,mm,mostly,oblanceolate,oblong,occasionally,pale,pedicel,peduncle,petiole,pore,probably,reniform,reticulate-punctate,ripe,rotate-stellate,scabrous,shrub,simple,slit,smooth,spaced,stem,stigma,style,suborbicular,surface,terminal,testa,tree,tube,unarmed,violet,white,x,yellow,yellowish,young	-8,.5-1,/50-1/10,0-150,0.2-0.6,0.3-0.8,0.7-1.5,0.7-1.6,0.7-2,0.8-1.2,1.1-2.4,1.2-1.6,1.2-2,1.3-4.2,1.5-4,1.7-4,1.8-4,1/2-3/4,2-3.6,2-4,2.8-4.8,3-7,3.5-7,4-7,5.5-10,7-10,8-25,abaxially,accrescent,acute,ag,anthesi,apice,apparently,articulated,axe,axillary,ba,basal,berry,blade,blister,branch,branched,brownish,bud,capitat,chartaceous,conical,dark,decurrent,dehiscing,directed,eaf,eed,entire,evident,exserted,ferrugineous,few-rayed,filament,fleshy,forming,free,fruiting,glabrescen,glabrescent,glabrous,granular-tomentose,green,hair,half,indument,inserted,lackin,line,lobe,lobed,long-,longer,lower,m.,main,margin,midvein,minute,mixed,multangulate,nearly,nflorescence,obovoid,obtuse,older,orbicular,orolla,ovate,partly,perfect,persistent,pitted,plurifoliate,porrect-stellat,porrect-stellate,pubescence,pubescent,rachi,rather,ray,relatively,rough,ruit,runk,sessile,short-,short-stalked,side,sometimes,somewhat,soon,sparingly,sparse,splitting,stamen,stellate-pubescent,stipitate-glandular,subcampanulate,suture,swelling,tamen,terete,thick,thick-stalked,time,toward,translucent,unarme,unit,usually,vary,vein,way,weakly,whitish,wide,ympodial	age,arrangement,capitate,color,connation,dehiscence,diminishing,distal,foetid,foliage,form,height,history,inflorescence,interjected,leaflet,life,na,ovary,papillae,petiolule,plant,pseudostipule,seed,shape,size,spacing,straightnes,texture,trichome,tuber-bearing
773	wfo-0001031834	success	150	99	60	90	39	0.4	0.5-1,0.5-3,0.5-3.5,0.6-1.4,0.8-1,1,2/3,6-7,acuminate,acute,anther,apex,attenuate,base,calyx,cm,corolla,flattened-reniform,fruit,fruiting,globose,green,greenish-yellow,hooked,leaf,less,lobed,long,minute,minutely,mm,opposite,ovary,ovate,pale,papillose,pedicel,petiole,pitted,poricidal,scabrous,shaped,short,shrub,simple,slender,stem,stigma,straight,style,surface,tan,tear-drop,tip,trichome,tube,way,white,yellow,young	.5,0.5,0.8-1.3,0.9-1.4,1.5,1.5-4,1.6-2,1.9-6.5,2.9-7,6.5-14,accrescent,across,anthesi,apar,apically,apiculate,appear,berry,bi-cellular,borne,campanulate,covered,deciduou,deciduous,decurrent,deflexed,deltoid,depression,dia,difoliate,eaf,edicel,eed,expanded,eye,few-flowered,filament,free,geminat,glabrou,glabrous,hook,incrassate,lamina,larger,leaving,like,lobe,lon,lower,major,margin,markedly,middle,minor,mound-like,multicellular,naked,nflorescence,often,papillo,persistent,planar,pore,portion,proximal,pubescent,ruit,scar,slightly,small,soon,spaced,sparsely,speck,tall,tapering,tufted,ud,unevenly,uni-,uniseriate,unit,upper,usually,vein,widest,woody,x,ympodial	apart,arrangement,articulation,bark,color,connation,dehiscence,diameter,diminishing,distal,foetid,foliage,form,growth,height,history,inflorescence,interjected,lateral,leaflet,length,life,na,papillae,peduncle,perennial,petiolule,plant,position,prickle,pseudostipule,seed,shape,size,spacing,straightnes,terminal,texture,tuber-bearing
774	wfo-0001031839	success	138	88	64	74	24	0.464	1,1-1.4,1.2-1.5,1/3-2/3,2.5-3.5,3-7,4-8,6-15,7-10,8-15,9-12,anther,apically,arcuate,base,beneath,blade,blue,blue-tinged,broadly,brown,calyx,cm,dark,dark-based,density,dry,foveolate,glabrous,green,herb,internodal,lenticular,linear-lanceolate,long,maturity,minutely,mm,olivaceous,otherwise,ovary,ovate,pale,perennial,petiole,pinnatifid,prickle,purple,root,smooth,spherical,splitting,stellate-pentagonal,stellate-pubescent,stem,subulate,tawny,twice,varying,velvety-tomentose,weakly,white,whitish,yellow	.5,2/3,8-14-rayed,9-13-flowere,accrescent,across,along,alyx,annually,anthesi,armed,becoming,berry,bristly,broad,campanulate,cauline,confluent,da,deltoid,densely,developing,dia,difoliate,divided,eaf,eed,emerging,erect,extended,externall,fully,geminat,invested,ligneous,lobe,lon,long-stalked,long-stipitate,main,nearly,nflorescence,often,orolla,persisting,prickly,pubescent,rounded,ruit,several,short,slende,somewhat,spreading,stella,stellae,stellate-tomento,stellate-tomentose,stipitate,tamen,throughout,tightly,tigma,tub,tube,tyle,ultimate,unexpande,unit,usually,vein,year,ympodial,zygomorphic	0.5,arrangement,color,corolla,diameter,form,fruit,growth,height,history,inflorescence,leaf,length,life,na,plant,seed,shape,stellate,stigma,style,surface,texture,unexpanded
775	wfo-0001031842	success	161	103	72	89	31	0.447	.5,0.5-2,0.7-1,1-1.5,1-1.8,10-20,2-10,3-8,3/4,4.5-6,acute,anther,apart,axil,bark,base,beneath,bi-lobed,brown,calyx,capitate,cm,corolla,dark,deeply,deflexed,elliptic,flattened-reniform,fruiting,glabrous,globose,green,lateral,leaf,lobed,long,main,middle,minutely,mm,opposite,ovary,pale,papillose,pedicel,petiole,pitted,poricidal,reddish-resinous,shiny,shrub,simple,size,stem,stigma,straight,strongly,style,surface,terminal,tip,tree,trichome,tube,tuft,uniseriate,vein,way,white,widest,woody,young	.1,.4,.75,0.1-0.5,0.5-1,0.6-1,1,1-3.5,1.5-2,10-12,10-30-flowered,2-3,2.5-3,2.5-6,7-9,9-15,anthesi,apex,attenuate,ba,bearing,beginning,berry,cup-shaped,cusp,decurrent,densely,dia,differing,difoliate,dry,eaf,edicel,eed,ellipsoid,exserte,exsertion,filament,free,geminat,incrassate,inflorescenc,irregularly,later,leaf-opposed,lobe,lon,lower,major,margin,minor,near,new,nflorescence,often,older,one,onto,overtopping,pair,paler,papillo,pore,portion,prominent,pubescent,quadrate,reddish,reflexed,ruit,scar,shaped,shoot,slender,somewhat,soon,spaced,sparsely,specimen,tall,tapering,tear-drop,time,ud,unit,x,yellowish,yellowish-whit,ympodial	arrangement,articulation,color,connation,dehiscence,diameter,foetid,foliage,form,fruit,growth,height,history,inflorescence,interjected,leaflet,length,life,na,papillae,peduncle,plant,position,prickle,pseudostipule,seed,shape,spacing,straightnes,texture,yellowish-white
776	wfo-0001031843	success	245	126	90	155	36	0.367	0-4,0.6-1.2,0.7-2,1-2,1-7,1.2-2,1.8-2.5,2-3,5-10,5-12,6-9,accrescent,acuminate,almost,along,anther,apex,appressed,bark,base,becoming,berry,black,branch,brown,calyx,capitate,caudate,cm,corolla,curved,dark,deeply,diameter,discoid,distributed,drying,dull,equal,erect,evenly,finely,fruiting,glabrous,honeycomb,leaf,length,liana,lobed,long,longitudinally,main,mm,multiseriate,oblique,oblong,obovate,opening,orange,orange-brown,orange-yellow,pattern,pedicel,peduncle,petiole,pitted,poricidal,pubescent,red,ridged,seed,shrub,side,slender,slightly,sparsely,spheroidal,stem,stigma,straight,style,surface,terminal,tip,trichome,tube,violet,wider,x,young	.2,.3,.5,.6,0.2-2,0.4-0.5,0.5-1,0.5-1.5,0.7-1.2,0.8-2,1.2-2.2,1.5,1.5-2,1/6-1/4,1mm,2-4,2.5,3-4,3-7,4-12,45-60°,abaxially,adaxially,age,always,alyx,anthesi,apar,apically,apice,apparently,around,articulated,attenuate,basal,branched,branching,broadly,canaliculate,clearly,collapsing,completely,conical,cupular,cuspidate,delineated,deltoid,dendritic,density,detaching,dilated,discolorous,domatia,eaf,eed,ellipsoi,entire,even,eye,fertilisation,filament,fine,flat,flexuous,flower,forming,free,green,hand,inner,largely,leave,len,lengthening,lignified,like,lobe,loop,looping,lower,m.,margin,midvein,much,naked,network,never,nflorescence,nther,obscure,older,orolla,outline,ovate,pair,papillo,part,partly,pendulous,perfec,pericarp,pit,plurifoliat,pore,portion,present,primary,prominent,pronounced,protruding,rachi,raised,rarely,recurve,reddish,reveal,ribbed,rounded,ruit,scar,see,shallowly,shiny,shortly,simple,sinus,small,smaller,smooth,sometimes,soon,spreading,strongly,stump,surfac,tearing,tertiary,thick-chartaceous,thickened,thin,tuft,twice,ud,unarmed,unit,variable,vary,vein,venation,visible,weakly,white,wide,without,ympodial	60-100,arrangement,articulation,color,connation,dehiscence,diminishing,distal,foetid,foliage,form,fruit,growth,height,history,inflorescence,lateral,leaflet,life,mentioned,na,ovary,papillae,papillose,perennial,petiolule,plant,position,prickle,recurved,shape,size,spacing,straightnes,texture,tuber-bearing
777	wfo-0001031852	success	155	103	79	76	24	0.51	-8,0.1-1,1-4,1-4.2,1-9,12-35,2-3,2-5.5,3.5-10,4-10,4-5,9-11,abruptly,acuminate,acute,apex,apical,apically,articulate,base,branched,calyx,cm,conical,connate,corolla,cyme,dehiscent,diameter,dichasial,dichasially,diminishing,distal,ebracteate,elliptic,elliptic-lanceolate,forked,green,green-white,herbaceous,honeycomb,interjected,introrse,lanceolate,lateral,leaf,leaflet,light,maturing,mm,monochasial,mucilaginous,oblique,odd-pinnate,often,ovoid,pattern,pedicel,peduncle,perennial,petiole,plant,poricidally,proximal,pubescent,seed,short,shortly,size,slit,stellate,stigma,style,terminal,throughout,tuber-bearing,white,yellow,¼	0.5-1.3,0.5-3,1-,1.3-2.5,1.4-3,1.5-3,2.6-9.5,3-4,3-6-foliat,3-9,4-,4-6,5-15,7-,abaxially,absen,acumen,adaxially,apiculate,attenuate,cell,covering,decurrent,digestion,dorsally,eaf,edge,eed,emoval,enzyme,exceeding,filament,flat,flower,folded,generally,globo,hair-like,half,living,lobe,lon,long,lower,lunat,make,nflorescence,nther,oblong,orolla,ovate-elliptic,pair,perfect,plan,rachi,reveal,ruit,sessile,seudostipule,specimen,stamen,straight,tal,tem,testal,thick,throughou,toward,typically,unit,vary,wall,white-crea,wide,without,ympodial	absent,anther,arrangement,color,dehiscence,form,fruit,globose,growth,height,history,inflorescence,length,life,lunate,pseudostipule,shape,spacing,stem,surface,texture,wet,white-cream,ye
778	wfo-0001031864	success	140	81	55	85	26	0.393	.25,0.2-0.5,0.4-3,0.5-13.5,0.6-3.5,0.6-4,1-2,1.5-2.5,15-60,2-3,2.5-6,3-3.5,3-pinnate,5-15,abaxially,adaxially,anther,apex,apiculate,base,calyx,chartaceous,cm,color,cuneate,diameter,fleshy,fruit,glabrous,herbaceous,lateral,leaflet,lenticular,minutely,mm,oblique,ovoid-deltoid,pedicel,peduncle,petiole,petiolule,pubescent,rotate,rounded,slightly,stem,stigma,style,surface,truncate,unbranched,unknown,vine,violet,x	.2,.5,0.5-4,0.7-0.8,0.8-1,1-1.2,1-1.8,1-3,1-5,1-6.5,1.2-1.5,1.5,1.5-10,2,5-9,5-merous,7.5-8,accrescent,acuminate,acute,alyx,apar,apical,axe,berry,blade,c.,capitat,ciliate,clavate,deltoid,dense,densely,eaf,eed,emarginate,entire,extra-axillary,filament,fine,flattened,flower,fruiting,glabrou,hair,like,lobe,lon,long,lower,m.,margin,middle,moderately,near,nflorescence,nternode,orolla,papillose,perfec,plurifoliat,pointed,pubescenc,pubescence,rachi,ruit,sand-punctate,scattered,short,slender,spaced,sparsely,tamen,tem,terrestria,tip,trichome,tube,typical,unit,vary,vein,wide-diameter,widely,ympodial	apart,arrangement,capitate,corolla,dehiscence,diminishing,distal,form,growth,height,history,inflorescence,interjected,leaf,length,life,na,plant,pseudostipule,seed,shape,size,spacing,terminal,terrestrial,texture
779	wfo-0001031864	success	148	84	56	92	28	0.378	.25,0.4-3,0.5-13.5,0.6-3.5,0.6-4,1-2,1-3,1.5-2.5,15-60,2-3,2.5-6,3-3.5,3-pinnate,5-15,absent,anther,apart,apex,apiculate,base,blue-purple,calyx,cm,color,cuneate,diameter,fleshy,fruit,herb,interjected,lateral,leaflet,lenticular,longitudinal,minutely,mm,oblique,oblong,opening,pedicel,peduncle,petiolule,pubescent,rotate,rounded,slit,somewhat,stigma,style,surface,terrestrial,truncate,unbranched,unknown,x,yellow	.2,.5,0.5-4,1-1.2,1-1.8,1-5,1-6.5,1.2-1.5,1.5,2,3-5-celled,5-9,5-merou,7.5-8,abaxially,accrescent,acuminate,acute,adaxially,ag,alyx,apical,apparently,articulated,axe,ba,basally,blade,capitat,center,ciliate,clavate,connivent,cordate,deltoid,dense,densely,directed,distally,eaf,eed,emarginate,entire,equal,etiole,extra-axillary,filament,fine,flower,fruiting,geminat,glabrous,hair,large,lobe,long,lower,m.,margin,near,nflorescence,node,orolla,papillose,perfect,plurifoliate,pore,pubescenc,pubescence,rachi,rooting,scattered,short,simple,slender,slightly,spaced,sparsely,tamen,tem,thick,tip,trailing,tube,uniseriate,unit,vary,weakly,widely,wiry,woody,ympodial	age,arrangement,capitate,corolla,dehiscence,diminishing,distal,form,growth,height,history,inflorescence,leaf,length,life,na,petiole,plant,present,pseudostipule,seed,shape,size,spacing,stem,terminal,texture,true
780	wfo-0001031871	success	185	106	76	109	30	0.411	0.4-2,0.6-1.2,1-2,1.4-2.1,1.5-11,1.6-2.7,2.9-6,3-10,3-5,33-40,36-44,4-6,4-7,6-12,6.5-20.5,7-9,acute,anther,apex,attenuate,base,brownish,chartaceous,clavate,cm,condition,connivent,corolla,deep,diameter,distal,dot,drying,elliptic,forked,fresh,fruit,glabrous,globose,green,greenish,herb,interjected,lanceolate,lateral,leaflet,medium,mm,mucilaginous,odd-pinnate,ovate,ovoid,pedicel,peduncle,petiole,petiolulate,plant,poricidal,rotate,round,rounded,seed,size,stigma,straight,style,subglabrous,terminal,tiny,tip,tube,wet,white,whitish,x,yellow	1.5-2,1.5-2.1,14-22,2-3,2-4,3-4,3.5-4,5-merou,5.4-12.3,6-7,7.5-23,abaxially,acumen,adaxiall,adaxially,ag,alyx,apart,apparently,articulated,asymmetric,axe,axillary,basiscopic,berry,blade,bud,capitat,cell,covering,dark,digestion,dorsally,eaf,edge,eed,end,enzyme,erec,exceeding,filament,flat,flower,folded,geminat,generally,glabrou,green-white,hair,hair-like,hal,half,high,homostylous,honeycomb-shaped,lengthening,linear,living,lobe,long,lower,make,mottled,narrowly,nflorescence,one,orbicular,orolla,pair,perfect,placed,plurifoliate,pore,pubescent,purple,removed,ripe,ruit,sessile,seudostipule,short,side,slit,sometimes,spaced,specimen,stamen,stolo,subequal,subglabrou,subtending,symmetric,tall,tamen,tem,testal,thick,throughout,tissue,tri-,tuber,typically,unit,usually,vary,wall,wide,winged,ympodial	arrangement,bark,calyx,capitate,color,connation,dehiscence,diminishing,erect,form,growth,height,history,inflorescence,leaf,length,life,na,ovary,papillae,petiolule,pseudostipule,shape,spacing,stem,straightnes,surface,texture,tuber-bearing,ye
781	wfo-0001031874	success	197	98	63	134	35	0.32	0.4,0.5-1,0.5-1.5,1.2,2-3.5,2-4,2-5,acute,anther,apex,base,bilobed,blue,broad,broadly,calyx,chartaceous,cm,connivent,diameter,elliptic,erect,especially,flattened-reniform,fruit,fully,globose,green,herb,lanceolate,lateral,length,light,long-attenuate,minutely,mm,nearly,oblong,orange,ovate,partially,pedicel,peduncle,petiole,pitted,pore,red,ripe,rotate-stellate,simple,slightly,somewhat,stem,stigma,style,surface,terminal,tip,tube,violet,white,yellow,young	-1.2,-1.5,-3.5,-4,-7,.5-1.2,0.2,0.2–0.8,0.5–0.9,0.6-1,1-4,1.2-1.8,1.3–1.4,1.4–1.5,1.5-,1.8,1.8–2.3,1/10,1/3,1/5,2,2-3,2-foliate,2–2.5,2–9-branched,3-8,3-lobed,3.5–11,3–5,4.5-6,5,5-merou,6–7,7–8,9–11,abaxially,accrescent,adaxiall,adaxially,always,alyx,angulate,apart,articulated,asymmetrically,axe,ba,barely,berr,bi-lobed,bifurcation,blade,branch,capitat,ciliate,completely,contact,covering,cylindrical,decumbent,dehiscent,downward,eaf,eed,even,extra-axillary,filament,flower,fruiting,geminat,generally,glabrous,hair,hermaphroditic,hold,juic,least,level,line,lobe,lobed,long,longitudinall,lower,lowermost,main,margin,mesocarp,midrib,near,nflorescence,node,numerous,obtuse,often,one,orolla,ovate-triangular,passing,petiol,prostrate,puberulent,pubescent,rachi,rarely,recurved,rooting,ruit,several,short,side,soil,sometimes,spaced,sparsely,spreading,swollen,tall,tamen,tem,terete,time,triangular,unit,usually,vary,vein,way,well,white-puberulent,wide,winged,x,ympodial	1.5-4,2-2.5,3-5,arrangement,bark,capitate,color,connation,corolla,dehiscence,diminishing,distal,form,growth,height,history,inflorescence,interjected,leaf,leaflet,life,longitudinally,na,ovary,papillae,petiolule,plant,pseudostipule,seed,shape,size,spacing,straightnes,texture,tuber-bearing
782	wfo-0001031876	success	140	97	54	86	43	0.386	.1,.5,1-1.5,1-1.6,1.5-2.2,acute,anther,apex,bark,base,beneath,bright,calyx,closely,cm,corolla,decurrent,elliptic,fruiting,glabrous,globose,green,greenish-yellow,lateral,leaf,lobed,long-acuminate,mm,nearly,oblanceolate,oblique,opposite,ovary,papillose,pedicel,petiole,poricidal,prominent,raised,shaped,shrub,simple,slightly,spaced,stem,stigma,straight,style,tear-drop,tip,tube,white,yellow,young	0-flowered,0.5,0.8-1,1,1-4,27-35,3,5,9-15,?,across,anthesi,apiculate,arc,arising,ba,bearing,berry,convergence,corky,cup-like,dia,differing,eaf,edicel,eed,erect,family,filament,flower,free,glabrou,granular,immature,irregularity,known,lenticellat,less,lightly,lobe,long,lower,main,major,margin,melastomataceae,member,middle,minute,minutely,nflorescence,often,otherwise,overlappin,pair,parallel,perpendicular,persistent,point,pore,portion,present,primary,recurved,reflexed,resemble,ruit,running,scar,secondary,slender,styl,tall,tapering,time,ud,unifoliat,unit,vein,venation,wide,widest,winged,woody,x,ympodial	arrangement,articulation,color,connation,dehiscence,diameter,diminishing,distal,foetid,foliage,form,fruit,growth,height,history,inflorescence,interjected,leaflet,length,lenticellate,life,midpoint,na,overlapping,papillae,peduncle,perennial,petiolule,plant,position,prickle,pseudostipule,seed,shape,size,spacing,straightnes,surface,terminal,texture,trichome,tuber-bearing,unifoliate
783	wfo-0001031877	success	216	140	105	111	35	0.486	0.3-1,0.3-1.2,0.5,0.5-1,0.6-1.2,1,1-1.5,1-3,1-4,2,6-8,abruptly,acuminate,acute,anther,apex,articulated,basal,basally,base,bright,brown,calyx,capitate,cell,clavate,cm,conical,connivent,corolla,deep,deltate,diameter,distal,ellipsoid,ellipsoidal,exposed,flattened,fruit,fruiting,furcate,globose,greenish,growth,hastate,lateral,lengthening,linear,lobe,lobed,long,loosely,mature,minutely,mm,nearly,occasionally,outline,pale,pedicel,peduncle,petiole,pitted,plant,plump,pore,poricidal,prominently,pubescent,purple,red,reddish,reniform,ripe,scrambler,seed,semi-woody,short,silky,simple,sleeve,slightly,slit,sometimes,somewhat,stellate,stem,stigma,style,surface,terminal,testal,tinged,tip,triangular,trichome,truncate,tube,uniseriate,usually,vine,wall,weak,white,young	+,.3,.5,0.2,0.3-,0.8-0.9,1-3.5,1.1-,1.5,1.5-1.9,1.5-2,1.8-5,2-,2.5,3-5,3-6,3.5-4,5-merou,6-10,abaxially,adaxiall,adaxially,ag,along,alyx,angled,anthesi,apar,apparently,ark,ascending,berry,deflexed,densely,dried,eaf,eed,enlarged,entire,erect,especially,exserted,eye,filament,fleshy,flower,free,glabrous,green,ilament,impressed,internal,irregularly,lamina,later,like,line,long-acuminate,lower,margin,material,midvein,minute,new,nflorescence,often,older,orolla,pair,papillate,papillo,parallel,part,per,perfect,pericarp,plurifoliat,pointing,portion,primary,pubescence,purplish,rectangular,reflexed,rest,rounded,ruit,scar,shiny,shorte,sinuate,slender,spaced,sparsely,spreadin,strongly,subshru,tem,thin,twinin,ud,uniformly,unit,upper,vary,vein,visible,woody,x,yello,ympodial	age,apart,arrangement,articulation,bark,color,connation,dehiscence,diminishing,foetid,foliage,form,height,history,inflorescence,interjected,leaf,leaflet,length,life,na,ovary,papillae,papillose,petiolule,position,prickle,pseudostipule,shape,size,spacing,straightnes,texture,tuber-bearing,yellow
784	wfo-0001031880	success	180	95	69	111	26	0.383	0.5-1,0.5-2,0.7-0.8,1,1-1.3,2-3,2.5-8,3-foliate,3-lobed,acuminate,acute,anther,apart,apex,base,berry,brown,calyx,capitate,cm,color,cordate,corolla,curved,dark,densely,diameter,elliptic,flattened,fleshy,fruit,glandular,globose,herb,heteromorphic,inflorescence,leaf,minutely,mm,orange,ovary,ovate,ovoid,pale,papillose,pedicel,peduncle,petiole,pitted,poricidal,pubescent,purple,red,reddish,shallowly,simple,stem,stigma,strongly,style,subshrub,surface,terminal,tip,triangular,truncate,tube,upward,yellow	.5,1-1.5,1-2,1.5,2,2-4,2-9,3-3.5,3-4-pluri-foliate,4,4-8,5,5-6,6-9,7-9,abaxially,adaxially,age,anthesi,basal,bearing,becoming,broadly,c.,cell,ciliate,conical,crenate,crowded,cup-shaped,eaf,edicel,eed,ellipsoid,enlarged,entire,erect,exerted,filament,flower,flush,free,fruiting,glabrous,gland,gland-tipped,green,growing,hollow,horn,internodal,irregularly,lamina,lengthening,less,lobe,lon,long,longest,lower,margin,markedly,mature,maturit,mid-length,middle,narrowly,near,nflorescence,nodding,pair,papillo,pericarp,plan,pore,portion,primary,pubescen,rachi,reflexed,ruit,scar,shortest,single,slender,slightly,slit,sometimes,spaced,sparse,sparsely,spreading,straight,testal,thin,toothed,trichome,ud,unicellula,uniseriate,unit,unlobed,upper,vein,wall,widely,widest,woody,x,ympodial,–5	1.5-5,arrangement,bark,connation,dehiscence,diminishing,distal,form,growth,height,history,lateral,leaflet,length,life,na,papillae,petiolule,plant,seed,shape,size,spacing,straightnes,texture,tuber-bearing
785	wfo-0001031881	success	168	104	69	99	35	0.411	.5,1-1.3,1-1.5,1-7,1.2-6,1.5-2.5,3/4,5-6,acute,anther,apex,bark,base,beneath,branched,broadly,brown,calyx,campanulate,capitate,cm,corolla,dark,densely,distal,elliptic,fleshy,fruit,fruiting,glabrous,globose,golden,green,inflorescence,lateral,leaf,lobed,minutely,mm,obovate,opposite,ovary,ovoid-reniform,papillose,pedicel,petiole,pitted,poricidal,pubescent,shape,shaped,shrub,size,small,sparsely,stem,stigma,straight,style,surface,tear-drop,tip,tree,trichome,tube,usually,way,white,young	0.1-0.5,0.2,0.2-0.6,0.4-1,0.5-0.7,0.5-1,1/3,10-12,10-30,2,2-9,3-19,3.5-4,7-14,absent,along,anthesi,apar,apparent,attenuate,axil,ba,branch,bud,constriction,decurrent,deflexed,deltoid,dia,differing,difoliate,dry,drying,eaf,edicel,eed,either,ellipsoid,erect,evenly,exserted,filament,free,geminat,golden-puberulent,golden-pubescent,greyish-brow,incrassate,inflorescenc,junction,lightly,like,lobe,lon,long,lower,main,major,margin,material,maturity,middle,midrib,minor,minute,nflorescence,occasionally,older,one,orbicular,pair,papillo,planar,pore,portion,puberulen,puberulent,rest,rounded,ruit,scar,simple,slender,slightly,somewhat,soon,spaced,strong,tall,tapering,ud,uniseriate,unit,vein,widest,winged,woody,x,ympodial	alternate,apart,arrangement,articulation,color,connation,dehiscence,diameter,diminishing,foetid,foliage,form,greyish-brown,growth,height,history,interjected,leaflet,length,life,midpoint,na,papillae,peduncle,petiolule,plant,position,prickle,pseudostipule,seed,spacing,straightnes,terminal,texture,tuber-bearing
786	wfo-0001031886	success	169	100	72	97	28	0.426	-25,-9,0.1,1-1.5,1-4,2,2-4,2-5,20-30,3-6,4-15,5-6,6-20,acuminate,anther,anticlinal,apex,attenuate,base,bright,broadly,brown,calyx,capitate,cm,completely,conical,corolla,deltate,diameter,elliptic,fleshy,fruit,glabrous,green,greenish,irregular,lanceolate,lateral,leaflet,minutely,mm,occasionally,open-conical,ovary,ovoid-reniform,papillae,papillose,pedicel,petiole,petiolule,pinnate,poricidal,projection,seed,shape,shrub,simple,sinuous,somewhat,stigma,style,surface,terminal,thickening,tip,triangular,tube,white,without,woody,x	-1.2,-4,.5,0,0.5-1,1.2-2.5,1.5-2,10-40,2-2.5,2-3,2.0-2.5,3.0,4,5-10,5-ridged,6-8,9-10,abaxially,abruptly,absent,adaxially,along,anthesi,arising,axil,axillary,basal,beak,bearing,berry,bud,cell,clavat,commonly,distinctly,dry,eaf,earl,edicel,eed,either,em,epidermal,equal,erec,exserted,filament,flower,free,fruiting,half,le,lobe,lobed,long,lower,margin,narrowed,near,nearly,nflorescence,noddin,node,oblique,pair,papillate,per,portion,primary,purple,rachi,raised,reddish,reflexed,ripe,rugose,ruit,scar,scattered,similar,single,smaller,smelling,sparse,specimen,strongly,time,trichome,tub,ud,unifoliat,uniseriate,unit,usually,vein,wintergreen,ympodial	1,arrangement,bark,clavate,color,connation,dehiscence,diminishing,distal,form,growth,height,history,inflorescence,leaf,length,less,life,na,peduncle,plant,pseudostipule,size,spacing,stem,straightnes,texture,tuber-bearing
787	wfo-0001031895	success	160	115	77	83	38	0.481	0.5-1,1-1.5,1.5-3,2-2.5,3-4,3-8,4,5,acute,age,anther,apex,articulating,attenuate,bark,base,beneath,berry,bluish,calyx,capitate,cm,corolla,dark,diameter,elliptic,exfoliating,fruiting,globose,green,growth,irregular,leaf-opposed,leafy,leaving,lengthening,less,lobed,matte,minutely,mm,occasionally,older,once-branched,ovary,ovoid,pale,patch,pedicel,peduncle,peeling,peg,petiole,pitted,pore,poricidal,reniform,shiny,shoot,short,shrub,simple,slit,stem,stigma,stout,straight,style,surface,tan,terminal,tip,tube,violet,way,white,¼-1/2	-1.5,0.5,0.5-2,1.5-2,1.5-6,2.5-3,3-10,3.5-6,4-5,4.5-16.5,5-6,5-8,6-7,6-9,anthesi,apparently,blac,broadly,campanulate,cell,completely,conical,cup-shaped,deltate,densely,drying,eaf,eed,ellipsoid,emarginated,enlarging,entire,erec,erect,exerted,expand,filament,fleshy,flower,fragrant,free,glabrou,glabrous,immature,inflorescenc,intensely,lobe,lower,margin,new,nflorescence,overlapping,pair,papillat,papillate,part,perfect,pericarp,planar,plurifoliat,portion,primary,reddish,revolute,ruit,scar,sinuate,slender,slightly,small,somewhat,strongly,testal,thick,thin,tree,tub,ud,unit,vein,woody,x,ympodial	arrangement,articulation,color,connation,dehiscence,diminishing,distal,foetid,foliage,form,fruit,height,history,inflorescence,interjected,lateral,leaf,leaflet,length,life,midpoint,na,papillae,perennial,petiolule,plant,position,prickle,pseudostipule,seed,shape,size,spacing,straightnes,texture,trichome,tuber-bearing,young
788	wfo-0001031896	success	196	105	73	123	32	0.372	0.1-0.6,0.3-0.8,0.4-0.8,0.5-1,0.5-2,1-10,1-3,10-20,13,2-7,3-5,5,5-15,7-10,accrescent,anther,apart,armed,articulated,base,branched,brown,calyx,chartaceous,cm,contiguous,densely,diameter,elliptic,erect,extra-axillary,flattened,flower,forked,fruit,fruiting,globose,green,lateral,midpoint,minutely,mm,nearly,orange,pedicel,peduncle,perfect,petiole,pitted,prickle,pubescence,ray,shape,shrub,simple,size,slightly,small,spaced,sparsely,stellate,stellate-pubescent,stem,stigma,style,surface,tapered,tree,tube,unbranched,white,x,yellow	-1.5,0-1.2,0.3-0.5,0.3-0.7,0.3-1,1-1.2,1-1.5,1-2,1.5,10-20+,15-20,2,2-2.5,2-3,2-4.5,2-5,3-30+,4-7,5-10,5-6,5-9,6-10,6-30+,6-9,9-18,abaxially,acute,adaxiall,adaxially,ample,apex,apparently,axe,ba,blade,broad-based,capitat,coarsely,connivent,conspicuously,covering,curved,cylindrical,denser,difoliate,directed,distall,eaf,eed,eglandular,entire,equal,ferruginous,ferruginous-pubescent,filament,frequently,frui,geminate,glabrous,gland-tipped,glandular,glandular-puberulent,hair,held,interpetalar,lanceolate,less,like,lobe,lon,long,long-acuminate,long-stalked,longer,lower,margin,midrib,midvein,mixed,moderately,mostly,multangulate,nflorescence,oblique,occasional,occasionally,often,orolla,pinnatifid,pore,porrect,pubescent,rachi,recurved,rounded,ruit,sessile,short,shorter,sometimes,stalk,stalked,ste,stellae,straight,subcordate,tal,tamen,tem,time,tip,tissue,toothed,truncate,unarmed,uniform,unit,uprigh,vary,vein,whitish,wide,ympodial	arrangement,articulation,capitate,color,connation,corolla,dehiscence,foetid,foliage,form,growth,height,history,inflorescence,interjected,leaf,leaflet,length,life,na,ovary,papillae,plant,position,pseudostipule,seed,spacing,straightnes,terminal,texture,trichome,young
789	wfo-0001031897	success	264	100	74	190	26	0.28	0-1,0.1-0.5,1.3-2,2-4,2/3,6-9,absent,acute,almost,along,anther,anthesi,apex,bark,base,bendy,berry,black,brachyblast,branch,branched,brown,calyx,chartaceous,clavate,clustered,cm,connate,coriaceous,corolla,dark,densely,diameter,distributed,drying,elliptic,epiphyte,evenly,free,fruit,glabrous,grey,lanceolate,lateral,leaf,light,lobed,long,longitudinally,mauve,mm,oblong,orange-brown,ovoid,pedicel,peduncle,petiole,plant,poricidal,ridged,shrub,smooth,sparsely,stem,stigma,style,surface,terminal,thick,tip,tube,unarmed,white,young	.1,.5,.8,0.15,0.2-0.4,0.4-1.1,0.5-1,0.5-3,0.6,0.8-1.5,0°,1,1-1.5,1-2,1-2.5,1.1,1.5,1.5-8,1.7-3,13,4-5,462.,5-6,8,abaxial,abaxially,accrescent,adaxial,adaxially,age,alyx,apar,apically,apparently,appearing,appendage,arising,aristate,articulated,attenuate,axillary,boiteau,cell,clearly,concolorous,condensed,conical,covering,cuneate,curved,datum,dehiscing,delineated,dendritic,dense,developed,developing,development,dilated,divided,domatia,dorsal,dorsifixed,dry,dull,eaf,earliest,ed,enlarged,entire,equal,erect,even,except,extending,eye,faint,filament,filiform,fine,flower,foliaceous,fruiting,green,hair,immature,indistinc,inner,inside,known,lamina,larger,least,lengthening,like,linear,lobe,longitudinal,looped,lower,m.,main,margi,margin,membranous,midvein,minute,minutely,multicellular,multiseriate,naked,never,nflorescence,nther,obconical,oblon,obtuse,occasional,occasionally,one,orange,orolla,outside,ovate,overlapping,pair,papillose,part,partly,pendulous,perfec,pericarp,persisting,plurifoliat,pointed,pore,portion,primary,prominent,pronounced,protruding,pubescent,raised,rarely,reach,reddish,revolute,ribbed,ridge,ruit,scar,secondary,see,seen,shoot,short,side,simple,sinus,slender,slightly,smaller,smoot,sometimes,sparse,stump,subulate,sunk,tearing,terete,tertiary,thin,toward,trichome,ud,unbranched,unicellular,unit,usually,vary,vein,venation,visible,weakly,well-developed,wide,winged,wrinkle,x,ympodial	arrangement,color,connation,dehiscence,diminishing,distal,form,growth,height,history,inflorescence,interjected,leaflet,length,life,na,ovary,papillae,petiolule,seed,shape,size,spacing,straightnes,texture,tuber-bearing
790	wfo-0001031908	success	213	129	108	105	21	0.507	0-22,0-45,0.4-1.4,1-10,1-5.5,1.5-5.5,10-35,2-6,3-8,3.5-9,4-25,5-11,5-19,9-13,absent-10,acuminate,acute,almost,anther,apex,ascending,auriculate,band,base,blue,broadly,brownish,cell,chartaceous,cm,color,condition,cordate,corolla,covering,cuneate,decreasing,decumbent,diameter,distal,drying,dull,elliptic,elliptic-lanceolate,erect,falcate,forked,fresh,fruit,generally,globose,green,greenish,hair-like,herb,interjected,lanceolate,lateral,leaf,leaflet,lengthening,lilac,make,membranous,mm,mucilaginous,oblique,odd-pinnate,ovate,ovoid,pedicel,peduncle,petiole,pink,plant,pore,poricidal,purple,red-purple,ripe,rotate,rotate-pentagonal,rounded,seed,semi-elliptic,semi-erect,shiny,shortly,size,slightly,slit,spot,stem,stigma,straight,style,surface,terminal,testal,thick,tinged,tip,wall,wet,white,whitish,x,yellow	0-25,0-9,1-2,1-4,1-8,3-5,5,5-13,5-merou,7,8-22,abaxially,acumen,adaxially,ag,along,alyx,apart,apparently,approximately,articulated,attenuate,axe,axillary,berry,blade,bud,capitat,ciliate,connivent,dark,densely,digestion,dorsally,eaf,edge,eed,enzyme,especially,exceeding,filament,flat,flower,folded,geminat,glabrou,glabrous,green-white,hair,half,homostylous,honeycomb-shaped,like,living,lobe,long,lower,margin,medium,middle,midrib,minutely,mottle,nearly,nflorescence,often,orolla,pair,papillose,perfect,petiolulate,plurifoliate,prominent,prostrat,puberulent,pubescent,rarely,removed,ruit,secondary,sessile,seudostipule,short,spaced,specimen,stamen,star,ste,stippled,subtending,tall,tamen,tem,thir,throughout,tri-,truncate,tube,uniform,unit,unwinged,usually,vary,wing,ympodial	age,arrangement,calyx,capitate,dehiscence,diminishing,form,growth,height,history,inflorescence,length,life,na,petiolule,prostrate,pseudostipule,shape,spacing,straightnes,texture
791	wfo-0001032157	success	136	99	62	74	37	0.456	.5,0.5-1,0.6-1,1-3,2-5,3-6,9-17,acute,anther,apart,apex,bark,base,bi-lobed,calyx,cm,corolla,deflexed,elliptic,fruiting,glabrous,globose,green,lateral,leaf,lobed,long,longitudinal,minutely,mm,nearly,opposite,ovary,ovoid-reniform,papillose,pedicel,peeling,persistent,petiole,pitted,plant,poricidal,reddish,rounded,shaped,shrub,simple,size,stem,stigma,straight,strip,style,surface,tear-drop,tip,tube,white,woody,x,yellowish,young	.75,0.25,0.75-1,1.9-2.2,2-3,2.2,5-15-flowered,5-8,5-9,7-9,anthesi,becoming,beginning,beneath,berry,caly,completely,crystalline,decurrent,deltoid,dia,differing,difoliate,dry,eaf,edicel,eed,evenly,exserted,filament,free,frui,geminat,glabrou,golden,incrassate,inflorescenc,less,live,living,lobe,lon,lower,main,major,margin,middle,minor,nflorescence,obscure,older,one,pair,paler,papillo,pore,portion,raised,reflexed,ruit,scar,shiny,slender,slightly,soon,spaced,tall,tapering,translucen,ud,unit,vein,widest,ympodial	arrangement,articulation,color,connation,dehiscence,diameter,diminishing,distal,foetid,foliage,form,fruit,growth,height,history,inflorescence,interjected,leaflet,length,life,midpoint,na,papillae,peduncle,petiolule,position,prickle,pseudostipule,seed,shape,spacing,straightnes,terminal,texture,translucent,trichome,tuber-bearing
792	wfo-0001032161	success	146	84	57	89	27	0.39	0.4-1.2,0.75-1,1-3,1.2-1.3,2-7,anther,bark,calyx,closely,cm,color,conical,coriaceous,corolla,dark,dendritic,drying,elliptic,globose,golden,green,inflorescence,leaf,lobed,minutely,mm,mustard,ovary,ovoid-reniform,pale,papillose,pedicel,petiole,pitted,plant,plurifoliate,poricidal,pubescent,shaped,shiny,shrub,simple,spaced,sparsely,stem,stigma,style,surface,tan,tear-drop,thin,tip,trichome,tube,white,yellow,young	.5,0.5-1,0.7-4,0.8-1,1-1.5,1-11,1.4-2,2-8-flowered,2.5-3,3.5-4,?,abaxially,acute,adaxiall,adaxially,anthesi,apex,apical,area,ba,base,beneath,berry,branched,brownish-blac,deflexed,delicate,deltate,densely,dia,difoliate,eaf,edicel,eed,ellipsoid,exserted,filament,filiform,free,fruiting,giving,glabrous,hanging,internodal,lamina,later,like,lobe,long,lower,many,margin,merely,middle,minute,nearly,nflorescence,obovate,occasionally,older,opposite,overlappin,pericarp,persistent,pore,portion,projection,quadrate,reflexed,rest,revolute,ruit,scar,shoot,short,strongly,styl,sulcate,tall,tub,ud,uniseriate,unit,usually,vein,widest,x,yellowish,ympodial	arrangement,brownish-black,connation,dehiscence,diameter,form,fruit,growth,height,history,interjected,lateral,leaflet,length,life,na,overlapping,papillae,peduncle,pseudostipule,seed,shape,size,spacing,straightnes,terminal,texture
793	wfo-0001032165	success	197	93	59	138	34	0.299	1-1.5,1-2,1.5-4,3-6,5-6,5-7,acute,anther,apex,bark,base,brown,calyx,capitate,closely,cm,corolla,dark,distal,elliptic,erect,fruiting,glabrous,globose,green,greyish-brown,inflorescence,lateral,leaf,lobed,minutely,mm,obovate,ovary,ovoid-reniform,pale,pedicel,petiole,pitted,plant,poricidal,shape,simple,size,small,spaced,stem,stigma,straight,style,surface,tear-drop,terminal,tree,trichome,tube,uniseriate,white,young	.25,.5,0.1,0.1-0.3,0.25-0.5,0.3-1,0.75-1,1-1.2,10-25,2-2.5,2.5-3.5,3-4,3.5-8.5,4-6,5-15,5-30-flowered,5-9.5,8-9,abaxial,adaxial,along,anthesi,apparent,appearing,ba,beginning,beneath,berry,broadly,bud,center,continued,cucullate,cup-shaped,deciduous,decurrent,deltoid,densely,denser,dia,differing,difoliate,dry,due,dull,eaf,edged,edicel,eed,ellipsoid,end,entire,even,expansion,exserted,exsertion,filament,free,geminat,golden,golden-puberulent,golden-pubescent,immature,inflorescenc,later,less,like,live,lobe,lon,long,lower,main,major,margin,markedly,medial,middle,midrib,minor,minute,near,nearly,nflorescence,node,occasionally,older,once-furcate,one,onto,opposite,orbicular,overlapping,pair,paler,papillo,papillose,planar,pore,portion,presence,prominent,puberulent,purplish,rather,rest,ridge,ripe,rounded,ruit,scar,shaepd,single,slender,slightly,slow,smoot,specimen,stout,stripe,strongly,swollen,tall,tapering,thickened,time,tinged,tip,tub,ud,unit,vein,widest,winged,woody,x,yellowish,ympodial	alternate,arrangement,articulation,color,connation,dehiscence,diameter,diminishing,foetid,foliage,form,fruit,growth,height,history,interjected,leaflet,length,life,midpoint,na,papillae,peduncle,petiolule,position,prickle,pseudostipule,seed,shaped,smooth,spacing,straightnes,texture,tuber-bearing
794	wfo-0001032167	success	163	104	69	94	35	0.423	.5,0.5-1,0.5-2.5,1,1-3,1.5,12-20,2-7,2-foliate,3-6,5-15,7-10,absent,acute,anther,apex,base,berry,brown,calyx,cell,chartaceous,cm,diameter,dm,drying,elliptic,elliptic-ovoid,few-,flower,forming,fruit,glabrous,globose,growth,herb,immature,long,many-branched,maturing,membranaceous,mm,nearly,netlike,oblong,obtuse,pedicel,peduncle,petiole,projection,pubescent,purple,raised,rotate,rounded,seed,semitransparent,slightly,sometimes,stigma,style,surface,tube,usually,wall,white,woody,x,yellow	0.5-1.5,0.75-3,1-2,1-2-celled,1-2.5,1-5,1-7,10-20,10-35,2-4,3-7,4-10,4-6,abaxially,abundant,adaxiall,adaxially,along,appressed,axe,blade,ciliate,closely,common,connected,cordate,curved,decurrent,dehiscing,dense,densely,denser,eaf,eed,emarginat,entire,explosively,filament,flat,flattened,frui,geminat,geniculate,growt,hair,held,interpetalar,larger,linear-lanceolate,lobe,longer,lower,lowermost,lying,margin,maturit,mesocarp,moderately,near,new,nfloresence,notch,often,older,one-celled,orolla,per,placenta,pressure,pubescen,rachi,ruit,shorter,small,smaller,sparsely,staman,stamen,straight,tal,tamen,tem,tissue,triangular,twisted,two-celled,unbranched,unit,upper,vary,vein,watery,wid,ympodial	arrangement,bark,color,connation,corolla,dehiscence,diminishing,distal,form,geminate,height,history,inflorescence,interjected,lateral,leaf,leaflet,length,life,na,ovary,papillae,petiolule,plant,pseudostipule,shape,size,spacing,stem,straightnes,tall,terminal,texture,tuber-bearing,wide
795	wfo-0001032176	success	177	101	73	104	28	0.412	.5,0.42,0.5-0.7,0.8-6,1-10,1.5-6,100,3-4,6,7,anther,apart,apex,attenuate,axillary,base,branched,calyx,cm,conical,corolla,creeping,densely,diameter,elliptic,green,greenish,grey-brown,greyish,herb,lateral,leaf,leaflet,lengthening,lobed,minutely,mm,nearly,obovate,obtuse,occasionally,onto,ovary,ovoid-reniform,papillose,pedicel,petiole,petiolule,pinnate,poricidal,projection,pubescent,rachi,rounded,scar,seed,sinuous,size,slit,spaced,sparsely,stem,stigma,style,terminal,thickening,tip,tube,unevenly,white,winged,without,x	0,0.5,0.5-0.75,0.5-1,0.8-1,1-1.2,1.5-1.6,1.5-2.5,1/2,2-3,2.5-10,3-15,3-3.5,3-7,5-6-celled,6-10,adaxially,adhering,along,anthesi,apical,arising,attaining,axil,basal,beak,becoming,berry,capitat,cateniform,cell,containing,copiously,cucullate,denser,drying,eaf,edicel,eed,ellipsoid,epidermal,equal,especially,exserted,fallen,filament,filiform,flower,free,fruiting,glabrous,globose,hangin,inflorescenc,lengt,like,lobe,log,long,long-papillose,lower,margin,minute,nflorescence,nodding,node,often,open,pair,pale,per,pore,portion,quadrate,reflexed,rest,rooting,ruit,separate,simple,single,slightly,smaller,somewhat,soon,strait,strongly,tem,tightly,time,tree,trichome,truncate,trunk,tub,ud,ultimate,unifoliat,uniseriate,unit,vein,wall,whit,ympodial	arrangement,bark,capitate,color,connation,dehiscence,diminishing,distal,form,fruit,growth,height,history,inflorescence,length,life,na,papillae,peduncle,plant,shape,spacing,straight,straightnes,surface,texture,tuber-bearing,winging
796	wfo-0001032183	success	162	91	53	109	38	0.327	0.3-0.6,0.5-1.5,0.7-1.4,4.5-7,5-9,5.5-7,7-12,absent,accrescent,acute,anther,apex,articulated,base,calyx,chartaceous,cm,contiguous,cuneate,diameter,directed,distally,extra-axillary,flower,fruit,fruiting,globose,inflorescence,lanceolate,lateral,length,minute,mm,nearly,obtuse,ovate,pale,pedicel,peduncle,perennial,petiole,prickle,purple,red,rotate-stellate,sessile,shrub,simple,stigma,style,tube,unbranched,yellow	%,0-0.1,0-1.5,0.1-0.2,0.2-0.8,0.25-0.4,0.4-0.5,0.4-0.6,0.4-0.8,0.4-4,0.5-1,0.6-0.9,0.9-1,1-2,1-3,1.1-2.3,1.5-1.9,16-23,2-foliate,2.4-2.7,2.7-3.6,3.5-4.5,4-,4-6,5-merou,7-8,7-9,8-9,abaxially,absen,across,adaxiall,adaxially,alyx,apart,axe,ba,blade,capitat,confined,cylindrical,densely,distall,distributed,eaf,eed,eglandular,elliptic,entire,erect,exceeding,finger,geminat,glaberous,glabrous,gland-tipped,green,grey,hair,homostylous,juicy,lamina,lobe,long,lower,margin,markedly,mature,mesocarp,mid-point,midpoint,midrib,nflorescence,oblique,orolla,part,per,perfect,pore,porrect,pseudo-umbellate,pubescent,rachi,ray,rhizomatous,ruit,short,solitary,spaced,sparsely,stalk,stellae,stellate-pubescent,succulen,tal,tamen,tem,thick,thicker,throughout,time,unarme,unarmed,unit,vary,white,wide,x,ympodial	arrangement,articulation,bark,capitate,color,connation,corolla,dehiscence,diminishing,distal,foetid,foliage,form,growth,height,history,interjected,leaf,leaflet,life,na,ovary,papillae,petiolule,plant,position,seed,shape,size,spacing,stem,straightnes,surface,terminal,texture,trichome,tuber-bearing,young
797	wfo-0001032187	success	139	96	52	87	44	0.374	-11,-4,-4.2,-9,0.5,0.5-,0.6–1.3,1.1–3.2,2–9,3.1–3.5,3–3.2,5–7,acuminate,acute,anther,apex,base,brown,brownish,cm,corolla,cyme,dull,elliptic,flowered,forked,glabrescent,globose,green,herb,leaf,light,mature,mm,obovate,ovate,pedicel,peduncle,petiole,plant,rarely,simple,stage,stellate,stem,style,sub-glabrous,texture,truncate,yellow,yellowish,±	-2.1,-5,0.1–1.4,0.5–1,1.3–1.8,1.6–2.1,1.8–2,1.8–2.8,100,1–1.7,22,24.6–26.3,3–4,5-merous,7–11,9,adherent,alyx,angular,ape,appressed,aromatic,berry,blade,branch,broadly,changing,consisting,dark,di-foliate,dia,eaf,eed,eglandular,entire,equal,erect,filament,fully,geminat,granule,hair,hite,hooked,hydrated,lobe,long,lower,many,margin,marked,nflorescence,numerous,occasionally,penden,pentagonal,per,perfec,persistent,petiolate,pollen,predominantly,presen,protruding,purple,ridge,ruit,running,sclerotic,short,small,soft,sometimes,sparse,spreading,straight,tinged,tooth,triangular,unit,well,widest,wing,ympodial,±1,µm,×	arrangement,articulation,bark,calyx,color,connation,dehiscence,diameter,diminishing,distal,foetid,foliage,form,fruit,fruiting,growth,height,history,inflorescence,interjected,lateral,leaflet,length,life,na,ovary,papillae,petiolule,position,prickle,pseudostipule,seed,shape,size,spacing,stigma,straightnes,surface,terminal,trichome,tube,tuber-bearing,white,young
798	wfo-0001032190	success	230	134	101	129	33	0.439	-1,0-0.6,0.2-0.3,0.5-3,1-6,1.5-4,10,2-6,3-21,4-5,4.5-7,5-22,7-11,abaxially,accrescent,acuminate,adaxially,along,anther,apart,apex,apical-lateral,articulated,attenuate,bark,base,becoming,blunt-tipped,branched,brown,calyx,cm,conical,continued,corolla,decurrent,deltoid,diameter,due,elliptic,entire,extend,flower,fruit,fruiting,globose,growth,high,honeycombed,introrse,lanceolate,large,lateral,leaf,length,long,long-attenuate,longitudinal,main,margin,midvein,mm,mostly,nearly,oblanceolate,oblong,openly,pale,pedicel,peduncle,petiole,plurifoliate,pore,pubescent,reniform,reticulate-punctate,ripe,rotate-stellate,scabridulous,scabrous,shrub,side,slit,small,somewhat,stem,stigma,style,suborbicular,terminal,tree,truncate,tube,unarmed,vein,white,whitish,x,yellow,yellowish,young	-3.4,-6,.5-6,/100-1/20,0-80,0.4-1.5,0.6-1.5,0.7-1.1,0.8-1.1,1-1.5,1-1.7,1.2-2.1,1.2-3,1.3-5,1.5-3.5,1.6-4.4,1.8-3,1.9-4.5,1/2-3/4,2.5-10,2.5-4.3,2.7-6.8,3.5-8,4-6,6-11,6x,7-28,absent,acute,ag,anthesi,apparently,appressed-tomentose,axe,axillary,ba,berry,blade,branch,bud,campanulate,chartaceous,closely,coarse-stalked,coriaceous,dehiscing,densely,eaf,eed,ellipsoid,evident,exserted,few-rayed,filament,fleshy,free,glabrescent,glabrou,glabrous,granular-pubescent,green,hair,hirsute,inserted,line,lobe,lobed,long-,long-stalked,lower,m.,magnification,minute,mixed,moderately,multangulat,multangulate,multiseriate-stalked,near,nflorescence,obtuse,occasional,occasionally,older,orolla,ovat,ovate,overlapping,partly,perfect,porrect-stellat,porrect-stellate,present,rachi,rarely,rather,relatively,ruit,runk,sessile,short-,short-stalked,simple,spaced,sparse,sparsely,stamen,stelliform,stipitate-glandular,strongly,subcapitat,subcoriaceous,suture,tamen,terete,testa,thick,thin-stalked,time,tomentose,touching,toward,unarme,unit,usually,vary,way,wide,ympodial	age,arrangement,articulation,color,connation,dehiscence,diminishing,distal,foetid,foliage,form,height,history,inflorescence,leaflet,life,na,ovary,papillae,plant,position,prickle,pseudostipule,seed,shape,size,spacing,straightnes,subcapitate,surface,texture,trichome,tuber-bearing
799	wfo-0001032206	success	216	129	80	136	49	0.37	-0.8,0.2,accrescent,anther,apart,apex,approximately,articulated,bark,base,berry,calyx,chartaceous,cm,connivent,covering,cream,curved,dark,deltate,diameter,distal,elliptic,flattened,flattened-reniform,fruit,fruiting,gently,glabrescent,glabrous,green,green-brown,lateral,leaf,length,lobed,long,long-styled,marking,mature,maturity,mauve,midpoint,midvein,mm,moderately,orange-brown,pale,pedicel,peduncle,petiole,plant,poricidal,porrect,prickle,purple,ray,reflexed,sessile,short-styled,shrub,sometimes,spaced,spherical,stalk,stalked,stellate-pubescent,stem,straight,style,surface,tapering,tip,trichome,tube,white,wide,yellow,yellow-orange,young	-2,-20,-5,..,.2,.5,0,0.2–0.4,0.2–0.5,0.5–1,0.8–1.2,00–200,0–20,0–30,0–5,1,1.1–1.2,1.2–2.2,1.5–2,1.5–2.5,1/3,1/4–1/2,1/4–1/3,1/6,10–80,11–22,1–2,1–2.3,1–3,1–4,2.5–3.3,2.7–3.5,2–2.5,2–3,2–8,3.5–9,30–80,3–4,4.5–5.8,4–6,5-merous,5–15,5–20,5–6,5–8,5–9,6–10,6–15,6–8,7–10,8–20,abaxially,acute,adaxially,alyx,andromonoecious,apar,apically,apparently,armed,blade,bluntly,branched,broad-deltate,brow,clearly,concolorous,cuneate,discolorous,distance,drying,eaf,eed,equal,erect,extending,filament,flower,foliaceous,free,functionally,hermaphroditic,heterostylous,infructescence,lengt,lobe,lobing,longer,lowermost,mal,margin,nflorescence,obtuse,often,older,one,open,orolla,ovate,ower,pair,pendent,pendulous,per,pericarp,plurifoliat,portion,primary,rarely,scar,secondary,side,slender,smooth,sparsely,spreading,stellate,stout,tamen,tertiary,time,toward,truncate,uit,unarmed,ung,unit,usually,variously,vary,vein,venation,visible,weakly,woody,ympodial	0-20,0.2-0.5,0.5-1.5,0.8-1.2,1-2,1-2.3,1-3,1.1-1.2,1/4-1/3,10-80,11-22,2-8,3.5-9,5-20,5-9,6-8,arrangement,articulation,brown,color,connation,corolla,dehiscence,diminishing,foetid,foliage,form,growth,height,history,inflorescence,interjected,leaflet,life,na,ovary,papillae,petiolule,position,pseudostipule,seed,shape,size,spacing,stigma,straightnes,terminal,texture,tuber-bearing
